ibge,anomes,bpc_ben,bpc_pcd_ben,bpc_idoso_ben,bpc_pcd_val,bpc_idoso_val,bpc_val
110001,202201,502,407,95,493284,116352,609636
110002,202201,2806,1782,1024,2163420,1242300.6,3405720.6
110003,202201,79,64,15,77568,18180,95748
110004,202201,1992,1338,654,1621657.8,792648,2414305.8
110005,202201,421,338,83,409656.6,101808,511464.6
110006,202201,432,324,108,392688.6,130896,523584.6
110007,202201,69,55,14,66660,16968,83628
110008,202201,243,138,105,167256,127260,294516
110009,202201,905,681,224,825372,271488.4,1096860.4
110010,202201,1650,979,671,1187760.19,813252,2001012.19
110011,202201,1681,1312,369,1591356,448440,2039796
110012,202201,4034,2350,1684,2849412,2041008,4890420
110013,202201,736,581,155,705384,187860,893244
110014,202201,361,319,42,386628,50904,437532
110015,202201,1342,1059,283,1284721.04,342996.6,1627717.64
110018,202201,1033,634,399,769620.6,483588,1253208.6
110020,202201,15624,8882,6742,10777115.17,8188274.56,18965389.73
110025,202201,649,473,176,573276.6,214524,787800.6
110026,202201,36,23,13,27876,15756,43632
110028,202201,1569,1117,452,1353805.76,550249.8,1904055.56
110029,202201,130,118,12,143016,14544,157560
110030,202201,2373,1577,796,1912343.55,965965.45,2878309.00
110032,202201,300,228,72,276336.6,87264,363600.6
110033,202201,642,462,180,561156,218160,779316
110034,202201,325,239,86,289668.98,104232,393900.98
110037,202201,85,76,9,92112,10908,103020
110040,202201,388,268,120,324816,145440,470256
110045,202201,918,640,278,775680.6,338148.16,1113828.76
110050,202201,87,76,11,92112,13332,105444
110060,202201,60,35,25,42420,30300,72720
110070,202201,107,69,38,83628,46056,129684
110080,202201,510,290,220,351480.6,266640,618120.6
110090,202201,25,21,4,25452,4848,30300
110092,202201,110,59,51,71508,61812,133320
110094,202201,191,134,57,162408,69084,231492
110100,202201,44,30,14,36360,16968,53328
110110,202201,95,54,41,65448,49692,115140
110120,202201,65,56,9,67872,10908,78780
110130,202201,273,221,52,267852,63024,330876
110140,202201,241,173,68,209676,82416,292092
110143,202201,51,42,9,50904,10908,61812
110145,202201,37,29,8,35148,9696,44844
110146,202201,22,10,12,12120,14544,26664
110147,202201,37,26,11,31512,13332,44844
110148,202201,36,27,9,32724,10908,43632
110149,202201,312,220,92,267852,111504,379356
110150,202201,134,102,32,123624,38784,162408
110155,202201,11,10,1,12120,1212,13332
110160,202201,63,50,13,60600,15756,76356
110170,202201,215,166,49,201192,59388,260580
110175,202201,62,48,14,58176,16968,75144
110180,202201,93,75,18,90900,21816,112716
120001,202201,193,145,48,176952.55,58176,235128.55
120005,202201,199,115,84,139380.87,101808,241188.87
120010,202201,1124,692,432,841128.6,524796,1365924.6
120013,202201,152,104,48,126048,58176,184224
120017,202201,113,62,51,76356,61812,138168
120020,202201,3438,2784,654,3375497.33,792661.2,4168158.53
120025,202201,544,305,239,369661.15,289668,659329.15
120030,202201,1043,899,144,1089637.96,174536.8,1264174.76
120032,202201,38,34,4,41208,4848,46056
120033,202201,220,192,28,232711.7,33936.55,266648.25
120034,202201,172,126,46,152712.55,55752,208464.55
120035,202201,38,32,6,38784,7272,46056
120038,202201,404,258,146,312699.3,176952.55,489651.85
120039,202201,29,28,1,33937.65,1212,35149.65
120040,202201,13883,9376,4507,11369874.79,5467670.4,16837545.19
120042,202201,44,39,5,47268,6060.55,53328.55
120043,202201,14,3,11,3636,13332,16968
120045,202201,536,342,194,414504.55,235129.65,649634.20
120050,202201,1246,955,291,1157513.92,352704.65,1510218.57
120060,202201,1441,1197,244,1450820.1,295734.6,1746554.7
120070,202201,406,293,113,355117.5,136956,492073.5
120080,202201,179,113,66,136957.65,79992.55,216950.20
130002,202201,164,119,45,144228,54540,198768
130006,202201,105,69,36,83628,43632,127260
130008,202201,129,74,55,89688,66660,156348
130010,202201,155,94,61,113928,73932,187860
130014,202201,271,194,77,235128,93324,328452
130020,202201,123,80,43,96960,52116,149076
130030,202201,936,531,405,645996,490860,1136856
130040,202201,346,164,182,198768,220584,419352
130050,202201,546,285,261,346632.6,316332,662964.6
130060,202201,859,591,268,716293.2,324816,1041109.2
130063,202201,605,363,242,439956,293304,733260
130068,202201,194,118,76,143016,92112,235128
130070,202201,1330,895,435,1085952.55,527220,1613172.55
130080,202201,687,456,231,552672,281184,833856
130083,202201,70,40,30,48480,36360,84840
130090,202201,325,183,142,221796,172104,393900
130100,202201,1187,541,646,655692.6,782952,1438644.6
130110,202201,715,312,403,378144,488436,866580
130115,202201,138,64,74,77568,89688,167256
130120,202201,1615,1011,604,1225332.6,732048,1957380.6
130130,202201,596,411,185,498132,225432,723564
130140,202201,1542,1197,345,1450764,419352,1870116
130150,202201,396,352,44,426624,53328,479952
130160,202201,426,250,176,303000,215736,518736
130165,202201,57,46,11,55752,13332,69084
130170,202201,996,696,300,843474.43,364812.9,1208287.33
130180,202201,243,176,67,213312,81204,294516
130185,202201,2182,1009,1173,1224120,1422888,2647008
130190,202201,3344,2103,1241,2548837,1505304,4054141
130195,202201,276,221,55,270276.6,67872,338148.6
130200,202201,171,80,91,96960.6,110292,207252.6
130210,202201,92,47,45,56964,54540,111504
130220,202201,196,140,56,170892,67872,238764
130230,202201,368,241,127,292092,153924,446016
130240,202201,1311,850,461,1030200,558732,1588932
130250,202201,4961,3133,1828,3798408.4,2215536,6013944.4
130255,202201,408,205,203,248460,246036,494496
130260,202201,58705,27686,31019,33586855.79,37631654.51,71218510.30
130270,202201,1513,1033,480,1252105.08,581760,1833865.08
130280,202201,131,77,54,93324,65448,158772
130290,202201,2084,1402,682,1700436,826584,2527020
130300,202201,421,286,135,346632,163620,510252
130310,202201,906,481,425,582972,515100,1098072
130320,202201,515,269,246,326028,298152,624180
130330,202201,753,474,279,574488,338148,912636
130340,202201,3349,1881,1468,2280984,1780428.6,4061412.6
130350,202201,470,324,146,393900,176952,570852
130353,202201,925,407,518,493284.6,627816,1121100.6
130356,202201,770,342,428,414505.2,518736,933241.2
130360,202201,85,66,19,79992,23028,103020
130370,202201,681,529,152,641148,184224,825372
130380,202201,645,503,142,612060,172104,784164
130390,202201,468,382,86,464196,104232,568428
130395,202201,157,44,113,53328,136956,190284
130400,202201,70,49,21,59388,25452,84840
130406,202201,2202,1300,902,1576814.4,1093224,2670038.4
130410,202201,439,222,217,269064,263004,532068
130420,202201,2786,2266,520,2748817.2,631452,3380269.2
130423,202201,167,93,74,112716.6,89688,202404.6
130426,202201,184,100,84,121200,101808,223008
130430,202201,401,236,165,287244,199980,487224
130440,202201,205,65,140,78780,169680,248460
140002,202201,23,3,20,3636,24240,27876
140005,202201,209,125,84,151500,101808,253308
140010,202201,11261,6940,4321,8418562.63,5239478.21,13658040.84
140015,202201,144,66,78,79992,94536,174528
140017,202201,121,68,53,82416,64236,146652
140020,202201,444,290,154,351480,186648,538128
140023,202201,39,20,19,24240,23028,47268
140028,202201,23,12,11,14544,13332,27876
140030,202201,357,237,120,287244,145440,432684
140040,202201,62,44,18,53328,21816,75144
140045,202201,263,101,162,122412,197556,319968
140047,202201,472,314,158,380568.6,191496,572064.6
140050,202201,137,84,53,101808,65448,167256
140060,202201,65,41,24,49692,29088,78780
140070,202201,29,27,2,32724,2424,35148
150010,202201,4872,2932,1940,3556009.2,2356128.6,5912137.8
150013,202201,167,118,49,143016,59388,202404
150020,202201,1095,597,498,723564,603576,1327140
150030,202201,695,311,384,376932.02,465408,842340.02
150034,202201,204,128,76,155136,92112,247248
150040,202201,1534,879,655,1065348,793860,1859208
150050,202201,679,386,293,469044,356328,825372
150060,202201,4812,3031,1781,3680741.8,2163922.96,5844664.76
150070,202201,443,228,215,277548,260580,538128
150080,202201,16193,7541,8652,9144545.52,10499562.02,19644107.54
150085,202201,417,269,148,326028,179376,505404
150090,202201,689,575,114,696900,138168,835068
150095,202201,43,29,14,35148,16968,52116
150100,202201,68,42,26,50904,31512,82416
150110,202201,214,120,94,145440,113928,259368
150120,202201,391,283,108,342996,130896,473892
150125,202201,48,17,31,20604,37572,58176
150130,202201,2117,1074,1043,1301688,1265328,2567016
150140,202201,57752,25397,32355,30796935.95,39236087.15,70033023.10
150145,202201,239,127,112,155136,135744,290880
150150,202201,3246,1421,1825,1723464,2214325.2,3937789.2
150157,202201,374,266,108,322392.6,132108,454500.6
150160,202201,128,97,31,117564,38784,156348
150170,202201,3880,2827,1053,3426324,1276236.6,4702560.6
150172,202201,345,240,105,292092,127260,419352
150175,202201,80,44,36,53328,43632,96960
150178,202201,755,509,246,616908,298152,915060
150180,202201,3206,1569,1637,1901628,1987680.6,3889308.6
150190,202201,365,235,130,284820.6,157560,442380.6
150195,202201,113,62,51,75144,61812,136956
150200,202201,188,93,95,112716,115140,227856
150210,202201,3224,2540,684,3078480.6,829008,3907488.6
150215,202201,606,376,230,455712.6,278760,734472.6
150220,202201,3522,2334,1188,2830021.67,1442280.36,4272302.03
150230,202201,1315,1043,272,1264116.3,329664,1593780.3
150240,202201,6832,3839,2993,4654082,3631153.8,8285235.8
150250,202201,69,38,31,46056,37572,83628
150260,202201,108,71,37,86052,44844,130896
150270,202201,2155,1387,768,1682256,932028.6,2614284.6
150275,202201,533,338,195,409656,237552,647208
150276,202201,112,40,72,48480,87264,135744
150277,202201,821,367,454,446016,551460,997476
150280,202201,367,248,119,300576,144228,444804
150285,202201,125,64,61,77568,73738.08,151306.08
150290,202201,1187,683,504,827796,610848,1438644
150293,202201,746,345,401,418140,486012,904152
150295,202201,538,246,292,298152,353904,652056
150300,202201,93,44,49,53328,59388,112716
150304,202201,191,112,79,135744,95748,231492
150307,202201,420,351,69,425412,83628,509040
150309,202201,585,410,175,496920,212100.36,709020.36
150310,202201,265,175,90,212100,110292,322392
150320,202201,1852,1283,569,1556208.54,689628.6,2245837.14
150330,202201,2068,1191,877,1444704,1062924,2507628
150340,202201,198,133,65,161196,78780,239976
150345,202201,631,349,282,422988,341784,764772
150350,202201,396,315,81,384204,99384,483588
150360,202201,4737,2855,1882,3463896,2284621.2,5748517.2
150370,202201,830,568,262,688416.6,317544,1005960.6
150375,202201,199,93,106,112716,128472,241188
150380,202201,1523,1006,517,1220484,626604,1847088
150390,202201,871,498,373,603576,453288,1056864
150400,202201,110,91,19,110292,23028,133320
150405,202201,1588,1007,581,1221697.48,705384,1927081.48
150410,202201,117,73,44,88476,53328,141804
150420,202201,7603,4097,3506,4970610.15,4250485.8,9221095.95
150430,202201,636,397,239,481164.6,289668,770832.6
150440,202201,450,278,172,336936,208464,545400
150442,202201,2329,1231,1098,1495609.2,1331988.6,2827597.8
150445,202201,542,352,190,426624.6,231492,658116.6
150450,202201,221,125,96,151500,116352,267852
150460,202201,709,532,177,644784,214524,859308
150470,202201,1296,773,523,936876,633876,1570752
150475,202201,241,186,55,225432,66660,292092
150480,202201,1368,946,422,1146552,511464,1658016
150490,202201,608,356,252,431472,305424,736896
150495,202201,336,253,83,306636,101808,408444
150497,202201,287,196,91,237552,110292,347844
150500,202201,249,149,100,180588,121200,301788
150503,202201,1270,625,645,757500.6,781740.6,1539241.2
150506,202201,913,620,293,751440,355116,1106556
150510,202201,1313,708,605,858097.2,733260,1591357.2
150520,202201,317,218,99,264216,119988,384204
150530,202201,1851,1021,830,1238664,1008384,2247048
150540,202201,202,150,52,181800,63024,244824
150543,202201,845,435,410,527220,498132,1025352
150548,202201,450,321,129,390264,156348,546612
150549,202201,71,45,26,54540,31512,86052
150550,202201,3039,1512,1527,1833756,1851936,3685692
150553,202201,3459,1946,1513,2359767.6,1834968,4194735.6
150555,202201,144,77,67,93324,81204,174528
150560,202201,50,23,27,27876,32724,60600
150563,202201,128,65,63,78780,76356,155136
150565,202201,205,128,77,155136,93324,248460
150570,202201,430,286,144,346632,174528,521160
150580,202201,1712,828,884,1003536,1072620,2076156
150590,202201,826,537,289,652056,350268,1002324
150600,202201,516,306,210,370872,254520.6,625392.6
150610,202201,154,124,30,150288,36360,186648
150611,202201,128,85,43,103020,52116,155136
150613,202201,3294,1871,1423,2268864.96,1727157.8,3996022.76
150616,202201,559,309,250,374508,304212,678720
150618,202201,1369,704,665,853248,809616,1662864
150619,202201,391,298,93,362388,112716,475104
150620,202201,1247,725,522,879912,632664,1512576
150630,202201,142,94,48,113928.6,58176,172104.6
150635,202201,448,197,251,238764,304212,542976
150640,202201,41,22,19,26664,23028,49692
150650,202201,2420,1392,1028,1689528,1245936.6,2935464.6
150655,202201,249,182,67,220584,81204,301788
150658,202201,82,49,33,59388,39996,99384
150660,202201,563,364,199,441168,241188,682356
150670,202201,1127,392,735,475104,890820,1365924
150680,202201,10573,5521,5052,6692667.1,6133935,12826602.1
150690,202201,27,14,13,16968,15756,32724
150700,202201,491,319,172,386628,208464,595092
150710,202201,290,168,122,203616,147864,351480
150715,202201,838,529,309,641148,375720,1016868
150720,202201,419,318,101,385416,122412,507828
150730,202201,1067,520,547,630240,662964,1293204
150740,202201,235,155,80,187860,96960,284820
150745,202201,755,424,331,513888,401172,915060
150746,202201,67,34,33,41208,39996,81204
150747,202201,245,181,64,219372,77568,296940
150750,202201,134,73,61,88476,73932,162408
150760,202201,1812,1168,644,1418040.9,781740,2199780.9
150770,202201,393,223,170,270276,206040,476316
150775,202201,102,54,48,65448,58176,123624
150780,202201,196,113,83,136956,100596,237552
150790,202201,656,373,283,452076,342996,795072
150795,202201,1625,978,647,1185336,785376,1970712
150796,202201,331,188,143,227856,173316,401172
150797,202201,389,182,207,220584,253308,473892
150800,202201,1566,876,690,1061712,836280,1897992
150803,202201,525,413,112,500556,135744,636300
150805,202201,209,122,87,147864,105444,253308
150808,202201,1039,536,503,649632,613272,1262904
150810,202201,3213,2187,1026,2650644.42,1243512.6,3894157.02
150812,202201,488,252,236,305424,286032,591456
150815,202201,1146,711,435,861732,527220,1388952
150820,202201,1542,938,604,1136856,733260,1870116
150830,202201,549,408,141,494496,170892,665388
150835,202201,223,128,95,155136,115140,270276
150840,202201,1399,839,560,1018080,679932,1698012
160005,202201,63,43,20,52116.89,24240.04,76356.93
160010,202201,195,125,70,151500.12,84840.08,236340.20
160015,202201,142,88,54,106656.06,65448,172104.06
160020,202201,136,71,65,86052.04,78780,164832.04
160021,202201,69,30,39,36360.64,47268.02,83628.66
160023,202201,67,43,24,52116.08,29088.04,81204.12
160025,202201,24,11,13,13332.02,15756.04,29088.06
160027,202201,1481,835,646,1018081.88,784164.96,1802246.84
160030,202201,16518,8498,8020,10304440.27,9732371.08,20036811.35
160040,202201,287,169,118,206040.12,143016.02,349056.14
160050,202201,738,359,379,435108.22,459348.06,894456.28
160053,202201,285,168,117,203616.26,141804.14,345420.40
160055,202201,22,14,8,16968.02,9696.02,26664.04
160060,202201,6611,3521,3090,4272310.71,3749935.04,8022245.75
160070,202201,190,113,77,136956.02,93324.02,230280.04
160080,202201,122,62,60,75144,72720,147864
170025,202201,28,15,13,18180,15756,33936
170030,202201,192,156,36,190284.24,43632,233916.24
170035,202201,201,95,106,115140,128472,243612
170040,202201,174,128,46,156348,55752,212100
170070,202201,318,200,118,243612,143016,386628
170100,202201,346,253,93,306636,112716,419352
170105,202201,46,39,7,47268,8484,55752
170110,202201,116,68,48,82416,58176,140592
170130,202201,72,37,35,44844,42420,87264
170190,202201,96,56,40,67872,48480,116352
170200,202201,344,237,107,287244,129684,416928
170210,202201,6358,3368,2990,4084150.37,3625094.4,7709244.77
170215,202201,129,64,65,77568,78780,156348
170220,202201,1348,981,367,1190184,444804.2,1634988.2
170230,202201,142,93,49,112716,59388,172104
170240,202201,501,339,162,410868.2,197556,608424.2
170255,202201,1038,842,196,1020504,237552,1258056
170270,202201,47,33,14,39996,16968,56964
170290,202201,126,80,46,96960,55752,152712
170300,202201,108,68,40,82416,48480,130896
170305,202201,48,37,11,44844,13332,58176
170307,202201,57,43,14,52116,16968,69084
170310,202201,120,70,50,84840,61812,146652
170320,202201,30,18,12,21816,14544,36360
170330,202201,29,22,7,26664,8484,35148
170360,202201,32,18,14,21816,16968,38784
170370,202201,88,44,44,53328,53328,106656
170380,202201,72,56,16,67872,19392,87264
170382,202201,36,31,5,37572,6060,43632
170384,202201,140,107,33,129684,39996,169680
170386,202201,70,30,40,36360,48480,84840
170388,202201,47,20,27,24240,32724,56964
170389,202201,25,20,5,24240,6060,30300
170390,202201,72,44,28,53328,33936,87264
170410,202201,24,22,2,26664,2424,29088
170460,202201,15,9,6,10908,7272,18180
170510,202201,32,24,8,29088,9696,38784
170550,202201,1534,892,642,1082316.6,780528,1862844.6
170555,202201,105,78,27,94536,32724,127260
170560,202201,104,74,30,89688,36360,126048
170600,202201,39,11,28,13332,33936,47268
170610,202201,182,97,85,117564,105444.6,223008.6
170625,202201,34,20,14,24240,16968,41208
170650,202201,88,62,26,75144,31512,106656
170700,202201,576,427,149,517524,180588,698112
170710,202201,149,97,52,117564,63024,180588
170720,202201,98,76,22,92112,26664,118776
170730,202201,96,56,40,67872,48480,116352
170740,202201,84,59,25,71508,30300,101808
170755,202201,51,27,24,33936,29088,63024
170765,202201,134,73,61,88476.2,73932,162408.2
170770,202201,193,123,70,149076,84840,233916
170820,202201,587,387,200,469044,243612.6,712656.6
170825,202201,40,22,18,26664,21816,48480
170830,202201,89,72,17,87264,20604,107868
170900,202201,166,129,37,156348,44844,201192
170930,202201,929,506,423,614484.08,512676,1127160.08
170950,202201,3152,1477,1675,1790124.23,2031313.36,3821437.59
170980,202201,16,10,6,12120,7272,19392
171050,202201,146,108,38,130896,46056,176952
171070,202201,49,42,7,50904,8484,59388
171090,202201,48,35,13,42420,15756,58176
171110,202201,23,17,6,20604,7272,27876
171150,202201,41,23,18,27876,21816,49692
171180,202201,25,11,14,13332,16968,30300
171190,202201,164,93,71,112716,86052,198768
171195,202201,58,48,10,58176,12120,70296
171200,202201,39,19,20,23028,24240,47268
171215,202201,7,5,2,6060,2424,8484
171240,202201,60,43,17,52116,20604,72720
171245,202201,55,48,7,58176,8484,66660
171250,202201,76,43,33,52116,39996,92112
171270,202201,13,9,4,10908,4848,15756
171280,202201,42,35,7,42420,8484,50904
171320,202201,979,557,422,676296,512676,1188972
171330,202201,417,211,206,256944,249672,506616
171360,202201,95,66,29,79992,35148,115140
171370,202201,35,20,15,24240,18180,42420
171380,202201,133,114,19,138168,23028,161196
171395,202201,42,24,18,29088,21816,50904
171420,202201,264,176,88,213312,107868,321180
171430,202201,75,61,14,73932,16968,90900
171488,202201,207,116,91,140592,110292,250884
171500,202201,65,35,30,42420,36360,78780
171510,202201,74,48,26,58176,31512,89688
171515,202201,38,31,7,37572,8484,46056
171525,202201,26,23,3,27876,3636,31512
171550,202201,15,9,6,10908,7272,18180
171570,202201,51,25,26,30300,31512,61812
171575,202201,271,179,92,216948,111504,328452
171610,202201,1761,881,880,1067772,1066560,2134332
171620,202201,144,97,47,117564,56964,174528
171630,202201,53,30,23,36360,27876,64236
171650,202201,330,227,103,275124,126048,401172
171660,202201,253,147,106,178164,128472.6,306636.6
171665,202201,78,49,29,59388,35148,94536
171670,202201,420,253,167,306636,202404,509040
171700,202201,63,55,8,67872,9696,77568
171720,202201,28,10,18,12120,21816,33936
171750,202201,105,55,50,66660,60600,127260
171780,202201,73,56,17,67872,21816,89688
171790,202201,83,68,15,82416,18180,100596
171800,202201,34,26,8,31512,9696,41208
171820,202201,2055,1190,865,1442280.72,1049592.2,2491872.92
171830,202201,34,24,10,29088,12120,41208
171840,202201,59,38,21,46056,25452,71508
171845,202201,29,19,10,23028,12120,35148
171850,202201,37,31,6,37572,7272,44844
171855,202201,75,57,18,70296,21816,92112
171865,202201,6,5,1,6060,1212,7272
171870,202201,30,18,12,21816,14544,36360
171875,202201,82,59,23,71508,27876,99384
171880,202201,36,21,15,25452,18180,43632
171884,202201,49,28,21,33936,25452,59388
171886,202201,131,59,72,71508,87264,158772
171888,202201,26,21,5,25452,6060,31512
171889,202201,12,6,6,7272,7272,14544
171890,202201,54,45,9,54540,10908,65448
171900,202201,31,22,9,26664,10908,37572
172000,202201,34,29,5,35148,6060,41208
172010,202201,56,46,10,55752,12120,67872
172015,202201,21,15,6,18180.52,7272,25452.52
172020,202201,144,91,53,110292,64236,174528
172025,202201,38,25,13,30300,15756,46056
172030,202201,44,25,19,30300,23028,53328
172049,202201,82,53,29,64236,35148,99384
172065,202201,119,78,41,94536,49692,144228
172080,202201,116,70,46,84840,55752,140592
172085,202201,30,15,15,18180,18180,36360
172090,202201,426,314,112,380568.03,135744,516312.03
172093,202201,16,13,3,15756,3636,19392
172097,202201,20,11,9,13332,10908,24240
172100,202201,5373,3028,2345,3671148.6,2844565.92,6515714.52
172110,202201,84,54,30,65448,36360,101808
172120,202201,1706,1421,285,1723464.6,345420,2068884.6
172125,202201,11,10,1,12120,1212,13332
172130,202201,24,13,11,15756,13332,29088
172208,202201,200,122,78,147864,94536,242400
172210,202201,367,184,183,224220,221796,446016
210005,202201,2944,1848,1096,2242200.09,1329567,3571767.09
210010,202201,144,89,55,107868,66660,174528
210015,202201,42,30,12,36360,14544,50904
210020,202201,360,206,154,249672,186648,436320
210030,202201,315,208,107,252096,129684,381780
210040,202201,133,109,24,132108,29088,161196
210043,202201,254,199,55,241188,66660,307848
210047,202201,498,306,192,370872,232704,603576
210050,202201,277,207,70,250884,84840,335724
210055,202201,51,43,8,52116,9696,61812
210060,202201,540,441,99,534492,119988,654480
210070,202201,433,336,97,407232,117564,524796
210080,202201,133,122,11,147864,13332,161196
210083,202201,284,142,142,172104,172104,344208
210087,202201,4,3,1,3636,1212,4848
210090,202201,433,310,123,375720,149076,524796
210095,202201,407,316,91,382992,110292,493284
210100,202201,691,546,145,662964,176952,839916
210110,202201,115,76,39,92112,47268,139380
210120,202201,4892,3866,1026,4686806.32,1243512,5930318.32
210125,202201,180,108,72,130896,87264,218160
210130,202201,451,266,185,322392,224220,546612
210135,202201,28,21,7,25452,8484,33936
210140,202201,4456,3442,1014,4174129,1228968,5403097
210150,202201,358,227,131,275124,158772,433896
210160,202201,3227,2761,466,3349968.73,564792,3914760.73
210170,202201,1192,958,234,1161096,283608,1444704
210173,202201,124,109,15,132108,18180,150288
210177,202201,328,185,143,224220,173316,397536
210180,202201,29,16,13,19392,15756,35148
210190,202201,434,291,143,352692,173316,526008
210193,202201,6,4,2,4848,2424,7272
210197,202201,70,52,18,63024,21816,84840
210200,202201,602,513,89,622968,110292,733260
210203,202201,209,148,61,179376,73932,253308
210207,202201,360,300,60,363600,72720,436320
210210,202201,717,661,56,801132,67872,869004
210215,202201,69,61,8,73932,9696,83628
210220,202201,369,314,55,380568,66660,447228
210230,202201,305,247,58,299364,70296,369660
210232,202201,1277,889,388,1077468,470256,1547724
210235,202201,180,138,42,168468,50904,219372
210237,202201,35,19,16,23028,19392,42420
210240,202201,77,65,12,78780,14544,93324
210250,202201,173,147,26,178164,31512,209676
210255,202201,360,274,86,332088,104232,436320
210260,202201,393,272,121,329664,146652,476316
210270,202201,625,425,200,515100,243612,758712
210275,202201,86,66,20,79992,24240,104232
210280,202201,1044,687,357,833856.12,433896,1267752.12
210290,202201,517,352,165,426624,199980,626604
210300,202201,4980,3206,1774,3888096.66,2151300,6039396.66
210310,202201,105,75,30,90900,36360,127260
210312,202201,115,80,35,98172,42420,140592
210315,202201,107,91,16,110292,19392,129684
210317,202201,136,104,32,126048,38784,164832
210320,202201,2294,1977,317,2399760,384204,2783964
210325,202201,142,85,57,103020.6,69084.6,172105.2
210330,202201,4301,2536,1765,3073633.16,2139180,5212813.16
210340,202201,1200,912,288,1105344,349056.6,1454400.6
210350,202201,650,536,114,649632,138168,787800
210355,202201,143,123,20,149076,24240,173316
210360,202201,2082,1473,609,1786488,739320,2525808
210370,202201,1212,613,599,742956,725988,1468944
210375,202201,187,93,94,112716,113928,226644
210380,202201,718,559,159,677508,192708,870216
210390,202201,193,164,29,198768,35148,233916
210400,202201,392,342,50,414504,60600,475104
210405,202201,1012,712,300,862944,363600,1226544
210407,202201,63,50,13,60600,15756,76356
210408,202201,38,33,5,39996,6060,46056
210409,202201,325,285,40,345420,48480,393900
210410,202201,436,342,94,415716,113928,529644
210420,202201,210,175,35,213312,42420,255732
210430,202201,52,36,16,43632,19392,63024
210440,202201,369,252,117,305424,141804,447228
210450,202201,100,82,18,99384,21816,121200
210455,202201,236,127,109,153924.6,132108,286032.6
210460,202201,299,206,93,249672,112716,362388
210462,202201,63,52,11,63024,13332,76356
210465,202201,137,109,28,132108,33936,166044
210467,202201,513,382,131,462984,158772,621756
210470,202201,46,39,7,47268,8484,55752
210480,202201,1284,923,361,1118676,437532,1556208
210490,202201,188,129,59,156348,71508,227856
210500,202201,488,304,184,369660,223008,592668
210510,202201,518,422,96,511464,116352,627816
210515,202201,346,221,125,267852,151500,419352
210520,202201,398,361,37,437532,44844,482376
210530,202201,9433,4915,4518,5960619.16,5477032.17,11437651.33
210535,202201,124,94,30,113928,36360,150288
210540,202201,1488,1005,483,1218060.8,585396,1803456.8
210542,202201,1124,571,553,692052,670237.2,1362289.2
210545,202201,19,17,2,20604,2424,23028
210547,202201,122,108,14,130896,16968,147864
210550,202201,602,431,171,522372.76,208464,730836.76
210560,202201,149,130,19,157560,23028,180588
210565,202201,20,14,6,16968,7272,24240
210570,202201,1277,1057,220,1282296.4,266640,1548936.4
210580,202201,118,101,17,122412,20604,143016
210590,202201,715,599,116,725988,140592,866580
210592,202201,41,38,3,46056,3636,49692
210594,202201,104,88,16,106656,19392,126048
210596,202201,113,97,16,117564,19392,136956
210598,202201,140,105,35,127260,42420,169680
210600,202201,303,262,41,317544,49692,367236
210610,202201,246,231,15,281184,18180,299364
210620,202201,43,26,17,31512,20604,52116
210630,202201,69,64,5,77568,6060,83628
210632,202201,982,704,278,853248,336936,1190184
210635,202201,23,20,3,24240,3636,27876
210637,202201,130,94,36,113928,43632,157560
210640,202201,572,508,64,615696,77568,693264
210650,202201,384,322,62,390264,75144,465408
210660,202201,358,281,77,340572,93324,433896
210663,202201,51,37,14,44844,16968,61812
210667,202201,94,40,54,48480,65448,113928
210670,202201,256,228,28,276336,33936,310272
210675,202201,490,274,216,332088,263004,595092
210680,202201,222,141,81,170892,98172,269064
210690,202201,60,54,6,65448,7272,72720
210700,202201,151,115,36,139380,43632,183012
210710,202201,227,144,83,174528,100596,275124
210720,202201,122,109,13,132108,15756,147864
210725,202201,58,49,9,59388,10908,70296
210730,202201,22,17,5,20604,6060,26664
210735,202201,283,209,74,253308,89688,342996
210740,202201,509,440,69,533280,83628,616908
210745,202201,147,110,37,133320,44844,178164
210750,202201,2460,1267,1193,1535604,1448340,2983944
210760,202201,248,195,53,236340,64236,300576
210770,202201,247,200,47,242400,56964,299364
210780,202201,420,324,96,392688,116352,509040
210790,202201,177,147,30,178164,36360,214524
210800,202201,168,131,37,158772,44844,203616
210805,202201,58,52,6,63024,7272,70296
210810,202201,454,370,84,448440,101808,550248
210820,202201,2013,1687,326,2048281.04,397536,2445817.04
210825,202201,150,86,64,104232,77568,181800
210830,202201,709,481,228,582972,276336,859308
210840,202201,188,136,52,164832,63024,227856
210845,202201,225,172,53,208464,64236,272700
210850,202201,717,493,224,597516,271488,869004
210860,202201,3375,1981,1394,2403396,1689528,4092924
210870,202201,408,324,84,392688,101808,494496
210880,202201,76,62,14,75144,16968,92112
210890,202201,313,272,41,329664.8,50904,380568.8
210900,202201,636,421,215,510252,260580,770832
210905,202201,60,34,26,41208,31512,72720
210910,202201,1907,1456,451,1764673.48,546612,2311285.48
210920,202201,145,61,84,73932,101808,175740
210923,202201,78,63,15,76356,18180,94536
210927,202201,410,205,205,248460,248460,496920
210930,202201,67,55,12,66660,14544,81204
210940,202201,81,63,18,76356,21816,98172
210945,202201,192,106,86,128472,104232,232704
210950,202201,510,375,135,454500,163620,618120
210955,202201,89,57,32,69084,38784,107868
210960,202201,2211,1141,1070,1384104,1298052,2682156
210970,202201,105,92,13,111504,15756,127260
210975,202201,77,72,5,87264,6060,93324
210980,202201,1061,523,538,633876,652056.6,1285932.6
210990,202201,4446,3105,1341,3763260.4,1626504,5389764.4
211000,202201,1265,1031,234,1251996,283608,1535604
211003,202201,959,698,261,845976,316332,1162308
211010,202201,470,425,45,515100,54540,569640
211020,202201,1361,601,760,728412,922332,1650744
211023,202201,45,40,5,48480,6060,54540
211027,202201,75,54,21,65448,25452,90900
211030,202201,356,257,99,312696,119988,432684
211040,202201,281,237,44,287244.6,53328,340572.6
211050,202201,1099,749,350,907788,424200.6,1331988.6
211060,202201,615,545,70,660540.2,84840.23,745380.43
211065,202201,24,19,5,23028,6060,29088
211070,202201,842,707,135,856884.04,163620,1020504.04
211080,202201,86,84,2,101808,2424,104232
211085,202201,52,29,23,35148,27876,63024
211090,202201,76,65,11,78780,13332,92112
211100,202201,462,389,73,471468,88476,559944
211102,202201,237,171,66,207252,79992,287244
211105,202201,214,152,62,185436,75144,260580
211107,202201,124,78,46,94536,55752,150288
211110,202201,939,630,309,763560,374508,1138068
211120,202201,4993,2577,2416,3124537.08,2931828.44,6056365.52
211125,202201,23,16,7,19392,8484,27876
211130,202201,40489,18966,21523,23012251.76,26104059.42,49116311.18
211140,202201,398,350,48,424200,58176,482376
211150,202201,1173,815,358,987780,433896.6,1421676.6
211153,202201,161,100,61,122412,73932,196344
211157,202201,69,57,12,69084,14544,83628
211160,202201,679,583,96,707808,116352,824160
211163,202201,2,2,0,2424,,2424.0
211167,202201,10,9,1,10908,1212,12120
211170,202201,405,304,101,368448.6,122412,490860.6
211172,202201,111,77,34,93324,41208,134532
211174,202201,248,160,88,193920,106656,300576
211176,202201,460,340,120,412080.6,145440,557520.6
211178,202201,84,58,26,70296,31512,101808
211180,202201,209,168,41,203616,49692,253308
211190,202201,68,61,7,73932,8484,82416
211195,202201,32,20,12,24240,14544,38784
211200,202201,151,130,21,157560,25452,183012
211210,202201,410,305,105,370872,127260,498132
211220,202201,4154,2459,1695,2981522.42,2057976.8,5039499.22
211223,202201,97,91,6,110292,7272,117564
211227,202201,53,43,10,52116,12120,64236
211230,202201,702,581,121,704172,146652,850824
211240,202201,375,309,66,375720,79992,455712
211245,202201,179,94,85,113928,103020,216948
211250,202201,1482,1286,196,1562268.4,237552,1799820.4
211260,202201,782,661,121,801132,146652,947784
211270,202201,1855,1529,326,1853148,395112.6,2248260.6
211280,202201,1753,1151,602,1396224,730836,2127060
211285,202201,206,131,75,158772,90900,249672
211290,202201,707,503,204,609636,247248,856884
211300,202201,739,596,143,722352,173316,895668
211400,202201,1490,945,545,1145340.02,660540,1805880.02
220005,202201,15,14,1,16968,1212,18180
220010,202201,84,69,15,83628,18180,101808
220020,202201,681,554,127,671448,153924,825372
220025,202201,104,101,3,122412,3636,126048
220027,202201,49,40,9,48480,10908,59388
220030,202201,118,96,22,116352,26664,143016
220040,202201,1250,956,294,1159884.4,356328,1516212.4
220045,202201,30,20,10,24240,12120,36360
220050,202201,699,578,121,701749.09,146652,848401.09
220060,202201,171,149,22,180588,26664,207252
220070,202201,111,97,14,117564,16968,134532
220080,202201,14,12,2,14544,2424,16968
220090,202201,36,27,9,32724,10908,43632
220095,202201,2,1,1,1212,1212,2424
220100,202201,22,18,4,21816,4848,26664
220105,202201,28,25,3,30300.6,3636,33936.6
220110,202201,236,217,19,263004,23028,286032
220115,202201,40,36,4,43632,4848,48480
220117,202201,22,20,2,24240,2424,26664
220120,202201,1472,1125,347,1363500,420564,1784064
220130,202201,28,27,1,32724,1212,33936
220140,202201,98,79,19,95748,23028,118776
220150,202201,475,358,117,433896,141804,575700
220155,202201,12,11,1,13332,1212,14544
220157,202201,19,16,3,19392,3636,23028
220160,202201,93,83,10,100596,12120,112716
220170,202201,39,35,4,42420,4848,47268
220173,202201,8,7,1,8484,1212,9696
220177,202201,14,13,1,15756,1212,16968
220180,202201,65,63,2,76356,2424,78780
220190,202201,1075,935,140,1133220,169680,1302900
220191,202201,35,29,6,35148,7272,42420
220192,202201,88,83,5,100596,6060,106656
220194,202201,58,52,6,63024,7272,70296
220196,202201,84,70,14,84840,16968,101808
220198,202201,1,1,0,1212,,1212.0
220200,202201,407,341,66,413292,79992,493284
220202,202201,37,32,5,38784,6060,44844
220205,202201,60,52,8,63024,9696,72720
220207,202201,12,12,0,14544,,14544.0
220208,202201,77,46,31,55752,37572,93324
220209,202201,33,27,6,32724,7272,39996
220210,202201,22,16,6,19392,7272,26664
220211,202201,29,27,2,32724,2424,35148
220213,202201,33,29,4,35148,4848.6,39996.6
220217,202201,38,31,7,37572,8484,46056
220220,202201,2235,1465,770,1775580,934452.6,2710032.6
220225,202201,8,3,5,3636,6060,9696
220230,202201,957,739,218,898092,264216,1162308
220240,202201,163,143,20,173316,24240,197556
220245,202201,35,32,3,38784.4,3636,42420.4
220250,202201,122,104,18,126048,21816,147864
220253,202201,53,47,6,56964,7272,64236
220255,202201,40,34,6,41208,7272,48480
220260,202201,690,524,166,637512,201192,838704
220265,202201,6,5,1,6060,1212,7272
220270,202201,809,729,80,883548,96960,980508
220271,202201,37,29,8,35148,9696,44844
220272,202201,11,10,1,12120,1212,13332
220273,202201,16,14,2,16968,2424,19392
220275,202201,61,51,10,61812,12120,73932
220277,202201,20,15,5,18180,6060,24240
220280,202201,17,11,6,13332,7272,20604
220285,202201,38,36,2,43632,2424,46056
220290,202201,1491,1276,215,1547724.6,260580.6,1808305.2
220300,202201,33,33,0,39996,,39996.0
220310,202201,324,277,47,335724,58176,393900
220320,202201,443,409,34,496920.6,41208,538128.6
220323,202201,2,1,1,1212,1212,2424
220325,202201,8,7,1,8484,1212,9696
220327,202201,12,12,0,14544,,14544.0
220330,202201,233,166,67,201192,81204,282396
220335,202201,138,117,21,141804,25452,167256
220340,202201,44,31,13,37572,15756,53328
220342,202201,52,44,8,53328,9696,63024
220345,202201,80,69,11,83628,13332,96960
220350,202201,461,398,63,482376,76356,558732
220360,202201,41,31,10,37572,12120,49692
220370,202201,1269,1055,214,1278660,259368,1538028
220375,202201,14,14,0,16968,,16968.0
220380,202201,26,19,7,23028,8484,31512
220385,202201,16,15,1,18180,1212,19392
220390,202201,2320,1286,1034,1558633.04,1254420.8,2813053.84
220400,202201,34,30,4,36360,4848,41208
220410,202201,24,22,2,26664,2424,29088
220415,202201,12,11,1,13332,1212,14544
220420,202201,126,106,20,128472,24240,152712
220430,202201,125,111,14,134532.6,16968,151500.6
220435,202201,24,17,7,20604,8484,29088
220440,202201,279,238,41,288456,49692,338148
220450,202201,332,168,164,203616,202404,406020
220455,202201,48,47,1,56964,1212,58176
220460,202201,18,16,2,19392,2424,21816
220465,202201,75,50,25,60600,30300,90900
220470,202201,238,208,30,252096,37572,289668
220480,202201,72,65,7,78780,8484,87264
220490,202201,89,75,14,90900,16968,107868
220500,202201,115,96,19,116352,23028,139380
220510,202201,375,288,87,349056.6,105444,454500.6
220515,202201,21,19,2,23028,2424,25452
220520,202201,369,327,42,396324.96,50904,447228.96
220525,202201,9,5,4,6060,4848,10908
220527,202201,16,13,3,15756,3636,19392
220530,202201,45,22,23,26664,27876,54540
220535,202201,6,4,2,4848,2424,7272
220540,202201,82,69,13,84840,15756,100596
220545,202201,28,19,9,23028,10908,33936
220550,202201,705,557,148,676296,179376,855672
220551,202201,16,13,3,15756,3636,19392
220552,202201,11,11,0,13332,,13332.0
220553,202201,49,44,5,53328,6060,59388
220554,202201,11,8,3,9696,3636,13332
220555,202201,40,31,9,37572,10908,48480
220556,202201,37,35,2,42420,2424,44844
220557,202201,54,48,6,58176,7272,65448
220558,202201,7,3,4,3636,4848,8484
220559,202201,2,2,0,2424,,2424.0
220560,202201,71,46,25,55752,30300,86052
220570,202201,719,449,270,544188,327240,871428
220580,202201,533,485,48,587820,58176,645996
220585,202201,11,10,1,12120,1212,13332
220590,202201,13,12,1,14544,1212,15756
220595,202201,72,55,17,66660,20604,87264
220600,202201,19,12,7,14544,8484,23028
220605,202201,24,21,3,25452,3636,29088
220610,202201,85,73,12,88476,14544,103020
220620,202201,536,452,84,547824.6,101808,649632.6
220630,202201,6,5,1,6060,1212,7272
220635,202201,33,29,4,35148,4848,39996
220640,202201,110,91,19,110292,23028,133320
220650,202201,113,107,6,129684,7272,136956
220660,202201,62,48,14,58176,16968,75144
220665,202201,8,8,0,9696,,9696.0
220667,202201,17,14,3,16968,3636,20604
220669,202201,32,26,6,31512,7272,38784
220670,202201,65,52,13,63024,15756,78780
220672,202201,79,59,20,71508,24240,95748
220675,202201,30,24,6,29088,7272,36360
220680,202201,47,40,7,48480,8484,56964
220690,202201,50,47,3,56964,3636,60600
220695,202201,26,14,12,16968,14544,31512
220700,202201,1758,1352,406,1641049.2,494496,2135545.2
220710,202201,6,4,2,4848,2424,7272
220720,202201,110,93,17,112716,20604,133320
220730,202201,17,16,1,19392,1212,20604
220735,202201,3,0,3,,3636,3636.0
220740,202201,49,44,5,53328,6060,59388
220750,202201,115,98,17,118776,20604,139380
220755,202201,17,16,1,19392,1212,20604
220760,202201,65,58,7,70296,8484,78780
220770,202201,5819,3271,2548,3969301.48,3093024.6,7062326.08
220775,202201,14,10,4,12120,4848,16968
220777,202201,20,19,1,23028,1212,24240
220779,202201,1,0,1,,1212,1212.0
220780,202201,899,765,134,927180,162408.6,1089588.6
220785,202201,5,1,4,1212,4848,6060
220790,202201,1138,901,237,1092012.08,287244,1379256.08
220793,202201,6,5,1,6060,1212,7272
220795,202201,16,14,2,16968,2424,19392
220800,202201,3999,3053,946,3702886.2,1148976,4851862.2
220810,202201,68,59,9,71508.6,10908,82416.6
220820,202201,235,213,22,258156,26664,284820
220830,202201,1280,1113,167,1350168.6,202404,1552572.6
220840,202201,2453,1728,725,2094339.28,879912.32,2974251.60
220850,202201,68,61,7,73932,8484,82416
220855,202201,8,4,4,4848,4848,9696
220860,202201,9,8,1,9696,1212,10908
220865,202201,30,26,4,31512,4848,36360
220870,202201,85,77,8,93324,9696,103020
220880,202201,322,258,64,313908,77568,391476
220885,202201,27,26,1,31512,1212,32724
220887,202201,7,6,1,7272,1212,8484
220890,202201,91,78,13,95748,15756,111504
220900,202201,26,14,12,16968,14544,31512
220910,202201,47,38,9,46056,10908,56964
220915,202201,11,10,1,12120,1212,13332
220920,202201,51,44,7,53328,8484,61812
220930,202201,44,42,2,50904,2424,53328
220935,202201,13,13,0,15756,,15756.0
220937,202201,32,29,3,35148,3636,38784
220940,202201,55,51,4,61812,4848,66660
220945,202201,2,2,0,2424,,2424.0
220950,202201,35,28,7,33936,8484,42420
220955,202201,15,15,0,18180,,18180.0
220960,202201,25,23,2,27876,2424,30300
220965,202201,39,36,3,43632,3636,47268
220970,202201,61,52,9,63024,10908,73932
220975,202201,10,9,1,10908,1212,12120
220980,202201,30,28,2,33936,2424,36360
220985,202201,55,49,6,59388,7272,66660
220987,202201,31,29,2,35148,2424,37572
220990,202201,26,25,1,30300,1212,31512
220995,202201,10,9,1,10908,1212,12120
220997,202201,58,50,8,60600,9696,70296
221000,202201,1193,1067,126,1293204,152712,1445916
221005,202201,35,32,3,38784,3636,42420
221010,202201,19,15,4,18180,4848,23028
221020,202201,34,33,1,39996,1212,41208
221030,202201,39,31,8,37572,9696,47268
221035,202201,20,19,1,23028,1212,24240
221037,202201,12,8,4,9696,4848,14544
221038,202201,28,25,3,30300,3636,33936
221039,202201,22,22,0,26664,,26664.0
221040,202201,264,226,38,273912,46056,319968
221050,202201,223,187,36,227856,43632,271488
221060,202201,1932,1666,266,2021616,322392,2344008
221062,202201,29,28,1,33936,1212,35148
221063,202201,15,10,5,12120,6060,18180
221065,202201,65,53,12,64236,14544,78780
221070,202201,135,117,18,141804,21816,163620
221080,202201,377,319,58,386628,70296,456924
221090,202201,21,16,5,19392,6060,25452
221093,202201,41,30,11,36360,13332,49692
221095,202201,4,4,0,4848,,4848.0
221097,202201,12,10,2,12120,2424,14544
221100,202201,25861,15398,10463,18672077.56,12686005.4,31358082.96
221110,202201,1117,844,273,1022928.6,330876,1353804.6
221120,202201,534,387,147,469044,179376,648420
221130,202201,966,778,188,942936,227856,1170792
221135,202201,30,26,4,31512,4848,36360
221140,202201,44,37,7,44844,8484,53328
221150,202201,9,7,2,8484,2424,10908
221160,202201,12,12,0,14544,,14544.0
221170,202201,17,17,0,20604,,20604.0
230010,202201,152,135,17,164832,20604,185436
230015,202201,144,116,28,140592,33936,174528
230020,202201,1637,1349,288,1634988.6,350268,1985256.6
230030,202201,1665,1199,466,1453188.2,564792,2017980.2
230040,202201,228,184,44,223008,53328,276336
230050,202201,231,167,64,202404,77568,279972
230060,202201,158,124,34,150288,41208,191496
230070,202201,303,259,44,313908,53328,367236
230075,202201,866,730,136,884760.6,164832,1049592.6
230080,202201,206,174,32,210888,38784,249672
230090,202201,147,109,38,132108,46056,178164
230100,202201,2385,1346,1039,1632565.6,1259268.4,2891834.0
230110,202201,2913,1842,1071,2232504.6,1298052.6,3530557.2
230120,202201,1082,843,239,1022928.4,289668,1312596.4
230125,202201,163,130,33,157560,39996,197556
230130,202201,471,417,54,505404.8,65448,570852.8
230140,202201,211,171,40,207252,48480,255732
230150,202201,150,115,35,139380,42420,181800
230160,202201,939,778,161,942936,195132,1138068
230170,202201,611,542,69,656905,83628,740533
230180,202201,65,60,5,72720,6060,78780
230185,202201,405,344,61,416928,73932,490860
230190,202201,2441,1884,557,2283408.4,675084,2958492.4
230195,202201,507,439,68,532068,82416,614484
230200,202201,419,330,89,399960,107868,507828
230205,202201,390,261,129,316332,156348,472680
230210,202201,1391,1064,327,1290780,396324,1687104
230220,202201,1587,1071,516,1299264.4,625392.6,1924657.0
230230,202201,970,808,162,980508,196344.6,1176852.6
230240,202201,1854,1612,242,1955259.8,294516.8,2249776.6
230250,202201,1772,1444,328,1750128,397536,2147664
230260,202201,3240,1998,1242,2422788,1505304,3928092
230270,202201,1359,1072,287,1300477.78,349056,1649533.78
230280,202201,2777,2099,678,2545200,821736,3366936
230290,202201,352,312,40,378184.66,48480,426664.66
230300,202201,529,386,143,467832,174528,642360
230310,202201,425,326,99,395112,121200,516312
230320,202201,903,767,136,929605.2,164832,1094437.2
230330,202201,308,244,64,296940,77568.4,374508.4
230340,202201,443,355,88,430260.4,106656,536916.4
230350,202201,3290,2033,1257,2465208,1524696.6,3989904.6
230360,202201,271,225,46,272700,55752,328452
230365,202201,128,104,24,127260,29088,156348
230370,202201,10825,5327,5498,6462387.42,6678120.4,13140507.82
230380,202201,482,412,70,499344.6,84840,584184.6
230390,202201,528,300,228,363600,276336.6,639936.6
230393,202201,243,201,42,244824,50904,295728
230395,202201,352,286,66,346632.12,79992,426624.12
230400,202201,628,499,129,604788,157560,762348
230410,202201,2693,1674,1019,2031312.86,1236240.6,3267553.46
230420,202201,6449,4247,2202,5148578.19,2671249.52,7819827.71
230423,202201,336,292,44,353904,53328,407232
230425,202201,464,367,97,444804.96,117564,562368.96
230426,202201,116,91,25,110292,30300,140592
230427,202201,69,63,6,76356,7272,83628
230428,202201,1595,781,814,946572,986568,1933140
230430,202201,451,364,87,441168,105444,546612
230435,202201,924,669,255,812040,309060,1121100
230440,202201,93956,42235,51721,51225203.28,62745257.16,113970460.44
230445,202201,318,216,102,261792.08,123624,385416.08
230450,202201,580,456,124,552672,150288,702960
230460,202201,83,62,21,75144,25452,100596
230465,202201,312,249,63,301788,76356,378144
230470,202201,2023,1588,435,1925868.6,527220,2453088.6
230480,202201,154,142,12,172104,14544,186648
230490,202201,324,255,69,309060,83628,392688
230495,202201,476,334,142,406020,172104,578124
230500,202201,1043,779,264,944148,321180,1265328
230510,202201,60,44,16,53328,19392,72720
230520,202201,397,305,92,369660,111504,481164
230523,202201,2459,1514,945,1837392,1146553.2,2983945.2
230526,202201,261,224,37,271488,44844,316332
230530,202201,692,511,181,619332.6,219372,838704.6
230533,202201,221,200,21,242400,25452,267852
230535,202201,373,278,95,336936,115140,452076
230540,202201,1801,1604,197,1944048.6,238764,2182812.6
230550,202201,3953,2506,1447,3038485.24,1753764.6,4792249.84
230560,202201,583,443,140,536916,169680,706596
230565,202201,217,161,56,195132,67872,263004
230570,202201,282,241,41,292092,49692,341784
230580,202201,1202,852,350,1032624,425412,1458036
230590,202201,1017,788,229,955056,277548,1232604
230600,202201,251,226,25,273912,30300,304212
230610,202201,426,318,108,385416.4,130896,516312.4
230620,202201,164,142,22,172104.6,26664,198768.6
230625,202201,822,559,263,678720,319968,998688
230630,202201,1337,1012,325,1226544,395112,1621656
230640,202201,3829,3186,643,3863856.02,779318,4643174.02
230650,202201,496,423,73,513888,88476,602364
230655,202201,701,574,127,696900.4,153924,850824.4
230660,202201,366,301,65,364812,79992,444804
230670,202201,455,370,85,448440,103020,551460
230680,202201,208,184,24,223008,29088,252096
230690,202201,933,782,151,947784,183012,1130796
230700,202201,905,754,151,913848,184224,1098072
230710,202201,675,631,44,764772,53328,818100
230720,202201,147,125,22,151500,26664,178164
230725,202201,244,180,64,219372,77568,296940
230730,202201,12609,6674,5935,8094873.52,7201707.15,15296580.67
230740,202201,675,536,139,649632.6,169680,819312.6
230750,202201,821,688,133,833856.4,161196,995052.4
230760,202201,1457,1254,203,1521060,247248,1768308
230763,202201,334,273,61,330876,73932,404808
230765,202201,8118,3758,4360,4557122.59,5287957.8,9845080.39
230770,202201,4999,2514,2485,3048181.72,3015456.6,6063638.32
230780,202201,767,671,96,813252.6,116352,929604.6
230790,202201,299,248,51,300576,61812,362388
230800,202201,1151,819,332,995052,402384,1397436
230810,202201,1397,1219,178,1477428.4,215736,1693164.4
230820,202201,373,250,123,303000.6,149076,452076.6
230830,202201,952,802,150,972024,181800,1153824
230835,202201,277,235,42,286032,50904,336936
230837,202201,169,139,30,168468,36360,204828
230840,202201,928,712,216,862944.72,261792,1124736.72
230850,202201,1405,1202,203,1456824,246036,1702860
230860,202201,307,227,80,275124,96967,372091
230870,202201,1835,1545,290,1872540,352692,2225232
230880,202201,76,58,18,70296,21816,92112
230890,202201,539,480,59,582972,71508,654480
230900,202201,291,213,78,258156,94536.88,352692.88
230910,202201,222,170,52,206040,63024,269064
230920,202201,479,376,103,455712,124836,580548
230930,202201,1038,722,316,875064,385416,1260480
230940,202201,842,648,194,785376,235128,1020504
230945,202201,522,415,107,502980.4,129684,632664.4
230950,202201,423,364,59,441168,71508,512676
230960,202201,2762,1834,928,2225232.6,1127160.6,3352393.2
230970,202201,1765,976,789,1184124,956268,2140392
230980,202201,204,162,42,196344,50904,247248
230990,202201,138,108,30,130896,36360,167256
231000,202201,204,187,17,226644,20604,247248
231010,202201,160,111,49,134532,59388,193920
231020,202201,1400,957,443,1159884.4,536916,1696800.4
231025,202201,1083,760,323,921120.4,391476,1312596.4
231030,202201,1048,870,178,1054844,215736,1270580
231040,202201,153,103,50,124836,60600,185436
231050,202201,933,811,122,986568.6,149076,1135644.6
231060,202201,161,131,30,158772,36360,195132
231070,202201,1499,1029,470,1247149.25,569640,1816789.25
231080,202201,263,236,27,286032,32724,318756
231085,202201,652,395,257,478740.4,311484,790224.4
231090,202201,259,205,54,249672,65448,315120
231095,202201,162,131,31,158772,37572,196344
231100,202201,164,132,32,159984,38784,198768
231110,202201,372,311,61,376932,73932,450864
231120,202201,272,225,47,272700,56964,329664
231123,202201,158,148,10,179376,12120,191496
231126,202201,322,243,79,294516,95748,390264
231130,202201,4961,3860,1101,4680744.6,1334413.2,6015157.8
231135,202201,212,185,27,224220,32724,256944
231140,202201,3097,2250,847,2729424,1026564,3755988
231150,202201,379,357,22,432684,26664,459348
231160,202201,1217,976,241,1184124,292092,1476216
231170,202201,517,359,158,435108,191496,626604
231180,202201,1760,1518,242,1841028.6,293304,2134332.6
231190,202201,209,170,39,206040,47268,253308
231195,202201,225,188,37,227856,44844,272700
231200,202201,816,658,158,799920.6,191496.4,991417.0
231210,202201,520,438,82,530856,99384,630240
231220,202201,1039,745,294,902941.52,356328,1259269.52
231230,202201,1486,1130,356,1369560,431472,1801032
231240,202201,1512,1032,480,1251996,581760,1833756
231250,202201,98,92,6,111504,7272,118776
231260,202201,257,171,86,207252,104232,311484
231270,202201,997,785,212,951420.84,256944,1208364.84
231280,202201,76,59,17,71508,20604,92112
231290,202201,7904,4405,3499,5343709.4,4244424.1,9588133.5
231300,202201,579,529,50,641148,60600,701748
231310,202201,758,694,64,841128,77568,918696
231320,202201,587,443,144,536916.8,174528,711444.8
231325,202201,103,88,15,106656,18180,124836
231330,202201,1918,1471,447,1782854.28,541764,2324618.28
231335,202201,253,224,29,271488,35148,306636
231340,202201,1770,1251,519,1516212,629028.6,2145240.6
231350,202201,1332,1062,270,1287144.6,328453.8,1615598.4
231355,202201,415,349,66,422988,79992,502980
231360,202201,550,378,172,458137.49,208464,666601.49
231370,202201,94,82,12,99384,14544,113928
231375,202201,293,214,79,260580,95748,356328
231380,202201,484,386,98,469044,118776,587820
231390,202201,206,155,51,187860,61812,249672
231395,202201,770,471,299,570852,362388,933240
231400,202201,1150,955,195,1157460.4,236340.6,1393801.0
231410,202201,1347,1095,252,1328353,305424,1633777
240010,202201,376,163,213,198768.83,258156,456924.83
240020,202201,2203,1791,412,2171906.03,499344,2671250.03
240030,202201,119,98,21,118776,25452,144228
240040,202201,33,32,1,38784,1212,39996
240050,202201,524,445,79,539340,95748,635088
240060,202201,68,64,4,77568,4848,82416
240070,202201,245,187,58,226644,70296,296940
240080,202201,537,355,182,430260,220584.6,650844.6
240090,202201,101,90,11,109080,13332,122412
240100,202201,1472,1384,88,1677408.92,106656,1784064.92
240110,202201,1030,683,347,829009,420564.8,1249573.8
240120,202201,148,111,37,134532,44844,179376
240130,202201,268,249,19,301788.4,23028,324816.4
240140,202201,80,55,25,66660,30300,96960
240145,202201,715,627,88,759924,106656,866580
240150,202201,24,17,7,20604,8484,29088
240160,202201,40,32,8,39996,9696,49692
240165,202201,42,33,9,39996,10908,50904
240170,202201,132,88,44,106656.6,53328,159984.6
240180,202201,101,77,24,93324,29088,122412
240185,202201,48,42,6,50904,7272,58176
240190,202201,14,12,2,14544.6,2424,16968.6
240200,202201,3059,1659,1400,2010708.8,1698013.4,3708722.2
240210,202201,162,123,39,149076,47268,196344
240220,202201,1106,776,330,941724.8,399960,1341684.8
240230,202201,831,758,73,918696.2,88476,1007172.2
240240,202201,67,46,21,55752,25452,81204
240250,202201,92,79,13,95748,15756,111504
240260,202201,1810,1288,522,1562269.2,632664,2194933.2
240270,202201,177,155,22,187860,27876,215736
240280,202201,54,41,13,49692,15756,65448
240290,202201,40,38,2,46056,2424,48480
240300,202201,173,91,82,110292,99384,209676
240310,202201,2421,1294,1127,1569540.44,1367137.16,2936677.60
240320,202201,176,162,14,196344,16968,213312
240325,202201,4689,2715,1974,3296643.43,2394914.12,5691557.55
240330,202201,70,66,4,79992,4848,84840
240340,202201,85,57,28,69084,33936,103020
240350,202201,92,75,17,90900,20604,111504
240360,202201,607,366,241,444804,292092,736896
240370,202201,52,45,7,54540,8484,63024
240375,202201,60,37,23,44844,27876,72720
240380,202201,227,186,41,225432,49692.2,275124.2
240390,202201,14,12,2,14544,2424,16968
240400,202201,86,76,10,92112,12120,104232
240410,202201,12,7,5,8484,6060,14544
240420,202201,1057,769,288,933240.8,349056,1282296.8
240430,202201,262,243,19,294516,23028,317544
240440,202201,122,66,56,79992,67872,147864
240450,202201,239,151,88,183013.2,106656,289669.2
240460,202201,73,58,15,70296,18180,88476
240470,202201,212,190,22,231492,26664,258156
240480,202201,16,14,2,16968,2424,19392
240485,202201,86,69,17,83628,20604,104232
240490,202201,47,43,4,52116,4848,56964
240500,202201,88,66,22,79992,26664,106656
240510,202201,42,30,12,36360,14544,50904
240520,202201,100,95,5,115140,6060,121200
240530,202201,58,48,10,58176,12120,70296
240540,202201,83,70,13,84840,15756,100596
240550,202201,12,10,2,12120,2424,14544
240560,202201,381,271,110,328452,133320,461772
240570,202201,426,267,159,323604,192708,516312
240580,202201,1295,995,300,1208364.4,364812,1573176.4
240590,202201,31,29,2,35148,2424,37572
240600,202201,96,90,6,109080,7272,116352
240610,202201,496,412,84,499344,101808,601152
240615,202201,13,12,1,14544,1212,15756
240620,202201,88,84,4,101808,4848,106656
240630,202201,40,33,7,39996,8484,48480
240640,202201,26,21,5,25452,6060,31512
240650,202201,241,195,46,236340,55752,292092
240660,202201,109,93,16,112716,19392,132108
240670,202201,307,165,142,199980.8,172104,372084.8
240680,202201,54,41,13,49692,15756,65448
240690,202201,47,44,3,53328,3636,56964
240700,202201,179,146,33,176952,39996,216948
240710,202201,2138,1281,857,1553785.2,1038684,2592469.2
240720,202201,1045,747,298,906576,361176.8,1267752.8
240725,202201,62,57,5,69084,6060,75144
240730,202201,151,126,25,152712,30300,183012
240740,202201,231,195,36,236340,43632,279972
240750,202201,53,31,22,37572,26664,64236
240760,202201,52,44,8,53328,9696,63024
240770,202201,140,107,33,129684,39996,169680
240780,202201,701,580,121,702960,146652,849612
240790,202201,42,40,2,48480,2424,50904
240800,202201,9453,6377,3076,7734992.24,3731751.8,11466744.04
240810,202201,21353,11271,10082,13676220.56,12236356.68,25912577.24
240820,202201,247,145,102,175740,123624,299364
240830,202201,1593,1311,282,1590144.8,341784,1931928.8
240840,202201,76,67,9,81204,10908,92112
240850,202201,82,73,9,88476,10908,99384
240860,202201,106,101,5,123624,6060,129684
240870,202201,58,49,9,59388,10908,70296
240880,202201,31,28,3,33936,3636,37572
240890,202201,1135,628,507,761136.6,614484,1375620.6
240895,202201,66,50,16,60600,19392,79992
240910,202201,171,144,27,174528,32724,207252
240920,202201,13,11,2,13332,2424,15756
240930,202201,409,363,46,439956,55752,495708
240933,202201,55,36,19,43632,23028,66660
240940,202201,2301,2025,276,2455513.2,334513.2,2790026.4
240950,202201,45,40,5,48480,6060,54540
240960,202201,24,20,4,24240,4848,29088
240970,202201,111,81,30,98172,36360,134532
240980,202201,200,162,38,196344,46056,242400
240990,202201,134,90,44,109080,53328,162408
241000,202201,59,55,4,66660,4848,71508
241010,202201,75,57,18,69084,21816,90900
241020,202201,106,98,8,118776.6,9696,128472.6
241025,202201,15,7,8,8484,9696,18180
241030,202201,103,83,20,100596,24240,124836
241040,202201,42,30,12,36360,14544,50904
241050,202201,77,69,8,83628,9696,93324
241060,202201,27,22,5,26664,6060,32724
241070,202201,17,16,1,19392,1212,20604
241080,202201,56,49,7,59388,8484,67872
241090,202201,56,42,14,50904,16968,67872
241100,202201,73,62,11,75144,13332,88476
241105,202201,13,5,8,6060,9696,15756
241110,202201,45,39,6,47268,7272,54540
241120,202201,1553,1169,384,1418040,465408,1883448
241140,202201,211,175,36,212100.6,43632,255732.6
241142,202201,46,34,12,41208,14544,55752
241150,202201,1206,1051,155,1275024,187860,1462884
241160,202201,20,15,5,18180,6060,24240
241170,202201,47,40,7,48480,8484,56964
241180,202201,41,30,11,36360,13332,49692
241190,202201,38,36,2,43632,2424,46056
241200,202201,4132,2165,1967,2626405.94,2386428,5012833.94
241210,202201,69,58,11,70296,13332,83628
241220,202201,1452,937,515,1135644.64,625392,1761036.64
241230,202201,250,206,44,249672,53328,303000
241240,202201,56,42,14,50904,16968,67872
241250,202201,1139,1040,99,1261693.2,119988,1381681.2
241255,202201,53,44,9,53328,10908,64236
241260,202201,685,522,163,632664,197556.6,830220.6
241270,202201,65,44,21,53328,25452,78780
241280,202201,97,85,12,103020,14544,117564
241290,202201,123,87,36,105444,43632,149076
241300,202201,82,57,25,69084,30300,99384
241310,202201,45,31,14,37572,16968,54540
241320,202201,27,13,14,15756,16968,32724
241330,202201,58,50,8,60600,9696,70296
241335,202201,79,70,9,84840,10908,95748
241340,202201,184,135,49,163620,59388,223008
241350,202201,60,51,9,61812,10908,72720
241355,202201,47,40,7,48480,8484,56964
241360,202201,50,49,1,59388,1212,60600
241370,202201,59,46,13,55752,15756,71508
241380,202201,35,31,4,37572.6,4848,42420.6
241390,202201,80,61,19,73932,23028,96960
241400,202201,217,164,53,201192,64236,265428
241410,202201,177,161,16,195132,19392,214524
241415,202201,101,81,20,98172,24240,122412
241420,202201,112,79,33,95748,39996,135744
241430,202201,20,18,2,21816,2424,24240
241440,202201,512,426,86,518736.4,104232,622968.4
241445,202201,39,34,5,41208,6060,47268
241450,202201,255,211,44,255732,53328,309060
241460,202201,142,127,15,153924,18180,172104
241470,202201,33,28,5,33936,6060,39996
241475,202201,53,47,6,56964,7272,64236
241480,202201,117,84,33,101808,39996,141804
241490,202201,13,12,1,14544,1212,15756
241500,202201,40,31,9,37572,10908,48480
250010,202201,98,84,14,101808,16968,118776
250020,202201,31,27,4,32724,4848,37572
250030,202201,896,659,237,799920,287245,1087165
250040,202201,389,313,76,380568,92112,472680
250050,202201,261,212,49,256944,60600,317544
250053,202201,62,49,13,59388,15756,75144
250057,202201,1,1,0,1212,,1212.0
250060,202201,601,435,166,527220,201192,728412
250070,202201,682,541,141,655692.88,170892,826584.88
250073,202201,8,8,0,9696,,9696.0
250077,202201,173,128,45,155136,54540,209676
250080,202201,424,336,88,407232.68,106656.8,513889.48
250090,202201,225,144,81,174528,98172,272700
250100,202201,542,448,94,542976,113928.8,656904.8
250110,202201,668,493,175,597516,212100,809616
250115,202201,14,3,11,3636,13332,16968
250120,202201,120,87,33,105444,39996,145440
250130,202201,552,443,109,536916,132108,669024
250135,202201,22,11,11,13332,13332,26664
250140,202201,81,72,9,87264,10908,98172
250150,202201,608,429,179,519948,218160,738108
250153,202201,11,9,2,10908,2424,13332
250157,202201,29,24,5,29088,6060,35148
250160,202201,236,182,54,220584,65448,286032
250170,202201,70,45,25,54540,30300,84840
250180,202201,4619,3151,1468,3822650.08,1781640.4,5604290.48
250190,202201,827,553,274,670236,334512,1004748
250200,202201,60,45,15,54540,18180,72720
250205,202201,23,19,4,23028,4848,27876
250210,202201,88,76,12,92112,14544,106656
250215,202201,70,53,17,64236,20604,84840
250220,202201,27,19,8,23028,9696,32724
250230,202201,77,69,8,83628,9696,93324
250240,202201,236,181,55,219372,66660,286032
250250,202201,367,315,52,381780,63024,444804
250260,202201,44,36,8,43632,9696,53328
250270,202201,76,53,23,64236,27876,92112
250280,202201,373,303,70,367236,86052,453288
250290,202201,91,83,8,100596,9696,110292
250300,202201,568,380,188,460560,227856,688416
250310,202201,46,42,4,50904,4848,55752
250320,202201,1998,1320,678,1602264.76,824160.6,2426425.36
250330,202201,109,93,16,112716,19392,132108
250340,202201,29,24,5,29088,6060,35148
250350,202201,190,124,66,150288,79992,230280
250355,202201,32,24,8,29088,9696,38784
250360,202201,189,156,33,189072,39996,229068
250370,202201,2375,1529,846,1854360.6,1025352,2879712.6
250375,202201,14,8,6,9696,7272,16968
250380,202201,55,45,10,54540,12120,66660
250390,202201,45,34,11,41208,13332,54540
250400,202201,16597,8294,8303,10058371.45,10075358.44,20133729.89
250403,202201,322,255,67,309060,81204,390264
250407,202201,66,53,13,64236,15756,79992
250410,202201,29,25,4,30300,4848,35148
250415,202201,44,28,16,33936,19392,53328
250420,202201,36,30,6,36360,7272,43632
250430,202201,1428,1229,199,1489851,242400,1732251
250435,202201,26,19,7,23028,8484,31512
250440,202201,678,561,117,679932.4,141804,821736.4
250450,202201,80,61,19,73932,23028,96960
250460,202201,471,305,166,369660,201192,570852
250470,202201,95,65,30,78780,36360,115140
250480,202201,331,262,69,317544,83628,401172
250485,202201,5,5,0,6060,,6060.0
250490,202201,233,191,42,231492,52116,283608
250500,202201,94,72,22,87264,26664,113928
250510,202201,792,621,171,753864,207252,961116
250520,202201,169,111,58,134532,70296,204828
250523,202201,119,98,21,118776,25452,144228
250527,202201,116,87,29,105444,35148,140592
250530,202201,6,3,3,3636,3636,7272
250535,202201,29,21,8,25452,9696,35148
250540,202201,137,108,29,130896,35148,166044
250550,202201,66,64,2,77568,2424,79992
250560,202201,59,38,21,46056,25452,71508
250570,202201,156,127,29,153924,35148,189072
250580,202201,98,74,24,89766,29088,118854
250590,202201,22,12,10,14544,12120,26664
250600,202201,1477,965,512,1172005.12,621756,1793761.12
250610,202201,155,127,28,153924,33936,187860
250620,202201,20,16,4,20604,4848,25452
250625,202201,72,54,18,65448,21816,87264
250630,202201,3106,1962,1144,2379156.57,1390164,3769320.57
250640,202201,194,154,40,186648,48480,235128
250650,202201,28,20,8,24240,9696,33936
250660,202201,59,43,16,52116,19392,71508
250670,202201,64,48,16,58176,19392,77568
250680,202201,414,330,84,399960,101808,501768
250690,202201,2119,1458,661,1767096.92,801132,2568228.92
250700,202201,919,780,139,945360.4,168468,1113828.4
250710,202201,446,353,93,427836,113928,541764
250720,202201,119,87,32,105444,38784,144228
250730,202201,413,345,68,418140,82416,500556
250740,202201,64,61,3,73932,3636,77568
250750,202201,23552,13952,9600,16925460.29,11657017.8,28582478.09
250760,202201,107,86,21,104232,25452,129684
250770,202201,362,232,130,282396.36,157560,439956.36
250780,202201,69,45,24,54540,30300,84840
250790,202201,456,289,167,351480,203616,555096
250800,202201,151,134,17,162408,20604,183012
250810,202201,77,62,15,75144,18180,93324
250820,202201,148,125,23,151500,27876,179376
250830,202201,451,294,157,356328.6,190284,546612.6
250840,202201,58,52,6,63024,7272,70296
250850,202201,57,48,9,58176,10908,69084
250855,202201,16,14,2,16968,2424,19392
250860,202201,239,155,84,189072,101808,290880
250870,202201,30,27,3,32724,3636,36360
250880,202201,87,66,21,79992,25452,105444
250890,202201,3074,2280,794,2764572,962328,3726900
250900,202201,58,48,10,58176,12120,70296
250905,202201,123,93,30,112716,36360,149076
250910,202201,1025,754,271,913848,328452,1242300
250915,202201,109,76,33,92112,39996,132108
250920,202201,136,98,38,118776,46056,164832
250930,202201,183,107,76,129684,92112,221796
250933,202201,8,5,3,6060,3636,9696
250937,202201,16,16,0,19392,,19392.0
250939,202201,31,25,6,30300,7272,37572
250940,202201,118,86,32,105444,38784,144228
250950,202201,73,51,22,61812,26664,88476
250960,202201,91,49,42,59388,50904,110292
250970,202201,1243,872,371,1056864,449652,1506516
250980,202201,99,67,32,81204,38784,119988
250990,202201,168,129,39,156348,47268,203616
251000,202201,78,68,10,82416,12120,94536
251010,202201,122,92,30,111504,36360,147864
251020,202201,76,62,14,75144,16968,92112
251030,202201,47,34,13,41208,15756,56964
251040,202201,56,38,18,46056,21816,67872
251050,202201,26,22,4,26664,4848,31512
251060,202201,49,39,10,47268,12120,59388
251065,202201,7,4,3,4848,3636,8484
251070,202201,18,14,4,16968,4848,21816
251080,202201,5248,2450,2798,2970612.8,3391176.88,6361789.68
251090,202201,189,159,30,192708,36360,229068
251100,202201,20,19,1,23028,1212,24240
251110,202201,55,37,18,44844,21816,66660
251120,202201,1932,1183,749,1433797.4,907788.92,2341586.32
251130,202201,428,354,74,429048,90900,519948
251140,202201,581,368,213,446016.4,258156,704172.4
251150,202201,345,285,60,345420,72720,418140
251160,202201,95,76,19,92112,23028,115140
251170,202201,93,75,18,90900,21816,112716
251180,202201,287,168,119,204828,144228,349056
251190,202201,196,128,68,155136,82416,237552
251200,202201,276,217,59,263004,71508,334512
251203,202201,36,33,3,39996,3636,43632
251207,202201,85,71,14,86052,16968,103020
251210,202201,1489,1084,405,1315020,490860,1805880
251220,202201,43,33,10,39996,12120,52116
251230,202201,572,473,99,576912,121200,698112
251240,202201,108,76,32,92112,38784,130896
251250,202201,1443,1026,417,1244625.21,505404.8,1750030.01
251260,202201,12,8,4,9696,4848,14544
251270,202201,300,237,63,287244,76356,363600
251272,202201,66,58,8,70296,9696,79992
251274,202201,27,21,6,25452,7272,32724
251275,202201,34,20,14,24240,16968,41208
251276,202201,26,20,6,24240,7272,31512
251278,202201,11,9,2,10908,2424,13332
251280,202201,100,95,5,115140,6060,121200
251290,202201,962,685,277,831432,335724,1167156
251300,202201,16,11,5,13332,6060,19392
251310,202201,300,216,84,261792,101808,363600
251315,202201,39,35,4,42420,4848,47268
251320,202201,73,56,17,67872,20604,88476
251330,202201,83,72,11,87264,13332,100596
251335,202201,23,9,14,10908,16968,27876
251340,202201,778,449,329,544188,398748,942936
251350,202201,35,34,1,41208,1212,42420
251360,202201,84,73,11,88476,13332,101808
251365,202201,6,6,0,7272,,7272.0
251370,202201,5766,3907,1859,4738920.09,2260380.4,6999300.49
251380,202201,48,37,11,44844,13332,58176
251385,202201,2,2,0,2424,,2424.0
251390,202201,907,668,239,810828,289668.6,1100496.6
251392,202201,26,16,10,19392,12120,31512
251394,202201,9,9,0,10908,,10908.0
251396,202201,14,9,5,10908,6060,16968
251398,202201,16,13,3,15756,3636,19392
251400,202201,48,38,10,47268,12120,59388
251410,202201,39,33,6,41208,7272,48480
251420,202201,104,77,27,93324,32724,126048
251430,202201,46,41,5,50904,6060,56964
251440,202201,47,24,23,30300,27876,58176
251445,202201,64,52,12,63024,14544,77568
251450,202201,389,337,52,408444.8,63024,471468.8
251455,202201,5,4,1,6060,1212,7272
251460,202201,20,17,3,20604,3636,24240
251465,202201,7,5,2,6060,2424,8484
251470,202201,54,40,14,48480,16968,65448
251480,202201,30,25,5,30300,6060,36360
251490,202201,109,67,42,81204,50904.6,132108.6
251500,202201,119,99,20,119988,24240,144228
251510,202201,77,49,28,59388,33936,93324
251520,202201,35,30,5,36360,6060,42420
251530,202201,4309,3031,1278,3677208.6,1550148.6,5227357.2
251540,202201,82,67,15,81204,18180,99384
251550,202201,410,311,99,376932.6,119988,496920.6
251560,202201,25,17,8,20604,9696,30300
251570,202201,17,15,2,18180,2424,20604
251580,202201,135,107,28,129684,33936,163620
251590,202201,110,75,35,91129.06,42420,133549.06
251593,202201,24,15,9,18180,10908,29088
251597,202201,101,77,24,93324,29088,122412
251600,202201,1090,756,334,916568.6,404808.4,1321377.0
251610,202201,234,172,62,208464,75144,283608
251615,202201,14,13,1,15756,1212,16968
251620,202201,4179,2670,1509,3237253.36,1830121.4,5067374.76
251630,202201,460,338,122,409656,147864,557520
251640,202201,126,92,34,111504,41208,152712
251650,202201,282,207,75,250884.8,90900,341784.8
251660,202201,198,175,23,212100,27876,239976
251670,202201,384,296,88,358752,106656,465408
251675,202201,10,8,2,9696,2424,12120
251680,202201,101,88,13,106656,15756,122412
251690,202201,320,263,57,318756,69084,387840
251700,202201,278,240,38,290880.64,46056,336936.64
251710,202201,20,12,8,14544,9696,24240
251720,202201,24,16,8,19392,9696,29088
251740,202201,13,10,3,12120,3636,15756
260005,202201,3475,1838,1637,2228356.91,1985256.8,4213613.71
260010,202201,1656,1223,433,1482276.14,524796,2007072.14
260020,202201,406,351,55,426624,66660,493284
260030,202201,590,397,193,481164,233916,715080
260040,202201,803,492,311,596304,376932,973236
260050,202201,1160,822,338,997476,409657.2,1407133.2
260060,202201,369,338,31,409656,37572,447228
260070,202201,1314,796,518,965964.2,629028,1594992.2
260080,202201,714,542,172,656904,209676,866580
260090,202201,485,313,172,379356.6,208464,587820.6
260100,202201,211,146,65,176952,78780,255732
260105,202201,251,141,110,172104,133320,305424
260110,202201,2925,2129,796,2583984.6,964752.6,3548737.2
260120,202201,2707,1448,1259,1756511.67,1525908.8,3282420.47
260130,202201,179,119,60,144228,72720,216948
260140,202201,2189,1421,768,1722253.36,932028,2654281.36
260150,202201,194,124,70,150288,84840,235128
260160,202201,343,280,63,339360,76356,415716
260170,202201,3324,1974,1350,2394912.72,1636201.2,4031113.92
260180,202201,178,143,35,173316,42420,215736
260190,202201,2349,1549,800,1878600,969600,2848200
260200,202201,968,758,210,918696.95,254520.6,1173217.55
260210,202201,1383,971,412,1178064.2,499344,1677408.2
260220,202201,653,588,65,712656,78780,791436
260230,202201,1228,909,319,1101708,386628,1488336
260240,202201,203,151,52,183012,63024,246036
260250,202201,87,64,23,77568,27876,105444
260260,202201,1057,726,331,879912.11,401172,1281084.11
260270,202201,259,187,72,226644,87264,313908
260280,202201,1156,919,237,1113828,287244.6,1401072.6
260290,202201,6781,3654,3127,4429862.4,3793562.16,8223424.56
260300,202201,977,826,151,1002324.8,183012,1185336.8
260310,202201,514,414,100,501768,121200,622968
260320,202201,828,598,230,724776,278760,1003536
260330,202201,72,53,19,64236,23028,87264
260340,202201,76,56,20,67872,24240,92112
260345,202201,5589,2920,2669,3539041,3236040,6775081
260350,202201,481,339,142,410868,172104.6,582972.6
260360,202201,246,136,110,164832.46,133320,298152.46
260370,202201,750,468,282,567216,341784,909000
260380,202201,561,401,160,487224,193920.19,681144.19
260390,202201,293,248,45,301788,54540,356328
260392,202201,113,96,17,116352,20604,136956
260400,202201,4348,2474,1874,3002125.26,2273712,5275837.26
260410,202201,14932,7708,7224,9348159.83,8763972.6,18112132.43
260415,202201,143,121,22,146652,26664,173316
260420,202201,1742,1063,679,1288356.32,822948,2111304.32
260430,202201,171,155,16,187860.24,19392,207252.24
260440,202201,188,129,59,156348,71508,227856
260450,202201,424,317,107,384204.95,130896,515100.95
260460,202201,821,427,394,518737,477528,996265
260470,202201,331,201,130,243612,157560.2,401172.2
260480,202201,253,157,96,190284,116352,306636
260490,202201,217,171,46,207252,55752,263004
260500,202201,1119,748,371,906576.6,450864,1357440.6
260510,202201,786,622,164,753864,199980,953844
260515,202201,230,207,23,250884,27876,278760
260520,202201,3235,1994,1241,2416728.6,1506516.92,3923245.52
260530,202201,805,652,153,790224,185436,975660
260540,202201,528,416,112,504192,136956,641148
260545,202201,17,11,6,13332,7272,20604
260550,202201,325,206,119,249672,144228,393900
260560,202201,505,382,123,462984.2,149076,612060.2
260570,202201,996,790,206,957480,249672,1207152
260580,202201,296,250,46,303000,55752,358752
260590,202201,619,353,266,427836,322392,750228
260600,202201,7690,4408,3282,5343711.1,3982632.6,9326343.7
260610,202201,489,323,166,391476,201192,592668
260620,202201,3668,1879,1789,2277348.8,2169481.19,4446829.99
260630,202201,81,74,7,89688,8484,98172
260640,202201,3374,1938,1436,2350070.08,1744068,4094138.08
260650,202201,316,226,90,273912,109080,382992
260660,202201,571,360,211,436320,255732,692052
260670,202201,104,74,30,89688,36360,126048
260680,202201,3949,2150,1799,2607012,2182813.8,4789825.8
260690,202201,124,93,31,112716,37572,150288
260700,202201,306,205,101,248460,122412,370872
260710,202201,47,37,10,44844,12120,56964
260720,202201,2646,1553,1093,1883450.4,1325928.6,3209379.0
260730,202201,742,544,198,660540,239976,900516
260740,202201,74,60,14,72720,16968,89688
260750,202201,565,411,154,498132,187860,685992
260760,202201,700,344,356,416928.79,431472,848400.79
260765,202201,969,494,475,598728,575700,1174428
260770,202201,217,158,59,191475,71508,262983
260775,202201,777,417,360,505405.4,436320,941725.4
260780,202201,236,145,91,175740,110292,286032
260790,202201,15076,7413,7663,8993044.04,9300889.8,18293933.84
260795,202201,162,105,57,127260,69084,196344
260800,202201,285,230,55,278760,66660,345420
260805,202201,171,113,58,136956,70296,207252
260810,202201,809,661,148,801132,179376,980508
260820,202201,294,186,108,225432.96,130896,356328.96
260825,202201,207,138,69,167256,83628,250884
260830,202201,295,184,111,223008,134532,357540
260840,202201,257,185,72,224220,87264,311484
260845,202201,171,109,62,132108,75144,207252
260850,202201,407,303,104,367236,126048,493284
260860,202201,252,187,65,226644,78780,305424
260870,202201,347,265,82,321180,99384,420564
260875,202201,739,537,202,650844,244824,895668
260880,202201,1543,1010,533,1224120.8,645996,1870116.8
260890,202201,2367,1634,733,1981620,888396.4,2870016.4
260900,202201,992,706,286,855672,346632,1202304
260910,202201,249,195,54,236340,65448,301788
260915,202201,276,204,72,247248,87264,334512
260920,202201,197,102,95,123624,115140,238764
260930,202201,366,306,60,370872,72720,443592
260940,202201,2581,1371,1210,1661653.44,1468944,3130597.44
260950,202201,1990,1119,871,1356228.8,1056864,2413092.8
260960,202201,13618,6643,6975,8054960.7,8469458.7,16524419.4
260970,202201,419,343,76,416928,92112,509040
260980,202201,201,180,21,218160,25452,243612
260990,202201,2655,2116,539,2567017.36,653268,3220285.36
261000,202201,4210,2557,1653,3099085.2,2004648.4,5103733.6
261010,202201,154,110,44,133320,53328,186648
261020,202201,584,434,150,526008.8,181800,707808.8
261030,202201,252,185,67,224220,82416,306636
261040,202201,376,320,56,387840,67872,455712
261050,202201,500,424,76,513888,92112,606000
261060,202201,1442,886,556,1073832,673872,1747704
261070,202201,9227,4389,4838,5319474.24,5868507.7,11187981.94
261080,202201,369,281,88,340572,106656,447228
261090,202201,2127,1631,496,1976773.99,601152,2577925.99
261100,202201,1216,848,368,1028989,446016,1475005
261110,202201,9050,5543,3507,6724178.54,4254120,10978298.54
261120,202201,239,204,35,247248,42420,289668
261130,202201,566,331,235,401172.4,284820.28,685992.68
261140,202201,218,135,83,163620,100596,264216
261150,202201,678,432,246,523584.03,298152,821736.03
261153,202201,70,65,5,78780,6060,84840
261160,202201,74831,36489,38342,44258737.38,46532326.16,90791063.54
261170,202201,468,343,125,416928,151500,568428
261180,202201,1779,1107,672,1341961,815676,2157637
261190,202201,568,392,176,476316.64,213312,689628.64
261200,202201,221,179,42,216948,50904,267852
261210,202201,41,31,10,37572,12120,49692
261220,202201,2719,1894,825,2296741.6,999900,3296641.6
261230,202201,339,248,91,300576,110292,410868
261240,202201,442,383,59,464196,71508,535704
261245,202201,247,203,44,246036,53328,299364
261247,202201,169,130,39,157560,47268,204828
261250,202201,3457,1631,1826,1979196.6,2214324,4193520.6
261255,202201,248,221,27,269064,32724,301788
261260,202201,832,716,116,869004.07,140592,1009596.07
261270,202201,197,135,62,163620,75144,238764
261280,202201,190,153,37,185436,44844,230280
261290,202201,110,81,29,98172,35148,133320
261300,202201,1326,973,353,1180488,427836,1608324
261310,202201,783,523,260,636300,316332,952632
261320,202201,561,380,181,460560,219372,679932
261330,202201,905,703,202,852036,244825.55,1096861.55
261340,202201,309,169,140,204828,170892,375720
261350,202201,864,601,263,728412.6,319968,1048380.6
261360,202201,1370,869,501,1055652,607212,1662864
261370,202201,4838,2823,2015,3421477.4,2444604,5866081.4
261380,202201,546,418,128,509041.56,155136.6,664178.16
261390,202201,3646,2455,1191,2975461.2,1443492.8,4418954.0
261400,202201,273,247,26,299364,31512,330876
261410,202201,1112,725,387,878700,469044,1347744
261420,202201,953,587,366,711444.93,444804,1156248.93
261430,202201,319,290,29,351480,35148,386628
261440,202201,105,100,5,121200,6060,127260
261450,202201,2496,1966,530,2384005.8,642360,3026365.8
261460,202201,758,593,165,718716,199980.6,918696.6
261470,202201,224,181,43,219372.4,52116,271488.4
261480,202201,454,348,106,421776.8,128417.46,550194.26
261485,202201,369,224,145,271488.2,175740,447228.2
261500,202201,612,408,204,494496.4,247248,741744.4
261510,202201,51,32,19,38784,23028,61812
261520,202201,88,71,17,86052,20604,106656
261530,202201,4026,2537,1489,3074845.7,1807092,4881937.7
261540,202201,1446,830,616,1005960.6,746592.6,1752553.2
261550,202201,253,121,132,146652,159984,306636
261560,202201,916,597,319,723565.4,386628.6,1110194.0
261570,202201,395,310,85,375720,103020,478740
261580,202201,389,307,82,372084,99384,471468
261590,202201,191,156,35,189072,42420,231492
261600,202201,291,228,63,276336,76356,352692
261610,202201,85,72,13,87264,15756,103020
261618,202201,72,54,18,66660,21816,88476
261620,202201,196,123,73,149076,88476,237552
261630,202201,666,525,141,637512,170892,808404
261640,202201,6496,3378,3118,4097774.82,3782652,7880426.82
261650,202201,467,301,166,364812,202404,567216
270010,202201,508,450,58,545400,70296,615696
270020,202201,243,198,45,239976,54540,294516
270030,202201,8756,5599,3157,6788413.71,3826231.8,10614645.51
270040,202201,2056,1333,723,1616808,877488.6,2494296.6
270050,202201,201,156,45,189072,54540,243612
270060,202201,73,48,25,58176,30300,88476
270070,202201,833,609,224,738310,271488,1009798
270080,202201,40,32,8,38784,9696,48480
270090,202201,20,16,4,19392,4848,24240
270100,202201,1308,891,417,1081104.6,505404,1586508.6
270110,202201,74,63,11,76356,13332,89688
270120,202201,233,188,45,227856,54540,282396
270130,202201,318,234,84,284820,101808,386628
270135,202201,119,81,38,98172.4,46056,144228.4
270140,202201,1364,886,478,1074074.4,579336,1653410.4
270150,202201,253,194,59,235128,71508,306636
270160,202201,487,385,102,467832,123624,591456
270170,202201,789,516,273,625392,332088,957480
270180,202201,56,45,11,54540,13332,67872
270190,202201,113,95,18,115140,21816,136956
270200,202201,113,100,13,121200,15756,136956
270210,202201,537,328,209,397536,253308,650844
270220,202201,188,143,45,173316,54540,227856
270230,202201,2165,1351,814,1638626.56,986568,2625194.56
270235,202201,654,507,147,615696,178164,793860
270240,202201,2966,2352,614,2851837.32,744169,3596006.32
270250,202201,124,90,34,109080,41208,150288
270255,202201,208,177,31,214524,37572,252096
270260,202201,360,290,70,351480,86052,437532
270270,202201,96,52,44,63024,53328,116352
270280,202201,225,137,88,166044,106656,272700
270290,202201,1106,866,240,1050804,290880,1341684
270300,202201,358,262,96,318756,116352,435108
270310,202201,808,674,134,816888,162408,979296
270320,202201,788,680,108,825372,133320,958692
270330,202201,299,253,46,309060,55752,364812
270340,202201,60,49,11,59388,13332,72720
270350,202201,90,54,36,65448,43632,109080
270360,202201,68,38,30,46056,36360,82416
270370,202201,59,46,13,55752,15756,71508
270375,202201,74,44,30,54540,36360,90900
270380,202201,1057,705,352,856884,426624,1283508
270390,202201,151,85,66,103020,79992,183012
270400,202201,730,554,176,673872.54,213312,887184.54
270410,202201,619,457,162,553884,196344,750228
270420,202201,401,281,120,340572,145440,486012
270430,202201,34211,24487,9724,29690335.7,11800037.8,41490373.5
270440,202201,475,378,97,459348,117564,576912
270450,202201,837,497,340,602364,412080,1014444
270460,202201,178,143,35,173316,42420,215736
270470,202201,1558,1080,478,1313364.2,579336,1892700.2
270480,202201,533,434,99,526008.6,119988,645996.6
270490,202201,21,16,5,19392,6060,25452
270500,202201,477,398,79,482376,95748,578124
270510,202201,853,545,308,660540,374508,1035048
270520,202201,270,176,94,213312,113928,327240
270530,202201,61,52,9,63024,10908,73932
270540,202201,92,67,25,81204,30300,111504
270550,202201,1697,1313,384,1591356,465408,2056764
270560,202201,260,154,106,186648,128472,315120
270570,202201,550,386,164,467832,198768,666600
270580,202201,79,62,17,75144,20604,95748
270590,202201,59,46,13,55752,15756,71508
270600,202201,154,132,22,159984,26664,186648
270610,202201,238,189,49,229068,59388,288456
270620,202201,15,15,0,18180,,18180.0
270630,202201,3676,2793,883,3388753.2,1072620,4461373.2
270640,202201,853,640,213,775680.48,258156,1033836.48
270642,202201,212,178,34,216948,41208,258156
270644,202201,255,173,82,209676,99384,309060
270650,202201,332,197,135,239976,163620,403596
270660,202201,198,174,24,210888,29088,239976
270670,202201,2933,2240,693,2714882.9,841128,3556010.9
270680,202201,400,250,150,303000,183012,486012
270690,202201,1221,814,407,987781.12,493284,1481065.12
270700,202201,25,20,5,24240,6060,30300
270710,202201,863,682,181,826584,219372,1045956
270720,202201,227,179,48,216948,58176,275124
270730,202201,1874,1162,712,1410768.2,862944.4,2273712.6
270740,202201,37,24,13,29088,15756,44844
270750,202201,628,478,150,579336,181800,761136
270760,202201,299,214,85,259368,103020,362388
270770,202201,2785,1883,902,2283410.72,1094436,3377846.72
270780,202201,65,42,23,50904,27876,78780
270790,202201,231,150,81,181800,98172,279972
270800,202201,2038,1629,409,1975560.8,495708,2471268.8
270810,202201,219,182,37,221796,44844,266640
270820,202201,124,87,37,105444,44844,150288
270830,202201,816,623,193,755076,233916,988992
270840,202201,1336,1025,311,1242300.88,376932.56,1619233.44
270850,202201,1504,974,530,1180488.4,642360,1822848.4
270860,202201,2543,1714,829,2078580.72,1005960,3084540.72
270870,202201,114,64,50,77568,60600,138168
270880,202201,854,679,175,825372.4,212100,1037472.4
270890,202201,264,200,64,242400,77568,319968
270895,202201,58,56,2,67872,2424,70296
270900,202201,64,54,10,65448,12120,77568
270910,202201,299,247,52,299364,63024,362388
270915,202201,1909,1250,659,1515000.2,799920.36,2314920.56
270920,202201,433,361,72,438744,87264,526008
270930,202201,5778,4416,1362,5354616.4,1651956.64,7006573.04
270940,202201,2202,1740,462,2108880.6,559944,2668824.6
280010,202201,37,31,6,37572,7272,44844
280020,202201,483,415,68,502980.72,82416,585396.72
280030,202201,21091,13634,7457,16532922.45,9048797.04,25581719.49
280040,202201,322,208,114,252096,138168,390264
280050,202201,415,319,96,386628,116352,502980
280060,202201,361,237,124,287244.6,150288,437532.6
280067,202201,1119,804,315,974448,381780,1356228
280070,202201,131,108,23,130896,27876,158772
280100,202201,653,505,148,612060,179376.4,791436.4
280110,202201,73,67,6,81204,7272,88476
280120,202201,666,557,109,675084,132108,807192
280130,202201,1740,1138,602,1379256,729624.2,2108880.2
280140,202201,491,411,80,499344.6,96960,596304.6
280150,202201,415,292,123,353904,149076,502980
280160,202201,131,104,27,127260,32724,159984
280170,202201,420,290,130,351480,157560,509040
280190,202201,28,23,5,27876,6060,33936
280200,202201,38,31,7,37572,8484,46056
280210,202201,2928,2097,831,2542683.92,1007172,3549855.92
280220,202201,49,40,9,48480,10908,59388
280230,202201,332,268,64,326028,77568,403596
280240,202201,132,124,8,150288,9696,159984
280250,202201,18,10,8,12120,9696,21816
280260,202201,79,72,7,87264,8484,95748
280270,202201,141,109,32,132108,38784,170892
280280,202201,190,122,68,147864.9,83628,231492.9
280290,202201,3508,2534,974,3071131.24,1180488.16,4251619.40
280300,202201,1600,1270,330,1541664.02,399960,1941624.02
280310,202201,93,88,5,106656,6060,112716
280320,202201,648,456,192,552672,232704,785376
280330,202201,315,235,80,284820,98172,382992
280340,202201,424,359,65,435108,78780,513888
280350,202201,3723,2850,873,3455416.15,1059288.8,4514704.95
280360,202201,463,313,150,380568,181800,562368
280370,202201,95,82,13,99384.04,15756,115140.04
280380,202201,51,39,12,47268,14544,61812
280390,202201,175,148,27,179376,33936,213312
280400,202201,377,256,121,311484.2,146652,458136.2
280410,202201,287,237,50,287244.4,60600,347844.4
280420,202201,134,114,20,138168,24240,162408
280430,202201,86,69,17,83628,20604,104232
280440,202201,719,587,132,715081.24,159984,875065.24
280445,202201,121,114,7,138168,8484,146652
280450,202201,1248,1076,172,1304112,208464,1512576
280460,202201,648,470,178,570853.11,215736,786589.11
280470,202201,102,92,10,113928,12120,126048
280480,202201,2908,1977,931,2396126.59,1130796.22,3526922.81
280490,202201,198,187,11,227856.91,13332,241188.91
280500,202201,42,39,3,47268,3636,50904
280510,202201,134,107,27,130896,32724.6,163620.6
280520,202201,51,37,14,44844,16968,61812
280530,202201,70,48,22,58176,26664,84840
280540,202201,536,458,78,555096,94536,649632
280550,202201,738,678,60,821737.45,72720,894457.45
280560,202201,480,428,52,519948.44,63024,582972.44
280570,202201,2315,1826,489,2215537.72,592668.6,2808206.32
280580,202201,579,451,128,546613,155136,701749
280590,202201,218,138,80,167256,96960,264216
280600,202201,398,328,70,397592.96,84840,482432.96
280610,202201,108,79,29,95748,35148,130896
280620,202201,538,438,100,530856.16,121200,652056.16
280630,202201,150,123,27,149076,32724,181800
280640,202201,183,148,35,179376,42420,221796
280650,202201,88,55,33,67872,39996,107868
280660,202201,137,101,36,122412,43632,166044
280670,202201,1947,1232,715,1493187.2,866581.36,2359768.56
280680,202201,233,201,32,243612,38784,282396
280690,202201,79,69,10,83628,12120,95748
280700,202201,19,19,0,23028,,23028.0
280710,202201,1495,1156,339,1403497.28,410868,1814365.28
280720,202201,122,82,40,99384,48480,147864
280730,202201,29,25,4,30300,4848,35148
280740,202201,2547,1909,638,2313708,774468,3088176
280750,202201,225,195,30,236340,36360,272700
280760,202201,857,582,275,705384.44,333300,1038684.44
290010,202201,195,138,57,167256,69084,236340
290020,202201,188,171,17,207252,21816,229068
290030,202201,624,400,224,484800,271488,756288
290035,202201,132,108,24,130896,29088,159984
290040,202201,296,202,94,244824,113928,358752
290050,202201,88,72,16,87264,19392,106656
290060,202201,255,114,141,138168,172104,310272
290070,202201,5772,2751,3021,3336637.89,3666302.2,7002940.09
290080,202201,448,194,254,235128,307848,542976
290090,202201,363,164,199,198768,241188,439956
290100,202201,1674,1065,609,1290780.8,738108,2028888.8
290110,202201,856,493,363,597516.4,439956,1037472.4
290115,202201,194,177,17,214524,20604,235128
290120,202201,781,522,259,632664,315120,947784
290130,202201,443,271,172,328452,208464,536916
290135,202201,296,228,68,276336,82416,358752
290140,202201,317,262,55,318756,66660,385416
290150,202201,133,90,43,109080,52116,161196
290160,202201,246,189,57,229068.48,69084,298152.48
290170,202201,94,66,28,79992,33936,113928
290180,202201,190,138,52,167256.4,63024,230280.4
290190,202201,368,288,80,349056,96960,446016
290195,202201,297,193,104,233916,127260,361176
290200,202201,260,213,47,258156,56964,315120
290205,202201,145,91,54,110292.6,65448,175740.6
290210,202201,1187,870,317,1054440.6,385416,1439856.6
290220,202201,186,104,82,126048,99384,225432
290225,202201,300,120,180,145440,218160,363600
290230,202201,77,47,30,56964,36360,93324
290240,202201,356,122,234,147864,284820,432684
290250,202201,247,229,18,277548,21816,299364
290260,202201,325,261,64,316332.6,77568,393900.6
290265,202201,183,160,23,193920,27876,221796
290270,202201,1387,1153,234,1397436.6,286032.6,1683469.2
290280,202201,473,330,143,399960,173316,573276
290290,202201,1357,811,546,982932.66,661752.6,1644685.26
290300,202201,401,343,58,416928.6,71508,488436.6
290310,202201,285,136,149,164832,180588,345420
290320,202201,4139,2518,1621,3055452.84,1965864.4,5021317.24
290323,202201,194,170,24,206040,29088,235128
290327,202201,156,121,35,146652,42420,189072
290330,202201,119,57,62,69084,75144,144228
290340,202201,777,319,458,386628,555096,941724
290350,202201,660,405,255,492072,309060.6,801132.6
290360,202201,320,247,73,299365.61,88476,387841.61
290370,202201,903,396,507,482376.2,614484,1096860.2
290380,202201,327,208,119,252096,144228,396324
290390,202201,2421,1501,920,1820425.6,1116252,2936677.6
290395,202201,236,133,103,161196,124836,286032
290400,202201,279,201,78,244824,94536,339360
290405,202201,241,205,36,248460,43632,292092
290410,202201,622,515,107,624180,129684,753864
290420,202201,269,217,52,263004,63024,326028
290430,202201,473,298,175,361176,212100,573276
290440,202201,79,70,9,84840,10908,95748
290450,202201,190,143,47,173316,56964,230280
290460,202201,1934,1149,785,1393800,953844,2347644
290470,202201,1366,594,772,719928,935665.2,1655593.2
290475,202201,556,518,38,627816,46056,673872
290480,202201,277,161,116,195132,140592,335724
290485,202201,235,216,19,261792,23028,284820
290490,202201,1239,877,362,1066560,438744,1505304
290500,202201,762,398,364,482376,441168,923544
290510,202201,203,162,41,196344,49692,246036
290515,202201,163,98,65,118776,78780,197556
290520,202201,1385,903,482,1094436.6,586608.98,1681045.58
290530,202201,287,260,27,315120,32724,347844
290540,202201,113,57,56,69084,67872,136956
290550,202201,163,138,25,167256,30300,197556
290560,202201,3173,1391,1782,1687104,2160996,3848100
290570,202201,6370,3061,3309,3712357.24,4015358,7727715.24
290580,202201,1263,756,507,917484,615696,1533180
290590,202201,566,454,112,550248,135744,685992
290600,202201,1753,1201,552,1456824,670236,2127060
290610,202201,179,164,15,198768,18180,216948
290620,202201,366,332,34,402384,41208,443592
290630,202201,1963,840,1123,1019292.2,1363500.6,2382792.8
290640,202201,142,113,29,138168,35148,173316
290650,202201,1824,843,981,1022928.76,1190184,2213112.76
290660,202201,263,219,44,265428,53328,318756
290670,202201,954,484,470,586608.6,569640,1156248.6
290680,202201,1232,984,248,1198668,303000,1501668
290682,202201,311,229,82,277548.36,99384,376932.36
290685,202201,243,154,89,186648,107868,294516
290687,202201,1121,728,393,882533.16,476316,1358849.16
290689,202201,148,77,71,93324,86052,179376
290690,202201,586,252,334,305424,404808.6,710232.6
290700,202201,238,121,117,146652,141804,288456
290710,202201,756,510,246,618120,298152,916272
290720,202201,1035,825,210,999900.6,254520,1254420.6
290730,202201,1205,703,502,852036.2,610848,1462884.2
290740,202201,22,18,4,21816,4848,26664
290750,202201,1427,613,814,742956,986569.2,1729525.2
290755,202201,71,63,8,76356,9696,86052
290760,202201,258,228,30,277548,36360,313908
290770,202201,183,173,10,209676,12120,221796
290780,202201,1111,873,238,1058076.6,288456,1346532.6
290790,202201,377,256,121,310272,146652.6,456924.6
290800,202201,2411,964,1447,1169580,1756188,2925768
290810,202201,475,324,151,392688,183012,575700
290820,202201,401,234,167,283608,202404,486012
290830,202201,429,307,122,372084,147864,519948
290840,202201,1792,1113,679,1350169.32,822948.6,2173117.92
290850,202201,927,467,460,566004,557520,1123524
290860,202201,639,289,350,350268.4,424200,774468.4
290870,202201,607,423,184,512676.56,223008.96,735685.52
290880,202201,117,63,54,76356,65448,141804
290890,202201,436,266,170,322392,206040,528432
290900,202201,165,124,41,150288,49692,199980
290910,202201,386,293,93,356328,112716,469044
290920,202201,202,177,25,214524,30300,244824
290930,202201,510,388,122,470256.6,147864,618120.6
290940,202201,226,191,35,232704,42420,275124
290950,202201,159,92,67,111504,81204,192708
290960,202201,470,329,141,398748,170892,569640
290970,202201,242,213,29,258156,35148.6,293304.6
290980,202201,1774,1206,568,1461674.72,688416.2,2150090.92
290990,202201,396,335,61,407232,73932,481164
291000,202201,882,274,608,332088,736896,1068984
291005,202201,2462,1047,1415,1270176,1717404,2987580
291010,202201,159,141,18,170892,21816,192708
291020,202201,92,72,20,87264,24240,111504
291030,202201,95,66,29,79992,35148,115140
291040,202201,618,349,269,422988,326028,749016
291050,202201,1507,799,708,969600,858096,1827696
291060,202201,1645,908,737,1100496,893244,1993740
291070,202201,1932,1443,489,1751341.6,595094.43,2346436.03
291072,202201,7131,2654,4477,3219072.6,5432185.2,8651257.8
291075,202201,240,194,46,235128.4,55752,290880.4
291077,202201,59,41,18,49692,21816,71508
291080,202201,20626,8796,11830,10671663.19,14346447.2,25018110.39
291085,202201,270,220,50,266640,61812,328452
291090,202201,276,111,165,135744.6,199980,335724.6
291100,202201,1007,337,670,408444,813252,1221696
291110,202201,431,330,101,399960,122412,522372
291120,202201,2412,1239,1173,1502880,1422888,2925768
291125,202201,58,29,29,35148,35148,70296
291130,202201,190,168,22,203616,26664,230280
291140,202201,126,102,24,123624,29088.6,152712.6
291150,202201,378,142,236,173316,287244,460560
291160,202201,379,306,73,372084,88476,460560
291165,202201,49,37,12,44844,14544,59388
291170,202201,3243,1593,1650,1930719.78,2003436.6,3934156.38
291180,202201,1241,500,741,606000,898092,1504092
291185,202201,110,102,8,123624,9696,133320
291190,202201,1381,657,724,797496,878700,1676196
291200,202201,169,123,46,149076,55752,204828
291210,202201,2373,945,1428,1146552.92,1733160.6,2879713.52
291220,202201,296,229,67,277548,81204,358752
291230,202201,963,336,627,407232.6,761136,1168368.6
291240,202201,406,377,29,458136.6,35148,493284.6
291250,202201,421,339,82,410868,99384,510252
291260,202201,59,52,7,63024,8484,71508
291270,202201,1040,450,590,546612,715080,1261692
291280,202201,355,164,191,198768,231492,430260
291290,202201,1684,882,802,1068985.2,972024.4,2041009.6
291300,202201,230,181,49,219372,59388,278760
291310,202201,225,199,26,241188,31512,272700
291320,202201,1313,916,397,1111404,481164,1592568
291330,202201,138,117,21,141804,25452,167256
291340,202201,222,133,89,161196,107868,269064
291345,202201,121,81,40,99384,48480,147864
291350,202201,1733,637,1096,773256,1328352.8,2101608.8
291360,202201,8340,3954,4386,4798308.4,5327952.6,10126261.0
291370,202201,1108,644,464,780528.6,563580,1344108.6
291380,202201,247,196,51,237552,61812,299364
291390,202201,3983,1772,2211,2151301.04,2680944,4832245.04
291400,202201,2073,1448,625,1757400,757500.94,2514900.94
291410,202201,194,165,29,199980.6,35148,235128.6
291420,202201,108,82,26,99384,31512,130896
291430,202201,168,99,69,119988,83628.34,203616.34
291440,202201,519,420,99,509040,119988,629028
291450,202201,922,603,319,730836,387840,1118676
291460,202201,1939,1547,392,1874965.2,476317.2,2351282.4
291465,202201,2241,1063,1178,1289568.6,1427736.6,2717305.2
291470,202201,2880,1452,1428,1759824.72,1733160.6,3492985.32
291480,202201,11815,5094,6721,6181203.88,8157973.8,14339177.68
291490,202201,632,256,376,310272,455712,765984
291500,202201,367,217,150,264216,183012,447228
291510,202201,1196,458,738,555096,894456,1449552
291520,202201,940,419,521,507828,631452,1139280
291530,202201,907,248,659,300576,798708,1099284
291535,202201,118,97,21,117564,25452,143016
291540,202201,358,118,240,143016.6,290880,433896.6
291550,202201,1287,602,685,730836.8,830220.6,1561057.4
291560,202201,5095,2534,2561,3072420.8,3106356.6,6178777.4
291570,202201,215,109,106,132108,128472,260580
291580,202201,1180,727,453,881124.48,550248,1431372.48
291590,202201,100,42,58,50904,70296,121200
291600,202201,1119,559,560,679932,679932,1359864
291610,202201,1400,676,724,819312,879912,1699224
291620,202201,562,266,296,322392,359964,682356
291630,202201,481,150,331,183012,401172,584184
291640,202201,4000,1993,2007,2415519.48,2434909.8,4850429.28
291650,202201,434,297,137,359965.1,166044,526009.1
291660,202201,364,146,218,176952,264216,441168
291670,202201,171,105,66,127260,79992,207252
291680,202201,639,387,252,470256,305424.2,775680.2
291685,202201,571,329,242,398748,293304,692052
291690,202201,451,289,162,350268,196344.52,546612.52
291700,202201,1008,778,230,942936,278760,1221696
291710,202201,1576,766,810,928392,981720.6,1910112.6
291720,202201,424,286,138,346632,167256,513888
291730,202201,913,528,385,641148,467832,1108980
291733,202201,287,190,97,230280,118776,349056
291735,202201,78,60,18,72720,21816,94536
291740,202201,342,259,83,315120,100596,415716
291750,202201,2258,1456,802,1764673.17,972024.6,2736697.77
291760,202201,3013,1650,1363,2001012,1658016,3659028
291770,202201,727,495,232,601153.88,281184,882337.88
291780,202201,67,40,27,48480.6,32724,81204.6
291790,202201,158,82,76,99384,92112,191496
291800,202201,10201,4265,5936,5170395.34,7196856,12367251.34
291810,202201,1075,807,268,978084.6,324816,1302900.6
291820,202201,284,202,82,244824,99384,344208
291830,202201,1026,418,608,506616.76,736896,1243512.76
291835,202201,549,508,41,618120,49692,667812
291840,202201,5069,2524,2545,3061512,3088177.6,6149689.6
291845,202201,266,83,183,100596,221796,322392
291850,202201,313,276,37,334512,44844,379356
291855,202201,259,109,150,132108,181800,313908
291860,202201,162,100,62,122412,75144,197556
291870,202201,82,35,47,42420.6,56964,99384.6
291875,202201,157,147,10,179376,12120,191496
291880,202201,424,346,78,419352,94536,513888
291890,202201,238,81,157,98172,190284.6,288456.6
291900,202201,56,33,23,39996,27876,67872
291905,202201,115,88,27,106656.6,32724,139380.6
291910,202201,158,126,32,152712,38784,191496
291915,202201,440,393,47,476316,56964,533280
291920,202201,5313,2586,2727,3140293.2,3311185.4,6451478.6
291930,202201,167,101,66,122412.26,79992,202404.26
291940,202201,370,212,158,256944,191496,448440
291950,202201,1137,901,236,1092012.6,286032,1378044.6
291955,202201,1349,818,531,992628,643572,1636200
291960,202201,200,148,52,179376,63024,242400
291970,202201,753,563,190,682356,230280,912636
291980,202201,1454,1271,183,1540453.68,223008.96,1763462.64
291990,202201,138,127,11,153924,13332,167256
291992,202201,177,90,87,109080,105444,214524
291995,202201,184,116,68,140592,82416,223008
292000,202201,398,294,104,356328,126048,482376
292010,202201,325,222,103,269064,124836,393900
292020,202201,298,219,79,265428,95748,361176
292030,202201,141,107,34,129684,41208,170892
292040,202201,590,307,283,373296,342996,716292
292045,202201,116,104,12,126048,14544,140592
292050,202201,925,670,255,812040,309060.6,1121100.6
292060,202201,874,706,168,855673.44,203616,1059289.44
292070,202201,62,23,39,27876,47268,75144
292080,202201,149,103,46,124836,55752,180588
292090,202201,530,183,347,221796,421776,643572
292100,202201,1507,651,856,789012.6,1043532,1832544.6
292105,202201,179,162,17,196344,20604,216948
292110,202201,2249,823,1426,997476,1729524,2727000
292120,202201,692,534,158,647208,191496,838704
292130,202201,459,254,205,307848,248460,556308
292140,202201,216,174,42,210888,50904,261792
292145,202201,162,84,78,101808,94536,196344
292150,202201,1488,1226,262,1487124.6,317544,1804668.6
292160,202201,159,125,34,152712,41208,193920
292170,202201,1190,1021,169,1238664.6,204828,1443492.6
292180,202201,223,163,60,197556,72720,270276
292190,202201,156,102,54,123624,65448,189072
292200,202201,1389,501,888,608424,1077468.6,1685892.6
292205,202201,116,98,18,118776,21816,140592
292210,202201,380,258,122,312696,147864,460560
292220,202201,31,20,11,24240,13332,37572
292225,202201,46,37,9,44844,10908,55752
292230,202201,969,736,233,892032,282396,1174428
292240,202201,618,444,174,538128.8,210888,749016.8
292250,202201,1641,1063,578,1288356,700536,1988892
292260,202201,404,242,162,293304,196344,489648
292265,202201,248,183,65,221796,78780,300576
292270,202201,714,337,377,408444,456924,865368
292273,202201,204,118,86,143016,104232,247248
292275,202201,170,86,84,104232,101808,206040
292280,202201,143,98,45,118776,54540,173316
292285,202201,85,67,18,81204,21816,103020
292290,202201,580,381,199,461772,241188,702960
292300,202201,1753,664,1089,804768,1322292,2127060
292303,202201,124,80,44,96960,53328,150288
292305,202201,116,87,29,105444,35148,140592
292310,202201,961,626,335,758712.8,406020.64,1164733.44
292320,202201,582,433,149,524796,180588,705384
292330,202201,180,111,69,134532,83628,218160
292335,202201,291,230,61,278760,73932,352692
292340,202201,562,385,177,466620,214524,681144
292350,202201,265,144,121,174528,146652,321180
292360,202201,709,535,174,648421.24,210888,859309.24
292370,202201,727,550,177,666600,214524,881124
292380,202201,615,505,110,612060.76,133320,745380.76
292390,202201,390,158,232,191496,281184,472680
292400,202201,3639,2253,1386,2731850.66,1681044.4,4412895.06
292405,202201,273,184,89,223008,107868,330876
292410,202201,122,75,47,90900,56964,147864
292420,202201,286,246,40,299364,48480,347844
292430,202201,546,397,149,481164,180588,661752
292440,202201,626,525,101,636300.92,122412,758712.92
292450,202201,238,182,56,220584,67872,288456
292460,202201,519,386,133,467833.12,161196,629029.12
292465,202201,204,174,30,210888,36360,247248
292467,202201,146,92,54,111504,65448,176952
292470,202201,305,212,93,256944,113928,370872
292480,202201,391,264,127,319968,153924.6,473892.6
292490,202201,238,174,64,210888,77568,288456
292500,202201,879,402,477,487224.09,579336,1066560.09
292510,202201,3530,1660,1870,2013132.96,2268865,4281997.96
292520,202201,1100,510,590,618120,717504,1335624
292525,202201,422,303,119,368448.4,145440,513888.4
292530,202201,4655,1825,2830,2211900.65,3434809.2,5646709.85
292540,202201,483,275,208,333300,252096,585396
292550,202201,1114,593,521,718716,632664,1351380
292560,202201,323,298,25,361176,30300,391476
292570,202201,311,238,73,288456,88476,376932
292575,202201,530,363,167,439956,202404,642360
292580,202201,999,667,332,808404,402384.6,1210788.6
292590,202201,552,487,65,590244,78780,669024
292593,202201,141,110,31,133320,37572,170892
292595,202201,203,162,41,197556,49692,247248
292600,202201,1251,897,354,1088376.95,429048,1517424.95
292610,202201,113,91,22,110292,26664,136956
292620,202201,532,447,85,541764,103020,644784
292630,202201,1501,820,681,993840.6,825372,1819212.6
292640,202201,872,601,271,728412,328452,1056864
292650,202201,183,146,37,176952.78,44844,221796.78
292660,202201,1938,1369,569,1659228,689628.36,2348856.36
292665,202201,139,98,41,118776,49692,168468
292670,202201,385,303,82,367236,100596,467832
292680,202201,266,195,71,236340,86052,322392
292690,202201,203,143,60,173316.6,72720,246036.6
292700,202201,1001,652,349,791436,422988,1214424
292710,202201,114,100,14,121200,16968,138168
292720,202201,956,546,410,662964.6,496920.6,1159885.2
292730,202201,202,98,104,118776,126048,244824
292740,202201,71314,34165,37149,41437088.52,45070655.61,86507744.13
292750,202201,380,275,105,333300.32,127260,460560.32
292760,202201,334,279,55,338148.72,66660,404808.72
292770,202201,849,362,487,438744,591456,1030200
292780,202201,19,10,9,12120,10908,23028
292790,202201,787,410,377,496920,456924,953844
292800,202201,1256,744,512,901728,622968,1524696
292805,202201,382,126,256,152712,311484,464196
292810,202201,1798,1072,726,1299265.8,879912,2179177.8
292820,202201,697,588,109,712656,132108,844764
292830,202201,125,99,26,119988,31512,151500
292840,202201,689,563,126,682356.4,152712,835068.4
292850,202201,137,89,48,107868,58176,166044
292860,202201,2106,1215,891,1473792.6,1081104.4,2554897.0
292870,202201,3607,2362,1245,2863957.29,1508940,4372897.29
292880,202201,1429,946,483,1146552.08,585396,1731948.08
292890,202201,525,437,88,530856,107868,638724
292895,202201,146,98,48,118776,59388,178164
292900,202201,344,246,98,298152.84,118776,416928.84
292905,202201,484,232,252,281184,305424,586608
292910,202201,465,346,119,419352.2,144228,563580.2
292920,202201,525,223,302,271488,366024,637512
292925,202201,476,436,40,528432,48480,576912
292930,202201,657,393,264,476316.6,321180,797496.6
292935,202201,278,119,159,144228,192708,336936
292937,202201,226,155,71,187860,86052,273912
292940,202201,188,144,44,174528,53328,227856
292950,202201,1230,596,634,722353.2,768408.6,1490761.8
292960,202201,521,368,153,446016,185436,631452
292970,202201,236,173,63,210889.16,76356,287245.16
292975,202201,92,54,38,65448,46056.4,111504.4
292980,202201,318,217,101,263004.1,123624,386628.1
292990,202201,1314,979,335,1186548.2,407232,1593780.2
293000,202201,112,79,33,95748,39996,135744
293010,202201,2924,1715,1209,2083428.6,1466521.06,3549949.66
293015,202201,611,497,114,603576,138168,741744
293020,202201,320,260,60,315120,72720.4,387840.4
293030,202201,577,509,68,616908.2,82416,699324.2
293040,202201,367,293,74,355116,89688,444804
293050,202201,2937,1733,1204,2100396.6,1461674.2,3562070.8
293060,202201,248,195,53,236340.44,64236,300576.44
293070,202201,3649,1824,1825,2211901.2,2217960.8,4429862.0
293075,202201,95,66,29,79992,35148,115140
293076,202201,75,56,19,67872,23028,90900
293077,202201,568,321,247,389052.6,300576,689628.6
293080,202201,421,375,46,455712.96,55752,511464.96
293090,202201,129,116,13,140592,15756,156348
293100,202201,524,359,165,435108,199980,635088
293105,202201,348,252,96,305424,116352,421776
293110,202201,120,80,40,96960,48480,145440
293120,202201,298,205,93,248460,112716,361176
293130,202201,249,167,82,202404,99384,301788
293135,202201,8167,3155,5012,3828710.8,6075759.8,9904470.6
293140,202201,191,114,77,138168.4,93324,231492.4
293150,202201,303,263,40,318756,48480,367236
293160,202201,422,258,164,312696,198768,511464
293170,202201,203,129,74,156348,89688,246036
293180,202201,567,386,181,467832.6,219372,687204.6
293190,202201,1350,927,423,1125949.36,512676.6,1638625.96
293200,202201,545,479,66,580548,79992,660540
293210,202201,415,319,96,386628,116352,502980
293220,202201,2391,1031,1360,1249572,1654380,2903952
293230,202201,1843,687,1156,832644.05,1402284,2234928.05
293240,202201,229,211,18,255732,23028,278760
293245,202201,126,104,22,126048,26664,152712
293250,202201,775,317,458,384204,557520,941724
293260,202201,305,247,58,299364,70296,369660
293270,202201,1168,525,643,636300.4,779316,1415616.4
293280,202201,296,173,123,210888,149076,359964
293290,202201,3033,1969,1064,2387640,1289568,3677208
293300,202201,786,556,230,673872.8,278760,952632.8
293305,202201,191,148,43,179376,52116,231492
293310,202201,166,125,41,151500,49692,201192
293315,202201,162,127,35,153924,42420,196344
293317,202201,86,64,22,78780,26664,105444
293320,202201,1098,588,510,712656.2,618120.6,1330776.8
293325,202201,194,71,123,86052,149076,235128
293330,202201,14006,6350,7656,7703475.18,9281500.8,16984975.98
293340,202201,291,205,86,248460,104232,352692
293345,202201,258,207,51,250884,61812,312696
293350,202201,583,350,233,424200,282396,706596
293360,202201,1497,1066,431,1291992,523584,1815576
310010,202201,140,73,67,88476,81204,169680
310020,202201,1008,552,456,669024,553884,1222908
310030,202201,312,250,62,303000,75144,378144
310040,202201,45,28,17,33936,20604,54540
310050,202201,157,99,58,119988,70296,190284
310060,202201,265,182,83,220584,100596,321180
310070,202201,14,8,6,9696,7272,16968
310080,202201,43,28,15,33936,18180,52116
310090,202201,1047,565,482,684783.33,584184.6,1268967.93
310100,202201,316,223,93,270276,112716,382992
310110,202201,682,364,318,441168,385416,826584
310120,202201,376,217,159,263004,193920,456924
310130,202201,30,17,13,20604,15756,36360
310140,202201,22,7,15,8484,18180,26664
310150,202201,1154,769,385,932029,467833.2,1399862.2
310160,202201,2046,993,1053,1204729.36,1281084.6,2485813.96
310163,202201,90,47,43,56964,52116,109080
310170,202201,2501,1131,1370,1370772.56,1661656.8,3032429.36
310180,202201,159,61,98,73932.6,119988,193920.6
310190,202201,475,321,154,390264,186648,576912
310200,202201,448,284,164,344208,198768,542976
310205,202201,68,45,23,54540,27876,82416
310210,202201,264,216,48,261792,59388,321180
310220,202201,60,32,28,39996,33936,73932
310230,202201,272,192,80,232704,96960,329664
310240,202201,108,92,16,111504,19392,130896
310250,202201,97,76,21,92112,25452,117564
310260,202201,714,373,341,453288.36,413292,866580.36
310270,202201,265,171,94,207252.36,113928,321180.36
310280,202201,378,274,104,332088,126048,458136
310285,202201,197,148,49,179376,59388,238764
310290,202201,231,128,103,155136,124836,279972
310300,202201,168,137,31,166044,37572,203616
310310,202201,10,7,3,8484,3636,12120
310320,202201,30,10,20,12120,24240,36360
310330,202201,39,25,14,30300,16968,47268
310340,202201,1839,1247,592,1513790.6,719928.6,2233719.2
310350,202201,2740,1442,1298,1750128.6,1574388,3324516.6
310360,202201,47,39,8,47268,9696,56964
310370,202201,127,106,21,128472,25452,153924
310375,202201,107,39,68,47268,82416,129684
310380,202201,51,29,22,35148,26664,61812
310390,202201,107,67,40,81204,48480,129684
310400,202201,2398,1547,851,1876176.4,1033836,2910012.4
310410,202201,113,62,51,75144,61812,136956
310420,202201,651,331,320,401172,387841.4,789013.4
310430,202201,274,168,106,203616,128472,332088
310440,202201,70,40,30,48480,36360,84840
310445,202201,78,65,13,78780,15756,94536
310450,202201,633,407,226,493284,273912,767196
310460,202201,243,168,75,203616,92112,295728
310470,202201,510,329,181,398748,221796,620544
310480,202201,88,55,33,66660,39996,106656
310490,202201,537,249,288,301788,349056,650844
310500,202201,127,49,78,59388,94536,153924
310510,202201,596,417,179,506616,216948,723564
310520,202201,140,100,40,121200,48480,169680
310530,202201,105,41,64,49692,77568,127260
310540,202201,467,263,204,318756.4,247248,566004.4
310550,202201,68,47,21,56964,25452,82416
310560,202201,3023,2059,964,2499145.86,1168368,3667513.86
310570,202201,101,61,40,73932,48480,122412
310590,202201,364,224,140,271488.4,170892,442380.4
310600,202201,140,71,69,86052.6,83628,169680.6
310610,202201,53,21,32,25452,38784,64236
310620,202201,47328,22114,25214,26826338.4,30605452.03,57431790.43
310630,202201,678,406,272,494496.4,329664,824160.4
310640,202201,132,93,39,112716,47268,159984
310650,202201,150,134,16,162408,19392,181800
310660,202201,108,74,34,89688,41208,130896
310665,202201,63,45,18,54540,21816,76356
310670,202201,6969,2977,3992,3611765,4845576.6,8457341.6
310680,202201,68,41,27,49692,32724,82416
310690,202201,615,430,185,521160.4,225432,746592.4
310700,202201,62,38,24,46056,29088,75144
310710,202201,1272,859,413,1040241.42,500556.6,1540798.02
310720,202201,148,39,109,47268,132108,179376
310730,202201,1503,1022,481,1241088.6,584184,1825272.6
310740,202201,979,539,440,655693.2,534492.6,1190185.8
310750,202201,248,155,93,187860.04,112716,300576.04
310760,202201,67,53,14,64236,16968,81204
310770,202201,89,44,45,53328,54540,107868
310780,202201,352,288,64,349056.6,77568,426624.6
310790,202201,110,87,23,105444,27876,133320
310800,202201,467,219,248,265428,300576,566004
310810,202201,170,116,54,140592.72,65448,206040.72
310820,202201,323,261,62,316332,75144,391476
310825,202201,206,174,32,210888,38784,249672
310830,202201,461,214,247,259368.6,299364,558732.6
310840,202201,360,212,148,256944,179376,436320
310850,202201,77,63,14,76356,16968,93324
310855,202201,403,314,89,380568,109080,489648
310860,202201,1591,1168,423,1415617.2,512676.8,1928294.0
310870,202201,49,41,8,49692,9696,59388
310880,202201,83,68,15,82416,18180,100596
310890,202201,293,170,123,206040,150288,356328
310900,202201,615,269,346,327246.16,421786.08,749032.24
310910,202201,242,163,79,197557.4,95748,293305.4
310920,202201,434,250,184,304212.72,223008.2,527220.92
310925,202201,34,26,8,31512,10908,42420
310930,202201,1276,825,451,1001112,546612,1547724
310940,202201,675,337,338,408444,409656,818100
310945,202201,124,77,47,93324,56964,150288
310950,202201,219,176,43,213312,53328,266640
310960,202201,77,24,53,29088,64236,93324
310970,202201,164,97,67,117564,81204.6,198768.6
310980,202201,46,30,16,36360,19392,55752
310990,202201,165,86,79,104232.6,95748,199980.6
311000,202201,807,383,424,466621.09,513888.6,980509.69
311010,202201,50,42,8,50904,9696,60600
311020,202201,41,24,17,29088,20604,49692
311030,202201,382,216,166,261792,201192,462984
311040,202201,40,31,9,37572,10908,48480
311050,202201,486,181,305,219372,369660,589032
311060,202201,790,437,353,529644,427836.6,957480.6
311070,202201,330,145,185,175740,224220,399960
311080,202201,105,61,44,75144,53328,128472
311090,202201,334,160,174,193920,210888,404808
311100,202201,552,327,225,398748,273912,672660
311110,202201,705,500,205,607212.6,248460.6,855673.2
311115,202201,73,51,22,61812,26664,88476
311120,202201,1045,557,488,675084.6,592668,1267752.6
311130,202201,292,170,122,206040,147864,353904
311140,202201,161,86,75,105444,90900,196344
311150,202201,349,219,130,265428.6,157560.6,422989.2
311160,202201,742,529,213,641149.2,258156,899305.2
311170,202201,88,72,16,87264,19392,106656
311180,202201,304,203,101,246036,122412.6,368448.6
311190,202201,41,16,25,19392,31512,50904
311200,202201,342,236,106,286032,128472,414504
311205,202201,34,25,9,30300,10908,41208
311210,202201,39,34,5,41208.6,6060,47268.6
311220,202201,30,26,4,31512,4848,36360
311230,202201,1646,1074,572,1302901,693264,1996165
311240,202201,200,123,77,149076,93324,242400
311250,202201,59,21,38,25452,46056,71508
311260,202201,546,341,205,414504,248460,662964
311265,202201,124,82,42,99384,50904,150288
311270,202201,289,201,88,243612,106656,350268
311280,202201,198,85,113,103020,136956.6,239976.6
311290,202201,101,82,19,99384,23028,122412
311300,202201,583,375,208,454500,252096,706596
311310,202201,18,15,3,18180,3636,21816
311320,202201,625,464,161,563580,197556,761136
311330,202201,1108,807,301,978084,367236.34,1345320.34
311340,202201,2607,1838,769,2227657.2,932028,3159685.2
311350,202201,265,205,60,248460,72720,321180
311360,202201,177,105,72,127260,88476,215736
311370,202201,1225,506,719,613272,872640,1485912
311380,202201,7,6,1,7272,1212,8484
311390,202201,247,137,110,166044,133320,299364
311400,202201,136,82,54,99384,65448,164832
311410,202201,114,54,60,65448,72720,138168
311420,202201,305,160,145,193920.4,175740,369660.4
311430,202201,825,550,275,669024,333300,1002324
311440,202201,454,309,145,374508,175740,550248
311450,202201,292,173,119,209676,144228,353904
311455,202201,262,178,84,215736,101808,317544
311460,202201,129,56,73,67872,89688,157560
311470,202201,30,15,15,18180,18180,36360
311480,202201,52,26,26,31512,31512,63024
311490,202201,10,6,4,7272,4848,12120
311500,202201,30,14,16,16968,19392,36360
311510,202201,650,440,210,533280,255732,789012
311520,202201,38,31,7,37572,8484,46056
311530,202201,1783,1288,495,1561058.12,604788,2165846.12
311535,202201,66,45,21,54540,25452,79992
311540,202201,34,29,5,35148,6060,41208
311545,202201,156,113,43,136956,52116,189072
311547,202201,44,33,11,39996,13332,53328
311550,202201,641,283,358,342996,435108,778104
311560,202201,43,26,17,31512,20604,52116
311570,202201,279,187,92,226644,112716,339360
311580,202201,391,237,154,288456,186648,475104
311590,202201,29,25,4,30300,4848,35148
311600,202201,95,78,17,94536,20604,115140
311610,202201,248,210,38,254520,46056,300576
311615,202201,126,103,23,126048,27876,153924
311620,202201,27,15,12,18180,14544,32724
311630,202201,92,78,14,94536,16968,111504
311640,202201,142,69,73,83628.6,88476,172104.6
311650,202201,127,87,40,105444,48480,153924
311660,202201,421,200,221,242400,267852,510252
311670,202201,142,95,47,115140.8,56964,172104.8
311680,202201,211,159,52,192708,63024,255732
311690,202201,13,11,2,13332,2424,15756
311700,202201,192,139,53,168468,64236,232704
311710,202201,179,121,58,146652,70296,216948
311720,202201,38,28,10,33936.6,12120,46056.6
311730,202201,559,384,175,465408,212100,677508
311740,202201,25,18,7,21816,8484,30300
311750,202201,721,484,237,586608.8,287244,873852.8
311760,202201,75,32,43,38784,52116,90900
311770,202201,380,179,201,216948.6,243612,460560.6
311780,202201,189,93,96,112716.6,116352,229068.6
311783,202201,86,79,7,95748,8484,104232
311787,202201,39,14,25,16968,30300,47268
311790,202201,271,115,156,140592,189072,329664
311800,202201,684,432,252,526008,305424,831432
311810,202201,50,40,10,48480,12120,60600
311820,202201,122,96,26,116352,31512,147864
311830,202201,1875,1135,740,1376832.6,899304,2276136.6
311840,202201,1009,556,453,676296.6,549036.6,1225333.2
311850,202201,14,10,4,12120,4848,16968
311860,202201,9635,4067,5568,4934053.6,6752053.2,11686106.8
311870,202201,110,61,49,73932,59388,133320
311880,202201,954,688,266,833856,322392,1156248
311890,202201,198,93,105,112616,127260,239876
311900,202201,65,28,37,33936,44844,78780
311910,202201,1354,833,521,1009596.6,632665.2,1642261.8
311920,202201,224,149,75,180588,90900,271488
311930,202201,904,509,395,616908.6,478740,1095648.6
311940,202201,2564,1355,1209,1644686.68,1468944,3113630.68
311950,202201,67,45,22,54540,26664,81204
311960,202201,62,44,18,53328,21816,75144
311970,202201,22,12,10,14544,13332,27876
311980,202201,43,33,10,39996,12120,52116
311990,202201,36,26,10,31512,12120,43632
311995,202201,46,27,19,32724,23028,55752
312000,202201,21,14,7,16968,8484,25452
312010,202201,73,57,16,69084,19392,88476
312015,202201,74,58,16,70296,19392,89688
312020,202201,131,92,39,111504,47268,158772
312030,202201,67,50,17,60600,20604,81204
312040,202201,78,48,30,58176,36360,94536
312050,202201,199,111,88,134532.6,106656,241188.6
312060,202201,23,14,9,16968,10908,27876
312070,202201,76,49,27,59388,32724,92112
312080,202201,543,245,298,296940,361176,658116
312083,202201,60,37,23,44844,27876,72720
312087,202201,95,71,24,86052,29088,115140
312090,202201,3276,1976,1300,2397339.2,1576813.2,3974152.4
312100,202201,143,100,43,120921.24,52116,173037.24
312110,202201,112,67,45,81204,54540,135744
312120,202201,124,91,33,110292.95,39996,150288.95
312125,202201,84,50,34,61812,41208,103020
312130,202201,134,89,45,109080,55752,164832
312140,202201,141,111,30,134532.6,36360,170892.6
312150,202201,40,32,8,39996,9696,49692
312160,202201,1472,960,512,1164842,620544,1785386
312170,202201,11,8,3,9696,3636,13332
312180,202201,102,66,36,79992,43632,123624
312190,202201,37,33,4,39996,4848,44844
312200,202201,736,632,104,765984.6,126048,892032.6
312210,202201,120,60,60,72720,72720,145440
312220,202201,130,98,32,118776,38784,157560
312230,202201,3699,1674,2025,2032524.84,2461573.8,4494098.64
312235,202201,155,104,51,126048,61812,187860
312240,202201,81,57,24,69084,29088,98172
312245,202201,196,135,61,164832,73932,238764
312247,202201,85,62,23,75144,27876,103020
312250,202201,173,86,87,104232,106656,210888
312260,202201,98,65,33,79992,39996,119988
312270,202201,135,80,55,96960,66660,163620
312280,202201,31,15,16,18180,19392,37572
312290,202201,138,93,45,112716,54540,167256
312300,202201,199,131,68,158772,82416,241188
312310,202201,60,53,7,64236,8484,72720
312320,202201,416,257,159,311484,195132.8,506616.8
312330,202201,92,76,16,92112,19392,111504
312340,202201,33,16,17,19392,20604,39996
312350,202201,11,5,6,7272,7272,14544
312352,202201,96,68,28,82416,33936,116352
312360,202201,565,242,323,294516,392688,687204
312370,202201,329,184,145,223008,175740,398748
312380,202201,144,94,50,113928,60600,174528
312385,202201,155,127,28,153924.6,33936,187860.6
312390,202201,297,191,106,231492,128472,359964
312400,202201,380,285,95,345420,115141.2,460561.2
312410,202201,1124,377,747,456924.6,906576,1363500.6
312420,202201,643,480,163,581760.6,197556,779316.6
312430,202201,880,633,247,767196.02,300576,1067772.02
312440,202201,39,30,9,36360,10908,47268
312450,202201,189,121,68,146652,82416,229068
312460,202201,28,13,15,15756,18180,33936
312470,202201,46,31,15,37572.6,18180,55752.6
312480,202201,164,99,65,119988,78780,198768
312490,202201,287,194,93,235128,112716,347844
312500,202201,34,21,13,25452,15756,41208
312510,202201,552,205,347,248460,420564,669024
312520,202201,29,9,20,10908,24240,35148
312530,202201,36,26,10,31512,12120,43632
312540,202201,87,78,9,94536,10908,105444
312550,202201,35,28,7,33936,9696,43632
312560,202201,195,150,45,181800,54540,236340
312570,202201,441,260,181,315120,219372,534492
312580,202201,93,48,45,58176,54540,112716
312590,202201,229,181,48,219372,58176,277548
312595,202201,130,107,23,129684,27876,157560
312600,202201,69,33,36,39996.4,43632,83628.4
312610,202201,1531,793,738,961119.4,894456.6,1855576.0
312620,202201,226,162,64,196344,77568,273912
312630,202201,69,56,13,67872,15756,83628
312640,202201,39,9,30,10908,36360,47268
312650,202201,148,124,24,150697.04,29088,179785.04
312660,202201,100,73,27,88476.81,32724,121200.81
312670,202201,930,595,335,722352,407232,1129584
312675,202201,37,28,9,33936,10908,44844
312680,202201,68,42,26,50904,31512,82416
312690,202201,233,115,118,139380,143016,282396
312695,202201,25,21,4,25452,4848,30300
312700,202201,236,135,101,163620,122412,286032
312705,202201,82,65,17,78780,20604,99384
312707,202201,134,95,39,115140,47268,162408
312710,202201,1880,1028,852,1245937.08,1032624,2278561.08
312720,202201,49,25,24,30300,29088,59388
312730,202201,267,155,112,187860,135744,323604
312733,202201,47,36,11,43632,13332,56964
312735,202201,21,14,7,16968,8484,25452
312737,202201,70,38,32,46056,38784,84840
312738,202201,64,42,22,50904,26664,77568
312740,202201,80,54,26,65448,31512,96960
312750,202201,95,63,32,76356,38784,115140
312760,202201,276,192,84,233916,101808,335724
312770,202201,8486,3938,4548,4776497,5523084.6,10299581.6
312780,202201,445,340,105,413292,127260,540552
312790,202201,20,15,5,18180,6060,24240
312800,202201,1585,1105,480,1339261.2,581760.24,1921021.44
312810,202201,339,230,109,278760,132108,410868
312820,202201,184,140,44,169680,53328,223008
312825,202201,35,25,10,30300,12120,42420
312830,202201,198,113,85,136956,103020,239976
312840,202201,180,122,58,147864,70296,218160
312850,202201,39,35,4,42420,4848,47268
312860,202201,143,94,49,113928,59388,173316
312870,202201,1092,565,527,684780.6,639936,1324716.6
312880,202201,115,82,33,99384,41208,140592
312890,202201,163,115,48,139380,58176,197556
312900,202201,178,133,45,161196,54540,215736
312910,202201,177,100,77,121200,93324,214524
312920,202201,130,70,60,84840,72720,157560
312930,202201,325,222,103,269064,124836,393900
312940,202201,124,86,38,104232,46056,150288
312950,202201,695,473,222,573276.6,269064,842340.6
312960,202201,147,109,38,132108.64,46056,178164.64
312965,202201,107,83,24,100596,29088,129684
312970,202201,272,225,47,272700,56964,329664
312980,202201,2529,1269,1260,1538030.61,1533180.96,3071211.57
312990,202201,51,25,26,30300,31512,61812
313000,202201,51,29,22,35148,26664,61812
313005,202201,174,133,41,161196,49692,210888
313010,202201,944,392,552,475104.6,669024.6,1144129.2
313020,202201,191,95,96,115140,116352,231492
313030,202201,196,129,67,156348.76,81204,237552.76
313040,202201,83,25,58,30300,70296,100596
313050,202201,194,139,55,168468.1,66660,235128.1
313055,202201,40,31,9,37572,10908,48480
313060,202201,136,90,46,109080,55752,164832
313065,202201,62,45,17,54540,20604.6,75144.6
313070,202201,130,69,61,83628,73932,157560
313080,202201,37,17,20,20604,24240,44844
313090,202201,670,429,241,519948,292092,812040
313100,202201,202,73,129,88476,157560,246036
313110,202201,152,82,70,99384,84840,184224
313115,202201,214,117,97,143016,117564,260580
313120,202201,848,471,377,570852,458136,1028988
313130,202201,5896,3192,2704,3873556.92,3282097.4,7155654.32
313140,202201,130,75,55,90900,66660,157560
313150,202201,297,236,61,286032,73932,359964
313160,202201,182,135,47,163620.6,56964,220584.6
313170,202201,1362,882,480,1070197.8,581760,1651957.8
313180,202201,310,184,126,223008.6,152712,375720.6
313190,202201,723,426,297,519948.6,361176,881124.6
313200,202201,31,26,5,31512,6060,37572
313210,202201,999,849,150,1030202.28,181800.6,1212002.88
313220,202201,298,174,124,212100,150288.85,362388.85
313230,202201,261,199,62,241188.1,75144,316332.1
313240,202201,2197,1095,1102,1327144.2,1338048.6,2665192.8
313250,202201,1245,944,301,1144128.6,364813.28,1508941.88
313260,202201,93,46,47,55752,56964,112716
313270,202201,1000,583,417,706596.8,505405.8,1212002.6
313280,202201,45,38,7,46056,8484,54540
313290,202201,212,169,43,204828,52116,256944
313300,202201,324,164,160,198768,193920,392688
313310,202201,246,111,135,134532,163620,298152
313320,202201,382,280,102,339360.4,123624,462984.4
313330,202201,1407,860,547,1042320.8,662964,1705284.8
313340,202201,327,234,93,283608,112716,396324
313350,202201,461,294,167,356328,202404,558732
313360,202201,169,77,92,93324,112716,206040
313370,202201,227,79,148,95748,180588,276336
313375,202201,301,176,125,214524,151500,366024
313380,202201,1323,706,617,855672.8,749016,1604688.8
313390,202201,48,45,3,54540,3636,58176
313400,202201,392,269,123,326028.8,149077.2,475106.0
313410,202201,35,17,18,20604,21816,42420
313420,202201,4558,2492,2066,3020305.87,2505205.8,5525511.67
313430,202201,129,64,65,78780,78780,157560
313440,202201,1370,959,411,1164734.89,498133.8,1662868.69
313450,202201,70,34,36,41208,43632,84840
313460,202201,385,162,223,196344,270276,466620
313470,202201,524,242,282,293304,341784.6,635088.6
313480,202201,147,108,39,130896.6,47268,178164.6
313490,202201,540,241,299,292092.6,362388.6,654481.2
313500,202201,29,16,13,19392,15756,35148
313505,202201,1060,818,242,991416,293304,1284720
313507,202201,90,55,35,66660,42420,109080
313510,202201,2853,1777,1076,2156280.2,1304112,3460392.2
313520,202201,3433,2668,765,3236044.77,927180,4163224.77
313530,202201,31,19,12,24240,14544,38784
313535,202201,73,57,16,69084,19392,88476
313540,202201,67,49,18,60600,21816,82416
313545,202201,110,94,16,113928,19392,133320
313550,202201,220,184,36,223008,43632.6,266640.6
313560,202201,342,162,180,196344,220584,416928
313570,202201,69,22,47,26664,56964,83628
313580,202201,1310,747,563,906576.6,682356.6,1588933.2
313590,202201,66,38,28,46056,33936,79992
313600,202201,670,397,273,481164,330876.6,812040.6
313610,202201,50,42,8,50904,9696,60600
313620,202201,1346,654,692,792649.2,838704.76,1631353.96
313630,202201,1608,1214,394,1471369.2,478740,1950109.2
313640,202201,116,70,46,84840,55752,140592
313650,202201,227,108,119,130896,144228,275124
313652,202201,24,23,1,27876,1212,29088
313655,202201,74,46,28,55752,33936,89688
313657,202201,47,43,4,52116,4848,56964
313660,202201,126,81,45,98172,54540,152712
313665,202201,660,301,359,364812.2,435108,799920.2
313670,202201,10314,7020,3294,8511884.32,3999600,12511484.32
313680,202201,42,31,11,37572,13332,50904
313690,202201,129,94,35,113928,42420,156348
313695,202201,76,57,19,69084,23028,92112
313700,202201,334,263,71,318756.6,86052,404808.6
313710,202201,129,95,34,115140,41208,156348
313720,202201,1141,516,625,626604.6,757501,1384105.6
313730,202201,70,42,28,50904,33936,84840
313740,202201,143,111,32,134532,38784,173316
313750,202201,410,288,122,349056,149076,498132
313753,202201,223,164,59,198768,71508,270276
313760,202201,1348,500,848,607212,1030200,1637412
313770,202201,398,274,124,333300,150288,483588
313780,202201,812,426,386,517524,469044,986568
313790,202201,29,28,1,33936,1212,35148
313800,202201,157,94,63,113928,76356.6,190284.6
313810,202201,84,50,34,60600,41208,101808
313820,202201,1329,627,702,759925.8,850824.6,1610750.4
313830,202201,52,36,16,43632,19392,63024
313835,202201,61,51,10,61812,12120,73932
313840,202201,1656,979,677,1186549,820524,2007073
313850,202201,210,86,124,104232,150288,254520
313860,202201,453,347,106,420565.2,128472,549037.2
313862,202201,175,119,56,144228,67872,212100
313865,202201,143,95,48,117564,58176,175740
313867,202201,55,44,11,53328,14544,67872
313868,202201,42,25,17,30300,20604,50904
313870,202201,96,52,44,63024,53328,116352
313880,202201,372,231,141,281184,170892,452076
313890,202201,331,175,156,212100.4,189072,401172.4
313900,202201,823,439,384,532068,465408.6,997476.6
313910,202201,143,97,46,117564,55752,173316
313920,202201,626,433,193,524796,233917.02,758713.02
313925,202201,35,29,6,35148,7272,42420
313930,202201,875,677,198,820524,241188,1061712
313940,202201,1882,1142,740,1384104,896880,2280984
313950,202201,856,527,329,638724.2,399960,1038684.2
313960,202201,1439,818,621,992628.6,752654.2,1745282.8
313970,202201,180,106,74,128472,89688,218160
313980,202201,213,140,73,170892,88476,259368
313990,202201,244,158,86,191496,104232,295728
314000,202201,873,576,297,699324.56,359964,1059288.56
314010,202201,86,49,37,59388,46056,105444
314015,202201,73,19,54,23028,65448,88476
314020,202201,58,39,19,47268,23028,70296
314030,202201,72,35,37,42420,44844,87264
314040,202201,43,23,20,27876,24240,52116
314050,202201,289,169,120,204828.8,145440,350268.8
314053,202201,100,62,38,75144,46056,121200
314055,202201,290,180,110,218160,133320,351480
314060,202201,123,108,15,130896,18180,149076
314070,202201,1051,519,532,629028,644784,1273812
314080,202201,212,132,80,159984,96960.84,256944.84
314085,202201,162,111,51,134532,61812,196344
314090,202201,377,265,112,321181.2,135744,456925.2
314100,202201,524,416,108,505404.2,130896,636300.2
314110,202201,767,356,411,431472,498132.6,929604.6
314120,202201,69,39,30,47268,36360,83628
314130,202201,24,16,8,19392,9696,29088
314140,202201,1110,687,423,832644.8,512676,1345320.8
314150,202201,194,125,69,151500,83628,235128
314160,202201,323,242,81,293304.4,98172,391476.4
314170,202201,83,63,20,76356,24240,100596
314180,202201,731,641,90,776893.2,109080,885973.2
314190,202201,90,55,35,66660,42420,109080
314200,202201,492,330,162,401172.4,196344,597516.4
314210,202201,254,193,61,233916,73932.6,307848.6
314220,202201,306,216,90,261792.6,109080,370872.6
314225,202201,57,38,19,46056,23028,69084
314230,202201,116,52,64,63024,77568,140592
314240,202201,163,116,47,140592,56964,197556
314250,202201,59,35,24,42420,29088,71508
314260,202201,224,111,113,134532,136956,271488
314270,202201,399,310,89,375720,107868,483588
314280,202201,721,384,337,465353.46,409656,875009.46
314290,202201,526,414,112,501768,135744,637512
314300,202201,339,254,85,307848,103020,410868
314310,202201,1314,900,414,1091103.84,501768,1592871.84
314315,202201,36,26,10,31512,12120,43632
314320,202201,573,383,190,464196.6,230280,694476.6
314330,202201,11420,5560,5860,6742359.4,7115653.8,13858013.2
314340,202201,605,270,335,327240,407233.2,734473.2
314345,202201,53,37,16,44844,19392,64236
314350,202201,175,109,66,132108,79992,212100
314360,202201,53,28,25,33936,30300,64236
314370,202201,71,48,23,58176,27876,86052
314380,202201,105,62,43,75144,52116,127260
314390,202201,3320,2137,1183,2591257.56,1436220.4,4027477.96
314400,202201,677,477,200,578124.6,243612,821736.6
314410,202201,492,313,179,379356,216948.21,596304.21
314420,202201,17,8,9,9696,10908,20604
314430,202201,2425,882,1543,1070196.76,1871329.8,2941526.56
314435,202201,174,102,72,123624,87264,210888
314437,202201,30,20,10,24240,12120,36360
314440,202201,96,62,34,75144,41208,116352
314450,202201,161,110,51,133320,61812,195132
314460,202201,624,296,328,358752.6,398748.6,757501.2
314465,202201,99,61,38,73932,46056.6,119988.6
314467,202201,71,58,13,70296,15756,86052
314470,202201,402,200,202,243612.6,244824,488436.6
314480,202201,1026,461,565,558732.6,684780,1243512.6
314490,202201,40,24,16,29088,19392,48480
314500,202201,282,197,85,238764,103020,341784
314505,202201,104,66,38,79992,46056,126048
314510,202201,242,197,45,238764,54540,293304
314520,202201,1348,719,629,871432.8,763561.8,1634994.6
314530,202201,746,587,159,712656.4,192708,905364.4
314535,202201,165,100,65,121200,78780,199980
314537,202201,63,38,25,46056,30300,76356
314540,202201,19,12,7,14544,8484,23028
314545,202201,56,38,18,46056,21816,67872
314550,202201,69,37,32,44844,38784,83628
314560,202201,846,452,394,549036.6,478740,1027776.6
314570,202201,17,14,3,16968,3636,20604
314580,202201,13,5,8,6060,9696,15756
314585,202201,26,19,7,23028,8484,31512
314587,202201,81,70,11,84840.4,13332,98172.4
314590,202201,552,379,173,459348,209676,669024
314600,202201,931,592,339,717505.2,413292.6,1130797.8
314610,202201,946,486,460,590244.6,557520,1147764.6
314620,202201,140,104,36,126048,44844,170892
314625,202201,99,73,26,88476,31512,119988
314630,202201,1132,599,533,725988,645996,1371984
314640,202201,84,53,31,64236,37572.6,101808.6
314650,202201,164,92,72,111504,89688,201192
314655,202201,61,44,17,53328,20604,73932
314660,202201,16,13,3,15756,3636,19392
314670,202201,211,164,47,198768.6,56964,255732.6
314675,202201,209,125,84,151500,101808,253308
314690,202201,568,306,262,370872,318756,689628
314700,202201,2217,1175,1042,1424101.8,1262904,2687005.8
314710,202201,1775,999,776,1210789.4,941724,2152513.4
314720,202201,378,215,163,260580,198768,459348
314730,202201,509,270,239,327240.6,290880,618120.6
314740,202201,754,350,404,426624,489648,916272
314750,202201,19,15,4,18180,4848,23028
314760,202201,358,153,205,186648,248460,435108
314770,202201,103,69,34,83628,41208,124836
314780,202201,22,9,13,10908,15756,26664
314790,202201,2429,1516,913,1838605,1107768.6,2946373.6
314795,202201,59,50,9,60600,10908,71508
314800,202201,2915,1680,1235,2036162.61,1500456,3536618.61
314810,202201,1463,831,632,1007172,765984.4,1773156.4
314820,202201,108,61,47,73932,56964,130896
314830,202201,208,170,38,206040,46056,252096
314840,202201,86,48,38,58176,46056,104232
314850,202201,403,189,214,229068,259368,488436
314860,202201,655,503,152,612060,184224,796284
314870,202201,1573,807,766,981721.2,928392,1910113.2
314875,202201,53,48,5,58176,6060,64236
314880,202201,43,31,12,37572,14544,52116
314890,202201,51,27,24,32724,29088,61812
314900,202201,26,20,6,24240,7272,31512
314910,202201,231,150,81,181800,98172,279972
314915,202201,132,117,15,141804,19392,161196
314920,202201,86,55,31,67872,37572,105444
314930,202201,1021,487,534,592669.4,647208,1239877.4
314940,202201,41,32,9,38784,10908,49692
314950,202201,21,17,4,20604,4848,25452
314960,202201,24,17,7,20604,8484,29088
314970,202201,167,81,86,98172,104232,202404
314980,202201,303,192,111,232704,134532,367236
314990,202201,443,243,200,294516.4,242400,536916.4
314995,202201,150,66,84,79992,101808,181800
315000,202201,85,66,19,79992,23028,103020
315010,202201,34,22,12,26664,14544,41208
315015,202201,158,125,33,151500,39996,191496
315020,202201,69,58,11,70296,13332,83628
315030,202201,109,82,27,99384,32724,132108
315040,202201,80,49,31,59388,37572,96960
315050,202201,205,122,83,147864,100596,248460
315053,202201,49,33,16,39996,19392,59388
315057,202201,116,92,24,111504,29088,140592
315060,202201,69,57,12,69084.88,14544,83628.88
315070,202201,103,57,46,69084,55752,124836
315080,202201,379,298,81,361176,98172,459348
315090,202201,96,57,39,69084,47268,116352
315100,202201,78,38,40,46056,48480,94536
315110,202201,269,138,131,167256,158772,326028
315120,202201,1792,856,936,1037472,1138068.6,2175540.6
315130,202201,335,242,93,293304,112716,406020
315140,202201,530,291,239,352692.46,289668,642360.46
315150,202201,966,461,505,559944,612060,1172004
315160,202201,197,101,96,122412,116352,238764
315170,202201,298,198,100,239976.6,121200,361176.6
315180,202201,3193,1332,1861,1614385.8,2262805.4,3877191.2
315190,202201,295,180,115,218160.8,140592,358752.8
315200,202201,1187,703,484,852036.6,586608,1438644.6
315210,202201,1626,946,680,1146552.4,825373.4,1971925.8
315213,202201,28,15,13,18180,15756,33936
315217,202201,192,150,42,181800,50904,232704
315220,202201,1595,1185,410,1437433.52,496920.02,1934353.54
315230,202201,174,131,43,158772.6,52116,210888.6
315240,202201,386,250,136,303000,164832.6,467832.6
315250,202201,2568,1232,1336,1495608.6,1622868.8,3118477.4
315260,202201,134,73,61,88476,73932,162408
315270,202201,132,90,42,109080,50904,159984
315280,202201,613,408,205,496921.68,248460,745381.68
315290,202201,184,115,69,139380,83628,223008
315300,202201,91,70,21,84840.6,25452,110292.6
315310,202201,81,73,8,88476,10908,99384
315320,202201,141,85,56,103020,69084,172104
315330,202201,59,46,13,55752.6,15756,71508.6
315340,202201,390,285,105,346632,127260,473892
315350,202201,152,96,56,116352,69084,185436
315360,202201,94,42,52,50904,63024,113928
315370,202201,54,34,20,41208,24240,65448
315380,202201,5,5,0,6060,,6060.0
315390,202201,60,18,42,21816,50904.6,72720.6
315400,202201,786,582,204,705386.2,247248,952634.2
315410,202201,307,179,128,216948,155137.6,372085.6
315415,202201,53,40,13,48480,15756,64236
315420,202201,190,139,51,168468.6,61812,230280.6
315430,202201,647,364,283,443592.6,342996.66,786589.26
315440,202201,90,60,30,72720,36360,109080
315445,202201,219,183,36,221796,43632,265428
315450,202201,178,130,48,157560,58176,215736
315460,202201,4322,1998,2324,2427637.2,2822749.68,5250386.88
315470,202201,44,17,27,20604,32724,53328
315480,202201,74,20,54,24240,65448,89688
315490,202201,698,431,267,522372,327240,849612
315500,202201,16,11,5,13332,6060,19392
315510,202201,140,97,43,117564,52116,169680
315520,202201,78,67,11,81204,13332,94536
315530,202201,40,21,19,25452,23028,48480
315540,202201,263,184,79,223008,95748,318756
315550,202201,179,144,35,174528,42420,216948
315560,202201,717,567,150,688416.6,183012,871428.6
315570,202201,311,150,161,181800.64,195132.4,376933.04
315580,202201,727,494,233,599940,282396.6,882336.6
315590,202201,191,99,92,119988,111504,231492
315600,202201,318,246,72,298152.6,87264,385416.6
315610,202201,104,50,54,60600,65448,126048
315620,202201,36,28,8,33936,9696,43632
315630,202201,121,85,36,103020,43632,146652
315640,202201,67,41,26,49692,31512,81204
315645,202201,49,32,17,38784,20604,59388
315650,202201,166,122,44,147864,54540,202404
315660,202201,452,197,255,238764.6,309060,547824.6
315670,202201,2373,1098,1275,1330777.2,1546512,2877289.2
315680,202201,789,562,227,682356,275124,957480
315690,202201,673,453,220,549036,266640,815676
315700,202201,1962,1020,942,1238665.73,1142916,2381581.73
315710,202201,357,110,247,133320,299364,432684
315720,202201,482,290,192,351480,232704,584184
315725,202201,190,151,39,183012.6,47268,230280.6
315727,202201,56,29,27,35148,32724,67872
315730,202201,49,44,5,53328,6060,59388
315733,202201,85,53,32,64236,38784,103020
315737,202201,50,37,13,44844,15756,60600
315740,202201,32,24,8,29088,9696,38784
315750,202201,147,109,38,132108,46056,178164
315760,202201,39,30,9,36360,10908,47268
315765,202201,124,73,51,88476,61812,150288
315770,202201,217,136,81,164832.38,99384,264216.38
315780,202201,3734,1840,1894,2230080.2,2295528.4,4525608.6
315790,202201,243,186,57,225432,69084,294516
315800,202201,299,196,103,238764,124836,363600
315810,202201,67,41,26,49692,31512,81204
315820,202201,745,544,201,659330.4,243612,902942.4
315830,202201,115,72,43,87264,52116,139380
315840,202201,81,53,28,64236,33936,98172
315850,202201,263,182,81,220585.4,98172.6,318758.0
315860,202201,17,5,12,6060,14544,20604
315870,202201,41,32,9,38784,10908,49692
315880,202201,94,66,28,79992,33936,113928
315890,202201,105,77,28,93324,33936,127260
315895,202201,406,265,141,321180,170892,492072
315900,202201,76,36,40,43632,48480,92112
315910,202201,45,27,18,32724,21816,54540
315920,202201,151,100,51,121200,61812,183012
315930,202201,53,18,35,21816,42420,64236
315935,202201,118,95,23,115140.6,27876,143016.6
315940,202201,99,72,27,87264,32724,119988
315950,202201,37,29,8,35148,9696,44844
315960,202201,547,258,289,312696,351480.6,664176.6
315970,202201,31,24,7,29088,8484,37572
315980,202201,670,333,337,404808,408444,813252
315990,202201,256,144,112,174528,135744,310272
316000,202201,46,30,16,36360,19392,55752
316010,202201,80,67,13,81204,15756,96960
316020,202201,109,94,15,115140,18180,133320
316030,202201,376,210,166,254520.6,201192.6,455713.2
316040,202201,525,210,315,254520.6,384204.6,638725.2
316045,202201,49,44,5,53328,6060,59388
316050,202201,20,15,5,18180,6060,24240
316060,202201,99,66,33,79992,39996,119988
316070,202201,1111,733,378,889609.4,460560,1350169.4
316080,202201,88,56,32,67978.65,38784,106762.65
316090,202201,40,19,21,23028,25452,48480
316095,202201,88,73,15,88476,18180,106656
316100,202201,320,178,142,218160,173316,391476
316105,202201,43,25,18,30300.6,21816,52116.6
316110,202201,1876,1458,418,1767096.7,510252,2277348.7
316120,202201,79,51,28,61812,33936,95748
316130,202201,112,83,29,100596.6,35148,135744.6
316140,202201,34,23,11,27876,13332,41208
316150,202201,214,147,67,178164,81204,259368
316160,202201,81,47,34,56964.6,41208,98172.6
316165,202201,68,45,23,54540,27876,82416
316170,202201,188,120,68,145440,82416,227856
316180,202201,207,82,125,99384.6,151500.6,250885.2
316190,202201,143,103,40,124836,48480,173316
316200,202201,653,347,306,420564,370872.6,791436.6
316210,202201,765,508,257,615904.46,312696,928600.46
316220,202201,112,72,40,87264,48480,135744
316225,202201,35,19,16,23028,19392,42420
316230,202201,37,19,18,23028,21816,44844
316240,202201,660,527,133,638724,162408,801132
316245,202201,142,124,18,150288,21816,172104
316250,202201,1600,1085,515,1316233.2,624180,1940413.2
316255,202201,140,113,27,136956,32724,169680
316257,202201,173,88,85,106656,103020,209676
316260,202201,183,126,57,152712,69084,221796
316265,202201,29,21,8,25452.6,9696,35148.6
316270,202201,680,480,200,581760.4,242400.96,824161.36
316280,202201,535,328,207,397537.35,250884.6,648421.95
316290,202201,799,540,259,654480,313908,968388
316292,202201,541,220,321,266640,390264,656904
316294,202201,103,66,37,81204,44844,126048
316295,202201,335,150,185,181800.6,224220,406020.6
316300,202201,9,8,1,9696,1212,10908
316310,202201,28,15,13,18180,15756,33936
316320,202201,52,27,25,32724,30300,63024
316330,202201,168,115,53,139380,64236,203616
316340,202201,135,91,44,110292,53328,163620
316350,202201,187,130,57,159984.2,69084,229068.2
316360,202201,28,15,13,18180,15756,33936
316370,202201,1170,580,590,702961.4,716292,1419253.4
316380,202201,110,83,27,100596,32724,133320
316390,202201,102,74,28,89688,33936,123624
316400,202201,140,106,34,128472,41208,169680
316410,202201,307,222,85,269064,103020,372084
316420,202201,214,144,70,174528,84840,259368
316430,202201,155,83,72,100596,87264,187860
316440,202201,77,40,37,48480,44844,93324
316443,202201,41,37,4,44844,4848,49692
316447,202201,43,34,9,41208,10908,52116
316450,202201,225,173,52,209676.6,63024,272700.6
316460,202201,85,31,54,37572,65448,103020
316470,202201,1666,1206,460,1462874.09,558732,2021606.09
316480,202201,11,8,3,9696,3636,13332
316490,202201,19,6,13,7272,15756,23028
316500,202201,158,103,55,124836,66660,191496
316510,202201,143,113,30,136956,37572,174528
316520,202201,185,105,80,127260,98172,225432
316530,202201,163,102,61,123624,73932,197556
316540,202201,150,75,75,90900,90900,181800
316550,202201,139,84,55,103020,66660,169680
316553,202201,361,163,198,197556,241188.72,438744.72
316555,202201,49,45,4,54540,4848,59388
316556,202201,13,9,4,10908,4848,15756
316557,202201,27,22,5,26664,6060,32724
316560,202201,68,48,20,58176,24240,82416
316570,202201,207,189,18,229068,21816,250884
316580,202201,21,15,6,18180,7272,25452
316590,202201,95,80,15,96960,18180,115140
316600,202201,177,147,30,178164,36360,214524
316610,202201,68,51,17,61812,20604,82416
316620,202201,142,101,41,122412,49692,172104
316630,202201,43,33,10,39996,12120,52116
316640,202201,21,14,7,16968,8484,25452
316650,202201,89,72,17,87264,20604,107868
316660,202201,7,2,5,2424,6060,8484
316670,202201,435,147,288,178164,349056,527220
316680,202201,163,122,41,147864,49692.4,197556.4
316690,202201,170,102,68,123624,82416,206040
316695,202201,59,49,10,59388,12120,71508
316700,202201,18,13,5,15756,6060,21816
316710,202201,754,567,187,688416,227856,916272
316720,202201,5049,2415,2634,2928194.4,3196044,6124238.4
316730,202201,13,13,0,15756,,15756.0
316740,202201,151,94,57,113928,69084,183012
316750,202201,22,14,8,16968,9696,26664
316760,202201,310,250,60,303000,72720,375720
316770,202201,168,87,81,105444,98172,203616
316780,202201,68,42,26,50904,31512,82416
316790,202201,56,39,17,47268,20604,67872
316800,202201,1769,1079,690,1310172,836281,2146453
316805,202201,26,19,7,23028,8484,31512
316810,202201,62,38,24,46056,30300,76356
316820,202201,39,22,17,26664,20604,47268
316830,202201,98,44,54,53328,65448,118776
316840,202201,510,302,208,367236,252096,619332
316850,202201,306,205,101,248460,122412,370872
316860,202201,6053,2686,3367,3255436.24,4085652.2,7341088.44
316870,202201,1601,1017,584,1233816.47,707809,1941625.47
316880,202201,148,75,73,90900,88476,179376
316890,202201,232,159,73,192708,88476,281184
316900,202201,406,281,125,340572.84,151500,492072.84
316905,202201,21,9,12,10908,14544,25452
316910,202201,63,25,38,30300,46056,76356
316920,202201,139,108,31,130896,37572,168468
316930,202201,1899,947,952,1148977.2,1153824.2,2302801.4
316935,202201,909,538,371,653268.16,449652.6,1102920.76
316940,202201,1089,616,473,747804.2,574489.4,1322293.6
316950,202201,176,83,93,100596,112716,213312
316960,202201,1078,594,484,721141.2,586608,1307749.2
316970,202201,622,490,132,593880,159984,753864
316980,202201,76,40,36,48480,43632,92112
316990,202201,2180,1474,706,1786489.56,856885.09,2643374.65
317000,202201,326,251,75,304212,90900,395112
317005,202201,219,157,62,190284,75144,265428
317010,202201,6468,3609,2859,4380174.08,3469956,7850130.08
317020,202201,15541,6782,8759,8227063.64,10631670.77,18858734.41
317030,202201,80,32,48,38784,58176,96960
317040,202201,3034,1923,1111,2333101.8,1348956.6,3682058.4
317043,202201,69,53,16,64236,19392,83628
317047,202201,40,22,18,26664,21816,48480
317050,202201,144,111,33,134532,39996,174528
317052,202201,143,112,31,136552,37572,174124
317057,202201,175,132,43,159984,52116,212100
317060,202201,59,36,23,43632,27876,71508
317065,202201,52,38,14,46056,16968,63024
317070,202201,1915,870,1045,1058077,1266540.6,2324617.6
317075,202201,95,52,43,63024,52116,115140
317080,202201,915,465,450,563580,545400,1108980
317090,202201,693,544,149,659328,180588,839916
317100,202201,414,310,104,376932.06,128472,505404.06
317103,202201,110,89,21,107868,25452,133320
317107,202201,46,39,7,47268,8484,55752
317110,202201,96,47,49,56964,60600,117564
317115,202201,44,40,4,48480,4848,53328
317120,202201,1996,941,1055,1141705.2,1279872.6,2421577.8
317130,202201,2006,1331,675,1613173.4,819312.6,2432486.0
317140,202201,12,11,1,13332,1212,14544
317150,202201,285,171,114,207252.6,138168,345420.6
317160,202201,336,250,86,303001.55,104232,407233.55
317170,202201,237,161,76,195132,92112,287244
317180,202201,430,291,139,352692,168468,521160
317190,202201,259,188,71,227856,86052,313908
317200,202201,796,550,246,667814.64,298152,965966.64
317210,202201,176,92,84,111504,101808,213312
317220,202201,23,11,12,13332,14544,27876
320010,202201,559,403,156,488436.4,189072,677508.4
320013,202201,123,86,37,104232,44844,149076
320016,202201,264,168,96,203616.52,116352.6,319969.12
320020,202201,713,413,300,500557.89,364812,865369.89
320030,202201,163,110,53,133320.04,65448.08,198768.12
320035,202201,136,96,40,116352,48480,164832
320040,202201,492,252,240,305424,292092,597516
320050,202201,120,81,39,98172,47268,145440
320060,202201,1753,818,935,991416.6,1135645.4,2127062.0
320070,202201,102,61,41,73932,49692,123624
320080,202201,795,451,344,546612.6,416928.8,963541.4
320090,202201,1252,808,444,980508,538128,1518636
320100,202201,335,195,140,236340,169680,406020
320110,202201,122,76,46,92112.8,55752,147864.8
320115,202201,112,91,21,110292,25452,135744
320120,202201,3627,1880,1747,2282198.2,2122212.64,4404410.84
320130,202201,7776,3424,4352,4154739.92,5278263.4,9433003.32
320140,202201,434,278,156,338148.4,189072.6,527221.0
320150,202201,2100,1155,945,1401072,1147764.6,2548836.6
320160,202201,645,279,366,338148,443592.2,781740.2
320170,202201,106,81,25,98172.1,30300.02,128472.12
320180,202201,56,35,21,42420,25452,67872
320190,202201,234,146,88,176952,106656,283608
320200,202201,61,48,13,58176,15756,73932
320210,202201,892,478,414,580549.2,501768.2,1082317.4
320220,202201,298,107,191,129684,231492,361176
320225,202201,77,61,16,73932,19392,93324
320230,202201,681,431,250,522372,303000,825372
320240,202201,3511,1618,1893,1962230.4,2300377.2,4262607.6
320245,202201,492,334,158,404809.2,192708,597517.2
320250,202201,228,104,124,126048,150288,276336
320255,202201,129,99,30,119988,36360,156348
320260,202201,241,137,104,166044.18,126048.12,292092.30
320265,202201,149,116,33,140592,39996,180588
320270,202201,151,114,37,138168,44844,183012
320280,202201,1180,662,518,803557.42,629028.02,1432585.44
320290,202201,59,48,11,58176,13332,71508
320300,202201,608,409,199,495709.22,241188.96,736898.18
320305,202201,720,383,337,464196,408444.6,872640.6
320310,202201,202,117,85,141804.84,103020,244824.84
320313,202201,342,157,185,190284.6,224220,414504.6
320316,202201,109,79,30,95748,36360,132108
320320,202201,3442,1521,1921,1845877.24,2331888.42,4177765.66
320330,202201,270,196,74,237552,89688,327240
320332,202201,785,462,323,559945.4,391476.6,951422.0
320334,202201,277,153,124,185436.02,150288,335724.02
320335,202201,141,89,52,107868,64236,172104
320340,202201,566,397,169,481164.88,204828.6,685993.48
320350,202201,1051,429,622,519949.26,755076.6,1275025.86
320360,202201,171,85,86,103020,104232,207252
320370,202201,229,170,59,206040.64,73932.6,279973.24
320380,202201,294,205,89,248460.6,109080,357540.6
320390,202201,1154,678,476,821736.88,576912.2,1398649.08
320400,202201,320,226,94,273912,113928,387840
320405,202201,956,392,564,475104.6,684780.6,1159885.2
320410,202201,960,480,480,581760,581760.6,1163520.6
320420,202201,533,251,282,305424.2,342996,648420.2
320425,202201,194,108,86,130896,104232,235128
320430,202201,379,196,183,237552.6,221796,459348.6
320435,202201,164,111,53,134532,64236,198768
320440,202201,206,114,92,138168.24,111504.2,249672.44
320450,202201,131,72,59,87264,71508,158772
320455,202201,234,185,49,224220,59388,283608
320460,202201,285,177,108,214524,130896,345420
320465,202201,113,76,37,92112,44844,136956
320470,202201,709,428,281,518736.6,340572,859308.6
320480,202201,199,132,67,159984,82416,242400
320490,202201,3202,1504,1698,1826487.51,2059191.7,3885679.21
320495,202201,114,65,49,78780,59388.6,138168.6
320500,202201,9757,4726,5031,5735195.8,6108483.12,11843678.92
320501,202201,549,273,276,330876,335724,666600
320503,202201,294,206,88,249672.06,106656.02,356328.08
320506,202201,254,179,75,216948,90900,307848
320510,202201,1153,504,649,610848.4,789012,1399860.4
320515,202201,79,60,19,72720,23028,95748
320517,202201,214,151,63,183012,76356,259368
320520,202201,7430,3098,4332,3758414.88,5255239.2,9013654.08
320530,202201,6692,3196,3496,3875956.86,4244428.4,8120385.26
330010,202201,3248,1613,1635,1956170.4,1981621.2,3937791.6
330015,202201,198,84,114,101808.64,138168,239976.64
330020,202201,3850,1524,2326,1850725.96,2821536.6,4672262.56
330022,202201,266,131,135,158772,163620,322392
330023,202201,710,206,504,249672,612060,861732
330025,202201,645,117,528,141804,642360.6,784164.6
330030,202201,1826,1126,700,1364712.6,850824.6,2215537.2
330040,202201,2530,1276,1254,1546512.4,1527120.5,3073632.9
330045,202201,9788,2866,6922,3474806.5,8401585.4,11876391.9
330050,202201,869,544,325,660540,393900,1054440
330060,202201,1096,644,452,780528.8,547824,1328352.8
330070,202201,4125,1405,2720,1704073.8,3303912.4,5007986.2
330080,202201,1589,684,905,829008.8,1096860,1925868.8
330090,202201,398,222,176,271488,213312.6,484800.6
330093,202201,250,104,146,126048,176952,303000
330095,202201,67,41,26,49692,31512,81204
330100,202201,10285,5042,5243,6112121.4,6367850,12479971.4
330110,202201,463,205,258,248460.8,313908,562368.8
330115,202201,520,264,256,321180,310272,631452
330120,202201,391,203,188,246036,227856.4,473892.4
330130,202201,1586,402,1184,487224.6,1437432,1924656.6
330140,202201,653,341,312,413292,378144,791436
330150,202201,511,290,221,351480,267852,619332
330160,202201,204,116,88,140592,106656,247248
330170,202201,27245,9112,18133,11059506.52,22012351.6,33071858.12
330180,202201,256,131,125,158772,151500,310272
330185,202201,1039,354,685,429048,830220,1259268
330187,202201,487,151,336,183013.2,409656,592669.2
330190,202201,6172,2251,3921,2729425.4,4754677.8,7484103.2
330200,202201,4673,1419,3254,1719829.78,3951120.6,5670950.38
330205,202201,451,251,200,304212,242400.6,546612.6
330210,202201,958,568,390,688417.2,472681.37,1161098.57
330220,202201,2739,1589,1150,1928294.38,1396225.2,3324519.58
330225,202201,570,291,279,352692.4,340572,693264.4
330227,202201,2447,735,1712,890820,2076157,2966977
330230,202201,266,142,124,172104,150288,322392
330240,202201,4105,1941,2164,2354918,2622769.6,4977687.6
330245,202201,150,64,86,77568.36,105444,183012.36
330250,202201,6726,3238,3488,3929306,4233516.24,8162822.24
330260,202201,707,190,517,230280,626604.6,856884.6
330270,202201,3827,1203,2624,1459248.4,3182715.4,4641963.8
330280,202201,444,276,168,335726.4,204828.12,540554.52
330285,202201,6800,2089,4711,2536717,5719431.2,8256148.2
330290,202201,706,245,461,296940.8,558732,855672.8
330300,202201,748,468,280,567961.36,339360.6,907321.96
330310,202201,457,251,206,304212.6,249672,553884.6
330320,202201,7976,2815,5161,3415418.8,6261193.2,9676612.0
330330,202201,9397,3445,5952,4182616.22,7222311.06,11404927.28
330340,202201,2681,1505,1176,1827696,1425312,3253008
330350,202201,19610,7152,12458,8675503.19,15131829.38,23807332.57
330360,202201,2098,978,1120,1185338,1359864,2545202
330370,202201,982,493,489,598729,593880,1192609
330380,202201,939,379,560,459348,679932.4,1139280.4
330385,202201,622,306,316,370872,384204,755076
330390,202201,5922,3024,2898,3672362.2,3516013.2,7188375.4
330395,202201,345,210,135,255732,163620.8,419352.8
330400,202201,705,346,359,420564.4,435108,855672.4
330410,202201,508,361,147,437532.4,178164,615696.4
330411,202201,282,145,137,175740.28,166044,341784.28
330412,202201,226,93,133,112716,161196,273912
330414,202201,5402,2115,3287,2563381.52,3987481.2,6550862.72
330415,202201,613,261,352,316333.4,426624.4,742957.8
330420,202201,2334,1181,1153,1431372.9,1397436,2828808.9
330430,202201,1796,756,1040,917484.6,1261694.4,2179179.0
330440,202201,338,159,179,192708.6,216948,409656.6
330450,202201,113,49,64,59388,77568,136956
330452,202201,2293,964,1329,1169581.6,1614384.6,2783966.2
330455,202201,120212,40491,79721,49111658.54,96741971.77,145853630.31
330460,202201,251,109,142,132108,174528,306636
330470,202201,1236,661,575,803557.8,696902,1500459.8
330475,202201,1734,489,1245,592668,1510153.2,2102821.2
330480,202201,801,439,362,532068,439956.4,972024.4
330490,202201,15822,4860,10962,5896498.6,13298064.6,19194563.2
330500,202201,1478,633,845,767196,1025352.24,1792548.24
330510,202201,11074,3722,7352,4519550,8919110.8,13438660.8
330513,202201,101,51,50,61812,60600,122412
330515,202201,743,308,435,374508.2,527220.4,901728.6
330520,202201,2548,864,1684,1047168,2044644,3091812
330530,202201,194,108,86,130896,105444.4,236340.4
330540,202201,336,169,167,204828,202404,407232
330550,202201,2838,961,1877,1165945.52,2280984.6,3446930.12
330555,202201,865,321,544,389052,660541.2,1049593.2
330560,202201,720,238,482,288456,584184,872640
330570,202201,292,203,89,246036,107868,353904
330575,202201,809,284,525,345420,636300.4,981720.4
330580,202201,3365,1800,1565,2186449.8,1899204.6,4085654.4
330590,202201,263,135,128,163620.18,156348,319968.18
330600,202201,1272,759,513,919908.6,622968,1542876.6
330610,202201,1631,847,784,1027778.6,951420.8,1979199.4
330615,202201,224,181,43,219372.6,52116.6,271489.2
330620,202201,1047,395,652,482377,790224,1272601
330630,202201,4311,2580,1731,3131810.6,2102821.4,5234632.0
350010,202201,595,391,204,473893.6,247248,721141.6
350020,202201,54,17,37,20604,44844,65448
350030,202201,530,325,205,393900.6,248460,642360.6
350040,202201,124,50,74,61812,89688,151500
350050,202201,346,175,171,213312,207252,420564
350055,202201,117,51,66,61812,79992,141804
350060,202201,88,35,53,42420,64236,106656
350070,202201,789,450,339,545401.66,412080.4,957482.06
350075,202201,71,43,28,52116,33936,86052
350080,202201,58,25,33,30300,39996,70296
350090,202201,84,47,37,56964,44844,101808
350100,202201,268,164,104,198768,126048,324816
350110,202201,46,31,15,37572,18180,55752
350115,202201,159,90,69,109080,83628.6,192708.6
350120,202201,107,68,39,82416,47268,129684
350130,202201,389,165,224,199980.03,271488,471468.03
350140,202201,38,23,15,27876,18180,46056
350150,202201,68,49,19,60600,23028,83628
350160,202201,2412,941,1471,1140492.6,1782853.8,2923346.4
350170,202201,393,223,170,270276.6,206040.6,476317.2
350180,202201,166,95,71,115140,86052.6,201192.6
350190,202201,1017,540,477,654484.19,578124.93,1232609.12
350200,202201,64,25,39,30300.4,47268,77568.4
350210,202201,1310,710,600,860521.2,727200.95,1587722.15
350220,202201,637,520,117,630240.95,141804,772044.95
350230,202201,74,49,25,59388,30300,89688
350240,202201,56,36,20,43632,24240,67872
350250,202201,1139,518,621,627817.6,752653.4,1380471.0
350260,202201,97,68,29,82416,35148,117564
350270,202201,955,633,322,767197.2,390264.88,1157462.08
350275,202201,306,117,189,141804,230280,372084
350280,202201,4491,2175,2316,2637316.2,2808204,5445520.2
350290,202201,468,200,268,242400,324816.6,567216.6
350300,202201,49,24,25,30300,30300,60600
350310,202201,74,45,29,54540,35148,89688
350315,202201,68,28,40,33936,48480,82416
350320,202201,3380,1599,1781,1939201,2160997.39,4100198.39
350330,202201,1675,864,811,1047172.3,982932,2030104.3
350335,202201,16,10,6,12120,7272,19392
350340,202201,124,51,73,61812,88476.2,150288.2
350350,202201,101,50,51,60600,61812,122412
350360,202201,107,70,37,84840,44844,129684
350370,202201,81,43,38,52116.95,47268,99384.95
350380,202201,783,324,459,395112.4,556308,951420.4
350390,202201,1727,624,1103,756288.9,1339260,2095548.9
350395,202201,20,16,4,19392,4848,24240
350400,202201,1709,822,887,996267.65,1077468,2073735.65
350410,202201,2957,1230,1727,1491972.6,2096761.55,3588734.15
350420,202201,263,152,111,184225.2,134532,318757.2
350430,202201,90,46,44,55752,53328,109080
350440,202201,149,108,41,130896,49692,180588
350450,202201,1736,962,774,1168369.95,939300.2,2107670.15
350460,202201,391,135,256,163620,310272,473892
350470,202201,20,12,8,14544,9696,24240
350480,202201,200,105,95,127260,115140.6,242400.6
350490,202201,241,110,131,133320,158772,292092
350500,202201,56,24,32,29088,38784,67872
350510,202201,154,92,62,111504,75144,186648
350520,202201,440,224,216,271488,261792,533280
350530,202201,434,204,230,248460,281184,529644
350535,202201,88,62,26,76356,31512,107868
350540,202201,367,195,172,236340,209676,446016
350550,202201,2740,1548,1192,1877388,1447129.9,3324517.9
350560,202201,577,390,187,473892,226644,700536
350570,202201,4467,1794,2673,2177966.55,3246949.15,5424915.70
350580,202201,369,176,193,213312,233916,447228
350590,202201,960,515,445,625392.2,540552.6,1165944.8
350600,202201,6284,2916,3368,3537832.87,4089289.2,7627122.07
350610,202201,1505,773,732,939300.6,887184,1826484.6
350620,202201,25,15,10,18180,12120,30300
350630,202201,249,125,124,151500,150288,301788
350635,202201,1100,430,670,521161.56,816888.6,1338050.16
350640,202201,112,84,28,101808,33936,135744
350650,202201,1876,1234,642,1496820,778104,2274924
350660,202201,753,295,458,358752,555096,913848
350670,202201,296,145,151,175740,183012,358752
350680,202201,169,82,87,99384,105444.6,204828.6
350690,202201,198,90,108,110292,130896,241188
350700,202201,852,398,454,482376.6,552672,1035048.6
350710,202201,405,149,256,181800,310272.6,492072.6
350715,202201,56,44,12,53328,14544,67872
350720,202201,17,10,7,12120,8484,20604
350730,202201,43,25,18,30300,21816,52116
350740,202201,233,128,105,155136,127260,282396
350745,202201,29,12,17,14544,20604,35148
350750,202201,2356,1377,979,1671349.2,1188972,2860321.2
350760,202201,3807,1567,2240,1902840.6,2720940,4623780.6
350770,202201,56,37,19,44844,23028,67872
350775,202201,47,34,13,41208,15756,56964
350780,202201,434,222,212,269064,256944,526008
350790,202201,366,151,215,183012,260580,443592
350800,202201,514,308,206,373296,252096,625392
350810,202201,506,390,116,472680.37,140592,613272.37
350820,202201,94,53,41,64236,49692,113928
350830,202201,72,39,33,47268,39996,87264
350840,202201,785,316,469,382992.6,568428,951420.6
350850,202201,1827,956,871,1162309.2,1058076.6,2220385.8
350860,202201,650,338,312,409657,380568,790225
350870,202201,440,291,149,353904,180588,534492
350880,202201,273,156,117,189072,141804,330876
350890,202201,39,24,15,29088,18180,47268
350900,202201,1602,475,1127,576912.8,1369560.95,1946473.75
350910,202201,24,13,11,15756,13332,29088
350920,202201,749,392,357,475104,432684,907788
350925,202201,1162,603,559,730836.32,677509.31,1408345.63
350930,202201,108,56,52,67872,63024,130896
350940,202201,737,384,353,465408,427836.6,893244.6
350945,202201,110,78,32,94536,38784,133320
350950,202201,17230,7839,9391,9510575.49,11400076.6,20910652.09
350960,202201,1563,630,933,765984.6,1133220,1899204.6
350970,202201,1080,536,544,649503.18,660540,1310043.18
350980,202201,97,65,32,78780,38784,117564
350990,202201,380,133,247,163620.6,299364,462984.6
350995,202201,41,18,23,21816,27876,49692
351000,202201,610,403,207,489648.95,252096,741744.95
351010,202201,50,32,18,38784,21816,60600
351015,202201,45,31,14,37572,16968,54540
351020,202201,1495,879,616,1066560.6,747804,1814364.6
351030,202201,341,203,138,247248,167256,414504
351040,202201,957,483,474,585398.12,576912.7,1162310.82
351050,202201,3464,1528,1936,1851940,2348857.2,4200797.2
351060,202201,5802,2080,3722,2522176.08,4514700.6,7036876.68
351070,202201,394,246,148,298154.31,179376,477530.31
351080,202201,719,517,202,626605.2,244824,871429.2
351090,202201,46,21,25,25452,31512,56964
351100,202201,421,228,193,276336.92,233916,510252.92
351110,202201,2061,950,1111,1152614.18,1348956.6,2501570.78
351120,202201,64,34,30,41208,36360,77568
351130,202201,189,61,128,73932,155136,229068
351140,202201,318,193,125,233916,151500,385416
351150,202201,476,237,239,287244.2,289669.2,576913.4
351160,202201,281,169,112,204828.72,135744,340572.72
351170,202201,205,105,100,127260,121200,248460
351190,202201,93,59,34,71508,41208,112716
351200,202201,346,219,127,265428.8,155136,420564.8
351210,202201,117,57,60,69084,72720,141804
351220,202201,547,318,229,385416.6,277548,662964.6
351230,202201,281,192,89,232704,107868,340572
351240,202201,238,111,127,134532,153924,288456
351250,202201,83,55,28,66660.82,33936,100596.82
351260,202201,152,109,43,132108,52116,184224
351270,202201,43,18,25,21816,30300,52116
351280,202201,1048,480,568,582972.95,689628.93,1272601.88
351290,202201,245,110,135,133320,163620,296940
351300,202201,3872,1643,2229,1994858.85,2706396.6,4701255.45
351310,202201,745,358,387,436320,469044,905364
351320,202201,117,65,52,78780,63024.6,141804.6
351330,202201,38,24,14,29088,16968,46056
351340,202201,1356,757,599,921121.6,725989.2,1647110.8
351350,202201,2353,1340,1013,1625294.04,1228968.2,2854262.24
351360,202201,798,371,427,449652,517524,967176
351370,202201,396,189,207,229068.6,250884,479952.6
351380,202201,8883,3823,5060,4634694.36,6137571.75,10772266.11
351385,202201,29,18,11,21816,13332,35148
351390,202201,276,207,69,250884.36,84840,335724.36
351400,202201,64,43,21,52116,25452,77568
351410,202201,453,273,180,330876.8,218160,549036.8
351420,202201,66,47,19,56964,24240,81204
351430,202201,73,39,34,47268,41208,88476
351440,202201,782,522,260,632668.3,315120,947788.3
351450,202201,268,125,143,151500,173316,324816
351460,202201,127,56,71,67872.6,86052,153924.6
351470,202201,144,76,68,93324,82416,175740
351480,202201,480,279,201,338149.15,243612,581761.15
351490,202201,288,103,185,126048,224220,350268
351492,202201,28,17,11,20604,13332,33936
351495,202201,26,18,8,21816,9696,31512
351500,202201,3508,1408,2100,1706497.8,2548837.84,4255335.64
351510,202201,2057,734,1323,889609.2,1603476,2493085.2
351512,202201,14,10,4,12120,4848,16968
351515,202201,197,116,81,140592,98172,238764
351518,202201,702,417,285,505404,345420.6,850824.6
351519,202201,81,45,36,54540,43632,98172
351520,202201,160,95,65,115140,78801.81,193941.81
351530,202201,22,13,9,15756,10908,26664
351535,202201,135,82,53,99384,64236,163620
351540,202201,463,311,152,376932.16,185436,562368.16
351550,202201,1470,856,614,1037475.1,744168,1781643.1
351560,202201,76,46,30,55752,36360,92112
351565,202201,13,6,7,7272,8484,15756
351570,202201,2747,1259,1488,1528332.6,1805880,3334212.6
351580,202201,39,33,6,39996,7272,47268
351590,202201,62,40,22,48480,26664,75144
351600,202201,177,128,49,155136,59388,214524
351610,202201,53,24,29,29088,35148,64236
351620,202201,5843,3115,2728,3787504.27,3306338.41,7093842.68
351630,202201,3158,1506,1652,1830120.4,2005860.6,3835981.0
351640,202201,2269,969,1300,1175640.6,1576813.55,2752454.15
351650,202201,29,24,5,29088,6060,35148
351660,202201,133,84,49,101808,59388,161196
351670,202201,721,420,301,509041.8,364812,873853.8
351680,202201,77,59,18,71508,21816,93324
351685,202201,11,8,3,9696,3636,13332
351690,202201,302,201,101,243612.3,122412,366024.3
351700,202201,174,113,61,137217,73932,211149
351710,202201,66,41,25,49692,30300,79992
351720,202201,129,70,59,84840,71508,156348
351730,202201,110,70,40,84840,48480,133320
351740,202201,769,485,284,589034.6,344208.6,933243.2
351750,202201,372,145,227,175740.96,276336,452076.96
351760,202201,723,554,169,672660,204828,877488
351770,202201,295,240,55,290880,66660,357540
351780,202201,153,93,60,112716,72720,185436
351790,202201,262,133,129,162408,156348,318756
351800,202201,39,24,15,29088,18180,47268
351810,202201,121,79,42,96960,50904,147864
351820,202201,781,555,226,673873.4,273912,947785.4
351830,202201,597,188,409,230280,496920,727200
351840,202201,2121,969,1152,1175642.36,1396224,2571866.36
351850,202201,227,155,72,187860,87264,275124
351860,202201,631,421,210,510253.92,254520,764773.92
351870,202201,5703,2555,3148,3101512.7,3822651.12,6924163.82
351880,202201,20909,7987,12922,9691157.2,15688131.56,25379288.76
351885,202201,87,48,39,58176,47268,105444
351890,202201,68,49,19,59388,23028,82416
351900,202201,224,123,101,149076,122412,271488
351905,202201,97,43,54,52116,65448,117564
351907,202201,3617,1457,2160,1765885.36,2623980.2,4389865.56
351910,202201,166,68,98,82416.01,118776,201192.01
351920,202201,111,60,51,72720,61812,134532
351925,202201,90,56,34,67872,41208,109080
351930,202201,418,270,148,327240,179376,506616
351940,202201,237,97,140,117564,169680,287244
351950,202201,139,72,67,87264,81204,168468
351960,202201,930,447,483,541764.95,585396.6,1127161.55
351970,202201,2066,988,1078,1197456.6,1308960.6,2506417.2
351980,202201,157,68,89,82416,107868,190284
351990,202201,255,161,94,195133.2,115140,310273.2
352000,202201,324,202,122,244825.2,147864,392689.2
352010,202201,423,267,156,324894,189072,513966
352020,202201,191,67,124,81204,150288,231492
352030,202201,1140,547,593,664176,718716,1382892
352040,202201,609,239,370,289668,448440,738108
352042,202201,304,71,233,86052,282397.2,368449.2
352044,202201,358,208,150,252097.2,181800,433897.2
352050,202201,3268,1187,2081,1439857.32,2523384,3963241.32
352060,202201,101,57,44,69084,54540,123624
352070,202201,93,65,28,78781.9,33936,112717.9
352080,202201,65,42,23,50904,27876,78780
352090,202201,165,109,56,132108,69084,201192
352100,202201,284,131,153,158772,185436.6,344208.6
352110,202201,115,36,79,43632,95748,139380
352115,202201,64,20,44,24240,54540,78780
352120,202201,73,49,24,59388.95,29088,88476.95
352130,202201,217,166,51,201192,63024,264216
352140,202201,178,80,98,96960,119988,216948
352150,202201,127,67,60,81204,72720,153924
352160,202201,141,91,50,110292,60600,170892
352170,202201,393,267,126,323604.6,153924,477528.6
352180,202201,677,408,269,495709.55,326028.6,821738.15
352190,202201,241,97,144,117564,176952,294516
352200,202201,28,10,18,12120,21816,33936
352210,202201,4341,1709,2632,2072521.37,3193621,5266142.37
352215,202201,72,39,33,47268,39996,87264
352220,202201,6458,2376,4082,2880925.2,4948598.55,7829523.75
352230,202201,3429,2176,1253,2643377.2,1521063.09,4164440.29
352240,202201,2616,1466,1150,1779217.6,1395012.6,3174230.2
352250,202201,3201,1420,1781,1721044.96,2159784.6,3880829.56
352260,202201,1008,537,471,652056,570852.6,1222908.6
352265,202201,61,32,29,38784,35148,73932
352270,202201,376,206,170,249672,206040.6,455712.6
352280,202201,489,290,199,351480.95,241188,592668.95
352290,202201,171,97,74,117564,89688,207252
352300,202201,100,65,35,78780,42420,121200
352310,202201,6860,2931,3929,3554801.12,4766798.28,8321599.40
352320,202201,1141,579,562,701749.2,683568,1385317.2
352330,202201,540,269,271,326028.6,328452,654480.6
352340,202201,1366,616,750,746594.55,911426.4,1658020.95
352350,202201,359,199,160,241188,193920,435108
352360,202201,227,101,126,122412,152712,275124
352370,202201,112,67,45,81204,54540,135744
352380,202201,109,76,33,92112,39996,132108
352390,202201,2610,1113,1497,1350170,1818001.28,3168171.28
352400,202201,529,225,304,272700,368448.6,641148.6
352410,202201,916,602,314,729625.31,380568.6,1110193.91
352420,202201,89,67,22,81204,26664,107868
352430,202201,1772,778,994,942940.65,1205941.9,2148882.55
352440,202201,3356,1550,1806,1879815.65,2196144.2,4075959.85
352450,202201,202,154,48,186648,59388,246036
352460,202201,633,314,319,380568,387840,768408
352470,202201,651,228,423,276337,513888,790225
352480,202201,1525,832,693,1008384,841128.6,1849512.6
352490,202201,47,15,32,18180,38784,56964
352500,202201,1288,520,768,630240,930816,1561056
352510,202201,702,362,340,439956.6,412080.6,852037.2
352520,202201,850,348,502,424200,609637.2,1033837.2
352530,202201,1817,932,885,1132009.62,1072620.6,2204630.22
352540,202201,66,43,23,52116,27876,79992
352550,202201,199,114,85,138168,103020,241188
352560,202201,47,38,9,46056,10908,56964
352570,202201,724,336,388,407234.15,470256,877490.15
352580,202201,55,42,13,50904,15756,66660
352585,202201,21,5,16,6060,19392,25452
352590,202201,4360,2107,2253,2557323.15,2735591.6,5292914.75
352600,202201,356,245,111,296940,134532,431472
352610,202201,912,404,508,489648,616908,1106556
352620,202201,1081,400,681,486012,826584,1312596
352630,202201,187,72,115,87264,139380,226644
352640,202201,513,330,183,401172,223008.6,624180.6
352650,202201,86,64,22,77568,26664,104232
352660,202201,66,37,29,44844,35148,79992
352670,202201,1699,888,811,1076257.55,985356,2061613.55
352680,202201,930,567,363,687204.4,441168.95,1128373.35
352690,202201,4627,2014,2613,2442184.3,3169381.55,5611565.85
352700,202201,91,51,40,61812,48480,110292
352710,202201,1477,753,724,912636,878700.6,1791336.6
352720,202201,1501,646,855,782952,1037472,1820424
352725,202201,25,20,5,24240,6060,30300
352730,202201,389,181,208,220584,252096,472680
352740,202201,395,255,140,309061.84,169680.49,478742.33
352750,202201,23,15,8,18180,9696,27876
352760,202201,213,134,79,162408,95748,258156
352770,202201,81,61,20,73932,24240,98172
352780,202201,75,38,37,46056,44844,90900
352790,202201,25,17,8,20604,9696,30300
352800,202201,233,175,58,212100,70296,282396
352810,202201,161,99,62,121200,75144,196344
352820,202201,44,33,11,39996,13332,53328
352830,202201,76,50,26,60600,31512,92112
352840,202201,686,305,381,370872,462984,833856
352850,202201,1718,514,1204,622968,1460460,2083428
352860,202201,111,70,41,84840,49692,134532
352870,202201,50,30,20,36360,24240,60600
352880,202201,177,106,71,128472,86052,214524
352885,202201,33,22,11,26664,13332,39996
352890,202201,51,33,18,39996,21816.6,61812.6
352900,202201,4670,2176,2494,2639737.2,3027576.2,5667313.4
352910,202201,38,31,7,37572,8484,46056
352920,202201,638,364,274,441168,332088,773256
352930,202201,1192,553,639,671449.2,774468,1445917.2
352940,202201,6215,2369,3846,2880927.96,4671048.6,7551976.56
352950,202201,113,43,70,52116,84840,136956
352960,202201,64,38,26,46056,31512,77568
352965,202201,15,8,7,9696,8484,18180
352970,202201,514,375,139,454500,170892,625392
352980,202201,160,90,70,109080,84840,193920
352990,202201,973,450,523,546612,633876,1180488
353000,202201,55,23,32,27876,38784,66660
353010,202201,519,315,204,381780,247248,629028
353020,202201,315,216,99,261792,119988,381780
353030,202201,1360,590,770,716292.96,933240,1649532.96
353040,202201,80,39,41,47268,49692,96960
353050,202201,1304,848,456,1027777.37,552672,1580449.37
353060,202201,8740,3645,5095,4421384.54,6181200,10602584.54
353070,202201,1875,1097,778,1330778.15,943932.26,2274710.41
353080,202201,1301,695,606,842342.04,734472,1576814.04
353090,202201,60,32,28,38784,33936,72720
353100,202201,42,33,9,39996,10908,50904
353110,202201,2189,688,1501,836281.8,1820424.2,2656706.0
353120,202201,123,66,57,79992.32,69084,149076.32
353130,202201,865,406,459,492073.23,556308,1048381.23
353140,202201,571,241,330,292092.95,399960,692052.95
353150,202201,330,175,155,212100.95,187860.6,399961.55
353160,202201,105,79,26,95748,31512,127260
353170,202201,206,64,142,77568,173316,250884
353180,202201,1161,515,646,625393.4,782952.6,1408346.0
353190,202201,488,344,144,416929.4,174528,591457.4
353200,202201,243,115,128,140592,155136,295728
353205,202201,20,13,7,15756,8484,24240
353210,202201,66,39,27,47268,32724,79992
353215,202201,40,23,17,27876,20604,48480
353220,202201,85,45,40,54540,48480,103020
353230,202201,154,64,90,77569,109080,186649
353240,202201,357,164,193,198768,233916,432684
353250,202201,199,96,103,116352,124836,241188
353260,202201,453,295,158,357540.28,191496,549036.28
353270,202201,72,54,18,65448,21816,87264
353280,202201,105,49,56,59388.4,67872,127260.4
353282,202201,125,87,38,105444,47268,152712
353284,202201,27,18,9,21816,10908,32724
353286,202201,6,1,5,1212,6060,7272
353290,202201,85,45,40,54540,48480,103020
353300,202201,439,223,216,270277.55,261792,532069.55
353310,202201,40,34,6,41208,7272,48480
353320,202201,39,23,16,27876,19392,47268
353325,202201,46,26,20,31512.6,24240,55752.6
353330,202201,61,41,20,49692.8,24240,73932.8
353340,202201,647,219,428,266640,518736.6,785376.6
353350,202201,898,428,470,518737.2,569640,1088377.2
353360,202201,104,80,24,96960,29088,126048
353370,202201,112,64,48,77568,58176,135744
353380,202201,28,14,14,16968,16968,33936
353390,202201,1118,522,596,632664,724776,1357440
353400,202201,47,28,19,33936,23028,56964
353410,202201,112,64,48,77568,58176.6,135744.6
353420,202201,54,22,32,26664,38784,65448
353430,202201,577,377,200,456925.45,243612,700537.45
353440,202201,12213,5159,7054,6266043.19,8556721.4,14822764.59
353450,202201,56,29,27,35148,32724,67872
353460,202201,624,317,307,384204.4,372084,756288.4
353470,202201,2276,1099,1177,1333200.83,1427736,2760936.83
353475,202201,266,172,94,208464.6,113928,322392.6
353480,202201,172,138,34,167256,41208,208464
353490,202201,224,133,91,161196,111504.6,272700.6
353500,202201,214,119,95,145440,115140,260580
353510,202201,80,55,25,66660,31512,98172
353520,202201,229,166,63,201192,76356.6,277548.6
353530,202201,460,234,226,283608,276336,559944
353540,202201,405,251,154,305424,186648,492072
353550,202201,717,442,275,536916.95,334512.6,871429.55
353560,202201,564,223,341,270276,413292.4,683568.4
353570,202201,62,38,24,46056,29088,75144
353580,202201,346,236,110,286032,134532,420564
353590,202201,85,60,25,72720,30300,103020
353600,202201,271,156,115,189072.95,139380,328452.95
353610,202201,127,66,61,81204,73932,155136
353620,202201,677,334,343,404808.6,415716,820524.6
353625,202201,54,29,25,35148,30300,65448
353630,202201,224,160,64,193920.52,77568,271488.52
353640,202201,122,79,43,95748,52116,147864
353650,202201,996,375,621,454500,752652,1207152
353657,202201,23,19,4,23028,4848,27876
353660,202201,284,145,139,176952,168468,345420
353670,202201,708,409,299,496920.95,362388.6,859309.55
353680,202201,129,87,42,105444,50904,156348
353690,202201,41,28,13,33936,15756,49692
353700,202201,282,193,89,233916.8,107868,341784.8
353710,202201,487,228,259,277548,313909.2,591457.2
353715,202201,48,29,19,35148,23028,58176
353720,202201,343,154,189,186648.6,229068,415716.6
353730,202201,1173,716,457,867792.6,553884,1421676.6
353740,202201,614,335,279,406020.8,338148.8,744169.6
353750,202201,72,40,32,48480,38784,87264
353760,202201,3215,1189,2026,1444705.24,2457937.9,3902643.14
353770,202201,79,63,16,76356,19392,95748
353780,202201,1332,597,735,723564.95,894456.6,1618021.55
353790,202201,483,286,197,346632.84,239976,586608.84
353800,202201,3586,1670,1916,2025279.6,2324617.2,4349896.8
353810,202201,224,111,113,135744,136956,272700
353820,202201,236,96,140,116352,169680.6,286032.6
353830,202201,62,49,13,60600,15756,76356
353850,202201,194,87,107,105444,130896,236340
353860,202201,530,227,303,276336.09,367236,643572.09
353870,202201,5594,2788,2806,3383907.42,3409358.64,6793266.06
353880,202201,711,457,254,553884,307848,861732
353890,202201,566,326,240,395112,290881.2,685993.2
353900,202201,131,68,63,82416,76356,158772
353910,202201,193,78,115,95748,139380,235128
353920,202201,423,222,201,269064.2,243612,512676.2
353930,202201,1057,611,446,740532,542977.2,1283509.2
353940,202201,195,95,100,115140,122412,237552
353950,202201,486,303,183,367236,221796,589032
353960,202201,74,60,14,72720,16968,89688
353970,202201,40,27,13,32724,15756,48480
353980,202201,1835,816,1019,990205.2,1241089.4,2231294.6
353990,202201,77,44,33,53328,41208,94536
354000,202201,376,170,206,206040,249672,455712
354010,202201,91,52,39,63024,47268,110292
354020,202201,509,317,192,384204,232704,616908
354025,202201,35,30,5,36360,6060,42420
354030,202201,47,27,20,32724,24240,56964
354040,202201,100,74,26,89688,32724,122412
354050,202201,174,93,81,112717.6,98172,210889.6
354060,202201,766,352,414,426624,502980,929604
354070,202201,931,525,406,636300.6,493284,1129584.6
354075,202201,181,84,97,101808,117564,219372
354080,202201,308,135,173,163620,209676,373296
354085,202201,22,12,10,14544,12120,26664
354090,202201,267,162,105,196241.6,127260,323501.6
354100,202201,5857,2347,3510,2845776.8,4262607.56,7108384.36
354105,202201,98,47,51,56964,61812,118776
354110,202201,43,20,23,24240,27876,52116
354120,202201,152,98,54,118776.19,65448,184224.19
354130,202201,719,433,286,524797.56,346632,871429.56
354140,202201,3236,1430,1806,1734372.6,2193720.6,3928093.2
354150,202201,631,360,271,438745.32,328452,767197.32
354160,202201,655,408,247,494496.2,299365.56,793861.76
354165,202201,15,13,2,15756,2424,18180
354170,202201,174,121,53,146652,64236,210888
354180,202201,57,33,24,41208,29088,70296
354190,202201,198,78,120,94536,145440,239976
354200,202201,107,55,52,66660,63024,129684
354210,202201,69,28,41,33936,49692,83628
354220,202201,622,390,232,473892.95,284820,758712.95
354230,202201,168,71,97,86052.4,117564,203616.4
354240,202201,329,207,122,250884.75,147864,398748.75
354250,202201,80,48,32,58176,38784,96960
354260,202201,2176,1005,1171,1218061.56,1421677.96,2639739.52
354270,202201,91,63,28,76356,33936,110292
354280,202201,53,28,25,33936,30300,64236
354290,202201,140,94,46,113928,55752,169680
354300,202201,352,246,106,299365.35,129684,429049.35
354310,202201,89,63,26,76356.6,31512,107868.6
354320,202201,219,108,111,130896,134532,265428
354323,202201,7,7,0,8484,,8484.0
354325,202201,123,67,56,81204.5,67872,149076.5
354330,202201,2433,803,1630,974275.8,1975560.6,2949836.4
354340,202201,10454,4753,5701,5765232.75,6919312,12684544.75
354350,202201,135,89,46,107868,55752,163620
354360,202201,71,41,30,49692,36360,86052
354370,202201,236,119,117,144228,141804,286032
354380,202201,171,98,73,118776,88476,207252
354390,202201,2734,959,1775,1164735.04,2152512.6,3317247.64
354400,202201,305,165,140,199980,169680,369660
354410,202201,650,289,361,350268.96,437532.6,787801.56
354420,202201,275,175,100,212100,121200,333300
354425,202201,325,179,146,217004,176952,393956
354430,202201,184,101,83,122412,101808,224220
354440,202201,32,26,6,31512,7272,38784
354450,202201,57,37,20,44844.6,24240,69084.6
354460,202201,96,55,41,66660,49692,116352
354470,202201,26,13,13,15756,15756,31512
354480,202201,110,57,53,69084,64236,133320
354490,202201,137,81,56,98172,67872,166044
354500,202201,403,178,225,216948,272700,489648
354510,202201,90,60,30,72720,36360,109080
354515,202201,45,12,33,14544,39996,54540
354520,202201,1613,679,934,823988.2,1132008.2,1955996.4
354530,202201,839,406,433,492073.4,526008,1018081.4
354540,202201,267,133,134,161196,162408,323604
354550,202201,37,21,16,25452,19392,44844
354560,202201,150,80,70,96960,84840,181800
354570,202201,135,92,43,111504,52116,163620
354580,202201,1844,859,985,1043533.8,1197456.6,2240990.4
354600,202201,275,134,141,163620,170892,334512
354610,202201,67,54,13,65448,15756,81204
354620,202201,64,17,47,20604,56964,77568
354625,202201,12,8,4,9696,4848,14544
354630,202201,318,203,115,246036,139380,385416
354640,202201,830,499,331,604788.2,402384,1007172.2
354650,202201,64,36,28,43632,33936,77568
354660,202201,806,591,215,716292.95,260580,976872.95
354670,202201,222,82,140,99384,170892,270276
354680,202201,1316,462,854,559944,1038684,1598628
354690,202201,70,46,24,55752.6,29088,84840.6
354700,202201,76,52,24,63024,29088,92112
354710,202201,46,31,15,37572,18180,55752
354720,202201,21,20,1,24240,1212,25452
354730,202201,1808,720,1088,872640.6,1319868,2192508.6
354740,202201,74,50,24,60600,29088,89688
354750,202201,412,233,179,283608,216948,500556
354760,202201,488,300,188,363601.2,227856,591457.2
354765,202201,7,2,5,3636,6060,9696
354770,202201,343,223,120,270276,145440,415716
354780,202201,8376,3086,5290,3742661.68,6422390.04,10165051.72
354790,202201,89,54,35,65448,42420,107868
354800,202201,432,232,200,281135.93,243612,524747.93
354805,202201,82,38,44,46056.6,53328,99384.6
354810,202201,101,55,46,66660,55752,122412
354820,202201,209,83,126,100596.64,152712,253308.64
354830,202201,44,22,22,26664,26664,53328
354840,202201,56,38,18,46056,21816,67872
354850,202201,4510,1935,2575,2354919.08,3123324.06,5478243.14
354860,202201,341,157,184,190284,223008,413292
354870,202201,11999,5120,6879,6212721.22,8345837.2,14558558.42
354880,202201,2687,961,1726,1165945.46,2091969.36,3257914.82
354890,202201,2934,1527,1407,1851938.75,1705284.4,3557223.15
354900,202201,63,42,21,50904,25452,76356
354910,202201,1289,651,638,791436.8,774468,1565904.8
354920,202201,39,32,7,38784,8484,47268
354925,202201,20,10,10,12120,12120,24240
354930,202201,35,30,5,36360.2,6060,42420.2
354940,202201,779,540,239,655692.4,289668,945360.4
354950,202201,215,131,84,158772.4,101808,260580.4
354960,202201,131,49,82,59388,99384,158772
354970,202201,1079,725,354,882338.11,429048.6,1311386.71
354980,202201,9193,3240,5953,3932948.69,7222309.37,11155258.06
354990,202201,10007,4338,5669,5264931.36,6876890.4,12141821.76
354995,202201,569,177,392,214524.6,475104,689628.6
355000,202201,453,158,295,191496,358752,550248
355010,202201,606,367,239,444805,290881.75,735686.75
355020,202201,784,481,303,582972,368448.6,951420.6
355030,202201,213934,78427,135507,95162748.57,164456366.21,259619114.78
355040,202201,883,406,477,493285.2,578124,1071409.2
355050,202201,175,98,77,119988,93324,213312
355060,202201,1730,810,920,982933.2,1117464.4,2100397.6
355070,202201,1566,690,876,837492.15,1062925.76,1900417.91
355080,202201,193,116,77,140592,93324,233916
355090,202201,285,169,116,204828,140592.7,345420.7
355100,202201,5298,2450,2848,2977765.56,3456624.8,6434390.36
355110,202201,237,153,84,185436,101808,287244
355120,202201,56,36,20,43632,24240,67872
355130,202201,50,29,21,35148,25452,60600
355140,202201,193,113,80,136956,96960,233916
355150,202201,690,401,289,486012.6,350268,836280.6
355160,202201,477,226,251,273912.95,305424,579336.95
355170,202201,2073,1054,1019,1277448,1235028,2512476
355180,202201,694,272,422,329664,513888,843552
355190,202201,218,148,70,179376,84840,264216
355200,202201,110,57,53,69084,65448.6,134532.6
355210,202201,722,394,328,477528,397536,875064
355220,202201,7561,3665,3896,4446833.8,4740134.8,9186968.6
355230,202201,96,58,38,70296,46056,116352
355240,202201,4611,1848,2763,2242203.1,3352393.2,5594596.3
355250,202201,6439,2763,3676,3353629.51,4462586,7816215.51
355255,202201,48,30,18,36360,21816,58176
355260,202201,185,105,80,127260.6,96960,224220.6
355270,202201,166,106,60,129684,72720,202404
355280,202201,6923,2558,4365,3102723.83,5294017.2,8396741.03
355290,202201,69,54,15,65448,18180,83628
355300,202201,225,127,98,153924,118776.6,272700.6
355310,202201,110,56,54,67872,65448,133320
355320,202201,92,47,45,56964,54540,111504
355330,202201,300,172,128,208464,155136,363600
355340,202201,1414,485,929,587821.75,1127160.6,1714982.35
355350,202201,161,77,84,94536,101808,196344
355360,202201,168,109,59,132108,71508,203616
355365,202201,17,12,5,14544,6060,20604
355370,202201,1023,610,413,739320.95,501768,1241088.95
355380,202201,823,506,317,615696,389052,1004748
355385,202201,85,54,31,65448,37572,103020
355390,202201,110,56,54,67872,65448,133320
355395,202201,190,101,89,122412.18,107868,230280.18
355400,202201,1737,988,749,1199782.63,910212.95,2109995.58
355410,202201,5071,2315,2756,2806998.89,3352392,6159390.89
355420,202201,47,33,14,39996,16968,56964
355430,202201,405,243,162,295728,196344,492072
355440,202201,87,52,35,63024,42420,105444
355450,202201,441,212,229,258156.72,277548,535704.72
355460,202201,58,44,14,53328,16968,70296
355465,202201,51,29,22,35148,26664,61812
355470,202201,188,72,116,87264.8,140592,227856.8
355475,202201,10,7,3,8484,3636,12120
355480,202201,600,241,359,292092,437532,729624
355490,202201,111,75,36,90900,43632,134532
355495,202201,77,26,51,31512,61812,93324
355500,202201,1598,848,750,1030201.56,911424.6,1941626.16
355510,202201,273,192,81,233917.75,98172,332089.75
355520,202201,29,22,7,26664,8484,35148
355530,202201,22,11,11,13332,13332,26664
355535,202201,74,33,41,39996,49692,89688
355540,202201,2680,1022,1658,1241259.74,2011920,3253179.74
355550,202201,62,36,26,43632,31512,75144
355560,202201,240,107,133,129684,161196,290880
355570,202201,16,11,5,13332,6060,19392
355580,202201,239,159,80,192708,96961.2,289669.2
355590,202201,17,10,7,12120,8484,20604
355600,202201,271,132,139,161196,169680,330876
355610,202201,231,144,87,174528,105444,279972
355620,202201,1301,567,734,687204,889608,1576812
355630,202201,417,300,117,364812,141804,506616
355635,202201,128,56,72,67872,88476,156348
355640,202201,541,285,256,345420,311484,656904
355645,202201,893,325,568,393900,688416.6,1082316.6
355650,202201,1907,798,1109,969601.96,1346532,2316133.96
355660,202201,234,120,114,145440,138168,283608
355670,202201,627,259,368,313908,446016,759924
355680,202201,203,114,89,138168,107868,246036
355690,202201,89,43,46,52116,55752,107868
355695,202201,25,16,9,19392,10908,30300
355700,202201,1215,606,609,734472.04,738109.2,1472581.24
355710,202201,2249,1211,1038,1471369.2,1258056,2729425.2
355715,202201,13,11,2,13332,2424,15756
355720,202201,254,156,98,189072.36,118776,307848.36
355730,202201,109,63,46,76356,55752,132108
410010,202201,129,101,28,122412,33936,156348
410020,202201,120,86,34,104232,41208,145440
410030,202201,169,93,76,112716,92112,204828
410040,202201,1303,633,670,767196.6,812040,1579236.6
410045,202201,46,35,11,42420,13332,55752
410050,202201,516,294,222,356328,269064,625392
410060,202201,282,204,78,247248,94536,341784
410070,202201,287,244,43,296940,52116,349056
410080,202201,177,106,71,128472,86052,214524
410090,202201,68,57,11,69084,13332,82416
410100,202201,258,167,91,202404,110292,312696
410105,202201,48,27,21,32724,25452,58176
410110,202201,346,207,139,250884,168468,419352
410115,202201,45,29,16,35148,19392,54540
410120,202201,438,204,234,247248,283608,530856
410130,202201,54,30,24,36360,29088,65448
410140,202201,3146,1414,1732,1713769.52,2102823,3816592.52
410150,202201,2686,1066,1620,1291993.55,1963440.6,3255434.15
410160,202201,483,277,206,335724,249672,585396
410165,202201,53,30,23,36360,27876,64236
410170,202201,194,121,73,147864,88476,236340
410180,202201,2286,1230,1056,1495608.6,1282296,2777904.6
410185,202201,35,31,4,37572,4848,42420
410190,202201,485,310,175,376932.3,212100,589032.3
410200,202201,984,700,284,848400,345420,1193820
410210,202201,631,323,308,391476,373296.2,764772.2
410220,202201,50,21,29,25452,35148,60600
410230,202201,171,77,94,93324,113928,207252
410240,202201,718,455,263,551460,318756,870216
410250,202201,381,267,114,323604,139380,462984
410260,202201,304,165,139,199980,168468.6,368448.6
410270,202201,29,22,7,26664,8484,35148
410275,202201,59,43,16,52116,19392,71508
410280,202201,324,183,141,221796,172104,393900
410290,202201,276,153,123,185436,149076,334512
410300,202201,89,55,34,66660,41208,107868
410302,202201,24,13,11,15756,13332,29088
410304,202201,38,25,13,30300,15756,46056
410305,202201,228,126,102,152712,123624,276336
410310,202201,192,112,80,135744,96960,232704
410315,202201,44,32,12,38784,14544,53328
410320,202201,138,91,47,110292,56964,167256
410322,202201,33,20,13,24240,15756,39996
410330,202201,168,111,57,134532,69084,203616
410335,202201,95,52,43,63024,52116,115140
410337,202201,42,32,10,39996,12120,52116
410340,202201,38,30,8,36360,9696,46056
410345,202201,200,118,82,143016,99384,242400
410347,202201,46,34,12,41208,14544,55752
410350,202201,259,147,112,178164,135744,313908
410360,202201,436,265,171,322392.6,207252.6,529645.2
410370,202201,2331,973,1358,1179276.6,1647108.6,2826385.2
410380,202201,190,112,78,135744,94536,230280
410390,202201,392,260,132,315120,159984,475104
410395,202201,35,21,14,25452,16968.6,42420.6
410400,202201,855,365,490,442380.94,595092,1037472.94
410405,202201,81,61,20,73932,24240,98172
410410,202201,26,16,10,19392,12120,31512
410420,202201,1711,766,945,929496.73,1147764,2077260.73
410425,202201,184,72,112,87264,135744,223008
410430,202201,2318,1225,1093,1488336,1325928,2814264
410440,202201,363,259,104,313908,126048,439956
410442,202201,361,227,134,275124,162408,437532
410445,202201,420,293,127,355116,155136,510252
410450,202201,381,181,200,219372,242400,461772
410460,202201,556,285,271,345420,328452,673872
410465,202201,250,135,115,163620,139380.6,303000.6
410470,202201,266,144,122,174528,147864.6,322392.6
410480,202201,6541,3109,3432,3771745.62,4160798.5,7932544.12
410490,202201,1408,805,603,975660,730836.6,1706496.6
410500,202201,270,153,117,186648,141804,328452
410510,202201,179,132,47,159984,56964,216948
410520,202201,264,188,76,229068,92112,321180
410530,202201,299,94,205,113928,248460,362388
410540,202201,337,243,94,294516.04,113928,408444.04
410550,202201,1701,694,1007,841128.92,1221696.6,2062825.52
410560,202201,154,104,50,126048,60600,186648
410570,202201,441,291,150,352693.2,181800,534493.2
410580,202201,3659,1521,2138,1844665.4,2592470.2,4437135.6
410590,202201,414,265,149,321159,180588,501747
410600,202201,190,165,25,199980,30300,230280
410610,202201,50,40,10,48480,12120,60600
410620,202201,264,172,92,208464.4,111504,319968.4
410630,202201,453,245,208,296940,252096,549036
410640,202201,1050,641,409,778104.8,496920,1275024.8
410645,202201,112,80,32,96960.8,38784,135744.8
410650,202201,368,225,143,272700,173316,446016
410655,202201,87,60,27,72720,32724,105444
410657,202201,34,11,23,13332,27876,41208
410660,202201,637,426,211,516312.14,255732,772044.14
410670,202201,78,64,14,77568,16968,94536
410680,202201,189,154,35,186648,42420,229068
410685,202201,28,17,11,20604,13332,33936
410690,202201,28590,11662,16928,14144047.06,20540982.64,34685029.70
410700,202201,322,234,88,283608,106656,390264
410710,202201,128,104,24,126048,29088,155136
410712,202201,45,33,12,39996,14544,54540
410715,202201,92,70,22,86052,26664,112716
410720,202201,655,374,281,454500.6,340572,795072.6
410725,202201,192,137,55,166044,66660,232704
410730,202201,104,49,55,59388,66660,126048
410740,202201,102,72,30,87264,36360,123624
410750,202201,288,187,101,227856,122412,350268
410752,202201,20,14,6,16968,7272,24240
410753,202201,58,23,35,27876,42420,70296
410754,202201,53,25,28,30300,33936,64236
410755,202201,79,45,34,54540,41208,95748
410760,202201,759,403,356,488436,431472.2,919908.2
410765,202201,1879,838,1041,1016869,1262905.4,2279774.4
410770,202201,110,78,32,94536,38784,133320
410773,202201,60,41,19,49692,23028,72720
410775,202201,178,133,45,161196,54540,215736
410780,202201,87,47,40,56964,48480,105444
410785,202201,51,41,10,49692,12120,61812
410790,202201,85,37,48,44844,58176,103020
410800,202201,280,172,108,208464,130896.6,339360.6
410810,202201,29,17,12,20604,14544.6,35148.6
410820,202201,157,112,45,135744,54540,190284
410830,202201,8966,3742,5224,4538942,6337549.6,10876491.6
410832,202201,116,75,41,90900,49692,140592
410840,202201,1423,748,675,906576.21,818100.8,1724677.01
410845,202201,50,27,23,32724,27876,60600
410850,202201,177,129,48,156348,58176,214524
410855,202201,71,61,10,73932,12120,86052
410860,202201,787,401,386,486012,469044.6,955056.6
410865,202201,100,70,30,86052,37572,123624
410870,202201,148,125,23,151500,27876,179376
410880,202201,1149,566,583,685992.6,706596.6,1392589.2
410890,202201,95,62,33,75144,39996,115140
410895,202201,77,58,19,70296,23028,93324
410900,202201,26,19,7,23028,8484,31512
410910,202201,15,10,5,12120,6060,18180
410920,202201,44,28,16,33936,19392,53328
410930,202201,554,337,217,408444,264216,672660
410940,202201,4428,2320,2108,2814264.6,2556108.2,5370372.8
410950,202201,103,76,27,92112,32724,124836
410960,202201,882,331,551,403596,669024,1072620
410965,202201,62,39,23,47268,27876,75144
410970,202201,613,418,195,506616,236340,742956
410975,202201,122,75,47,90900.58,56964,147864.58
410980,202201,1647,722,925,876277.2,1121100,1997377.2
410990,202201,273,195,78,236340,94536,330876
411000,202201,64,35,29,42420,35148.6,77568.6
411005,202201,30,23,7,27876,8484,36360
411007,202201,253,140,113,169680,136956,306636
411010,202201,595,390,205,472680,248460,721140
411020,202201,290,183,107,221796,129684,351480
411030,202201,23,12,11,14544,13332,27876
411040,202201,58,38,20,46056,24240,70296
411050,202201,213,152,61,184224.46,73932,258156.46
411060,202201,528,354,174,429048,212100,641148
411065,202201,46,41,5,49692,6060,55752
411070,202201,1271,724,547,879912,662964.2,1542876.2
411080,202201,242,168,74,204302.8,89688,293990.8
411090,202201,89,67,22,81204,26664,107868
411095,202201,341,120,221,145440,267852,413292
411100,202201,112,88,24,106656,29088,135744
411110,202201,140,84,56,101808,67872,169680
411120,202201,212,139,73,168468,88476,256944
411125,202201,284,130,154,157560,186648,344208
411130,202201,120,102,18,123624,21816,145440
411140,202201,212,145,67,175740,81204,256944
411150,202201,1242,792,450,959904,546613.55,1506517.55
411155,202201,122,84,38,103020,46056,149076
411160,202201,31,13,18,15756,21816,37572
411170,202201,50,45,5,54540,6060,60600
411180,202201,990,648,342,786588,415716,1202304
411190,202201,337,184,153,223008,185436,408444
411200,202201,667,385,282,466620.95,341784,808404.95
411210,202201,687,351,336,425412,408444.25,833856.25
411220,202201,162,113,49,136956,59388,196344
411230,202201,37,29,8,35148,9696,44844
411240,202201,117,71,46,87264,55752,143016
411250,202201,423,307,116,372084,140592,512676
411260,202201,14,10,4,12120,4848,16968
411270,202201,265,133,132,161196,159984,321180
411275,202201,184,157,27,190284,32724,223008
411280,202201,206,148,58,179376.95,70296,249672.95
411290,202201,64,50,14,60600,16968,77568
411295,202201,122,97,25,117564,30300,147864
411300,202201,78,36,42,43632,50904,94536
411310,202201,93,67,26,81204,31512,112716
411320,202201,798,500,298,607212.6,361176,968388.6
411325,202201,64,46,18,55752,21816,77568
411330,202201,900,580,320,704172.2,387840,1092012.2
411340,202201,31,21,10,25452,12120,37572
411342,202201,58,44,14,53328,16968,70296
411345,202201,108,51,57,61812,69084,130896
411350,202201,500,368,132,447228.52,159984.6,607213.12
411360,202201,57,36,21,43632,25452,69084
411370,202201,14000,5578,8422,6766603.25,10220801.9,16987405.15
411373,202201,184,122,62,149076,75144,224220
411375,202201,80,63,17,76356,20604,96960
411380,202201,76,54,22,65448,26664,92112
411390,202201,130,75,55,90900,66660,157560
411400,202201,419,279,140,339360,169680,509040
411410,202201,500,231,269,279972,326028.6,606000.6
411420,202201,962,402,560,487225.56,678720.2,1165945.76
411430,202201,511,276,235,334512,284820,619332
411435,202201,30,19,11,23028,13332,36360
411440,202201,470,371,99,449652,119988,569640
411450,202201,411,346,65,419352,78780,498132
411460,202201,798,296,502,358752,608424,967176
411470,202201,105,73,32,88476,38784,127260
411480,202201,702,368,334,446016.6,404808,850824.6
411490,202201,278,170,108,206040,130896,336936
411500,202201,99,81,18,98172,21816,119988
411510,202201,226,179,47,216948,56964,273912
411520,202201,6114,2114,4000,2562168.98,4854062.6,7416231.58
411530,202201,120,81,39,98172,47268,145440
411535,202201,47,15,32,18180,38784,56964
411540,202201,373,248,125,300576,151500,452076
411545,202201,58,42,16,50904,19392,70296
411550,202201,93,70,23,84840,27876,112716
411560,202201,403,163,240,197556,292092,489648
411570,202201,916,311,605,376932.32,733260,1110192.32
411573,202201,27,16,11,19392,13332,32724
411575,202201,317,191,126,231492.6,152712,384204.6
411580,202201,1242,439,803,533280.6,973236,1506516.6
411585,202201,71,36,35,43632,42420,86052
411590,202201,16,10,6,12120,7272,19392
411600,202201,21,9,12,10908,14544,25452
411605,202201,247,92,155,111504,187860,299364
411610,202201,227,141,86,170892,104232,275124
411620,202201,396,187,209,226644,253308,479952
411630,202201,52,36,16,43632,19392,63024
411640,202201,32,22,10,26664,12120,38784
411650,202201,9,6,3,7272,3636,10908
411660,202201,39,28,11,33936,13332,47268
411670,202201,239,166,73,202404,88476,290880
411680,202201,156,127,29,153924,35148,189072
411690,202201,614,317,297,386628,361176,747804
411695,202201,65,47,18,56964,21816,78780
411700,202201,146,115,31,139380,37572,176952
411705,202201,105,70,35,84840,42420,127260
411710,202201,295,195,100,236340,121200,357540
411720,202201,141,95,46,115140,55752,170892
411721,202201,86,70,16,84840,19392,104232
411722,202201,103,45,58,54540,70296,124836
411725,202201,171,123,48,149076,58176,207252
411727,202201,100,78,22,94536,26664,121200
411729,202201,46,32,14,38784,16968,55752
411730,202201,558,345,213,418140.99,259368,677508.99
411740,202201,32,20,12,24240,14544,38784
411745,202201,64,48,16,58176,19392,77568
411750,202201,846,351,495,426624,599940,1026564
411760,202201,1224,885,339,1073833.16,410868,1484701.16
411770,202201,425,279,146,340572,176952,517524
411780,202201,368,238,130,288456,157560,446016
411790,202201,573,316,257,382992.6,311484,694476.6
411800,202201,151,108,43,130896.65,54540,185436.65
411810,202201,184,139,45,168468,54540,223008
411820,202201,2414,987,1427,1196245.8,1733161,2929406.8
411830,202201,13,12,1,14544,1212,15756
411840,202201,2120,1258,862,1524696,1045956.6,2570652.6
411845,202201,65,22,43,26664,52116,78780
411850,202201,1235,662,573,804768.6,695688.8,1500457.4
411860,202201,50,31,19,37572.6,23028,60600.6
411870,202201,69,41,28,49692,33936,83628
411880,202201,432,253,179,306636,216948,523584
411885,202201,103,61,42,73932,50904,124836
411890,202201,316,215,101,260581.19,122412,382993.19
411900,202201,100,72,28,87264.6,33936,121200.6
411910,202201,184,137,47,166044,56964,223008
411915,202201,2361,924,1437,1119888,1746492.08,2866380.08
411920,202201,113,88,25,106656,30300,136956
411925,202201,17,10,7,12120,8484,20604
411930,202201,785,545,240,661830.52,290880,952710.52
411940,202201,598,376,222,455712,269064,724776
411950,202201,1158,525,633,636300.6,768408,1404708.6
411960,202201,1109,702,407,850824,493284,1344108
411965,202201,22,12,10,14544,12120,26664
411970,202201,92,77,15,93324,18180,111504
411980,202201,203,112,91,135744,110292,246036
411990,202201,5142,2754,2388,3337856.66,2897972.98,6235829.64
411995,202201,582,168,414,203616,504192,707808
412000,202201,326,213,113,258156,136956,395112
412010,202201,46,24,22,29088,26664,55752
412015,202201,38,30,8,36360,9696,46056
412020,202201,19,14,5,16968,6060,23028
412030,202201,37,33,4,39996,4848,44844
412033,202201,49,29,20,35148,24240,59388
412035,202201,73,46,27,56964,32724,89688
412040,202201,38,18,20,21816.6,24240,46056.6
412050,202201,215,157,58,190284,70296,260580
412060,202201,776,554,222,671448,269064.13,940512.13
412065,202201,50,29,21,35148,25452,60600
412070,202201,163,115,48,139380,58176,197556
412080,202201,313,143,170,173316,207252,380568
412085,202201,35,14,21,16968,25452,42420
412090,202201,842,520,322,630240.6,390264,1020504.6
412100,202201,265,221,44,267852,53328,321180
412110,202201,69,53,16,64236.8,19392,83628.8
412120,202201,341,182,159,220584,192708,413292
412125,202201,70,42,28,50904,33936,84840
412130,202201,45,28,17,33936.84,20604,54540.84
412135,202201,29,17,12,20604,14544,35148
412140,202201,419,265,154,322392.6,187860,510252.6
412150,202201,235,153,82,185436,99384,284820
412160,202201,84,54,30,65448,36360,101808
412170,202201,712,477,235,579336,284820,864156
412175,202201,39,27,12,32724,14544,47268
412180,202201,187,138,49,167256.8,59388,226644.8
412190,202201,318,247,71,299364,86052,385416
412200,202201,187,116,71,140592,86052,226644
412210,202201,94,71,23,86052,27876,113928
412215,202201,235,156,79,189072.6,95748,284820.6
412217,202201,67,55,12,66660,14544,81204
412220,202201,825,547,278,662964,336936,999900
412230,202201,299,179,120,216948,145440,362388
412240,202201,1321,639,682,774468.8,826584.6,1601053.4
412250,202201,406,249,157,301788,191496,493284
412260,202201,117,76,41,92112,49692,141804
412265,202201,170,128,42,155136,50904,206040
412270,202201,92,57,35,69084,42420,111504
412280,202201,90,69,21,83628,25452,109080
412290,202201,89,56,33,67872,39996,107868
412300,202201,206,143,63,173316,76356,249672
412310,202201,52,42,10,50904,12120,63024
412320,202201,89,70,19,84840,23028,107868
412330,202201,186,151,35,183012,42420,225432
412340,202201,170,113,57,136956,69084,206040
412350,202201,641,295,346,357540,419352,776892
412360,202201,24,21,3,25452,3636,29088
412370,202201,149,126,23,152712.6,27876,180588.6
412380,202201,207,156,51,189072,63024,252096
412382,202201,64,35,29,42420,35148,77568
412385,202201,153,108,45,130896,54540,185436
412390,202201,304,227,77,276336,93324,369660
412395,202201,64,51,13,61812,15756,77568
412400,202201,100,67,33,81204,39996,121200
412402,202201,239,118,121,143824.6,146652,290476.6
412405,202201,944,316,628,382992,761136,1144128
412410,202201,960,575,385,697520.6,466620,1164140.6
412420,202201,17,16,1,19392,1212,20604
412430,202201,23,21,2,25452,2424,27876
412440,202201,649,327,322,396324,390264,786588
412450,202201,73,64,9,77568,10908,88476
412460,202201,89,68,21,82416,25452,107868
412470,202201,212,166,46,201192,55752,256944
412480,202201,146,103,43,124836,52116,176952
412490,202201,161,136,25,164832,30300,195132
412500,202201,407,320,87,387840.95,106656,494496.95
412510,202201,168,139,29,168468,35148,203616
412520,202201,92,58,34,70296,41208,111504
412530,202201,108,54,54,65448,65448,130896
412535,202201,88,68,20,82416,24240,106656
412540,202201,83,38,45,46056,54540,100596
412545,202201,82,55,27,67872,32724,100596
412550,202201,4000,1591,2409,1930716,2922132.6,4852848.6
412555,202201,10,6,4,7272,4848,12120
412560,202201,651,433,218,524797.2,264216,789013.2
412570,202201,803,383,420,464196,509040,973236
412575,202201,93,66,27,79992.6,32724,112716.6
412580,202201,172,114,58,138168,70296,208464
412590,202201,31,28,3,33936,3636,37572
412600,202201,174,118,56,143016,69084,212100
412610,202201,36,15,21,18180,25452,43632
412620,202201,138,115,23,139380,27876,167256
412625,202201,2117,1040,1077,1261693.61,1308960.96,2570654.57
412627,202201,65,48,17,58176,20604,78780
412630,202201,384,255,129,309060,156348,465408
412635,202201,74,20,54,24240,65448,89688
412640,202201,105,73,32,88476,38784,127260
412650,202201,325,216,109,261792,132108,393900
412660,202201,454,263,191,318756,231492,550248
412665,202201,43,39,4,47268,4848,52116
412667,202201,295,190,105,230280,127260,357540
412670,202201,73,59,14,71508,16968,88476
412680,202201,330,251,79,304212,95748.12,399960.12
412690,202201,128,83,45,100596,54540,155136
412700,202201,185,125,60,152712,72720,225432
412710,202201,1328,750,578,910212.79,700536,1610748.79
412720,202201,227,124,103,150288,124836,275124
412730,202201,208,175,33,212100,39996,252096
412740,202201,422,213,209,258156,253308,511464
412750,202201,429,230,199,278760,242400,521160
412760,202201,329,163,166,198768,201192,399960
412770,202201,2102,1122,980,1362289.35,1190184.6,2552473.95
412780,202201,142,103,39,124836,47268,172104
412785,202201,312,154,158,186648,191496,378144
412788,202201,46,26,20,31512,24240,55752
412790,202201,127,105,22,127260,26664,153924
412795,202201,150,103,47,124836,56964,181800
412796,202201,296,185,111,224220,134532,358752
412800,202201,664,395,269,478740,327240,805980
412810,202201,3058,1657,1401,2011921.6,1700436,3712357.6
412820,202201,951,569,382,690842.46,465408,1156250.46
412830,202201,12,10,2,12120,2424,14544
412840,202201,259,173,86,209676.6,104232,313908.6
412850,202201,706,439,267,532068,324816,856884
412853,202201,162,74,88,89688,106656,196344
412855,202201,199,107,92,129684.91,111504,241188.91
412860,202201,95,62,33,75144,39996,115140
412862,202201,78,51,27,61812,32724,94536
412863,202201,8,6,2,7272,2424,9696
412865,202201,45,34,11,41208,13332,54540
412870,202201,110,65,45,78780,54540,133320
412880,202201,91,64,27,77568.6,32724,110292.6
420005,202201,39,35,4,42420,4848,47268
420010,202201,366,238,128,290880,155136,446016
420020,202201,90,72,18,87264,21816,109080
420030,202201,27,22,5,26664,6060,32724
420040,202201,94,71,23,86052,27876,113928
420050,202201,58,36,22,43632,26664,70296
420055,202201,18,17,1,20604,1212,21816
420060,202201,25,18,7,21816,8484,30300
420070,202201,99,84,15,101808,18180,119988
420075,202201,9,9,0,10908,,10908.0
420080,202201,39,33,6,41208,7272,48480
420090,202201,37,30,7,36360,8484,44844
420100,202201,153,128,25,155136.6,30300,185436.6
420110,202201,20,20,0,24240,,24240.0
420120,202201,54,37,17,44844,20604,65448
420125,202201,89,70,19,84840,23028,107868
420127,202201,35,29,6,35148,7272,42420
420130,202201,454,271,183,328452,221796,550248
420140,202201,1316,725,591,880154.6,716292.6,1596447.2
420150,202201,44,36,8,43632,9696,53328
420160,202201,30,28,2,33936,2424,36360
420165,202201,14,9,5,10908,6060,16968
420170,202201,66,40,26,48480,31512,79992
420180,202201,22,19,3,23028,3636,26664
420190,202201,25,22,3,26664,3636,30300
420195,202201,151,67,84,81204.6,101808,183012.6
420200,202201,1297,540,757,655693.2,919908,1575601.2
420205,202201,100,58,42,70296,50904,121200
420207,202201,135,72,63,87264,76356,163620
420208,202201,19,15,4,18180,4848,23028
420209,202201,14,12,2,14544,2424,16968
420210,202201,566,266,300,322392,363600,685992
420213,202201,49,37,12,44844,14544,59388
420215,202201,25,21,4,25452,4848,30300
420220,202201,61,38,23,46056.6,27876,73932.6
420230,202201,911,543,368,659328.6,448440,1107768.6
420240,202201,2248,1465,783,1775581.8,950208.6,2725790.4
420243,202201,44,35,9,43632.6,10908,54540.6
420245,202201,199,97,102,117564,123624,241188
420250,202201,62,41,21,49692,25452,75144
420253,202201,28,22,6,26664,7272,33936
420257,202201,13,9,4,10908,4848,15756
420260,202201,112,89,23,109080,27876,136956
420270,202201,30,23,7,27876,8484,36360
420280,202201,275,205,70,249672.8,84840.8,334513.6
420285,202201,23,16,7,19392,8484,27876
420287,202201,51,34,17,41208,20604,61812
420290,202201,922,631,291,767196.6,353904,1121100.6
420300,202201,1497,1187,310,1441070.84,375721.44,1816792.28
420310,202201,46,31,15,37572,18180,55752
420315,202201,31,24,7,29088,8484,37572
420320,202201,969,453,516,550248.76,625392,1175640.76
420325,202201,5,3,2,3636,2424,6060
420330,202201,121,79,42,95748,50904,146652
420340,202201,179,120,59,145440.8,71508,216948.8
420350,202201,255,174,81,210888.6,98172,309060.6
420360,202201,699,537,162,652056.76,196344,848400.76
420370,202201,129,72,57,87264,69084,156348
420380,202201,1205,833,372,1009597.2,450864,1460461.2
420390,202201,229,159,70,192708,84840,277548
420395,202201,186,136,50,164832,60600,225432
420400,202201,227,172,55,208464.8,66660,275124.8
420410,202201,54,40,14,48480,16968,65448
420415,202201,33,28,5,33936,6060,39996
420417,202201,53,42,11,50904,13332,64236
420419,202201,11,10,1,12120,1212,13332
420420,202201,2798,1733,1065,2102823,1291993.2,3394816.2
420425,202201,70,55,15,66660,18180,84840
420430,202201,1081,779,302,944148.8,366024,1310172.8
420435,202201,14,12,2,14544,2424,16968
420440,202201,93,65,28,78780.6,33936,112716.6
420445,202201,31,28,3,33936,3636,37572
420450,202201,81,41,40,49692,48480,98172
420455,202201,195,152,43,184224,52116,236340
420460,202201,2317,1451,866,1758614.52,1049592,2808206.52
420470,202201,93,64,29,77568,35148,112716
420475,202201,9,8,1,9696,1212,10908
420480,202201,866,653,213,791437.8,258156.2,1049594.0
420490,202201,93,68,25,82416,30300.04,112716.04
420500,202201,431,233,198,282396.71,241188,523584.71
420510,202201,24,20,4,24240,4848,29088
420515,202201,30,16,14,19392,16968,36360
420517,202201,6,6,0,8484,,8484.0
420519,202201,0,,,,,0.0
420520,202201,62,47,15,56964,18180,75144
420530,202201,144,93,51,112716,61812,174528
420535,202201,16,14,2,16968,2424,19392
420540,202201,6116,3779,2337,4584093.62,2836081.2,7420174.82
420543,202201,30,28,2,33936,2424,36360
420545,202201,210,144,66,174528,79992,254520
420550,202201,781,646,135,784165.24,163620,947785.24
420555,202201,27,19,8,23028,9696,32724
420560,202201,58,46,12,56964,14544,71508
420570,202201,179,93,86,112716,104232,216948
420580,202201,291,142,149,173316,180588.6,353904.6
420590,202201,475,305,170,370872,206040,576912
420600,202201,144,78,66,94536,79992,174528
420610,202201,37,34,3,41208,3636,44844
420620,202201,78,57,21,69084,25452,94536
420630,202201,147,96,51,116352,63024,179376
420640,202201,71,62,9,76356,12120,88476
420650,202201,267,141,126,170892,152712,323604
420660,202201,41,33,8,39996,9696,49692
420665,202201,43,27,16,32724,19392,52116
420670,202201,253,197,56,238764,67872,306636
420675,202201,15,13,2,15756,2424,18180
420680,202201,31,25,6,30300,7272,37572
420690,202201,186,142,44,172104,53328,225432
420700,202201,703,455,248,551460.72,300576,852036.72
420710,202201,148,76,72,92112,87264,179376
420720,202201,101,81,20,98172,24240,122412
420730,202201,687,410,277,496922.04,335724.6,832646.64
420740,202201,52,52,0,63024,,63024.0
420750,202201,483,317,166,384204.6,201192,585396.6
420757,202201,17,15,2,18180,2424,20604
420760,202201,37,29,8,35148,9696,44844
420765,202201,77,56,21,69084,25452,94536
420768,202201,52,43,9,52116,10908,63024
420770,202201,73,61,12,73932,14544,88476
420775,202201,36,33,3,39996,3636,43632
420780,202201,201,158,43,192708.8,52116,244824.8
420785,202201,21,13,8,15756,9696,25452
420790,202201,144,119,25,144228,30300,174528
420800,202201,58,44,14,53328,16968,70296
420810,202201,266,217,49,263004,59388,322392
420820,202201,2451,1356,1095,1647109.2,1327141.26,2974250.46
420830,202201,647,332,315,402384.6,382992,785376.6
420840,202201,141,97,44,117564,53328,170892
420845,202201,437,187,250,226644,303000,529644
420850,202201,261,198,63,239976,76356,316332
420860,202201,59,50,9,60600,10908,71508
420870,202201,130,90,40,109080,48480,157560
420880,202201,186,121,65,146652,78780,225432
420890,202201,934,444,490,538128.6,593880,1132008.6
420895,202201,8,8,0,9696,,9696.0
420900,202201,417,331,86,401172,104232,505404
420910,202201,5728,3078,2650,3732964.21,3214225.2,6947189.41
420915,202201,62,55,7,66660,8484,75144
420917,202201,20,15,5,18180,6060,24240
420920,202201,19,13,6,15756,7272,23028
420930,202201,3025,1924,1101,2334236.6,1336836.2,3671072.8
420940,202201,588,425,163,516313.2,197556.64,713869.84
420945,202201,11,8,3,9696,3636,13332
420950,202201,48,37,11,44844,13332,58176
420960,202201,112,92,20,111504,25452,136956
420970,202201,281,224,57,271489,70296,341785
420980,202201,20,19,1,23028,1212,24240
420985,202201,54,48,6,58176,7272,65448
420990,202201,80,61,19,73932,23028,96960
421000,202201,53,29,24,35148,29088,64236
421003,202201,39,26,13,31512,15756,47268
421005,202201,8,5,3,6060,3636,9696
421010,202201,809,530,279,642361.4,339360.8,981722.2
421020,202201,21,16,5,19392,6060,25452
421030,202201,110,94,16,113928.2,19392,133320.2
421040,202201,69,47,22,56964,26664,83628
421050,202201,335,233,102,282397.8,123624,406021.8
421055,202201,18,14,4,16968,4848,21816
421060,202201,102,55,47,66660,56964,123624
421070,202201,39,32,7,38784.6,8484,47268.6
421080,202201,38,33,5,39996,6060,46056
421085,202201,17,14,3,16968,3636,20604
421090,202201,35,28,7,33936,8484,42420
421100,202201,117,86,31,104232,37572,141804
421105,202201,184,149,35,180588,42420,223008
421110,202201,110,82,28,99384,33936,133320
421120,202201,173,123,50,149076.6,60600,209676.6
421125,202201,17,10,7,12120,8484,20604
421130,202201,821,496,325,601152,393900.6,995052.6
421140,202201,33,23,10,27876,12120,39996
421145,202201,49,38,11,46056,13332,59388
421150,202201,92,72,20,87264,24240,111504
421160,202201,61,38,23,46056,27876,73932
421165,202201,16,12,4,14544,4848,19392
421170,202201,171,142,29,173462,35148,208610
421175,202201,182,123,59,150288,71508,221796
421180,202201,43,30,13,36360.56,15756,52116.56
421185,202201,14,11,3,13332,3636,16968
421187,202201,4,2,2,2424,2424,4848
421189,202201,45,32,13,38784,15756,54540
421190,202201,1845,1158,687,1404711.08,832644.55,2237355.63
421200,202201,96,68,28,82416,33936,116352
421205,202201,28,20,8,24240,9696,33936
421210,202201,177,129,48,156348,58176,214524
421220,202201,248,194,54,235128,65448,300576
421223,202201,50,39,11,47268.4,13332,60600.4
421225,202201,70,44,26,53328,31512,84840
421227,202201,74,59,15,71508,18180,89688
421230,202201,66,45,21,54540,25452,79992
421240,202201,15,15,0,18180,,18180.0
421250,202201,377,220,157,266640.2,191496,458136.2
421260,202201,21,17,4,20604,4848,25452
421265,202201,4,3,1,3636,1212,4848
421270,202201,50,44,6,53328,7272,60600
421280,202201,355,178,177,215736.6,214524,430260.6
421290,202201,315,208,107,252096,129684.6,381780.6
421300,202201,23,19,4,23028,4848,27876
421310,202201,52,35,17,42420,20604,63024
421315,202201,31,19,12,23028,14544,37572
421320,202201,132,85,47,103020,56964,159984
421330,202201,110,83,27,100596,32724,133320
421335,202201,43,31,12,37572,14544,52116
421340,202201,241,154,87,186648.8,105444,292092.8
421350,202201,185,108,77,130897.02,93324,224221.02
421360,202201,695,489,206,592668,250884,843552
421370,202201,187,136,51,164832,61812,226644
421380,202201,139,108,31,130896,37572,168468
421390,202201,16,10,6,12120,7272,19392
421400,202201,116,95,21,115140,25452,140592
421410,202201,22,19,3,23028,3636,26664
421415,202201,20,17,3,20604,3636,24240
421420,202201,105,91,14,110292,16968,127260
421430,202201,18,13,5,15756,6060,21816
421440,202201,59,51,8,61812,9696,71508
421450,202201,89,73,16,88476,19392.44,107868.44
421460,202201,57,43,14,52116,16968,69084
421470,202201,72,41,31,49692,37572,87264
421480,202201,746,566,180,685992.6,218160,904152.6
421490,202201,25,24,1,29088,1212,30300
421500,202201,472,284,188,344208.6,227856.77,572065.37
421505,202201,28,20,8,24240,9696,33936
421507,202201,30,24,6,29088,7272,36360
421510,202201,70,45,25,54540,30300,84840
421520,202201,53,44,9,53328,10908,64236
421530,202201,52,42,10,50904,12120,63024
421535,202201,19,18,1,21816,1212,23028
421540,202201,52,41,11,49692,13332,63024
421545,202201,81,58,23,70296,27876,98172
421550,202201,287,204,83,247248.96,100596,347844.96
421555,202201,18,15,3,18180,3636,21816
421560,202201,9,8,1,9696,1212,10908
421565,202201,119,77,42,93324,50904,144228
421567,202201,32,25,7,30300,8484,38784
421568,202201,43,40,3,48480,3636,52116
421569,202201,11,11,0,13332,,13332.0
421570,202201,220,144,76,174528,92112,266640
421575,202201,25,22,3,26664,3636,30300
421580,202201,699,408,291,494575,352692.6,847267.6
421590,202201,20,19,1,23028,1212,24240
421600,202201,152,100,52,121200.6,63024,184224.6
421605,202201,103,71,32,86052.2,38784,124836.2
421610,202201,166,126,40,152712,48480,201192
421620,202201,1020,574,446,698112,541764.8,1239876.8
421625,202201,21,19,2,23028,2424,25452
421630,202201,334,200,134,242400.6,162409.2,404809.8
421635,202201,20,9,11,10908,13332,24240
421640,202201,99,82,17,99384.4,20604,119988.4
421650,202201,292,169,123,206040.6,149076,355116.6
421660,202201,2454,1471,983,1786490.4,1192608,2979098.4
421670,202201,167,118,49,143016,59388,202404
421680,202201,186,167,19,202404,23028,225432
421690,202201,343,234,109,283609.4,132108.36,415717.76
421700,202201,57,39,18,47268,21816.2,69084.2
421710,202201,19,18,1,21816,1212,23028
421715,202201,5,4,1,4848,1212,6060
421720,202201,629,433,196,524796,237552,762348
421725,202201,22,7,15,8484,18180,26664
421730,202201,24,18,6,21816,7272,29088
421740,202201,103,38,65,46056,78780,124836
421750,202201,195,142,53,173316,64236,237552
421755,202201,20,18,2,21816,2424,24240
421760,202201,100,69,31,83628,37572,121200
421770,202201,699,445,254,540553.6,309060,849613.6
421775,202201,28,18,10,21816,12120,33936
421780,202201,177,140,37,169680,44844,214524
421790,202201,154,132,22,159984.78,26664,186648.78
421795,202201,16,13,3,15756,3636,19392
421800,202201,538,329,209,398748,253308,652056
421810,202201,70,57,13,69084,15756,84840
421820,202201,304,191,113,231494,136956,368450
421825,202201,152,125,27,151500,32724,184224
421830,202201,150,89,61,107868.6,73932,181800.6
421835,202201,7,2,5,2424,6060,8484
421840,202201,45,39,6,47268,7272,54540
421850,202201,82,69,13,83628,15756,99384
421860,202201,41,29,12,35148,14544,49692
421870,202201,1036,747,289,907790,351480,1259270
421875,202201,53,42,11,50904,13332,64236
421880,202201,181,122,59,147864,71508,219372
421885,202201,27,20,7,24240,8484,32724
421890,202201,136,96,40,116352,48480.1,164832.1
421895,202201,44,38,6,46056,7272,53328
421900,202201,131,98,33,118776,39996,158772
421910,202201,64,41,23,49692,27876,77568
421915,202201,34,28,6,33936,7272,41208
421917,202201,38,28,10,33936,12120,46056
421920,202201,35,31,4,37572,4848,42420
421930,202201,615,487,128,590244.8,156348,746592.8
421935,202201,45,39,6,47268,7272,54540
421940,202201,50,42,8,50904.4,9696,60600.4
421950,202201,863,570,293,692052.8,355116.4,1047169.2
421960,202201,40,34,6,41208,7272,48480
421970,202201,323,206,117,250884,141804,392688
421985,202201,18,11,7,13332,8484,21816
422000,202201,0,0,0,,,0.0
430003,202201,192,53,139,64236,168468,232704
430005,202201,36,26,10,31512,12120,43632
430010,202201,258,185,73,224220,88476,312696
430020,202201,145,97,48,117564.6,58176,175740.6
430030,202201,119,100,19,121200,24240,145440
430040,202201,2922,1717,1205,2085852.6,1462884.6,3548737.2
430045,202201,72,61,11,73932,13332,87264
430047,202201,6,5,1,6060,1212,7272
430050,202201,84,71,13,86052,15756,101808
430055,202201,12,11,1,13332,1212,14544
430057,202201,5,4,1,4848,1212,6060
430060,202201,3921,2266,1655,2747606.4,2007072.4,4754678.8
430063,202201,54,45,9,54540,10908,65448
430064,202201,160,124,36,150288,43632,193920
430066,202201,6,3,3,3636,3636,7272
430070,202201,43,32,11,38784,13332,52116
430080,202201,76,48,28,58176,33936,92112
430085,202201,28,13,15,15756,18180,33936
430087,202201,23,16,7,19392.8,8484,27876.8
430090,202201,65,55,10,66660,12120,78780
430100,202201,136,93,43,112716.6,52116,164832.6
430105,202201,148,84,64,101808,77568,179376
430107,202201,19,13,6,15756,7272,23028
430110,202201,490,266,224,324816,271488,596304
430120,202201,164,148,16,179376,19392,198768
430130,202201,785,474,311,574488,376932.6,951420.6
430140,202201,131,119,12,144228,14544,158772
430150,202201,101,64,37,77568,44844,122412
430155,202201,29,24,5,29088,6060,35148
430160,202201,3623,2078,1545,2522174.6,1874964.6,4397139.2
430163,202201,405,183,222,223008,269064,492072
430165,202201,32,20,12,24240,14544,38784
430170,202201,82,68,14,82416,16968,99384
430175,202201,82,62,20,75144,24240,99384
430180,202201,105,85,20,103020,24240,127260
430185,202201,28,19,9,23028,10908,33936
430187,202201,52,28,24,33936,29088,63024
430190,202201,227,117,110,141804,133320,275124
430192,202201,15,11,4,13332,4848,18180
430195,202201,17,11,6,13332,7272,20604
430200,202201,156,132,24,159984,29088.2,189072.2
430205,202201,20,20,0,24240,,24240.0
430210,202201,713,542,171,656904,207252,864156
430215,202201,11,10,1,12120,1212,13332
430220,202201,73,49,24,60600,29088,89688
430222,202201,12,4,8,4848,9696,14544
430223,202201,16,10,6,12120,7272,19392
430225,202201,2,1,1,1212,1212,2424
430230,202201,316,190,126,230280,152712,382992
430235,202201,46,32,14,39996,16968,56964
430237,202201,20,15,5,18180,6060,24240
430240,202201,109,75,34,90900,41208,132108
430245,202201,69,55,14,66660,16968,83628
430250,202201,188,107,81,129684,98172,227856
430258,202201,8,7,1,8484,1212,9696
430260,202201,34,28,6,33936,7272,41208
430265,202201,35,30,5,36360,6060,42420
430270,202201,521,377,144,458136.2,174528,632664.2
430280,202201,1072,630,442,764773.2,536916,1301689.2
430290,202201,424,219,205,265428,248460,513888
430300,202201,2116,1127,989,1368348.6,1198670.2,2567018.8
430310,202201,2058,1005,1053,1219272.6,1279874.72,2499147.32
430320,202201,55,46,9,55752,10908,66660
430330,202201,92,80,12,99384,14544,113928
430340,202201,65,52,13,63024,15756,78780
430350,202201,1672,1098,574,1331988,695688.6,2027676.6
430355,202201,19,17,2,20604,2424,23028
430360,202201,89,42,47,50904,56964,107868
430367,202201,39,29,10,35148,12120,47268
430370,202201,57,50,7,61812,8484,70296
430380,202201,116,88,28,106656,33936,140592
430390,202201,571,348,223,424200,270276,694476
430400,202201,261,183,78,221796.6,94536,316332.6
430410,202201,59,47,12,56964.6,14544,71508.6
430420,202201,511,319,192,387840.2,232704,620544.2
430430,202201,52,50,2,59792.8,2424,62216.8
430435,202201,141,107,34,129684,41208,170892
430440,202201,535,332,203,402384.4,246036,648420.4
430450,202201,1175,960,215,1163520.6,260580,1424100.6
430460,202201,5667,2890,2777,3508741.44,3365724.6,6874466.04
430461,202201,16,14,2,16968,2424,19392
430462,202201,4,2,2,2424,2424,4848
430463,202201,1154,619,535,752652,649632,1402284
430465,202201,24,13,11,15756,13332,29088
430466,202201,654,456,198,552672.6,239976,792648.6
430467,202201,118,70,48,84840,58176,143016
430468,202201,137,79,58,95748,70296.6,166044.6
430469,202201,19,15,4,18180,4848,23028
430470,202201,1136,625,511,759072.7,620544,1379616.7
430471,202201,65,42,23,50904,29088,79992
430480,202201,116,80,36,96960,43632,140592
430485,202201,8,8,0,9696.6,,9696.6
430490,202201,77,61,16,73932,19392,93324
430495,202201,32,24,8,29088,9696,38784
430500,202201,187,125,62,151500,75144,226644
430510,202201,3657,2365,1292,2871229.35,1567116,4438345.35
430511,202201,15,15,0,18180,,18180.0
430512,202201,153,104,49,126048,59388,185436
430513,202201,50,39,11,47268,13332,60600
430515,202201,25,24,1,29088,1212,30300
430517,202201,177,147,30,178164,36360,214524
430520,202201,336,238,98,288456,118776,407232
430530,202201,79,44,35,53328,42420,95748
430535,202201,448,296,152,359964,184224,544188
430537,202201,11,11,0,13332,,13332.0
430540,202201,79,53,26,64236,31512,95748
430543,202201,380,117,263,141804,318756,460560
430544,202201,44,41,3,49692,3636,53328
430545,202201,396,183,213,223008.6,258156,481164.6
430550,202201,42,34,8,41208,9696,50904
430558,202201,1,1,0,1212,,1212.0
430560,202201,53,30,23,36360,27876,64236
430570,202201,116,49,67,59388,81204,140592
430580,202201,126,101,25,122412,30300,152712
430583,202201,15,15,0,18180,,18180.0
430585,202201,12,8,4,9696,4848,14544
430587,202201,13,8,5,9696,6060,15756
430590,202201,156,127,29,155136,35148,190284
430593,202201,2,2,0,2424,,2424.0
430595,202201,16,13,3,15756,3636,19392
430597,202201,48,27,21,32724,25452,58176
430600,202201,219,169,50,204828,60600,265428
430605,202201,169,97,72,118776,87264,206040
430607,202201,29,23,6,27876,7272,35148
430610,202201,1717,803,914,974448,1111404.6,2085852.6
430613,202201,5,5,0,6060,,6060.0
430620,202201,105,78,27,94536,32724,127260
430630,202201,45,38,7,46056,8484,54540
430632,202201,30,25,5,30300,6060,36360
430635,202201,40,32,8,38784,9696,48480
430637,202201,67,33,34,39996,41208,81204
430640,202201,176,97,79,117564,96960,214524
430642,202201,17,15,2,18180,2424,20604
430645,202201,28,24,4,29088,4848,33936
430650,202201,249,199,50,241188.99,60600,301788.99
430655,202201,5,4,1,4848,1212,6060
430660,202201,968,470,498,570852,604788,1175640
430670,202201,73,49,24,59388,29088,88476
430673,202201,80,49,31,59388,37572,96960
430675,202201,8,6,2,7272,2424,9696
430676,202201,585,343,242,418140,293304,711444
430680,202201,239,157,82,190284.6,99384,289668.6
430690,202201,526,321,205,389052,248460.95,637512.95
430692,202201,9,7,2,8484,2424,10908
430693,202201,138,86,52,104232,63024,167256
430695,202201,64,53,11,64236,13332,77568
430697,202201,64,39,25,47268,30300,77568
430700,202201,1400,945,455,1147764.6,555096,1702860.6
430705,202201,29,26,3,31512,3636,35148
430710,202201,252,156,96,189072,116352,305424
430720,202201,108,91,17,110292,20604,130896
430730,202201,143,121,22,146652,26664,173316
430740,202201,76,50,26,60600,31512,92112
430745,202201,30,19,11,23028,13332,36360
430750,202201,335,220,115,266640,139380,406020
430755,202201,88,47,41,56964,49692,106656
430760,202201,391,215,176,260580.76,213312,473892.76
430770,202201,1571,816,755,988992.6,917484.4,1906477.0
430780,202201,317,198,119,239976,144228,384204
430781,202201,26,23,3,27876,3636,31512
430783,202201,66,51,15,61812,18180,79992
430786,202201,5,3,2,3636,2424,6060
430790,202201,523,332,191,403596,231492,635088
430800,202201,152,119,33,144228.61,39996,184224.61
430805,202201,38,31,7,37572,8484,46056
430807,202201,57,33,24,41208,29088,70296
430810,202201,74,48,26,58176,31512,89688
430820,202201,147,92,55,111504,66660,178164
430825,202201,11,9,2,10908,2424,13332
430830,202201,243,226,17,273912.6,20604,294516.6
430840,202201,138,91,47,110292,56964,167256
430843,202201,6,4,2,4848,2424,7272
430845,202201,73,41,32,49692,38784,88476
430850,202201,584,415,169,502980,204828,707808
430860,202201,153,97,56,117564,67872,185436
430865,202201,75,38,37,46056,44844,90900
430870,202201,75,60,15,72720,18180,90900
430880,202201,157,116,41,140592,49692,190284
430885,202201,10,9,1,10908,1212,12120
430890,202201,338,199,139,241188,168468,409656
430900,202201,523,361,162,437532,197556,635088
430905,202201,127,55,72,66660,88476,155136
430910,202201,278,153,125,185436.6,151500,336936.6
430912,202201,4,4,0,4848,,4848.0
430915,202201,37,34,3,41208,3636,44844
430920,202201,4501,2359,2142,2861532,2599740,5461272
430925,202201,5,4,1,4848,1212,6060
430930,202201,2059,1180,879,1435010,1065348,2500358
430940,202201,254,161,93,195132,112716,307848
430950,202201,153,125,28,151500,33936,185436
430955,202201,24,13,11,15756,13332,29088
430957,202201,24,21,3,25452,3636,29088
430960,202201,243,159,84,192708,101808,294516
430965,202201,105,68,37,82416,44844,127260
430970,202201,91,73,18,88476,21816,110292
430975,202201,46,40,6,48480,7272,55752
430980,202201,51,31,20,37572,24240,61812
430990,202201,101,77,24,93324,29088,122412
430995,202201,116,107,9,129684,10908,140592
431000,202201,293,146,147,176952.6,178164,355116.6
431010,202201,355,203,152,247248.6,184224,431472.6
431020,202201,1874,1085,789,1315020,959904.6,2274924.6
431030,202201,38,30,8,36360,9696,46056
431033,202201,447,204,243,247248,295728,542976
431036,202201,13,7,6,8484,7272,15756
431040,202201,143,91,52,110292,63024,173316
431041,202201,37,21,16,25452,19392,44844
431043,202201,39,22,17,26664,20604,47268
431046,202201,13,10,3,12120,3636,15756
431050,202201,204,127,77,153924,93324,247248
431053,202201,69,36,33,43632,39996,83628
431055,202201,66,44,22,53328,26664,79992
431057,202201,17,17,0,20604,,20604.0
431060,202201,1575,1012,563,1228968.98,683568,1912536.98
431065,202201,17,8,9,9696,10908,20604
431070,202201,59,52,7,64236,8484,72720
431075,202201,7,7,0,8484,,8484.0
431080,202201,129,75,54,90900,65448,156348
431085,202201,33,29,4,35148,4848,39996
431087,202201,12,10,2,12120,2424,14544
431090,202201,52,39,13,47268,15756,63024
431100,202201,1242,737,505,893244,613272,1506516
431110,202201,218,130,88,158772,107868,266640
431112,202201,27,20,7,24240,8484,32724
431113,202201,31,23,8,27876,9696,37572
431115,202201,158,112,46,135744,55752,191496
431120,202201,593,340,253,412080,306636,718716
431123,202201,4,4,0,4848,,4848.0
431125,202201,97,84,13,101808,15756,117564
431127,202201,5,3,2,3636,2424,6060
431130,202201,726,479,247,580548,300576,881124
431140,202201,785,543,242,658116.6,294516,952632.6
431142,202201,20,18,2,21816.84,2424,24240.84
431150,202201,199,149,50,180588,60600,241188
431160,202201,46,43,3,52116,3636,55752
431162,202201,3,3,0,3636,,3636.0
431164,202201,4,4,0,4848,,4848.0
431170,202201,114,83,31,100596,37572,138168
431171,202201,71,41,30,49692,36360,86052
431173,202201,1,1,0,1212,,1212.0
431175,202201,208,110,98,133320.6,118776,252096.6
431177,202201,90,64,26,77568,31512,109080
431179,202201,14,10,4,12120,4848,16968
431180,202201,406,253,153,306636,185436,492072
431190,202201,74,54,20,65448,24240,89688
431198,202201,67,47,20,56964,24240,81204
431200,202201,20,16,4,19392,4848,24240
431205,202201,21,19,2,23028,2424,25452
431210,202201,102,66,36,79992,43632,123624
431213,202201,35,28,7,33936,8484,42420
431215,202201,23,20,3,24240,3636,27876
431217,202201,7,6,1,7272,1212,8484
431220,202201,68,58,10,70296,12120,82416
431225,202201,166,105,61,127260,73932,201192
431230,202201,96,84,12,101808,14544,116352
431235,202201,5,5,0,6060,,6060.0
431237,202201,12,9,3,10908,3636,14544
431238,202201,12,9,3,10908,3636,14544
431240,202201,1073,658,415,797497.2,502980,1300477.2
431242,202201,40,39,1,47268,1212,48480
431244,202201,18,14,4,16968,4848,21816
431245,202201,50,37,13,44844,15756,60600
431247,202201,10,6,4,7272,4848,12120
431250,202201,287,141,146,170892,176952,347844
431260,202201,54,46,8,55752,9696,65448
431261,202201,18,12,6,14544,7272,21816
431262,202201,15,13,2,15756,2424,18180
431265,202201,154,81,73,99384,88476,187860
431267,202201,17,15,2,18180,2424,20604
431270,202201,329,255,74,309060,89688,398748
431275,202201,40,35,5,42420,6060,48480
431280,202201,18,14,4,16968,4848,21816
431290,202201,17,15,2,18180,2424,20604
431295,202201,2,1,1,1212,1212,2424
431300,202201,20,18,2,21816,2424,24240
431301,202201,6,6,0,7272,,7272.0
431303,202201,59,37,22,44844,26664,71508
431306,202201,241,126,115,152712,139380,292092
431308,202201,6,4,2,4848,2424,7272
431310,202201,65,52,13,63024,15756,78780
431320,202201,168,101,67,122412.6,81204,203616.6
431330,202201,193,123,70,149076,86052,235128
431333,202201,28,22,6,26664,7272,33936
431335,202201,7,4,3,4848,3636,8484
431337,202201,391,181,210,219372.6,254520,473892.6
431339,202201,22,17,5,20604,6060,26664
431340,202201,3129,1692,1437,2051821.45,1744069.4,3795890.85
431342,202201,37,24,13,29088.6,15756,44844.6
431344,202201,18,18,0,21816,,21816.0
431346,202201,5,4,1,4848,1212,6060
431349,202201,33,29,4,36360,4848,41208
431350,202201,1003,547,456,664177.6,552672.6,1216850.2
431360,202201,52,40,12,48480,14544,63024
431365,202201,354,147,207,179376,250884,430260
431370,202201,1195,683,512,829008.6,620544,1449552.6
431380,202201,98,88,10,106656,12120,118776
431390,202201,503,273,230,333300,278760,612060
431395,202201,324,135,189,164832,229068,393900
431400,202201,38,25,13,30300,16968,47268
431402,202201,101,71,30,86052,36360,122412
431403,202201,22,14,8,16968,9696,26664
431405,202201,698,392,306,476316.6,372084,848400.6
431406,202201,36,28,8,33936,9696,43632
431407,202201,47,36,11,43632,13332,56964
431410,202201,3393,2050,1343,2487024.8,1630140.2,4117165.0
431413,202201,17,14,3,16968,3636,20604
431415,202201,68,49,19,59388,23028,82416
431417,202201,25,11,14,13332,16968,30300
431420,202201,344,230,114,278760,139380,418140
431430,202201,58,29,29,35148,35148,70296
431440,202201,9062,6170,2892,7482897.44,3507585.75,10990483.19
431442,202201,28,15,13,18180,15756,33936
431445,202201,28,26,2,32724,2424,35148
431446,202201,4,3,1,3636,1212,4848
431447,202201,83,60,23,72720,27876,100596
431449,202201,55,42,13,50904,15756.6,66660.6
431450,202201,409,269,140,326028.6,169680,495708.6
431454,202201,12,7,5,8484,6060,14544
431455,202201,45,36,9,43632,10908,54540
431460,202201,496,339,157,413292,190284,603576
431470,202201,129,96,33,116352,39996,156348
431475,202201,8,7,1,8484,1212,9696
431477,202201,39,24,15,29088,18180,47268
431478,202201,9,8,1,9696,1212,10908
431480,202201,579,346,233,419352,282396.6,701748.6
431490,202201,29044,16075,12969,19509774.34,15752372,35262146.34
431500,202201,79,62,17,75144,20604,95748
431505,202201,30,20,10,24240,12120,36360
431507,202201,9,7,2,8484,2424,10908
431510,202201,228,166,62,202404.4,75144,277548.4
431513,202201,21,20,1,24240,2424,26664
431514,202201,6,3,3,3636,3636,7272
431515,202201,81,66,15,81204,18180,99384
431517,202201,7,4,3,4848,3636,8484
431520,202201,38,33,5,39996,6060,46056
431530,202201,1407,626,781,761136,947784,1708920
431531,202201,21,19,2,23028,2424,25452
431532,202201,36,27,9,32724,10908,43632
431535,202201,27,14,13,16968,15756,32724
431540,202201,138,113,25,136956,30300.6,167256.6
431545,202201,12,10,2,12120,2424,14544
431550,202201,359,192,167,232704,202404,435108
431555,202201,10,10,0,12120,,12120.0
431560,202201,4667,3111,1556,3775386.56,1893144,5668530.56
431570,202201,828,431,397,522373.2,483588.6,1005961.8
431575,202201,48,27,21,32724,25452,58176
431580,202201,86,58,28,70296,35148,105444
431590,202201,142,118,24,143016,29088,172104
431595,202201,18,15,3,18180,3636,21816
431600,202201,255,147,108,178164,130896,309060
431610,202201,114,84,30,101808,36360,138168
431620,202201,41,34,7,41208,8484,49692
431630,202201,127,103,24,124836,29088,153924
431640,202201,1333,831,502,1008384.6,612060.6,1620445.2
431642,202201,35,32,3,38784,3636,42420
431643,202201,43,17,26,20604,31512,52116
431645,202201,320,185,135,224220,163620,387840
431647,202201,9,8,1,9696,1212,10908
431650,202201,31,17,14,20604,16968,37572
431660,202201,271,170,101,206040.8,122412,328452.8
431670,202201,223,99,124,119988,150288,270276
431673,202201,13,11,2,13332,2424,15756
431675,202201,26,21,5,25452,6060,31512
431680,202201,1146,837,309,1016868,375720,1392588
431690,202201,4884,2892,1992,3509956.02,2416729.8,5926685.82
431695,202201,21,15,6,18180,7272,25452
431697,202201,2,1,1,1212,1212,2424
431700,202201,184,138,46,167256,55752,223008
431710,202201,4056,1757,2299,2129485.4,2787600,4917085.4
431720,202201,1288,787,501,955662.4,608424,1564086.4
431725,202201,1,1,0,1212,,1212.0
431730,202201,1142,760,382,921123.04,464196,1385319.04
431740,202201,1323,637,686,773256,831433.2,1604689.2
431750,202201,1833,1194,639,1448341.53,775680,2224021.53
431755,202201,7,5,2,6060,2424,8484
431760,202201,978,609,369,739321.4,448440,1187761.4
431770,202201,422,290,132,351480,159984,511464
431775,202201,25,19,6,23028,7272,30300
431780,202201,550,331,219,402384,265428,667812
431790,202201,154,120,34,145440,41208,186648
431795,202201,13,10,3,12120,3636,15756
431800,202201,3183,1663,1520,2016772.09,1842241.2,3859013.29
431805,202201,19,17,2,20604,2424,23028
431810,202201,594,388,206,470256,249672,719928
431820,202201,330,193,137,235128.6,167256,402384.6
431830,202201,2280,1378,902,1670136.6,1095648,2765784.6
431840,202201,476,313,163,379356.6,197556,576912.6
431842,202201,37,30,7,36360,8484,44844
431843,202201,11,8,3,9696,3636,13332
431844,202201,17,12,5,14544,6060,20604
431845,202201,25,22,3,26664,3636,30300
431846,202201,26,22,4,26664,4848,31512
431848,202201,15,13,2,15756,2424,18180
431849,202201,5,5,0,6060,,6060.0
431850,202201,759,590,169,715080,204828,919908
431860,202201,121,80,41,96960,49692,146652
431861,202201,6,2,4,2424,4848,7272
431862,202201,59,42,17,50904,20604,71508
431870,202201,3609,2037,1572,2471270.27,1908900,4380170.27
431880,202201,963,686,277,832644,335724,1168368
431890,202201,1254,731,523,885972.6,633876,1519848.6
431900,202201,187,130,57,157560,69084,226644
431910,202201,49,35,14,42420,16968,59388
431912,202201,50,30,20,36360,24240,60600
431915,202201,148,112,36,135744,43632,179376
431920,202201,152,111,41,135744,49692,185436
431930,202201,81,68,13,82416,15756,98172
431935,202201,3,2,1,2424,1212,3636
431936,202201,3,3,0,3636,,3636.0
431937,202201,20,15,5,18180,6060,24240
431940,202201,466,316,150,384204,181800,566004
431950,202201,475,302,173,366024,210888,576912
431960,202201,735,395,340,479952,412080,892032
431970,202201,69,63,6,76356,7272,83628
431971,202201,5,3,2,3636,2424,6060
431973,202201,17,14,3,16968,3636,20604
431975,202201,9,9,0,10908,,10908.0
431980,202201,205,121,84,146652.6,101808,248460.6
431990,202201,1104,591,513,717425.74,621756,1339181.74
432000,202201,1829,951,878,1155038.4,1064136.6,2219175.0
432010,202201,260,176,84,213312,101808,315120
432020,202201,178,148,30,180588,36360,216948
432023,202201,14,12,2,14544,2424,16968
432026,202201,54,48,6,58176,7272,65448
432030,202201,62,31,31,37572,37572,75144
432032,202201,15,11,4,13332,4848,18180
432035,202201,61,47,14,56964,16968,73932
432040,202201,85,56,29,67872,35148,103020
432045,202201,2,2,0,2424,,2424.0
432050,202201,81,48,33,58176,39996,98172
432055,202201,128,93,35,112716,42420,155136
432057,202201,6,4,2,4848.6,2424,7272.6
432060,202201,36,31,5,37572,6060,43632
432065,202201,29,26,3,31512,3636,35148
432067,202201,87,80,7,96960,8484,105444
432070,202201,381,296,85,360267.2,103020,463287.2
432080,202201,818,575,243,696900.6,294516,991416.6
432085,202201,8,6,2,7272,2424,9696
432090,202201,266,179,87,216948,105444,322392
432100,202201,172,111,61,134532,73932,208464
432110,202201,548,360,188,436320,227856,664176
432120,202201,1011,571,440,694477.2,535704,1230181.2
432130,202201,490,349,141,424200.8,172104,596304.8
432132,202201,25,22,3,26664,3636,30300
432135,202201,78,63,15,76356,19392,95748
432140,202201,264,199,65,241188,78780,319968
432143,202201,216,127,89,153924,107868,261792
432145,202201,277,189,88,229068,106656,335724
432146,202201,13,12,1,14544,1212,15756
432147,202201,112,60,52,72720,64236,136956
432149,202201,16,10,6,12120,7272,19392
432150,202201,989,609,380,738108.6,461772,1199880.6
432160,202201,1625,833,792,1013232.46,959904,1973136.46
432162,202201,3,2,1,2424,1212,3636
432163,202201,17,12,5,14544,6060,20604
432166,202201,123,90,33,109383,39996,149379
432170,202201,228,114,114,138168,138168,276336
432180,202201,569,355,214,430260,260580.6,690840.6
432183,202201,10,9,1,10908,1212,12120
432185,202201,75,62,13,75144,15756,90900
432190,202201,506,298,208,361176,252096,613272
432195,202201,92,78,14,94536,16968,111504
432200,202201,407,252,155,305424,187860,493284
432210,202201,112,69,43,83628,52116,135744
432215,202201,32,30,2,36360,2424,38784
432218,202201,20,20,0,24240,,24240.0
432220,202201,630,321,309,390264,375720,765984
432225,202201,18,12,6,14544,7272,21816
432230,202201,127,80,47,96960,56964,153924
432232,202201,23,19,4,23028,4848,27876
432234,202201,3,1,2,1212,2424,3636
432235,202201,2,2,0,2424,,2424.0
432237,202201,23,15,8,18180,9696,27876
432240,202201,4436,2476,1960,3002125.8,2382793.8,5384919.6
432250,202201,1111,727,384,881124,466620,1347744
432252,202201,50,49,1,59388,1212,60600
432253,202201,61,49,12,59388,14544,73932
432254,202201,28,12,16,14544,19392,33936
432255,202201,13,11,2,13332,2424,15756
432260,202201,839,668,171,810828.6,208464,1019292.6
432270,202201,217,162,55,196344,66660,263004
432280,202201,147,111,36,134532.4,44844,179376.4
432285,202201,1,1,0,1212,,1212.0
432290,202201,55,48,7,58176,8484,66660
432300,202201,4876,2593,2283,3143849.82,2769421.5,5913271.32
432310,202201,126,105,21,128472,25452,153924
432320,202201,22,17,5,20604,6060,26664
432330,202201,15,10,5,12120,6060,18180
432335,202201,8,6,2,7272,2424,9696
432340,202201,37,31,6,37572,7272,44844
432345,202201,111,74,37,89688.6,44844,134532.6
432350,202201,22,21,1,25452,1212,26664
432360,202201,5,4,1,4848,1212,6060
432370,202201,25,25,0,30300,,30300.0
432375,202201,27,25,2,30300,2424,32724
432377,202201,6,6,0,7272,,7272.0
432380,202201,184,79,105,95748,127260,223008
500020,202201,261,135,126,163620,152712,316332
500025,202201,137,67,70,81204,84840,166044
500060,202201,1437,907,530,1100496,644785.2,1745281.2
500070,202201,737,350,387,425412,469044,894456
500080,202201,136,106,30,128472,36360,164832
500085,202201,133,106,27,128472.6,32724,161196.6
500090,202201,368,170,198,206040,239976,446016
500100,202201,703,367,336,444804,407233.2,852037.2
500110,202201,2277,1080,1197,1311384.6,1454401.2,2765785.8
500124,202201,267,146,121,176952,146652,323604
500150,202201,336,135,201,163620,243612,407232
500190,202201,518,345,173,418140,209676.6,627816.6
500200,202201,205,172,33,208464.32,39996,248460.32
500210,202201,1608,541,1067,656904,1293204,1950108
500215,202201,205,118,87,143016,105444,248460
500220,202201,722,459,263,556308.12,318756,875064.12
500230,202201,226,137,89,166044,107868,273912
500240,202201,644,424,220,515100,266640.6,781740.6
500260,202201,582,226,356,273912,432684,706596
500270,202201,29983,12899,17084,15648607.56,20722782,36371389.56
500280,202201,198,67,131,81204,159984,241188
500290,202201,1168,719,449,871428.6,544188,1415616.6
500295,202201,456,295,161,357540.6,195132,552672.6
500310,202201,105,38,67,46056,81204,127260
500315,202201,812,450,362,547824,438744,986568
500320,202201,3673,1764,1909,2140393.85,2314920,4455313.85
500325,202201,907,499,408,606000,494496.6,1100496.6
500330,202201,1503,704,799,853226.78,969600,1822826.78
500345,202201,309,231,78,281184.6,94536,375720.6
500348,202201,251,154,97,186648,117564,304212
500350,202201,105,50,55,60600,66660,127260
500370,202201,5704,2581,3123,3129388.19,3787501,6916889.19
500375,202201,350,237,113,287244,136956,424200
500380,202201,599,339,260,410868,315120,725988
500390,202201,71,34,37,41208,44844,86052
500400,202201,211,137,74,167256,89688,256944
500410,202201,512,218,294,265428,358752,624180
500430,202201,544,377,167,458136,202404,660540
500440,202201,213,116,97,140592,117564,258156
500450,202201,417,179,238,216948,288456,505404
500460,202201,265,143,122,173316.6,147864,321180.6
500470,202201,418,316,102,382992,124836,507828
500480,202201,104,61,43,73932,52116,126048
500490,202201,99,44,55,53328,66660,119988
500500,202201,1434,527,907,639936,1101708,1741644
500510,202201,41,34,7,41208,8484,49692
500515,202201,99,68,31,82416.7,37572,119988.7
500520,202201,290,154,136,186648.8,167256,353904.8
500525,202201,90,49,41,59388,49692,109080
500540,202201,893,390,503,472680,609636,1082316
500560,202201,908,502,406,610848,492072.6,1102920.6
500568,202201,1008,538,470,652056,569640,1221696
500570,202201,1176,682,494,826584.8,598729.2,1425314.0
500580,202201,321,168,153,203616,185436,389052
500600,202201,353,174,179,210888,218160,429048
500620,202201,930,648,282,789012.74,342996,1132008.74
500625,202201,76,60,16,72720,19392,92112
500627,202201,40,18,22,21816,26664,48480
500630,202201,1560,891,669,1080596.77,810828,1891424.77
500635,202201,515,307,208,372084,252096,624180
500640,202201,360,196,164,237552,198768,436320
500660,202201,5729,2071,3658,2512477.4,4438344.6,6950822.0
500690,202201,603,213,390,258156,472680,730836
500710,202201,393,194,199,235128.6,241188.6,476317.2
500720,202201,933,509,424,618120,515100.6,1133220.6
500730,202201,161,97,64,117564.6,78780,196344.6
500740,202201,915,375,540,454500,655692,1110192
500750,202201,167,54,113,65448,136956,202404
500755,202201,118,89,29,107868,35148,143016
500769,202201,737,406,331,492072.6,401172,893244.6
500770,202201,438,243,195,294516.6,236340,530856.6
500780,202201,136,92,44,111504,53328,164832
500790,202201,1038,511,527,619332,638724,1258056
500793,202201,294,150,144,181800,174528.6,356328.6
500795,202201,164,107,57,129684,69084,198768
500797,202201,49,33,16,39996,19392,59388
500800,202201,422,181,241,219372,292092,511464
500830,202201,2228,1210,1018,1466521.95,1236240,2702761.95
500840,202201,121,91,30,110292,36360,146652
510010,202201,169,94,75,113928,90900,204828
510020,202201,530,236,294,286032,356328,642360
510025,202201,1670,930,740,1128372.54,896880,2025252.54
510030,202201,664,340,324,413292,392688,805980
510035,202201,133,71,62,86052,75144,161196
510040,202201,412,197,215,238764,260580.68,499344.68
510050,202201,378,204,174,247248,210888.39,458136.39
510060,202201,127,64,63,77568,76356,153924
510080,202201,245,92,153,111504,185436.6,296940.6
510100,202201,65,27,38,32724,46056,78780
510120,202201,33,20,13,24240,15756,39996
510125,202201,375,231,144,281184,174528,455712
510130,202201,543,329,214,398748,259368.6,658116.6
510140,202201,442,141,301,170892,364812,535704
510160,202201,100,34,66,41208,79992,121200
510170,202201,748,457,291,553884,352692,906576
510180,202201,2885,1330,1555,1613175.6,1884660.2,3497835.8
510185,202201,24,13,11,15756,13332,29088
510190,202201,238,83,155,100596,189072,289668
510250,202201,2642,1627,1015,1976772,1231393.2,3208165.2
510260,202201,175,125,50,151500,60600,212100
510263,202201,468,263,205,318756.2,248460,567216.2
510267,202201,620,338,282,409656.6,341784,751440.6
510268,202201,62,28,34,33936,41208,75144
510269,202201,74,34,40,41208,48480,89688
510270,202201,379,185,194,224220,235128,459348
510279,202201,199,152,47,184224,56964,241188
510285,202201,177,71,106,86052,128472,214524
510300,202201,508,267,241,323604,295728,619332
510305,202201,199,91,108,110292,130896,241188
510310,202201,108,54,54,65448,65448,130896
510320,202201,814,509,305,616908,370872,987780
510325,202201,424,174,250,210888,303000,513888
510330,202201,427,235,192,286032,232704,518736
510335,202201,639,375,264,454500,319968,774468
510336,202201,55,39,16,47268,20604,67872
510337,202201,102,46,56,55752,67872,123624
510340,202201,17600,7862,9738,9538445.95,11813367.8,21351813.75
510343,202201,64,47,17,56964,20604,77568
510345,202201,157,98,59,118776,71508.6,190284.6
510350,202201,652,351,301,425412,364812,790224
510360,202201,213,134,79,162408,95748,258156
510370,202201,153,70,83,84840,100596,185436
510380,202201,80,60,20,72720,24240,96960
510385,202201,58,26,32,31512,38784,70296
510390,202201,100,44,56,53328,67872,121200
510395,202201,48,33,15,39996,18180,58176
510410,202201,745,470,275,569640,334512,904152
510420,202201,556,269,287,326028,347844,673872
510450,202201,51,25,26,30300,31512,61812
510452,202201,51,23,28,27876,33936,61812
510454,202201,51,24,27,29088,32724,61812
510455,202201,128,74,54,89688,65448,155136
510460,202201,180,82,98,99384,118776,218160
510480,202201,705,418,287,506616.32,347844.6,854460.92
510490,202201,338,167,171,202404,207252,409656
510500,202201,230,173,57,209676,69084,278760
510510,202201,796,460,336,557521.2,408444,965965.2
510515,202201,1254,647,607,784164,735684,1519848
510517,202201,268,123,145,149076,175740,324816
510520,202201,214,142,72,172104,87264,259368
510523,202201,108,84,24,101808,29088,130896
510525,202201,853,511,342,619332.8,414504,1033836.8
510530,202201,19,12,7,14544,8484,23028
510550,202201,240,110,130,133320,157560,290880
510558,202201,291,142,149,172104,180588,352692
510560,202201,396,221,175,267852.6,212100,479952.6
510562,202201,641,463,178,561156,215736,776892
510590,202201,716,364,352,441168,426624,867792
510600,202201,222,115,107,139380,129684,269064
510610,202201,223,93,130,112716,157560,270276
510615,202201,188,87,101,105444,122412,227856
510617,202201,26,12,14,14544,16968,31512
510618,202201,121,59,62,72720,75144,147864
510619,202201,86,61,25,75144,30300,105444
510620,202201,158,89,69,107868,83628,191496
510621,202201,174,110,64,133320,77568,210888
510622,202201,473,264,209,319968,253308,573276
510623,202201,289,195,94,237552,115140,352692
510624,202201,85,45,40,54540,48480,103020
510625,202201,510,324,186,393900,225432.95,619332.95
510626,202201,111,63,48,76356,58176,134532
510627,202201,89,62,27,75144,32724,107868
510628,202201,158,96,62,116352,75144,191496
510629,202201,267,158,109,193920,132129.81,326049.81
510630,202201,434,213,221,259368,269064.6,528432.6
510631,202201,16,8,8,9696,9696,19392
510637,202201,348,198,150,239976,181800,421776
510642,202201,1051,560,491,678720,595092,1273812
510645,202201,8,1,7,1212,8484,9696
510650,202201,1321,864,457,1048380.6,556308,1604688.6
510665,202201,81,32,49,38784,59388,98172
510670,202201,56,30,26,36360,31512,67872
510675,202201,1113,713,400,866580,486012,1352592
510677,202201,350,187,163,226644.6,197556,424200.6
510680,202201,94,57,37,69084,46056,115140
510682,202201,192,96,96,116352,116352,232704
510685,202201,55,40,15,48480,18180,66660
510700,202201,559,314,245,380568,296940,677508
510704,202201,1169,605,564,734472,684780,1419252
510706,202201,144,75,69,90900,83628,174528
510710,202201,415,287,128,347844,155136,502980
510715,202201,56,40,16,48480,19392,67872
510718,202201,229,112,117,135744,141804,277548
510719,202201,45,17,28,20604,33936,54540
510720,202201,184,130,54,157560,65448,223008
510724,202201,83,32,51,38784,61812,100596
510726,202201,63,31,32,37572,38784,76356
510729,202201,17,8,9,9696,10908,20604
510730,202201,468,254,214,309060,259368,568428
510735,202201,114,47,67,56964,82416,139380
510740,202201,21,11,10,13332,13332,26664
510757,202201,24,19,5,23028,6060,29088
510760,202201,7336,3741,3595,4536518,4359565.8,8896083.8
510770,202201,672,318,354,385416,429048,814464
510774,202201,20,8,12,9696,14544,24240
510775,202201,110,85,25,103020,30300,133320
510776,202201,37,12,25,14544,30300,44844
510777,202201,193,81,112,98172,135744,233916
510779,202201,36,21,15,25452,18180,43632
510780,202201,264,147,117,178164,141804,319968
510785,202201,356,195,161,236340,196344,432684
510787,202201,185,86,99,104232,119988,224220
510788,202201,6,1,5,1212,6060,7272
510790,202201,2567,1328,1239,1610804,1504092,3114896
510792,202201,1120,618,502,749016.6,609636.01,1358652.61
510794,202201,111,60,51,72720,61812,134532
510795,202201,2270,1325,945,1607112.96,1146552.6,2753665.56
510800,202201,186,112,74,135744,89688,225432
510805,202201,202,134,68,162408,82416,244824
510810,202201,100,41,59,49692,71508,121200
510820,202201,231,115,116,139380.92,140592.7,279973.62
510830,202201,77,42,35,50904,42420,93324
510835,202201,15,10,5,12120,6060,18180
510840,202201,9107,4272,4835,5182516.8,5863656,11046172.8
510850,202201,205,86,119,104232,144228,248460
510860,202201,406,194,212,235128,256944,492072
510880,202201,70,50,20,60600,24240,84840
510885,202201,67,40,27,48480,32724,81204
510890,202201,65,36,29,43632,35148,78780
510895,202201,167,99,68,119988,82416,202404
520005,202201,134,57,77,69084,93324,162408
520010,202201,289,127,162,155136,196344.2,351480.2
520013,202201,728,486,242,589032.6,293304.6,882337.2
520015,202201,47,33,14,39996,16968,56964
520017,202201,87,50,37,60600,44844,105444
520020,202201,17,9,8,10908,9696,20604
520025,202201,2633,1389,1244,1684681,1508940,3193621
520030,202201,798,433,365,526311.4,443592,969903.4
520050,202201,66,46,20,55752,24240,79992
520055,202201,61,39,22,47268,26664,73932
520060,202201,175,112,63,135744,77568,213312
520080,202201,565,410,155,498132,190284,688416
520082,202201,17,11,6,13332,7272,20604
520085,202201,88,66,22,79992,26664,106656
520090,202201,88,63,25,76356,30300,106656
520110,202201,9114,3899,5215,4728013.4,6326643,11054656.4
520120,202201,10,5,5,6060,6060,12120
520130,202201,813,571,242,692052.23,295728,987780.23
520140,202201,11928,6610,5318,8013746.6,6452692.08,14466438.68
520145,202201,54,32,22,38784,26664,65448
520150,202201,153,121,32,146652,38784,185436
520160,202201,47,33,14,39996,16968,56964
520170,202201,233,131,102,158772,124836,283608
520180,202201,179,81,98,98172,118776,216948
520215,202201,201,134,67,162408,81204,243612
520235,202201,81,63,18,76356,21816,98172
520250,202201,127,73,54,88476,65448,153924
520260,202201,114,70,44,84840,53328,138168
520280,202201,45,32,13,38784,15756,54540
520310,202201,45,26,19,31512,23028,54540
520320,202201,171,103,68,124836,82416,207252
520330,202201,810,440,370,534492,448440,982932
520340,202201,357,206,151,249672,183012,432684
520350,202201,499,242,257,293304,311484,604788
520355,202201,88,47,41,56964,49692,106656
520357,202201,25,20,5,24240,6060,30300
520360,202201,6,2,4,2424,4848,7272
520380,202201,140,78,62,94536,76356,170892
520390,202201,247,105,142,127260,173316,300576
520393,202201,16,13,3,15756,3636,19392
520396,202201,73,50,23,60600,27876,88476
520400,202201,198,121,77,146652.6,93324,239976.6
520410,202201,189,93,96,112716,116352,229068
520420,202201,20,12,8,14544,9696,24240
520425,202201,252,130,122,157560,147864.4,305424.4
520430,202201,511,244,267,295728,324816.6,620544.6
520440,202201,656,472,184,572064,223008,795072
520450,202201,2058,869,1189,1053229,1442280,2495509
520455,202201,56,31,25,37572,30300,67872
520460,202201,37,22,15,26664,18180,44844
520465,202201,29,25,4,31512,6060,37572
520470,202201,430,273,157,330876.6,192708,523584.6
520480,202201,82,46,36,55752,43632,99384
520485,202201,101,37,64,44844,77568,122412
520490,202201,435,325,110,393900,133320,527220
520495,202201,158,92,66,111504,79992,191496
520500,202201,182,143,39,173316,47268,220584
520505,202201,193,115,78,139380,94536,233916
520510,202201,1868,881,987,1068984.6,1197458,2266442.6
520520,202201,49,33,16,39996,19392,59388
520530,202201,211,166,45,203616,54540,258156
520540,202201,635,428,207,518776.4,250884,769660.4
520545,202201,136,75,61,90900,73932,164832
520547,202201,57,33,24,39996,29088,69084
520549,202201,1324,606,718,735684.94,871428,1607112.94
520551,202201,324,166,158,201192,191496.6,392688.6
520552,202201,33,24,9,29088,10908,39996
520570,202201,13,8,5,9696,6060,15756
520580,202201,270,169,101,204828,122412,327240
520590,202201,141,81,60,98172,72720,170892
520620,202201,1115,520,595,631453.8,725988.6,1357442.4
520630,202201,42,21,21,25452,25452,50904
520640,202201,372,219,153,265428,185436,450864
520650,202201,65,32,33,38784,39996,78780
520660,202201,42,22,20,26664,24240,50904
520670,202201,39,31,8,37572,9696,47268
520680,202201,43,26,17,31512,20604,52116
520690,202201,40,10,30,12120,36360,48480
520710,202201,35,30,5,37572,6060,43632
520725,202201,194,145,49,175740,59388,235128
520735,202201,55,35,20,42420,24240,66660
520740,202201,462,225,237,272700,287244,559944
520750,202201,34,25,9,30300,10908,41208
520753,202201,69,47,22,56964,26664,83628
520760,202201,103,67,36,81204,43632,124836
520780,202201,269,206,63,249672,76356,326028
520790,202201,157,92,65,112716,78780,191496
520800,202201,3387,1866,1521,2261593.66,1845876.72,4107470.38
520810,202201,148,114,34,138168,41208,179376
520815,202201,4,3,1,3636,1212,4848
520830,202201,145,98,47,118776,56964,175740
520840,202201,383,246,137,298152,167256,465408
520850,202201,98,54,44,66660,53328,119988
520860,202201,1754,1121,633,1358652,767196,2125848
520870,202201,31741,14640,17101,17758233.54,20759144.2,38517377.74
520880,202201,1170,626,544,758712.6,660540.6,1419253.2
520890,202201,790,485,305,587820,369660,957480
520910,202201,973,514,459,622969.44,556308,1179277.44
520915,202201,85,66,19,79992,23028,103020
520920,202201,439,209,230,253308,281184,534492
520929,202201,15,13,2,15756,2424,18180
520940,202201,65,46,19,55752,23028,78780
520945,202201,14,10,4,12120,4848,16968
520960,202201,39,24,15,29088,18180,47268
520970,202201,371,216,155,261792,187860,449652
520980,202201,93,66,27,79992,32724,112716
520990,202201,440,307,133,373296,161196,534492
520993,202201,128,65,63,78780,76356,155136
520995,202201,248,137,111,166044.04,135744,301788.04
521000,202201,1556,907,649,1099284,786588.2,1885872.2
521010,202201,665,341,324,414504.6,392688,807192.6
521015,202201,13,9,4,10908,4848,15756
521020,202201,1377,953,424,1155036,513888.6,1668924.6
521030,202201,58,37,21,44844,25452,70296
521040,202201,932,615,317,745380.6,384204.6,1129585.2
521056,202201,50,33,17,39996,20604,60600
521060,202201,126,80,46,99384,55752,155136
521080,202201,354,274,80,332088,96960,429048
521090,202201,556,362,194,439956,236340,676296
521100,202201,259,193,66,233916,79992,313908
521120,202201,1061,741,320,898092.6,387840,1285932.6
521130,202201,340,246,94,299364,113928.6,413292.6
521140,202201,181,96,85,116352,103020,219372
521150,202201,2570,1102,1468,1336836.6,1785276,3122112.6
521160,202201,23,9,14,10908,16968,27876
521170,202201,221,127,94,153924,113928,267852
521180,202201,1174,754,420,913850,510252.6,1424102.6
521190,202201,2523,1071,1452,1298052,1762248.31,3060300.31
521200,202201,55,40,15,48480,18180,66660
521205,202201,10,7,3,8484,3636,12120
521210,202201,120,75,45,90900,54540,145440
521220,202201,721,507,214,614484,259368,873852
521225,202201,24,18,6,21816,7272,29088
521230,202201,108,65,43,78780,53328,132108
521250,202201,6219,3483,2736,4223824.34,3319670.6,7543494.94
521260,202201,32,14,18,16968,21816,38784
521270,202201,136,103,33,124836,39996,164832
521280,202201,415,256,159,310272,193920,504192
521290,202201,26,18,8,21816,9696,31512
521295,202201,100,66,34,79992,41208,121200
521300,202201,220,120,100,145440,122412,267852
521305,202201,38,30,8,36360,9696,46056
521308,202201,996,759,237,919909.2,287244,1207153.2
521310,202201,1325,744,581,902940.6,705384,1608324.6
521340,202201,20,16,4,19392,4848,24240
521350,202201,116,88,28,106656,33936,140592
521370,202201,162,111,51,134532,61812,196344
521375,202201,185,92,93,111504.6,112716,224220.6
521377,202201,49,39,10,47268,12120,59388
521380,202201,1047,637,410,772044.6,496920,1268964.6
521385,202201,11,7,4,8484,4848,13332
521390,202201,99,81,18,98172,21816,119988
521400,202201,349,240,109,290880,132108,422988
521405,202201,144,82,62,99384,75144,174528
521410,202201,73,52,21,63024,25452,88476
521440,202201,201,138,63,167256,76356,243612
521450,202201,750,414,336,501768,408444,910212
521460,202201,1099,729,370,884760.55,452076,1336836.55
521470,202201,12,8,4,9696,4848,14544
521480,202201,39,29,10,35148,12120.6,47268.6
521483,202201,310,192,118,233918.18,143016,376934.18
521486,202201,293,189,104,229068,126048,355116
521487,202201,25,11,14,13332,16968,30300
521490,202201,24,13,11,15756,14544,30300
521500,202201,139,64,75,77568,90900,168468
521520,202201,45,34,11,41208,13332,54540
521523,202201,853,505,348,613272,421776,1035048
521525,202201,45,29,16,35148,19392,54540
521530,202201,239,132,107,159984,130896,290880
521540,202201,38,19,19,23028,23028,46056
521550,202201,101,44,57,53328,69084,122412
521560,202201,834,563,271,682356.6,328452.8,1010809.4
521565,202201,66,48,18,58176,21816,79992
521570,202201,534,338,196,409656.6,237552.6,647209.2
521580,202201,51,32,19,38784,23028,61812
521590,202201,34,15,19,18180,23028,41208
521600,202201,23,12,11,14544,13332,27876
521630,202201,237,126,111,152712,134532,287244
521640,202201,301,163,138,197556,167256.6,364812.6
521645,202201,37,20,17,24240,21816,46056
521680,202201,242,148,94,179376,115140.4,294516.4
521690,202201,9,8,1,9696,1212,10908
521710,202201,1133,540,593,654480,718716.6,1373196.6
521720,202201,527,366,161,443592,196344.96,639936.96
521730,202201,648,309,339,374508,410868,785376
521740,202201,885,391,494,475104,599940,1075044
521760,202201,2200,1148,1052,1392669.23,1277448,2670117.23
521770,202201,804,504,300,612060,363600,975660
521800,202201,1918,1254,664,1519849.2,804768,2324617.2
521805,202201,32,18,14,21816,16968,38784
521810,202201,95,55,40,66660,48480,115140
521830,202201,971,693,278,839916.77,339360.36,1179277.13
521839,202201,78,46,32,55752,38784,94536
521850,202201,1117,558,559,676297.21,678720.8,1355018.01
521860,202201,321,203,118,246036,143016,389052
521870,202201,76,47,29,56964,35148,92112
521878,202201,37,14,23,16968,27876,44844
521880,202201,4803,2114,2689,2565805.6,3263917.4,5829723.0
521890,202201,588,401,187,486053.16,226644,712697.16
521900,202201,278,221,57,267852,69084,336936
521910,202201,168,116,52,140592,63024,203616
521920,202201,43,22,21,26664,25452,52116
521925,202201,50,29,21,35148,25452,60600
521930,202201,1174,655,519,795072.6,629028.6,1424101.2
521935,202201,31,20,11,24240,13332,37572
521940,202201,216,96,120,116352,145440,261792
521945,202201,16,13,3,15756,3636,19392
521950,202201,15,10,5,12120,6060,18180
521960,202201,67,50,17,60600,20604,81204
521970,202201,403,258,145,312696,175740,488436
521971,202201,111,58,53,70296.4,64236,134532.4
521973,202201,38,19,19,23028,23028,46056
521975,202201,1577,798,779,970812.31,945361.4,1916173.71
521980,202201,242,162,80,196344,96960,293304
521990,202201,76,56,20,67872,24240,92112
522000,202201,290,188,102,227433.01,123624,351057.01
522005,202201,19,12,7,14544,8484,23028
522010,202201,1116,629,487,762348.87,590244,1352592.87
522015,202201,60,36,24,43632,29088,72720
522020,202201,878,513,365,621756,442380.2,1064136.2
522026,202201,25,16,9,19392,10908,30300
522028,202201,20,15,5,18180,6060,24240
522040,202201,778,327,451,396324,547824.6,944148.6
522045,202201,2495,1492,1003,1809517.66,1215636.6,3025154.26
522050,202201,156,75,81,90900,98172,189072
522060,202201,541,340,201,412080,243612,655692
522068,202201,105,73,32,88476,38784,127260
522070,202201,12,11,1,13332,1212,14544
522100,202201,33,21,12,25452,14544,39996
522108,202201,44,33,11,39996,13332,53328
522119,202201,58,32,26,38784,31512,70296
522130,202201,75,27,48,32724,58176,90900
522140,202201,4036,2084,1952,2528232.6,2368248,4896480.6
522145,202201,45,35,10,42420,13332,55752
522150,202201,105,72,33,87264,39996,127260
522155,202201,50,38,12,46056,14544,60600
522157,202201,9,6,3,7272,3636,10908
522160,202201,1655,988,667,1201092.8,808404,2009496.8
522170,202201,396,268,128,324816,155136,479952
522180,202201,33,12,21,14544,25452,39996
522185,202201,2239,940,1299,1139281.2,1576812,2716093.2
522190,202201,64,36,28,43632,33936,77568
522200,202201,300,177,123,214524,149076,363600
522205,202201,145,101,44,122412,53328,175740
522220,202201,137,101,36,122412,43632,166044
522230,202201,31,27,4,32724,4848,37572
530010,202201,54565,27654,26911,33542439.64,32652625.4,66195065.04
110001,202202,504,409,95,495708,116352,612060
110002,202202,2794,1779,1015,2157360,1230180.6,3387540.6
110003,202202,78,63,15,76356,18180,94536
110004,202202,1980,1330,650,1613173.2,789012,2402185.2
110005,202202,416,333,83,403596.6,100596,504192.6
110006,202202,435,326,109,395112.6,132108,527220.6
110007,202202,67,54,13,65448,15756,81204
110008,202202,240,136,104,164832,126048,290880
110009,202202,902,678,224,822948,271488.4,1094436.4
110010,202202,1644,977,667,1184124.19,810828,1994952.19
110011,202202,1680,1313,367,1592568,444804,2037372
110012,202202,4039,2355,1684,2854260,2043432,4897692
110013,202202,730,573,157,695688,190284,885972
110014,202202,361,318,43,385860.4,52116,437976.4
110015,202202,1342,1057,285,1281085.04,345420.6,1626505.64
110018,202202,1029,632,397,765984.6,481164,1247148.6
110020,202202,15622,8903,6719,10796507.77,8153126.56,18949634.33
110025,202202,654,478,176,580548.6,213312,793860.6
110026,202202,34,22,12,26664,14544,41208
110028,202202,1555,1105,450,1340473.76,545401.8,1885875.56
110029,202202,126,115,11,139380,13332,152712
110030,202202,2380,1584,796,1920827.55,964753.45,2885581.00
110032,202202,297,226,71,275124.6,86052,361176.6
110033,202202,637,458,179,555096,216948,772044
110034,202202,321,237,84,287244.98,101808,389052.98
110037,202202,83,75,8,90900,9696,100596
110040,202202,386,266,120,324816,145440,470256
110045,202202,914,638,276,774468.6,335724.16,1110192.76
110050,202202,87,76,11,92112,13332,105444
110060,202202,61,37,24,44844,29088,73932
110070,202202,105,68,37,82416,46056,128472
110080,202202,508,291,217,352692.6,264216,616908.6
110090,202202,24,20,4,25452,4848,30300
110092,202202,109,57,52,69084,63024,132108
110094,202202,188,132,56,159984,67872,227856
110100,202202,42,29,13,35148,16968,52116
110110,202202,94,53,41,64236,49692,113928
110120,202202,65,56,9,67872,10908,78780
110130,202202,273,220,53,266640,64236,330876
110140,202202,240,173,67,209676,81204,290880
110143,202202,52,43,9,52116,10908,63024
110145,202202,38,30,8,36360,9696,46056
110146,202202,22,10,12,12120,14544,26664
110147,202202,35,24,11,29088,13332,42420
110148,202202,36,27,9,32724,10908,43632
110149,202202,317,224,93,271488,112716,384204
110150,202202,135,103,32,124836,38784,163620
110155,202202,11,10,1,12120,1212,13332
110160,202202,62,49,13,59388,15756,75144
110170,202202,214,165,49,199980,59388,259368
110175,202202,64,48,16,58176,19392,77568
110180,202202,94,76,18,92112,21816,113928
120001,202202,196,146,50,178164.55,60600,238764.55
120005,202202,199,115,84,139380.87,101808,241188.87
120010,202202,1119,689,430,835068.6,521160,1356228.6
120013,202202,154,105,49,127260,59388,186648
120017,202202,114,63,51,76356,61812,138168
120020,202202,3412,2764,648,3351255.13,785389.2,4136644.33
120025,202202,545,306,239,370873.15,289668,660541.15
120030,202202,1040,898,142,1088425.96,173324.8,1261750.76
120032,202202,39,35,4,42420,4848,47268
120033,202202,220,193,27,233923.7,32724.55,266648.25
120034,202202,172,126,46,152712,55752,208464
120035,202202,37,31,6,37572,7272,44844
120038,202202,401,255,146,310275.3,176952.55,487227.85
120039,202202,29,28,1,33937.65,1212,35149.65
120040,202202,13893,9380,4513,11377129.69,5471300.3,16848429.99
120042,202202,42,38,4,46056,4848.55,50904.55
120043,202202,14,3,11,3636,13332,16968
120045,202202,533,341,192,414504.55,232705.65,647210.20
120050,202202,1249,960,289,1164786.25,351492.65,1516278.90
120060,202202,1440,1200,240,1454455.55,290886.6,1745342.15
120070,202202,403,291,112,352693.5,136956,489649.5
120080,202202,179,114,65,138169.1,78780.55,216949.65
130002,202202,161,116,45,140592,54540,195132
130006,202202,104,69,35,83628,42420,126048
130008,202202,127,73,54,88476,65448,153924
130010,202202,155,94,61,113928,73932,187860
130014,202202,272,195,77,236643,93324,329967
130020,202202,122,80,42,96960,50904,147864
130030,202202,925,527,398,638724,483588,1122312
130040,202202,342,161,181,195132,219372,414504
130050,202202,544,285,259,345420.6,313908,659328.6
130060,202202,854,587,267,711444.6,324816,1036260.6
130063,202202,603,362,241,438744,292092,730836
130068,202202,197,121,76,146652,92112,238764
130070,202202,1335,898,437,1088376.55,529644.6,1618021.15
130080,202202,683,452,231,547824,279972,827796
130083,202202,71,40,31,48480,37572,86052
130090,202202,323,182,141,220584,170892,391476
130100,202202,1189,543,646,658116.6,784164,1442280.6
130110,202202,715,317,398,384204,482376,866580
130115,202202,138,64,74,77568,89688,167256
130120,202202,1614,1015,599,1233816,727200,1961016
130130,202202,599,412,187,499344,226644,725988
130140,202202,1536,1193,343,1445916,415716,1861632
130150,202202,392,348,44,421776,53328,475104
130160,202202,427,251,176,304212,213312,517524
130165,202202,58,47,11,56964,13332,70296
130170,202202,995,697,298,844686.43,361176.9,1205863.33
130180,202202,241,175,66,212100,79992,292092
130185,202202,2185,1021,1164,1237452,1410768,2648220
130190,202202,3340,2100,1240,2545201,1504092,4049293
130195,202202,276,221,55,267852.6,66660,334512.6
130200,202202,172,81,91,98172,110292,208464
130210,202202,92,46,46,56964,55752,112716
130220,202202,196,141,55,170892,66660,237552
130230,202202,370,243,127,294516,155136,449652
130240,202202,1315,850,465,1030200,564792,1594992
130250,202202,4956,3131,1825,3798408.4,2214324,6012732.4
130255,202202,405,202,203,244824,246036,490860
130260,202202,58649,27654,30995,33543224.56,37600141.46,71143366.02
130270,202202,1511,1034,477,1253317.08,578124,1831441.08
130280,202202,131,77,54,93324,65448,158772
130290,202202,2068,1390,678,1684680,822948,2507628
130300,202202,419,287,132,347844,159984,507828
130310,202202,901,478,423,579336,512676,1092012
130320,202202,513,270,243,327240,296940,624180
130330,202202,751,473,278,573276,339360,912636
130340,202202,3355,1882,1473,2282196,1786488.6,4068684.6
130350,202202,469,322,147,390264,178164,568428
130353,202202,929,411,518,498132.6,627816,1125948.6
130356,202202,779,348,431,421776,522372,944148
130360,202202,85,66,19,79992,23028,103020
130370,202202,680,528,152,639936,184224,824160
130380,202202,643,501,142,607212,172104,779316
130390,202202,462,374,88,453288,106656,559944
130395,202202,157,45,112,54540,135744,190284
130400,202202,70,49,21,59388,25452,84840
130406,202202,2179,1282,897,1554999,1087164,2642163
130410,202202,440,222,218,269064,264216,533280
130420,202202,2774,2262,512,2741544.6,621756,3363300.6
130423,202202,174,100,74,121200.6,89688,210888.6
130426,202202,185,101,84,122412,101808,224220
130430,202202,406,238,168,288456,203616,492072
130440,202202,204,66,138,79992,167256,247248
140002,202202,24,4,20,4848,24240,29088
140005,202202,206,122,84,149076,101808,250884
140010,202202,11252,6933,4319,8408867.79,5243113.61,13651981.40
140015,202202,145,67,78,81204,94536,175740
140017,202202,119,68,51,82416,61812,144228
140020,202202,439,288,151,349056,183012,532068
140023,202202,41,20,21,24240,25452,49692
140028,202202,22,11,11,13332,13332,26664
140030,202202,355,237,118,288456,144228,432684
140040,202202,61,44,17,53328,20604,73932
140045,202202,266,102,164,123624,198768,322392
140047,202202,478,318,160,385416.6,193920,579336.6
140050,202202,138,85,53,103020,64236,167256
140060,202202,67,42,25,50904,30300,81204
140070,202202,28,26,2,31512,2424,33936
150010,202202,4871,2930,1941,3551161.2,2353704.6,5904865.8
150013,202202,168,119,49,144228.6,59388,203616.6
150020,202202,1097,600,497,727200,602364,1329564
150030,202202,697,312,385,379356.02,466620,845976.02
150034,202202,205,126,79,153924,95748,249672
150040,202202,1535,879,656,1065348,795072,1860420
150050,202202,678,388,290,470256.6,351480,821736.6
150060,202202,4807,3029,1778,3673470.57,2156650.96,5830121.53
150070,202202,446,231,215,279972,260580,540552
150080,202202,16266,7590,8676,9203934.2,10520166.62,19724100.82
150085,202202,416,268,148,324816,179376,504192
150090,202202,685,567,118,688416,143016,831432
150095,202202,46,31,15,37572,18180,55752
150100,202202,68,42,26,50904,31512,82416
150110,202202,213,118,95,143016,115140,258156
150120,202202,393,286,107,346632,129684,476316
150125,202202,49,18,31,21816,37572,59388
150130,202202,2125,1070,1055,1298052,1281084,2579136
150140,202202,57786,25401,32385,30802995.8,39267599.26,70070595.06
150145,202202,238,126,112,152712,135744,288456
150150,202202,3248,1432,1816,1738008,2202205.2,3940213.2
150157,202202,376,268,108,324816.6,130896,455712.6
150160,202202,129,98,31,118776,37572,156348
150170,202202,3864,2816,1048,3414204,1271388,4685592
150172,202202,343,239,104,289668,126048,415716
150175,202202,79,43,36,52116,43632,95748
150178,202202,750,506,244,613272,295728,909000
150180,202202,3210,1575,1635,1908900,1982832.6,3891732.6
150190,202202,365,236,129,286032.6,156348,442380.6
150195,202202,115,62,53,75144,64236,139380
150200,202202,187,92,95,111504,115140,226644
150210,202202,3218,2533,685,3069996.6,830220,3900216.6
150215,202202,605,378,227,459348.6,277548,736896.6
150220,202202,3515,2332,1183,2827597.1,1433796.36,4261393.46
150230,202202,1314,1045,269,1266540.3,326028,1592568.3
150240,202202,6857,3849,3008,4664989.4,3648121.8,8313111.2
150250,202202,70,39,31,47268,37572,84840
150260,202202,106,70,36,84840,43632,128472
150270,202202,2137,1377,760,1670136,922332.6,2592468.6
150275,202202,530,336,194,407232,235128,642360
150276,202202,115,41,74,49692,89688,139380
150277,202202,822,366,456,443592,552672,996264
150280,202202,362,245,117,296940,143016,439956
150285,202202,131,65,66,78780,79798.08,158578.08
150290,202202,1186,682,504,827796,612060,1439856
150293,202202,746,347,399,420564.96,484800,905364.96
150295,202202,540,247,293,299364,356328,655692
150300,202202,93,44,49,53328,59388,112716
150304,202202,190,113,77,136956,93324,230280
150307,202202,421,352,69,426624,83628,510252
150309,202202,581,411,170,498132,206040.36,704172.36
150310,202202,264,175,89,212100,109080,321180
150320,202202,1841,1278,563,1548936.54,682356.6,2231293.14
150330,202202,2067,1194,873,1447128.6,1058076,2505204.6
150340,202202,196,131,65,158772,79992,238764
150345,202202,632,352,280,426624,339360,765984
150350,202202,394,314,80,380568,96960,477528
150360,202202,4722,2847,1875,3452988,2279772.6,5732760.6
150370,202202,835,571,264,692052.6,319968,1012020.6
150375,202202,201,94,107,113928,129684,243612
150380,202202,1518,1003,515,1215636,625392,1841028
150390,202202,874,499,375,604788,454500,1059288
150400,202202,111,92,19,111504,23028,134532
150405,202202,1589,1007,582,1220485.48,706596,1927081.48
150410,202202,116,72,44,87264,53328,140592
150420,202202,7590,4094,3496,4966974.01,4238365.8,9205339.81
150430,202202,631,395,236,479952.6,286032,765984.6
150440,202202,450,279,171,338148,207252,545400
150442,202202,2323,1228,1095,1489549.2,1328352.6,2817901.8
150445,202202,543,353,190,427836.6,230280,658116.6
150450,202202,221,125,96,151500,116352,267852
150460,202202,710,533,177,645996,214524,860520
150470,202202,1287,769,518,932028,627816,1559844
150475,202202,236,182,54,220584,65448,286032
150480,202202,1371,946,425,1146552,515100,1661652
150490,202202,603,355,248,430260,300576,730836
150495,202202,337,254,83,307848,100596,408444
150497,202202,284,194,90,235128,110292,345420
150500,202202,252,152,100,184224,121200,305424
150503,202202,1279,627,652,761136.6,790224.6,1551361.2
150506,202202,918,625,293,757500.02,355116,1112616.02
150510,202202,1315,713,602,864157.2,729624,1593781.2
150520,202202,318,219,99,265428,119988,385416
150530,202202,1848,1020,828,1237452,1003536,2240988
150540,202202,201,148,53,179376,64236,243612
150543,202202,842,436,406,528432,493284,1021716
150548,202202,451,323,128,391476,155136,546612
150549,202202,72,47,25,56964,30300,87264
150550,202202,3049,1521,1528,1843452.6,1853148,3696600.6
150553,202202,3445,1943,1502,2360979.6,1830120,4191099.6
150555,202202,144,76,68,92112,82416,174528
150560,202202,50,22,28,26664,33936,60600
150563,202202,127,64,63,77568,76356,153924
150565,202202,205,127,78,153924,94536,248460
150570,202202,430,287,143,349056,173316,522372
150580,202202,1711,827,884,1002324,1071408,2073732
150590,202202,825,536,289,650844,350268,1001112
150600,202202,516,306,210,370872,254520.6,625392.6
150610,202202,154,124,30,150288,36360,186648
150611,202202,129,85,44,103020,53328,156348
150613,202202,3283,1866,1417,2262804,1718673.8,3981477.8
150616,202202,562,310,252,375720,306636,682356
150618,202202,1370,708,662,858096,803556,1661652
150619,202202,391,298,93,361176,112716,473892
150620,202202,1238,720,518,873852,629028,1502880
150630,202202,141,94,47,113928.6,56964,170892.6
150635,202202,450,198,252,239976,305424.6,545400.6
150640,202202,41,22,19,27876,23028,50904
150650,202202,2412,1388,1024,1682256,1242300.6,2924556.6
150655,202202,248,180,68,218160,82416,300576
150658,202202,80,48,32,58176,38784,96960
150660,202202,566,366,200,443592,242400,685992
150670,202202,1118,389,729,471468,885972,1357440
150680,202202,10626,5560,5066,6738723.1,6153327.6,12892050.7
150690,202202,27,14,13,16968,15756,32724
150700,202202,489,318,171,385416,207252,592668
150710,202202,292,170,122,206040,147864,353904
150715,202202,833,526,307,637512,373296,1010808
150720,202202,420,321,99,389052,119988,509040
150730,202202,1059,515,544,624180,660540,1284720
150740,202202,237,157,80,190284,96960,287244
150745,202202,760,428,332,518736,402384,921120
150746,202202,68,35,33,42420,39996,82416
150747,202202,243,180,63,218160,76356,294516
150750,202202,132,72,60,88476,72720,161196
150760,202202,1804,1165,639,1415616.9,778104,2193720.9
150770,202202,392,223,169,270276,204828,475104
150775,202202,102,54,48,65448,58176,123624
150780,202202,193,112,81,135744,98172,233916
150790,202202,658,376,282,455712,341784,797496
150795,202202,1634,986,648,1195032,787800,1982832
150796,202202,331,189,142,229068,173316,402384
150797,202202,391,184,207,223008,250884,473892
150800,202202,1573,883,690,1070196,836280,1906476
150803,202202,524,413,111,500556,134532,635088
150805,202202,210,123,87,149076,105444,254520
150808,202202,1032,539,493,653268,598728,1251996
150810,202202,3199,2176,1023,2639736.42,1243512.6,3883249.02
150812,202202,487,251,236,305424,286032,591456
150815,202202,1153,719,434,872640,526008,1398648
150820,202202,1534,932,602,1129584,729624,1859208
150830,202202,547,406,141,494496,170892,665388
150835,202202,222,128,94,155136,113928,269064
150840,202202,1394,835,559,1012020,678720,1690740
160005,202202,64,43,21,52116.06,25452.04,77568.10
160010,202202,196,127,69,153924.12,83628.08,237552.20
160015,202202,142,88,54,106656.06,65448,172104.06
160020,202202,139,71,68,86052.04,82416,168468.04
160021,202202,70,32,38,38784.64,46056.02,84840.66
160023,202202,67,43,24,52116.08,29088.04,81204.12
160025,202202,24,11,13,13332.02,15756.04,29088.06
160027,202202,1481,838,643,1015657.88,781740.94,1797398.82
160030,202202,16524,8508,8016,10316559.8,9722674.9,20039234.7
160040,202202,290,172,118,208464.12,143016.02,351480.14
160050,202202,727,355,372,431472.2,452076.04,883548.24
160053,202202,283,164,119,198768.26,144228.14,342996.40
160055,202202,23,15,8,18180.02,9696.02,27876.04
160060,202202,6608,3527,3081,4277158.59,3735391.02,8012549.61
160070,202202,192,113,79,136956.02,95748.02,232704.04
160080,202202,123,62,61,75144,73932,149076
170025,202202,28,15,13,18180,15756,33936
170030,202202,191,155,36,187860.24,43632,231492.24
170035,202202,199,95,104,115140,126048,241188
170040,202202,172,127,45,153924,54540,208464
170070,202202,323,205,118,248460,143016,391476
170100,202202,343,253,90,306636,110292,416928
170105,202202,46,39,7,47268,8484,55752
170110,202202,115,67,48,81204,58176,139380
170130,202202,72,37,35,44844,42420,87264
170190,202202,95,56,39,67872,47268,115140
170200,202202,339,234,105,283608,127260,410868
170210,202202,6378,3397,2981,4119297.77,3612973.8,7732271.57
170215,202202,126,63,63,76356,76356,152712
170220,202202,1350,980,370,1187760,448440.2,1636200.2
170230,202202,143,93,50,112716,60600.6,173316.6
170240,202202,504,342,162,414504.2,196344,610848.2
170255,202202,1026,832,194,1010808,236340,1247148
170270,202202,47,33,14,39996,16968,56964
170290,202202,126,80,46,96960,55752,152712
170300,202202,106,67,39,81204,47268,128472
170305,202202,48,37,11,44844,13332,58176
170307,202202,55,42,13,50904,15756,66660
170310,202202,121,71,50,86052,60600,146652
170320,202202,31,19,12,23028,14544,37572
170330,202202,29,22,7,26664,8484,35148
170360,202202,32,19,13,23028,15756,38784
170370,202202,84,41,43,49692,52116,101808
170380,202202,72,55,17,66660,20604,87264
170382,202202,37,32,5,38784,6060,44844
170384,202202,140,107,33,129684,39996,169680
170386,202202,69,30,39,36360,47268,83628
170388,202202,46,19,27,23028,32724,55752
170389,202202,23,20,3,24240,3636,27876
170390,202202,72,44,28,53328,33936,87264
170410,202202,24,22,2,26664,2424,29088
170460,202202,15,9,6,10908,7272,18180
170510,202202,33,24,9,29088,10908,39996
170550,202202,1523,887,636,1075044.6,773256,1848300.6
170555,202202,105,78,27,94536,32724,127260
170560,202202,106,74,32,89688,38784,128472
170600,202202,38,11,27,13332,32724,46056
170610,202202,182,97,85,117564,104232.6,221796.6
170625,202202,34,20,14,24240,16968,41208
170650,202202,88,62,26,75144,31512,106656
170700,202202,575,427,148,518736,179376,698112
170710,202202,148,97,51,117564,61812,179376
170720,202202,99,77,22,93324,26664,119988
170730,202202,97,56,41,67872,49692,117564
170740,202202,85,59,26,71508,31512,103020
170755,202202,52,28,24,33936,29088,63024
170765,202202,133,73,60,88476.2,72720,161196.2
170770,202202,193,124,69,150288,83628,233916
170820,202202,584,386,198,467832,239976.6,707808.6
170825,202202,40,22,18,26664,21816,48480
170830,202202,87,70,17,84840,20604,105444
170900,202202,168,130,38,157560,46056,203616
170930,202202,930,509,421,616908.08,510252,1127160.08
170950,202202,3157,1487,1670,1804668.2,2026465.36,3831133.56
170980,202202,17,11,6,13332,7272,20604
171050,202202,146,108,38,130896,46056,176952
171070,202202,51,43,8,52116,9696,61812
171090,202202,48,35,13,42420,15756,58176
171110,202202,23,17,6,20604,7272,27876
171150,202202,41,23,18,27876,21816,49692
171180,202202,24,10,14,12120,16968,29088
171190,202202,165,96,69,116352,83628,199980
171195,202202,58,48,10,59388,12120,71508
171200,202202,36,17,19,20604,23028,43632
171215,202202,7,5,2,6060,2424,8484
171240,202202,59,43,16,52116,19392,71508
171245,202202,55,48,7,58176,8484,66660
171250,202202,75,43,32,52116,39996,92112
171270,202202,13,9,4,10908,4848,15756
171280,202202,43,36,7,43632,8484,52116
171320,202202,979,559,420,677508,509040,1186548
171330,202202,422,215,207,260580,250884,511464
171360,202202,95,66,29,79992,35148,115140
171370,202202,36,21,15,25452,18180,43632
171380,202202,133,114,19,139380,23028,162408
171395,202202,42,24,18,29088,21816,50904
171420,202202,263,175,88,212100,106656,318756
171430,202202,75,61,14,73932,16968,90900
171488,202202,204,114,90,138168,109080,247248
171500,202202,64,34,30,41208,36360,77568
171510,202202,73,47,26,56964,31512,88476
171515,202202,37,30,7,36360,8484,44844
171525,202202,26,23,3,27876,3636,31512
171550,202202,14,8,6,9696,7272,16968
171570,202202,51,25,26,30300,31512,61812
171575,202202,270,178,92,215736,111504,327240
171610,202202,1749,878,871,1064136,1059288,2123424
171620,202202,142,96,46,117564,55752,173316
171630,202202,52,31,21,37572,25452,63024
171650,202202,329,226,103,273912,124836,398748
171660,202202,252,146,106,176952,128472.6,305424.6
171665,202202,78,49,29,59388,35148,94536
171670,202202,419,253,166,306636,201192,507828
171700,202202,63,55,8,66660,9696,76356
171720,202202,28,10,18,12120,21816,33936
171750,202202,103,54,49,65448,59388,124836
171780,202202,73,56,17,67872,20604,88476
171790,202202,83,68,15,82416,18180,100596
171800,202202,34,26,8,31512,9696,41208
171820,202202,2047,1189,858,1441068.72,1042320.2,2483388.92
171830,202202,34,25,9,30300,10908,41208
171840,202202,58,38,20,46056,24240,70296
171845,202202,30,19,11,23028,13332,36360
171850,202202,38,31,7,37572,8484,46056
171855,202202,76,58,18,71508,21816,93324
171865,202202,6,5,1,6060,1212,7272
171870,202202,31,18,13,21816,15756,37572
171875,202202,81,58,23,70296,27876,98172
171880,202202,37,22,15,26664,18180,44844
171884,202202,49,28,21,33936,25452,59388
171886,202202,134,61,73,73932,88476,162408
171888,202202,26,21,5,25452,6060,31512
171889,202202,11,5,6,6060,7272,13332
171890,202202,54,45,9,54540,10908,65448
171900,202202,31,21,10,25452,12120,37572
172000,202202,34,29,5,35148,6060,41208
172010,202202,55,45,10,54540,12120,66660
172015,202202,21,15,6,18180.52,7272,25452.52
172020,202202,144,91,53,110292,64236,174528
172025,202202,37,24,13,29088,15756,44844
172030,202202,44,25,19,30300,23028,53328
172049,202202,82,53,29,64236,35148,99384
172065,202202,115,74,41,89688,49692,139380
172080,202202,117,72,45,87264,54540,141804
172085,202202,30,15,15,18180,18180,36360
172090,202202,425,314,111,380568.03,134532,515100.03
172093,202202,15,13,2,15756,2424,18180
172097,202202,20,11,9,13332,10908,24240
172100,202202,5388,3041,2347,3686905.2,2848201.52,6535106.72
172110,202202,85,55,30,66660,36360,103020
172120,202202,1686,1403,283,1701648.6,342996,2044644.6
172125,202202,11,10,1,12120,1212,13332
172130,202202,25,14,11,16968,13332,30300
172208,202202,198,121,77,146652,93324,239976
172210,202202,367,185,182,224220,220584,444804
210005,202202,2944,1843,1101,2236140.09,1335627,3571767.09
210010,202202,143,88,55,106656,66660,173316
210015,202202,42,30,12,36360,14544,50904
210020,202202,360,208,152,252096,184224,436320
210030,202202,313,209,104,253308,126048,379356
210040,202202,132,108,24,130896.6,29088,159984.6
210043,202202,251,197,54,238764,65448,304212
210047,202202,495,303,192,367236,232704,599940
210050,202202,273,203,70,246036,86052,332088
210055,202202,51,43,8,52116,9696,61812
210060,202202,537,440,97,533280,117564,650844
210070,202202,427,334,93,404808,112716,517524
210080,202202,134,123,11,149076,13332,162408
210083,202202,282,141,141,170892,170892,341784
210087,202202,4,3,1,3636,1212,4848
210090,202202,433,310,123,375720,149076,524796
210095,202202,402,313,89,379356,107868,487224
210100,202202,694,548,146,664176,176952,841128
210110,202202,117,78,39,94536,47268,141804
210120,202202,4907,3884,1023,4709834.21,1239876,5949710.21
210125,202202,182,111,71,134532,86052,220584
210130,202202,451,267,184,323604,223008,546612
210135,202202,28,21,7,25452,8484,33936
210140,202202,4444,3436,1008,4166857,1225332,5392189
210150,202202,357,227,130,275124,157560,432684
210160,202202,3214,2745,469,3328152.73,568428,3896580.73
210170,202202,1191,955,236,1157460,286032,1443492
210173,202202,122,108,14,130896,16968,147864
210177,202202,326,185,141,224220,170892,395112
210180,202202,29,16,13,19392,15756,35148
210190,202202,434,291,143,352692,173316,526008
210193,202202,6,4,2,4848,2424,7272
210197,202202,70,52,18,63024,21816,84840
210200,202202,596,506,90,613272,109080,722352
210203,202202,205,147,58,178164,70296,248460
210207,202202,355,296,59,358752,71508,430260
210210,202202,717,662,55,802344,66660,869004
210215,202202,68,60,8,72720,9696,82416
210220,202202,365,312,53,378144,64236,442380
210230,202202,303,244,59,295728,71508,367236
210232,202202,1275,889,386,1077468,467832,1545300
210235,202202,178,136,42,164832,50904,215736
210237,202202,34,18,16,21816,19392,41208
210240,202202,77,66,11,79992,13332,93324
210250,202202,175,149,26,180588,31512,212100
210255,202202,362,277,85,336936,103020,439956
210260,202202,393,272,121,329664,146652,476316
210270,202202,617,422,195,511464,236340,747804
210275,202202,86,67,19,81204,23028,104232
210280,202202,1042,683,359,827796.12,435108,1262904.12
210290,202202,514,350,164,424200,198768,622968
210300,202202,4953,3191,1762,3871128.66,2136756,6007884.66
210310,202202,108,76,32,92112,38784,130896
210312,202202,115,80,35,96960,42420,139380
210315,202202,108,92,16,111504,19392,130896
210317,202202,135,103,32,124836,38784,163620
210320,202202,2305,1987,318,2410668,385416,2796084
210325,202202,143,86,57,104232.6,69084,173316.6
210330,202202,4287,2529,1758,3065148.8,2134332,5199480.8
210340,202202,1199,912,287,1106556,347844.6,1454400.6
210350,202202,655,541,114,655692,138168,793860
210355,202202,142,122,20,147864,24240,172104
210360,202202,2070,1472,598,1784064,724776,2508840
210370,202202,1210,616,594,749016,721140,1470156
210375,202202,189,95,94,115140,113928,229068
210380,202202,721,562,159,681144,192708,873852
210390,202202,192,163,29,197556,35148,232704
210400,202202,395,345,50,418140,60600,478740
210405,202202,1003,707,296,856884,359964,1216848
210407,202202,64,51,13,61812,15756,77568
210408,202202,39,34,5,41208,6060,47268
210409,202202,327,286,41,346632,49692,396324
210410,202202,434,341,93,413292,112716,526008
210420,202202,209,174,35,210888,42420,253308
210430,202202,51,35,16,42420,20604,63024
210440,202202,363,246,117,298152,141804,439956
210450,202202,100,82,18,99384,21816,121200
210455,202202,237,127,110,153924.6,133320,287244.6
210460,202202,298,205,93,248460,112716,361176
210462,202202,64,52,12,63024,14544,77568
210465,202202,136,109,27,132108,32724,164832
210467,202202,519,385,134,466620,162408,629028
210470,202202,48,41,7,49692,8484,58176
210480,202202,1286,926,360,1122312,437532,1559844
210490,202202,182,126,56,152712,69084,221796
210500,202202,483,301,182,366024,220584,586608
210510,202202,516,421,95,510252,115140,625392
210515,202202,343,219,124,265428,150288,415716
210520,202202,396,360,36,436320,43632,479952
210530,202202,9412,4888,4524,5926682.96,5484303.57,11410986.53
210535,202202,124,94,30,113928,36360,150288
210540,202202,1479,998,481,1209576.8,584184,1793760.8
210542,202202,1121,570,551,690840,669025.2,1359865.2
210545,202202,21,19,2,23028,2424,25452
210547,202202,123,108,15,130896,18180,149076
210550,202202,602,430,172,521160.76,208464,729624.76
210560,202202,148,130,18,157560,21816,179376
210565,202202,20,14,6,16968,7272,24240
210570,202202,1277,1056,221,1281084.4,267852,1548936.4
210580,202202,119,103,16,124836,19392,144228
210590,202202,713,597,116,723564,140592,864156
210592,202202,41,38,3,46056,3636,49692
210594,202202,105,89,16,107868,19392,127260
210596,202202,115,99,16,121200,19392,140592
210598,202202,140,106,34,128472,41208,169680
210600,202202,303,263,40,318756,48480,367236
210610,202202,242,228,14,277548,18180,295728
210620,202202,44,27,17,32724,20604,53328
210630,202202,69,64,5,77568,6060,83628
210632,202202,977,702,275,850824,333300,1184124
210635,202202,22,20,2,24240,2424,26664
210637,202202,129,93,36,112716,43632,156348
210640,202202,570,508,62,615696,76356,692052
210650,202202,383,321,62,389052,75144,464196
210660,202202,357,281,76,340572,92112,432684
210663,202202,52,37,15,44844,18180,63024
210667,202202,94,40,54,48480,65448,113928
210670,202202,255,228,27,276336,33936,310272
210675,202202,494,276,218,334512,264216,598728
210680,202202,225,144,81,174528,98172,272700
210690,202202,60,54,6,65448,7272,72720
210700,202202,155,119,36,144228,43632,187860
210710,202202,222,141,81,170892,98172,269064
210720,202202,122,110,12,133320,14544,147864
210725,202202,58,49,9,59388,10908,70296
210730,202202,22,17,5,20604,6060,26664
210735,202202,281,207,74,250884,89688,340572
210740,202202,513,444,69,538128,83628,621756
210745,202202,148,111,37,134532,44844,179376
210750,202202,2457,1268,1189,1538028,1442280,2980308
210760,202202,244,191,53,231492,64236,295728
210770,202202,244,197,47,238764,56964,295728
210780,202202,421,323,98,392688,118776,511464
210790,202202,182,152,30,184224,36360,220584
210800,202202,166,130,36,157560,44844,202404
210805,202202,59,53,6,64236,7272,71508
210810,202202,450,366,84,443592,101808,545400
210820,202202,2009,1681,328,2038584.92,398748,2437332.92
210825,202202,149,85,64,103020,77568,180588
210830,202202,703,475,228,576912,276336,853248
210840,202202,186,136,50,164832,60600,225432
210845,202202,226,173,53,209676,64236,273912
210850,202202,712,491,221,595092,267852,862944
210860,202202,3371,1979,1392,2398548,1688316,4086864
210870,202202,411,328,83,397536,100596,498132
210880,202202,75,61,14,73932,16968,90900
210890,202202,313,274,39,332088.8,47268,379356.8
210900,202202,635,419,216,509040,261792,770832
210905,202202,59,33,26,39996,31512,71508
210910,202202,1897,1452,445,1759825.48,539340,2299165.48
210920,202202,145,60,85,72720,103020,175740
210923,202202,77,62,15,75144,18180,93324
210927,202202,412,207,205,250884,248460,499344
210930,202202,67,55,12,66660,14544,81204
210940,202202,78,62,16,75144,19392,94536
210945,202202,194,111,83,134532,100596,235128
210950,202202,506,372,134,450864,162408,613272
210955,202202,88,57,31,69084,37572,106656
210960,202202,2238,1148,1090,1392588,1321080,2713668
210970,202202,104,91,13,110292,15756,126048
210975,202202,77,72,5,87264,6060,93324
210980,202202,1059,524,535,636300,648420.6,1284720.6
210990,202202,4424,3084,1340,3741444.4,1625292,5366736.4
211000,202202,1259,1029,230,1248360,278760,1527120
211003,202202,947,688,259,833856,313908,1147764
211010,202202,465,422,43,511464,52116,563580
211020,202202,1348,594,754,721140,913848,1634988
211023,202202,44,39,5,47268,6060,53328
211027,202202,76,55,21,66660,25452,92112
211030,202202,358,258,100,312696,121200,433896
211040,202202,280,235,45,286032.6,54540,340572.6
211050,202202,1086,744,342,901728,414504.6,1316232.6
211060,202202,611,540,71,654480.2,86052.23,740532.43
211065,202202,25,20,5,24240,6060,30300
211070,202202,834,701,133,849612.04,161196,1010808.04
211080,202202,83,81,2,98172,2424,100596
211085,202202,54,31,23,37572,27876,65448
211090,202202,76,65,11,78780,13332,92112
211100,202202,462,389,73,471468,88476,559944
211102,202202,234,168,66,203616,79992,283608
211105,202202,214,152,62,184224,75144,259368
211107,202202,125,80,45,96960,54540,151500
211110,202202,939,631,308,764772,373296,1138068
211120,202202,4954,2559,2395,3106357.08,2907588.44,6013945.52
211125,202202,24,17,7,20604,8484,29088
211130,202202,40270,18912,21358,22939531.76,25902867,48842398.76
211140,202202,395,349,46,422988,55752,478740
211150,202202,1183,824,359,999900,435108.6,1435008.6
211153,202202,161,99,62,119988,75144,195132
211157,202202,69,57,12,69084,14544,83628
211160,202202,676,579,97,704172,117564,821736
211163,202202,2,2,0,2424,,2424.0
211167,202202,11,10,1,12120,1212,13332
211170,202202,404,302,102,366024.6,123624,489648.6
211172,202202,111,76,35,92112,42420,134532
211174,202202,250,160,90,193920,109080,303000
211176,202202,457,337,120,408444.6,145440,553884.6
211178,202202,85,59,26,71508,31512,103020
211180,202202,209,168,41,203616,49692,253308
211190,202202,68,61,7,73932,8484,82416
211195,202202,33,21,12,25452,14544,39996
211200,202202,150,129,21,156348,25452,181800
211210,202202,406,302,104,367236,126048,493284
211220,202202,4154,2462,1692,2986370.42,2051916.8,5038287.22
211223,202202,94,89,5,107868,6060,113928
211227,202202,54,44,10,53328,12120,65448
211230,202202,698,578,120,700536,146652,847188
211240,202202,369,306,63,370872,76356,447228
211245,202202,181,96,85,116352,103020,219372
211250,202202,1478,1283,195,1557420.4,236340,1793760.4
211260,202202,771,653,118,795072,143016,938088
211270,202202,1849,1525,324,1849512,392688.6,2242200.6
211280,202202,1754,1156,598,1401072,727200,2128272
211285,202202,204,130,74,157560,89688,247248
211290,202202,711,507,204,615696,247248,862944
211300,202202,745,599,146,725988,178164,904152
211400,202202,1495,954,541,1156248.02,655692,1811940.02
220005,202202,16,15,1,18180,1212,19392
220010,202202,85,70,15,84840,18180,103020
220020,202202,685,558,127,676296,155136,831432
220025,202202,104,101,3,122412,3636,126048
220027,202202,48,40,8,48480,9696,58176
220030,202202,120,98,22,118776,26664,145440
220040,202202,1242,951,291,1152612.4,352692,1505304.4
220045,202202,30,20,10,24240,12120,36360
220050,202202,693,571,122,692053.09,147864,839917.09
220060,202202,174,152,22,184224,26664,210888
220070,202202,110,96,14,116352,16968,133320
220080,202202,14,12,2,14544,2424,16968
220090,202202,36,27,9,32724,10908,43632
220095,202202,1,1,0,1212,1212,2424
220100,202202,21,18,3,21816,3636,25452
220105,202202,28,25,3,30300.6,3636,33936.6
220110,202202,235,217,18,264216,23028,287244
220115,202202,41,37,4,44844,4848,49692
220117,202202,22,20,2,24240,2424,26664
220120,202202,1458,1114,344,1352592,419352,1771944
220130,202202,28,26,2,31512,2424,33936
220140,202202,99,80,19,96960,23028,119988
220150,202202,471,354,117,429048,141804,570852
220155,202202,12,11,1,13332,1212,14544
220157,202202,19,16,3,19392,3636,23028
220160,202202,94,84,10,101808,12120,113928
220170,202202,39,34,5,41208,6060,47268
220173,202202,8,7,1,8484,1212,9696
220177,202202,14,13,1,15756,1212,16968
220180,202202,64,63,1,76356,1212,77568
220190,202202,1072,932,140,1129584,169680,1299264
220191,202202,35,29,6,35148,7272,42420
220192,202202,89,84,5,101808,6060,107868
220194,202202,58,52,6,63024,7272,70296
220196,202202,83,69,14,83628,16968,100596
220198,202202,1,1,0,1212,,1212.0
220200,202202,408,342,66,414504,79992,494496
220202,202202,37,32,5,38784,6060,44844
220205,202202,59,51,8,61812,9696,71508
220207,202202,12,12,0,14544,,14544.0
220208,202202,76,45,31,54540,37572,92112
220209,202202,33,27,6,32724,7272,39996
220210,202202,21,15,6,18180,7272,25452
220211,202202,29,27,2,32724,2424,35148
220213,202202,32,29,3,35148,3636,38784
220217,202202,39,31,8,37572,9696,47268
220220,202202,2238,1469,769,1782852,932028.6,2714880.6
220225,202202,8,3,5,3636,6060,9696
220230,202202,949,730,219,884760,265428,1150188
220240,202202,163,143,20,173316,24240,197556
220245,202202,35,32,3,38784.4,3636,42420.4
220250,202202,122,104,18,127260,21816,149076
220253,202202,53,47,6,56964,7272,64236
220255,202202,40,33,7,39996,8484,48480
220260,202202,691,527,164,638724,198768,837492
220265,202202,6,5,1,6060,1212,7272
220270,202202,812,732,80,887184,96960,984144
220271,202202,37,28,9,33936,10908,44844
220272,202202,10,10,0,12120,,12120.0
220273,202202,17,15,2,18180,2424,20604
220275,202202,60,51,9,61812,10908,72720
220277,202202,20,15,5,18180,6060,24240
220280,202202,17,11,6,13332,7272,20604
220285,202202,38,36,2,43632,2424,46056
220290,202202,1482,1270,212,1539240.6,256944.6,1796185.2
220300,202202,34,34,0,41208,,41208.0
220310,202202,326,278,48,336936,58176,395112
220320,202202,442,408,34,494496.6,41208,535704.6
220323,202202,2,1,1,1212,1212,2424
220325,202202,8,7,1,8484,1212,9696
220327,202202,12,12,0,14544,,14544.0
220330,202202,233,167,66,202404,79992,282396
220335,202202,137,116,21,140592,25452,166044
220340,202202,45,31,14,37572,16968,54540
220342,202202,52,43,9,52116,10908,63024
220345,202202,81,70,11,84840,13332,98172
220350,202202,459,397,62,481164,75144,556308
220360,202202,40,30,10,37572,12120,49692
220370,202202,1267,1055,212,1281084,256944,1538028
220375,202202,13,13,0,15756,,15756.0
220380,202202,26,19,7,23028,8484,31512
220385,202202,16,15,1,18180,1212,19392
220390,202202,2320,1288,1032,1561057.04,1251996.8,2813053.84
220400,202202,33,29,4,35148,4848,39996
220410,202202,24,22,2,26664,2424,29088
220415,202202,12,11,1,13332,1212,14544
220420,202202,126,105,21,127260,25452,152712
220430,202202,127,112,15,135744.6,18180,153924.6
220435,202202,24,17,7,20604,8484,29088
220440,202202,278,237,41,287244,49692,336936
220450,202202,331,167,164,202404,198768,401172
220455,202202,48,47,1,56964,1212,58176
220460,202202,18,16,2,19392,2424,21816
220465,202202,74,49,25,59388,30300,89688
220470,202202,235,207,28,250884.6,35148,286032.6
220480,202202,72,65,7,78780,8484,87264
220490,202202,89,75,14,90900,16968,107868
220500,202202,115,96,19,116352,23028,139380
220510,202202,372,286,86,346632.6,105444,452076.6
220515,202202,20,18,2,21816,2424,24240
220520,202202,366,325,41,393900.96,49692,443592.96
220525,202202,10,6,4,7272,4848,12120
220527,202202,16,13,3,15756,3636,19392
220530,202202,45,22,23,26664,27876,54540
220535,202202,6,4,2,4848,2424,7272
220540,202202,82,70,12,84840,14544,99384
220545,202202,28,19,9,23028,10908,33936
220550,202202,698,552,146,669024,176952,845976
220551,202202,15,12,3,14544,3636,18180
220552,202202,12,12,0,14544,,14544.0
220553,202202,50,45,5,54540,6060,60600
220554,202202,10,7,3,8484,3636,12120
220555,202202,40,31,9,37572,10908,48480
220556,202202,37,35,2,42420,2424,44844
220557,202202,53,47,6,56964,7272,64236
220558,202202,7,3,4,3636,4848,8484
220559,202202,2,2,0,2424,,2424.0
220560,202202,71,46,25,55752,30300,86052
220570,202202,716,448,268,542976,324816,867792
220580,202202,533,485,48,589032,58176,647208
220585,202202,11,10,1,12120,1212,13332
220590,202202,13,12,1,14544,1212,15756
220595,202202,72,55,17,66660,20604,87264
220600,202202,19,12,7,14544,8484,23028
220605,202202,25,22,3,26664,3636,30300
220610,202202,85,73,12,88476,14544,103020
220620,202202,537,452,85,547824.6,103020,650844.6
220630,202202,6,5,1,6060,1212,7272
220635,202202,33,30,3,36360,3636,39996
220640,202202,110,91,19,110292,23028,133320
220650,202202,114,108,6,130896,7272,138168
220660,202202,62,48,14,58176,16968,75144
220665,202202,9,9,0,10908,,10908.0
220667,202202,17,14,3,16968,3636,20604
220669,202202,31,25,6,30300,7272,37572
220670,202202,65,52,13,63024,15756,78780
220672,202202,78,58,20,70296,24240,94536
220675,202202,31,24,7,29088,8484,37572
220680,202202,48,41,7,49692,8484,58176
220690,202202,50,47,3,56964,3636,60600
220695,202202,26,14,12,16968,14544,31512
220700,202202,1754,1350,404,1637413.2,489648,2127061.2
220710,202202,6,4,2,4848,2424,7272
220720,202202,110,93,17,112716,20604,133320
220730,202202,18,17,1,20604,1212,21816
220735,202202,3,0,3,,3636,3636.0
220740,202202,48,43,5,52116,6060,58176
220750,202202,116,99,17,119988,20604,140592
220755,202202,16,16,0,19392,,19392.0
220760,202202,65,58,7,70296,8484,78780
220770,202202,5810,3274,2536,3970513.48,3074844.6,7045358.08
220775,202202,14,10,4,12120,4848,16968
220777,202202,20,19,1,23028,1212,24240
220779,202202,1,0,1,,1212,1212.0
220780,202202,901,766,135,929604,163620.6,1093224.6
220785,202202,5,1,4,1212,4848,6060
220790,202202,1143,906,237,1098072.08,288456,1386528.08
220793,202202,6,5,1,6060,1212,7272
220795,202202,17,15,2,18180,2424,20604
220800,202202,3992,3043,949,3691978.2,1150188,4842166.2
220810,202202,69,60,9,72720.6,10908,83628.6
220820,202202,234,212,22,256944,26664,283608
220830,202202,1264,1100,164,1334412.6,198768,1533180.6
220840,202202,2435,1721,714,2091915.28,870216.32,2962131.60
220850,202202,68,61,7,73932,8484,82416
220855,202202,8,4,4,4848,4848,9696
220860,202202,9,8,1,9696,1212,10908
220865,202202,29,25,4,30300,4848,35148
220870,202202,85,78,7,94536,8484,103020
220880,202202,320,258,62,312696,75144,387840
220885,202202,28,27,1,32724,1212,33936
220887,202202,7,6,1,7272,1212,8484
220890,202202,89,76,13,92112,15756,107868
220900,202202,26,14,12,16968,14544,31512
220910,202202,47,38,9,46056,10908,56964
220915,202202,11,10,1,12120,1212,13332
220920,202202,53,45,8,54540,9696,64236
220930,202202,45,43,2,52116,2424,54540
220935,202202,13,13,0,15756,,15756.0
220937,202202,32,29,3,35148,3636,38784
220940,202202,53,49,4,59388,4848,64236
220945,202202,2,2,0,2424,,2424.0
220950,202202,34,27,7,32724,8484,41208
220955,202202,15,15,0,18180,,18180.0
220960,202202,27,24,3,29088.6,3636,32724.6
220965,202202,39,36,3,43632,3636,47268
220970,202202,60,51,9,61812,10908,72720
220975,202202,10,9,1,10908,1212,12120
220980,202202,29,27,2,32724,2424,35148
220985,202202,55,49,6,59388,7272,66660
220987,202202,31,29,2,35148,2424,37572
220990,202202,24,24,0,30300,,30300.0
220995,202202,10,9,1,10908,1212,12120
220997,202202,58,50,8,60600,9696,70296
221000,202202,1187,1061,126,1285932,152712,1438644
221005,202202,36,33,3,39996,3636,43632
221010,202202,19,15,4,18180,4848,23028
221020,202202,34,33,1,39996,1212,41208
221030,202202,39,31,8,37572,9696,47268
221035,202202,20,19,1,23028,1212,24240
221037,202202,12,8,4,9696,4848,14544
221038,202202,28,25,3,30300,3636,33936
221039,202202,23,23,0,27876,,27876.0
221040,202202,263,226,37,273912,44844,318756
221050,202202,220,185,35,224220,42420,266640
221060,202202,1925,1659,266,2010708,322392,2333100
221062,202202,29,28,1,33936,1212,35148
221063,202202,14,9,5,10908,6060,16968
221065,202202,65,53,12,64236,14544,78780
221070,202202,136,118,18,143016,21816,164832
221080,202202,376,318,58,385416,70296,455712
221090,202202,21,16,5,19392,6060,25452
221093,202202,41,30,11,36360,13332,49692
221095,202202,4,4,0,4848,,4848.0
221097,202202,12,10,2,12120,2424,14544
221100,202202,25797,15365,10432,18629659.32,12655706,31285365.32
221110,202202,1104,841,263,1019292.6,319968,1339260.6
221120,202202,539,391,148,475104,179376,654480
221130,202202,969,779,190,944148,230280,1174428
221135,202202,30,26,4,31512,4848,36360
221140,202202,44,37,7,44844,8484,53328
221150,202202,9,7,2,8484,2424,10908
221160,202202,12,12,0,14544,,14544.0
221170,202202,17,17,0,20604,,20604.0
230010,202202,152,135,17,163620,20604,184224
230015,202202,143,116,27,140592,32724,173316
230020,202202,1643,1354,289,1641048.6,351480,1992528.6
230030,202202,1658,1194,464,1447128.2,562368,2009496.2
230040,202202,225,182,43,221796,52116,273912
230050,202202,229,164,65,198768,78780,277548
230060,202202,157,124,33,150288,39996,190284
230070,202202,304,260,44,315120,53328,368448
230075,202202,868,730,138,887184.6,167256,1054440.6
230080,202202,209,177,32,214524,38784,253308
230090,202202,149,111,38,134532,46056,180588
230100,202202,2395,1353,1042,1641049.2,1262904,2903953.2
230110,202202,2908,1842,1066,2233717.2,1291992.6,3525709.8
230120,202202,1093,851,242,1031412.4,293304,1324716.4
230125,202202,165,131,34,158772,41208,199980
230130,202202,474,419,55,507828.8,67872,575700.8
230140,202202,210,170,40,206040,48480,254520
230150,202202,151,116,35,140592,42420,183012
230160,202202,938,777,161,942936,195132,1138068
230170,202202,611,543,68,658117,82416,740533
230180,202202,65,60,5,72720,6060,78780
230185,202202,405,344,61,416928,73932,490860
230190,202202,2441,1882,559,2280984.4,677508,2958492.4
230195,202202,508,440,68,533280,82416,615696
230200,202202,420,329,91,398748,110292,509040
230205,202202,390,260,130,316332,157560,473892
230210,202202,1399,1069,330,1295628,399960,1695588
230220,202202,1584,1073,511,1300476.4,619332.6,1919809.0
230230,202202,970,809,161,980508,195132.02,1175640.02
230240,202202,1849,1609,240,1950412.19,290880.8,2241292.99
230250,202202,1770,1443,327,1751340,396324,2147664
230260,202202,3239,2002,1237,2428848,1500456,3929304
230270,202202,1350,1064,286,1291993.78,346632,1638625.78
230280,202202,2786,2109,677,2556108,820524,3376632
230290,202202,352,311,41,376932.26,49692,426624.26
230300,202202,530,386,144,467832,174528,642360
230310,202202,424,326,98,395112,118776,513888
230320,202202,905,764,141,925969.2,170892,1096861.2
230330,202202,307,243,64,294516,77568.4,372084.4
230340,202202,437,351,86,426624.4,104232,530856.4
230350,202202,3307,2044,1263,2479752,1530756,4010508
230360,202202,269,224,45,271488,54540,326028
230365,202202,128,104,24,126048,29088,155136
230370,202202,10845,5349,5496,6486626.96,6663576.4,13150203.36
230380,202202,485,414,71,501768.6,86052,587820.6
230390,202202,527,301,226,364812,273912.6,638724.6
230393,202202,243,201,42,243612,50904,294516
230395,202202,351,284,67,344208.12,81204,425412.12
230400,202202,628,501,127,607212,153924,761136
230410,202202,2695,1673,1022,2028888.86,1238664.6,3267553.46
230420,202202,6471,4261,2210,5166759.11,2680945.52,7847704.63
230423,202202,335,292,43,356328,52116,408444
230425,202202,470,372,98,450864.99,118776,569640.99
230426,202202,115,90,25,109080,30300,139380
230427,202202,69,64,5,77568,6060,83628
230428,202202,1605,792,813,959904,985356,1945260
230430,202202,453,366,87,443592,105444,549036
230435,202202,930,677,253,820524,306636,1127160
230440,202202,94070,42441,51629,51465178.69,62613147.34,114078326.03
230445,202202,317,215,102,260580,123624,384204
230450,202202,583,460,123,557520,149076,706596
230460,202202,85,64,21,77568,25452,103020
230465,202202,308,247,61,300576,73932,374508
230470,202202,2028,1590,438,1927080.6,530856,2457936.6
230480,202202,153,140,13,169680,15756,185436
230490,202202,326,257,69,311484,83628,395112
230495,202202,481,337,144,408444,174528,582972
230500,202202,1056,787,269,955056,326028,1281084
230510,202202,61,45,16,54540,19392,73932
230520,202202,399,306,93,370872,112716,483588
230523,202202,2466,1518,948,1839816,1148977.2,2988793.2
230526,202202,259,223,36,270276,43632,313908
230530,202202,692,508,184,615696.6,223008,838704.6
230533,202202,221,200,21,242400,25452,267852
230535,202202,378,283,95,342996,115140,458136
230540,202202,1798,1603,195,1942836.6,237552,2180388.6
230550,202202,3968,2524,1444,3060301.24,1753764.6,4814065.84
230560,202202,582,441,141,534492,170892,705384
230565,202202,217,162,55,197556,67872,265428
230570,202202,282,241,41,292092,49692,341784
230580,202202,1192,848,344,1028988,416928,1445916
230590,202202,1018,788,230,955056,278760,1233816
230600,202202,251,226,25,273912,30300,304212
230610,202202,431,323,108,391476.4,130896,522372.4
230620,202202,164,141,23,170892.6,27876,198768.6
230625,202202,824,562,262,682356,317544,999900
230630,202202,1343,1016,327,1231392,396324,1627716
230640,202202,3827,3179,648,3856584.02,785378,4641962.02
230650,202202,499,423,76,512676,92112,604788
230655,202202,699,574,125,695688.4,151500,847188.4
230660,202202,362,298,64,361176,77568,438744
230670,202202,459,374,85,453288,103020,556308
230680,202202,207,183,24,221796,29088,250884
230690,202202,935,783,152,948996,184224,1133220
230700,202202,916,762,154,923544,186648,1110192
230710,202202,669,626,43,758712,52116,810828
230720,202202,147,125,22,151500,26664,178164
230725,202202,245,182,63,220584,76356,296940
230730,202202,12609,6671,5938,8087601.52,7200495.39,15288096.91
230740,202202,674,535,139,648420.6,168468,816888.6
230750,202202,815,684,131,829008.4,158772,987780.4
230760,202202,1462,1260,202,1528332,244824,1773156
230763,202202,336,275,61,333300,73932,407232
230765,202202,8140,3769,4371,4574090.4,5301289.2,9875379.6
230770,202202,4995,2515,2480,3049393.72,3009396.6,6058790.32
230780,202202,770,675,95,818100.6,115140,933240.6
230790,202202,300,248,52,301788,63024,364812
230800,202202,1145,815,330,988992,402384,1391376
230810,202202,1405,1225,180,1485912.4,219372,1705284.4
230820,202202,369,249,120,301788.6,145440,447228.6
230830,202202,944,796,148,964752,179376,1144128
230835,202202,278,236,42,286032,50904,336936
230837,202202,172,141,31,170892,37572,208464
230840,202202,929,712,217,862944,263004,1125948
230850,202202,1406,1204,202,1462884,246036,1708920
230860,202202,308,229,79,277548,95755,373303
230870,202202,1837,1545,292,1872540,353904,2226444
230880,202202,74,58,16,70296,19392,89688
230890,202202,541,481,60,582972,72720,655692
230900,202202,291,214,77,259368,93324.88,352692.88
230910,202202,223,170,53,207252,64236,271488
230920,202202,481,378,103,458136,124836,582972
230930,202202,1041,725,316,878700,382992,1261692
230940,202202,839,645,194,781740,235128,1016868
230945,202202,517,413,104,501768.4,126048,627816.4
230950,202202,421,362,59,438744,71508,510252
230960,202202,2766,1841,925,2232504.6,1122312.6,3354817.2
230970,202202,1768,976,792,1185336,959904,2145240
230980,202202,205,163,42,197556,50904,248460
230990,202202,136,107,29,129684,35148,164832
231000,202202,202,185,17,224220,20604,244824
231010,202202,160,111,49,134532,59388,193920
231020,202202,1402,956,446,1158672.4,540552,1699224.4
231025,202202,1087,762,325,923544.4,393900,1317444.4
231030,202202,1041,861,180,1044744,218160,1262904
231040,202202,156,107,49,129684,59388,189072
231050,202202,936,813,123,986568.6,149076,1135644.6
231060,202202,159,130,29,157560,35148,192708
231070,202202,1499,1026,473,1243513.2,573276,1816789.2
231080,202202,265,237,28,287244,33936,321180
231085,202202,652,394,258,478740.4,312696,791436.4
231090,202202,259,206,53,249672,64236,313908
231095,202202,164,132,32,159984,38784,198768
231100,202202,165,133,32,161196,38784,199980
231110,202202,368,308,60,373296,72720,446016
231120,202202,271,226,45,273912,54540,328452
231123,202202,158,147,11,178164,13332,191496
231126,202202,322,242,80,293304,96960,390264
231130,202202,4946,3852,1094,4673472.6,1329564.6,6003037.2
231135,202202,210,184,26,223008,31512,254520
231140,202202,3088,2243,845,2719728,1024140,3743868
231150,202202,378,356,22,431472,26664,458136
231160,202202,1219,978,241,1187760,293304,1481064
231170,202202,520,361,159,438744,192708,631452
231180,202202,1761,1520,241,1842240.6,292092,2134332.6
231190,202202,208,169,39,204828,47268,252096
231195,202202,223,186,37,225432,44844,270276
231200,202202,820,662,158,802344,192708.4,995052.4
231210,202202,522,439,83,532068,100596,632664
231220,202202,1036,744,292,901728.6,353904,1255632.6
231230,202202,1498,1143,355,1385316,430260,1815576
231240,202202,1518,1038,480,1259268,582972,1842240
231250,202202,98,92,6,111504,7272,118776
231260,202202,261,174,87,210888,105444,316332
231270,202202,999,788,211,955056.84,255732,1210788.84
231280,202202,76,59,17,71508,20604,92112
231290,202202,7908,4415,3493,5354618,4238364.1,9592982.1
231300,202202,579,529,50,641148,60600,701748
231310,202202,761,698,63,845976,77568,923544
231320,202202,594,450,144,545400.8,174528,719928.8
231325,202202,101,87,14,105444,16968,122412
231330,202202,1920,1467,453,1779218.28,549036,2328254.28
231335,202202,252,222,30,269064,36360,305424
231340,202202,1765,1248,517,1513788,629028.6,2142816.6
231350,202202,1339,1066,273,1291992,330877.8,1622869.8
231355,202202,409,345,64,418140,77568,495708
231360,202202,546,375,171,455713.49,207252,662965.49
231370,202202,94,81,13,98172,15756,113928
231375,202202,289,211,78,255732,94536,350268
231380,202202,486,386,100,467832,121200,589032
231390,202202,206,155,51,187860,61812,249672
231395,202202,766,468,298,568428,362388,930816
231400,202202,1149,953,196,1157460.4,237552.6,1395013.0
231410,202202,1341,1095,246,1328353,300576,1628929
240010,202202,374,162,212,196344.83,256944,453288.83
240020,202202,2198,1787,411,2167057.85,500556,2667613.85
240030,202202,119,98,21,118776,25452,144228
240040,202202,33,32,1,38784,1212,39996
240050,202202,524,446,78,540552,94536,635088
240060,202202,69,64,5,77568,6060,83628
240070,202202,245,187,58,226644,70296,296940
240080,202202,545,364,181,441168,220584.6,661752.6
240090,202202,103,92,11,111504,13332,124836
240100,202202,1469,1381,88,1673772.4,106656,1780428.4
240110,202202,1026,684,342,829009,415716.8,1244725.8
240120,202202,143,108,35,130896,42420,173316
240130,202202,267,248,19,300576.4,23028,323604.4
240140,202202,79,55,24,67872,29088,96960
240145,202202,713,626,87,759924,105444,865368
240150,202202,25,18,7,21816,8484,30300
240160,202202,41,33,8,39996,9696,49692
240165,202202,41,32,9,38784,10908,49692
240170,202202,133,88,45,107868.6,54540,162408.6
240180,202202,100,76,24,92112,29088,121200
240185,202202,47,42,5,50904,6060,56964
240190,202202,14,12,2,14544.6,2424,16968.6
240200,202202,3059,1662,1397,2014344.8,1694377.4,3708722.2
240210,202202,161,122,39,147864,47268,195132
240220,202202,1105,775,330,939300.8,403596,1342896.8
240230,202202,825,753,72,915060.2,87264,1002324.2
240240,202202,71,47,24,56964,29088,86052
240250,202202,90,79,11,95748,13332,109080
240260,202202,1801,1279,522,1550149.2,632664,2182813.2
240270,202202,178,155,23,187860,27876,215736
240280,202202,54,41,13,49692,15756,65448
240290,202202,41,39,2,47268,2424,49692
240300,202202,171,91,80,110292,96960,207252
240310,202202,2419,1290,1129,1563480.44,1368349.16,2931829.60
240320,202202,176,162,14,196344,16968,213312
240325,202202,4676,2710,1966,3288159.01,2385218.12,5673377.13
240330,202202,70,66,4,79992,4848,84840
240340,202202,85,57,28,69084,33936,103020
240350,202202,90,73,17,89688,20604,110292
240360,202202,604,362,242,438744,293304,732048
240370,202202,51,44,7,53328,8484,61812
240375,202202,60,37,23,44844,27876,72720
240380,202202,224,183,41,223008,49692.2,272700.2
240390,202202,15,13,2,15756,2424,18180
240400,202202,86,76,10,92112,12120,104232
240410,202202,13,8,5,9696,6060,15756
240420,202202,1059,768,291,930816.8,352692,1283508.8
240430,202202,263,243,20,294516,24240,318756
240440,202202,121,65,56,78780,67872,146652
240450,202202,238,150,88,181801.2,106656,288457.2
240460,202202,75,59,16,71508,19392,90900
240470,202202,211,190,21,230280,25452,255732
240480,202202,16,14,2,16968,2424,19392
240485,202202,85,68,17,82416,20604,103020
240490,202202,47,43,4,52116,4848,56964
240500,202202,87,65,22,79992,26664,106656
240510,202202,42,30,12,36360,14544,50904
240520,202202,99,94,5,113928,6060,119988
240530,202202,58,48,10,58176,12120,70296
240540,202202,84,70,14,84840,16968,101808
240550,202202,12,10,2,12120,2424,14544
240560,202202,377,268,109,324816,132108,456924
240570,202202,426,267,159,323604,192708,516312
240580,202202,1292,992,300,1204728.4,363600,1568328.4
240590,202202,31,29,2,35148,2424,37572
240600,202202,97,91,6,110292,7272,117564
240610,202202,497,411,86,498132,104232,602364
240615,202202,13,12,1,14544,1212,15756
240620,202202,87,83,4,100596,4848,105444
240630,202202,40,33,7,39996,8484,48480
240640,202202,26,21,5,25452,6060,31512
240650,202202,240,193,47,233916,56964,290880
240660,202202,107,91,16,110292,19392,129684
240670,202202,306,164,142,198768.8,173316,372084.8
240680,202202,53,40,13,48480,15756,64236
240690,202202,46,43,3,52116,3636,55752
240700,202202,178,145,33,176952,39996,216948
240710,202202,2130,1272,858,1542877.4,1039896,2582773.4
240720,202202,1046,749,297,909000,359964.8,1268964.8
240725,202202,64,59,5,71508,6060,77568
240730,202202,150,125,25,151500,30300,181800
240740,202202,229,193,36,233916,43632,277548
240750,202202,51,31,20,37572,24240,61812
240760,202202,54,44,10,53328,12120,65448
240770,202202,138,105,33,127260,39996,167256
240780,202202,706,583,123,707808,149076,856884
240790,202202,40,38,2,46056,2424,48480
240800,202202,9443,6366,3077,7725295.24,3729327.8,11454623.04
240810,202202,21296,11241,10055,13632588.56,12192724.68,25825313.24
240820,202202,242,141,101,170892,122412,293304
240830,202202,1596,1313,283,1592568.8,344208,1936776.8
240840,202202,76,67,9,81204,10908,92112
240850,202202,82,73,9,88476,10908,99384
240860,202202,106,101,5,122412,6060,128472
240870,202202,57,49,8,59388,9696,69084
240880,202202,32,28,4,33936,4848,38784
240890,202202,1134,630,504,763560.6,610848,1374408.6
240895,202202,67,51,16,61812,19392,81204
240910,202202,167,140,27,169680,32724,202404
240920,202202,12,10,2,12120,2424,14544
240930,202202,409,363,46,439956,55752,495708
240933,202202,55,36,19,43632,23028,66660
240940,202202,2292,2013,279,2442181.2,338149.2,2780330.4
240950,202202,45,40,5,48480,6060,54540
240960,202202,24,20,4,24240,4848,29088
240970,202202,112,82,30,99384,36360,135744
240980,202202,200,161,39,195132,47268,242400
240990,202202,133,89,44,107868,53328,161196
241000,202202,59,55,4,66660,4848,71508
241010,202202,74,56,18,67872,21816,89688
241020,202202,104,96,8,116352.6,9696,126048.6
241025,202202,16,8,8,9696,9696,19392
241030,202202,101,80,21,96960,25452,122412
241040,202202,41,29,12,35148,14544,49692
241050,202202,77,69,8,83628,9696,93324
241060,202202,26,21,5,25452,6060,31512
241070,202202,17,16,1,19392,1212,20604
241080,202202,54,47,7,56964,8484,65448
241090,202202,55,41,14,49692,16968,66660
241100,202202,71,60,11,72720,13332,86052
241105,202202,13,5,8,6060,9696,15756
241110,202202,45,39,6,47268,7272,54540
241120,202202,1552,1169,383,1416828,464196,1881024
241140,202202,211,175,36,212100.6,43632,255732.6
241142,202202,46,34,12,41208,14544,55752
241150,202202,1201,1046,155,1267752,187860,1455612
241160,202202,20,15,5,18180,6060,24240
241170,202202,47,40,7,48480,8484,56964
241180,202202,41,30,11,36360,13332,49692
241190,202202,38,36,2,43632,2424,46056
241200,202202,4133,2160,1973,2619133.94,2396124,5015257.94
241210,202202,70,59,11,71508,13332,84840
241220,202202,1450,936,514,1135644.64,622968,1758612.64
241230,202202,251,207,44,250884,53328,304212
241240,202202,55,41,14,49692,16968,66660
241250,202202,1131,1033,98,1251996.6,118776,1370772.6
241255,202202,53,44,9,53328,10908,64236
241260,202202,685,522,163,632664,197556,830220
241270,202202,63,44,19,53328,23028,76356
241280,202202,96,84,12,101808,14544,116352
241290,202202,122,87,35,105444,43632,149076
241300,202202,81,56,25,67872,30300,98172
241310,202202,44,30,14,36360,16968,53328
241320,202202,26,12,14,14544,16968,31512
241330,202202,57,49,8,60600,9696,70296
241335,202202,80,71,9,86052,10908,96960
241340,202202,182,133,49,161196,59388,220584
241350,202202,60,50,10,60600,12120,72720
241355,202202,48,41,7,49692,8484,58176
241360,202202,50,49,1,59388,1212,60600
241370,202202,59,46,13,55752,15756,71508
241380,202202,34,30,4,36360,4848,41208
241390,202202,79,61,18,73932,21816,95748
241400,202202,217,163,54,197556,65448,263004
241410,202202,178,162,16,196344,19392,215736
241415,202202,101,81,20,98172,24240,122412
241420,202202,113,79,34,95748,41208,136956
241430,202202,20,18,2,21816,2424,24240
241440,202202,514,429,85,519948.4,103020,622968.4
241445,202202,40,35,5,42420,6060,48480
241450,202202,256,213,43,258156,52116,310272
241460,202202,144,130,14,157560,16968,174528
241470,202202,33,27,6,32724,7272,39996
241475,202202,52,47,5,56964,6060,63024
241480,202202,113,80,33,99384,39996,139380
241490,202202,13,12,1,14544,1212,15756
241500,202202,40,31,9,37572,10908,48480
250010,202202,99,85,14,103020,16968,119988
250020,202202,31,27,4,32724,4848,37572
250030,202202,896,659,237,798708,287245,1085953
250040,202202,385,308,77,373296,93324,466620
250050,202202,266,216,50,261792,60600,322392
250053,202202,61,48,13,58176,15756,73932
250057,202202,1,1,0,1212,,1212.0
250060,202202,602,437,165,529644,199980,729624
250070,202202,683,543,140,658116.88,169680,827796.88
250073,202202,8,8,0,9696,,9696.0
250077,202202,175,129,46,157560,55752,213312
250080,202202,423,337,86,408444.68,104232.8,512677.48
250090,202202,225,145,80,175740,96960,272700
250100,202202,547,452,95,547824,115140.8,662964.8
250110,202202,666,493,173,597516,209676,807192
250115,202202,14,3,11,3636,13332,16968
250120,202202,117,84,33,101808,39996,141804
250130,202202,552,443,109,536916,133320,670236
250135,202202,22,11,11,13332,13332,26664
250140,202202,81,72,9,87264,10908,98172
250150,202202,609,432,177,523584,214524,738108
250153,202202,11,9,2,10908,2424,13332
250157,202202,29,24,5,29088,6060,35148
250160,202202,237,183,54,221796,65448,287244
250170,202202,70,45,25,54540,30300,84840
250180,202202,4591,3137,1454,3806894.08,1764672.4,5571566.48
250190,202202,820,548,272,664176,330876,995052
250200,202202,61,46,15,55752,18180,73932
250205,202202,24,19,5,23028,6060,29088
250210,202202,87,75,12,90900,14544,105444
250215,202202,70,53,17,64236,20604,84840
250220,202202,26,18,8,21816,9696,31512
250230,202202,76,68,8,82416,9696,92112
250240,202202,235,181,54,219372,66660,286032
250250,202202,371,319,52,386628,63024,449652
250260,202202,44,36,8,43632,9696,53328
250270,202202,74,52,22,63024,26664,89688
250280,202202,373,303,70,367236,84840,452076
250290,202202,91,83,8,100596,9696,110292
250300,202202,564,377,187,456924,226644,683568
250310,202202,46,42,4,50904,4848,55752
250320,202202,1986,1310,676,1588932.76,819312.6,2408245.36
250330,202202,109,92,17,111504,20604,132108
250340,202202,29,24,5,29088,6060,35148
250350,202202,188,122,66,147864,79992,227856
250355,202202,31,23,8,27876,9696,37572
250360,202202,189,156,33,189072,39996,229068
250370,202202,2360,1520,840,1843452.6,1018080,2861532.6
250375,202202,14,8,6,9696,7272,16968
250380,202202,55,45,10,54540,12120,66660
250390,202202,45,34,11,41208,13332,54540
250400,202202,16550,8280,8270,10041402.76,10038998.44,20080401.20
250403,202202,315,247,68,299364,82416,381780
250407,202202,66,53,13,64236,15756,79992
250410,202202,29,25,4,30300,4848,35148
250415,202202,45,28,17,33936,20604,54540
250420,202202,36,30,6,36360,7272,43632
250430,202202,1431,1234,197,1497123,238764,1735887
250435,202202,26,20,6,24240,7272,31512
250440,202202,680,563,117,682356.4,141804,824160.4
250450,202202,81,62,19,75144,23028,98172
250460,202202,464,301,163,364812,198768,563580
250470,202202,96,66,30,79992,36360,116352
250480,202202,329,260,69,315120,83628,398748
250485,202202,6,6,0,7272,,7272.0
250490,202202,231,191,40,231492,48480,279972
250500,202202,93,72,21,87264,25452,112716
250510,202202,785,619,166,750228,201192,951420
250520,202202,168,111,57,134532,69084,203616
250523,202202,119,98,21,118776,25452,144228
250527,202202,117,88,29,106656,35148,141804
250530,202202,6,3,3,3636,3636,7272
250535,202202,29,21,8,25452,9696,35148
250540,202202,140,110,30,133320,36360,169680
250550,202202,65,63,2,76356,2424,78780
250560,202202,59,38,21,46056,25452,71508
250570,202202,156,127,29,153924,35148,189072
250580,202202,96,73,23,89766,27876,117642
250590,202202,22,12,10,14544,12120,26664
250600,202202,1483,970,513,1175641.12,622968,1798609.12
250610,202202,156,126,30,152712,36360,189072
250620,202202,20,16,4,19392,4848,24240
250625,202202,70,52,18,64236,21816,86052
250630,202202,3100,1956,1144,2371884.57,1386528,3758412.57
250640,202202,190,150,40,181800,48480,230280
250650,202202,29,20,9,24240,10908,35148
250660,202202,59,43,16,52116,19392,71508
250670,202202,64,49,15,59388,18180,77568
250680,202202,412,328,84,398748,101808,500556
250690,202202,2119,1459,660,1768308.2,801132.6,2569440.8
250700,202202,919,780,139,945360.4,168468,1113828.4
250710,202202,448,354,94,430260,113928,544188
250720,202202,119,87,32,105444,38784,144228
250730,202202,411,342,69,414504,83628,498132
250740,202202,64,60,4,72720,4848,77568
250750,202202,23394,13854,9540,16804260.78,11573389.8,28377650.58
250760,202202,108,86,22,104232,26664,130896
250770,202202,358,230,128,279972.36,155136,435108.36
250780,202202,65,43,22,52116,26664,78780
250790,202202,457,290,167,351480,202404,553884
250800,202202,149,133,16,161196,20604,181800
250810,202202,78,63,15,76356,18180,94536
250820,202202,150,126,24,152712,29088,181800
250830,202202,448,292,156,353904.6,189072,542976.6
250840,202202,59,53,6,64236,7272,71508
250850,202202,58,49,9,59388,10908,70296
250855,202202,16,14,2,16968,2424,19392
250860,202202,238,155,83,189072,100596,289668
250870,202202,29,26,3,31512,3636,35148
250880,202202,87,66,21,79992,25452,105444
250890,202202,3071,2275,796,2757300,964752,3722052
250900,202202,58,48,10,58176,12120,70296
250905,202202,123,93,30,112716,36360,149076
250910,202202,1018,748,270,906576,329664,1236240
250915,202202,108,74,34,89688,41208,130896
250920,202202,135,98,37,118776,44844,163620
250930,202202,181,105,76,127260,92112,219372
250933,202202,8,5,3,6060,3636,9696
250937,202202,16,16,0,19392,,19392.0
250939,202202,30,25,5,30300,6060,36360
250940,202202,119,87,32,105444,38784,144228
250950,202202,72,50,22,60600,27876,88476
250960,202202,91,50,41,60600,49692,110292
250970,202202,1247,875,372,1060500,450864,1511364
250980,202202,99,67,32,81204,38784,119988
250990,202202,166,127,39,153924,47268,201192
251000,202202,77,67,10,81204,12120,93324
251010,202202,121,90,31,109080,37572,146652
251020,202202,76,62,14,75144,16968,92112
251030,202202,46,33,13,39996,15756,55752
251040,202202,56,38,18,46056,21816,67872
251050,202202,25,21,4,26664,4848,31512
251060,202202,49,39,10,47268,12120,59388
251065,202202,7,4,3,4848,3636,8484
251070,202202,17,13,4,15756,4848,20604
251080,202202,5245,2444,2801,2964609.76,3397237.48,6361847.24
251090,202202,189,158,31,191496,37572,229068
251100,202202,20,19,1,23028,1212,24240
251110,202202,57,38,19,46056,23028,69084
251120,202202,1924,1180,744,1431373.4,901728.92,2333102.32
251130,202202,430,355,75,431472,90900,522372
251140,202202,580,367,213,446016,258156,704172
251150,202202,343,283,60,342996,72720,415716
251160,202202,96,76,20,92112,24240,116352
251170,202202,93,75,18,90900,21816,112716
251180,202202,283,164,119,199980,144228,344208
251190,202202,193,127,66,153924,81204,235128
251200,202202,277,216,61,261792,73932,335724
251203,202202,35,32,3,38784,3636,42420
251207,202202,86,72,14,87264,16968,104232
251210,202202,1487,1081,406,1311384,492072,1803456
251220,202202,44,34,10,41208,12120,53328
251230,202202,563,465,98,566004,118776,684780
251240,202202,107,75,32,90900,38784,129684
251250,202202,1448,1030,418,1249473.21,507828.8,1757302.01
251260,202202,12,8,4,9696,4848,14544
251270,202202,298,235,63,284820,76356,361176
251272,202202,66,58,8,70296,9696,79992
251274,202202,28,22,6,26664,7272,33936
251275,202202,34,20,14,24240,16968,41208
251276,202202,26,20,6,24240,7272,31512
251278,202202,12,10,2,12120,2424,14544
251280,202202,100,94,6,113928,7272,121200
251290,202202,961,684,277,829008,335724.6,1164732.6
251300,202202,17,12,5,14544,6060,20604
251310,202202,298,214,84,259368,101808,361176
251315,202202,38,34,4,41208,4848,46056
251320,202202,74,57,17,69084,20604,89688
251330,202202,82,71,11,86052,13332,99384
251335,202202,24,10,14,12120,16968,29088
251340,202202,778,447,331,541764,401172,942936
251350,202202,35,34,1,41208,1212,42420
251360,202202,83,72,11,87264,13332,100596
251365,202202,6,6,0,7272,,7272.0
251370,202202,5711,3872,1839,4695288.09,2230080.4,6925368.49
251380,202202,45,34,11,41208,13332,54540
251385,202202,2,2,0,2424,,2424.0
251390,202202,907,668,239,809616,289668.6,1099284.6
251392,202202,26,16,10,19392,12120,31512
251394,202202,9,9,0,10908,,10908.0
251396,202202,14,8,6,9696,7272,16968
251398,202202,17,13,4,15756,4848,20604
251400,202202,48,38,10,46056,12120,58176
251410,202202,39,33,6,39996,7272,47268
251420,202202,104,77,27,93324,32724,126048
251430,202202,45,41,4,49692,4848,54540
251440,202202,48,25,23,30300,27876,58176
251445,202202,64,52,12,63024,14544,77568
251450,202202,389,337,52,408444.8,63024,471468.8
251455,202202,5,4,1,4848,1212,6060
251460,202202,20,17,3,20604,3636,24240
251465,202202,8,5,3,6060,3636,9696
251470,202202,54,40,14,48480,16968,65448
251480,202202,30,25,5,30300,6060,36360
251490,202202,110,69,41,83628,49692.6,133320.6
251500,202202,118,98,20,118776,24240,143016
251510,202202,76,48,28,58176,33936,92112
251520,202202,34,29,5,35148,6060,41208
251530,202202,4296,3020,1276,3661452.6,1547724.6,5209177.2
251540,202202,82,67,15,81204,18180,99384
251550,202202,408,309,99,374508.6,119988,494496.6
251560,202202,24,17,7,20604,9696,30300
251570,202202,16,14,2,16968,2424,19392
251580,202202,132,104,28,126048,33936,159984
251590,202202,110,75,35,91129.06,42420,133549.06
251593,202202,23,14,9,16968,10908,27876
251597,202202,100,76,24,92112,29088,121200
251600,202202,1087,753,334,912932.6,404808.4,1317741.0
251610,202202,236,174,62,210888,75144,286032
251615,202202,13,12,1,14544,1212,15756
251620,202202,4168,2667,1501,3233617.36,1822849.4,5056466.76
251630,202202,458,336,122,407232,147864,555096
251640,202202,122,88,34,106656,41208,147864
251650,202202,283,208,75,252096.8,90900,342996.8
251660,202202,195,172,23,209676,27876,237552
251670,202202,387,297,90,359964,109080,469044
251675,202202,9,8,1,9696,1212,10908
251680,202202,101,88,13,106656,15756,122412
251690,202202,315,260,55,315120,66660,381780
251700,202202,280,241,39,292092.64,47268,339360.64
251710,202202,21,13,8,15756,9696,25452
251720,202202,24,16,8,19392,9696,29088
251740,202202,13,10,3,12120,3636,15756
260005,202202,3480,1838,1642,2227144.2,1990104.6,4217248.8
260010,202202,1658,1229,429,1489549.02,519948,2009497.02
260020,202202,403,349,54,424200,65448,489648
260030,202202,588,397,191,481164,231492,712656
260040,202202,799,489,310,593880,375720,969600
260050,202202,1160,819,341,993840,415717.2,1409557.2
260060,202202,366,336,30,407232,36360,443592
260070,202202,1313,800,513,969600.2,621756,1591356.2
260080,202202,714,543,171,658116,208464,866580
260090,202202,484,316,168,382992.6,203616,586608.6
260100,202202,214,148,66,179376,79992,259368
260105,202202,252,140,112,169680,135744,305424
260110,202202,2926,2126,800,2582773.2,969600.6,3552373.8
260120,202202,2703,1450,1253,1761359.67,1518636.8,3279996.47
260130,202202,181,119,62,144228,75144,219372
260140,202202,2191,1419,772,1722253.36,935664,2657917.36
260150,202202,193,124,69,150288,83628,233916
260160,202202,341,278,63,336936,76356,413292
260170,202202,3321,1972,1349,2392488.72,1637413.2,4029901.92
260180,202202,178,143,35,173316,42420,215736
260190,202202,2335,1541,794,1868904,962328,2831232
260200,202202,967,754,213,915060.95,258156.6,1173217.55
260210,202202,1384,974,410,1181700.2,498132,1679832.2
260220,202202,652,587,65,711444,78780,790224
260230,202202,1222,903,319,1095648,386628,1482276
260240,202202,200,150,50,181800,60600,242400
260250,202202,90,66,24,79992,29088,109080
260260,202202,1049,722,327,876276,396324,1272600
260270,202202,262,188,74,227856,89688,317544
260280,202202,1157,922,235,1117464,286032.6,1403496.6
260290,202202,6764,3641,3123,4417742.1,3789926.16,8207668.26
260300,202202,981,830,151,1005960.8,183012,1188972.8
260310,202202,509,411,98,498132,119988,618120
260320,202202,822,598,224,724776,272700,997476
260330,202202,72,53,19,64236,23028,87264
260340,202202,76,56,20,67872,25452,93324
260345,202202,5571,2908,2663,3529345,3234828,6764173
260350,202202,477,335,142,407232,172104.6,579336.6
260360,202202,244,135,109,163620,132108,295728
260370,202202,747,468,279,567216,340572,907788
260380,202202,561,401,160,486012,193920.19,679932.19
260390,202202,294,249,45,301788,54540,356328
260392,202202,116,99,17,119988,20604,140592
260400,202202,4345,2474,1871,2999701.26,2270076,5269777.26
260410,202202,14921,7715,7206,9354219.83,8740944.6,18095164.43
260415,202202,142,120,22,145440,26664,172104
260420,202202,1739,1063,676,1290780.32,820524,2111304.32
260430,202202,169,153,16,185436.24,19392,204828.24
260440,202202,188,128,60,155136,72720,227856
260450,202202,423,316,107,382992.95,129684,512676.95
260460,202202,823,427,396,517525,479952,997477
260470,202202,334,203,131,246036,159984.2,406020.2
260480,202202,250,156,94,189072,115140,304212
260490,202202,217,171,46,207252,55752,263004
260500,202202,1109,743,366,900516.6,443592,1344108.6
260510,202202,796,631,165,767196,199980,967176
260515,202202,230,207,23,250884,27876,278760
260520,202202,3221,1984,1237,2404608.6,1499244.92,3903853.52
260530,202202,808,654,154,792648,186648,979296
260540,202202,525,413,112,500556,135744,636300
260545,202202,17,11,6,13332,7272,20604
260550,202202,324,204,120,247248,145440,392688
260560,202202,505,382,123,462984.2,149076,612060.2
260570,202202,998,792,206,962328,249672,1212000
260580,202202,303,255,48,309060,58176,367236
260590,202202,616,352,264,426624,321180,747804
260600,202202,7674,4400,3274,5334015.1,3970512.6,9304527.7
260610,202202,489,323,166,392688,201192,593880
260620,202202,3662,1877,1785,2274924.8,2164633.19,4439557.99
260630,202202,81,74,7,89688,8484,98172
260640,202202,3368,1936,1432,2346434.08,1739220,4085654.08
260650,202202,316,225,91,273912,110292,384204
260660,202202,573,361,212,438744,258156,696900
260670,202202,104,75,29,90900,35148,126048
260680,202202,3943,2153,1790,2610648,2169482.6,4780130.6
260690,202202,123,93,30,112716,36360,149076
260700,202202,305,204,101,247248,122412,369660
260710,202202,47,37,10,44844,12120,56964
260720,202202,2656,1558,1098,1890722.4,1330776,3221498.4
260730,202202,744,544,200,659328,243612,902940
260740,202202,74,61,13,73932,15756,89688
260750,202202,566,412,154,499344,186648,685992
260760,202202,701,342,359,414504.79,435108,849612.79
260765,202202,965,492,473,597516,573276,1170792
260770,202202,217,158,59,192687,71508,264195
260775,202202,774,415,359,502981.4,435108,938089.4
260780,202202,232,142,90,172104,109080,281184
260790,202202,15044,7381,7663,8951836.04,9299677.8,18251513.84
260795,202202,158,103,55,124836,67872,192708
260800,202202,286,231,55,279972,66660,346632
260805,202202,169,111,58,134532,70296,204828
260810,202202,801,655,146,793860,176952,970812
260820,202202,296,187,109,226644.96,132108,358752.96
260825,202202,208,138,70,167256,84840,252096
260830,202202,295,185,110,224220,133320,357540
260840,202202,258,186,72,225432,87264,312696
260845,202202,171,109,62,132108,75144,207252
260850,202202,406,303,103,367236,124836,492072
260860,202202,250,186,64,225432,77568,303000
260870,202202,345,264,81,319968,98172,418140
260875,202202,743,541,202,655692,244824,900516
260880,202202,1547,1014,533,1228968.8,645996,1874964.8
260890,202202,2377,1639,738,1986468,895668.4,2882136.4
260900,202202,994,709,285,859308,345420,1204728
260910,202202,247,193,54,233916,65448,299364
260915,202202,276,205,71,248460,86052,334512
260920,202202,198,103,95,124836,115140,239976
260930,202202,363,304,59,369660,71508,441168
260940,202202,2582,1372,1210,1664077.44,1466520,3130597.44
260950,202202,1983,1115,868,1351380.8,1053228,2404608.8
260960,202202,13569,6604,6965,8006480.7,8445219.3,16451700.0
260970,202202,416,340,76,412080,92112,504192
260980,202202,205,185,20,224220,24240,248460
260990,202202,2655,2114,541,2562169.36,655692,3217861.36
261000,202202,4194,2548,1646,3089389.2,1996164.4,5085553.6
261010,202202,153,109,44,132108,53328,185436
261020,202202,586,434,152,526008.8,184224,710232.8
261030,202202,250,184,66,223008,79992,303000
261040,202202,375,319,56,386628,67872,454500
261050,202202,499,424,75,513888,90900,604788
261060,202202,1443,884,559,1072620,677508,1750128
261070,202202,9205,4387,4818,5321898.53,5846691.7,11168590.23
261080,202202,367,279,88,339360,106656,446016
261090,202202,2119,1624,495,1968289.99,599940,2568229.99
261100,202202,1213,845,368,1025353,447228,1472581
261110,202202,9073,5567,3506,6749630.93,4251696,11001326.93
261120,202202,238,204,34,247248,41208,288456
261130,202202,564,331,233,401172.4,282396.28,683568.68
261140,202202,217,135,82,163620,100596,264216
261150,202202,675,429,246,521160.03,298152,819312.03
261153,202202,69,65,4,78780,4848,83628
261160,202202,74592,36399,38193,44147309.83,46339616.98,90486926.81
261170,202202,463,341,122,413292,147864,561156
261180,202202,1776,1103,673,1338325,815676,2154001
261190,202202,569,394,175,477528.64,212100,689628.64
261200,202202,222,180,42,218160,50904,269064
261210,202202,41,32,9,38784.6,10908,49692.6
261220,202202,2722,1896,826,2300377.6,1001112,3301489.6
261230,202202,337,247,90,299364,109080,408444
261240,202202,441,383,58,464196,70296,534492
261245,202202,247,203,44,246036,53328,299364
261247,202202,169,130,39,157560,47268,204828
261250,202202,3480,1640,1840,1987680.6,2231292,4218972.6
261255,202202,246,219,27,265428,32724,298152
261260,202202,829,712,117,865368.07,141804,1007172.07
261270,202202,196,135,61,163620,73932,237552
261280,202202,192,154,38,186648,46056,232704
261290,202202,108,79,29,96960,35148,132108
261300,202202,1326,972,354,1178064,429048,1607112
261310,202202,779,520,259,630240,313908,944148
261320,202202,556,378,178,458136,215736,673872
261330,202202,902,705,197,854460,239977.55,1094437.55
261340,202202,311,171,140,207252,169680,376932
261350,202202,869,607,262,735684.6,317544,1053228.6
261360,202202,1367,864,503,1047168,609636,1656804
261370,202202,4831,2820,2011,3419053.4,2442180,5861233.4
261380,202202,542,415,127,502980.79,153924.6,656905.39
261390,202202,3656,2460,1196,2981521.2,1450764.8,4432286.0
261400,202202,272,247,25,299364,30300,329664
261410,202202,1114,726,388,879912,470256,1350168
261420,202202,951,586,365,710232.93,442380,1152612.93
261430,202202,320,291,29,352692,35148,387840
261440,202202,105,100,5,121200,6060,127260
261450,202202,2492,1966,526,2384005.8,637512,3021517.8
261460,202202,757,592,165,717504,199980.6,917484.6
261470,202202,221,178,43,215736.4,52116,267852.4
261480,202202,455,348,107,421776.8,130841.46,552618.26
261485,202202,369,224,145,271488.2,175740,447228.2
261500,202202,606,404,202,489648.4,244824,734472.4
261510,202202,53,33,20,39996,24240,64236
261520,202202,88,72,16,87264,19392,106656
261530,202202,4033,2546,1487,3089389.7,1802244,4891633.7
261540,202202,1445,830,615,1005960.77,745380.6,1751341.37
261550,202202,254,122,132,147864,159984,307848
261560,202202,913,595,318,721141.4,385416.6,1106558.0
261570,202202,397,312,85,378144,103020,481164
261580,202202,388,306,82,370872,99384,470256
261590,202202,191,157,34,190284,41208,231492
261600,202202,291,229,62,277548,75144,352692
261610,202202,86,74,12,89688,14544,104232
261618,202202,71,53,18,64236,21816,86052
261620,202202,197,123,74,149076,89688,238764
261630,202202,661,522,139,632664,168468,801132
261640,202202,6459,3367,3092,4080806.82,3747504,7828310.82
261650,202202,468,304,164,368448,198768.6,567216.6
270010,202202,509,450,59,545400,71508.6,616908.6
270020,202202,244,200,44,242400,53328,295728
270030,202202,8734,5581,3153,6765789.71,3823807.8,10589597.51
270040,202202,2060,1334,726,1616808,879912.6,2496720.6
270050,202202,200,157,43,191496,53328,244824
270060,202202,72,48,24,58176,29088,87264
270070,202202,829,608,221,736896,269064,1005960
270080,202202,41,32,9,38784,10908,49692
270090,202202,20,16,4,19392,4848,24240
270100,202202,1311,896,415,1087164.6,502980,1590144.6
270110,202202,71,60,11,72720,13332,86052
270120,202202,228,186,42,226644,53328,279972
270130,202202,318,234,84,283608,101808,385416
270135,202202,117,79,38,95748.4,46056,141804.4
270140,202202,1365,887,478,1075084.4,579336,1654420.4
270150,202202,250,191,59,231492,71508,303000
270160,202202,489,387,102,469044,123624,592668
270170,202202,791,517,274,626604,332088,958692
270180,202202,57,46,11,55752,13332,69084
270190,202202,113,94,19,113928,23028,136956
270200,202202,115,101,14,122412,16968,139380
270210,202202,534,325,209,393900,253308,647208
270220,202202,189,142,47,173154.4,56964,230118.4
270230,202202,2154,1347,807,1632566.16,978084,2610650.16
270235,202202,648,502,146,609636,176952,786588
270240,202202,2959,2347,612,2844565.32,741745,3586310.32
270250,202202,122,88,34,106656,41208,147864
270255,202202,209,178,31,215736,37572,253308
270260,202202,359,291,68,353904,82416,436320
270270,202202,96,51,45,61812,54540,116352
270280,202202,220,133,87,161196,105444,266640
270290,202202,1104,868,236,1054440,286032,1340472
270300,202202,359,263,96,318756,116352,435108
270310,202202,811,676,135,819312,163620,982932
270320,202202,782,674,108,818100,130896,948996
270330,202202,297,251,46,304212,55752,359964
270340,202202,61,49,12,59388,14544,73932
270350,202202,90,55,35,66660,42420,109080
270360,202202,68,38,30,46056,36360,82416
270370,202202,58,46,12,55752,14544,70296
270375,202202,74,44,30,53328,36360,89688
270380,202202,1053,706,347,855672,420564,1276236
270390,202202,151,85,66,103020,79992,183012
270400,202202,728,552,176,669024.54,213312,882336.54
270410,202202,618,457,161,555096,196344,751440
270420,202202,402,281,121,340572,146652,487224
270430,202202,34163,24483,9680,29686577.88,11741861.74,41428439.62
270440,202202,473,376,97,455712,117564,573276
270450,202202,830,493,337,599576.4,408444,1008020.4
270460,202202,176,141,35,170892,42420,213312
270470,202202,1548,1079,469,1307748.6,569640,1877388.6
270480,202202,532,430,102,521160.6,123624,644784.6
270490,202202,21,16,5,19392,6060,25452
270500,202202,473,398,75,482376,90900,573276
270510,202202,843,538,305,652217.6,369660,1021877.6
270520,202202,268,175,93,212100,112716,324816
270530,202202,61,52,9,63024,10908,73932
270540,202202,91,66,25,79992,30300,110292
270550,202202,1679,1299,380,1576812,461772,2038584
270560,202202,256,154,102,186648,123624,310272
270570,202202,549,386,163,467832,197556,665388
270580,202202,77,60,17,72720,20604,93324
270590,202202,59,46,13,55752,15756,71508
270600,202202,153,131,22,158772,26664,185436
270610,202202,240,191,49,231492,59388,290880
270620,202202,14,14,0,18180,,18180.0
270630,202202,3669,2785,884,3376633.2,1073832,4450465.2
270640,202202,855,641,214,776892.48,259368,1036260.48
270642,202202,211,177,34,214524,41208,255732
270644,202202,253,170,83,206040,100596,306636
270650,202202,333,198,135,239976,164832,404808
270660,202202,198,174,24,210888,29088,239976
270670,202202,2930,2236,694,2712458.9,841128,3553586.9
270680,202202,398,250,148,303000,179376,482376
270690,202202,1219,814,405,987781.12,490860,1478641.12
270700,202202,24,19,5,23028,6060,29088
270710,202202,862,683,179,827796,218160,1045956
270720,202202,224,177,47,214524,56964,271488
270730,202202,1872,1160,712,1405920.2,862944.4,2268864.6
270740,202202,37,24,13,29088,15756,44844
270750,202202,627,478,149,579336,180588,759924
270760,202202,298,214,84,259368,101808,361176
270770,202202,2783,1878,905,2276138.72,1096860,3372998.72
270780,202202,65,42,23,50904,27876,78780
270790,202202,230,148,82,179376,99384,278760
270800,202202,2045,1634,411,1981620.8,499344,2480964.8
270810,202202,219,182,37,220584,44844,265428
270820,202202,123,86,37,104232,44844,149076
270830,202202,817,626,191,758712,231492,990204
270840,202202,1328,1021,307,1237452.88,373296.56,1610749.44
270850,202202,1501,971,530,1178064.4,643572,1821636.4
270860,202202,2536,1716,820,2081004.72,996264,3077268.72
270870,202202,113,63,50,76356,60600,136956
270880,202202,848,675,173,819312.4,209676,1028988.4
270890,202202,270,204,66,247248,79992,327240
270895,202202,58,56,2,67872,2424,70296
270900,202202,64,54,10,65448,12120,77568
270910,202202,301,248,53,300576,64236,364812
270915,202202,1902,1247,655,1511364.8,793860.36,2305225.16
270920,202202,425,354,71,430260,86052,516312
270930,202202,5741,4392,1349,5324316.4,1634988.64,6959305.04
270940,202202,2197,1734,463,2101608.6,561156,2662764.6
280010,202202,37,31,6,37572,7272,44844
280020,202202,484,416,68,504192.72,82416,586608.72
280030,202202,21047,13620,7427,16515955.41,9008801.04,25524756.45
280040,202202,321,208,113,252096,136956,389052
280050,202202,417,320,97,387840,117564,505404
280060,202202,362,238,124,288456.6,150288,438744.6
280067,202202,1122,808,314,979296,381780,1361076
280070,202202,131,108,23,130896,27876,158772
280100,202202,649,502,147,608424,179376.4,787800.4
280110,202202,73,67,6,81204,7272,88476
280120,202202,664,556,108,673872,130896,804768
280130,202202,1730,1129,601,1370772,728412.2,2099184.2
280140,202202,491,411,80,498132.6,96960,595092.6
280150,202202,418,293,125,356328,151500,507828
280160,202202,134,106,28,128472,33936,162408
280170,202202,416,289,127,350268,153924,504192
280190,202202,28,23,5,27876,6060,33936
280200,202202,39,31,8,37572,9696,47268
280210,202202,2936,2102,834,2548743.06,1010808,3559551.06
280220,202202,49,40,9,48480,10908,59388
280230,202202,331,268,63,326028,76356,402384
280240,202202,130,122,8,147864,9696,157560
280250,202202,18,10,8,12120,9696,21816
280260,202202,78,71,7,86052,8484,94536
280270,202202,139,107,32,130896,38784,169680
280280,202202,189,121,68,146652.9,82416,229068.9
280290,202202,3519,2545,974,3085675.24,1181700.16,4267375.40
280300,202202,1597,1269,328,1538028,398748,1936776
280310,202202,92,87,5,105444,6060,111504
280320,202202,648,460,188,557520,229068,786588
280330,202202,314,235,79,284820,95748,380568
280340,202202,419,354,65,429048,78780,507828
280350,202202,3719,2846,873,3450568.15,1058076.8,4508644.95
280360,202202,461,311,150,376932,183012,559944
280370,202202,92,81,11,98172.04,13332,111504.04
280380,202202,51,39,12,47268,14544,61812
280390,202202,177,149,28,180588,33936,214524
280400,202202,384,260,124,315120.2,150288,465408.2
280410,202202,287,237,50,287244.4,60600,347844.4
280420,202202,133,114,19,138168,23028,161196
280430,202202,87,70,17,84840,20604,105444
280440,202202,718,585,133,709021.24,161196,870217.24
280445,202202,121,114,7,138168,8484,146652
280450,202202,1251,1079,172,1308960,209676,1518636
280460,202202,652,472,180,572065.11,218160,790225.11
280470,202202,100,91,9,110292,10908,121200
280480,202202,2930,1991,939,2415518.59,1141704.22,3557222.81
280490,202202,196,185,11,224220,13332,237552
280500,202202,42,39,3,47268,3636,50904
280510,202202,132,106,26,128472,31512.6,159984.6
280520,202202,51,37,14,44844,16968,61812
280530,202202,69,47,22,56964,26664,83628
280540,202202,537,459,78,557520,94536,652056
280550,202202,735,676,59,819313.45,71508,890821.45
280560,202202,480,428,52,519948.44,63024,582972.44
280570,202202,2310,1824,486,2214325.72,590244,2804569.72
280580,202202,578,452,126,547825,152712,700537
280590,202202,217,138,79,167256,95748,263004
280600,202202,393,324,69,392744.96,83628,476372.96
280610,202202,110,81,29,98172,35148,133320
280620,202202,538,437,101,529644.16,122412,652056.16
280630,202202,151,123,28,149076,33936,183012
280640,202202,181,146,35,176952,42420,219372
280650,202202,88,55,33,66660,39996,106656
280660,202202,135,101,34,122412,41208,163620
280670,202202,1954,1234,720,1499247.2,872641.36,2371888.56
280680,202202,235,203,32,246036,38784,284820
280690,202202,79,69,10,83628,12120,95748
280700,202202,19,19,0,23028,,23028.0
280710,202202,1494,1162,332,1408345.28,402384,1810729.28
280720,202202,124,84,40,101808,48480,150288
280730,202202,30,26,4,31512,4848,36360
280740,202202,2537,1906,631,2310072,764772,3074844
280750,202202,226,196,30,237552,36360,273912
280760,202202,862,586,276,710232.44,334512,1044744.44
290010,202202,196,139,57,168468,69084,237552
290020,202202,189,171,18,207252,21816,229068
290030,202202,621,398,223,482376,270276,752652
290035,202202,133,109,24,132108,29088,161196
290040,202202,296,202,94,244824,113928,358752
290050,202202,88,72,16,87264,19392,106656
290060,202202,255,113,142,136956,172104,309060
290070,202202,5716,2731,2985,3312397.49,3621458.2,6933855.69
290080,202202,449,194,255,235128,309060,544188
290090,202202,358,160,198,193920,239976,433896
290100,202202,1681,1065,616,1290780.8,746592.6,2037373.4
290110,202202,850,492,358,596304.4,435108,1031412.4
290115,202202,191,173,18,209676,21816,231492
290120,202202,783,526,257,637512,312696,950208
290130,202202,445,271,174,328452,210888,539340
290135,202202,293,225,68,272700,82416,355116
290140,202202,315,260,55,315120,66660,381780
290150,202202,132,90,42,109080,52116,161196
290160,202202,243,187,56,226644.48,67872,294516.48
290170,202202,98,69,29,83628,35148,118776
290180,202202,187,137,50,166044.4,60600,226644.4
290190,202202,363,287,76,347844,93324,441168
290195,202202,299,192,107,232704,129684,362388
290200,202202,257,211,46,255732,55752,311484
290205,202202,145,91,54,110292.6,65448,175740.6
290210,202202,1188,870,318,1054440.6,385416,1439856.6
290220,202202,182,103,79,124836,95748,220584
290225,202202,304,121,183,146652,221796,368448
290230,202202,76,46,30,55752,36360,92112
290240,202202,363,124,239,150288,289668,439956
290250,202202,245,227,18,275124,21816,296940
290260,202202,325,260,65,315120.6,78780,393900.6
290265,202202,184,161,23,196344,27876,224220
290270,202202,1377,1144,233,1388952.6,282396.6,1671349.2
290280,202202,470,329,141,398748,170892,569640
290290,202202,1360,820,540,993841.26,654480.6,1648321.86
290300,202202,399,343,56,416928.6,69084,486012.6
290310,202202,283,134,149,162408,180588,342996
290320,202202,4142,2520,1622,3056664.84,1967076.4,5023741.24
290323,202202,196,170,26,206040,31512,237552
290327,202202,156,121,35,146652,42420,189072
290330,202202,119,56,63,67872,76356,144228
290340,202202,774,318,456,385416,552672,938088
290350,202202,664,407,257,493284,311484,804768
290360,202202,323,249,74,301789.61,89688,391477.61
290370,202202,902,398,504,483588.8,613272,1096860.8
290380,202202,328,209,119,253308,144228,397536
290390,202202,2408,1498,910,1816789.29,1105344,2922133.29
290395,202202,239,137,102,166044,123624,289668
290400,202202,277,200,77,243612,93324,336936
290405,202202,241,206,35,249672,42420,292092
290410,202202,624,518,106,629028,128472,757500
290420,202202,271,217,54,263004,65448,328452
290430,202202,473,301,172,364812,208464,573276
290440,202202,79,70,9,84840,10908,95748
290450,202202,191,143,48,173316,58176,231492
290460,202202,1921,1145,776,1387740.6,940512,2328252.6
290470,202202,1362,597,765,723564,929605.2,1653169.2
290475,202202,557,519,38,629028,46056,675084
290480,202202,274,159,115,192708,139380,332088
290485,202202,235,216,19,264216,23028,287244
290490,202202,1232,872,360,1056864,436320,1493184
290500,202202,767,401,366,487224,443592,930816
290510,202202,203,163,40,197556,48480,246036
290515,202202,166,101,65,122412,78780,201192
290520,202202,1390,903,487,1098073.2,590244.98,1688318.18
290530,202202,285,259,26,313908,31512,345420
290540,202202,110,57,53,69084,65448,134532
290550,202202,160,134,26,162408,31512,193920
290560,202202,3185,1389,1796,1684680,2176752,3861432
290570,202202,6353,3047,3306,3697813.24,4014146.6,7711959.84
290580,202202,1259,751,508,910212,616908,1527120
290590,202202,565,453,112,549036,135744,684780
290600,202202,1746,1200,546,1455613.32,664176,2119789.32
290610,202202,175,160,15,193920,18180,212100
290620,202202,366,332,34,402384,41208,443592
290630,202202,1959,842,1117,1021716.2,1357440.6,2379156.8
290640,202202,142,112,30,135744,36360,172104
290650,202202,1809,836,973,1013232.76,1180488,2193720.76
290660,202202,263,219,44,265428,53328,318756
290670,202202,964,488,476,591456.6,576912,1168368.6
290680,202202,1230,984,246,1192608,298152,1490760
290682,202202,314,233,81,282396.36,98172,380568.36
290685,202202,239,150,89,181800,107868,289668
290687,202202,1123,730,393,884957.16,476316,1361273.16
290689,202202,147,77,70,94536,84840,179376
290690,202202,582,252,330,305424,403596.6,709020.6
290700,202202,240,121,119,146652,144228,290880
290710,202202,754,512,242,620544.6,293304,913848.6
290720,202202,1030,821,209,995052.18,253308,1248360.18
290730,202202,1200,702,498,852036.2,603576,1455612.2
290740,202202,22,18,4,21816,4848,26664
290750,202202,1420,610,810,739320,981721.2,1721041.2
290755,202202,72,64,8,77568,9696,87264
290760,202202,258,228,30,276336,36360,312696
290770,202202,181,172,9,208464,10908,219372
290780,202202,1098,866,232,1049592.6,281184,1330776.6
290790,202202,377,256,121,310272,146652.6,456924.6
290800,202202,2406,966,1440,1170792,1746492,2917284
290810,202202,473,323,150,391476,181800,573276
290820,202202,401,234,167,283608,202404,486012
290830,202202,433,308,125,374508,151500,526008
290840,202202,1793,1114,679,1350169.32,822948.6,2173117.92
290850,202202,922,469,453,568428,549036,1117464
290860,202202,635,287,348,347844.4,421776,769620.4
290870,202202,604,422,182,511464.56,220584.96,732049.52
290880,202202,117,64,53,77568,64236,141804
290890,202202,436,266,170,322392,206040,528432
290900,202202,165,124,41,150288,49692,199980
290910,202202,385,292,93,353904,113928,467832
290920,202202,201,176,25,214524,30300,244824
290930,202202,512,389,123,471468.6,149076,620544.6
290940,202202,224,190,34,230280,41208,271488
290950,202202,156,90,66,109080,79992,189072
290960,202202,468,328,140,397536,169680,567216
290970,202202,239,210,29,254520,35148.6,289668.6
290980,202202,1771,1205,566,1460462.12,685992.2,2146454.32
290990,202202,392,331,61,402384,73932,476316
291000,202202,888,278,610,336936,739320,1076256
291005,202202,2449,1044,1405,1265328,1704072,2969400
291010,202202,162,144,18,174528,21816,196344
291020,202202,93,73,20,88476,24240,112716
291030,202202,95,67,28,81204,33936,115140
291040,202202,619,351,268,425412,326028,751440
291050,202202,1492,789,703,957480,853248,1810728
291060,202202,1648,910,738,1102920,894456,1997376
291070,202202,1932,1441,491,1747705.6,595094.43,2342800.03
291072,202202,7182,2693,4489,3265128.6,5441880.6,8707009.2
291075,202202,243,197,46,238764.4,55752,294516.4
291077,202202,60,42,18,50904,21816,72720
291080,202202,20633,8784,11849,10657119.95,14374323.2,25031443.15
291085,202202,265,217,48,263004,58176,321180
291090,202202,278,114,164,138168.6,198768,336936.6
291100,202202,999,335,664,406020,805980,1212000
291110,202202,431,331,100,401172,121200,522372
291120,202202,2408,1239,1169,1501668,1416828,2918496
291125,202202,59,30,29,36360,35148,71508
291130,202202,185,163,22,197556,26664,224220
291140,202202,126,102,24,123624,29088.6,152712.6
291150,202202,377,142,235,172104,284820,456924
291160,202202,385,308,77,373296,93324,466620
291165,202202,48,36,12,43632,14544,58176
291170,202202,3252,1602,1650,1941627.6,2002224.6,3943852.2
291180,202202,1240,502,738,608424,896880,1505304
291185,202202,112,103,9,124836,10908,135744
291190,202202,1392,661,731,801132,885972,1687104
291200,202202,168,123,45,149076,54540,203616
291210,202202,2397,959,1438,1162308.92,1742856.6,2905165.52
291220,202202,294,225,69,273912,83628,357540
291230,202202,970,339,631,410868.6,764772,1175640.6
291240,202202,406,380,26,460560.6,31512,492072.6
291250,202202,417,336,81,408444,98172,506616
291260,202202,60,52,8,63024,9696,72720
291270,202202,1040,449,591,544188,716292,1260480
291280,202202,352,165,187,199980,227856,427836
291290,202202,1669,871,798,1056865.2,967176.4,2024041.6
291300,202202,232,183,49,221796,59388,281184
291310,202202,226,199,27,241188,32724,273912
291320,202202,1314,918,396,1112616,479952,1592568
291330,202202,138,117,21,141804,25452,167256
291340,202202,223,134,89,163620,107868,271488
291345,202202,123,82,41,99384,49692,149076
291350,202202,1751,649,1102,787800,1335624.8,2123424.8
291360,202202,8345,3969,4376,4814064.4,5308560.2,10122624.6
291370,202202,1101,644,457,780528.6,555096,1335624.6
291380,202202,248,197,51,238764,61812,300576
291390,202202,4011,1783,2228,2160997.04,2702760.6,4863757.64
291400,202202,2087,1454,633,1762248,767196.94,2529444.94
291410,202202,202,173,29,209676.6,35148,244824.6
291420,202202,110,83,27,100596,32724,133320
291430,202202,169,100,69,121200,83628.34,204828.34
291440,202202,521,422,99,511464,119988,631452
291450,202202,921,600,321,727200,389052,1116252
291460,202202,1940,1541,399,1868905.34,483589.2,2352494.54
291465,202202,2255,1070,1185,1298052.6,1437432.6,2735485.2
291470,202202,2881,1454,1427,1762248.72,1731948.6,3494197.32
291480,202202,11851,5112,6739,6203019.88,8182213.8,14385233.68
291490,202202,640,257,383,311484,464196,775680
291500,202202,365,216,149,261792,180588,442380
291510,202202,1197,460,737,557520,894456,1451976
291520,202202,938,419,519,507828,630240,1138068
291530,202202,917,254,663,309060,804768,1113828
291535,202202,119,98,21,118776,25452,144228
291540,202202,352,116,236,140592,287244,427836
291550,202202,1286,604,682,732048.8,826584,1558632.8
291560,202202,5117,2556,2561,3097872.8,3108780.6,6206653.4
291570,202202,217,107,110,129684,133320,263004
291580,202202,1189,735,454,891426.48,550248,1441674.48
291590,202202,100,42,58,50904,70296,121200
291600,202202,1111,554,557,671448,675084,1346532
291610,202202,1389,667,722,809616,876276,1685892
291620,202202,558,263,295,318756,357540,676296
291630,202202,484,152,332,184224,402384,586608
291640,202202,4011,1995,2016,2419155.48,2444605.8,4863761.28
291650,202202,436,299,137,362389.1,166044,528433.1
291660,202202,369,146,223,176952,270276,447228
291670,202202,171,105,66,127260,79992,207252
291680,202202,639,390,249,472680,303000.2,775680.2
291685,202202,573,332,241,402384,292092,694476
291690,202202,454,293,161,355116,195132.52,550248.52
291700,202202,1010,776,234,941724,283608,1225332
291710,202202,1573,768,805,930816,975660.6,1906476.6
291720,202202,426,290,136,351480,166044,517524
291730,202202,917,532,385,644784,466620,1111404
291733,202202,288,192,96,233916,116352,350268
291735,202202,78,59,19,71508,23028,94536
291740,202202,344,260,84,315120,101808,416928
291750,202202,2267,1461,806,1773157.17,978084.6,2751241.77
291760,202202,3029,1657,1372,2010708,1662864,3673572
291770,202202,725,493,232,597517.88,281184,878701.88
291780,202202,70,42,28,50904.6,33936,84840.6
291790,202202,159,82,77,99384,93324,192708
291800,202202,10236,4287,5949,5198271.34,7217460,12415731.34
291810,202202,1069,802,267,973236.6,323604,1296840.6
291820,202202,284,200,84,242400,101808,344208
291830,202202,1026,420,606,509040.76,735684,1244724.76
291835,202202,550,509,41,616908,49692,666600
291840,202202,5078,2535,2543,3073632,3082117.6,6155749.6
291845,202202,267,82,185,99384,224220,323604
291850,202202,312,275,37,333300,44844,378144
291855,202202,261,109,152,132108,185436,317544
291860,202202,166,106,60,128472,72720,201192
291870,202202,84,37,47,44844.48,56964,101808.48
291875,202202,157,147,10,178164,12120,190284
291880,202202,426,350,76,424200,92112,516312
291890,202202,240,84,156,101808,190284.6,292092.6
291900,202202,57,34,23,41208,27876,69084
291905,202202,114,87,27,105444.6,32724,138168.6
291910,202202,158,126,32,152712,38784,191496
291915,202202,440,392,48,475104,58176,533280
291920,202202,5305,2580,2725,3131809.2,3307549.48,6439358.68
291930,202202,167,100,67,121200.26,81204,202404.26
291940,202202,373,213,160,258156,193920,452076
291950,202202,1138,901,237,1092012.6,287244,1379256.6
291955,202202,1348,812,536,985356,650844,1636200
291960,202202,200,148,52,179376,63024,242400
291970,202202,754,559,195,678720,236340,915060
291980,202202,1452,1269,183,1538029.68,221796.6,1759826.28
291990,202202,137,126,11,152712,13332,166044
291992,202202,176,89,87,107868,105444,213312
291995,202202,186,116,70,140592,84840,225432
292000,202202,408,301,107,364812,129684,494496
292010,202202,323,222,101,269064,123624,392688
292020,202202,297,219,78,265428,95748,361176
292030,202202,145,110,35,133320,42420,175740
292040,202202,589,307,282,372084,341784,713868
292045,202202,117,105,12,127260,14544,141804
292050,202202,926,671,255,813252,310272.6,1123524.6
292060,202202,879,711,168,861733.44,203616,1065349.44
292070,202202,66,25,41,30300,49692,79992
292080,202202,150,104,46,126048,55752,181800
292090,202202,536,186,350,225432,425412,650844
292100,202202,1510,653,857,791436.6,1039896,1831332.6
292105,202202,177,159,18,192708,21816,214524
292110,202202,2256,827,1429,1003536,1734372,2737908
292120,202202,687,527,160,638724,193920,832644
292130,202202,467,259,208,313908,252096,566004
292140,202202,214,172,42,210888,50904,261792
292145,202202,162,83,79,100596,95748,196344
292150,202202,1494,1233,261,1494396.6,316332,1810728.6
292160,202202,159,126,33,152712,39996,192708
292170,202202,1183,1013,170,1228968.6,206040,1435008.6
292180,202202,222,163,59,197556,71508,269064
292190,202202,152,98,54,118776,65448,184224
292200,202202,1401,512,889,620544,1078680.6,1699224.6
292205,202202,114,96,18,116352,21816,138168
292210,202202,384,259,125,313908,151500,465408
292220,202202,33,21,12,25452,14544,39996
292225,202202,45,37,8,44844,10908,55752
292230,202202,979,743,236,900516,287244,1187760
292240,202202,625,448,177,544188.8,214524,758712.8
292250,202202,1638,1070,568,1296840.23,688416,1985256.23
292260,202202,406,244,162,295728,196344,492072
292265,202202,249,184,65,223008,78780,301788
292270,202202,720,343,377,415716,456924,872640
292273,202202,205,119,86,144228,104232,248460
292275,202202,170,86,84,104232,101808,206040
292280,202202,145,100,45,121200,54540,175740
292285,202202,87,68,19,82416,23028,105444
292290,202202,583,385,198,466620,239976,706596
292300,202202,1771,672,1099,814464,1331988,2146452
292303,202202,129,84,45,101808,54540,156348
292305,202202,117,87,30,105444,36360,141804
292310,202202,967,631,336,765984.8,407232.64,1173217.44
292320,202202,580,432,148,523584,179376,702960
292330,202202,179,111,68,134532,82416,216948
292335,202202,293,233,60,282396,72720,355116
292340,202202,557,386,171,467832,209676,677508
292350,202202,269,145,124,175740,150288,326028
292360,202202,708,534,174,649632.64,210888,860520.64
292370,202202,726,549,177,665388,214524,879912
292380,202202,617,508,109,615696.76,132108,747804.76
292390,202202,393,158,235,191496,284820,476316
292400,202202,3618,2237,1381,2711246.66,1676196.4,4387443.06
292405,202202,271,184,87,223008,105444,328452
292410,202202,119,73,46,88476,55752,144228
292420,202202,285,245,40,296940,48480,345420
292430,202202,543,396,147,479952,179376,659328
292440,202202,630,528,102,639936.92,123624,763560.92
292450,202202,235,180,55,218160,66660,284820
292460,202202,520,388,132,470257.12,161196,631453.12
292465,202202,204,174,30,210888,36360,247248
292467,202202,149,95,54,115140,65448,180588
292470,202202,305,209,96,254520.2,116352,370872.2
292480,202202,393,264,129,319968,156348.6,476316.6
292490,202202,240,176,64,213312,77568,290880
292500,202202,872,398,474,483588.09,574488,1058076.09
292510,202202,3566,1676,1890,2036160.96,2290681,4326841.96
292520,202202,1106,512,594,620544,719928,1340472
292525,202202,420,302,118,366024.4,143016,509040.4
292530,202202,4695,1857,2838,2250684.65,3442081.2,5692765.85
292540,202202,487,278,209,336936,253308,590244
292550,202202,1117,600,517,728412,627816,1356228
292560,202202,322,298,24,361176,29088,390264
292570,202202,317,244,73,295728,88476,384204
292575,202202,533,368,165,446016,199980,645996
292580,202202,995,665,330,805980,399960.6,1205940.6
292590,202202,555,490,65,593880,78780,672660
292593,202202,141,110,31,133320,37572,170892
292595,202202,202,161,41,195132,49692,244824
292600,202202,1245,894,351,1083528.95,425412,1508940.95
292610,202202,114,92,22,111504,26664,138168
292620,202202,528,444,84,538128,101808,639936
292630,202202,1506,823,683,997476.6,829008,1826484.6
292640,202202,878,605,273,733260,330876,1064136
292650,202202,182,146,36,176952.78,43632,220584.78
292660,202202,1934,1366,568,1658016,688416.36,2346432.36
292665,202202,137,96,41,116352,49692,166044
292670,202202,389,305,84,369660,101808,471468
292680,202202,268,197,71,238764,86052,324816
292690,202202,204,143,61,173316.6,73932,247248.6
292700,202202,998,649,349,787800,422988,1210788
292710,202202,111,97,14,117564,16968,134532
292720,202202,960,550,410,666600.6,496920,1163520.6
292730,202202,202,97,105,117564,127260,244824
292740,202202,71421,34250,37171,41532835.54,45091259.21,86624094.75
292750,202202,381,277,104,335724.32,126048,461772.32
292760,202202,332,277,55,335724.72,66660,402384.72
292770,202202,852,364,488,441168,592668,1033836
292780,202202,17,7,10,8484,12120,20604
292790,202202,783,409,374,495708,454500,950208
292800,202202,1256,744,512,902940,620544,1523484
292805,202202,387,130,257,157560,311484,469044
292810,202202,1793,1068,725,1294417.8,882336,2176753.8
292820,202202,698,590,108,716292,130896,847188
292830,202202,123,97,26,117564,31512,149076
292840,202202,692,565,127,684780.4,153924,838704.4
292850,202202,137,90,47,109080,56964,166044
292860,202202,2097,1204,893,1459248.6,1082316.4,2541565.0
292870,202202,3623,2368,1255,2871228.52,1522272,4393500.52
292880,202202,1423,942,481,1141704.08,585396,1727100.08
292890,202202,525,438,87,530856,105444,636300
292895,202202,147,99,48,119988,58176,178164
292900,202202,345,245,100,296940,121200,418140
292905,202202,485,233,252,282396,305424,587820
292910,202202,469,350,119,424200.2,144228,568428.2
292920,202202,531,228,303,276336,367236,643572
292925,202202,473,434,39,526008,47268,573276
292930,202202,655,394,261,477528,318756,796284
292935,202202,274,115,159,139380,192708,332088
292937,202202,226,156,70,189072,84840,273912
292940,202202,186,142,44,172104,53328,225432
292950,202202,1234,598,636,724777.6,770832.6,1495610.2
292960,202202,520,367,153,444804,185436,630240
292970,202202,234,172,62,208465.16,75144,283609.16
292975,202202,91,53,38,64236,46056.4,110292.4
292980,202202,320,220,100,266640.1,122412,389052.1
292990,202202,1313,976,337,1182912.2,408444,1591356.2
293000,202202,112,78,34,94536,41208,135744
293010,202202,2937,1724,1213,2090701.2,1471368.6,3562069.8
293015,202202,606,495,111,599940,135744,735684
293020,202202,321,260,61,315120,73932.4,389052.4
293030,202202,577,509,68,616908.2,82416,699324.2
293040,202202,366,293,73,355116,88476,443592
293050,202202,2927,1720,1207,2087064.6,1462886.2,3549950.8
293060,202202,251,197,54,238764.44,65448,304212.44
293070,202202,3646,1828,1818,2215537.2,2205840.8,4421378.0
293075,202202,95,65,30,78780,36360,115140
293076,202202,75,56,19,68074,23028,91102
293077,202202,571,323,248,391476.6,301788,693264.6
293080,202202,421,375,46,454500.96,55752,510252.96
293090,202202,129,116,13,140592,15756,156348
293100,202202,524,357,167,432684,202404,635088
293105,202202,350,254,96,307848,116352,424200
293110,202202,119,80,39,96960,47268,144228
293120,202202,298,205,93,248460,112716,361176
293130,202202,243,162,81,196344,98172,294516
293135,202202,8228,3197,5031,3878402.8,6107271.8,9985674.6
293140,202202,192,115,77,139380.4,93324,232704.4
293150,202202,303,264,39,319968,47268,367236
293160,202202,426,262,164,317544,198768,516312
293170,202202,202,128,74,155136,89688,244824
293180,202202,570,387,183,469044.6,221796.6,690841.2
293190,202202,1356,933,423,1132009.36,512676.6,1644685.96
293200,202202,543,478,65,579336,78780,658116
293210,202202,417,321,96,390264,116352,506616
293220,202202,2388,1031,1357,1250784,1645936.4,2896720.4
293230,202202,1831,685,1146,830220.05,1388952,2219172.05
293240,202202,228,209,19,253308,23028,276336
293245,202202,125,103,22,124836,26664,151500
293250,202202,772,315,457,382992,553884,936876
293260,202202,300,246,54,298152,66660,364812
293270,202202,1163,524,639,636300.4,774468,1410768.4
293280,202202,302,178,124,215736,150288,366024
293290,202202,3014,1956,1058,2371884,1282296.6,3654180.6
293300,202202,788,553,235,671448.8,284820,956268.8
293305,202202,193,149,44,180588,53328,233916
293310,202202,164,123,41,149076,49692,198768
293315,202202,163,128,35,155136,42420,197556
293317,202202,87,64,23,77568,27876,105444
293320,202202,1086,584,502,707808.8,608424.6,1316233.4
293325,202202,198,75,123,90900,149076,239976
293330,202202,14142,6414,7728,7777408.38,9369976.15,17147384.53
293340,202202,291,206,85,249672,104232,353904
293345,202202,260,209,51,253308,61812,315120
293350,202202,590,358,232,433896,281184,715080
293360,202202,1500,1070,430,1296840,521160,1818000
310010,202202,141,74,67,89688,81204,170892
310020,202202,1004,547,457,664176,555096,1219272
310030,202202,309,247,62,299364,75144,374508
310040,202202,46,29,17,35148,20604,55752
310050,202202,154,97,57,117564,69084,186648
310060,202202,264,181,83,219372,100596,319968
310070,202202,14,8,6,9696,7272,16968
310080,202202,43,28,15,33936,18180,52116
310090,202202,1054,569,485,689631.36,587820.6,1277451.96
310100,202202,313,222,91,269064,110292,379356
310110,202202,682,365,317,442380,384204,826584
310120,202202,376,218,158,264216,191496,455712
310130,202202,30,17,13,20604,15756,36360
310140,202202,23,8,15,9696,18180,27876
310150,202202,1147,767,380,930817,461773.2,1392590.2
310160,202202,2033,992,1041,1202305.36,1265328.6,2467633.96
310163,202202,90,48,42,58176,50904,109080
310170,202202,2488,1129,1359,1369560,1651960.2,3021520.2
310180,202202,159,61,98,73932.6,118776,192708.6
310190,202202,474,321,153,389052,185436,574488
310200,202202,441,279,162,339360,197556,536916
310205,202202,69,46,23,55752,27876,83628
310210,202202,264,216,48,261792,58176,319968
310220,202202,58,33,25,39996,30300,70296
310230,202202,271,193,78,233916,95748,329664
310240,202202,108,91,17,110292,20604,130896
310250,202202,96,75,21,90900,25452,116352
310260,202202,713,372,341,450864.36,413292,864156.36
310270,202202,266,172,94,208464.36,113928,322392.36
310280,202202,380,274,106,333300,128472,461772
310285,202202,198,149,49,180588,59388,239976
310290,202202,229,127,102,153924,123624,277548
310300,202202,167,135,32,163620,38784,202404
310310,202202,10,7,3,8484,3636,12120
310320,202202,30,10,20,12120,24240,36360
310330,202202,39,26,13,31512,15756,47268
310340,202202,1838,1251,587,1518638,715080.6,2233718.6
310350,202202,2729,1435,1294,1740432.6,1571964,3312396.6
310360,202202,47,39,8,47268,9696,56964
310370,202202,125,106,19,128472,23028,151500
310375,202202,108,40,68,48480,82416,130896
310380,202202,51,30,21,36360,25452,61812
310390,202202,105,67,38,81204,46056,127260
310400,202202,2396,1549,847,1881025,1026564,2907589
310410,202202,117,66,51,79992,61812,141804
310420,202202,645,327,318,396324,385418,781742
310430,202202,275,170,105,206040,127260,333300
310440,202202,71,40,31,48480,37572,86052
310445,202202,79,66,13,79992,15756,95748
310450,202202,634,411,223,498132,270276,768408
310460,202202,245,170,75,206040,90900,296940
310470,202202,515,333,182,403596,220584,624180
310480,202202,88,54,34,65448,41208,106656
310490,202202,537,250,287,303000,347844,650844
310500,202202,123,47,76,56964,93324,150288
310510,202202,594,418,176,509040,213312,722352
310520,202202,138,99,39,119988,47268,167256
310530,202202,104,40,64,48480,77568,126048
310540,202202,462,260,202,315120.4,244824,559944.4
310550,202202,69,47,22,56964,26664,83628
310560,202202,3018,2054,964,2496722,1168368,3665090
310570,202202,105,65,40,78780,48480,127260
310590,202202,366,226,140,273912.4,169680,443592.4
310600,202202,141,71,70,86052.6,84840,170892.6
310610,202202,53,21,32,25452,38784,64236
310620,202202,47224,22085,25139,26787556.2,30498795.37,57286351.57
310630,202202,684,410,274,496920.4,332088,829008.4
310640,202202,132,94,38,113928,46056,159984
310650,202202,147,131,16,158772,19392,178164
310660,202202,108,75,33,90900,39996,130896
310665,202202,64,46,18,55752,21816,77568
310670,202202,6963,2976,3987,3610553,4833456.6,8444009.6
310680,202202,70,41,29,49692,35148,84840
310690,202202,614,428,186,519948.4,225432,745380.4
310700,202202,62,38,24,46056,29088,75144
310710,202202,1271,858,413,1041453.42,500556.6,1542010.02
310720,202202,146,39,107,47268,129684,176952
310730,202202,1500,1021,479,1238664.6,581760,1820424.6
310740,202202,986,545,441,660541.2,534492.6,1195033.8
310750,202202,249,155,94,187860.04,113928,301788.04
310760,202202,66,53,13,64236,15756,79992
310770,202202,89,44,45,53328,54540,107868
310780,202202,350,285,65,346632.6,78780,425412.6
310790,202202,107,86,21,104232,26664,130896
310800,202202,465,218,247,264216,299364,563580
310810,202202,171,117,54,141804.72,65448,207252.72
310820,202202,318,256,62,310272,75144,385416
310825,202202,207,174,33,210888,39996,250884
310830,202202,454,213,241,259368.6,294516,553884.6
310840,202202,360,210,150,255732,181800,437532
310850,202202,78,64,14,77568,16968,94536
310855,202202,403,315,88,381780,106656,488436
310860,202202,1585,1166,419,1413193.2,509040.8,1922234.0
310870,202202,49,41,8,49692,9696,59388
310880,202202,84,69,15,83628,18180,101808
310890,202202,292,167,125,202404,151500,353904
310900,202202,613,270,343,327245.44,415725.36,742970.80
310910,202202,240,162,78,196345.4,94536,290881.4
310920,202202,432,251,181,304212.72,219372.2,523584.92
310925,202202,34,26,8,31512,9696,41208
310930,202202,1271,829,442,1004748,538128,1542876
310940,202202,676,340,336,412080,407232,819312
310945,202202,126,78,48,94536,58176,152712
310950,202202,220,178,42,215736,50904,266640
310960,202202,76,24,52,29088,63024,92112
310970,202202,163,97,66,117564,79992.6,197556.6
310980,202202,46,31,15,37572,18180,55752
310990,202202,164,86,78,104232.6,94536,198768.6
311000,202202,805,383,422,464197.09,511464.6,975661.69
311010,202202,47,39,8,47268,9696,56964
311020,202202,41,24,17,29088,20604,49692
311030,202202,381,215,166,260580,201192,461772
311040,202202,40,31,9,37572,10908,48480
311050,202202,486,182,304,220584,369660,590244
311060,202202,789,435,354,527220,429049.2,956269.2
311070,202202,326,143,183,173316,221796,395112
311080,202202,105,61,44,73932,53328,127260
311090,202202,333,158,175,191496,212100,403596
311100,202202,547,323,224,392688,271488,664176
311110,202202,699,499,200,604788.6,243612.7,848401.3
311115,202202,74,51,23,63024,27876,90900
311120,202202,1053,566,487,687204.6,590244,1277448.6
311130,202202,293,172,121,208464,146652,355116
311140,202202,163,87,76,105444,92112,197556
311150,202202,343,214,129,260580,156348.6,416928.6
311160,202202,745,530,215,643573.2,260580,904153.2
311170,202202,88,72,16,87264,19392,106656
311180,202202,303,201,102,243612,123624.6,367236.6
311190,202202,37,16,21,19392,26664,46056
311200,202202,341,234,107,284820,129684,414504
311205,202202,34,25,9,30300,10908,41208
311210,202202,37,32,5,38784.6,6060,44844.6
311220,202202,31,27,4,32724,4848,37572
311230,202202,1643,1073,570,1300477,693264,1993741
311240,202202,201,124,77,151500,93324,244824
311250,202202,59,21,38,25452,46056,71508
311260,202202,545,340,205,412080,248460,660540
311265,202202,126,84,42,101808,50904,152712
311270,202202,285,198,87,239976,105444,345420
311280,202202,193,83,110,100596,133320,233916
311290,202202,101,82,19,99384,23028,122412
311300,202202,578,371,207,449652.6,250884,700536.6
311310,202202,18,15,3,18180,3636,21816
311320,202202,621,460,161,558732,195132,753864
311330,202202,1107,811,296,984144,358752.2,1342896.2
311340,202202,2592,1826,766,2214325.2,928392,3142717.2
311350,202202,266,206,60,249672,72720,322392
311360,202202,179,105,74,127260,89688,216948
311370,202202,1226,504,722,610848,876276,1487124
311380,202202,7,6,1,7272,1212,8484
311390,202202,246,137,109,166044,132108,298152
311400,202202,137,84,53,101808,64236,166044
311410,202202,112,54,58,65448,70296,135744
311420,202202,307,161,146,195132.4,176952,372084.4
311430,202202,822,547,275,662964,333300,996264
311440,202202,449,306,143,370872,174528,545400
311450,202202,292,174,118,212100,144228,356328
311455,202202,259,177,82,214524,99384,313908
311460,202202,131,57,74,69084,89688,158772
311470,202202,30,15,15,18180,18180,36360
311480,202202,52,27,25,32724,30300,63024
311490,202202,10,6,4,7272,4848,12120
311500,202202,30,14,16,16968,19392,36360
311510,202202,645,440,205,533280.6,248460,781740.6
311520,202202,38,31,7,37572,8484,46056
311530,202202,1778,1284,494,1556209.92,599940,2156149.92
311535,202202,66,45,21,54540,25452,79992
311540,202202,33,29,4,35148,6060,41208
311545,202202,159,115,44,139380,53328,192708
311547,202202,43,33,10,39996,12120,52116
311550,202202,638,281,357,341784,432684,774468
311560,202202,43,26,17,31512,20604,52116
311570,202202,281,188,93,227856,112716,340572
311580,202202,391,240,151,292092,183012,475104
311590,202202,28,24,4,29088,4848,33936
311600,202202,95,78,17,94536,20604,115140
311610,202202,248,209,39,253308,47268,300576
311615,202202,123,100,23,121200,27876,149076
311620,202202,27,15,12,18180,14544,32724
311630,202202,92,78,14,94536,16968,111504
311640,202202,140,67,73,81204.6,88476,169680.6
311650,202202,126,86,40,104232,48480,152712
311660,202202,420,198,222,239976,269064,509040
311670,202202,143,97,46,117564.8,55752,173316.8
311680,202202,209,159,50,192708,60600,253308
311690,202202,13,11,2,13332,2424,15756
311700,202202,191,139,52,168468,64236,232704
311710,202202,181,122,59,147864,71508,219372
311720,202202,39,28,11,33936.6,13332,47268.6
311730,202202,560,386,174,467832,210888,678720
311740,202202,25,18,7,21816,8484,30300
311750,202202,721,487,234,590245.4,283608,873853.4
311760,202202,75,33,42,39996,50904,90900
311770,202202,377,178,199,215736.6,241188,456924.6
311780,202202,187,92,95,111504.6,115140,226644.6
311783,202202,86,79,7,95748,8484,104232
311787,202202,38,13,25,15756,30300,46056
311790,202202,270,115,155,139380,187860,327240
311800,202202,682,429,253,519948,306636,826584
311810,202202,50,39,11,47268,13332,60600
311820,202202,122,96,26,116352,31512,147864
311830,202202,1882,1139,743,1380468,901728,2282196
311840,202202,1020,565,455,684780.6,552672.6,1237453.2
311850,202202,15,11,4,13332,4848,18180
311860,202202,9645,4086,5559,4954657.6,6744782.4,11699440.0
311870,202202,112,63,49,76356,59388,135744
311880,202202,955,692,263,839916,318756,1158672
311890,202202,197,92,105,112616,127260,239876
311900,202202,65,28,37,33936,44844,78780
311910,202202,1359,842,517,1020504.6,627817.2,1648321.8
311920,202202,222,147,75,178164,90900,269064
311930,202202,893,502,391,608424.6,475104,1083528.6
311940,202202,2572,1364,1208,1653171.28,1466520,3119691.28
311950,202202,67,45,22,54540,26664,81204
311960,202202,62,44,18,53328,23028,76356
311970,202202,22,12,10,14544,12120,26664
311980,202202,41,31,10,37572,12120,49692
311990,202202,36,26,10,31512,12120,43632
311995,202202,46,26,20,31512,24240,55752
312000,202202,21,14,7,16968,8484,25452
312010,202202,73,57,16,69084,19392,88476
312015,202202,74,58,16,70296,19392,89688
312020,202202,133,94,39,113928,47268,161196
312030,202202,67,50,17,60600,20604,81204
312040,202202,78,48,30,58176,36360,94536
312050,202202,196,110,86,133320.6,104232,237552.6
312060,202202,23,14,9,16968,10908,27876
312070,202202,76,49,27,59388,32724,92112
312080,202202,542,246,296,298152,358752,656904
312083,202202,60,37,23,44844,27876,72720
312087,202202,94,71,23,86052,27876,113928
312090,202202,3267,1973,1294,2394914.6,1570753.2,3965667.8
312100,202202,143,100,43,120921.24,52116,173037.24
312110,202202,111,67,44,81204,53328,134532
312120,202202,123,91,32,110292.95,38784,149076.95
312125,202202,82,49,33,59388,39996,99384
312130,202202,134,89,45,107868,54540,162408
312140,202202,139,109,30,132108.6,36360,168468.6
312150,202202,40,32,8,38784,9696,48480
312160,202202,1474,964,510,1169690,618120,1787810
312170,202202,11,8,3,9696,3636,13332
312180,202202,100,66,34,79992,41208,121200
312190,202202,38,34,4,41208,4848,46056
312200,202202,734,630,104,763561.2,126048,889609.2
312210,202202,121,63,58,76356,70296,146652
312220,202202,130,98,32,118776,38784,157560
312230,202202,3695,1681,2014,2038584.84,2448241.8,4486826.64
312235,202202,152,102,50,123624,60600,184224
312240,202202,79,55,24,66660,29088,95748
312245,202202,197,136,61,164832,73932,238764
312247,202202,82,60,22,72720,26664,99384
312250,202202,173,86,87,104232,105444,209676
312260,202202,98,65,33,78780,39996,118776
312270,202202,136,81,55,98172,66660,164832
312280,202202,32,16,16,19392,19392,38784
312290,202202,140,95,45,115140,54540,169680
312300,202202,196,128,68,155136,82416,237552
312310,202202,60,53,7,64236,8484,72720
312320,202202,412,256,156,312696,189072.8,501768.8
312330,202202,89,73,16,88476,19392,107868
312340,202202,33,16,17,19392,20604,39996
312350,202202,12,6,6,7272,7272,14544
312352,202202,98,70,28,84840,33936,118776
312360,202202,565,241,324,292092,392688,684780
312370,202202,331,186,145,226644,175740,402384
312380,202202,142,94,48,113928,58176,172104
312385,202202,154,126,28,152712.6,33936,186648.6
312390,202202,295,189,106,230280,128472.2,358752.2
312400,202202,376,281,95,340572,115141.2,455713.2
312410,202202,1121,379,742,459348.6,900516.6,1359865.2
312420,202202,648,487,161,590244.6,196344,786588.6
312430,202202,879,631,248,764772.02,300576,1065348.02
312440,202202,38,30,8,36360,9696,46056
312450,202202,189,121,68,146652,82416,229068
312460,202202,28,13,15,15756,18180,33936
312470,202202,46,31,15,37572,18180,55752
312480,202202,163,99,64,119988,77568,197556
312490,202202,286,194,92,235128,111504,346632
312500,202202,35,22,13,26664.6,15756,42420.6
312510,202202,566,212,354,256944,429048,685992
312520,202202,29,9,20,10908,24240,35148
312530,202202,36,26,10,31512,12120,43632
312540,202202,88,79,9,95748,10908,106656
312550,202202,35,28,7,33936,8484,42420
312560,202202,194,153,41,185436,49692,235128
312570,202202,442,261,181,316332,219372,535704
312580,202202,94,49,45,59388,54540,113928
312590,202202,228,181,47,219372,58176,277548
312595,202202,129,107,22,129684,26664,156348
312600,202202,70,33,37,39996.4,44844,84840.4
312610,202202,1534,797,737,967180,894456.6,1861636.6
312620,202202,226,162,64,197556,77568,275124
312630,202202,69,57,12,69084,14544,83628
312640,202202,40,10,30,12120,36360,48480
312650,202202,149,125,24,151909.04,29088,180997.04
312660,202202,100,73,27,88476.81,32724,121200.81
312670,202202,925,593,332,718716,402384,1121100
312675,202202,38,29,9,35148,10908,46056
312680,202202,68,42,26,50904,31512,82416
312690,202202,232,114,118,138168,143016,281184
312695,202202,26,22,4,26664,4848,31512
312700,202202,238,138,100,167256,121200,288456
312705,202202,82,65,17,78780,20604,99384
312707,202202,134,95,39,115140,47268,162408
312710,202202,1866,1024,842,1242301.08,1020504,2262805.08
312720,202202,48,24,24,29088,29088,58176
312730,202202,265,156,109,189072,132108,321180
312733,202202,47,36,11,43632,13332,56964
312735,202202,22,15,7,18180,8484,26664
312737,202202,70,38,32,46056,38784,84840
312738,202202,67,43,24,52116,29088,81204
312740,202202,79,53,26,64236,31512,95748
312750,202202,96,64,32,77568,38784,116352
312760,202202,277,193,84,233916,101808,335724
312770,202202,8514,3969,4545,4814068.98,5518236.6,10332305.58
312780,202202,442,337,105,409656,127260,536916
312790,202202,20,15,5,18180,6060,24240
312800,202202,1585,1102,483,1335625.2,585396.24,1921021.44
312810,202202,338,229,109,277548,132108,409656
312820,202202,185,142,43,172104,52116,224220
312825,202202,37,27,10,32724,12120,44844
312830,202202,200,113,87,136956,105444,242400
312840,202202,179,118,61,143016,73932,216948
312850,202202,40,36,4,43632,4848,48480
312860,202202,140,92,48,111504,58176,169680
312870,202202,1093,568,525,689628.6,636300,1325928.6
312880,202202,114,81,33,98172,39996,138168
312890,202202,165,117,48,141804,58176,199980
312900,202202,177,132,45,161196,54540,215736
312910,202202,179,101,78,122412,94536,216948
312920,202202,127,69,58,83628,70296,153924
312930,202202,324,224,100,271488,121200,392688
312940,202202,124,86,38,104232,46056,150288
312950,202202,694,472,222,572064.6,269064,841128.6
312960,202202,150,110,40,133320.64,48480,181800.64
312965,202202,106,83,23,100596,27876,128472
312970,202202,271,225,46,272700,55752,328452
312980,202202,2562,1300,1262,1575602.2,1529544,3105146.2
312990,202202,51,25,26,30300,31512,61812
313000,202202,51,29,22,35148,26664,61812
313005,202202,174,134,40,162408,48480,210888
313010,202202,937,391,546,473892.6,662964.6,1136857.2
313020,202202,192,98,94,118776,115140,233916
313030,202202,193,129,64,156348.76,78780,235128.76
313040,202202,82,25,57,30300,70296,100596
313050,202202,194,140,54,169680,65448,235128
313055,202202,42,33,9,39996,10908,50904
313060,202202,136,90,46,109080,55752,164832
313065,202202,62,45,17,54540,20604.6,75144.6
313070,202202,130,69,61,83628,73932,157560
313080,202202,38,18,20,21816,24240,46056
313090,202202,673,433,240,524796,290880,815676
313100,202202,200,71,129,86052,156348,242400
313110,202202,151,81,70,98172,84840,183012
313115,202202,215,117,98,141804,118776,260580
313120,202202,846,470,376,569640,456924,1026564
313130,202202,5889,3196,2693,3875980.92,3267553.4,7143534.32
313140,202202,130,74,56,89688,67872,157560
313150,202202,297,237,60,287244,72720,359964
313160,202202,183,137,46,166044.6,55752,221796.6
313170,202202,1358,877,481,1064137.8,584184,1648321.8
313180,202202,311,186,125,225432.6,151500,376932.6
313190,202202,723,423,300,512676.6,363600,876276.6
313200,202202,30,25,5,30300,6060,36360
313210,202202,1001,851,150,1032626.28,181800.6,1214426.88
313220,202202,299,174,125,210888,151500,362388
313230,202202,260,198,62,239976.1,75144,315120.1
313240,202202,2184,1090,1094,1321084.2,1330776.6,2651860.8
313250,202202,1242,941,301,1140492.6,364813.28,1505305.88
313260,202202,90,43,47,52116,56964,109080
313270,202202,1001,586,415,711444.8,505405.8,1216850.6
313280,202202,45,38,7,46056,8484,54540
313290,202202,213,172,41,208464,49692,258156
313300,202202,322,164,158,198768,191496,390264
313310,202202,241,109,132,132108,161196,293304
313320,202202,387,282,105,341784.4,127260,469044.4
313330,202202,1407,860,547,1042320.8,662964,1705284.8
313340,202202,327,234,93,283608,112716,396324
313350,202202,460,296,164,358752,202404,561156
313360,202202,167,78,89,94536,110292,204828
313370,202202,226,79,147,95748,178164,273912
313375,202202,299,175,124,213312,150288,363600
313380,202202,1319,706,613,855672.8,744168,1599840.8
313390,202202,50,47,3,56964,3636,60600
313400,202202,396,272,124,329664.8,151501.2,481166.0
313410,202202,35,16,19,19392,23028,42420
313420,202202,4538,2489,2049,3019093.6,2485813.8,5504907.4
313430,202202,129,64,65,77568,78780,156348
313440,202202,1367,962,405,1167159.49,490861.8,1658021.29
313450,202202,68,34,34,41208,41208,82416
313460,202202,386,162,224,196344,271488,467832
313470,202202,524,243,281,294516,340572.6,635088.6
313480,202202,149,110,39,133320.6,47268,180588.6
313490,202202,543,243,300,294516.6,364812.6,659329.2
313500,202202,29,16,13,19392,15756,35148
313505,202202,1056,816,240,991416,290880,1282296
313507,202202,94,58,36,70296,43632,113928
313510,202202,2847,1777,1070,2156279.62,1298052,3454331.62
313520,202202,3418,2662,756,3226348.17,916272,4142620.17
313530,202202,31,19,12,23028,14544,37572
313535,202202,76,60,16,72720,19392,92112
313540,202202,67,49,18,59388,21816,81204
313545,202202,109,93,16,112716,19392,132108
313550,202202,213,178,35,215736,42420.6,258156.6
313560,202202,338,159,179,192708,216948,409656
313570,202202,69,22,47,26664,56964,83628
313580,202202,1300,740,560,898092.6,678720.6,1576813.2
313590,202202,66,38,28,46056,33936,79992
313600,202202,668,398,270,482376,327240,809616
313610,202202,49,41,8,50904,9696,60600
313620,202202,1351,654,697,796285.2,849612.76,1645897.96
313630,202202,1596,1210,386,1466521.2,469044,1935565.2
313640,202202,115,70,45,84840,54540,139380
313650,202202,225,107,118,129684,144228,273912
313652,202202,25,24,1,29088,1212,30300
313655,202202,77,49,28,59388,33936,93324
313657,202202,48,44,4,53328,4848,58176
313660,202202,128,82,46,99384,55752,155136
313665,202202,663,305,358,369660.2,433896,803556.2
313670,202202,10286,7027,3259,8521580.06,3953544,12475124.06
313680,202202,41,31,10,37572,12120,49692
313690,202202,130,94,36,113928,43632,157560
313695,202202,75,57,18,69084,21816,90900
313700,202202,329,261,68,317544.6,82416,399960.6
313710,202202,127,94,33,113928,39996,153924
313720,202202,1146,520,626,630241.2,758713,1388954.2
313730,202202,71,43,28,52116,33936,86052
313740,202202,143,111,32,134532,38784,173316
313750,202202,410,289,121,350268,146652,496920
313753,202202,225,165,60,199980,72720,272700
313760,202202,1341,500,841,607212,1020504.38,1627716.38
313770,202202,401,277,124,335724.6,150288,486012.6
313780,202202,806,425,381,515100,461772,976872
313790,202202,30,29,1,35148,1212,36360
313800,202202,156,93,63,112716,76356.6,189072.6
313810,202202,83,48,35,58176,42420,100596
313820,202202,1320,624,696,756289.8,844764.6,1601054.4
313830,202202,53,37,16,44844,19392,64236
313835,202202,61,52,9,63024,12120,75144
313840,202202,1651,979,672,1187761.6,816888,2004649.6
313850,202202,212,88,124,106656,150288,256944
313860,202202,454,347,107,420565.2,129684,550249.2
313862,202202,176,120,56,145440,67872,213312
313865,202202,145,97,48,117564,58176,175740
313867,202202,55,44,11,54540,13332,67872
313868,202202,41,25,16,30300,19392,49692
313870,202202,95,52,43,63024,52116,115140
313880,202202,376,235,141,284820,172104,456924
313890,202202,328,173,155,209676.4,187860,397536.4
313900,202202,816,431,385,522372,466620.6,988992.6
313910,202202,143,97,46,117564,55752,173316
313920,202202,623,430,193,522372,233917.02,756289.02
313925,202202,35,30,5,36360,6060,42420
313930,202202,878,677,201,820524,243612,1064136
313940,202202,1887,1149,738,1392588,896880,2289468
313950,202202,852,523,329,633876.2,398748,1032624.2
313960,202202,1437,819,618,992628.6,750230.2,1742858.8
313970,202202,179,106,73,128472,88476,216948
313980,202202,211,138,73,168468,88476,256944
313990,202202,244,158,86,191496,104232,295728
314000,202202,872,577,295,699324.56,358752,1058076.56
314010,202202,88,51,37,61812,44844,106656
314015,202202,74,19,55,23028,66660,89688
314020,202202,59,40,19,48480,23028,71508
314030,202202,71,34,37,41208,44844,86052
314040,202202,43,23,20,27876,24240,52116
314050,202202,288,168,120,203616.8,145440,349056.8
314053,202202,98,60,38,72720,46056,118776
314055,202202,290,180,110,218160,133320,351480
314060,202202,126,110,16,133320.5,19392,152712.5
314070,202202,1048,517,531,626604,643572,1270176
314080,202202,210,132,78,159984,94536.84,254520.84
314085,202202,165,115,50,139380,60600,199980
314090,202202,377,266,111,322393.2,134532,456925.2
314100,202202,523,413,110,500556.2,133320,633876.2
314110,202202,763,352,411,426624,499344.6,925968.6
314120,202202,69,40,29,48480,35148,83628
314130,202202,23,15,8,18180,9696,27876
314140,202202,1110,687,423,833856.8,513888,1347744.8
314150,202202,193,124,69,151500,83628,235128
314160,202202,322,240,82,292092.4,99384,391476.4
314170,202202,84,64,20,77568,24240,101808
314180,202202,729,639,90,775681.2,109080,884761.2
314190,202202,90,55,35,66660,42420,109080
314200,202202,487,328,159,397536.4,193920,591456.4
314210,202202,254,193,61,233916,73932.6,307848.6
314220,202202,305,215,90,260580.6,109080,369660.6
314225,202202,57,38,19,46056,23028,69084
314230,202202,115,51,64,61812,77568,139380
314240,202202,164,117,47,141804,56964,198768
314250,202202,58,35,23,42420,27876,70296
314260,202202,223,110,113,133320,136956,270276
314270,202202,398,308,90,374508,109080,483588
314280,202202,726,389,337,471414.06,408444,879858.06
314290,202202,523,412,111,499344,135744,635088
314300,202202,339,255,84,309060,103020,412080
314310,202202,1316,906,410,1098375.84,496920,1595295.84
314315,202202,36,26,10,31512,12120,43632
314320,202202,569,383,186,465408.6,225432,690840.6
314330,202202,11409,5560,5849,6744783.4,7096261.8,13841045.2
314340,202202,607,269,338,326028,409657.2,735685.2
314345,202202,58,42,16,50904,19392,70296
314350,202202,172,108,64,130896,77568,208464
314360,202202,54,29,25,35148,30300,65448
314370,202202,70,48,22,58176,26664,84840
314380,202202,107,64,43,77568,52116,129684
314390,202202,3309,2128,1181,2582773.56,1431372.4,4014145.96
314400,202202,677,477,200,578124.6,243612,821736.6
314410,202202,492,316,176,384204,213312,597516
314420,202202,16,8,8,9696,9696,19392
314430,202202,2425,885,1540,1072620.76,1871329.8,2943950.56
314435,202202,178,105,73,127260,88476,215736
314437,202202,37,26,11,31512,13332,44844
314440,202202,95,61,34,73932,41208,115140
314450,202202,161,110,51,133320,61812,195132
314460,202202,620,295,325,357540.6,397536.6,755077.2
314465,202202,100,61,39,73932,47268,121200
314467,202202,72,59,13,71508,15756,87264
314470,202202,400,200,200,242400.6,242400,484800.6
314480,202202,1029,460,569,557521.2,689628,1247149.2
314490,202202,38,22,16,27876,19392,47268
314500,202202,279,195,84,236340,103020,339360
314505,202202,104,67,37,81204,44844,126048
314510,202202,243,199,44,241188,53328,294516
314520,202202,1355,721,634,875068.8,768409.8,1643478.6
314530,202202,751,591,160,717504.4,193920,911424.4
314535,202202,166,100,66,121200,79992,201192
314537,202202,64,38,26,46056,31512,77568
314540,202202,19,12,7,14544,8484,23028
314545,202202,56,38,18,46056,21816,67872
314550,202202,70,38,32,46056,38784,84840
314560,202202,844,449,395,544188.6,478740,1022928.6
314570,202202,16,13,3,15756,3636,19392
314580,202202,13,5,8,6060,9696,15756
314585,202202,25,18,7,23028,8484,31512
314587,202202,81,70,11,84840,13332,98172
314590,202202,550,377,173,456924,209676,666600
314600,202202,926,591,335,717505.2,406020.6,1123525.8
314610,202202,939,483,456,585396.6,553884,1139280.6
314620,202202,138,103,35,124836,43632,168468
314625,202202,99,73,26,88476,31512,119988
314630,202202,1130,602,528,729624,641148,1370772
314640,202202,86,55,31,66660,37572.6,104232.6
314650,202202,163,92,71,111504,86052,197556
314655,202202,59,43,16,52116,19392,71508
314660,202202,16,12,4,14544,4848,19392
314670,202202,211,164,47,198768.6,56964,255732.6
314675,202202,208,124,84,150288,101808,252096
314690,202202,572,311,261,376932,316332,693264
314700,202202,2198,1166,1032,1413193.8,1250784,2663977.8
314710,202202,1765,994,771,1205941.4,934452,2140393.4
314720,202202,379,216,163,261792,197556,459348
314730,202202,507,269,238,326028.6,289668,615696.6
314740,202202,747,345,402,418140,487224,905364
314750,202202,19,15,4,18180,4848,23028
314760,202202,356,152,204,184224,247248,431472
314770,202202,103,70,33,84840,41208,126048
314780,202202,22,9,13,10908,15756,26664
314790,202202,2426,1519,907,1843453.54,1104132.6,2947586.14
314795,202202,58,49,9,59388,10908,70296
314800,202202,2907,1678,1229,2034950.61,1489548,3524498.61
314810,202202,1464,831,633,1007172,767196.4,1774368.4
314820,202202,108,62,46,75144,55752,130896
314830,202202,207,170,37,207252,44844,252096
314840,202202,85,47,38,56964,46056,103020
314850,202202,399,189,210,229068,254520,483588
314860,202202,651,500,151,606000,183012,789012
314870,202202,1573,806,767,976873.2,929604,1906477.2
314875,202202,54,50,4,60600,4848,65448
314880,202202,42,30,12,36360,14544,50904
314890,202202,50,27,23,32724,27876,60600
314900,202202,26,20,6,24240,7272,31512
314910,202202,230,149,81,180588,98172,278760
314915,202202,128,115,13,139380,15756,155136
314920,202202,85,55,30,66660,36360,103020
314930,202202,1016,485,531,587821.4,643572,1231393.4
314940,202202,40,31,9,37572,10908,48480
314950,202202,22,18,4,21816,4848,26664
314960,202202,23,17,6,20604,7272,27876
314970,202202,166,80,86,96960,104232,201192
314980,202202,297,187,110,226644,133320,359964
314990,202202,443,240,203,290880.4,246036,536916.4
314995,202202,150,66,84,79992,101808,181800
315000,202202,86,67,19,81204,23028,104232
315010,202202,34,22,12,26664,14544,41208
315015,202202,160,126,34,152712,41208,193920
315020,202202,68,57,11,69084,13332,82416
315030,202202,108,82,26,99384,31512,130896
315040,202202,81,49,32,59388,38784,98172
315050,202202,208,124,84,150288,101808,252096
315053,202202,51,35,16,42420,19392,61812
315057,202202,117,93,24,112716,29088,141804
315060,202202,68,57,11,69084.88,13332,82416.88
315070,202202,102,57,45,69084,54540,123624
315080,202202,382,301,81,364812,98172,462984
315090,202202,96,57,39,69084,47268,116352
315100,202202,77,38,39,46056,47268,93324
315110,202202,268,136,132,164832,159984,324816
315120,202202,1792,860,932,1042320,1133220.6,2175540.6
315130,202202,330,239,91,292092,110292,402384
315140,202202,530,295,235,357540,284820,642360
315150,202202,964,461,503,558732,610848,1169580
315160,202202,195,99,96,119988,116352,236340
315170,202202,295,197,98,238764.6,119988,358752.6
315180,202202,3182,1332,1850,1616809.8,2244625.4,3861435.2
315190,202202,294,179,115,216948.8,139380,356328.8
315200,202202,1188,708,480,858096.6,581760,1439856.6
315210,202202,1626,946,680,1148976.4,824161.4,1973137.8
315213,202202,27,15,12,18180,14544,32724
315217,202202,192,151,41,183012,50904,233916
315220,202202,1582,1172,410,1421677.52,496920,1918597.52
315230,202202,173,131,42,158772.6,50904,209676.6
315240,202202,385,249,136,301788,164832.6,466620.6
315250,202202,2569,1229,1340,1491972,1625293.4,3117265.4
315260,202202,132,71,61,86052,73932,159984
315270,202202,130,89,41,107868,49692,157560
315280,202202,604,400,204,486013.68,247248,733261.68
315290,202202,181,113,68,138168,82416,220584
315300,202202,95,72,23,87264.6,27876,115140.6
315310,202202,81,73,8,88476,9696,98172
315320,202202,141,85,56,103020,67872,170892
315330,202202,60,47,13,56964,15756,72720
315340,202202,386,282,104,341784,127260,469044
315350,202202,152,96,56,116352,67872,184224
315360,202202,94,42,52,50904,63024,113928
315370,202202,54,34,20,41208,24240,65448
315380,202202,5,5,0,6060,,6060.0
315390,202202,60,18,42,21816,50904.6,72720.6
315400,202202,784,582,202,706597.6,244824,951421.6
315410,202202,306,179,127,216948,153925.6,370873.6
315415,202202,53,40,13,48480,15756,64236
315420,202202,190,139,51,168468.6,61812,230280.6
315430,202202,649,364,285,442380.6,345420.4,787801.0
315440,202202,90,60,30,72720,36360,109080
315445,202202,216,180,36,218160,43632,261792
315450,202202,176,128,48,155136,58176,213312
315460,202202,4353,2018,2335,2447029.2,2831233.2,5278262.4
315470,202202,44,17,27,20604,32724,53328
315480,202202,73,20,53,24240,64236,88476
315490,202202,696,433,263,524796,318756,843552
315500,202202,15,11,4,13332,4848,18180
315510,202202,140,97,43,117564,52116,169680
315520,202202,79,67,12,81204,14544,95748
315530,202202,40,21,19,25452,23028,48480
315540,202202,264,185,79,224220,95748,319968
315550,202202,179,145,34,175740,42420,218160
315560,202202,712,563,149,682356.6,180588,862944.6
315570,202202,309,147,162,178165.24,196344.4,374509.64
315580,202202,727,495,232,599940,282396.6,882336.6
315590,202202,190,99,91,119988,110292,230280
315600,202202,319,247,72,299364.6,87264,386628.6
315610,202202,104,50,54,60600,65448,126048
315620,202202,37,29,8,35148,9696,44844
315630,202202,123,87,36,105444,43632,149076
315640,202202,66,40,26,48480,31512,79992
315645,202202,48,31,17,37572,20604,58176
315650,202202,166,122,44,147864,53328,201192
315660,202202,455,203,252,246036.6,305424,551460.6
315670,202202,2363,1096,1267,1329565.2,1539240,2868805.2
315680,202202,782,557,225,675084,272700,947784
315690,202202,676,453,223,550248,270276,820524
315700,202202,1955,1020,935,1237453.73,1133220,2370673.73
315710,202202,355,109,246,132108,298152,430260
315720,202202,485,293,192,355116,233916,589032
315725,202202,190,151,39,183012.6,47268,230280.6
315727,202202,60,32,28,38784,33936,72720
315730,202202,48,43,5,52116,6060,58176
315733,202202,86,54,32,65448,38784,104232
315737,202202,50,37,13,44844,16968,61812
315740,202202,34,26,8,31512,9696,41208
315750,202202,145,107,38,129684,46056,175740
315760,202202,39,30,9,36360,10908,47268
315765,202202,124,73,51,88476,61812,150288
315770,202202,218,137,81,166044.38,98172,264216.38
315780,202202,3742,1852,1890,2245836.8,2291892.63,4537729.43
315790,202202,245,188,57,227856,69084,296940
315800,202202,297,195,102,237552,124836,362388
315810,202202,59,36,23,43632,27876,71508
315820,202202,750,550,200,666602.4,242400,909002.4
315830,202202,117,73,44,88476,53328,141804
315840,202202,81,53,28,64236,33936,98172
315850,202202,262,180,82,218161.4,99384.6,317546.0
315860,202202,17,5,12,6060,14544,20604
315870,202202,41,32,9,38784,10908,49692
315880,202202,94,66,28,79992,33936,113928
315890,202202,105,77,28,93324,33936,127260
315895,202202,405,264,141,319968,170892,490860
315900,202202,78,37,41,44844,49692,94536
315910,202202,45,27,18,32724,21816,54540
315920,202202,152,101,51,122412,61812,184224
315930,202202,53,18,35,21816,42420,64236
315935,202202,117,94,23,113928.6,27876,141804.6
315940,202202,99,72,27,87264,32724,119988
315950,202202,28,21,7,25452,8484,33936
315960,202202,547,261,286,316332,347844.6,664176.6
315970,202202,30,23,7,29088,8484,37572
315980,202202,667,332,335,402384,406020,808404
315990,202202,257,146,111,176952,134532,311484
316000,202202,45,30,15,36360,18180,54540
316010,202202,83,70,13,84840,15756,100596
316020,202202,108,94,14,113928,16968,130896
316030,202202,371,208,163,252096.6,197556.6,449653.2
316040,202202,522,209,313,254521.2,379356.6,633877.8
316045,202202,49,44,5,53328,6060,59388
316050,202202,20,15,5,18180,6060,24240
316060,202202,101,67,34,81204.6,41208,122412.6
316070,202202,1115,734,381,890821.4,461772,1352593.4
316080,202202,89,57,32,69190.65,38784,107974.65
316090,202202,40,19,21,23028,25452,48480
316095,202202,89,74,15,89688,18180,107868
316100,202202,319,179,140,218160,169680,387840
316105,202202,43,25,18,30300.6,21816,52116.6
316110,202202,1869,1455,414,1763461.23,502980,2266441.23
316120,202202,79,51,28,61812,33936,95748
316130,202202,112,83,29,100596.6,35148,135744.6
316140,202202,34,23,11,27876,13332,41208
316150,202202,216,149,67,180588,82416,263004
316160,202202,80,47,33,56964.6,39996,96960.6
316165,202202,68,45,23,54540,27876,82416
316170,202202,187,119,68,144228,82416,226644
316180,202202,206,81,125,98172.6,151500.6,249673.2
316190,202202,145,104,41,126048,49692,175740
316200,202202,644,344,300,418140,364812.6,782952.6
316210,202202,756,497,259,602572.46,313908,916480.46
316220,202202,113,73,40,88476,48480,136956
316225,202202,35,21,14,25452,18180,43632
316230,202202,37,19,18,23028,21816,44844
316240,202202,659,527,132,638724,159984,798708
316245,202202,148,130,18,157560,21816,179376
316250,202202,1604,1086,518,1316233.2,627816,1944049.2
316255,202202,137,110,27,133320,32724,166044
316257,202202,173,88,85,106656,103020,209676
316260,202202,185,128,57,155136,69084,224220
316265,202202,29,21,8,25452.6,9696,35148.6
316270,202202,677,480,197,581760.4,239976.96,821737.36
316280,202202,535,330,205,399961.35,248460.6,648421.95
316290,202202,805,549,256,665388,310272,975660
316292,202202,549,225,324,272700,392688,665388
316294,202202,103,66,37,79992,44844,124836
316295,202202,338,155,183,187860.6,223008,410868.6
316300,202202,8,7,1,8484,1212,9696
316310,202202,27,14,13,16968,15756,32724
316320,202202,53,27,26,32724,31512,64236
316330,202202,170,116,54,140592,65448,206040
316340,202202,133,89,44,107868,53328,161196
316350,202202,186,129,57,156348.2,69084,225432.2
316360,202202,28,16,12,19392,14544,33936
316370,202202,1170,584,586,709021.4,712656,1421677.4
316380,202202,109,83,26,100596,31512,132108
316390,202202,102,74,28,89688,33936,123624
316400,202202,139,105,34,128472,41208,169680
316410,202202,304,220,84,266640,101808,368448
316420,202202,213,144,69,174528,83628,258156
316430,202202,154,82,72,99384,87264,186648
316440,202202,75,40,35,48480,42420,90900
316443,202202,41,37,4,44844,4848,49692
316447,202202,43,34,9,41208,10908,52116
316450,202202,226,175,51,212100.6,61812,273912.6
316460,202202,85,31,54,37572,65448,103020
316470,202202,1681,1222,459,1483477.53,557520,2040997.53
316480,202202,11,8,3,9696,3636,13332
316490,202202,19,6,13,7272,15756,23028
316500,202202,159,104,55,126048,66660,192708
316510,202202,141,111,30,134532,36360,170892
316520,202202,186,106,80,128472,96960,225432
316530,202202,164,102,62,123624,75144,198768
316540,202202,150,76,74,92112,90900,183012
316550,202202,139,84,55,101808,66660,168468
316553,202202,359,161,198,195132,241188.72,436320.72
316555,202202,47,43,4,52116,4848,56964
316556,202202,14,10,4,12120,4848,16968
316557,202202,26,21,5,25452,6060,31512
316560,202202,69,49,20,59388,24240,83628
316570,202202,207,189,18,229068,21816,250884
316580,202202,22,16,6,19392,7272,26664
316590,202202,96,80,16,96960,19392,116352
316600,202202,177,147,30,179376,36360,215736
316610,202202,71,53,18,64236,21816,86052
316620,202202,141,100,41,121200,49692,170892
316630,202202,43,33,10,39996,12120,52116
316640,202202,21,14,7,16968,8484,25452
316650,202202,92,75,17,90900,20604,111504
316660,202202,7,2,5,2424,6060,8484
316670,202202,430,146,284,176952,344208,521160
316680,202202,163,122,41,147864,49692.4,197556.4
316690,202202,169,102,67,123624,81204,204828
316695,202202,59,49,10,59388,12120,71508
316700,202202,19,13,6,15756,7272,23028
316710,202202,753,570,183,690840,223008,913848
316720,202202,5025,2403,2622,2914863.59,3182712,6097575.59
316730,202202,13,13,0,15756,,15756.0
316740,202202,153,96,57,116352,70296,186648
316750,202202,22,14,8,16968,9696,26664
316760,202202,310,250,60,304212,72720,376932
316770,202202,167,86,81,104232,98172,202404
316780,202202,68,42,26,50904,31512,82416
316790,202202,56,39,17,47268,20604,67872
316800,202202,1764,1080,684,1308960,829009,2137969
316805,202202,27,19,8,23028,9696,32724
316810,202202,60,37,23,44844,27876,72720
316820,202202,39,22,17,26664,20604,47268
316830,202202,98,44,54,53328,66660,119988
316840,202202,505,296,209,359964,253308.4,613272.4
316850,202202,304,205,99,248460,119988,368448
316860,202202,6079,2700,3379,3273616.24,4098984.2,7372600.44
316870,202202,1602,1016,586,1231392.8,711445,1942837.8
316880,202202,146,75,71,90900,86052,176952
316890,202202,231,159,72,192708,87264,279972
316900,202202,404,280,124,340572.84,150288,490860.84
316905,202202,21,9,12,10908,14544,25452
316910,202202,63,25,38,30300,46056,76356
316920,202202,138,108,30,130896,36360,167256
316930,202202,1897,946,951,1147765.2,1152612.8,2300378.0
316935,202202,916,542,374,656904.76,453288.6,1110193.36
316940,202202,1088,619,469,750228.8,569641.4,1319870.2
316950,202202,175,81,94,100596,113928,214524
316960,202202,1080,598,482,724777.2,584184,1308961.2
316970,202202,622,491,131,595092,158772,753864
316980,202202,76,39,37,47268,44844,92112
316990,202202,2181,1476,705,1788913.96,855673.09,2644587.05
317000,202202,327,251,76,304212,92112,396324
317005,202202,220,158,62,191496,75144,266640
317010,202202,6485,3642,2843,4416534.08,3449352,7865886.08
317020,202202,15463,6767,8696,8212519.64,10550466.31,18762985.95
317030,202202,83,34,49,41208,59388,100596
317040,202202,3019,1921,1098,2333101.2,1331988.6,3665089.8
317043,202202,69,52,17,63024,20604,83628
317047,202202,39,22,17,26664,20604,47268
317050,202202,143,110,33,133320,39996,173316
317052,202202,143,112,31,135744,37572,173316
317057,202202,173,131,42,158772,50904,209676
317060,202202,60,37,23,44844,27876,72720
317065,202202,51,37,14,44844,16968,61812
317070,202202,1910,873,1037,1059289,1256844.6,2316133.6
317075,202202,95,52,43,63024,52116,115140
317080,202202,917,466,451,564792,546612,1111404
317090,202202,692,543,149,659328,181800,841128
317100,202202,415,311,104,376932,126048,502980
317103,202202,110,90,20,109080,24240,133320
317107,202202,46,39,7,47268,8484,55752
317110,202202,92,45,47,54540,56964,111504
317115,202202,43,39,4,47268,4848,52116
317120,202202,2001,946,1055,1147765.2,1279872.6,2427637.8
317130,202202,2021,1342,679,1627717.4,822948.6,2450666.0
317140,202202,12,11,1,13332,1212,14544
317150,202202,282,169,113,204828.6,136956,341784.6
317160,202202,332,248,84,301789.55,103020,404809.55
317170,202202,237,160,77,193920,93324,287244
317180,202202,431,291,140,352692,169680,522372
317190,202202,257,188,69,227856,84840,312696
317200,202202,802,553,249,670238.64,301788,972026.64
317210,202202,175,92,83,111504,100596,212100
317220,202202,23,11,12,13332,14544,27876
320010,202202,561,402,159,487224.4,192708,679932.4
320013,202202,125,87,38,105444,46056,151500
320016,202202,263,167,96,202404.52,117564.6,319969.12
320020,202202,712,418,294,506617.89,357540,864157.89
320030,202202,162,109,53,132108.04,64236.08,196344.12
320035,202202,135,96,39,116352,47268,163620
320040,202202,490,252,238,305424,288456,593880
320050,202202,120,81,39,98172,47268,145440
320060,202202,1745,813,932,987780.6,1130797.4,2118578.0
320070,202202,103,62,41,75144,49692,124836
320080,202202,795,450,345,545400.6,418140.8,963541.4
320090,202202,1247,801,446,972024,541764,1513788
320100,202202,332,193,139,233916,168468,402384
320110,202202,122,75,47,90900.8,56964,147864.8
320115,202202,112,92,20,111504,24240,135744
320120,202202,3621,1876,1745,2274926.8,2116152.64,4391079.44
320130,202202,7728,3401,4327,4122015.92,5252811.4,9374827.32
320140,202202,438,282,156,344208.4,189072.6,533281.0
320150,202202,2080,1153,927,1401072,1123524,2524596
320160,202202,639,278,361,338148,437532.2,775680.2
320170,202202,105,82,23,99384.1,27876.02,127260.12
320180,202202,55,34,21,41208,25452,66660
320190,202202,230,140,90,169680,109080,278760
320200,202202,61,47,14,56964,16968,73932
320210,202202,892,481,411,582973.2,498132.8,1081106.0
320220,202202,298,107,191,129684,231492,361176
320225,202202,76,61,15,73932,18180,92112
320230,202202,685,438,247,530856,299364,830220
320240,202202,3480,1604,1876,1946474.4,2277349.2,4223823.6
320245,202202,494,337,157,408444.6,190284,598728.6
320250,202202,229,104,125,126048,151500,277548
320255,202202,129,99,30,119988,36360,156348
320260,202202,243,138,105,167256.18,127260.12,294516.30
320265,202202,150,117,33,141804,39996,181800
320270,202202,154,117,37,141804,44844,186648
320280,202202,1186,665,521,807193.42,633876.02,1441069.44
320290,202202,60,49,11,59388,13332,72720
320300,202202,616,418,198,506617.22,239976.96,746594.18
320305,202202,713,380,333,461772,403596.6,865368.6
320310,202202,202,117,85,141804.84,103020,244824.84
320313,202202,339,154,185,186648.6,224220,410868.6
320316,202202,111,80,31,96960,37572,134532
320320,202202,3419,1516,1903,1837393.24,2306436,4143829.24
320330,202202,271,196,75,237552,90900,328452
320332,202202,784,461,323,559945.4,391476.6,951422.0
320334,202202,276,153,123,185436.02,149076,334512.02
320335,202202,141,89,52,107868,63024,170892
320340,202202,559,391,168,475104.88,203616.6,678721.48
320350,202202,1048,425,623,515101.26,756288.6,1271389.86
320360,202202,167,81,86,99384,104232,203616
320370,202202,228,170,58,206040.64,70296.6,276337.24
320380,202202,295,207,88,250884.6,106656,357540.6
320390,202202,1152,675,477,818100.8,578124.2,1396225.0
320400,202202,319,226,93,273912,112716,386628
320405,202202,953,388,565,470256.6,684780.6,1155037.2
320410,202202,947,472,475,574488,576912.6,1151400.6
320420,202202,534,250,284,303000.2,344208,647208.2
320425,202202,195,109,86,132108,104232,236340
320430,202202,379,196,183,237552.6,223008,460560.6
320435,202202,166,112,54,135744,65448,201192
320440,202202,206,113,93,136956.24,112716.2,249672.44
320450,202202,132,72,60,87264,72720,159984
320455,202202,231,182,49,220584,59388,279972
320460,202202,281,173,108,209676,130896,340572
320465,202202,111,74,37,89688,44844,134532
320470,202202,710,426,284,517524.6,344208,861732.6
320480,202202,201,132,69,159984,84840,244824
320490,202202,3199,1504,1695,1824063.51,2056767.1,3880830.61
320495,202202,117,67,50,81204,60600.6,141804.6
320500,202202,9741,4715,5026,5719439.34,6096363.12,11815802.46
320501,202202,542,271,271,328452,328452,656904
320503,202202,296,207,89,250884.06,107868.02,358752.08
320506,202202,251,176,75,214524,90900,305424
320510,202202,1155,505,650,613272.4,787800,1401072.4
320515,202202,82,62,20,75144,24240,99384
320517,202202,213,149,64,180588,77568,258156
320520,202202,7396,3080,4316,3739022.68,5239483.2,8978505.88
320530,202202,6675,3194,3481,3875956.94,4222612.4,8098569.34
330010,202202,3249,1605,1644,1946474.4,1996164.6,3942639.0
330015,202202,198,83,115,100596.64,140592,241188.64
330020,202202,3841,1525,2316,1849514.56,2806993.2,4656507.76
330022,202202,266,131,135,159984,163620,323604
330023,202202,713,205,508,248460,615696,864156
330025,202202,646,119,527,144228,638724.6,782952.6
330030,202202,1819,1130,689,1369560.6,841128,2210688.6
330040,202202,2529,1273,1256,1542876.4,1523484.5,3066360.9
330045,202202,9764,2878,6886,3491774.5,8353105.4,11844879.9
330050,202202,865,539,326,653268,395112,1048380
330060,202202,1096,643,453,780528.8,549036,1329564.8
330070,202202,4108,1405,2703,1705285.8,3277248.4,4982534.2
330080,202202,1589,687,902,832644.8,1094436.6,1927081.4
330090,202202,400,222,178,269064,215736.6,484800.6
330093,202202,247,104,143,126048,173316,299364
330095,202202,64,41,23,49692,27876,77568
330100,202202,10279,5042,5237,6115757.84,6347246,12463003.84
330110,202202,460,208,252,252096.8,305424,557520.8
330115,202202,519,262,257,317544,311484,629028
330120,202202,390,203,187,246036,226644.4,472680.4
330130,202202,1605,404,1201,489648.6,1455612,1945260.6
330140,202202,652,340,312,412080,378144,790224
330150,202202,508,289,219,350268,265428,615696
330160,202202,203,116,87,140592,106656,247248
330170,202202,27037,9068,17969,10996480.44,21807523.62,32804004.06
330180,202202,253,130,123,157560,149076,306636
330185,202202,1041,356,685,431472,831432,1262904
330187,202202,486,147,339,178164.6,412080,590244.6
330190,202202,6153,2248,3905,2730637.4,4742557.8,7473195.2
330200,202202,4651,1417,3234,1721041.26,3923244.6,5644285.86
330205,202202,457,257,200,311484,243612.6,555096.6
330210,202202,958,570,388,690841.2,470257,1161098.2
330220,202202,2745,1593,1152,1931930.32,1396225.2,3328155.52
330225,202202,566,287,279,347844.4,338148,685992.4
330227,202202,2433,735,1698,892032,2059189,2951221
330230,202202,269,143,126,173316,153924,327240
330240,202202,4115,1941,2174,2353706,2637314.2,4991020.2
330245,202202,149,63,86,76356.36,104232,180588.36
330250,202202,6733,3245,3488,3932942,4232304.24,8165246.24
330260,202202,702,187,515,226644,624180.6,850824.6
330270,202202,3835,1207,2628,1462884.4,3191199.4,4654083.8
330280,202202,441,277,164,338149.8,198768.12,536917.92
330285,202202,6751,2077,4674,2519749,5669739.2,8189488.2
330290,202202,706,246,460,298152.8,557520,855672.8
330300,202202,744,466,278,566749.36,338148.6,904897.96
330310,202202,457,254,203,307848.6,246036,553884.6
330320,202202,7901,2792,5109,3387542.8,6198169.2,9585712.0
330330,202202,9326,3433,5893,4164436.22,7147166.8,11311603.02
330340,202202,2663,1499,1164,1819212,1413192.6,3232404.6
330350,202202,19479,7132,12347,8654899.52,14982753.98,23637653.50
330360,202202,2074,967,1107,1172006,1344108,2516114
330370,202202,983,493,490,598729,593880,1192609
330380,202202,944,380,564,460560,683568.4,1144128.4
330385,202202,634,311,323,376932,391476,768408
330390,202202,5906,3017,2889,3661453.6,3507529.8,7168983.4
330395,202202,343,211,132,255732,161196.8,416928.8
330400,202202,704,349,355,424200.4,431472,855672.4
330410,202202,506,360,146,436320.4,176952,613272.4
330411,202202,285,148,137,179376.88,166044,345420.88
330412,202202,228,94,134,113928,162408,276336
330414,202202,5387,2113,3274,2562169.52,3972936.6,6535106.12
330415,202202,614,261,353,316333.4,427836.4,744169.8
330420,202202,2334,1185,1149,1442280.92,1395012,2837292.92
330430,202202,1780,751,1029,911424.6,1249574.4,2160999.0
330440,202202,339,158,181,191496.6,219372,410868.6
330450,202202,113,50,63,60600,77568,138168
330452,202202,2299,965,1334,1169581.6,1618020.6,2787602.2
330455,202202,119830,40445,79385,49068026.7,96304438.22,145372464.92
330460,202202,250,109,141,132108,172104,304212
330470,202202,1235,661,574,801133.8,696902,1498035.8
330475,202202,1730,486,1244,589032,1507729.2,2096761.2
330480,202202,802,439,363,532068,441168.4,973236.4
330490,202202,15755,4844,10911,5874682.47,13247160.6,19121843.07
330500,202202,1484,635,849,769620,1028988.24,1798608.24
330510,202202,10996,3714,7282,4501370.6,8834271.16,13335641.76
330513,202202,101,50,51,60600,61812,122412
330515,202202,746,310,436,375720.2,528432.2,904152.4
330520,202202,2552,862,1690,1045956,2049492.6,3095448.6
330530,202202,192,107,85,129684,103020.4,232704.4
330540,202202,333,167,166,203616,201192,404808
330550,202202,2815,955,1860,1158673.52,2256744.6,3415418.12
330555,202202,866,323,543,391476,658116,1049592
330560,202202,721,239,482,289668,584184,873852
330570,202202,291,202,89,244824,107868,352692
330575,202202,806,287,519,347844,630240.4,978084.4
330580,202202,3371,1792,1579,2174329.54,1916173.2,4090502.74
330590,202202,262,135,127,163620.18,153924,317544.18
330600,202202,1279,764,515,925968.6,625392,1551360.6
330610,202202,1636,847,789,1026566.6,956268.8,1982835.4
330615,202202,224,181,43,220584.6,52116.6,272701.2
330620,202202,1032,394,638,479953,774468,1254421
330630,202202,4319,2581,1738,3129387.2,2108880.8,5238268.0
350010,202202,604,396,208,479954.52,252096,732050.52
350020,202202,53,17,36,20604,43632,64236
350030,202202,533,322,211,392688.6,255732,648420.6
350040,202202,123,50,73,60600,88476,149076
350050,202202,349,174,175,210888,212100,422988
350055,202202,121,51,70,61812,84840,146652
350060,202202,90,37,53,44844,64236,109080
350070,202202,792,454,338,552673.66,409656.4,962330.06
350075,202202,71,42,29,50904,35148,86052
350080,202202,56,24,32,29088,38784,67872
350090,202202,85,48,37,58176,44844,103020
350100,202202,267,164,103,198768,124836,323604
350110,202202,46,31,15,38784,18180,56964
350115,202202,158,90,68,109080,83628.6,192708.6
350120,202202,108,69,39,83628,47268,130896
350130,202202,389,168,221,203616.03,269064,472680.03
350140,202202,38,23,15,27876,18180,46056
350150,202202,67,47,20,58176,24240,82416
350160,202202,2393,937,1456,1136856.6,1768309.8,2905166.4
350170,202202,392,222,170,269064.6,206040.6,475105.2
350180,202202,165,94,71,113928,86052.6,199980.6
350190,202202,1015,539,476,653272.19,578124,1231396.19
350200,202202,62,25,37,30300.4,44844,75144.4
350210,202202,1306,703,603,854461.8,730836.95,1585298.75
350220,202202,640,522,118,632664.95,143016,775680.95
350230,202202,73,47,26,56964,31512,88476
350240,202202,56,36,20,43632,24240,67872
350250,202202,1131,512,619,620545.6,750229.4,1370775.0
350260,202202,94,68,26,82416,32724,115140
350270,202202,959,637,322,772045.2,391476.88,1163522.08
350275,202202,305,116,189,140592,230280,370872
350280,202202,4476,2165,2311,2627619.8,2803356,5430975.8
350290,202202,466,199,267,241188,323604.6,564792.6
350300,202202,49,24,25,29088,30300,59388
350310,202202,75,45,30,54540,36360,90900
350315,202202,68,28,40,33936,48480,82416
350320,202202,3360,1585,1775,1924657,2151301,4075958
350330,202202,1673,861,812,1044747.9,984144.6,2028892.5
350335,202202,17,10,7,12120,8484,20604
350340,202202,124,51,73,61812,88476.2,150288.2
350350,202202,98,50,48,60600,58176,118776
350360,202202,106,69,37,83628,44844,128472
350370,202202,82,43,39,52116.95,47268,99384.95
350380,202202,793,335,458,406020.4,555096,961116.4
350390,202202,1747,636,1111,770832.3,1347744,2118576.3
350395,202202,21,17,4,20604,4848,25452
350400,202202,1716,825,891,999902.85,1079892,2079794.85
350410,202202,2962,1232,1730,1498032.6,2097973.55,3596006.15
350420,202202,263,156,107,189073.2,130896,319969.2
350430,202202,92,46,46,55752,55752,111504
350440,202202,149,108,41,130896,49692,180588
350450,202202,1725,957,768,1162309.95,933240.2,2095550.15
350460,202202,395,133,262,162408,317544,479952
350470,202202,19,12,7,14544,8484,23028
350480,202202,204,106,98,128472,118776.6,247248.6
350490,202202,242,110,132,133320,159984,293304
350500,202202,57,24,33,29088,39996,69084
350510,202202,153,92,61,111504,73932,185436
350520,202202,441,227,214,275124,259368,534492
350530,202202,441,206,235,249672,284820,534492
350535,202202,91,63,28,76356,33936,110292
350540,202202,366,194,172,235128,208464,443592
350550,202202,2750,1558,1192,1889508.6,1447129.9,3336638.5
350560,202202,576,392,184,475104,223008,698112
350570,202202,4484,1806,2678,2188874.55,3249373.15,5438247.70
350580,202202,370,177,193,214524,233916,448440
350590,202202,964,515,449,624180,545400.6,1169580.6
350600,202202,6292,2918,3374,3539044.87,4092925.8,7631970.67
350610,202202,1509,772,737,935664.6,895668,1831332.6
350620,202202,25,15,10,18180,12120,30300
350630,202202,251,127,124,153924,150288.6,304212.6
350635,202202,1116,439,677,533281.56,821736.6,1355018.16
350640,202202,113,83,30,100596,36360,136956
350650,202202,1851,1216,635,1477428,772044,2249472
350660,202202,756,297,459,359964,557520,917484
350670,202202,297,145,152,175740,184224,359964
350680,202202,169,81,88,98172,106656.6,204828.6
350690,202202,202,92,110,111504,133320,244824
350700,202202,864,405,459,490860.6,556308,1047168.6
350710,202202,409,150,259,181800,313908.6,495708.6
350715,202202,56,44,12,53328,14544,67872
350720,202202,18,11,7,13332,8484,21816
350730,202202,43,25,18,30300,21816,52116
350740,202202,235,129,106,157560,128472,286032
350745,202202,29,12,17,14544,20604,35148
350750,202202,2363,1384,979,1678621.2,1186548,2865169.2
350760,202202,3807,1583,2224,1919808.6,2700336,4620144.6
350770,202202,55,36,19,43632,23028,66660
350775,202202,46,33,13,39996,15756,55752
350780,202202,436,220,216,266640,261792,528432
350790,202202,370,150,220,181800,267852,449652
350800,202202,515,310,205,375720,249672,625392
350810,202202,506,391,115,473892.37,139380,613272.37
350820,202202,93,52,41,63024,49692,112716
350830,202202,72,40,32,48480,38784,87264
350840,202202,787,317,470,385416.6,574488,959904.6
350850,202202,1816,949,867,1151401.2,1052016,2203417.2
350860,202202,652,341,311,413293,376932,790225
350870,202202,443,292,151,355116,183012,538128
350880,202202,271,154,117,189072,141804,330876
350890,202202,39,24,15,29088,18180,47268
350900,202202,1594,473,1121,573276.8,1359864.95,1933141.75
350910,202202,22,11,11,13332,13332,26664
350920,202202,761,394,367,477528,444804,922332
350925,202202,1166,606,560,735684.32,679933.31,1415617.63
350930,202202,108,57,51,69084,63024,132108
350940,202202,734,381,353,461772,427836.6,889608.6
350945,202202,109,78,31,94536,37572,132108
350950,202202,17266,7871,9395,9543299.44,11402500,20945799.44
350960,202202,1565,633,932,768408.6,1133220,1901628.6
350970,202202,1079,536,543,649503.18,659328,1308831.18
350980,202202,97,65,32,78780,38784,117564
350990,202202,375,130,245,157560.6,296940,454500.6
350995,202202,40,17,23,20604,27876,48480
351000,202202,610,401,209,486012.95,253308,739320.95
351010,202202,50,32,18,38784,21816,60600
351015,202202,45,31,14,37572,16968,54540
351020,202202,1496,876,620,1064136.6,752652,1816788.6
351030,202202,341,201,140,243612,169680,413292
351040,202202,961,491,470,597516.92,570852,1168368.92
351050,202202,3478,1538,1940,1866484,2351280.6,4217764.6
351060,202202,5822,2086,3736,2529448.08,4530456.6,7059904.68
351070,202202,394,248,146,300578.31,176952,477530.31
351080,202202,725,524,201,636301.2,243612,879913.2
351090,202202,46,22,24,26664,29088,55752
351100,202202,422,231,191,279972.92,231492,511464.92
351110,202202,2063,949,1114,1152614.06,1351380.6,2503994.66
351120,202202,63,33,30,39996,36360,76356
351130,202202,193,62,131,75144,158772,233916
351140,202202,321,194,127,235128,153924,389052
351150,202202,472,236,236,286032.2,287244.6,573276.8
351160,202202,280,166,114,201192.12,138168,339360.12
351170,202202,208,107,101,129684,122412,252096
351190,202202,93,58,35,70296,42420,112716
351200,202202,348,221,127,267852.12,153924,421776.12
351210,202202,118,58,60,70296,73932,144228
351220,202202,550,320,230,387840.6,278760,666600.6
351230,202202,280,190,90,230280.6,109080,339360.6
351240,202202,234,110,124,134532,150288,284820
351250,202202,83,55,28,66660.82,33936,100596.82
351260,202202,150,106,44,129684,53328,183012
351270,202202,43,18,25,21816,30300,52116
351280,202202,1043,481,562,584184.95,682356.95,1266541.90
351290,202202,242,107,135,129684,163620,293304
351300,202202,3866,1645,2221,1996071.45,2695489.2,4691560.65
351310,202202,744,355,389,431472,471468,902940
351320,202202,117,63,54,76356,65448.6,141804.6
351330,202202,37,24,13,29088,15756,44844
351340,202202,1365,756,609,919909.6,739322.4,1659232.0
351350,202202,2348,1340,1008,1625294.04,1225332.2,2850626.24
351360,202202,795,370,425,449652,517524,967176
351370,202202,396,190,206,230280.6,249672,479952.6
351380,202202,8853,3812,5041,4623786.36,6114542.55,10738328.91
351385,202202,29,18,11,21816,13332,35148
351390,202202,278,208,70,252096.2,84840,336936.2
351400,202202,63,42,21,50904,25452,76356
351410,202202,450,273,177,330876.8,218160,549036.8
351420,202202,68,49,19,59388,23028,82416
351430,202202,74,40,34,48480,41208,89688
351440,202202,783,524,259,635092.3,315120,950212.3
351450,202202,269,126,143,152712,174528,327240
351460,202202,128,56,72,67872.6,87264,155136.6
351470,202202,144,76,68,92112,83628,175740
351480,202202,479,281,198,340573.27,241188,581761.27
351490,202202,289,105,184,127260,223008,350268
351492,202202,28,16,12,19392,14544,33936
351495,202202,25,18,7,21816,8484,30300
351500,202202,3470,1396,2074,1691952.6,2519749.84,4211702.44
351510,202202,2055,737,1318,893245.2,1601052,2494297.2
351512,202202,14,10,4,12120,4848,16968
351515,202202,197,116,81,140592,98172,238764
351518,202202,701,415,286,502980,346632,849612
351519,202202,82,45,37,54540,44844,99384
351520,202202,160,95,65,115140,80013.81,195153.81
351530,202202,23,13,10,15756,12120,27876
351535,202202,135,81,54,98172,65448,163620
351540,202202,467,311,156,376932.16,190284,567216.16
351550,202202,1476,864,612,1047171.1,745380,1792551.1
351560,202202,76,46,30,55752,36360,92112
351565,202202,12,6,6,7272,7272,14544
351570,202202,2759,1262,1497,1531968.6,1815576,3347544.6
351580,202202,39,33,6,39996,7272,47268
351590,202202,63,41,22,49692,26664,76356
351600,202202,179,130,49,157560,59388,216948
351610,202202,52,24,28,29088,33936,63024
351620,202202,5830,3121,2709,3782655.67,3285735.66,7068391.33
351630,202202,3175,1513,1662,1837393.6,2020404.6,3857798.2
351640,202202,2292,984,1308,1192608.6,1587721.55,2780330.15
351650,202202,29,24,5,29088,6060,35148
351660,202202,132,83,49,100596,59388,159984
351670,202202,723,423,300,512677.8,363600,876277.8
351680,202202,77,59,18,71508,23028,94536
351685,202202,11,8,3,9696,3636,13332
351690,202202,297,198,99,241188.3,121200,362388.3
351700,202202,174,112,62,136005.6,75144,211149.6
351710,202202,67,42,25,50904,30300,81204
351720,202202,128,71,57,86052,69084,155136
351730,202202,113,72,41,87264,49692,136956
351740,202202,764,483,281,585398,340572.6,925970.6
351750,202202,378,149,229,180588,277548,458136
351760,202202,716,549,167,665388,202404,867792
351770,202202,292,238,54,289668,65448,355116
351780,202202,151,91,60,110292,72720,183012
351790,202202,255,127,128,153924,155136,309060
351800,202202,39,25,14,30300,16968,47268
351810,202202,123,81,42,98172,50904,149076
351820,202202,783,557,226,675085.4,273912,948997.4
351830,202202,604,190,414,230280,501768,732048
351840,202202,2136,973,1163,1180490.36,1411980.6,2592470.96
351850,202202,231,158,73,191496,89688,281184
351860,202202,622,412,210,499345.32,254520,753865.32
351870,202202,5699,2555,3144,3097876.7,3816591.1,6914467.8
351880,202202,20894,8007,12887,9717821.75,15636016.16,25353837.91
351885,202202,89,48,41,58176,49692,107868
351890,202202,70,50,20,60600,24240,84840
351900,202202,226,125,101,151500,122412,273912
351905,202202,96,42,54,50904,65448,116352
351907,202202,3607,1457,2150,1765885.36,2608224.2,4374109.56
351910,202202,165,70,95,84840,116352,201192
351920,202202,113,62,51,75144,61812,136956
351925,202202,90,56,34,67872,41208,109080
351930,202202,418,270,148,327240,179376,506616
351940,202202,235,97,138,117564,167256,284820
351950,202202,140,73,67,88476,81204,169680
351960,202202,929,451,478,547824.95,580548.6,1128373.55
351970,202202,2069,992,1077,1203516.6,1306536,2510052.6
351980,202202,157,72,85,87264,104232,191496
351990,202202,255,161,94,195133.2,113928,309061.2
352000,202202,322,200,122,242400.6,147864,390264.6
352010,202202,427,272,155,329742,189072,518814
352020,202202,190,67,123,81204,150288,231492
352030,202202,1147,546,601,661752,728412,1390164
352040,202202,615,240,375,290880,454500,745380
352042,202202,305,73,232,88476,281185.2,369661.2
352044,202202,361,209,152,253309.2,185436,438745.2
352050,202202,3268,1189,2079,1441069.94,2520960,3962029.94
352060,202202,99,56,43,67872,52116,119988
352070,202202,90,63,27,76357.9,32724,109081.9
352080,202202,64,42,22,50904,26664,77568
352090,202202,167,109,58,132108,70296,202404
352100,202202,290,136,154,164832,186648.6,351480.6
352110,202202,114,34,80,41208,96960,138168
352115,202202,60,19,41,23028,50904,73932
352120,202202,71,48,23,58176.95,27876,86052.95
352130,202202,215,165,50,201192,60600,261792
352140,202202,177,81,96,98172,117564,215736
352150,202202,128,67,61,81204,73932,155136
352160,202202,143,91,52,111504,63024,174528
352170,202202,395,269,126,326028,152712,478740
352180,202202,676,409,267,495709.55,326028.6,821738.15
352190,202202,244,99,145,119988,175740,295728
352200,202202,28,11,17,13332,20604,33936
352210,202202,4352,1721,2631,2088277.37,3193621,5281898.37
352215,202202,72,39,33,47268,39996,87264
352220,202202,6416,2370,4046,2873653.2,4911026.55,7784679.75
352230,202202,3439,2181,1258,2643376.25,1525910.27,4169286.52
352240,202202,2636,1480,1156,1794973.6,1402284.6,3197258.2
352250,202202,3218,1434,1784,1738011.08,2164633.2,3902644.28
352260,202202,1008,537,471,650844,572064.6,1222908.6
352265,202202,62,33,29,39996,35148,75144
352270,202202,376,205,171,248460,207252.6,455712.6
352280,202202,493,292,201,353904.95,243612,597516.95
352290,202202,172,99,73,119988,88476,208464
352300,202202,101,64,37,77568,44844,122412
352310,202202,6884,2947,3937,3574192.85,4777706.28,8351899.13
352320,202202,1141,580,561,704173.2,679932,1384105.2
352330,202202,532,269,263,326028.6,318756,644784.6
352340,202202,1371,621,750,753867,911427,1665294
352350,202202,362,200,162,244824,196344,441168
352360,202202,219,100,119,121200,144228,265428
352370,202202,111,66,45,79992,54540,134532
352380,202202,111,78,33,94536,39996,134532
352390,202202,2627,1125,1502,1364714,1825273.28,3189987.28
352400,202202,533,230,303,278760,368448.6,647208.6
352410,202202,920,605,315,734473.31,381780.6,1116253.91
352420,202202,87,66,21,79992,25452,105444
352430,202202,1773,778,995,942940.05,1205941.9,2148881.95
352440,202202,3374,1562,1812,1896782.96,2196144.2,4092927.16
352450,202202,199,153,46,185436,55752,241188
352460,202202,630,314,316,380568,382992,763560
352470,202202,654,233,421,282397,511464,793861
352480,202202,1531,833,698,1009596,847188.6,1856784.6
352490,202202,49,17,32,20604,38784,59388
352500,202202,1276,510,766,618120,928392,1546512
352510,202202,700,362,338,438744.6,409656.6,848401.2
352520,202202,856,356,500,431472,607213.2,1038685.2
352530,202202,1824,931,893,1128373.2,1082316.6,2210689.8
352540,202202,67,44,23,53328.6,27876,81204.6
352550,202202,200,115,85,139380,104232,243612
352560,202202,48,38,10,46056,12120,58176
352570,202202,720,334,386,407234.15,469044,876278.15
352580,202202,54,42,12,50904,14544,65448
352585,202202,22,6,16,7272,19392,26664
352590,202202,4367,2112,2255,2560959.15,2740439.3,5301398.45
352600,202202,356,245,111,298152,134532,432684
352610,202202,908,405,503,492072,610848,1102920
352620,202202,1092,405,687,490860,832644,1323504
352630,202202,190,73,117,88476,141804,230280
352640,202202,507,326,181,395112,219372.6,614484.6
352650,202202,87,65,22,78780,26664,105444
352660,202202,67,38,29,46056,35148,81204
352670,202202,1703,891,812,1079893.55,985356,2065249.55
352680,202202,927,563,364,684780.4,441168.95,1125949.35
352690,202202,4622,2012,2610,2443395.1,3171805.55,5615200.65
352700,202202,88,50,38,60600,46056,106656
352710,202202,1485,762,723,924756,876276,1801032
352720,202202,1498,644,854,780528,1035048,1815576
352725,202202,25,20,5,24240,6060,30300
352730,202202,388,183,205,221796,250884,472680
352740,202202,395,254,141,307848.64,170892.49,478741.13
352750,202202,23,15,8,18180,9696,27876
352760,202202,214,135,79,163620,95748,259368
352770,202202,81,61,20,73932,24240,98172
352780,202202,73,37,36,44844,43632,88476
352790,202202,25,17,8,20604,9696,30300
352800,202202,233,175,58,212100,70296,282396
352810,202202,161,100,61,121200,73932,195132
352820,202202,45,34,11,41208,13332,54540
352830,202202,75,50,25,60600,30300,90900
352840,202202,690,308,382,373296,462984,836280
352850,202202,1722,514,1208,622968,1464096,2087064
352860,202202,113,70,43,84840,52116,136956
352870,202202,51,31,20,37572,24240,61812
352880,202202,177,105,72,127260,87264,214524
352885,202202,34,23,11,27876,13332,41208
352890,202202,51,33,18,39996,21816.6,61812.6
352900,202202,4643,2168,2475,2631254.01,3003336.2,5634590.21
352910,202202,35,29,6,35148,7272,42420
352920,202202,640,367,273,446016,332088,778104
352930,202202,1200,558,642,677509.6,779316,1456825.6
352940,202202,6221,2370,3851,2874869.16,4675896.6,7550765.76
352950,202202,115,45,70,54540,84840,139380
352960,202202,65,39,26,47268,32724,79992
352965,202202,15,8,7,9696,8484,18180
352970,202202,513,375,138,454500,167256,621756
352980,202202,159,91,68,110292,82416,192708
352990,202202,975,453,522,549036,632664,1181700
353000,202202,55,23,32,27876,38784,66660
353010,202202,519,315,204,382992,247248,630240
353020,202202,311,216,95,263004,115140,378144
353030,202202,1376,602,774,729626.16,940512,1670138.16
353040,202202,85,43,42,52116,50904,103020
353050,202202,1304,850,454,1030201.37,553884,1584085.37
353060,202202,8789,3691,5098,4473501.14,6184836,10658337.14
353070,202202,1892,1108,784,1342898.74,953628.26,2296527.00
353080,202202,1302,697,605,844765.44,733260,1578025.44
353090,202202,60,32,28,38784,33936,72720
353100,202202,41,32,9,38784,10908,49692
353110,202202,2180,697,1483,844765.2,1802244,2647009.2
353120,202202,125,66,59,79992,71508,151500
353130,202202,863,408,455,494497.23,551460,1045957.23
353140,202202,573,245,328,296940.95,397536,694476.95
353150,202202,326,172,154,208464.95,186648.6,395113.55
353160,202202,107,81,26,98172,31512,129684
353170,202202,203,63,140,76356,169680,246036
353180,202202,1158,517,641,626605.4,776892.6,1403498.0
353190,202202,486,342,144,414505.4,174528,589033.4
353200,202202,244,115,129,139380,156348,295728
353205,202202,20,13,7,15756,8484,24240
353210,202202,65,38,27,46056,33936,79992
353215,202202,40,23,17,27876,20604,48480
353220,202202,84,45,39,54540,47268,101808
353230,202202,153,63,90,76356.2,109080,185436.2
353240,202202,368,173,195,209676,236340,446016
353250,202202,195,95,100,115140,121200,236340
353260,202202,452,294,158,356328.28,191496,547824.28
353270,202202,73,55,18,66660,21816,88476
353280,202202,103,48,55,58176.4,66660,124836.4
353282,202202,125,87,38,105444,46056,151500
353284,202202,27,18,9,21816,10908,32724
353286,202202,7,3,4,3636,4848,8484
353290,202202,84,43,41,52116,49692,101808
353300,202202,439,222,217,269064.96,264216,533280.96
353310,202202,40,34,6,41208,7272,48480
353320,202202,41,25,16,30300,19392,49692
353325,202202,45,25,20,30300.2,24240,54540.2
353330,202202,64,44,20,53328.8,24240,77568.8
353340,202202,656,220,436,266640,528432.6,795072.6
353350,202202,896,430,466,521160.6,566004,1087164.6
353360,202202,101,79,22,95748,26664,122412
353370,202202,112,65,47,78780,56964,135744
353380,202202,27,13,14,15756,16968,32724
353390,202202,1123,526,597,637512,724776,1362288
353400,202202,45,27,18,32724,21816,54540
353410,202202,112,64,48,77568,58176.6,135744.6
353420,202202,52,21,31,25452,37572,63024
353430,202202,574,375,199,454501.45,241188,695689.45
353440,202202,12214,5181,7033,6281798.59,8539753.44,14821552.03
353450,202202,56,29,27,35148,32724,67872
353460,202202,632,322,310,390264.4,375720,765984.4
353470,202202,2282,1108,1174,1345320.83,1425312,2770632.83
353475,202202,265,171,94,208464.6,113928,322392.6
353480,202202,175,140,35,169680,42420,212100
353490,202202,225,132,93,161196,112716.6,273912.6
353500,202202,214,119,95,144228,115140,259368
353510,202202,81,55,26,66660,31512,98172
353520,202202,226,164,62,199980,75144.6,275124.6
353530,202202,459,235,224,284820,271488,556308
353540,202202,402,247,155,301788,187860,489648
353550,202202,714,441,273,534493.55,332088.6,866582.15
353560,202202,560,221,339,267852,413292.4,681144.4
353570,202202,62,38,24,46056,29088,75144
353580,202202,341,231,110,279972,134532,414504
353590,202202,84,59,25,71508,30300,101808
353600,202202,272,156,116,189072.95,140592,329664.95
353610,202202,127,67,60,81204,72720,153924
353620,202202,681,336,345,407232.6,418140,825372.6
353625,202202,54,29,25,35148,30300,65448
353630,202202,217,155,62,187860.52,75144,263004.52
353640,202202,119,76,43,92112,52116,144228
353650,202202,993,378,615,458136,745380,1203516
353657,202202,23,19,4,23028,4848,27876
353660,202202,284,145,139,175740,168468,344208
353670,202202,708,410,298,498132.95,363600.6,861733.55
353680,202202,130,89,41,107868,49692,157560
353690,202202,41,28,13,33936,15756,49692
353700,202202,278,191,87,231492.8,105444,336936.8
353710,202202,485,226,259,275124,315121.2,590245.2
353715,202202,48,29,19,35148,24240,59388
353720,202202,343,153,190,185436.6,230280,415716.6
353730,202202,1169,708,461,860520.6,558732,1419252.6
353740,202202,606,330,276,401172.8,335724.8,736897.6
353750,202202,69,39,30,47268,36360,83628
353760,202202,3189,1183,2006,1435009.24,2434909.9,3869919.14
353770,202202,76,61,15,73932,18180,92112
353780,202202,1342,610,732,739320.95,890820,1630140.95
353790,202202,482,288,194,349056.68,235128,584184.68
353800,202202,3590,1677,1913,2033763.6,2320981.2,4354744.8
353810,202202,224,111,113,134532,136956,271488
353820,202202,240,97,143,117564,173316.6,290880.6
353830,202202,62,49,13,59388,15756,75144
353850,202202,194,87,107,105444,129684,235128
353860,202202,532,225,307,273912.6,374508,648420.6
353870,202202,5605,2788,2817,3380271,3415418,6795689
353880,202202,709,458,251,555096,304212,859308
353890,202202,562,321,241,390264,293305.2,683569.2
353900,202202,130,66,64,79992,77568,157560
353910,202202,191,77,114,93324,138168,231492
353920,202202,423,222,201,269064.2,243612,512676.2
353930,202202,1057,613,444,742956,538129.2,1281085.2
353940,202202,193,93,100,112716,121200,233916
353950,202202,489,307,182,372084,220584,592668
353960,202202,73,60,13,72720,16968,89688
353970,202202,40,27,13,32724,15756,48480
353980,202202,1838,814,1024,986568.6,1241089.4,2227658.0
353990,202202,78,45,33,54540,39996,94536
354000,202202,377,170,207,206040,250884,456924
354010,202202,90,51,39,61812,47268,109080
354020,202202,504,314,190,380568,230280,610848
354025,202202,36,31,5,37572,6060,43632
354030,202202,46,26,20,31512,24240,55752
354040,202202,100,74,26,89688,31512,121200
354050,202202,173,92,81,111504.4,98172,209676.4
354060,202202,769,354,415,430260,502980,933240
354070,202202,935,527,408,639936.6,495708,1135644.6
354075,202202,181,83,98,100596,118776,219372
354080,202202,312,137,175,166044,212100,378144
354085,202202,23,13,10,15756,12120,27876
354090,202202,266,160,106,193817.6,128472,322289.6
354100,202202,5860,2355,3505,2854260.8,4252912.16,7107172.96
354105,202202,99,48,51,58176,61812,119988
354110,202202,41,19,22,23028,26664,49692
354120,202202,150,97,53,117564.19,65448,183012.19
354130,202202,717,431,286,524797.56,346632,871429.56
354140,202202,3238,1433,1805,1738008.76,2192508.6,3930517.36
354150,202202,631,360,271,436321.32,328452,764773.32
354160,202202,649,408,241,494496.8,292093.56,786590.36
354165,202202,15,13,2,15756,2424,18180
354170,202202,174,119,55,144228,66660,210888
354180,202202,56,32,24,38784,29088,67872
354190,202202,202,80,122,96960,147864,244824
354200,202202,108,55,53,66660,64236,130896
354210,202202,71,29,42,35148,50904,86052
354220,202202,623,390,233,472680.95,283608,756288.95
354230,202202,167,71,96,86052.4,116352,202404.4
354240,202202,326,204,122,247248.75,147864,395112.75
354250,202202,82,48,34,58176,41208,99384
354260,202202,2170,1010,1160,1224121.56,1410769.96,2634891.52
354270,202202,87,60,27,72720,32724,105444
354280,202202,50,26,24,31512,29088,60600
354290,202202,140,94,46,113928,55752.7,169680.7
354300,202202,351,246,105,298152.95,127260,425412.95
354310,202202,88,63,25,76356.6,30300,106656.6
354320,202202,219,108,111,130896,134532,265428
354323,202202,7,7,0,8484,,8484.0
354325,202202,124,67,57,81204.5,69084,150288.5
354330,202202,2445,811,1634,982759.8,1980408.6,2963168.4
354340,202202,10433,4751,5682,5761596.47,6901132.6,12662729.07
354350,202202,135,90,45,109080,55752,164832
354360,202202,71,41,30,49692,36360,86052
354370,202202,235,117,118,141804,143016,284820
354380,202202,170,97,73,118776,88476,207252
354390,202202,2726,954,1772,1158674.44,2148876,3307550.44
354400,202202,307,165,142,199980.49,172104,372084.49
354410,202202,652,289,363,350268.96,439956.6,790225.56
354420,202202,274,177,97,214524,117564,332088
354425,202202,326,178,148,215792,179376,395168
354430,202202,183,100,83,121200,100596,221796
354440,202202,32,26,6,31512,7272,38784
354450,202202,55,35,20,42420.6,24240,66660.6
354460,202202,96,54,42,65448,50904,116352
354470,202202,26,13,13,15756,15756,31512
354480,202202,110,57,53,69084,65448,134532
354490,202202,132,77,55,94536,66660,161196
354500,202202,400,177,223,214524,271488,486012
354510,202202,89,59,30,71508,36360,107868
354515,202202,45,12,33,14544,41208,55752
354520,202202,1608,680,928,823988.2,1125948.2,1949936.4
354530,202202,842,408,434,495709.69,526008,1021717.69
354540,202202,263,131,132,158772,161196,319968
354550,202202,39,21,18,25452,21816,47268
354560,202202,152,81,71,98172,86052,184224
354570,202202,135,92,43,111504,52116,163620
354580,202202,1851,866,985,1050805.8,1196244.6,2247050.4
354600,202202,276,136,140,164832,169680,334512
354610,202202,67,54,13,65448,15756,81204
354620,202202,65,17,48,20604,58176,78780
354625,202202,12,8,4,9696,4848,14544
354630,202202,318,203,115,246036,139380,385416
354640,202202,828,495,333,601152,404808,1005960
354650,202202,63,36,27,43632,33936,77568
354660,202202,801,587,214,712656.95,260580,973236.95
354670,202202,219,80,139,98172,168468,266640
354680,202202,1317,462,855,559944,1038684,1598628
354690,202202,71,47,24,56964.6,29088,86052.6
354700,202202,75,52,23,63024,27876,90900
354710,202202,46,32,14,38784,16968,55752
354720,202202,21,20,1,24240,1212,25452
354730,202202,1792,717,1075,870216.6,1302900,2173116.6
354740,202202,74,50,24,60600,29088,89688
354750,202202,409,232,177,281184,215736,496920
354760,202202,489,302,187,367237.2,226644,593881.2
354765,202202,7,2,5,2424,6060,8484
354770,202202,346,225,121,272700,146652,419352
354780,202202,8371,3100,5271,3759628.48,6405421.72,10165050.20
354790,202202,87,53,34,64236,41208,105444
354800,202202,427,231,196,279923.93,238764,518687.93
354805,202202,81,37,44,44844,53328,98172
354810,202202,100,54,46,65448,55752,121200
354820,202202,209,84,125,101808.64,151500,253308.64
354830,202202,43,22,21,26664,25452,52116
354840,202202,57,39,18,47268,21816,69084
354850,202202,4502,1938,2564,2352495.08,3112416.06,5464911.14
354860,202202,337,155,182,187860,221796,409656
354870,202202,11977,5107,6870,6195753.54,8340989.4,14536742.94
354880,202202,2685,966,1719,1172005.46,2083485.36,3255490.82
354890,202202,2925,1523,1402,1848302.75,1700436.4,3548739.15
354900,202202,63,43,20,52116,24240,76356
354910,202202,1286,648,638,787800.8,774468,1562268.8
354920,202202,39,32,7,38784,8484,47268
354925,202202,20,10,10,12120,12120,24240
354930,202202,35,30,5,36360.2,6060,42420.2
354940,202202,777,536,241,650844.6,292092,942936.6
354950,202202,213,130,83,157560.4,100596,258156.4
354960,202202,130,49,81,59388,98172,157560
354970,202202,1091,736,355,892034.11,430260.6,1322294.71
354980,202202,9212,3248,5964,3946280.11,7235641.37,11181921.48
354990,202202,10044,4360,5684,5289171.25,6895069.8,12184241.05
354995,202202,573,177,396,214525.2,479952,694477.2
355000,202202,452,158,294,191496,356328,547824
355010,202202,607,371,236,449653,286033.75,735686.75
355020,202202,784,480,304,581760,368448.6,950208.6
355030,202202,213432,78389,135043,95088812.47,163829753.84,258918566.31
355040,202202,892,415,477,502980.6,578124,1081104.6
355050,202202,173,96,77,116352,94536,210888
355060,202202,1742,820,922,995053.2,1119888.4,2114941.6
355070,202202,1566,692,874,839916.38,1059289.76,1899206.14
355080,202202,194,117,77,141804,93324,235128
355090,202202,296,177,119,214524,144228.7,358752.7
355100,202202,5290,2444,2846,2966857.56,3455412.8,6422270.36
355110,202202,235,153,82,185436,99384,284820
355120,202202,55,34,21,41208,25452,66660
355130,202202,50,29,21,35148,25452,60600
355140,202202,192,113,79,136956,95748,232704
355150,202202,690,402,288,488436.6,350268,838704.6
355160,202202,481,226,255,273912.95,309060,582972.95
355170,202202,2073,1060,1013,1285932.53,1228968,2514900.53
355180,202202,692,273,419,330876,507828,838704
355190,202202,221,150,71,183012,86052,269064
355200,202202,107,55,52,66660,64236.6,130896.6
355210,202202,724,397,327,481164,396324,877488
355220,202202,7575,3674,3901,4457742.4,4736498.8,9194241.2
355230,202202,98,58,40,70296,48480,118776
355240,202202,4621,1849,2772,2244627.1,3362090.4,5606717.5
355250,202202,6513,2819,3694,3417865.51,4478342.6,7896208.11
355255,202202,48,30,18,36360,21816,58176
355260,202202,186,105,81,127260.6,98172,225432.6
355270,202202,167,107,60,129684.6,72720,202404.6
355280,202202,6962,2564,4398,3111207.6,5334013.8,8445221.4
355290,202202,71,56,15,67872,18180,86052
355300,202202,231,132,99,159984,122412.6,282396.6
355310,202202,111,57,54,69084,65448,134532
355320,202202,94,48,46,58176,55752,113928
355330,202202,305,176,129,213312,156348,369660
355340,202202,1413,480,933,581761.75,1130796,1712557.75
355350,202202,163,78,85,94536,103020,197556
355360,202202,165,106,59,128472,71508,199980
355365,202202,18,13,5,15756,6060,21816
355370,202202,1022,605,417,734472.95,505404,1239876.95
355380,202202,825,505,320,612060,389052,1001112
355385,202202,83,54,29,65448,35148,100596
355390,202202,108,55,53,66660,64236,130896
355395,202202,191,100,91,121200.18,110292,231492.18
355400,202202,1741,992,749,1202207.08,907788.95,2109996.03
355410,202202,5057,2303,2754,2797301,3341484,6138785
355420,202202,46,33,13,39996,15756,55752
355430,202202,410,245,165,296940,201192,498132
355440,202202,87,52,35,63024,42420,105444
355450,202202,439,214,225,259368.12,272700,532068.12
355460,202202,59,45,14,54540,16968,71508
355465,202202,51,29,22,35148,26664,61812
355470,202202,187,72,115,87264.8,139380,226644.8
355475,202202,9,6,3,8484,3636,12120
355480,202202,599,240,359,290880,435108,725988
355490,202202,113,77,36,93324,43632,136956
355495,202202,76,26,50,31512,60600,92112
355500,202202,1606,853,753,1035049.56,913848.6,1948898.16
355510,202202,276,196,80,238765.75,98172,336937.75
355520,202202,29,22,7,26664,8484,35148
355530,202202,23,11,12,13332,14544,27876
355535,202202,74,32,42,38784,50904,89688
355540,202202,2685,1024,1661,1243684.09,2013132,3256816.09
355550,202202,62,35,27,42420,32724,75144
355560,202202,243,108,135,130896,163620,294516
355570,202202,15,11,4,13332,6060,19392
355580,202202,243,163,80,197556,96960.6,294516.6
355590,202202,18,11,7,13332,8484,21816
355600,202202,269,131,138,158772,167256,326028
355610,202202,232,144,88,174528,106656,281184
355620,202202,1299,570,729,690840,884760,1575600
355630,202202,417,300,117,363600,141804,505404
355635,202202,128,55,73,66660,88476,155136
355640,202202,540,284,256,344208,310272,654480
355645,202202,899,325,574,393900,695688.6,1089588.6
355650,202202,1910,806,1104,976873,1338048,2314921
355660,202202,234,121,113,147864,136956,284820
355670,202202,628,259,369,313908,448440,762348
355680,202202,205,115,90,139380,109080,248460
355690,202202,91,43,48,52116,58176,110292
355695,202202,26,17,9,20604,10908,31512
355700,202202,1211,607,604,736896.04,733261.2,1470157.24
355710,202202,2259,1221,1038,1481065.2,1258056,2739121.2
355715,202202,13,11,2,13332,2424,15756
355720,202202,253,154,99,186648.36,121200,307848.36
355730,202202,109,63,46,76356,55752,132108
410010,202202,130,103,27,124836,32724,157560
410020,202202,120,86,34,104232,41208,145440
410030,202202,168,90,78,109080,94536,203616
410040,202202,1316,635,681,769620.6,825372,1594992.6
410045,202202,45,34,11,41208,13332,54540
410050,202202,514,291,223,352692,270276,622968
410060,202202,285,206,79,249672,95748,345420
410070,202202,285,243,42,294516,52116,346632
410080,202202,179,108,71,130896,86052,216948
410090,202202,64,53,11,64236,13332,77568
410100,202202,257,165,92,199980,111504,311484
410105,202202,49,28,21,33936,25452,59388
410110,202202,343,206,137,250884,167256,418140
410115,202202,45,29,16,35148,19392,54540
410120,202202,438,203,235,246036,284820,530856
410130,202202,57,30,27,36360,32724,69084
410140,202202,3144,1417,1727,1717405.52,2093127,3810532.52
410150,202202,2689,1074,1615,1302901.2,1961016.6,3263917.8
410160,202202,478,273,205,332088,248460,580548
410165,202202,52,30,22,36360,26664,63024
410170,202202,198,123,75,149076,90900,239976
410180,202202,2305,1239,1066,1502880.6,1294416,2797296.6
410185,202202,37,30,7,36360,8484,44844
410190,202202,485,310,175,375720.3,212100,587820.3
410200,202202,987,702,285,850824,345420,1196244
410210,202202,624,316,308,382992,373296.2,756288.2
410220,202202,50,21,29,25452,35148,60600
410230,202202,175,79,96,95748,116352,212100
410240,202202,719,455,264,551460,319968,871428
410250,202202,384,269,115,326028,139380,465408
410260,202202,302,165,137,199980,166044.6,366024.6
410270,202202,29,22,7,26664,8484,35148
410275,202202,61,45,16,54540,19392,73932
410280,202202,322,186,136,225432,164832,390264
410290,202202,278,156,122,189072,147864,336936
410300,202202,88,54,34,65448,41208,106656
410302,202202,24,13,11,15756,13332,29088
410304,202202,38,25,13,30300,15756,46056
410305,202202,228,126,102,152712,123624,276336
410310,202202,190,110,80,133320,96960,230280
410315,202202,44,32,12,38784,14544,53328
410320,202202,137,89,48,109080,58176,167256
410322,202202,34,21,13,25452,15756,41208
410330,202202,168,111,57,134532,69084,203616
410335,202202,96,53,43,64236,52116,116352
410337,202202,43,33,10,39996,12120,52116
410340,202202,37,30,7,36360,8484,44844
410345,202202,195,115,80,139380,96960,236340
410347,202202,45,33,12,39996,14544,54540
410350,202202,258,147,111,178164,134532,312696
410360,202202,439,267,172,323604.6,208464.6,532069.2
410370,202202,2340,983,1357,1191396.6,1645896.6,2837293.2
410380,202202,190,112,78,136956,94536,231492
410390,202202,394,260,134,315120,162408,477528
410395,202202,33,21,12,25452,15756,41208
410400,202202,851,360,491,437532.94,596304,1033836.94
410405,202202,80,60,20,72720,24240,96960
410410,202202,27,18,9,21816,10908,32724
410420,202202,1718,772,946,935556.73,1146552,2082108.73
410425,202202,187,75,112,90900,135744,226644
410430,202202,2326,1228,1098,1491972,1331988,2823960
410440,202202,359,256,103,310272,124836,435108
410442,202202,359,224,135,271488,163620,435108
410445,202202,416,288,128,350268,155136,505404
410450,202202,380,179,201,216948,243612,460560
410460,202202,559,287,272,347844,329664,677508
410465,202202,250,134,116,163620,140592.6,304212.6
410470,202202,267,144,123,175740,149076,324816
410480,202202,6547,3115,3432,3783865.8,4164434.5,7948300.3
410490,202202,1405,798,607,969600,735684.6,1705284.6
410500,202202,269,152,117,184224,141804,326028
410510,202202,178,131,47,158772,56964,215736
410520,202202,264,188,76,227856,92112,319968
410530,202202,298,95,203,115140,248460,363600
410540,202202,338,244,94,295728.04,113928,409656.04
410550,202202,1706,699,1007,847188.92,1221696.6,2068885.52
410560,202202,154,104,50,126048,60600,186648
410570,202202,441,294,147,358753.2,178164,536917.2
410580,202202,3656,1523,2133,1850725.4,2597317,4448042.4
410590,202202,417,265,152,321159,184224,505383
410600,202202,191,166,25,201192,30300,231492
410610,202202,49,39,10,47268,12120,59388
410620,202202,268,172,96,208464.4,116352,324816.4
410630,202202,451,245,206,296940,249672,546612
410640,202202,1056,648,408,785376.8,494496,1279872.8
410645,202202,113,81,32,98172.8,39996,138168.8
410650,202202,366,224,142,271488,173316,444804
410655,202202,86,60,26,72720,31512,104232
410657,202202,33,10,23,12120,27876,39996
410660,202202,643,431,212,522372.14,256944,779316.14
410670,202202,78,64,14,77568,16968,94536
410680,202202,188,153,35,185436,42420,227856
410685,202202,28,17,11,20604,13332,33936
410690,202202,28520,11667,16853,14156168.25,20454929.4,34611097.65
410700,202202,323,234,89,283608,107868,391476
410710,202202,128,104,24,126048,29088,155136
410712,202202,44,32,12,38784,14544,53328
410715,202202,90,68,22,82416,26664,109080
410720,202202,654,373,281,453288.6,341784,795072.6
410725,202202,191,136,55,164832,66660,231492
410730,202202,104,48,56,58176,67872,126048
410740,202202,100,71,29,86052,35148,121200
410750,202202,288,189,99,229068,119988,349056
410752,202202,20,14,6,16968,7272,24240
410753,202202,58,23,35,27876,42420,70296
410754,202202,54,26,28,31512,33936,65448
410755,202202,77,43,34,52116,41208,93324
410760,202202,757,404,353,489648,427836.2,917484.2
410765,202202,1877,835,1042,1013233,1265329.4,2278562.4
410770,202202,112,79,33,95748,39996,135744
410773,202202,63,42,21,50904,25452,76356
410775,202202,178,133,45,161196,54540,215736
410780,202202,89,48,41,58176,49692,107868
410785,202202,51,41,10,50904,12120,63024
410790,202202,86,37,49,44844,59388,104232
410800,202202,277,173,104,210888,126048.6,336936.6
410810,202202,30,18,12,21816,14544.6,36360.6
410820,202202,160,113,47,136956,56964,193920
410830,202202,8958,3739,5219,4534094,6336337.6,10870431.6
410832,202202,117,76,41,92112,49692,141804
410840,202202,1423,750,673,909000.21,816888.8,1725889.01
410845,202202,50,27,23,32724,27876,60600
410850,202202,173,126,47,152712,56964,209676
410855,202202,73,63,10,76356,12120,88476
410860,202202,786,402,384,487224,465408.6,952632.6
410865,202202,101,71,30,86052.6,36360,122412.6
410870,202202,148,124,24,150288,29088,179376
410880,202202,1159,569,590,689628.6,715080.6,1404709.2
410890,202202,96,63,33,76356,39996,116352
410895,202202,75,56,19,67872,23028,90900
410900,202202,26,19,7,23028,8484,31512
410910,202202,15,10,5,12120,6060,18180
410920,202202,44,28,16,33936,19392,53328
410930,202202,553,335,218,406020,265428,671448
410940,202202,4426,2306,2120,2794873.2,2573076.2,5367949.4
410950,202202,103,76,27,92112,32724,124836
410960,202202,882,332,550,403596.6,669024,1072620.6
410965,202202,62,39,23,47268,27876,75144
410970,202202,610,416,194,504192,235128,739320
410975,202202,120,74,46,89688.58,55752,145440.58
410980,202202,1643,723,920,877489.2,1115040,1992529.2
410990,202202,274,197,77,238764,93324,332088
411000,202202,62,36,26,43632,31512.6,75144.6
411005,202202,30,23,7,27876,8484,36360
411007,202202,251,140,111,169680,135744,305424
411010,202202,600,391,209,475104,253308,728412
411020,202202,291,185,106,224220,129684,353904
411030,202202,23,12,11,14544,13332,27876
411040,202202,58,38,20,46056,24240,70296
411050,202202,212,149,63,181800,76356,258156
411060,202202,529,356,173,431472,209676,641148
411065,202202,46,41,5,49692,6060,55752
411070,202202,1275,724,551,879912,669024.2,1548936.2
411080,202202,243,168,75,203616,92112,295728
411090,202202,89,67,22,81204,26664,107868
411095,202202,340,120,220,145440,266640,412080
411100,202202,109,86,23,104232,27876,132108
411110,202202,140,84,56,101808,67872,169680
411120,202202,209,135,74,163620,89688,253308
411125,202202,293,134,159,162408,192708,355116
411130,202202,118,100,18,121200,21816,143016
411140,202202,211,144,67,174528,81204,255732
411150,202202,1234,786,448,952632,545401.55,1498033.55
411155,202202,119,83,36,100596,43632,144228
411160,202202,31,13,18,15756,21816,37572
411170,202202,50,45,5,54540,6060,60600
411180,202202,987,642,345,778104,419352,1197456
411190,202202,337,184,153,223008,185436,408444
411200,202202,664,383,281,464196.95,340572,804768.95
411210,202202,681,348,333,421776,406020.25,827796.25
411220,202202,159,111,48,134532,58176,192708
411230,202202,37,29,8,35148,9696,44844
411240,202202,114,69,45,83628,54540,138168
411250,202202,423,307,116,372084,140592,512676
411260,202202,14,10,4,12120,4848,16968
411270,202202,267,134,133,162408,161196,323604
411275,202202,182,155,27,189072,32724,221796
411280,202202,207,149,58,180588.95,70296,250884.95
411290,202202,68,52,16,63024,19392,82416
411295,202202,123,97,26,117564,31512,149076
411300,202202,79,36,43,43632,52116,95748
411310,202202,93,67,26,81204,31512,112716
411320,202202,801,503,298,609636,361176.6,970812.6
411325,202202,65,46,19,55752,23028,78780
411330,202202,901,577,324,699324.2,392688,1092012.2
411340,202202,32,22,10,26664,12120,38784
411342,202202,59,45,14,54540,16968,71508
411345,202202,109,53,56,64236,67872,132108
411350,202202,499,368,131,446016.52,158772.6,604789.12
411360,202202,57,36,21,43632,25452,69084
411370,202202,13942,5573,8369,6762966.51,10157778.5,16920745.01
411373,202202,182,120,62,145440,75144,220584
411375,202202,77,61,16,75144,19392,94536
411380,202202,77,55,22,66660,26664,93324
411390,202202,128,75,53,90900,64236,155136
411400,202202,422,281,141,340572,172104,512676
411410,202202,502,231,271,279972,328452.6,608424.6
411420,202202,966,399,567,484801.82,687204.2,1172006.02
411430,202202,512,277,235,336936,284820,621756
411435,202202,29,18,11,21816,13332,35148
411440,202202,464,367,97,444804,118776,563580
411450,202202,414,347,67,421776,81204,502980
411460,202202,806,302,504,367236,610848,978084
411470,202202,109,76,33,92112,39996,132108
411480,202202,702,367,335,446016.6,406020,852036.6
411490,202202,283,173,110,209676,133320,342996
411500,202202,97,79,18,95748,21816,117564
411510,202202,225,177,48,214524,58176,272700
411520,202202,6109,2101,4008,2547624.24,4862546.45,7410170.69
411530,202202,121,82,39,99384,47268,146652
411535,202202,47,15,32,18180,38784,56964
411540,202202,372,247,125,299364,151500,450864
411545,202202,58,42,16,50904,19392,70296
411550,202202,92,70,22,84840,26664,111504
411560,202202,406,163,243,197556,295728,493284
411570,202202,921,312,609,378144.32,739320,1117464.32
411573,202202,27,16,11,19392,13332,32724
411575,202202,316,192,124,232704,150288,382992
411580,202202,1239,435,804,527220.6,978084,1505304.6
411585,202202,71,36,35,43632,42420,86052
411590,202202,16,10,6,12120,7272,19392
411600,202202,21,9,12,10908,14544,25452
411605,202202,246,92,154,111504,186648,298152
411610,202202,229,143,86,173316,105444,278760
411620,202202,392,187,205,226644,248460,475104
411630,202202,49,34,15,41208,18180,59388
411640,202202,31,22,9,26664,10908,37572
411650,202202,9,6,3,7272,3636,10908
411660,202202,40,29,11,35148,13332,48480
411670,202202,241,167,74,202404,89688,292092
411680,202202,156,127,29,153924,35148,189072
411690,202202,607,313,294,379356,357540,736896
411695,202202,67,49,18,59388,21816,81204
411700,202202,145,115,30,139380,37572,176952
411705,202202,102,67,35,81204,42420,123624
411710,202202,296,196,100,237552,121200.6,358752.6
411720,202202,140,94,46,113928,55752,169680
411721,202202,85,69,16,83628,19392,103020
411722,202202,102,45,57,54540,69084,123624
411725,202202,171,122,49,149076,59388,208464
411727,202202,99,78,21,94536,26664,121200
411729,202202,47,33,14,39996,16968,56964
411730,202202,558,346,212,419352,256944,676296
411740,202202,31,19,12,23028,14544,37572
411745,202202,64,49,15,59388,18180,77568
411750,202202,842,344,498,416928,603576,1020504
411760,202202,1226,884,342,1071409.17,414504,1485913.17
411770,202202,424,276,148,335724,179376,515100
411780,202202,366,236,130,286032,157560,443592
411790,202202,583,325,258,393900.6,312696,706596.6
411800,202202,149,107,42,129684.65,50904,180588.65
411810,202202,184,140,44,169680,53328,223008
411820,202202,2411,979,1432,1188974.4,1735585,2924559.4
411830,202202,14,12,2,14544,2424,16968
411840,202202,2132,1268,864,1538028,1047168.6,2585196.6
411845,202202,66,22,44,26664,53328,79992
411850,202202,1247,671,576,813252.6,699324.8,1512577.4
411860,202202,50,31,19,37572.6,23028,60600.6
411870,202202,69,41,28,49692,33936,83628
411880,202202,430,251,179,304212,216948,521160
411885,202202,104,62,42,75144,50904,126048
411890,202202,319,219,100,265429.19,121200,386629.19
411900,202202,103,75,28,90900.6,33936,124836.6
411910,202202,185,137,48,166044,58176,224220
411915,202202,2384,938,1446,1136856,1753764.08,2890620.08
411920,202202,112,87,25,105444,30300,135744
411925,202202,17,10,7,12120,8484,20604
411930,202202,783,543,240,658194.52,290880,949074.52
411940,202202,595,375,220,456924,267852,724776
411950,202202,1150,519,631,629028.6,764772,1393800.6
411960,202202,1102,694,408,841128,494496,1335624
411965,202202,25,15,10,18180,12120,30300
411970,202202,91,76,15,92112,18180,110292
411980,202202,204,114,90,138168,110292,248460
411990,202202,5128,2746,2382,3333008.87,2890700.98,6223709.85
411995,202202,581,170,411,207252,499344,706596
412000,202202,324,213,111,258156,134532,392688
412010,202202,47,25,22,30300,26664,56964
412015,202202,37,30,7,36360,8484,44844
412020,202202,19,14,5,16968,6060,23028
412030,202202,37,33,4,39996,4848,44844
412033,202202,50,30,20,36360,24240,60600
412035,202202,72,47,25,56964,30300,87264
412040,202202,37,18,19,21816.6,23028,44844.6
412050,202202,212,155,57,187860,69084,256944
412060,202202,779,555,224,672660,271488.13,944148.13
412065,202202,49,29,20,35148,24240,59388
412070,202202,164,115,49,140592,59388,199980
412080,202202,322,150,172,181800,208464,390264
412085,202202,35,14,21,16968,25452,42420
412090,202202,839,516,323,626604.6,391476,1018080.6
412100,202202,264,221,43,267852,52116,319968
412110,202202,69,53,16,64236.8,19392,83628.8
412120,202202,345,181,164,221796,198768,420564
412125,202202,70,42,28,50904,33936,84840
412130,202202,46,28,18,33936.84,21816,55752.84
412135,202202,29,17,12,20604,14544,35148
412140,202202,421,266,155,322392.6,187860,510252.6
412150,202202,240,153,87,185436,105444,290880
412160,202202,85,55,30,66660,36360,103020
412170,202202,714,476,238,578124,289668,867792
412175,202202,36,26,10,31512,12120,43632
412180,202202,188,138,50,167256.8,60600,227856.8
412190,202202,316,245,71,296940,86052,382992
412200,202202,188,115,73,139380,88476,227856
412210,202202,94,71,23,86052,27876,113928
412215,202202,234,155,79,187860,95748,283608
412217,202202,66,55,11,66660,13332,79992
412220,202202,822,544,278,659328,336936,996264
412230,202202,296,177,119,215736,144228,359964
412240,202202,1326,643,683,779316.8,829008.6,1608325.4
412250,202202,404,246,158,298152,191496,489648
412260,202202,118,76,42,92112,50904,143016
412265,202202,169,127,42,153924,50904,204828
412270,202202,92,56,36,67872,43632,111504
412280,202202,88,69,19,83628,23028,106656
412290,202202,87,55,32,66660,38784,105444
412300,202202,204,142,62,172104,75144,247248
412310,202202,55,44,11,53328,13332,66660
412320,202202,87,68,19,82416,23028,105444
412330,202202,184,149,35,180588,42420,223008
412340,202202,170,112,58,135744,70296,206040
412350,202202,640,295,345,357540,419352,776892
412360,202202,23,20,3,24240,3636,27876
412370,202202,147,124,23,150288.6,27876,178164.6
412380,202202,204,156,48,189072,59388,248460
412382,202202,63,34,29,41208,35148,76356
412385,202202,152,108,44,130896,53328,184224
412390,202202,305,229,76,277548,92112,369660
412395,202202,62,49,13,59388,15756,75144
412400,202202,98,66,32,79992,39996,119988
412402,202202,239,120,119,145440.6,145440,290880.6
412405,202202,939,311,628,378144,762348,1140492
412410,202202,963,576,387,697520.6,469044,1166564.6
412420,202202,16,16,0,19392,,19392.0
412430,202202,24,22,2,26664,2424,29088
412440,202202,657,331,326,401172,396324,797496
412450,202202,71,62,9,75144,10908,86052
412460,202202,89,68,21,82416,25452,107868
412470,202202,210,164,46,198768,55752,254520
412480,202202,147,104,43,126048,52116,178164
412490,202202,161,136,25,164832,30300,195132
412500,202202,407,321,86,389053.16,104232,493285.16
412510,202202,168,140,28,169680,33936,203616
412520,202202,93,59,34,71508,41208,112716
412530,202202,106,52,54,63024,65448,128472
412535,202202,90,69,21,83628,25452,109080
412540,202202,83,39,44,47268,53328,100596
412545,202202,80,54,26,65448,31512,96960
412550,202202,4004,1598,2406,1939200,2922132.6,4861332.6
412555,202202,10,6,4,7272,4848,12120
412560,202202,656,437,219,529645.2,266640,796285.2
412570,202202,806,385,421,466620,511464,978084
412575,202202,92,64,28,77568.94,33936,111504.94
412580,202202,172,114,58,138168,70296,208464
412590,202202,31,28,3,33936,3636,37572
412600,202202,176,119,57,144228,69084,213312
412610,202202,36,15,21,18180,25452,43632
412620,202202,137,114,23,138168,27876,166044
412625,202202,2104,1034,1070,1254421.61,1298052.96,2552474.57
412627,202202,64,47,17,56964,20604,77568
412630,202202,385,257,128,311484,155136,466620
412635,202202,74,21,53,25452,64236,89688
412640,202202,105,73,32,89688,38784,128472
412650,202202,325,214,111,259368,134532,393900
412660,202202,450,263,187,319968,227856,547824
412665,202202,42,38,4,46056,4848,50904
412667,202202,291,188,103,229068,124836,353904
412670,202202,73,59,14,71508,16968,88476
412680,202202,333,254,79,307848,95748.12,403596.12
412690,202202,124,81,43,98172,52116,150288
412700,202202,189,126,63,152712,76356,229068
412710,202202,1329,748,581,906577.56,705384,1611961.56
412720,202202,227,124,103,150288,124836,275124
412730,202202,205,173,32,210888,39996,250884
412740,202202,421,213,208,258156,252096,510252
412750,202202,431,232,199,281184,242400,523584
412760,202202,333,165,168,199980,203616,403596
412770,202202,2097,1125,972,1365925.95,1179276.6,2545202.55
412780,202202,143,104,39,127260,47268,174528
412785,202202,312,155,157,187860,190284,378144
412788,202202,47,27,20,32724,24240,56964
412790,202202,123,101,22,123624,26664,150288
412795,202202,150,103,47,124836,56964,181800
412796,202202,291,183,108,224220,132108,356328
412800,202202,665,394,271,477528,329664,807192
412810,202202,3064,1665,1399,2022829,1695588,3718417
412820,202202,958,574,384,696902.48,465408,1162310.48
412830,202202,13,11,2,13332,2424,15756
412840,202202,264,178,86,215736.6,104232,319968.6
412850,202202,698,433,265,524796,322392,847188
412853,202202,161,75,86,90900,104232,195132
412855,202202,197,106,91,128472.91,110292,238764.91
412860,202202,95,62,33,75144,39996,115140
412862,202202,79,50,29,60600,35148,95748
412863,202202,8,6,2,7272,2424,9696
412865,202202,45,34,11,41208,13332,54540
412870,202202,110,64,46,77568,55752,133320
412880,202202,91,63,28,76356.6,33936,110292.6
420005,202202,38,34,4,41208,4848,46056
420010,202202,367,240,127,290880,153924,444804
420020,202202,93,74,19,89688,23028,112716
420030,202202,27,22,5,26664,6060,32724
420040,202202,94,71,23,86052,27876,113928
420050,202202,58,36,22,43632,26664,70296
420055,202202,18,17,1,20604,1212,21816
420060,202202,25,18,7,21816,8484,30300
420070,202202,98,83,15,100596,18180,118776
420075,202202,9,9,0,10908,,10908.0
420080,202202,40,34,6,41208,7272,48480
420090,202202,38,31,7,37572,8484,46056
420100,202202,144,121,23,146652.6,29088,175740.6
420110,202202,21,21,0,25452,,25452.0
420120,202202,54,37,17,44844,20604,65448
420125,202202,87,69,18,83628,21816,105444
420127,202202,36,30,6,36360,7272,43632
420130,202202,454,269,185,326028,224220,550248
420140,202202,1310,720,590,873852.2,715080.6,1588932.8
420150,202202,43,35,8,42420,9696,52116
420160,202202,29,27,2,32724,2424,35148
420165,202202,15,10,5,12120,6060,18180
420170,202202,68,42,26,50904,31512,82416
420180,202202,22,19,3,23028,3636,26664
420190,202202,25,22,3,26664,3636,30300
420195,202202,150,67,83,81204.6,100596,181800.6
420200,202202,1310,544,766,660541.2,929604,1590145.2
420205,202202,102,60,42,72720,50904,123624
420207,202202,137,74,63,89688,76356,166044
420208,202202,19,15,4,18180,4848,23028
420209,202202,12,10,2,12120,2424,14544
420210,202202,565,265,300,321180,363600,684780
420213,202202,51,39,12,47268,14544,61812
420215,202202,26,22,4,26664,4848,31512
420220,202202,60,38,22,46056.6,26664,72720.6
420230,202202,921,551,370,669024.6,448440,1117464.6
420240,202202,2235,1459,776,1768309.8,941724.6,2710034.4
420243,202202,44,35,9,42420,10908,53328
420245,202202,201,98,103,118776,124836,243612
420250,202202,62,42,20,50904,24240,75144
420253,202202,25,19,6,23028,7272,30300
420257,202202,13,9,4,10908,4848,15756
420260,202202,111,88,23,106656,27876,134532
420270,202202,31,24,7,29088,8484,37572
420280,202202,270,202,68,247248,82416.8,329664.8
420285,202202,25,18,7,21816,8484,30300
420287,202202,50,33,17,39996,20604,60600
420290,202202,920,629,291,763560,353904,1117464
420300,202202,1502,1191,311,1449555.37,376933.44,1826488.81
420310,202202,46,31,15,37572,18180,55752
420315,202202,31,24,7,29088,8484,37572
420320,202202,972,453,519,550248,630240,1180488
420325,202202,6,4,2,4848,2424,7272
420330,202202,120,78,42,94536,50904,145440
420340,202202,182,123,59,149076.8,71508,220584.8
420350,202202,254,174,80,210888,96960,307848
420360,202202,697,532,165,645996.76,199980,845976.76
420370,202202,130,72,58,87264,70296,157560
420380,202202,1202,832,370,1009597.81,449652,1459249.81
420390,202202,230,160,70,193920,84840,278760
420395,202202,188,137,51,166044,61812,227856
420400,202202,228,173,55,209676.8,66660,276336.8
420410,202202,54,40,14,48480,16968,65448
420415,202202,33,28,5,33936,6060,39996
420417,202202,55,44,11,53328,13332,66660
420419,202202,9,8,1,9696,1212,10908
420420,202202,2799,1732,1067,2099186.95,1294417.2,3393604.15
420425,202202,67,52,15,63024,18180,81204
420430,202202,1073,773,300,938089.4,364812,1302901.4
420435,202202,14,12,2,14544,2424,16968
420440,202202,94,66,28,79992.6,33936,113928.6
420445,202202,31,28,3,33936,3636,37572
420450,202202,83,42,41,50904,49692,100596
420455,202202,189,148,41,179376,49692,229068
420460,202202,2301,1441,860,1748918.24,1042320,2791238.24
420470,202202,91,62,29,75144,35148,110292
420475,202202,9,8,1,9696,1212,10908
420480,202202,861,648,213,785378.22,258156,1043534.22
420490,202202,93,69,24,83628,29088,112716
420500,202202,424,233,191,282396.71,231492,513888.71
420510,202202,25,21,4,25452,4848,30300
420515,202202,30,16,14,19392,16968,36360
420517,202202,6,6,0,7272,,7272.0
420519,202202,0,,,,,0.0
420520,202202,63,47,16,56964,19392,76356
420530,202202,143,92,51,111504,61812,173316
420535,202202,16,14,2,16968,2424,19392
420540,202202,6116,3794,2322,4601061.63,2817901.2,7418962.83
420543,202202,30,28,2,33936,2424,36360
420545,202202,212,147,65,178164,78780,256944
420550,202202,778,645,133,781741.24,161196,942937.24
420555,202202,26,19,7,23028,8484,31512
420560,202202,56,45,11,54540,13332,67872
420570,202202,181,94,87,115140,105444,220584
420580,202202,296,146,150,176952,181800.6,358752.6
420590,202202,472,302,170,367236,207252,574488
420600,202202,146,78,68,94536,82416,176952
420610,202202,38,35,3,42420,3636,46056
420620,202202,78,57,21,69084,25452,94536
420630,202202,149,98,51,118776,61812,180588
420640,202202,69,60,9,72720,10908,83628
420650,202202,267,143,124,173316,150288,323604
420660,202202,41,33,8,39996,9696,49692
420665,202202,44,28,16,33936,19392,53328
420670,202202,248,194,54,235128,65448,300576
420675,202202,15,13,2,15756,2424,18180
420680,202202,32,25,7,30300,8484,38784
420690,202202,186,143,43,173316,52116,225432
420700,202202,702,455,247,551460.72,299364,850824.72
420710,202202,148,76,72,92112,87264,179376
420720,202202,101,81,20,98172,24240,122412
420730,202202,683,409,274,495710.04,333300.6,829010.64
420740,202202,54,54,0,65448,,65448.0
420750,202202,481,314,167,380568.6,202404,582972.6
420757,202202,18,16,2,19392,2424,21816
420760,202202,37,29,8,35148,9696,44844
420765,202202,76,55,21,67872,25452,93324
420768,202202,54,43,11,52116,13332,65448
420770,202202,75,63,12,76356,14544,90900
420775,202202,37,34,3,41208,3636,44844
420780,202202,202,159,43,193920.8,52116,246036.8
420785,202202,21,13,8,15756,9696,25452
420790,202202,140,116,24,141804,29088,170892
420800,202202,59,44,15,53328,18180,71508
420810,202202,271,221,50,267852,60600,328452
420820,202202,2438,1343,1095,1628929.2,1329565.26,2958494.46
420830,202202,646,332,314,402385.2,380568,782953.2
420840,202202,140,97,43,117564,52116,169680
420845,202202,439,184,255,223008,309060,532068
420850,202202,267,202,65,244824,78780,323604
420860,202202,60,51,9,61812,10908,72720
420870,202202,128,88,40,106656,48480,155136
420880,202202,187,121,66,146652,79992,226644
420890,202202,947,453,494,549036.6,598728,1147764.6
420895,202202,8,8,0,9696,,9696.0
420900,202202,415,332,83,402384,100596,502980
420910,202202,5746,3091,2655,3748760.55,3222709.94,6971470.49
420915,202202,61,55,6,66660,7272,73932
420917,202202,19,15,4,18180,4848,23028
420920,202202,20,14,6,16968,7272,24240
420930,202202,3062,1953,1109,2368172.6,1346532.6,3714705.2
420940,202202,585,420,165,510252.6,199980.64,710233.24
420945,202202,11,8,3,9696,3636,13332
420950,202202,48,38,10,46056,12120,58176
420960,202202,110,91,19,111504,23028,134532
420970,202202,279,223,56,270277,67872,338149
420980,202202,20,19,1,23028,1212,24240
420985,202202,54,48,6,58176,7272,65448
420990,202202,80,61,19,73932,23028,96960
421000,202202,54,29,25,35148,30300,65448
421003,202202,38,26,12,31512,14544,46056
421005,202202,8,5,3,6060,3636,9696
421010,202202,816,533,283,647209.4,344208.8,991418.2
421020,202202,20,16,4,19392,4848,24240
421030,202202,112,96,16,116352.2,19392,135744.2
421040,202202,72,50,22,60600,26664,87264
421050,202202,335,235,100,286033.2,121200,407233.2
421055,202202,18,14,4,16968,4848,21816
421060,202202,105,58,47,70296,56964,127260
421070,202202,40,33,7,39996.6,8484,48480.6
421080,202202,38,33,5,39996,6060,46056
421085,202202,17,14,3,16968,3636,20604
421090,202202,36,29,7,35148,8484,43632
421100,202202,114,85,29,103020,35148,138168
421105,202202,188,153,35,185436,42420,227856
421110,202202,112,82,30,99384,36360,135744
421120,202202,173,125,48,151500.6,58176,209676.6
421125,202202,18,10,8,12120,9696,21816
421130,202202,825,503,322,609636,391476.6,1001112.6
421140,202202,33,23,10,27876,12120,39996
421145,202202,47,37,10,46056,12120,58176
421150,202202,90,70,20,86052,24240,110292
421160,202202,62,39,23,47268,27876,75144
421165,202202,16,12,4,14544,4848,19392
421170,202202,168,139,29,168614,35148,203762
421175,202202,181,124,57,150288,69084,219372
421180,202202,43,30,13,36360.56,15756,52116.56
421185,202202,14,11,3,13332,3636,16968
421187,202202,3,2,1,2424,1212,3636
421189,202202,43,30,13,36360,15756,52116
421190,202202,1858,1167,691,1415617.8,837492.55,2253110.35
421200,202202,92,63,29,76356,35148,111504
421205,202202,28,20,8,24240,9696,33936
421210,202202,175,126,49,152712,59388,212100
421220,202202,248,195,53,237552,64236,301788
421223,202202,49,39,10,47268.4,12120,59388.4
421225,202202,69,44,25,53328,30300,83628
421227,202202,74,59,15,71508,18180,89688
421230,202202,67,46,21,55752,25452,81204
421240,202202,15,15,0,18180,,18180.0
421250,202202,374,217,157,263004.2,190284,453288.2
421260,202202,22,18,4,21816,4848,26664
421265,202202,4,3,1,3636,1212,4848
421270,202202,51,45,6,54540,7272,61812
421280,202202,353,177,176,214524,213312,427836
421290,202202,309,204,105,247248,127260.6,374508.6
421300,202202,23,19,4,23028,4848,27876
421310,202202,52,35,17,42420,20604,63024
421315,202202,33,21,12,25452,14544,39996
421320,202202,134,87,47,105444,56964,162408
421330,202202,108,81,27,98172,32724,130896
421335,202202,43,31,12,37572,14544,52116
421340,202202,242,158,84,191496.8,101808,293304.8
421350,202202,183,106,77,128472.85,93324,221796.85
421360,202202,699,488,211,592668,255732,848400
421370,202202,190,138,52,168468,63024.6,231492.6
421380,202202,141,107,34,132108,41208,173316
421390,202202,16,10,6,12120,7272,19392
421400,202202,118,97,21,117564,25452,143016
421410,202202,21,18,3,21816,3636,25452
421415,202202,20,17,3,20604,3636,24240
421420,202202,102,88,14,106656,16968,123624
421430,202202,17,12,5,14544,6060,20604
421440,202202,61,52,9,63024,10908,73932
421450,202202,89,73,16,88476,19392.44,107868.44
421460,202202,58,44,14,53328,16968,70296
421470,202202,72,41,31,49692,37572,87264
421480,202202,742,560,182,678720.6,220584,899304.6
421490,202202,25,24,1,29088,1212,30300
421500,202202,470,283,187,342996.6,227856.77,570853.37
421505,202202,28,21,7,25452,8484,33936
421507,202202,30,24,6,29088,7272,36360
421510,202202,70,44,26,54540,31512,86052
421520,202202,51,43,8,53328,10908,64236
421530,202202,50,40,10,48480,12120,60600
421535,202202,20,19,1,23028,1212,24240
421540,202202,51,40,11,48480,13332,61812
421545,202202,84,61,23,73932,27876,101808
421550,202202,286,203,83,246036.96,100596,346632.96
421555,202202,18,15,3,18180,3636,21816
421560,202202,9,8,1,9696,1212,10908
421565,202202,121,79,42,95748,50904,146652
421567,202202,33,27,6,32724,7272,39996
421568,202202,44,41,3,49692,3636,53328
421569,202202,11,11,0,13332,,13332.0
421570,202202,221,145,76,175740,92112,267852
421575,202202,26,23,3,27876,3636,31512
421580,202202,702,410,292,498211,353904.6,852115.6
421590,202202,18,17,1,21816,1212,23028
421600,202202,152,102,50,123624.6,60600,184224.6
421605,202202,103,70,33,84840.2,39996,124836.2
421610,202202,165,125,40,151500,48480,199980
421620,202202,1024,579,445,701748,539340.8,1241088.8
421625,202202,21,19,2,23028,2424,25452
421630,202202,339,203,136,246036.6,164833.2,410869.8
421635,202202,20,9,11,10908,13332,24240
421640,202202,101,83,18,100596.4,21816,122412.4
421650,202202,295,172,123,208464.6,149076,357540.6
421660,202202,2461,1484,977,1801034.4,1186548,2987582.4
421670,202202,168,118,50,143016,60600,203616
421680,202202,189,171,18,207252,21816,229068
421690,202202,342,233,109,282397.4,132108.36,414505.76
421700,202202,58,40,18,48480,21816.2,70296.2
421710,202202,18,18,0,21816,,21816.0
421715,202202,5,4,1,4848,1212,6060
421720,202202,629,433,196,524796,237552,762348
421725,202202,24,9,15,10908,18180,29088
421730,202202,25,18,7,21816,8484,30300
421740,202202,105,38,67,46056,81204,127260
421750,202202,197,144,53,174528,64236,238764
421755,202202,18,16,2,21816,2424,24240
421760,202202,99,68,31,82416,37572,119988
421770,202202,695,445,250,539341.6,304212,843553.6
421775,202202,30,19,11,23028,13332,36360
421780,202202,176,140,36,169680,43632,213312
421790,202202,150,129,21,156348,25452,181800
421795,202202,17,14,3,16968,3636,20604
421800,202202,532,326,206,395112,249672,644784
421810,202202,68,56,12,67872,14544,82416
421820,202202,306,192,114,232705.4,139380,372085.4
421825,202202,154,126,28,152712,33936,186648
421830,202202,147,89,58,107868.5,71508,179376.5
421835,202202,7,2,5,2424,6060,8484
421840,202202,46,39,7,47268,8484,55752
421850,202202,81,69,12,83628,14544,98172
421860,202202,39,28,11,33936,13332,47268
421870,202202,1026,743,283,902942,342996,1245938
421875,202202,53,42,11,50904,13332,64236
421880,202202,183,124,59,150288,71508,221796
421885,202202,26,19,7,23028,8484,31512
421890,202202,137,96,41,116352,49692.1,166044.1
421895,202202,43,37,6,46056,7272,53328
421900,202202,132,100,32,121200,38784,159984
421910,202202,65,43,22,52116,26664,78780
421915,202202,34,28,6,33936,7272,41208
421917,202202,38,28,10,33936,12120,46056
421920,202202,36,32,4,38784,4848,43632
421930,202202,614,486,128,590244.8,155136,745380.8
421935,202202,46,39,7,47268,8484,55752
421940,202202,52,44,8,53328.4,9696,63024.4
421950,202202,870,575,295,696900.8,358752.4,1055653.2
421960,202202,40,34,6,41208,7272,48480
421970,202202,324,209,115,254520,139380,393900
421985,202202,19,12,7,14544,8484,23028
422000,202202,2,2,0,2424,,2424.0
430003,202202,189,53,136,64236,164832,229068
430005,202202,33,24,9,29088,10908,39996
430010,202202,252,179,73,216948,88476,305424
430020,202202,143,97,46,117564.6,55752,173316.6
430030,202202,117,99,18,119988,21816,141804
430040,202202,2909,1715,1194,2082216.6,1449552.6,3531769.2
430045,202202,72,62,10,75144,12120,87264
430047,202202,7,5,2,6060,2424,8484
430050,202202,83,71,12,86052,14544,100596
430055,202202,12,11,1,13332,1212,14544
430057,202202,5,4,1,4848,1212,6060
430060,202202,3924,2270,1654,2754878.12,2007072.4,4761950.52
430063,202202,52,43,9,52116,10908,63024
430064,202202,163,126,37,152712,44844,197556
430066,202202,6,3,3,3636,3636,7272
430070,202202,44,33,11,39996,13332,53328
430080,202202,78,49,29,59388,35148,94536
430085,202202,29,14,15,16968,18180,35148
430087,202202,24,17,7,20604.8,8484,29088.8
430090,202202,63,53,10,64236,12120,76356
430100,202202,137,94,43,113928.6,52116,166044.6
430105,202202,148,84,64,101808,77568,179376
430107,202202,18,13,5,15756,6060,21816
430110,202202,489,267,222,323604,269064,592668
430120,202202,162,145,17,176952,20604,197556
430130,202202,781,472,309,572064,374508,946572
430140,202202,128,116,12,140592,14544,155136
430150,202202,102,64,38,77568,46056,123624
430155,202202,29,24,5,29088,6060,35148
430160,202202,3599,2068,1531,2507630.6,1859208.6,4366839.2
430163,202202,405,182,223,220584,270276,490860
430165,202202,32,20,12,24240,14544,38784
430170,202202,81,67,14,81204,16968,98172
430175,202202,80,61,19,73932,23028,96960
430180,202202,104,85,19,103020,23028,126048
430185,202202,28,19,9,23028,10908,33936
430187,202202,52,28,24,33936,29088,63024
430190,202202,227,118,109,143016,132108,275124
430192,202202,16,12,4,14544,4848,19392
430195,202202,17,11,6,13332,7272,20604
430200,202202,151,129,22,156348,27876.04,184224.04
430205,202202,19,19,0,23028,,23028.0
430210,202202,717,543,174,658116,210888,869004
430215,202202,11,10,1,12120,1212,13332
430220,202202,72,49,23,59388,27876,87264
430222,202202,12,4,8,4848,9696,14544
430223,202202,16,10,6,12120,7272,19392
430225,202202,2,1,1,1212,1212,2424
430230,202202,317,193,124,233916,150288,384204
430235,202202,45,31,14,37572,16968,54540
430237,202202,19,14,5,16968,6060,23028
430240,202202,108,75,33,90900,39996,130896
430245,202202,67,54,13,65448,15756,81204
430250,202202,187,107,80,129684,96960,226644
430258,202202,8,7,1,8484,1212,9696
430260,202202,34,28,6,33936,7272,41208
430265,202202,35,30,5,36360,6060,42420
430270,202202,517,372,145,450864.2,176952,627816.2
430280,202202,1065,626,439,759925.2,532068,1291993.2
430290,202202,424,217,207,263004,250884,513888
430300,202202,2107,1125,982,1363500.6,1192609.6,2556110.2
430310,202202,2060,1009,1051,1222908.6,1275026.72,2497935.32
430320,202202,57,48,9,58176,10908,69084
430330,202202,90,78,12,94536,14544,109080
430340,202202,66,53,13,64236,15756,79992
430350,202202,1667,1092,575,1323504,698112.6,2021616.6
430355,202202,20,18,2,21816,2424,24240
430360,202202,89,43,46,52116,55752,107868
430367,202202,40,30,10,36360,12120,48480
430370,202202,54,48,6,58176,7272,65448
430380,202202,116,88,28,107868,33936,141804
430390,202202,576,354,222,429048,269064,698112
430400,202202,257,181,76,219372.6,93324,312696.6
430410,202202,59,47,12,56964.69,14544,71508.69
430420,202202,511,321,190,389052.2,230280,619332.2
430430,202202,51,49,2,58580.8,2424,61004.8
430435,202202,138,104,34,126048,41208,167256
430440,202202,534,329,205,398748.4,250884,649632.4
430450,202202,1187,968,219,1173216.6,265428,1438644.6
430460,202202,5657,2881,2776,3495410.24,3371784.6,6867194.84
430461,202202,16,14,2,16968,2424,19392
430462,202202,5,3,2,3636,2424,6060
430463,202202,1150,620,530,751440,642360,1393800
430465,202202,25,14,11,16968,13332,30300
430466,202202,649,451,198,549036.6,239976,789012.6
430467,202202,122,71,51,86052,61812,147864
430468,202202,138,79,59,95748,71508,167256
430469,202202,19,15,4,18180,4848,23028
430470,202202,1139,624,515,757860.7,624180,1382040.7
430471,202202,63,41,22,49692,26664,76356
430480,202202,114,78,36,94536,43632,138168
430485,202202,8,8,0,9696.6,,9696.6
430490,202202,75,60,15,72720,18180,90900
430495,202202,32,24,8,29088,9696,38784
430500,202202,185,125,60,151500,72720,224220
430510,202202,3666,2372,1294,2878502.55,1570752,4449254.55
430511,202202,14,14,0,16968,,16968.0
430512,202202,152,104,48,126048,58176,184224
430513,202202,50,39,11,47268,13332,60600
430515,202202,25,24,1,29088,1212,30300
430517,202202,177,147,30,178164,36360,214524
430520,202202,336,239,97,290880,117564,408444
430530,202202,79,45,34,54540,41208,95748
430535,202202,443,292,151,353904,183012,536916
430537,202202,10,10,0,12120,,12120.0
430540,202202,79,52,27,63024,32724,95748
430543,202202,379,118,261,143016,316332,459348
430544,202202,46,42,4,50904,4848,55752
430545,202202,393,181,212,219372.4,256944,476316.4
430550,202202,44,35,9,42420,10908,53328
430558,202202,2,2,0,2424,,2424.0
430560,202202,55,31,24,37572,29088,66660
430570,202202,117,49,68,59388,82416,141804
430580,202202,124,99,25,119988,30300,150288
430583,202202,15,15,0,18180,,18180.0
430585,202202,12,8,4,9696,4848,14544
430587,202202,13,8,5,9696,6060,15756
430590,202202,161,128,33,155136,39996,195132
430593,202202,2,2,0,2424,,2424.0
430595,202202,16,13,3,15756,3636,19392
430597,202202,46,26,20,31512,24240,55752
430600,202202,219,166,53,201192,64236,265428
430605,202202,166,95,71,115140,86052,201192
430607,202202,29,23,6,27876,7272,35148
430610,202202,1714,806,908,978084,1100496.6,2078580.6
430613,202202,6,6,0,7272,,7272.0
430620,202202,97,70,27,84840,32724,117564
430630,202202,45,38,7,46056,8484,54540
430632,202202,30,25,5,30300,6060,36360
430635,202202,40,32,8,38784,9696,48480
430637,202202,66,33,33,39996,39996,79992
430640,202202,178,100,78,121200,94536,215736
430642,202202,18,15,3,18180,3636,21816
430645,202202,29,25,4,30300,4848,35148
430650,202202,247,197,50,238764.6,60600,299364.6
430655,202202,5,4,1,4848,1212,6060
430660,202202,966,469,497,568428,603576,1172004
430670,202202,71,48,23,58176,27876,86052
430673,202202,82,52,30,63024,36360,99384
430675,202202,8,6,2,7272,2424,9696
430676,202202,582,343,239,415716,290880,706596
430680,202202,241,159,82,192708.6,99384,292092.6
430690,202202,528,319,209,386628,253308.95,639936.95
430692,202202,9,7,2,8484,2424,10908
430693,202202,140,88,52,106656,63024,169680
430695,202202,65,54,11,65448,13332,78780
430697,202202,64,40,24,48480,29088,77568
430700,202202,1388,936,452,1135644.6,549036,1684680.6
430705,202202,29,26,3,31512,3636,35148
430710,202202,254,157,97,190284,117564,307848
430720,202202,109,92,17,111504,20604,132108
430730,202202,143,121,22,146652,26664,173316
430740,202202,76,50,26,60600,31512,92112
430745,202202,31,20,11,24240,13332,37572
430750,202202,331,215,116,260580,140592,401172
430755,202202,87,46,41,55752,49692,105444
430760,202202,390,214,176,259368.76,214524,473892.76
430770,202202,1573,820,753,995052.6,913848.4,1908901.0
430780,202202,318,199,119,241188,144228,385416
430781,202202,25,23,2,27876,2424,30300
430783,202202,64,50,14,60600,16968,77568
430786,202202,5,3,2,3636,2424,6060
430790,202202,523,329,194,401172,235128,636300
430800,202202,151,119,32,144228.61,38784,183012.61
430805,202202,37,30,7,36360,8484,44844
430807,202202,58,32,26,38784,31512,70296
430810,202202,73,47,26,56964,31512,88476
430820,202202,149,94,55,113928,66660,180588
430825,202202,12,9,3,10908,3636,14544
430830,202202,242,224,18,271488.6,21816,293304.6
430840,202202,136,89,47,107868,56964,164832
430843,202202,6,4,2,4848,2424,7272
430845,202202,73,41,32,49692,38784,88476
430850,202202,583,415,168,505404,203616,709020
430860,202202,158,101,57,122412,69084,191496
430865,202202,77,39,38,47268,46056,93324
430870,202202,73,59,14,72720.6,16968,89688.6
430880,202202,160,117,43,141804,52116,193920
430885,202202,11,10,1,12120,1212,13332
430890,202202,333,198,135,239976,163620,403596
430900,202202,526,361,165,437532,201192,638724
430905,202202,125,54,71,65448,86052,151500
430910,202202,278,152,126,184224.6,152712,336936.6
430912,202202,4,4,0,4848,,4848.0
430915,202202,38,35,3,42420,3636,46056
430920,202202,4511,2370,2141,2872440,2594892,5467332
430925,202202,5,4,1,4848,1212,6060
430930,202202,2054,1179,875,1428949.4,1061712,2490661.4
430940,202202,248,155,93,187860,112716,300576
430950,202202,151,125,26,151500,31512,183012
430955,202202,25,14,11,16968,13332,30300
430957,202202,23,20,3,25452,3636,29088
430960,202202,243,158,85,191496,103020,294516
430965,202202,103,66,37,79992,44844,124836
430970,202202,90,73,17,88476,20604,109080
430975,202202,46,40,6,48480,7272,55752
430980,202202,51,32,19,38784,23028,61812
430990,202202,98,75,23,90900,27876,118776
430995,202202,115,106,9,128472,10908,139380
431000,202202,296,150,146,181800.6,176952,358752.6
431010,202202,352,202,150,244824.6,181800,426624.6
431020,202202,1880,1091,789,1324716,958692.6,2283408.6
431030,202202,38,30,8,36360,9696,46056
431033,202202,445,203,242,246036,293304,539340
431036,202202,14,8,6,9696,7272,16968
431040,202202,141,89,52,109080,63024,172104
431041,202202,39,22,17,26664,20604,47268
431043,202202,38,22,16,26664,20604,47268
431046,202202,13,10,3,12120,3636,15756
431050,202202,204,126,78,152712,94536,247248
431053,202202,69,37,32,44844,38784,83628
431055,202202,66,44,22,53328,26664,79992
431057,202202,17,17,0,20604,,20604.0
431060,202202,1564,1008,556,1221696.98,675084,1896780.98
431065,202202,15,8,7,9696,8484,18180
431070,202202,60,52,8,63024,9696,72720
431075,202202,7,7,0,8484,,8484.0
431080,202202,129,75,54,90900,65448,156348
431085,202202,34,30,4,36360,4848,41208
431087,202202,14,11,3,13332,3636,16968
431090,202202,50,37,13,44844,15756,60600
431100,202202,1246,743,503,900516,609636,1510152
431110,202202,215,129,86,156348,104232,260580
431112,202202,26,20,6,24240,7272,31512
431113,202202,31,23,8,27876,9696,37572
431115,202202,156,110,46,133320,55752,189072
431120,202202,593,340,253,413292,307848,721140
431123,202202,5,5,0,6060,,6060.0
431125,202202,98,85,13,103020,15756,118776
431127,202202,5,3,2,3636,2424,6060
431130,202202,722,472,250,572064.6,304212,876276.6
431140,202202,784,543,241,659328.6,293304,952632.6
431142,202202,20,18,2,21816.84,2424,24240.84
431150,202202,199,149,50,180588,60600,241188
431160,202202,46,43,3,52116,3636,55752
431162,202202,3,3,0,3636,,3636.0
431164,202202,4,4,0,4848,,4848.0
431170,202202,113,82,31,99384,37572,136956
431171,202202,70,40,30,48480,36360,84840
431173,202202,3,2,1,2424,1212,3636
431175,202202,207,109,98,132108.6,118776,250884.6
431177,202202,90,64,26,77568,31512,109080
431179,202202,15,11,4,13332,4848,18180
431180,202202,402,253,149,306636,181800,488436
431190,202202,75,55,20,66660,24240,90900
431198,202202,66,46,20,55752,24240,79992
431200,202202,20,16,4,19392,4848,24240
431205,202202,21,19,2,23028,2424,25452
431210,202202,103,67,36,81204,43632,124836
431213,202202,33,27,6,32724,7272,39996
431215,202202,24,21,3,25452,3636,29088
431217,202202,6,5,1,6060,1212,7272
431220,202202,68,58,10,70296,12120,82416
431225,202202,164,104,60,127260,72720,199980
431230,202202,96,83,13,100596,15756,116352
431235,202202,5,5,0,6060,,6060.0
431237,202202,12,9,3,10908,3636,14544
431238,202202,12,9,3,10908,3636,14544
431240,202202,1083,664,419,805981.2,507828,1313809.2
431242,202202,40,39,1,47268,1212,48480
431244,202202,19,15,4,18180,4848,23028
431245,202202,51,37,14,44844,16968,61812
431247,202202,10,6,4,7272,4848,12120
431250,202202,285,141,144,170892,174528,345420
431260,202202,54,46,8,55752,9696,65448
431261,202202,17,12,5,14544,6060,20604
431262,202202,15,13,2,15756,2424,18180
431265,202202,154,82,72,99384,87264,186648
431267,202202,18,16,2,19392,2424,21816
431270,202202,329,256,73,310272,88476,398748
431275,202202,40,35,5,42420,6060,48480
431280,202202,18,14,4,16968,4848,21816
431290,202202,18,16,2,19392,2424,21816
431295,202202,2,1,1,1212,1212,2424
431300,202202,19,17,2,20604,2424,23028
431301,202202,6,6,0,7272,,7272.0
431303,202202,56,36,20,43632,24240,67872
431306,202202,241,125,116,151500,140592,292092
431308,202202,6,4,2,4848,2424,7272
431310,202202,65,52,13,63024,15756,78780
431320,202202,175,106,69,128472.6,83628,212100.6
431330,202202,196,124,72,150288,87264,237552
431333,202202,28,22,6,26664,7272,33936
431335,202202,7,4,3,4848,3636,8484
431337,202202,390,182,208,220584.6,252096,472680.6
431339,202202,21,16,5,19392,6060,25452
431340,202202,3133,1702,1431,2065153.45,1736797.54,3801950.99
431342,202202,36,24,12,29088.6,14544,43632.6
431344,202202,18,18,0,21816,,21816.0
431346,202202,5,4,1,4848,1212,6060
431349,202202,33,29,4,35148,4848,39996
431350,202202,1006,551,455,667813.6,551460,1219273.6
431360,202202,52,40,12,48480,14544,63024
431365,202202,348,146,202,176952,247248,424200
431370,202202,1184,678,506,822948.6,613272,1436220.6
431380,202202,96,86,10,104232,12120,116352
431390,202202,505,274,231,332088,281184,613272
431395,202202,324,135,189,163620,229068,392688
431400,202202,37,23,14,27876,16968,44844
431402,202202,99,71,28,86052,33936,119988
431403,202202,24,16,8,19392,9696,29088
431405,202202,702,393,309,476316,374508,850824
431406,202202,36,28,8,33936,9696,43632
431407,202202,47,36,11,43632,13332,56964
431410,202202,3415,2065,1350,2506417.64,1638624.2,4145041.84
431413,202202,17,14,3,16968,3636,20604
431415,202202,69,49,20,59388,24240,83628
431417,202202,23,11,12,13332,15756,29088
431420,202202,344,230,114,278760,138168,416928
431430,202202,59,30,29,36360,35148,71508
431440,202202,9011,6141,2870,7447750.64,3480921.75,10928672.39
431442,202202,27,14,13,16968,15756,32724
431445,202202,27,25,2,30300,2424,32724
431446,202202,3,2,1,2424,1212,3636
431447,202202,83,60,23,72720,27876,100596
431449,202202,54,42,12,50904,14544,65448
431450,202202,406,268,138,324816.6,167256,492072.6
431454,202202,12,7,5,8484,6060,14544
431455,202202,46,36,10,43632,12120,55752
431460,202202,496,339,157,410868,190284,601152
431470,202202,131,97,34,117564,41208,158772
431475,202202,9,7,2,8484,2424,10908
431477,202202,39,24,15,29088,18180,47268
431478,202202,7,7,0,8484,,8484.0
431480,202202,574,345,229,419352,278760.6,698112.6
431490,202202,28897,16021,12876,19434349.12,15640867.4,35075216.52
431500,202202,77,59,18,71508,21816,93324
431505,202202,31,20,11,24240,13332,37572
431507,202202,10,8,2,9696,2424,12120
431510,202202,231,170,61,206040.4,73932,279972.4
431513,202202,21,20,1,24240,1212,25452
431514,202202,5,3,2,3636,2424,6060
431515,202202,83,69,14,83628,16968,100596
431517,202202,7,4,3,4848,3636,8484
431520,202202,38,33,5,39996,6060,46056
431530,202202,1396,622,774,753864,938088,1691952
431531,202202,21,19,2,23028,2424,25452
431532,202202,35,26,9,31512,10908,42420
431535,202202,28,14,14,16968,16968,33936
431540,202202,135,111,24,134532,29088.6,163620.6
431545,202202,12,10,2,12120,2424,14544
431550,202202,358,191,167,231492,202404,433896
431555,202202,10,10,0,12120,,12120.0
431560,202202,4688,3127,1561,3789929.96,1896780,5686709.96
431570,202202,825,429,396,519949.2,479952.8,999902.0
431575,202202,48,27,21,32724,25452,58176
431580,202202,86,58,28,70296,33936,104232
431590,202202,141,118,23,143016,27876,170892
431595,202202,19,16,3,19392,3636,23028
431600,202202,250,144,106,174528,128472,303000
431610,202202,112,83,29,100596,36360,136956
431620,202202,41,34,7,41208,8484,49692
431630,202202,127,103,24,124836,29088,153924
431640,202202,1326,830,496,1008384.6,602364.6,1610749.2
431642,202202,36,33,3,39996,3636,43632
431643,202202,42,17,25,20604,30300,50904
431645,202202,324,188,136,227856,164832,392688
431647,202202,9,8,1,9696,1212,10908
431650,202202,32,18,14,21816,16968,38784
431660,202202,270,167,103,202404,124836,327240
431670,202202,222,99,123,119988,149076,269064
431673,202202,14,12,2,14544,2424,16968
431675,202202,27,22,5,26664,6060,32724
431680,202202,1154,842,312,1020504,378144,1398648
431690,202202,4870,2883,1987,3499047.62,2411881.8,5910929.42
431695,202202,21,15,6,18180,7272,25452
431697,202202,2,1,1,1212,1212,2424
431700,202202,184,138,46,167256,55752,223008
431710,202202,4031,1749,2282,2122214,2768208.6,4890422.6
431720,202202,1283,785,498,950814.4,603576,1554390.4
431725,202202,1,1,0,1212,,1212.0
431730,202202,1145,764,381,925971.04,461772,1387743.04
431740,202202,1320,636,684,773256,830221.2,1603477.2
431750,202202,1810,1184,626,1436221.13,761136,2197357.13
431755,202202,7,5,2,6060,2424,8484
431760,202202,974,602,372,731524.2,450864,1182388.2
431770,202202,415,284,131,344208,159984,504192
431775,202202,24,18,6,21816,7272,29088
431780,202202,557,337,220,408444,266640,675084
431790,202202,154,120,34,146652,41208,187860
431795,202202,13,10,3,12120,3636,15756
431800,202202,3156,1652,1504,2003438.52,1826485.2,3829923.72
431805,202202,18,16,2,19392,2424,21816
431810,202202,592,384,208,465408,252096,717504
431820,202202,337,195,142,236340.28,173316,409656.28
431830,202202,2282,1377,905,1671348.6,1098072,2769420.6
431840,202202,473,313,160,379356.6,195132,574488.6
431842,202202,36,30,6,36360,8484,44844
431843,202202,11,8,3,9696,3636,13332
431844,202202,17,12,5,14544,6060,20604
431845,202202,25,22,3,26664,3636,30300
431846,202202,27,23,4,27876,4848,32724
431848,202202,15,13,2,15756,2424,18180
431849,202202,5,5,0,6060,,6060.0
431850,202202,761,592,169,718716,204828,923544
431860,202202,120,78,42,95748,50904,146652
431861,202202,6,2,4,2424,4848,7272
431862,202202,60,43,17,52116,20604,72720
431870,202202,3602,2039,1563,2476117.6,1899204,4375321.6
431880,202202,957,680,277,825372,335724,1161096
431890,202202,1249,729,520,884760.6,632664,1517424.6
431900,202202,189,131,58,158772,70296,229068
431910,202202,48,35,13,42420,15756,58176
431912,202202,50,30,20,36360,24240,60600
431915,202202,148,113,35,136956,42420,179376
431920,202202,150,109,41,132108,49692,181800
431930,202202,79,65,14,78780,16968,95748
431935,202202,3,2,1,2424,1212,3636
431936,202202,3,3,0,3636,,3636.0
431937,202202,19,15,4,18180,4848,23028
431940,202202,466,321,145,389052,175740,564792
431950,202202,470,299,171,363600,208464,572064
431960,202202,729,392,337,475104,408444,883548
431970,202202,68,62,6,76356,7272,83628
431971,202202,5,3,2,3636,2424,6060
431973,202202,19,16,3,19392,3636,23028
431975,202202,9,9,0,10908,,10908.0
431980,202202,207,122,85,147864.6,103020,250884.6
431990,202202,1095,580,515,708941.74,624180,1333121.74
432000,202202,1825,953,872,1155038.34,1059288.6,2214326.94
432010,202202,262,175,87,212100,105444,317544
432020,202202,178,149,29,180588,35148,215736
432023,202202,15,13,2,15756,2424,18180
432026,202202,54,48,6,58176,7272,65448
432030,202202,61,30,31,36360,37572,73932
432032,202202,15,11,4,13332,4848,18180
432035,202202,61,46,15,55752,18180,73932
432040,202202,87,57,30,69084,36360,105444
432045,202202,2,2,0,2424,,2424.0
432050,202202,80,47,33,58176,39996,98172
432055,202202,130,95,35,115140,42420,157560
432057,202202,6,4,2,4848.6,2424,7272.6
432060,202202,34,29,5,36360,6060,42420
432065,202202,29,26,3,31512,3636,35148
432067,202202,85,79,6,95748,8484,104232
432070,202202,383,298,85,361479.2,103020,464499.2
432080,202202,817,577,240,699324.55,290880,990204.55
432085,202202,8,6,2,7272,2424,9696
432090,202202,264,178,86,215736,104232,319968
432100,202202,171,112,59,135744,72720,208464
432110,202202,552,363,189,439956,229068,669024
432120,202202,1017,576,441,699324.6,534492,1233816.6
432130,202202,489,346,143,421776.8,173316,595092.8
432132,202202,24,22,2,26664,2424,29088
432135,202202,79,64,15,77568,18180,95748
432140,202202,265,200,65,242400,78780,321180
432143,202202,215,127,88,153924,106656,260580
432145,202202,277,192,85,233916,103020,336936
432146,202202,13,12,1,14544,1212,15756
432147,202202,110,61,49,73932,59388,133320
432149,202202,16,10,6,12120,7272,19392
432150,202202,985,605,380,734472.6,460560,1195032.6
432160,202202,1630,834,796,1012020.46,965964,1977984.46
432162,202202,4,2,2,2424,2424,4848
432163,202202,17,12,5,14544,6060,20604
432166,202202,122,90,32,109383,38784,148167
432170,202202,230,118,112,143016,136956,279972
432180,202202,565,354,211,430260,256944.6,687204.6
432183,202202,10,9,1,10908,1212,12120
432185,202202,76,62,14,75144,16968,92112
432190,202202,506,299,207,362388,250884,613272
432195,202202,92,78,14,94536,16968,111504
432200,202202,405,253,152,306636,185436,492072
432210,202202,112,68,44,82416,53328,135744
432215,202202,31,29,2,36360,2424,38784
432218,202202,19,19,0,23028,,23028.0
432220,202202,629,321,308,389052,373296,762348
432225,202202,18,12,6,14544,7272,21816
432230,202202,124,80,44,96960,53328,150288
432232,202202,22,18,4,21816,4848,26664
432234,202202,3,1,2,1212,2424,3636
432235,202202,2,2,0,2424,,2424.0
432237,202202,23,15,8,18180,9696,27876
432240,202202,4427,2480,1947,3009397.2,2362189.8,5371587.0
432250,202202,1118,731,387,888396.6,469044,1357440.6
432252,202202,50,49,1,59388,1212,60600
432253,202202,60,48,12,58176,14544,72720
432254,202202,28,12,16,14544,19392,33936
432255,202202,13,11,2,13332,2424,15756
432260,202202,848,677,171,820524.6,208464,1028988.6
432270,202202,215,162,53,196344,64236,260580
432280,202202,148,111,37,134532.4,44844,179376.4
432285,202202,1,1,0,1212,,1212.0
432290,202202,54,47,7,56964,8484,65448
432300,202202,4878,2607,2271,3162029.82,2756089.5,5918119.32
432310,202202,125,104,21,126048,25452,151500
432320,202202,22,17,5,20604,6060,26664
432330,202202,15,10,5,12120,6060,18180
432335,202202,9,7,2,8484,2424,10908
432340,202202,37,30,7,36360,8484,44844
432345,202202,110,74,36,89688.6,43632,133320.6
432350,202202,23,22,1,26664,1212,27876
432360,202202,5,4,1,4848,1212,6060
432370,202202,25,25,0,30300,,30300.0
432375,202202,27,25,2,30300,2424,32724
432377,202202,6,6,0,7272,,7272.0
432380,202202,185,80,105,96960,127260,224220
500020,202202,265,138,127,167256,155136,322392
500025,202202,138,68,70,82416,84840,167256
500060,202202,1433,911,522,1106556,632665.2,1739221.2
500070,202202,732,349,383,422988,464196,887184
500080,202202,137,109,28,132108,35148,167256
500085,202202,134,107,27,129684.8,32724,162408.8
500090,202202,370,171,199,207252,241188,448440
500100,202202,702,365,337,442380,408445.2,850825.2
500110,202202,2291,1092,1199,1323504.6,1453189.2,2776693.8
500124,202202,270,150,120,181800,145440,327240
500150,202202,334,135,199,163620,241188,404808
500190,202202,522,349,173,424200,209676.85,633876.85
500200,202202,205,173,32,209676.32,38784,248460.32
500210,202202,1610,542,1068,658116,1294416,1952532
500215,202202,202,118,84,143016,103020,246036
500220,202202,717,459,258,556308.12,313908,870216.12
500230,202202,227,137,90,166044,109080,275124
500240,202202,644,423,221,512676,267852.6,780528.6
500260,202202,584,229,355,277548,430260,707808
500270,202202,29962,12939,17023,15694662.72,20650062.5,36344725.22
500280,202202,198,67,131,81204,158772,239976
500290,202202,1178,725,453,879912.6,549036,1428948.6
500295,202202,455,293,162,355116.6,196344,551460.6
500310,202202,106,38,68,46056,82416,128472
500315,202202,814,450,364,545400,441168,986568
500320,202202,3667,1762,1905,2135545.85,2308860,4444405.85
500325,202202,904,498,406,603576,493284.6,1096860.6
500330,202202,1500,706,794,855650.78,963540,1819190.78
500345,202202,306,229,77,278760.6,93324,372084.6
500348,202202,250,153,97,185436,117564,303000
500350,202202,104,49,55,59388,66660,126048
500370,202202,5684,2580,3104,3131811.2,3766897,6898708.2
500375,202202,349,239,110,289668,133320,422988
500380,202202,597,337,260,408444,315120,723564
500390,202202,71,34,37,41208,44844,86052
500400,202202,209,136,73,164832,88476,253308
500410,202202,508,214,294,259368,356328,615696
500430,202202,544,373,171,452076,207252,659328
500440,202202,214,117,97,141804,117564,259368
500450,202202,413,177,236,214524,287244,501768
500460,202202,265,144,121,174528.6,146652,321180.6
500470,202202,420,315,105,381780,127260,509040
500480,202202,100,60,40,72720,49692,122412
500490,202202,95,42,53,50904,64236,115140
500500,202202,1432,530,902,642360,1094436,1736796
500510,202202,40,34,6,41208,7272,48480
500515,202202,101,70,31,84840,37572,122412
500520,202202,284,149,135,180588.8,163620,344208.8
500525,202202,91,50,41,60600,49692,110292
500540,202202,882,392,490,476316,595092,1071408
500560,202202,897,496,401,602364,487224.6,1089588.6
500568,202202,1005,536,469,652056,570852,1222908
500570,202202,1172,680,492,825372.8,596304.6,1421677.4
500580,202202,322,166,156,202404,189072,391476
500600,202202,350,173,177,209676,214524,424200
500620,202202,939,655,284,793860.74,345420,1139280.74
500625,202202,77,61,16,73932,19392,93324
500627,202202,39,17,22,20604,26664,47268
500630,202202,1554,891,663,1079384.77,804768,1884152.77
500635,202202,511,305,206,369660,249672,619332
500640,202202,361,198,163,239976,197556,437532
500660,202202,5716,2080,3636,2523385.4,4411680.6,6935066.0
500690,202202,606,216,390,261792,472680,734472
500710,202202,390,191,199,231492.6,241188.6,472681.2
500720,202202,933,511,422,619332,513888.28,1133220.28
500730,202202,161,96,65,116352.6,78780,195132.6
500740,202202,915,379,536,459348,649632,1108980
500750,202202,170,56,114,67872,138168,206040
500755,202202,119,90,29,109080,35148,144228
500769,202202,735,406,329,492072.6,398748,890820.6
500770,202202,438,246,192,298152,232704,530856
500780,202202,134,91,43,111504,52116,163620
500790,202202,1037,509,528,618120,639936,1258056
500793,202202,292,148,144,179376,174528.6,353904.6
500795,202202,164,108,56,130896,67872,198768
500797,202202,49,33,16,39996,19392,59388
500800,202202,421,180,241,218160,292092,510252
500830,202202,2225,1205,1020,1461672.2,1236240,2697912.2
500840,202202,121,91,30,110292,36360,146652
510010,202202,166,93,73,112716,88476,201192
510020,202202,529,237,292,287244.6,353904,641148.6
510025,202202,1671,933,738,1132008.78,895668,2027676.78
510030,202202,664,344,320,416928,387840,804768
510035,202202,132,69,63,83628,76356,159984
510040,202202,412,197,215,238764,260580.68,499344.68
510050,202202,377,203,174,246036,210888.39,456924.39
510060,202202,126,63,63,76356,76356,152712
510080,202202,247,93,154,112716,186648.6,299364.6
510100,202202,65,27,38,32724,46056,78780
510120,202202,32,20,12,24240,14544,38784
510125,202202,377,233,144,282396,174528,456924
510130,202202,542,329,213,399960,258156.6,658116.6
510140,202202,444,141,303,170892,367236,538128
510160,202202,101,35,66,42420,79992,122412
510170,202202,743,456,287,552672,347844,900516
510180,202202,2858,1318,1540,1599843.6,1871328.2,3471171.8
510185,202202,25,13,12,15756,14544,30300
510190,202202,233,81,152,98172,184224,282396
510250,202202,2636,1623,1013,1967076,1231393.2,3198469.2
510260,202202,173,123,50,149076,60600,209676
510263,202202,468,263,205,319968.2,249672,569640.2
510267,202202,621,340,281,412080.6,340572,752652.6
510268,202202,62,28,34,33936,41208,75144
510269,202202,73,33,40,39996,48480,88476
510270,202202,374,184,190,223008,230280,453288
510279,202202,199,151,48,183012,58176,241188
510285,202202,178,71,107,86052,130896,216948
510300,202202,509,269,240,326028,290880,616908
510305,202202,201,91,110,110292,133320,243612
510310,202202,107,54,53,65448,64236,129684
510320,202202,811,507,304,616908,368448,985356
510325,202202,423,172,251,209676,304212,513888
510330,202202,423,233,190,283608,230280,513888
510335,202202,644,382,262,462984.6,317544,780528.6
510336,202202,55,38,17,46056,20604,66660
510337,202202,102,46,56,55752,67872,123624
510340,202202,17547,7843,9704,9511780.88,11768524.4,21280305.28
510343,202202,62,45,17,54540,20604,75144
510345,202202,155,96,59,116352,71508.6,187860.6
510350,202202,646,342,304,414504,368448,782952
510360,202202,214,134,80,162408,96960,259368
510370,202202,150,68,82,83628,99384,183012
510380,202202,79,58,21,71508,25452,96960
510385,202202,58,26,32,31512,38784,70296
510390,202202,100,44,56,53328,67872,121200
510395,202202,47,33,14,39996,16968,56964
510410,202202,743,474,269,574488,327240,901728
510420,202202,554,270,284,327240,344208,671448
510450,202202,51,25,26,30300,31512,61812
510452,202202,52,24,28,29088,33936,63024
510454,202202,50,23,27,27876,32724,60600
510455,202202,125,73,52,88476,63024,151500
510460,202202,180,83,97,100596,118776,219372
510480,202202,705,419,286,507828.32,346632.6,854460.92
510490,202202,336,166,170,201192,206040,407232
510500,202202,231,174,57,210888,69084,279972
510510,202202,794,459,335,556309.2,406020,962329.2
510515,202202,1250,645,605,781740,733260,1515000
510517,202202,266,123,143,149076,173316,322392
510520,202202,213,140,73,169680,88476,258156
510523,202202,108,84,24,101808,29088,130896
510525,202202,854,516,338,625392.8,409656,1035048.8
510530,202202,19,12,7,14544,8484,23028
510550,202202,234,108,126,130896,152712,283608
510558,202202,290,143,147,173316,179376,352692
510560,202202,386,216,170,261792.6,206040,467832.6
510562,202202,638,461,177,558732,215736,774468
510590,202202,712,363,349,439956,422988,862944
510600,202202,220,113,107,136956,129684,266640
510610,202202,226,97,129,117564,157560,275124
510615,202202,190,88,102,106656,123624,230280
510617,202202,24,10,14,12120,16968,29088
510618,202202,121,58,63,71508,76356,147864
510619,202202,87,61,26,73932,31512,105444
510620,202202,158,89,69,107868,83628,191496
510621,202202,170,108,62,130896,75144,206040
510622,202202,469,260,209,315120,253308,568428
510623,202202,291,197,94,238764,113928,352692
510624,202202,85,46,39,55752,47268,103020
510625,202202,511,323,188,391476,227856.95,619332.95
510626,202202,113,64,49,77568,59388,136956
510627,202202,90,63,27,76356,32724,109080
510628,202202,159,98,61,118776.6,73932,192708.6
510629,202202,270,159,111,192708,134553.81,327261.81
510630,202202,433,213,220,258156,267852.6,526008.6
510631,202202,16,8,8,9696,9696,19392
510637,202202,343,196,147,237552,178164,415716
510642,202202,1064,570,494,690840,598728,1289568
510645,202202,8,1,7,1212,8484,9696
510650,202202,1318,867,451,1050804.6,547824,1598628.6
510665,202202,82,33,49,39996,59388,99384
510670,202202,56,31,25,37572,30300,67872
510675,202202,1112,714,398,866580,483588,1350168
510677,202202,351,186,165,225432.6,199980,425412.6
510680,202202,94,56,38,67872,46056,113928
510682,202202,192,95,97,115140,117564,232704
510685,202202,55,40,15,49692,18180,67872
510700,202202,560,316,244,382992,296940,679932
510704,202202,1168,606,562,734472,681144,1415616
510706,202202,144,74,70,89688,84840,174528
510710,202202,421,291,130,352692,158772.6,511464.6
510715,202202,55,40,15,48480,19392,67872
510718,202202,232,113,119,136956,145440,282396
510719,202202,45,17,28,20604,33936,54540
510720,202202,183,130,53,157560,64236,221796
510724,202202,83,32,51,38784,61812,100596
510726,202202,65,33,32,39996,38784,78780
510729,202202,14,6,8,7272,9696,16968
510730,202202,458,245,213,298152,258156,556308
510735,202202,113,47,66,56964,79992,136956
510740,202202,21,11,10,13332,12120,25452
510757,202202,25,20,5,24240,6060,30300
510760,202202,7331,3744,3587,4541366.2,4352293.2,8893659.4
510770,202202,672,317,355,384204,430260,814464
510774,202202,20,8,12,9696,14544,24240
510775,202202,111,86,25,104232,30300,134532
510776,202202,39,12,27,14544,32724,47268
510777,202202,192,81,111,98172,134532,232704
510779,202202,36,21,15,25452,18180,43632
510780,202202,263,146,117,176952,141804,318756
510785,202202,353,194,159,235128,192708,427836
510787,202202,186,86,100,104232,121200,225432
510788,202202,6,1,5,1212,6060,7272
510790,202202,2564,1328,1236,1613228,1500457.2,3113685.2
510792,202202,1114,616,498,747804.6,604788.01,1352592.61
510794,202202,109,60,49,72720,59388,132108
510795,202202,2263,1322,941,1603476.96,1142916.6,2746393.56
510800,202202,186,111,75,135744,90900,226644
510805,202202,201,133,68,161196,82416,243612
510810,202202,97,40,57,48480,69084,117564
510820,202202,231,116,115,140592.92,139380.7,279973.62
510830,202202,77,41,36,49692,43632,93324
510835,202202,15,10,5,12120,6060,18180
510840,202202,9058,4243,4815,5148581.08,5841840,10990421.08
510850,202202,204,85,119,103020,145440,248460
510860,202202,410,195,215,236340,260580,496920
510880,202202,70,50,20,60600,24240,84840
510885,202202,67,40,27,48480,32724,81204
510890,202202,66,37,29,44844,35148,79992
510895,202202,166,98,68,118776,82416,201192
520005,202202,130,53,77,64236,93324,157560
520010,202202,288,127,161,153924,195132,349056
520013,202202,730,490,240,593880.6,290880.6,884761.2
520015,202202,46,33,13,39996,15756,55752
520017,202202,86,50,36,60600,43632,104232
520020,202202,15,7,8,8484,9696,18180
520025,202202,2635,1387,1248,1682256.4,1512576,3194832.4
520030,202202,792,431,361,522675.4,437532,960207.4
520050,202202,66,48,18,58176,21816,79992
520055,202202,62,40,22,48480,26664,75144
520060,202202,178,113,65,136956,78780,215736
520080,202202,562,408,154,495708,186648,682356
520082,202202,16,11,5,13332,6060,19392
520085,202202,86,65,21,78780,25452,104232
520090,202202,88,63,25,76356,30300,106656
520110,202202,9031,3859,5172,4678322.8,6280586.4,10958909.2
520120,202202,10,5,5,6060,6060,12120
520130,202202,807,569,238,689628,288456,978084
520140,202202,11856,6565,5291,7965266.92,6416331.48,14381598.40
520145,202202,53,31,22,37572,26664,64236
520150,202202,152,120,32,145440,38784,184224
520160,202202,47,32,15,38784,18180,56964
520170,202202,230,130,100,157560,121200,278760
520180,202202,180,82,98,99384,118776,218160
520215,202202,205,139,66,168468,81204,249672
520235,202202,80,63,17,76356,20604,96960
520250,202202,127,73,54,88476,65448,153924
520260,202202,115,70,45,84840,54540,139380
520280,202202,45,32,13,38784,15756,54540
520310,202202,44,26,18,31512,21816,53328
520320,202202,165,101,64,122412,77568,199980
520330,202202,809,442,367,535704,444804,980508
520340,202202,358,205,153,248460,185436,433896
520350,202202,486,240,246,290880,298152,589032
520355,202202,85,47,38,56964,46056,103020
520357,202202,26,21,5,25452,6060,31512
520360,202202,4,2,2,2424,2424,4848
520380,202202,141,78,63,94536,76356,170892
520390,202202,245,104,141,126048,170892,296940
520393,202202,15,12,3,14544,3636,18180
520396,202202,74,50,24,60600,29088,89688
520400,202202,197,120,77,145440.18,93324,238764.18
520410,202202,190,94,96,113928,116352,230280
520420,202202,20,12,8,14544,9696,24240
520425,202202,249,128,121,155136,147864.4,303000.4
520430,202202,505,239,266,289668,323604.6,613272.6
520440,202202,648,466,182,564792,220584,785376
520450,202202,2053,870,1183,1055652,1437432,2493084
520455,202202,56,31,25,37572,30300,67872
520460,202202,37,22,15,26664,18180,44844
520465,202202,29,25,4,30300,4848,35148
520470,202202,426,272,154,329664.6,187860,517524.6
520480,202202,80,46,34,55752,41208,96960
520485,202202,101,37,64,44844,77568,122412
520490,202202,428,320,108,387840,130896,518736
520495,202202,157,91,66,110292,79992,190284
520500,202202,180,143,37,174528,47268,221796
520505,202202,196,116,80,140592,96960,237552
520510,202202,1868,881,987,1067772.6,1197458,2265230.6
520520,202202,48,33,15,39996,18180,58176
520530,202202,210,165,45,199980,54540,254520
520540,202202,640,431,209,522372,253308,775680
520545,202202,136,75,61,90900.6,73932,164832.6
520547,202202,55,31,24,37572,29088,66660
520549,202202,1331,612,719,742956.68,872640.6,1615597.28
520551,202202,323,165,158,199980,191496.6,391476.6
520552,202202,34,25,9,30300,10908,41208
520570,202202,13,8,5,9696,6060,15756
520580,202202,270,171,99,207252,119988,327240
520590,202202,140,80,60,96960,72720,169680
520620,202202,1117,520,597,632665.8,725988.6,1358654.4
520630,202202,40,20,20,24240,24240,48480
520640,202202,370,217,153,263004.6,185436,448440.6
520650,202202,65,32,33,38784,39996,78780
520660,202202,39,20,19,24240,23028,47268
520670,202202,40,32,8,38784,9696,48480
520680,202202,42,25,17,30300,20604,50904
520690,202202,39,9,30,10908,36360,47268
520710,202202,35,30,5,36360,6060,42420
520725,202202,195,146,49,176952,59388,236340
520735,202202,54,35,19,42420,23028,65448
520740,202202,459,221,238,267852,288456,556308
520750,202202,33,24,9,29088,10908,39996
520753,202202,68,46,22,55752,26664,82416
520760,202202,99,65,34,79992,41208,121200
520780,202202,267,206,61,249672,73932,323604
520790,202202,158,93,65,112716,78780,191496
520800,202202,3358,1859,1499,2255533.6,1820424.72,4075958.32
520810,202202,146,112,34,135744,41208,176952
520815,202202,4,3,1,3636,1212,4848
520830,202202,144,97,47,117564,56964,174528
520840,202202,379,245,134,296940,162408,459348
520850,202202,97,54,43,65448,52116,117564
520860,202202,1746,1121,625,1359864,759924,2119788
520870,202202,31542,14557,16985,17654000.69,20613704.2,38267704.89
520880,202202,1162,622,540,753864.6,654480.6,1408345.2
520890,202202,788,486,302,589032,367236,956268
520910,202202,973,515,458,624181.44,555096,1179277.44
520915,202202,86,68,18,82416,21816,104232
520920,202202,434,206,228,250884,276336,527220
520929,202202,15,13,2,15756,2424,18180
520940,202202,65,46,19,55752,23028,78780
520945,202202,12,8,4,9696,4848,14544
520960,202202,39,23,16,27876,19392,47268
520970,202202,372,218,154,264216,187860,452076
520980,202202,93,65,28,78780,33936,112716
520990,202202,443,310,133,375720,161196,536916
520993,202202,127,65,62,78780,75144,153924
520995,202202,249,138,111,167256.04,134532,301788.04
521000,202202,1565,912,653,1106556,792648.2,1899204.2
521010,202202,661,340,321,413292.6,389052,802344.6
521015,202202,13,9,4,10908,4848,15756
521020,202202,1368,948,420,1148976,509040.6,1658016.6
521030,202202,59,37,22,44844,26664,71508
521040,202202,933,621,312,752652.6,379356,1132008.6
521056,202202,51,34,17,41208,20604,61812
521060,202202,123,80,43,96960,52116,149076
521080,202202,352,274,78,332088,94536,426624
521090,202202,558,364,194,441168,235128,676296
521100,202202,252,186,66,225432,79992,305424
521120,202202,1045,732,313,888396.6,379356,1267752.6
521130,202202,339,244,95,295728,115140.6,410868.6
521140,202202,182,98,84,118776,101808,220584
521150,202202,2547,1093,1454,1324717.2,1763460,3088177.2
521160,202202,23,9,14,10908,16968,27876
521170,202202,221,126,95,152712,115140,267852
521180,202202,1166,748,418,906578,507828.6,1414406.6
521190,202202,2519,1071,1448,1298052,1756188,3054240
521200,202202,54,38,16,46056,19392,65448
521205,202202,11,8,3,9696,3636,13332
521210,202202,121,76,45,92112,54540,146652
521220,202202,714,502,212,608424,258156,866580
521225,202202,24,18,6,21816,7272,29088
521230,202202,104,65,39,78780,47268,126048
521250,202202,6181,3467,2714,4205644.34,3297854.6,7503498.94
521260,202202,32,14,18,16968,21816,38784
521270,202202,136,102,34,123624,41208,164832
521280,202202,409,252,157,306636,190284,496920
521290,202202,26,18,8,21816,9696,31512
521295,202202,100,66,34,79992,41208,121200
521300,202202,222,121,101,146652,122412,269064
521305,202202,36,28,8,33936,9696,43632
521308,202202,988,751,237,910213.2,287244,1197457.2
521310,202202,1321,744,577,901728.6,700536,1602264.6
521340,202202,21,16,5,19392,6060,25452
521350,202202,114,87,27,105444,32724,138168
521370,202202,161,111,50,135744,60600,196344
521375,202202,188,94,94,113928.6,113928,227856.6
521377,202202,50,40,10,48480,12120,60600
521380,202202,1042,633,409,767196.35,495708,1262904.35
521385,202202,11,7,4,8484,4848,13332
521390,202202,99,81,18,98172,21816,119988
521400,202202,349,240,109,290880,132108,422988
521405,202202,144,82,62,99384,75144,174528
521410,202202,76,55,21,66660,25452,92112
521440,202202,202,139,63,168468,76356,244824
521450,202202,745,410,335,496920.62,406020,902940.62
521460,202202,1092,727,365,882336,442380,1324716
521470,202202,12,8,4,9696,4848,14544
521480,202202,39,29,10,35148,12120.6,47268.6
521483,202202,307,190,117,230281.2,141804,372085.2
521486,202202,289,186,103,226644,124836,351480
521487,202202,25,11,14,13332,16968,30300
521490,202202,23,13,10,15756,12120,27876
521500,202202,137,64,73,77568,88476,166044
521520,202202,45,34,11,41208,13332,54540
521523,202202,853,505,348,613272,421776,1035048
521525,202202,45,29,16,35148,19392,54540
521530,202202,235,134,101,162408,123624,286032
521540,202202,39,20,19,24240,23028,47268
521550,202202,101,44,57,53328,69084,122412
521560,202202,834,561,273,679932,330876.8,1010808.8
521565,202202,65,48,17,58176,20604,78780
521570,202202,525,334,191,404808.6,231492.6,636301.2
521580,202202,51,32,19,38784,23028,61812
521590,202202,33,15,18,18180,21816,39996
521600,202202,24,12,12,14544,14544,29088
521630,202202,236,125,111,151500,134532,286032
521640,202202,300,162,138,196344,167256.6,363600.6
521645,202202,37,20,17,24240,20604,44844
521680,202202,243,150,93,181800,112716.4,294516.4
521690,202202,9,8,1,9696,1212,10908
521710,202202,1127,539,588,653268,713868.6,1367136.6
521720,202202,525,364,161,441168,195132.96,636300.96
521730,202202,648,307,341,373296.82,413292,786588.82
521740,202202,877,388,489,470256,592668,1062924
521760,202202,2189,1146,1043,1389032.83,1264116,2653148.83
521770,202202,806,505,301,612060,364812,976872
521800,202202,1904,1246,658,1510153.2,797496,2307649.2
521805,202202,33,19,14,23028,16968,39996
521810,202202,95,55,40,66660,48480,115140
521830,202202,958,685,273,831432.77,330876.36,1162309.13
521839,202202,76,45,31,54540,37572,92112
521850,202202,1114,555,559,672661.21,677508.8,1350170.01
521860,202202,322,202,120,244824,145440,390264
521870,202202,75,46,29,55752,35148,90900
521878,202202,37,14,23,16968,27876,44844
521880,202202,4812,2125,2687,2575501.6,3260281.4,5835783.0
521890,202202,589,400,189,486013.01,229068,715081.01
521900,202202,273,216,57,261792,69084,330876
521910,202202,167,116,51,140592,61812,202404
521920,202202,43,22,21,26664,25452,52116
521925,202202,48,28,20,33936,24240,58176
521930,202202,1168,655,513,793860.6,622968.2,1416828.8
521935,202202,32,21,11,25452,13332,38784
521940,202202,218,96,122,116352,149076,265428
521945,202202,17,14,3,16968,3636,20604
521950,202202,14,10,4,12120,4848,16968
521960,202202,67,50,17,60600,20604,81204
521970,202202,398,254,144,307848,174528,482376
521971,202202,111,58,53,70296,64236,134532
521973,202202,38,19,19,23028,23028,46056
521975,202202,1583,802,781,972024.31,947785.4,1919809.71
521980,202202,241,160,81,195132,98172,293304
521990,202202,77,57,20,69084,24240,93324
522000,202202,287,188,99,227433.01,119988,347421.01
522005,202202,19,12,7,14544,8484,23028
522010,202202,1109,624,485,757500,587820,1345320
522015,202202,61,38,23,46056,27876,73932
522020,202202,881,515,366,624180,444804.2,1068984.2
522026,202202,26,17,9,20604,10908,31512
522028,202202,20,14,6,16968,7272,24240
522040,202202,779,330,449,399960.6,544188.6,944149.2
522045,202202,2513,1505,1008,1824061.4,1221696.6,3045758.0
522050,202202,156,76,80,92112,96960,189072
522060,202202,540,341,199,413292,241188,654480
522068,202202,105,74,31,89688,37572,127260
522070,202202,12,11,1,13332,1212,14544
522100,202202,34,21,13,25452,15756,41208
522108,202202,43,33,10,39996,12120,52116
522119,202202,60,34,26,41208,31512,72720
522130,202202,73,26,47,31512,56964,88476
522140,202202,4017,2077,1940,2518536.6,2351280,4869816.6
522145,202202,45,35,10,42420,12120,54540
522150,202202,103,70,33,84840,39996,124836
522155,202202,52,39,13,47268,15756,63024
522157,202202,9,6,3,7272,3636,10908
522160,202202,1652,988,664,1198668.8,804768,2003436.8
522170,202202,393,266,127,323280.8,153924,477204.8
522180,202202,31,11,20,13332,24240,37572
522185,202202,2231,937,1294,1135645.46,1568328,2703973.46
522190,202202,64,36,28,43632,33936,77568
522200,202202,300,177,123,215736,149076,364812
522205,202202,146,102,44,123624,53328,176952
522220,202202,136,101,35,122412,42420,164832
522230,202202,31,27,4,32724,4848,37572
530010,202202,54201,27539,26662,33407947.36,32347201.4,65755148.76
110001,202203,506,410,96,496920,116352,613272
110002,202203,2796,1780,1016,2160955.6,1231392.6,3392348.2
110003,202203,79,64,15,77568,18180,95748
110004,202203,1981,1336,645,1621657.2,782952,2404609.2
110005,202203,419,336,83,407232.6,100596,507828.6
110006,202203,431,322,109,392688.6,132108,524796.6
110007,202203,67,54,13,65448,15756,81204
110008,202203,236,134,102,162408,124836,287244
110009,202203,905,682,223,827796,270276.4,1098072.4
110010,202203,1653,977,676,1187760,819312,2007072
110011,202203,1687,1319,368,1599840,446016,2045856
110012,202203,4062,2377,1685,2883348,2042220,4925568
110013,202203,730,576,154,700536,186648,887184
110014,202203,358,315,43,381780,52116,433896
110015,202203,1341,1057,284,1282297.08,345420.6,1627717.68
110018,202203,1019,625,394,758713.16,477528,1236241.16
110020,202203,15699,8961,6738,10868015.74,8174942.56,19042958.30
110025,202203,653,478,175,579336.6,212100,791436.6
110026,202203,34,22,12,26664,14544,41208
110028,202203,1560,1109,451,1346533.76,546613.9,1893147.66
110029,202203,122,111,11,134532,13332,147864
110030,202203,2386,1584,802,1924463.55,973237.45,2897701.00
110032,202203,296,226,70,275124.6,86052,361176.6
110033,202203,637,457,180,553884,218160,772044
110034,202203,314,233,81,282396.98,99384,381780.98
110037,202203,82,74,8,89688,9696,99384
110040,202203,387,267,120,323604,145440,469044
110045,202203,914,645,269,781740.6,328452.16,1110192.76
110050,202203,87,76,11,92112,13332,105444
110060,202203,62,38,24,46056,29088,75144
110070,202203,108,71,37,86052,44844,130896
110080,202203,511,296,215,358752.6,260580,619332.6
110090,202203,24,20,4,24240,4848,29088
110092,202203,110,57,53,69084,64236,133320
110094,202203,189,132,57,160064.8,69084,229148.8
110100,202203,45,32,13,38784,15756,54540
110110,202203,96,55,41,66660,49692,116352
110120,202203,65,57,8,69084,9696,78780
110130,202203,277,224,53,271488.47,64236,335724.47
110140,202203,242,174,68,210888,82416,293304
110143,202203,53,44,9,53328,10908,64236
110145,202203,38,30,8,36360,9696,46056
110146,202203,22,10,12,12120,14544,26664
110147,202203,36,25,11,30300,13332,43632
110148,202203,37,28,9,33936,10908,44844
110149,202203,316,224,92,271488,111504,382992
110150,202203,137,104,33,126048,39996,166044
110155,202203,11,10,1,12120,1212,13332
110160,202203,64,51,13,61812,15756,77568
110170,202203,215,165,50,199980,60600.6,260580.6
110175,202203,62,48,14,58176,16968,75144
110180,202203,94,76,18,92112,21816,113928
120001,202203,195,145,50,175740.55,60600,236340.55
120005,202203,202,116,86,140592.87,104232,244824.87
120010,202203,1135,695,440,842340.6,533280,1375620.6
120013,202203,158,107,51,129684,61812,191496
120017,202203,115,64,51,77568,61812,139380
120020,202203,3420,2774,646,3362162.58,785389.2,4147551.78
120025,202203,560,313,247,379357.15,299364,678721.15
120030,202203,1049,905,144,1098123.06,174536.8,1272659.86
120032,202203,39,35,4,42420,4848,47268
120033,202203,221,194,27,235136.25,32724.55,267860.80
120034,202203,172,126,46,152712,55752,208464
120035,202203,38,32,6,38784,7272,46056
120038,202203,397,254,143,307850.75,173316.55,481167.30
120039,202203,29,28,1,33937.65,1212,35149.65
120040,202203,13994,9467,4527,11484986.57,5497959.85,16982946.42
120042,202203,41,37,4,44844,4848.55,49692.55
120043,202203,14,3,11,3636,13332,16968
120045,202203,530,343,187,415716.55,227857.65,643574.20
120050,202203,1253,962,291,1168422.31,352703.55,1521125.86
120060,202203,1448,1208,240,1464151,292098.6,1756249.6
120070,202203,405,294,111,356329.5,135744,492073.5
120080,202203,179,114,65,138169.65,78780.55,216950.20
130002,202203,160,115,45,139380,54540,193920
130006,202203,104,69,35,83628,42420,126048
130008,202203,124,71,53,86052,64236,150288
130010,202203,157,96,61,116352,73932,190284
130014,202203,277,198,79,240279,95748,336027
130020,202203,117,75,42,90900,50904,141804
130030,202203,937,534,403,647208,488436,1135644
130040,202203,347,163,184,197556,223008.6,420564.6
130050,202203,544,286,258,346632.6,312696,659328.6
130060,202203,856,585,271,709020.6,328452,1037472.6
130063,202203,607,365,242,442380,293304,735684
130068,202203,194,120,74,145440,89688,235128
130070,202203,1336,899,437,1089588.55,530856.6,1620445.15
130080,202203,687,457,230,553884,278760,832644
130083,202203,70,41,29,49692,35148,84840
130090,202203,325,183,142,221796.8,172104,393900.8
130100,202203,1194,548,646,664176.6,782952,1447128.6
130110,202203,724,322,402,390264,487224,877488
130115,202203,143,71,72,86052.6,87264,173316.6
130120,202203,1629,1030,599,1249572.6,728412,1977984.6
130130,202203,609,418,191,506616,231492,738108
130140,202203,1546,1199,347,1453188.6,420564,1873752.6
130150,202203,402,350,52,424200,63024,487224
130160,202203,430,253,177,306636,215736,522372
130165,202203,59,48,11,59388,13332,72720
130170,202203,1003,704,299,853170.43,362388.9,1215559.33
130180,202203,242,175,67,212100,81204,293304
130185,202203,2183,1018,1165,1236240,1411980,2648220
130190,202203,3356,2109,1247,2556109,1511364,4067473
130195,202203,276,220,56,266640,67872,334512
130200,202203,173,81,92,98172,111504,209676
130210,202203,92,45,47,54540,56964,111504
130220,202203,197,140,57,169680,69084,238764
130230,202203,369,242,127,293304,155136,448440
130240,202203,1317,853,464,1035048,563580,1598628
130250,202203,5004,3163,1841,3834768.4,2233716,6068484.4
130255,202203,426,213,213,258156.6,258156,516312.6
130260,202203,59009,27824,31185,33746839.27,37842540.2,71589379.47
130270,202203,1517,1038,479,1259377.08,580548,1839925.08
130280,202203,135,79,56,95748,67872,163620
130290,202203,2071,1391,680,1685892,824160,2510052
130300,202203,420,288,132,349056,159984,509040
130310,202203,905,478,427,579336,517524,1096860
130320,202203,512,273,239,330876,289668,620544
130330,202203,752,476,276,576912,334512,911424
130340,202203,3375,1889,1486,2289468,1803456,4092924
130350,202203,477,325,152,395112,185436,580548
130353,202203,929,408,521,494496.2,631452,1125948.2
130356,202203,782,351,431,426624,523584,950208
130360,202203,87,66,21,79992,25452,105444
130370,202203,688,530,158,642360,191496,833856
130380,202203,648,500,148,606000,179376,785376
130390,202203,468,380,88,460560,106656,567216
130395,202203,158,45,113,54540,136956,191496
130400,202203,72,52,20,63024,24240,87264
130406,202203,2196,1291,905,1565905.8,1098072,2663977.8
130410,202203,446,223,223,270276,270276,540552
130420,202203,2789,2269,520,2750028.6,630240,3380268.6
130423,202203,182,108,74,130896.6,90900,221796.6
130426,202203,184,100,84,122412,101808,224220
130430,202203,407,239,168,290880,203616,494496
130440,202203,203,66,137,79992,166044,246036
140002,202203,25,5,20,6060,24240,30300
140005,202203,209,125,84,151500,101808,253308
140010,202203,11304,6965,4339,8446438.13,5263717.61,13710155.74
140015,202203,145,68,77,82416,93324,175740
140017,202203,119,69,50,83628,60600,144228
140020,202203,435,286,149,349056,180588.6,529644.6
140023,202203,42,21,21,25452,25452,50904
140028,202203,21,11,10,13332,12120,25452
140030,202203,357,239,118,289668,143016,432684
140040,202203,62,45,17,54540,20604,75144
140045,202203,272,103,169,124836,204828,329664
140047,202203,483,322,161,390264.6,195132,585396.6
140050,202203,139,84,55,101808,66660,168468
140060,202203,69,44,25,53328,30300,83628
140070,202203,28,26,2,31512,2424,33936
150010,202203,4901,2952,1949,3579037.2,2362188.6,5941225.8
150013,202203,169,120,49,145440.6,59388,204828.6
150020,202203,1112,603,509,730836,616908,1347744
150030,202203,704,315,389,381780.02,471468,853248.02
150034,202203,207,128,79,155136,95748,250884
150040,202203,1554,887,667,1075044,808404,1883448
150050,202203,686,394,292,477528.6,355116,832644.6
150060,202203,4837,3044,1793,3690438.26,2173618.96,5864057.22
150070,202203,449,234,215,283608,260580,544188
150080,202203,16370,7645,8725,9269382.26,10591674.8,19861057.06
150085,202203,412,266,146,322392,178164,500556
150090,202203,690,567,123,688416,149076,837492
150095,202203,44,30,14,36360,16968,53328
150100,202203,69,43,26,52116,31512,83628
150110,202203,215,118,97,143016,117564,260580
150120,202203,396,287,109,347844,132108,479952
150125,202203,49,18,31,21816,37572,59388
150130,202203,2149,1078,1071,1306536,1298052.6,2604588.6
150140,202203,58172,25572,32600,31016307.26,39557266.92,70573574.18
150145,202203,245,130,115,157560,139380,296940
150150,202203,3286,1450,1836,1758612,2226445.2,3985057.2
150157,202203,380,270,110,327240.6,133320,460560.6
150160,202203,129,98,31,118776,37572,156348
150170,202203,3894,2845,1049,3449352,1272600,4721952
150172,202203,353,246,107,298152,129684,427836
150175,202203,82,46,36,55752,43632,99384
150178,202203,754,508,246,615696,299364,915060
150180,202203,3224,1583,1641,1918596,1991316.6,3909912.6
150190,202203,368,235,133,286032.6,161196,447228.6
150195,202203,118,62,56,75144,67872,143016
150200,202203,187,90,97,109080,117564,226644
150210,202203,3234,2548,686,3088176.6,832644,3920820.6
150215,202203,609,378,231,459348.6,279972,739320.6
150220,202203,3538,2350,1188,2849413.07,1443492.36,4292905.43
150230,202203,1317,1045,272,1266540.3,329664,1596204.3
150240,202203,6902,3875,3027,4701349.8,3671149.8,8372499.6
150250,202203,72,40,32,48480,38784,87264
150260,202203,108,73,35,88476,42420,130896
150270,202203,2134,1377,757,1668924,917484.6,2586408.6
150275,202203,535,340,195,412080,236340,648420
150276,202203,116,42,74,50904,89688,140592
150277,202203,834,370,464,448440,562368,1010808
150280,202203,360,243,117,295728,141804,437532
150285,202203,136,69,67,83628,81010.08,164638.08
150290,202203,1198,688,510,833856,618120,1451976
150293,202203,749,355,394,430260.72,477528,907788.72
150295,202203,547,252,295,305424,357540,662964
150300,202203,93,44,49,53328,59388,112716
150304,202203,189,112,77,135744,93324,229068
150307,202203,428,357,71,432684,86052,518736
150309,202203,586,415,171,504192,208464.36,712656.36
150310,202203,268,178,90,215736,109080,324816
150320,202203,1850,1284,566,1556208.54,685992.6,2242201.14
150330,202203,2085,1199,886,1453188.6,1073832,2527020.6
150340,202203,197,131,66,158772,79992,238764
150345,202203,635,356,279,431472,339360,770832
150350,202203,397,314,83,380568,100596,481164
150360,202203,4751,2856,1895,3467532,2297952,5765484
150370,202203,839,573,266,694476.6,322392,1016868.6
150375,202203,203,94,109,113928,132108,246036
150380,202203,1516,999,517,1210788,626604,1837392
150390,202203,881,501,380,609636,460560,1070196
150400,202203,109,90,19,109080,23028,132108
150405,202203,1590,1009,581,1224121.48,704172.6,1928294.08
150410,202203,116,71,45,86052,54540,140592
150420,202203,7618,4115,3503,4991213.55,4250485.8,9241699.35
150430,202203,638,400,238,484800.6,289668,774468.6
150440,202203,453,283,170,342996,206040,549036
150442,202203,2344,1237,1107,1501669.2,1341684.6,2843353.8
150445,202203,540,350,190,424200.6,230280,654480.6
150450,202203,224,125,99,151500,119988,271488
150460,202203,714,535,179,648420,216948,865368
150470,202203,1286,767,519,930816,629028,1559844
150475,202203,238,182,56,220584,67872,288456
150480,202203,1384,957,427,1159884,517524,1677408
150490,202203,601,350,251,424200,304212,728412
150495,202203,336,252,84,307848,101808,409656
150497,202203,286,195,91,236340,110292,346632
150500,202203,255,154,101,186648,122412,309060
150503,202203,1288,639,649,774468.6,786588.6,1561057.2
150506,202203,920,625,295,758712.02,357540,1116252.02
150510,202203,1317,715,602,866581.2,729624,1596205.2
150520,202203,318,219,99,265428,119988,385416
150530,202203,1856,1028,828,1245936.6,1003536,2249472.6
150540,202203,202,150,52,181800,63024,244824
150543,202203,843,436,407,528432,493284,1021716
150548,202203,456,327,129,396324,156348,552672
150549,202203,73,47,26,56964,31512,88476
150550,202203,3054,1520,1534,1844664.09,1860420,3705084.09
150553,202203,3468,1954,1514,2370675.6,1834968,4205643.6
150555,202203,144,76,68,92112,82416,174528
150560,202203,55,22,33,26664,39996,66660
150563,202203,126,64,62,77568,75144,152712
150565,202203,206,129,77,156348,94536,250884
150570,202203,432,287,145,347844,175740,523584
150580,202203,1733,838,895,1015656,1085952,2101608
150590,202203,831,539,292,653268,353904,1007172
150600,202203,515,304,211,368448,255732.6,624180.6
150610,202203,156,126,30,152712,36360,189072
150611,202203,132,86,46,104232,55752,159984
150613,202203,3314,1890,1424,2290680,1728369.8,4019049.8
150616,202203,572,316,256,382992,313908,696900
150618,202203,1378,715,663,866580,804768,1671348
150619,202203,395,300,95,363600,115140,478740
150620,202203,1248,723,525,876276,636300,1512576
150630,202203,144,97,47,117564.6,56964,174528.6
150635,202203,450,197,253,238764.6,306636.6,545401.2
150640,202203,43,22,21,26664,25452,52116
150650,202203,2427,1403,1024,1700436,1241088.6,2941524.6
150655,202203,247,181,66,219372,79992,299364
150658,202203,79,48,31,58176,37572,95748
150660,202203,572,373,199,452076,241188,693264
150670,202203,1126,399,727,483588,881124,1364712
150680,202203,10711,5629,5082,6827198.66,6165447.6,12992646.26
150690,202203,28,15,13,18180,15756,33936
150700,202203,492,322,170,390264,206040,596304
150710,202203,293,172,121,208464,146652,355116
150715,202203,837,527,310,638724,375720,1014444
150720,202203,425,327,98,396324,119988,516312
150730,202203,1072,523,549,633876,665388,1299264
150740,202203,236,156,80,189072,96960,286032
150745,202203,769,432,337,523584,408444,932028
150746,202203,68,36,32,43632,38784,82416
150747,202203,243,180,63,218160,77568,295728
150750,202203,132,72,60,87264,72720,159984
150760,202203,1810,1170,640,1418040.9,775680,2193720.9
150770,202203,400,223,177,270276,214524,484800
150775,202203,103,54,49,65448,59388,124836
150780,202203,193,114,79,138168,95748,233916
150790,202203,658,376,282,455712,341784,797496
150795,202203,1644,995,649,1205940,787800,1993740
150796,202203,330,189,141,229068,170892,399960
150797,202203,393,186,207,225432,252096,477528
150800,202203,1595,894,701,1083528,850824,1934352
150803,202203,524,411,113,498132,136956,635088
150805,202203,209,123,86,149076,104232,253308
150808,202203,1030,535,495,649632,602364,1251996
150810,202203,3209,2178,1031,2640948.42,1249572.6,3890521.02
150812,202203,492,253,239,306636,290880,597516
150815,202203,1165,729,436,883548,528432,1411980
150820,202203,1557,939,618,1138068,749016,1887084
150830,202203,551,406,145,493284,175740,669024
150835,202203,223,128,95,155136,115140,270276
150840,202203,1416,847,569,1027776,690840,1718616
160005,202203,63,43,20,52116.06,24240.04,76356.10
160010,202203,192,124,68,150288.12,82416.08,232704.20
160015,202203,144,88,56,106656.06,67872,174528.06
160020,202203,140,71,69,86052.04,83628,169680.04
160021,202203,69,31,38,37572.64,46056.02,83628.66
160023,202203,65,42,23,50904.06,27876.04,78780.10
160025,202203,23,10,13,12120.02,15756.04,27876.06
160027,202203,1496,848,648,1027777.86,785376.88,1813154.74
160030,202203,16670,8566,8104,10388067.58,9829330.94,20217398.52
160040,202203,295,173,122,209676.12,147864.02,357540.14
160050,202203,735,359,376,435108.18,455712.04,890820.22
160053,202203,286,166,120,201192.26,145440.14,346632.40
160055,202203,22,14,8,16968.02,9696.02,26664.04
160060,202203,6673,3548,3125,4300186.41,3788719.58,8088905.99
160070,202203,193,114,79,138168.02,95748.02,233916.04
160080,202203,125,64,61,77568,73932,151500
170025,202203,27,15,12,18180,14544,32724
170030,202203,189,153,36,185436.24,43632,229068.24
170035,202203,199,95,104,115140,126048,241188
170040,202203,176,130,46,157560,55752,213312
170070,202203,322,203,119,246036,144228,390264
170100,202203,343,253,90,306636,110292,416928
170105,202203,45,38,7,46056,8484,54540
170110,202203,113,66,47,79992,56964,136956
170130,202203,72,37,35,44844,42420,87264
170190,202203,96,56,40,67872,48480,116352
170200,202203,337,233,104,282396,126048,408444
170210,202203,6406,3424,2982,4152022.37,3615397.8,7767420.17
170215,202203,127,68,59,82416,72720,155136
170220,202203,1343,973,370,1181700,448440.2,1630140.2
170230,202203,141,90,51,111504,61812,173316
170240,202203,505,340,165,412080.2,199980,612060.2
170255,202203,1025,830,195,1008384,236340,1244724
170270,202203,47,33,14,39996,16968,56964
170290,202203,125,79,46,95748,55752,151500
170300,202203,107,68,39,82416,47268,129684
170305,202203,47,37,10,44844,13332,58176
170307,202203,55,42,13,50904,15756,66660
170310,202203,120,71,49,86052,59388,145440
170320,202203,31,19,12,23028,14544,37572
170330,202203,29,22,7,26664,8484,35148
170360,202203,32,19,13,23028,15756,38784
170370,202203,85,42,43,50904,52116,103020
170380,202203,74,56,18,67872,21816,89688
170382,202203,37,32,5,38784,6060,44844
170384,202203,140,107,33,129684,39996,169680
170386,202203,69,29,40,35148,48480,83628
170388,202203,46,19,27,23028,32724,55752
170389,202203,23,20,3,24240,3636,27876
170390,202203,72,43,29,52116,35148,87264
170410,202203,24,22,2,26664,2424,29088
170460,202203,16,9,7,10908,8484,19392
170510,202203,34,24,10,29088,12120,41208
170550,202203,1531,893,638,1082316.6,773256,1855572.6
170555,202203,105,78,27,94536,32724,127260
170560,202203,109,77,32,93324,38784,132108
170600,202203,39,12,27,14544,32724,47268
170610,202203,180,97,83,117564,101808,219372
170625,202203,34,20,14,24240,16968,41208
170650,202203,89,63,26,76356,31512,107868
170700,202203,570,421,149,510252,180588,690840
170710,202203,150,99,51,119988,61812,181800
170720,202203,98,76,22,92112,26664,118776
170730,202203,98,58,40,70296,49692,119988
170740,202203,85,59,26,71508,31512,103020
170755,202203,52,27,25,32724,30300,63024
170765,202203,128,72,56,87264.2,69084,156348.2
170770,202203,194,125,69,151500,84840,236340
170820,202203,588,388,200,471468,242400.6,713868.6
170825,202203,40,22,18,26664,21816,48480
170830,202203,88,70,18,84840,21816.6,106656.6
170900,202203,170,131,39,158772,47268,206040
170930,202203,936,511,425,621756.88,515100,1136856.88
170950,202203,3160,1494,1666,1813192.6,2019193.36,3832385.96
170980,202203,16,10,6,12120,7272,19392
171050,202203,145,109,36,132108,44844,176952
171070,202203,52,44,8,53328,9696,63024
171090,202203,47,35,12,42420,14544,56964
171110,202203,23,17,6,20604,7272,27876
171150,202203,41,23,18,27876,21816,49692
171180,202203,23,9,14,10908,16968,27876
171190,202203,168,96,72,116352,87264,203616
171195,202203,57,47,10,56964,12120,69084
171200,202203,36,17,19,20604,23028,43632
171215,202203,7,5,2,6060,2424,8484
171240,202203,61,45,16,54540,19392,73932
171245,202203,57,48,9,58176,10908,69084
171250,202203,76,44,32,53328,38784,92112
171270,202203,13,9,4,10908,4848,15756
171280,202203,45,37,8,44844,9696,54540
171320,202203,979,560,419,678720,507828,1186548
171330,202203,420,214,206,259368,249672,509040
171360,202203,96,68,28,82416,33936,116352
171370,202203,35,20,15,24240,18180,42420
171380,202203,136,115,21,139380,25452,164832
171395,202203,43,24,19,29088,23028,52116
171420,202203,260,173,87,210888,106656,317544
171430,202203,77,63,14,76356,16968,93324
171488,202203,204,114,90,138168,109080,247248
171500,202203,63,33,30,39996,36360,76356
171510,202203,74,48,26,58176,31512,89688
171515,202203,37,30,7,36360,8484,44844
171525,202203,26,23,3,27876,3636,31512
171550,202203,14,8,6,9696,7272,16968
171570,202203,50,25,25,30300,30300,60600
171575,202203,268,177,91,214524,111504,326028
171610,202203,1765,895,870,1084740,1055652,2140392
171620,202203,143,97,46,117564,55752,173316
171630,202203,52,31,21,37572,25452,63024
171650,202203,331,228,103,277548,124836,402384
171660,202203,250,145,105,175740,127260.6,303000.6
171665,202203,78,49,29,59388,35148,94536
171670,202203,419,254,165,307848,199980,507828
171700,202203,63,55,8,66660,9696,76356
171720,202203,30,11,19,13332,23028,36360
171750,202203,103,54,49,65448,59388,124836
171780,202203,72,55,17,66660,20604,87264
171790,202203,83,68,15,82416,18180,100596
171800,202203,34,26,8,31512,9696,41208
171820,202203,2035,1187,848,1442280.72,1030200.2,2472480.92
171830,202203,33,24,9,29088,10908,39996
171840,202203,59,39,20,47268,24240,71508
171845,202203,30,19,11,23028,13332,36360
171850,202203,37,30,7,36360,8484,44844
171855,202203,76,57,19,69084,23028,92112
171865,202203,5,4,1,4848,1212,6060
171870,202203,31,18,13,21816,15756,37572
171875,202203,81,58,23,70296,27876,98172
171880,202203,38,23,15,27876,18180,46056
171884,202203,50,28,22,33936,26664,60600
171886,202203,135,61,74,73932,89688,163620
171888,202203,26,21,5,25452,6060,31512
171889,202203,11,5,6,6060,7272,13332
171890,202203,54,45,9,54540,10908,65448
171900,202203,31,21,10,25452,12120,37572
172000,202203,34,29,5,35148,6060,41208
172010,202203,54,44,10,53328,12120,65448
172015,202203,21,16,5,19392.52,6060,25452.52
172020,202203,146,92,54,111504,65448,176952
172025,202203,37,24,13,29088,15756,44844
172030,202203,44,25,19,30300,23028,53328
172049,202203,81,52,29,63024,35148,98172
172065,202203,115,75,40,90900,48480,139380
172080,202203,117,72,45,87264,54540,141804
172085,202203,31,16,15,19392,18180,37572
172090,202203,428,316,112,382992.03,135744,518736.03
172093,202203,15,13,2,15756,2424,18180
172097,202203,20,11,9,13332,10908,24240
172100,202203,5437,3082,2355,3739020.6,2856686.12,6595706.72
172110,202203,87,56,31,67872,37572,105444
172120,202203,1685,1400,285,1696801.92,345420,2042221.92
172125,202203,11,10,1,12120,1212,13332
172130,202203,26,15,11,18180,13332,31512
172208,202203,195,119,76,144228,92112,236340
172210,202203,364,182,182,220584,220584,441168
210005,202203,2982,1859,1123,2253108.09,1362291,3615399.09
210010,202203,146,89,57,107868,69084,176952
210015,202203,42,30,12,36360,14544,50904
210020,202203,368,210,158,254520,191496,446016
210030,202203,316,210,106,254520,128472,382992
210040,202203,133,107,26,129684,31512,161196
210043,202203,250,196,54,237552,65448,303000
210047,202203,503,305,198,369660,239976,609636
210050,202203,272,203,69,246036,83628,329664
210055,202203,52,44,8,53328,9696,63024
210060,202203,540,441,99,534492,119988,654480
210070,202203,435,338,97,409656,117564,527220
210080,202203,135,123,12,149076,14544,163620
210083,202203,294,144,150,174528,181800,356328
210087,202203,4,3,1,3636,1212,4848
210090,202203,436,312,124,378144,150288,528432
210095,202203,416,320,96,387840,116352,504192
210100,202203,703,556,147,673872,178164,852036
210110,202203,118,78,40,94536,48480,143016
210120,202203,4951,3919,1032,4751041.96,1250784,6001825.96
210125,202203,181,110,71,133320,86052,219372
210130,202203,456,267,189,323604,229068,552672
210135,202203,29,22,7,26664,8484,35148
210140,202203,4463,3454,1009,4186249,1224120,5410369
210150,202203,358,228,130,276336,157560,433896
210160,202203,3231,2752,479,3335424.73,580548,3915972.73
210170,202203,1201,961,240,1164732,290880,1455612
210173,202203,121,107,14,129684,16968,146652
210177,202203,328,184,144,223008,174528,397536
210180,202203,29,16,13,19392,15756,35148
210190,202203,437,293,144,355116,174528,529644
210193,202203,6,4,2,4848,2424,7272
210197,202203,71,53,18,64236,21816,86052
210200,202203,608,513,95,621756,115140,736896
210203,202203,207,146,61,176952,73932,250884
210207,202203,359,298,61,362388,73932,436320
210210,202203,713,660,53,799920,64236,864156
210215,202203,71,60,11,72720,13332,86052
210220,202203,365,311,54,376932,65448,442380
210230,202203,307,248,59,300576,71508,372084
210232,202203,1280,893,387,1083528,469044,1552572
210235,202203,180,137,43,166044,52116,218160
210237,202203,35,18,17,21816,20604,42420
210240,202203,77,67,10,81204,12120,93324
210250,202203,176,150,26,181800,31512,213312
210255,202203,366,280,86,339360,104232,443592
210260,202203,394,274,120,332088,145440,477528
210270,202203,622,427,195,517524,236340,753864
210275,202203,90,69,21,83628,25452,109080
210280,202203,1049,688,361,833856.12,437532,1271388.12
210290,202203,522,354,168,429048,203616,632664
210300,202203,5020,3215,1805,3896580.66,2192508,6089088.66
210310,202203,114,78,36,94536,43632,138168
210312,202203,117,82,35,99384,42420,141804
210315,202203,111,94,17,113928,20604,134532
210317,202203,139,105,34,127260,41208,168468
210320,202203,2320,1994,326,2417940,395112,2813052
210325,202203,145,87,58,105444.6,70296,175740.6
210330,202203,4350,2538,1812,3078480.8,2198568,5277048.8
210340,202203,1214,923,291,1119888,352692.6,1472580.6
210350,202203,665,550,115,666600,139380,805980
210355,202203,143,122,21,147864,25452,173316
210360,202203,2089,1478,611,1791336,740532,2531868
210370,202203,1219,616,603,747804,730836,1478640
210375,202203,191,97,94,117564,113928,231492
210380,202203,730,568,162,688416,196344,884760
210390,202203,192,163,29,197556,35148,232704
210400,202203,399,348,51,421776,61812,483588
210405,202203,1016,713,303,864156,367236,1231392
210407,202203,66,52,14,63024,16968,79992
210408,202203,42,37,5,44844,6060,50904
210409,202203,329,289,40,350268,48480,398748
210410,202203,434,341,93,413292,112716,526008
210420,202203,212,177,35,214524,42420,256944
210430,202203,54,38,16,46056,19392,65448
210440,202203,367,248,119,300576,144228,444804
210450,202203,101,84,17,101808,20604,122412
210455,202203,237,128,109,155136.6,132108,287244.6
210460,202203,307,210,97,254520,117564,372084
210462,202203,66,54,12,65448,14544,79992
210465,202203,142,112,30,135744,36360,172104
210467,202203,526,391,135,475104,163620,638724
210470,202203,48,41,7,49692,8484,58176
210480,202203,1296,931,365,1128372,443592.1,1571964.1
210490,202203,184,128,56,155136,67872,223008
210500,202203,485,301,184,367236,223008,590244
210510,202203,526,426,100,516312,121200,637512
210515,202203,346,220,126,266640,152712,419352
210520,202203,397,361,36,437532,43632,481164
210530,202203,9435,4901,4534,5944862.76,5501271.57,11446134.33
210535,202203,125,93,32,112716,38784,151500
210540,202203,1495,998,497,1209576.8,602364,1811940.8
210542,202203,1123,572,551,694476,667813.2,1362289.2
210545,202203,22,20,2,24240,2424,26664
210547,202203,125,109,16,132108,19392,151500
210550,202203,605,430,175,521160.76,212100,733260.76
210560,202203,153,132,21,159984,25452,185436
210565,202203,20,14,6,16968,7272,24240
210570,202203,1291,1067,224,1293204.4,271488,1564692.4
210580,202203,120,103,17,124836,20604,145440
210590,202203,722,601,121,728412,146652,875064
210592,202203,44,40,4,48480,4848,53328
210594,202203,106,90,16,109080,19392,128472
210596,202203,115,99,16,119988,19392,139380
210598,202203,142,107,35,129684,42420,172104
210600,202203,307,267,40,323604,48480,372084
210610,202203,242,228,14,277548,16968,294516
210620,202203,43,27,16,32724,19392,52116
210630,202203,69,64,5,77568,6060,83628
210632,202203,989,705,284,854460,344208,1198668
210635,202203,23,21,2,25452,2424,27876
210637,202203,128,92,36,111504,43632,155136
210640,202203,576,513,63,621756,76356,698112
210650,202203,384,323,61,391476,73932,465408
210660,202203,356,279,77,338148,93324,431472
210663,202203,52,38,14,46056,16968,63024
210667,202203,94,40,54,48480,65448,113928
210670,202203,255,228,27,276336,32724,309060
210675,202203,504,282,222,341784,269064,610848
210680,202203,228,144,84,174528,101808,276336
210690,202203,69,59,10,71508,12120,83628
210700,202203,154,119,35,144228,42420,186648
210710,202203,228,143,85,173316,103020,276336
210720,202203,128,114,14,138168,16968,155136
210725,202203,59,50,9,60600,10908,71508
210730,202203,21,16,5,19392,6060,25452
210735,202203,283,207,76,250884,92112.6,342996.6
210740,202203,515,447,68,541764,82416,624180
210745,202203,149,110,39,133320,47268,180588
210750,202203,2487,1280,1207,1551360.6,1466520,3017880.6
210760,202203,245,190,55,230280,66660,296940
210770,202203,245,199,46,241188,55752,296940
210780,202203,423,324,99,392688,119988,512676
210790,202203,185,154,31,186648,37572,224220
210800,202203,166,130,36,157560,43632,201192
210805,202203,59,53,6,64236,7272,71508
210810,202203,450,367,83,444804,100596,545400
210820,202203,2021,1688,333,2047068.92,403596,2450664.92
210825,202203,151,87,64,105444,77568,183012
210830,202203,704,474,230,574488,278760,853248
210840,202203,193,138,55,167256,66660,233916
210845,202203,230,173,57,209676,69084,278760
210850,202203,722,497,225,603576,272700,876276
210860,202203,3418,1997,1421,2421576,1723464,4145040
210870,202203,421,334,87,404808,105444,510252
210880,202203,80,62,18,75144,21816,96960
210890,202203,314,276,38,334512.8,46056,380568.8
210900,202203,639,419,220,509040,266640,775680
210905,202203,60,33,27,39996,32724,72720
210910,202203,2138,1601,537,1941625.48,650844,2592469.48
210920,202203,151,62,89,75144,107868,183012
210923,202203,80,64,16,77568,19392,96960
210927,202203,419,209,210,253308,254520,507828
210930,202203,68,55,13,66660,15756,82416
210940,202203,76,59,17,71508,20604,92112
210945,202203,198,114,84,138168,101808,239976
210950,202203,506,372,134,452076,162408,614484
210955,202203,88,57,31,69084,37572,106656
210960,202203,2283,1158,1125,1403496,1367136,2770632
210970,202203,105,91,14,110292,16968,127260
210975,202203,78,73,5,88476,6060,94536
210980,202203,1071,531,540,643572,654480.6,1298052.6
210990,202203,4468,3110,1358,3770532.4,1645896,5416428.4
211000,202203,1273,1038,235,1258056,284820,1542876
211003,202203,960,697,263,844764,318756,1163520
211010,202203,468,424,44,513888,53328,567216
211020,202203,1378,603,775,730836,939300,1670136
211023,202203,44,39,5,47268,6060,53328
211027,202203,74,54,20,65448,24240,89688
211030,202203,362,259,103,313908,124836,438744
211040,202203,282,236,46,286032.6,56964,342996.6
211050,202203,1089,746,343,904152,416928.6,1321080.6
211060,202203,614,544,70,659328.2,86052.23,745380.43
211065,202203,25,20,5,24240,6060,30300
211070,202203,843,707,136,856884.04,164832,1021716.04
211080,202203,84,82,2,99384,2424,101808
211085,202203,55,32,23,38784,27876,66660
211090,202203,75,64,11,77568,13332,90900
211100,202203,466,391,75,473892,90900,564792
211102,202203,240,171,69,207252,83628,290880
211105,202203,216,151,65,183012,78780,261792
211107,202203,126,81,45,98172,54540,152712
211110,202203,939,632,307,767196,372084,1139280
211120,202203,5006,2574,2432,3119689.08,2948796.44,6068485.52
211125,202203,24,17,7,20604,8484,29088
211130,202203,40747,19057,21690,23111636.36,26305251,49416887.36
211140,202203,399,352,47,426624,56964,483588
211150,202203,1190,829,361,1004748,437532.6,1442280.6
211153,202203,166,101,65,122412,78780,201192
211157,202203,69,57,12,69084,14544,83628
211160,202203,677,580,97,702960,117564,820524
211163,202203,2,2,0,2424,,2424.0
211167,202203,12,11,1,13332,1212,14544
211170,202203,408,304,104,369660.6,126048,495708.6
211172,202203,110,76,34,92112,41208,133320
211174,202203,13,10,3,12120,3636,15756
211176,202203,458,337,121,408444.6,146652,555096.6
211178,202203,92,63,29,76356,35148,111504
211180,202203,210,169,41,204828,49692,254520
211190,202203,70,63,7,76356,8484,84840
211195,202203,34,23,11,27876,13332,41208
211200,202203,152,130,22,157560,26664,184224
211210,202203,412,306,106,370872,128472,499344
211220,202203,4192,2479,1713,3005762.42,2078580.8,5084343.22
211223,202203,95,89,6,107868,7272,115140
211227,202203,54,44,10,53328,12120,65448
211230,202203,711,590,121,715080,147864,862944
211240,202203,372,306,66,370872,79992,450864
211245,202203,180,95,85,115140,103020,218160
211250,202203,1493,1291,202,1564692.4,244824,1809516.4
211260,202203,783,659,124,798708,150288,948996
211270,202203,1868,1536,332,1861632,402384.6,2264016.6
211280,202203,1764,1171,593,1419252,718716,2137968
211285,202203,206,132,74,159984,90900,250884
211290,202203,716,512,204,621756,247248,869004
211300,202203,760,608,152,736896,184224,921120
211400,202203,1526,968,558,1173216.02,676296,1849512.02
220005,202203,17,16,1,19392,1212,20604
220010,202203,85,70,15,84840,18180,103020
220020,202203,686,558,128,677508,155136,832644
220025,202203,104,101,3,122412,3636,126048
220027,202203,48,40,8,48480,9696,58176
220030,202203,121,99,22,119988,26664,146652
220040,202203,1254,962,292,1165944.4,353904,1519848.4
220045,202203,30,20,10,24240,12120,36360
220050,202203,698,575,123,696901.09,149076,845977.09
220060,202203,176,154,22,187860,26664,214524
220070,202203,111,97,14,117564,16968,134532
220080,202203,13,11,2,13332,2424,15756
220090,202203,36,27,9,32724,10908,43632
220095,202203,1,1,0,1212,,1212.0
220100,202203,21,18,3,21816,3636,25452
220105,202203,28,25,3,30300.6,3636,33936.6
220110,202203,236,218,18,264216,21816,286032
220115,202203,42,38,4,46056,4848,50904
220117,202203,22,20,2,24240,2424,26664
220120,202203,1461,1116,345,1352592,418140,1770732
220130,202203,27,26,1,31512,1212,32724
220140,202203,97,79,18,95748,21816,117564
220150,202203,472,354,118,429048,143016,572064
220155,202203,12,11,1,13332,1212,14544
220157,202203,19,16,3,19392,3636,23028
220160,202203,96,84,12,101808,14544,116352
220170,202203,39,34,5,41208,6060,47268
220173,202203,8,7,1,8484,1212,9696
220177,202203,14,13,1,15756,1212,16968
220180,202203,64,63,1,76356,1212,77568
220190,202203,1087,946,141,1146552,170892,1317444
220191,202203,36,30,6,36360,7272,43632
220192,202203,87,82,5,99384,6060,105444
220194,202203,58,52,6,63024,7272,70296
220196,202203,83,67,16,81204,19392,100596
220198,202203,1,1,0,1212,,1212.0
220200,202203,410,344,66,416928,79992,496920
220202,202203,37,32,5,38784,6060,44844
220205,202203,60,52,8,63024,9696,72720
220207,202203,12,12,0,14544,,14544.0
220208,202203,75,45,30,54540,36360,90900
220209,202203,33,27,6,32724,7272,39996
220210,202203,22,16,6,19392,7272,26664
220211,202203,31,28,3,33936,3636,37572
220213,202203,33,30,3,36360,3636,39996
220217,202203,39,31,8,37572,9696,47268
220220,202203,2248,1476,772,1791336,939300.6,2730636.6
220225,202203,8,3,5,3636,6060,9696
220230,202203,958,737,221,893244,267852,1161096
220240,202203,162,142,20,172104,24240,196344
220245,202203,35,32,3,38784.4,3636,42420.4
220250,202203,123,105,18,127260,21816,149076
220253,202203,53,47,6,56964,7272,64236
220255,202203,42,35,7,42420,8484,50904
220260,202203,695,531,164,643572,198768,842340
220265,202203,6,5,1,6060,1212,7272
220270,202203,815,734,81,889608,98172,987780
220271,202203,38,29,9,35148,10908,46056
220272,202203,10,10,0,12120,,12120.0
220273,202203,18,15,3,18180,3636,21816
220275,202203,60,51,9,61812,10908,72720
220277,202203,21,16,5,19392,6060,25452
220280,202203,17,11,6,13332,7272,20604
220285,202203,40,38,2,46056,2424,48480
220290,202203,1493,1276,217,1547724.6,263004.6,1810729.2
220300,202203,35,34,1,41208,1212,42420
220310,202203,328,281,47,340572,56964,397536
220320,202203,446,411,35,498132.6,42420,540552.6
220323,202203,2,1,1,1212,1212,2424
220325,202203,8,7,1,8484,1212,9696
220327,202203,11,11,0,13332,,13332.0
220330,202203,230,165,65,199980,78780,278760
220335,202203,137,116,21,141804,25452,167256
220340,202203,46,32,14,38784,16968,55752
220342,202203,53,44,9,53328,10908,64236
220345,202203,81,70,11,84840,13332,98172
220350,202203,460,397,63,481164,76356,557520
220360,202203,40,30,10,36360,12120,48480
220370,202203,1278,1062,216,1288356,261792,1550148
220375,202203,14,14,0,16968,,16968.0
220380,202203,26,19,7,23028,8484,31512
220385,202203,16,15,1,18180,1212,19392
220390,202203,2323,1284,1039,1557421.04,1260480.8,2817901.84
220400,202203,33,29,4,35148,4848,39996
220410,202203,24,22,2,26664,2424,29088
220415,202203,12,11,1,13332,1212,14544
220420,202203,126,106,20,128472,24240,152712
220430,202203,130,114,16,138168.6,19392,157560.6
220435,202203,24,17,7,20604,8484,29088
220440,202203,277,235,42,284820,50904,335724
220450,202203,330,166,164,201192,198768,399960
220455,202203,48,47,1,56964,1212,58176
220460,202203,18,16,2,19392,2424,21816
220465,202203,73,49,24,59388,29088,88476
220470,202203,233,205,28,248460,33936,282396
220480,202203,73,66,7,79992,8484,88476
220490,202203,90,76,14,92112,16968,109080
220500,202203,116,97,19,117564,23028,140592
220510,202203,372,286,86,346632.6,104232,450864.6
220515,202203,20,18,2,21816,2424,24240
220520,202203,368,325,43,393900.96,52116,446016.96
220525,202203,10,6,4,7272,4848,12120
220527,202203,16,13,3,15756,3636,19392
220530,202203,44,22,22,26664,26664,53328
220535,202203,6,4,2,4848,2424,7272
220540,202203,83,71,12,86052,14544,100596
220545,202203,28,18,10,23028,12120,35148
220550,202203,703,555,148,672660,179376,852036
220551,202203,15,12,3,14544,3636,18180
220552,202203,13,12,1,14544,1212,15756
220553,202203,51,46,5,55752,6060,61812
220554,202203,11,8,3,9696,3636,13332
220555,202203,39,32,7,38784,8484,47268
220556,202203,36,34,2,41208,2424,43632
220557,202203,55,48,7,58176,8484,66660
220558,202203,7,3,4,3636,4848,8484
220559,202203,3,3,0,3636,,3636.0
220560,202203,71,46,25,55752,30300,86052
220570,202203,716,447,269,542976,326028,869004
220580,202203,536,489,47,592668,56964,649632
220585,202203,11,10,1,12120,1212,13332
220590,202203,13,12,1,14544,1212,15756
220595,202203,74,56,18,67872,21816,89688
220600,202203,20,13,7,15756,8484,24240
220605,202203,25,22,3,26664,3636,30300
220610,202203,86,74,12,89688,14544,104232
220620,202203,548,462,86,559944.6,104232,664176.6
220630,202203,6,5,1,6060,1212,7272
220635,202203,33,30,3,36360,3636,39996
220640,202203,109,89,20,107868,24240,132108
220650,202203,113,107,6,129684,7272,136956
220660,202203,62,48,14,58176,16968,75144
220665,202203,8,8,0,9696,,9696.0
220667,202203,17,14,3,16968,3636,20604
220669,202203,32,26,6,31512,7272,38784
220670,202203,65,53,12,64236,14544,78780
220672,202203,78,59,19,71508,23028,94536
220675,202203,30,23,7,27876,8484,36360
220680,202203,48,41,7,49692,8484,58176
220690,202203,50,47,3,56964,3636,60600
220695,202203,26,14,12,16968,14544,31512
220700,202203,1767,1364,403,1654381.2,488436,2142817.2
220710,202203,6,4,2,4848,2424,7272
220720,202203,111,94,17,113928,20604,134532
220730,202203,19,18,1,21816,1212,23028
220735,202203,3,0,3,,3636,3636.0
220740,202203,49,44,5,53328,6060,59388
220750,202203,113,96,17,116352,20604,136956
220755,202203,16,16,0,19392,,19392.0
220760,202203,65,58,7,70296,8484,78780
220770,202203,5854,3295,2559,3997177.68,3105144.6,7102322.28
220775,202203,14,10,4,12120,4848,16968
220777,202203,20,19,1,23028,1212,24240
220779,202203,1,0,1,,1212,1212.0
220780,202203,897,762,135,923544,163620.6,1087164.6
220785,202203,5,1,4,1212,4848,6060
220790,202203,1149,912,237,1105344.08,287244,1392588.08
220793,202203,6,5,1,6060,1212,7272
220795,202203,18,16,2,19392,2424,21816
220800,202203,3994,3047,947,3693190.2,1148976,4842166.2
220810,202203,69,60,9,72720.3,10908,83628.3
220820,202203,236,213,23,258156,27876,286032
220830,202203,1274,1110,164,1346532.6,198768,1545300.6
220840,202203,2448,1733,715,2101610.88,866580.32,2968191.20
220850,202203,68,61,7,73932,8484,82416
220855,202203,8,4,4,4848,4848,9696
220860,202203,10,8,2,9696,2424,12120
220865,202203,29,25,4,30300,4848,35148
220870,202203,85,78,7,94536,8484,103020
220880,202203,322,260,62,315120,75144,390264
220885,202203,27,26,1,31512,1212,32724
220887,202203,7,6,1,7272,1212,8484
220890,202203,88,76,12,92112,14544,106656
220900,202203,26,14,12,16968,14544,31512
220910,202203,47,38,9,46056,10908,56964
220915,202203,11,10,1,12120,1212,13332
220920,202203,52,45,7,54540,8484,63024
220930,202203,46,44,2,53328,2424,55752
220935,202203,13,13,0,15756,,15756.0
220937,202203,31,28,3,33936,3636,37572
220940,202203,54,50,4,60600,4848,65448
220945,202203,2,2,0,2424,,2424.0
220950,202203,34,27,7,32724,8484,41208
220955,202203,16,16,0,19392,,19392.0
220960,202203,28,25,3,30300.6,3636,33936.6
220965,202203,39,36,3,43632,3636,47268
220970,202203,60,51,9,61812,10908,72720
220975,202203,10,9,1,10908,1212,12120
220980,202203,30,28,2,33936,2424,36360
220985,202203,56,49,7,59388,8484,67872
220987,202203,31,29,2,35148,2424,37572
220990,202203,23,22,1,26664,1212,27876
220995,202203,11,9,2,10908,2424,13332
220997,202203,57,50,7,60600,8484,69084
221000,202203,1202,1073,129,1300476,156348,1456824
221005,202203,37,34,3,41208,3636,44844
221010,202203,20,15,5,18180,6060,24240
221020,202203,33,32,1,38784,1212,39996
221030,202203,39,31,8,37572,9696,47268
221035,202203,20,19,1,23028,1212,24240
221037,202203,12,8,4,9696,4848,14544
221038,202203,28,25,3,30300,3636,33936
221039,202203,25,24,1,29088,1212,30300
221040,202203,263,226,37,273912,44844,318756
221050,202203,221,186,35,225432,42420,267852
221060,202203,1929,1662,267,2016768,323604,2340372
221062,202203,28,27,1,32724,1212,33936
221063,202203,15,10,5,12120,6060,18180
221065,202203,67,55,12,66660,14544,81204
221070,202203,137,118,19,143016,23028,166044
221080,202203,379,321,58,389052,70296,459348
221090,202203,20,15,5,18180,6060,24240
221093,202203,42,31,11,37572,13332,50904
221095,202203,4,4,0,4848,,4848.0
221097,202203,12,10,2,12120,2424,14544
221100,202203,26002,15517,10485,18813882.37,12713881.4,31527763.77
221110,202203,1112,844,268,1024140.6,326028,1350168.6
221120,202203,543,393,150,477528,181800,659328
221130,202203,968,779,189,944148,231492,1175640
221135,202203,30,26,4,31512,4848,36360
221140,202203,44,37,7,44844,8484,53328
221150,202203,9,7,2,8484,2424,10908
221160,202203,11,11,0,13332,,13332.0
221170,202203,17,17,0,20604,,20604.0
230010,202203,151,135,16,163620,20604,184224
230015,202203,144,117,27,141804,32724,174528
230020,202203,1658,1358,300,1647108.6,364812,2011920.6
230030,202203,1665,1193,472,1447128.2,572064,2019192.2
230040,202203,225,181,44,219372,53328,272700
230050,202203,232,167,65,202404,78780,281184
230060,202203,154,123,31,149076,37572,186648
230070,202203,305,261,44,316332,53328,369660
230075,202203,861,726,135,881124.6,163620,1044744.6
230080,202203,207,176,31,216948,37572,254520
230090,202203,150,112,38,135744,46056,181800
230100,202203,2415,1365,1050,1655592.75,1272600,2928192.75
230110,202203,2932,1858,1074,2253108.6,1301688.6,3554797.2
230120,202203,1093,849,244,1028988.4,295728,1324716.4
230125,202203,165,131,34,158772,41208,199980
230130,202203,473,419,54,507828.8,66660,574488.8
230140,202203,210,170,40,206040,48480,254520
230150,202203,152,117,35,141804,42420,184224
230160,202203,937,776,161,940512,195132,1135644
230170,202203,612,544,68,659329,82416,741745
230180,202203,67,61,6,73932,7272,81204
230185,202203,406,345,61,420564,73932,494496
230190,202203,2456,1890,566,2291892.4,688416,2980308.4
230195,202203,509,441,68,534492,82416,616908
230200,202203,422,329,93,398748,112716,511464
230205,202203,394,263,131,318756,158772,477528
230210,202203,1406,1075,331,1302900,401172,1704072
230220,202203,1584,1069,515,1298052.4,624180.6,1922233.0
230230,202203,974,812,162,984144,196344,1180488
230240,202203,1847,1606,241,1949199.8,292092.8,2241292.6
230250,202203,1774,1445,329,1751340,398748,2150088
230260,202203,3246,2003,1243,2427636.6,1506516,3934152.6
230270,202203,1353,1066,287,1291993.78,347844,1639837.78
230280,202203,2791,2115,676,2564592,820524,3385116
230290,202203,355,314,41,380568.26,49692,430260.26
230300,202203,523,381,142,462984,172104,635088
230310,202203,425,325,100,395112,121200,516312
230320,202203,910,768,142,930817.2,172104,1102921.2
230330,202203,307,245,62,296940,75144.4,372084.4
230340,202203,439,353,86,427836.4,104232,532068.4
230350,202203,3325,2054,1271,2490660,1541664,4032324
230360,202203,269,223,46,270276,55752,326028
230365,202203,126,103,23,124836,27876,152712
230370,202203,10875,5371,5504,6515715.76,6682968.4,13198684.16
230380,202203,484,414,70,501768.6,84840,586608.6
230390,202203,528,300,228,363600,277548.6,641148.6
230393,202203,241,199,42,241188,50904,292092
230395,202203,351,283,68,342996.12,82416,425412.12
230400,202203,627,502,125,608424,152712,761136
230410,202203,2702,1685,1017,2042220.86,1236240.6,3278461.46
230420,202203,6500,4291,2209,5207966.19,2682158.02,7890124.21
230423,202203,337,294,43,356328,52116,408444
230425,202203,472,376,96,455712,116352,572064
230426,202203,113,88,25,107868,30300,138168
230427,202203,70,65,5,78780,6060,84840
230428,202203,1605,797,808,965964,979296,1945260
230430,202203,455,369,86,448440,104232,552672
230435,202203,937,685,252,830220,305424,1135644
230440,202203,94532,42758,51774,51855441.44,62803434.12,114658875.56
230445,202203,319,217,102,263004,123624,386628
230450,202203,589,465,124,563580,150288,713868
230460,202203,85,64,21,77568,25452,103020
230465,202203,316,255,61,309060,75144,384204
230470,202203,2040,1598,442,1936776.6,535704,2472480.6
230480,202203,153,140,13,169680,15756,185436
230490,202203,329,258,71,312696,86052,398748
230495,202203,478,338,140,409656,170892,580548
230500,202203,1073,800,273,970812,330876,1301688
230510,202203,61,45,16,54540,19392,73932
230520,202203,404,309,95,374508,115140,489648
230523,202203,2476,1521,955,1843452,1157461.2,3000913.2
230526,202203,261,224,37,271488,44844,316332
230530,202203,689,506,183,613272.6,223008,836280.6
230533,202203,218,197,21,238764,25452,264216
230535,202203,380,285,95,345420,115140,460560
230540,202203,1803,1604,199,1946472.6,241188,2187660.6
230550,202203,3976,2534,1442,3074845.46,1749037.8,4823883.26
230560,202203,586,444,142,538128,172104,710232
230565,202203,220,164,56,198768,67872,266640
230570,202203,286,245,41,296940,49692,346632
230580,202203,1194,847,347,1027776,422988,1450764
230590,202203,1019,786,233,952632,282396,1235028
230600,202203,252,227,25,275124,30300,305424
230610,202203,437,326,111,395112.4,134532,529644.4
230620,202203,164,141,23,170892.6,27876,198768.6
230625,202203,823,561,262,679932,317544,997476
230630,202203,1350,1023,327,1239876,396324,1636200
230640,202203,3860,3205,655,3886884.02,793862,4680746.02
230650,202203,503,429,74,519948,89688,609636
230655,202203,705,577,128,700536.4,155136,855672.4
230660,202203,363,299,64,362388,77568,439956
230670,202203,459,376,83,455712,101808,557520
230680,202203,211,187,24,226644,29088,255732
230690,202203,944,792,152,959904,184224,1144128
230700,202203,926,773,153,936876,185436,1122312
230710,202203,668,625,43,757500,52116,809616
230720,202203,147,125,22,151500,26664,178164
230725,202203,241,181,60,219372,72720,292092
230730,202203,12661,6700,5961,8123961.43,7232006.55,15355967.98
230740,202203,679,536,143,649632.6,173316,822948.6
230750,202203,819,686,133,831432.4,161196,992628.4
230760,202203,1476,1275,201,1545300,243612,1788912
230763,202203,338,277,61,335724,73932,409656
230765,202203,8174,3792,4382,4597117.39,5317045.2,9914162.59
230770,202203,5015,2531,2484,3067573.72,3014245.2,6081818.92
230780,202203,776,679,97,822948.6,117564,940512.6
230790,202203,303,250,53,303000,64236,367236
230800,202203,1156,823,333,997476,403596,1401072
230810,202203,1407,1228,179,1490760.4,216948,1707708.4
230820,202203,373,253,120,306636.6,145440,452076.6
230830,202203,944,797,147,965964,178164,1144128
230835,202203,281,238,43,288456,52116,340572
230837,202203,170,139,31,168468,37572,206040
230840,202203,931,718,213,870216,258156,1128372
230850,202203,1406,1204,202,1459248,244824,1704072
230860,202203,308,230,78,278760,94543,373303
230870,202203,1843,1552,291,1881024,353904,2234928
230880,202203,77,61,16,73932,19392,93324
230890,202203,545,486,59,589032,71508,660540
230900,202203,295,217,78,263004,94536.88,357540.88
230910,202203,225,172,53,208464,64236,272700
230920,202203,486,380,106,460560,128472,589032
230930,202203,1052,735,317,892032,385416,1277448
230940,202203,841,645,196,781740,237552,1019292
230945,202203,521,416,105,504192.4,127260,631452.4
230950,202203,425,363,62,439956,75144,515100
230960,202203,2760,1836,924,2226444.6,1121100.6,3347545.2
230970,202203,1770,978,792,1187760,961116,2148876
230980,202203,206,163,43,197556,52116,249672
230990,202203,138,110,28,133320,33936,167256
231000,202203,203,186,17,226644,20604,247248
231010,202203,162,113,49,136956,59388,196344
231020,202203,1412,959,453,1163520.4,550248,1713768.4
231025,202203,1096,764,332,925968.4,402384,1328352.4
231030,202203,1044,862,182,1045956,220584,1266540
231040,202203,158,109,49,132108,59388,191496
231050,202203,944,818,126,992628.6,152712,1145340.6
231060,202203,161,131,30,158772,36360,195132
231070,202203,1505,1032,473,1250785.2,573276,1824061.2
231080,202203,270,241,29,293304,35148,328452
231085,202203,657,399,258,483588.4,313908,797496.4
231090,202203,258,207,51,250884,63024,313908
231095,202203,164,130,34,157560,41208,198768
231100,202203,168,136,32,164832,38784,203616
231110,202203,368,308,60,373296,72720,446016
231120,202203,277,231,46,279972,55752,335724
231123,202203,159,148,11,179376,13332,192708
231126,202203,324,245,79,296940,95748,392688
231130,202203,4965,3866,1099,4686804.6,1331988.6,6018793.2
231135,202203,209,184,25,223008,31512,254520
231140,202203,3095,2241,854,2717304,1036260,3753564
231150,202203,379,357,22,432684,26664,459348
231160,202203,1228,987,241,1196244,292092,1488336
231170,202203,520,361,159,438744,192708,631452
231180,202203,1784,1540,244,1867692.6,295728,2163420.6
231190,202203,208,170,38,206040,46056,252096
231195,202203,224,187,37,227856,44844,272700
231200,202203,826,665,161,805980,195132.4,1001112.4
231210,202203,521,436,85,529644,103020,632664
231220,202203,1041,740,301,899304.6,364812,1264116.6
231230,202203,1515,1152,363,1396224,439956,1836180
231240,202203,1522,1042,480,1262904,581760,1844664
231250,202203,95,89,6,107868,7272,115140
231260,202203,258,172,86,209676,104232,313908
231270,202203,1003,789,214,957480.84,259368,1216848.84
231280,202203,75,59,16,71508,19392,90900
231290,202203,7937,4429,3508,5369162,4258968.1,9628130.1
231300,202203,580,531,49,644784,59388,704172
231310,202203,770,705,65,854460,78780,933240
231320,202203,593,449,144,544188.8,174528,718716.8
231325,202203,101,87,14,105444,16968,122412
231330,202203,1926,1473,453,1785278.28,550248,2335526.28
231335,202203,252,222,30,269064,36360,305424
231340,202203,1781,1254,527,1522272,639936.6,2162208.6
231350,202203,1347,1072,275,1299264,334513.8,1633777.8
231355,202203,413,346,67,419352,81204,500556
231360,202203,545,374,171,453289.49,208464,661753.49
231370,202203,94,81,13,98172,15756,113928
231375,202203,290,211,79,255732,95748,351480
231380,202203,488,386,102,467832,123624,591456
231390,202203,206,154,52,186648,63024,249672
231395,202203,773,471,302,570852,366024,936876
231400,202203,1157,960,197,1164732.4,238764.6,1403497.0
231410,202203,1353,1105,248,1341685,300576,1642261
240010,202203,371,162,209,196344.83,253308,449652.83
240020,202203,2215,1798,417,2180389.43,505404,2685793.43
240030,202203,118,97,21,117564,25452,143016
240040,202203,34,33,1,39996,1212,41208
240050,202203,527,449,78,544188,94536,638724
240060,202203,69,64,5,77568,6060,83628
240070,202203,247,188,59,227856,71508,299364
240080,202203,544,364,180,441168,218160.6,659328.6
240090,202203,104,92,12,111504,14544,126048
240100,202203,1474,1384,90,1677408.4,109080,1786488.4
240110,202203,1029,686,343,832645,415716,1248361
240120,202203,142,107,35,129684,42420,172104
240130,202203,266,247,19,299364.4,23028,322392.4
240140,202203,80,54,26,65448,31512,96960
240145,202203,714,626,88,758712,106656,865368
240150,202203,26,19,7,23028,8484,31512
240160,202203,41,33,8,39996,9696,49692
240165,202203,41,32,9,38784,10908,49692
240170,202203,135,89,46,107868.6,55752,163620.6
240180,202203,101,77,24,93324,30300,123624
240185,202203,48,42,6,50904,7272,58176
240190,202203,14,12,2,14544.6,2424,16968.6
240200,202203,3058,1658,1400,2009496.8,1696800.2,3706297.0
240210,202203,162,122,40,147864,48480,196344
240220,202203,1112,778,334,944148.8,406020,1350168.8
240230,202203,824,753,71,913848.2,86052,999900.2
240240,202203,71,47,24,56964,29088,86052
240250,202203,91,80,11,96960,13332,110292
240260,202203,1804,1278,526,1552573.2,638724,2191297.2
240270,202203,177,154,23,186648,27876,214524
240280,202203,54,41,13,49692,15756,65448
240290,202203,41,39,2,47268,2424,49692
240300,202203,172,93,79,112716,95748,208464
240310,202203,2427,1298,1129,1573177.23,1368349.16,2941526.39
240320,202203,176,162,14,196344,16968,213312
240325,202203,4705,2712,1993,3289371.76,2415518.72,5704890.48
240330,202203,71,67,4,81204,4848,86052
240340,202203,86,57,29,69084,35148,104232
240350,202203,90,74,16,89688,19392,109080
240360,202203,606,363,243,439956,294516,734472
240370,202203,51,44,7,53328,8484,61812
240375,202203,60,37,23,44844,27876,72720
240380,202203,224,183,41,221796,49692.2,271488.2
240390,202203,15,13,2,15756,2424,18180
240400,202203,86,76,10,92112,12120,104232
240410,202203,12,8,4,9696,4848,14544
240420,202203,1065,770,295,933240.8,359964,1293204.8
240430,202203,261,240,21,290880,25452,316332
240440,202203,124,66,58,79992,70296,150288
240450,202203,239,151,88,183012.6,106656,289668.6
240460,202203,74,58,16,70296,19392,89688
240470,202203,211,191,20,231492,24240,255732
240480,202203,16,14,2,16968,2424,19392
240485,202203,83,65,18,78780,21816,100596
240490,202203,50,45,5,54540,6060,60600
240500,202203,88,66,22,79992,26664,106656
240510,202203,42,30,12,36360,14544,50904
240520,202203,100,95,5,115140,6060,121200
240530,202203,59,49,10,59388,12120,71508
240540,202203,84,71,13,86052,15756,101808
240550,202203,12,10,2,12120,2424,14544
240560,202203,380,272,108,329664,130896,460560
240570,202203,424,266,158,323604,191496,515100
240580,202203,1297,995,302,1205940.4,367236,1573176.4
240590,202203,32,30,2,36360,2424,38784
240600,202203,95,89,6,107868,7272,115140
240610,202203,499,413,86,500556,104232,604788
240615,202203,13,12,1,14544,1212,15756
240620,202203,88,84,4,101808,4848,106656
240630,202203,40,33,7,39996,8484,48480
240640,202203,24,20,4,24240,4848,29088
240650,202203,240,193,47,233916,56964,290880
240660,202203,106,90,16,109080,19392,128472
240670,202203,306,165,141,201192.8,172104,373296.8
240680,202203,53,40,13,48480,15756,64236
240690,202203,46,43,3,52116,3636,55752
240700,202203,178,145,33,175740,39996,215736
240710,202203,2147,1289,858,1562269.4,1042320,2604589.4
240720,202203,1047,748,299,909000,362388.8,1271388.8
240725,202203,65,60,5,72720,6060,78780
240730,202203,149,124,25,150288,30300,180588
240740,202203,228,193,35,233916,42420,276336
240750,202203,52,31,21,37572,25452,63024
240760,202203,53,44,9,53328,10908,64236
240770,202203,139,105,34,127260,41208,168468
240780,202203,703,580,123,702960,149076,852036
240790,202203,40,38,2,46056,2424,48480
240800,202203,9461,6374,3087,7728931.24,3743871.8,11472803.04
240810,202203,21429,11334,10095,13745304.46,12249688.68,25994993.14
240820,202203,240,139,101,168468,122412,290880
240830,202203,1601,1317,284,1598628.8,344208,1942836.8
240840,202203,75,66,9,79992,10908,90900
240850,202203,83,74,9,89688,10908,100596
240860,202203,105,100,5,121200,6060,127260
240870,202203,56,48,8,58176,9696,67872
240880,202203,31,28,3,33936,3636,37572
240890,202203,1141,636,505,772044.6,612060,1384104.6
240895,202203,67,51,16,61812,19392,81204
240910,202203,169,142,27,172104,32724,204828
240920,202203,12,10,2,12120,2424,14544
240930,202203,412,366,46,443592.73,55752,499344.73
240933,202203,56,36,20,43632,24240,67872
240940,202203,2299,2017,282,2444605.2,341785.2,2786390.4
240950,202203,45,40,5,48480,6060,54540
240960,202203,24,20,4,24240,4848,29088
240970,202203,111,81,30,98172,36360,134532
240980,202203,197,160,37,193920,44844,238764
240990,202203,132,89,43,107868,52116,159984
241000,202203,59,55,4,66660,4848,71508
241010,202203,72,55,17,67872,20604,88476
241020,202203,105,96,9,116352.6,10908,127260.6
241025,202203,15,8,7,9696,8484,18180
241030,202203,101,80,21,96960,25452,122412
241040,202203,40,28,12,33936,14544,48480
241050,202203,78,69,9,83628,10908,94536
241060,202203,26,21,5,25452,6060,31512
241070,202203,19,18,1,21816,1212,23028
241080,202203,54,47,7,56964,8484,65448
241090,202203,54,40,14,48480,16968,65448
241100,202203,73,62,11,75144,13332,88476
241105,202203,13,5,8,6060,9696,15756
241110,202203,46,39,7,47268,8484,55752
241120,202203,1557,1176,381,1425312,462984,1888296
241140,202203,209,174,35,210888.6,42420,253308.6
241142,202203,47,35,12,42420,14544,56964
241150,202203,1202,1047,155,1268964,187860,1456824
241160,202203,21,16,5,19392,6060,25452
241170,202203,48,41,7,49692,8484,58176
241180,202203,41,30,11,36360,13332,49692
241190,202203,36,34,2,41208,2424,43632
241200,202203,4131,2159,1972,2619133.94,2392488,5011621.94
241210,202203,71,60,11,72720,13332,86052
241220,202203,1457,937,520,1135644.64,630240,1765884.64
241230,202203,252,208,44,252096,53328,305424
241240,202203,55,41,14,49692,16968,66660
241250,202203,1132,1035,97,1254420,117564,1371984
241255,202203,53,44,9,53328,10908,64236
241260,202203,683,523,160,633876,195132,829008
241270,202203,65,47,18,56964,21816,78780
241280,202203,95,83,12,100596,14544,115140
241290,202203,125,90,35,109080,42420,151500
241300,202203,81,56,25,67872,30300,98172
241310,202203,46,32,14,38784,16968,55752
241320,202203,26,12,14,14544,16968,31512
241330,202203,57,49,8,59388,9696,69084
241335,202203,81,72,9,87264,10908,98172
241340,202203,181,133,48,161196,58176,219372
241350,202203,60,51,9,61812,10908,72720
241355,202203,49,42,7,50904,8484,59388
241360,202203,50,49,1,59388,1212,60600
241370,202203,58,46,12,55752,14544,70296
241380,202203,35,31,4,37572,4848,42420
241390,202203,83,64,19,77568,23028,100596
241400,202203,219,165,54,201192,65448,266640
241410,202203,177,161,16,195132,19392,214524
241415,202203,101,81,20,98172,24240,122412
241420,202203,112,78,34,94536,41208,135744
241430,202203,20,18,2,21816,2424,24240
241440,202203,514,430,84,521160.4,101808,622968.4
241445,202203,40,35,5,42420,6060,48480
241450,202203,257,213,44,258156,53328,311484
241460,202203,142,128,14,155136,16968,172104
241470,202203,35,28,7,33936,8484,42420
241475,202203,53,48,5,58176,6060,64236
241480,202203,117,85,32,103020,38784,141804
241490,202203,14,13,1,15756,1212,16968
241500,202203,40,31,9,37572,10908,48480
250010,202203,99,85,14,103020,16968,119988
250020,202203,31,27,4,32724,4848,37572
250030,202203,895,660,235,802344,284821,1087165
250040,202203,386,308,78,373296,94536,467832
250050,202203,270,220,50,266640,60600,327240
250053,202203,60,47,13,56964,15756,72720
250057,202203,1,1,0,1212,,1212.0
250060,202203,604,439,165,532068,199980,732048
250070,202203,682,543,139,658116.88,168468,826584.88
250073,202203,7,7,0,9696,,9696.0
250077,202203,175,130,45,157560,54540,212100
250080,202203,422,335,87,407232.68,105444.8,512677.48
250090,202203,223,143,80,173316,96960,270276
250100,202203,554,457,97,553884,117564.8,671448.8
250110,202203,666,492,174,597516.06,210888,808404.06
250115,202203,14,3,11,3636,13332,16968
250120,202203,119,85,34,103020,41208,144228
250130,202203,554,447,107,541764,130896,672660
250135,202203,22,11,11,13332,13332,26664
250140,202203,81,72,9,87264,10908,98172
250150,202203,614,439,175,532068,212100,744168
250153,202203,11,9,2,10908,2424,13332
250157,202203,29,24,5,29088,6060,35148
250160,202203,237,182,55,220584,66660,287244
250170,202203,72,46,26,55752,31512,87264
250180,202203,4618,3160,1458,3831134.08,1770732.4,5601866.48
250190,202203,820,546,274,661752,332088,993840
250200,202203,60,46,14,55752,16968,72720
250205,202203,23,19,4,23028,4848,27876
250210,202203,88,76,12,92112,14544,106656
250215,202203,71,53,18,64236,21816,86052
250220,202203,27,19,8,23028,9696,32724
250230,202203,77,68,9,82416,10908,93324
250240,202203,236,180,56,218160,67872,286032
250250,202203,374,323,51,391476,61812,453288
250260,202203,45,37,8,44844,9696,54540
250270,202203,74,52,22,63024,26664,89688
250280,202203,372,301,71,366024,86052,452076
250290,202203,91,83,8,100596,9696,110292
250300,202203,527,354,173,430260,209676,639936
250310,202203,46,42,4,50904,4848,55752
250320,202203,1989,1318,671,1597417.36,815676.6,2413093.96
250330,202203,109,92,17,111504,20604,132108
250340,202203,29,24,5,29088,6060,35148
250350,202203,189,123,66,149076,79992,229068
250355,202203,30,22,8,27876,9696,37572
250360,202203,190,157,33,190284,39996,230280
250370,202203,2370,1526,844,1849512.6,1022928,2872440.6
250375,202203,14,8,6,9696,7272,16968
250380,202203,54,45,9,54540,10908,65448
250390,202203,45,34,11,41208,13332,54540
250400,202203,16613,8333,8280,10103216.06,10047482.44,20150698.50
250403,202203,315,246,69,298152,83628,381780
250407,202203,66,53,13,64236,15756,79992
250410,202203,29,25,4,30300,4848,35148
250415,202203,44,27,17,32724,20604,53328
250420,202203,38,32,6,38784,7272,46056
250430,202203,1440,1240,200,1504395,242400,1746795
250435,202203,27,21,6,25452,7272,32724
250440,202203,680,562,118,681144.4,143016,824160.4
250450,202203,80,61,19,73932,23028,96960
250460,202203,465,301,164,366024,198768,564792
250470,202203,96,66,30,79992,36360,116352
250480,202203,331,263,68,318756,82416,401172
250485,202203,6,6,0,7272,,7272.0
250490,202203,231,190,41,230280,49692,279972
250500,202203,95,74,21,89688,25452,115140
250510,202203,790,623,167,755076,203616,958692
250520,202203,167,110,57,133320,69084,202404
250523,202203,120,99,21,119988,25452,145440
250527,202203,117,88,29,106656,35148,141804
250530,202203,7,4,3,4848,3636,8484
250535,202203,30,22,8,26664,9696,36360
250540,202203,141,110,31,133320,37572,170892
250550,202203,66,65,1,78780,1212,79992
250560,202203,60,39,21,47268,25452,72720
250570,202203,156,127,29,153924,36360,190284
250580,202203,99,74,25,89766,30300,120066
250590,202203,22,12,10,14544,12120,26664
250600,202203,1498,982,516,1190185.12,625392,1815577.12
250610,202203,155,126,29,152712,35148,187860
250620,202203,19,15,4,18180,4848,23028
250625,202203,66,50,16,60600,19392,79992
250630,202203,3112,1962,1150,2380368.57,1393800,3774168.57
250640,202203,188,148,40,180588,48480,229068
250650,202203,29,20,9,24240,10908,35148
250660,202203,60,44,16,53328,19392,72720
250670,202203,66,51,15,61812,18180,79992
250680,202203,415,331,84,401172,101808,502980
250690,202203,2113,1458,655,1770732.2,795072,2565804.2
250700,202203,926,786,140,952632.4,169680,1122312.4
250710,202203,453,359,94,435108,113928,549036
250720,202203,120,87,33,105444,39996,145440
250730,202203,412,342,70,414504,84840,499344
250740,202203,65,61,4,73932,4848,78780
250750,202203,23546,13955,9591,16929097.07,11652170.6,28581267.67
250760,202203,106,85,21,104232,25452,129684
250770,202203,356,231,125,279972.36,151500,431472.36
250780,202203,66,43,23,52116,27876,79992
250790,202203,455,288,167,349056,202404,551460
250800,202203,149,133,16,161196,19392,180588
250810,202203,75,60,15,72720,18180,90900
250820,202203,151,128,23,155136,27876,183012
250830,202203,453,295,158,357540.6,191496,549036.6
250840,202203,59,53,6,64236,7272,71508
250850,202203,58,49,9,59388,10908,70296
250855,202203,17,15,2,18180,2424,20604
250860,202203,239,156,83,189072,100596,289668
250870,202203,29,26,3,31512,3636,35148
250880,202203,89,67,22,81204,26664,107868
250890,202203,3094,2290,804,2777904,974448,3752352
250900,202203,58,48,10,58176,12120,70296
250905,202203,123,93,30,112716,36360,149076
250910,202203,1019,748,271,906576,328452,1235028
250915,202203,107,73,34,88476,41208,129684
250920,202203,137,100,37,121200,44844,166044
250930,202203,180,104,76,126048,92112,218160
250933,202203,8,5,3,6060,3636,9696
250937,202203,16,16,0,19392,,19392.0
250939,202203,30,25,5,30300,6060,36360
250940,202203,116,84,32,101808,38784,140592
250950,202203,73,51,22,61812,26664,88476
250960,202203,91,50,41,60600,49692,110292
250970,202203,1250,880,370,1066560,448440,1515000
250980,202203,100,68,32,82416,38784,121200
250990,202203,167,128,39,155136,47268,202404
251000,202203,79,68,11,82416,13332,95748
251010,202203,125,93,32,112716,38784,151500
251020,202203,76,62,14,75144,16968,92112
251030,202203,46,33,13,39996,15756,55752
251040,202203,59,39,20,47268,24240,71508
251050,202203,23,19,4,23028,4848,27876
251060,202203,49,39,10,47268,12120,59388
251065,202203,8,3,5,3636,6060,9696
251070,202203,17,13,4,15756,4848,20604
251080,202203,5262,2460,2802,2982789.76,3399660.88,6382450.64
251090,202203,190,158,32,191496,38784,230280
251100,202203,20,19,1,23028,1212,24240
251110,202203,57,38,19,46056,23028,69084
251120,202203,1929,1187,742,1439857.4,901728.92,2341586.32
251130,202203,429,355,74,430260,90900,521160
251140,202203,583,371,212,449652,256944,706596
251150,202203,345,286,59,347844,71508,419352
251160,202203,95,76,19,92112,23028,115140
251170,202203,92,75,17,90900,20604,111504
251180,202203,288,165,123,199980,149076,349056
251190,202203,193,129,64,156348,78780,235128
251200,202203,280,217,63,263004,76356,339360
251203,202203,35,32,3,38784,3636,42420
251207,202203,86,72,14,87264,16968,104232
251210,202203,1500,1092,408,1324716,494496,1819212
251220,202203,44,34,10,41208,12120,53328
251230,202203,564,467,97,566004,117564,683568
251240,202203,109,77,32,93324,38784,132108
251250,202203,1457,1037,420,1260381.21,509040.8,1769422.01
251260,202203,12,8,4,9696,4848,14544
251270,202203,304,240,64,290880,77568,368448
251272,202203,68,60,8,72720,9696,82416
251274,202203,28,22,6,26664,7272,33936
251275,202203,35,21,14,25452,16968,42420
251276,202203,26,20,6,24240,7272,31512
251278,202203,13,10,3,12120,3636,15756
251280,202203,102,97,5,117564.6,6060,123624.6
251290,202203,967,691,276,838704,334512.6,1173216.6
251300,202203,16,11,5,13332,6060,19392
251310,202203,300,215,85,260580,103020,363600
251315,202203,38,35,3,42420,3636,46056
251320,202203,76,59,17,71508,20604,92112
251330,202203,81,70,11,84840,13332,98172
251335,202203,24,10,14,12120,16968,29088
251340,202203,785,450,335,545400,406020,951420
251350,202203,35,34,1,41208,1212,42420
251360,202203,82,71,11,86052,13332,99384
251365,202203,6,6,0,7272,,7272.0
251370,202203,5737,3895,1842,4721952.09,2232504.4,6954456.49
251380,202203,44,33,11,39996,13332,53328
251385,202203,2,2,0,2424,,2424.0
251390,202203,916,676,240,819312,290880.6,1110192.6
251392,202203,26,16,10,19392,12120,31512
251394,202203,10,9,1,10908,1212,12120
251396,202203,13,8,5,9696,6060,15756
251398,202203,16,13,3,15756,3636,19392
251400,202203,50,39,11,47268,13332,60600
251410,202203,39,33,6,39996,7272,47268
251420,202203,103,76,27,92112,32724,124836
251430,202203,43,39,4,47268,4848,52116
251440,202203,49,25,24,30300,29088,59388
251445,202203,65,52,13,63024,15756,78780
251450,202203,388,335,53,406020.8,64236,470256.8
251455,202203,5,4,1,4848,1212,6060
251460,202203,21,17,4,20604,4848,25452
251465,202203,8,5,3,6060,3636,9696
251470,202203,54,40,14,48480,16968,65448
251480,202203,30,25,5,30300,6060,36360
251490,202203,109,68,41,82416,49692.6,132108.6
251500,202203,117,98,19,118776,23028,141804
251510,202203,76,47,29,56964,35148,92112
251520,202203,35,30,5,36360,6060,42420
251530,202203,4293,3018,1275,3659028.6,1545300.6,5204329.2
251540,202203,84,69,15,83628,18180,101808
251550,202203,410,312,98,378144.6,119988,498132.6
251560,202203,24,17,7,20604,8484,29088
251570,202203,17,15,2,18180,2424,20604
251580,202203,133,105,28,127260,33936,161196
251590,202203,109,74,35,89917.06,42420,132337.06
251593,202203,23,14,9,16968,10908,27876
251597,202203,102,78,24,94536,29088,123624
251600,202203,1091,757,334,918992.6,404808.4,1323801.0
251610,202203,237,174,63,212100,76356,288456
251615,202203,14,13,1,15756,1212,16968
251620,202203,4181,2673,1508,3240889.2,1830121.4,5071010.6
251630,202203,458,337,121,408444,146652,555096
251640,202203,123,90,33,109080,39996,149076
251650,202203,288,212,76,256944.8,92112,349056.8
251660,202203,195,172,23,208464,27876,236340
251670,202203,388,299,89,362388,107868,470256
251675,202203,10,8,2,9696,2424,12120
251680,202203,102,89,13,107868,15756,123624
251690,202203,317,263,54,318756,65448,384204
251700,202203,279,241,38,292092,46056,338148
251710,202203,20,12,8,14544,9696,24240
251720,202203,25,17,8,20604,9696,30300
251740,202203,13,10,3,12120,3636,15756
260005,202203,3511,1853,1658,2245324.2,2009496.6,4254820.8
260010,202203,1667,1238,429,1501669.02,519948,2021617.02
260020,202203,404,350,54,424200,65448,489648
260030,202203,591,399,192,483588,232704,716292
260040,202203,800,492,308,597516,373296,970812
260050,202203,1159,819,340,993840,413293.2,1407133.2
260060,202203,365,335,30,406020,36360,442380
260070,202203,1316,803,513,973236.2,622968,1596204.2
260080,202203,716,543,173,658116,209676,867792
260090,202203,490,315,175,381780.6,212100,593880.6
260100,202203,212,148,64,179376,78780,258156
260105,202203,255,141,114,170892,138168,309060
260110,202203,2941,2133,808,2586409.2,979297.2,3565706.4
260120,202203,2714,1455,1259,1763783.67,1527120.8,3290904.47
260130,202203,180,119,61,144228,73932,218160
260140,202203,2199,1425,774,1728313.36,938088,2666401.36
260150,202203,194,125,69,151500,83628,235128
260160,202203,341,277,64,335724,77568,413292
260170,202203,3333,1979,1354,2399760.72,1642261.2,4042021.92
260180,202203,176,142,34,173316,41208,214524
260190,202203,2339,1546,793,1874964,961116,2836080
260200,202203,975,759,216,919908.95,261792.6,1181701.55
260210,202203,1383,976,407,1184124.2,495708,1679832.2
260220,202203,653,588,65,712656,78780,791436
260230,202203,1229,906,323,1098072,391476,1489548
260240,202203,200,149,51,180588,61812,242400
260250,202203,93,69,24,83628,29088,112716
260260,202203,1052,727,325,881124,395112,1276236
260270,202203,264,188,76,227856,92112,319968
260280,202203,1157,924,233,1119888,282396.6,1402284.6
260290,202203,6806,3663,3143,4444405.8,3814165.6,8258571.4
260300,202203,982,831,151,1007172.8,184224,1191396.8
260310,202203,509,409,100,495708,121200,616908
260320,202203,825,601,224,728412,271488.54,999900.54
260330,202203,72,53,19,64236,23028,87264
260340,202203,78,57,21,69084,25452,94536
260345,202203,5574,2907,2667,3525709.8,3234828.6,6760538.4
260350,202203,474,333,141,403596,170892.6,574488.6
260360,202203,243,135,108,163620,130896,294516
260370,202203,762,470,292,569640,353904,923544
260380,202203,563,399,164,484800,198768.19,683568.19
260390,202203,293,248,45,300576,54540,355116
260392,202203,114,97,17,117564,20604,138168
260400,202203,4345,2479,1866,3009397.46,2268864,5278261.46
260410,202203,14981,7755,7226,9408759.83,8765184.6,18173944.43
260415,202203,141,120,21,145440,25452,170892
260420,202203,1740,1067,673,1293204.32,816888,2110092.32
260430,202203,171,154,17,186648.24,20604,207252.24
260440,202203,191,132,59,159984,71508,231492
260450,202203,430,320,110,387840.95,133320,521160.95
260460,202203,818,429,389,519949,471468,991417
260470,202203,335,204,131,247248,158772.2,406020.2
260480,202203,250,158,92,191496,111504,303000
260490,202203,219,172,47,208464,56964,265428
260500,202203,1115,749,366,909000,443592,1352592
260510,202203,800,632,168,765984,204828,970812
260515,202203,230,206,24,250884,29088,279972
260520,202203,3229,1992,1237,2414304.6,1500456.92,3914761.52
260530,202203,804,650,154,787800,186648,974448
260540,202203,527,415,112,502980,135744,638724
260545,202203,17,12,5,14544,6060,20604
260550,202203,327,207,120,252096,145440,397536
260560,202203,507,383,124,464196.2,150288,614484.2
260570,202203,1006,800,206,969600,249672,1219272
260580,202203,325,268,57,324816,69084,393900
260590,202203,619,355,264,431472,319968,751440
260600,202203,7717,4423,3294,5363103.7,3992328.6,9355432.3
260610,202203,489,322,167,390264,202404,592668
260620,202203,3715,1916,1799,2324616.8,2181601.19,4506217.99
260630,202203,81,73,8,88476,9696,98172
260640,202203,3377,1943,1434,2357342.08,1739220,4096562.08
260650,202203,319,229,90,277548,109080,386628
260660,202203,573,364,209,441168,256944,698112
260670,202203,103,74,29,89688,35148,124836
260680,202203,3971,2168,1803,2628828,2185238.4,4814066.4
260690,202203,123,92,31,111504,37572,149076
260700,202203,303,202,101,244824,122412,367236
260710,202203,45,36,9,43632,10908,54540
260720,202203,2668,1568,1100,1901630.6,1334412,3236042.6
260730,202203,744,544,200,659328,242400,901728
260740,202203,75,61,14,73932,16968,90900
260750,202203,569,412,157,500556,190284,690840
260760,202203,711,346,365,419352.79,442380,861732.79
260765,202203,967,495,472,599940,573276,1173216
260770,202203,221,159,62,192687,75144,267831
260775,202203,781,416,365,506617.4,442380,948997.4
260780,202203,232,142,90,172104,109080,281184
260790,202203,15085,7405,7680,8982136.04,9323918.4,18306054.44
260795,202203,157,103,54,124836,65448,190284
260800,202203,287,231,56,279972,67872,347844
260805,202203,171,112,59,135744,71508,207252
260810,202203,810,664,146,804768,176952,981720
260820,202203,296,188,108,227856.96,130896,358752.96
260825,202203,211,139,72,168468,87264,255732
260830,202203,301,184,117,223008,141804,364812
260840,202203,260,186,74,225432,89688,315120
260845,202203,173,111,62,134532,75144,209676
260850,202203,412,308,104,373296,126048,499344
260860,202203,252,187,65,226644,78780,305424
260870,202203,346,264,82,319968,99384,419352
260875,202203,742,537,205,652056,248460,900516
260880,202203,1561,1028,533,1245936.8,645996,1891932.8
260890,202203,2382,1641,741,1990104,898092.4,2888196.4
260900,202203,998,714,284,865368,346632.6,1212000.6
260910,202203,245,192,53,232704,64236,296940
260915,202203,282,208,74,252096,89688,341784
260920,202203,199,104,95,126048,115140,241188
260930,202203,364,304,60,368448,72720,441168
260940,202203,2586,1380,1206,1672561.44,1461672,3134233.44
260950,202203,1976,1112,864,1348956.8,1048380,2397336.8
260960,202203,13570,6612,6958,8021024.7,8445219.3,16466244.0
260970,202203,418,341,77,413292,93324,506616
260980,202203,206,186,20,225432,24240,249672
260990,202203,2661,2119,542,2568229.36,658116,3226345.36
261000,202203,4219,2577,1642,3124537.2,1991316.4,5115853.6
261010,202203,164,109,55,132108,66660,198768
261020,202203,588,435,153,527221.4,185436,712657.4
261030,202203,253,183,70,221796,84840,306636
261040,202203,378,320,58,387840,70296,458136
261050,202203,501,424,77,515100,93324,608424
261060,202203,1464,902,562,1093224,681144,1774368
261070,202203,9241,4405,4836,5344926.24,5868507.7,11213433.94
261080,202203,368,279,89,338148,109080,447228
261090,202203,2113,1616,497,1959805.41,602364,2562169.41
261100,202203,1216,845,371,1024141,449652,1473793
261110,202203,9105,5602,3503,6790838.08,4249272,11040110.08
261120,202203,237,204,33,247248,39996,287244
261130,202203,568,332,236,402384.4,286032.28,688416.68
261140,202203,216,136,80,164832,96960,261792
261150,202203,676,428,248,518736.03,300576,819312.03
261153,202203,69,65,4,78780,4848,83628
261160,202203,74949,36645,38304,44464855.68,46497178.11,90962033.79
261170,202203,466,344,122,416928,147864,564792
261180,202203,1783,1108,675,1344385,818100,2162485
261190,202203,572,397,175,481164.64,212100,693264.64
261200,202203,222,179,43,216948,52116,269064
261210,202203,40,32,8,38784,9696,48480
261220,202203,2733,1897,836,2301590.52,1014444,3316034.52
261230,202203,343,249,94,301788,113928,415716
261240,202203,442,384,58,465408,70296,535704
261245,202203,246,203,43,246036,52116,298152
261247,202203,167,127,40,153924,48480,202404
261250,202203,3491,1651,1840,2001012.6,2230080,4231092.6
261255,202203,244,217,27,264216,32724,296940
261260,202203,830,713,117,864156.07,141804,1005960.07
261270,202203,200,138,62,167256,75144,242400
261280,202203,192,154,38,186648,46056,232704
261290,202203,109,79,30,95748,36360,132108
261300,202203,1332,977,355,1184124,430260,1614384
261310,202203,779,522,257,633876,311484,945360
261320,202203,562,381,181,462984,219372,682356
261330,202203,906,705,201,855672,243613.55,1099285.55
261340,202203,311,173,138,209676,167256,376932
261350,202203,869,608,261,736896.6,317544,1054440.6
261360,202203,1375,870,505,1055652,613272,1668924
261370,202203,4846,2828,2018,3428749.4,2448240,5876989.4
261380,202203,549,421,128,510252.79,155136.6,665389.39
261390,202203,3665,2470,1195,2993641.2,1450764.8,4444406.0
261400,202203,273,245,28,298152,33936,332088
261410,202203,1120,730,390,885972,472680,1358652
261420,202203,955,585,370,711444.93,448440,1159884.93
261430,202203,321,292,29,353904,35148,389052
261440,202203,103,98,5,118776,6060,124836
261450,202203,2504,1976,528,2398550.44,639936,3038486.44
261460,202203,762,595,167,721140,202404.6,923544.6
261470,202203,222,180,42,218160.4,50904,269064.4
261480,202203,458,351,107,425412.8,129629.46,555042.26
261485,202203,372,227,145,275124.2,175740,450864.2
261500,202203,608,405,203,492072.4,246036,738108.4
261510,202203,52,33,19,39996,23028,63024
261520,202203,88,72,16,87264,19392,106656
261530,202203,4030,2555,1475,3100297.7,1790124,4890421.7
261540,202203,1449,830,619,1005960.2,750228.6,1756188.8
261550,202203,251,119,132,144228,159984,304212
261560,202203,912,596,316,722353.4,382992.6,1105346.0
261570,202203,397,312,85,378144,103020,481164
261580,202203,391,307,84,372084,101808,473892
261590,202203,190,157,33,190809.2,39996,230805.2
261600,202203,295,231,64,281184,77568,358752
261610,202203,84,72,12,88476,14544,103020
261618,202203,72,54,18,65448,21816,87264
261620,202203,195,123,72,149076,87264,236340
261630,202203,662,523,139,635088,168468,803556
261640,202203,6474,3384,3090,4103834.02,3748716,7852550.02
261650,202203,472,306,166,370872,201192.6,572064.6
270010,202203,511,451,60,546612,72720.6,619332.6
270020,202203,245,200,45,242400,54540,296940
270030,202203,8740,5586,3154,6773869.71,3825018.6,10598888.31
270040,202203,2075,1346,729,1631352,883548.6,2514900.6
270050,202203,202,158,44,191496,53328,244824
270060,202203,72,48,24,58176,29088,87264
270070,202203,828,607,221,735724.4,267852,1003576.4
270080,202203,39,32,7,38784,8484,47268
270090,202203,20,16,4,19392,4848,24240
270100,202203,1316,903,413,1094436.6,501768,1596204.6
270110,202203,70,59,11,71508,13332,84840
270120,202203,231,189,42,229068,50904,279972
270130,202203,320,232,88,281184,106656,387840
270135,202203,119,82,37,99384.4,44844,144228.4
270140,202203,1372,895,477,1085952,579336,1665288
270150,202203,252,193,59,233916,71508,305424
270160,202203,490,386,104,467832,127260,595092
270170,202203,794,519,275,629028,334512,963540
270180,202203,59,47,12,56964,14544,71508
270190,202203,112,93,19,112716,23028,135744
270200,202203,115,101,14,122412,16968,139380
270210,202203,536,327,209,396324,254520,650844
270220,202203,187,140,47,169680,56964,226644
270230,202203,2160,1352,808,1639838.16,980508,2620346.16
270235,202203,647,502,145,609636,176952,786588
270240,202203,2965,2347,618,2844565.32,749017,3593582.32
270250,202203,121,87,34,106656,41208,147864
270255,202203,210,179,31,216948,37572,254520
270260,202203,357,291,66,352692,82416,435108
270270,202203,94,50,44,61812,53328,115140
270280,202203,216,130,86,157560,104232,261792
270290,202203,1114,880,234,1067772,283608,1351380
270300,202203,363,265,98,321180,119988,441168
270310,202203,812,676,136,820524,164832,985356
270320,202203,780,671,109,813252,132108,945360
270330,202203,298,253,45,306636,55752,362388
270340,202203,61,50,11,60600,13332,73932
270350,202203,90,55,35,66660,42420,109080
270360,202203,70,40,30,48480,36360,84840
270370,202203,60,48,12,58176,14544,72720
270375,202203,76,46,30,55752,36360,92112
270380,202203,1058,712,346,864156,419352,1283508
270390,202203,149,84,65,101808,78780,180588
270400,202203,738,561,177,679932.54,214524,894456.54
270410,202203,618,456,162,552672,196344,749016
270420,202203,401,280,121,339360,146652,486012
270430,202203,34280,24575,9705,29808220.91,11774585.2,41582806.11
270440,202203,477,378,99,458136,119988,578124
270450,202203,837,492,345,596304,418140,1014444
270460,202203,177,142,35,172104,42420,214524
270470,202203,1555,1081,474,1311384.6,574488,1885872.6
270480,202203,531,429,102,519948.6,123624,643572.6
270490,202203,21,16,5,19392,6060,25452
270500,202203,475,401,74,486012,89688,575700
270510,202203,859,552,307,669024,372084,1041108
270520,202203,272,176,96,213312,116352,329664
270530,202203,61,52,9,63024,10908,73932
270540,202203,92,67,25,81204,30300,111504
270550,202203,1679,1296,383,1571964,464196,2036160
270560,202203,254,152,102,184224,124836,309060
270570,202203,554,391,163,473892,197556,671448
270580,202203,77,60,17,72720,20604,93324
270590,202203,59,46,13,55752,15756,71508
270600,202203,152,130,22,157560,26664,184224
270610,202203,236,189,47,229068,56964,286032
270620,202203,15,15,0,18180,,18180.0
270630,202203,3680,2793,887,3386329.2,1078680,4465009.2
270640,202203,863,647,216,784164.48,261792,1045956.48
270642,202203,212,178,34,216948,41208,258156
270644,202203,256,171,85,207252,103020,310272
270650,202203,333,198,135,239976,163620,403596
270660,202203,196,172,24,208464,29088,237552
270670,202203,2925,2230,695,2705186.9,842340,3547526.9
270680,202203,399,250,149,303000,180588,483588
270690,202203,1217,813,404,986569.52,489648,1476217.52
270700,202203,24,19,5,23028,6060,29088
270710,202203,870,687,183,832644,221796,1054440
270720,202203,221,175,46,212100,55752,267852
270730,202203,1887,1173,714,1422888.2,865368.4,2288256.6
270740,202203,36,24,12,29088,14544,43632
270750,202203,632,482,150,584184,181800,765984
270760,202203,296,213,83,258156,100596,358752
270770,202203,2800,1895,905,2297954.72,1096860,3394814.72
270780,202203,65,41,24,49692,29088,78780
270790,202203,230,148,82,179376,99384,278760
270800,202203,2053,1639,414,1991316.8,501768,2493084.8
270810,202203,220,183,37,221796,44844,266640
270820,202203,122,86,36,104232,43632,147864
270830,202203,821,626,195,758712,236340,995052
270840,202203,1337,1027,310,1244724.88,375720.56,1620445.44
270850,202203,1505,975,530,1181700.4,642360,1824060.4
270860,202203,2545,1722,823,2087105.12,997476,3084581.12
270870,202203,114,63,51,76356,61812,138168
270880,202203,851,677,174,824160.4,210888,1035048.4
270890,202203,274,206,68,249672,82416,332088
270895,202203,60,58,2,70296,2424,72720
270900,202203,64,54,10,65448,12120,77568
270910,202203,302,248,54,301788,65448,367236
270915,202203,1912,1254,658,1519848.2,798708.36,2318556.56
270920,202203,424,353,71,427836,86052,513888
270930,202203,5766,4405,1361,5348556.4,1653168.64,7001725.04
270940,202203,2197,1737,460,2107668.6,557520,2665188.6
280010,202203,37,31,6,37572,7272,44844
280020,202203,495,427,68,517524.72,82416,599940.72
280030,202203,21220,13766,7454,16696541.05,9047584.73,25744125.78
280040,202203,319,206,113,249672,136956,386628
280050,202203,416,318,98,385416,118776,504192
280060,202203,365,238,127,288456.6,153924,442380.6
280067,202203,1124,808,316,979296,382992,1362288
280070,202203,130,107,23,129684,27876,157560
280100,202203,656,507,149,615696,180588.4,796284.4
280110,202203,75,68,7,82416,8484,90900
280120,202203,662,553,109,670236,132108,802344
280130,202203,1737,1135,602,1375620,730836.2,2106456.2
280140,202203,497,417,80,505404.6,96960,602364.6
280150,202203,419,294,125,357540,152712,510252
280160,202203,137,107,30,129684,36360,166044
280170,202203,416,287,129,347844,156348,504192
280190,202203,28,23,5,27876,6060,33936
280200,202203,39,30,9,36360,10908,47268
280210,202203,2954,2121,833,2571771.06,1010808,3582579.06
280220,202203,50,40,10,48480,12120,60600
280230,202203,335,271,64,328452,77568,406020
280240,202203,131,122,9,147864,10908,158772
280250,202203,18,10,8,12120,9696,21816
280260,202203,78,71,7,86052,8484,94536
280270,202203,138,106,32,129684,38784,168468
280280,202203,186,120,66,145440.9,79992,225432.9
280290,202203,3541,2567,974,3113551.24,1181700.16,4295251.40
280300,202203,1599,1275,324,1546512,392688,1939200
280310,202203,90,86,4,104232,4848,109080
280320,202203,649,457,192,555096,232704,787800
280330,202203,311,233,78,283608,94536,378144
280340,202203,420,354,66,429048,79992,509040
280350,202203,3737,2860,877,3469960.75,1064136.8,4534097.55
280360,202203,468,316,152,382992,184224,567216
280370,202203,91,80,11,96960.04,13332,110292.04
280380,202203,53,41,12,49692,14544,64236
280390,202203,180,153,27,185436,32724,218160
280400,202203,388,261,127,316332.2,153924,470256.2
280410,202203,293,243,50,294516.4,60600,355116.4
280420,202203,134,115,19,139380,23028,162408
280430,202203,89,71,18,86052,21816,107868
280440,202203,720,587,133,711445.24,161196,872641.24
280445,202203,119,111,8,134532,9696,144228
280450,202203,1257,1081,176,1310172,213312,1523484
280460,202203,654,473,181,574489.11,219372,793861.11
280470,202203,101,92,9,111504,10908,122412
280480,202203,2971,2024,947,2455514.3,1150188.22,3605702.52
280490,202203,198,187,11,226644.6,13332,239976.6
280500,202203,42,39,3,47268,3636,50904
280510,202203,132,105,27,127260,32724.6,159984.6
280520,202203,52,38,14,46056,16968,63024
280530,202203,69,47,22,56964,26664,83628
280540,202203,542,463,79,561156,95748,656904
280550,202203,730,673,57,818101.45,70296,888397.45
280560,202203,481,431,50,522372.44,60600,582972.44
280570,202203,2324,1835,489,2224021.72,592668,2816689.72
280580,202203,580,454,126,550249.4,152712,702961.4
280590,202203,219,140,79,169680,95748,265428
280600,202203,392,324,68,392744.96,82416,475160.96
280610,202203,109,80,29,96960,35148,132108
280620,202203,543,440,103,533280.16,124836,658116.16
280630,202203,151,123,28,149076,33936,183012
280640,202203,180,145,35,175740,42420,218160
280650,202203,88,55,33,67872,39996,107868
280660,202203,136,102,34,123624,41208,164832
280670,202203,1981,1254,727,1522275.8,882337.36,2404613.16
280680,202203,239,207,32,250884,38784,289668
280690,202203,79,69,10,83628,12120,95748
280700,202203,19,19,0,23028,,23028.0
280710,202203,1498,1168,330,1416829.88,399960,1816789.88
280720,202203,124,84,40,101808,48480,150288
280730,202203,29,24,5,30300,6060,36360
280740,202203,2538,1903,635,2308860,769620,3078480
280750,202203,227,198,29,239976,35148,275124
280760,202203,868,590,278,716292.44,336936,1053228.44
290010,202203,196,139,57,168468,69084,237552
290020,202203,191,173,18,209676,21816,231492
290030,202203,613,394,219,478740,266640,745380
290035,202203,130,106,24,128472,29088,157560
290040,202203,298,203,95,246036,115140,361176
290050,202203,88,72,16,87264,19392,106656
290060,202203,257,114,143,138168,173316,311484
290070,202203,5727,2729,2998,3309973.49,3637214.2,6947187.69
290080,202203,451,193,258,233916,312696,546612
290090,202203,359,162,197,196344,239976,436320
290100,202203,1693,1076,617,1304112.8,747804.6,2051917.4
290110,202203,847,491,356,595092.4,431472,1026564.4
290115,202203,192,174,18,210888,21816,232704
290120,202203,779,525,254,636300,309060,945360
290130,202203,444,273,171,330876,207252,538128
290135,202203,295,227,68,275124,82416,357540
290140,202203,315,261,54,316332,65448,381780
290150,202203,135,93,42,112716,50904,163620
290160,202203,243,187,56,226644.48,67872,294516.48
290170,202203,100,71,29,86052,35148,121200
290180,202203,187,138,49,167256.4,59388,226644.4
290190,202203,362,285,77,345420,93324,438744
290195,202203,301,192,109,232704,132108,364812
290200,202203,258,212,46,256944,55752,312696
290205,202203,145,90,55,109080.6,66660,175740.6
290210,202203,1196,875,321,1061712.6,390264,1451976.6
290220,202203,181,103,78,124836,94536,219372
290225,202203,301,120,181,145440,219372,364812
290230,202203,77,46,31,55752,37572,93324
290240,202203,363,123,240,149076,290880,439956
290250,202203,244,225,19,272700,23028,295728
290260,202203,327,260,67,315120.6,81204,396324.6
290265,202203,185,162,23,197556,27876,225432
290270,202203,1381,1144,237,1387740.6,288456.6,1676197.2
290280,202203,473,333,140,403596,169680,573276
290290,202203,1356,815,541,988992.66,655692.6,1644685.26
290300,202203,403,345,58,419352.6,70296,489648.6
290310,202203,284,134,150,162408,181800,344208
290320,202203,4151,2530,1621,3067572.84,1968289.76,5035862.60
290323,202203,197,171,26,207252,31512,238764
290327,202203,156,121,35,146652,42420,189072
290330,202203,122,58,64,70296,77568,147864
290340,202203,772,319,453,386628,550248,936876
290350,202203,672,409,263,496920,318756,815676
290360,202203,323,249,74,301789.61,89688,391477.61
290370,202203,905,400,505,484800.8,612060,1096860.8
290380,202203,329,210,119,254520,144228,398748
290390,202203,2402,1495,907,1813153,1101708,2914861
290395,202203,236,136,100,164832,121200,286032
290400,202203,279,202,77,244824,93324,338148
290405,202203,242,207,35,250884,42420,293304
290410,202203,626,521,105,631452,127260,758712
290420,202203,272,218,54,264216,65448,329664
290430,202203,473,302,171,366024,208464,574488
290440,202203,81,71,10,86052,12120,98172
290450,202203,192,141,51,170892,61812,232704
290460,202203,1923,1145,778,1387740.6,942936,2330676.6
290470,202203,1357,594,763,719928,925969.2,1645897.2
290475,202203,559,521,38,632664,46056,678720
290480,202203,273,158,115,191496,139380,330876
290485,202203,236,217,19,263004,23028,286032
290490,202203,1246,881,365,1068984,442380,1511364
290500,202203,762,399,363,484800,441168,925968
290510,202203,202,162,40,196344,48480,244824
290515,202203,169,102,67,123624,81204,204828
290520,202203,1390,903,487,1095648.6,590244.38,1685892.98
290530,202203,285,259,26,313908,31512,345420
290540,202203,113,59,54,71508,65448,136956
290550,202203,162,134,28,162408,33936,196344
290560,202203,3202,1404,1798,1702860,2181600,3884460
290570,202203,6391,3063,3328,3718417.24,4033539.2,7751956.44
290580,202203,1267,755,512,915060,620544,1535604
290590,202203,568,454,114,550248,138168,688416
290600,202203,1752,1206,546,1461672.84,664176,2125848.84
290610,202203,176,161,15,195132,18180,213312
290620,202203,367,332,35,402384,42420,444804
290630,202203,1961,847,1114,1026564.2,1351380.6,2377944.8
290640,202203,140,112,28,135744,33936,169680
290650,202203,1821,837,984,1014444.76,1192608,2207052.76
290660,202203,263,219,44,265428,53328,318756
290670,202203,980,495,485,599940.6,587820,1187760.6
290680,202203,1231,986,245,1196244,296940,1493184
290682,202203,318,236,82,286032.36,99384,385416.36
290685,202203,242,150,92,181800,111504,293304
290687,202203,1125,730,395,884957.16,478740,1363697.16
290689,202203,148,78,70,94536,84840,179376
290690,202203,582,248,334,300576,406020,706596
290700,202203,242,122,120,147864,145440,293304
290710,202203,754,512,242,622968.6,293304,916272.6
290720,202203,1032,823,209,998688,253308,1251996
290730,202203,1206,706,500,855672.2,606000,1461672.2
290740,202203,23,19,4,23028,4848,27876
290750,202203,1425,613,812,742956,985357.2,1728313.2
290755,202203,74,66,8,79992,9696,89688
290760,202203,259,229,30,277548,36360,313908
290770,202203,180,171,9,207252,10908,218160
290780,202203,1109,873,236,1058076.6,286032,1344108.6
290790,202203,378,256,122,310272,147864.6,458136.6
290800,202203,2418,971,1447,1179276,1753764,2933040
290810,202203,476,323,153,391476.6,185436,576912.6
290820,202203,404,235,169,284820,206040,490860
290830,202203,437,309,128,374508,155136,529644
290840,202203,1791,1118,673,1355017.32,818100.6,2173117.92
290850,202203,935,480,455,581760,551460,1133220
290860,202203,639,288,351,349056.4,426624,775680.4
290870,202203,607,426,181,516312.56,219372.96,735685.52
290880,202203,113,61,52,73932,63024,136956
290890,202203,443,268,175,324816,212100,536916
290900,202203,165,124,41,150288,49692,199980
290910,202203,382,293,89,355116,109080,464196
290920,202203,202,177,25,214524,30300,244824
290930,202203,516,393,123,476316.6,149076,625392.6
290940,202203,225,191,34,231492,41208,272700
290950,202203,157,90,67,109080,81204,190284
290960,202203,472,329,143,401172,173316,574488
290970,202203,239,211,28,255732,33936.6,289668.6
290980,202203,1791,1222,569,1483490.12,689628.2,2173118.32
290990,202203,392,330,62,399960,75144,475104
291000,202203,900,278,622,336936,753864,1090800
291005,202203,2460,1045,1415,1267752,1714980,2982732
291010,202203,163,144,19,174528,23028,197556
291020,202203,94,73,21,88476,25452,113928
291030,202203,95,68,27,82416,32724,115140
291040,202203,624,357,267,432684,323604,756288
291050,202203,1498,793,705,962328.8,854460,1816788.8
291060,202203,1637,907,730,1100496,885972,1986468
291070,202203,1930,1441,489,1748917.35,592669.83,2341587.18
291072,202203,7224,2718,4506,3295428.6,5463696.6,8759125.2
291075,202203,242,196,46,237552.4,55752,293304.4
291077,202203,59,41,18,49692,21816,71508
291080,202203,20745,8856,11889,10743171.19,14419167.6,25162338.79
291085,202203,268,220,48,267852,58176,326028
291090,202203,278,114,164,138168.6,198768,336936.6
291100,202203,1003,336,667,407232,809616,1216848
291110,202203,435,334,101,404808,122412,527220
291120,202203,2410,1245,1165,1508940,1414404,2923344
291125,202203,60,30,30,36360,36360,72720
291130,202203,188,165,23,199980,27876,227856
291140,202203,126,101,25,122412,30300.6,152712.6
291150,202203,377,141,236,170892,286032,456924
291160,202203,389,310,79,375720,95748,471468
291165,202203,47,36,11,43632,13332,56964
291170,202203,3252,1606,1646,1950111.18,1997376.6,3947487.78
291180,202203,1234,499,735,606000,893244,1499244
291185,202203,112,103,9,127260,10908,138168
291190,202203,1391,665,726,805980,879912,1685892
291200,202203,170,125,45,151500,54540,206040
291210,202203,2410,973,1437,1180488.92,1741644.6,2922133.52
291220,202203,296,226,70,273912,84840,358752
291230,202203,969,341,628,413292.6,761136,1174428.6
291240,202203,406,380,26,460560.6,31512,492072.6
291250,202203,419,338,81,409656,99384,509040
291260,202203,61,53,8,64236,9696,73932
291270,202203,1039,447,592,542976,717504,1260480
291280,202203,357,167,190,202404,230280,432684
291290,202203,1666,870,796,1054441.2,964752.4,2019193.6
291300,202203,234,185,49,224220,59388,283608
291310,202203,225,198,27,239976,32724,272700
291320,202203,1319,922,397,1118676,481164,1599840
291330,202203,140,119,21,144228,25452,169680
291340,202203,221,132,89,159984,107868,267852
291345,202203,124,83,41,100596,49692,150288
291350,202203,1764,658,1106,797496,1341684.8,2139180.8
291360,202203,8371,3995,4376,4844364.4,5309773.31,10154137.71
291370,202203,1111,648,463,787800.6,561156,1348956.6
291380,202203,251,198,53,239976,64236,304212
291390,202203,4022,1792,2230,2171905.04,2708820,4880725.04
291400,202203,2088,1457,631,1767096,764772.94,2531868.94
291410,202203,201,173,28,209676.6,33936,243612.6
291420,202203,110,83,27,100596,32724,133320
291430,202203,173,102,71,123624,86052.34,209676.34
291440,202203,524,424,100,513888,121200,635088
291450,202203,926,602,324,729624,392688,1122312
291460,202203,1948,1545,403,1877388.6,488437.33,2365825.93
291465,202203,2261,1075,1186,1302900.6,1438644.6,2741545.2
291470,202203,2882,1450,1432,1758612.72,1736796.6,3495409.32
291480,202203,11890,5132,6758,6222411.88,8196757.8,14419169.68
291490,202203,650,266,384,322392,465408,787800
291500,202203,367,218,149,264216,180588,444804
291510,202203,1202,462,740,559944,896880,1456824
291520,202203,936,418,518,506616,627816,1134432
291530,202203,924,258,666,312696,807192,1119888
291535,202203,120,99,21,119988,25452,145440
291540,202203,357,118,239,143016,289668,432684
291550,202203,1281,607,674,735684.8,816888,1552572.8
291560,202203,5138,2569,2569,3116052.8,3117264.6,6233317.4
291570,202203,220,110,110,133320,133320,266640
291580,202203,1191,733,458,888396.48,556308,1444704.48
291590,202203,100,42,58,50904,70296,121200
291600,202203,1114,554,560,671448,678720,1350168
291610,202203,1393,670,723,812040,877488,1689528
291620,202203,556,264,292,319968,353904,673872
291630,202203,481,150,331,183012,401172,584184
291640,202203,4019,2001,2018,2427639.48,2448241.8,4875881.28
291650,202203,440,301,139,364813.1,168468,533281.1
291660,202203,371,148,223,179376,270276,449652
291670,202203,173,107,66,129684,79992,209676
291680,202203,640,391,249,473892,301788.2,775680.2
291685,202203,578,332,246,402384,298152,700536
291690,202203,460,299,161,362388.6,195132.52,557521.12
291700,202203,1025,789,236,956268,286032,1242300
291710,202203,1573,769,804,932028,974449.2,1906477.2
291720,202203,423,287,136,347844,166044,513888
291730,202203,920,531,389,643572,473892,1117464
291733,202203,295,197,98,238764,118776,357540
291735,202203,81,60,21,72720,25452,98172
291740,202203,343,258,85,312696,103020,415716
291750,202203,2277,1470,807,1784065.17,978084.6,2762149.77
291760,202203,3028,1657,1371,2009496,1664076,3673572
291770,202203,727,494,233,598729.88,282396,881125.88
291780,202203,73,45,28,54540,33936,88476
291790,202203,158,81,77,98172,93324,191496
291800,202203,10278,4318,5960,5243115.34,7232004.6,12475119.94
291810,202203,1068,801,267,970812.6,324816,1295628.6
291820,202203,287,202,85,244824,103020,347844
291830,202203,1031,423,608,512676.76,738108,1250784.76
291835,202203,552,511,41,619332,49692,669024
291840,202203,5089,2539,2550,3078480,3094237.6,6172717.6
291845,202203,266,82,184,99384,223008,322392
291850,202203,312,276,36,334512,43632,378144
291855,202203,262,110,152,133320,185436,318756
291860,202203,163,105,58,127260,71508,198768
291870,202203,82,38,44,46056,53328,99384
291875,202203,158,148,10,179376,12120,191496
291880,202203,431,355,76,431472,92112,523584
291890,202203,243,84,159,101808,192708.6,294516.6
291900,202203,56,33,23,39996,27876,67872
291905,202203,115,87,28,105444.84,33936,139380.84
291910,202203,159,127,32,153924,38784,192708
291915,202203,439,391,48,473892,58176,532068
291920,202203,5346,2600,2746,3152412.6,3331788.8,6484201.4
291930,202203,168,102,66,123624.26,82416,206040.26
291940,202203,370,213,157,258156,191496,449652
291950,202203,1139,903,236,1094436.6,286032,1380468.6
291955,202203,1358,819,539,992628,653268,1645896
291960,202203,199,147,52,178164,63024,241188
291970,202203,759,565,194,687204,236340,923544
291980,202203,1448,1266,182,1534393.68,220584.6,1754978.28
291990,202203,138,127,11,153924,13332,167256
291992,202203,178,90,88,109080,106656,215736
291995,202203,182,115,67,140592,82416,223008
292000,202203,411,301,110,364812,133320,498132
292010,202203,328,226,102,273912,123624,397536
292020,202203,296,218,78,264216,94536,358752
292030,202203,148,113,35,136956,42420,179376
292040,202203,586,306,280,370872,339360,710232
292045,202203,115,103,12,124836,14544,139380
292050,202203,926,675,251,819312,305424.6,1124736.6
292060,202203,883,717,166,870217.44,202404,1072621.44
292070,202203,64,24,40,29088,48480,77568
292080,202203,152,105,47,127260,56964,184224
292090,202203,535,188,347,227856,420564,648420
292100,202203,1508,653,855,792648.6,1036260,1828908.6
292105,202203,178,159,19,192708,23028,215736
292110,202203,2269,833,1436,1009596,1745280,2754876
292120,202203,690,529,161,641148,195132,836280
292130,202203,465,259,206,315120.6,249672,564792.6
292140,202203,216,174,42,210888,50904,261792
292145,202203,159,83,76,100596,92112,192708
292150,202203,1494,1233,261,1496820.6,316332,1813152.6
292160,202203,161,127,34,153924,41208,195132
292170,202203,1180,1010,170,1224120.6,206040,1430160.6
292180,202203,223,164,59,198768,71508,270276
292190,202203,155,99,56,119988,67872,187860
292200,202203,1404,510,894,618120,1085953.2,1704073.2
292205,202203,115,97,18,117564,21816,139380
292210,202203,388,263,125,318756,151500,470256
292220,202203,34,22,12,26664,14544,41208
292225,202203,47,39,8,47268,9696,56964
292230,202203,997,758,239,918696,289668,1208364
292240,202203,631,454,177,550248.8,215736,765984.8
292250,202203,1649,1077,572,1305324,693264,1998588
292260,202203,408,245,163,296940,198768,495708
292265,202203,247,182,65,221796,78780,300576
292270,202203,719,345,374,418140,453288,871428
292273,202203,205,120,85,145440,103020,248460
292275,202203,171,87,84,105444,101808,207252
292280,202203,147,101,46,122412,55752,178164
292285,202203,87,69,18,83628,23028,106656
292290,202203,586,388,198,470256,239976,710232
292300,202203,1782,683,1099,827796,1331988.28,2159784.28
292303,202203,128,84,44,101808,53328,155136
292305,202203,120,87,33,105444,39996,145440
292310,202203,979,635,344,769620.8,416928.64,1186549.44
292320,202203,589,437,152,529644,184224,713868
292330,202203,177,109,68,132108,82416,214524
292335,202203,293,234,59,283608,71508,355116
292340,202203,556,387,169,470256,204828,675084
292350,202203,272,147,125,178164,151500,329664
292360,202203,713,535,178,648420.64,215736,864156.64
292370,202203,725,550,175,666600,212100,878700
292380,202203,620,510,110,618120.76,133320,751440.76
292390,202203,395,158,237,191496,287244,478740
292400,202203,3626,2241,1385,2716095.26,1679832.4,4395927.66
292405,202203,271,184,87,223008,106656,329664
292410,202203,119,72,47,87264,56964,144228
292420,202203,284,244,40,295728,48480,344208
292430,202203,545,397,148,482376,179376,661752
292440,202203,637,532,105,644784.92,127260,772044.92
292450,202203,235,180,55,218160,66660,284820
292460,202203,520,387,133,469045.12,161196.6,630241.72
292465,202203,207,176,31,213312,37572,250884
292467,202203,154,97,57,117564,69084,186648
292470,202203,304,206,98,249672.2,119988,369660.2
292480,202203,393,266,127,322392,155136.6,477528.6
292490,202203,241,178,63,215736,76356,292092
292500,202203,872,397,475,481164.09,575700,1056864.09
292510,202203,3598,1706,1892,2068884.96,2294317,4363201.96
292520,202203,1116,521,595,632664,721140,1353804
292525,202203,424,303,121,367236.4,146652,513888.4
292530,202203,4746,1890,2856,2291892.65,3466321.2,5758213.85
292540,202203,487,280,207,339360,250884,590244
292550,202203,1120,603,517,730836,627816,1358652
292560,202203,324,297,27,359964,32724,392688
292570,202203,319,248,71,300576,86052,386628
292575,202203,544,380,164,460560,198768,659328
292580,202203,1002,670,332,812040,402384.6,1214424.6
292590,202203,561,497,64,602364,77568,679932
292593,202203,144,112,32,135744,38784,174528
292595,202203,201,160,41,193920,49692,243612
292600,202203,1251,896,355,1087164.95,431472,1518636.95
292610,202203,116,93,23,112716,27876,140592
292620,202203,524,441,83,534492,100596,635088
292630,202203,1511,823,688,998688.6,833856,1832544.6
292640,202203,878,605,273,733260,330876,1064136
292650,202203,183,145,38,175740.78,46056,221796.78
292660,202203,1926,1358,568,1647108,688416.36,2335524.36
292665,202203,137,97,40,117564,48480,166044
292670,202203,384,301,83,364812,100596,465408
292680,202203,264,194,70,235128,84840,319968
292690,202203,205,143,62,173316.6,75144,248460.6
292700,202203,998,649,349,789012,424200,1213212
292710,202203,113,99,14,119988,16968,136956
292720,202203,970,556,414,673872.6,502980,1176852.6
292730,202203,199,94,105,116352,128472,244824
292740,202203,71877,34553,37324,41913402.54,45283967.41,87197369.95
292750,202203,388,280,108,339360.32,130896,470256.32
292760,202203,334,279,55,338148,66660,404808
292770,202203,858,368,490,446016,597516,1043532
292780,202203,19,8,11,9696,13332,23028
292790,202203,782,410,372,496920,452076,948996
292800,202203,1262,752,510,911424,619332,1530756
292805,202203,388,131,257,158772,313908,472680
292810,202203,1804,1072,732,1300477.8,887184,2187661.8
292820,202203,700,592,108,717504,130896,848400
292830,202203,126,100,26,121200,31512,152712
292840,202203,695,568,127,688416.4,153924,842340.4
292850,202203,137,91,46,110292,55752,166044
292860,202203,2093,1203,890,1458036.6,1079892.4,2537929.0
292870,202203,3664,2399,1265,2911224.52,1533180,4444404.52
292880,202203,1426,943,483,1142916.08,585396,1728312.08
292890,202203,527,440,87,533280,105444,638724
292895,202203,147,98,49,118776,59388,178164
292900,202203,346,248,98,300576,119988,420564
292905,202203,484,232,252,282396,306636,589032
292910,202203,473,352,121,426624.2,146652,573276.2
292920,202203,527,225,302,272700,366024,638724
292925,202203,472,432,40,523584,48480,572064
292930,202203,662,400,262,484800,318756,803556
292935,202203,272,113,159,136956,192708,329664
292937,202203,226,157,69,190284,83628,273912
292940,202203,187,143,44,173316,53328,226644
292950,202203,1239,598,641,724777.6,776892.6,1501670.2
292960,202203,518,370,148,449652,180588,630240
292970,202203,234,172,62,208465.16,75144,283609.16
292975,202203,91,54,37,65448,46056.4,111504.4
292980,202203,326,225,101,272700.1,122412,395112.1
292990,202203,1320,979,341,1186548.2,413292,1599840.2
293000,202203,112,79,33,95748,39996,135744
293010,202203,2946,1735,1211,2104033.2,1468944.6,3572977.8
293015,202203,606,495,111,599940,134532,734472
293020,202203,323,261,62,316332,75144.4,391476.4
293030,202203,577,509,68,616908.2,82416,699324.2
293040,202203,372,298,74,361176,89688,450864
293050,202203,2936,1726,1210,2091912.6,1468946.2,3560858.8
293060,202203,248,196,52,237552.44,64236,301788.44
293070,202203,3681,1856,1825,2249473.2,2216748.8,4466222.0
293075,202203,95,65,30,78780,36360,115140
293076,202203,75,55,20,66660,24240,90900
293077,202203,581,328,253,397536.6,306636,704172.6
293080,202203,423,378,45,458136.96,54540,512676.96
293090,202203,130,117,13,141804,15756,157560
293100,202203,522,358,164,433896,198768,632664
293105,202203,351,254,97,307848,117564,425412
293110,202203,120,81,39,98172,47268,145440
293120,202203,302,208,94,252096,113928,366024
293130,202203,244,163,81,197556,98172,295728
293135,202203,8294,3244,5050,3935367.2,6126663.53,10062030.73
293140,202203,189,114,75,138168.4,90900,229068.4
293150,202203,303,264,39,319968,47268,367236
293160,202203,426,262,164,318756,199980,518736
293170,202203,205,129,76,156348,92112,248460
293180,202203,575,390,185,472680.6,224220,696900.6
293190,202203,1367,940,427,1139282.56,519948.6,1659231.16
293200,202203,542,478,64,579336,77568,656904
293210,202203,423,324,99,392688,119988,512676
293220,202203,2396,1036,1360,1255632,1648320,2903952
293230,202203,1837,688,1149,833856.05,1392588,2226444.05
293240,202203,229,211,18,255732,23028,278760
293245,202203,126,104,22,126048,26664,152712
293250,202203,768,316,452,382992,550248,933240
293260,202203,302,247,55,299364,66660,366024
293270,202203,1176,534,642,647208.4,778104,1425312.4
293280,202203,304,180,124,220584,150288,370872
293290,202203,3045,1978,1067,2398548.6,1293204,3691752.6
293300,202203,795,559,236,677508.8,286032,963540.8
293305,202203,192,148,44,179376,53328,232704
293310,202203,167,124,43,151500,52116,203616
293315,202203,164,126,38,153924,46056,199980
293317,202203,88,64,24,77568,29088,106656
293320,202203,1089,587,502,712656.6,609637,1322293.6
293325,202203,200,74,126,89688,152712,242400
293330,202203,14219,6466,7753,7839220.14,9412395.6,17251615.74
293340,202203,291,206,85,249672,103020,352692
293345,202203,261,210,51,254520,61812,316332
293350,202203,594,363,231,441168,279972,721140
293360,202203,1509,1080,429,1308960,522372,1831332
310010,202203,142,75,67,90900,81204,172104
310020,202203,1005,550,455,666600,553884,1220484
310030,202203,309,247,62,299364,75144,374508
310040,202203,45,29,16,35148,19392,54540
310050,202203,155,99,56,119988,67872,187860
310060,202203,263,181,82,219372,99384,318756
310070,202203,14,8,6,9696,7272,16968
310080,202203,44,29,15,35148,18180,53328
310090,202203,1054,572,482,694478.73,586608.6,1281087.33
310100,202203,317,226,91,273912,111504,385416
310110,202203,687,366,321,443592,389052,832644
310120,202203,374,219,155,265428,187860,453288
310130,202203,30,17,13,20604,15756,36360
310140,202203,23,8,15,9696,18180,27876
310150,202203,1149,773,376,936877,455713.2,1392590.2
310160,202203,2045,1007,1038,1220485.36,1258056.6,2478541.96
310163,202203,91,50,41,60600.6,49692,110292.6
310170,202203,2491,1136,1355,1376832,1645900.2,3022732.2
310180,202203,162,65,97,78780,117564,196344
310190,202203,475,323,152,391476,184224,575700
310200,202203,442,279,163,338148,197556,535704
310205,202203,68,46,22,55752,27876,83628
310210,202203,267,218,49,264216,59388,323604
310220,202203,58,33,25,39996,30300,70296
310230,202203,270,192,78,233916,94536,328452
310240,202203,111,94,17,113928,20604,134532
310250,202203,97,76,21,92112,25452,117564
310260,202203,710,373,337,452076.36,409656,861732.36
310270,202203,266,173,93,209676.36,115140,324816.36
310280,202203,379,272,107,329664,129684,459348
310285,202203,198,149,49,180588,59388,239976
310290,202203,227,124,103,151500,124836,276336
310300,202203,166,133,33,161196,39996,201192
310310,202203,11,8,3,9696,3636,13332
310320,202203,30,10,20,12120,24240,36360
310330,202203,38,26,12,31512,14544,46056
310340,202203,1841,1256,585,1524698,709020.6,2233718.6
310350,202203,2735,1441,1294,1747705.2,1570752,3318457.2
310360,202203,47,39,8,47268,9696,56964
310370,202203,125,106,19,128472,23028,151500
310375,202203,108,40,68,48480,82416,130896
310380,202203,52,31,21,37572,25452,63024
310390,202203,105,67,38,81204,46056,127260
310400,202203,2388,1543,845,1874965,1025352,2900317
310410,202203,116,65,51,79992,61812,141804
310420,202203,654,332,322,402384,390265.4,792649.4
310430,202203,278,172,106,208464,128472,336936
310440,202203,72,41,31,49692,37572,87264
310445,202203,80,67,13,81204,15756,96960
310450,202203,638,415,223,504192,270276,774468
310460,202203,248,174,74,210888,89688,300576
310470,202203,515,334,181,404808,219372,624180
310480,202203,91,56,35,67872,42420,110292
310490,202203,542,253,289,306636,350268,656904
310500,202203,125,49,76,59388,92112,151500
310510,202203,598,422,176,511464,213312,724776
310520,202203,139,99,40,119988,48480,168468
310530,202203,105,40,65,48480,78780,127260
310540,202203,474,268,206,324816.4,249672,574488.4
310550,202203,70,48,22,58176,26664,84840
310560,202203,3037,2070,967,2512478,1173216,3685694
310570,202203,103,63,40,76356,48480,124836
310590,202203,367,226,141,273912.4,170892,444804.4
310600,202203,139,71,68,86052,82416,168468
310610,202203,55,22,33,26664,39996.02,66660.02
310620,202203,47576,22365,25211,27135402.2,30590908.21,57726310.41
310630,202203,689,411,278,498132.4,336936,835068.4
310640,202203,136,94,42,113928,50904,164832
310650,202203,146,130,16,157560,19392,176952
310660,202203,109,75,34,90900,41208,132108
310665,202203,64,46,18,55752,21816,77568
310670,202203,7005,2979,4026,3616613,4884360.6,8500973.6
310680,202203,68,40,28,48480,33936,82416
310690,202203,614,428,186,518736.4,225432,744168.4
310700,202203,60,38,22,46056,26664,72720
310710,202203,1263,850,413,1030545.42,500556.6,1531102.02
310720,202203,146,39,107,47268,129684,176952
310730,202203,1506,1027,479,1244724.6,581760,1826484.6
310740,202203,992,549,443,665389.2,536916.6,1202305.8
310750,202203,250,156,94,189072.04,113928,303000.04
310760,202203,66,53,13,64236,15756,79992
310770,202203,87,43,44,52116,53328,105444
310780,202203,351,286,65,346632.6,78780,425412.6
310790,202203,108,87,21,105444,25452,130896
310800,202203,469,221,248,267852,301788,569640
310810,202203,171,116,55,140592.72,66660,207252.72
310820,202203,320,257,63,311484,76356,387840
310825,202203,209,176,33,213312,39996,253308
310830,202203,447,211,236,255732.82,286032,541764.82
310840,202203,359,211,148,255732,179376,435108
310850,202203,77,64,13,77568,15756,93324
310855,202203,406,318,88,385416,106656,492072
310860,202203,1585,1170,415,1418526,502980.8,1921506.8
310870,202203,50,42,8,50904,9696,60600
310880,202203,84,69,15,83628,18180,101808
310890,202203,292,167,125,203616,151500,355116
310900,202203,614,270,344,327245.44,418149.36,745394.80
310910,202203,240,161,79,195133.4,95748,290881.4
310920,202203,429,250,179,303000.72,216948.2,519948.92
310925,202203,35,27,8,32724,9696,42420
310930,202203,1273,833,440,1010808,533280,1544088
310940,202203,675,339,336,410868.6,408444,819312.6
310945,202203,129,80,49,96960,59388,156348
310950,202203,219,177,42,214524,50904,265428
310960,202203,76,24,52,29088,64236,93324
310970,202203,162,96,66,116352,79992.6,196344.6
310980,202203,46,31,15,37572,18180,55752
310990,202203,164,87,77,105444.6,93324,198768.6
311000,202203,809,388,421,471469.09,510252,981721.09
311010,202203,46,38,8,46056,9696,55752
311020,202203,41,24,17,29088,20604,49692
311030,202203,385,218,167,264216,202404,466620
311040,202203,41,32,9,38784,10908,49692
311050,202203,487,185,302,224220,366024,590244
311060,202203,790,437,353,529644,427836,957480
311070,202203,324,142,182,172104,221796,393900
311080,202203,106,61,45,73932,54540,128472
311090,202203,334,159,175,193920,212100,406020
311100,202203,546,325,221,393900,267852,661752
311110,202203,701,502,199,608424.6,241188,849612.6
311115,202203,75,52,23,63024,27876,90900
311120,202203,1070,577,493,699324.6,597516,1296840.6
311130,202203,293,173,120,209676,145440,355116
311140,202203,160,84,76,101808,92112,193920
311150,202203,342,215,127,261792,155136.6,416928.6
311160,202203,753,537,216,650845.2,261792,912637.2
311170,202203,88,72,16,87264,19392,106656
311180,202203,305,205,100,248460,121200.6,369660.6
311190,202203,36,16,20,19392,24240,43632
311200,202203,341,233,108,282396,130896,413292
311205,202203,34,26,8,31512,9696,41208
311210,202203,36,31,5,37572.6,6060,43632.6
311220,202203,31,27,4,32724,4848,37572
311230,202203,1645,1077,568,1305325,689628,1994953
311240,202203,203,126,77,152712,93324,246036
311250,202203,60,22,38,26664,46056,72720
311260,202203,545,340,205,412080,248460,660540
311265,202203,126,84,42,101808,50904,152712
311270,202203,289,200,89,242400,107868,350268
311280,202203,192,82,110,99384,133320,232704
311290,202203,102,82,20,99384,24240,123624
311300,202203,579,370,209,448440.6,254520,702960.6
311310,202203,18,15,3,18180,3636,21816
311320,202203,623,461,162,558732,196344,755076
311330,202203,1108,812,296,984144,358752.2,1342896.2
311340,202203,2591,1827,764,2216749.2,927180,3143929.2
311350,202203,266,206,60,249672,72720,322392
311360,202203,179,105,74,127260,89688,216948
311370,202203,1222,501,721,607212,876276,1483488
311380,202203,7,6,1,7272,1212,8484
311390,202203,243,137,106,166044,129684,295728
311400,202203,139,86,53,104232,64236,168468
311410,202203,113,55,58,66660,70296,136956
311420,202203,307,162,145,196344.4,175740,372084.4
311430,202203,824,548,276,664176,335724,999900
311440,202203,449,307,142,372084,172104,544188
311450,202203,296,176,120,213312,145440,358752
311455,202203,262,179,83,216948,100596,317544
311460,202203,130,57,73,69084,88476,157560
311470,202203,31,15,16,18180,19392,37572
311480,202203,51,26,25,31512,30300,61812
311490,202203,10,6,4,7272,4848,12120
311500,202203,30,14,16,16968,19392,36360
311510,202203,652,448,204,544188.6,248460,792648.6
311520,202203,39,32,7,38784,8484,47268
311530,202203,1774,1278,496,1548937.92,602364,2151301.92
311535,202203,66,45,21,54540,25452,79992
311540,202203,34,30,4,36360,4848,41208
311545,202203,161,117,44,141804,53328,195132
311547,202203,44,34,10,41208,12120,53328
311550,202203,647,283,364,342996,441168,784164
311560,202203,43,26,17,31512,20604,52116
311570,202203,281,187,94,226644,113928,340572
311580,202203,397,245,152,296940,184224,481164
311590,202203,28,24,4,29088,4848,33936
311600,202203,95,78,17,94536,20604,115140
311610,202203,245,209,36,254520,43632,298152
311615,202203,126,103,23,124836,27876,152712
311620,202203,27,15,12,18180,14544,32724
311630,202203,95,80,15,96960,18180,115140
311640,202203,137,66,71,79992.6,86052,166044.6
311650,202203,128,88,40,106656,48480,155136
311660,202203,418,196,222,239976.6,269064,509040.6
311670,202203,144,98,46,118776.8,55752,174528.8
311680,202203,210,160,50,193920,60600,254520
311690,202203,12,10,2,12120,2424,14544
311700,202203,193,141,52,170892,63024,233916
311710,202203,180,121,59,146652,71508,218160
311720,202203,38,28,10,33936.6,12120,46056.6
311730,202203,564,386,178,467832,215736,683568
311740,202203,25,18,7,21816,8484,30300
311750,202203,723,487,236,590244.8,286032,876276.8
311760,202203,75,33,42,39996,50904,90900
311770,202203,379,178,201,215736.6,244824,460560.6
311780,202203,188,93,95,112716.11,115140,227856.11
311783,202203,86,79,7,95748,8484,104232
311787,202203,39,14,25,16968,30300,47268
311790,202203,264,114,150,138168,181800,319968
311800,202203,695,429,266,519948,322392,842340
311810,202203,50,39,11,47268,13332,60600
311820,202203,119,93,26,113928,31512,145440
311830,202203,1885,1139,746,1384104.2,905364,2289468.2
311840,202203,1026,570,456,692052.6,552672.6,1244725.2
311850,202203,15,11,4,13332,4848,18180
311860,202203,9680,4104,5576,4980109.6,6764174.4,11744284.0
311870,202203,111,63,48,76356,58176,134532
311880,202203,948,686,262,832644,318756,1151400
311890,202203,196,93,103,112616,124836,237452
311900,202203,65,28,37,33936,44844,78780
311910,202203,1377,853,524,1033836.6,635089.2,1668925.8
311920,202203,221,147,74,178164,89688,267852
311930,202203,899,507,392,614484.83,475104,1089588.83
311940,202203,2587,1376,1211,1668926.68,1468944,3137870.68
311950,202203,66,44,22,53328,26664,79992
311960,202203,62,45,17,54540,21816,76356
311970,202203,22,12,10,14544,12120,26664
311980,202203,41,30,11,36360,13332,49692
311990,202203,36,26,10,31512,12120,43632
311995,202203,48,28,20,33936,24240,58176
312000,202203,22,14,8,16968,9696,26664
312010,202203,74,58,16,70296,19392,89688
312015,202203,75,58,17,70296,20604,90900
312020,202203,136,96,40,116352,48480,164832
312030,202203,69,52,17,63024,20604,83628
312040,202203,78,49,29,59388,35148,94536
312050,202203,195,110,85,133320.6,103020,236340.6
312060,202203,23,14,9,16968,10908,27876
312070,202203,77,50,27,60600,32724,93324
312080,202203,546,248,298,300576,361176,661752
312083,202203,61,38,23,46056,27876,73932
312087,202203,95,72,23,87264,27876,115140
312090,202203,3295,2003,1292,2427638.6,1570753.2,3998391.8
312100,202203,145,102,43,123345.24,52116,175461.24
312110,202203,114,70,44,84840,53328,138168
312120,202203,124,92,32,111504.95,38784,150288.95
312125,202203,86,53,33,64236,39996,104232
312130,202203,134,89,45,107868,54540,162408
312140,202203,143,110,33,133320.6,39996,173316.6
312150,202203,39,31,8,37572,9696,47268
312160,202203,1491,981,510,1190294,619332,1809626
312170,202203,11,8,3,9696,3636,13332
312180,202203,103,68,35,82416,42420,124836
312190,202203,38,34,4,41208,4848,46056
312200,202203,737,632,105,765985.2,127260,893245.2
312210,202203,118,62,56,75144,67872,143016
312220,202203,131,100,31,121200,37572,158772
312230,202203,3701,1690,2011,2050704.84,2439757.8,4490462.64
312235,202203,153,103,50,124836,60600,185436
312240,202203,78,54,24,65448,29088,94536
312245,202203,199,139,60,168468,73932,242400
312247,202203,81,60,21,72720,25452,98172
312250,202203,175,89,86,107868.6,104232,212100.6
312260,202203,100,67,33,81204,39996,121200
312270,202203,136,82,54,99384,66660,166044
312280,202203,31,16,15,19392,18180,37572
312290,202203,143,97,46,117564,55752,173316
312300,202203,196,128,68,155136,82416,237552
312310,202203,60,52,8,63024,9696,72720
312320,202203,409,253,156,306636,189072.8,495708.8
312330,202203,89,73,16,88476,19392,107868
312340,202203,34,16,18,19392,21816,41208
312350,202203,13,7,6,8484,7272,15756
312352,202203,98,70,28,84840,33936,118776
312360,202203,560,238,322,288456,390264,678720
312370,202203,332,185,147,224220,180588,404808
312380,202203,141,93,48,113928,58176,172104
312385,202203,157,129,28,156348.6,33936,190284.6
312390,202203,292,187,105,226644,127260.6,353904.6
312400,202203,376,280,96,339360,116353.2,455713.2
312410,202203,1131,384,747,466620.6,905364.6,1371985.2
312420,202203,652,489,163,593880.6,197556,791436.6
312430,202203,874,626,248,759924,301788,1061712
312440,202203,38,30,8,36360,9696,46056
312450,202203,188,122,66,147864,79992,227856
312460,202203,28,13,15,15756,18180,33936
312470,202203,47,31,16,37572,19392,56964
312480,202203,161,98,63,118776,76356,195132
312490,202203,291,198,93,239976,112716,352692
312500,202203,35,23,12,27876.6,14544,42420.6
312510,202203,575,215,360,260580,436320,696900
312520,202203,28,8,20,10908,24240,35148
312530,202203,35,25,10,31512,12120,43632
312540,202203,87,78,9,94536,10908,105444
312550,202203,35,28,7,33936,8484,42420
312560,202203,192,152,40,185436,48480,233916
312570,202203,444,265,179,321180,216948,538128
312580,202203,93,48,45,58176,54540,112716
312590,202203,230,183,47,221796,56964,278760
312595,202203,128,106,22,128472,26664,155136
312600,202203,70,32,38,38784.4,46056,84840.4
312610,202203,1526,789,737,956271.4,895668.6,1851940.0
312620,202203,226,162,64,197556,77568,275124
312630,202203,70,57,13,69084,15756,84840
312640,202203,39,10,29,12120,35148,47268
312650,202203,149,125,24,151909.04,29088,180997.04
312660,202203,101,73,28,88476.81,33936,122412.81
312670,202203,922,590,332,715080,402384,1117464
312675,202203,38,28,10,33936,12120,46056
312680,202203,69,43,26,52116,31512,83628
312690,202203,233,116,117,140592,141804,282396
312695,202203,27,23,4,27876,4848,32724
312700,202203,242,141,101,170892,123624,294516
312705,202203,82,65,17,78780,20604,99384
312707,202203,134,95,39,115140,47268,162408
312710,202203,1870,1035,835,1256844.48,1014444,2271288.48
312720,202203,49,24,25,29088,30300,59388
312730,202203,266,156,110,189072,133320,322392
312733,202203,47,36,11,43632,13332,56964
312735,202203,23,15,8,18180,9696,27876
312737,202203,69,37,32,44844,38784,83628
312738,202203,66,42,24,50904,29088,79992
312740,202203,80,54,26,65448,31512,96960
312750,202203,97,64,33,77568,39996,117564
312760,202203,279,194,85,235128,103020,338148
312770,202203,8560,4002,4558,4857701.2,5524296,10381997.2
312780,202203,442,337,105,408444,127260,535704
312790,202203,20,15,5,18180,6060,24240
312800,202203,1587,1100,487,1336837.2,590244.24,1927081.44
312810,202203,337,228,109,278760,132108,410868
312820,202203,184,142,42,172104,50904,223008
312825,202203,38,28,10,35148,12120,47268
312830,202203,198,111,87,134532,105444,239976
312840,202203,180,120,60,145440,73932,219372
312850,202203,40,36,4,43632,4848,48480
312860,202203,141,94,47,113928,56964,170892
312870,202203,1103,578,525,701748.6,637512,1339260.6
312880,202203,115,82,33,99384,39996,139380
312890,202203,165,117,48,141804,58176,199980
312900,202203,178,133,45,161196,54540,215736
312910,202203,179,104,75,126048,90900,216948
312920,202203,125,70,55,84840,67872,152712
312930,202203,321,221,100,267852,121200,389052
312940,202203,126,89,37,107868,44844,152712
312950,202203,702,478,224,579336.6,271488,850824.6
312960,202203,151,111,40,134532.64,48480,183012.64
312965,202203,105,83,22,100596,26664,127260
312970,202203,271,225,46,272700,55752,328452
312980,202203,2562,1302,1260,1581662.8,1531968,3113630.8
312990,202203,51,24,27,29088,32724,61812
313000,202203,52,30,22,36360,26664,63024
313005,202203,175,135,40,163620,48480,212100
313010,202203,942,394,548,479952.6,664176.6,1144129.2
313020,202203,192,100,92,121200,111504.6,232704.6
313030,202203,194,129,65,156348.76,78780,235128.76
313040,202203,83,26,57,31512,69084,100596
313050,202203,199,145,54,175740,65448,241188
313055,202203,42,32,10,38784,12120,50904
313060,202203,138,92,46,111504,55752,167256
313065,202203,61,45,16,54540,20604.6,75144.6
313070,202203,127,67,60,81204,72720,153924
313080,202203,37,18,19,21816,23028,44844
313090,202203,678,438,240,530856,290880,821736
313100,202203,202,72,130,87264,157560,244824
313110,202203,152,83,69,100596,83628,184224
313115,202203,219,119,100,145440,121200,266640
313120,202203,854,477,377,578124,458136,1036260
313130,202203,5909,3216,2693,3901432.92,3268765.4,7170198.32
313140,202203,130,74,56,90900,67872,158772
313150,202203,297,237,60,287244,72720,359964
313160,202203,186,139,47,168468.6,56964,225432.6
313170,202203,1365,884,481,1071409.8,582972,1654381.8
313180,202203,309,185,124,224220.6,150288,374508.6
313190,202203,724,423,301,512676.6,364812,877488.6
313200,202203,32,25,7,30300,8484,38784
313210,202203,1005,858,147,1039898.28,180588.6,1220486.88
313220,202203,298,175,123,212100,150288,362388
313230,202203,265,201,64,243612.1,77568,321180.1
313240,202203,2187,1088,1099,1323508.2,1334412.6,2657920.8
313250,202203,1244,942,302,1141704.6,366025.28,1507729.88
313260,202203,93,44,49,53328,59388,112716
313270,202203,1000,584,416,707808.8,504193.8,1212002.6
313280,202203,45,38,7,46056,8484,54540
313290,202203,216,175,41,212100,49692,261792
313300,202203,320,162,158,196344,191496,387840
313310,202203,243,109,134,132108,162408,294516
313320,202203,389,284,105,344208.4,128472,472680.4
313330,202203,1416,868,548,1052016.8,664176,1716192.8
313340,202203,328,236,92,286032,111504,397536
313350,202203,460,294,166,356328,201192,557520
313360,202203,169,78,91,94536,110292,204828
313370,202203,226,79,147,95748,178164,273912
313375,202203,301,177,124,214524,150288,364812
313380,202203,1326,712,614,862944.8,747804,1610748.8
313390,202203,52,48,4,58176,4848,63024
313400,202203,398,272,126,329664.8,152713.2,482378.0
313410,202203,35,16,19,19392,23028,42420
313420,202203,4567,2512,2055,3044546.2,2491873.8,5536420.0
313430,202203,129,64,65,77568,78780,156348
313440,202203,1357,957,400,1161099.49,484801.8,1645901.29
313450,202203,67,33,34,41208,41208,82416
313460,202203,383,162,221,196344,270276,466620
313470,202203,522,244,278,295728,336936.6,632664.6
313480,202203,154,113,41,136956.6,49692,186648.6
313490,202203,541,241,300,294516.6,363600.6,658117.2
313500,202203,29,15,14,18180,16968,35148
313505,202203,1059,818,241,991416,292092,1283508
313507,202203,90,59,31,71508,37572,109080
313510,202203,2847,1777,1070,2156279.62,1296840,3453119.62
313520,202203,3430,2668,762,3234832.17,923544,4158376.17
313530,202203,31,19,12,23028,14544,37572
313535,202203,80,65,15,78780,19392,98172
313540,202203,69,49,20,60600,24240,84840
313545,202203,111,95,16,115140,19392,134532
313550,202203,213,178,35,215736,42420.6,258156.6
313560,202203,342,161,181,196344,219372,415716
313570,202203,70,23,47,27876,56964,84840
313580,202203,1302,749,553,909000.6,672660.6,1581661.2
313590,202203,64,37,27,44844,32724,77568
313600,202203,664,396,268,481164,324816,805980
313610,202203,50,42,8,50904,9696,60600
313620,202203,1355,652,703,791437.2,853248.76,1644685.96
313630,202203,1611,1224,387,1483489.2,470256,1953745.2
313640,202203,117,72,45,87264,54540,141804
313650,202203,222,108,114,130896,138168,269064
313652,202203,26,25,1,30300,1212,31512
313655,202203,77,49,28,59388,33936,93324
313657,202203,48,44,4,53328,4848,58176
313660,202203,131,84,47,101808,56964,158772
313665,202203,664,308,356,373296.2,431472,804768.2
313670,202203,10363,7099,3264,8613690.72,3957180,12570870.72
313680,202203,42,31,11,37572,13332,50904
313690,202203,129,94,35,113928,42420,156348
313695,202203,75,56,19,67872,23028,90900
313700,202203,332,260,72,315120.6,87264,402384.6
313710,202203,126,93,33,112716,39996,152712
313720,202203,1147,524,623,636301.2,757501,1393802.2
313730,202203,70,42,28,50904,33936,84840
313740,202203,141,110,31,133320,37572,170892
313750,202203,411,290,121,351480,146652,498132
313753,202203,224,164,60,198768,72720,271488
313760,202203,1341,502,839,609636.6,1016868.71,1626505.31
313770,202203,407,281,126,340572.6,152712,493284.6
313780,202203,822,433,389,524796,471468,996264
313790,202203,30,29,1,35148,1212,36360
313800,202203,158,95,63,115140,76356.6,191496.6
313810,202203,83,49,34,59388,41208,100596
313820,202203,1326,627,699,759925.36,847188.6,1607113.96
313830,202203,52,37,15,44844,18180,63024
313835,202203,61,52,9,63024,10908,73932
313840,202203,1655,987,668,1196245,810828,2007073
313850,202203,214,89,125,107868,151500,259368
313860,202203,466,356,110,431472.6,133320,564792.6
313862,202203,174,119,55,144228,66660,210888
313865,202203,149,101,48,122412,58176,180588
313867,202203,56,45,11,54540,13332,67872
313868,202203,42,26,16,31512,19392,50904
313870,202203,96,52,44,63024,53328,116352
313880,202203,379,237,142,287244,173316,460560
313890,202203,329,176,153,213312.4,185436,398748.4
313900,202203,819,434,385,526008,467832.6,993840.6
313910,202203,143,95,48,115140,58176,173316
313920,202203,626,431,195,522372,236341.02,758713.02
313925,202203,34,29,5,35148,6060,41208
313930,202203,880,679,201,822948,243612,1066560
313940,202203,1888,1149,739,1392588,899304,2291892
313950,202203,855,523,332,633876.2,402384,1036260.2
313960,202203,1443,828,615,1003537.2,745382.2,1748919.4
313970,202203,183,110,73,133320,88476,221796
313980,202203,217,142,75,172104.6,90900,263004.6
313990,202203,246,160,86,195132,104232,299364
314000,202203,872,579,293,701748.56,356328,1058076.56
314010,202203,87,50,37,60600,44844,105444
314015,202203,75,20,55,24240,66660,90900
314020,202203,60,41,19,49692,23028,72720
314030,202203,71,34,37,41208,44844,86052
314040,202203,43,23,20,27876,24240,52116
314050,202203,288,167,121,202404.8,146652,349056.8
314053,202203,98,60,38,72720,46056,118776
314055,202203,290,179,111,216948,134532,351480
314060,202203,126,110,16,133320.5,19392,152712.5
314070,202203,1048,518,530,629028,644784,1273812
314080,202203,212,135,77,163620,93324.84,256944.84
314085,202203,166,115,51,139380,61812,201192
314090,202203,380,267,113,323605.2,136956,460561.2
314100,202203,528,417,111,505404.2,134532,639936.2
314110,202203,761,348,413,426624,500556.6,927180.6
314120,202203,70,41,29,49692,35148,84840
314130,202203,24,15,9,18180,10908,29088
314140,202203,1111,688,423,833856.8,512676,1346532.8
314150,202203,189,123,66,151500,81204,232704
314160,202203,320,240,80,290880.4,96960,387840.4
314170,202203,84,64,20,77568,24240,101808
314180,202203,728,636,92,770833.2,111504,882337.2
314190,202203,89,55,34,66660,41208,107868
314200,202203,487,332,155,402384.4,189072,591456.4
314210,202203,254,193,61,233916,73932.6,307848.6
314220,202203,303,214,89,259368.6,107868,367236.6
314225,202203,58,38,20,46056,24240,70296
314230,202203,117,52,65,63024,78780,141804
314240,202203,166,119,47,144228,56964,201192
314250,202203,59,36,23,43632,27876,71508
314260,202203,221,109,112,132108,136956,269064
314270,202203,399,311,88,376932,106656,483588
314280,202203,728,395,333,478685.46,403596,882281.46
314290,202203,531,417,114,505404,139380,644784
314300,202203,338,256,82,310272,99384,409656
314310,202203,1320,908,412,1103223.84,499344,1602567.84
314315,202203,37,27,10,32724,12120,44844
314320,202203,571,383,188,465408.6,229068,694476.6
314330,202203,11423,5570,5853,6755691,7101109.8,13856800.8
314340,202203,610,272,338,329664,409656.6,739320.6
314345,202203,59,43,16,52116,19392,71508
314350,202203,172,108,64,130896,77568,208464
314360,202203,54,29,25,35148,30300,65448
314370,202203,71,49,22,59388,26664,86052
314380,202203,108,65,43,78780,52116,130896
314390,202203,3309,2125,1184,2576713.56,1436220.4,4012933.96
314400,202203,682,480,202,581760.6,244824,826584.6
314410,202203,494,319,175,386628,212100,598728
314420,202203,16,8,8,9696,9696,19392
314430,202203,2430,893,1537,1082317.36,1862845.8,2945163.16
314435,202203,178,104,74,126048,89688,215736
314437,202203,37,26,11,31512,13332,44844
314440,202203,95,62,33,75144,39996,115140
314450,202203,160,108,52,130896,63024,193920
314460,202203,624,297,327,359964.6,396324.6,756289.2
314465,202203,101,62,39,75144,47268,122412
314467,202203,71,58,13,70296,15756,86052
314470,202203,403,202,201,244824.6,244824,489648.6
314480,202203,1038,465,573,563581.2,694476,1258057.2
314490,202203,39,23,16,27876,19392,47268
314500,202203,281,197,84,238764,101808,340572
314505,202203,106,70,36,84840,43632,128472
314510,202203,246,202,44,244824,53328,298152
314520,202203,1362,723,639,877492.8,774469.8,1651962.6
314530,202203,745,589,156,715080.4,189072,904152.4
314535,202203,161,100,61,121200,75144,196344
314537,202203,64,38,26,46056,31512,77568
314540,202203,20,12,8,14544,9696,24240
314545,202203,56,38,18,46056,21816,67872
314550,202203,70,38,32,46056,38784,84840
314560,202203,847,451,396,546612.6,481164,1027776.6
314570,202203,16,13,3,15756,3636,19392
314580,202203,13,5,8,6060,9696,15756
314585,202203,26,19,7,23028,8484,31512
314587,202203,82,71,11,86052,13332,99384
314590,202203,554,379,175,460560,212100,672660
314600,202203,932,599,333,725989.2,403596.6,1129585.8
314610,202203,945,489,456,592668.6,552672,1145340.6
314620,202203,139,104,35,126048,42420,168468
314625,202203,98,72,26,87264,31512,118776
314630,202203,1131,605,526,733260,637512,1370772
314640,202203,85,54,31,65448,37572.6,103020.6
314650,202203,166,94,72,113928,87264,201192
314655,202203,59,43,16,52116,19392,71508
314660,202203,16,12,4,14544,4848,19392
314670,202203,210,163,47,197556.6,56964,254520.6
314675,202203,207,124,83,151500,100596,252096
314690,202203,576,312,264,378144,319968,698112
314700,202203,2198,1165,1033,1411981.8,1253208,2665189.8
314710,202203,1773,1003,770,1216849.49,933240,2150089.49
314720,202203,379,216,163,261792,198768,460560
314730,202203,510,271,239,328452,289668,618120
314740,202203,754,349,405,422988,490860,913848
314750,202203,20,16,4,19392,4848,24240
314760,202203,353,151,202,185436,244824,430260
314770,202203,102,69,33,83628,39996,123624
314780,202203,22,9,13,10908,15756,26664
314790,202203,2430,1529,901,1854361.4,1096860.6,2951222.0
314795,202203,58,50,8,60600,9696,70296
314800,202203,2897,1680,1217,2038586.61,1478640,3517226.61
314810,202203,1466,837,629,1015656,762348.4,1778004.4
314820,202203,109,64,45,77568,54540,132108
314830,202203,208,171,37,207252,44844,252096
314840,202203,85,47,38,56964,46056,103020
314850,202203,401,191,210,231492,254520,486012
314860,202203,649,498,151,603576,183012,786588
314870,202203,1575,815,760,987781.2,924756,1912537.2
314875,202203,53,49,4,59388,4848,64236
314880,202203,41,30,11,36360,13332,49692
314890,202203,50,27,23,32724,27876.6,60600.6
314900,202203,26,20,6,24240,7272,31512
314910,202203,233,153,80,185436,96960,282396
314915,202203,132,117,15,141804,18180,159984
314920,202203,85,55,30,66660,36360,103020
314930,202203,1013,485,528,587821.4,641148,1228969.4
314940,202203,39,30,9,36360,10908,47268
314950,202203,23,19,4,23028,4848,27876
314960,202203,24,18,6,21816,7272,29088
314970,202203,164,79,85,95748,103020,198768
314980,202203,295,186,109,225432,132108,357540
314990,202203,445,241,204,293304.4,247248,540552.4
314995,202203,150,66,84,79992,103020,183012
315000,202203,88,69,19,83628,23028,106656
315010,202203,33,21,12,25452,14544,39996
315015,202203,160,127,33,155136,39996,195132
315020,202203,67,57,10,69084,12120,81204
315030,202203,105,81,24,98172,29088,127260
315040,202203,82,51,31,61812,38784,100596
315050,202203,209,126,83,152712,100596,253308
315053,202203,51,35,16,42420,19392,61812
315057,202203,118,93,25,112716,30300,143016
315060,202203,67,56,11,67872.88,13332,81204.88
315070,202203,102,57,45,69084,54540,123624
315080,202203,385,302,83,366024,100596,466620
315090,202203,95,55,40,66660,48480,115140
315100,202203,77,38,39,46056,47268,93324
315110,202203,266,134,132,163620,159984,323604
315120,202203,1780,856,924,1037472.6,1124736.6,2162209.2
315130,202203,327,236,91,286032,110292,396324
315140,202203,527,292,235,356328,286032,642360
315150,202203,967,463,504,561156,610848,1172004
315160,202203,194,98,96,118776,116352,235128
315170,202203,297,200,97,242400.6,117564,359964.6
315180,202203,3179,1335,1844,1620446.4,2238565.4,3859011.8
315190,202203,295,180,115,218160.8,139380,357540.8
315200,202203,1178,701,477,853248.6,579336,1432584.6
315210,202203,1638,956,682,1159884.4,826585.4,1986469.8
315213,202203,28,16,12,19392,14544,33936
315217,202203,193,152,41,184224,49692,233916
315220,202203,1588,1175,413,1424101.52,500556,1924657.52
315230,202203,173,132,41,159984.6,49692,209676.6
315240,202203,383,248,135,301788,166044.6,467832.6
315250,202203,2566,1221,1345,1481064,1634988.8,3116052.8
315260,202203,133,72,61,87264,73932,161196
315270,202203,130,90,40,109080,48480,157560
315280,202203,601,398,203,484801.68,246036,730837.68
315290,202203,182,113,69,136956,83628,220584
315300,202203,94,71,23,86052,27876,113928
315310,202203,79,71,8,86052,9696,95748
315320,202203,140,85,55,103020,67872,170892
315330,202203,60,48,12,58176,14544,72720
315340,202203,387,285,102,345420,123624,469044
315350,202203,153,97,56,117564,67872,185436
315360,202203,95,43,52,52116,63024,115140
315370,202203,54,34,20,41208,24240,65448
315380,202203,5,5,0,6060,,6060.0
315390,202203,60,18,42,21816,50904.6,72720.6
315400,202203,797,594,203,721141.6,247248,968389.6
315410,202203,310,181,129,219372.6,156349.6,375722.2
315415,202203,52,40,12,48480,14544,63024
315420,202203,190,138,52,167256.6,63024,230280.6
315430,202203,651,366,285,443592.6,345420,789012.6
315440,202203,89,59,30,71508,36360,107868
315445,202203,217,181,36,219372,43632,263004
315450,202203,176,129,47,156348,56964,213312
315460,202203,4386,2032,2354,2463997.2,2856685.2,5320682.4
315470,202203,44,17,27,20604,32724,53328
315480,202203,74,20,54,24240,65448,89688
315490,202203,702,436,266,528432,323604,852036
315500,202203,16,12,4,14544,4848,19392
315510,202203,139,97,42,117564,50904,168468
315520,202203,80,68,12,82416,14544,96960
315530,202203,41,21,20,25452,24240,49692
315540,202203,266,187,79,226644,95748,322392
315550,202203,176,142,34,173316,41208,214524
315560,202203,712,564,148,683568.6,179376,862944.6
315570,202203,307,147,160,178165.24,195132.4,373297.64
315580,202203,730,496,234,602364,283608.6,885972.6
315590,202203,190,99,91,121200,110292,231492
315600,202203,320,248,72,300576.6,87264,387840.6
315610,202203,103,49,54,59388,65448,124836
315620,202203,38,30,8,36360,9696,46056
315630,202203,123,87,36,105444,43632,149076
315640,202203,64,38,26,46056,31512,77568
315645,202203,47,31,16,37572,19392,56964
315650,202203,164,120,44,145440,53328,198768
315660,202203,451,201,250,243612.6,303000,546612.6
315670,202203,2374,1105,1269,1340473.2,1541664,2882137.2
315680,202203,784,559,225,678720,272700,951420
315690,202203,675,453,222,550248,269064,819312
315700,202203,1956,1018,938,1236241.73,1138068,2374309.73
315710,202203,358,111,247,134532,300576,435108
315720,202203,492,297,195,359964,236340,596304
315725,202203,190,151,39,184224.6,47268,231492.6
315727,202203,66,37,29,44844,35148,79992
315730,202203,48,43,5,52116,6060,58176
315733,202203,83,52,31,63024,37572,100596
315737,202203,49,37,12,44844,15756,60600
315740,202203,35,26,9,31512,10908,42420
315750,202203,147,108,39,130896,47268,178164
315760,202203,41,31,10,37572,12120,49692
315765,202203,124,73,51,88476,61812,150288
315770,202203,224,144,80,174528.38,96960,271488.38
315780,202203,3771,1867,1904,2270077.56,2308860.78,4578938.34
315790,202203,244,186,58,225432,70296,295728
315800,202203,296,194,102,235128,123624,358752
315810,202203,58,34,24,41208,29088,70296
315820,202203,749,548,201,664178.4,243612,907790.4
315830,202203,118,74,44,89688,53328,143016
315840,202203,80,52,28,63024,33936,96960
315850,202203,266,182,84,221797.4,101808.6,323606.0
315860,202203,17,5,12,6060,14544,20604
315870,202203,41,32,9,38784,10908,49692
315880,202203,93,65,28,78780,33936,112716
315890,202203,106,77,29,93324,35148,128472
315895,202203,405,266,139,322392.6,169680,492072.6
315900,202203,78,37,41,44844,49692,94536
315910,202203,45,27,18,32724,21816,54540
315920,202203,154,102,52,123624,63024,186648
315930,202203,52,17,35,20604,42420,63024
315935,202203,118,95,23,115140.6,27876,143016.6
315940,202203,100,72,28,87264,33936,121200
315950,202203,28,21,7,25452,8484,33936
315960,202203,547,263,284,318756,345420.6,664176.6
315970,202203,30,23,7,29088,8484,37572
315980,202203,668,332,336,403596,407232,810828
315990,202203,259,148,111,179376,134532,313908
316000,202203,47,31,16,37572,19392,56964
316010,202203,84,71,13,86052,15756,101808
316020,202203,108,94,14,113928,16968,130896
316030,202203,373,208,165,252096.6,199980.6,452077.2
316040,202203,528,212,316,256945.2,382992.6,639937.8
316045,202203,51,46,5,55752,6060,61812
316050,202203,21,16,5,19392,6060,25452
316060,202203,101,67,34,81204.6,41208,122412.6
316070,202203,1131,743,388,902941.4,471468,1374409.4
316080,202203,89,57,32,69190.65,38784,107974.65
316090,202203,40,19,21,23028,25452,48480
316095,202203,88,74,14,89688,16968,106656
316100,202203,322,180,142,218160,172104.6,390264.6
316105,202203,42,24,18,29088.6,21816,50904.6
316110,202203,1877,1462,415,1771944.7,502980,2274924.7
316120,202203,79,52,27,63024.6,32724,95748.6
316130,202203,113,83,30,100596.6,36360,136956.6
316140,202203,33,22,11,26664,13332,39996
316150,202203,214,147,67,178164,81204,259368
316160,202203,78,47,31,56964.6,38784,95748.6
316165,202203,71,47,24,56964,29088,86052
316170,202203,187,120,67,146652,81204,227856
316180,202203,209,84,125,101808.6,151500.6,253309.2
316190,202203,146,104,42,126048,50904,176952
316200,202203,645,346,299,420564,363600.55,784164.55
316210,202203,756,499,257,604996.46,311484,916480.46
316220,202203,115,74,41,89688,49692,139380
316225,202203,35,21,14,25452,16968,42420
316230,202203,38,20,18,24240,21816,46056
316240,202203,658,525,133,636300,161196,797496
316245,202203,153,135,18,163620,21816,185436
316250,202203,1614,1091,523,1323505.2,635088,1958593.2
316255,202203,135,108,27,130896,32724,163620
316257,202203,175,89,86,107868,104232,212100
316260,202203,187,130,57,157560,69084.8,226644.8
316265,202203,30,22,8,26664.6,9696,36360.6
316270,202203,676,480,196,581760.4,238764.96,820525.36
316280,202203,538,337,201,408445.35,246036.6,654481.95
316290,202203,811,553,258,670236,312696,982932
316292,202203,558,229,329,277548,398748,676296
316294,202203,105,68,37,82416,44844,127260
316295,202203,341,156,185,190284.6,224220,414504.6
316300,202203,8,7,1,8484,1212,9696
316310,202203,27,14,13,16968,15756,32724
316320,202203,54,28,26,33936,31512,65448
316330,202203,173,118,55,143016,66660,209676
316340,202203,138,94,44,113928,53328,167256
316350,202203,188,130,58,157560.2,70296,227856.2
316360,202203,28,16,12,19392,14544,33936
316370,202203,1178,586,592,710233.4,719928,1430161.4
316380,202203,109,83,26,100596,31512,132108
316390,202203,100,72,28,87264,33936,121200
316400,202203,141,106,35,128472,42420,170892
316410,202203,304,220,84,266640,103020,369660
316420,202203,218,148,70,179376,84840,264216
316430,202203,153,82,71,99384,86052,185436
316440,202203,76,41,35,49692,42420,92112
316443,202203,42,38,4,46056,4848,50904
316447,202203,43,34,9,41208,10908,52116
316450,202203,228,177,51,214524.6,61812,276336.6
316460,202203,86,32,54,38784,65448,104232
316470,202203,1692,1234,458,1495597.53,558732,2054329.53
316480,202203,11,8,3,9696,3636,13332
316490,202203,19,6,13,7272,15756,23028
316500,202203,158,103,55,124836,66660,191496
316510,202203,143,113,30,136956,36360,173316
316520,202203,188,107,81,129684,98172,227856
316530,202203,163,101,62,122412,75144,197556
316540,202203,154,78,76,94536,92112,186648
316550,202203,140,85,55,103020,66660,169680
316553,202203,361,166,195,202404.6,236340.72,438745.32
316555,202203,49,44,5,53328,6060,59388
316556,202203,14,10,4,12120,4848,16968
316557,202203,26,21,5,25452,6060,31512
316560,202203,70,49,21,59388,25452,84840
316570,202203,208,189,19,229068,23028,252096
316580,202203,22,16,6,19392,7272,26664
316590,202203,95,79,16,95748,19392,115140
316600,202203,176,146,30,176952,36360,213312
316610,202203,69,51,18,61812,21816,83628
316620,202203,142,101,41,122412,50904,173316
316630,202203,43,33,10,39996,12120,52116
316640,202203,21,14,7,16968,8484,25452
316650,202203,92,75,17,90900,20604,111504
316660,202203,7,2,5,2424,6060,8484
316670,202203,432,148,284,179376,344208,523584
316680,202203,163,122,41,147864,49692.4,197556.4
316690,202203,166,99,67,119988,81204,201192
316695,202203,59,49,10,59388,12120,71508
316700,202203,19,13,6,15756,7272,23028
316710,202203,756,573,183,696900,221796,918696
316720,202203,5046,2415,2631,2928194,3193620,6121814
316730,202203,14,14,0,16968,,16968.0
316740,202203,150,95,55,115140,66660,181800
316750,202203,23,15,8,18180,9696,27876
316760,202203,309,249,60,301788,72720,374508
316770,202203,167,85,82,103020,99384,202404
316780,202203,68,42,26,50904.6,31512,82416.6
316790,202203,57,40,17,48480,20604,69084
316800,202203,1767,1084,683,1315020,827797,2142817
316805,202203,27,19,8,23028,9696,32724
316810,202203,60,37,23,44844,27876,72720
316820,202203,39,21,18,25452,21816,47268
316830,202203,98,44,54,53328,65448,118776
316840,202203,507,301,206,366024,249672.4,615696.4
316850,202203,303,203,100,246036,121200,367236
316860,202203,6105,2708,3397,3282908.24,4119588.2,7402496.44
316870,202203,1614,1029,585,1247149.4,712657,1959806.4
316880,202203,146,74,72,89688,87264,176952
316890,202203,230,157,73,190284,88476,278760
316900,202203,408,286,122,346632.84,149076,495708.84
316905,202203,21,9,12,10908,14544,25452
316910,202203,65,27,38,32724,46056,78780
316920,202203,140,110,30,133320,36360,169680
316930,202203,1906,955,951,1158673.53,1158672.8,2317346.33
316935,202203,923,549,374,665388.76,454500.6,1119889.36
316940,202203,1088,622,466,759925.4,564793.4,1324718.8
316950,202203,182,85,97,103020,118776,221796
316960,202203,1094,609,485,738109.2,587820,1325929.2
316970,202203,631,500,131,606000,158772,764772
316980,202203,77,39,38,47268,46056,93324
316990,202203,2184,1480,704,1793761.36,855673.09,2649434.45
317000,202203,329,254,75,307848,90900,398748
317005,202203,220,156,64,189072,77568,266640
317010,202203,6495,3645,2850,4420413.28,3456624,7877037.28
317020,202203,15492,6804,8688,8250091.27,10539558.28,18789649.55
317030,202203,84,35,49,42420,59388,101808
317040,202203,3028,1932,1096,2344008.6,1330776.6,3674785.2
317043,202203,70,53,17,64236,20604,84840
317047,202203,40,23,17,27876,20604,48480
317050,202203,141,109,32,132108,38784,170892
317052,202203,144,113,31,136956,37572,174528
317057,202203,172,130,42,157560,50904,208464
317060,202203,61,37,24,44844,29088,73932
317065,202203,51,37,14,44844,16968,61812
317070,202203,1916,881,1035,1067773,1254420.6,2322193.6
317075,202203,95,52,43,63024,52116,115140
317080,202203,916,465,451,563580,547824,1111404
317090,202203,699,547,152,662964,184224,847188
317100,202203,418,316,102,382992,123624,506616
317103,202203,109,88,21,106656,25452,132108
317107,202203,46,39,7,47268,8484,55752
317110,202203,92,46,46,55752,55752,111504
317115,202203,44,40,4,48480,4848,53328
317120,202203,2008,958,1050,1161097.2,1272600.6,2433697.8
317130,202203,2021,1344,677,1628928.2,820524.6,2449452.8
317140,202203,13,12,1,14544,1212,15756
317150,202203,282,170,112,206040.6,135744,341784.6
317160,202203,333,250,83,304213.55,100596,404809.55
317170,202203,238,161,77,195132,93324,288456
317180,202203,429,292,137,353904,167256,521160
317190,202203,259,189,70,229068,84840,313908
317200,202203,810,559,251,677511.24,304212,981723.24
317210,202203,177,92,85,112716,103020,215736
317220,202203,23,11,12,13332,14544,27876
320010,202203,561,403,158,488436.4,191496,679932.4
320013,202203,125,86,39,104232,47268,151500
320016,202203,258,163,95,198768.52,115140.6,313909.12
320020,202203,712,421,291,511465.89,353904,865369.89
320030,202203,162,109,53,132108.06,64236.68,196344.74
320035,202203,137,98,39,118776,47268,166044
320040,202203,492,255,237,309060,287244,596304
320050,202203,119,81,38,98172,46056,144228
320060,202203,1761,822,939,996264.6,1138069.4,2134334.0
320070,202203,101,62,39,75144,47268,122412
320080,202203,799,454,345,550248.6,419353.2,969601.8
320090,202203,1253,806,447,978084,541764,1519848
320100,202203,335,195,140,236340,169680,406020
320110,202203,125,77,48,93325,58176,151501
320115,202203,110,92,18,111504,21816,133320
320120,202203,3637,1882,1755,2282199.44,2130696.64,4412896.08
320130,202203,7750,3397,4353,4118381.12,5278262.37,9396643.49
320140,202203,439,284,155,344209,189072.6,533281.6
320150,202203,2089,1157,932,1402284,1130796,2533080
320160,202203,641,280,361,340572,437532.2,778104.2
320170,202203,106,83,23,100596.1,27876.02,128472.12
320180,202203,56,34,22,41208,26664,67872
320190,202203,234,143,91,173316,110292,283608
320200,202203,62,48,14,58176,16968,75144
320210,202203,896,485,411,589033.2,499344.8,1088378.0
320220,202203,294,105,189,128472,230280,358752
320225,202203,75,60,15,72720,18180,90900
320230,202203,682,436,246,528432,299364,827796
320240,202203,3488,1605,1883,1945262.4,2285833.41,4231095.81
320245,202203,495,337,158,408444.6,191496,599940.6
320250,202203,230,105,125,127260,152712,279972
320255,202203,130,99,31,119988,37572,157560
320260,202203,243,138,105,167256.18,127260.12,294516.30
320265,202203,149,116,33,140592,39996,180588
320270,202203,156,119,37,144228,44844,189072
320280,202203,1195,667,528,808405.42,639936.02,1448341.44
320290,202203,60,49,11,59388,13332,72720
320300,202203,612,415,197,502981.58,239976.96,742958.54
320305,202203,724,389,335,471468,406020.6,877488.6
320310,202203,198,116,82,140592.84,99384,239976.84
320313,202203,337,153,184,185436.6,223008,408444.6
320316,202203,110,80,30,96960,36360,133320
320320,202203,3436,1525,1911,1850725.24,2317344,4168069.24
320330,202203,274,199,75,241188,90900,332088
320332,202203,779,458,321,557521.4,390264.6,947786.0
320334,202203,277,151,126,183012.02,152712,335724.02
320335,202203,141,90,51,109080,61812,170892
320340,202203,564,393,171,476316.88,208464.6,684781.48
320350,202203,1053,429,624,519949.26,758712.6,1278661.86
320360,202203,166,80,86,96960,104232,201192
320370,202203,230,171,59,207252.64,71508.6,278761.24
320380,202203,293,207,86,250884.6,105444,356328.6
320390,202203,1151,672,479,814464.8,581760.2,1396225.0
320400,202203,318,225,93,273912,112716,386628
320405,202203,954,385,569,467832.6,689628.6,1157461.2
320410,202203,945,472,473,572064,574488.6,1146552.6
320420,202203,536,250,286,303000,346632,649632
320425,202203,200,111,89,134532,107868,242400
320430,202203,380,196,184,237552.6,223008,460560.6
320435,202203,165,111,54,134532,65448,199980
320440,202203,207,114,93,138168.24,112716.2,250884.44
320450,202203,134,72,62,87264,75144,162408
320455,202203,235,186,49,225432,59388,284820
320460,202203,282,173,109,209676,132108,341784
320465,202203,111,74,37,89688,44844,134532
320470,202203,714,426,288,516312.6,349056,865368.6
320480,202203,203,133,70,161196,86052,247248
320490,202203,3213,1506,1707,1827698.92,2072523.7,3900222.62
320495,202203,118,68,50,82416,60600.6,143016.6
320500,202203,9758,4728,5030,5733984,6108483.12,11842467.12
320501,202203,543,276,267,334512,324816,659328
320503,202203,298,209,89,253308.06,107868.02,361176.08
320506,202203,254,178,76,215736,92112,307848
320510,202203,1158,507,651,615696.4,789012,1404708.4
320515,202203,82,61,21,73932,25452,99384
320517,202203,214,152,62,184224,75144,259368
320520,202203,7430,3095,4335,3753566.68,5260086.85,9013653.53
320530,202203,6709,3234,3475,3923224.94,4221400.4,8144625.34
330010,202203,3269,1618,1651,1961018.4,2002225.2,3963243.6
330015,202203,196,84,112,101808.64,136956,238764.64
330020,202203,3854,1529,2325,1855574.56,2820325.2,4675899.76
330022,202203,269,134,135,162408,163620,326028
330023,202203,725,206,519,249672,629028,878700
330025,202203,646,121,525,147864,637512.6,785376.6
330030,202203,1826,1139,687,1380468.6,832644,2213112.6
330040,202203,2540,1285,1255,1557420.4,1522272.5,3079692.9
330045,202203,9813,2899,6914,3513590.5,8394312.8,11907903.3
330050,202203,871,545,326,660540,395112,1055652
330060,202203,1109,651,458,789013.2,556308,1345321.2
330070,202203,4130,1416,2714,1716193.8,3293004.4,5009198.2
330080,202203,1597,694,903,841128.8,1095648.6,1936777.4
330090,202203,396,220,176,266640,213312.6,479952.6
330093,202203,244,104,140,126048,169680,295728
330095,202203,66,41,25,49692,30300,79992
330100,202203,10331,5072,5259,6150905.35,6400574,12551479.35
330110,202203,462,211,251,256944.8,305424,562368.8
330115,202203,518,265,253,321180,307848,629028
330120,202203,394,206,188,249672,227856.4,477528.4
330130,202203,1617,410,1207,496920.6,1462884,1959804.6
330140,202203,654,341,313,413292,379356,792648
330150,202203,514,295,219,357540,265428,622968
330160,202203,203,117,86,141804,104232,246036
330170,202203,27145,9126,18019,11074048.44,21869337,32943385.44
330180,202203,258,134,124,162408,150288,312696
330185,202203,1040,360,680,437532,825372,1262904
330187,202203,490,149,341,180588.6,415716,596304.6
330190,202203,6182,2258,3924,2737909.4,4764374.4,7502283.8
330200,202203,4659,1430,3229,1734373.26,3919608.6,5653981.86
330205,202203,460,259,201,313908,243612.6,557520.6
330210,202203,952,567,385,687205.2,466621,1153826.2
330220,202203,2790,1623,1167,1967078.92,1415617.2,3382696.12
330225,202203,567,290,277,351480.4,336936,688416.4
330227,202203,2428,737,1691,893244,2054341,2947585
330230,202203,259,138,121,167256,146652,313908
330240,202203,4146,1958,2188,2375522,2653069.6,5028591.6
330245,202203,150,65,85,78780.36,103020,181800.36
330250,202203,6744,3254,3490,3949910.16,4232304.24,8182214.40
330260,202203,712,187,525,227856,636300.6,864156.6
330270,202203,3852,1217,2635,1478640.4,3193623.4,4672263.8
330280,202203,444,279,165,338149.8,199980.72,538130.52
330285,202203,6760,2090,4670,2536717,5669739.8,8206456.8
330290,202203,711,246,465,298152.8,563580,861732.8
330300,202203,745,467,278,566749.16,338148.6,904897.76
330310,202203,462,258,204,312696.6,248460,561156.6
330320,202203,7909,2805,5104,3405722.8,6190897.2,9596620.0
330330,202203,9367,3446,5921,4180191.82,7185952,11366143.82
330340,202203,2683,1510,1173,1833756,1422888,3256644
330350,202203,19550,7169,12381,8693683.52,15022750.12,23716433.64
330360,202203,2079,966,1113,1172006,1348956,2520962
330370,202203,987,500,487,606001,591456,1197457
330380,202203,952,384,568,466620,688416.4,1155036.4
330385,202203,641,315,326,382992,395112,778104
330390,202203,5917,3038,2879,3683270.2,3496621.8,7179892.0
330395,202203,350,218,132,264216,161196.8,425412.8
330400,202203,709,355,354,430260.4,430260,860520.4
330410,202203,516,367,149,444804.4,180588,625392.4
330411,202203,287,149,138,180588.28,167256,347844.28
330412,202203,227,94,133,115140,161196,276336
330414,202203,5424,2117,3307,2570653.72,4021417.2,6592070.92
330415,202203,613,260,353,315121.8,429048.4,744170.2
330420,202203,2346,1195,1151,1455612.92,1399860,2855472.92
330430,202203,1781,749,1032,907788.6,1253210.4,2160999.0
330440,202203,340,160,180,193920.6,218160,412080.6
330450,202203,118,54,64,65448,77568,143016
330452,202203,2311,963,1348,1167158,1634988.6,2802146.6
330455,202203,120603,40815,79788,49549189.34,96808632.26,146357821.60
330460,202203,251,111,140,134532,169680,304212
330470,202203,1240,663,577,803557.8,699326,1502883.8
330475,202203,1735,490,1245,595092,1510153.2,2105245.2
330480,202203,804,439,365,532068.6,443592.4,975661.0
330490,202203,15839,4874,10965,5921950,13317456.6,19239406.6
330500,202203,1484,634,850,768408,1031412.24,1799820.24
330510,202203,11008,3723,7285,4517126,8839118.8,13356244.8
330513,202203,102,52,50,63024,61812,124836
330515,202203,747,311,436,376932.2,528432.2,905364.4
330520,202203,2561,865,1696,1048380,2060400.6,3108780.6
330530,202203,190,107,83,129684,101808.4,231492.4
330540,202203,332,169,163,204828,197556,402384
330550,202203,2819,958,1861,1162309.52,2257956.6,3420266.12
330555,202203,892,335,557,406020,675084,1081104
330560,202203,722,243,479,294516,580548,875064
330570,202203,294,203,91,247248,110292,357540
330575,202203,811,291,520,352692,630240.4,982932.4
330580,202203,3389,1808,1581,2192509.2,1918597.2,4111106.4
330590,202203,263,136,127,164832.18,155136,319968.18
330600,202203,1289,771,518,935664.6,629028,1564692.6
330610,202203,1642,854,788,1036262,956268.8,1992530.8
330615,202203,228,183,45,221796.6,54540.6,276337.2
330620,202203,1038,399,639,483589,776892,1260481
330630,202203,4338,2590,1748,3142719.2,2121000.8,5263720.0
350010,202203,600,397,203,481165,246036,727201
350020,202203,55,18,37,21816,44844,66660
350030,202203,534,322,212,391476.6,256944,648420.6
350040,202203,123,50,73,60600,88476,149076
350050,202203,349,173,176,210888,213312,424200
350055,202203,122,52,70,63024,86052,149076
350060,202203,90,38,52,46056,63024,109080
350070,202203,791,452,339,549037.66,412080.4,961118.06
350075,202203,71,42,29,52116,35148,87264
350080,202203,57,25,32,30300,38784,69084
350090,202203,88,49,39,59388,47268,106656
350100,202203,266,164,102,199980,123624,323604
350110,202203,45,29,16,35148,19392,54540
350115,202203,160,90,70,109080,84840.6,193920.6
350120,202203,112,70,42,84840,50904,135744
350130,202203,389,169,220,204828.03,266640,471468.03
350140,202203,39,24,15,29088,18180,47268
350150,202203,68,48,20,58176,24240,82416
350160,202203,2399,945,1454,1146552.93,1763461.8,2910014.73
350170,202203,396,225,171,272700.6,207252.6,479953.2
350180,202203,163,92,71,111504,86052.6,197556.6
350190,202203,1016,540,476,655696.19,578124,1233820.19
350200,202203,61,25,36,30300.4,43632,73932.4
350210,202203,1316,713,603,864157.2,730836.95,1594994.15
350220,202203,645,527,118,639936.95,143016,782952.95
350230,202203,73,47,26,56964,31512,88476
350240,202203,57,37,20,44844,24240,69084
350250,202203,1133,519,614,629029.6,745381.4,1374411.0
350260,202203,95,68,27,82416,32724,115140
350270,202203,965,644,321,782953.8,390264.88,1173218.68
350275,202203,307,117,190,141804,230280,372084
350280,202203,4474,2164,2310,2627619.84,2810628,5438247.84
350290,202203,468,202,266,244824,322392.6,567216.6
350300,202203,49,24,25,29088,30300,59388
350310,202203,78,48,30,58176,37572,95748
350315,202203,70,29,41,35148,49692,84840
350320,202203,3384,1604,1780,1947685,2158572.4,4106257.4
350330,202203,1672,859,813,1043535.9,987780.6,2031316.5
350335,202203,17,10,7,12120,8484,20604
350340,202203,124,51,73,61812,88476.2,150288.2
350350,202203,97,49,48,59388,58176,117564
350360,202203,108,71,37,86052,44844,130896
350370,202203,81,43,38,52116.95,46056,98172.95
350380,202203,798,341,457,413293,553884,967177
350390,202203,1753,640,1113,775680.3,1350168,2125848.3
350395,202203,21,17,4,20604,4848,25452
350400,202203,1723,826,897,1001114.85,1089588.21,2090703.06
350410,202203,2976,1247,1729,1511364.6,2096761.22,3608125.82
350420,202203,268,159,109,192709.2,132108,324817.2
350430,202203,92,46,46,55752,55752,111504
350440,202203,148,107,41,129684,49692,179376
350450,202203,1729,963,766,1169582.55,928392.2,2097974.75
350460,202203,394,134,260,163620,315120,478740
350470,202203,20,13,7,15756,8484,24240
350480,202203,200,103,97,124836,117564.6,242400.6
350490,202203,248,112,136,135744,164832,300576
350500,202203,57,23,34,27876,41208,69084
350510,202203,152,92,60,112716,72720,185436
350520,202203,444,231,213,279972,259368,539340
350530,202203,436,205,231,248460,282396,530856
350535,202203,90,62,28,76356,33936,110292
350540,202203,368,196,172,237552,209676,447228
350550,202203,2767,1569,1198,1907688,1456825.9,3364513.9
350560,202203,580,395,185,478740,224220,702960
350570,202203,4507,1823,2684,2211902.55,3256645.15,5468547.70
350580,202203,370,178,192,216948,232704,449652
350590,202203,971,524,447,635088,544188.6,1179276.6
350600,202203,6340,2957,3383,3589949.47,4105045.8,7694995.27
350610,202203,1511,773,738,938088.6,896880,1834968.6
350620,202203,25,15,10,18180,12120,30300
350630,202203,253,130,123,157560.55,149076,306636.55
350635,202203,1120,449,671,544189.56,813252.6,1357442.16
350640,202203,111,81,30,98172,36360,134532
350650,202203,1858,1226,632,1485912,765984,2251896
350660,202203,760,301,459,364812,556308,921120
350670,202203,298,148,150,179376,183012,362388
350680,202203,165,80,85,99384,103020.6,202404.6
350690,202203,204,93,111,112716,134532,247248
350700,202203,873,409,464,495709.2,562368,1058077.2
350710,202203,409,152,257,184224,312696.6,496920.6
350715,202203,55,44,11,53328,14544,67872
350720,202203,19,12,7,14544,8484,23028
350730,202203,43,25,18,30300,21816,52116
350740,202203,237,130,107,157560,129684,287244
350745,202203,27,11,16,13332,19392,32724
350750,202203,2402,1415,987,1716193.2,1198668,2914861.2
350760,202203,3835,1601,2234,1941624.6,2708820.2,4650444.8
350770,202203,55,36,19,43632,23028,66660
350775,202203,49,36,13,43632,15756,59388
350780,202203,442,224,218,271488,264216,535704
350790,202203,368,151,217,183012,264216,447228
350800,202203,522,316,206,382992,249672,632664
350810,202203,508,391,117,475104.37,141804,616908.37
350820,202203,93,52,41,63024,49692,112716
350830,202203,73,39,34,47268,41208,88476
350840,202203,791,322,469,390264.6,568428,958692.6
350850,202203,1824,961,863,1165945.2,1048380,2214325.2
350860,202203,653,341,312,413293,378144.4,791437.4
350870,202203,450,298,152,361176,184224,545400
350880,202203,273,155,118,187860,143016,330876
350890,202203,39,24,15,29088,18180,47268
350900,202203,1608,485,1123,589032.8,1363501.55,1952534.35
350910,202203,21,10,11,12120,13332,25452
350920,202203,764,397,367,482376,448440,930816
350925,202203,1166,609,557,738108.32,676297.31,1414405.63
350930,202203,107,57,50,69084,60600,129684
350940,202203,739,384,355,465408,430260.48,895668.48
350945,202203,110,79,31,95748,37572,133320
350950,202203,17357,7948,9409,9648741.38,11423105.2,21071846.58
350960,202203,1574,642,932,778104,1129584,1907688
350970,202203,1091,539,552,654351.18,670236,1324587.18
350980,202203,97,65,32,78780,38784,117564
350990,202203,379,132,247,159984.6,300576,460560.6
350995,202203,42,18,24,21816,29088,50904
351000,202203,615,404,211,490860.95,256944,747804.95
351010,202203,49,32,17,38784,21816,60600
351015,202203,45,31,14,37572,16968,54540
351020,202203,1501,884,617,1071408.6,751440,1822848.6
351030,202203,339,203,136,246036,164832,410868
351040,202203,981,508,473,615698.13,573276,1188974.13
351050,202203,3502,1558,1944,1888300.6,2359764.6,4248065.2
351060,202203,5842,2106,3736,2553687.68,4534092.6,7087780.28
351070,202203,398,251,147,305426.31,178164,483590.31
351080,202203,743,539,204,654481.2,249672,904153.2
351090,202203,46,22,24,26664,29088,55752
351100,202203,422,228,194,276336.92,235128,511464.92
351110,202203,2063,953,1110,1157462.18,1347744.6,2505206.78
351120,202203,63,32,31,38784,37572,76356
351130,202203,192,62,130,75144,158772,233916
351140,202203,323,195,128,236340,155136,391476
351150,202203,479,243,236,294516.2,286032.6,580548.8
351160,202203,281,166,115,201192.12,139380,340572.12
351170,202203,208,110,98,133320,118776,252096
351190,202203,90,56,34,67872,41208,109080
351200,202203,345,221,124,267852.2,151500,419352.2
351210,202203,119,57,62,69084,75144,144228
351220,202203,552,322,230,390264.6,278760,669024.6
351230,202203,280,190,90,230280,109080,339360
351240,202203,235,111,124,135744,150288,286032
351250,202203,82,54,28,65448.82,33936,99384.82
351260,202203,152,109,43,132108,52116,184224
351270,202203,45,19,26,23028,31512,54540
351280,202203,1046,485,561,587820.95,681144.95,1268965.90
351290,202203,243,108,135,130896,163620,294516
351300,202203,3892,1660,2232,2014250.85,2708821.2,4723072.05
351310,202203,741,359,382,436320,465408,901728
351320,202203,117,62,55,75144,66660.6,141804.6
351330,202203,38,25,13,30300,15756,46056
351340,202203,1364,754,610,913849,739321.77,1653170.77
351350,202203,2359,1354,1005,1642262.04,1222908.2,2865170.24
351360,202203,794,369,425,447228,516312,963540
351370,202203,405,196,209,237552.6,253308,490860.6
351380,202203,8887,3827,5060,4641967.56,6138782.55,10780750.11
351385,202203,28,17,11,20604,13332,33936
351390,202203,279,208,71,252096.76,86052,338148.76
351400,202203,65,43,22,52116,26664,78780
351410,202203,456,277,179,335724.8,216948,552672.8
351420,202203,68,49,19,59388,23028,82416
351430,202203,73,40,33,48480,41208,89688
351440,202203,779,516,263,629032.3,318756,947788.3
351450,202203,271,128,143,155136,173316,328452
351460,202203,129,56,73,67872.6,89688,157560.6
351470,202203,145,76,69,92112,83628,175740
351480,202203,480,282,198,341785.55,241188,582973.55
351490,202203,292,108,184,130896,223008,353904
351492,202203,27,16,11,19392,13332,32724
351495,202203,24,17,7,20604,8484,29088
351500,202203,3483,1404,2079,1701648.6,2524597.84,4226246.44
351510,202203,2066,747,1319,906577.2,1599840.6,2506417.8
351512,202203,13,9,4,10908,4848,15756
351515,202203,199,118,81,143016,98172,241188
351518,202203,694,414,280,502980,340572,843552
351519,202203,82,45,37,54540,44844,99384
351520,202203,162,97,65,118776,78801.81,197577.81
351530,202203,23,13,10,15756,12120,27876
351535,202203,136,82,54,99384,65448,164832
351540,202203,467,311,156,376932.16,189072,566004.16
351550,202203,1490,871,619,1058079.1,750228,1808307.1
351560,202203,75,45,30,54540,36360,90900
351565,202203,12,6,6,7272,7272,14544
351570,202203,2763,1272,1491,1542876.6,1811940.6,3354817.2
351580,202203,38,33,5,39996,6060,46056
351590,202203,63,41,22,49692,26664,76356
351600,202203,178,129,49,157560,59388,216948
351610,202203,52,24,28,29088,33936,63024
351620,202203,5867,3156,2711,3829926.28,3293007.51,7122933.79
351630,202203,3194,1520,1674,1847089.25,2033736.6,3880825.85
351640,202203,2305,992,1313,1203516.6,1591357.55,2794874.15
351650,202203,29,24,5,29088,6060,35148
351660,202203,132,82,50,100596,60600,161196
351670,202203,736,435,301,527221.8,366024,893245.8
351680,202203,77,59,18,71508,21816,93324
351685,202203,11,8,3,9696,3636,13332
351690,202203,300,199,101,241188.3,122412,363600.3
351700,202203,175,114,61,138429,73932,212361
351710,202203,65,41,24,49692,29088,78780
351720,202203,127,71,56,86052,69084,155136
351730,202203,112,75,37,90900,46056,136956
351740,202203,783,492,291,596305.4,352692.6,948998.0
351750,202203,375,147,228,178164,276336,454500
351760,202203,723,554,169,671448,204828,876276
351770,202203,289,237,52,287244,63024,350268
351780,202203,150,90,60,109080,72720,181800
351790,202203,255,129,126,156348,152712,309060
351800,202203,40,26,14,31512,16968,48480
351810,202203,126,84,42,101808,50904,152712
351820,202203,776,549,227,665389.4,275124,940513.4
351830,202203,608,194,414,236340,501768,738108
351840,202203,2140,980,1160,1190186.36,1409556,2599742.36
351850,202203,235,161,74,196344,89688,286032
351860,202203,620,412,208,500557.32,252096,752653.32
351870,202203,5738,2584,3154,3134236.72,3831135.12,6965371.84
351880,202203,21039,8120,12919,9854777.2,15686918.96,25541696.16
351885,202203,87,48,39,58176,47268,105444
351890,202203,69,49,20,59388,24240,83628
351900,202203,229,127,102,153924,123624,277548
351905,202203,96,43,53,52116,65448,117564
351907,202203,3646,1481,2165,1796185.36,2630040.2,4426225.56
351910,202203,163,70,93,84840,112716,197556
351920,202203,112,60,52,72720,63024,135744
351925,202203,91,56,35,67872,42420,110292
351930,202203,422,268,154,324816,186648,511464
351940,202203,236,97,139,117564,168468,286032
351950,202203,140,73,67,88476,81204,169680
351960,202203,928,448,480,544188.95,581760.6,1125949.55
351970,202203,2086,1003,1083,1216848.6,1313808,2530656.6
351980,202203,156,71,85,86052,103020,189072
351990,202203,258,164,94,198769.2,113928,312697.2
352000,202203,321,200,121,242400.6,146652,389052.6
352010,202203,427,273,154,330954,186648,517602
352020,202203,191,67,124,81204,150288,231492
352030,202203,1146,548,598,665388,725988,1391376
352040,202203,619,239,380,290880,460560,751440
352042,202203,311,76,235,92112,284821.2,376933.2
352044,202203,363,210,153,254521.2,185436,439957.2
352050,202203,3274,1193,2081,1450766.15,2529444.6,3980210.75
352060,202203,98,57,41,69084,49692,118776
352070,202203,92,64,28,77569.9,33936,111505.9
352080,202203,63,41,22,49692,26664,76356
352090,202203,171,112,59,135744,71508,207252
352100,202203,295,137,158,166044,192708.6,358752.6
352110,202203,112,34,78,41208,94536,135744
352115,202203,61,21,40,25452,48480,73932
352120,202203,73,50,23,60600.95,27876,88476.95
352130,202203,214,162,52,196344,63024,259368
352140,202203,182,85,97,103020,117564,220584
352150,202203,124,64,60,78780,72720,151500
352160,202203,141,89,52,107868,63024,170892
352170,202203,396,270,126,327240,152712,479952
352180,202203,686,417,269,505405.55,326028.6,831434.15
352190,202203,245,100,145,121200,175740,296940
352200,202203,29,11,18,13332,21816,35148
352210,202203,4376,1735,2641,2103467.17,3205741.4,5309208.57
352215,202203,72,40,32,48480,38784,87264
352220,202203,6402,2372,4030,2874865.4,4887998.55,7762863.95
352230,202203,3460,2192,1268,2662768.25,1538030.27,4200798.52
352240,202203,2656,1496,1160,1814366.2,1409556.6,3223922.8
352250,202203,3246,1444,1802,1751342.23,2185236.6,3936578.83
352260,202203,1012,539,473,653268,574488.6,1227756.6
352265,202203,63,34,29,41208,35148,76356
352270,202203,376,206,170,249672.6,206040,455712.6
352280,202203,495,295,200,357540.95,244824,602364.95
352290,202203,172,101,71,122412,86052,208464
352300,202203,101,64,37,77568,44844,122412
352310,202203,6937,2982,3955,3615399.46,4795886.28,8411285.74
352320,202203,1148,590,558,716293.8,678720,1395013.8
352330,202203,533,269,264,326028.6,321180,647208.6
352340,202203,1370,625,745,758715,905367,1664082
352350,202203,364,202,162,244824,196344,441168
352360,202203,218,100,118,121200,143016,264216
352370,202203,111,66,45,79992,54540,134532
352380,202203,111,77,34,93324,41208,134532
352390,202203,2628,1132,1496,1374410,1814365.28,3188775.28
352400,202203,534,228,306,276336,370872.6,647208.6
352410,202203,922,605,317,735685.31,384204.6,1119889.91
352420,202203,86,65,21,78780,25452,104232
352430,202203,1764,779,985,946575.45,1193821.9,2140397.35
352440,202203,3393,1578,1815,1913750.96,2199780.2,4113531.16
352450,202203,207,160,47,195132,56964,252096
352460,202203,631,314,317,380568,385416,765984
352470,202203,657,235,422,284820.74,512676,797496.74
352480,202203,1554,848,706,1030200,855672.6,1885872.6
352490,202203,50,17,33,20604,39996,60600
352500,202203,1279,514,765,622968,929604,1552572
352510,202203,705,363,342,439956.6,416928.6,856885.2
352520,202203,863,365,498,442380,603577.56,1045957.56
352530,202203,1844,941,903,1140493.2,1095648.6,2236141.8
352540,202203,68,44,24,53328.6,29088,82416.6
352550,202203,203,116,87,140592,105444,246036
352560,202203,49,38,11,46056,13332,59388
352570,202203,722,338,384,412082.15,466620,878702.15
352580,202203,55,43,12,52116,14544,66660
352585,202203,22,6,16,7272,19392,26664
352590,202203,4394,2135,2259,2590047.82,2740439,5330486.82
352600,202203,359,248,111,300576,134532,435108
352610,202203,907,402,505,487224,612060,1099284
352620,202203,1098,406,692,493284,839916,1333200
352630,202203,188,71,117,86052,141804,227856
352640,202203,510,327,183,396324,221796.6,618120.6
352650,202203,85,65,20,78780,25452,104232
352660,202203,69,38,31,46056,37572,83628
352670,202203,1713,900,813,1090801.55,985356,2076157.55
352680,202203,931,567,364,687204,442381.55,1129585.55
352690,202203,4623,2020,2603,2454304.34,3160897.55,5615201.89
352700,202203,86,49,37,59388,44844,104232
352710,202203,1504,779,725,946572,879912,1826484
352720,202203,1516,648,868,786588,1052016,1838604
352725,202203,25,20,5,24240,6060,30300
352730,202203,391,186,205,225432,248460,473892
352740,202203,397,256,141,311484.64,170892.49,482377.13
352750,202203,23,15,8,18180,9696,27876
352760,202203,212,134,78,162408,94536,256944
352770,202203,81,62,19,75144,23028,98172
352780,202203,74,38,36,46056,43632,89688
352790,202203,25,18,7,21816,8484,30300
352800,202203,236,178,58,215736,70296,286032
352810,202203,164,101,63,122412,76356,198768
352820,202203,45,34,11,41208,13332,54540
352830,202203,75,50,25,60600,30300,90900
352840,202203,693,310,383,376932,464196,841128
352850,202203,1738,519,1219,631452,1478640.6,2110092.6
352860,202203,113,71,42,87264,50904,138168
352870,202203,52,32,20,38784,24240,63024
352880,202203,178,105,73,127260,88476,215736
352885,202203,33,23,10,27876,12120,39996
352890,202203,53,34,19,41208,23028.6,64236.6
352900,202203,4649,2179,2470,2642161.8,2997276.2,5639438.0
352910,202203,34,28,6,33936,7272,41208
352920,202203,645,369,276,447228,334512,781740
352930,202203,1198,556,642,675085.82,779316,1454401.82
352940,202203,6272,2397,3875,2906380.05,4703772.6,7610152.65
352950,202203,114,44,70,54540.6,84840,139380.6
352960,202203,64,39,25,47268,30300,77568
352965,202203,15,9,6,10908,8484,19392
352970,202203,516,377,139,456924,168468,625392
352980,202203,162,94,68,113928,82416,196344
352990,202203,978,454,524,550248.6,635088,1185336.6
353000,202203,54,22,32,26664,38784,65448
353010,202203,517,314,203,380568,247248,627816
353020,202203,317,220,97,266640,118776,385416
353030,202203,1381,606,775,735686.3,940512,1676198.3
353040,202203,84,42,42,50904,50904,101808
353050,202203,1313,859,454,1042321.37,550248,1592569.37
353060,202203,8869,3743,5126,4543797.14,6218772,10762569.14
353070,202203,1907,1116,791,1352594.15,958476.26,2311070.41
353080,202203,1308,703,605,852037.44,733260,1585297.44
353090,202203,62,33,29,39996,35148,75144
353100,202203,42,32,10,38784,12120,50904
353110,202203,2187,699,1488,848401.2,1804668,2653069.2
353120,202203,133,70,63,84840,76356,161196
353130,202203,863,411,452,498133.23,550248,1048381.23
353140,202203,569,246,323,298152.95,391476,689628.95
353150,202203,323,169,154,206040.95,186648.6,392689.55
353160,202203,107,81,26,98172,31512,129684
353170,202203,203,64,139,77568,168468,246036
353180,202203,1169,522,647,633877.4,784164.6,1418042.0
353190,202203,490,347,143,421777.4,173316,595093.4
353200,202203,246,116,130,140592,157560,298152
353205,202203,19,12,7,14544,8484,23028
353210,202203,67,40,27,48480,32724,81204
353215,202203,41,23,18,27876,21816,49692
353220,202203,85,46,39,55752,47268,103020
353230,202203,152,63,89,76356.2,107868,184224.2
353240,202203,368,171,197,208464,239976,448440
353250,202203,196,95,101,115140,122412,237552
353260,202203,452,296,156,358752.28,191496,550248.28
353270,202203,72,54,18,65448,21816,87264
353280,202203,104,48,56,58176.4,67872,126048.4
353282,202203,124,86,38,105444,46056,151500
353284,202203,28,19,9,23028,10908,33936
353286,202203,7,3,4,3636,4848,8484
353290,202203,83,43,40,52116,48480,100596
353300,202203,438,222,216,269065.5,264216,533281.5
353310,202203,39,33,6,41208,7272,48480
353320,202203,41,26,15,31512,18180,49692
353325,202203,44,25,19,30300.6,23028,53328.6
353330,202203,64,43,21,52116.8,25452,77568.8
353340,202203,674,228,446,276336,540552.6,816888.6
353350,202203,900,437,463,529644.6,562368,1092012.6
353360,202203,102,80,22,96960,26664,123624
353370,202203,114,66,48,79992,58176,138168
353380,202203,27,13,14,15756,16968,32724
353390,202203,1121,523,598,633876.6,725988,1359864.6
353400,202203,45,27,18,32724,21816,54540
353410,202203,113,65,48,78780,58176.6,136956.6
353420,202203,49,20,29,24240,35148,59388
353430,202203,575,376,199,456925.45,243612,700537.45
353440,202203,12317,5245,7072,6365426.59,8585808.8,14951235.39
353450,202203,57,30,27,36360,32724,69084
353460,202203,636,324,312,393900.4,378144,772044.4
353470,202203,2286,1107,1179,1341684.83,1430160,2771844.83
353475,202203,270,174,96,212100.6,116352,328452.6
353480,202203,177,141,36,170892,43632,214524
353490,202203,224,130,94,157560,113928.6,271488.6
353500,202203,212,118,94,143016,113928,256944
353510,202203,82,56,26,67872,31512,99384
353520,202203,230,165,65,199980,78780.6,278760.6
353530,202203,460,236,224,286032,271488,557520
353540,202203,404,251,153,304212,185436,489648
353550,202203,725,454,271,550248.95,328452.6,878701.55
353560,202203,560,223,337,271488,409656.4,681144.4
353570,202203,63,40,23,48480,29088,77568
353580,202203,349,232,117,281184,141804,422988
353590,202203,85,58,27,70296,32724,103020
353600,202203,270,155,115,187860.95,140592,328452.95
353610,202203,126,66,60,79992,72720,152712
353620,202203,680,336,344,408444.6,418140,826584.6
353625,202203,53,29,24,35148,30300,65448
353630,202203,214,151,63,183012.52,76356,259368.52
353640,202203,123,79,44,95748,53328,149076
353650,202203,993,382,611,464196,744168,1208364
353657,202203,22,18,4,21816,4848,26664
353660,202203,285,147,138,179376,168468,347844
353670,202203,711,410,301,498132.95,366024.6,864157.55
353680,202203,131,89,42,107868,50904.6,158772.6
353690,202203,40,27,13,32724,15756,48480
353700,202203,279,194,85,235128.8,103020,338148.8
353710,202203,493,232,261,281184,316333.2,597517.2
353715,202203,49,30,19,36360,23028,59388
353720,202203,336,154,182,186648.6,221796,408444.6
353730,202203,1173,708,465,859308.6,563580,1422888.6
353740,202203,601,328,273,397536.8,332088.8,729625.6
353750,202203,69,39,30,47268,36360,83628
353760,202203,3204,1193,2011,1447129.24,2440969.3,3888098.54
353770,202203,76,61,15,73932,18180,92112
353780,202203,1346,619,727,753864.95,885972,1639836.95
353790,202203,488,288,200,349056.24,243612,592668.24
353800,202203,3594,1682,1912,2045884.2,2324617.8,4370502.0
353810,202203,229,115,114,139380,138168,277548
353820,202203,242,98,144,119988,175740.6,295728.6
353830,202203,61,49,12,59388,14544,73932
353850,202203,196,88,108,106656,130896,237552
353860,202203,529,225,304,272700.6,368448,641148.6
353870,202203,5654,2834,2820,3438449.4,3422690,6861139.4
353880,202203,713,459,254,557520,310272,867792
353890,202203,570,327,243,396324,299365.44,695689.44
353900,202203,131,67,64,81204,77568,158772
353910,202203,192,77,115,93324,139380,232704
353920,202203,428,225,203,272700.2,246036,518736.2
353930,202203,1053,612,441,741744,534493.2,1276237.2
353940,202203,195,94,101,113928,122412,236340
353950,202203,493,309,184,374508,223008,597516
353960,202203,73,60,13,72720,15756,88476
353970,202203,40,28,12,33936,14544,48480
353980,202203,1850,818,1032,992628.6,1253209.53,2245838.13
353990,202203,78,45,33,54540,39996,94536
354000,202203,377,170,207,206040,252096,458136
354010,202203,90,51,39,61812,47268,109080
354020,202203,503,315,188,381780,229068,610848
354025,202203,35,30,5,36360,6060,42420
354030,202203,44,24,20,29088,24240,53328
354040,202203,100,75,25,90900,31512,122412
354050,202203,171,90,81,109080.4,99384,208464.4
354060,202203,775,356,419,431472,507828,939300
354070,202203,934,529,405,642360.15,493284,1135644.15
354075,202203,186,86,100,104232,121200,225432
354080,202203,312,139,173,168468,210888,379356
354085,202203,22,13,9,15756,10908,26664
354090,202203,268,160,108,193817,130896,324713
354100,202203,5898,2383,3515,2888196.2,4263820.16,7152016.36
354105,202203,98,47,51,56964,61812,118776
354110,202203,42,20,22,24240,26664,50904
354120,202203,151,97,54,117564.19,65448,183012.19
354130,202203,721,433,288,526009.56,349056,875065.56
354140,202203,3264,1459,1805,1771945.2,2196144.6,3968089.8
354150,202203,639,363,276,439957.32,334512,774469.32
354160,202203,656,416,240,504192.8,292093.56,796286.36
354165,202203,14,12,2,14544,2424,16968
354170,202203,172,116,56,140592,67872,208464
354180,202203,55,32,23,38784,27876,66660
354190,202203,201,79,122,95748,147864,243612
354200,202203,109,55,54,66660,65448,132108
354210,202203,72,30,42,36360.6,50904,87264.6
354220,202203,622,390,232,472680.95,281184,753864.95
354230,202203,168,71,97,86052.4,117564,203616.4
354240,202203,329,206,123,249672.75,149076,398748.75
354250,202203,83,49,34,59388,41208,100596
354260,202203,2180,1019,1161,1235029.56,1407133.96,2642163.52
354270,202203,88,60,28,72720,33936,106656
354280,202203,51,27,24,32724,30300,63024
354290,202203,140,94,46,113928,55752.63,169680.63
354300,202203,345,241,104,292092.95,126048,418140.95
354310,202203,90,65,25,78780.6,30300,109080.6
354320,202203,217,107,110,130896,133320,264216
354323,202203,7,7,0,8484,,8484.0
354325,202203,130,69,61,83628.5,73932,157560.5
354330,202203,2452,816,1636,991244.74,1987680.6,2978925.34
354340,202203,10450,4769,5681,5785837.35,6897495.6,12683332.95
354350,202203,140,93,47,112716,56964,169680
354360,202203,71,41,30,49692,36360,86052
354370,202203,236,118,118,143016,143016,286032
354380,202203,172,98,74,118776,89688,208464
354390,202203,2748,968,1780,1173218.26,2159784,3333002.26
354400,202203,310,168,142,204828.95,174528,379356.95
354410,202203,655,291,364,352692.96,441168.6,793861.56
354420,202203,275,179,96,216948,116352,333300
354425,202203,325,178,147,215792,178164,393956
354430,202203,185,100,85,121200,103020,224220
354440,202203,33,27,6,32724,7272,39996
354450,202203,55,36,19,43632.26,23028,66660.26
354460,202203,94,53,41,64236,49692,113928
354470,202203,26,13,13,15756,15756,31512
354480,202203,111,57,54,70296,65448,135744
354490,202203,132,76,56,92112,67872,159984
354500,202203,404,180,224,218160,271488,489648
354510,202203,91,61,30,73932,36360,110292
354515,202203,44,12,32,14544,38784,53328
354520,202203,1616,691,925,838532.82,1123524.2,1962057.02
354530,202203,850,413,437,500557.2,530856,1031413.2
354540,202203,263,130,133,157560,161196,318756
354550,202203,41,22,19,26664,23028,49692
354560,202203,151,80,71,96960,86052,183012
354570,202203,136,93,43,112716,52116,164832
354580,202203,1863,878,985,1065349.8,1198668.6,2264018.4
354600,202203,276,135,141,164832,170892,335724
354610,202203,67,54,13,65448,15756,81204
354620,202203,67,18,49,21816,59388,81204
354625,202203,12,8,4,9696,4848,14544
354630,202203,327,212,115,258156,139380,397536
354640,202203,840,502,338,609636,410868,1020504
354650,202203,64,37,27,44844,32724,77568
354660,202203,808,592,216,717504.95,261792,979296.95
354670,202203,220,81,139,98172,169680,267852
354680,202203,1319,463,856,561156,1038684,1599840
354690,202203,70,47,23,56964.6,27876,84840.6
354700,202203,74,52,22,63024,26664,89688
354710,202203,47,33,14,39996,16968,56964
354720,202203,21,20,1,24240,1212,25452
354730,202203,1801,724,1077,877488.6,1305324,2182812.6
354740,202203,74,50,24,60600,29088,89688
354750,202203,409,231,178,279972,215736,495708
354760,202203,495,308,187,373297.2,226644,599941.2
354765,202203,6,2,4,2424,4848,7272
354770,202203,347,226,121,273912,146652,420564
354780,202203,8416,3124,5292,3789928.48,6421177.72,10211106.20
354790,202203,87,53,34,64236,41208,105444
354800,202203,428,233,195,282347.93,236340,518687.93
354805,202203,80,37,43,44844,52116,96960
354810,202203,98,54,44,65448,53328,118776
354820,202203,209,84,125,101808.64,151500,253308.64
354830,202203,43,22,21,26664,25452,52116
354840,202203,56,39,17,47268,20604,67872
354850,202203,4543,1973,2570,2393705.08,3122112.46,5515817.54
354860,202203,336,155,181,187860,220584,408444
354870,202203,12063,5148,6915,6247868.02,8389470,14637338.02
354880,202203,2696,973,1723,1180489.46,2089545.36,3270034.82
354890,202203,2947,1542,1405,1871331.35,1707708.4,3579039.75
354900,202203,65,45,20,54540,24240,78780
354910,202203,1301,657,644,797496.8,780528,1578024.8
354920,202203,39,32,7,38784,8484,47268
354925,202203,21,11,10,13332,12120,25452
354930,202203,32,28,4,35148.2,4848,39996.2
354940,202203,775,536,239,650844,289668,940512
354950,202203,215,130,85,157560.4,103020,260580.4
354960,202203,130,50,80,60600,96960,157560
354970,202203,1107,751,356,910214.11,431472.6,1341686.71
354980,202203,9268,3285,5983,3988701,7256244.77,11244945.77
354990,202203,10134,4410,5724,5348558.4,6943549.8,12292108.2
354995,202203,579,182,397,220585.2,482376,702961.2
355000,202203,456,160,296,193920,358752,552672
355010,202203,610,376,234,455713,283609.75,739322.75
355020,202203,787,484,303,587820,367236.6,955056.6
355030,202203,214899,79424,135475,96360206.2,164416364.15,260776570.35
355040,202203,910,429,481,519948.6,584184,1104132.6
355050,202203,173,96,77,116352,93324,209676
355060,202203,1759,833,926,1010809.2,1124736.4,2135545.6
355070,202203,1578,694,884,843552.15,1071409.76,1914961.91
355080,202203,194,117,77,141804,93324,235128
355090,202203,299,177,122,214524,147864.7,362388.7
355100,202203,5328,2475,2853,3000793.96,3462684.8,6463478.76
355110,202203,232,151,81,183012,98172,281184
355120,202203,55,34,21,41208,25452,66660
355130,202203,52,29,23,35148,27876,63024
355140,202203,195,115,80,139380,96960,236340
355150,202203,690,403,287,489648.6,347844,837492.6
355160,202203,481,225,256,272700.95,310272,582972.95
355170,202203,2078,1063,1015,1291992,1230180,2522172
355180,202203,693,271,422,328452,511464,839916
355190,202203,222,152,70,184224,84840,269064
355200,202203,112,56,56,67872,67872.6,135744.6
355210,202203,718,392,326,476316,395112,871428
355220,202203,7637,3706,3931,4498950.4,4766798.8,9265749.2
355230,202203,99,57,42,70296,50904,121200
355240,202203,4643,1864,2779,2264018.53,3370575,5634593.53
355250,202203,6576,2847,3729,3455437.05,4524397.4,7979834.45
355255,202203,49,31,18,37572,21816,59388
355260,202203,187,106,81,128472.6,99384,227856.6
355270,202203,164,105,59,127260.6,72720,199980.6
355280,202203,6991,2580,4411,3128175.6,5349769.8,8477945.4
355290,202203,69,54,15,65448,18180,83628
355300,202203,230,131,99,161196,119988,281184
355310,202203,113,58,55,70296,66660,136956
355320,202203,93,47,46,56964,55752,112716
355330,202203,308,179,129,218160,156348,374508
355340,202203,1412,488,924,591458.35,1121100,1712558.35
355350,202203,162,78,84,94536,101808,196344
355360,202203,166,108,58,130896,70296,201192
355365,202203,18,13,5,15756,6060,21816
355370,202203,1022,606,416,736896.95,505404,1242300.95
355380,202203,825,506,319,614484.36,386628,1001112.36
355385,202203,84,56,28,67872,33936,101808
355390,202203,108,54,54,65448,65448,130896
355395,202203,191,100,91,121200.78,110292,231492.78
355400,202203,1753,1000,753,1213115.08,912636.95,2125752.03
355410,202203,5072,2312,2760,2808209.1,3352392,6160601.1
355420,202203,45,32,13,38784,15756,54540
355430,202203,410,249,161,301788,197556,499344
355440,202203,88,53,35,64236,42420,106656
355450,202203,441,217,224,264216.12,271488,535704.12
355460,202203,58,43,15,54540,18180,72720
355465,202203,51,30,21,36360,25452,61812
355470,202203,189,74,115,89688.8,140592,230280.8
355475,202203,9,6,3,7272,3636,10908
355480,202203,602,243,359,294516,435108,729624
355490,202203,111,75,36,90900,43632,134532
355495,202203,78,27,51,32724,61812,94536
355500,202203,1608,856,752,1039897.74,912636.6,1952534.34
355510,202203,275,195,80,236341.75,96960,333301.75
355520,202203,29,22,7,26664,8484,35148
355530,202203,23,11,12,13332,14544,27876
355535,202203,74,32,42,38784,50904,89688
355540,202203,2697,1042,1655,1263076.09,2008284,3271360.09
355550,202203,61,34,27,42420,32724,75144
355560,202203,242,107,135,129684,163620,293304
355570,202203,15,10,5,12120,6060,18180
355580,202203,245,164,81,198768,98172.6,296940.6
355590,202203,18,11,7,13332,8484,21816
355600,202203,269,133,136,162408,164832,327240
355610,202203,233,144,89,174528,107868,282396
355620,202203,1294,564,730,684780,885972,1570752
355630,202203,418,301,117,366024,141804,507828
355635,202203,125,54,71,65448,87264,152712
355640,202203,546,287,259,347844,313908,661752
355645,202203,904,326,578,395112,701748.6,1096860.6
355650,202203,1926,818,1108,992629,1344108,2336737
355660,202203,236,121,115,146652,139380,286032
355670,202203,631,263,368,318756,446016,764772
355680,202203,199,111,88,136956,107868,244824
355690,202203,89,43,46,52116,55752,107868
355695,202203,26,17,9,20604,10908,31512
355700,202203,1216,609,607,738108.04,741745.2,1479853.24
355710,202203,2279,1240,1039,1504093.2,1260480,2764573.2
355715,202203,13,11,2,13332,2424,15756
355720,202203,254,154,100,186648.36,121200,307848.36
355730,202203,107,62,45,75144,55752,130896
410010,202203,132,105,27,127260,32724,159984
410020,202203,120,86,34,104232,41208,145440
410030,202203,164,88,76,106656,92112,198768
410040,202203,1323,640,683,775680.6,827796,1603476.6
410045,202203,45,34,11,41208,13332,54540
410050,202203,510,290,220,351480,267852,619332
410060,202203,289,209,80,253308,96960,350268
410070,202203,286,244,42,295728,50904,346632
410080,202203,180,109,71,132108,86052,218160
410090,202203,64,53,11,64236,13332,77568
410100,202203,258,165,93,199980,112716,312696
410105,202203,49,28,21,33936,25452,59388
410110,202203,343,205,138,248460,167256,415716
410115,202203,46,29,17,35148,20604,55752
410120,202203,439,203,236,246036,286032,532068
410130,202203,58,30,28,36360,33936,70296
410140,202203,3183,1438,1745,1744069.52,2116155,3860224.52
410150,202203,2683,1073,1610,1302900.6,1956168.6,3259069.2
410160,202203,481,274,207,333300,250884,584184
410165,202203,52,30,22,36360,26664,63024
410170,202203,202,122,80,147864,96960,244824
410180,202203,2316,1244,1072,1507728.6,1299264,2806992.6
410185,202203,36,29,7,35148,8484,43632
410190,202203,486,309,177,374508.3,214524,589032.3
410200,202203,988,704,284,855672,344208,1199880
410210,202203,626,319,307,386628,373296.2,759924.2
410220,202203,51,21,30,25452,36360,61812
410230,202203,179,80,99,96960,119988,216948
410240,202203,726,459,267,556308,324816,881124
410250,202203,382,267,115,323604,139380,462984
410260,202203,301,166,135,201192,163620,364812
410270,202203,29,22,7,26664,8484,35148
410275,202203,61,45,16,54540,19392,73932
410280,202203,319,184,135,223008,163620,386628
410290,202203,281,157,124,190284,150288,340572
410300,202203,90,56,34,67872,41208,109080
410302,202203,25,13,12,15756,14544,30300
410304,202203,38,25,13,30300,15756,46056
410305,202203,229,127,102,153924,123624,277548
410310,202203,190,111,79,134532,95748,230280
410315,202203,43,31,12,37572,14544,52116
410320,202203,137,91,46,110292,55752,166044
410322,202203,34,21,13,25452,15756,41208
410330,202203,173,114,59,138168,71508,209676
410335,202203,97,53,44,64236,53328,117564
410337,202203,44,34,10,41208,12120,53328
410340,202203,38,31,7,37572,8484,46056
410345,202203,195,114,81,138168,98172,236340
410347,202203,45,33,12,39996,15756,55752
410350,202203,255,146,109,176952,132108,309060
410360,202203,444,271,173,328452.6,209676.6,538129.2
410370,202203,2354,990,1364,1201092.6,1656804.6,2857897.2
410380,202203,192,114,78,138168,94536,232704
410390,202203,398,262,136,317544,164832,482376
410395,202203,33,21,12,25452,14544,39996
410400,202203,862,367,495,444804.94,599940,1044744.94
410405,202203,81,61,20,73932,24240,98172
410410,202203,22,14,8,16968,9696,26664
410420,202203,1733,781,952,946464.73,1155036,2101500.73
410425,202203,186,75,111,92112,134532,226644
410430,202203,2341,1236,1105,1500456,1340472,2840928
410440,202203,358,255,103,310272,124836,435108
410442,202203,360,225,135,272700,163620.04,436320.04
410445,202203,416,288,128,349056,155136,504192
410450,202203,384,181,203,219372,246036,465408
410460,202203,558,288,270,350268,330876,681144
410465,202203,254,138,116,167256,143016.6,310272.6
410470,202203,272,149,123,180588,149076,329664
410480,202203,6589,3145,3444,3815377.8,4182615.1,7997992.9
410490,202203,1414,804,610,974448,740532.6,1714980.6
410500,202203,272,155,117,187860,141804,329664
410510,202203,183,137,46,166044,55752,221796
410520,202203,267,191,76,231492,92112,323604
410530,202203,297,94,203,113928,246036,359964
410540,202203,341,247,94,299364.04,113928,413292.04
410550,202203,1717,708,1009,858096,1225332.6,2083428.6
410560,202203,157,106,51,128472,61812,190284
410570,202203,445,296,149,358753.2,181800,540553.2
410580,202203,3664,1523,2141,1847089.54,2599741,4446830.54
410590,202203,420,267,153,323583,185436,509019
410600,202203,192,168,24,203616,29088,232704
410610,202203,50,40,10,48480,12120,60600
410620,202203,270,171,99,207252,119988.6,327240.6
410630,202203,452,250,202,303000,246036,549036
410640,202203,1055,649,406,789012.8,492072,1281084.8
410645,202203,114,82,32,99384.8,38784,138168.8
410650,202203,367,225,142,272700,173316,446016
410655,202203,85,60,25,72720,30300,103020
410657,202203,36,13,23,15756,27876,43632
410660,202203,645,433,212,524796.14,256944,781740.14
410670,202203,79,64,15,77568,18180,95748
410680,202203,188,153,35,185436,42420,227856
410685,202203,28,17,11,20604,13332,33936
410690,202203,28759,11833,16926,14353721.93,20549466.6,34903188.53
410700,202203,326,237,89,287244,107868,395112
410710,202203,128,104,24,127260,29088,156348
410712,202203,44,32,12,38784,14544,53328
410715,202203,92,68,24,82416,29088,111504
410720,202203,655,371,284,450864.6,344208,795072.6
410725,202203,189,135,54,163620,65448,229068
410730,202203,104,48,56,58176,67872,126048
410740,202203,99,70,29,84840,35148,119988
410750,202203,285,187,98,226644,118776,345420
410752,202203,19,13,6,15756,7272,23028
410753,202203,59,24,35,29088,42420,71508
410754,202203,54,26,28,31512,33936,65448
410755,202203,75,43,32,52116,38784,90900
410760,202203,766,410,356,496920,431472.2,928392.2
410765,202203,1891,843,1048,1026565,1272601.4,2299166.4
410770,202203,114,81,33,99384,39996,139380
410773,202203,64,43,21,52116,25452,77568
410775,202203,177,133,44,161196,54540,215736
410780,202203,85,45,40,54540,48480,103020
410785,202203,53,43,10,52116,12120,64236
410790,202203,86,38,48,46056,58176,104232
410800,202203,284,179,105,216948,127260.6,344208.6
410810,202203,31,18,13,21816,15756.6,37572.6
410820,202203,159,112,47,135744,56964,192708
410830,202203,9057,3782,5275,4588635.54,6399361.6,10987997.14
410832,202203,117,75,42,90900,50904,141804
410840,202203,1429,760,669,921120.21,810829.4,1731949.61
410845,202203,49,27,22,33936,26664,60600
410850,202203,177,128,49,155136,59388,214524
410855,202203,71,62,9,75144,10908,86052
410860,202203,791,405,386,490860,467832.6,958692.6
410865,202203,102,71,31,86052.6,37572,123624.6
410870,202203,149,123,26,150288,31512,181800
410880,202203,1167,571,596,692052.6,722352.6,1414405.2
410890,202203,97,63,34,76356,41208,117564
410895,202203,76,56,20,67872,24240,92112
410900,202203,28,21,7,25452,8484,33936
410910,202203,14,9,5,10908,6060,16968
410920,202203,44,28,16,33936,19392,53328
410930,202203,551,333,218,404808,264216,669024
410940,202203,4438,2304,2134,2796085.2,2593680.2,5389765.4
410950,202203,102,76,26,92112,31512,123624
410960,202203,890,339,551,410868.6,667812,1078680.6
410965,202203,63,40,23,48480,27876,76356
410970,202203,617,420,197,510252,238764,749016
410975,202203,124,78,46,94536.58,55752,150288.58
410980,202203,1641,729,912,883549.2,1107768,1991317.2
410990,202203,271,197,74,238764,89688,328452
411000,202203,63,36,27,43632,32724.6,76356.6
411005,202203,32,25,7,30300,8484,38784
411007,202203,249,139,110,168468,133320,301788
411010,202203,602,392,210,477528,254520,732048
411020,202203,288,182,106,220584,128472,349056
411030,202203,23,12,11,14544,13332,27876
411040,202203,59,38,21,46056,25452,71508
411050,202203,215,152,63,184224,76356,260580
411060,202203,537,361,176,437532,213312,650844
411065,202203,47,42,5,50904,6060,56964
411070,202203,1281,728,553,882336,672660.2,1554996.2
411080,202203,241,168,73,203616,88476,292092
411090,202203,91,68,23,82416,27876,110292
411095,202203,338,119,219,145440,265428,410868
411100,202203,109,85,24,103020,29088,132108
411110,202203,138,82,56,100596,67872,168468
411120,202203,206,133,73,161196,88476,249672
411125,202203,300,138,162,167256.65,196344,363600.65
411130,202203,117,99,18,119988,21816,141804
411140,202203,211,144,67,174528,81204,255732
411150,202203,1247,799,448,968388,544189.55,1512577.55
411155,202203,120,83,37,100596,44844,145440
411160,202203,31,13,18,15756,21816,37572
411170,202203,49,44,5,53328,6060,59388
411180,202203,987,645,342,781740,415716,1197456
411190,202203,339,184,155,223008,189072,412080
411200,202203,660,379,281,460560.95,341784,802344.95
411210,202203,687,349,338,422988,409656.25,832644.25
411220,202203,159,111,48,134532,58176,192708
411230,202203,38,30,8,36360,9696,46056
411240,202203,111,67,44,81204,53328,134532
411250,202203,429,311,118,379356,143016,522372
411260,202203,14,10,4,12120,4848,16968
411270,202203,269,137,132,166044,159984,326028
411275,202203,187,159,28,192708,33936,226644
411280,202203,204,146,58,176952.95,70296,247248.95
411290,202203,67,53,14,64236,16968,81204
411295,202203,127,99,28,119988,33936,153924
411300,202203,79,36,43,43632,52116,95748
411310,202203,95,67,28,81204,33936,115140
411320,202203,812,511,301,619332,364812.6,984144.6
411325,202203,64,45,19,54540,23028,77568
411330,202203,895,575,320,696900.8,387840,1084740.8
411340,202203,33,23,10,27876,12120,39996
411342,202203,60,45,15,54540,18180,72720
411345,202203,109,52,57,63024,69084,132108
411350,202203,503,373,130,452076.52,157560.6,609637.12
411360,202203,56,35,21,42420,25452,67872
411370,202203,14008,5635,8373,6837626.33,10160202.99,16997829.32
411373,202203,181,119,62,144228,75144,219372
411375,202203,77,61,16,73932,19392,93324
411380,202203,77,54,23,65448,27876,93324
411390,202203,135,76,59,92112,71508,163620
411400,202203,419,278,141,336936,170892,507828
411410,202203,501,228,273,276336,330876.6,607212.6
411420,202203,966,399,567,484800.96,687204.2,1172005.16
411430,202203,516,279,237,338148,287244,625392
411435,202203,28,17,11,20604,13332,33936
411440,202203,464,369,95,447228,115140,562368
411450,202203,402,337,65,408444,79992,488436
411460,202203,810,305,505,369660,612060,981720
411470,202203,110,76,34,92112,41208,133320
411480,202203,704,365,339,442380.6,412080,854460.6
411490,202203,285,176,109,213312,132108,345420
411500,202203,99,79,20,95748,24240,119988
411510,202203,224,176,48,213312,58176,271488
411520,202203,6163,2116,4047,2565804.59,4909814.47,7475619.06
411530,202203,123,82,41,99384,49692,149076
411535,202203,48,15,33,18180,39996,58176
411540,202203,370,246,124,298152,150288,448440
411545,202203,58,42,16,50904,19392,70296
411550,202203,94,72,22,87264,26664,113928
411560,202203,408,163,245,197556,298152,495708
411570,202203,931,311,620,376932.32,752652,1129584.32
411573,202203,27,16,11,19392,13332,32724
411575,202203,316,191,125,231492,151500,382992
411580,202203,1246,443,803,536916.6,973236,1510152.6
411585,202203,71,36,35,43632,42420,86052
411590,202203,17,11,6,13332,7272,20604
411600,202203,21,9,12,10908,14544,25452
411605,202203,247,91,156,110292,189072,299364
411610,202203,232,144,88,174528,106656,281184
411620,202203,392,186,206,226644,249672,476316
411630,202203,47,32,15,38784,19392,58176
411640,202203,33,24,9,29088,10908,39996
411650,202203,8,5,3,6060,3636,9696
411660,202203,41,30,11,36360,13332,49692
411670,202203,241,169,72,204828,87264,292092
411680,202203,156,127,29,153924,35148,189072
411690,202203,607,314,293,380568,357540,738108
411695,202203,68,50,18,60600,21816,82416
411700,202203,147,117,30,141804,36360,178164
411705,202203,102,67,35,81204,42420,123624
411710,202203,296,196,100,237552,121200,358752
411720,202203,141,95,46,115140,55752,170892
411721,202203,90,72,18,87264,21816,109080
411722,202203,105,47,58,56964,70296,127260
411725,202203,173,124,49,150288,59388,209676
411727,202203,99,78,21,94536,25452,119988
411729,202203,47,33,14,39996,16968,56964
411730,202203,561,348,213,422988,258156,681144
411740,202203,32,19,13,23028,15756,38784
411745,202203,63,48,15,58176,18180,76356
411750,202203,844,346,498,419352,604788,1024140
411760,202203,1239,890,349,1079892.56,424200,1504092.56
411770,202203,425,275,150,333300,181800,515100
411780,202203,367,234,133,283608,161196,444804
411790,202203,581,328,253,398748.6,306636,705384.6
411800,202203,154,111,43,134532.65,52116,186648.65
411810,202203,183,139,44,168468,53328,221796
411820,202203,2433,990,1443,1199881.8,1748917,2948798.8
411830,202203,15,13,2,15756,2424,18180
411840,202203,2147,1277,870,1550148,1056864.6,2607012.6
411845,202203,66,22,44,26664,53328,79992
411850,202203,1261,680,581,824928.2,705384.8,1530313.0
411860,202203,50,30,20,36360.6,24240,60600.6
411870,202203,67,41,26,49692,31512,81204
411880,202203,426,249,177,303000,214524,517524
411885,202203,106,64,42,77568,50904,128472
411890,202203,318,218,100,264217.19,121200,385417.19
411900,202203,107,77,30,93324.6,36360,129684.6
411910,202203,186,135,51,163620,61812,225432
411915,202203,2393,938,1455,1139280,1765884.08,2905164.08
411920,202203,111,86,25,104232,30300,134532
411925,202203,18,11,7,13332,8484,21816
411930,202203,783,541,242,656982.52,293304,950286.52
411940,202203,597,376,221,455712.56,270276,725988.56
411950,202203,1169,532,637,644784.6,775680,1420464.6
411960,202203,1123,709,414,860520,502980,1363500
411965,202203,24,14,10,16968,12120,29088
411970,202203,91,76,15,92112,18180,110292
411980,202203,207,115,92,140592,111504,252096
411990,202203,5159,2762,2397,3349977.53,2907668.98,6257646.51
411995,202203,588,171,417,207252,506616,713868
412000,202203,323,212,111,256944,134532,391476
412010,202203,48,26,22,31512,26664,58176
412015,202203,37,30,7,36360,8484,44844
412020,202203,19,14,5,16968,6060,23028
412030,202203,37,33,4,39996,4848,44844
412033,202203,49,28,21,33936,25452,59388
412035,202203,73,47,26,56964,31512,88476
412040,202203,35,17,18,20604.6,23028,43632.6
412050,202203,214,159,55,193920,67872,261792
412060,202203,784,560,224,678720,272700.13,951420.13
412065,202203,50,29,21,35148,25452,60600
412070,202203,164,115,49,139380,59388,198768
412080,202203,326,154,172,186648,208464,395112
412085,202203,36,14,22,16968,26664,43632
412090,202203,845,519,326,629028.6,395112,1024140.6
412100,202203,266,222,44,269064,53328,322392
412110,202203,70,54,16,65448.8,19392,84840.8
412120,202203,347,184,163,223008,197556,420564
412125,202203,68,41,27,49692,32724,82416
412130,202203,47,29,18,35148.84,21816,56964.84
412135,202203,29,17,12,20604,14544,35148
412140,202203,424,269,155,326028.6,187860,513888.6
412150,202203,240,152,88,184224,106656,290880
412160,202203,84,55,29,66660,35148,101808
412170,202203,713,473,240,573276,292092,865368
412175,202203,39,27,12,32724,14544,47268
412180,202203,185,135,50,164832.8,60600,225432.8
412190,202203,323,246,77,298152,93324,391476
412200,202203,189,118,71,143016,86052,229068
412210,202203,95,71,24,86052,29088,115140
412215,202203,236,157,79,190284,95748,286032
412217,202203,68,55,13,66660,15756,82416
412220,202203,832,550,282,666600,341784,1008384
412230,202203,295,179,116,219372,141804,361176
412240,202203,1341,655,686,793861.6,831432.6,1625294.2
412250,202203,403,249,154,301788,186648,488436
412260,202203,120,78,42,94536,50904,145440
412265,202203,170,128,42,156348,50904,207252
412270,202203,92,56,36,67872,43632,111504
412280,202203,87,68,19,82416,23028,105444
412290,202203,89,56,33,67872,39996,107868
412300,202203,201,141,60,170892,72720,243612
412310,202203,55,44,11,53328,13332,66660
412320,202203,87,68,19,82416,23028,105444
412330,202203,184,149,35,180588,42420,223008
412340,202203,165,110,55,133320,66660,199980
412350,202203,644,293,351,356328,425412,781740
412360,202203,23,20,3,24240,3636,27876
412370,202203,146,123,23,150288.6,27876,178164.6
412380,202203,202,154,48,186648,58176,244824
412382,202203,63,34,29,41208,35148,76356
412385,202203,152,107,45,129684,54540,184224
412390,202203,314,237,77,287244,93324,380568
412395,202203,62,49,13,59388,15756,75144
412400,202203,100,66,34,79992,41208,121200
412402,202203,236,122,114,147864.6,138168,286032.6
412405,202203,945,311,634,376932,768408,1145340
412410,202203,960,573,387,693884.6,469044,1162928.6
412420,202203,16,16,0,19392,,19392.0
412430,202203,24,22,2,26664,2424,29088
412440,202203,660,331,329,401172,399960,801132
412450,202203,71,62,9,75144,10908,86052
412460,202203,89,67,22,81204,26664,107868
412470,202203,212,166,46,201192,55752,256944
412480,202203,149,106,43,128472,52116,180588
412490,202203,164,139,25,168468,30300,198768
412500,202203,405,320,85,387841.16,103020,490861.16
412510,202203,166,138,28,167256,33936,201192
412520,202203,92,59,33,71508,41208,112716
412530,202203,108,53,55,64236,66660,130896
412535,202203,89,69,20,84840,24240,109080
412540,202203,83,39,44,47268,53328,100596
412545,202203,81,55,26,66660,31512,98172
412550,202203,4024,1614,2410,1957380,2922132.6,4879512.6
412555,202203,11,7,4,8484,4848,13332
412560,202203,656,439,217,532109.6,265428,797537.6
412570,202203,807,384,423,465408,512676,978084
412575,202203,93,64,29,77568,35148,112716
412580,202203,175,114,61,138168,73932,212100
412590,202203,34,29,5,35148,6060,41208
412600,202203,179,122,57,147864,69084,216948
412610,202203,37,15,22,18180,26664,44844
412620,202203,133,110,23,133320,27876,161196
412625,202203,2114,1039,1075,1264118.21,1302900.96,2567019.17
412627,202203,64,48,16,58176,19392,77568
412630,202203,382,254,128,307848,155136,462984
412635,202203,75,22,53,26664,64236,90900
412640,202203,108,75,33,90900,39996,130896
412650,202203,320,211,109,255732,132108,387840
412660,202203,454,265,189,321180,229068,550248
412665,202203,43,39,4,47268,4848,52116
412667,202203,294,191,103,231492,124836,356328
412670,202203,72,58,14,70296,16968,87264
412680,202203,330,252,78,305424,94536.12,399960.12
412690,202203,121,80,41,98172,49692,147864
412700,202203,190,126,64,152712,77568,230280
412710,202203,1338,754,584,916273.56,709020,1625293.56
412720,202203,230,126,104,152712,126048,278760
412730,202203,203,172,31,209676,37572,247248
412740,202203,418,212,206,256944,249672,506616
412750,202203,432,232,200,281184,242400,523584
412760,202203,338,167,171,203616,207252,410868
412770,202203,2102,1122,980,1362289.35,1187760.6,2550049.95
412780,202203,144,107,37,129684,44844,174528
412785,202203,315,160,155,193920,187860,381780
412788,202203,49,28,21,33936,25452,59388
412790,202203,123,100,23,121200,27876,149076
412795,202203,150,102,48,124836,58176,183012
412796,202203,292,181,111,220584,134532,355116
412800,202203,674,398,276,482376.6,335724,818100.6
412810,202203,3075,1664,1411,2019193,1712556,3731749
412820,202203,954,567,387,688417.8,469044,1157461.8
412830,202203,13,11,2,13332,2424,15756
412840,202203,266,180,86,218160,104232,322392
412850,202203,692,431,261,522372,319968,842340
412853,202203,160,74,86,89688,104232,193920
412855,202203,200,106,94,128472.91,115140,243612.91
412860,202203,95,62,33,75144,39996,115140
412862,202203,81,51,30,61812,36360,98172
412863,202203,8,6,2,7272,2424,9696
412865,202203,45,34,11,41208,13332,54540
412870,202203,109,64,45,77568,54540,132108
412880,202203,93,65,28,78780.6,33936,112716.6
420005,202203,39,35,4,42420,4848,47268
420010,202203,366,240,126,290880,152712,443592
420020,202203,93,75,18,90900,21816,112716
420030,202203,27,22,5,26664,6060,32724
420040,202203,93,69,24,83628,29088,112716
420050,202203,58,36,22,43632,26664,70296
420055,202203,18,17,1,20604,1212,21816
420060,202203,26,19,7,23028,8484,31512
420070,202203,98,83,15,100596,18180,118776
420075,202203,9,9,0,10908,,10908.0
420080,202203,40,34,6,41208,7272,48480
420090,202203,38,31,7,37572,8484,46056
420100,202203,145,123,22,149076.6,27876,176952.6
420110,202203,21,21,0,25452,,25452.0
420120,202203,54,38,16,46056,19392,65448
420125,202203,88,70,18,84840,21816,106656
420127,202203,36,30,6,36360,7272,43632
420130,202203,462,279,183,338148,221796,559944
420140,202203,1318,726,592,880195,718716.6,1598911.6
420150,202203,45,35,10,42420,12120,54540
420160,202203,30,27,3,32724,3636,36360
420165,202203,15,10,5,12120,6060,18180
420170,202203,68,42,26,50904,31512,82416
420180,202203,22,19,3,23028,3636,26664
420190,202203,26,23,3,27876,3636,31512
420195,202203,148,66,82,81204.6,99384,180588.6
420200,202203,1321,559,762,677509.2,927180,1604689.2
420205,202203,104,60,44,72720,53328,126048
420207,202203,138,75,63,90900,76356,167256
420208,202203,20,16,4,19392,4848,24240
420209,202203,12,10,2,12120,2424,14544
420210,202203,576,272,304,329664,368448,698112
420213,202203,52,40,12,48480,14544,63024
420215,202203,26,22,4,26664,4848,31512
420220,202203,62,39,23,47268.6,27876,75144.6
420230,202203,931,560,371,678721.51,449652,1128373.51
420240,202203,2264,1483,781,1799821.2,946572.6,2746393.8
420243,202203,44,35,9,42420,10908,53328
420245,202203,198,95,103,115140,124836,239976
420250,202203,62,42,20,50904,24240,75144
420253,202203,25,19,6,23028,7272,30300
420257,202203,13,9,4,10908,4848,15756
420260,202203,115,91,24,110292,29088,139380
420270,202203,30,23,7,27876,8484,36360
420280,202203,275,206,69,249672,83628.8,333300.8
420285,202203,25,18,7,21816,8484,30300
420287,202203,52,35,17,42420,20604,63024
420290,202203,927,633,294,767196,356328,1123524
420300,202203,1519,1205,314,1460464.2,380569.44,1841033.64
420310,202203,45,31,14,37572,16968,54540
420315,202203,30,24,6,29088,7272,36360
420320,202203,978,453,525,550248,636300,1186548
420325,202203,4,2,2,2424,2424,4848
420330,202203,121,78,43,94536,52116,146652
420340,202203,183,124,59,150288.8,71508,221796.8
420350,202203,255,175,80,213312,96960,310272
420360,202203,706,537,169,650844.76,204828,855672.76
420370,202203,129,72,57,87264,69084,156348
420380,202203,1204,831,373,1008385.2,453288,1461673.2
420390,202203,231,161,70,195132,84840,279972
420395,202203,187,136,51,164832,61812,226644
420400,202203,228,174,54,210888.8,65448,276336.8
420410,202203,52,38,14,46056,16968,63024
420415,202203,35,30,5,36360,6060,42420
420417,202203,54,43,11,52116,13332,65448
420419,202203,9,8,1,9696,1212,10908
420420,202203,2809,1744,1065,2117366.4,1293205.2,3410571.6
420425,202203,66,51,15,61812,18180,79992
420430,202203,1066,771,295,934453.28,357540,1291993.28
420435,202203,14,12,2,14544,2424,16968
420440,202203,94,66,28,79992.6,33936,113928.6
420445,202203,31,28,3,33936,3636,37572
420450,202203,85,43,42,52116,50904,103020
420455,202203,190,150,40,181800,48480,230280
420460,202203,2325,1456,869,1764673.6,1053228,2817901.6
420470,202203,89,61,28,73932,33936,107868
420475,202203,9,8,1,9696,1212,10908
420480,202203,872,659,213,801134.2,258156,1059290.2
420490,202203,93,69,24,83628,29088,112716
420500,202203,426,233,193,284820.71,233916,518736.71
420510,202203,26,22,4,26664,4848,31512
420515,202203,29,15,14,18180,16968,35148
420517,202203,7,6,1,7272,1212,8484
420519,202203,0,,,,,0.0
420520,202203,64,47,17,56964,20604,77568
420530,202203,144,93,51,112716,61812,174528
420535,202203,16,14,2,16968,2424,19392
420540,202203,6258,3892,2366,4721105.1,2867592.6,7588697.7
420543,202203,30,28,2,33936,2424,36360
420545,202203,210,145,65,175740,78780,254520
420550,202203,778,645,133,784165.52,161196,945361.52
420555,202203,28,21,7,25452,8484,33936
420560,202203,56,45,11,54540,13332,67872
420570,202203,180,92,88,111504,106656,218160
420580,202203,300,147,153,178164,185436.6,363600.6
420590,202203,475,305,170,369660.6,206040,575700.6
420600,202203,144,76,68,93324,82416,175740
420610,202203,38,35,3,42420,3636,46056
420620,202203,76,55,21,66660,25452,92112
420630,202203,150,99,51,119988,61812,181800
420640,202203,67,58,9,70296,10908,81204
420650,202203,270,146,124,176952,150288,327240
420660,202203,41,33,8,39996,9696,49692
420665,202203,44,28,16,33936,19392,53328
420670,202203,246,191,55,232704,66660,299364
420675,202203,15,13,2,15756,2424,18180
420680,202203,32,25,7,30300,8484,38784
420690,202203,188,143,45,173316,54540,227856
420700,202203,706,456,250,552672.72,303000,855672.72
420710,202203,147,76,71,92112,86052,178164
420720,202203,99,79,20,95748,24240,119988
420730,202203,683,403,280,489650.13,341784,831434.13
420740,202203,54,54,0,65448,,65448.0
420750,202203,476,311,165,379356.6,199980,579336.6
420757,202203,19,16,3,19392,3636,23028
420760,202203,37,28,9,33936,10908,44844
420765,202203,76,55,21,66660,25452,92112
420768,202203,56,45,11,54540,13332,67872
420770,202203,74,62,12,75144,14544,89688
420775,202203,37,34,3,41208,3636,44844
420780,202203,203,158,45,191496.8,54540,246036.8
420785,202203,21,13,8,15756,9696,25452
420790,202203,141,117,24,141804,29088,170892
420800,202203,60,45,15,54540,18180,72720
420810,202203,270,219,51,265428,61812,327240
420820,202203,2468,1365,1103,1658017.15,1338049.26,2996066.41
420830,202203,652,338,314,409657.45,381780,791437.45
420840,202203,140,97,43,117564,52116,169680
420845,202203,434,184,250,223008,303000,526008
420850,202203,265,200,65,242400,78780,321180
420860,202203,61,52,9,63024,10908,73932
420870,202203,134,92,42,111504,50904,162408
420880,202203,186,120,66,145440,79992,225432
420890,202203,947,458,489,555096.6,593880,1148976.6
420895,202203,8,8,0,9696,,9696.0
420900,202203,414,334,80,406020,96960,502980
420910,202203,5782,3117,2665,3783867.95,3232404.6,7016272.55
420915,202203,60,54,6,65448,7272,72720
420917,202203,19,15,4,18180,4848,23028
420920,202203,21,14,7,16968,8484,25452
420930,202203,3095,1985,1110,2409380.84,1348956.6,3758337.44
420940,202203,587,421,166,510252.6,201192.64,711445.24
420945,202203,11,8,3,9696,3636,13332
420950,202203,50,39,11,47268,13332,60600
420960,202203,110,90,20,109080,24240,133320
420970,202203,280,225,55,272701,66660,339361
420980,202203,21,20,1,24240,1212,25452
420985,202203,53,47,6,56964,7272,64236
420990,202203,80,61,19,73932,24240.6,98172.6
421000,202203,53,29,24,35148,29088,64236
421003,202203,38,27,11,32724,13332,46056
421005,202203,8,5,3,6060,3636,9696
421010,202203,831,542,289,658117.4,350268.8,1008386.2
421020,202203,20,16,4,19392,4848,24240
421030,202203,113,97,16,117564.2,19392,136956.2
421040,202203,72,49,23,59388,27876,87264
421050,202203,337,236,101,286033.2,122412,408445.2
421055,202203,20,16,4,19392,4848,24240
421060,202203,106,58,48,70296,58176,128472
421070,202203,42,35,7,42420.6,8484,50904.6
421080,202203,38,33,5,39996,6060,46056
421085,202203,17,14,3,16968,3636,20604
421090,202203,37,30,7,36360,8484,44844
421100,202203,111,84,27,101808,32724,134532
421105,202203,181,148,33,180588.6,41208,221796.6
421110,202203,115,83,32,100596,38784,139380
421120,202203,175,127,48,153924.6,58176,212100.6
421125,202203,18,10,8,12120,9696,21816
421130,202203,831,513,318,621756,389052.6,1010808.6
421140,202203,33,23,10,27876,12120,39996
421145,202203,47,37,10,44844,12120,56964
421150,202203,87,67,20,81204,24240,105444
421160,202203,63,39,24,47268,29088,76356
421165,202203,14,11,3,13332,3636,16968
421170,202203,169,139,30,168614,36360,204974
421175,202203,184,128,56,155136,67872,223008
421180,202203,42,29,13,35148.56,15756,50904.56
421185,202203,15,12,3,14544,3636,18180
421187,202203,3,2,1,2424,1212,3636
421189,202203,43,31,12,37572,14544,52116
421190,202203,1868,1176,692,1426525.8,841129.15,2267654.95
421200,202203,93,63,30,76356,36360,112716
421205,202203,27,19,8,23028,9696,32724
421210,202203,174,125,49,151500,59388,210888
421220,202203,254,199,55,241188,67872,309060
421223,202203,47,38,9,46056.4,10908,56964.4
421225,202203,69,45,24,54540,29088,83628
421227,202203,75,60,15,72720,18180,90900
421230,202203,68,47,21,56964,25452,82416
421240,202203,16,15,1,18180,1212,19392
421250,202203,382,223,159,270276.2,192708,462984.2
421260,202203,21,17,4,20604,4848,25452
421265,202203,4,3,1,3636,1212,4848
421270,202203,51,46,5,55752,7272,63024
421280,202203,354,178,176,216948,213312,430260
421290,202203,308,204,104,247248,127260.6,374508.6
421300,202203,23,19,4,23028,4848,27876
421310,202203,53,36,17,43632,20604,64236
421315,202203,33,21,12,25452,14544,39996
421320,202203,131,86,45,104232,54540,158772
421330,202203,111,84,27,101808,32724,134532
421335,202203,44,32,12,38784,14544,53328
421340,202203,244,159,85,193920.8,103020,296940.8
421350,202203,183,106,77,128472.85,93324,221796.85
421360,202203,704,493,211,599940,255732,855672
421370,202203,190,138,52,167256,63024.6,230280.6
421380,202203,142,107,35,129684,42420,172104
421390,202203,16,10,6,12120,7272,19392
421400,202203,120,98,22,118776,26664,145440
421410,202203,21,18,3,21816,3636,25452
421415,202203,19,17,2,20604,2424,23028
421420,202203,102,87,15,105444,18180,123624
421430,202203,18,13,5,15756,6060,21816
421440,202203,61,53,8,64236,9696,73932
421450,202203,86,71,15,86052,18180.44,104232.44
421460,202203,58,44,14,53328,16968,70296
421470,202203,72,41,31,49692,37572,87264
421480,202203,751,568,183,688416.6,221796,910212.6
421490,202203,24,23,1,27876,1212,29088
421500,202203,468,283,185,342996.6,224220.77,567217.37
421505,202203,29,22,7,26664,8484,35148
421507,202203,30,24,6,29088,7272,36360
421510,202203,70,44,26,53328,31512,84840
421520,202203,51,43,8,52116,9696,61812
421530,202203,49,40,9,48480,12120,60600
421535,202203,20,19,1,23028,1212,24240
421540,202203,52,41,11,49692,13332,63024
421545,202203,84,61,23,73932,27876,101808
421550,202203,291,204,87,247248.96,105444,352692.96
421555,202203,17,15,2,18180,2424,20604
421560,202203,8,7,1,8484,1212,9696
421565,202203,121,79,42,95748,50904,146652
421567,202203,35,29,6,35148,7272,42420
421568,202203,43,40,3,48480,3636,52116
421569,202203,11,11,0,13332,,13332.0
421570,202203,231,153,78,185436.6,94536,279972.6
421575,202203,26,23,3,27876,3636,31512
421580,202203,712,416,296,504271,358752.6,863023.6
421590,202203,18,17,1,20604,1212,21816
421600,202203,154,103,51,126048.6,61812,187860.6
421605,202203,103,70,33,84840.2,39996,124836.2
421610,202203,169,128,41,155136,49692,204828
421620,202203,1027,580,447,702960,542976.8,1245936.8
421625,202203,21,19,2,23028,2424,25452
421630,202203,344,207,137,250884.6,167257.2,418141.8
421635,202203,21,10,11,12120,13332,25452
421640,202203,102,84,18,101808.4,23028,124836.4
421650,202203,305,177,128,214524,155136,369660
421660,202203,2487,1500,987,1820427.15,1198668,3019095.15
421670,202203,167,118,49,143016,59388,202404
421680,202203,189,171,18,208464,21816,230280
421690,202203,343,233,110,283609.4,133320.36,416929.76
421700,202203,59,41,18,49692,21816.2,71508.2
421710,202203,18,18,0,21816,,21816.0
421715,202203,5,4,1,4848,1212,6060
421720,202203,633,435,198,527220,239976,767196
421725,202203,26,10,16,12120,19392,31512
421730,202203,25,18,7,21816,8484,30300
421740,202203,104,38,66,46056,79992,126048
421750,202203,198,145,53,175740,64236,239976
421755,202203,17,15,2,18180,2424,20604
421760,202203,103,72,31,87264,37572,124836
421770,202203,693,444,249,540553.6,301788,842341.6
421775,202203,30,19,11,23028,13332,36360
421780,202203,178,142,36,172104,43632,215736
421790,202203,153,132,21,159984,25452,185436
421795,202203,16,13,3,15756,3636,19392
421800,202203,534,326,208,395112,252096,647208
421810,202203,69,57,12,69084,14544,83628
421820,202203,310,195,115,236340.6,139380,375720.6
421825,202203,157,129,28,156348,33936,190284
421830,202203,150,90,60,110292,72720,183012
421835,202203,7,2,5,2424,6060,8484
421840,202203,45,38,7,46056,8484,54540
421850,202203,82,70,12,84840,14544,99384
421860,202203,39,28,11,33936,13332,47268
421870,202203,1037,755,282,915062,341784.6,1256846.6
421875,202203,53,42,11,50904,13332,64236
421880,202203,184,124,60,150288,72720,223008
421885,202203,25,19,6,23028,7272,30300
421890,202203,140,100,40,121200,48480.1,169680.1
421895,202203,43,37,6,44844,7272,52116
421900,202203,131,99,32,121200,38784,159984
421910,202203,61,39,22,47268,26664,73932
421915,202203,34,28,6,33936,7272,41208
421917,202203,39,29,10,35148,12120,47268
421920,202203,37,32,5,38784,6060,44844
421930,202203,612,487,125,591456.8,151500,742956.8
421935,202203,47,41,6,49692,7272,56964
421940,202203,53,45,8,54540.4,9696,64236.4
421950,202203,869,573,296,695688.8,359964.4,1055653.2
421960,202203,40,33,7,39996,8484,48480
421970,202203,325,213,112,258156,136956,395112
421985,202203,18,11,7,13332,8484,21816
422000,202203,3,2,1,2424,1212,3636
430003,202203,191,53,138,64236,167256,231492
430005,202203,33,24,9,29088,10908,39996
430010,202203,257,185,72,224220,87264,311484
430020,202203,146,100,46,121200.6,55752,176952.6
430030,202203,117,99,18,119988,21816,141804
430040,202203,2913,1718,1195,2083429.55,1450764.6,3534194.15
430045,202203,75,64,11,77568,13332,90900
430047,202203,7,5,2,6060,2424,8484
430050,202203,86,74,12,89688,14544,104232
430055,202203,12,11,1,13332,1212,14544
430057,202203,6,4,2,4848,2424,7272
430060,202203,3961,2297,1664,2785176.6,2017980.81,4803157.41
430063,202203,53,44,9,53328,10908,64236
430064,202203,166,129,37,156348,44844,201192
430066,202203,7,3,4,3636,4848,8484
430070,202203,44,33,11,39996,13332,53328
430080,202203,80,50,30,60600,36360,96960
430085,202203,29,14,15,16968,18180,35148
430087,202203,26,19,7,23028.8,8484,31512.8
430090,202203,64,53,11,64236,13332,77568
430100,202203,137,94,43,115140.6,52116,167256.6
430105,202203,149,86,63,104232,77568,181800
430107,202203,18,13,5,15756,6060,21816
430110,202203,496,271,225,329664,272700,602364
430120,202203,162,147,15,178164,18180,196344
430130,202203,784,471,313,570852,379356,950208
430140,202203,128,116,12,140592,14544,155136
430150,202203,103,65,38,78780,46056,124836
430155,202203,29,23,6,27876,7272,35148
430160,202203,3621,2071,1550,2512478.6,1881024.6,4393503.2
430163,202203,409,183,226,221796,273912,495708
430165,202203,32,20,12,24240,14544,38784
430170,202203,81,67,14,81204,16968,98172
430175,202203,79,60,19,73932,23028,96960
430180,202203,104,85,19,103020,23028,126048
430185,202203,28,19,9,23028,10908,33936
430187,202203,54,28,26,33936,31512,65448
430190,202203,227,118,109,143016,132108,275124
430192,202203,16,12,4,14544,4848,19392
430195,202203,16,11,5,13332,6060,19392
430200,202203,154,131,23,158772,27876,186648
430205,202203,19,19,0,23028,,23028.0
430210,202203,732,554,178,671448.6,215736,887184.6
430215,202203,11,10,1,12120,1212,13332
430220,202203,73,50,23,60600,27876,88476
430222,202203,13,5,8,6060,9696,15756
430223,202203,16,10,6,12120,7272,19392
430225,202203,2,1,1,1212,1212,2424
430230,202203,319,193,126,233916,152712,386628
430235,202203,48,32,16,38784,19392,58176
430237,202203,19,14,5,16968,6060,23028
430240,202203,106,74,32,89688,38784,128472
430245,202203,68,55,13,66660,15756,82416
430250,202203,187,107,80,129684,96960,226644
430258,202203,8,7,1,8484,1212,9696
430260,202203,31,27,4,32724,4848,37572
430265,202203,35,30,5,36360,6060,42420
430270,202203,522,374,148,453288.2,179376,632664.2
430280,202203,1065,625,440,757501.2,533280,1290781.2
430290,202203,423,217,206,263004,249672,512676
430300,202203,2115,1138,977,1379256.6,1186549.6,2565806.2
430310,202203,2065,1015,1050,1232604.6,1273814.72,2506419.32
430320,202203,55,46,9,55752,10908,66660
430330,202203,91,78,13,94536,15756,110292
430340,202203,67,54,13,65448,15756,81204
430350,202203,1672,1092,580,1324716,702960.6,2027676.6
430355,202203,21,19,2,23028,2424,25452
430360,202203,93,47,46,56964,55752,112716
430367,202203,42,31,11,37572,13332,50904
430370,202203,54,48,6,58176,7272,65448
430380,202203,117,88,29,106656,35148,141804
430390,202203,584,363,221,439956,267852,707808
430400,202203,262,182,80,220584.6,96960,317544.6
430410,202203,59,47,12,56964,14544,71508
430420,202203,519,325,194,393900.2,235128,629028.2
430430,202203,53,51,2,61004.8,2424,63428.8
430435,202203,141,106,35,128472,42420,170892
430440,202203,539,335,204,406020.4,247248,653268.4
430450,202203,1189,971,218,1178064.6,264216,1442280.6
430460,202203,5698,2896,2802,3512377.64,3402084.69,6914462.33
430461,202203,16,14,2,16968,2424,19392
430462,202203,5,3,2,3636,2424,6060
430463,202203,1163,625,538,757500,652056,1409556
430465,202203,25,14,11,16968,13332,30300
430466,202203,661,460,201,557520.6,243612,801132.6
430467,202203,124,71,53,87264,64236,151500
430468,202203,137,77,60,93324,72720,166044
430469,202203,18,14,4,16968,4848,21816
430470,202203,1146,628,518,761496.7,629028,1390524.7
430471,202203,65,42,23,50904,27876,78780
430480,202203,119,82,37,99384,44844,144228
430485,202203,8,8,0,9696.6,,9696.6
430490,202203,76,61,15,73932,18180,92112
430495,202203,31,23,8,27876,9696,37572
430500,202203,186,126,60,152712,72720,225432
430510,202203,3727,2419,1308,2934253.86,1588932,4523185.86
430511,202203,14,14,0,16968,,16968.0
430512,202203,157,107,50,129684,60600,190284
430513,202203,52,41,11,49692,13332,63024
430515,202203,25,24,1,29088,1212,30300
430517,202203,179,148,31,180588,37572,218160
430520,202203,343,244,99,295728,119988,415716
430530,202203,80,45,35,54540,42420,96960
430535,202203,446,294,152,356328,184224,540552
430537,202203,10,10,0,12120,,12120.0
430540,202203,81,52,29,63024,35148,98172
430543,202203,388,119,269,145440,326028,471468
430544,202203,46,43,3,52116,3636,55752
430545,202203,400,184,216,223008,261792,484800
430550,202203,44,35,9,42420,10908,53328
430558,202203,2,2,0,2424,,2424.0
430560,202203,55,31,24,37572,30300,67872
430570,202203,118,50,68,60600,82416,143016
430580,202203,126,100,26,121200,31512,152712
430583,202203,15,15,0,18180,,18180.0
430585,202203,12,8,4,9696,4848,14544
430587,202203,13,8,5,9696,6060,15756
430590,202203,162,129,33,156348,41208,197556
430593,202203,2,2,0,2424,,2424.0
430595,202203,16,13,3,15756,3636,19392
430597,202203,46,26,20,31512,24240,55752
430600,202203,219,165,54,201192,65448,266640
430605,202203,166,94,72,113928,87264,201192
430607,202203,30,24,6,29088,7272,36360
430610,202203,1723,813,910,986568,1104132.6,2090700.6
430613,202203,6,6,0,7272,,7272.0
430620,202203,95,69,26,83628,31512,115140
430630,202203,46,38,8,46056,9696,55752
430632,202203,30,25,5,30300,6060,36360
430635,202203,38,32,6,38784,7272,46056
430637,202203,67,34,33,41208,39996,81204
430640,202203,178,100,78,121200,94536,215736
430642,202203,18,15,3,18180,3636,21816
430645,202203,31,26,5,31512,6060,37572
430650,202203,248,197,51,238764.6,61812,300576.6
430655,202203,5,4,1,4848,1212,6060
430660,202203,974,473,501,574488,607212,1181700
430670,202203,71,48,23,58176,27876,86052
430673,202203,82,53,29,64236,36360,100596
430675,202203,8,6,2,7272,2424,9696
430676,202203,591,348,243,421776,294516,716292
430680,202203,244,163,81,197556.6,98172,295728.6
430690,202203,536,325,211,395112,255732.95,650844.95
430692,202203,9,7,2,8484,2424,10908
430693,202203,137,84,53,101808,64236,166044
430695,202203,65,54,11,65448,13332,78780
430697,202203,65,41,24,49692,29088,78780
430700,202203,1386,936,450,1135644.6,545400,1681044.6
430705,202203,29,26,3,31512,3636,35148
430710,202203,258,157,101,190284,122412,312696
430720,202203,109,92,17,111504,20604,132108
430730,202203,142,120,22,145440,26664,172104
430740,202203,75,49,26,59388,31512,90900
430745,202203,30,19,11,23028,13332,36360
430750,202203,334,217,117,263004,141804,404808
430755,202203,88,47,41,56964,49692,106656
430760,202203,392,216,176,263004.76,213312,476316.76
430770,202203,1577,822,755,998688.6,915060.4,1913749.0
430780,202203,325,205,120,248460,145440,393900
430781,202203,24,23,1,27876,1212,29088
430783,202203,63,49,14,59388,16968,76356
430786,202203,5,3,2,3636,2424,6060
430790,202203,519,327,192,397536,232704,630240
430800,202203,154,120,34,145440.61,41208,186648.61
430805,202203,37,30,7,36360,8484,44844
430807,202203,61,33,28,39996,33936,73932
430810,202203,75,50,25,60600,30300,90900
430820,202203,152,95,57,115140,69084,184224
430825,202203,12,9,3,10908,3636,14544
430830,202203,243,226,17,275124.6,20604,295728.6
430840,202203,137,91,46,110292,55752,166044
430843,202203,7,4,3,4848,3636,8484
430845,202203,74,42,32,50904,38784,89688
430850,202203,583,417,166,505404,201192,706596
430860,202203,155,99,56,119988,67872,187860
430865,202203,78,40,38,48480,46056,94536
430870,202203,74,60,14,72720.6,16968,89688.6
430880,202203,160,116,44,140592,53328,193920
430885,202203,12,11,1,13332,1212,14544
430890,202203,338,201,137,243612,166044,409656
430900,202203,525,360,165,436320.6,199980,636300.6
430905,202203,129,54,75,66660,90900,157560
430910,202203,277,152,125,184224.6,151500,335724.6
430912,202203,4,4,0,4848,,4848.0
430915,202203,38,35,3,42420,3636,46056
430920,202203,4543,2373,2170,2880924,2636100,5517024
430925,202203,5,4,1,4848,1212,6060
430930,202203,2069,1190,879,1442281.4,1066560,2508841.4
430940,202203,257,162,95,196344,115140,311484
430950,202203,151,124,27,150288,32724,183012
430955,202203,24,14,10,16968,13332,30300
430957,202203,24,21,3,25452,3636,29088
430960,202203,246,158,88,191496,106656,298152
430965,202203,103,67,36,81204,43632,124836
430970,202203,91,74,17,89688,20604,110292
430975,202203,48,42,6,50904,7272,58176
430980,202203,51,32,19,38784,23028,61812
430990,202203,98,74,24,89688,29088,118776
430995,202203,113,104,9,126048,10908,136956
431000,202203,297,150,147,181800.6,178164,359964.6
431010,202203,356,205,151,248460.6,183012,431472.6
431020,202203,1880,1089,791,1321080,958692.6,2279772.6
431030,202203,39,30,9,36360,10908,47268
431033,202203,448,204,244,247248,295728,542976
431036,202203,14,8,6,9696,7272,16968
431040,202203,140,88,52,106656,63024,169680
431041,202203,38,23,15,27876,18180,46056
431043,202203,39,23,16,27876,19392,47268
431046,202203,13,10,3,12120,3636,15756
431050,202203,201,125,76,152712,92112,244824
431053,202203,71,38,33,46056,39996,86052
431055,202203,67,45,22,54540,26664,81204
431057,202203,17,17,0,20604,,20604.0
431060,202203,1570,1013,557,1228968.98,676296,1905264.98
431065,202203,15,8,7,9696,8484,18180
431070,202203,64,55,9,66660,10908,77568
431075,202203,8,8,0,9696,,9696.0
431080,202203,127,73,54,88476,65448,153924
431085,202203,35,31,4,37572,4848,42420
431087,202203,14,11,3,13332,3636,16968
431090,202203,50,37,13,44844,15756,60600
431100,202203,1269,751,518,910212,627816,1538028
431110,202203,213,128,85,156348,103020,259368
431112,202203,26,20,6,24240,7272,31512
431113,202203,31,23,8,27876,9696,37572
431115,202203,155,109,46,132108,55752,187860
431120,202203,590,339,251,410868,305424,716292
431123,202203,5,5,0,6060,,6060.0
431125,202203,98,85,13,103020,15756,118776
431127,202203,5,3,2,3636,2424,6060
431130,202203,734,483,251,586608.6,304212,890820.6
431140,202203,788,549,239,665389.2,289668,955057.2
431142,202203,20,18,2,21816.84,2424,24240.84
431150,202203,200,149,51,180588,61812,242400
431160,202203,47,43,4,52116,4848,56964
431162,202203,3,3,0,3636,,3636.0
431164,202203,4,4,0,4848,,4848.0
431170,202203,113,82,31,99384,37572,136956
431171,202203,71,41,30,49692,37572,87264
431173,202203,3,2,1,2424,1212,3636
431175,202203,205,109,96,132108.6,117564,249672.6
431177,202203,93,65,28,78780,33936,112716
431179,202203,16,11,5,13332,6060,19392
431180,202203,402,250,152,303000,184224,487224
431190,202203,76,56,20,67872,24240,92112
431198,202203,68,47,21,56964,25452,82416
431200,202203,22,18,4,21816,4848,26664
431205,202203,21,19,2,23028,2424,25452
431210,202203,104,68,36,82416,43632,126048
431213,202203,34,28,6,33936,7272,41208
431215,202203,25,22,3,26664,3636,30300
431217,202203,5,4,1,4848,1212,6060
431220,202203,66,56,10,67872,12120,79992
431225,202203,162,103,59,126048,71508,197556
431230,202203,96,82,14,99384,16968,116352
431235,202203,5,5,0,6060,,6060.0
431237,202203,15,11,4,13332,4848,18180
431238,202203,12,9,3,10908,3636,14544
431240,202203,1085,663,422,807193.2,511464,1318657.2
431242,202203,42,40,2,48480,2424,50904
431244,202203,21,17,4,20604,4848,25452
431245,202203,51,37,14,44844,16968,61812
431247,202203,10,6,4,7272,4848,12120
431250,202203,288,143,145,173316,175740,349056
431260,202203,56,47,9,56964,10908,67872
431261,202203,17,12,5,14544,6060,20604
431262,202203,15,13,2,15756,2424,18180
431265,202203,149,80,69,96960,83628,180588
431267,202203,18,16,2,19392,2424,21816
431270,202203,329,257,72,311484,87264,398748
431275,202203,40,35,5,42420,6060,48480
431280,202203,20,16,4,19392,4848,24240
431290,202203,19,17,2,20604,2424,23028
431295,202203,2,1,1,1212,1212,2424
431300,202203,19,17,2,20604,2424,23028
431301,202203,6,6,0,7272,,7272.0
431303,202203,55,35,20,42420,24240,66660
431306,202203,241,124,117,150288,141804,292092
431308,202203,6,4,2,4848,2424,7272
431310,202203,65,51,14,61812,16968,78780
431320,202203,174,103,71,124836.6,86052,210888.6
431330,202203,201,128,73,155136,88476,243612
431333,202203,28,22,6,26664,7272,33936
431335,202203,6,4,2,4848,2424,7272
431337,202203,396,186,210,226644.6,254520,481164.6
431339,202203,22,16,6,19392,7272,26664
431340,202203,3144,1710,1434,2074849.32,1739222.2,3814071.52
431342,202203,36,24,12,29088.6,14544,43632.6
431344,202203,19,19,0,23028.89,,23028.89
431346,202203,5,4,1,4848,1212,6060
431349,202203,33,29,4,35148,4848,39996
431350,202203,1023,561,462,679933.6,559944,1239877.6
431360,202203,52,40,12,48480,14544,63024
431365,202203,350,148,202,179376,244824,424200
431370,202203,1183,678,505,822948.6,612060,1435008.6
431380,202203,97,86,11,104232,13332,117564
431390,202203,502,273,229,330876,278760,609636
431395,202203,327,137,190,166044,230280,396324
431400,202203,37,23,14,27876,16968,44844
431402,202203,99,71,28,86052,33936,119988
431403,202203,24,16,8,19392,9696,29088
431405,202203,706,396,310,479952,375720,855672
431406,202203,36,28,8,33936,9696,43632
431407,202203,45,35,10,42420,12120,54540
431410,202203,3450,2091,1359,2540353.64,1648320.2,4188673.84
431413,202203,17,14,3,16968,3636,20604
431415,202203,72,49,23,59388,27876,87264
431417,202203,24,11,13,13332,15756,29088
431420,202203,340,227,113,275124,136956,412080
431430,202203,59,30,29,36360,35148,71508
431440,202203,9036,6161,2875,7479262.04,3490617.75,10969879.79
431442,202203,27,14,13,16968,15756,32724
431445,202203,27,25,2,30300,2424,32724
431446,202203,4,3,1,3636,1212,4848
431447,202203,83,60,23,72720,27876,100596
431449,202203,55,43,12,52116,14544,66660
431450,202203,412,271,141,328452.33,170892,499344.33
431454,202203,12,7,5,8484,6060,14544
431455,202203,48,38,10,46056,12120,58176
431460,202203,497,340,157,412080,191496,603576
431470,202203,132,97,35,117564,42420,159984
431475,202203,9,7,2,8484,2424,10908
431477,202203,39,24,15,29088,18180,47268
431478,202203,7,7,0,8484,,8484.0
431480,202203,582,353,229,427836,277548.6,705384.6
431490,202203,29251,16275,12976,19759123.52,15742675.4,35501798.92
431500,202203,77,60,17,73932,20604,94536
431505,202203,30,19,11,23028,13332,36360
431507,202203,10,8,2,9696,2424,12120
431510,202203,234,168,66,203616.4,79992,283608.4
431513,202203,21,20,1,24240,1212,25452
431514,202203,6,4,2,4848,2424,7272
431515,202203,85,72,13,87264,15756,103020
431517,202203,6,3,3,3636,3636,7272
431520,202203,38,33,5,39996,6060,46056
431530,202203,1416,623,793,755076,961116,1716192
431531,202203,21,19,2,23028,2424,25452
431532,202203,37,27,10,32724,12120,44844
431535,202203,29,14,15,16968,18180,35148
431540,202203,136,111,25,134532.6,30300.6,164833.2
431545,202203,12,10,2,12120,2424,14544
431550,202203,358,190,168,230280,204828,435108
431555,202203,10,10,0,12120,,12120.0
431560,202203,4718,3140,1578,3812957.96,1916172,5729129.96
431570,202203,825,430,395,521161.2,479952.8,1001114.0
431575,202203,48,28,20,33936,24240,58176
431580,202203,86,57,29,69084,35148,104232
431590,202203,144,120,24,145440,29088,174528
431595,202203,18,15,3,18180,3636,21816
431600,202203,249,146,103,176952,124836,301788
431610,202203,112,83,29,100596,35148,135744
431620,202203,41,34,7,41208,8484,49692
431630,202203,127,103,24,124836,29088,153924
431640,202203,1324,828,496,1003536.6,603576,1607112.6
431642,202203,34,32,2,38784,3636,42420
431643,202203,42,17,25,20604,30300,50904
431645,202203,319,185,134,224220,162408,386628
431647,202203,9,8,1,9696,1212,10908
431650,202203,32,18,14,21816,16968,38784
431660,202203,271,170,101,207252,122412,329664
431670,202203,221,98,123,118776,149076,267852
431673,202203,13,11,2,13332,2424,15756
431675,202203,26,21,5,25452,6060,31512
431680,202203,1161,849,312,1028988,378144,1407132
431690,202203,4894,2908,1986,3530559.02,2411881.2,5942440.22
431695,202203,21,15,6,18180,7272,25452
431697,202203,2,1,1,1212,1212,2424
431700,202203,186,140,46,169680,55752,225432
431710,202203,4066,1754,2312,2127061.4,2804568,4931629.4
431720,202203,1289,785,504,953238.4,610848,1564086.4
431725,202203,1,1,0,1212,,1212.0
431730,202203,1144,765,379,928395.04,460560,1388955.04
431740,202203,1330,642,688,779316,835069.2,1614385.2
431750,202203,1818,1190,628,1443493.92,761136,2204629.92
431755,202203,6,5,1,6060,1212,7272
431760,202203,976,605,371,733261.4,449652,1182913.4
431770,202203,417,285,132,345420,159984,505404
431775,202203,23,17,6,20604,7272,27876
431780,202203,561,338,223,409656,270276,679932
431790,202203,155,119,36,144228,43632,187860
431795,202203,13,10,3,12120,3636,15756
431800,202203,3163,1653,1510,2007074.4,1834969.2,3842043.6
431805,202203,17,15,2,18180,2424,20604
431810,202203,590,383,207,465408,250884,716292
431820,202203,340,198,142,239976,172104,412080
431830,202203,2301,1388,913,1684680,1107768,2792448
431840,202203,476,313,163,381780.6,197556,579336.6
431842,202203,35,29,6,35148,7272,42420
431843,202203,11,9,2,10908,3636,14544
431844,202203,18,13,5,15756,6060,21816
431845,202203,25,22,3,26664,3636,30300
431846,202203,27,23,4,27876,4848,32724
431848,202203,15,13,2,15756,2424,18180
431849,202203,6,5,1,6060,1212,7272
431850,202203,767,597,170,723564,207252,930816
431860,202203,123,79,44,95748,53328,149076
431861,202203,6,2,4,2424,4848,7272
431862,202203,59,43,16,52116,19392,71508
431870,202203,3654,2073,1581,2516113.6,1919808,4435921.6
431880,202203,959,680,279,824160,338148,1162308
431890,202203,1243,726,517,881124.6,626604,1507728.6
431900,202203,190,131,59,158772,71508,230280
431910,202203,49,36,13,43632,15756,59388
431912,202203,50,30,20,36360,24240,60600
431915,202203,148,113,35,136956,42420,179376
431920,202203,152,110,42,133320,50904,184224
431930,202203,78,64,14,77568,16968,94536
431935,202203,4,3,1,3636,1212,4848
431936,202203,3,3,0,3636,,3636.0
431937,202203,19,16,3,19392,3636,23028
431940,202203,473,326,147,395112,179376,574488
431950,202203,469,300,169,363600,204828,568428
431960,202203,738,395,343,478740,416928,895668
431970,202203,67,61,6,73932,7272,81204
431971,202203,5,3,2,3636,2424,6060
431973,202203,18,15,3,18180,3636,21816
431975,202203,10,10,0,12120,,12120.0
431980,202203,205,120,85,146652.6,103020,249672.6
431990,202203,1101,583,518,706517.74,627816,1334333.74
432000,202203,1836,959,877,1162310.2,1064136.6,2226446.8
432010,202203,267,177,90,215736,109080,324816
432020,202203,181,152,29,184224,35148,219372
432023,202203,14,12,2,14544,2424,16968
432026,202203,58,50,8,60600,9696,70296
432030,202203,61,30,31,36360,37572,73932
432032,202203,15,11,4,13332,4848,18180
432035,202203,62,46,16,55752,19392,75144
432040,202203,89,59,30,71508,36360,107868
432045,202203,2,2,0,2424,,2424.0
432050,202203,79,46,33,55752,39996,95748
432055,202203,129,95,34,115140,41208,156348
432057,202203,6,4,2,4848.6,2424,7272.6
432060,202203,34,29,5,35148,6060,41208
432065,202203,30,26,4,31512,4848,36360
432067,202203,85,79,6,95748,7272,103020
432070,202203,384,300,84,363600.2,103020,466620.2
432080,202203,815,574,241,698112,292092,990204
432085,202203,10,8,2,9696,2424,12120
432090,202203,266,180,86,218160,105444,323604
432100,202203,172,111,61,134532,73932,208464
432110,202203,552,366,186,443592,226644,670236
432120,202203,1029,581,448,705384.6,542976,1248360.6
432130,202203,498,352,146,427837.4,176952,604789.4
432132,202203,22,20,2,24240,2424,26664
432135,202203,79,65,14,78780,16968,95748
432140,202203,267,200,67,242400,81204,323604
432143,202203,215,127,88,153924,106656,260580
432145,202203,276,192,84,232704,101808,334512
432146,202203,13,12,1,14544,1212,15756
432147,202203,111,60,51,72720,61812,134532
432149,202203,16,10,6,12120,7272,19392
432150,202203,982,603,379,730836.6,459348,1190184.6
432160,202203,1655,854,801,1036260.46,972024,2008284.46
432162,202203,5,2,3,2424,3636,6060
432163,202203,17,12,5,14544,6060,20604
432166,202203,124,91,33,110595,39996,150591
432170,202203,229,117,112,141804,135744,277548
432180,202203,562,353,209,427836,253308.6,681144.6
432183,202203,10,9,1,10908,1212,12120
432185,202203,79,64,15,77568,18180,95748
432190,202203,509,297,212,361176,258156,619332
432195,202203,92,78,14,94536,16968,111504
432200,202203,406,253,153,307848,185436,493284
432210,202203,113,68,45,82416,54540,136956
432215,202203,30,28,2,33936,2424,36360
432218,202203,19,19,0,23028,,23028.0
432220,202203,633,324,309,392688,374508,767196
432225,202203,18,12,6,14544,7272,21816
432230,202203,122,79,43,95748,52116,147864
432232,202203,23,19,4,23028,4848,27876
432234,202203,4,2,2,2424,2424,4848
432235,202203,2,2,0,2424,,2424.0
432237,202203,23,15,8,18180,9696,27876
432240,202203,4481,2520,1961,3055453.2,2382793.8,5438247.0
432250,202203,1115,733,382,889608,462984,1352592
432252,202203,48,48,0,58176,,58176.0
432253,202203,62,49,13,59388,15756,75144
432254,202203,28,12,16,14544,19392,33936
432255,202203,12,10,2,13332,2424,15756
432260,202203,855,684,171,829008.6,207252,1036260.6
432270,202203,217,164,53,198768,64236,263004
432280,202203,154,115,39,139380.4,47268,186648.4
432285,202203,1,1,0,1212,,1212.0
432290,202203,53,46,7,55752,8484,64236
432300,202203,4914,2626,2288,3187482.42,2775481.5,5962963.92
432310,202203,128,107,21,129684,25452,155136
432320,202203,22,17,5,20604,6060,26664
432330,202203,15,10,5,12120,6060,18180
432335,202203,9,7,2,8484,2424,10908
432340,202203,37,30,7,36360,8484,44844
432345,202203,109,73,36,88476.6,43632,132108.6
432350,202203,24,23,1,27876,1212,29088
432360,202203,5,4,1,4848,1212,6060
432370,202203,25,25,0,30300,,30300.0
432375,202203,30,27,3,32724,3636.6,36360.6
432377,202203,6,6,0,7272,,7272.0
432380,202203,185,80,105,96960,127260,224220
500020,202203,265,138,127,167256,153924,321180
500025,202203,138,68,70,82416,84840,167256
500060,202203,1424,906,518,1099284,630241.2,1729525.2
500070,202203,733,349,384,422988,465408,888396
500080,202203,136,109,27,132108,32724,164832
500085,202203,132,105,27,127261.18,32724,159985.18
500090,202203,368,168,200,203616,242400,446016
500100,202203,700,365,335,443592,406021.2,849613.2
500110,202203,2305,1107,1198,1344108.6,1461673.2,2805781.8
500124,202203,271,150,121,181800,146652,328452
500150,202203,332,135,197,163620,238764,402384
500190,202203,526,356,170,431472.6,206040,637512.6
500200,202203,208,173,35,209676.32,42420,252096.32
500210,202203,1614,544,1070,659328,1298052,1957380
500215,202203,203,118,85,143016,103020,246036
500220,202203,718,461,257,558732.12,311484,870216.12
500230,202203,227,137,90,166044,109080,275124
500240,202203,641,422,219,515100,265428.6,780528.6
500260,202203,584,233,351,282396,425412,707808
500270,202203,30035,13012,17023,15777078.27,20646426.95,36423505.22
500280,202203,199,66,133,81204,161196,242400
500290,202203,1178,724,454,878700.6,550248,1428948.6
500295,202203,461,297,164,361176.6,198768,559944.6
500310,202203,108,39,69,47268,83628,130896
500315,202203,811,448,363,542976,441168,984144
500320,202203,3654,1756,1898,2129485.26,2301588,4431073.26
500325,202203,895,494,401,602364,488436.6,1090800.6
500330,202203,1500,710,790,860499.38,961116,1821615.38
500345,202203,302,226,76,273912.6,92112,366024.6
500348,202203,246,150,96,181800,116352,298152
500350,202203,106,51,55,61812,66660,128472
500370,202203,5701,2587,3114,3137870.6,3780229,6918099.6
500375,202203,348,238,110,288456,134532,422988
500380,202203,605,344,261,416928,316332,733260
500390,202203,70,33,37,39996,44844,84840
500400,202203,212,138,74,167256,89688,256944
500410,202203,505,215,290,261792,351480,613272
500430,202203,545,373,172,452076,208464,660540
500440,202203,212,115,97,139380,117564,256944
500450,202203,413,176,237,214524,287244,501768
500460,202203,266,143,123,173316.6,149076,322392.6
500470,202203,420,313,107,379356,130896,510252
500480,202203,102,61,41,73932,49692,123624
500490,202203,95,42,53,50904,64236,115140
500500,202203,1427,528,899,641148,1090800,1731948
500510,202203,40,34,6,41208,7272,48480
500515,202203,103,73,30,88476,36360,124836
500520,202203,281,148,133,179376.8,161196,340572.8
500525,202203,91,50,41,60600,49692,110292
500540,202203,887,398,489,482376,595092,1077468
500560,202203,893,495,398,599940,482376.6,1082316.6
500568,202203,1007,533,474,648420,575700,1224120
500570,202203,1176,684,492,830220.8,596304.6,1426525.4
500580,202203,318,163,155,197556,187860,385416
500600,202203,353,172,181,208464,219372,427836
500620,202203,941,658,283,797496.74,342996,1140492.74
500625,202203,79,63,16,76356,19392,95748
500627,202203,39,17,22,20604,26664,47268
500630,202203,1560,897,663,1089081.32,804768,1893849.32
500635,202203,510,305,205,369660,250884,620544
500640,202203,363,199,164,241188,198768,439956
500660,202203,5756,2095,3661,2539141.4,4438344.6,6977486.0
500690,202203,602,217,385,263004,466620,729624
500710,202203,393,193,200,233916.6,242400.6,476317.2
500720,202203,932,512,420,620544,510252,1130796
500730,202203,160,96,64,116352.6,77568,193920.6
500740,202203,925,383,542,464196,658116,1122312
500750,202203,171,56,115,67872,139380,207252
500755,202203,118,89,29,109080,35148,144228
500769,202203,732,401,331,487224.6,401172,888396.6
500770,202203,436,245,191,296940,231492,528432
500780,202203,134,92,42,111504,52116,163620
500790,202203,1053,518,535,629028,649632,1278660
500793,202203,290,146,144,176952,174528.6,351480.6
500795,202203,165,108,57,130896,69084,199980
500797,202203,49,34,15,41208,18180,59388
500800,202203,415,179,236,216948,287244,504192
500830,202203,2229,1206,1023,1464096.2,1239876,2703972.2
500840,202203,120,90,30,109080,36360,145440
510010,202203,168,93,75,112716,90900,203616
510020,202203,528,237,291,287244.09,352692,639936.09
510025,202203,1673,938,735,1139280.14,893244,2032524.14
510030,202203,656,341,315,413292,381780,795072
510035,202203,132,69,63,83628,76356,159984
510040,202203,411,196,215,238764,260580.88,499344.88
510050,202203,378,205,173,249672,209676.99,459348.99
510060,202203,125,63,62,76356,75144,151500
510080,202203,249,94,155,113928,187860.6,301788.6
510100,202203,66,27,39,32724,47268,79992
510120,202203,31,19,12,23028,14544,37572
510125,202203,382,237,145,287244,175740,462984
510130,202203,540,327,213,396324,258156.6,654480.6
510140,202203,444,144,300,174528,363600,538128
510160,202203,104,36,68,43632,82416,126048
510170,202203,740,456,284,553884,345420,899304
510180,202203,2868,1323,1545,1605903.6,1873752.2,3479655.8
510185,202203,23,12,11,14544,13332,27876
510190,202203,232,80,152,96960,185436,282396
510250,202203,2658,1641,1017,1990104,1235028.6,3225132.6
510260,202203,176,126,50,152712,60600,213312
510263,202203,471,267,204,323604.2,248460,572064.2
510267,202203,623,341,282,413292.6,342996,756288.6
510268,202203,62,29,33,35148,39996,75144
510269,202203,75,35,40,42420,48480,90900
510270,202203,374,185,189,224220,230280,454500
510279,202203,202,153,49,185436,59388,244824
510285,202203,178,71,107,86052,129684,215736
510300,202203,512,270,242,327240,293304,620544
510305,202203,199,90,109,109080,132108,241188
510310,202203,109,55,54,66660,65448,132108
510320,202203,811,507,304,614484,368448,982932
510325,202203,422,174,248,210888,300576,511464
510330,202203,427,235,192,284820,232704,517524
510335,202203,654,386,268,467832.6,324816,792648.6
510336,202203,53,36,17,43632,20604,64236
510337,202203,102,46,56,55752,67872,123624
510340,202203,17623,7865,9758,9540867.57,11844880.4,21385747.97
510343,202203,61,45,16,54540,19392,73932
510345,202203,156,97,59,117564,71508.6,189072.6
510350,202203,648,343,305,415716,369660,785376
510360,202203,216,135,81,163620,98172,261792
510370,202203,150,68,82,82416,99384,181800
510380,202203,80,59,21,71508,25452,96960
510385,202203,58,26,32,31512,38784,70296
510390,202203,95,42,53,50904,64236,115140
510395,202203,50,35,15,42420,18180,60600
510410,202203,753,483,270,585396,327240,912636
510420,202203,552,270,282,327240,341784,669024
510450,202203,51,25,26,30300,31512,61812
510452,202203,53,25,28,30300,33936,64236
510454,202203,49,23,26,27876,31512,59388
510455,202203,125,73,52,88476,63024,151500
510460,202203,181,83,98,100596,119988,220584
510480,202203,711,426,285,517524.32,345420,862944.32
510490,202203,336,166,170,201192,206040,407232
510500,202203,233,173,60,209676,72720,282396
510510,202203,803,463,340,561157.2,414504,975661.2
510515,202203,1255,649,606,786588,735684,1522272
510517,202203,268,125,143,151500,173316,324816
510520,202203,212,139,73,168468,88476,256944
510523,202203,112,87,25,105444,30300,135744
510525,202203,860,521,339,631452.8,410868,1042320.8
510530,202203,19,12,7,14544,8484,23028
510550,202203,234,109,125,132108,152712,284820
510558,202203,293,145,148,176952,181800,358752
510560,202203,385,217,168,263004.6,206040,469044.6
510562,202203,647,468,179,567216,216948,784164
510590,202203,712,361,351,437532,426624,864156
510600,202203,225,116,109,140592,132108,272700
510610,202203,227,97,130,117564,157560,275124
510615,202203,189,88,101,107868,122412,230280
510617,202203,25,11,14,13332,16968,30300
510618,202203,121,58,63,70296,76356,146652
510619,202203,87,61,26,73932,31512,105444
510620,202203,156,88,68,107868,82416,190284
510621,202203,172,110,62,133320,75144,208464
510622,202203,475,262,213,317544,258156,575700
510623,202203,293,199,94,242400,113928,356328
510624,202203,84,44,40,53328,48480,101808
510625,202203,513,323,190,391476,231492.95,622968.95
510626,202203,110,64,46,77568,56964,134532
510627,202203,88,61,27,75144,32724,107868
510628,202203,158,96,62,116352,75144,191496
510629,202203,270,159,111,192708,134553.81,327261.81
510630,202203,435,213,222,258156,269064.6,527220.6
510631,202203,17,8,9,9696,10908,20604
510637,202203,341,196,145,237552,175740,413292
510642,202203,1061,567,494,687204,599940,1287144
510645,202203,8,1,7,1212,8484,9696
510650,202203,1322,869,453,1054440.6,549036,1603476.6
510665,202203,81,34,47,41208,56964,98172
510670,202203,55,32,23,38784,27876,66660
510675,202203,1117,718,399,872640,484800,1357440
510677,202203,359,191,168,231492.6,203616,435108.6
510680,202203,90,55,35,66660,42420,109080
510682,202203,192,95,97,115140,117564,232704
510685,202203,54,40,14,48480,16968,65448
510700,202203,566,319,247,386628,299364,685992
510704,202203,1177,611,566,742956,685992,1428948
510706,202203,145,75,70,90900,84840,175740
510710,202203,417,287,130,347844,157560.6,505404.6
510715,202203,55,40,15,48480,18180,66660
510718,202203,233,114,119,138168,144228,282396
510719,202203,44,17,27,20604,33936,54540
510720,202203,181,128,53,155136,64236,219372
510724,202203,80,30,50,36360,60600,96960
510726,202203,65,33,32,39996,38784,78780
510729,202203,14,6,8,7272,9696,16968
510730,202203,459,246,213,298152,258156,556308
510735,202203,116,49,67,59388,81204,140592
510740,202203,21,11,10,13332,12120,25452
510757,202203,25,20,5,24240,6060,30300
510760,202203,7365,3767,3598,4566818.8,4363201.8,8930020.6
510770,202203,679,320,359,387840,436320,824160
510774,202203,18,8,10,9696,13332,23028
510775,202203,115,88,27,106656,32724,139380
510776,202203,40,12,28,14544,33936.6,48480.6
510777,202203,194,82,112,99384,135744,235128
510779,202203,37,22,15,26664,18180,44844
510780,202203,262,144,118,174528,143016,317544
510785,202203,356,197,159,238764,192708,431472
510787,202203,185,86,99,104232,119988,224220
510788,202203,6,1,5,1212,6060,7272
510790,202203,2579,1328,1251,1609592.2,1517424,3127016.2
510792,202203,1115,618,497,749016.6,602364.01,1351380.61
510794,202203,108,60,48,72720,58176,130896
510795,202203,2272,1329,943,1611960.96,1144128.6,2756089.56
510800,202203,188,112,76,135744,92112,227856
510805,202203,200,132,68,159984,82416,242400
510810,202203,97,40,57,48480,69084,117564
510820,202203,233,118,115,143016.92,139380.7,282397.62
510830,202203,76,41,35,49692,42420,92112
510835,202203,17,11,6,13332,7272,20604
510840,202203,9076,4257,4819,5166760.8,5845476.6,11012237.4
510850,202203,205,87,118,105444,143016,248460
510860,202203,410,196,214,237552,260580,498132
510880,202203,72,50,22,60600,26664,87264
510885,202203,68,41,27,49692,32724,82416
510890,202203,66,37,29,44844,35148,79992
510895,202203,166,100,66,121200,79992,201192
520005,202203,132,54,78,65448,94536,159984
520010,202203,287,126,161,152712,195132,347844
520013,202203,731,493,238,597516.6,288456.6,885973.2
520015,202203,45,32,13,38784,15756,54540
520017,202203,87,51,36,61812,43632,105444
520020,202203,14,6,8,7272,9696,16968
520025,202203,2655,1402,1253,1699224.4,1521060,3220284.4
520030,202203,794,432,362,526311.61,438744,965055.61
520050,202203,64,47,17,56964,20604,77568
520055,202203,66,42,24,50904,29088,79992
520060,202203,180,114,66,138168,79992,218160
520080,202203,566,410,156,496920,190284,687204
520082,202203,16,11,5,13332,6060,19392
520085,202203,85,64,21,77568,25452,103020
520090,202203,87,62,25,75144,30300,105444
520110,202203,9043,3876,5167,4700138.8,6269678.4,10969817.2
520120,202203,10,5,5,6060,6060,12120
520130,202203,803,565,238,685992,288456,974448
520140,202203,11897,6582,5315,7983446,6447843.48,14431289.48
520145,202203,53,31,22,37572,26664,64236
520150,202203,154,122,32,147864,38784,186648
520160,202203,47,32,15,38784,18180,56964
520170,202203,230,131,99,159984,119988,279972
520180,202203,179,81,98,98172,118776,216948
520215,202203,205,139,66,168468,81204,249672
520235,202203,80,63,17,76356,20604,96960
520250,202203,125,72,53,87264,65448,152712
520260,202203,114,69,45,83628,54540,138168
520280,202203,44,32,12,38784,14544,53328
520310,202203,46,27,19,32724,23028,55752
520320,202203,167,102,65,123624,78780,202404
520330,202203,813,447,366,541764,444804,986568
520340,202203,361,208,153,252096,185436,437532
520350,202203,484,241,243,292092,295728,587820
520355,202203,85,47,38,56964,46056,103020
520357,202203,28,23,5,27876,6060,33936
520360,202203,4,2,2,2424,2424,4848
520380,202203,140,78,62,94536,75144,169680
520390,202203,244,105,139,127260,168468,295728
520393,202203,15,12,3,14544,3636,18180
520396,202203,75,51,24,61812,29088,90900
520400,202203,200,123,77,149076,93324,242400
520410,202203,192,95,97,115140,117564,232704
520420,202203,20,12,8,14544,9696,24240
520425,202203,248,126,122,152712,147864.4,300576.4
520430,202203,508,242,266,293304,322392.6,615696.6
520440,202203,652,471,181,573276,220584,793860
520450,202203,2061,878,1183,1066560,1436220,2502780
520455,202203,55,30,25,37572,30300,67872
520460,202203,38,24,14,29088,16968,46056
520465,202203,30,26,4,31512,4848,36360
520470,202203,428,275,153,333301.56,186648,519949.56
520480,202203,80,46,34,55752,41208,96960
520485,202203,103,38,65,46056,78780,124836
520490,202203,434,325,109,393900,132108,526008
520495,202203,158,92,66,111504,79992,191496
520500,202203,183,146,37,176952,44844,221796
520505,202203,194,115,79,139380,95748,235128
520510,202203,1871,888,983,1077468.6,1192610,2270078.6
520520,202203,48,33,15,39996,18180,58176
520530,202203,206,164,42,198768,50904,249672
520540,202203,647,441,206,534492,250884,785376
520545,202203,135,74,61,89688,73932,163620
520547,202203,54,31,23,37572,27876,65448
520549,202203,1354,631,723,764772.68,878700.6,1643473.28
520551,202203,324,165,159,199980,192708.6,392688.6
520552,202203,34,26,8,31512,9696,41208
520570,202203,15,10,5,12120,6060,18180
520580,202203,271,171,100,207252,121200,328452
520590,202203,142,80,62,96960,75144,172104
520620,202203,1128,522,606,633877.8,734472.6,1368350.4
520630,202203,41,21,20,25452,24240,49692
520640,202203,369,217,152,263004.6,184224,447228.6
520650,202203,65,32,33,38784,39996,78780
520660,202203,39,20,19,24240,23028,47268
520670,202203,40,32,8,38784,9696,48480
520680,202203,40,25,15,30300,18180,48480
520690,202203,39,9,30,10908,36360,47268
520710,202203,34,29,5,35148,6060,41208
520725,202203,198,146,52,176952,63024,239976
520735,202203,55,36,19,43632.6,23028,66660.6
520740,202203,460,222,238,269064,288456,557520
520750,202203,33,23,10,27876,12120,39996
520753,202203,67,45,22,54540,26664,81204
520760,202203,100,66,34,79992,41208,121200
520780,202203,268,206,62,249672,75144,324816
520790,202203,154,91,63,110292,76356,186648
520800,202203,3360,1862,1498,2260381.6,1819212.72,4079594.32
520810,202203,145,112,33,135744,39996,175740
520815,202203,4,3,1,3636,1212,4848
520830,202203,142,95,47,115140,56964,172104
520840,202203,384,247,137,299364,166044,465408
520850,202203,96,53,43,64236,52116,116352
520860,202203,1761,1130,631,1369560,764772.6,2134332.6
520870,202203,31602,14631,16971,17744901.5,20599160,38344061.5
520880,202203,1167,627,540,760975,655692.6,1416667.6
520890,202203,788,488,300,591456,363600,955056
520910,202203,973,515,458,624181.44,555096,1179277.44
520915,202203,86,67,19,81204,23028,104232
520920,202203,434,205,229,248460,277548,526008
520929,202203,15,13,2,15756,2424,18180
520940,202203,66,47,19,56964,23028,79992
520945,202203,12,8,4,9696,4848,14544
520960,202203,39,23,16,27876,19392,47268
520970,202203,370,216,154,263004,186648,449652
520980,202203,93,67,26,81204,31512,112716
520990,202203,445,314,131,380568,159984,540552
520993,202203,128,66,62,79992,75144,155136
520995,202203,249,137,112,166044.04,135744,301788.04
521000,202203,1567,913,654,1107768,793860.2,1901628.2
521010,202203,658,339,319,411676.6,386628,798304.6
521015,202203,11,7,4,8484,4848,13332
521020,202203,1377,958,419,1161096,507828.6,1668924.6
521030,202203,59,37,22,44844,26664,71508
521040,202203,943,625,318,758712.6,385416,1144128.6
521056,202203,54,35,19,42420,23028,65448
521060,202203,122,80,42,96960,50904,147864
521080,202203,349,272,77,330876,94536,425412
521090,202203,555,362,193,438744,233916,672660
521100,202203,255,187,68,226644,82416,309060
521120,202203,1043,729,314,883589,380568,1264157
521130,202203,336,243,93,295728,113928.6,409656.6
521140,202203,183,98,85,118776,103020,221796
521150,202203,2548,1096,1452,1328353.2,1761036,3089389.2
521160,202203,23,9,14,10908,16968,27876
521170,202203,218,125,93,151500,112716,264216
521180,202203,1159,743,416,900517.4,504192.6,1404710.0
521190,202203,2516,1071,1445,1298052,1752552,3050604
521200,202203,53,36,17,44844,20604,65448
521205,202203,11,8,3,9696,3636,13332
521210,202203,119,75,44,90900,53328,144228
521220,202203,716,502,214,609636,259368,869004
521225,202203,24,18,6,21816,7272,29088
521230,202203,103,63,40,77568,48480,126048
521250,202203,6209,3486,2723,4225036.34,3306338.6,7531374.94
521260,202203,32,14,18,16968,21816,38784
521270,202203,134,102,32,123624,38784,162408
521280,202203,411,254,157,307848,191496,499344
521290,202203,26,18,8,21816,9696,31512
521295,202203,100,66,34,79992,41208,121200
521300,202203,223,122,101,147864,122412,270276
521305,202203,36,28,8,33936,9696,43632
521308,202203,987,751,236,910213.2,286032,1196245.2
521310,202203,1323,748,575,906576,698112,1604688
521340,202203,21,16,5,19392,6060,25452
521350,202203,112,86,26,104232,31512,135744
521370,202203,162,114,48,138168,58176,196344
521375,202203,189,94,95,113928.6,115140,229068.6
521377,202203,50,40,10,48480,12120,60600
521380,202203,1044,635,409,770832,495708,1266540
521385,202203,11,7,4,8484,4848,13332
521390,202203,100,81,19,98172,23028,121200
521400,202203,355,245,110,298152,133320,431472
521405,202203,147,84,63,101808,76356,178164
521410,202203,76,55,21,66660,25452,92112
521440,202203,200,140,60,169680,72720,242400
521450,202203,750,413,337,501768.4,410868,912636.4
521460,202203,1094,730,364,884760,441168,1325928
521470,202203,13,9,4,10908,4848,15756
521480,202203,39,29,10,35148,12120.6,47268.6
521483,202203,308,190,118,230281.2,143016,373297.2
521486,202203,292,189,103,229068,124836,353904
521487,202203,24,10,14,12120,16968,29088
521490,202203,23,13,10,15756,12120,27876
521500,202203,134,61,73,73932,88476,162408
521520,202203,45,34,11,41208,13332,54540
521523,202203,867,515,352,625392,426624,1052016
521525,202203,46,30,16,36360,19392,55752
521530,202203,236,134,102,162408,123624,286032
521540,202203,38,18,20,21816,24240,46056
521550,202203,103,45,58,54540,70296,124836
521560,202203,836,564,272,683568,329664.8,1013232.8
521565,202203,67,50,17,60600,20604,81204
521570,202203,528,337,191,410868.6,231492.6,642361.2
521580,202203,51,32,19,38784,23028,61812
521590,202203,33,15,18,18180,21816,39996
521600,202203,25,12,13,14544,15756,30300
521630,202203,235,124,111,150288,134532,284820
521640,202203,298,160,138,193920,167256.6,361176.6
521645,202203,36,20,16,24240,19392,43632
521680,202203,245,152,93,184224,112716.4,296940.4
521690,202203,9,8,1,9696,1212,10908
521710,202203,1125,539,586,655692,710232.6,1365924.6
521720,202203,525,364,161,441168,195132.96,636300.96
521730,202203,652,307,345,372084,418140,790224
521740,202203,878,393,485,476316,587820,1064136
521760,202203,2200,1154,1046,1398728.83,1267752,2666480.83
521770,202203,803,505,298,612060,361176,973236
521800,202203,1921,1259,662,1525909.2,802344,2328253.2
521805,202203,33,19,14,23028,16968,39996
521810,202203,96,55,41,66660,49692,116352
521830,202203,956,684,272,829008.73,329664.36,1158673.09
521839,202203,78,46,32,55752,38784,94536
521850,202203,1111,553,558,671449.21,676296.8,1347746.01
521860,202203,324,203,121,247248,147864,395112
521870,202203,75,46,29,55752,35148,90900
521878,202203,36,14,22,16968,26664,43632
521880,202203,4826,2126,2700,2576713.6,3274825.4,5851539.0
521890,202203,587,400,187,484800,226644,711444
521900,202203,276,217,59,263004,71508,334512
521910,202203,171,118,53,143016,64236,207252
521920,202203,42,23,19,27876,24240,52116
521925,202203,47,27,20,32724,24240,56964
521930,202203,1156,651,505,791436.6,614484.2,1405920.8
521935,202203,33,22,11,26664,13332,39996
521940,202203,226,99,127,119988,153924,273912
521945,202203,16,13,3,15756,3636,19392
521950,202203,15,10,5,12120,6060,18180
521960,202203,66,49,17,59388,20604,79992
521970,202203,400,256,144,310272,174528,484800
521971,202203,112,59,53,71508,64236,135744
521973,202203,38,19,19,23028,23028,46056
521975,202203,1586,809,777,980508.31,944149.4,1924657.71
521980,202203,245,162,83,196344,100596,296940
521990,202203,74,54,20,65448,24240,89688
522000,202203,290,191,99,231069.01,119988,351057.01
522005,202203,18,11,7,14544,8484,23028
522010,202203,1108,625,483,758712,585396,1344108
522015,202203,58,37,21,44844,26664,71508
522020,202203,904,537,367,652056,444804.2,1096860.2
522026,202203,25,16,9,19392,10908,30300
522028,202203,17,13,4,15756,4848,20604
522040,202203,779,331,448,401172,542976.6,944148.6
522045,202203,2526,1508,1018,1830121.4,1235028.6,3065150.0
522050,202203,157,77,80,93324,96960,190284
522060,202203,538,339,199,413292,241188,654480
522068,202203,104,74,30,89688,37572,127260
522070,202203,12,11,1,13332,1212,14544
522100,202203,35,22,13,26664,15756,42420
522108,202203,44,34,10,41208,12120,53328
522119,202203,59,36,23,43632,29088,72720
522130,202203,72,26,46,31512,55752,87264
522140,202203,4089,2148,1941,2608224.6,2354916,4963140.6
522145,202203,43,33,10,39996,12120,52116
522150,202203,103,70,33,84840,39996,124836
522155,202203,52,39,13,47268,15756,63024
522157,202203,9,6,3,7272,3636,10908
522160,202203,1647,986,661,1196244.8,802344,1998588.8
522170,202203,393,266,127,322392,153924,476316
522180,202203,30,11,19,13332,23028,36360
522185,202203,2259,954,1305,1157460.6,1582872,2740332.6
522190,202203,67,37,30,44844,36360,81204
522200,202203,302,180,122,218160,147864,366024
522205,202203,147,102,45,123624,54540,178164
522220,202203,134,99,35,119988,42420,162408
522230,202203,31,27,4,32724,4848,37572
530010,202203,54297,27644,26653,33531528.46,32343566.8,65875095.26
110001,202204,501,406,95,493284.2,115140,608424.2
110002,202204,2775,1768,1007,2146454.44,1222908.14,3369362.58
110003,202204,81,66,15,79992,18180,98172
110004,202204,1975,1327,648,1608326.78,785376,2393702.78
110005,202204,423,337,86,408444.6,104232,512676.6
110006,202204,429,320,109,389052.6,132108,521160.6
110007,202204,67,53,14,64236,16968,81204
110008,202204,235,133,102,161196,123624,284820
110009,202204,905,681,224,825372,271488.4,1096860.4
110010,202204,1640,970,670,1175640.3,812040,1987680.3
110011,202204,1670,1300,370,1579237.89,449652,2028889.89
110012,202204,4044,2361,1683,2868806.38,2043433.31,4912239.69
110013,202204,722,570,152,692052.42,184224.2,876276.62
110014,202204,359,315,44,381780.5,53328,435108.5
110015,202204,1328,1045,283,1268966.44,342996.9,1611963.34
110018,202204,1016,625,391,757501.36,473892,1231393.36
110020,202204,15659,8922,6737,10819545.41,8168886.25,18988431.66
110025,202204,651,476,175,576912.7,212100.5,789013.2
110026,202204,33,22,11,26664,13332,39996
110028,202204,1554,1104,450,1340476.25,547825.9,1888302.15
110029,202204,118,107,11,129684.5,13332,143016.5
110030,202204,2369,1574,795,1909920.88,964753.55,2874674.43
110032,202204,298,228,70,276336.8,84840,361176.8
110033,202204,635,458,177,555096.1,214524,769620.1
110034,202204,313,230,83,278760,100596,379356
110037,202204,85,77,8,93324,9696,103020
110040,202204,390,268,122,324816,147864,472680
110045,202204,908,642,266,780530.01,323604.16,1104134.17
110050,202204,86,74,12,90900,14544,105444
110060,202204,61,36,25,44844,30300,75144
110070,202204,107,71,36,86052,44844,130896
110080,202204,511,293,218,355116.7,264216,619332.7
110090,202204,26,21,5,25452,6060,31512
110092,202204,109,56,53,67872,64236,132108
110094,202204,189,132,57,159984.1,69084,229068.1
110100,202204,45,32,13,38784,15756,54540
110110,202204,97,56,41,67872,49692,117564
110120,202204,64,56,8,67872.2,9696,77568.2
110130,202204,276,223,53,271488.67,64236,335724.67
110140,202204,243,175,68,212100.69,82416,294516.69
110143,202204,52,43,9,52116,10908,63024
110145,202204,38,30,8,36360,9696,46056
110146,202204,24,11,13,13332,15756,29088
110147,202204,36,25,11,30300,13332,43632
110148,202204,37,28,9,33936,10908,44844
110149,202204,311,219,92,266640,111504,378144
110150,202204,136,104,32,126048,38784,164832
110155,202204,11,10,1,12120,1212,13332
110160,202204,62,49,13,59388,15756,75144
110170,202204,212,162,50,196344,60600.6,256944.6
110175,202204,60,47,13,56964,15756,72720
110180,202204,92,74,18,89688,21816,111504
120001,202204,194,145,49,175741.15,59388,235129.15
120005,202204,195,113,82,136956.87,99384,236340.87
120010,202204,1126,690,436,836280.6,528432,1364712.6
120013,202204,153,105,48,127260,58176,185436
120017,202204,116,65,51,78780,61812,140592
120020,202204,3402,2758,644,3343987.48,780540.65,4124528.13
120025,202204,557,312,245,378144.55,296940,675084.55
120030,202204,1044,898,146,1088425.96,176960.8,1265386.76
120032,202204,40,35,5,42420,6060,48480
120033,202204,218,191,27,231500.25,32724.55,264224.80
120034,202204,171,125,46,151500,55752,207252
120035,202204,38,32,6,38784,7272,46056
120038,202204,397,254,143,307851.55,173316.55,481168.10
120039,202204,29,28,1,33937.65,1212,35149.65
120040,202204,13936,9398,4538,11397714.55,5506437.37,16904151.92
120042,202204,41,37,4,44844,4848.55,49692.55
120043,202204,15,3,12,3636,14544,18180
120045,202204,527,342,185,414504.75,224221.85,638726.60
120050,202204,1248,960,288,1164785.91,349067.55,1513853.46
120060,202204,1438,1201,237,1456879,287250.6,1744129.6
120070,202204,405,293,112,355117.5,135744,490861.5
120080,202204,180,115,65,139381.85,78780.55,218162.40
130002,202204,159,115,44,139380,53328,192708
130006,202204,103,68,35,83628,42420,126048
130008,202204,123,71,52,86052,63024,149076
130010,202204,160,97,63,117564,76356,193920
130014,202204,278,200,78,242703,94536,337239
130020,202204,118,76,42,93324,50904,144228
130030,202204,925,531,394,643572,478740.1,1122312.1
130040,202204,346,161,185,195132,224220,419352
130050,202204,540,286,254,346632.6,307848,654480.6
130060,202204,856,585,271,709020,328452,1037472
130063,202204,606,369,237,447228,287244,734472
130068,202204,196,121,75,146652,90900.28,237552.28
130070,202204,1328,893,435,1083528.95,529646.14,1613175.09
130080,202204,674,451,223,546612,270276,816888
130083,202204,75,45,30,54540,36360,90900
130090,202204,323,182,141,220584,170892,391476
130100,202204,1186,546,640,661752.6,778104,1439856.6
130110,202204,717,318,399,386628,483588,870216
130115,202204,142,71,71,86052.6,86052,172104.6
130120,202204,1619,1021,598,1238664.88,724776,1963440.88
130130,202204,604,413,191,500556,231492,732048
130140,202204,1532,1195,337,1448340.2,408444,1856784.2
130150,202204,399,347,52,421776,63024,484800
130160,202204,437,264,173,319968.6,210888,530856.6
130165,202204,67,53,14,64236,16968,81204
130170,202204,996,698,298,847110.93,361176.9,1208287.83
130180,202204,251,183,68,221796,82416.1,304212.1
130185,202204,2174,1019,1155,1235029.69,1399860.2,2634889.89
130190,202204,3328,2089,1239,2533082,1506516.2,4039598.2
130195,202204,277,220,57,266640,69084,335724
130200,202204,172,83,89,100596,107868,208464
130210,202204,91,45,46,54540,55752,110292
130220,202204,197,138,59,167256,72720,239976
130230,202204,365,242,123,293304,150288,443592
130240,202204,1309,847,462,1027776.2,561156,1588932.2
130250,202204,4973,3161,1812,3831136.1,2199780.47,6030916.57
130255,202204,426,220,206,266640.6,250884,517524.6
130260,202204,59025,27777,31248,33691112.18,37901942.46,71593054.64
130270,202204,1512,1036,476,1258165.08,579336,1837501.08
130280,202204,136,79,57,95748,69084,164832
130290,202204,2072,1384,688,1678620.6,833856.2,2512476.8
130300,202204,411,283,128,342996,156348,499344
130310,202204,894,470,424,569640,513888.1,1083528.1
130320,202204,511,274,237,332088,287244,619332
130330,202204,744,473,271,573276,328452,901728
130340,202204,3374,1888,1486,2289468.75,1801032.8,4090501.55
130350,202204,468,320,148,387840,179376,567216
130353,202204,922,406,516,492072.29,626604,1118676.29
130356,202204,777,346,431,421776,523584.6,945360.6
130360,202204,85,65,20,78780,24240,103020
130370,202204,680,528,152,639936,184224,824160
130380,202204,635,492,143,597516,174528,772044
130390,202204,468,380,88,461772,106656,568428
130395,202204,157,45,112,54540,135744.1,190284.1
130400,202204,72,51,21,61812,25452,87264
130406,202204,2190,1290,900,1565906.4,1092012,2657918.4
130410,202204,445,222,223,269064,271488,540552
130420,202204,2753,2244,509,2722154.1,616908,3339062.1
130423,202204,184,110,74,133320,89688,223008
130426,202204,183,100,83,121200,100596,221796
130430,202204,407,237,170,288456,206040,494496
130440,202204,199,65,134,78780,162408,241188
140002,202204,25,5,20,6060,24240,30300
140005,202204,209,124,85,151500.82,103020,254520.82
140010,202204,11274,6905,4369,8377360.87,5296443.59,13673804.46
140015,202204,145,68,77,82416,93324,175740
140017,202204,118,68,50,82416,60600,143016
140020,202204,432,283,149,342996,180588.6,523584.6
140023,202204,43,21,22,25452,26664,52116
140028,202204,21,11,10,13332,12120,25452
140030,202204,361,242,119,293304,144228,437532
140040,202204,59,42,17,50904,20604,71508
140045,202204,271,103,168,124836,203616,328452
140047,202204,488,324,164,392688.8,198768,591456.8
140050,202204,138,85,53,103020,65448,168468
140060,202204,70,45,25,54540,30300,84840
140070,202204,27,25,2,30300,2424,32724
150010,202204,4857,2928,1929,3548738.9,2339161.8,5887900.7
150013,202204,165,117,48,141804.51,58176,199980.51
150020,202204,1096,597,499,723564.94,604788,1328352.94
150030,202204,697,312,385,378144.02,466620,844764.02
150034,202204,207,127,80,153924,96960,250884
150040,202204,1549,884,665,1071409.3,805980.2,1877389.5
150050,202204,692,397,295,481164,357540,838704
150060,202204,4790,3010,1780,3649232.29,2160286.96,5809519.25
150070,202204,447,234,213,283608,259368.6,542976.6
150080,202204,16287,7612,8675,9230610.83,10521384.75,19751995.58
150085,202204,405,258,147,312696.3,178164.1,490860.4
150090,202204,681,562,119,682356,144228,826584
150095,202204,42,27,15,32724,18180,50904
150100,202204,69,41,28,49692.1,33936.1,83628.2
150110,202204,209,116,93,140592,112716,253308
150120,202204,392,284,108,344208.2,130896,475104.2
150125,202204,47,17,30,20604,36360,56964
150130,202204,2136,1070,1066,1296840.3,1291992.82,2588833.12
150140,202204,57857,25399,32458,30793324.74,39353673.3,70146998.04
150145,202204,248,134,114,162408.1,138168,300576.1
150150,202204,3291,1455,1836,1763461.5,2225235.2,3988696.7
150157,202204,376,270,106,327241.1,128472,455713.1
150160,202204,129,99,30,119988,36360,156348
150170,202204,3870,2824,1046,3425113.98,1267752.6,4692866.58
150172,202204,355,248,107,300576,129684,430260
150175,202204,81,46,35,55752,42420,98172
150178,202204,748,506,242,614484.2,293304,907788.2
150180,202204,3199,1571,1628,1905266.14,1973137.2,3878403.34
150190,202204,358,233,125,282397.47,152712,435109.47
150195,202204,117,61,56,73932,67872,141804
150200,202204,194,90,104,109080,126048,235128
150210,202204,3179,2508,671,3039697.8,813252.1,3852949.9
150215,202204,603,374,229,453289,277548.2,730837.2
150220,202204,3487,2324,1163,2819113.97,1410768.86,4229882.83
150230,202204,1303,1043,260,1265328.9,315120.3,1580449.2
150240,202204,6914,3868,3046,4690444.14,3691756.61,8382200.75
150250,202204,75,42,33,50904,39996,90900
150260,202204,109,74,35,89688,42420,132108
150270,202204,2116,1377,739,1668925.1,895669,2564594.1
150275,202204,531,339,192,410868.3,232704,643572.3
150276,202204,114,42,72,50904,87264,138168
150277,202204,828,370,458,449652,555096.3,1004748.3
150280,202204,351,237,114,287244,138168,425412
150285,202204,134,68,66,82416,79798.08,162214.08
150290,202204,1195,686,509,831432.2,616908,1448340.2
150293,202204,738,352,386,426626.12,469044.4,895670.52
150295,202204,542,251,291,305424,352692,658116
150300,202204,91,44,47,53328,56964,110292
150304,202204,188,113,75,136956,90900,227856
150307,202204,422,351,71,425412.8,86052,511464.8
150309,202204,586,418,168,506616.2,203616.36,710232.56
150310,202204,270,180,90,218160.2,109080,327240.2
150320,202204,1837,1275,562,1545302.02,681144.9,2226446.92
150330,202204,2040,1180,860,1431372.1,1042320,2473692.1
150340,202204,192,127,65,155136,78780,233916
150345,202204,620,344,276,416928.54,334512,751440.54
150350,202204,391,309,82,374508,99384,473892
150360,202204,4737,2842,1895,3446929.4,2299165.08,5746094.48
150370,202204,825,563,262,682356.9,317544.18,999901.08
150375,202204,196,87,109,105444,132108.08,237552.08
150380,202204,1502,992,510,1203517.45,619332,1822849.45
150390,202204,876,500,376,606000.1,455712,1061712.1
150400,202204,107,89,18,107868,21816,129684
150405,202204,1578,1003,575,1216849.88,696900.6,1913750.48
150410,202204,111,69,42,83628,50904,134532
150420,202204,7577,4077,3500,4947587.58,4243216.04,9190803.62
150430,202204,629,392,237,475106.75,287244.1,762350.85
150440,202204,445,278,167,338148.7,202404,540552.7
150442,202204,2328,1231,1097,1491975.4,1329564.8,2821540.2
150445,202204,539,350,189,424200.6,229068,653268.6
150450,202204,218,124,94,150288,115140,265428
150460,202204,713,537,176,650844.8,213312,864156.8
150470,202204,1265,756,509,916272.3,616908,1533180.3
150475,202204,240,184,56,223008,67872,290880
150480,202204,1374,954,420,1159885.41,511464,1671349.41
150490,202204,591,344,247,416928,299364,716292
150495,202204,336,251,85,304212,103020,407232
150497,202204,283,193,90,235128,109080,344208
150500,202204,253,154,99,186648,119988,306636
150503,202204,1283,636,647,770833.9,784164.6,1554998.5
150506,202204,908,621,287,752652.42,347844,1100496.42
150510,202204,1307,708,599,858096.96,727200.2,1585297.16
150520,202204,319,219,100,265428,121200,386628
150530,202204,1846,1022,824,1238666.55,998688.6,2237355.15
150540,202204,205,149,56,180588,67872,248460
150543,202204,829,431,398,522372.3,483588.4,1005960.7
150548,202204,444,318,126,387840,152712,540552
150549,202204,73,46,27,55752,32724,88476
150550,202204,3025,1499,1526,1819213.2,1849512,3668725.2
150553,202204,3444,1935,1509,2346437.99,1830120.3,4176558.29
150555,202204,141,75,66,90900,79992,170892
150560,202204,55,23,32,27876,38784,66660
150563,202204,125,64,61,77568,73932,151500
150565,202204,208,129,79,156348,95748,252096
150570,202204,426,284,142,345420,172104,517524
150580,202204,1710,837,873,1014444,1059288,2073732
150590,202204,831,541,290,655692.8,351480.5,1007173.3
150600,202204,508,300,208,364812,252097.3,616909.3
150610,202204,159,127,32,153924,38784,192708
150611,202204,134,88,46,106656,55752,162408
150613,202204,3302,1880,1422,2278560.68,1725945.5,4004506.18
150616,202204,564,313,251,379356.2,304212,683568.2
150618,202204,1376,709,667,859308.2,808404,1667712.2
150619,202204,394,301,93,364812,112716,477528
150620,202204,1243,722,521,875064.4,632664,1507728.4
150630,202204,149,99,50,119988.6,60600,180588.6
150635,202204,456,201,255,244824.7,309060.2,553884.9
150640,202204,41,19,22,23028,26664,49692
150650,202204,2408,1392,1016,1689528.71,1231393.25,2920921.96
150655,202204,246,181,65,219372,78780,298152
150658,202204,78,47,31,56964,37572,94536
150660,202204,572,373,199,452076,241188,693264
150670,202204,1111,400,711,484800,862944.6,1347744.6
150680,202204,10687,5621,5066,6816297.2,6144845.86,12961143.06
150690,202204,28,15,13,18180,15756,33936
150700,202204,487,317,170,384204,206040.2,590244.2
150710,202204,286,170,116,206040,140592,346632
150715,202204,831,527,304,638724.1,368448,1007172.1
150720,202204,419,325,94,393900.8,113928,507828.8
150730,202204,1058,518,540,627816.2,654480.2,1282296.4
150740,202204,238,155,83,187860,100596,288456
150745,202204,772,429,343,519949.1,415716.4,935665.5
150746,202204,66,35,31,42420,37572,79992
150747,202204,240,179,61,218160,73932,292092
150750,202204,130,72,58,87264.1,70296,157560.1
150760,202204,1804,1165,639,1411981.92,775680,2187661.92
150770,202204,395,222,173,269064,209676,478740
150775,202204,102,54,48,65448.1,58176,123624.1
150780,202204,197,116,81,140592,98172,238764
150790,202204,666,381,285,461772,346632.1,808404.1
150795,202204,1631,994,637,1204728.56,774468,1979196.56
150796,202204,324,184,140,223008,169680,392688
150797,202204,389,185,204,224220,247248,471468
150800,202204,1567,881,686,1067772,831432.9,1899204.9
150803,202204,511,400,111,484800.2,134532,619332.2
150805,202204,205,121,84,146652,101808,248460
150808,202204,1021,534,487,648420.2,591456,1239876.2
150810,202204,3175,2156,1019,2616708.92,1239876.6,3856585.52
150812,202204,491,253,238,306636.3,288456,595092.3
150815,202204,1163,730,433,885972,524796,1410768
150820,202204,1549,931,618,1128374.4,749016.7,1877391.1
150830,202204,540,401,139,487224.4,168468,655692.4
150835,202204,227,130,97,157560,117564,275124
150840,202204,1410,841,569,1019292,689628.3,1708920.3
160005,202204,62,42,20,50904.06,24240.02,75144.08
160010,202204,190,121,69,146652.12,83628.08,230280.20
160015,202204,141,88,53,106656.06,64236,170892.06
160020,202204,133,68,65,82416.02,79992,162408.02
160021,202204,66,30,36,36360.64,43632.02,79992.66
160023,202204,66,42,24,50904.06,29088.04,79992.10
160025,202204,22,10,12,12120.02,14544.04,26664.06
160027,202204,1482,837,645,1014446.12,781740.86,1796186.98
160030,202204,16577,8535,8042,10348081.77,9752979.96,20101061.73
160040,202204,291,173,118,209676.12,143016.02,352692.14
160050,202204,724,352,372,426624.18,452076.94,878701.12
160053,202204,287,168,119,203616.26,144228.14,347844.40
160055,202204,21,14,7,16968.02,8484,25452.02
160060,202204,6616,3530,3086,4279585.4,3741453.29,8021038.69
160070,202204,191,113,78,136956.02,94536.12,231492.14
160080,202204,123,65,58,78780.6,70296,149076.6
170025,202204,26,15,11,18180,13332,31512
170030,202204,185,150,35,181800.84,42420,224220.84
170035,202204,198,95,103,115140,124836,239976
170040,202204,175,129,46,156348,55752,212100
170070,202204,319,202,117,244824,141804,386628
170100,202204,338,249,89,301788,107868,409656
170105,202204,44,38,6,46056,7272,53328
170110,202204,113,68,45,82416,54540.1,136956.1
170130,202204,71,37,34,44844,41208,86052
170190,202204,97,56,41,67872,49692,117564
170200,202204,336,231,105,279972,127260,407232
170210,202204,6418,3432,2986,4161721.41,3623882.89,7785604.30
170215,202204,120,63,57,76356,69084,145440
170220,202204,1334,971,363,1176854.4,441168.2,1618022.6
170230,202204,141,90,51,109080,63024,172104
170240,202204,500,338,162,409656.4,196344,606000.4
170255,202204,1008,813,195,986568.2,236340,1222908.2
170270,202204,46,32,14,38784,16968,55752
170290,202204,127,79,48,95748.2,58176,153924.2
170300,202204,108,69,39,83628,47268,130896
170305,202204,46,36,10,43632,12120,55752
170307,202204,55,43,12,52116,15756,67872
170310,202204,119,69,50,83628,60600,144228
170320,202204,30,19,11,23028,13332,36360
170330,202204,28,21,7,25452,8484,33936
170360,202204,32,19,13,23028,15756,38784
170370,202204,81,39,42,47268,50904,98172
170380,202204,74,56,18,67872,21816,89688
170382,202204,36,31,5,37572,6060,43632
170384,202204,141,108,33,130896,39996,170892
170386,202204,69,29,40,35148,48480,83628
170388,202204,46,19,27,23028,32724.96,55752.96
170389,202204,23,20,3,24240,3636,27876
170390,202204,72,43,29,52116,35148,87264
170410,202204,24,22,2,26664,2424,29088
170460,202204,17,10,7,12120,8484,20604
170510,202204,34,24,10,29088,12120,41208
170550,202204,1524,892,632,1082318.31,768408.51,1850726.82
170555,202204,104,78,26,94536,31512,126048
170560,202204,108,77,31,93324,37572,130896
170600,202204,39,12,27,14544,32724,47268
170610,202204,178,96,82,116352,99384,215736
170625,202204,35,21,14,25452,16968,42420
170650,202204,89,63,26,76356,31512,107868
170700,202204,572,421,151,510252,183012,693264
170710,202204,148,97,51,118776,61812,180588
170720,202204,98,76,22,92112,26664,118776
170730,202204,98,58,40,70296,48480,118776
170740,202204,84,58,26,70296,31512,101808
170755,202204,50,27,23,32724.44,27876,60600.44
170765,202204,125,71,54,86052.4,66660,152712.4
170770,202204,194,125,69,151500,83628,235128
170820,202204,583,386,197,470256,238764.6,709020.6
170825,202204,42,24,18,29088,21816,50904
170830,202204,86,69,17,83628,20604,104232
170900,202204,171,132,39,159984.2,47268,207252.2
170930,202204,936,510,426,618120.99,517524.27,1135645.26
170950,202204,3130,1482,1648,1797396.8,1999801.46,3797198.26
170980,202204,17,10,7,12120.2,8484,20604.2
171050,202204,144,109,35,132108,42420,174528
171070,202204,52,44,8,53328,9696,63024
171090,202204,46,34,12,41208,14544,55752
171110,202204,24,18,6,21816,7272,29088
171150,202204,40,23,17,27876,21816,49692
171180,202204,22,9,13,10908,15756,26664
171190,202204,168,95,73,115140,88476,203616
171195,202204,57,47,10,56964,12120,69084
171200,202204,34,16,18,19392,23028,42420
171215,202204,7,5,2,6060,2424,8484
171240,202204,60,44,16,53328,19392,72720
171245,202204,55,47,8,56964.2,9696,66660.2
171250,202204,75,43,32,53328,38784,92112
171270,202204,12,8,4,9696,4848,14544
171280,202204,44,36,8,43632,9696,53328
171320,202204,984,561,423,681144,512676.6,1193820.6
171330,202204,419,215,204,260580,247248,507828
171360,202204,97,68,29,82416,35148,117564
171370,202204,33,18,15,21816,18180,39996
171380,202204,133,115,18,139380,23028,162408
171395,202204,43,24,19,29088,23028,52116
171420,202204,260,173,87,209676.5,105444,315120.5
171430,202204,75,62,13,75144,15756,90900
171488,202204,204,114,90,138168,109080,247248
171500,202204,63,33,30,39996,36360,76356
171510,202204,75,48,27,58176,33936,92112
171515,202204,36,29,7,35148,8484,43632
171525,202204,24,22,2,26664,2424,29088
171550,202204,14,8,6,9696,7272,16968
171570,202204,51,25,26,30300,31512,61812
171575,202204,267,177,90,214524,109080,323604
171610,202204,1768,893,875,1083528.52,1061712.9,2145241.42
171620,202204,141,95,46,115140,55752,170892
171630,202204,51,30,21,36360,25452,61812
171650,202204,332,230,102,278760.96,123624,402384.96
171660,202204,250,146,104,176952,126048.6,303000.6
171665,202204,78,49,29,59388,35148,94536
171670,202204,423,258,165,312696,201192,513888
171700,202204,63,55,8,66660,9696,76356
171720,202204,31,12,19,14544,23028,37572
171750,202204,101,52,49,64236,59388,123624
171780,202204,72,55,17,66660,20604,87264
171790,202204,83,68,15,82416,18180,100596
171800,202204,34,26,8,31512,9696,41208
171820,202204,2029,1179,850,1432587.06,1033836.2,2466423.26
171830,202204,33,25,8,30300,9696,39996
171840,202204,61,39,22,47268,26664,73932
171845,202204,28,18,10,21816,12120,33936
171850,202204,38,31,7,37572,8484,46056
171855,202204,75,56,19,67872,23028,90900
171865,202204,5,4,1,4848,1212,6060
171870,202204,30,18,12,21816,14544,36360
171875,202204,81,59,22,71508,26664,98172
171880,202204,39,23,16,27876,19392,47268
171884,202204,51,29,22,35148,26664,61812
171886,202204,129,58,71,70296,86052,156348
171888,202204,26,21,5,25452.1,6060,31512.1
171889,202204,11,5,6,6060,7272,13332
171890,202204,53,44,9,53328,10908,64236
171900,202204,30,20,10,24240.1,12120,36360.1
172000,202204,34,29,5,35148,6060,41208
172010,202204,55,44,11,53328,13332,66660
172015,202204,21,16,5,19392.52,6060,25452.52
172020,202204,144,93,51,112716,63024,175740
172025,202204,37,24,13,30300,15756,46056
172030,202204,44,25,19,30300,23028,53328
172049,202204,82,53,29,64236,35148,99384
172065,202204,114,74,40,89688,48480,138168
172080,202204,117,72,45,88476.2,54540,143016.2
172085,202204,30,16,14,19392,16968,36360
172090,202204,430,319,111,387840.63,134532,522372.63
172093,202204,15,13,2,15756,2424,18180
172097,202204,19,10,9,12120,10908,23028
172100,202204,5455,3107,2348,3768113.94,2851839.82,6619953.76
172110,202204,83,56,27,67872,33936,101808
172120,202204,1675,1395,280,1691954.93,339360,2031314.93
172125,202204,11,10,1,12120,1212,13332
172130,202204,26,15,11,18180,13332,31512
172208,202204,197,120,77,145440,93324,238764
172210,202204,361,182,179,220584.67,216948,437532.67
210005,202204,2962,1858,1104,2253109.6,1339263.1,3592372.7
210010,202204,145,90,55,109080,66660,175740
210015,202204,42,30,12,36360,14544,50904
210020,202204,368,212,156,256944,189072,446016
210030,202204,313,209,104,253308,126048,379356
210040,202204,133,107,26,129684,31512,161196
210043,202204,252,199,53,241188,64236,305424
210047,202204,488,300,188,364812,227856,592668
210050,202204,268,199,69,241188,83628,324816
210055,202204,54,43,11,52116,13332,65448
210060,202204,529,432,97,523584.7,117564,641148.7
210070,202204,438,341,97,413292,117564,530856
210080,202204,135,124,11,150288,13332,163620
210083,202204,288,146,142,176952,172104,349056
210087,202204,5,4,1,4848,1212,6060
210090,202204,433,310,123,378144.6,149076,527220.6
210095,202204,412,317,95,384204.2,115140.2,499344.4
210100,202204,698,555,143,672660,173316,845976
210110,202204,119,80,39,96960,47268,144228
210120,202204,4879,3873,1006,4696506.98,1220484.2,5916991.18
210125,202204,173,106,67,128472,81204,209676
210130,202204,445,261,184,318756,223008,541764
210135,202204,29,22,7,26664,8484,35148
210140,202204,4412,3408,1004,4131712.3,1216849.22,5348561.52
210150,202204,357,229,128,278760.65,155136,433896.65
210160,202204,3194,2727,467,3306339.53,566004,3872343.53
210170,202204,1188,957,231,1159884,279972,1439856
210173,202204,120,107,13,129684,15756,145440
210177,202204,321,180,141,218160,170892,389052
210180,202204,29,16,13,19392,15756,35148
210190,202204,433,292,141,355116,170892,526008
210193,202204,6,4,2,4848,2424,7272
210197,202204,71,54,17,65448,20604,86052
210200,202204,597,509,88,616908.6,106656,723564.6
210203,202204,200,143,57,173316,69084,242400
210207,202204,355,296,59,358752,71508,430260
210210,202204,708,659,49,798708,59388,858096
210215,202204,70,59,11,71508.2,13332,84840.2
210220,202204,360,309,51,374508,61812,436320
210230,202204,306,247,59,299364,71508,370872
210232,202204,1238,880,358,1066560,433896,1500456
210235,202204,181,137,44,166044,53328,219372
210237,202204,33,17,16,20604,19392,39996
210240,202204,74,64,10,78780,12120,90900
210250,202204,176,151,25,183012,30300,213312
210255,202204,361,275,86,334512.1,104232,438744.1
210260,202204,386,270,116,327240,140592,467832
210270,202204,609,417,192,505404,233916,739320
210275,202204,89,69,20,83628,24240,107868
210280,202204,1045,687,358,833856.52,436320,1270176.52
210290,202204,512,346,166,419352.5,201192,620544.5
210300,202204,4932,3176,1756,3855373.56,2128272.72,5983646.28
210310,202204,115,78,37,94536,44844,139380
210312,202204,119,83,36,100596,43632,144228
210315,202204,111,94,17,113928,20604,134532
210317,202204,138,105,33,127260,39996,167256
210320,202204,2311,1988,323,2410668.62,391476,2802144.62
210325,202204,142,85,57,103020.6,69084,172104.6
210330,202204,4255,2493,1762,3022729,2135544.2,5158273.2
210340,202204,1196,914,282,1108980.4,341784.6,1450765.0
210350,202204,660,550,110,666600.2,133320,799920.2
210355,202204,141,121,20,147864,24240,172104
210360,202204,2051,1460,591,1771946.64,716292,2488238.64
210370,202204,1202,614,588,744168.6,713868,1458036.6
210375,202204,188,95,93,115140,112716,227856
210380,202204,720,564,156,683568.6,189072,872640.6
210390,202204,187,158,29,193920,35148,229068
210400,202204,395,345,50,418140,60600,478740
210405,202204,1009,709,300,861732.1,363600,1225332.1
210407,202204,68,55,13,66660,15756,82416
210408,202204,41,36,5,44844,6060,50904
210409,202204,325,286,39,346632,47268,393900
210410,202204,434,342,92,414504,111504,526008
210420,202204,209,174,35,210888,42420,253308
210430,202204,52,37,15,44844,18180,63024
210440,202204,367,249,118,301788.8,143016,444804.8
210450,202204,101,85,16,103020,19392,122412
210455,202204,235,127,108,153924.6,130896,284820.6
210460,202204,305,209,96,253308.2,117564,370872.2
210462,202204,65,53,12,64236,14544,78780
210465,202204,138,111,27,134532,32724,167256
210467,202204,517,386,131,467832,158772,626604
210470,202204,49,42,7,50904,8484,59388
210480,202204,1275,924,351,1121100.72,425412.1,1546512.82
210490,202204,182,128,54,155136,65448,220584
210500,202204,478,299,179,362388.3,216948,579336.3
210510,202204,523,425,98,516312,118776,635088
210515,202204,342,220,122,266640,147864.2,414504.2
210520,202204,397,361,36,437532,43632,481164
210530,202204,9377,4865,4512,5902450.34,5474611.72,11377062.06
210535,202204,122,92,30,111504,36360,147864
210540,202204,1476,991,485,1201094.6,587820,1788914.6
210542,202204,1110,568,542,689628.9,659329.8,1348958.7
210545,202204,21,19,2,23028,2424,25452
210547,202204,122,105,17,127260.12,20604,147864.12
210550,202204,596,427,169,517524.76,204828,722352.76
210560,202204,156,135,21,163620,25452,189072
210565,202204,20,14,6,16968,7272,24240
210570,202204,1281,1068,213,1294416.9,259368,1553784.9
210580,202204,120,103,17,124836,20604,145440
210590,202204,715,596,119,722352,144228,866580
210592,202204,43,39,4,47268,4848,52116
210594,202204,105,92,13,111504,15756,127260
210596,202204,113,97,16,117564,19392,136956
210598,202204,137,106,31,128472,38784,167256
210600,202204,298,260,38,315120,46056,361176
210610,202204,241,227,14,275124,16968,292092
210620,202204,43,28,15,33936,18180,52116
210630,202204,68,65,3,78780,3636,82416
210632,202204,974,693,281,839916,340572,1180488
210635,202204,25,22,3,26664,3636,30300
210637,202204,126,91,35,111504,42420,153924
210640,202204,574,512,62,620544.2,75144,695688.2
210650,202204,377,323,54,391476,65448,456924
210660,202204,350,278,72,336936.1,87264,424200.1
210663,202204,54,41,13,49692.1,15756,65448.1
210667,202204,93,40,53,48480,64236,112716
210670,202204,250,223,27,270276.2,32724,303000.2
210675,202204,488,276,212,334512.2,258156,592668.2
210680,202204,224,144,80,174528,96960,271488
210690,202204,69,61,8,73932,9696,83628
210700,202204,155,119,36,144228,43632,187860
210710,202204,229,142,87,172104,105444,277548
210720,202204,126,111,15,134532,18180,152712
210725,202204,59,50,9,60600,10908,71508
210730,202204,20,16,4,19392,4848,24240
210735,202204,280,205,75,248460,90900.6,339360.6
210740,202204,507,439,68,532068.2,82416,614484.2
210745,202204,149,111,38,134532,46056,180588
210750,202204,2484,1293,1191,1571965.95,1443492.2,3015458.15
210760,202204,244,190,54,230280,65448,295728
210770,202204,240,195,45,236340.58,54540,290880.58
210780,202204,417,321,96,389052,116352,505404
210790,202204,181,153,28,185436,33936,219372
210800,202204,165,129,36,156348.7,43632,199980.7
210805,202204,60,54,6,65448,7272,72720
210810,202204,446,364,82,441168.3,99384,540552.3
210820,202204,1983,1664,319,2016771.97,386628,2403399.97
210825,202204,150,88,62,107868.2,75144,183012.2
210830,202204,688,469,219,568428,266640,835068
210840,202204,191,138,53,167256,64236,231492
210845,202204,226,173,53,209676,64236,273912
210850,202204,711,496,215,602364.6,261792,864156.6
210860,202204,3375,1994,1381,2416728.8,1674984,4091712.8
210870,202204,411,329,82,399960.6,99384,499344.6
210880,202204,76,60,16,73932.2,19392,93324.2
210890,202204,313,275,38,333300.8,46056,379356.8
210900,202204,649,428,221,519948.58,269064,789012.58
210905,202204,58,33,25,39996,31512,71508
210910,202204,2110,1584,526,1921021.78,638724.2,2559745.98
210920,202204,151,63,88,76356,106656,183012
210923,202204,78,64,14,77568,16968,94536
210927,202204,414,212,202,256944,244824,501768
210930,202204,65,54,11,65448,13332,78780
210940,202204,76,60,16,72720,19392,92112
210945,202204,197,115,82,139380.14,99384,238764.14
210950,202204,505,372,133,450864,161196,612060
210955,202204,86,56,30,67872,36360,104232
210960,202204,2251,1146,1105,1390164,1339260,2729424
210970,202204,106,92,14,111504,16968,128472
210975,202204,77,72,5,87264,6060,93324
210980,202204,1058,529,529,641148.4,641148.6,1282297.0
210990,202204,4375,3071,1304,3724481.46,1580448,5304929.46
211000,202204,1251,1026,225,1244726.08,272700,1517426.08
211003,202204,946,690,256,836280.37,310272,1146552.37
211010,202204,467,423,44,512676.36,53328,566004.36
211020,202204,1360,601,759,729625.28,919908.42,1649533.70
211023,202204,43,38,5,46056,6060,52116
211027,202204,75,54,21,65448,25452,90900
211030,202204,358,258,100,312696,121200,433896
211040,202204,281,237,44,287244.6,53328,340572.6
211050,202204,1079,741,338,898092.6,409656.6,1307749.2
211060,202204,606,538,68,652056.4,82416.23,734472.63
211065,202204,24,19,5,23028.2,6060,29088.2
211070,202204,828,699,129,847190.27,156348,1003538.27
211080,202204,86,84,2,101808,2424,104232
211085,202204,56,33,23,39996,27876,67872
211090,202204,74,63,11,76356,13332,89688
211100,202204,457,385,72,466620.95,87264,553884.95
211102,202204,232,167,65,203616,78780,282396
211105,202204,208,147,61,178164,73932,252096
211107,202204,124,79,45,95748,54540,150288
211110,202204,932,633,299,767196.2,363600.8,1130797.0
211120,202204,4951,2569,2382,3114843.72,2888196.84,6003040.56
211125,202204,25,17,8,20604,9696,30300
211130,202204,40352,18982,21370,23021966.5,25913783.9,48935750.4
211140,202204,395,349,46,422988.2,55752,478740.2
211150,202204,1169,823,346,997476.4,419352.8,1416829.2
211153,202204,162,100,62,121200,75144,196344
211157,202204,68,57,11,69084,13332,82416
211160,202204,672,575,97,696900.94,117564,814464.94
211163,202204,3,3,0,3636,,3636.0
211167,202204,12,11,1,13332,1212,14544
211170,202204,403,300,103,363600,124836,488436
211172,202204,111,79,32,95748,39996,135744
211174,202204,15,13,2,15756,2424,18180
211176,202204,453,333,120,403596.6,145440.2,549036.8
211178,202204,92,63,29,76356,35148,111504
211180,202204,210,170,40,207252,48480,255732
211190,202204,66,59,7,71508,8484,79992
211195,202204,34,23,11,27876.2,13332.6,41208.8
211200,202204,148,127,21,153924,25452,179376
211210,202204,402,301,101,364812,122412,487224
211220,202204,4151,2473,1678,2997281.16,2037372.8,5034653.96
211223,202204,97,92,5,112716,6060,118776
211227,202204,53,44,9,53328,10908,64236
211230,202204,708,588,120,713868.2,145440.2,859308.4
211240,202204,368,304,64,368448,77568,446016
211245,202204,177,96,81,116352,98172,214524
211250,202204,1469,1276,193,1547725.6,233916.65,1781642.25
211260,202204,769,654,115,793860,139380,933240
211270,202204,1840,1519,321,1841028.6,389052.6,2230081.2
211280,202204,1752,1174,578,1422889.52,700536,2123425.52
211285,202204,206,134,72,163620,87264,250884
211290,202204,709,510,199,619332.2,241188,860520.2
211300,202204,741,600,141,728412.4,170892,899304.4
211400,202204,1502,961,541,1165945.6,655692.76,1821638.36
220005,202204,16,15,1,18180,1212,19392
220010,202204,82,68,14,82416,16968,99384
220020,202204,687,561,126,679932.17,152712,832644.17
220025,202204,104,101,3,122412,3636,126048
220027,202204,51,42,9,50904,10908,61812
220030,202204,122,100,22,121200,26664,147864
220040,202204,1238,953,285,1156248.88,345420,1501668.88
220045,202204,29,20,9,25452,10908,36360
220050,202204,683,566,117,687205.29,141804,829009.29
220060,202204,176,154,22,186648,26664,213312
220070,202204,110,96,14,116352,16968,133320
220080,202204,12,11,1,13332,1212,14544
220090,202204,37,28,9,33936,10908,44844
220095,202204,1,1,0,1212,,1212.0
220100,202204,20,17,3,20604,3636,24240
220105,202204,28,26,2,31512.6,2424,33936.6
220110,202204,236,218,18,264216,21816,286032
220115,202204,42,38,4,46056,4848,50904
220117,202204,22,20,2,24240,2424,26664
220120,202204,1451,1107,344,1345320.46,418140,1763460.46
220130,202204,27,26,1,31512,1212,32724
220140,202204,97,78,19,94536,23028,117564
220150,202204,475,356,119,431472.4,144228,575700.4
220155,202204,12,11,1,13332,1212,14544
220157,202204,19,16,3,19392,3636,23028
220160,202204,95,83,12,100596,14544,115140
220170,202204,39,34,5,41208,6060,47268
220173,202204,9,8,1,9696,1212,10908
220177,202204,15,14,1,16968,1212,18180
220180,202204,64,63,1,76356,1212,77568
220190,202204,1085,945,140,1145340,169680,1315020
220191,202204,36,30,6,36360,7272,43632
220192,202204,87,82,5,99384,6060,105444
220194,202204,58,52,6,63024,7272,70296
220196,202204,82,67,15,81204,18180,99384
220198,202204,1,1,0,1212,,1212.0
220200,202204,406,342,64,414504.6,77568,492072.6
220202,202204,37,32,5,38784,6060,44844
220205,202204,62,54,8,65448,9696,75144
220207,202204,12,12,0,14544,,14544.0
220208,202204,74,45,29,54540,35148,89688
220209,202204,33,27,6,32724,7272,39996
220210,202204,22,16,6,19392,7272,26664
220211,202204,32,29,3,35148,3636,38784
220213,202204,33,30,3,36360.44,3636,39996.44
220217,202204,39,31,8,37572,9696,47268
220220,202204,2241,1478,763,1791336.2,925968.6,2717304.8
220225,202204,8,3,5,3636,6060,9696
220230,202204,960,738,222,894456.2,269064.2,1163520.4
220240,202204,162,142,20,172104,24240,196344
220245,202204,35,32,3,38784.4,3636,42420.4
220250,202204,124,107,17,129684,20604,150288
220253,202204,52,46,6,55752,7272,63024
220255,202204,41,35,6,42420,7272,49692
220260,202204,690,529,161,642360,197556,839916
220265,202204,6,5,1,6060,1212,7272
220270,202204,812,734,78,889608.75,94536,984144.75
220271,202204,37,28,9,33936,10908,44844
220272,202204,11,11,0,13332,,13332.0
220273,202204,17,15,2,18180,2424,20604
220275,202204,60,51,9,61812,10908,72720
220277,202204,21,16,5,19392,6060.2,25452.2
220280,202204,17,11,6,13332,7272,20604
220285,202204,37,35,2,42420,2424,44844
220290,202204,1489,1276,213,1546515.18,258156.8,1804671.98
220300,202204,34,33,1,39996,1212,41208
220310,202204,327,280,47,339360,56964,396324
220320,202204,444,411,33,498132.8,39996,538128.8
220323,202204,2,1,1,1212,1212,2424
220325,202204,8,7,1,8484,1212,9696
220327,202204,11,11,0,13332,,13332.0
220330,202204,225,161,64,195132,77568,272700
220335,202204,135,114,21,138168,25452,163620
220340,202204,45,32,13,38784,16968,55752
220342,202204,53,44,9,53328,10908,64236
220345,202204,80,69,11,83628,13332,96960
220350,202204,458,396,62,479952,75144,555096
220360,202204,40,30,10,36360,12120,48480
220370,202204,1277,1064,213,1290781.92,259368,1550149.92
220375,202204,14,14,0,16968,,16968.0
220380,202204,26,19,7,23028.2,8484,31512.2
220385,202204,15,14,1,16968,1212,18180
220390,202204,2314,1281,1033,1553785.98,1253209,2806994.98
220400,202204,34,30,4,36360,4848,41208
220410,202204,23,21,2,25452,2424,27876
220415,202204,13,12,1,14544,1212,15756
220420,202204,123,104,19,126048,23028,149076
220430,202204,129,114,15,138168.6,18180,156348.6
220435,202204,23,17,6,20604,7272,27876
220440,202204,274,233,41,282396.6,49692.2,332088.8
220450,202204,332,165,167,201192,202404,403596
220455,202204,48,47,1,56964,1212,58176
220460,202204,18,16,2,19392,2424,21816
220465,202204,73,49,24,59388,29088,88476
220470,202204,232,204,28,247248,33936,281184
220480,202204,73,66,7,79992,8484,88476
220490,202204,88,75,13,90900,15756,106656
220500,202204,114,95,19,115140,23028,138168
220510,202204,369,284,85,344208,103020,447228
220515,202204,20,18,2,21816,2424,24240
220520,202204,366,324,42,392688.96,50904,443592.96
220525,202204,7,3,4,3636,4848,8484
220527,202204,16,13,3,15756,3636,19392
220530,202204,43,22,21,26664,25452,52116
220535,202204,6,5,1,6060,1212,7272
220540,202204,85,73,12,88476,14544,103020
220545,202204,27,18,9,21816,10908,32724
220550,202204,699,553,146,670236.51,176952.1,847188.61
220551,202204,13,11,2,13332,2424,15756
220552,202204,13,12,1,14544,1212,15756
220553,202204,52,47,5,56964,6060,63024
220554,202204,9,6,3,7272,3636,10908
220555,202204,41,34,7,41208,8484,49692
220556,202204,36,34,2,41208,2424,43632
220557,202204,55,48,7,58176,8484,66660
220558,202204,7,3,4,3636,4848,8484
220559,202204,3,3,0,3636,,3636.0
220560,202204,71,46,25,55752,30300,86052
220570,202204,709,444,265,539340.2,321180,860520.2
220580,202204,537,491,46,596304.71,56964,653268.71
220585,202204,12,11,1,13332,1212,14544
220590,202204,13,12,1,14544,1212,15756
220595,202204,75,57,18,69084,21816,90900
220600,202204,20,13,7,15756,8484,24240
220605,202204,25,22,3,26664,3636,30300
220610,202204,86,74,12,89688,14544,104232
220620,202204,546,462,84,559944.6,101808,661752.6
220630,202204,6,5,1,6060,1212,7272
220635,202204,33,30,3,36360,3636,39996
220640,202204,108,89,19,107868,23028,130896
220650,202204,113,107,6,129684,7272,136956
220660,202204,62,47,15,56964,18180,75144
220665,202204,8,8,0,9696,,9696.0
220667,202204,17,14,3,16968,3636,20604
220669,202204,33,27,6,32724,7272,39996
220670,202204,64,52,12,63024,14544,77568
220672,202204,76,57,19,69084,23028,92112
220675,202204,30,23,7,27876,8484,36360
220680,202204,50,43,7,52116,8484,60600
220690,202204,50,47,3,56964,3636,60600
220695,202204,26,14,12,16968,14544,31512
220700,202204,1772,1369,403,1660442.13,488436,2148878.13
220710,202204,6,4,2,4848,2424,7272
220720,202204,109,93,16,112716,19392,132108
220730,202204,19,18,1,21816,1212,23028
220735,202204,4,1,3,1212,3636,4848
220740,202204,50,45,5,54540,6060,60600
220750,202204,113,95,18,115140,21816,136956
220755,202204,17,17,0,20604,,20604.0
220760,202204,64,57,7,69084,8484,77568
220770,202204,5829,3291,2538,3989908.45,3078481.2,7068389.65
220775,202204,13,9,4,10908,4848,15756
220777,202204,20,19,1,23028,1212,24240
220779,202204,1,0,1,,1212,1212.0
220780,202204,897,761,136,922332,164832.6,1087164.6
220785,202204,4,1,3,1212,3636,4848
220790,202204,1151,914,237,1107769.62,287244,1395013.62
220793,202204,6,5,1,6060,1212,7272
220795,202204,17,15,2,18180,2424,20604
220800,202204,3987,3050,937,3696827.1,1138068.2,4834895.3
220810,202204,69,60,9,72720.75,10908,83628.75
220820,202204,239,216,23,261792,27876,289668
220830,202204,1268,1104,164,1340472.19,198768,1539240.19
220840,202204,2447,1729,718,2096764.99,872640.8,2969405.79
220850,202204,66,59,7,71508,8484,79992
220855,202204,8,4,4,4848,4848,9696
220860,202204,9,8,1,9696,1212,10908
220865,202204,29,25,4,30300,4848,35148
220870,202204,86,79,7,95748,8484,104232
220880,202204,326,263,63,318756,76356,395112
220885,202204,27,26,1,32724,1212,33936
220887,202204,7,6,1,7272,1212,8484
220890,202204,86,74,12,89688,14544,104232
220900,202204,25,14,11,16968,13332,30300
220910,202204,47,38,9,46056,10908,56964
220915,202204,10,9,1,10908,1212,12120
220920,202204,50,44,6,53328.2,7272,60600.2
220930,202204,47,45,2,54540,2424,56964
220935,202204,13,13,0,15756,,15756.0
220937,202204,32,28,4,33936,4848,38784
220940,202204,54,50,4,60600,4848,65448
220945,202204,2,2,0,2424,,2424.0
220950,202204,34,27,7,32724,8484,41208
220955,202204,15,15,0,18180,,18180.0
220960,202204,28,26,2,31512.6,2424,33936.6
220965,202204,39,36,3,43632,3636,47268
220970,202204,61,52,9,63024,10908,73932
220975,202204,11,10,1,12120,1212,13332
220980,202204,30,28,2,33936,2424,36360
220985,202204,56,49,7,59388,8484,67872
220987,202204,30,28,2,33936,2424,36360
220990,202204,23,22,1,26664,1212,27876
220995,202204,11,9,2,10908,2424,13332
220997,202204,59,52,7,63024,8484,71508
221000,202204,1206,1077,129,1306536.4,157560,1464096.4
221005,202204,38,35,3,42420,3636,46056
221010,202204,21,16,5,19392,6060,25452
221020,202204,32,31,1,37572,1212,38784
221030,202204,38,30,8,36360,9696,46056
221035,202204,20,19,1,23028,1212,24240
221037,202204,12,8,4,9696,4848,14544
221038,202204,28,25,3,30300,3636,33936
221039,202204,24,23,1,27876,1212,29088
221040,202204,264,228,36,276336.2,43632,319968.2
221050,202204,221,186,35,225432,42420,267852
221060,202204,1920,1656,264,2008287.16,321180,2329467.16
221062,202204,27,26,1,31512,1212,32724
221063,202204,14,9,5,10908,6060,16968
221065,202204,67,55,12,66660,14544,81204
221070,202204,137,119,18,144228,21816,166044
221080,202204,377,321,56,389052.3,69084,458136.3
221090,202204,19,15,4,18180,4848.1,23028.1
221093,202204,42,31,11,37572,13332,50904
221095,202204,4,4,0,4848,,4848.0
221097,202204,12,10,2,12120,2424,14544
221100,202204,25839,15463,10376,18752095.1,12582989.39,31335084.49
221110,202204,1105,841,264,1021716.73,319968.2,1341684.93
221120,202204,540,391,149,473893.17,180588,654481.17
221130,202204,969,781,188,947784,227856,1175640
221135,202204,31,26,5,31512,6060,37572
221140,202204,44,37,7,44844,8484,53328
221150,202204,9,7,2,8484,2424,10908
221160,202204,10,10,0,12120,,12120.0
221170,202204,17,17,0,20604,,20604.0
230010,202204,151,135,16,163620.5,19392,183012.5
230015,202204,147,120,27,145440,32724,178164
230020,202204,1647,1349,298,1638626.85,362388.7,2001015.55
230030,202204,1656,1188,468,1439863.05,567216,2007079.05
230040,202204,225,179,46,218160.2,55752,273912.2
230050,202204,228,163,65,197556,78780,276336
230060,202204,155,124,31,150288,37572,187860
230070,202204,300,257,43,311484.2,52116,363600.2
230075,202204,863,726,137,881124.6,166044,1047168.6
230080,202204,206,176,30,213312,36360,249672
230090,202204,151,113,38,136956,46056,183012
230100,202204,2420,1368,1052,1658017,1275024,2933041
230110,202204,2929,1853,1076,2249475.25,1305324.8,3554800.05
230120,202204,1091,850,241,1031412.5,292092,1323504.5
230125,202204,165,131,34,158772.2,41208,199980.2
230130,202204,472,417,55,507828.8,66660,574488.8
230140,202204,208,170,38,206040,47268,253308
230150,202204,152,117,35,141804,42420,184224
230160,202204,935,776,159,940512,192708,1133220
230170,202204,611,542,69,656905.88,83628,740533.88
230180,202204,66,60,6,72720,7272,79992
230185,202204,410,349,61,422988.2,73932,496920.2
230190,202204,2444,1882,562,2281793.3,683568.2,2965361.5
230195,202204,507,439,68,532068.1,82416,614484.1
230200,202204,425,332,93,402384.5,112716,515100.5
230205,202204,391,262,129,317544,157560,475104
230210,202204,1405,1073,332,1301689.91,403596.78,1705286.69
230220,202204,1583,1065,518,1291993.3,627816.6,1919809.9
230230,202204,970,807,163,979296,197556,1176852
230240,202204,1848,1608,240,1951624.9,290881.2,2242506.1
230250,202204,1764,1441,323,1750130.13,391476,2141606.13
230260,202204,3241,2007,1234,2432484.6,1499244,3931728.6
230270,202204,1343,1055,288,1283509.88,349056,1632565.88
230280,202204,2789,2117,672,2567018.3,815676.56,3382694.86
230290,202204,354,312,42,379356.26,50904,430260.26
230300,202204,518,378,140,460560,169680,630240
230310,202204,424,325,99,393900,119988,513888
230320,202204,915,770,145,934453.2,175740,1110193.2
230330,202204,308,245,63,296940.2,76356.4,373296.6
230340,202204,438,352,86,426624.6,105444,532068.6
230350,202204,3324,2059,1265,2497933.5,1535604.2,4033537.7
230360,202204,273,225,48,272700,58176,330876
230365,202204,127,104,23,126048,27876,153924
230370,202204,10903,5388,5515,6531477.54,6692667.1,13224144.64
230380,202204,485,416,69,504192.5,83628.65,587821.15
230390,202204,524,299,225,362388,273912.6,636300.6
230393,202204,238,197,41,238764,49692,288456
230395,202204,351,284,67,344208.52,81204.1,425412.62
230400,202204,628,503,125,609636,151500,761136
230410,202204,2703,1689,1014,2048283.94,1232606.62,3280890.56
230420,202204,6493,4296,2197,5211605.38,2665192.2,7876797.58
230423,202204,340,296,44,358752,53328,412080
230425,202204,475,377,98,456924.2,118776,575700.2
230426,202204,111,86,25,104232,30300,134532
230427,202204,71,66,5,79992,6060,86052
230428,202204,1605,796,809,965964,984144,1950108
230430,202204,453,370,83,448440,103020,551460
230435,202204,942,689,253,835068,307848,1142916
230440,202204,94676,42892,51784,52032447.09,62817999.38,114850446.47
230445,202204,323,220,103,266640,124836,391476
230450,202204,582,458,124,555096,151500,706596
230460,202204,85,64,21,77568,25452,103020
230465,202204,312,252,60,307848,72720,380568
230470,202204,2033,1593,440,1931928.6,533280,2465208.6
230480,202204,154,140,14,170892,16968,187860
230490,202204,328,260,68,316332,83628,399960
230495,202204,478,338,140,409656.1,169680.2,579336.3
230500,202204,1074,803,271,973236,328452,1301688
230510,202204,61,44,17,53328,20604,73932
230520,202204,403,308,95,373296,115140,488436
230523,202204,2486,1532,954,1857997.06,1157461.94,3015459.00
230526,202204,258,222,36,269064,43632,312696
230530,202204,689,506,183,613274.15,221796,835070.15
230533,202204,218,199,19,241188,23028,264216
230535,202204,377,282,95,342997.11,115140,458137.11
230540,202204,1786,1588,198,1927083.65,239977.25,2167060.90
230550,202204,3980,2541,1439,3083333,1745284.41,4828617.41
230560,202204,587,446,141,540552,170892,711444
230565,202204,218,163,55,198768,66660,265428
230570,202204,282,241,41,292092,49692,341784
230580,202204,1194,846,348,1026565.43,422988.2,1449553.63
230590,202204,1025,791,234,959904,283608,1243512
230600,202204,252,226,26,273912.2,31512,305424.2
230610,202204,437,326,111,395112.4,134532,529644.4
230620,202204,166,144,22,174528.8,26664,201192.8
230625,202204,831,565,266,684780.1,323604,1008384.1
230630,202204,1352,1025,327,1242301.88,397536.74,1639838.62
230640,202204,3849,3189,660,3865072.36,801134.78,4666207.14
230650,202204,502,429,73,519948,89688,609636
230655,202204,698,570,128,690840.4,155136,845976.4
230660,202204,355,292,63,353904,76356,430260
230670,202204,463,380,83,460560.56,101808,562368.56
230680,202204,208,184,24,223008,29088,252096
230690,202204,950,799,151,968388.79,183012,1151400.79
230700,202204,939,784,155,950208.9,187860,1138068.9
230710,202204,661,618,43,750228.64,52116,802344.64
230720,202204,144,124,20,150288,24240,174528
230725,202204,247,186,61,225432,73932,299364
230730,202204,12623,6686,5937,8109425.74,7205345.55,15314771.29
230740,202204,686,539,147,653269.2,178164.2,831433.4
230750,202204,819,686,133,831432.66,162408,993840.66
230760,202204,1491,1285,206,1558634.7,249672,1808306.7
230763,202204,335,275,60,333300.9,72720,406020.9
230765,202204,8199,3805,4394,4612880,5326743.4,9939623.4
230770,202204,5017,2537,2480,3076061.61,3008185.85,6084247.46
230780,202204,775,676,99,820524.6,119988,940512.6
230790,202204,307,254,53,307848,64236,372084
230800,202204,1163,831,332,1007172,402384,1409556
230810,202204,1414,1234,180,1495611.93,218160.5,1713772.43
230820,202204,375,252,123,305424.6,149076,454500.6
230830,202204,951,801,150,970812.9,181800,1152612.9
230835,202204,279,236,43,287244,52116,339360
230837,202204,172,139,33,168468,39996,208464
230840,202204,926,712,214,862944.1,259368.9,1122313.0
230850,202204,1400,1200,200,1455614.85,244824.09,1700438.94
230860,202204,308,231,77,279972,93331,373303
230870,202204,1852,1565,287,1896780.64,350268,2247048.64
230880,202204,78,62,16,75144,19392,94536
230890,202204,540,480,60,585396,72720,658116
230900,202204,296,219,77,265428,93324.88,358752.88
230910,202204,226,173,53,209676,64236,273912
230920,202204,488,381,107,461772,129684,591456
230930,202204,1053,733,320,889608.4,387840.2,1277448.6
230940,202204,844,646,198,782952.4,239976,1022928.4
230945,202204,524,419,105,509040.7,128472,637512.7
230950,202204,423,362,61,438744,73932,512676
230960,202204,2769,1840,929,2232507.23,1127160.8,3359668.03
230970,202204,1769,976,793,1184126.77,963540.95,2147667.72
230980,202204,204,161,43,195132,52116,247248
230990,202204,139,111,28,134532,33936,168468
231000,202204,203,186,17,225432,20604,246036
231010,202204,159,112,47,135744,56964,192708
231020,202204,1407,958,449,1161096.4,545401.55,1706497.95
231025,202204,1095,767,328,929604.53,399960.3,1329564.83
231030,202204,1043,860,183,1043534.88,221796.1,1265330.98
231040,202204,159,109,50,132108,60600,192708
231050,202204,948,819,129,992631.02,156349.32,1148980.34
231060,202204,161,131,30,158772,36360,195132
231070,202204,1503,1032,471,1250785.53,572064,1822849.53
231080,202204,272,243,29,294516,35148,329664
231085,202204,654,396,258,479952.4,312696,792648.4
231090,202204,259,207,52,250884,63024,313908
231095,202204,164,130,34,157560,41208,198768
231100,202204,166,136,30,164832,36360,201192
231110,202204,366,307,59,372084,72720,444804
231120,202204,272,224,48,271488,58176,329664
231123,202204,157,146,11,176952.95,13332,190284.95
231126,202204,322,244,78,298152,95748,393900
231130,202204,4968,3870,1098,4690446.13,1334412.85,6024858.98
231135,202204,212,186,26,225432,31512,256944
231140,202204,3091,2233,858,2706398.05,1039897.3,3746295.35
231150,202204,376,354,22,430260.6,26664,456924.6
231160,202204,1228,988,240,1198669.5,290880,1489549.5
231170,202204,518,361,157,437532,190284,627816
231180,202204,1793,1550,243,1878602.08,294516,2173118.08
231190,202204,209,172,37,209676,44844,254520
231195,202204,226,188,38,229068,46056,275124
231200,202204,822,662,160,805980.94,193920.4,999901.34
231210,202204,518,433,85,527220.2,103020,630240.2
231220,202204,1043,743,300,900518.57,363600.2,1264118.77
231230,202204,1508,1147,361,1392588.8,438744,1831332.8
231240,202204,1530,1046,484,1267752.4,586608.2,1854360.6
231250,202204,95,89,6,107868,7272,115140
231260,202204,255,170,85,206040,103020,309060
231270,202204,998,783,215,950208.68,260580,1210788.68
231280,202204,75,59,16,71508,19392,90900
231290,202204,7890,4419,3471,5357045.65,4209276.2,9566321.85
231300,202204,582,533,49,645996.9,59388,705384.9
231310,202204,773,709,64,859308.4,77568,936876.4
231320,202204,586,441,145,535704.8,175740,711444.8
231325,202204,97,83,14,101808,16968,118776
231330,202204,1915,1463,452,1774373.74,549036.46,2323410.20
231335,202204,250,221,29,267852,35148,303000
231340,202204,1789,1257,532,1524697.12,644785.5,2169482.62
231350,202204,1352,1075,277,1304113.7,335726.1,1639839.8
231355,202204,413,344,69,416928,83628,500556
231360,202204,546,374,172,453289.49,208464,661753.49
231370,202204,94,81,13,99384,15756,115140
231375,202204,288,211,77,255732,93324,349056
231380,202204,488,389,99,471468,121200,592668
231390,202204,205,154,51,186648,61812,248460
231395,202204,769,473,296,573276.2,358752.5,932028.7
231400,202204,1158,958,200,1162311.61,242401.5,1404713.11
231410,202204,1354,1110,244,1347745.3,295728,1643473.3
240010,202204,371,162,209,196346.23,253309.68,449655.91
240020,202204,2229,1813,416,2197359.42,504192.1,2701551.52
240030,202204,116,95,21,116352.2,25452,141804.2
240040,202204,34,33,1,39996.7,1212,41208.7
240050,202204,520,443,77,536916.4,93324.1,630240.5
240060,202204,69,63,6,76356.1,7272,83628.1
240070,202204,247,188,59,227856.48,71508,299364.48
240080,202204,545,366,179,443592.8,216948.6,660541.4
240090,202204,103,91,12,110292,14544,124836
240100,202204,1479,1391,88,1688317,107868,1796185
240110,202204,1028,686,342,832645.2,414504,1247149.2
240120,202204,144,108,36,130896,43632,174528
240130,202204,269,250,19,303000.4,23028,326028.4
240140,202204,80,55,25,66660,30300,96960
240145,202204,709,623,86,755076.5,104232.2,859308.7
240150,202204,26,19,7,23028,8484,31512
240160,202204,41,33,8,39996,9696,49692
240165,202204,40,31,9,37572,10908.2,48480.2
240170,202204,139,94,45,113928,54540,168468
240180,202204,104,78,26,94536,31512.2,126048.2
240185,202204,47,42,5,50904,6060,56964
240190,202204,14,12,2,14544.6,2424,16968.6
240200,202204,3058,1654,1404,2004649.84,1702861.3,3707511.14
240210,202204,165,125,40,151500,48480,199980
240220,202204,1108,776,332,940513.2,403596,1344109.2
240230,202204,822,751,71,910213.57,86052.1,996265.67
240240,202204,72,47,25,56964,30300,87264
240250,202204,91,79,12,95748.2,14544,110292.2
240260,202204,1795,1274,521,1545300.8,631452,2176752.8
240270,202204,176,152,24,184224,29088,213312
240280,202204,53,41,12,49692,14544,64236
240290,202204,40,38,2,46056,2424,48480
240300,202204,172,93,79,112716,95748,208464
240310,202204,2431,1303,1128,1581663.7,1368350.66,2950014.36
240320,202204,176,162,14,196344,16968,213312
240325,202204,4702,2712,1990,3286950.27,2414310.62,5701260.89
240330,202204,70,66,4,79992,4848,84840
240340,202204,86,57,29,69084,35148,104232
240350,202204,89,73,16,88476,19392,107868
240360,202204,609,369,240,447228,290880,738108
240370,202204,50,43,7,52116,8484,60600
240375,202204,59,37,22,44844,26664,71508
240380,202204,220,179,41,218160.1,49692.2,267852.3
240390,202204,15,13,2,15756,2424,18180
240400,202204,86,75,11,90900,13332,104232
240410,202204,12,8,4,9696,4848,14544
240420,202204,1057,765,292,928393.2,353904,1282297.2
240430,202204,259,237,22,287244.49,26664,313908.49
240440,202204,122,65,57,78780.1,69084,147864.1
240450,202204,242,153,89,185436.6,107868,293304.6
240460,202204,73,58,15,70296,18180,88476
240470,202204,209,189,20,229068.58,24240,253308.58
240480,202204,16,14,2,16968,2424,19392
240485,202204,82,65,17,78780,20604,99384
240490,202204,51,46,5,55752,6060,61812
240500,202204,91,68,23,82416,27876,110292
240510,202204,41,30,11,36360,13332,49692
240520,202204,99,94,5,113928,6060,119988
240530,202204,57,48,9,58176.1,10908,69084.1
240540,202204,83,70,13,84840,15756,100596
240550,202204,13,11,2,13332,2424,15756
240560,202204,380,272,108,329664,130896,460560
240570,202204,428,267,161,323604,195132,518736
240580,202204,1300,998,302,1209577.2,367236,1576813.2
240590,202204,31,30,1,36360,1212,37572
240600,202204,94,88,6,106656,7272,113928
240610,202204,494,410,84,496921.68,101808.2,598729.88
240615,202204,13,12,1,14544,1212,15756
240620,202204,85,81,4,98172,4848,103020
240630,202204,41,34,7,41208,8484,49692
240640,202204,23,19,4,23028,4848,27876
240650,202204,239,193,46,233916,55752,289668
240660,202204,107,91,16,110292,19392,129684
240670,202204,302,164,138,198768.8,167256,366024.8
240680,202204,53,40,13,48480,15756,64236
240690,202204,46,43,3,52116,3636,55752
240700,202204,177,144,33,174528,39996,214524
240710,202204,2155,1287,868,1561061.09,1052017.06,2613078.15
240720,202204,1047,741,306,900518.28,370873.1,1271391.38
240725,202204,66,61,5,73932,6060,79992
240730,202204,148,123,25,149076,30300,179376
240740,202204,230,195,35,236340.2,42420,278760.2
240750,202204,53,32,21,38784,25452,64236
240760,202204,51,42,9,50904,10908,61812
240770,202204,139,106,33,128472,39996,168468
240780,202204,704,580,124,702960.2,152712,855672.2
240790,202204,40,38,2,46056.32,2424,48480.32
240800,202204,9458,6371,3087,7730161.93,3742663.88,11472825.81
240810,202204,21355,11290,10065,13691996.82,12212125.12,25904121.94
240820,202204,238,137,101,166044,122412.3,288456.3
240830,202204,1593,1311,282,1590147.39,341784,1931931.39
240840,202204,74,65,9,78780,10908,89688
240850,202204,83,74,9,89688,10908,100596
240860,202204,105,100,5,121200,6060,127260
240870,202204,54,45,9,54540,10908,65448
240880,202204,30,27,3,32724,3636,36360
240890,202204,1145,638,507,773257.04,614484,1387741.04
240895,202204,64,49,15,59388,18180,77568
240910,202204,169,142,27,172104,32724,204828
240920,202204,11,10,1,12120,1212,13332
240930,202204,409,363,46,439956.3,55752,495708.3
240933,202204,56,36,20,43632,24240,67872
240940,202204,2302,2022,280,2451880.92,340574.14,2792455.06
240950,202204,44,39,5,47268,6060,53328
240960,202204,24,20,4,24240,4848,29088
240970,202204,107,81,26,98172,36360,134532
240980,202204,198,161,37,195132,44844,239976
240990,202204,133,89,44,107868,53328,161196
241000,202204,59,55,4,66660,4848,71508
241010,202204,74,57,17,69084,20604,89688
241020,202204,104,95,9,115140.6,10908,126048.6
241025,202204,16,9,7,10908,8484,19392
241030,202204,102,81,21,98172,25452,123624
241040,202204,39,29,10,35148,12120,47268
241050,202204,75,68,7,82416,8484,90900
241060,202204,25,20,5,24240,6060,30300
241070,202204,18,17,1,20604,1212.1,21816.1
241080,202204,54,47,7,56964,8484,65448
241090,202204,51,38,13,46056,15756,61812
241100,202204,73,62,11,75144,13332,88476
241105,202204,13,5,8,6060,9696,15756
241110,202204,46,39,7,47268,8484,55752
241120,202204,1561,1180,381,1432585.56,461772.1,1894357.66
241140,202204,205,170,35,206040.6,42420,248460.6
241142,202204,47,35,12,42420,14544,56964
241150,202204,1194,1037,157,1258058.78,190284.2,1448342.98
241160,202204,20,15,5,18180,6060,24240
241170,202204,47,40,7,49692,8484,58176
241180,202204,42,30,12,36360,14544,50904
241190,202204,37,35,2,42420,2424,44844
241200,202204,4150,2176,1974,2638531.98,2396126.04,5034658.02
241210,202204,70,59,11,71508,13332,84840
241220,202204,1457,939,518,1140495.02,629028.95,1769523.97
241230,202204,250,206,44,252096,53328,305424
241240,202204,54,40,14,48480,16968,65448
241250,202204,1131,1033,98,1255632.3,118776,1374408.3
241255,202204,55,45,10,54540.6,12120,66660.6
241260,202204,691,531,160,643572.2,193920,837492.2
241270,202204,63,45,18,54540,21816,76356
241280,202204,94,82,12,99384,14544,113928
241290,202204,124,90,34,109080,41208,150288
241300,202204,81,56,25,67872,30300,98172
241310,202204,48,33,15,39996,18180,58176
241320,202204,26,12,14,14544,16968,31512
241330,202204,58,50,8,60600,9696,70296
241335,202204,81,72,9,87264,10908,98172
241340,202204,181,132,49,159984,59388,219372
241350,202204,61,52,9,63024.74,10908,73932.74
241355,202204,50,43,7,52116,8484,60600
241360,202204,50,49,1,59388,1212,60600
241370,202204,57,45,12,54540,14544,69084
241380,202204,34,30,4,36360,4848,41208
241390,202204,82,63,19,76356,23028,99384
241400,202204,218,164,54,198768,65448,264216
241410,202204,177,161,16,195132,19392,214524
241415,202204,101,81,20,98172,24240,122412
241420,202204,116,80,36,96960,43632,140592
241430,202204,21,18,3,21816,3636,25452
241440,202204,510,427,83,518738,101808,620546
241445,202204,40,35,5,42420,6060.1,48480.1
241450,202204,258,214,44,259368.86,53328,312696.86
241460,202204,145,131,14,158772,16968,175740
241470,202204,35,29,6,35148,7272,42420
241475,202204,52,47,5,56964,6060,63024
241480,202204,118,87,31,105444,37572,143016
241490,202204,13,12,1,14544,1212,15756
241500,202204,42,32,10,38784,12120,50904
250010,202204,100,85,15,103020,18180,121200
250020,202204,29,25,4,30300,4848,35148
250030,202204,889,654,235,792648.28,284821,1077469.28
250040,202204,390,311,79,376932,95748,472680
250050,202204,268,220,48,266640,58176,324816
250053,202204,60,47,13,56964,15756,72720
250057,202204,1,1,0,1212,,1212.0
250060,202204,604,439,165,532068.3,199980,732048.3
250070,202204,678,540,138,654481.92,167256,821737.92
250073,202204,8,7,1,8484,1212,9696
250077,202204,172,128,44,155136,53328,208464
250080,202204,421,334,87,404808.68,105444.8,510253.48
250090,202204,223,143,80,173316,96960,270276
250100,202204,558,461,97,558732.58,117564.8,676297.38
250110,202204,664,489,175,593880.09,212100.5,805980.59
250115,202204,14,3,11,3636,13332.26,16968.26
250120,202204,119,85,34,103020,41208,144228
250130,202204,554,447,107,541764,129684.1,671448.1
250135,202204,22,10,12,12120,14544,26664
250140,202204,80,71,9,86052,10908,96960
250150,202204,607,433,174,524796,210888,735684
250153,202204,11,9,2,10908,2424,13332
250157,202204,29,24,5,29088,6060,35148
250160,202204,237,182,55,220584,66660.9,287244.9
250170,202204,73,46,27,55752,32724,88476
250180,202204,4606,3144,1462,3815381.48,1775584.22,5590965.70
250190,202204,813,541,272,655692,329664,985356
250200,202204,60,46,14,55752,16968,72720
250205,202204,23,19,4,23028,4848,27876
250210,202204,87,75,12,90900,14544,105444
250215,202204,71,53,18,64236,21816,86052
250220,202204,27,19,8,23028,9696,32724
250230,202204,77,68,9,82416,10908,93324
250240,202204,232,177,55,214524.19,66660,281184.19
250250,202204,372,321,51,389052.4,61812,450864.4
250260,202204,45,37,8,44844,9696,54540
250270,202204,74,52,22,63024,26664,89688
250280,202204,369,301,68,364812,83628.2,448440.2
250290,202204,90,81,9,98172,10908,109080
250300,202204,524,351,173,425412.2,209676,635088.2
250310,202204,46,42,4,50904,4848,55752
250320,202204,1993,1327,666,1608327.86,808405.4,2416733.26
250330,202204,111,94,17,113928.2,20604,134532.2
250340,202204,30,24,6,29088,7272,36360
250350,202204,189,122,67,147864,81204,229068
250355,202204,31,23,8,27876,9696,37572
250360,202204,190,158,32,191496,38784,230280
250370,202204,2356,1523,833,1848302.2,1012021.1,2860323.3
250375,202204,14,8,6,9696,7272,16968
250380,202204,54,44,10,54540,12120,66660
250390,202204,43,33,10,41208.16,12120,53328.16
250400,202204,16597,8319,8278,10088677.18,10037793.64,20126470.82
250403,202204,312,243,69,295728,83628,379356
250407,202204,68,55,13,66660,15756,82416
250410,202204,29,25,4,30300,4848,35148
250415,202204,45,28,17,33936,20604,54540
250420,202204,38,31,7,37572,8484,46056
250430,202204,1436,1237,199,1500759.72,241188.74,1741948.46
250435,202204,28,22,6,26664,7272,33936
250440,202204,676,560,116,678720.4,140592.2,819312.6
250450,202204,80,61,19,73932,23028,96960
250460,202204,466,306,160,370872.1,195132,566004.1
250470,202204,97,67,30,81204,36360,117564
250480,202204,326,261,65,316332.7,81204,397536.7
250485,202204,6,6,0,7272,,7272.0
250490,202204,228,187,41,226644.5,49692,276336.5
250500,202204,93,73,20,88476,24240,112716
250510,202204,786,622,164,753864.63,198768,952632.63
250520,202204,168,111,57,134532,69084,203616
250523,202204,120,100,20,121200,25452,146652
250527,202204,115,88,27,106656,32724,139380
250530,202204,7,4,3,4848,3636,8484
250535,202204,29,21,8,26664,9696,36360
250540,202204,143,111,32,134532.5,38784,173316.5
250550,202204,66,64,2,77568,2424,79992
250560,202204,58,38,20,46056,24240,70296
250570,202204,156,127,29,153924,35148,189072
250580,202204,98,74,24,89766,29088,118854
250590,202204,21,11,10,13332,12120,25452
250600,202204,1501,985,516,1193822.22,627816,1821638.22
250610,202204,155,126,29,152712.4,35148,187860.4
250620,202204,20,15,5,18180,6060,24240
250625,202204,65,50,15,60600,18180,78780
250630,202204,3107,1958,1149,2375751.48,1392588.1,3768339.58
250640,202204,189,150,39,181800,47268,229068
250650,202204,30,21,9,25452,10908,36360
250660,202204,60,44,16,53328,19392,72720
250670,202204,66,50,16,60600,19392,79992
250680,202204,412,330,82,399960,100596.1,500556.1
250690,202204,2097,1446,651,1753766.47,790224.69,2543991.16
250700,202204,923,786,137,952632.4,166044,1118676.4
250710,202204,453,359,94,436320.5,113928,550248.5
250720,202204,121,89,32,109080,38784,147864
250730,202204,408,338,70,410868,84840,495708
250740,202204,65,61,4,73932,4848,78780
250750,202204,23407,13895,9512,16850333.53,11543100.45,28393433.98
250760,202204,104,83,21,100596,25452,126048
250770,202204,357,231,126,279972.86,152712,432684.86
250780,202204,67,44,23,53328,27876,81204
250790,202204,452,285,167,346632,202404,549036
250800,202204,145,131,14,158772,16968,175740
250810,202204,75,61,14,73932,18180,92112
250820,202204,152,128,24,155136,29088,184224
250830,202204,448,290,158,351480.6,192708,544188.6
250840,202204,57,51,6,61812,7272,69084
250850,202204,59,49,10,59388,12120,71508
250855,202204,17,15,2,18180,2424,20604
250860,202204,238,155,83,187860,100596,288456
250870,202204,29,26,3,31512,3636,35148
250880,202204,89,67,22,81204,26664,107868
250890,202204,3101,2297,804,2786389.09,974448.5,3760837.59
250900,202204,60,50,10,60600,12120,72720
250905,202204,125,95,30,115140,36360,151500
250910,202204,1008,739,269,898092.27,326028,1224120.27
250915,202204,107,73,34,88476,41208.8,129684.8
250920,202204,138,100,38,121200,46056,167256
250930,202204,180,102,78,123624,94536,218160
250933,202204,8,5,3,6060,3636,9696
250937,202204,16,16,0,19392,,19392.0
250939,202204,30,24,6,29088,7272,36360
250940,202204,116,84,32,101808,38784,140592
250950,202204,75,53,22,64236,26664,90900
250960,202204,90,50,40,60600.5,48480,109080.5
250970,202204,1251,878,373,1064136,452076,1516212
250980,202204,103,70,33,84840.2,39996,124836.2
250990,202204,167,127,40,153924,48480,202404
251000,202204,78,68,10,82416,12120,94536
251010,202204,125,93,32,113928,38784,152712
251020,202204,77,63,14,76356,16968,93324
251030,202204,48,34,14,41208,16968,58176
251040,202204,59,39,20,47268,24240,71508
251050,202204,24,20,4,24240,4848,29088
251060,202204,49,39,10,47268,12120,59388
251065,202204,6,3,3,3636,3636,7272
251070,202204,16,13,3,15756,3636,19392
251080,202204,5277,2467,2810,2992487.16,3408146.92,6400634.08
251090,202204,189,157,32,190284,38784,229068
251100,202204,22,21,1,25452,1212,26664
251110,202204,57,38,19,46056,23028,69084
251120,202204,1908,1176,732,1426527.95,887186.42,2313714.37
251130,202204,425,350,75,424200.1,90900,515100.1
251140,202204,588,372,216,450864.1,261792,712656.1
251150,202204,343,284,59,345420.1,71508,416928.1
251160,202204,94,75,19,90900,23028,113928
251170,202204,92,75,17,90900,20604,111504
251180,202204,289,166,123,201192,150288,351480
251190,202204,195,128,67,155136.2,81204.1,236340.3
251200,202204,275,214,61,259368,73932,333300
251203,202204,35,32,3,38784,3636,42420
251207,202204,86,72,14,87264,16968,104232
251210,202204,1495,1092,403,1323506.37,488436.2,1811942.57
251220,202204,44,34,10,41208,12120,53328
251230,202204,566,468,98,568428,118776,687204
251240,202204,110,78,32,94536,38784,133320
251250,202204,1466,1040,426,1262805.61,516312.9,1779118.51
251260,202204,12,8,4,9696,4848,14544
251270,202204,305,240,65,290880,78780,369660
251272,202204,69,61,8,73932,9696,83628
251274,202204,28,22,6,26664,7272,33936
251275,202204,36,21,15,25452,18180,43632
251276,202204,28,22,6,26664,7272,33936
251278,202204,13,11,2,13332,2424,15756
251280,202204,102,97,5,117564.51,6060,123624.51
251290,202204,965,691,274,839916.3,332088.8,1172005.1
251300,202204,16,11,5,13332,6060,19392
251310,202204,298,214,84,259368,101808,361176
251315,202204,39,36,3,43632,3636,47268
251320,202204,74,58,16,70296,19392,89688
251330,202204,81,70,11,84840,13332,98172
251335,202204,22,10,12,12120,14544,26664
251340,202204,787,451,336,546612.88,407232,953844.88
251350,202204,34,33,1,39996,1212,41208
251360,202204,82,71,11,86052,13332,99384
251365,202204,6,6,0,7272,,7272.0
251370,202204,5724,3896,1828,4724379.36,2217962.25,6942341.61
251380,202204,43,32,11,38784,13332,52116
251385,202204,2,2,0,2424,,2424.0
251390,202204,923,683,240,827796,290880.65,1118676.65
251392,202204,28,18,10,21816,12120,33936
251394,202204,11,9,2,10908,2424,13332
251396,202204,13,8,5,9696,6060,15756
251398,202204,16,13,3,15756,3636,19392
251400,202204,50,39,11,47268,13332,60600
251410,202204,39,33,6,39996,7272,47268
251420,202204,103,76,27,92112,32724,124836
251430,202204,44,39,5,47268,6060,53328
251440,202204,49,25,24,30300,29088,59388
251445,202204,64,51,13,61812,15756,77568
251450,202204,387,334,53,407233.7,64236,471469.7
251455,202204,5,4,1,4848,1212,6060
251460,202204,21,17,4,20604,4848,25452
251465,202204,8,5,3,6060,3636,9696
251470,202204,53,39,14,47268,16968,64236
251480,202204,29,24,5,29088,6060,35148
251490,202204,108,68,40,82416,48480.7,130896.7
251500,202204,116,97,19,117564.2,23028,140592.2
251510,202204,74,45,29,55752,35148,90900
251520,202204,33,29,4,35148,4848,39996
251530,202204,4271,3004,1267,3643274.26,1536817.3,5180091.56
251540,202204,83,68,15,82416,18180,100596
251550,202204,407,311,96,378144.87,116352,494496.87
251560,202204,23,16,7,19392,8484,27876
251570,202204,17,15,2,18180,2424,20604
251580,202204,129,102,27,123624,32724,156348
251590,202204,107,73,34,88476,41208,129684
251593,202204,23,14,9,16968,10908,27876
251597,202204,98,74,24,89688,29088,118776
251600,202204,1084,754,330,914145.5,402384.4,1316529.9
251610,202204,237,175,62,212100,75144,287244
251615,202204,15,14,1,16968,1212,18180
251620,202204,4168,2664,1504,3231196.49,1825275.87,5056472.36
251630,202204,456,334,122,406020,147864,553884
251640,202204,120,88,32,107868,38784,146652
251650,202204,287,210,77,254520.8,93324,347844.8
251660,202204,196,173,23,209676,27876,237552
251670,202204,383,295,88,357540.4,106656,464196.4
251675,202204,10,8,2,9696,2424,12120
251680,202204,104,89,15,107868,18180,126048
251690,202204,316,263,53,318756.5,64236,382992.5
251700,202204,274,238,36,288456,43632,332088
251710,202204,21,12,9,14544,10908,25452
251720,202204,24,17,7,20604,8484,29088
251740,202204,13,10,3,12120,3636,15756
260005,202204,3511,1856,1655,2250175.3,2005862.54,4256037.84
260010,202204,1668,1242,426,1505306.24,516312.2,2021618.44
260020,202204,396,346,50,420564,60600,481164
260030,202204,594,402,192,487224,232704,719928
260040,202204,794,488,306,591456.5,372084.06,963540.56
260050,202204,1147,815,332,988994.94,403597.2,1392592.14
260060,202204,363,334,29,404808,35148,439956
260070,202204,1325,809,516,980510.83,625392,1605902.83
260080,202204,714,539,175,653268.1,212100,865368.1
260090,202204,479,312,167,378144,202404,580548
260100,202204,210,146,64,176952,77568,254520
260105,202204,249,141,108,170892,132108,303000
260110,202204,2935,2126,809,2581562.37,984144.7,3565707.07
260120,202204,2700,1449,1251,1760149.92,1516212.8,3276362.72
260130,202204,181,122,59,147864,71508,219372
260140,202204,2202,1423,779,1727101.56,945360.54,2672462.10
260150,202204,194,125,69,151500,83628,235128
260160,202204,344,281,63,340572,76356,416928
260170,202204,3324,1979,1345,2403397.12,1632566,4035963.12
260180,202204,176,142,34,172104,41208,213312
260190,202204,2334,1543,791,1870116.26,959905.75,2830022.01
260200,202204,977,761,216,922334.35,263004.6,1185338.95
260210,202204,1381,975,406,1181702.73,492072.2,1673774.93
260220,202204,650,586,64,710233.75,77568,787801.75
260230,202204,1237,914,323,1107768,392688,1500456
260240,202204,197,149,48,180588.26,58176,238764.26
260250,202204,92,68,24,82416,29088,111504
260260,202204,1051,727,324,881124,393900,1275024
260270,202204,264,188,76,227856,92112,319968
260280,202204,1151,918,233,1113828,282396.6,1396224.6
260290,202204,6788,3661,3127,4446832.16,3795985.6,8242817.76
260300,202204,980,834,146,1010810.3,178164,1188974.3
260310,202204,508,407,101,493284,122412,615696
260320,202204,821,600,221,728412,267852.54,996264.54
260330,202204,73,53,20,64236,24240,88476
260340,202204,78,58,20,70296,24240,94536
260345,202204,5554,2894,2660,3508744.3,3225132.4,6733876.7
260350,202204,475,333,142,403596,172104.6,575700.6
260360,202204,246,136,110,164832,133320,298152
260370,202204,758,469,289,569640,350268,919908
260380,202204,561,398,163,483588,197556.19,681144.19
260390,202204,297,248,49,300576,59388,359964
260392,202204,115,97,18,117564,21816,139380
260400,202204,4340,2478,1862,3008186.66,2256744.1,5264930.76
260410,202204,14987,7755,7232,9402703.45,8774881.82,18177585.27
260415,202204,141,119,22,144228,26664,170892
260420,202204,1729,1058,671,1282297.92,813252.1,2095550.02
260430,202204,172,155,17,187860.24,20604,208464.24
260440,202204,189,129,60,157560,72720,230280
260450,202204,424,317,107,384205.75,129684,513889.75
260460,202204,812,425,387,515100.4,469044.9,984145.3
260470,202204,338,206,132,249672.5,159984.2,409656.7
260480,202204,249,158,91,191496,110292.2,301788.2
260490,202204,220,172,48,208464,58176,266640
260500,202204,1114,750,364,909000.2,441168,1350168.2
260510,202204,800,631,169,764772.2,204828,969600.2
260515,202204,227,203,24,247248,29088,276336
260520,202204,3221,1980,1241,2399761,1504092.92,3903853.92
260530,202204,809,657,152,796284,184224,980508
260540,202204,528,418,110,506616,133320,639936
260545,202204,19,13,6,15756,7272,23028
260550,202204,329,209,120,255732,146652,402384
260560,202204,504,382,122,462984.3,147864.51,610848.81
260570,202204,1001,797,204,965965.39,247248,1213213.39
260580,202204,332,273,59,330876,71508,402384
260590,202204,615,356,259,431472,313908,745380
260600,202204,7731,4432,3299,5371588.38,4000814.07,9372402.45
260610,202204,489,323,166,391476,201192,592668
260620,202204,3719,1923,1796,2331892.46,2177965.49,4509857.95
260630,202204,81,73,8,88476,9696,98172
260640,202204,3372,1949,1423,2365826.08,1727100,4092926.08
260650,202204,316,227,89,275124,107868,382992
260660,202204,578,367,211,444804.2,255732.1,700536.3
260670,202204,103,74,29,89688,35148,124836
260680,202204,3975,2170,1805,2630044.91,2188875.49,4818920.40
260690,202204,124,93,31,112716.54,37572,150288.54
260700,202204,304,204,100,247248,121200,368448
260710,202204,47,38,9,46056,10908,56964
260720,202204,2668,1566,1102,1899206.6,1338048,3237254.6
260730,202204,736,541,195,656904,236340,893244
260740,202204,76,62,14,75144,16968,92112
260750,202204,571,416,155,504192,187860,692052
260760,202204,694,337,357,409658.62,432684.3,842342.92
260765,202204,977,501,476,607212.3,576912.9,1184125.2
260770,202204,219,159,60,192687,72720,265407
260775,202204,779,416,363,504193.4,441168,945361.4
260780,202204,232,143,89,173316,107868,281184
260790,202204,15087,7412,7675,8988200.37,9309376.71,18297577.08
260795,202204,157,103,54,124836,65448,190284
260800,202204,287,233,54,282396,65448.08,347844.08
260805,202204,171,111,60,134532,72720,207252
260810,202204,808,660,148,801132,179376,980508
260820,202204,297,191,106,231492.96,128472,359964.96
260825,202204,209,138,71,167256,86052,253308
260830,202204,297,184,113,224220,136956,361176
260840,202204,264,189,75,229068,90900,319968
260845,202204,175,112,63,135744,76356,212100
260850,202204,409,306,103,370872.1,127260,498132.1
260860,202204,252,186,66,226644,79992,306636
260870,202204,346,265,81,321180,99384,420564
260875,202204,739,538,201,652056.88,243612,895668.88
260880,202204,1552,1028,524,1245938.06,637512.2,1883450.26
260890,202204,2373,1632,741,1979196.2,899304.4,2878500.6
260900,202204,999,720,279,872640.3,338148.6,1210788.9
260910,202204,243,190,53,230280,64236,294516
260915,202204,279,208,71,252096,86052,338148
260920,202204,201,104,97,126048,117564,243612
260930,202204,358,300,58,363600,70296,433896
260940,202204,2572,1368,1204,1659229.44,1459248.47,3118477.91
260950,202204,1977,1117,860,1353807.56,1043532.6,2397340.16
260960,202204,13556,6588,6968,7988307.53,8453709.42,16442016.95
260970,202204,419,342,77,415716.6,93324,509040.6
260980,202204,204,184,20,223008.2,24240,247248.2
260990,202204,2651,2118,533,2567018.85,645996.1,3213014.95
261000,202204,4216,2582,1634,3130599.18,1981621.24,5112220.42
261010,202204,161,109,52,132108,63024,195132
261020,202204,583,435,148,527220.8,179376,706596.8
261030,202204,251,180,71,218160,86052,304212
261040,202204,375,317,58,384204,70296,454500
261050,202204,503,426,77,516312.2,93324,609636.2
261060,202204,1450,889,561,1077468.1,679932.6,1757400.7
261070,202204,9251,4397,4854,5331602.14,5889117.83,11220719.97
261080,202204,365,278,87,336936.95,105444,442380.95
261090,202204,2100,1605,495,1947686.26,599940,2547626.26
261100,202204,1212,843,369,1022929.44,447228,1470157.44
261110,202204,9054,5590,3464,6777513.06,4202006.39,10979519.45
261120,202204,234,201,33,243612.95,39996,283608.95
261130,202204,568,332,236,402385.57,286032.63,688418.20
261140,202204,212,134,78,163620,94536,258156
261150,202204,683,431,252,522372.03,306636,829008.03
261153,202204,69,65,4,78780,4848,83628
261160,202204,74641,36502,38139,44274124.52,46269346.14,90543470.66
261170,202204,463,344,119,416928.95,145440,562368.95
261180,202204,1762,1098,664,1332266.2,804768.2,2137034.4
261190,202204,566,394,172,477528.83,208464,685992.83
261200,202204,222,179,43,216948,52116,269064
261210,202204,40,32,8,38784,9696,48480
261220,202204,2734,1899,835,2301591.17,1018080.96,3319672.13
261230,202204,349,255,94,309060,113928.97,422988.97
261240,202204,439,379,60,460560.3,72720.2,533280.5
261245,202204,241,199,42,241188,50904,292092
261247,202204,165,124,41,150288,49692,199980
261250,202204,3501,1656,1845,2008285.83,2239776.6,4248062.43
261255,202204,244,217,27,263004,32724,295728
261260,202204,821,709,112,860520.57,135744.1,996264.67
261270,202204,198,140,58,169680.6,70296,239976.6
261280,202204,194,155,39,189072,47268,236340
261290,202204,106,76,30,92112,36360,128472
261300,202204,1340,984,356,1192609.35,431472.4,1624081.75
261310,202204,780,522,258,632664.9,312696,945360.9
261320,202204,557,380,177,462984.72,214524,677508.72
261330,202204,905,704,201,853250.87,243614.49,1096865.36
261340,202204,313,177,136,214524.1,164832,379356.1
261350,202204,876,612,264,741744.6,319968.5,1061713.1
261360,202204,1375,874,501,1059288,609636,1668924
261370,202204,4847,2830,2017,3431177.5,2444605.1,5875782.6
261380,202204,550,421,129,510252.79,156348.6,666601.39
261390,202204,3675,2487,1188,3015461.42,1441071.07,4456532.49
261400,202204,270,243,27,295728,32724,328452
261410,202204,1127,739,388,895668.54,470256,1365924.54
261420,202204,945,579,366,704172.93,443592.2,1147765.13
261430,202204,318,288,30,349056,36360,385416
261440,202204,101,97,4,117564,4848,122412
261450,202204,2506,1976,530,2394915.6,644784.56,3039700.16
261460,202204,766,598,168,724776.2,204828,929604.2
261470,202204,219,178,41,215736.4,49692,265428.4
261480,202204,462,353,109,427836.8,132053.46,559890.26
261485,202204,373,227,146,275125.2,176952,452077.2
261500,202204,605,402,203,487224.4,246036,733260.4
261510,202204,51,32,19,38784,23028,61812
261520,202204,89,73,16,88476,19392,107868
261530,202204,4032,2555,1477,3100299.11,1792549.58,4892848.69
261540,202204,1446,828,618,1003536.2,749016.6,1752552.8
261550,202204,247,116,131,140592,158772,299364
261560,202204,904,594,310,719929.64,376933.45,1096863.09
261570,202204,390,309,81,375720,98172,473892
261580,202204,391,309,82,374508,99384,473892
261590,202204,192,158,34,191496,41208,232704
261600,202204,299,235,64,284820,77568,362388
261610,202204,83,72,11,87264,13332,100596
261618,202204,69,52,17,63024,20604,83628
261620,202204,195,124,71,151500,86052,237552
261630,202204,664,523,141,635088,170892,805980
261640,202204,6481,3386,3095,4108683.36,3752353.75,7861037.11
261650,202204,464,301,163,364812,197556.6,562368.6
270010,202204,507,448,59,542976.4,71508,614484.4
270020,202204,242,199,43,241188.6,52116,293304.6
270030,202204,8705,5573,3132,6758930.75,3800782.08,10559712.83
270040,202204,2071,1351,720,1638624.2,872640.6,2511264.8
270050,202204,207,161,46,195132,55752,250884
270060,202204,73,50,23,60600,27876,88476
270070,202204,824,605,219,734472,265428,999900
270080,202204,38,32,6,38784,8484,47268
270090,202204,20,16,4,19392,4848,24240
270100,202204,1313,903,410,1094436.57,496920.76,1591357.33
270110,202204,70,59,11,71508,13332,84840
270120,202204,230,189,41,229068.32,49692,278760.32
270130,202204,322,235,87,284820,105444,390264
270135,202204,118,81,37,98172.4,44844,143016.4
270140,202204,1370,897,473,1087164.75,573276,1660440.75
270150,202204,243,186,57,225432,69084,294516
270160,202204,487,383,104,464196,126048,590244
270170,202204,794,522,272,632664.9,329664,962328.9
270180,202204,58,47,11,58176,13332,71508
270190,202204,112,94,18,113928,21816,135744
270200,202204,114,100,14,121200,16968,138168
270210,202204,540,331,209,402384,253308,655692
270220,202204,188,141,47,170892,56964,227856
270230,202204,2153,1350,803,1641050.16,975660.3,2616710.46
270235,202204,643,499,144,604788.2,174528,779316.2
270240,202204,2955,2343,612,2842143.21,742957,3585100.21
270250,202204,122,89,33,109080.8,39996,149076.8
270255,202204,209,178,31,215736,37572,253308
270260,202204,353,286,67,346632.2,81204,427836.2
270270,202204,91,47,44,58176,53328,111504
270280,202204,217,134,83,162408,100596,263004
270290,202204,1113,879,234,1065348.74,284820,1350168.74
270300,202204,367,270,97,328452,117564,446016
270310,202204,804,669,135,810828.2,163620,974448.2
270320,202204,773,664,109,807192.2,132108,939300.2
270330,202204,303,260,43,315120,53328,368448
270340,202204,63,52,11,63024,13332,76356
270350,202204,89,54,35,65448,42420,107868
270360,202204,70,40,30,48480,36360,84840
270370,202204,60,48,12,58176,14544,72720
270375,202204,76,47,29,56964,35148,92112
270380,202204,1057,713,344,864156,416928,1281084
270390,202204,145,82,63,99384,76356,175740
270400,202204,731,558,173,676296.74,209676.6,885973.34
270410,202204,613,453,160,549036.1,193920,742956.1
270420,202204,403,282,121,341784.2,146652,488436.2
270430,202204,34205,24550,9655,29783644.62,11710354.51,41493999.13
270440,202204,471,373,98,453288.5,118776,572064.5
270450,202204,837,494,343,599940.91,416928,1016868.91
270460,202204,176,142,34,172104.2,41208,213312.2
270470,202204,1563,1092,471,1323505.06,570852,1894357.06
270480,202204,533,432,101,523585.2,122412,645997.2
270490,202204,21,16,5,19392,6060,25452
270500,202204,468,394,74,477528,89688,567216
270510,202204,862,558,304,676296,369660,1045956
270520,202204,270,175,95,212100,115140,327240
270530,202204,60,51,9,61812,10908,72720
270540,202204,92,68,24,82416,29088,111504
270550,202204,1674,1294,380,1571964.2,460560,2032524.2
270560,202204,256,154,102,186648,123624,310272
270570,202204,555,394,161,478740,196344,675084
270580,202204,77,60,17,72720,20604,93324
270590,202204,59,46,13,55752,15756,71508
270600,202204,150,130,20,158772,24240,183012
270610,202204,238,190,48,230280,58176,288456
270620,202204,16,16,0,19392,,19392.0
270630,202204,3667,2781,886,3371786.3,1075044.2,4446830.5
270640,202204,855,641,214,778104.67,259368.35,1037473.02
270642,202204,211,177,34,214524,41208,255732
270644,202204,252,168,84,204828,101808,306636
270650,202204,339,205,134,248460.2,162408,410868.2
270660,202204,192,170,22,206040,26664,232704
270670,202204,2925,2235,690,2710035.8,836280,3546315.8
270680,202204,398,252,146,305424,176952,482376
270690,202204,1208,808,400,980511.06,486012,1466523.06
270700,202204,24,19,5,23028,6060,29088
270710,202204,850,676,174,821736,212100,1033836
270720,202204,223,177,46,215736.9,55752,271488.9
270730,202204,1877,1171,706,1420464.7,855672.36,2276137.06
270740,202204,35,24,11,29088,13332,42420
270750,202204,618,473,145,574488.4,175740.1,750228.5
270760,202204,293,211,82,255732.36,99384,355116.36
270770,202204,2784,1884,900,2283412.2,1090800.2,3374212.4
270780,202204,65,41,24,49692,29088,78780
270790,202204,231,149,82,180588,99384,279972
270800,202204,2043,1629,414,1976773.5,501768,2478541.5
270810,202204,220,183,37,221796,44844,266640
270820,202204,120,86,34,104232,41208,145440
270830,202204,817,621,196,755076,237552,992628
270840,202204,1327,1019,308,1236240.88,375720.56,1611961.44
270850,202204,1503,979,524,1186548.4,635088,1821636.4
270860,202204,2543,1720,823,2085853.67,997477.69,3083331.36
270870,202204,116,66,50,79992,60600,140592
270880,202204,849,675,174,818100.4,210888,1028988.4
270890,202204,270,205,65,248460,78780,327240
270895,202204,60,58,2,70296,2424,72720
270900,202204,64,54,10,65448,12120,77568
270910,202204,302,249,53,301788.1,64236,366024.1
270915,202204,1920,1266,654,1534392.4,792648.36,2327040.76
270920,202204,417,347,70,421776,84840,506616
270930,202204,5689,4361,1328,5289171.22,1610748.64,6899919.86
270940,202204,2190,1734,456,2102820.8,553884,2656704.8
280010,202204,37,31,6,37572,7272,44844
280020,202204,494,424,70,515100.72,84840,599940.72
280030,202204,21196,13781,7415,16707486.5,8999120.29,25706606.79
280040,202204,321,206,115,249672.2,139380,389052.2
280050,202204,411,316,95,382992,115140,498132
280060,202204,364,238,126,288456.8,152712,441168.8
280067,202204,1123,808,315,979296,381780,1361076
280070,202204,128,106,22,129684,26664,156348
280100,202204,657,506,151,613272,183012.4,796284.4
280110,202204,77,70,7,84840,8484,93324
280120,202204,666,556,110,673872,133320,807192
280130,202204,1738,1140,598,1382892,725988.2,2108880.2
280140,202204,494,415,79,502980.6,95748,598728.6
280150,202204,420,296,124,359964.2,150288,510252.2
280160,202204,136,108,28,130896,33936,164832
280170,202204,420,293,127,356328,153924,510252
280190,202204,28,23,5,27876,6060,33936
280200,202204,37,29,8,35148,9696,44844
280210,202204,2954,2125,829,2577833.66,1007173.14,3585006.80
280220,202204,49,40,9,48480,10908,59388
280230,202204,332,267,65,324816.2,78780,403596.2
280240,202204,130,121,9,146652,10908,157560
280250,202204,19,11,8,13332,9696,23028
280260,202204,78,71,7,86052,8484,94536
280270,202204,138,106,32,128472,38784,167256
280280,202204,187,123,64,149076.9,77568,226644.9
280290,202204,3546,2570,976,3118401.45,1182912.46,4301313.91
280300,202204,1601,1281,320,1552575.04,387840,1940415.04
280310,202204,93,89,4,107868.4,4848,112716.4
280320,202204,647,454,193,550248.2,233916,784164.2
280330,202204,308,229,79,278760.2,95748,374508.2
280340,202204,424,355,69,431472.3,83628,515100.3
280350,202204,3738,2861,877,3468752.01,1064138.41,4532890.42
280360,202204,464,312,152,378144,184224,562368
280370,202204,91,80,11,96960.04,13332,110292.04
280380,202204,50,39,11,47268,13332,60600
280390,202204,176,150,26,181800,31512,213312
280400,202204,384,261,123,316332.8,149076,465408.8
280410,202204,292,242,50,293304.4,60600,353904.4
280420,202204,133,114,19,138168.8,23028,161196.8
280430,202204,89,71,18,86052,21816,107868
280440,202204,720,589,131,713870.12,158772,872642.12
280445,202204,118,111,7,134532,8484,143016
280450,202204,1260,1082,178,1312596.2,215736.2,1528332.4
280460,202204,654,477,177,578125.11,215736,793861.11
280470,202204,101,92,9,111504,10908,122412
280480,202204,2986,2044,942,2477336.18,1141706.45,3619042.63
280490,202204,201,190,11,230280.68,13332,243612.68
280500,202204,42,39,3,47268,3636,50904
280510,202204,134,108,26,130896,31512.6,162408.6
280520,202204,53,39,14,47268,16968,64236
280530,202204,69,48,21,58176,25452,83628
280540,202204,543,465,78,563580.48,94536,658116.48
280550,202204,725,669,56,810830.03,67872,878702.03
280560,202204,478,428,50,518736.64,60600,579336.64
280570,202204,2324,1837,487,2226446.7,592668,2819114.7
280580,202204,580,455,125,551461.4,152712,704173.4
280590,202204,217,139,78,168468.8,94536.2,263005.0
280600,202204,393,324,69,393958.08,83628,477586.08
280610,202204,110,79,31,95748,37572,133320
280620,202204,550,446,104,540552.16,126048,666600.16
280630,202204,148,121,27,147864.67,32724,180588.67
280640,202204,182,147,35,178164,42420,220584
280650,202204,85,52,33,63024,39996,103020
280660,202204,130,98,32,118776.1,38784,157560.1
280670,202204,1985,1258,727,1524700.29,881126.46,2405826.75
280680,202204,240,207,33,250884,39996,290880
280690,202204,78,68,10,82416,12120,94536
280700,202204,19,19,0,23028,,23028.0
280710,202204,1491,1165,326,1411984.45,396324,1808308.45
280720,202204,125,85,40,103020,48480,151500
280730,202204,29,24,5,29088,6060,35148
280740,202204,2535,1900,635,2304013.78,770832,3074845.78
280750,202204,224,195,29,236340,35148,271488
280760,202204,875,595,280,721140.64,339360,1060500.64
290010,202204,197,139,58,168468,70296,238764
290020,202204,187,169,18,204828,21816,226644
290030,202204,614,394,220,478740,266640,745380
290035,202204,130,106,24,128472,29088,157560
290040,202204,297,204,93,247248,112716,359964
290050,202204,87,71,16,87264,19392,106656
290060,202204,252,110,142,133320,172104,305424
290070,202204,5728,2729,2999,3311188.53,3638427.1,6949615.63
290080,202204,445,190,255,230280,309060,539340
290090,202204,356,163,193,197556,233916.2,431472.2
290100,202204,1692,1071,621,1299265.6,753864.6,2053130.2
290110,202204,844,487,357,592668.4,433896,1026564.4
290115,202204,189,171,18,207252.2,21816,229068.2
290120,202204,785,529,256,641148,310272,951420
290130,202204,441,273,168,330876,204828,535704
290135,202204,293,224,69,271488,83628,355116
290140,202204,311,257,54,311484,65448,376932
290150,202204,134,93,41,112716,49692,162408
290160,202204,238,182,56,220584.48,67872,288456.48
290170,202204,104,74,30,89688,36360,126048
290180,202204,188,138,50,167256.32,60600,227856.32
290190,202204,360,283,77,342996.1,93324,436320.1
290195,202204,300,192,108,232704,130896,363600
290200,202204,262,216,46,261792,55752,317544
290205,202204,144,89,55,107868.6,66660,174528.6
290210,202204,1196,876,320,1061713.38,387840.1,1449553.48
290220,202204,178,101,77,122412,93324,215736
290225,202204,295,118,177,144228,214524,358752
290230,202204,78,48,30,58176,36360,94536
290240,202204,359,123,236,149076,286032,435108
290250,202204,243,226,17,273912,20604,294516
290260,202204,328,261,67,316332.6,81204,397536.6
290265,202204,183,160,23,193920,27876,221796
290270,202204,1371,1136,235,1378046.14,284820.6,1662866.74
290280,202204,472,334,138,407232.2,167256,574488.2
290290,202204,1358,815,543,987781.74,658116.6,1645898.34
290300,202204,396,338,58,409656.8,70296,479952.8
290310,202204,282,134,148,162408,180588,342996
290320,202204,4162,2541,1621,3082120.92,1967080.39,5049201.31
290323,202204,199,174,25,210888,30300,241188
290327,202204,154,118,36,143016,43632,186648
290330,202204,122,57,65,69084,78780,147864
290340,202204,773,323,450,391476.2,545400,936876.2
290350,202204,659,401,258,487225.15,312696,799921.15
290360,202204,321,249,72,301789.61,87264.52,389054.13
290370,202204,897,400,497,484801.4,603576.1,1088377.5
290380,202204,333,213,120,258156,145440,403596
290390,202204,2383,1488,895,1804669.6,1084740.4,2889410.0
290395,202204,234,135,99,163620,119988,283608
290400,202204,280,202,78,244824,94536,339360
290405,202204,239,204,35,249672,42420,292092
290410,202204,624,520,104,630240,126048,756288
290420,202204,271,216,55,261792.2,66660,328452.2
290430,202204,472,301,171,366024,207252,573276
290440,202204,81,71,10,86052,12120,98172
290450,202204,192,141,51,170892,61812,232704
290460,202204,1919,1146,773,1390165.41,936876,2327041.41
290470,202204,1354,593,761,718717.46,922333.4,1641050.86
290475,202204,557,517,40,626604.37,48480,675084.37
290480,202204,273,158,115,191496,139380,330876
290485,202204,238,217,21,263004,25452,288456
290490,202204,1246,881,365,1068984.1,442380,1511364.1
290500,202204,755,399,356,483588,432684,916272
290510,202204,196,158,38,191496,46056,237552
290515,202204,171,104,67,126048,81204,207252
290520,202204,1378,898,480,1089588.6,582972.38,1672560.98
290530,202204,280,255,25,309060.36,30300,339360.36
290540,202204,108,56,52,67872,63024,130896
290550,202204,158,132,26,159984,31512,191496
290560,202204,3196,1413,1783,1713768.8,2168268.4,3882037.2
290570,202204,6392,3044,3348,3691755.32,4057780.38,7749535.70
290580,202204,1255,754,501,915060,607212,1522272
290590,202204,558,447,111,542976,134532.2,677508.2
290600,202204,1752,1208,544,1466523.57,659330.46,2125854.03
290610,202204,177,162,15,196344,18180,214524
290620,202204,366,331,35,401172,42420,443592
290630,202204,1955,843,1112,1022928.8,1347744.9,2370673.7
290640,202204,139,110,29,134532.2,35148,169680.2
290650,202204,1826,842,984,1020505.66,1192608.1,2213113.76
290660,202204,260,216,44,261792,53328,315120
290670,202204,983,499,484,604789,587820,1192609
290680,202204,1235,988,247,1201092.2,299364,1500456.2
290682,202204,315,233,82,282396.36,99384,381780.36
290685,202204,243,151,92,183012,111504,294516
290687,202204,1126,729,397,884957,481164,1366121
290689,202204,147,77,70,94536,84840,179376
290690,202204,573,246,327,298152,396324,694476
290700,202204,243,124,119,150288,144228,294516
290710,202204,753,515,238,624181,288456,912637
290720,202204,1037,829,208,1004748.7,252096,1256844.7
290730,202204,1206,704,502,853248.6,608424.85,1461673.45
290740,202204,23,19,4,23028,4848,27876
290750,202204,1423,617,806,750229.45,976873.2,1727102.65
290755,202204,72,64,8,77568,9696,87264
290760,202204,256,226,30,275124,36360,311484
290770,202204,177,170,7,206040,8484,214524
290780,202204,1104,867,237,1052016.36,287244,1339260.36
290790,202204,369,250,119,303000,145440.2,448440.2
290800,202204,2420,976,1444,1182912.44,1750128,2933040.44
290810,202204,476,324,152,392688.6,184224,576912.6
290820,202204,402,234,168,284820.48,203616,488436.48
290830,202204,438,309,129,374508,156348,530856
290840,202204,1788,1118,670,1356231.27,812040.6,2168271.87
290850,202204,945,487,458,590244,555096.4,1145340.4
290860,202204,636,287,349,347844.4,422988,770832.4
290870,202204,608,427,181,519948.56,219372.96,739321.52
290880,202204,116,65,51,78780,61812,140592
290890,202204,434,262,172,317544,208464,526008
290900,202204,164,123,41,149076,49692,198768
290910,202204,386,295,91,357540,110292,467832
290920,202204,199,174,25,210888,30300,241188
290930,202204,517,395,122,478740.8,147864,626604.8
290940,202204,224,191,33,231492,39996,271488
290950,202204,160,92,68,111504,82416,193920
290960,202204,470,328,142,397536.1,172104,569640.1
290970,202204,238,210,28,254520,33936.6,288456.6
290980,202204,1797,1229,568,1490762.72,688416.2,2179178.92
290990,202204,396,333,63,403596.73,76356.79,479953.52
291000,202204,892,278,614,336936,744168,1081104
291005,202204,2472,1051,1421,1276237.09,1722252.9,2998489.99
291010,202204,165,146,19,176952,23028,199980
291020,202204,93,73,20,88476,24240,112716
291030,202204,95,69,26,83628,31512,115140
291040,202204,633,365,268,442380,324816,767196
291050,202204,1501,796,705,964753.92,854460,1819213.92
291060,202204,1641,912,729,1107768.2,883548,1991316.2
291070,202204,1924,1434,490,1740433.2,593882.23,2334315.43
291072,202204,7209,2725,4484,3306339.58,5444307.95,8750647.53
291075,202204,239,194,45,235128,54540,289668
291077,202204,59,41,18,49692,21816,71508
291080,202204,20742,8846,11896,10733488.47,14431297.22,25164785.69
291085,202204,265,219,46,265428.26,55752,321180.26
291090,202204,276,113,163,136956.6,197556,334512.6
291100,202204,993,333,660,404808,801132,1205940
291110,202204,438,336,102,407232.2,123624.2,530856.4
291120,202204,2405,1252,1153,1519848,1397436,2917284
291125,202204,61,30,31,36360,37572,73932
291130,202204,186,163,23,197556,27876,225432
291140,202204,125,100,25,121200,30300.6,151500.6
291150,202204,374,140,234,169680,283608,453288
291160,202204,393,309,84,374508.1,101808,476316.1
291165,202204,47,36,11,43632,13332,56964
291170,202204,3233,1597,1636,1936781.15,1984044.6,3920825.75
291180,202204,1227,498,729,604788,884760,1489548
291185,202204,112,103,9,124836,10908,135744
291190,202204,1385,661,724,801132.54,877488,1678620.54
291200,202204,168,124,44,150288,53328,203616
291210,202204,2395,966,1429,1172005.52,1733161.2,2905166.72
291220,202204,291,224,67,271488,81204,352692
291230,202204,964,338,626,409656.6,759924,1169580.6
291240,202204,406,380,26,460560.6,31512,492072.6
291250,202204,419,338,81,409656,98172,507828
291260,202204,62,54,8,65448,9696,75144
291270,202204,1032,445,587,540552.9,712656.2,1253209.1
291280,202204,357,167,190,202404,230280,432684
291290,202204,1656,871,785,1056866.07,952632.6,2009498.67
291300,202204,232,183,49,221796,59388,281184
291310,202204,224,197,27,238764.2,32724,271488.2
291320,202204,1314,918,396,1112616,479952,1592568
291330,202204,142,121,21,146652,25452,172104
291340,202204,222,133,89,161196.87,107868,269064.87
291345,202204,119,82,37,99384,44844,144228
291350,202204,1753,652,1101,791436.2,1334412.8,2125849.0
291360,202204,8354,3990,4364,4839521.25,5295235.24,10134756.49
291370,202204,1110,655,455,793861.87,551460.2,1345322.07
291380,202204,250,198,52,239976,63024,303000
291390,202204,4004,1783,2221,2160997.84,2693064.2,4854062.04
291400,202204,2079,1450,629,1758614.39,762349.54,2520963.93
291410,202204,202,174,28,210888.6,33936,244824.6
291420,202204,114,86,28,104232,33936,138168
291430,202204,178,108,70,130896,84840.34,215736.34
291440,202204,521,422,99,512676,119988,632664
291450,202204,922,605,317,734472.7,385416.1,1119888.8
291460,202204,1943,1543,400,1871331.04,486013.8,2357344.84
291465,202204,2247,1072,1175,1299264.8,1427737,2727001.8
291470,202204,2887,1457,1430,1767097.12,1734373.5,3501470.62
291480,202204,11912,5146,6766,6238176.45,8206456.21,14444632.66
291490,202204,651,264,387,319968,469044,789012
291500,202204,362,215,147,260580,178164,438744
291510,202204,1190,458,732,555096.1,887184,1442280.1
291520,202204,927,414,513,501768.2,621756,1123524.2
291530,202204,926,263,663,318756,805980,1124736
291535,202204,120,99,21,119988,25452,145440
291540,202204,353,116,237,141804,287244,429048
291550,202204,1279,605,674,733261,816888,1550149
291560,202204,5127,2580,2547,3129385.21,3088176.6,6217561.81
291570,202204,221,110,111,133320,134532,267852
291580,202204,1194,739,455,896881.38,551460,1448341.38
291590,202204,96,42,54,50904,65448,116352
291600,202204,1112,555,557,672660,675084,1347744
291610,202204,1386,674,712,818102.28,862944,1681046.28
291620,202204,557,263,294,318756,356328,675084
291630,202204,480,150,330,183012,399960,582972
291640,202204,4001,1989,2012,2411885.96,2439760.24,4851646.20
291650,202204,437,298,139,361177.1,168468,529645.1
291660,202204,372,151,221,183012.88,269064,452076.88
291670,202204,173,108,65,130896,78780,209676
291680,202204,635,390,245,473892.49,296940.2,770832.69
291685,202204,576,331,245,401173,296940,698113
291690,202204,457,297,160,359964,195132,555096
291700,202204,1025,793,232,963540.4,283608,1247148.4
291710,202204,1569,773,796,936876,964752.6,1901628.6
291720,202204,425,288,137,350268,166044,516312
291730,202204,918,532,386,644784.2,467832.2,1112616.4
291733,202204,293,197,96,238764,116352,355116
291735,202204,83,62,21,75144,25452,100596
291740,202204,337,253,84,306636,101808,408444
291750,202204,2280,1477,803,1791341.87,975661.79,2767003.66
291760,202204,3033,1658,1375,2011920.2,1667712,3679632.2
291770,202204,725,492,233,596305.88,282396,878701.88
291780,202204,76,47,29,56964,35148,92112
291790,202204,157,82,75,99384,90900,190284
291800,202204,10264,4321,5943,5239482.43,7212614.31,12452096.74
291810,202204,1052,790,262,957480.8,317544.5,1275025.3
291820,202204,285,202,83,244824,100596,345420
291830,202204,1030,423,607,512676.76,736896,1249572.76
291835,202204,554,513,41,621756,49692,671448
291840,202204,5052,2534,2518,3073637.01,3054244.21,6127881.22
291845,202204,271,84,187,101808,226644,328452
291850,202204,313,277,36,335724.3,43632,379356.3
291855,202204,264,112,152,135744,184224,319968
291860,202204,164,106,58,128472,70296.9,198768.9
291870,202204,82,37,45,44844,54540,99384
291875,202204,159,149,10,180588,12120,192708
291880,202204,434,358,76,433896,92112,526008
291890,202204,245,87,158,105444,191496.6,296940.6
291900,202204,55,33,22,39996,26664,66660
291905,202204,115,88,27,106656.4,32724,139380.4
291910,202204,158,126,32,152712,38784,191496
291915,202204,439,391,48,475104,58176,533280
291920,202204,5366,2621,2745,3179085.1,3328155.95,6507241.05
291930,202204,167,101,66,123624.26,79992,203616.26
291940,202204,372,215,157,260580,190284,450864
291950,202204,1137,902,235,1095648.6,284820,1380468.6
291955,202204,1358,819,539,996264.3,653268,1649532.3
291960,202204,194,146,48,176952.2,58176,235128.2
291970,202204,762,565,197,684780,238764,923544
291980,202204,1438,1258,180,1524697.88,220584.6,1745282.48
291990,202204,138,127,11,153924,13332,167256
291992,202204,178,86,92,104232,111504.48,215736.48
291995,202204,183,115,68,139380.2,82416,221796.2
292000,202204,407,299,108,362388.6,130896,493284.6
292010,202204,325,223,102,270276,123624,393900
292020,202204,290,213,77,258156,94536,352692
292030,202204,147,113,34,136956,41208,178164
292040,202204,584,306,278,370872,336936,707808
292045,202204,117,105,12,127260,14544,141804
292050,202204,930,676,254,819312,307849,1127161
292060,202204,891,723,168,876278.92,204828.51,1081107.43
292070,202204,63,25,38,30300,46056,76356
292080,202204,152,106,46,128472,55752,184224
292090,202204,539,191,348,231492.2,421776,653268.2
292100,202204,1498,644,854,786588.8,1038684.18,1825272.98
292105,202204,169,151,18,184224,21816,206040
292110,202204,2261,833,1428,1010808,1738008.2,2748816.2
292120,202204,690,529,161,641148.4,195132,836280.4
292130,202204,467,262,205,317544.6,248460,566004.6
292140,202204,212,170,42,206040,50904,256944
292145,202204,163,85,78,103020,94536,197556
292150,202204,1490,1232,258,1494397.93,315120,1809517.93
292160,202204,162,127,35,153924.2,42420.2,196344.4
292170,202204,1177,1006,171,1219272.9,207252,1426524.9
292180,202204,220,162,58,196344,70296,266640
292190,202204,150,96,54,116352,65448,181800
292200,202204,1415,517,898,626604.27,1089589.4,1716193.67
292205,202204,115,97,18,117564,21816,139380
292210,202204,389,263,126,318756,152712.2,471468.2
292220,202204,34,22,12,26664,14544,41208
292225,202204,45,37,8,44844,9696.6,54540.6
292230,202204,993,753,240,912636.43,292092,1204728.43
292240,202204,626,455,171,551461.1,207252,758713.1
292250,202204,1645,1069,576,1296841.4,698112,1994953.4
292260,202204,404,246,158,298152,191496,489648
292265,202204,245,182,63,220584.2,76356,296940.2
292270,202204,720,351,369,425412,449652,875064
292273,202204,207,121,86,146652,104232,250884
292275,202204,170,88,82,106656,99384,206040
292280,202204,147,102,45,123624,54540,178164
292285,202204,87,69,18,83628,21816,105444
292290,202204,578,388,190,470256.2,231492.2,701748.4
292300,202204,1771,680,1091,824160.2,1325928.47,2150088.67
292303,202204,128,84,44,101808,53328,155136
292305,202204,117,85,32,104232,38784,143016
292310,202204,967,629,338,763561,409656.64,1173217.64
292320,202204,583,433,150,524796,181800,706596
292330,202204,176,108,68,132108,82416,214524
292335,202204,296,237,59,287244,71508,358752
292340,202204,551,383,168,464196,203616,667812
292350,202204,266,144,122,174528,147864,322392
292360,202204,715,539,176,653268.84,213312,866580.84
292370,202204,720,549,171,665388,208464,873852
292380,202204,615,507,108,614484.86,130896,745380.86
292390,202204,391,155,236,187860,286032,473892
292400,202204,3604,2228,1376,2700345.01,1668925.56,4369270.57
292405,202204,273,184,89,223008,107868,330876
292410,202204,115,69,46,83628,55752,139380
292420,202204,283,243,40,294516,48480,342996
292430,202204,540,393,147,476316,178164,654480
292440,202204,627,522,105,633876.92,128472,762348.92
292450,202204,231,176,55,213312,66660,279972
292460,202204,517,383,134,464197.12,162408,626605.12
292465,202204,203,173,30,212100,37572,249672
292467,202204,152,100,52,121200,63024,184224
292470,202204,309,210,99,254520.2,119988,374508.2
292480,202204,390,265,125,321180,151500.6,472680.6
292490,202204,238,175,63,213312,76356.2,289668.2
292500,202204,873,396,477,481165.09,578124.2,1059289.29
292510,202204,3582,1701,1881,2061614.44,2279773.3,4341387.74
292520,202204,1119,523,596,633876.1,722352.1,1356228.2
292525,202204,418,304,114,368448.8,138168,506616.8
292530,202204,4775,1916,2859,2323406.19,3471169.6,5794575.79
292540,202204,481,276,205,334512,248460,582972
292550,202204,1122,610,512,740532.1,622968,1363500.1
292560,202204,326,298,28,361176.3,33936,395112.3
292570,202204,320,250,70,303000.2,84840,387840.2
292575,202204,545,388,157,470256.2,190284,660540.2
292580,202204,1001,673,328,815676.2,397536.6,1213212.8
292590,202204,553,492,61,596304,73932,670236
292593,202204,145,114,31,138168,37572,175740
292595,202204,198,156,42,189072,50904,239976
292600,202204,1238,890,348,1078680.95,421776.2,1500457.15
292610,202204,117,94,23,113928,27876.2,141804.2
292620,202204,517,436,81,528432.9,98172.5,626605.4
292630,202204,1508,828,680,1004748.6,824160,1828908.6
292640,202204,873,602,271,729624.2,328452,1058076.2
292650,202204,182,143,39,173316.78,47268,220584.78
292660,202204,1923,1357,566,1645898.19,685992.56,2331890.75
292665,202204,139,98,41,118776,49692,168468
292670,202204,387,302,85,366024,103020,469044
292680,202204,263,194,69,235128,84840,319968
292690,202204,202,142,60,172104.6,73932,246036.6
292700,202204,998,653,345,792648.6,418140.33,1210788.93
292710,202204,112,99,13,119988,15756,135744
292720,202204,965,554,411,671448.6,498132,1169580.6
292730,202204,198,94,104,113928,126048,239976
292740,202204,72062,34648,37414,42027382.58,45395500.59,87422883.17
292750,202204,380,277,103,335724.52,124836,460560.52
292760,202204,336,280,56,339360,67872,407232
292770,202204,861,370,491,448440,595092,1043532
292780,202204,19,10,9,12120,10908,23028
292790,202204,785,413,372,501768.4,452076,953844.4
292800,202204,1258,752,506,911424.6,614484,1525908.6
292805,202204,384,132,252,159984,305424,465408
292810,202204,1800,1069,731,1296842.64,888396,2185238.64
292820,202204,696,590,106,715081.45,128472.1,843553.55
292830,202204,128,101,27,122412,32724,155136
292840,202204,686,561,125,681145.46,151500,832645.46
292850,202204,138,91,47,110292,56964,167256
292860,202204,2081,1191,890,1444706.1,1079893.5,2524599.6
292870,202204,3652,2388,1264,2895471.42,1531969.51,4427440.93
292880,202204,1416,935,481,1133220.08,582972.9,1716192.98
292890,202204,525,437,88,530856.2,106656.2,637512.4
292895,202204,147,99,48,119988,58176,178164
292900,202204,343,246,97,298152.4,117564.1,415716.5
292905,202204,483,230,253,278760.7,306636,585396.7
292910,202204,478,354,124,429048.4,150288,579336.4
292920,202204,519,220,299,266640,362388,629028
292925,202204,476,437,39,529644.2,48480,578124.2
292930,202204,668,403,265,488436.2,322392,810828.2
292935,202204,271,116,155,140592.15,187860,328452.15
292937,202204,221,153,68,185436,82416,267852
292940,202204,186,141,45,170892,54540,225432
292950,202204,1235,597,638,723566.3,775680.7,1499247.0
292960,202204,512,364,148,442380,179376.32,621756.32
292970,202204,233,171,62,208465.16,75144,283609.16
292975,202204,89,52,37,63024,44844.4,107868.4
292980,202204,323,222,101,269064.1,122412,391476.1
292990,202204,1321,979,342,1186548.2,414504.2,1601052.4
293000,202204,111,79,32,95748,38784,134532
293010,202204,2937,1736,1201,2104036.08,1455613.86,3559649.94
293015,202204,607,497,110,602364,134532,736896
293020,202204,320,257,63,312696.3,76356.4,389052.7
293030,202204,574,507,67,614484.4,82416,696900.4
293040,202204,370,296,74,358752,89688,448440
293050,202204,2921,1718,1203,2085854.54,1458038.56,3543893.10
293060,202204,245,193,52,233916.96,63024,296940.96
293070,202204,3675,1861,1814,2256748.71,2203417.44,4460166.15
293075,202204,94,64,30,77568,36360,113928
293076,202204,76,56,20,67872,24240,92112
293077,202204,578,331,247,401173.64,300576,701749.64
293080,202204,426,380,46,460561.56,55752,516313.56
293090,202204,129,115,14,139380,16968,156348
293100,202204,513,350,163,425412.95,197556,622968.95
293105,202204,347,251,96,304212,116352,420564
293110,202204,120,80,40,96960,48480,145440
293120,202204,304,211,93,255733,112716,368449
293130,202204,244,163,81,197556.76,98172,295728.76
293135,202204,8296,3264,5032,3957189.37,6106061.05,10063250.42
293140,202204,187,113,74,136956.4,89688,226644.4
293150,202204,299,262,37,317544.2,44844,362388.2
293160,202204,424,261,163,316332.2,197556,513888.2
293170,202204,205,128,77,155136.9,94536,249672.9
293180,202204,576,390,186,472681.03,225432,698113.03
293190,202204,1362,941,421,1141706.77,510252.8,1651959.57
293200,202204,542,478,64,579336.95,77568.2,656905.15
293210,202204,425,325,100,393900.2,121200,515100.2
293220,202204,2377,1034,1343,1253208.95,1628928.2,2882137.15
293230,202204,1831,687,1144,832644.25,1388952,2221596.25
293240,202204,228,210,18,254520,21816,276336
293245,202204,127,104,23,126048.56,27876,153924.56
293250,202204,771,317,454,384205.43,550248,934453.43
293260,202204,305,250,55,303000,66660,369660
293270,202204,1174,534,640,647208.4,775680,1422888.4
293280,202204,301,181,120,219372,146652,366024
293290,202204,3024,1966,1058,2382793,1284720,3667513
293300,202204,793,559,234,677509.51,283608,961117.51
293305,202204,191,148,43,179376,52116,231492
293310,202204,166,123,43,149076,52116,201192
293315,202204,163,125,38,151500,46056,197556
293317,202204,89,66,23,79992,27876,107868
293320,202204,1094,586,508,710233.7,616909.5,1327143.2
293325,202204,203,75,128,90900,155136,246036
293330,202204,14228,6487,7741,7865888.43,9388159.11,17254047.54
293340,202204,288,205,83,248460,100596,349056
293345,202204,260,211,49,255732.1,59388,315120.1
293350,202204,588,362,226,438744,273912,712656
293360,202204,1497,1068,429,1294417,519948,1814365
310010,202204,145,75,70,90900,84840,175740
310020,202204,1003,546,457,662964.33,553884,1216848.33
310030,202204,306,244,62,295728.2,75144,370872.2
310040,202204,46,30,16,36360,19392,55752
310050,202204,155,98,57,119988,69084,189072
310060,202204,265,182,83,220584.1,100596,321180.1
310070,202204,14,8,6,9696,7272,16968
310080,202204,47,32,15,38784,18180,56964
310090,202204,1047,568,479,688418.73,581760.6,1270179.33
310100,202204,322,231,91,279972,110292,390264
310110,202204,679,360,319,439956,386628,826584
310120,202204,379,222,157,269064,190284,459348
310130,202204,29,17,12,20604,15756,36360
310140,202204,23,8,15,9696,18180,27876
310150,202204,1150,773,377,936878.1,456925.2,1393803.3
310160,202204,2039,1009,1030,1222911.22,1249572.6,2472483.82
310163,202204,92,51,41,61812.37,49692,111504.37
310170,202204,2482,1137,1345,1378044.87,1632568.41,3010613.28
310180,202204,164,67,97,81204,118776,199980
310190,202204,476,318,158,386628.8,191496,578124.8
310200,202204,439,279,160,338148,195132,533280
310205,202204,67,45,22,54540,26664,81204
310210,202204,267,220,47,267852,56964,324816
310220,202204,61,36,25,43632,30300,73932
310230,202204,269,193,76,233916,93324,327240
310240,202204,110,93,17,112716,20604,133320
310250,202204,97,76,21,92112.76,25452,117564.76
310260,202204,707,371,336,449652.56,407232.2,856884.76
310270,202204,267,174,93,212100.36,112716,324816.36
310280,202204,380,272,108,329664,130896,460560
310285,202204,198,150,48,181800,58176,239976
310290,202204,226,125,101,151500,123624,275124
310300,202204,166,132,34,159984,41208,201192
310310,202204,11,8,3,9696,3636,13332
310320,202204,28,9,19,10908,23028,33936
310330,202204,39,27,12,32724,14544,47268
310340,202204,1727,1199,528,1454401.97,643572,2097973.97
310350,202204,2739,1443,1296,1751346.39,1570752.3,3322098.69
310360,202204,47,39,8,47268,9696,56964
310370,202204,125,106,19,128472,23028,151500
310375,202204,109,41,68,49692,82416,132108
310380,202204,52,31,21,37572,25452,63024
310390,202204,106,68,38,82416,46056,128472
310400,202204,2399,1547,852,1874967.94,1033836,2908803.94
310410,202204,115,66,49,79992.2,59388,139380.2
310420,202204,655,335,320,406020.24,387841.4,793861.64
310430,202204,277,173,104,209676,127260,336936
310440,202204,72,42,30,50904,37572,88476
310445,202204,79,67,12,81204,14544,95748
310450,202204,640,419,221,507828.99,267852,775680.99
310460,202204,246,172,74,208464,89688,298152
310470,202204,515,333,182,403596,220584,624180
310480,202204,91,56,35,67872,42420,110292
310490,202204,540,252,288,306636,349056,655692
310500,202204,125,49,76,59388,92112,151500
310510,202204,599,422,177,512676.21,214524,727200.21
310520,202204,138,98,40,118776,48480,167256
310530,202204,106,40,66,48480,79992,128472
310540,202204,476,270,206,327240.5,249672,576912.5
310550,202204,69,47,22,56964,26664,83628
310560,202204,3059,2087,972,2530661.3,1180488,3711149.3
310570,202204,103,63,40,76356,48480,124836
310590,202204,373,231,142,279972.76,172104,452076.76
310600,202204,137,69,68,83628,82416,166044
310610,202204,53,22,31,26664,38784,65448
310620,202204,47726,22404,25322,27170578.49,30718174.07,57888752.56
310630,202204,697,415,282,504192.87,341784,845976.87
310640,202204,137,94,43,113928,52116,166044
310650,202204,147,130,17,158772,20604,179376
310660,202204,108,75,33,90900,39996,130896
310665,202204,65,46,19,55752,23028,78780
310670,202204,7018,2982,4036,3617829.81,4895268.4,8513098.21
310680,202204,67,40,27,48480,32724,81204
310690,202204,618,430,188,521160.4,229068,750228.4
310700,202204,60,38,22,46056,26664,72720
310710,202204,1262,851,411,1030545.62,499344.6,1529890.22
310720,202204,146,40,106,48480,128472,176952
310730,202204,1507,1027,480,1244725.63,581760.74,1826486.37
310740,202204,997,547,450,662965.2,545400.7,1208365.9
310750,202204,251,155,96,187860.04,116352,304212.04
310760,202204,66,52,14,63024,16968,79992
310770,202204,86,41,45,49692,54540,104232
310780,202204,350,286,64,346632.8,77568,424200.8
310790,202204,106,85,21,104232,25452,129684
310800,202204,468,218,250,265428,303000,568428
310810,202204,169,114,55,138168.72,66660,204828.72
310820,202204,316,253,63,306636.84,76356,382992.84
310825,202204,208,175,33,212100,39996,252096
310830,202204,448,213,235,258156.72,286032,544188.72
310840,202204,357,210,147,254520.2,178164.36,432684.56
310850,202204,75,62,13,75144,15756,90900
310855,202204,404,316,88,382992.3,106656,489648.3
310860,202204,1591,1170,421,1418043.41,510253,1928296.41
310870,202204,50,42,8,50904,9696,60600
310880,202204,84,69,15,83628,18180,101808
310890,202204,296,170,126,206040,152712,358752
310900,202204,618,273,345,330881.44,418149.36,749030.80
310910,202204,241,163,78,197558,94536,292094
310920,202204,432,252,180,305424.82,218160.2,523585.02
310925,202204,35,27,8,32724,9696,42420
310930,202204,1277,835,442,1013232.51,535704,1548936.51
310940,202204,677,342,335,414504.7,406020,820524.7
310945,202204,129,80,49,96960,59388,156348
310950,202204,218,175,43,212100.96,52116,264216.96
310960,202204,75,24,51,29088,61812,90900
310970,202204,161,96,65,116352,78780.6,195132.6
310980,202204,45,30,15,36360.29,18180,54540.29
310990,202204,165,87,78,105444.77,94536,199980.77
311000,202204,818,398,420,482377.09,509040,991417.09
311010,202204,46,38,8,46056,9696,55752
311020,202204,41,24,17,29088,20604,49692
311030,202204,385,218,167,264216,202404,466620
311040,202204,40,31,9,37572,10908,48480
311050,202204,487,184,303,224220,368448,592668
311060,202204,790,439,351,532068,425412,957480
311070,202204,324,143,181,173316,219372,392688
311080,202204,108,63,45,76356.1,54540,130896.1
311090,202204,334,160,174,196344,210888,407232
311100,202204,545,326,219,396324,265428,661752
311110,202204,707,506,201,613272.6,243612,856884.6
311115,202204,75,53,22,64236,27876,92112
311120,202204,1071,578,493,700536.6,598728,1299264.6
311130,202204,291,170,121,206040,146652,352692
311140,202204,159,83,76,100596,92112,192708
311150,202204,338,212,126,258156,153924.6,412080.6
311160,202204,744,528,216,641149.2,261792,902941.2
311170,202204,89,74,15,89688,18180,107868
311180,202204,305,205,100,248460.2,121200.6,369660.8
311190,202204,37,18,19,21816,23028,44844
311200,202204,339,231,108,279972,132108.2,412080.2
311205,202204,33,25,8,30300,9696,39996
311210,202204,35,30,5,36360.6,6060,42420.6
311220,202204,31,27,4,32724,4848,37572
311230,202204,1647,1079,568,1310175.51,689628,1999803.51
311240,202204,204,128,76,155136,92112,247248
311250,202204,61,24,37,29088,44844,73932
311260,202204,546,341,205,414504,248460,662964
311265,202204,125,83,42,101808,50904,152712
311270,202204,287,200,87,242400.1,105444,347844.1
311280,202204,195,84,111,101808,134532,236340
311290,202204,103,84,19,101808,23028,124836
311300,202204,578,366,212,444804.6,256944,701748.6
311310,202204,18,15,3,18180,3636,21816
311320,202204,624,462,162,561157.36,197556,758713.36
311330,202204,1118,820,298,993840.65,361176.2,1355016.85
311340,202204,2589,1826,763,2213116.15,925968,3139084.15
311350,202204,265,205,60,248460,72720,321180
311360,202204,177,103,74,124836,89688,214524
311370,202204,1220,504,716,612062,869004,1481066
311380,202204,7,6,1,7272,1212,8484
311390,202204,241,138,103,167256,124836,292092
311400,202204,138,86,52,104232,63024,167256
311410,202204,115,57,58,69084,70296,139380
311420,202204,312,161,151,195132.4,183012,378144.4
311430,202204,826,549,277,665388,335724,1001112
311440,202204,446,307,139,372085.77,169680,541765.77
311450,202204,303,179,124,216948,150288,367236
311455,202204,265,181,84,219372.78,101808,321180.78
311460,202204,129,57,72,69084,87264,156348
311470,202204,31,15,16,18180,19392,37572
311480,202204,49,24,25,29088,30300,59388
311490,202204,10,6,4,7272,4848,12120
311500,202204,30,14,16,16968,19392,36360
311510,202204,656,451,205,546655.05,249672,796327.05
311520,202204,39,33,6,39996,7272,47268
311530,202204,1766,1273,493,1542880.19,597516,2140396.19
311535,202204,64,43,21,52116,25452,77568
311540,202204,33,29,4,35148,4848,39996
311545,202204,161,115,46,139380.2,55752,195132.2
311547,202204,46,35,11,42420,13332,55752
311550,202204,652,290,362,351480,438744,790224
311560,202204,44,26,18,31512,21816,53328
311570,202204,286,191,95,231492,115140.2,346632.2
311580,202204,403,250,153,303000.6,185436,488436.6
311590,202204,28,24,4,29088,4848,33936
311600,202204,95,79,16,95748,19392,115140
311610,202204,244,209,35,253308,42420,295728
311615,202204,128,105,23,127260,27876,155136
311620,202204,27,15,12,19392,14544,33936
311630,202204,96,81,15,98172,18180,116352
311640,202204,136,64,72,77568.6,87264,164832.6
311650,202204,126,88,38,106656,46056,152712
311660,202204,417,195,222,236340,270276,506616
311670,202204,144,97,47,117564.8,56964,174528.8
311680,202204,208,158,50,191496,60600,252096
311690,202204,12,10,2,12120,2424,14544
311700,202204,190,139,51,169680,61812,231492
311710,202204,177,120,57,145440,70296,215736
311720,202204,38,28,10,33936.6,12120,46056.6
311730,202204,559,387,172,469044.3,213312,682356.3
311740,202204,26,18,8,21816,9696,31512
311750,202204,714,482,232,586608.9,283608,870216.9
311760,202204,77,33,44,39996,53328,93324
311770,202204,378,177,201,214524.6,244824,459348.6
311780,202204,190,95,95,115140,115140,230280
311783,202204,88,81,7,98172,8484,106656
311787,202204,38,14,24,16968,30300,47268
311790,202204,259,113,146,136956,176952,313908
311800,202204,706,436,270,528432,327240,855672
311810,202204,51,39,12,47268,14544,61812
311820,202204,117,91,26,110292,31512,141804
311830,202204,1893,1142,751,1384104.4,912636,2296740.4
311840,202204,1030,575,455,696901.2,551462.45,1248363.65
311850,202204,15,11,4,13332,4848,18180
311860,202204,9718,4124,5594,5001930.15,6787206.61,11789136.76
311870,202204,110,62,48,75144,58176,133320
311880,202204,952,689,263,837492.1,318757.05,1156249.15
311890,202204,198,93,105,112616,127260,239876
311900,202204,65,28,37,33936,44844,78780
311910,202204,1379,858,521,1041110.23,632665.2,1673775.43
311920,202204,218,146,72,176952,87264,264216
311930,202204,893,506,387,614484,470256,1084740
311940,202204,2588,1377,1211,1668929.02,1468944.19,3137873.21
311950,202204,186,112,74,135744.8,89688.6,225433.4
311960,202204,63,45,18,54540,21816,76356
311970,202204,22,12,10,14544,12120,26664
311980,202204,41,30,11,36360,13332,49692
311990,202204,36,26,10,31512,12120,43632
311995,202204,49,28,21,33936,25452,59388
312000,202204,22,14,8,16968,9696,26664
312010,202204,72,56,16,67872,19392,87264
312015,202204,78,61,17,73932,20604,94536
312020,202204,135,95,40,115140,48480,163620
312030,202204,69,52,17,63024,20604,83628
312040,202204,78,50,28,60600,33936,94536
312050,202204,195,110,85,133320.6,103020,236340.6
312060,202204,23,14,9,16968,10908,27876
312070,202204,78,51,27,61812,32724,94536
312080,202204,547,248,299,300576,362388.3,662964.3
312083,202204,61,38,23,46056,27876,73932
312087,202204,95,72,23,87264,27876,115140
312090,202204,3318,2016,1302,2443397.9,1578025.2,4021423.1
312100,202204,145,102,43,123345.24,52116,175461.24
312110,202204,116,72,44,87264,53328,140592
312120,202204,126,92,34,111504.95,41208,152712.95
312125,202204,86,54,32,65448.1,38784,104232.1
312130,202204,132,87,45,105444,54540,159984
312140,202204,141,109,32,133320.6,38784,172104.6
312150,202204,40,31,9,37572,10908,48480
312160,202204,1490,985,505,1193930.2,612060,1805990.2
312170,202204,11,8,3,9696,3636,13332
312180,202204,103,69,34,83628,41208,124836
312190,202204,37,33,4,39996,4848,44844
312200,202204,738,634,104,768409.88,126048,894457.88
312210,202204,119,62,57,75144,69084,144228
312220,202204,132,100,32,121200,38784,159984
312230,202204,3802,1719,2083,2087067.08,2524597.8,4611664.88
312235,202204,153,103,50,124836,60600,185436
312240,202204,77,54,23,65448,27876,93324
312245,202204,197,138,59,167256.2,71508,238764.2
312247,202204,81,60,21,73932,25452,99384
312250,202204,172,89,83,107868.6,101808,209676.6
312260,202204,99,67,32,81204,38784,119988
312270,202204,137,83,54,100596,65448,166044
312280,202204,32,16,16,19392,19392,38784
312290,202204,143,96,47,116352,56964,173316
312300,202204,199,131,68,158772,82416.1,241188.1
312310,202204,57,50,7,60600,8484,69084
312320,202204,408,253,155,306636,189072.8,495708.8
312330,202204,88,74,14,89688,16968,106656
312340,202204,35,17,18,20604,21816,42420
312350,202204,13,7,6,8484,7272,15756
312352,202204,98,70,28,84840,33936,118776
312360,202204,563,242,321,293304.2,389052,682356.2
312370,202204,335,185,150,224220,181800,406020
312380,202204,138,92,46,111504.2,56964,168468.2
312385,202204,157,130,27,157560.8,32724,190284.8
312390,202204,292,187,105,226644,127260.6,353904.6
312400,202204,374,279,95,338148,116353.79,454501.79
312410,202204,1141,390,751,472680.8,911425.2,1384106.0
312420,202204,652,488,164,591456.6,198768,790224.6
312430,202204,873,626,247,758712,299364,1058076
312440,202204,39,31,8,37572,9696,47268
312450,202204,190,122,68,147864,82416,230280
312460,202204,28,13,15,15756,18180,33936
312470,202204,48,32,16,38784,19392,58176
312480,202204,164,100,64,121200,77568,198768
312490,202204,296,203,93,246036,112716,358752
312500,202204,36,24,12,29088.86,14544,43632.86
312510,202204,578,214,364,259369,442380.3,701749.3
312520,202204,28,8,20,9696,24240,33936
312530,202204,35,24,11,29088,13332,42420
312540,202204,87,78,9,94536,10908,105444
312550,202204,35,28,7,33936,8484,42420
312560,202204,192,151,41,183012,49692,232704
312570,202204,447,266,181,322392.18,219372,541764.18
312580,202204,92,48,44,58176,53328,111504
312590,202204,228,182,46,221796,55752,277548
312595,202204,127,105,22,127260,26664,153924
312600,202204,69,31,38,37572.4,46056,83628.4
312610,202204,1541,788,753,955059.6,912636.7,1867696.3
312620,202204,222,159,63,193920,76356,270276
312630,202204,70,57,13,69084,15756,84840
312640,202204,39,10,29,12120,35148,47268
312650,202204,149,124,25,150697.74,30300,180997.74
312660,202204,103,74,29,89688.81,35148,124836.81
312670,202204,916,589,327,713868.73,398748,1112616.73
312675,202204,39,28,11,33936,13332,47268
312680,202204,69,43,26,52116,31512,83628
312690,202204,233,117,116,141804,140592,282396
312695,202204,27,23,4,27876,4848,32724
312700,202204,240,141,99,170892.2,119988,290880.2
312705,202204,82,65,17,78780,20604,99384
312707,202204,134,95,39,115140,47268,162408
312710,202204,1863,1033,830,1251998.26,1010808.64,2262806.90
312720,202204,49,24,25,29088,30300,59388
312730,202204,265,157,108,190284.9,130896.54,321181.44
312733,202204,47,36,11,44844,13332,58176
312735,202204,22,15,7,18180,8484,26664
312737,202204,71,39,32,47268,38784,86052
312738,202204,64,40,24,48480,29088,77568
312740,202204,80,54,26,65448,31512,96960
312750,202204,98,66,32,79992,38784,118776
312760,202204,279,193,86,233916,104232,338148
312770,202204,8585,4019,4566,4873462.87,5538841.7,10412304.57
312780,202204,438,333,105,403596,127260.6,530856.6
312790,202204,20,15,5,18180,6060,24240
312800,202204,1589,1104,485,1339261.2,589033.08,1928294.28
312810,202204,339,231,108,281184,130896,412080
312820,202204,185,141,44,170892,53328,224220
312825,202204,37,27,10,32724,12120,44844
312830,202204,196,109,87,132108,105444,237552
312840,202204,180,121,59,146652,71508,218160
312850,202204,39,36,3,43632,3636,47268
312860,202204,142,95,47,115140,56964,172104
312870,202204,1101,576,525,698112.77,636300,1334412.77
312880,202204,115,82,33,100596,39996,140592
312890,202204,164,116,48,140592,58176,198768
312900,202204,174,129,45,156348,54540,210888
312910,202204,176,102,74,123624.1,89688,213312.1
312920,202204,125,70,55,84840,66660,151500
312930,202204,323,222,101,269064,122412,391476
312940,202204,129,92,37,111504,46056,157560
312950,202204,712,486,226,589032.6,273912,862944.6
312960,202204,150,109,41,132108.64,49692,181800.64
312965,202204,105,83,22,100596,26664,127260
312970,202204,270,223,47,270276,56964,327240
312980,202204,2565,1305,1260,1582875.68,1527120,3109995.68
312990,202204,50,23,27,27876,32724,60600
313000,202204,53,30,23,36360,27876,64236
313005,202204,174,134,40,162408.56,48480,210888.56
313010,202204,940,395,545,478740.6,661752.6,1140493.2
313020,202204,192,100,92,121200,111504.6,232704.6
313030,202204,195,128,67,155136.76,81204,236340.76
313040,202204,83,26,57,31512,69084,100596
313050,202204,200,145,55,175740,66660,242400
313055,202204,42,32,10,38784,12120,50904
313060,202204,138,91,47,110292,56964,167256
313065,202204,61,45,16,54540,19392.6,73932.6
313070,202204,126,66,60,79992,72720,152712
313080,202204,38,18,20,21816,24240,46056
313090,202204,673,437,236,529644.6,286032.2,815676.8
313100,202204,202,73,129,88476,156348,244824
313110,202204,153,84,69,101808,83628,185436
313115,202204,220,119,101,145440,122412,267852
313120,202204,849,481,368,582972,447228,1030200
313130,202204,5910,3221,2689,3903859.99,3261494.1,7165354.09
313140,202204,130,74,56,89688,67872,157560
313150,202204,294,234,60,283609.03,72720,356329.03
313160,202204,187,140,47,169680.8,56964,226644.8
313170,202204,1371,889,482,1077469.8,584184.6,1661654.4
313180,202204,313,186,127,225433.5,153924.4,379357.9
313190,202204,731,426,305,516312.6,369660,885972.6
313200,202204,32,25,7,30300,8484,38784
313210,202204,1006,861,145,1044745.71,175740.6,1220486.31
313220,202204,306,175,131,212100,158772,370872
313230,202204,264,202,62,244824.1,75144,319968.1
313240,202204,2198,1092,1106,1324720.77,1340472.6,2665193.37
313250,202204,1239,936,303,1136858.36,367237.28,1504095.64
313260,202204,92,43,49,52116,59388,111504
313270,202204,1009,590,419,715080.8,507829.8,1222910.6
313280,202204,45,38,7,46056,8484,54540
313290,202204,218,178,40,215736,48480,264216
313300,202204,318,162,156,196344,189072,385416
313310,202204,240,108,132,132108,159984,292092
313320,202204,389,284,105,344208.49,127260,471468.49
313330,202204,1418,870,548,1054441.5,665388,1719829.5
313340,202204,329,237,92,287244,111504,398748
313350,202204,459,294,165,356328,199980,556308
313360,202204,173,80,93,96960,112716,209676
313370,202204,229,79,150,95748.2,183012,278760.2
313375,202204,301,177,124,214524,150288,364812
313380,202204,1335,708,627,859309.6,759924.2,1619233.8
313390,202204,52,48,4,58176,4848,63024
313400,202204,395,270,125,327241.4,151500.6,478742.0
313410,202204,38,18,20,21816,24240,46056
313420,202204,4597,2545,2052,3084544.88,2495510.01,5580054.89
313430,202204,127,62,65,75144,78780.6,153924.6
313440,202204,1354,958,396,1161102.85,481165.8,1642268.65
313450,202204,70,33,37,39996,44844,84840
313460,202204,382,162,220,196344,266640,462984
313470,202204,516,241,275,292092.1,333300.6,625392.7
313480,202204,156,114,42,138168.6,50904,189072.6
313490,202204,541,242,299,294517.41,364813.1,659330.51
313500,202204,29,15,14,18180,16968,35148
313505,202204,1056,816,240,988992,290880,1279872
313507,202204,92,61,31,73932.9,37572,111504.9
313510,202204,2844,1770,1074,2147796.52,1304112.1,3451908.62
313520,202204,3427,2668,759,3234843.63,919908.1,4154751.73
313530,202204,33,19,14,23028,16968,39996
313535,202204,81,66,15,79992,18180,98172
313540,202204,69,48,21,58176,25452,83628
313545,202204,111,95,16,115140,19392,134532
313550,202204,210,175,35,212100,42420.6,254520.6
313560,202204,344,161,183,195132,221796,416928
313570,202204,70,22,48,26664,58176,84840
313580,202204,1303,749,554,907789.1,673872.6,1581661.7
313590,202204,63,37,26,44844,31512,76356
313600,202204,665,400,265,485770.2,321180,806950.2
313610,202204,51,42,9,50904,10908,61812
313620,202204,1362,658,704,798710.22,853248.76,1651958.98
313630,202204,1610,1222,388,1482280.65,470256,1952536.65
313640,202204,117,72,45,87264,54540,141804
313650,202204,223,108,115,130896,139380,270276
313652,202204,24,23,1,29088,1212,30300
313655,202204,77,49,28,59388,33936,93324
313657,202204,49,44,5,53328,6060,59388
313660,202204,130,84,46,101808.66,55752,157560.66
313665,202204,674,308,366,375720.3,443592.1,819312.4
313670,202204,10400,7134,3266,8651272.31,3970512.6,12621784.91
313680,202204,44,32,12,38784,14544,53328
313690,202204,128,93,35,112716,42420,155136
313695,202204,76,57,19,69084.2,23028,92112.2
313700,202204,326,256,70,310272.6,84840,395112.6
313710,202204,125,92,33,111504,39996,151500
313720,202204,1163,533,630,647209.2,763561,1410770.2
313730,202204,70,41,29,49692,35148,84840
313740,202204,143,111,32,134532,38784,173316
313750,202204,407,287,120,347844.9,145440,493284.9
313753,202204,223,164,59,198768,71508,270276
313760,202204,1340,508,832,615697.4,1010808.78,1626506.18
313770,202204,411,281,130,340572.85,157560,498132.85
313780,202204,823,435,388,528434.76,470256,998690.76
313790,202204,30,29,1,35148,1212,36360
313800,202204,158,96,62,116352,75144.6,191496.6
313810,202204,82,49,33,59388,39996,99384
313820,202204,1319,629,690,762349.2,838704.6,1601053.8
313830,202204,55,39,16,47268,19392,66660
313835,202204,61,52,9,63024,10908,73932
313840,202204,1648,985,663,1197457.75,805980,2003437.75
313850,202204,214,90,124,109080,150288,259368
313860,202204,468,356,112,431472.6,135744,567216.6
313862,202204,173,117,56,143016,67872,210888
313865,202204,154,105,49,127260,59388,186648
313867,202204,54,44,10,53328,12120,65448
313868,202204,42,26,16,31512,19392,50904
313870,202204,95,51,44,61812,53328,115140
313880,202204,381,239,142,289668,172104,461772
313890,202204,327,175,152,212100.4,184224,396324.4
313900,202204,813,433,380,524796,461772.7,986568.7
313910,202204,144,96,48,116352,58176,174528
313920,202204,626,431,195,522372,236341.02,758713.02
313925,202204,35,30,5,36360,6060,42420
313930,202204,876,677,199,820524.88,241188.2,1061713.08
313940,202204,1892,1151,741,1395012.2,898093,2293105.2
313950,202204,844,514,330,624180.2,399960,1024140.2
313960,202204,1440,825,615,999902.5,746594.2,1746496.7
313970,202204,186,110,76,133320,92112,225432
313980,202204,219,143,76,173316.6,92112,265428.6
313990,202204,245,160,85,195132,104232,299364
314000,202204,856,566,290,685992.86,352692,1038684.86
314010,202204,89,50,39,60600,47268,107868
314015,202204,78,21,57,25452,69084,94536
314020,202204,59,40,19,48480,23028,71508
314030,202204,73,36,37,43632,44844,88476
314040,202204,41,22,19,27876,23028,50904
314050,202204,290,166,124,202405.4,150288,352693.4
314053,202204,98,60,38,72720,46056,118776
314055,202204,291,179,112,216948,135744,352692
314060,202204,123,107,16,129684.5,19392,149076.5
314070,202204,1056,519,537,629028,650844,1279872
314080,202204,211,134,77,162408.9,93324.84,255733.74
314085,202204,166,115,51,139380,61812,201192
314090,202204,376,264,112,321181.2,135744,456925.2
314100,202204,525,415,110,502980.2,134532,637512.2
314110,202204,765,348,417,421776,505404.6,927180.6
314120,202204,67,39,28,48480,33936,82416
314130,202204,25,16,9,19392,10908,30300
314140,202204,1111,691,420,837493.32,509040.6,1346533.92
314150,202204,187,121,66,146652,79992,226644
314160,202204,320,241,79,292092.4,95748,387840.4
314170,202204,84,64,20,77568,24240,101808
314180,202204,732,642,90,778105.2,109080,887185.2
314190,202204,89,55,34,66660,41208,107868
314200,202204,487,332,155,402384.61,189072,591456.61
314210,202204,255,194,61,236340.2,73932.6,310272.8
314220,202204,302,212,90,256944.8,109080,366024.8
314225,202204,56,37,19,44844,23028,67872
314230,202204,118,53,65,64236,79992,144228
314240,202204,167,120,47,145440,56964,202404
314250,202204,59,37,22,44844,26664,71508
314260,202204,220,108,112,130896,135744,266640
314270,202204,402,313,89,379357.1,107868,487225.1
314280,202204,734,400,334,487169.96,404808,891977.96
314290,202204,526,412,114,499344.6,138168,637512.6
314300,202204,337,256,81,310272.3,98172,408444.3
314310,202204,1327,915,412,1109285.73,500556,1609841.73
314315,202204,39,29,10,35148,12120,47268
314320,202204,582,391,191,473892.7,231492,705384.7
314330,202204,11425,5566,5859,6747220.23,7107169.7,13854389.93
314340,202204,612,274,338,332088,409656.6,741744.6
314345,202204,58,42,16,50904,19392,70296
314350,202204,172,107,65,129684,78780,208464
314360,202204,55,30,25,36360,30300,66660
314370,202204,72,50,22,60600,26664,87264
314380,202204,110,65,45,78780,54540,133320
314390,202204,3327,2142,1185,2598530.2,1436220.4,4034750.6
314400,202204,686,479,207,580548.8,250884.9,831433.7
314410,202204,494,322,172,390264,208464.1,598728.1
314420,202204,16,8,8,9696,9696,19392
314430,202204,2423,892,1531,1082317.56,1857997.8,2940315.36
314435,202204,175,103,72,124836,87264,212100
314437,202204,40,28,12,33936,14544,48480
314440,202204,96,63,33,76356,39996,116352
314450,202204,163,110,53,133320,64236,197556
314460,202204,622,298,324,361176.6,393900.6,755077.2
314465,202204,103,64,39,77568,47268,124836
314467,202204,74,60,14,72720,16968,89688
314470,202204,399,200,199,242400.6,241188,483588.6
314480,202204,1034,465,569,564793.66,689628.9,1254422.56
314490,202204,38,21,17,25452,20604,46056
314500,202204,279,195,84,236340.13,101808,338148.13
314505,202204,108,70,38,84840,46056,130896
314510,202204,247,203,44,246036.2,53328,299364.2
314520,202204,1389,724,665,879917.12,805982.69,1685899.81
314530,202204,752,595,157,722352.6,191496,913848.6
314535,202204,160,99,61,119988,73932,193920
314537,202204,64,38,26,46056,31512,77568
314540,202204,19,12,7,14544,8484,23028
314545,202204,57,39,18,47268,21816,69084
314550,202204,70,37,33,44844,39996,84840
314560,202204,855,456,399,552672.6,484800,1037472.6
314570,202204,16,13,3,15756,3636,19392
314580,202204,13,5,8,6060,9696,15756
314585,202204,26,19,7,23028,8484,31512
314587,202204,82,71,11,86052,13332,99384
314590,202204,562,385,177,467832,214524,682356
314600,202204,930,597,333,723566.26,403596.85,1127163.11
314610,202204,948,489,459,592668.6,556308.1,1148976.7
314620,202204,139,105,34,128472,41208,169680
314625,202204,97,71,26,86052,31512,117564
314630,202204,1125,605,520,735684.2,631452,1367136.2
314640,202204,87,55,32,66660,38784.6,105444.6
314650,202204,162,92,70,111504.2,84840,196344.2
314655,202204,59,43,16,52116,19392,71508
314660,202204,17,12,5,14544,6060,20604
314670,202204,213,164,49,198768.6,59388,258156.6
314675,202204,208,124,84,151500.2,101808,253308.2
314690,202204,587,317,270,384204,327240.2,711444.2
314700,202204,2191,1165,1026,1411983.13,1244724,2656707.13
314710,202204,1797,1004,793,1218060.8,961116,2179176.8
314720,202204,378,218,160,264216,195132,459348
314730,202204,504,269,235,326028,284820,610848
314740,202204,752,347,405,421776.2,490860,912636.2
314750,202204,21,17,4,20604,4848,25452
314760,202204,352,150,202,181800,244824,426624
314770,202204,101,69,32,83628,38784,122412
314780,202204,22,9,13,10908,15756,26664
314790,202204,2458,1545,913,1873756.01,1110192.6,2983948.61
314795,202204,57,49,8,60600,9696,70296
314800,202204,2904,1687,1217,2045860.82,1475004,3520864.82
314810,202204,1466,836,630,1013233.2,763560.4,1776793.6
314820,202204,109,66,43,79992,52116,132108
314830,202204,207,171,36,207252,43632,250884
314840,202204,86,47,39,56964,47268,104232
314850,202204,404,195,209,236340,253308,489648
314860,202204,645,496,149,602364,181800,784164
314870,202204,1582,827,755,1003537.2,917484.5,1921021.7
314875,202204,55,51,4,61812,4848,66660
314880,202204,40,29,11,35148,13332,48480
314890,202204,50,27,23,32724,27876,60600
314900,202204,26,20,6,24240,7272,31512
314910,202204,233,153,80,185436,96960,282396
314915,202204,131,116,15,140592,18180,158772
314920,202204,83,54,29,65448,35148,100596
314930,202204,1014,485,529,587822.46,641148,1228970.46
314940,202204,38,30,8,36360,9696.1,46056.1
314950,202204,22,19,3,23028,3636,26664
314960,202204,25,18,7,21816,8484,30300
314970,202204,167,78,89,94536,107868,202404
314980,202204,292,183,109,221796,132108.75,353904.75
314990,202204,444,238,206,289668.4,249672,539340.4
314995,202204,149,64,85,77568,103020,180588
315000,202204,87,69,18,83628,21816,105444
315010,202204,33,21,12,25452,14544,39996
315015,202204,156,124,32,150288,38784,189072
315020,202204,67,57,10,69084,12120,81204
315030,202204,107,81,26,98172,31512,129684
315040,202204,82,50,32,60600,38784,99384
315050,202204,209,127,82,153924,99384,253308
315053,202204,51,35,16,42420,19392,61812
315057,202204,118,93,25,112716,30300,143016
315060,202204,66,55,11,66660.88,13332,79992.88
315070,202204,102,58,44,70296,53328.9,123624.9
315080,202204,384,302,82,366024,99384,465408
315090,202204,94,55,39,66660,47268,113928
315100,202204,80,40,40,48480,48480,96960
315110,202204,268,135,133,163620,161196,324816
315120,202204,1793,858,935,1041109.45,1135645.09,2176754.54
315130,202204,330,236,94,287244,113928,401172
315140,202204,526,289,237,350268,287244,637512
315150,202204,972,461,511,559944.8,620544,1180488.8
315160,202204,194,98,96,118776,116352,235128
315170,202204,293,197,96,239976.6,116352,356328.6
315180,202204,3174,1335,1839,1618023.3,2230081.4,3848104.7
315190,202204,293,179,114,216948.8,138168,355116.8
315200,202204,1166,694,472,843552.6,572064,1415616.6
315210,202204,1642,960,682,1163521,829008.6,1992529.6
315213,202204,26,15,11,18180,13332,31512
315217,202204,195,155,40,187860,48480,236340
315220,202204,1587,1173,414,1421677.62,502980,1924657.62
315230,202204,173,131,42,158772.6,50904,209676.6
315240,202204,379,245,134,296940.2,162408.6,459348.8
315250,202204,2561,1221,1340,1479853.22,1626504.8,3106358.02
315260,202204,133,72,61,87264,73932,161196
315270,202204,132,92,40,111504,48480,159984
315280,202204,594,392,202,475105.52,244824.8,719930.32
315290,202204,183,114,69,138168,83628,221796
315300,202204,97,73,24,88476,29088,117564
315310,202204,79,71,8,86052,9696,95748
315320,202204,141,86,55,104232,66660,170892
315330,202204,60,48,12,58176,14544,72720
315340,202204,389,285,104,346632,126048,472680
315350,202204,153,97,56,117564,67872,185436
315360,202204,97,44,53,53328,64236,117564
315370,202204,56,34,22,41208,26664,67872
315380,202204,5,5,0,6060,,6060.0
315390,202204,58,17,41,20604,49692.6,70296.6
315400,202204,794,594,200,721142.4,243612,964754.4
315410,202204,313,182,131,220584.64,158773.6,379358.24
315415,202204,52,40,12,48480,14544,63024
315420,202204,190,140,50,169680.54,60600,230280.54
315430,202204,655,369,286,447228.8,346632,793860.8
315440,202204,89,59,30,71508,36360,107868
315445,202204,212,178,34,215736.2,41208,256944.2
315450,202204,174,127,47,153924,56964,210888
315460,202204,4390,2039,2351,2473696.47,2855474.46,5329170.93
315470,202204,43,17,26,20604,31512,52116
315480,202204,75,20,55,24240,66660,90900
315490,202204,700,434,266,528432,322392,850824
315500,202204,17,14,3,16968,3636,20604
315510,202204,139,97,42,117564,50904,168468
315520,202204,81,69,12,83628,14544,98172
315530,202204,43,23,20,27876,24240,52116
315540,202204,269,189,80,229068,96960,326028
315550,202204,176,141,35,170892.2,42420,213312.2
315560,202204,710,563,147,682356.6,178164,860520.6
315570,202204,308,148,160,179377.44,193920.4,373297.84
315580,202204,733,497,236,604788,286032.6,890820.6
315590,202204,188,99,89,119988.9,109080,229068.9
315600,202204,320,246,74,298152.6,89688,387840.6
315610,202204,103,50,53,60600,64236,124836
315620,202204,39,30,9,36360,10908,47268
315630,202204,125,87,38,105444,46056,151500
315640,202204,64,38,26,46056,31512,77568
315645,202204,49,31,18,37572,21816,59388
315650,202204,165,121,44,146652.58,53328.2,199980.78
315660,202204,451,201,250,243612.6,303000.99,546613.59
315670,202204,2368,1103,1265,1340474.76,1539240.19,2879714.95
315680,202204,784,561,223,679932.2,271488,951420.2
315690,202204,679,454,225,550248.69,272700,822948.69
315700,202204,1957,1020,937,1236809.73,1135644.6,2372454.33
315710,202204,353,111,242,134532,294516,429048
315720,202204,491,298,193,361176.2,233916,595092.2
315725,202204,189,150,39,181800.6,47268,229068.6
315727,202204,65,35,30,42420.2,36360,78780.2
315730,202204,49,44,5,53328,6060,59388
315733,202204,85,53,32,64236,38784,103020
315737,202204,49,37,12,44844,14544,59388
315740,202204,33,25,8,30300,9696,39996
315750,202204,150,110,40,134532,48480,183012
315760,202204,41,31,10,37572,12120,49692
315765,202204,124,73,51,88476.13,61812.46,150288.59
315770,202204,222,142,80,172104.38,96960,269064.38
315780,202204,3778,1876,1902,2273715.04,2307648,4581363.04
315790,202204,241,185,56,225432,67872,293304
315800,202204,301,197,104,238764.6,127260,366024.6
315810,202204,59,35,24,42420,29088,71508
315820,202204,738,542,196,656906.8,239976,896882.8
315830,202204,117,73,44,88476,53328,141804
315840,202204,79,52,27,63024,32724,95748
315850,202204,263,181,82,220585.94,99384.6,319970.54
315860,202204,17,5,12,6060,14544,20604
315870,202204,41,32,9,38784,10908,49692
315880,202204,94,65,29,78780,35148,113928
315890,202204,105,77,28,93324,33936,127260
315895,202204,404,264,140,321180.8,170892,492072.8
315900,202204,80,39,41,47268,49692,96960
315910,202204,45,27,18,32724,21816,54540
315920,202204,154,102,52,123624,63024,186648
315930,202204,53,17,36,20604,43632,64236
315935,202204,120,96,24,116352.8,29088,145440.8
315940,202204,101,74,27,89688,32724,122412
315950,202204,29,21,8,25452,9696,35148
315960,202204,550,264,286,319968,346632.6,666600.6
315970,202204,30,23,7,27876,8484,36360
315980,202204,664,333,331,403596.49,402384,805980.49
315990,202204,260,149,111,180588,134532,315120
316000,202204,46,30,16,36360,19392,55752
316010,202204,83,70,13,84840.28,15756,100596.28
316020,202204,109,95,14,115140,16968,132108
316030,202204,370,207,163,250884.6,197556.6,448441.2
316040,202204,533,211,322,255733.28,390264.6,645997.88
316045,202204,51,46,5,55752,6060,61812
316050,202204,21,16,5,19392,6060,25452
316060,202204,102,68,34,82416,41208,123624
316070,202204,1139,751,388,913849.48,472680,1386529.48
316080,202204,91,59,32,71614.65,38784,110398.65
316090,202204,39,19,20,23028,24240,47268
316095,202204,85,71,14,86052.72,16968,103020.72
316100,202204,324,181,143,219372,173316.6,392688.6
316105,202204,42,24,18,29088.6,21816,50904.6
316110,202204,1867,1454,413,1762250.54,502980,2265230.54
316120,202204,78,51,27,61812.6,32724,94536.6
316130,202204,115,85,30,103020.6,36360,139380.6
316140,202204,33,22,11,26664,13332,39996
316150,202204,212,146,66,176952,79992,256944
316160,202204,80,48,32,58176,38784,96960
316165,202204,72,47,25,56964,30300,87264
316170,202204,186,119,67,144228,81204,225432
316180,202204,213,84,129,101808.6,156348.6,258157.2
316190,202204,145,105,40,127260,48480,175740
316200,202204,643,346,297,419352,361176,780528
316210,202204,752,498,254,603784.66,307848,911632.66
316220,202204,116,74,42,89688,50904,140592
316225,202204,35,21,14,25452,16968,42420
316230,202204,38,20,18,24240,21816,46056
316240,202204,653,521,132,631452,159984,791436
316245,202204,155,137,18,166044,21816,187860
316250,202204,1613,1083,530,1313809.2,642360,1956169.2
316255,202204,135,109,26,132108,31512,163620
316257,202204,174,89,85,107868,104232,212100
316260,202204,186,128,58,155136,70296.71,225432.71
316265,202204,30,22,8,26664.55,9696,36360.55
316270,202204,668,474,194,574489.36,236340.96,810830.32
316280,202204,540,339,201,410869.35,243612.6,654481.95
316290,202204,812,557,255,676296.44,309060,985356.44
316292,202204,557,229,328,277548,397536,675084
316294,202204,107,68,39,82416,47268,129684
316295,202204,346,156,190,190284.6,230280,420564.6
316300,202204,8,6,2,7272,2424,9696
316310,202204,27,14,13,16968,15756,32724
316320,202204,54,28,26,33936,31512,65448
316330,202204,173,119,54,144228,65448,209676
316340,202204,138,93,45,112716,54540,167256
316350,202204,187,130,57,157560.2,69084,226644.2
316360,202204,26,15,11,18180,13332,31512
316370,202204,1183,589,594,713869.66,721140,1435009.66
316380,202204,109,84,25,101808,31512,133320
316390,202204,100,72,28,87264,33936,121200
316400,202204,141,106,35,128472,42420,170892
316410,202204,300,215,85,260580,103020,363600
316420,202204,217,147,70,178164,84840,263004
316430,202204,152,82,70,99384,86052,185436
316440,202204,74,40,34,48480,41208,89688
316443,202204,41,36,5,44844,6060,50904
316447,202204,43,34,9,41208,10908,52116
316450,202204,232,180,52,218160.6,63024,281184.6
316460,202204,41,12,29,14544,35148,49692
316470,202204,1703,1240,463,1506505.87,561156,2067661.87
316480,202204,11,8,3,9696,3636,13332
316490,202204,20,7,13,8484,15756,24240
316500,202204,160,104,56,126048,67872,193920
316510,202204,141,112,29,135744,36360,172104
316520,202204,186,106,80,128472,96960,225432
316530,202204,163,101,62,122412,75144,197556
316540,202204,152,77,75,93324,90900,184224
316550,202204,141,85,56,103020,67872,170892
316553,202204,371,175,196,212100,237552.72,449652.72
316555,202204,49,44,5,53328,6060,59388
316556,202204,13,9,4,10908,4848,15756
316557,202204,27,21,6,25452,7272,32724
316560,202204,71,49,22,59388,26664,86052
316570,202204,206,189,17,229068,20604,249672
316580,202204,22,16,6,19392,7272,26664
316590,202204,96,80,16,96960,19392,116352
316600,202204,174,143,31,173316,37572,210888
316610,202204,69,50,19,60600,23028,83628
316620,202204,144,103,41,124836,49692,174528
316630,202204,43,34,9,41208,10908,52116
316640,202204,20,13,7,15756,8484,24240
316650,202204,93,76,17,92112,20604,112716
316660,202204,7,2,5,2424,6060,8484
316670,202204,427,147,280,178164.1,339360,517524.1
316680,202204,159,119,40,144228,48480.4,192708.4
316690,202204,164,98,66,118776,81204,199980
316695,202204,57,48,9,58176,10908,69084
316700,202204,19,13,6,15756,7272,23028
316710,202204,764,581,183,704172,221796,925968
316720,202204,5034,2410,2624,2920926.74,3182713.31,6103640.05
316730,202204,13,13,0,15756,,15756.0
316740,202204,149,94,55,113928,66660,180588
316750,202204,23,15,8,18180,9696,27876
316760,202204,309,249,60,301788,72720,374508
316770,202204,168,86,82,104232,100596,204828
316780,202204,67,42,25,50904.6,30300,81204.6
316790,202204,59,42,17,50904,20604,71508
316800,202204,1766,1083,683,1312596.2,827797.5,2140393.7
316805,202204,26,18,8,21816,9696,31512
316810,202204,61,37,24,44844,29088,73932
316820,202204,40,22,18,26664,21816,48480
316830,202204,98,44,54,53328.2,65448,118776.2
316840,202204,506,302,204,366024,247248.4,613272.4
316850,202204,303,204,99,247248,119988,367236
316860,202204,6112,2716,3396,3291796.64,4118377.16,7410173.80
316870,202204,1626,1043,583,1266543,707809.77,1974352.77
316880,202204,151,77,74,93324,89688,183012
316890,202204,226,154,72,186648.2,87264,273912.2
316900,202204,408,288,120,349057.14,145440,494497.14
316905,202204,22,10,12,12120,14544,26664
316910,202204,67,29,38,35148,46056,81204
316920,202204,140,110,30,133320.2,36360,169680.2
316930,202204,1906,957,949,1162310.71,1150188.9,2312499.61
316935,202204,926,549,377,665388.46,456924.6,1122313.06
316940,202204,1085,625,460,758713.23,558733.4,1317446.63
316950,202204,181,85,96,103020,116352,219372
316960,202204,1087,605,482,733262.2,585396.7,1318658.9
316970,202204,630,498,132,604788.74,159984,764772.74
316980,202204,78,40,38,48480,46056,94536
316990,202204,2191,1486,705,1802246.91,859309.09,2661556.00
317000,202204,327,254,73,309060.7,88476,397536.7
317005,202204,218,154,64,186648,77568,264216
317010,202204,6511,3661,2850,4441993.86,3462688.1,7904681.96
317020,202204,15519,6830,8689,8281620.9,10540772.17,18822393.07
317030,202204,85,36,49,43632.6,59388,103020.6
317040,202204,3019,1926,1093,2335525.93,1330777.44,3666303.37
317043,202204,72,55,17,66660.32,20604,87264.32
317047,202204,40,23,17,27876,20604,48480
317050,202204,142,110,32,134532,38784,173316
317052,202204,145,114,31,138168,37572,175740
317057,202204,170,128,42,155136,50904,206040
317060,202204,62,37,25,44844,30300,75144
317065,202204,51,37,14,44844,16968,61812
317070,202204,1905,878,1027,1065349.93,1244724.6,2310074.53
317075,202204,95,52,43,63024,52116,115140
317080,202204,917,468,449,568428.2,544188,1112616.2
317090,202204,697,545,152,660540.2,184224,844764.2
317100,202204,421,318,103,385416,124836,510252
317103,202204,113,90,23,109080,27876,136956
317107,202204,48,40,8,48480,9696,58176
317110,202204,90,47,43,56964.2,54540,111504.2
317115,202204,44,40,4,48480,4848,53328
317120,202204,1998,962,1036,1170795.35,1256844,2427639.35
317130,202204,2040,1365,675,1654380.6,821736.6,2476117.2
317140,202204,12,11,1,13332,1212,14544
317150,202204,283,170,113,206041.5,136956,342997.5
317160,202204,334,249,85,301789.65,103020,404809.65
317170,202204,235,158,77,192708,93324,286032
317180,202204,428,292,136,353904.2,164832,518736.2
317190,202204,258,188,70,227856,84840,312696
317200,202204,814,558,256,677511.77,310273,987784.77
317210,202204,180,95,85,115140.27,103020,218160.27
317220,202204,22,11,11,13332,14544,27876
320010,202204,559,402,157,487224.4,190284.1,677508.5
320013,202204,126,87,39,105444,47268,152712
320016,202204,259,164,95,198768.52,115140,313908.52
320020,202204,716,424,292,513890.09,355116,869006.09
320030,202204,157,107,50,129684.06,60600.84,190284.90
320035,202204,136,98,38,118776,46056,164832
320040,202204,494,253,241,306636,292092,598728
320050,202204,117,80,37,96960,44844,141804
320060,202204,1758,819,939,993841.92,1138069.6,2131911.52
320070,202204,98,60,38,72720,46056,118776
320080,202204,806,457,349,553885.1,422989.75,976874.85
320090,202204,1255,808,447,979296,541764,1521060
320100,202204,336,194,142,235128,172104,407232
320110,202204,124,77,47,93325.8,56964,150289.8
320115,202204,110,92,18,111504,21816,133320
320120,202204,3625,1876,1749,2279778.1,2121001.27,4400779.37
320130,202204,7746,3390,4356,4111108.99,5286747.71,9397856.70
320140,202204,441,285,156,345421,189072.6,534493.6
320150,202204,2087,1163,924,1409558.69,1121100.1,2530658.79
320160,202204,638,278,360,336936.1,437532.63,774468.73
320170,202204,107,84,23,101808.1,27876.02,129684.12
320180,202204,56,34,22,41208.76,26664,67872.76
320190,202204,233,142,91,172104.2,110292,282396.2
320200,202204,63,49,14,59388.1,16968,76356.1
320210,202204,895,484,411,586609.2,499347.13,1085956.33
320220,202204,291,103,188,124836.45,227856,352692.45
320225,202204,75,61,14,73932,16968,90900
320230,202204,692,440,252,533284.21,305424.2,838708.41
320240,202204,3488,1606,1882,1946474.7,2280984.8,4227459.5
320245,202204,499,341,158,413293.57,191496,604789.57
320250,202204,227,105,122,127260,149076,276336
320255,202204,130,99,31,119988,37572,157560
320260,202204,240,136,104,164832.16,126048.12,290880.28
320265,202204,147,114,33,138168,39996,178164
320270,202204,157,120,37,146652.2,44844,191496.2
320280,202204,1197,668,529,812041.72,642360.22,1454401.94
320290,202204,60,48,12,58176,14544,72720
320300,202204,611,415,196,504193.58,237552.76,741746.34
320305,202204,717,383,334,466620,404808.6,871428.6
320310,202204,199,116,83,140592.84,100596,241188.84
320313,202204,339,155,184,187860.8,223008,410868.8
320316,202204,108,79,29,95748.2,35148,130896.2
320320,202204,3418,1512,1906,1836182.14,2311284.8,4147466.94
320330,202204,273,199,74,241188,90900,332088
320332,202204,776,454,322,550249.69,390265.32,940515.01
320334,202204,279,154,125,186648.02,151500.9,338148.92
320335,202204,140,89,51,107868,61812,169680
320340,202204,562,392,170,475104.88,206040.7,681145.58
320350,202204,1059,434,625,526011.32,757500.6,1283511.92
320360,202204,169,81,88,99384,106656,206040
320370,202204,229,170,59,206040.64,71508.6,277549.24
320380,202204,296,210,86,254520.66,104232,358752.66
320390,202204,1147,670,477,813253,579336.2,1392589.2
320400,202204,315,222,93,269064.12,112716,381780.12
320405,202204,951,384,567,466622,689628.85,1156250.85
320410,202204,945,474,471,574488.4,570852.6,1145341.0
320420,202204,540,254,286,307848.2,347844.2,655692.4
320425,202204,199,108,91,130896.1,110292,241188.1
320430,202204,382,194,188,236340.7,227856,464196.7
320435,202204,162,109,53,133320,64236,197556
320440,202204,203,110,93,133320.24,112716.2,246036.44
320450,202204,136,73,63,88476,76356,164832
320455,202204,232,183,49,221796,59388,281184
320460,202204,287,177,110,214524,133320.96,347844.96
320465,202204,109,73,36,88476.2,43632,132108.2
320470,202204,712,424,288,513888.77,349056.18,862944.95
320480,202204,203,133,70,161196.1,84840,246036.1
320490,202204,3207,1502,1705,1821641.54,2071313.35,3892954.89
320495,202204,118,68,50,82416,60600.6,143016.6
320500,202204,9758,4726,5032,5736415.91,6103639.16,11840055.07
320501,202204,548,279,269,339360,327240,666600
320503,202204,298,211,87,255732.74,105444.12,361176.86
320506,202204,253,175,78,212100,94536,306636
320510,202204,1175,510,665,618120.4,805980.7,1424101.1
320515,202204,82,62,20,75144,24240,99384
320517,202204,213,152,61,184224,73932,258156
320520,202204,7431,3081,4350,3737813.85,5275848.8,9013662.65
320530,202204,6710,3220,3490,3905047.02,4232312.96,8137359.98
330010,202204,3275,1616,1659,1959809.42,2011921.97,3971731.39
330015,202204,197,85,112,103020.64,135744,238764.64
330020,202204,3851,1539,2312,1868906.73,2805783.33,4674690.06
330022,202204,268,133,135,161196,163620,324816
330023,202204,725,209,516,253308,625393.26,878701.26
330025,202204,642,123,519,149076,631452.8,780528.8
330030,202204,1822,1134,688,1374409.81,835068,2209477.81
330040,202204,2559,1286,1273,1559846.34,1546512.5,3106358.84
330045,202204,9806,2910,6896,3528137.61,8371287.38,11899424.99
330050,202204,869,546,323,661752.6,391476,1053228.6
330060,202204,1116,655,461,793861.5,558732.23,1352593.73
330070,202204,4152,1411,2741,1711346.2,3328153.4,5039499.6
330080,202204,1599,697,902,845977.93,1098072.6,1944050.53
330090,202204,396,221,175,267852,212100.6,479952.6
330093,202204,240,100,140,121200,169680,290880
330095,202204,65,40,25,48480,30300,78780
330100,202204,10394,5095,5299,6181210.24,6429664.09,12610874.33
330110,202204,459,210,249,254520.95,301788,556308.95
330115,202204,519,264,255,319968,309060,629028
330120,202204,396,208,188,252096,227856.4,479952.4
330130,202204,1620,414,1206,501769,1462884.19,1964653.19
330140,202204,657,345,312,418140,378144,796284
330150,202204,513,298,215,362388.9,260580.92,622969.82
330160,202204,207,121,86,146652,104232,250884
330170,202204,27052,9107,17945,11053457.37,21771179.22,32824636.59
330180,202204,258,135,123,163620,149076,312696
330185,202204,1034,354,680,429048.76,824160.2,1253208.96
330187,202204,491,145,346,175740.67,420564.5,596305.17
330190,202204,6168,2258,3910,2739122.24,4746195.2,7485317.44
330200,202204,4647,1438,3209,1742859.32,3891734.8,5634594.12
330205,202204,460,259,201,313908,243612.6,557520.6
330210,202204,955,568,387,688417.62,469045.6,1157463.22
330220,202204,2801,1634,1167,1980412.69,1414405.97,3394818.66
330225,202204,570,295,275,357540.4,333300,690840.4
330227,202204,2412,733,1679,889608.39,2039797.6,2929405.99
330230,202204,255,135,120,163620,146652,310272
330240,202204,4127,1947,2180,2359767.23,2644586,5004353.23
330245,202204,151,66,85,79992.36,103020,183012.36
330250,202204,6723,3234,3489,3926886.08,4235942.86,8162828.94
330260,202204,716,190,526,230280,638724.6,869004.6
330270,202204,3855,1213,2642,1470157.15,3205744.35,4675901.50
330280,202204,448,278,170,336938.2,206040.12,542978.32
330285,202204,6713,2087,4626,2534295.48,5615204.16,8149499.64
330290,202204,717,245,472,298153.6,572064,870217.6
330300,202204,745,464,281,565537.56,340572.8,906110.36
330310,202204,460,258,202,312696.6,244824,557520.6
330320,202204,7914,2801,5113,3397241.4,6204234.81,9601476.21
330330,202204,9295,3426,5869,4153531.85,7125355.51,11278887.36
330340,202204,2674,1515,1159,1836180.77,1408344,3244524.77
330350,202204,19538,7156,12382,8679149.94,15032450.86,23711600.80
330360,202204,2060,961,1099,1164735.45,1333200.6,2497936.05
330370,202204,980,500,480,606001.96,584184.5,1190186.46
330380,202204,959,386,573,469044.56,695688.4,1164732.96
330385,202204,650,323,327,391476,396324.1,787800.1
330390,202204,5935,3042,2893,3691756.56,3509954.64,7201711.20
330395,202204,359,225,134,272700.2,162408.8,435109.0
330400,202204,713,355,358,430262.94,435108,865370.94
330410,202204,516,368,148,446016.85,179376.1,625392.95
330411,202204,306,162,144,196344.28,174528,370872.28
330412,202204,226,92,134,111504,162408,273912
330414,202204,5404,2114,3290,2563383.02,3992329.1,6555712.12
330415,202204,612,261,351,316333.79,426624.4,742958.19
330420,202204,2352,1203,1149,1459249.73,1393800.51,2853050.24
330430,202204,1779,751,1028,911424.91,1247149.94,2158574.85
330440,202204,352,169,183,204828.8,221796,426624.8
330450,202204,120,55,65,66660.6,78780,145440.6
330452,202204,2317,962,1355,1165948.24,1643474.3,2809422.54
330455,202204,120725,40987,79738,49723760.77,96739600.85,146463361.62
330460,202204,251,112,139,135744,168468,304212
330470,202204,1237,661,576,801134.49,700538,1501672.49
330475,202204,1747,498,1249,603576.2,1515001.2,2118577.4
330480,202204,802,439,363,532068.58,439956.4,972024.98
330490,202204,15762,4856,10906,5894078.14,13231411.34,19125489.48
330500,202204,1481,633,848,767197.14,1028988.24,1796185.38
330510,202204,10956,3730,7226,4523190.99,8773677.79,13296868.78
330513,202204,103,52,51,63024,61812,124836
330515,202204,738,307,431,374508.6,522372.4,896881.0
330520,202204,2546,858,1688,1043532.45,2050706.98,3094239.43
330530,202204,189,106,83,128472,100596.4,229068.4
330540,202204,328,166,162,201192,196344,397536
330550,202204,2798,945,1853,1147766.24,2247050.21,3394816.45
330555,202204,905,342,563,414504,682356.1,1096860.1
330560,202204,728,241,487,292092.8,591456,883548.8
330570,202204,292,203,89,246036,107868,353904
330575,202204,823,294,529,356328,641148.4,997476.4
330580,202204,3370,1788,1582,2167058,1919809.4,4086867.4
330590,202204,261,135,126,163620.18,152712,316332.18
330600,202204,1299,773,526,938089.7,637512.2,1575601.9
330610,202204,1649,852,797,1033838.3,965964.8,1999803.1
330615,202204,224,181,43,219372.8,52117.36,271490.16
330620,202204,1033,397,636,482378.5,772044.95,1254423.45
330630,202204,4383,2614,1769,3170599.65,2145241.36,5315841.01
350010,202204,599,395,204,478742.62,247248.5,725991.12
350020,202204,56,19,37,23028,44844,67872
350030,202204,542,326,216,395112.7,261792.3,656905.0
350040,202204,119,47,72,56965.02,87264,144229.02
350050,202204,354,176,178,213312,215736,429048
350055,202204,123,51,72,61812,87264,149076
350060,202204,88,38,50,46056,61812,107868
350070,202204,796,453,343,549041.06,416929.5,965970.56
350075,202204,72,43,29,52116,35148,87264
350080,202204,56,25,31,30300.2,37572.2,67872.4
350090,202204,86,49,37,59388,44844,104232
350100,202204,266,165,101,199980.74,122412,322392.74
350110,202204,47,30,17,36360.6,20604,56964.6
350115,202204,161,88,73,106656,88476.6,195132.6
350120,202204,113,70,43,84840.4,52116,136956.4
350130,202204,391,170,221,206040.03,267852,473892.03
350140,202204,40,24,16,29088,19392,48480
350150,202204,68,48,20,58176,24240,82416
350160,202204,2397,946,1451,1146552.4,1758613.3,2905165.7
350170,202204,399,226,173,273912.6,209676.6,483589.2
350180,202204,165,93,72,112716,88476.6,201192.6
350190,202204,1012,538,474,654243.72,575700,1229943.72
350200,202204,59,25,34,30300.4,41208,71508.4
350210,202204,1317,713,604,865369.9,733260.95,1598630.85
350220,202204,642,524,118,636303.78,144228,780531.78
350230,202204,71,46,25,55752,30300,86052
350240,202204,59,37,22,44844.48,26664.2,71508.68
350250,202204,1131,519,612,629029.6,741746,1370775.6
350260,202204,95,68,27,82416,32724,115140
350270,202204,961,640,321,776892.6,390264.88,1167157.48
350275,202204,310,118,192,143016.1,233916,376932.1
350280,202204,4486,2166,2320,2625200.49,2815477.17,5440677.66
350290,202204,465,200,265,243612.2,323604.6,567216.8
350300,202204,50,25,25,30300.72,30300,60600.72
350310,202204,77,46,31,55752.2,37572,93324.2
350315,202204,69,29,40,35148,48480,83628
350320,202204,3385,1599,1786,1937993.02,2170693.53,4108686.55
350330,202204,1678,865,813,1048385.21,985356.6,2033741.81
350335,202204,17,10,7,12120,8484,20604
350340,202204,125,51,74,61812,89688.2,151500.2
350350,202204,95,47,48,56964,58176,115140
350360,202204,104,68,36,82416,43632,126048
350370,202204,83,45,38,54540.95,46056,100596.95
350380,202204,804,338,466,409657.85,564792,974449.85
350390,202204,1760,648,1112,786588.3,1347744.1,2134332.4
350395,202204,23,18,5,21816,6060,27876
350400,202204,1724,826,898,1001117.49,1093225.03,2094342.52
350410,202204,2998,1245,1753,1508941.77,2128273.79,3637215.56
350420,202204,268,159,109,192709.31,133320,326029.31
350430,202204,92,46,46,55752.2,55752.2,111504.4
350440,202204,147,106,41,128472.2,49692,178164.2
350450,202204,1729,955,774,1161102.79,938088.2,2099190.99
350460,202204,396,135,261,163620,316332.2,479952.2
350470,202204,20,13,7,15756,8484,24240
350480,202204,198,102,96,123624.1,116352.6,239976.7
350490,202204,247,114,133,138168.2,162408,300576.2
350500,202204,57,23,34,27876,41208,69084
350510,202204,154,93,61,112716,73932,186648
350520,202204,441,231,210,279972,255732,535704
350530,202204,440,209,231,253308,281184.34,534492.34
350535,202204,89,61,28,73932,33936,107868
350540,202204,373,199,174,241188,210888,452076
350550,202204,2771,1573,1198,1910117.49,1454401.9,3364519.39
350560,202204,580,395,185,478740,224220.6,702960.6
350570,202204,4528,1833,2695,2222813.94,3267553.75,5490367.69
350580,202204,373,178,195,215736,236340.3,452076.3
350590,202204,975,525,450,636300.4,545400.75,1181701.15
350600,202204,6370,2955,3415,3581467.95,4142619.1,7724087.05
350610,202204,1507,772,735,936878.57,893244.88,1830123.45
350620,202204,26,16,10,19392,12120,31512
350630,202204,259,131,128,158772.55,155136,313908.55
350635,202204,1143,460,683,557521.85,827798.07,1385319.92
350640,202204,111,80,31,96960.95,37572,134532.95
350650,202204,1860,1226,634,1485913.66,768408,2254321.66
350660,202204,761,300,461,363600.48,559944.2,923544.68
350670,202204,300,147,153,178164,186648,364812
350680,202204,165,81,84,99384.68,103020.6,202405.28
350690,202204,202,91,111,110292,135744,246036
350700,202204,877,415,462,502980.67,561156,1064136.67
350710,202204,410,152,258,185436.2,313908.8,499345.0
350715,202204,54,43,11,52116,13332,65448
350720,202204,18,11,7,13332,8484,21816
350730,202204,41,26,15,31512,19392,50904
350740,202204,235,128,107,155136,129684,284820
350745,202204,28,12,16,14544,19392,33936
350750,202204,2398,1407,991,1705287.62,1202305.13,2907592.75
350760,202204,3862,1605,2257,1946474.57,2739121,4685595.57
350770,202204,55,36,19,43632,23028,66660
350775,202204,48,35,13,42420.9,15756,58176.9
350780,202204,444,224,220,271488.5,267852.5,539341.0
350790,202204,365,152,213,184224.2,258156,442380.2
350800,202204,523,314,209,380568.86,253308,633876.86
350810,202204,504,391,113,473895.07,138168,612063.07
350820,202204,94,52,42,63024,50904,113928
350830,202204,72,39,33,47268.9,39996,87264.9
350840,202204,796,323,473,391476.6,574488,965964.6
350850,202204,1851,967,884,1175642.15,1072620,2248262.15
350860,202204,656,342,314,414505.3,381780.4,796285.7
350870,202204,452,299,153,362388,185436,547824
350880,202204,276,156,120,189072,145440,334512
350890,202204,40,25,15,30300,18180,48480
350900,202204,1608,484,1124,589033.6,1362289.5,1951323.1
350910,202204,23,11,12,13332,14544,27876
350920,202204,761,395,366,478740.1,443592,922332.1
350925,202204,1171,604,567,733261,688417.41,1421678.41
350930,202204,109,58,51,70296.18,61812,132108.18
350940,202204,736,384,352,465408.3,426624.48,892032.78
350945,202204,112,81,31,98172,37572,135744
350950,202204,17431,7970,9461,9666931.02,11475222.98,21142154.00
350960,202204,1586,643,943,782953.13,1142916.7,1925869.83
350970,202204,1093,537,556,651927.18,673872,1325799.18
350980,202204,96,64,32,77568.9,38784,116352.9
350990,202204,382,131,251,158772.6,304212,462984.6
350995,202204,41,18,23,21816,27876,49692
351000,202204,620,403,217,488436.95,263004.8,751441.75
351010,202204,49,33,16,39996.2,19392,59388.2
351015,202204,45,30,15,36360,18180,54540
351020,202204,1494,881,613,1068985.7,746592,1815577.7
351030,202204,344,205,139,248460,168468,416928
351040,202204,991,512,479,621759.68,580548,1202307.68
351050,202204,3529,1568,1961,1900422.95,2380368.8,4280791.75
351060,202204,5877,2106,3771,2552478.19,4575300.6,7127778.79
351070,202204,401,252,149,306638.61,180588.95,487227.56
351080,202204,740,535,205,650844.7,250884.7,901729.4
351090,202204,47,22,25,26664,30300,56964
351100,202204,422,227,195,275125.71,236341.83,511467.54
351110,202204,2075,955,1120,1157464.6,1359864.6,2517329.2
351120,202204,64,31,33,37572,39996.6,77568.6
351130,202204,194,63,131,76356.94,159984,236340.94
351140,202204,326,194,132,235128,159984,395112
351150,202204,484,244,240,295728.5,292092.6,587821.1
351160,202204,284,167,117,202404.93,141804,344208.93
351170,202204,211,111,100,134532,121200,255732
351190,202204,91,57,34,69084,41208,110292
351200,202204,351,224,127,271488.4,153924,425412.4
351210,202204,121,59,62,71508,75144,146652
351220,202204,557,322,235,390265.53,286032,676297.53
351230,202204,285,193,92,233916.2,111504,345420.2
351240,202204,235,111,124,134532.19,150288.98,284821.17
351250,202204,82,54,28,65448.82,33936,99384.82
351260,202204,151,106,45,128472,54540,183012
351270,202204,45,20,25,24240,30300,54540
351280,202204,1044,480,564,582973.15,683568.95,1266542.10
351290,202204,245,108,137,130896,166044,296940
351300,202204,3905,1665,2240,2019101,2718517,4737618
351310,202204,738,356,382,431474.15,462984.1,894458.25
351320,202204,119,64,55,77568,67872.6,145440.6
351330,202204,38,24,14,29088,16968,46056
351340,202204,1381,751,630,911427.81,763561.2,1674989.01
351350,202204,2364,1354,1010,1644689.28,1224121,2868810.28
351360,202204,800,371,429,449652.2,519948,969600.2
351370,202204,406,195,211,236342.23,255732.2,492074.43
351380,202204,8901,3813,5088,4626212.44,6175145.25,10801357.69
351385,202204,29,18,11,21816,13332,35148
351390,202204,280,207,73,250884.76,88476,339360.76
351400,202204,62,42,20,50904,24240,75144
351410,202204,463,281,182,340572.8,220584,561156.8
351420,202204,69,48,21,58176,25452,83628
351430,202204,74,40,34,48480,41208,89688
351440,202204,794,522,272,635092.66,329664,964756.66
351450,202204,273,127,146,153924.7,176952,330876.7
351460,202204,134,56,78,67872.8,94536,162408.8
351470,202204,144,75,69,90900,83628,174528
351480,202204,480,283,197,342997.55,238764,581761.55
351490,202204,290,107,183,129684,221796,351480
351492,202204,26,16,10,19392,12120,31512
351495,202204,24,17,7,20604,8484,29088
351500,202204,3468,1393,2075,1691954.16,2518538.04,4210492.20
351510,202204,2077,751,1326,910214,1608325.8,2518539.8
351512,202204,13,9,4,10908,4848,15756
351515,202204,201,120,81,145440,98172,243612
351518,202204,690,411,279,498133.61,339360.82,837494.43
351519,202204,80,44,36,53328,43632,96960
351520,202204,163,97,66,117564.48,80013.93,197578.41
351530,202204,22,12,10,15756,12120,27876
351535,202204,138,83,55,100596.73,66660.2,167256.93
351540,202204,466,310,156,376932.29,189072,566004.29
351550,202204,1500,877,623,1062928.84,756288,1819216.84
351560,202204,76,46,30,55752.2,36360,92112.2
351565,202204,12,6,6,7272,7272,14544
351570,202204,2767,1272,1495,1541666.3,1813152.85,3354819.15
351580,202204,38,34,4,41208,4848,46056
351590,202204,64,42,22,50904.52,26664,77568.52
351600,202204,180,130,50,157560.64,60600,218160.64
351610,202204,52,24,28,29088,33936,63024
351620,202204,5856,3138,2718,3808112.91,3297854.96,7105967.87
351630,202204,3218,1524,1694,1849513.2,2053128.6,3902641.8
351640,202204,2325,996,1329,1207154.63,1614385.83,2821540.46
351650,202204,30,25,5,30300,6060,36360
351660,202204,137,85,52,103020,63024,166044
351670,202204,741,436,305,528434.02,369660,898094.02
351680,202204,78,59,19,71508,23028,94536
351685,202204,12,8,4,9696,4848,14544
351690,202204,300,199,101,241188.3,122412,363600.3
351700,202204,178,117,61,142065,75144,217209
351710,202204,66,42,24,50904,29088,79992
351720,202204,126,71,55,86052,66660,152712
351730,202204,111,75,36,92112,43632,135744
351740,202204,783,490,293,593882.18,356329.45,950211.63
351750,202204,376,147,229,179376.07,277548,456924.07
351760,202204,725,554,171,672660.2,207252,879912.2
351770,202204,293,237,56,287245.06,67872,355117.06
351780,202204,150,90,60,109080,72720,181800
351790,202204,259,131,128,158772.1,155136,313908.1
351800,202204,41,27,14,32724,16968,49692
351810,202204,126,83,43,101808.47,52116,153924.47
351820,202204,769,545,224,661754.72,272700,934454.72
351830,202204,614,194,420,235128,509040,744168
351840,202204,2157,979,1178,1187762.06,1427736,2615498.06
351850,202204,239,164,75,198768,90900,289668
351860,202204,620,409,211,495710.34,255732,751442.34
351870,202204,5741,2580,3161,3129389.89,3835985.89,6965375.78
351880,202204,21210,8137,13073,9872965.54,15862662.25,25735627.79
351885,202204,88,49,39,59388.2,47268,106656.2
351890,202204,68,48,20,58176,24240.2,82416.2
351900,202204,230,126,104,152712,126048,278760
351905,202204,93,43,50,52116,60600,112716
351907,202204,3658,1470,2188,1784067.73,2653068.79,4437136.52
351910,202204,161,70,91,84840,110292,195132
351920,202204,111,59,52,71508,63024,134532
351925,202204,89,55,34,66660.2,41208,107868.2
351930,202204,424,271,153,328452.7,185436,513888.7
351940,202204,239,98,141,118776,170892,289668
351950,202204,142,73,69,88476,83628,172104
351960,202204,928,447,481,542978.84,585396.95,1128375.79
351970,202204,2087,997,1090,1208364.6,1321080.6,2529445.2
351980,202204,156,71,85,86052,103020,189072
351990,202204,254,162,92,196345.2,112716,309061.2
352000,202204,319,200,119,242400.6,144228,386628.6
352010,202204,424,273,151,333379.53,183012.93,516392.46
352020,202204,191,68,123,82416,149076,231492
352030,202204,1165,552,613,669024,744169.1,1413193.1
352040,202204,626,239,387,290880,469044,759924
352042,202204,316,79,237,95748,288457.3,384205.3
352044,202204,363,208,155,252097.53,187860,439957.53
352050,202204,3273,1193,2080,1445918.85,2525808.96,3971727.81
352060,202204,98,57,41,69084,49692,118776
352070,202204,91,64,27,77569.9,32724,110293.9
352080,202204,66,41,25,49692,30300,79992
352090,202204,171,111,60,135744,73932,209676
352100,202204,296,139,157,168468,192708.6,361176.6
352110,202204,113,34,79,41208,95748,136956
352115,202204,61,21,40,25452,49692,75144
352120,202204,70,47,23,56964.95,27876,84840.95
352130,202204,215,161,54,195132.1,65448,260580.1
352140,202204,181,83,98,101808.2,118776,220584.2
352150,202204,123,64,59,77568,71508,149076
352160,202204,142,89,53,107868,64236,172104
352170,202204,400,272,128,329664.6,156348,486012.6
352180,202204,688,418,270,506617.84,327240.6,833858.44
352190,202204,248,101,147,122412,178164.1,300576.1
352200,202204,29,11,18,13332,21816,35148
352210,202204,4402,1749,2653,2121003.8,3219074.09,5340077.89
352215,202204,71,39,32,47268,38784,86052
352220,202204,6376,2342,4034,2842142.94,4895274.05,7737416.99
352230,202204,3476,2196,1280,2665198.49,1551362.86,4216561.35
352240,202204,2685,1502,1183,1820426.64,1435008.8,3255435.44
352250,202204,3290,1458,1832,1767098.79,2220384.6,3987483.39
352260,202204,1017,538,479,652056.9,581760.8,1233817.7
352265,202204,63,34,29,41208,35148,76356
352270,202204,384,210,174,254520.6,210888.93,465409.53
352280,202204,493,293,200,356329.55,243612,599941.55
352290,202204,173,100,73,121200,88476,209676
352300,202204,100,63,37,76356,44844,121200
352310,202204,6997,2996,4001,3632370.79,4854063.54,8486434.33
352320,202204,1151,593,558,718717.32,676296.8,1395014.12
352330,202204,536,273,263,330876.6,318756,649632.6
352340,202204,1358,619,739,750232.32,896883.46,1647115.78
352350,202204,365,201,164,243612,198768,442380
352360,202204,216,99,117,121200,141804,263004
352370,202204,114,67,47,81204,56964,138168
352380,202204,112,79,33,95748.6,39996,135744.6
352390,202204,2619,1127,1492,1368350.4,1815577.28,3183927.68
352400,202204,536,230,306,278760.07,370872.6,649632.67
352410,202204,927,610,317,740536.64,386629.91,1127166.55
352420,202204,87,66,21,79992,25452,105444
352430,202204,1774,779,995,945363.67,1207154.8,2152518.47
352440,202204,3426,1586,1840,1925872.57,2232504.75,4158377.32
352450,202204,209,160,49,193920,59388.72,253308.72
352460,202204,637,314,323,380568.3,391476,772044.3
352470,202204,654,237,417,287245.6,505404,792649.6
352480,202204,1563,853,710,1035050.5,861732,1896782.5
352490,202204,49,18,31,21816,37572,59388
352500,202204,1289,514,775,624180.3,939300,1563480.3
352510,202204,710,367,343,444804.6,415716.7,860521.3
352520,202204,855,362,493,439956,597516.8,1037472.8
352530,202204,1851,941,910,1142920.35,1102921.4,2245841.75
352540,202204,68,44,24,53328,29088,82416
352550,202204,205,116,89,140592,107868,248460
352560,202204,48,37,11,44844,13332,58176
352570,202204,725,341,384,413295.17,465408.58,878703.75
352580,202204,53,41,12,49692,14544,64236
352585,202204,23,6,17,7272,20604,27876
352590,202204,4405,2140,2265,2594897.85,2750135.64,5345033.49
352600,202204,361,251,110,305424.2,133320,438744.2
352610,202204,916,403,513,488436.4,622968.2,1111404.6
352620,202204,1105,409,696,496920,845976,1342896
352630,202204,189,71,118,86052,143016,229068
352640,202204,512,326,186,396324,225432.6,621756.6
352650,202204,84,64,20,77568,24240,101808
352660,202204,67,38,29,46056,35148,81204
352670,202204,1720,905,815,1098074.97,991416.5,2089491.47
352680,202204,945,574,371,696901.1,450865.9,1147767.0
352690,202204,4649,2021,2628,2451884.02,3187561.49,5639445.51
352700,202204,87,50,37,60600,44844,105444
352710,202204,1519,777,742,942939.85,899304,1842243.85
352720,202204,1529,643,886,779317.15,1073836.16,1853153.31
352725,202204,24,19,5,23028,6060,29088
352730,202204,393,188,205,229068,248460,477528
352740,202204,400,259,141,313909.44,170892.49,484801.93
352750,202204,23,15,8,18180,9696,27876
352760,202204,215,136,79,164832.6,95748,260580.6
352770,202204,79,60,19,73932,23028,96960
352780,202204,74,38,36,46056,43632,89688
352790,202204,24,18,6,21816.2,7272,29088.2
352800,202204,236,178,58,215736.18,70296,286032.18
352810,202204,163,101,62,122412,75144,197556
352820,202204,47,35,12,42420,14544,56964
352830,202204,75,50,25,60600,30300,90900
352840,202204,695,308,387,373297.4,469044,842341.4
352850,202204,1761,527,1234,639936.48,1496820,2136756.48
352860,202204,114,71,43,86052,52116,138168
352870,202204,51,31,20,38784,24240,63024
352880,202204,176,103,73,126049.41,88476,214525.41
352885,202204,33,22,11,26664,13332,39996
352890,202204,54,34,20,41208,24240.6,65448.6
352900,202204,4658,2177,2481,2643380.25,3014245.64,5657625.89
352910,202204,35,29,6,35148,7272,42420
352920,202204,644,372,272,450865.96,330876.86,781742.82
352930,202204,1200,555,645,673875.07,781740,1455615.07
352940,202204,6263,2377,3886,2880931.31,4713468.6,7594399.91
352950,202204,116,45,71,54540,86052,140592
352960,202204,66,40,26,48480,31512,79992
352965,202204,15,9,6,10908,7272,18180
352970,202204,520,379,141,460561.7,170892,631453.7
352980,202204,164,94,70,113928.4,84840,198768.4
352990,202204,976,453,523,549037.23,633876,1182913.23
353000,202204,54,22,32,26664,38784,65448
353010,202204,514,312,202,378144,246036,624180
353020,202204,322,219,103,265428,124836,390264
353030,202204,1386,605,781,733262.66,946574.96,1679837.62
353040,202204,86,46,40,55752,48480,104232
353050,202204,1319,858,461,1039899.33,559944,1599843.33
353060,202204,8949,3771,5178,4576525.99,6285433.2,10861959.19
353070,202204,1920,1119,801,1356233.62,971808.8,2328042.42
353080,202204,1310,706,604,855675.07,733260,1588935.07
353090,202204,64,34,30,41208.2,36360,77568.2
353100,202204,42,32,10,38784,12120,50904
353110,202204,2200,699,1501,847189.78,1819212.63,2666402.41
353120,202204,136,70,66,86052,79992,166044
353130,202204,863,408,455,496921.23,553884.15,1050805.38
353140,202204,574,251,323,304213.25,392688,696901.25
353150,202204,326,170,156,206041.31,190284.6,396325.91
353160,202204,108,82,26,99384,31512,130896
353170,202204,205,66,139,79992,168468,248460
353180,202204,1177,524,653,636301.5,792648.8,1428950.3
353190,202204,492,350,142,424201.4,172104,596305.4
353200,202204,251,118,133,143016,161196,304212
353205,202204,19,12,7,14544,8484,23028
353210,202204,68,40,28,48480,33936,82416
353215,202204,41,23,18,27876,21816,49692
353220,202204,84,45,39,54540,47268,101808
353230,202204,154,64,90,77568.2,109080,186648.2
353240,202204,370,171,199,207252.1,241188,448440.1
353250,202204,195,96,99,116352,119988,236340
353260,202204,457,298,159,361176.28,192708.85,553885.13
353270,202204,73,54,19,65448.5,23028,88476.5
353280,202204,106,48,58,58176.4,70296,128472.4
353282,202204,122,84,38,101808,46056,147864
353284,202204,28,19,9,23028,10908,33936
353286,202204,7,3,4,3636,4848,8484
353290,202204,85,44,41,53328,49692,103020
353300,202204,441,224,217,271489.6,263004.6,534494.2
353310,202204,40,33,7,39996,8484,48480
353320,202204,41,26,15,31512,18180,49692
353325,202204,43,25,18,30300.6,21816,52116.6
353330,202204,64,43,21,52116.8,25452,77568.8
353340,202204,681,229,452,277548.5,547825.35,825373.85
353350,202204,920,445,475,539341.4,576912.99,1116254.39
353360,202204,103,82,21,99384,25452,124836
353370,202204,110,63,47,76356,56964,133320
353380,202204,26,12,14,14544,16968,31512
353390,202204,1125,519,606,629029.54,734472.6,1363502.14
353400,202204,47,28,19,33936,23028.4,56964.4
353410,202204,116,64,52,77568,63024.6,140592.6
353420,202204,52,21,31,25452,37572,63024
353430,202204,577,378,199,460561.45,241188.48,701749.93
353440,202204,12361,5259,7102,6378761.32,8623383.26,15002144.58
353450,202204,57,30,27,36360,32724,69084
353460,202204,639,323,316,391477,382992.5,774469.5
353470,202204,2290,1105,1185,1340479.34,1441068.3,2781547.64
353475,202204,275,177,98,214524.98,118776,333300.98
353480,202204,178,141,37,170892,44844,215736
353490,202204,223,130,93,157560,112716.6,270276.6
353500,202204,211,118,93,143016,113928,256944
353510,202204,83,55,28,66660.5,33936,100596.5
353520,202204,229,164,65,198768.2,78780.6,277548.8
353530,202204,463,237,226,287244.74,275124,562368.74
353540,202204,407,253,154,306636.7,187860,494496.7
353550,202204,736,462,274,559946.35,332088.9,892035.25
353560,202204,561,226,335,275124,406020.4,681144.4
353570,202204,62,40,22,48480.1,26664,75144.1
353580,202204,348,227,121,275124,146652,421776
353590,202204,84,58,26,70296,31512,101808
353600,202204,270,155,115,189072.95,140592,329664.95
353610,202204,129,68,61,82416,73932,156348
353620,202204,677,336,341,408444.6,414504,822948.6
353625,202204,52,28,24,33936,29088,63024
353630,202204,212,150,62,183012.52,75144,258156.52
353640,202204,124,80,44,96960.16,53328.5,150288.66
353650,202204,1007,383,624,464196,757500,1221696
353657,202204,22,18,4,21816,4848,26664
353660,202204,284,147,137,178164,166044,344208
353670,202204,711,407,304,495709.95,369660.6,865370.55
353680,202204,131,89,42,107868,50904.6,158772.6
353690,202204,40,27,13,32724,15756,48480
353700,202204,282,197,85,238764.8,105444,344208.8
353710,202204,495,232,263,281184,318757.2,599941.2
353715,202204,48,29,19,35148,23028,58176
353720,202204,338,156,182,189073.2,220584,409657.2
353730,202204,1175,707,468,858097.14,567216.2,1425313.34
353740,202204,605,331,274,401173.35,332090.62,733263.97
353750,202204,69,39,30,47268,36360,83628
353760,202204,3226,1206,2020,1461675.46,2449453.51,3911128.97
353770,202204,77,63,14,76356,16968,93324
353780,202204,1357,618,739,749018.05,895668,1644686.05
353790,202204,488,289,199,350268.34,241188.2,591456.54
353800,202204,3609,1681,1928,2038614.44,2337950.6,4376565.04
353810,202204,232,115,117,139380.6,141804.2,281184.8
353820,202204,243,97,146,117564,176952.6,294516.6
353830,202204,61,49,12,59388,14544,73932
353850,202204,197,87,110,106656,134532,241188
353860,202204,531,226,305,273912.8,369660,643572.8
353870,202204,5666,2844,2822,3449364.29,3428751.28,6878115.57
353880,202204,718,462,256,561156.8,310272,871428.8
353890,202204,569,323,246,391476.4,298154.7,689631.1
353900,202204,133,69,64,83628,77568,161196
353910,202204,192,77,115,93324,139380,232704
353920,202204,430,225,205,272700.2,248460,521160.2
353930,202204,1064,622,442,753864.33,535705.2,1289569.53
353940,202204,197,95,102,115140,123624,238764
353950,202204,494,309,185,374508,225432,599940
353960,202204,73,59,14,71508,16968,88476
353970,202204,39,27,12,32724,14544,47268
353980,202204,1862,822,1040,997477.3,1261693.7,2259171.0
353990,202204,79,46,33,55752.2,39996,95748.2
354000,202204,381,173,208,209676.2,252096,461772.2
354010,202204,90,51,39,61812,47268,109080
354020,202204,511,319,192,386628.2,232704,619332.2
354025,202204,36,30,6,36360,7272,43632
354030,202204,44,24,20,29088,24240,53328
354040,202204,101,74,27,89688,32724,122412
354050,202204,175,93,82,112716.4,99384,212100.4
354060,202204,781,359,422,435108,511464,946572
354070,202204,937,529,408,641148.81,495708.62,1136857.43
354075,202204,186,86,100,104232,121200.2,225432.2
354080,202204,311,137,174,166044,210888,376932
354085,202204,21,13,8,15756.5,9696,25452.5
354090,202204,265,158,107,191393,129684,321077
354100,202204,5920,2390,3530,2900317.72,4283215.11,7183532.83
354105,202204,98,47,51,56964,61812,118776
354110,202204,42,20,22,24240,26664,50904
354120,202204,151,97,54,117564.39,65448,183012.39
354130,202204,720,430,290,522374.81,351480,873854.81
354140,202204,3298,1473,1825,1786493.7,2214326.11,4000819.81
354150,202204,635,358,277,433899.81,335724.35,769624.16
354160,202204,661,421,240,510254.68,290881.86,801136.54
354165,202204,12,10,2,12120.88,2424,14544.88
354170,202204,172,115,57,139380.2,69084,208464.2
354180,202204,55,32,23,38784,27876,66660
354190,202204,201,78,123,94536,149076.95,243612.95
354200,202204,111,54,57,65448,69084,134532
354210,202204,74,32,42,38784,50904,89688
354220,202204,613,388,225,471470.75,276336,747806.75
354230,202204,170,71,99,86052.5,119988,206040.5
354240,202204,330,207,123,250884.75,149076,399960.75
354250,202204,82,49,33,59388,41208,100596
354260,202204,2178,1015,1163,1232607,1410771.06,2643378.06
354270,202204,85,58,27,70296,32724,103020
354280,202204,53,28,25,33936,30300,64236
354290,202204,139,93,46,112716,55752.1,168468.1
354300,202204,340,238,102,288457.15,123624,412081.15
354310,202204,88,63,25,76356.6,31512,107868.6
354320,202204,213,105,108,127260.2,130896,258156.2
354323,202204,8,8,0,9696,,9696.0
354325,202204,129,67,62,81204.5,75144,156348.5
354330,202204,2463,817,1646,990033.41,1994953.52,2984986.93
354340,202204,10508,4776,5732,5797969.13,6953248.45,12751217.58
354350,202204,140,93,47,112716,58176,170892
354360,202204,72,42,30,50904.1,36360,87264.1
354370,202204,235,117,118,141804.2,143016,284820.2
354380,202204,173,98,75,118776,90900,209676
354390,202204,2762,973,1789,1181702.13,2173116.1,3354818.23
354400,202204,315,171,144,207252.95,174528,381780.95
354410,202204,667,297,370,359965.76,449653.58,809619.34
354420,202204,278,180,98,218160.2,118776,336936.2
354425,202204,327,179,148,217004.4,179376,396380.4
354430,202204,181,97,84,117564,101808,219372
354440,202204,30,24,6,29088,7272,36360
354450,202204,54,36,18,43632,21816,65448
354460,202204,94,54,40,65448,48480,113928
354470,202204,26,13,13,15756,15756,31512
354480,202204,111,58,53,70296.5,64236,134532.5
354490,202204,131,76,55,92112.9,66660,158772.9
354500,202204,406,181,225,219372,272700.8,492072.8
354510,202204,91,61,30,73932,36360,110292
354515,202204,47,15,32,18180,38784,56964
354520,202204,1606,682,924,827623.79,1119888.2,1947511.99
354530,202204,855,412,443,499345.95,536916.1,1036262.05
354540,202204,263,130,133,158772,161196,319968
354550,202204,42,22,20,26664,24240,50904
354560,202204,152,82,70,99384,84840,184224
354570,202204,136,91,45,111504,54540,166044
354580,202204,1879,882,997,1070199.49,1209576,2279775.49
354600,202204,279,136,143,164832,173316,338148
354610,202204,67,54,13,65448,15756,81204
354620,202204,66,17,49,20604,60600,81204
354625,202204,12,8,4,9696.5,4848,14544.5
354630,202204,330,216,114,261793.99,138168,399961.99
354640,202204,838,498,340,603576,412080,1015656
354650,202204,64,37,27,44844,32724,77568
354660,202204,816,595,221,721142.49,267852,988994.49
354670,202204,223,82,141,99384,170892,270276
354680,202204,1336,468,868,567216,1052016,1619232
354690,202204,71,48,23,58176.8,27876,86052.8
354700,202204,74,52,22,63024,26664,89688
354710,202204,49,34,15,41208,18180,59388
354720,202204,19,18,1,21816,1212,23028
354730,202204,1801,726,1075,881124.7,1302900,2184024.7
354740,202204,73,49,24,59388,29088,88476
354750,202204,411,229,182,277548.2,220584,498132.2
354760,202204,500,307,193,374511.08,233916,608427.08
354765,202204,6,2,4,2424,4848,7272
354770,202204,348,223,125,272700.3,152712.1,425412.4
354780,202204,8485,3149,5336,3817806.37,6470871.54,10288677.91
354790,202204,87,52,35,63024,42420,105444
354800,202204,435,234,201,283559.27,243612,527171.27
354805,202204,79,37,42,44844,50904.68,95748.68
354810,202204,95,54,41,65448,49692,115140
354820,202204,211,84,127,101808.64,153924,255732.64
354830,202204,41,21,20,25452,24240,49692
354840,202204,56,39,17,47268,20604,67872
354850,202204,4564,1981,2583,2404614.93,3133020.66,5537635.59
354860,202204,333,152,181,184224,219372,403596
354870,202204,12112,5173,6939,6274537.04,8416135.3,14690672.34
354880,202204,2688,971,1717,1176852.86,2083487.64,3260340.50
354890,202204,2966,1539,1427,1868910.59,1730736.5,3599647.09
354900,202204,65,45,20,54540,24240,78780
354910,202204,1290,655,635,793861.98,769620,1563481.98
354920,202204,39,32,7,38784,8484,47268
354925,202204,20,10,10,12120,12120,24240
354930,202204,32,28,4,33936.4,6060,39996.4
354940,202204,767,534,233,647210.26,284820.63,932030.89
354950,202204,214,130,84,157562.26,101808,259370.26
354960,202204,132,51,81,61812,98172,159984
354970,202204,1114,756,358,916277.09,433896.6,1350173.69
354980,202204,9353,3309,6044,4014156.41,7337452.49,11351608.90
354990,202204,10173,4413,5760,5353410.61,6985972.01,12339382.62
354995,202204,584,188,396,227857.4,479952,707809.4
355000,202204,454,156,298,189072.2,361176,550248.2
355010,202204,614,377,237,456925.1,287246.35,744171.45
355020,202204,791,487,304,590244.76,369661.09,959905.85
355030,202204,214851,79342,135509,96247546.95,164416392.7,260663939.65
355040,202204,928,442,486,535706.7,591456.5,1127163.2
355050,202204,175,96,79,116352,95748,212100
355060,202204,1772,838,934,1019295.14,1132009.34,2151304.48
355070,202204,1590,690,900,836280.78,1092014.57,1928295.35
355080,202204,197,116,81,140592,98172,238764
355090,202204,300,176,124,214524.6,150288.7,364813.3
355100,202204,5354,2477,2877,3005643.45,3491772.9,6497416.35
355110,202204,229,150,79,181800,96960,278760
355120,202204,57,35,22,42420,26664,69084
355130,202204,52,29,23,35148,27876,63024
355140,202204,193,113,80,136956,96960,233916
355150,202204,690,401,289,486013.78,350268.1,836281.88
355160,202204,479,227,252,275124.95,306636,581760.95
355170,202204,2088,1067,1021,1295629.69,1238664.3,2534293.99
355180,202204,696,270,426,328452.35,516312.2,844764.55
355190,202204,222,152,70,184224,84840.2,269064.2
355200,202204,116,56,60,67872,72720.6,140592.6
355210,202204,711,381,330,461772,399960,861732
355220,202204,7672,3680,3992,4467442.11,4840733.49,9308175.60
355230,202204,98,55,43,67872,52116,119988
355240,202204,4661,1864,2797,2261594.6,3392392.34,5653986.94
355250,202204,6661,2876,3785,3489382.22,4593482,8082864.22
355255,202204,49,31,18,37572,21816,59388
355260,202204,188,106,82,128472.8,99384,227856.8
355270,202204,162,102,60,123624.6,72720,196344.6
355280,202204,7025,2582,4443,3131812.86,5388557.16,8520370.02
355290,202204,69,54,15,65448,18180,83628
355300,202204,230,129,101,157560,122412,279972
355310,202204,113,57,56,69084,67872,136956
355320,202204,93,47,46,56964.6,55752,112716.6
355330,202204,313,179,134,218160.53,162408,380568.53
355340,202204,1406,488,918,593883.12,1117468.95,1711352.07
355350,202204,164,79,85,95748,103020,198768
355360,202204,166,106,60,128472,72720,201192
355365,202204,18,13,5,15756,6060,21816
355370,202204,1027,609,418,738110.29,507828,1245938.29
355380,202204,827,510,317,619333.25,384204.2,1003537.45
355385,202204,85,56,29,67872,35148,103020
355390,202204,107,54,53,65448,64236,129684
355395,202204,192,100,92,121200.78,111504,232704.78
355400,202204,1770,1006,764,1219177.41,927180.95,2146358.36
355410,202204,5079,2300,2779,2793668.72,3372997.96,6166666.68
355420,202204,44,31,13,37572,15756,53328
355430,202204,413,247,166,299365.7,201192.1,500557.8
355440,202204,86,51,35,61812,42420,104232
355450,202204,441,218,223,264216,270276.1,534492.1
355460,202204,58,43,15,52116,18180,70296
355465,202204,52,30,22,36360,26664,63024
355470,202204,191,74,117,89688.8,141804.5,231493.3
355475,202204,9,6,3,7272,3636,10908
355480,202204,610,244,366,295728,443592.17,739320.17
355490,202204,111,77,34,93324,41208,134532
355495,202204,85,30,55,36360,66660,103020
355500,202204,1604,854,750,1037477.27,912637.32,1950114.59
355510,202204,274,194,80,235130.55,98172,333302.55
355520,202204,28,21,7,25452,8484,33936
355530,202204,24,12,12,14544,14544,29088
355535,202204,76,33,43,39996,52116,92112
355540,202204,2719,1053,1666,1277620.09,2024040.16,3301660.25
355550,202204,62,35,27,42420,32724,75144
355560,202204,247,108,139,130896.91,168468,299364.91
355570,202204,15,10,5,12120,6060,18180
355580,202204,241,160,81,195132.1,98172.6,293304.7
355590,202204,18,11,7,13332,8484,21816
355600,202204,269,132,137,159984,166044,326028
355610,202204,235,144,91,174528,110292.85,284820.85
355620,202204,1298,565,733,684780.8,888396.6,1573177.4
355630,202204,419,300,119,363600.2,144228,507828.2
355635,202204,126,53,73,64236,88476,152712
355640,202204,556,291,265,352692.1,321180.54,673872.64
355645,202204,901,325,576,395112.2,698113.3,1093225.5
355650,202204,1907,806,1101,978086.72,1334412.2,2312498.92
355660,202204,233,121,112,146652,135744,282396
355670,202204,637,267,370,323604,448440,772044
355680,202204,197,109,88,132108,106656,238764
355690,202204,93,47,46,56964,55752,112716
355695,202204,26,16,10,19392,12120,31512
355700,202204,1217,613,604,742957.09,735685.26,1478642.35
355710,202204,2273,1236,1037,1502885.52,1256844.2,2759729.72
355715,202204,13,11,2,13332,2424,15756
355720,202204,256,157,99,190284.36,121200,311484.36
355730,202204,105,61,44,73932,53328,127260
410010,202204,131,104,27,126048.2,32724,158772.2
410020,202204,116,83,33,100596,39996,140592
410030,202204,168,91,77,110292,93324,203616
410040,202204,1332,648,684,786588.6,829008,1615596.6
410045,202204,45,34,11,41208,13332,54540
410050,202204,512,293,219,355116,265428,620544
410060,202204,285,205,80,249672,96960,346632
410070,202204,287,245,42,296940,50904,347844
410080,202204,181,109,72,132108,87264,219372
410090,202204,61,51,10,61812,12120,73932
410100,202204,260,167,93,203616,112716,316332
410105,202204,48,28,20,33936,24240,58176
410110,202204,347,209,138,253308.4,168468,421776.4
410115,202204,46,29,17,35148,20604,55752
410120,202204,442,204,238,248460,288456,536916
410130,202204,58,30,28,36360,33936,70296
410140,202204,3202,1443,1759,1750129.72,2133124.62,3883254.34
410150,202204,2692,1076,1616,1305326.63,1961017.95,3266344.58
410160,202204,481,275,206,333300,249672,582972
410165,202204,50,29,21,35148,25452,60600
410170,202204,202,121,81,147864,98172,246036
410180,202204,2318,1242,1076,1508942.7,1304112.72,2813055.42
410185,202204,34,28,6,33936,7272,41208
410190,202204,485,307,178,373296.3,215736,589032.3
410200,202204,989,705,284,854460.87,344208,1198668.87
410210,202204,626,322,304,390264,368448.2,758712.2
410220,202204,49,20,29,25452,35148,60600
410230,202204,184,82,102,99384,123624,223008
410240,202204,731,460,271,558733.07,328452.2,887185.27
410250,202204,382,265,117,321180,141804,462984
410260,202204,300,166,134,201192,162408,363600
410270,202204,30,22,8,26664,9696,36360
410275,202204,62,46,16,55752,19392,75144
410280,202204,318,184,134,223008,162408,385416
410290,202204,282,158,124,191496.2,150288,341784.2
410300,202204,88,54,34,65448,41208,106656
410302,202204,25,13,12,15756,14544,30300
410304,202204,39,26,13,31512,15756,47268
410305,202204,228,128,100,155136,121200,276336
410310,202204,190,112,78,135744,94536,230280
410315,202204,43,31,12,37572,14544,52116
410320,202204,136,91,45,110292,54540,164832
410322,202204,34,21,13,26664,15756,42420
410330,202204,173,114,59,138168,71508,209676
410335,202204,97,53,44,64236,53328,117564
410337,202204,44,34,10,41208,12120,53328
410340,202204,38,31,7,37572.11,8484,46056.11
410345,202204,196,115,81,139380,98172,237552
410347,202204,45,33,12,39996,14544,54540
410350,202204,252,144,108,174528.22,130896,305424.22
410360,202204,445,272,173,330876.6,210888.8,541765.4
410370,202204,2354,990,1364,1199881.6,1654381.49,2854263.09
410380,202204,193,113,80,136956,96960,233916
410390,202204,405,264,141,319968,170892,490860
410395,202204,34,22,12,26664,14544,41208
410400,202204,872,367,505,444804.4,612060.6,1056865.0
410405,202204,80,61,19,73932.2,23028,96960.2
410410,202204,23,15,8,18180,9696,27876
410420,202204,1744,782,962,947677.03,1169580.2,2117257.23
410425,202204,187,77,110,93324,133320,226644
410430,202204,2347,1231,1116,1493184.21,1353804,2846988.21
410440,202204,358,253,105,306636,127260,433896
410442,202204,361,225,136,272700,164832,437532
410445,202204,416,285,131,346632,158772,505404
410450,202204,385,181,204,219372,247248,466620
410460,202204,556,290,266,351480,322392,673872
410465,202204,254,136,118,164832.1,143016.6,307848.7
410470,202204,272,148,124,181800,150288,332088
410480,202204,6638,3179,3459,3857800.84,4197160.58,8054961.42
410490,202204,1414,802,612,973236.9,742957.1,1716194.0
410500,202204,275,155,120,187860,145440,333300
410510,202204,186,139,47,168468.2,56964,225432.2
410520,202204,267,190,77,230280,93324,323604
410530,202204,299,94,205,113928,248460,362388
410540,202204,341,248,93,300576.04,113928,414504.04
410550,202204,1710,704,1006,853248,1221696.6,2074944.6
410560,202204,164,110,54,133320,65448,198768
410570,202204,443,292,151,355116.88,183012,538128.88
410580,202204,3692,1531,2161,1859210.54,2622769,4481979.54
410590,202204,427,272,155,329643,187860.2,517503.2
410600,202204,194,169,25,204828,30300,235128
410610,202204,50,40,10,48480,12120,60600
410620,202204,266,168,98,203616.1,118777.26,322393.36
410630,202204,455,252,203,305424.6,247248,552672.6
410640,202204,1056,650,406,787801.81,493284.9,1281086.71
410645,202204,114,82,32,99384.94,39996,139380.94
410650,202204,369,224,145,271488,175740,447228
410655,202204,85,61,24,73932,30300,104232
410657,202204,37,14,23,16968,27876,44844
410660,202204,645,434,211,527221.39,256944,784165.39
410670,202204,80,65,15,78780,18180,96960
410680,202204,186,151,35,183012,42420,225432
410685,202204,27,17,10,20604,12120,32724
410690,202204,28770,11827,16943,14344033.01,20559171.86,34903204.87
410700,202204,328,239,89,289668,107868,397536
410710,202204,129,104,25,126048,30300.2,156348.2
410712,202204,43,31,12,37572,14544,52116
410715,202204,94,68,26,82416.76,31512,113928.76
410720,202204,653,371,282,449652.8,341784.5,791437.3
410725,202204,189,134,55,162408,66660,229068
410730,202204,104,47,57,56964,69084,126048
410740,202204,97,70,27,84840,32724,117564
410750,202204,283,185,98,224221.41,118776,342997.41
410752,202204,19,13,6,15756,7272,23028
410753,202204,60,24,36,29088,43632,72720
410754,202204,53,26,27,31512,32724,64236
410755,202204,74,42,32,50904,38784,89688
410760,202204,767,412,355,499344.2,431472.2,930816.4
410765,202204,1894,849,1045,1030203.14,1267753.7,2297956.84
410770,202204,114,82,32,99384,38784,138168
410773,202204,65,44,21,53328,25452,78780
410775,202204,174,129,45,156348,54540,210888
410780,202204,86,46,40,55752,48480,104232
410785,202204,52,43,9,53328,10908,64236
410790,202204,86,38,48,46056,58176,104232
410800,202204,285,176,109,213312,132108.6,345420.6
410810,202204,31,17,14,20604,16968.6,37572.6
410820,202204,156,110,46,134532,55752,190284
410830,202204,9089,3792,5297,4599546.76,6422390.25,11021937.01
410832,202204,118,73,45,89688,54540,144228
410840,202204,1437,761,676,924756.21,819313.8,1744070.01
410845,202204,51,28,23,33936,27876,61812
410850,202204,168,124,44,150288,54540,204828
410855,202204,72,63,9,76356,10908.4,87264.4
410860,202204,789,405,384,492152.8,466620.6,958773.4
410865,202204,100,69,31,84840.6,37572,122412.6
410870,202204,146,119,27,145440,32724,178164
410880,202204,1176,576,600,699325.2,727200.6,1426525.8
410890,202204,99,63,36,76356.1,43632,119988.1
410895,202204,75,55,20,66660,24240,90900
410900,202204,30,23,7,27876,8484,36360
410910,202204,15,9,6,10908,7272,18180
410920,202204,43,28,15,33936,18180,52116
410930,202204,552,332,220,403596,266640,670236
410940,202204,4448,2302,2146,2791238.46,2604590.36,5395828.82
410950,202204,102,77,25,93324,30300,123624
410960,202204,901,344,557,416928.95,676296.2,1093225.15
410965,202204,61,39,22,47268,26664,73932
410970,202204,615,416,199,504192,241188,745380
410975,202204,121,75,46,90900.58,55752,146652.58
410980,202204,1640,732,908,888397.2,1100497.01,1988894.21
410990,202204,273,201,72,243612,87264,330876
411000,202204,63,35,28,42420,33936.6,76356.6
411005,202204,32,25,7,30300,8484,38784
411007,202204,249,139,110,168468,133320,301788
411010,202204,603,391,212,473892.29,258156.1,732048.39
411020,202204,289,181,108,220584.3,130896,351480.3
411030,202204,25,14,11,16968,13332,30300
411040,202204,59,38,21,46056,25452,71508
411050,202204,217,152,65,184224.6,78780,263004.6
411060,202204,534,360,174,436321.92,212100,648421.92
411065,202204,46,42,4,50904.6,4848,55752.6
411070,202204,1292,730,562,884760.73,681144.2,1565904.93
411080,202204,241,169,72,206040,87264,293304
411090,202204,90,67,23,81204,27876,109080
411095,202204,341,119,222,144228,269064,413292
411100,202204,111,86,25,104232,30300,134532
411110,202204,139,82,57,99384,69084,168468
411120,202204,203,131,72,158772,87264,246036
411125,202204,301,140,161,169680.92,195132,364812.92
411130,202204,116,98,18,118777.93,21816,140593.93
411140,202204,213,145,68,176952,83628,260580
411150,202204,1248,800,448,969600,544189.55,1513789.55
411155,202204,120,83,37,101808,44844,146652
411160,202204,31,13,18,15756,21816,37572
411170,202204,51,46,5,55752,6060,61812
411180,202204,990,645,345,782955.04,418140,1201095.04
411190,202204,337,182,155,221796,187860,409656
411200,202204,659,376,283,455712.95,342996,798708.95
411210,202204,685,348,337,421776,409656.25,831432.25
411220,202204,159,111,48,134532.67,58176,192708.67
411230,202204,38,30,8,36360,9696,46056
411240,202204,113,68,45,82416,54540,136956
411250,202204,425,307,118,373296,143016,516312
411260,202204,14,10,4,12120,4848,16968
411270,202204,266,134,132,163620,159984.1,323604.1
411275,202204,185,158,27,191496.6,32724,224220.6
411280,202204,200,142,58,172104.95,70296,242400.95
411290,202204,68,55,13,66660,15756,82416
411295,202204,122,95,27,115140,32724,147864
411300,202204,77,36,41,43632,49692,93324
411310,202204,94,66,28,79992,33936,113928
411320,202204,812,509,303,618120.36,367236.8,985357.16
411325,202204,64,45,19,54540,23028,77568
411330,202204,895,575,320,698112.8,387840.2,1085953.0
411340,202204,35,23,12,29088,14544,43632
411342,202204,60,45,15,54540,18180,72720
411345,202204,104,50,54,60600,66660,127260
411350,202204,506,376,130,455713.12,157560.6,613273.72
411360,202204,60,39,21,47268,25452,72720
411370,202204,13989,5631,8358,6829632.37,10138391.03,16968023.40
411373,202204,179,118,61,143016,73932,216948
411375,202204,77,61,16,73932,19392,93324
411380,202204,77,54,23,65448,27876,93324
411390,202204,137,76,61,92112,73932,166044
411400,202204,420,276,144,335724,175740,511464
411410,202204,504,233,271,282396,328453.55,610849.55
411420,202204,970,398,572,482376.96,693264,1175640.96
411430,202204,518,281,237,340572.65,287244,627816.65
411435,202204,29,17,12,20604,14544,35148
411440,202204,466,368,98,447228,118776,566004
411450,202204,401,335,66,406020,79992,486012
411460,202204,804,301,503,366024.52,610848,976872.52
411470,202204,111,76,35,92112,42420,134532
411480,202204,704,361,343,437532.81,416928,854460.81
411490,202204,284,175,109,212100,132108,344208
411500,202204,99,79,20,95748,24240,119988
411510,202204,225,176,49,214524,59388,273912
411520,202204,6186,2114,4072,2567019.17,4937689.4,7504708.57
411530,202204,119,79,40,95748,48480,144228
411535,202204,47,14,33,16968,39996,56964
411540,202204,372,248,124,301788,150288,452076
411545,202204,58,42,16,50904,19392,70296
411550,202204,92,70,22,84840,26664,111504
411560,202204,403,161,242,195132,294516,489648
411570,202204,943,316,627,382992.32,759924.5,1142916.82
411573,202204,25,16,9,19392,10908,30300
411575,202204,321,195,126,236340,152712,389052
411580,202204,1248,446,802,541764.6,973236,1515000.6
411585,202204,73,36,37,43632,44844,88476
411590,202204,17,11,6,13332,7272,20604
411600,202204,21,9,12,10908,14544.1,25452.1
411605,202204,245,90,155,109080,187860,296940
411610,202204,233,145,88,175740,106656,282396
411620,202204,389,183,206,221796.4,249672.2,471468.6
411630,202204,46,32,14,38784,16968,55752
411640,202204,32,23,9,29088,10908,39996
411650,202204,8,5,3,6060,3636,9696
411660,202204,41,30,11,36360,13332,49692
411670,202204,244,170,74,206040,89688,295728
411680,202204,156,127,29,153924,35148,189072
411690,202204,610,315,295,382992.1,359964,742956.1
411695,202204,69,51,18,61812,21816,83628
411700,202204,141,112,29,136956,35148,172104
411705,202204,103,67,36,81204.2,43632,124836.2
411710,202204,296,197,99,238764,119988,358752
411720,202204,147,97,50,117564,60600,178164
411721,202204,90,72,18,87264,21816,109080
411722,202204,105,47,58,56964,70296,127260
411725,202204,171,124,47,150288,56964,207252
411727,202204,102,81,21,98172,25452,123624
411729,202204,51,37,14,44844,16968,61812
411730,202204,564,354,210,429048,254520,683568
411740,202204,31,19,12,23028,14544,37572
411745,202204,64,49,15,59388,18180,77568
411750,202204,845,349,496,422988.1,604788,1027776.1
411760,202204,1245,892,353,1083530.81,430260.2,1513791.01
411770,202204,431,280,151,339360,183012,522372
411780,202204,371,237,134,287244.5,163620,450864.5
411790,202204,587,333,254,403596.6,307848,711444.6
411800,202204,152,111,41,134532.65,52116,186648.65
411810,202204,178,135,43,163620,52116,215736
411820,202204,2434,977,1457,1185339.67,1771945.7,2957285.37
411830,202204,15,13,2,15756,2424,18180
411840,202204,2158,1279,879,1552572.43,1067773.76,2620346.19
411845,202204,66,22,44,26664,53328,79992
411850,202204,1259,676,583,820526.54,709020.95,1529547.49
411860,202204,51,30,21,36360.6,25452,61812.6
411870,202204,69,42,27,50904,32724,83628
411880,202204,427,249,178,301788,215736,517524
411885,202204,110,67,43,81204,52116,133320
411890,202204,318,217,101,263005.19,122412,385417.19
411900,202204,107,77,30,94536.6,36360,130896.6
411910,202204,191,136,55,166044,66660.2,232704.2
411915,202204,2385,935,1450,1134432.64,1757400.72,2891833.36
411920,202204,110,84,26,101808.24,31512,133320.24
411925,202204,18,11,7,13332,8484,21816
411930,202204,785,542,243,656984.22,294516.68,951500.90
411940,202204,596,377,219,456924.56,266640,723564.56
411950,202204,1174,532,642,647209.3,779317.71,1426527.01
411960,202204,1133,712,421,862944.2,511464,1374408.2
411965,202204,24,15,9,18180,10908,29088
411970,202204,92,77,15,93324,18180,111504
411980,202204,213,115,98,139380,118776,258156
411990,202204,5172,2767,2405,3353616.1,2919792.27,6273408.37
411995,202204,593,173,420,210888,510252.96,721140.96
412000,202204,325,214,111,259368.4,134532,393900.4
412010,202204,50,27,23,32724,27876,60600
412015,202204,37,30,7,36360,8484,44844
412020,202204,21,16,5,19392,6060,25452
412030,202204,37,33,4,39996,4848,44844
412033,202204,49,28,21,33936,25452,59388
412035,202204,72,46,26,55752,31512,87264
412040,202204,37,17,20,20604.6,24240,44844.6
412050,202204,215,160,55,195132,66660.97,261792.97
412060,202204,791,565,226,684780.2,273912.13,958692.33
412065,202204,51,28,23,33936,27876,61812
412070,202204,161,113,48,136956,58176,195132
412080,202204,327,152,175,184224.1,212100,396324.1
412085,202204,38,14,24,16968,29088,46056
412090,202204,851,522,329,632664.6,398748,1031412.6
412100,202204,263,220,43,266640.6,52116.6,318757.2
412110,202204,70,54,16,65448.8,19392,84840.8
412120,202204,344,184,160,223008,195132,418140
412125,202204,67,41,26,49692,31512,81204
412130,202204,48,30,18,36360.84,21816,58176.84
412135,202204,29,17,12,20604,14544,35148
412140,202204,427,271,156,328452.6,189072,517524.6
412150,202204,239,153,86,185436,104232.9,289668.9
412160,202204,83,54,29,66660,35148,101808
412170,202204,717,473,244,573276,295728,869004
412175,202204,40,28,12,33936,14544,48480
412180,202204,182,134,48,162409.3,58176,220585.3
412190,202204,325,248,77,300577.49,93324,393901.49
412200,202204,190,118,72,143016,87264,230280
412210,202204,96,71,25,86052,30300,116352
412215,202204,234,155,79,189072,96960,286032
412217,202204,67,54,13,65448,15756,81204
412220,202204,833,549,284,665388,344208.2,1009596.2
412230,202204,286,172,114,210888.1,138168,349056.1
412240,202204,1332,652,680,791437.82,826584.6,1618022.42
412250,202204,405,250,155,303000,187860,490860
412260,202204,121,79,42,95748,50904,146652
412265,202204,170,128,42,155136,50904,206040
412270,202204,92,56,36,67872,43632.37,111504.37
412280,202204,88,69,19,83628,23028,106656
412290,202204,88,55,33,66660,39996,106656
412300,202204,204,143,61,173316.85,73932,247248.85
412310,202204,54,43,11,52116,13332,65448
412320,202204,88,68,20,82416.95,24240,106656.95
412330,202204,186,148,38,179376,46056,225432
412340,202204,168,113,55,136956,66660,203616
412350,202204,646,293,353,355116.47,427836.2,782952.67
412360,202204,23,20,3,24240,3636,27876
412370,202204,145,122,23,147864,27876,175740
412380,202204,204,155,49,187860.99,59388,247248.99
412382,202204,64,34,30,41208,36360,77568
412385,202204,151,107,44,129684,53328,183012
412390,202204,314,236,78,287244,95748,382992
412395,202204,64,51,13,61812,15756,77568
412400,202204,99,65,34,78780.2,41208,119988.2
412402,202204,237,123,114,149076.6,138168,287244.6
412405,202204,954,313,641,379356,778104,1157460
412410,202204,967,578,389,699947.6,471468.2,1171415.8
412420,202204,17,16,1,19392,1212,20604
412430,202204,24,22,2,26664,2424,29088
412440,202204,655,329,326,399960.8,395112,795072.8
412450,202204,70,61,9,73932,10908,84840
412460,202204,89,66,23,79992.6,27876,107868.6
412470,202204,212,167,45,202404,54540,256944
412480,202204,149,105,44,127260,53328,180588
412490,202204,167,142,25,172104,30300,202404
412500,202204,403,320,83,387841.16,100596,488437.16
412510,202204,166,138,28,167256,33936,201192
412520,202204,89,58,31,71508,37572,109080
412530,202204,107,53,54,64236,65448,129684
412535,202204,88,68,20,82416,24240,106656
412540,202204,85,40,45,48480,54540.8,103020.8
412545,202204,81,54,27,65448,32724,98172
412550,202204,4045,1625,2420,1971925.3,2939100.8,4911026.1
412555,202204,10,6,4,7272,4848,12120
412560,202204,656,435,221,528433.2,267852,796285.2
412570,202204,813,384,429,465408,519948,985356
412575,202204,93,64,29,77568,36360,113928
412580,202204,178,118,60,143016.8,72720,215736.8
412590,202204,34,29,5,35148,6060,41208
412600,202204,181,124,57,150288.4,69084,219372.4
412610,202204,38,17,21,20604,25452,46056
412620,202204,131,108,23,130896,27876,158772
412625,202204,2107,1031,1076,1253211.65,1306537.81,2559749.46
412627,202204,66,50,16,60600,19392,79992
412630,202204,375,247,128,300576.2,155136.22,455712.42
412635,202204,75,22,53,26664,64236,90900
412640,202204,108,75,33,90900,39996,130896
412650,202204,317,209,108,253308.6,130896,384204.6
412660,202204,456,265,191,321180,231492,552672
412665,202204,43,39,4,47268,4848,52116
412667,202204,292,190,102,230280,123624,353904
412670,202204,71,57,14,69084,16968,86052
412680,202204,327,248,79,300576,95748.12,396324.12
412690,202204,118,77,41,94536,50904,145440
412700,202204,191,124,67,150288,81204,231492
412710,202204,1334,754,580,915061.86,704172,1619233.86
412720,202204,231,127,104,153924,126048,279972
412730,202204,202,171,31,208464,37572,246036
412740,202204,414,209,205,254520,248460.2,502980.2
412750,202204,433,233,200,282396,242400.6,524796.6
412760,202204,343,169,174,204828,210888,415716
412770,202204,2118,1138,980,1379257.54,1191396.6,2570654.14
412780,202204,143,106,37,128472,44844,173316
412785,202204,314,158,156,191496,189072,380568
412788,202204,49,28,21,33936,25452,59388
412790,202204,124,100,24,121200,30300,151500
412795,202204,148,101,47,122412,56964,179376
412796,202204,294,183,111,221796,134532,356328
412800,202204,676,400,276,484800.6,334512,819312.6
412810,202204,3086,1669,1417,2025256.9,1717404.2,3742661.1
412820,202204,958,568,390,689629.9,472680.61,1162310.51
412830,202204,14,12,2,14544,2424,16968
412840,202204,265,179,86,218160,105444,323604
412850,202204,683,424,259,513888,313908,827796
412853,202204,161,74,87,89688,105444,195132
412855,202204,200,106,94,128472.91,113928,242400.91
412860,202204,95,61,34,75144,41208,116352
412862,202204,80,51,29,61812,36360,98172
412863,202204,8,6,2,7272,2424,9696
412865,202204,43,32,11,39996,13332,53328
412870,202204,109,65,44,78780,53328,132108
412880,202204,93,65,28,78780.8,33936,112716.8
420005,202204,41,36,5,43632,6060,49692
420010,202204,364,240,124,290880.16,150288.4,441168.56
420020,202204,93,75,18,90900,21816,112716
420030,202204,27,22,5,26664,6060,32724
420040,202204,91,68,23,82416,27876,110292
420050,202204,57,36,21,43632.2,25452,69084.2
420055,202204,17,16,1,20604,1212,21816
420060,202204,26,19,7,23028,8484,31512
420070,202204,99,84,15,101808,18180,119988
420075,202204,10,10,0,12120,,12120.0
420080,202204,43,37,6,44844,7272,52116
420090,202204,41,33,8,39996,9696,49692
420100,202204,146,123,23,149076.6,27876,176952.6
420110,202204,21,21,0,25452,,25452.0
420120,202204,56,40,16,48480,19392,67872
420125,202204,91,72,19,87264,23028,110292
420127,202204,36,30,6,36360,7272,43632
420130,202204,464,281,183,340572.4,221796.44,562368.84
420140,202204,1318,728,590,884760.4,716293.52,1601053.92
420150,202204,47,34,13,41208,15756,56964
420160,202204,31,28,3,33936,3636,37572
420165,202204,16,11,5,13332,6060,19392
420170,202204,67,42,25,50904,30300,81204
420180,202204,21,18,3,21816,3636,25452
420190,202204,26,24,2,29088,2424,31512
420195,202204,148,66,82,79992.98,99384,179376.98
420200,202204,1307,554,753,671450.36,915060.2,1586510.56
420205,202204,105,62,43,76356,52116,128472
420207,202204,139,75,64,90900,77568,168468
420208,202204,19,15,4,18180,4848,23028
420209,202204,13,11,2,13332,2424,15756
420210,202204,568,263,305,318756.2,369660,688416.2
420213,202204,51,40,11,48480,13332,61812
420215,202204,26,22,4,26664,4848,31512
420220,202204,60,38,22,46056.6,26664,72720.6
420230,202204,938,565,373,685993.51,454500,1140493.51
420240,202204,2273,1492,781,1809518.63,948996.6,2758515.23
420243,202204,44,35,9,42420,10908,53328
420245,202204,196,92,104,111504,126048,237552
420250,202204,63,42,21,50904,25452,76356
420253,202204,26,20,6,24240,7272,31512
420257,202204,13,9,4,10908,4848,15756
420260,202204,117,93,24,113928.1,29088,143016.1
420270,202204,30,23,7,27876,8484,36360
420280,202204,274,206,68,250884.65,82416.8,333301.45
420285,202204,24,18,6,21816,7272,29088
420287,202204,51,35,16,42420,19392,61812
420290,202204,924,629,295,764772,357540,1122312
420300,202204,1526,1209,317,1467736.65,386629.44,1854366.09
420310,202204,45,31,14,37572,16968,54540
420315,202204,30,24,6,29088,7272,36360
420320,202204,1004,462,542,559945.66,656904,1216849.66
420325,202204,4,2,2,2424,2424,4848
420330,202204,119,77,42,93324,50904,144228
420340,202204,184,124,60,150288.8,72720,223008.8
420350,202204,249,171,78,207252.18,94536,301788.18
420360,202204,702,537,165,652057.06,199980,852037.06
420370,202204,135,73,62,88476,75144,163620
420380,202204,1210,835,375,1014445.7,455712,1470157.7
420390,202204,230,160,70,193920,84840,278760
420395,202204,192,142,50,172104,60600,232704
420400,202204,229,174,55,210888.8,66660,277548.8
420410,202204,51,37,14,46056,16968,63024
420415,202204,35,30,5,36360,6060,42420
420417,202204,54,42,12,50904,14544,65448
420419,202204,11,10,1,12120,1212,13332
420420,202204,2829,1754,1075,2125853.74,1302902.25,3428755.99
420425,202204,64,49,15,59388,18180,77568
420430,202204,1061,769,292,934452.8,355116,1289568.8
420435,202204,14,12,2,14544,2424,16968
420440,202204,95,67,28,81204.6,33936,115140.6
420445,202204,31,28,3,33936.1,3636,37572.1
420450,202204,85,42,43,50904,52116,103020
420455,202204,190,149,41,180588.85,49692,230280.85
420460,202204,2324,1449,875,1756191.73,1061712.08,2817903.81
420470,202204,88,61,27,73932,32724,106656
420475,202204,9,8,1,9696,1212,10908
420480,202204,868,658,210,799922.68,255732.2,1055654.88
420490,202204,96,73,23,88476,27876,116352
420500,202204,415,232,183,282396.71,221796,504192.71
420510,202204,25,22,3,26664,3636,30300
420515,202204,28,15,13,18180,15756,33936
420517,202204,7,6,1,7272,1212,8484
420519,202204,0,,,,,0.0
420520,202204,63,47,16,56964,19392,76356
420530,202204,144,93,51,112716,61812,174528
420535,202204,16,14,2,16968,2424,19392
420540,202204,6282,3917,2365,4750144.08,2867594.61,7617738.69
420543,202204,30,28,2,33936,2424,36360
420545,202204,207,144,63,174528,77568,252096
420550,202204,779,644,135,780530.11,163620,944150.11
420555,202204,27,20,7,24240,8484,32724
420560,202204,56,45,11,54540,13332,67872
420570,202204,182,93,89,112716,107868,220584
420580,202204,301,146,155,176952,187860.6,364812.6
420590,202204,486,314,172,380568.7,208464,589032.7
420600,202204,144,77,67,93324,81204,174528
420610,202204,37,34,3,41208,3636,44844
420620,202204,78,56,22,67872,26664,94536
420630,202204,151,99,52,119988,63024,183012
420640,202204,67,58,9,70296,10908,81204
420650,202204,266,144,122,174528,150288.6,324816.6
420660,202204,41,33,8,39996,9696,49692
420665,202204,42,26,16,32724,19392,52116
420670,202204,242,189,53,230280.6,65448,295728.6
420675,202204,15,13,2,15756,2424,18180
420680,202204,32,25,7,30300,8484,38784
420690,202204,192,146,46,176952,55752,232704
420700,202204,707,452,255,547825.6,309060.2,856885.8
420710,202204,144,75,69,90900,83628,174528
420720,202204,97,78,19,94536,23028.1,117564.1
420730,202204,683,403,280,489649.79,339360.18,829009.97
420740,202204,55,55,0,66660,,66660.0
420750,202204,474,313,161,380568.8,196344,576912.8
420757,202204,19,16,3,19392,3636,23028
420760,202204,36,27,9,32724,10908,43632
420765,202204,77,55,22,66660,26664,93324
420768,202204,56,46,10,55752,12120,67872
420770,202204,69,59,10,71508,12120,83628
420775,202204,39,35,4,42420.6,4848,47268.6
420780,202204,208,161,47,195132.8,56964,252096.8
420785,202204,22,14,8,16968,9696,26664
420790,202204,141,117,24,141804,29088,170892
420800,202204,59,44,15,53328,18180,71508
420810,202204,272,220,52,266640.16,63024,329664.16
420820,202204,2461,1368,1093,1660441.6,1325930.06,2986371.66
420830,202204,649,336,313,407233.24,379356,786589.24
420840,202204,139,96,43,117564.56,52116,169680.56
420845,202204,431,180,251,218160,304212,522372
420850,202204,265,198,67,239976,81204,321180
420860,202204,59,50,9,60600,10908,71508
420870,202204,133,92,41,111504,50904,162408
420880,202204,188,121,67,146652,81204,227856
420890,202204,948,460,488,558733,592668,1151401
420895,202204,8,8,0,9696,,9696.0
420900,202204,412,331,81,401172,98172,499344
420910,202204,5801,3125,2676,3793569.48,3249373.1,7042942.58
420915,202204,60,54,6,65448,7272,72720
420917,202204,20,16,4,19392,4848,24240
420920,202204,21,14,7,16968,8484,25452
420930,202204,3128,2010,1118,2438470.78,1356228.6,3794699.38
420940,202204,581,417,164,506617.42,198768.64,705386.06
420945,202204,11,8,3,9696,3636,13332
420950,202204,48,37,11,44844,13332,58176
420960,202204,114,93,21,112716,25452,138168
420970,202204,280,225,55,272701.1,66660,339361.1
420980,202204,22,21,1,25452,1212,26664
420985,202204,54,47,7,56964,8484,65448
420990,202204,81,62,19,75144,23028.6,98172.6
421000,202204,53,29,24,35148,29088,64236
421003,202204,38,27,11,32724,13332,46056
421005,202204,7,5,2,6060,2424,8484
421010,202204,841,550,291,667814.08,353904.8,1021718.88
421020,202204,21,17,4,20604,4848,25452
421030,202204,112,96,16,116352,19392,135744
421040,202204,68,46,22,55752,26664,82416
421050,202204,339,236,103,286033.2,124836,410869.2
421055,202204,19,15,4,18180,4848,23028
421060,202204,104,57,47,69084.6,56964,126048.6
421070,202204,42,35,7,42420.6,8484,50904.6
421080,202204,38,33,5,39996,6060,46056
421085,202204,18,15,3,18180,3636,21816
421090,202204,37,30,7,36360,8484,44844
421100,202204,111,84,27,101808,32724,134532
421105,202204,183,148,35,180588,42420,223008
421110,202204,112,80,32,96960,38784,135744
421120,202204,173,125,48,151500.6,58176,209676.6
421125,202204,19,11,8,13332,9696.13,23028.13
421130,202204,817,505,312,614484.94,378144.7,992629.64
421140,202204,33,23,10,27876,12120,39996
421145,202204,45,37,8,44844,9696,54540
421150,202204,88,67,21,81204,25452,106656
421160,202204,64,39,25,47268,30300,77568
421165,202204,14,11,3,13332,3636,16968
421170,202204,169,139,30,168614.1,36360,204974.1
421175,202204,186,130,56,157560.2,67872,225432.2
421180,202204,42,29,13,35148.56,15756,50904.56
421185,202204,15,12,3,14544,3636,18180
421187,202204,3,2,1,2424,1212,3636
421189,202204,44,30,14,36360,16968,53328
421190,202204,1901,1193,708,1448344.7,859309.64,2307654.34
421200,202204,90,61,29,73932,35148,109080
421205,202204,27,19,8,23028,9696,32724
421210,202204,173,123,50,151500,60600,212100
421220,202204,254,196,58,237552,70296,307848
421223,202204,48,39,9,47268.4,10908,58176.4
421225,202204,69,46,23,55752,27876,83628
421227,202204,71,58,13,70296,15756,86052
421230,202204,72,49,23,59388.2,27876,87264.2
421240,202204,16,15,1,18180,1212,19392
421250,202204,381,225,156,273912.73,190284,464196.73
421260,202204,21,17,4,20604,4848,25452
421265,202204,5,3,2,3636,2424,6060
421270,202204,55,49,6,59388,7272,66660
421280,202204,354,178,176,215736.83,213312,429048.83
421290,202204,307,204,103,247248,124836.6,372084.6
421300,202204,23,19,4,23028,4848,27876
421310,202204,52,35,17,42420,20604,63024
421315,202204,33,21,12,25452.1,14544,39996.1
421320,202204,133,88,45,106656,54540,161196
421330,202204,109,82,27,99384,32724,132108
421335,202204,45,33,12,39996,14544,54540
421340,202204,243,159,84,192708.8,101808,294516.8
421350,202204,181,106,75,128473.75,90900,219373.75
421360,202204,712,496,216,601152.78,261792,862944.78
421370,202204,190,139,51,168468,61812.6,230280.6
421380,202204,145,109,36,132108.2,43632,175740.2
421390,202204,16,10,6,12120,7272,19392
421400,202204,121,98,23,118776,27876,146652
421410,202204,21,18,3,21816,3636,25452
421415,202204,19,17,2,20604,2424,23028
421420,202204,103,89,14,107868,16968,124836
421430,202204,18,12,6,14544,7272,21816
421440,202204,62,54,8,65448,9696,75144
421450,202204,87,72,15,87264,18180.44,105444.44
421460,202204,58,44,14,53328,16968,70296
421470,202204,74,42,32,50904,38784,89688
421480,202204,754,569,185,690841.23,224220,915061.23
421490,202204,24,23,1,27876,1212,29088
421500,202204,471,282,189,341784.8,229068.77,570853.57
421505,202204,30,23,7,27876,8484,36360
421507,202204,30,24,6,29088,7272,36360
421510,202204,66,40,26,49692,31512,81204
421520,202204,51,43,8,52116,9696,61812
421530,202204,52,41,11,49692,13332,63024
421535,202204,20,19,1,23028,1212,24240
421540,202204,52,41,11,49692,13332,63024
421545,202204,84,61,23,73932,27876,101808
421550,202204,290,203,87,247248,105444,352692
421555,202204,17,15,2,18180,2424,20604
421560,202204,8,7,1,8484,1212,9696
421565,202204,124,80,44,96960,53328,150288
421567,202204,33,27,6,32724,7272,39996
421568,202204,44,41,3,49692,3636,53328
421569,202204,11,11,0,13332,,13332.0
421570,202204,234,154,80,187860,96960,284820
421575,202204,25,22,3,26664,3636,30300
421580,202204,712,416,296,504271,361176.6,865447.6
421590,202204,17,16,1,19392,1212,20604
421600,202204,155,105,50,127260.6,60600,187860.6
421605,202204,103,69,34,83628.2,41208,124836.2
421610,202204,168,128,40,155136,49692,204828
421620,202204,1033,582,451,706596.48,546613,1253209.48
421625,202204,21,19,2,23028,2424,25452
421630,202204,344,208,136,252096.8,164833.65,416930.45
421635,202204,21,10,11,12120,13332.1,25452.1
421640,202204,101,84,17,101808.4,20604,122412.4
421650,202204,306,179,127,216948.2,155136,372084.2
421660,202204,2494,1506,988,1826488.88,1197457.01,3023945.89
421670,202204,167,118,49,144228,59388,203616
421680,202204,195,176,19,213312.2,23028,236340.2
421690,202204,341,230,111,279972.6,134532.36,414504.96
421700,202204,60,41,19,49692,23028.2,72720.2
421710,202204,19,19,0,23028,,23028.0
421715,202204,5,4,1,4848,1212,6060
421720,202204,637,438,199,532068.3,241188,773256.3
421725,202204,25,10,15,12120,18180,30300
421730,202204,27,20,7,24240,8484,32724
421740,202204,104,38,66,46056,79992,126048
421750,202204,197,145,52,176952,63024,239976
421755,202204,18,16,2,19392,2424,21816
421760,202204,101,70,31,84840,37572,122412
421770,202204,692,442,250,538129.6,303000,841129.6
421775,202204,31,20,11,24240,13332,37572
421780,202204,175,140,35,170892,42420,213312
421790,202204,152,131,21,158772,25452,184224
421795,202204,16,13,3,15756,3636,19392
421800,202204,535,325,210,393901.32,254520.48,648421.80
421810,202204,68,56,12,69084,14544,83628
421820,202204,303,192,111,232704.6,135744,368448.6
421825,202204,158,130,28,157560.92,33936,191496.92
421830,202204,149,89,60,107868.1,72720.2,180588.3
421835,202204,7,2,5,2424,6060,8484
421840,202204,45,38,7,46056,8484,54540
421850,202204,79,67,12,81204,14544,95748
421860,202204,38,27,11,33936,13332,47268
421870,202204,1043,757,286,918698.7,346633.56,1265332.26
421875,202204,48,38,10,47268,12120,59388
421880,202204,182,122,60,149076,72720,221796
421885,202204,24,18,6,21816,7272,29088
421890,202204,144,103,41,124836,49692.4,174528.4
421895,202204,43,37,6,44844,7272,52116
421900,202204,129,98,31,118776,37572,156348
421910,202204,61,39,22,47268,26664,73932
421915,202204,33,27,6,32724,7272,39996
421917,202204,41,30,11,36360.2,13332,49692.2
421920,202204,37,32,5,38784,6060,44844
421930,202204,614,487,127,590245.4,153924,744169.4
421935,202204,45,39,6,47268,7272,54540
421940,202204,53,45,8,54540.4,9696,64236.4
421950,202204,870,573,297,694477.32,359964.6,1054441.92
421960,202204,41,34,7,41208,8484,49692
421970,202204,324,211,113,255732,136956,392688
421985,202204,20,12,8,14544,9696,24240
422000,202204,5,3,2,3636.6,2424,6060.6
430003,202204,189,55,134,66660,162408,229068
430005,202204,32,24,8,29088,9696,38784
430010,202204,255,184,71,223008,86052,309060
430020,202204,142,96,46,116352.6,55752,172104.6
430030,202204,117,98,19,118776,23028,141804
430040,202204,2919,1723,1196,2090701.48,1450764.6,3541466.08
430045,202204,74,63,11,76356,13332,89688
430047,202204,7,5,2,6060,2424,8484
430050,202204,86,74,12,89688,14544,104232
430055,202204,13,12,1,14544,1212,15756
430057,202204,6,4,2,4848,2424,7272
430060,202204,3960,2302,1658,2796084.8,2011921.2,4808006.0
430063,202204,52,43,9,52116,10908,63024
430064,202204,168,131,37,158772,44844,203616
430066,202204,7,3,4,3636,4848,8484
430070,202204,45,33,12,39996,14544,54540
430080,202204,82,51,31,61812,37572,99384
430085,202204,30,14,16,16968,19392,36360
430087,202204,25,18,7,21816.8,8484,30300.8
430090,202204,65,54,11,65448,13332,78780
430100,202204,138,95,43,115140.6,53328,168468.6
430105,202204,152,88,64,106656,77568,184224
430107,202204,19,14,5,16968,6060,23028
430110,202204,497,271,226,328452.1,273912,602364.1
430120,202204,162,147,15,178164,18180,196344
430130,202204,783,475,308,575700,375720,951420
430140,202204,131,120,11,145440,13332,158772
430150,202204,104,65,39,78780,47268,126048
430155,202204,30,24,6,29088,7272,36360
430160,202204,3628,2082,1546,2527023.9,1878600.8,4405624.7
430163,202204,411,186,225,225432,272700,498132
430165,202204,32,20,12,24240,14544,38784
430170,202204,79,65,14,78780,16968,95748
430175,202204,78,61,17,73932,20604,94536
430180,202204,106,85,21,103020,25452,128472
430185,202204,28,19,9,23028,10908,33936
430187,202204,53,28,25,33936,30300,64236
430190,202204,232,120,112,145440,135744,281184
430192,202204,16,12,4,14544,4848,19392
430195,202204,16,11,5,13332,6060,19392
430200,202204,153,128,25,155136,30300,185436
430205,202204,19,19,0,23028,,23028.0
430210,202204,738,558,180,676296.8,218160,894456.8
430215,202204,11,10,1,12120,1212,13332
430220,202204,75,50,25,60600,30300,90900
430222,202204,13,5,8,6060,9696,15756
430223,202204,17,11,6,13332,7272,20604
430225,202204,3,2,1,2424,1212,3636
430230,202204,317,195,122,236340,147864,384204
430235,202204,48,32,16,38784,19392,58176
430237,202204,21,15,6,18180,7272,25452
430240,202204,109,74,35,89688,42420,132108
430245,202204,67,55,12,66660,14544,81204
430250,202204,185,105,80,127260,96960,224220
430258,202204,9,8,1,9696,1212,10908
430260,202204,31,27,4,32724,4848,37572
430265,202204,35,30,5,36360,6060,42420
430270,202204,519,373,146,453288.4,178164,631452.4
430280,202204,1065,623,442,755077.2,536916,1291993.2
430290,202204,427,220,207,266640,250884,517524
430300,202204,2125,1149,976,1392589.2,1182913.06,2575502.26
430310,202204,2059,1008,1051,1221698.31,1278663.62,2500361.93
430320,202204,54,44,10,54540,12120,66660
430330,202204,89,76,13,92112.5,15756,107868.5
430340,202204,66,53,13,64236,15756,79992
430350,202204,1679,1088,591,1319868.2,717504.6,2037372.8
430355,202204,20,18,2,21816,2424,24240
430360,202204,95,48,47,58176,56964,115140
430367,202204,42,31,11,37572,13332,50904
430370,202204,57,51,6,61812,7272,69084
430380,202204,115,86,29,105444,35148,140592
430390,202204,589,366,223,443592.2,270276,713868.2
430400,202204,259,179,80,216948.6,96960,313908.6
430410,202204,58,46,12,55752,14544,70296
430420,202204,520,328,192,397537.1,232704,630241.1
430430,202204,53,51,2,61004.8,2424,63428.8
430435,202204,139,104,35,126048,42420,168468
430440,202204,538,334,204,406020.4,247248,653268.4
430450,202204,1189,970,219,1176854.27,266640,1443494.27
430460,202204,5731,2924,2807,3547529.93,3405721.43,6953251.36
430461,202204,16,14,2,16968,2424,19392
430462,202204,5,3,2,3636,2424,6060
430463,202204,1170,624,546,757500.2,662964,1420464.2
430465,202204,25,14,11,16968,13332,30300
430466,202204,661,461,200,558733,242400,801133
430467,202204,121,69,52,83628,63024,146652
430468,202204,137,78,59,94536,71508,166044
430469,202204,18,14,4,16968,4848,21816
430470,202204,1148,628,520,761496.7,630240,1391736.7
430471,202204,66,43,23,52116,27876,79992
430480,202204,121,83,38,100596,46056,146652
430485,202204,8,8,0,9696.6,,9696.6
430490,202204,72,58,14,70296,16968,87264
430495,202204,31,23,8,27876,9696,37572
430500,202204,187,125,62,151500,75144,226644
430510,202204,3759,2440,1319,2959705.75,1599840.49,4559546.24
430511,202204,14,14,0,16968,,16968.0
430512,202204,160,109,51,132108,61812,193920
430513,202204,51,40,11,48480,13332,61812
430515,202204,25,24,1,29088,1212,30300
430517,202204,179,148,31,179376,37572,216948
430520,202204,345,243,102,295728,123624,419352
430530,202204,78,44,34,53328,41208,94536
430535,202204,448,294,154,356328,186648.2,542976.2
430537,202204,10,10,0,12120,,12120.0
430540,202204,82,53,29,64236,35148,99384
430543,202204,391,121,270,146652,327240,473892
430544,202204,47,44,3,53328,3636,56964
430545,202204,410,190,220,230280.8,266640.78,496921.58
430550,202204,44,35,9,42420,10908,53328
430558,202204,2,2,0,2424,,2424.0
430560,202204,55,31,24,37572,29088,66660
430570,202204,121,53,68,64236,82416,146652
430580,202204,125,99,26,119988,31512,151500
430583,202204,15,15,0,18180,,18180.0
430585,202204,11,8,3,9696,3636,13332
430587,202204,14,8,6,9696,7272,16968
430590,202204,167,133,34,161196,41208,202404
430593,202204,1,1,0,1212,,1212.0
430595,202204,16,13,3,15756,3636,19392
430597,202204,44,25,19,30300,23028,53328
430600,202204,222,167,55,202404,66660,269064
430605,202204,168,95,73,115140,88476,203616
430607,202204,30,24,6,29088,7272,36360
430610,202204,1726,821,905,996264,1096861.2,2093125.2
430613,202204,6,6,0,7272,,7272.0
430620,202204,94,67,27,81204,32724,113928
430630,202204,46,38,8,46056,9696,55752
430632,202204,31,26,5,31512,6060,37572
430635,202204,37,31,6,37572,7272,44844
430637,202204,67,33,34,39996,41208,81204
430640,202204,175,100,75,121200,92112,213312
430642,202204,18,15,3,18180,3636,21816
430645,202204,31,26,5,31512,6060,37572
430650,202204,247,195,52,236340.6,63024,299364.6
430655,202204,5,4,1,4848,1212,6060
430660,202204,975,470,505,569640,613272,1182912
430670,202204,70,47,23,56964,27876,84840
430673,202204,82,54,28,65448,33936,99384
430675,202204,8,6,2,7272,2424,9696
430676,202204,591,348,243,421776,295728.1,717504.1
430680,202204,246,163,83,197556.6,100596,298152.6
430690,202204,545,330,215,399960,260580.95,660540.95
430692,202204,9,7,2,8484,2424,10908
430693,202204,137,85,52,103020.1,63024,166044.1
430695,202204,66,54,12,65448,14544,79992
430697,202204,65,41,24,49692,29088,78780
430700,202204,1378,929,449,1127160.87,546612.2,1673773.07
430705,202204,29,26,3,31512,3636,35148
430710,202204,257,158,99,191496,119988,311484
430720,202204,108,91,17,110292,20604,130896
430730,202204,144,122,22,147864,26664,174528
430740,202204,76,50,26,60600,31512,92112
430745,202204,30,19,11,23028,13332,36360
430750,202204,331,213,118,259368,143016,402384
430755,202204,87,46,41,55752,49692,105444
430760,202204,396,219,177,266640.86,214524.34,481165.20
430770,202204,1578,823,755,998688.6,916272.4,1914961.0
430780,202204,327,207,120,250884,145440,396324
430781,202204,24,23,1,27876,1212,29088
430783,202204,62,48,14,58176.2,16968,75144.2
430786,202204,5,3,2,3636,2424,6060
430790,202204,516,328,188,398748,229068,627816
430800,202204,152,118,34,143016.01,41208,184224.01
430805,202204,37,31,6,37572,7272,44844
430807,202204,61,31,30,37572,36360,73932
430810,202204,76,51,25,61812,30300,92112
430820,202204,152,96,56,116352,67872,184224
430825,202204,12,9,3,10908,3636,14544
430830,202204,249,231,18,279972.6,21816,301788.6
430840,202204,133,88,45,106656,54540,161196
430843,202204,6,4,2,4848,2424,7272
430845,202204,75,45,30,54540,36360,90900
430850,202204,589,423,166,512676,201192,713868
430860,202204,157,99,58,121200,70296,191496
430865,202204,77,41,36,49692,43632,93324
430870,202204,75,61,14,73932,16968,90900
430880,202204,163,117,46,141804,55752,197556
430885,202204,12,11,1,13332,1212,14544
430890,202204,339,200,139,243612,168468,412080
430900,202204,528,361,167,437532.6,202404,639936.6
430905,202204,124,50,74,60600,93324,153924
430910,202204,280,153,127,185436,153924,339360
430912,202204,4,4,0,4848,,4848.0
430915,202204,41,37,4,44844,4848,49692
430920,202204,4574,2385,2189,2893046.07,2655493.28,5548539.35
430925,202204,6,5,1,6060,1212,7272
430930,202204,2081,1193,888,1448340.8,1077468,2525808.8
430940,202204,258,164,94,198768,113928,312696
430950,202204,153,124,29,150288.1,35148,185436.1
430955,202204,24,14,10,16968,12120,29088
430957,202204,22,19,3,23028,3636,26664
430960,202204,247,159,88,192708,106656,299364
430965,202204,104,68,36,82416,43632,126048
430970,202204,88,72,16,87264,19392,106656
430975,202204,47,41,6,49692,7272,56964
430980,202204,50,30,20,36360,24240,60600
430990,202204,99,75,24,90900,29088,119988
430995,202204,111,103,8,124836,9696,134532
431000,202204,296,149,147,180588.6,178164,358752.6
431010,202204,359,207,152,250884.8,185436,436320.8
431020,202204,1884,1090,794,1321928.4,962328,2284256.4
431030,202204,40,31,9,37572,10908,48480
431033,202204,447,199,248,242400,300576.2,542976.2
431036,202204,14,8,6,9696,7272,16968
431040,202204,142,89,53,107868,64236,172104
431041,202204,38,22,16,26664,19392,46056
431043,202204,39,23,16,27876,19392,47268
431046,202204,13,10,3,12120,3636,15756
431050,202204,203,126,77,152712,93324,246036
431053,202204,72,38,34,46056,41208.4,87264.4
431055,202204,66,43,23,52116,27876,79992
431057,202204,17,17,0,20604,,20604.0
431060,202204,1573,1012,561,1226546.22,682356,1908902.22
431065,202204,16,8,8,9696,9696,19392
431070,202204,64,55,9,66660,10908,77568
431075,202204,8,8,0,9696,,9696.0
431080,202204,125,72,53,87264,64236,151500
431085,202204,33,29,4,35148,4848,39996
431087,202204,14,11,3,13332,3636,16968
431090,202204,50,37,13,44844,15756,60600
431100,202204,1263,755,508,916272.5,616908.1,1533180.6
431110,202204,218,131,87,158772,105444,264216
431112,202204,28,20,8,24240,9696,33936
431113,202204,31,23,8,27876,9696,37572
431115,202204,150,106,44,128472,53328,181800
431120,202204,589,337,252,409656.3,305424,715080.3
431123,202204,5,5,0,6060,,6060.0
431125,202204,97,84,13,101808,15756,117564
431127,202204,5,3,2,3636,2424,6060
431130,202204,725,479,246,581761.38,299364.5,881125.88
431140,202204,780,547,233,662964.4,283608,946572.4
431142,202204,20,18,2,21816.84,2424,24240.84
431150,202204,200,149,51,180588,61812,242400
431160,202204,47,43,4,52116,4848,56964
431162,202204,4,4,0,4848,,4848.0
431164,202204,4,4,0,4848,,4848.0
431170,202204,114,81,33,98172,39996,138168
431171,202204,70,40,30,48480,36360,84840
431173,202204,5,3,2,3636,2424,6060
431175,202204,207,109,98,132108.6,118776,250884.6
431177,202204,93,64,29,77568,35148,112716
431179,202204,15,11,4,13332,4848,18180
431180,202204,403,251,152,306636,185436,492072
431190,202204,76,56,20,67872,24240.1,92112.1
431198,202204,70,48,22,58176,26664,84840
431200,202204,21,17,4,20604,4848,25452
431205,202204,22,20,2,24240,2424,26664
431210,202204,104,67,37,81204,44844,126048
431213,202204,35,29,6,35148,7272,42420
431215,202204,25,23,2,27876,2424,30300
431217,202204,5,4,1,4848,1212,6060
431220,202204,66,56,10,67872,12120,79992
431225,202204,165,105,60,127260,72720,199980
431230,202204,97,82,15,99384,18180,117564
431235,202204,6,5,1,6060,1212,7272
431237,202204,17,12,5,14544,6060,20604
431238,202204,12,9,3,10908,3636,14544
431240,202204,1090,664,426,804770.32,516312,1321082.32
431242,202204,42,39,3,48480,3636,52116
431244,202204,22,18,4,21816,4848,26664
431245,202204,52,38,14,46056,16968,63024
431247,202204,10,6,4,7272,4848,12120
431250,202204,287,141,146,170892,176952,347844
431260,202204,56,47,9,56964,10908,67872
431261,202204,16,11,5,13332,6060,19392
431262,202204,16,13,3,15756,3636,19392
431265,202204,148,79,69,96960,83628,180588
431267,202204,18,16,2,19392,2424,21816
431270,202204,327,255,72,310272.2,87264,397536.2
431275,202204,40,35,5,42420,6060,48480
431280,202204,20,16,4,19392,4848,24240
431290,202204,19,17,2,20604,2424,23028
431295,202204,2,1,1,1212,1212,2424
431300,202204,18,16,2,20604,2424,23028
431301,202204,6,6,0,7272,,7272.0
431303,202204,57,36,21,43632,25452,69084
431306,202204,242,124,118,151500,143016,294516
431308,202204,6,4,2,4848,2424,7272
431310,202204,64,50,14,60600,16968,77568
431320,202204,178,107,71,129684.9,87264,216948.9
431330,202204,203,130,73,157560,88476,246036
431333,202204,28,22,6,26664,7272,33936
431335,202204,7,5,2,6060,2424,8484
431337,202204,396,190,206,230280.83,252096,482376.83
431339,202204,22,17,5,20604,6060,26664
431340,202204,3148,1707,1441,2072426.76,1747706.71,3820133.47
431342,202204,35,23,12,27876.6,14544,42420.6
431344,202204,19,19,0,23028,,23028.0
431346,202204,5,4,1,4848,1212,6060
431349,202204,32,28,4,33936.23,4848,38784.23
431350,202204,1038,565,473,684781.6,573276.6,1258058.2
431360,202204,51,39,12,47268,14544,61812
431365,202204,351,148,203,179376,248460,427836
431370,202204,1185,682,503,826584.8,609636,1436220.8
431380,202204,98,87,11,105444.6,13332,118776.6
431390,202204,498,269,229,327240,277548,604788
431395,202204,326,136,190,164832,230280,395112
431400,202204,37,23,14,27876,16968,44844
431402,202204,99,73,26,88476,31512,119988
431403,202204,26,17,9,20604,10908,31512
431405,202204,705,396,309,479952.06,375720,855672.06
431406,202204,35,27,8,33936,9696,43632
431407,202204,45,35,10,42420,12120,54540
431410,202204,3471,2102,1369,2550049.25,1660440.2,4210489.45
431413,202204,16,13,3,16968,3636,20604
431415,202204,71,49,22,59388,26664,86052
431417,202204,24,11,13,13332,15756,29088
431420,202204,345,229,116,277548,140592,418140
431430,202204,58,29,29,35148,35148,70296
431440,202204,9048,6170,2878,7482900.95,3490619.45,10973520.40
431442,202204,26,13,13,15756,15756,31512
431445,202204,27,25,2,30300,2424,32724
431446,202204,4,3,1,3636,1212,4848
431447,202204,84,61,23,73932,27876,101808
431449,202204,54,42,12,50904.99,14544,65448.99
431450,202204,416,274,142,332088.05,172104,504192.05
431454,202204,11,6,5,7272,6060,13332
431455,202204,48,38,10,46056,12120,58176
431460,202204,504,345,159,418140.45,192708,610848.45
431470,202204,132,97,35,117564,42420,159984
431475,202204,9,7,2,8484,2424,10908
431477,202204,39,24,15,29088,18180,47268
431478,202204,7,7,0,8484,,8484.0
431480,202204,579,351,228,427836.6,277548.6,705385.2
431490,202204,29104,16201,12903,19650052.99,15661476.58,35311529.57
431500,202204,77,61,16,73932,19392,93324
431505,202204,30,20,10,24240,12120,36360
431507,202204,9,8,1,9696,1212,10908
431510,202204,230,167,63,202404.4,76356,278760.4
431513,202204,20,19,1,23028,1212,24240
431514,202204,5,3,2,3636,2424,6060
431515,202204,85,72,13,87264,15756,103020
431517,202204,7,4,3,4848,3636,8484
431520,202204,37,32,5,38784,6060,44844
431530,202204,1420,624,796,756288,965964,1722252
431531,202204,22,20,2,24240,2424,26664
431532,202204,37,27,10,32724,12120,44844
431535,202204,29,14,15,16968,18180,35148
431540,202204,136,111,25,135744.6,30300.6,166045.2
431545,202204,12,10,2,12120,2424,14544
431550,202204,357,189,168,229068,203616,432684
431555,202204,10,10,0,12120,,12120.0
431560,202204,4710,3139,1571,3805687.84,1907690.4,5713378.24
431570,202204,829,435,394,527221.2,478741.2,1005962.4
431575,202204,47,27,20,32724,24240,56964
431580,202204,85,56,29,67872,35148,103020
431590,202204,143,119,24,144228,29088,173316
431595,202204,19,16,3,19392,3636,23028
431600,202204,249,147,102,178164.35,123624,301788.35
431610,202204,111,82,29,99384,35148,134532
431620,202204,40,33,7,39996,8484,48480
431630,202204,124,101,23,122412,29088,151500
431640,202204,1316,825,491,1002324.8,596304,1598628.8
431642,202204,34,31,3,37572,3636,41208
431643,202204,42,17,25,20604,30300,50904
431645,202204,316,182,134,221796,162408,384204
431647,202204,9,8,1,9696,1212,10908
431650,202204,34,19,15,23028,18180,41208
431660,202204,272,171,101,207252,122412,329664
431670,202204,224,98,126,119988,152712,272700
431673,202204,12,10,2,12120,2424,14544
431675,202204,27,21,6,25452,7272,32724
431680,202204,1164,851,313,1032624.7,379356.57,1411981.27
431690,202204,4898,2905,1993,3523288.54,2420366.2,5943654.74
431695,202204,20,14,6,16968,7272,24240
431697,202204,3,1,2,1212,2424,3636
431700,202204,188,142,46,172104,55752,227856
431710,202204,4030,1749,2281,2122213.9,2764572,4886785.9
431720,202204,1275,781,494,948390.98,598728,1547118.98
431725,202204,1,1,0,1212,,1212.0
431730,202204,1148,765,383,927185.55,465408.9,1392594.45
431740,202204,1331,641,690,778104,837493.2,1615597.2
431750,202204,1813,1186,627,1439857.8,763560.14,2203417.94
431755,202204,6,5,1,6060,1212,7272
431760,202204,978,607,371,736897.06,450864.5,1187761.56
431770,202204,413,281,132,341784,159984,501768
431775,202204,23,17,6,20604,7272,27876
431780,202204,560,336,224,407757.2,271488,679245.2
431790,202204,156,121,35,146652,42420,189072
431795,202204,13,10,3,12120,3636,15756
431800,202204,3152,1652,1500,2003439.48,1824061.57,3827501.05
431805,202204,17,15,2,18180,2424,20604
431810,202204,588,383,205,464196.05,249672.6,713868.65
431820,202204,334,195,139,237552,168468,406020
431830,202204,2299,1391,908,1688316,1101708.8,2790024.8
431840,202204,474,314,160,380568.6,195132.2,575700.8
431842,202204,34,28,6,33936,7272,41208
431843,202204,11,9,2,10908,2424,13332
431844,202204,18,13,5,15756,6060,21816
431845,202204,25,22,3,26664,3636,30300
431846,202204,26,22,4,26664,4848,31512
431848,202204,15,13,2,15756,2424,18180
431849,202204,6,5,1,6060,1212,7272
431850,202204,766,597,169,723564,206040,929604
431860,202204,123,77,46,94536,55752,150288
431861,202204,6,2,4,2424,4848,7272
431862,202204,60,43,17,52116,20604,72720
431870,202204,3692,2103,1589,2551263.34,1928292.74,4479556.08
431880,202204,969,686,283,831432.7,342996,1174428.7
431890,202204,1243,724,519,877488.6,629028,1506516.6
431900,202204,189,130,59,157560,71508,229068
431910,202204,47,35,12,42420,14544,56964
431912,202204,49,30,19,36360,24240,60600
431915,202204,146,111,35,134532,42420,176952
431920,202204,151,108,43,130896,52116,183012
431930,202204,76,62,14,75144,16968,92112
431935,202204,5,4,1,4848,1212,6060
431936,202204,3,3,0,3636,,3636.0
431937,202204,19,16,3,19392,3636,23028
431940,202204,467,318,149,387840,181800,569640
431950,202204,463,299,164,362388,202404,564792
431960,202204,733,394,339,478740,414504.6,893244.6
431970,202204,67,61,6,73932,7272,81204
431971,202204,5,3,2,3636,2424,6060
431973,202204,18,15,3,18180,3636,21816
431975,202204,10,10,0,12120,,12120.0
431980,202204,203,118,85,145440.6,103020,248460.6
431990,202204,1084,573,511,696821.74,622968,1319789.74
432000,202204,1825,949,876,1153826.6,1061713.75,2215540.35
432010,202204,266,177,89,214524,107868,322392
432020,202204,181,153,28,185436,33936,219372
432023,202204,14,12,2,14544,2424,16968
432026,202204,56,50,6,60600,7272,67872
432030,202204,63,31,32,37572,38784,76356
432032,202204,16,12,4,14544,4848,19392
432035,202204,61,45,16,54540,19392,73932
432040,202204,88,58,30,71508,36360,107868
432045,202204,2,2,0,2424,,2424.0
432050,202204,80,47,33,56964,39996,96960
432055,202204,131,95,36,115140,43632,158772
432057,202204,6,4,2,4848.6,2424,7272.6
432060,202204,33,28,5,33936,6060,39996
432065,202204,29,25,4,30300,4848,35148
432067,202204,86,80,6,96960,7272,104232
432070,202204,387,302,85,366024.61,103020,469044.61
432080,202204,812,572,240,695688.4,293304,988992.4
432085,202204,11,9,2,10908,2424,13332
432090,202204,265,180,85,218160,103020,321180
432100,202204,171,111,60,134532,72720,207252
432110,202204,547,362,185,438744.2,224220,662964.2
432120,202204,1026,578,448,701748.6,542976,1244724.6
432130,202204,501,355,146,431472.8,178164,609636.8
432132,202204,21,19,2,23028,2424,25452
432135,202204,80,65,15,78780,18180,96960
432140,202204,269,201,68,243612.17,82416,326028.17
432143,202204,215,129,86,156348,104232.1,260580.1
432145,202204,278,192,86,232704,104232,336936
432146,202204,13,12,1,14544,1212,15756
432147,202204,103,60,43,72720,52116,124836
432149,202204,16,9,7,10908,8484,19392
432150,202204,992,608,384,736897.2,466620.39,1203517.59
432160,202204,1672,867,805,1050804.76,975660.2,2026464.96
432162,202204,4,2,2,2424,2424,4848
432163,202204,16,11,5,13332,6060,19392
432166,202204,123,90,33,109383,39996,149379
432170,202204,224,115,109,139380,133320,272700
432180,202204,567,357,210,432684,254520.6,687204.6
432183,202204,11,10,1,12120,1212,13332
432185,202204,80,64,16,77568,19392,96960
432190,202204,508,299,209,362388,253308,615696
432195,202204,93,78,15,94536,18180,112716
432200,202204,403,252,151,305424,184224,489648
432210,202204,115,68,47,82416,56964,139380
432215,202204,31,29,2,35148,2424,37572
432218,202204,19,19,0,23028,,23028.0
432220,202204,640,326,314,395112,380568,775680
432225,202204,18,12,6,14544,7272,21816
432230,202204,122,80,42,96960,50904,147864
432232,202204,23,20,3,24240,3636,27876
432234,202204,3,1,2,1212,2424,3636
432235,202204,2,2,0,2424,,2424.0
432237,202204,23,15,8,18180,9696,27876
432240,202204,4499,2532,1967,3073634.87,2385218.98,5458853.85
432250,202204,1120,733,387,888396,469044,1357440
432252,202204,47,47,0,56964,,56964.0
432253,202204,62,49,13,60600,15756,76356
432254,202204,28,12,16,14544,19392,33936
432255,202204,12,10,2,12120,2424,14544
432260,202204,848,679,169,822948.6,204828,1027776.6
432270,202204,217,163,54,197556.1,65448,263004.1
432280,202204,155,116,39,140592.4,47268,187860.4
432285,202204,1,1,0,1212,,1212.0
432290,202204,54,47,7,56964,8484,65448
432300,202204,4935,2633,2302,3194757.37,2794875.03,5989632.40
432310,202204,129,108,21,130896,25452,156348
432320,202204,22,17,5,20604,6060,26664
432330,202204,15,10,5,12120,6060,18180
432335,202204,8,6,2,7272,2424,9696
432340,202204,36,29,7,35148,8484,43632
432345,202204,111,75,36,90900.82,43632,134532.82
432350,202204,23,22,1,26664,1212,27876
432360,202204,5,4,1,4848,1212,6060
432370,202204,25,25,0,30300,,30300.0
432375,202204,29,26,3,31512,3636.6,35148.6
432377,202204,7,6,1,7272,1212,8484
432380,202204,191,84,107,101808,129684,231492
500020,202204,266,141,125,170892.5,151500,322392.5
500025,202204,138,68,70,82416,84840,167256
500060,202204,1419,901,518,1094436.2,627817.2,1722253.4
500070,202204,732,352,380,426624.4,461772.2,888396.6
500080,202204,136,108,28,130896,33936,164832
500085,202204,129,102,27,123625.4,32724,156349.4
500090,202204,369,170,199,206040,242400,448440
500100,202204,703,366,337,443592,408445.76,852037.76
500110,202204,2302,1100,1202,1333200.6,1456826.4,2790027.0
500124,202204,267,148,119,179376,144228,323604
500150,202204,327,134,193,162408.64,233916,396324.64
500190,202204,533,360,173,436320.74,209676,645996.74
500200,202204,205,171,34,207252.32,41208,248460.32
500210,202204,1616,546,1070,661752.56,1299264.82,1961017.38
500215,202204,201,116,85,140592.2,104232,244824.2
500220,202204,714,455,259,551460.32,313908,865368.32
500230,202204,227,137,90,166044,109080,275124
500240,202204,638,424,214,513888,259368.6,773256.6
500260,202204,586,233,353,283608,427836,711444
500270,202204,30107,13024,17083,15804985.47,20739761.05,36544746.52
500280,202204,200,67,133,81204,161196,242400
500290,202204,1169,719,450,872640.8,546612.5,1419253.3
500295,202204,460,296,164,358753.7,198768,557521.7
500310,202204,110,39,71,47268,86052,133320
500315,202204,806,441,365,534492,442380,976872
500320,202204,3642,1744,1898,2113731.4,2302800.1,4416531.5
500325,202204,892,495,397,601152.95,481164.8,1082317.75
500330,202204,1497,711,786,864135.78,956269.24,1820405.02
500345,202204,305,228,77,276336.96,93324,369660.96
500348,202204,243,147,96,178164,116352,294516
500350,202204,107,52,55,63024,66660,129684
500370,202204,5685,2577,3108,3126969.46,3768109.49,6895078.95
500375,202204,349,237,112,287244,135744,422988
500380,202204,606,346,260,419352,315120,734472
500390,202204,68,32,36,38784,43632,82416
500400,202204,209,136,73,164832,89688,254520
500410,202204,501,213,288,258156,351480.95,609636.95
500430,202204,542,368,174,447228.1,210888,658116.1
500440,202204,207,113,94,136956,113928,250884
500450,202204,412,175,237,212100.99,287244,499344.99
500460,202204,268,144,124,174528.84,150288,324816.84
500470,202204,419,312,107,379356,130896,510252
500480,202204,102,61,41,73932,49692,123624
500490,202204,95,42,53,50904.5,64236.2,115140.7
500500,202204,1422,525,897,636300.24,1087164.19,1723464.43
500510,202204,41,34,7,41208,8484,49692
500515,202204,105,74,31,89688,37572,127260
500520,202204,281,146,135,178164.8,163620,341784.8
500525,202204,90,50,40,60600,48480,109080
500540,202204,894,401,493,487224.8,597516,1084740.8
500560,202204,884,491,393,596304,476316.6,1072620.6
500568,202204,1006,530,476,643572,576912,1220484
500570,202204,1170,683,487,829009.2,591456.85,1420466.05
500580,202204,318,163,155,197556.2,187860,385416.2
500600,202204,347,170,177,206040.86,214524.9,420565.76
500620,202204,936,649,287,787800.58,347844.2,1135644.78
500625,202204,80,64,16,77568.65,19392,96960.65
500627,202204,40,18,22,21816,26664,48480
500630,202204,1565,899,666,1089081.02,807192,1896273.02
500635,202204,508,303,205,367236,248460,615696
500640,202204,362,198,164,239977,198768,438745
500660,202204,5703,2066,3637,2511267.42,4411680.6,6922948.02
500690,202204,604,220,384,266640,465408,732048
500710,202204,392,194,198,235128.6,241188.6,476317.2
500720,202204,928,508,420,615696.81,509040.9,1124737.71
500730,202204,160,96,64,116352.6,77568,193920.6
500740,202204,926,387,539,470256.3,655692.93,1125949.23
500750,202204,169,56,113,67872,136956.65,204828.65
500755,202204,118,89,29,107868.7,35148,143016.7
500769,202204,731,401,330,486013.45,401172,887185.45
500770,202204,421,231,190,279972,230280,510252
500780,202204,135,90,45,110292,54540,164832
500790,202204,1046,515,531,626604.3,644784.2,1271388.5
500793,202204,289,147,142,178164,172105.1,350269.1
500795,202204,174,118,56,143016.47,69084.5,212100.97
500797,202204,49,34,15,41208,18180,59388
500800,202204,420,180,240,218160.2,290880,509040.2
500830,202204,2234,1205,1029,1461675.32,1249572.2,2711247.52
500840,202204,119,88,31,107868,37572,145440
510010,202204,166,91,75,110292,90900,201192
510020,202204,522,237,285,287244,349056.84,636300.84
510025,202204,1667,931,736,1130797.01,893244.2,2024041.21
510030,202204,659,342,317,414504.8,384204.2,798709.0
510035,202204,133,69,64,83628,77568,161196
510040,202204,409,195,214,236340,259368.88,495708.88
510050,202204,380,205,175,248460,213312.99,461772.99
510060,202204,124,63,61,76356,73932,150288
510080,202204,246,94,152,113928,184224.6,298152.6
510100,202204,67,27,40,32724,48480,81204
510120,202204,29,18,11,21816,13332,35148
510125,202204,382,237,145,287244,176952,464196
510130,202204,536,323,213,391477.58,258156.6,649634.18
510140,202204,439,140,299,169680,362388,532068
510160,202204,104,35,69,42420,83628.1,126048.1
510170,202204,736,451,285,546612.2,345420,892032.2
510180,202204,2851,1316,1535,1596209.08,1865269.03,3461478.11
510185,202204,26,12,14,14544,16968,31512
510190,202204,233,78,155,94536,187860,282396
510250,202204,2649,1641,1008,1988895.32,1222908.8,3211804.12
510260,202204,171,123,48,149076,58176,207252
510263,202204,472,268,204,324816.2,247248.2,572064.4
510267,202204,614,337,277,409658.78,335724,745382.78
510268,202204,62,29,33,35148.1,39996,75144.1
510269,202204,76,35,41,42420,49692,92112
510270,202204,372,184,188,224220.19,229068,453288.19
510279,202204,197,150,47,181800,56964,238764
510285,202204,177,71,106,86052,128472,214524
510300,202204,513,269,244,326028.4,296940,622968.4
510305,202204,200,91,109,110292,132108,242400
510310,202204,105,53,52,64236,63024,127260
510320,202204,807,503,304,609637.28,372084,981721.28
510325,202204,419,171,248,207252,301788,509040
510330,202204,422,236,186,286032,225432,511464
510335,202204,653,390,263,472680.4,321180,793860.4
510336,202204,52,36,16,43632,19392,63024
510337,202204,105,48,57,58176,69084,127260
510340,202204,17623,7831,9792,9500883.25,11882458.38,21383341.63
510343,202204,60,44,16,54540,19392,73932
510345,202204,153,95,58,115140.5,70296.6,185437.1
510350,202204,636,336,300,407232.4,363600,770832.4
510360,202204,219,137,82,166044,99384,265428
510370,202204,154,71,83,86052,100596,186648
510380,202204,78,57,21,69084,25452,94536
510385,202204,59,26,33,31512,39996,71508
510390,202204,94,44,50,53328,60600,113928
510395,202204,51,36,15,43632,18180,61812
510410,202204,750,478,272,579336.6,330876,910212.6
510420,202204,549,269,280,327240.6,339360,666600.6
510450,202204,50,25,25,30300,30300,60600
510452,202204,54,25,29,30300,35148,65448
510454,202204,50,23,27,27876,32724,60600
510455,202204,124,73,51,88476,63024,151500
510460,202204,181,83,98,100596,118776,219372
510480,202204,715,427,288,517524.66,349057,866581.66
510490,202204,331,162,169,196344,204828,401172
510500,202204,227,170,57,207252,69084,276336
510510,202204,800,460,340,557521.25,413292.1,970813.35
510515,202204,1254,648,606,785376.2,734472,1519848.2
510517,202204,268,124,144,150288,174528,324816
510520,202204,209,137,72,167256.7,87264,254520.7
510523,202204,112,88,24,106656,29088,135744
510525,202204,855,517,338,626605,409656.2,1036261.2
510530,202204,20,13,7,15756,8484,24240
510550,202204,235,110,125,133320,151500,284820
510558,202204,297,147,150,178164.46,181800.6,359965.06
510560,202204,380,212,168,256944.8,203616,460560.8
510562,202204,643,465,178,563581,215736,779317
510590,202204,711,359,352,435108.5,426624,861732.5
510600,202204,225,117,108,141804,130896,272700
510610,202204,223,96,127,116352,153924,270276
510615,202204,192,91,101,110292,122412,232704
510617,202204,26,13,13,15756,15756,31512
510618,202204,121,57,64,69084,77568,146652
510619,202204,87,61,26,73932,31512,105444
510620,202204,158,89,69,107868,83628,191496
510621,202204,172,108,64,130896,77568,208464
510622,202204,479,262,217,317545.11,263004,580549.11
510623,202204,290,196,94,237552,113928,351480
510624,202204,84,44,40,53328,48480,101808
510625,202204,515,324,191,392688.2,231492.95,624181.15
510626,202204,107,62,45,75144,54540,129684
510627,202204,89,61,28,73932,33936,107868
510628,202204,160,97,63,117564,76356,193920
510629,202204,273,162,111,196344,134553.81,330897.81
510630,202204,434,215,219,260580.6,265428.6,526009.2
510631,202204,17,8,9,9696,10908,20604
510637,202204,340,194,146,235128,176952.5,412080.5
510642,202204,1064,569,495,690840.02,599940.35,1290780.37
510645,202204,8,1,7,1212,8484,9696
510650,202204,1310,863,447,1045958.25,541764,1587722.25
510665,202204,82,34,48,41208,58176,99384
510670,202204,55,32,23,38784,27876,66660
510675,202204,1100,706,394,855672.6,479952,1335624.6
510677,202204,353,189,164,229069.2,198768,427837.2
510680,202204,92,56,36,67872,43632,111504
510682,202204,193,96,97,116352,117564,233916
510685,202204,54,40,14,48480,16968,65448
510700,202204,563,317,246,384204,298152,682356
510704,202204,1171,608,563,736898.12,684780.2,1421678.32
510706,202204,147,76,71,92112,86052.2,178164.2
510710,202204,417,287,130,347844,157560.6,505404.6
510715,202204,55,40,15,48480,18180,66660
510718,202204,234,113,121,136956,146652,283608
510719,202204,45,18,27,21816,32724,54540
510720,202204,179,127,52,153924.1,63024,216948.1
510724,202204,80,30,50,36360,60600,96960
510726,202204,65,32,33,38784,39996,78780
510729,202204,14,6,8,7272,9696,16968
510730,202204,453,244,209,295728,253308,549036
510735,202204,116,48,68,59388,82416,141804
510740,202204,20,11,9,13332.69,10908,24240.69
510757,202204,24,19,5,23028,6060,29088
510760,202204,7369,3766,3603,4565611.95,4371687.98,8937299.93
510770,202204,683,322,361,390264.3,438744.2,829008.5
510774,202204,17,7,10,8484,12120,20604
510775,202204,115,88,27,107262,32724,139986
510776,202204,40,12,28,14544,35148.6,49692.6
510777,202204,192,80,112,96960,135744,232704
510779,202204,36,22,14,26664,16968,43632
510780,202204,265,145,120,175740,145440,321180
510785,202204,352,197,155,238764,187860,426624
510787,202204,187,89,98,107868.1,118776,226644.1
510788,202204,6,1,5,1212,6060,7272
510790,202204,2577,1327,1250,1608382.32,1515040.8,3123423.12
510792,202204,1104,610,494,741745.89,599940.01,1341685.90
510794,202204,110,61,49,73932,59388,133320
510795,202204,2273,1326,947,1609539.3,1147766.01,2757305.31
510800,202204,185,110,75,134532,90900,225432
510805,202204,201,131,70,158772,84840,243612
510810,202204,100,42,58,50904,70296,121200
510820,202204,232,117,115,141804.92,139381.6,281186.52
510830,202204,76,41,35,49692.48,42420,92112.48
510835,202204,17,12,5,14544,6060,20604
510840,202204,9078,4235,4843,5135252.94,5872142.31,11007395.25
510850,202204,206,87,119,105444,144228,249672
510860,202204,408,197,211,238764,255732.39,494496.39
510880,202204,70,49,21,60600,25452,86052
510885,202204,68,41,27,49692,32724,82416
510890,202204,67,37,30,44844.2,36360,81204.2
510895,202204,168,101,67,122412,81204,203616
520005,202204,134,53,81,64236,98172,162408
520010,202204,281,122,159,147864,195132,342996
520013,202204,732,497,235,602364.6,284820.2,887184.8
520015,202204,44,31,13,37572,15756,53328
520017,202204,87,51,36,61812,43632,105444
520020,202204,14,6,8,7272,9696,16968
520025,202204,2671,1414,1257,1716194.57,1524696.6,3240891.17
520030,202204,789,428,361,521463.4,438744,960207.4
520050,202204,64,47,17,56964,20604,77568
520055,202204,67,43,24,52116,29088,81204
520060,202204,181,116,65,140592.1,78780,219372.1
520080,202204,573,417,156,506616,189072,695688
520082,202204,15,11,4,13332,4848,18180
520085,202204,86,65,21,78780,25452,104232
520090,202204,87,62,25,75144,30300,105444
520110,202204,8998,3849,5149,4666208.05,6252711.32,10918919.37
520120,202204,10,5,5,6060,6060,12120
520130,202204,806,569,237,689628.3,287244,976872.3
520140,202204,11865,6551,5314,7947095.35,6447845.01,14394940.36
520145,202204,53,31,22,37572,26664,64236
520150,202204,153,121,32,147864,38784,186648
520160,202204,46,31,15,37572,18180,55752
520170,202204,227,128,99,155136.1,121200,276336.1
520180,202204,183,85,98,103020.2,118776,221796.2
520215,202204,204,139,65,168468,78780,247248
520235,202204,81,62,19,75144,23028,98172
520250,202204,130,75,55,90900,66660,157560
520260,202204,114,69,45,83628,54540,138168
520280,202204,43,32,11,38784,13332,52116
520310,202204,44,26,18,31512,21816,53328
520320,202204,168,103,65,124836,78780,203616
520330,202204,807,445,362,539340.2,442380,981720.2
520340,202204,364,210,154,254520.61,186648,441168.61
520350,202204,480,241,239,292092,290880,582972
520355,202204,87,50,37,60600,44844,105444
520357,202204,29,24,5,29088,6060,35148
520360,202204,3,2,1,2424,1212,3636
520380,202204,138,78,60,94536,72720,167256
520390,202204,241,104,137,126048.1,167256,293304.1
520393,202204,15,12,3,14544,3636,18180
520396,202204,73,50,23,60600,27876,88476
520400,202204,201,124,77,150288,93324,243612
520410,202204,196,97,99,117564,119988,237552
520420,202204,19,12,7,14544,8484,23028
520425,202204,247,126,121,152712,146652.4,299364.4
520430,202204,510,242,268,293304,324816.6,618120.6
520440,202204,652,469,183,568428.48,221796,790224.48
520450,202204,2056,879,1177,1066561.46,1427736.1,2494297.56
520455,202204,56,31,25,37572,30300,67872
520460,202204,39,24,15,29088,18180,47268
520465,202204,35,30,5,36360,6060,42420
520470,202204,435,280,155,339361.76,187860,527221.76
520480,202204,82,48,34,58176,41208.2,99384.2
520485,202204,102,37,65,44844,78780,123624
520490,202204,435,325,110,393900.3,133320,527220.3
520495,202204,154,91,63,110292,76356,186648
520500,202204,185,147,38,178164,46056,224220
520505,202204,199,115,84,139380,101808,241188
520510,202204,1865,885,980,1072621.56,1190186.72,2262808.28
520520,202204,49,34,15,41208,18180,59388
520530,202204,202,162,40,196344,49692,246036
520540,202204,655,447,208,541765.57,252096,793861.57
520545,202204,139,78,61,94536,73932,168468
520547,202204,54,31,23,37572.2,27876,65448.2
520549,202204,1350,633,717,767197.28,870217.5,1637414.78
520551,202204,325,168,157,203616.6,190284.6,393901.2
520552,202204,34,26,8,32724,9696,42420
520570,202204,15,10,5,12120,6060,18180
520580,202204,269,170,99,207252,122412,329664
520590,202204,142,80,62,96960.19,75144,172104.19
520620,202204,1132,526,606,638725.8,735684.6,1374410.4
520630,202204,40,21,19,25452,23028,48480
520640,202204,371,218,153,264216.57,185436,449652.57
520650,202204,65,31,34,37572,41208,78780
520660,202204,41,21,20,25452.1,24240,49692.1
520670,202204,42,34,8,41208,9696,50904
520680,202204,36,22,14,26664,16968,43632
520690,202204,38,9,29,10908,35148,46056
520710,202204,33,28,5,33936,6060,39996
520725,202204,199,146,53,176952.2,64236,241188.2
520735,202204,55,36,19,43632,23028,66660
520740,202204,458,220,238,266640,289668.6,556308.6
520750,202204,34,24,10,29088,12120,41208
520753,202204,70,48,22,58176,26664,84840
520760,202204,99,65,34,78780.5,41208,119988.5
520780,202204,268,207,61,250884,75144.18,326028.18
520790,202204,155,93,62,112716,75144,187860
520800,202204,3320,1844,1476,2237356.55,1792549.48,4029906.03
520810,202204,142,110,32,133320,38784,172104
520815,202204,4,3,1,3636,1212,4848
520830,202204,139,93,46,112716,56964,169680
520840,202204,387,252,135,306636,163620,470256
520850,202204,97,53,44,64236.57,53328,117564.57
520860,202204,1765,1135,630,1376833.06,763560.7,2140393.76
520870,202204,31427,14490,16937,17575239.89,20565229.28,38140469.17
520880,202204,1179,633,546,768410.28,662964.6,1431374.88
520890,202204,804,497,307,603576.2,373296,976872.2
520910,202204,975,519,456,629029.74,556308,1185337.74
520915,202204,88,68,20,82416,24240,106656
520920,202204,429,202,227,244824,275124,519948
520929,202204,15,13,2,15756.2,2424,18180.2
520940,202204,64,45,19,54540,23028,77568
520945,202204,12,8,4,9696,4848,14544
520960,202204,39,23,16,27876,19392,47268
520970,202204,374,216,158,263004,191496,454500
520980,202204,92,66,26,79992,31512,111504
520990,202204,439,310,129,378144,158772,536916
520993,202204,129,66,63,79992,76356,156348
520995,202204,252,139,113,168468.04,136956,305424.04
521000,202204,1558,901,657,1092013.78,799920.3,1891934.08
521010,202204,648,341,307,414505.3,382992.91,797498.21
521015,202204,11,7,4,8484,4848,13332
521020,202204,1384,967,417,1173217.65,505404.7,1678622.35
521030,202204,60,39,21,47268,25452,72720
521040,202204,947,627,320,759925.3,387840,1147765.3
521056,202204,55,35,20,42420,24240,66660
521060,202204,121,79,42,95748,50904,146652
521080,202204,344,267,77,324816.8,93324,418140.8
521090,202204,555,363,192,439956.54,233916,673872.54
521100,202204,259,191,68,231492,82416,313908
521120,202204,1035,726,309,881126.13,374508.6,1255634.73
521130,202204,329,238,91,288456.1,110292.6,398748.7
521140,202204,185,102,83,123624,100596,224220
521150,202204,2499,1089,1410,1321081.42,1751341.83,3072423.25
521160,202204,22,9,13,10908,15756,26664
521170,202204,220,124,96,150288,116352,266640
521180,202204,1151,741,410,899308.14,499345.2,1398653.34
521190,202204,2517,1070,1447,1296840.85,1753764.3,3050605.15
521200,202204,54,36,18,43632,21816,65448
521205,202204,11,8,3,9696,3636,13332
521210,202204,121,76,45,93324.9,54540,147864.9
521220,202204,723,506,217,614484,263004,877488
521225,202204,25,19,6,23028,7272,30300
521230,202204,101,62,39,75144,48480,123624
521250,202204,6181,3468,2713,4210496.73,3290585.29,7501082.02
521260,202204,32,13,19,15756,23028,38784
521270,202204,134,103,31,124836,37572,162408
521280,202204,409,253,156,306636,189072,495708
521290,202204,26,17,9,20604,10908,31512
521295,202204,100,67,33,81204,41208,122412
521300,202204,230,125,105,151500,127260,278760
521305,202204,37,29,8,35148,9696,44844
521308,202204,999,762,237,924759.12,287244.1,1212003.22
521310,202204,1315,744,571,901729.4,694476,1596205.4
521340,202204,21,16,5,19392,6060,25452
521350,202204,112,86,26,104232,31512,135744
521370,202204,159,111,48,134532,58176,192708
521375,202204,187,91,96,110292.6,116352,226644.6
521377,202204,50,40,10,48480,12120,60600
521380,202204,1047,638,409,773256.79,498132,1271388.79
521385,202204,11,7,4,8484,4848,13332
521390,202204,101,82,19,99384,23028,122412
521400,202204,361,251,110,304212.6,133320,437532.6
521405,202204,142,81,61,98172,73932,172104
521410,202204,74,55,19,66660,23028,89688
521440,202204,204,143,61,173316,73932,247248
521450,202204,752,412,340,499344.2,412080,911424.2
521460,202204,1077,722,355,875064,431472,1306536
521470,202204,13,9,4,10908,4848,15756
521480,202204,40,29,11,35148,13332.6,48480.6
521483,202204,309,191,118,231493.2,143016,374509.2
521486,202204,296,193,103,233916,124836,358752
521487,202204,23,10,13,12120,15756,27876
521490,202204,23,13,10,15756,12120,27876
521500,202204,136,62,74,75144,89688,164832
521520,202204,44,33,11,39996,13332,53328
521523,202204,882,519,363,631452.4,439956,1071408.4
521525,202204,50,33,17,39996,20604,60600
521530,202204,234,135,99,163620,119988,283608
521540,202204,36,17,19,20604,23028,43632
521550,202204,101,43,58,52116,70296,122412
521560,202204,843,566,277,687204.4,335724.8,1022929.2
521565,202204,66,49,17,59388,20604,79992
521570,202204,529,337,192,409656.16,233916.6,643572.76
521580,202204,50,32,18,38784,21816,60600
521590,202204,33,15,18,18180,21816,39996
521600,202204,25,11,14,13332,16968,30300
521630,202204,239,124,115,150288,139380.78,289668.78
521640,202204,298,160,138,193920.35,167256.26,361176.61
521645,202204,36,20,16,24240,19392,43632
521680,202204,245,152,93,185436,112716.4,298152.4
521690,202204,11,10,1,12120,1212,13332
521710,202204,1125,534,591,649632.4,717504.6,1367137.0
521720,202204,523,361,162,437532.4,196344.96,633877.36
521730,202204,657,312,345,378144.8,419352,797496.8
521740,202204,880,397,483,482377.15,586608,1068985.15
521760,202204,2210,1158,1052,1406001.11,1275024,2681025.11
521770,202204,805,508,297,616908,359964,976872
521800,202204,1949,1289,660,1563481.8,801132,2364613.8
521805,202204,34,18,16,21816,19392,41208
521810,202204,96,55,41,66660,49692,116352
521830,202204,965,693,272,839916.65,329665.45,1169582.10
521839,202204,76,46,30,55752,36360,92112
521850,202204,1112,553,559,670239.15,677508.8,1347747.95
521860,202204,325,204,121,247248.8,146652,393900.8
521870,202204,76,47,29,56964,35148,92112
521878,202204,34,13,21,15756,25452,41208
521880,202204,4807,2113,2694,2562172.24,3267553,5829725.24
521890,202204,585,398,187,484759.6,226644,711403.6
521900,202204,276,217,59,263004.2,71508,334512.2
521910,202204,170,118,52,143016,63024,206040
521920,202204,39,23,16,27876,19392,47268
521925,202204,48,28,20,33936,24240,58176
521930,202204,1155,646,509,782953.04,618120.2,1401073.24
521935,202204,31,22,9,26664,10908,37572
521940,202204,230,100,130,121200,157560,278760
521945,202204,16,13,3,15756,3636,19392
521950,202204,14,10,4,12120,4848,16968
521960,202204,64,48,16,58176,19392,77568
521970,202204,395,251,144,304212,174528,478740
521971,202204,112,58,54,70296,65448,135744
521973,202204,38,18,20,21816,24240,46056
521975,202204,1586,809,777,980510.1,942937.4,1923447.5
521980,202204,246,163,83,197556,100596,298152
521990,202204,74,53,21,64236,25452,89688
522000,202204,284,186,98,226221.01,118776,344997.01
522005,202204,18,11,7,13332,8484,21816
522010,202204,1102,624,478,757501.6,579336,1336837.6
522015,202204,59,37,22,44844,26664,71508
522020,202204,909,541,368,655692.1,446016.2,1101708.3
522026,202204,23,15,8,18180,10908,29088
522028,202204,19,15,4,18180,4848,23028
522040,202204,777,335,442,406020.3,538128.56,944148.86
522045,202204,2529,1509,1020,1831335.42,1238664.6,3070000.02
522050,202204,155,76,79,92112,95748,187860
522060,202204,533,337,196,408444.2,238764,647208.2
522068,202204,105,75,30,90900,36360,127260
522070,202204,12,11,1,13332,1212,14544
522100,202204,36,23,13,27876,15756,43632
522108,202204,42,32,10,38784.2,12120,50904.2
522119,202204,57,33,24,39996,29088,69084
522130,202204,72,26,46,31512,55752,87264
522140,202204,4081,2146,1935,2602167.55,2352492.78,4954660.33
522145,202204,43,33,10,39996,12120,52116
522150,202204,104,69,35,83628,42420,126048
522155,202204,53,39,14,47268,16968,64236
522157,202204,9,6,3,7272,3636,10908
522160,202204,1645,985,660,1193822,799920.72,1993742.72
522170,202204,400,271,129,328452.9,156348,484800.9
522180,202204,32,11,21,13332,25452,38784
522185,202204,2265,962,1303,1167157.57,1584084.36,2751241.93
522190,202204,67,37,30,44844.2,36360,81204.2
522200,202204,298,177,121,215736,146652,362388
522205,202204,148,103,45,124836.32,54540,179376.32
522220,202204,135,100,35,121200,42420,163620
522230,202204,34,30,4,36360,4848,41208
530010,202204,53841,27393,26448,33234339.41,32097540.87,65331880.28
110001,202205,505,410,95,496922.03,115140,612062.03
110002,202205,2801,1787,1014,2168073.16,1232606.55,3400679.71
110003,202205,82,67,15,81204.1,18180,99384.1
110004,202205,2000,1348,652,1633784.52,791436.72,2425221.24
110005,202205,423,338,85,410868.68,103020,513888.68
110006,202205,427,318,109,385416.8,133320.8,518737.6
110007,202205,68,54,14,65448.2,16968,82416.2
110008,202205,238,135,103,163620.97,124836.2,288457.17
110009,202205,914,691,223,838704.59,270276.4,1108980.99
110010,202205,1646,971,675,1176856.08,820524.6,1997380.68
110011,202205,1675,1306,369,1582885.62,448441.69,2031327.31
110012,202205,4048,2366,1682,2867599.93,2041012.96,4908612.89
110013,202205,717,566,151,685995.57,184224.9,870220.47
110014,202205,359,315,44,381781.47,53328,435109.47
110015,202205,1326,1046,280,1267757.73,339360.9,1607118.63
110018,202205,1011,627,384,763564.31,465409.2,1228973.51
110020,202205,15678,8920,6758,10817189.05,8196789.67,19013978.72
110025,202205,650,477,173,578125.94,209676.47,787802.41
110026,202205,33,22,11,26664,13332,39996
110028,202205,1563,1110,453,1345336.66,549039.1,1894375.76
110029,202205,121,109,12,132108.6,14544,146652.6
110030,202205,2372,1577,795,1911140.39,963543.49,2874683.88
110032,202205,305,234,71,283610.39,87264.76,370875.15
110033,202205,627,454,173,550254.36,212101.2,762355.56
110034,202205,313,229,84,277548.25,101808,379356.25
110037,202205,83,75,8,90900.2,9696,100596.2
110040,202205,392,267,125,323604,151500,475104
110045,202205,914,650,264,789017.76,321180.36,1110198.12
110050,202205,88,76,12,92112.99,14544,106656.99
110060,202205,62,37,25,44844,30300,75144
110070,202205,111,73,38,88476,46056,134532
110080,202205,507,293,214,355117.22,259368.5,614485.72
110090,202205,25,21,4,25452,4848,30300
110092,202205,106,57,49,69084.71,59388,128472.71
110094,202205,193,135,58,163620.3,70296,233916.3
110100,202205,45,32,13,38784,15756,54540
110110,202205,95,56,39,67873.28,47268,115141.28
110120,202205,66,58,8,70296.2,9696.65,79992.85
110130,202205,272,221,51,267853.4,61812.1,329665.5
110140,202205,243,174,69,210888.69,83628.1,294516.79
110143,202205,51,41,10,49692,12120,61812
110145,202205,39,30,9,36360,10908,47268
110146,202205,24,11,13,13332,15756,29088
110147,202205,36,25,11,30300,13332,43632
110148,202205,34,26,8,33936,9696,43632
110149,202205,308,219,89,265428,107868.1,373296.1
110150,202205,137,105,32,127260,38784,166044
110155,202205,10,9,1,10908,1212,12120
110160,202205,62,48,14,58176,16968,75144
110170,202205,212,161,51,195132.1,61812,256944.1
110175,202205,58,46,12,56964,14544,71508
110180,202205,94,76,18,92112,21816,113928
120001,202205,193,143,50,173317.47,60600.7,233918.17
120005,202205,197,113,84,136956.49,101808,238764.49
120010,202205,1132,691,441,839917.75,534492,1374409.75
120013,202205,154,106,48,128472.97,58176,186648.97
120017,202205,118,66,52,79992.2,63024,143016.2
120020,202205,3392,2750,642,3335510.85,778117.25,4113628.10
120025,202205,562,313,249,379358.81,301789.22,681148.03
120030,202205,1056,908,148,1100548.23,179384.8,1279933.03
120032,202205,40,35,5,42420,6060,48480
120033,202205,219,191,28,231502.19,33936.55,265438.74
120034,202205,172,125,47,151500.2,56964,208464.2
120035,202205,42,35,7,43632,8484,52116
120038,202205,398,257,141,311489.43,170893.16,482382.59
120039,202205,29,28,1,33937.65,1212,35149.65
120040,202205,13949,9395,4554,11394740.45,5519774.28,16914514.73
120042,202205,44,40,4,48480,4848.55,53328.55
120043,202205,15,3,12,3636,14544,18180
120045,202205,527,341,186,413297.27,226646,639943.27
120050,202205,1259,966,293,1170849.91,355126.91,1525976.82
120060,202205,1450,1210,240,1466576.83,290886.8,1757463.63
120070,202205,399,291,108,352694.92,132108,484802.92
120080,202205,180,114,66,138169.75,79992.65,218162.40
130002,202205,158,114,44,138168,53328,191496
130006,202205,102,68,34,82416,41208,123624
130008,202205,124,71,53,86052,64236,150288
130010,202205,195,132,63,159984.4,76356.1,236340.5
130014,202205,285,206,79,249975,95748,345723
130020,202205,119,77,42,93324,50904,144228
130030,202205,933,533,400,645996.2,484800.92,1130797.12
130040,202205,382,180,202,218160.6,246036,464196.6
130050,202205,532,282,250,341784.6,303000.4,644785.0
130060,202205,857,586,271,711444.38,328452,1039896.38
130063,202205,610,374,236,453288,286032,739320
130068,202205,213,137,76,166044.95,92112.56,258157.51
130070,202205,1334,897,437,1087167.74,529645.55,1616813.29
130080,202205,678,454,224,550248.16,272700.2,822948.36
130083,202205,79,49,30,59388.6,36360,95748.6
130090,202205,320,182,138,220584,167256,387840
130100,202205,1189,545,644,660541.27,780528.2,1441069.47
130110,202205,730,325,405,393900,490860.28,884760.28
130115,202205,143,73,70,88476.6,84840,173316.6
130120,202205,1627,1028,599,1247149.76,727200,1974349.76
130130,202205,602,413,189,501768,229068.1,730836.1
130140,202205,1543,1196,347,1449552.02,420564,1870116.02
130150,202205,397,347,50,420564.2,60600,481164.2
130160,202205,433,262,171,318756.7,208464,527220.7
130165,202205,71,57,14,69084.2,16968,86052.2
130170,202205,1002,700,302,848330.46,366026.52,1214356.98
130180,202205,250,183,67,221796.3,81204.1,303000.4
130185,202205,2181,1029,1152,1248368.03,1396228.81,2644596.84
130190,202205,3325,2076,1249,2516122.65,1515003.13,4031125.78
130195,202205,278,219,59,265428,71508,336936
130200,202205,172,87,85,105444,104232,209676
130210,202205,92,45,47,54540,56964,111504
130220,202205,198,139,59,168468,71508,239976
130230,202205,364,241,123,292092,149076,441168
130240,202205,1302,842,460,1020505.25,557520.2,1578025.45
130250,202205,4954,3133,1821,3798428.46,2207060.05,6005488.51
130255,202205,418,214,204,259368,247248,506616
130260,202205,59244,27853,31391,33771272.39,38064460.5,71835732.89
130270,202205,1505,1032,473,1250893.65,574488,1825381.65
130280,202205,134,78,56,94536,67872,162408
130290,202205,2059,1364,695,1653177.09,842343.06,2495520.15
130300,202205,425,297,128,359964.2,155136.97,515101.17
130310,202205,889,467,422,566004.2,511464.1,1077468.3
130320,202205,549,300,249,363601.8,301788,665389.8
130330,202205,741,473,268,573277.28,324816,898093.28
130340,202205,3372,1874,1498,2272510.08,1818007.97,4090518.05
130350,202205,458,311,147,376932,178164,555096
130353,202205,926,409,517,495711.56,626605.25,1122316.81
130356,202205,770,347,423,420564.21,513888,934452.21
130360,202205,91,70,21,84840,25452,110292
130370,202205,680,528,152,639936,184224,824160
130380,202205,631,487,144,590244,174528,764772
130390,202205,473,385,88,466620,106656,573276
130395,202205,158,46,112,55752,135744.35,191496.35
130400,202205,97,75,22,90900.2,26664,117564.2
130406,202205,2193,1290,903,1563483.07,1094436.2,2657919.27
130410,202205,442,220,222,266640,269064,535704
130420,202205,2756,2246,510,2724590.69,618120.4,3342711.09
130423,202205,188,114,74,138168.6,89688,227856.6
130426,202205,182,99,83,119988,100596,220584
130430,202205,403,235,168,284820,203616,488436
130440,202205,199,65,134,78780.2,162408.7,241188.9
140002,202205,26,5,21,6060,25452,31512
140005,202205,213,128,85,155136.72,103020.5,258157.22
140010,202205,11296,6900,4396,8367722.99,5331613.74,13699336.73
140015,202205,147,69,78,83628.2,94536,178164.2
140017,202205,118,72,46,87266.26,55752.55,143018.81
140020,202205,436,285,151,345421.76,184224.98,529646.74
140023,202205,46,22,24,26664.2,29088,55752.2
140028,202205,24,13,11,15756,13332.1,29088.1
140030,202205,364,240,124,290882.55,150288.1,441170.65
140040,202205,60,42,18,50904,21816,72720
140045,202205,271,100,171,121200,207252,328452
140047,202205,495,327,168,396326.18,203616.2,599942.38
140050,202205,137,84,53,101808.33,64236,166044.33
140060,202205,70,46,24,55752,29088.4,84840.4
140070,202205,27,25,2,30300.2,2424,32724.2
150010,202205,4881,2948,1933,3574201.96,2342803.83,5917005.79
150013,202205,162,114,48,138168,58176.2,196344.2
150020,202205,1087,589,498,715082.5,603576,1318658.5
150030,202205,697,312,385,378145.69,466620.3,844765.99
150034,202205,210,129,81,156348.2,98172,254520.2
150040,202205,1597,906,691,1098079.45,839919.23,1937998.68
150050,202205,703,404,299,489650.44,362388.71,852039.15
150060,202205,4806,3028,1778,3669851.3,2157866.24,5827717.54
150070,202205,450,235,215,284820,260580.6,545400.6
150080,202205,16361,7633,8728,9254894.44,10583244.04,19838138.48
150085,202205,406,258,148,312699.08,179376.68,492075.76
150090,202205,671,554,117,671449,141804.33,813253.33
150095,202205,44,29,15,35148.08,18180.5,53328.58
150100,202205,66,40,26,48480.1,31512.3,79992.4
150110,202205,209,116,93,140592,112716,253308
150120,202205,395,286,109,346632.76,133320.2,479952.96
150125,202205,47,17,30,20604,36360,56964
150130,202205,2153,1075,1078,1302904.88,1306539.15,2609444.03
150140,202205,58007,25432,32575,30833529.11,39492017.3,70325546.41
150145,202205,249,135,114,163621.11,138168,301789.11
150150,202205,3315,1455,1860,1763475.74,2254334.3,4017810.04
150157,202205,377,268,109,324818.44,132108,456926.44
150160,202205,131,101,30,122412,36360,158772
150170,202205,3883,2829,1054,3428761.85,1278664.4,4707426.25
150172,202205,357,250,107,303000.36,129684,432684.36
150175,202205,81,46,35,55752,42420,98172
150178,202205,747,506,241,613274.1,292092.2,905366.3
150180,202205,3200,1566,1634,1897999.91,1980410.95,3878410.86
150190,202205,365,237,128,287246.22,155136.85,442383.07
150195,202205,119,61,58,73932,70296.75,144228.75
150200,202205,194,91,103,110292,124836,235128
150210,202205,3191,2512,679,3045765.24,824161.87,3869927.11
150215,202205,600,370,230,448443.37,278762.05,727205.42
150220,202205,3486,2312,1174,2802162.11,1422892.85,4225054.96
150230,202205,1312,1050,262,1272604.31,317545.13,1590149.44
150240,202205,6929,3872,3057,4695319.51,3707527.67,8402847.18
150250,202205,74,41,33,49692,39996,89688
150260,202205,108,75,33,90900.2,39996,130896.2
150270,202205,2129,1383,746,1676203.46,906578.85,2582782.31
150275,202205,531,338,193,412082,235128.5,647210.5
150276,202205,111,40,71,48480,86052,134532
150277,202205,830,372,458,450868.26,555099.1,1005967.36
150280,202205,351,238,113,288456.16,138168,426624.16
150285,202205,142,68,74,82416.5,89494.08,171910.58
150290,202205,1200,685,515,831439.23,624181.82,1455621.05
150293,202205,752,359,393,435110.34,477528.75,912639.09
150295,202205,546,252,294,305425.83,356328,661753.83
150300,202205,90,44,46,53328.1,55752,109080.1
150304,202205,186,113,73,136956,88476.55,225432.55
150307,202205,428,352,76,426626.59,92112.6,518739.19
150309,202205,591,420,171,509043.58,207254.05,716297.63
150310,202205,269,179,90,216948.75,109080,326028.75
150320,202205,1837,1276,561,1546517.02,679934.8,2226451.82
150330,202205,2052,1187,865,1438646.16,1048381.16,2487027.32
150340,202205,191,128,63,155136,76356,231492
150345,202205,621,347,274,420564.84,333300,753864.84
150350,202205,396,312,84,378150,101808.2,479958.2
150360,202205,4735,2830,1905,3432404.13,2310079.01,5742483.14
150370,202205,828,567,261,687208.92,316334.29,1003543.21
150375,202205,193,86,107,104232,129684.08,233916.08
150380,202205,1504,995,509,1205953.03,616910.78,1822863.81
150390,202205,877,503,374,609640.41,454502.16,1064142.57
150400,202205,109,90,19,109080,23028,132108
150405,202205,1591,1013,578,1227761.43,702960.44,1930721.87
150410,202205,109,68,41,82416,49692,132108
150420,202205,7585,4065,3520,4928240.46,4267484.28,9195724.74
150430,202205,627,391,236,473904.52,286033.94,759938.46
150440,202205,446,276,170,334515.93,206040,540555.93
150442,202205,2345,1236,1109,1498041.44,1344113.02,2842154.46
150445,202205,539,350,189,424202.1,229068,653270.1
150450,202205,216,123,93,149076,112716,261792
150460,202205,711,538,173,652059.09,209676.27,861735.36
150470,202205,1269,755,514,915062.06,622968.1,1538030.16
150475,202205,239,182,57,220585.55,69084.9,289670.45
150480,202205,1386,970,416,1175648.31,506618.84,1682267.15
150490,202205,592,345,247,418140,299364,717504
150495,202205,335,252,83,305424,101808,407232
150497,202205,283,191,92,231493,111504,342997
150500,202205,257,156,101,189073.59,122412,311485.59
150503,202205,1299,646,653,782957.59,791437.55,1574395.14
150506,202205,911,623,288,755079.01,349056.1,1104135.11
150510,202205,1302,705,597,854464.48,723564.38,1578028.86
150520,202205,328,223,105,270276.57,127260.2,397536.77
150530,202205,1856,1025,831,1243529.64,1007184.47,2250714.11
150540,202205,206,152,54,184224.4,65448,249672.4
150543,202205,840,442,398,535708.72,482379.68,1018088.40
150548,202205,442,318,124,385416.76,151500,536916.76
150549,202205,72,47,25,56964,30300,87264
150550,202205,3027,1496,1531,1813158.69,1857996.7,3671155.39
150553,202205,3458,1941,1517,2352509.02,1839826.86,4192335.88
150555,202205,141,75,66,90900,79992,170892
150560,202205,56,25,31,30300.2,37572,67872.2
150563,202205,125,65,60,78780.78,72720.07,151500.85
150565,202205,208,129,79,156348.2,95748,252096.2
150570,202205,424,283,141,342996,170892,513888
150580,202205,1717,841,876,1019292.7,1061712.77,2081005.47
150590,202205,830,540,290,654483.31,351481.83,1005965.14
150600,202205,521,311,210,376934.69,254522.43,631457.12
150610,202205,157,125,32,151500,38784,190284
150611,202205,133,87,46,105444,55752,161196
150613,202205,3315,1885,1430,2285845.35,1734437.82,4020283.17
150616,202205,570,313,257,379357.35,311485.07,690842.42
150618,202205,1377,713,664,864158.73,805980.2,1670138.93
150619,202205,395,301,94,365661.6,113928.92,479590.52
150620,202205,1252,725,527,878706.19,638724.5,1517430.69
150630,202205,146,97,49,117566.74,59388.2,176954.94
150635,202205,454,199,255,242400.71,310274.56,552675.27
150640,202205,42,18,24,21816,29088,50904
150650,202205,2417,1391,1026,1687115.98,1243520.31,2930636.29
150655,202205,246,182,64,220584.2,77568,298152.2
150658,202205,77,46,31,55752,37572,93324
150660,202205,573,373,200,452079.12,242400,694479.12
150670,202205,1120,406,714,492073.32,866581.58,1358654.90
150680,202205,10735,5661,5074,6863442.15,6150939.83,13014381.98
150690,202205,29,15,14,18180.2,16968,35148.2
150700,202205,487,317,170,384208.8,206040.48,590249.28
150710,202205,282,166,116,201192.2,140592.4,341784.6
150715,202205,833,527,306,638727.02,370872.65,1009599.67
150720,202205,418,322,96,390266.07,116352.2,506618.27
150730,202205,1067,520,547,631454.48,662966.6,1294421.08
150740,202205,236,153,83,185436.2,100596,286032.2
150745,202205,774,432,342,523587.17,414504.1,938091.27
150746,202205,69,37,32,44844,38784,83628
150747,202205,240,177,63,214524,76356,290880
150750,202205,131,72,59,87264.4,71508.8,158773.2
150760,202205,1825,1182,643,1435016.5,781741.96,2216758.46
150770,202205,396,222,174,269064.1,210888,479952.1
150775,202205,102,55,47,66660.2,58176,124836.2
150780,202205,198,117,81,141804,98172,239976
150790,202205,669,381,288,461774.92,349057.48,810832.40
150795,202205,1635,1003,632,1216854.46,765987.15,1982841.61
150796,202205,322,184,138,223008,167256.72,390264.72
150797,202205,387,184,203,223008.4,246036,469044.4
150800,202205,1576,884,692,1071409.93,838704.9,1910114.83
150803,202205,508,397,111,481166.06,134532.1,615698.16
150805,202205,204,120,84,145440.4,101808.1,247248.5
150808,202205,1032,538,494,653269.04,598728.84,1251997.88
150810,202205,3172,2157,1015,2614292.49,1230181.5,3844473.99
150812,202205,491,251,240,305424.68,290880.1,596304.78
150815,202205,1169,734,435,890820.7,527220.2,1418040.9
150820,202205,1549,932,617,1129598.54,747811.56,1877410.10
150830,202205,552,408,144,494496.88,174529.05,669025.93
150835,202205,233,136,97,164832.6,117564,282396.6
150840,202205,1416,843,573,1022930,694478.8,1717408.8
160005,202205,62,42,20,50904.06,24240.02,75144.08
160010,202205,187,119,68,144228.6,82416.18,226644.78
160015,202205,144,87,57,105444.36,69084.1,174528.46
160020,202205,133,68,65,82416.45,78780,161196.45
160021,202205,67,31,36,37573.3,43632.02,81205.32
160023,202205,66,42,24,50904.54,29088.34,79992.88
160025,202205,22,10,12,12120.52,14544.02,26664.54
160027,202205,1486,836,650,1013239.43,787802.4,1801041.83
160030,202205,16644,8564,8080,10385726.45,9794232.9,20179959.35
160040,202205,292,174,118,210888.92,143016.22,353905.14
160050,202205,723,351,372,425414.87,450866.45,876281.32
160053,202205,288,168,120,203618.28,145440.14,349058.42
160055,202205,22,15,7,18180.02,8484,26664.02
160060,202205,6651,3552,3099,4308692.85,3757219.03,8065911.88
160070,202205,191,114,77,138168.02,93324.1,231492.12
160080,202205,126,66,60,79992.07,72720,152712.07
170025,202205,26,15,11,18180,13332,31512
170030,202205,179,144,35,174529.27,42420.07,216949.34
170035,202205,201,97,104,117564.2,126049.06,243613.26
170040,202205,175,129,46,156348,55752,212100
170070,202205,319,202,117,244826.15,141804.27,386630.42
170100,202205,336,247,89,299365.87,107868,407233.87
170105,202205,43,37,6,44844,7272,52116
170110,202205,114,69,45,83628,54540.1,138168.1
170130,202205,72,38,34,46056,41208,87264
170190,202205,95,55,40,66660.32,48480,115140.32
170200,202205,336,231,105,279972,127260,407232
170210,202205,6430,3444,2986,4175068.49,3620255.39,7795323.88
170215,202205,116,62,54,75144.2,65448,140592.2
170220,202205,1334,969,365,1176857.78,443592.81,1620450.59
170230,202205,142,92,50,111504,60600.1,172104.1
170240,202205,502,339,163,410869.77,197556.2,608425.97
170255,202205,1008,811,197,984146.99,238764.2,1222911.19
170270,202205,45,31,14,37572,16968,54540
170290,202205,129,80,49,96960.2,59388,156348.2
170300,202205,108,69,39,83628,47268,130896
170305,202205,47,37,10,44844,12120,56964
170307,202205,54,42,12,50904.8,14544,65448.8
170310,202205,117,69,48,83628,58176,141804
170320,202205,30,19,11,23028,13332,36360
170330,202205,29,22,7,26664,8484,35148
170360,202205,32,19,13,23028.2,15756.66,38784.86
170370,202205,79,40,39,48480.88,47268,95748.88
170380,202205,73,56,17,67872,20604,88476
170382,202205,37,32,5,38784,6060,44844
170384,202205,140,107,33,129684.15,39996,169680.15
170386,202205,69,28,41,33936,49692,83628
170388,202205,45,19,26,23028,31512.96,54540.96
170389,202205,23,20,3,24240.2,3636,27876.2
170390,202205,72,44,28,53328,35148,88476
170410,202205,24,22,2,26664,2424,29088
170460,202205,17,10,7,12120.1,8484,20604.1
170510,202205,35,25,10,30300.1,12120,42420.1
170550,202205,1530,896,634,1085961.71,768411.84,1854373.55
170555,202205,105,78,27,94536.95,32724,127260.95
170560,202205,108,77,31,93324,37572.1,130896.1
170600,202205,39,12,27,14544.2,32724,47268.2
170610,202205,177,95,82,115140.2,99384,214524.2
170625,202205,36,21,15,25452,18180,43632
170650,202205,89,62,27,75144,32724,107868
170700,202205,570,421,149,510252.3,180588,690840.3
170710,202205,151,98,53,118776.9,64236.74,183013.64
170720,202205,100,77,23,93324,27876.2,121200.2
170730,202205,98,59,39,71508,47268,118776
170740,202205,84,59,25,71508,30300,101808
170755,202205,50,27,23,32724.44,27876.1,60600.54
170765,202205,125,72,53,87265.06,64236,151501.06
170770,202205,192,124,68,150288,82416,232704
170820,202205,584,387,197,469045.51,238765.1,707810.61
170825,202205,42,24,18,29088,21816,50904
170830,202205,87,69,18,83628,21816,105444
170900,202205,170,132,38,159984.3,46056,206040.3
170930,202205,938,512,426,620546.61,517526.81,1138073.42
170950,202205,3152,1496,1656,1813204.93,2008289.51,3821494.44
170980,202205,17,10,7,12120.8,8484,20604.8
171050,202205,144,109,35,132108,42420,174528
171070,202205,54,46,8,55752.57,9696,65448.57
171090,202205,46,34,12,41208,14544,55752
171110,202205,24,18,6,21816.2,7272,29088.2
171150,202205,41,23,18,27876,21816,49692
171180,202205,23,9,14,10908,16968,27876
171190,202205,168,95,73,116352.2,88476,204828.2
171195,202205,57,47,10,56964,12120,69084
171200,202205,33,15,18,18180,21816,39996
171215,202205,8,6,2,7272,2424,9696
171240,202205,61,45,16,54540,19392,73932
171245,202205,52,44,8,53328.98,9696,63024.98
171250,202205,77,44,33,53328.1,39996,93324.1
171270,202205,12,8,4,9696,4848,14544
171280,202205,43,35,8,42420.59,9696,52116.59
171320,202205,989,566,423,687204.4,512676.2,1199880.6
171330,202205,420,215,205,260580,248461.03,509041.03
171360,202205,98,69,29,83628,35148,118776
171370,202205,34,18,16,21816,19392,41208
171380,202205,131,113,18,136956.24,21816,158772.24
171395,202205,43,25,18,30300,21816,52116
171420,202205,260,173,87,209677.4,105444.2,315121.6
171430,202205,73,60,13,72720,15756.15,88476.15
171488,202205,207,115,92,139380.14,111504,250884.14
171500,202205,60,33,27,39996,33936,73932
171510,202205,75,49,26,59388,31512,90900
171515,202205,37,30,7,36360,8484,44844
171525,202205,24,22,2,26664,2424,29088
171550,202205,14,8,6,9696.2,7272,16968.2
171570,202205,53,27,26,32724,31512,64236
171575,202205,268,177,91,214524,110292,324816
171610,202205,1778,895,883,1084742.62,1070199.98,2154942.60
171620,202205,141,97,44,117564.2,53328,170892.2
171630,202205,51,30,21,36360,25452,61812
171650,202205,334,232,102,281186.74,123624.4,404811.14
171660,202205,253,147,106,178165.75,128472.6,306638.35
171665,202205,79,49,30,59388.08,36360,95748.08
171670,202205,424,261,163,316332.4,197556,513888.4
171700,202205,64,56,8,67872,9696,77568
171720,202205,30,11,19,13332,23028,36360
171750,202205,99,50,49,61812.2,59388.2,121200.4
171780,202205,74,57,17,69084,20604,89688
171790,202205,83,68,15,82416,18180,100596
171800,202205,33,26,7,31512,8484,39996
171820,202205,2010,1166,844,1414411.28,1025352.56,2439763.84
171830,202205,32,24,8,29088.2,9696,38784.2
171840,202205,59,38,21,46056.2,25452,71508.2
171845,202205,28,18,10,21816.41,12120,33936.41
171850,202205,38,31,7,37572,8484,46056
171855,202205,75,56,19,67872,23028.2,90900.2
171865,202205,5,4,1,4848,1212,6060
171870,202205,29,18,11,21816,13332.45,35148.45
171875,202205,82,60,22,72720,26664,99384
171880,202205,39,23,16,27876,19392,47268
171884,202205,55,30,25,36360,30300,66660
171886,202205,126,57,69,69084,83628,152712
171888,202205,26,21,5,25452.05,6060,31512.05
171889,202205,11,5,6,6060,7272,13332
171890,202205,54,45,9,54540.96,10908,65448.96
171900,202205,31,21,10,25452.7,12120,37572.7
172000,202205,34,29,5,35148,6060,41208
172010,202205,55,44,11,53328,13332,66660
172015,202205,23,17,6,20604.52,7272,27876.52
172020,202205,144,93,51,112716,61812.1,174528.1
172025,202205,37,24,13,29088,15756,44844
172030,202205,44,25,19,30300,23028,53328
172049,202205,82,52,30,63024,36360,99384
172065,202205,113,73,40,88476.2,48480,136956.2
172080,202205,113,68,45,82416.54,54540,136956.54
172085,202205,30,16,14,19392,16968,36360
172090,202205,429,318,111,385417.08,134532,519949.08
172093,202205,15,13,2,15756,2424,18180
172097,202205,18,9,9,12120,10908,23028
172100,202205,5456,3117,2339,3781462.1,2837303.58,6618765.68
172110,202205,83,56,27,67872,32724,100596
172120,202205,1682,1404,278,1702877.37,339361.1,2042238.47
172125,202205,11,10,1,12120,1212,13332
172130,202205,26,15,11,18180,13332.7,31512.7
172208,202205,195,120,75,145440.2,92112,237552.2
172210,202205,355,179,176,216949.58,213312.66,430262.24
210005,202205,2981,1871,1110,2267666.11,1345330.09,3612996.20
210010,202205,145,90,55,109080.4,66660,175740.4
210015,202205,42,30,12,36360.19,14544,50904.19
210020,202205,369,212,157,256944,190284.44,447228.44
210030,202205,317,214,103,259369.42,124836.4,384205.82
210040,202205,134,108,26,130896.1,31512,162408.1
210043,202205,258,206,52,250885.78,63024.2,313909.98
210047,202205,487,299,188,362388.4,227856,590244.4
210050,202205,269,200,69,242400,83628,326028
210055,202205,53,42,11,50904,13332,64236
210060,202205,529,432,97,523587.96,117564.4,641152.36
210070,202205,443,345,98,418140,118776,536916
210080,202205,139,128,11,155136.4,13332,168468.4
210083,202205,289,147,142,178164,172104,350268
210087,202205,5,4,1,4848,1212,6060
210090,202205,430,309,121,374511.31,146652.17,521163.48
210095,202205,415,319,96,386629.66,116352.48,502982.14
210100,202205,700,557,143,675085.53,173316,848401.53
210110,202205,117,79,38,95748,46056,141804
210120,202205,4877,3871,1006,4695333.28,1219274.79,5914608.07
210125,202205,176,109,67,132108,81204.85,213312.85
210130,202205,447,265,182,321180.74,220584,541764.74
210135,202205,28,21,7,25452,8484,33936
210140,202205,4420,3415,1005,4142644.95,1218065.35,5360710.30
210150,202205,354,226,128,273915.04,155136.66,429051.70
210160,202205,3205,2734,471,3313629.9,572065.2,3885695.1
210170,202205,1194,962,232,1165953.05,281184,1447137.05
210173,202205,120,107,13,129684,15756,145440
210177,202205,316,178,138,215736.44,167256,382992.44
210180,202205,29,16,13,19392.2,15756,35148.2
210190,202205,435,293,142,355116,172104,527220
210193,202205,6,4,2,4848,2424,7272
210197,202205,70,53,17,64236,20604,84840
210200,202205,592,505,87,612062.81,105444,717506.81
210203,202205,200,144,56,174528.6,67872.72,242401.32
210207,202205,356,297,59,359965.99,71508,431473.99
210210,202205,703,654,49,792648.98,59388,852036.98
210215,202205,71,61,10,73933.15,12120,86053.15
210220,202205,360,309,51,374509.14,61812.2,436321.34
210230,202205,305,246,59,298153.29,71508,369661.29
210232,202205,1240,882,358,1068986.37,433896.2,1502882.57
210235,202205,185,140,45,169680.3,54540,224220.3
210237,202205,32,16,16,19392,19392,38784
210240,202205,74,64,10,77568,12120,89688
210250,202205,175,150,25,181800.2,30300,212100.2
210255,202205,363,276,87,334513.52,105444,439957.52
210260,202205,387,271,116,328452,140592,469044
210270,202205,601,413,188,500556.6,227856,728412.6
210275,202205,93,71,22,86052,26664,112716
210280,202205,1041,686,355,831435.92,430260.2,1261696.12
210290,202205,512,346,166,419353.5,202404.8,621758.3
210300,202205,4941,3181,1760,3856601.9,2135545.22,5992147.12
210310,202205,115,78,37,94536,44844,139380
210312,202205,119,83,36,100596,43632,144228
210315,202205,112,95,17,115140,20604,135744
210317,202205,138,105,33,127260,39996,167256
210320,202205,2326,1999,327,2424008.8,396324,2820332.8
210325,202205,143,86,57,104232.85,69084.2,173317.05
210330,202205,4246,2491,1755,3021522.94,2128273.59,5149796.53
210340,202205,1194,913,281,1107772.54,340573.39,1448345.93
210350,202205,670,559,111,677509.4,134532,812041.4
210355,202205,139,119,20,144228,24240,168468
210360,202205,2049,1462,587,1771954.24,711444.52,2483398.76
210370,202205,1204,620,584,751441.51,707808,1459249.51
210375,202205,186,90,96,109081.54,116352.1,225433.64
210380,202205,723,567,156,687205.6,189072,876277.6
210390,202205,188,159,29,192708.83,35148,227856.83
210400,202205,394,343,51,415717.76,61812,477529.76
210405,202205,1013,717,296,869005.4,358752.27,1227757.67
210407,202205,68,55,13,66660,15756,82416
210408,202205,41,36,5,43632,6060,49692
210409,202205,327,289,38,350268.16,46056,396324.16
210410,202205,431,343,88,415716,107868,523584
210420,202205,207,172,35,208464.3,42420.2,250884.5
210430,202205,53,38,15,46056,18180,64236
210440,202205,367,248,119,300579,144228,444807
210450,202205,102,87,15,105444.4,18180,123624.4
210455,202205,235,129,106,156351.59,128472.99,284824.58
210460,202205,302,208,94,252097.4,113928,366025.4
210462,202205,68,56,12,67872,14544,82416
210465,202205,136,109,27,132108.68,32724,164832.68
210467,202205,522,388,134,470257.01,162408,632665.01
210470,202205,47,40,7,49692,8484,58176
210480,202205,1273,922,351,1118680.01,425413.98,1544093.99
210490,202205,182,129,53,156348.3,64236,220584.3
210500,202205,476,297,179,359966.3,216948,576914.3
210510,202205,525,426,99,516312.2,119988,636300.2
210515,202205,349,224,125,272700.2,151500.2,424200.4
210520,202205,396,360,36,436320.84,43632,479952.84
210530,202205,9420,4898,4522,5936423.49,5483133.89,11419557.38
210535,202205,122,92,30,111504,36360,147864
210540,202205,1483,995,488,1205948.49,592668.4,1798616.89
210542,202205,1105,566,539,685997.34,653271.79,1339269.13
210545,202205,20,18,2,21816.2,2424,24240.2
210547,202205,121,105,16,127261.27,19392.31,146653.58
210550,202205,591,427,164,517527.25,199981.1,717508.35
210560,202205,157,135,22,163620.2,26664,190284.2
210565,202205,20,14,6,16968,7272.08,24240.08
210570,202205,1290,1076,214,1305329.92,259368,1564697.92
210580,202205,119,102,17,123624,20604,144228
210590,202205,714,597,117,723564.65,141804,865368.65
210592,202205,42,39,3,47268,3636,50904
210594,202205,104,91,13,110292.2,15756,126048.2
210596,202205,114,98,16,118776,19392,138168
210598,202205,137,106,31,128472,37572,166044
210600,202205,296,258,38,312697.87,46056,358753.87
210610,202205,239,225,14,272700.56,16968,289668.56
210620,202205,43,28,15,33936,18180,52116
210630,202205,69,66,3,79992,3636,83628
210632,202205,972,692,280,838704.4,339360,1178064.4
210635,202205,24,21,3,25452,3636,29088
210637,202205,124,90,34,109080.2,41208,150288.2
210640,202205,574,511,63,619332.6,76356,695688.6
210650,202205,380,325,55,395112.89,66660,461772.89
210660,202205,354,281,73,340573.5,88476,429049.5
210663,202205,54,41,13,49692.1,15756,65448.1
210667,202205,93,41,52,49692.2,63024.8,112717.0
210670,202205,250,223,27,270276.4,32724,303000.4
210675,202205,489,278,211,336940.05,255732.92,592672.97
210680,202205,224,143,81,173316.6,98172,271488.6
210690,202205,70,62,8,75144,9696,84840
210700,202205,153,118,35,143016.2,42420.2,185436.4
210710,202205,226,141,85,170892.2,103020,273912.2
210720,202205,128,113,15,136956,18180,155136
210725,202205,60,51,9,61813.18,10908,72721.18
210730,202205,20,16,4,19392,4848,24240
210735,202205,281,206,75,249672.48,90900.6,340573.08
210740,202205,508,440,68,533283.08,82416,615699.08
210745,202205,148,110,38,133320,46056,179376
210750,202205,2495,1306,1189,1585305.7,1441069.4,3026375.1
210760,202205,245,192,53,232704.2,64236.2,296940.4
210770,202205,241,196,45,237554.9,54540,292094.9
210780,202205,413,317,96,385419.45,116352.2,501771.65
210790,202205,183,155,28,187860,33936,221796
210800,202205,166,129,37,156350.32,44844.2,201194.52
210805,202205,60,54,6,65448.2,7272,72720.2
210810,202205,450,368,82,446016.8,99384,545400.8
210820,202205,1974,1656,318,2007088.44,386628,2393716.44
210825,202205,149,87,62,105444.2,75144,180588.2
210830,202205,687,470,217,570853.2,263004.2,833857.4
210840,202205,190,137,53,166044,64236,230280
210845,202205,228,174,54,210888,65448,276336
210850,202205,712,497,215,604792.49,260580.08,865372.57
210860,202205,3369,1993,1376,2416735.98,1667713.6,4084449.58
210870,202205,410,328,82,397538.01,99384,496922.01
210880,202205,79,61,18,73932.38,21816,95748.38
210890,202205,312,273,39,330878.88,47268,378146.88
210900,202205,647,426,221,517527.38,267853.05,785380.43
210905,202205,58,33,25,39996,30300,70296
210910,202205,2112,1584,528,1921028.23,639938.67,2560966.90
210920,202205,148,62,86,75144,104232,179376
210923,202205,79,65,14,78780.15,16968,95748.15
210927,202205,415,214,201,259368.1,243612,502980.1
210930,202205,65,54,11,65448,13332,78780
210940,202205,75,59,16,71508,19392,90900
210945,202205,198,115,83,139380.14,100596,239976.14
210950,202205,503,371,132,449652.14,159984,609636.14
210955,202205,83,54,29,65448,35148,100596
210960,202205,2270,1152,1118,1397439.02,1355016.2,2752455.22
210970,202205,107,92,15,111504.2,18180,129684.2
210975,202205,78,73,5,88476.2,6060,94536.2
210980,202205,1063,534,529,647210.26,641148.8,1288359.06
210990,202205,4366,3065,1301,3716015.04,1578027.54,5294042.58
211000,202205,1243,1020,223,1236245.13,270276.64,1506521.77
211003,202205,950,688,262,835069.61,318756.2,1153825.81
211010,202205,474,429,45,519949.85,54540,574489.85
211020,202205,1355,600,755,728414.33,916273.62,1644687.95
211023,202205,44,39,5,47268,6060,53328
211027,202205,76,55,21,66660,25452,92112
211030,202205,358,258,100,312696,121200,433896
211040,202205,281,236,45,287244.9,54540,341784.9
211050,202205,1084,744,340,901732.57,412080.6,1313813.17
211060,202205,605,537,68,650848.83,82416.23,733265.06
211065,202205,23,18,5,21817.27,6060.25,27877.52
211070,202205,823,695,128,842347.75,155136.2,997483.95
211080,202205,81,79,2,95748,2424,98172
211085,202205,59,33,26,39996.2,31512,71508.2
211090,202205,74,63,11,76356,13332,89688
211100,202205,452,382,70,462986.23,84840,547826.23
211102,202205,230,166,64,201192,77568,278760
211105,202205,209,149,60,180588.2,72720,253308.2
211107,202205,124,79,45,95748,54540,150288
211110,202205,931,632,299,765986.86,362390.3,1128377.16
211120,202205,4959,2583,2376,3130624.42,2880934.33,6011558.75
211125,202205,23,15,8,18180,9696,27876
211130,202205,40350,19070,21280,23120283.82,25813238.56,48933522.38
211140,202205,389,343,46,415718.14,55752,471470.14
211150,202205,1153,821,332,995058.2,402384.94,1397443.14
211153,202205,162,99,63,119988,76356,196344
211157,202205,68,57,11,69084,13332,82416
211160,202205,670,572,98,693266.95,118776,812042.95
211163,202205,4,4,0,4848,,4848.0
211167,202205,11,10,1,12120,1212,13332
211170,202205,404,299,105,362388,127260,489648
211172,202205,109,77,32,93324.02,38784,132108.02
211174,202205,16,14,2,16968,2424.2,19392.2
211176,202205,452,331,121,401173.96,146652.2,547826.16
211178,202205,93,64,29,77568,35148,112716
211180,202205,209,169,40,206040.1,48480.1,254520.2
211190,202205,68,61,7,73932,8484,82416
211195,202205,32,23,9,27876.4,10908,38784.4
211200,202205,146,125,21,151500,25452,176952
211210,202205,403,303,100,367237.61,121200,488437.61
211220,202205,4164,2486,1678,3013064.88,2037386.11,5050450.99
211223,202205,102,97,5,117564,6060,123624
211227,202205,53,44,9,53328.2,10908,64236.2
211230,202205,702,582,120,705386.19,145441,850827.19
211240,202205,370,305,65,369660.2,78780,448440.2
211245,202205,177,96,81,116352.14,98172,214524.14
211250,202205,1467,1274,193,1544101.78,233916.19,1778017.97
211260,202205,771,654,117,792649.97,141804,934453.97
211270,202205,1832,1511,321,1831339.11,389052.6,2220391.71
211280,202205,1752,1176,576,1425317.21,698112,2123429.21
211285,202205,209,136,73,164832,88476.6,253308.6
211290,202205,712,512,200,620546.13,243612,864158.13
211300,202205,747,603,144,730839.29,174528.88,905368.17
211400,202205,1509,973,536,1180496.68,649632.76,1830129.44
220005,202205,16,15,1,18180,1212,19392
220010,202205,80,66,14,79992,16968,96960
220020,202205,698,570,128,690840.4,155136.2,845976.6
220025,202205,104,101,3,122412.44,3636,126048.44
220027,202205,51,42,9,50904,10908,61812
220030,202205,118,99,19,119988,23028,143016
220040,202205,1241,957,284,1159887.12,344208.16,1504095.28
220045,202205,28,19,9,23028.54,10908.4,33936.94
220050,202205,681,564,117,683570.78,141804,825374.78
220060,202205,176,154,22,186648,26664.2,213312.2
220070,202205,109,95,14,115140.57,16968,132108.57
220080,202205,12,11,1,13332,1212,14544
220090,202205,37,28,9,33936,10908,44844
220095,202205,1,1,0,1212,,1212.0
220100,202205,20,17,3,20604,3636,24240
220105,202205,29,27,2,32724.6,2424,35148.6
220110,202205,236,219,17,265428.1,21816,287244.1
220115,202205,42,38,4,46056,4848,50904
220117,202205,21,19,2,23028,2424,25452
220120,202205,1457,1113,344,1348960.31,416928,1765888.31
220130,202205,27,26,1,31512,1212,32724
220140,202205,95,76,19,92112,23028.2,115140.2
220150,202205,477,359,118,435111.98,143017.34,578129.32
220155,202205,12,11,1,13332,1212,14544
220157,202205,20,17,3,20604,3636,24240
220160,202205,97,85,12,103020,14544,117564
220170,202205,39,34,5,41208,6060,47268
220173,202205,9,8,1,9696,1212,10908
220177,202205,14,13,1,15756,1212,16968
220180,202205,63,62,1,75144.2,1212,76356.2
220190,202205,1087,946,141,1146557.49,170892,1317449.49
220191,202205,35,29,6,35148,7272,42420
220192,202205,88,83,5,100596,6060,106656
220194,202205,58,52,6,63024,7272,70296
220196,202205,81,66,15,79992,18180,98172
220198,202205,1,1,0,1212,,1212.0
220200,202205,406,343,63,415719.16,76356,492075.16
220202,202205,35,30,5,36360,6060,42420
220205,202205,61,53,8,64236,9696,73932
220207,202205,13,13,0,15756,,15756.0
220208,202205,74,45,29,54540,35148,89688
220209,202205,33,27,6,32724,7272,39996
220210,202205,20,15,5,18180,6060,24240
220211,202205,31,29,2,35148,2424,37572
220213,202205,32,29,3,35148.44,3636,38784.44
220217,202205,39,31,8,37572.2,9696,47268.2
220220,202205,2244,1488,756,1804671.4,921121.37,2725792.77
220225,202205,8,3,5,3636.2,6060,9696.2
220230,202205,967,741,226,898094.61,273914.12,1172008.73
220240,202205,162,142,20,172104.44,24240.2,196344.64
220245,202205,36,33,3,39996.4,3636,43632.4
220250,202205,124,107,17,129686.25,20604,150290.25
220253,202205,51,45,6,54540,7272,61812
220255,202205,42,36,6,43632,7272,50904
220260,202205,697,533,164,645998.56,199980,845978.56
220265,202205,7,6,1,7272,1212,8484
220270,202205,817,737,80,895670.44,96960,992630.44
220271,202205,37,28,9,33936.2,10908,44844.2
220272,202205,12,12,0,14544,,14544.0
220273,202205,17,15,2,18180,2424,20604
220275,202205,60,51,9,61812,10908,72720
220277,202205,21,16,5,19392,6060.65,25452.65
220280,202205,17,11,6,13332,7272,20604
220285,202205,37,35,2,42420,2424,44844
220290,202205,1491,1279,212,1551369.99,256946.26,1808316.25
220300,202205,34,33,1,39996.4,1212,41208.4
220310,202205,330,281,49,340574.12,59388.48,399962.60
220320,202205,441,408,33,494499.17,39996,534495.17
220323,202205,2,1,1,1212.8,1212,2424.8
220325,202205,8,7,1,8484,1212,9696
220327,202205,11,11,0,13332,,13332.0
220330,202205,223,159,64,193920,77568,271488
220335,202205,135,114,21,138168.2,25452,163620.2
220340,202205,46,33,13,39996,15756,55752
220342,202205,53,44,9,53329.42,10908,64237.42
220345,202205,80,68,12,82416,14544,96960
220350,202205,457,396,61,479952.17,73932,553884.17
220360,202205,41,31,10,37572,12120,49692
220370,202205,1283,1066,217,1291996.95,263004.6,1555001.55
220375,202205,14,14,0,16968.2,,16968.2
220380,202205,27,20,7,24240.2,8484,32724.2
220385,202205,15,14,1,16968,1212.66,18180.66
220390,202205,2311,1283,1028,1555003.23,1245940.49,2800943.72
220400,202205,35,30,5,36360,6060,42420
220410,202205,22,21,1,25452,1212,26664
220415,202205,13,12,1,14544,1212,15756
220420,202205,121,102,19,123624.2,23028,146652.2
220430,202205,129,115,14,139381.05,16968,156349.05
220435,202205,24,18,6,21816,7272,29088
220440,202205,272,231,41,281187.18,49692,330879.18
220450,202205,337,168,169,203617.42,204829,408446.42
220455,202205,49,48,1,58176.2,1212,59388.2
220460,202205,17,15,2,18180.4,2424.29,20604.69
220465,202205,70,47,23,56964.2,27876,84840.2
220470,202205,231,203,28,246036.4,33936,279972.4
220480,202205,72,65,7,78780,8484,87264
220490,202205,85,73,12,88476,14544,103020
220500,202205,114,95,19,115140,23028,138168
220510,202205,368,284,84,344208.36,101808,446016.36
220515,202205,20,18,2,21816,2424,24240
220520,202205,368,326,42,395113.98,50904,446017.98
220525,202205,7,3,4,3636,4848,8484
220527,202205,16,13,3,15756,3636,19392
220530,202205,43,22,21,26664,25452,52116
220535,202205,6,5,1,6060.2,1212,7272.2
220540,202205,84,72,12,87264,14544,101808
220545,202205,26,17,9,20604,10908,31512
220550,202205,703,555,148,673873.71,179376.5,853250.21
220551,202205,12,10,2,12120,2424,14544
220552,202205,12,12,0,14544,,14544.0
220553,202205,51,46,5,55752.62,6060.2,61812.82
220554,202205,8,5,3,6060.2,3636,9696.2
220555,202205,41,33,8,39996,9696,49692
220556,202205,36,34,2,41208,2424,43632
220557,202205,57,49,8,59388.2,9696,69084.2
220558,202205,7,3,4,3636,4848,8484
220559,202205,3,3,0,3636,,3636.0
220560,202205,71,46,25,55752,30300,86052
220570,202205,712,444,268,538129.95,324816.2,862946.15
220580,202205,540,495,45,599946.63,54540,654486.63
220585,202205,12,11,1,13332.2,1212.2,14544.4
220590,202205,13,12,1,14544,1212,15756
220595,202205,75,57,18,69084.62,21816.1,90900.72
220600,202205,21,14,7,16968,8484,25452
220605,202205,26,23,3,27876,3636,31512
220610,202205,88,74,14,89688,16968,106656
220620,202205,548,464,84,562368.8,101808.1,664176.9
220630,202205,4,3,1,3636,1212,4848
220635,202205,31,28,3,33936,3636,37572
220640,202205,107,88,19,106656,23028,129684
220650,202205,113,107,6,129684,7272,136956
220660,202205,62,47,15,56965.08,18180.2,75145.28
220665,202205,8,8,0,9696,,9696.0
220667,202205,17,14,3,16968.77,3636,20604.77
220669,202205,33,27,6,32724,7272,39996
220670,202205,64,51,13,61812,15756,77568
220672,202205,79,59,20,71508.81,24240,95748.81
220675,202205,29,22,7,27876.47,8484,36360.47
220680,202205,52,45,7,54540,8484,63024
220690,202205,50,47,3,56964.2,3636,60600.2
220695,202205,26,14,12,16968,14544,31512
220700,202205,1779,1375,404,1666505.98,490860.58,2157366.56
220710,202205,7,5,2,6060,2424,8484
220720,202205,109,93,16,112716,19392,132108
220730,202205,20,18,2,21816,2424,24240
220735,202205,5,2,3,2424,3636,6060
220740,202205,49,44,5,53328,6060,59388
220750,202205,113,96,17,116352.2,20604.15,136956.35
220755,202205,17,17,0,20604,,20604.0
220760,202205,65,57,8,69084,9696,78780
220770,202205,5838,3308,2530,4014172.62,3068794.39,7082967.01
220775,202205,13,9,4,10908,4848.2,15756.2
220777,202205,20,19,1,23028,1212,24240
220779,202205,1,0,1,,1212,1212.0
220780,202205,897,763,134,924756.3,162408.6,1087164.9
220785,202205,4,1,3,1212,3636,4848
220790,202205,1153,921,232,1118681.29,281185.2,1399866.49
220793,202205,5,4,1,4848,1212,6060
220795,202205,18,16,2,19392.2,2424,21816.2
220800,202205,3991,3051,940,3699259.08,1139281.8,4838540.88
220810,202205,70,61,9,73932.34,10908,84840.34
220820,202205,237,215,22,260581.31,26665.8,287247.11
220830,202205,1265,1105,160,1339262.9,195132,1534394.9
220840,202205,2454,1731,723,2097981.65,876280.31,2974261.96
220850,202205,66,59,7,71508,8484,79992
220855,202205,8,4,4,4848,4848,9696
220860,202205,9,8,1,9696.4,1212,10908.4
220865,202205,28,24,4,29088,4848,33936
220870,202205,85,78,7,94536.6,8484,103020.6
220880,202205,330,269,61,326029.06,75144,401173.06
220885,202205,25,24,1,29088.9,1212,30300.9
220887,202205,6,5,1,6060.2,1212,7272.2
220890,202205,86,74,12,89688.73,14544,104232.73
220900,202205,26,14,12,16968,14544,31512
220910,202205,48,39,9,47268,10908,58176
220915,202205,10,9,1,10908,1212,12120
220920,202205,48,42,6,52117.05,7272,59389.05
220930,202205,48,46,2,55752,2424,58176
220935,202205,13,13,0,15756,,15756.0
220937,202205,34,30,4,36360.4,4848,41208.4
220940,202205,54,50,4,60600,4848,65448
220945,202205,2,2,0,2424,,2424.0
220950,202205,34,27,7,32724,8484,41208
220955,202205,16,15,1,18180.72,1212,19392.72
220960,202205,29,27,2,32724.6,2424,35148.6
220965,202205,39,36,3,43632,3636,47268
220970,202205,62,52,10,63024,12120,75144
220975,202205,11,10,1,12120.2,1212,13332.2
220980,202205,29,27,2,32724,2424,35148
220985,202205,56,49,7,59388,8484,67872
220987,202205,31,29,2,36360,2424,38784
220990,202205,23,22,1,26664,1212,27876
220995,202205,11,9,2,10908,2424,13332
220997,202205,57,51,6,61812,7272,69084
221000,202205,1208,1078,130,1307754.77,158772.2,1466526.97
221005,202205,38,35,3,42420,3636,46056
221010,202205,22,16,6,19392,7272,26664
221020,202205,32,31,1,37572.18,1212,38784.18
221030,202205,39,30,9,36360,10908,47268
221035,202205,20,19,1,23028,1212,24240
221037,202205,12,8,4,9696,4848,14544
221038,202205,28,25,3,30300,3636,33936
221039,202205,24,23,1,27876.48,1212,29088.48
221040,202205,262,226,36,273912.66,43632,317544.66
221050,202205,222,185,37,224221.33,44844,269065.33
221060,202205,1928,1661,267,2014355.54,323604.55,2337960.09
221062,202205,29,28,1,33936.34,1212,35148.34
221063,202205,16,11,5,13332,6060,19392
221065,202205,66,55,11,67872,13332,81204
221070,202205,137,119,18,144228.3,21816,166044.3
221080,202205,376,320,56,387841.6,67872,455713.6
221090,202205,19,15,4,18180.2,4848,23028.2
221093,202205,43,32,11,38784.2,13332,52116.2
221095,202205,4,4,0,4848,,4848.0
221097,202205,12,10,2,12120,2424,14544
221100,202205,25904,15558,10346,18867363.15,12552750.09,31420113.24
221110,202205,1109,848,261,1027783.33,316332.8,1344116.13
221120,202205,544,394,150,477529.17,181800,659329.17
221130,202205,974,788,186,955058.05,225432,1180490.05
221135,202205,31,26,5,31512,6060,37572
221140,202205,44,37,7,44844.24,8484,53328.24
221150,202205,10,7,3,8484,3636,12120
221160,202205,10,10,0,12120.5,,12120.5
221170,202205,18,17,1,20604,1212,21816
230010,202205,153,137,16,166044.11,19392,185436.11
230015,202205,147,121,26,146652,31512,178164
230020,202205,1654,1356,298,1643480.66,362391.53,2005872.19
230030,202205,1653,1189,464,1441078.15,562368.95,2003447.10
230040,202205,225,178,47,215736.2,56964,272700.2
230050,202205,228,163,65,197556,78780,276336
230060,202205,155,123,32,149076,38784,187860
230070,202205,299,256,43,310272.02,52116,362388.02
230075,202205,860,724,136,877489.53,166044.2,1043533.73
230080,202205,207,176,31,213312,37572,250884
230090,202205,152,113,39,136956,47268,184224
230100,202205,2434,1380,1054,1672566.72,1278662.9,2951229.62
230110,202205,2944,1868,1076,2266454.32,1306541.3,3572995.62
230120,202205,1098,853,245,1033842.38,296940,1330782.38
230125,202205,163,129,34,156348.2,41208,197556.2
230130,202205,476,420,56,509043.48,67872,576915.48
230140,202205,208,170,38,206040.2,46056,252096.2
230150,202205,153,118,35,143016.2,42420.2,185436.4
230160,202205,945,780,165,945360.7,199980,1145340.7
230170,202205,616,548,68,664180.22,82416.2,746596.42
230180,202205,66,60,6,72720,7272,79992
230185,202205,411,347,64,420565.5,77568,498133.5
230190,202205,2448,1886,562,2288270.52,681144.92,2969415.44
230195,202205,504,437,67,530857.6,81204.2,612061.8
230200,202205,425,333,92,403598.84,111504.1,515102.94
230205,202205,395,265,130,321180,157560,478740
230210,202205,1409,1076,333,1304115.86,403596.28,1707712.14
230220,202205,1584,1065,519,1290784.41,629030.41,1919814.82
230230,202205,975,811,164,984145.25,198768.99,1182914.24
230240,202205,1859,1615,244,1957693.56,296941.98,2254635.54
230250,202205,1764,1447,317,1754990.03,385417.69,2140407.72
230260,202205,3242,2009,1233,2437333.7,1495609.3,3932943.0
230270,202205,1343,1054,289,1277453.37,350270.1,1627723.47
230280,202205,2796,2124,672,2575514.76,814467.37,3389982.13
230290,202205,352,310,42,375723.38,50904.9,426628.28
230300,202205,516,377,139,456924.94,168468,625392.94
230310,202205,425,328,97,397536.2,117564,515100.2
230320,202205,925,779,146,944152.45,178164,1122316.45
230330,202205,308,245,63,296941.11,76356.4,373297.51
230340,202205,443,356,87,431473.2,105444,536917.2
230350,202205,3323,2054,1269,2490672.88,1538033.67,4028706.55
230360,202205,275,226,49,273912.3,59388,333300.3
230365,202205,126,103,23,124836.73,27876,152712.73
230370,202205,10951,5431,5520,6584842.53,6701176.36,13286018.89
230380,202205,488,421,67,511465.95,81204.65,592670.60
230390,202205,526,302,224,366025.14,271488.6,637513.74
230393,202205,236,195,41,236340.67,49692.5,286033.17
230395,202205,350,284,66,344209.77,79992.28,424202.05
230400,202205,628,503,125,609636.89,151500.2,761137.09
230410,202205,2708,1693,1015,2053142.81,1230183.59,3283326.40
230420,202205,6498,4310,2188,5226187.92,2655505.76,7881693.68
230423,202205,336,292,44,355116,53328,408444
230425,202205,477,380,97,461773.3,117564.2,579337.5
230426,202205,112,87,25,105444,30300,135744
230427,202205,71,66,5,79992,6060,86052
230428,202205,1611,799,812,968389.54,984144.98,1952534.52
230430,202205,459,373,86,452078.15,104232,556310.15
230435,202205,950,698,252,847189.03,305424.85,1152613.88
230440,202205,94854,43077,51777,52236323.64,62795172.77,115031496.41
230445,202205,320,219,101,265428.83,123624,389052.83
230450,202205,585,461,124,558732.5,150288,709020.5
230460,202205,87,64,23,77568.14,27876,105444.14
230465,202205,311,253,58,306636,70296,376932
230470,202205,2038,1596,442,1934356.32,535705.3,2470061.62
230480,202205,152,138,14,168468,16968,185436
230490,202205,330,261,69,316332,83628,399960
230495,202205,479,339,140,410869.37,169681.65,580551.02
230500,202205,1085,812,273,984145.7,330876.73,1315022.43
230510,202205,61,44,17,53328,20604,73932
230520,202205,403,309,94,374508.2,113928,488436.2
230523,202205,2501,1542,959,1868910.75,1162314.88,3031225.63
230526,202205,257,221,36,267853.02,43632,311485.02
230530,202205,693,509,184,616910.5,223008.72,839919.22
230533,202205,217,198,19,239977.3,23028,263005.3
230535,202205,380,284,96,344209.51,116352.2,460561.71
230540,202205,1793,1594,199,1931938.32,241189.45,2173127.77
230550,202205,4000,2557,1443,3100327.39,1748933.37,4849260.76
230560,202205,591,449,142,544190.04,172104,716294.04
230565,202205,219,164,55,198768,66660,265428
230570,202205,285,244,41,295728.2,49692,345420.2
230580,202205,1203,852,351,1032627.15,425412.8,1458039.95
230590,202205,1026,795,231,963540.97,279973.86,1243514.83
230600,202205,253,227,26,276336.73,31512,307848.73
230610,202205,443,332,111,402384.76,134532.11,536916.87
230620,202205,165,143,22,173316.28,26664,199980.28
230625,202205,834,566,268,685993.65,324816.1,1010809.75
230630,202205,1356,1029,327,1247156.69,396325.77,1643482.46
230640,202205,3864,3202,662,3883272.09,803564.44,4686836.53
230650,202205,496,422,74,513888.5,89688.7,603577.2
230655,202205,697,568,129,689631.01,156348.6,845979.61
230660,202205,349,287,62,347844.2,76356.2,424200.4
230670,202205,465,380,85,460563.96,103020.2,563584.16
230680,202205,209,185,24,224220.2,29088,253308.2
230690,202205,949,797,152,965968.08,184224.1,1150192.18
230700,202205,949,794,155,962331.99,187860.72,1150192.71
230710,202205,657,614,43,745382.2,52116,797498.2
230720,202205,144,124,20,150288,24240,174528
230725,202205,248,187,61,226644.2,73932,300576.2
230730,202205,12631,6719,5912,8145829.64,7171429.21,15317258.85
230740,202205,687,540,147,654485.33,178164.2,832649.53
230750,202205,826,691,135,837495.32,163620.2,1001115.52
230760,202205,1513,1298,215,1573186,260580.36,1833766.36
230763,202205,331,271,60,328452.9,72720,401172.9
230765,202205,8247,3845,4402,4662599.88,5340107.63,10002707.51
230770,202205,5026,2544,2482,3086985.03,3009403.83,6096388.86
230780,202205,788,685,103,830222.57,124836,955058.57
230790,202205,310,256,54,310272.2,65448,375720.2
230800,202205,1161,833,328,1009597.64,397536.85,1407134.49
230810,202205,1423,1241,182,1504108.23,221797.02,1725905.25
230820,202205,375,252,123,305424.6,149076,454500.6
230830,202205,950,804,146,975662.85,176952,1152614.85
230835,202205,280,237,43,287244.39,52116,339360.39
230837,202205,173,140,33,169680,39996,209676
230840,202205,932,719,213,871429.21,258157.28,1129586.49
230850,202205,1393,1194,199,1449569.8,241189.57,1690759.37
230860,202205,309,231,78,279972,94542.06,374514.06
230870,202205,1862,1576,286,1910117.95,346632.28,2256750.23
230880,202205,82,66,16,79992,19392,99384
230890,202205,542,482,60,585396.1,72720.1,658116.2
230900,202205,298,221,77,267852.2,93324.88,361177.08
230910,202205,223,170,53,206040,64236,270276
230920,202205,486,380,106,460560,128472,589032
230930,202205,1057,734,323,890823.42,391477.36,1282300.78
230940,202205,842,648,194,785379.01,235128,1020507.01
230945,202205,538,431,107,522376.12,129686.46,652062.58
230950,202205,424,364,60,441170.25,72720,513890.25
230960,202205,2791,1853,938,2245852,1136864.63,3382716.63
230970,202205,1782,986,796,1196251.65,965967.87,2162219.52
230980,202205,204,162,42,196344.74,50904,247248.74
230990,202205,138,111,27,134532,32724.3,167256.3
231000,202205,201,184,17,224220,20604,244824
231010,202205,160,113,47,136956.32,56964.7,193921.02
231020,202205,1411,961,450,1165953.77,546616.31,1712570.08
231025,202205,1098,769,329,932034.21,398748.92,1330783.13
231030,202205,1048,863,185,1045959.29,225432.7,1271391.99
231040,202205,161,108,53,130896,64236,195132
231050,202205,949,821,128,995060.2,155138.18,1150198.38
231060,202205,161,131,30,158772,36360,195132
231070,202205,1494,1026,468,1245940.67,567217.16,1813157.83
231080,202205,273,244,29,295728.1,35148,330876.1
231085,202205,658,399,259,483591.05,313908,797499.05
231090,202205,260,208,52,252096,63024,315120
231095,202205,164,130,34,157560,41208.2,198768.2
231100,202205,168,138,30,167256,36360,203616
231110,202205,366,308,58,373298.07,70296,443594.07
231120,202205,270,224,46,271488,55752.1,327240.1
231123,202205,157,147,10,179376.95,12120,191496.95
231126,202205,318,241,77,292092,93324,385416
231130,202205,4987,3883,1104,4707441.58,1338058.56,6045500.14
231135,202205,207,184,23,223008.2,27876,250884.2
231140,202205,3081,2221,860,2691866.97,1042324.99,3734191.96
231150,202205,381,360,21,436321.85,25452,461773.85
231160,202205,1223,988,235,1197464.45,284820,1482284.45
231170,202205,522,364,158,441168,192708,633876
231180,202205,1810,1565,245,1896790.38,296940.3,2193730.68
231190,202205,210,173,37,209676.1,44844,254520.1
231195,202205,225,187,38,226644,46056,272700
231200,202205,823,666,157,807194.55,190285.05,997479.60
231210,202205,516,434,82,526009.44,99384.2,625393.64
231220,202205,1044,742,302,900523.77,366024.92,1266548.69
231230,202205,1508,1148,360,1392591.23,437532.2,1830123.43
231240,202205,1544,1055,489,1278665.94,592669.62,1871335.56
231250,202205,95,89,6,107868,7272,115140
231260,202205,254,169,85,204828,103020,307848
231270,202205,996,779,217,944156.18,263005.02,1207161.20
231280,202205,75,59,16,71508,19392,90900
231290,202205,7907,4436,3471,5380092.28,4211710.36,9591802.64
231300,202205,586,538,48,652058.65,58176,710234.65
231310,202205,776,710,66,860522.44,79992,940514.44
231320,202205,588,441,147,534492,178164,712656
231325,202205,98,83,15,100596,18180,118776
231330,202205,1922,1469,453,1780444.06,550248.86,2330692.92
231335,202205,250,222,28,269064.88,33936,303000.88
231340,202205,1809,1269,540,1538032.38,654483.08,2192515.46
231350,202205,1356,1077,279,1305333.78,339364.72,1644698.50
231355,202205,413,344,69,416929.55,83628,500557.55
231360,202205,548,377,171,456926.37,207252.93,664179.30
231370,202205,97,83,14,100596,16968,117564
231375,202205,292,214,78,259368.1,94536.1,353904.2
231380,202205,486,388,98,470256.2,118776,589032.2
231390,202205,207,156,51,189072,61812,250884
231395,202205,770,473,297,573276.48,359964.1,933240.58
231400,202205,1161,963,198,1167161.22,241190.21,1408351.43
231410,202205,1363,1118,245,1355020.61,296940.1,1651960.71
240010,202205,369,162,207,196349.04,250888.59,447237.63
240020,202205,2263,1843,420,2233737.89,509043.35,2742781.24
240030,202205,118,97,21,117564.6,25452,143016.6
240040,202205,33,32,1,38784,1212,39996
240050,202205,520,444,76,538131.5,92112.3,630243.8
240060,202205,70,64,6,77568.1,7272,84840.1
240070,202205,246,189,57,229068.48,69084.96,298153.44
240080,202205,547,370,177,448442.37,214525.4,662967.77
240090,202205,103,91,12,110292,14544,124836
240100,202205,1493,1404,89,1702868.73,107868.1,1810736.83
240110,202205,1031,687,344,835077.92,416935.48,1252013.40
240120,202205,149,111,38,134532.2,46056.53,180588.73
240130,202205,271,251,20,304213.08,24240,328453.08
240140,202205,80,55,25,66660.3,30300,96960.3
240145,202205,713,629,84,762353.69,101808.02,864161.71
240150,202205,26,19,7,23028,8484,31512
240160,202205,39,31,8,37572,9696,47268
240165,202205,39,31,8,37572,9696,47268
240170,202205,139,95,44,115140.88,53328,168468.88
240180,202205,104,79,25,95749.17,30300,126049.17
240185,202205,47,42,5,50904,6060,56964
240190,202205,14,12,2,14544.6,2424,16968.6
240200,202205,3074,1666,1408,2021628.38,1706500.04,3728128.42
240210,202205,167,127,40,153924,48480,202404
240220,202205,1101,773,328,936882.68,398748.91,1335631.59
240230,202205,827,754,73,913854.36,88477.29,1002331.65
240240,202205,72,47,25,56964,30300.2,87264.2
240250,202205,90,79,11,95748.2,13332,109080.2
240260,202205,1810,1283,527,1554998.62,638726.46,2193725.08
240270,202205,175,151,24,183012.8,29088,212100.8
240280,202205,54,42,12,50904.2,14544,65448.2
240290,202205,40,38,2,46056,2424,48480
240300,202205,172,92,80,111504.2,96960,208464.2
240310,202205,2459,1322,1137,1602280.11,1378053,2980333.11
240320,202205,177,163,14,197556,16968,214524
240325,202205,4716,2718,1998,3299096.59,2422805.39,5721901.98
240330,202205,73,69,4,83628,4848,88476
240340,202205,86,57,29,69084,35148,104232
240350,202205,90,74,16,89688,19392,109080
240360,202205,609,370,239,448444.87,289670.27,738115.14
240370,202205,52,45,7,54540,8484,63024
240375,202205,57,36,21,43632.2,25452.4,69084.6
240380,202205,221,180,41,218162.51,49693.3,267855.81
240390,202205,15,13,2,15756,2424,18180
240400,202205,87,76,11,92112.1,13332.69,105444.79
240410,202205,12,8,4,9696,4848,14544
240420,202205,1073,779,294,944153.81,357540.88,1301694.69
240430,202205,260,238,22,288456.89,26664.1,315120.99
240440,202205,124,67,57,81204.3,69084,150288.3
240450,202205,244,152,92,184224.74,111504.3,295729.04
240460,202205,76,59,17,71508,20604,92112
240470,202205,210,191,19,231493.58,23028,254521.58
240480,202205,16,14,2,16968,2424,19392
240485,202205,81,64,17,77568.2,20604,98172.2
240490,202205,52,46,6,55752,7272,63024
240500,202205,92,69,23,83628,27876,111504
240510,202205,41,30,11,36360.6,13332,49692.6
240520,202205,97,92,5,111504.2,6060.03,117564.23
240530,202205,58,49,9,59388.1,10908,70296.1
240540,202205,85,72,13,87264,15756,103020
240550,202205,12,10,2,12120,2424,14544
240560,202205,381,270,111,329664.32,134532,464196.32
240570,202205,432,270,162,327240,196344.6,523584.6
240580,202205,1311,1006,305,1219279.5,369660.8,1588940.3
240590,202205,31,30,1,36360,1212,37572
240600,202205,95,89,6,107868,7272,115140
240610,202205,491,405,86,490863.67,104233.1,595096.77
240615,202205,13,12,1,14544,1212,15756
240620,202205,85,81,4,98173.03,4848,103021.03
240630,202205,41,34,7,41208.2,8484.1,49692.3
240640,202205,23,19,4,23028,4848,27876
240650,202205,235,191,44,231492.6,53328,284820.6
240660,202205,109,93,16,112716,19392,132108
240670,202205,303,165,138,199982.75,167256.85,367239.60
240680,202205,53,40,13,48480,15756,64236
240690,202205,47,44,3,53328,3636,56964
240700,202205,175,142,33,172104,39996,212100
240710,202205,2160,1288,872,1561070.88,1056870.82,2617941.70
240720,202205,1051,750,301,909006.77,364813.8,1273820.57
240725,202205,68,63,5,76356.2,6060,82416.2
240730,202205,147,122,25,147864,30300,178164
240740,202205,228,193,35,233917.47,42420.2,276337.67
240750,202205,53,32,21,38784,25452,64236
240760,202205,50,41,9,49692,10908,60600
240770,202205,143,108,35,130896.3,42420,173316.3
240780,202205,712,589,123,713873.96,149076,862949.96
240790,202205,40,38,2,46057.14,2424,48481.14
240800,202205,9476,6390,3086,7747212.49,3741482.66,11488695.15
240810,202205,21345,11271,10074,13670304.01,12218245.05,25888549.06
240820,202205,244,140,104,169681.53,126048.6,295730.13
240830,202205,1596,1311,285,1588941.18,345422.27,1934363.45
240840,202205,74,65,9,78780.2,10908,89688.2
240850,202205,84,75,9,90900,10908,101808
240860,202205,106,101,5,122412.4,6060,128472.4
240870,202205,55,46,9,55752.8,10908,66660.8
240880,202205,32,28,4,33936,4848,38784
240890,202205,1149,644,505,780533.53,612063.2,1392596.73
240895,202205,65,50,15,60600.2,18180,78780.2
240910,202205,168,142,26,173316,31512,204828
240920,202205,11,10,1,12120.28,1212,13332.28
240930,202205,411,365,46,442385.3,55752.7,498138.0
240933,202205,58,37,21,44844.95,25452,70296.95
240940,202205,2301,2021,280,2450673.15,339363.69,2790036.84
240950,202205,43,38,5,46056,6060,52116
240960,202205,24,20,4,24240.2,4848.2,29088.4
240970,202205,106,80,26,96960,31512,128472
240980,202205,197,160,37,193920.2,44844.2,238764.4
240990,202205,135,88,47,106656,56964,163620
241000,202205,59,55,4,66660.3,4848,71508.3
241010,202205,76,58,18,70296,21816,92112
241020,202205,104,95,9,115140.6,10908,126048.6
241025,202205,15,9,6,10908,7272.5,18180.5
241030,202205,102,80,22,96960,26664,123624
241040,202205,39,29,10,35148,12120,47268
241050,202205,74,67,7,81204,8484,89688
241060,202205,24,20,4,24240,4848,29088
241070,202205,17,17,0,20604,,20604.0
241080,202205,54,47,7,56964.2,8484,65448.2
241090,202205,50,37,13,44845.56,15756,60601.56
241100,202205,73,62,11,75144,13332,88476
241105,202205,14,5,9,6060,10908,16968
241110,202205,46,39,7,47268,8484,55752
241120,202205,1573,1183,390,1433799.98,472681.3,1906481.28
241140,202205,207,171,36,207252.6,43632,250884.6
241142,202205,48,35,13,42420,15756.45,58176.45
241150,202205,1182,1027,155,1244739.03,187861.13,1432600.16
241160,202205,20,15,5,18180,6060,24240
241170,202205,47,40,7,48480,8484,56964
241180,202205,43,31,12,37572,14544,52116
241190,202205,38,35,3,42420,3636,46056
241200,202205,4223,2220,2003,2693097.62,2428868.19,5121965.81
241210,202205,69,58,11,70296.07,13332,83628.07
241220,202205,1462,944,518,1146560.88,627820.27,1774381.15
241230,202205,251,208,43,252096.4,52116,304212.4
241240,202205,52,39,13,47268,15756,63024
241250,202205,1134,1036,98,1256851.02,118776,1375627.02
241255,202205,56,46,10,55752.79,12120,67872.79
241260,202205,693,535,158,649633.45,192708.7,842342.15
241270,202205,64,46,18,55752,21816,77568
241280,202205,96,84,12,101808.2,14544,116352.2
241290,202205,125,91,34,110292,41208,151500
241300,202205,81,55,26,66660,31512,98172
241310,202205,45,31,14,37572.2,16968,54540.2
241320,202205,27,12,15,14544,18180,32724
241330,202205,58,50,8,60600,9696,70296
241335,202205,83,73,10,88476.2,12120,100596.2
241340,202205,181,132,49,159984,59388,219372
241350,202205,61,53,8,64236.4,9696,73932.4
241355,202205,50,43,7,52116,8484,60600
241360,202205,48,47,1,58176,1212,59388
241370,202205,57,45,12,54540,14544,69084
241380,202205,35,31,4,37572.2,4848,42420.2
241390,202205,83,65,18,78780,21816,100596
241400,202205,213,160,53,193920,64236,258156
241410,202205,175,159,16,192708,19392.69,212100.69
241415,202205,101,81,20,98172,24240.2,122412.2
241420,202205,115,80,35,96960,42420,139380
241430,202205,21,18,3,21816,3636,25452
241440,202205,510,428,82,519954.19,99384.7,619338.89
241445,202205,40,35,5,42420,6060.1,48480.1
241450,202205,259,216,43,261793.54,52116.2,313909.74
241460,202205,146,132,14,159984.4,16968,176952.4
241470,202205,35,29,6,35148.2,7272,42420.2
241475,202205,52,47,5,56964,6060,63024
241480,202205,119,88,31,106656.2,37572,144228.2
241490,202205,13,12,1,14544,1212.1,15756.1
241500,202205,41,32,9,38784.2,10908,49692.2
250010,202205,101,86,15,104232.08,18180,122412.08
250020,202205,29,25,4,30300,4848,35148
250030,202205,881,647,234,784166.5,283609.76,1067776.26
250040,202205,389,311,78,376933.98,94536.8,471470.78
250050,202205,274,225,49,272700.12,59388.01,332088.13
250053,202205,60,47,13,56964,15756,72720
250057,202205,1,1,0,1212,,1212.0
250060,202205,605,439,166,532072.37,201192.9,733265.27
250070,202205,679,541,138,655695.56,167256,822951.56
250073,202205,9,8,1,9696,1212,10908
250077,202205,174,130,44,157561.87,53328,210889.87
250080,202205,417,330,87,399963.27,105444.8,505408.07
250090,202205,222,142,80,172104,96960,269064
250100,202205,557,459,98,556309.1,118777.8,675086.9
250110,202205,664,488,176,592668.7,213313.21,805981.91
250115,202205,14,3,11,3636,13332.26,16968.26
250120,202205,122,87,35,105444.2,42420.35,147864.55
250130,202205,554,446,108,540552.9,130896.1,671449.0
250135,202205,23,10,13,12120,15756,27876
250140,202205,82,72,10,87264.12,12120,99384.12
250150,202205,615,438,177,530857.35,214525.17,745382.52
250153,202205,12,10,2,12120.21,2424,14544.21
250157,202205,28,23,5,27876,6060,33936
250160,202205,239,184,55,223008.45,66660,289668.45
250170,202205,73,46,27,55752,32724,88476
250180,202205,4649,3178,1471,3851771.68,1782871.56,5634643.24
250190,202205,813,542,271,656905.3,328452.88,985358.18
250200,202205,64,48,16,58176,19392,77568
250205,202205,23,19,4,23028,4848,27876
250210,202205,87,75,12,90900,14544,105444
250215,202205,71,53,18,64236,21816,86052
250220,202205,27,19,8,23028,9696,32724
250230,202205,77,68,9,82416,10908,93324
250240,202205,232,178,54,215736.54,65448,281184.54
250250,202205,369,319,50,386628.47,60600,447228.47
250260,202205,45,37,8,44844,9696,54540
250270,202205,77,54,23,65448,27876,93324
250280,202205,371,302,69,366025.44,83628.2,449653.64
250290,202205,93,83,10,100596,12120,112716
250300,202205,525,351,174,425413.72,210888,636301.72
250310,202205,45,41,4,49692,4848.1,54540.1
250320,202205,1985,1320,665,1599852.51,805987.36,2405839.87
250330,202205,111,93,18,112716.2,21816.99,134533.19
250340,202205,29,23,6,27876,7272,35148
250350,202205,189,124,65,150288,79992,230280
250355,202205,31,23,8,27876,9696,37572
250360,202205,190,158,32,191496.68,38784.84,230281.52
250370,202205,2359,1530,829,1854374.53,1009604.02,2863978.55
250375,202205,14,8,6,9696,7272.2,16968.2
250380,202205,51,43,8,52116,9696,61812
250390,202205,44,34,10,41208.16,12120,53328.16
250400,202205,16585,8335,8250,10109336.54,10005120.74,20114457.28
250403,202205,310,241,69,292092.1,83628,375720.1
250407,202205,68,55,13,66660,15756.85,82416.85
250410,202205,30,26,4,31512,4848,36360
250415,202205,44,27,17,32724,20604,53328
250420,202205,38,31,7,37572,8484,46056
250430,202205,1441,1244,197,1510458.76,239977.65,1750436.41
250435,202205,29,23,6,27876,7272,35148
250440,202205,672,556,116,673873.6,140592.4,814466.0
250450,202205,80,61,19,73932.2,23028,96960.2
250460,202205,458,300,158,363601.59,191497.05,555098.64
250470,202205,98,68,30,82416,36360,118776
250480,202205,323,257,66,311486.43,79992,391478.43
250485,202205,6,6,0,7272,,7272.0
250490,202205,230,189,41,230280.68,49692,279972.68
250500,202205,93,73,20,88476,24240,112716
250510,202205,784,621,163,753866.11,199980,953846.11
250520,202205,169,112,57,135744,69084,204828
250523,202205,118,98,20,118776,24240,143016
250527,202205,115,88,27,106656,32724,139380
250530,202205,8,4,4,4848,4848,9696
250535,202205,29,21,8,25452,9696,35148
250540,202205,145,112,33,135744.5,39996,175740.5
250550,202205,68,66,2,79992,2424,82416
250560,202205,60,38,22,46056,26664,72720
250570,202205,157,129,28,156348,33936.55,190284.55
250580,202205,98,74,24,89766,29088,118854
250590,202205,21,11,10,13332,12120,25452
250600,202205,1516,998,518,1209581.48,627816.1,1837397.58
250610,202205,154,125,29,151501.2,35148,186649.2
250620,202205,19,15,4,18180.1,4848,23028.1
250625,202205,65,50,15,60600.33,18180,78780.33
250630,202205,3122,1968,1154,2385461.1,1398655.92,3784117.02
250640,202205,191,151,40,183012.6,48480.72,231493.32
250650,202205,31,21,10,25452,12120.6,37572.6
250660,202205,60,44,16,53328,19392,72720
250670,202205,67,51,16,61812,19392,81204
250680,202205,410,328,82,397538.17,99384.25,496922.42
250690,202205,2133,1468,665,1779229.99,807195.19,2586425.18
250700,202205,919,782,137,947785.45,166044.2,1113829.65
250710,202205,459,364,95,441171.44,115140.6,556312.04
250720,202205,118,86,32,104232.2,38784,143016.2
250730,202205,410,339,71,410868.2,86052.5,496920.7
250740,202205,62,58,4,70296,4848,75144
250750,202205,23514,13985,9529,16958330.15,11557711.47,28516041.62
250760,202205,111,90,21,109080,25452,134532
250770,202205,360,234,126,283610.3,152712.2,436322.5
250780,202205,68,45,23,54540,27876,82416
250790,202205,448,281,167,340573.3,202404.75,542978.05
250800,202205,145,131,14,158772,16968,175740
250810,202205,74,60,14,73932,16968,90900
250820,202205,153,129,24,156348.2,29088,185436.2
250830,202205,446,288,158,349056.9,191496,540552.9
250840,202205,57,51,6,61812,7272,69084
250850,202205,60,50,10,60600,12120,72720
250855,202205,17,15,2,18180.2,2424,20604.2
250860,202205,241,158,83,191496,100596,292092
250870,202205,29,26,3,31512.8,3636,35148.8
250880,202205,89,68,21,82416,25452,107868
250890,202205,3120,2303,817,2792462.32,990206.2,3782668.52
250900,202205,59,49,10,59388,12120,71508
250905,202205,127,96,31,116352,37572,153924
250910,202205,1009,741,268,898095.43,324816.21,1222911.64
250915,202205,107,73,34,88476.46,41209,129685.46
250920,202205,140,102,38,123624,46056,169680
250930,202205,182,104,78,126048,94536,220584
250933,202205,9,6,3,7272,3636,10908
250937,202205,16,16,0,19392,,19392.0
250939,202205,31,25,6,30300,7272,37572
250940,202205,121,88,33,106656.8,39996,146652.8
250950,202205,76,54,22,65448,26664,92112
250960,202205,90,50,40,60600.73,48480,109080.73
250970,202205,1256,885,371,1072625.1,450865.63,1523490.73
250980,202205,101,68,33,82416.05,39996,122412.05
250990,202205,168,129,39,156348,47268,203616
251000,202205,78,68,10,82416,12120,94536
251010,202205,125,92,33,112716,39996,152712
251020,202205,76,62,14,75144.68,16968,92112.68
251030,202205,48,34,14,41208,16968,58176
251040,202205,58,39,19,47268,23028,70296
251050,202205,25,21,4,25452,4848,30300
251060,202205,49,39,10,47268.48,12120,59388.48
251065,202205,6,3,3,3636,3636,7272
251070,202205,16,13,3,15756,3636,19392
251080,202205,5288,2481,2807,3007044.75,3404525.6,6411570.35
251090,202205,188,157,31,190284.2,37572,227856.2
251100,202205,23,22,1,26664,1212,27876
251110,202205,58,39,19,47268,23028,70296
251120,202205,1912,1180,732,1430176.82,888401.92,2318578.74
251130,202205,427,352,75,426624.23,90900,517524.23
251140,202205,586,371,215,449652.6,263004.83,712657.43
251150,202205,340,281,59,341785.52,71508.3,413293.82
251160,202205,94,75,19,90900.1,23028,113928.1
251170,202205,90,74,16,89688.22,20604,110292.22
251180,202205,290,168,122,203616.35,147864,351480.35
251190,202205,191,125,66,151500.2,79992.1,231492.3
251200,202205,276,214,62,259370.05,75144,334514.05
251203,202205,35,32,3,38784,3636,42420
251207,202205,85,71,14,86052,16968,103020
251210,202205,1494,1093,401,1324724.11,486013.76,1810737.87
251220,202205,46,36,10,43632.2,12120,55752.2
251230,202205,566,468,98,568428.2,118777.5,687205.7
251240,202205,110,77,33,93324,39996,133320
251250,202205,1462,1038,424,1259173.34,513890.32,1773063.66
251260,202205,11,7,4,8484,4848,13332
251270,202205,304,242,62,293306.1,75144,368450.1
251272,202205,68,60,8,73932,9696.1,83628.1
251274,202205,27,21,6,26664,7272,33936
251275,202205,34,20,14,24240,16968,41208
251276,202205,29,23,6,27876.38,7272,35148.38
251278,202205,14,12,2,14544,2424,16968
251280,202205,100,95,5,115140,6060,121200
251290,202205,968,692,276,839924.23,334514.32,1174438.55
251300,202205,16,11,5,13332,6060,19392
251310,202205,300,216,84,261793.39,101808.35,363601.74
251315,202205,38,35,3,42420,3636,46056
251320,202205,74,59,15,71508,19392.1,90900.1
251330,202205,81,70,11,84840,13332.2,98172.2
251335,202205,22,11,11,13332,13332,26664
251340,202205,791,455,336,552675.29,407232.2,959907.49
251350,202205,34,33,1,39996,1212,41208
251360,202205,83,72,11,87264,13332,100596
251365,202205,6,6,0,7272,,7272.0
251370,202205,5709,3885,1824,4709867.35,2211910.66,6921778.01
251380,202205,46,34,12,41208,14544,55752
251385,202205,3,3,0,3636,,3636.0
251390,202205,930,689,241,835071.89,292094.88,1127166.77
251392,202205,28,18,10,21816,12120,33936
251394,202205,11,9,2,10908,2424,13332
251396,202205,13,8,5,9696,6060,15756
251398,202205,16,13,3,15756,3636,19392
251400,202205,50,39,11,47268,13332,60600
251410,202205,39,33,6,39996.2,7272,47268.2
251420,202205,104,77,27,93324.1,32724,126048.1
251430,202205,44,40,4,48480,4848,53328
251440,202205,51,27,24,32724,29088,61812
251445,202205,63,52,11,63024.39,13332,76356.39
251450,202205,385,332,53,402387.5,64236.8,466624.3
251455,202205,5,4,1,4848,1212,6060
251460,202205,21,17,4,20604,4848,25452
251465,202205,8,5,3,6060,3636,9696
251470,202205,52,38,14,46056,16968,63024
251480,202205,30,25,5,30300,6060,36360
251490,202205,109,68,41,82416.68,49692.7,132109.38
251500,202205,114,95,19,115140.2,23028,138168.2
251510,202205,75,46,29,55752.82,35148,90900.82
251520,202205,33,29,4,35148,4848,39996
251530,202205,4275,3003,1272,3639650.13,1542879.39,5182529.52
251540,202205,87,72,15,87264,18180.2,105444.2
251550,202205,406,310,96,375720.9,116352.41,492073.31
251560,202205,23,16,7,19392,8484,27876
251570,202205,18,15,3,18180,3636,21816
251580,202205,129,101,28,122412,33936,156348
251590,202205,107,74,33,89688,39996,129684
251593,202205,26,14,12,16968,14544,31512
251597,202205,99,77,22,93324,26664.68,119988.68
251600,202205,1093,763,330,925056.6,401172.7,1326229.3
251610,202205,239,176,63,213312,76356,289668
251615,202205,15,13,2,15756,2424,18180
251620,202205,4177,2673,1504,3240901.08,1824069.37,5064970.45
251630,202205,457,335,122,406023.16,147864.1,553887.26
251640,202205,118,87,31,105444.2,37572,143016.2
251650,202205,286,210,76,255732.8,92112,347844.8
251660,202205,197,174,23,210888.46,27876,238764.46
251670,202205,386,299,87,363601.82,105444.1,469045.92
251675,202205,10,8,2,9696,2424,12120
251680,202205,105,89,16,107868,19392,127260
251690,202205,315,262,53,317545.57,64236.2,381781.77
251700,202205,275,240,35,290880.1,42420,333300.1
251710,202205,21,12,9,14544,10908,25452
251720,202205,24,17,7,20604,8484,29088
251740,202205,13,10,3,12120,3636,15756
260005,202205,3535,1873,1662,2269581.52,2015564.16,4285145.68
260010,202205,1678,1244,434,1508948.02,526010.14,2034958.16
260020,202205,396,346,50,419352.89,60600.2,479953.09
260030,202205,598,406,192,493284.49,232704.42,725988.91
260040,202205,799,494,305,598729.6,369660.66,968390.26
260050,202205,1156,825,331,1001120.81,401173.3,1402294.11
260060,202205,362,333,29,403598.01,35148,438746.01
260070,202205,1324,805,519,975668.52,630243,1605911.52
260080,202205,715,542,173,656904.96,209676,866580.96
260090,202205,478,309,169,374508.2,204829.65,579337.85
260100,202205,214,150,64,181800.15,77568,259368.15
260105,202205,248,141,107,170892.67,129684,300576.67
260110,202205,2943,2139,804,2592475.65,976875,3569350.65
260120,202205,2706,1456,1250,1765001.6,1519855.66,3284857.26
260130,202205,181,124,57,150288,69084,219372
260140,202205,2210,1437,773,1742864.34,939304.7,2682169.04
260150,202205,192,125,67,151500,81204,232704
260160,202205,349,283,66,342997.49,79992,422989.49
260170,202205,3329,1977,1352,2398557.88,1641055.91,4039613.79
260180,202205,179,143,36,173478.2,43632.66,217110.86
260190,202205,2344,1551,793,1879819.52,962330.79,2842150.31
260200,202205,981,767,214,929609.06,259368.6,1188977.66
260210,202205,1376,973,403,1179282.85,489649.55,1668932.40
260220,202205,645,581,64,704178.07,77568.91,781746.98
260230,202205,1239,914,325,1107771.23,393901.32,1501672.55
260240,202205,204,155,49,187861.16,59388,247249.16
260250,202205,94,70,24,84840,29088,113928
260260,202205,1054,732,322,887185.6,390264,1277449.6
260270,202205,260,186,74,225432.68,89688,315120.68
260280,202205,1141,914,227,1110198.42,275125.9,1385324.32
260290,202205,6780,3668,3112,4445633.49,3774171.88,8219805.37
260300,202205,985,839,146,1016881.33,176953.1,1193834.43
260310,202205,503,403,100,489648.6,121200,610848.6
260320,202205,822,600,222,728412.94,269064.54,997477.48
260330,202205,73,53,20,64236.2,24240.1,88476.3
260340,202205,78,58,20,70297.76,24240,94537.76
260345,202205,5596,2924,2672,3543912.69,3239684.97,6783597.66
260350,202205,472,333,139,403597.86,168469.12,572066.98
260360,202205,243,134,109,162408.4,132108.2,294516.6
260370,202205,747,472,275,572064.94,334512.1,906577.04
260380,202205,559,398,161,482377.2,195132.19,677509.39
260390,202205,295,249,46,301788,55752,357540
260392,202205,116,98,18,118776,21816,140592
260400,202205,4354,2494,1860,3025160.97,2255536.61,5280697.58
260410,202205,14991,7769,7222,9423343.81,8762775.38,18186119.19
260415,202205,143,122,21,147864.74,25452,173316.74
260420,202205,1739,1070,669,1296845.47,812040.89,2108886.36
260430,202205,172,155,17,187860.64,20604,208464.64
260440,202205,192,131,61,158773.38,73932,232705.38
260450,202205,422,314,108,380569.57,130896,511465.57
260460,202205,816,430,386,521163.86,467833.1,988996.96
260470,202205,343,207,136,250886.56,164833.18,415719.74
260480,202205,249,158,91,191496,110292.2,301788.2
260490,202205,219,174,45,210888,55752,266640
260500,202205,1119,751,368,911426.1,446016.92,1357443.02
260510,202205,813,643,170,779316.4,206040.1,985356.5
260515,202205,228,204,24,247248.2,29088,276336.2
260520,202205,3214,1980,1234,2399765.9,1495613.12,3895379.02
260530,202205,811,659,152,801138.47,184224.1,985362.57
260540,202205,529,419,110,507829.49,133320.2,641149.69
260545,202205,16,11,5,13332,6060,19392
260550,202205,330,210,120,254520.5,145440,399960.5
260560,202205,507,383,124,464198.7,150289.71,614488.41
260570,202205,1000,796,204,965969.98,247249.08,1213219.06
260580,202205,336,273,63,330876,76356,407232
260590,202205,616,354,262,429048,317544,746592
260600,202205,7730,4454,3276,5398276.29,3982642.86,9380919.15
260610,202205,492,326,166,395113.8,201192.8,596306.6
260620,202205,3710,1921,1789,2330689.18,2169488.06,4500177.24
260630,202205,81,73,8,88476,9696,98172
260640,202205,3357,1953,1404,2367044.24,1702862.1,4069906.34
260650,202205,315,228,87,276336.05,105444.8,381780.85
260660,202205,578,368,210,446018.62,254521.86,700540.48
260670,202205,103,74,29,89688,35148,124836
260680,202205,3977,2173,1804,2636120.73,2187673.21,4823793.94
260690,202205,128,95,33,115140.74,39996.3,155137.04
260700,202205,304,202,102,244824.81,123624,368448.81
260710,202205,46,38,8,46056,9696,55752
260720,202205,2676,1567,1109,1899209.25,1344108.9,3243318.15
260730,202205,730,537,193,652057.78,235128,887185.78
260740,202205,76,61,15,73932,18180,92112
260750,202205,568,414,154,502981,186648,689629
260760,202205,699,338,361,409661.52,438746.09,848407.61
260765,202205,979,503,476,609638.23,576914,1186552.23
260770,202205,216,158,58,191475.6,71508.74,262984.34
260775,202205,780,420,360,509044.26,436320.99,945365.25
260780,202205,232,143,89,173316,107868.6,281184.6
260790,202205,15204,7466,7738,9053694.08,9380894.2,18434588.28
260795,202205,157,101,56,123624,67872,191496
260800,202205,289,234,55,283608,66660.46,350268.46
260805,202205,172,111,61,134532,73932,208464
260810,202205,811,663,148,803557.72,179376.2,982933.92
260820,202205,292,188,104,227856.27,127260,355116.27
260825,202205,211,138,73,167256,88476,255732
260830,202205,295,187,108,226644,130896.72,357540.72
260840,202205,262,189,73,229068.2,88476.2,317544.4
260845,202205,173,112,61,135744,75144.1,210888.1
260850,202205,409,308,101,373297.45,122412,495709.45
260860,202205,251,186,65,225433.4,78780,304213.4
260870,202205,346,264,82,319968.92,99384,419352.92
260875,202205,741,541,200,655699.38,242400.58,898099.96
260880,202205,1561,1040,521,1261699.41,631452.2,1893151.61
260890,202205,2393,1647,746,1997385.69,904155.19,2901540.88
260900,202205,1000,722,278,875066.39,338148.6,1213214.99
260910,202205,246,192,54,232705.1,65448,298153.1
260915,202205,279,208,71,252096,86052,338148
260920,202205,204,106,98,128472,118776,247248
260930,202205,357,300,57,363601.1,69084.1,432685.2
260940,202205,2565,1361,1204,1649540.43,1459251.37,3108791.80
260950,202205,1981,1124,857,1362302.81,1038688.5,2400991.31
260960,202205,13587,6603,6984,8004119.31,8471915.88,16476035.19
260970,202205,422,343,79,415716.6,95748,511464.6
260980,202205,201,181,20,219373.78,24240,243613.78
260990,202205,2648,2113,535,2563405.49,648421.12,3211826.61
261000,202205,4217,2587,1630,3135452.39,1976775.98,5112228.37
261010,202205,155,105,50,127260,60600,187860
261020,202205,582,433,149,524797,180588,705385
261030,202205,252,182,70,220584,84840,305424
261040,202205,372,314,58,380569.45,70296,450865.45
261050,202205,509,431,78,522372.97,94536,616908.97
261060,202205,1457,892,565,1081107.14,684781.7,1765888.84
261070,202205,9274,4415,4859,5354675.52,5892791.97,11247467.49
261080,202205,366,278,88,336937.2,106656,443593.2
261090,202205,2091,1598,493,1939215.98,598728.4,2537944.38
261100,202205,1216,847,369,1026569.01,447229,1473798.01
261110,202205,9075,5604,3471,6794528.58,4206877.42,11001406.00
261120,202205,233,200,33,242400.16,39996,282396.16
261130,202205,568,332,236,402389.27,287245.78,689635.05
261140,202205,212,134,78,162408,94536,256944
261150,202205,682,433,249,524797.43,301788,826585.43
261153,202205,69,65,4,78780,4848,83628
261160,202205,74636,36531,38105,44295454.28,46214947.17,90510401.45
261170,202205,462,344,118,416929.17,143016.1,559945.27
261180,202205,1760,1096,664,1329846.39,804771.39,2134617.78
261190,202205,567,394,173,477528.91,209676,687204.91
261200,202205,225,181,44,219372,53328,272700
261210,202205,39,31,8,38784,9696,48480
261220,202205,2732,1901,831,2305235.68,1007176.3,3312411.98
261230,202205,349,256,93,310272.3,112716.97,422989.27
261240,202205,438,378,60,458139.44,72720.2,530859.64
261245,202205,240,198,42,239976,50904,290880
261247,202205,167,125,42,151500,50904,202404
261250,202205,3529,1667,1862,2021621.74,2256744.8,4278366.54
261255,202205,246,218,28,264216,33936,298152
261260,202205,820,709,111,859317.91,134534.36,993852.27
261270,202205,197,139,58,168468.6,70296,238764.6
261280,202205,191,153,38,185436.1,46056,231492.1
261290,202205,105,75,30,90900,36360.2,127260.2
261300,202205,1350,993,357,1203521.26,432685.76,1636207.02
261310,202205,782,521,261,632668.26,316332.16,949000.42
261320,202205,552,378,174,459352.16,210889.31,670241.47
261330,202205,913,713,200,864165.88,242404.71,1106570.59
261340,202205,310,175,135,212100.1,163620.45,375720.55
261350,202205,875,609,266,738113.77,322393.5,1060507.27
261360,202205,1387,881,506,1067772.9,613273.3,1681046.2
261370,202205,4852,2839,2013,3442099.37,2439761.46,5881860.83
261380,202205,552,424,128,513890.35,155136.6,669026.95
261390,202205,3677,2484,1193,3010628.74,1445929.1,4456557.84
261400,202205,269,242,27,293304.52,32724,326028.52
261410,202205,1124,740,384,896883.04,465408.82,1362291.86
261420,202205,946,580,366,702965.02,444804.59,1147769.61
261430,202205,316,285,31,345421.5,37572,382993.5
261440,202205,102,97,5,117564.2,6060,123624.2
261450,202205,2529,1995,534,2419159.17,647210.34,3066369.51
261460,202205,768,598,170,724778.88,206040.7,930819.58
261470,202205,219,178,41,216948.4,49692.49,266640.89
261480,202205,464,354,110,429050.61,133266.43,562317.04
261485,202205,379,230,149,279973.86,180588.1,460561.96
261500,202205,607,403,204,489648.7,247248,736896.7
261510,202205,50,32,18,38784.98,21816.1,60601.08
261520,202205,89,73,16,88476.18,19392,107868.18
261530,202205,4029,2561,1468,3106372.88,1781646.94,4888019.82
261540,202205,1454,833,621,1009597.7,753866.53,1763464.23
261550,202205,244,115,129,139380.3,156348,295728.3
261560,202205,905,599,306,725993.36,372086.35,1098079.71
261570,202205,387,306,81,370873.61,98172,469045.61
261580,202205,390,308,82,373297.02,99384,472681.02
261590,202205,188,156,32,189072.2,38784.8,227857.0
261600,202205,296,234,62,283608.98,75144,358752.98
261610,202205,85,74,11,89688,13332,103020
261618,202205,69,53,16,64236,19392,83628
261620,202205,198,126,72,152712.56,87264.2,239976.76
261630,202205,664,523,141,633877.15,170892,804769.15
261640,202205,6486,3406,3080,4132935.68,3734184.9,7867120.58
261650,202205,463,299,164,362389,198768.6,561157.6
270010,202205,511,451,60,546615.61,72720.5,619336.11
270020,202205,241,200,41,242401.61,49692.2,292093.81
270030,202205,8715,5587,3128,6776379.92,3791093.17,10567473.09
270040,202205,2072,1354,718,1643476.54,872642.79,2516119.33
270050,202205,208,162,46,196344.5,55752,252096.5
270060,202205,70,48,22,58177,26664,84841
270070,202205,821,602,219,729625.05,265429.1,995054.15
270080,202205,40,33,7,39996,8484,48480
270090,202205,20,16,4,19392,4848,24240
270100,202205,1317,905,412,1096862.83,500556.76,1597419.59
270110,202205,68,57,11,69084,13332,82416
270120,202205,234,193,41,233917.35,49692,283609.35
270130,202205,318,234,84,283608,101808,385416
270135,202205,118,81,37,98172.4,44844,143016.4
270140,202205,1377,903,474,1098080.79,575703.21,1673784.00
270150,202205,244,187,57,226644.6,69084.1,295728.7
270160,202205,483,380,103,460561,124836,585397
270170,202205,803,532,271,644786.49,328452.29,973238.78
270180,202205,57,45,12,54540,14544.55,69084.55
270190,202205,107,92,15,111504,18180,129684
270200,202205,114,100,14,121200,16968,138168
270210,202205,539,330,209,401172.1,253308,654480.1
270220,202205,191,143,48,173316.2,58176,231492.2
270230,202205,2156,1356,800,1643480.78,969600.54,2613081.32
270235,202205,642,501,141,607215.44,170892,778107.44
270240,202205,2957,2346,611,2845788.42,740534,3586322.42
270250,202205,122,89,33,109686.8,39996,149682.8
270255,202205,208,177,31,214524,37572,252096
270260,202205,356,289,67,350270.17,81204.31,431474.48
270270,202205,93,48,45,58176,54540,112716
270280,202205,220,138,82,167256,99384,266640
270290,202205,1115,878,237,1065350.81,287245.8,1352596.61
270300,202205,367,269,98,326028,118776,444804
270310,202205,804,671,133,813256.1,161196.2,974452.3
270320,202205,774,665,109,805980.78,132108,938088.78
270330,202205,305,262,43,317544.48,52116,369660.48
270340,202205,62,51,11,61812,13332,75144
270350,202205,89,53,36,64236,43632,107868
270360,202205,72,41,31,49692,37572,87264
270370,202205,59,48,11,58176,13332,71508
270375,202205,77,48,29,58176,35148,93324
270380,202205,1059,715,344,869004.6,418140,1287144.6
270390,202205,142,81,61,98172,75144,173316
270400,202205,730,561,169,679935.99,204828,884763.99
270410,202205,613,451,162,546613.72,196344,742957.72
270420,202205,405,285,120,345420.32,145440,490860.32
270430,202205,34269,24628,9641,29862237.08,11695867.1,41558104.18
270440,202205,472,374,98,453288.7,118776.1,572064.8
270450,202205,840,495,345,599941.74,418140.92,1018082.66
270460,202205,178,143,35,173318.12,42420,215738.12
270470,202205,1578,1100,478,1334216.84,579337.4,1913554.24
270480,202205,538,435,103,527223.06,124836,652059.06
270490,202205,21,15,6,18180,7272,25452
270500,202205,463,389,74,472680.77,89688,562368.77
270510,202205,865,561,304,681186.03,368448,1049634.03
270520,202205,268,175,93,213312.58,112716,326028.58
270530,202205,61,52,9,63024,10908,73932
270540,202205,93,69,24,83628,29088,112716
270550,202205,1675,1298,377,1573183.3,458136.2,2031319.5
270560,202205,255,154,101,186648.3,122412.5,309060.8
270570,202205,563,400,163,486012.15,197556,683568.15
270580,202205,76,59,17,72720,20604,93324
270590,202205,59,46,13,55752.3,15756,71508.3
270600,202205,153,133,20,161196.2,24240,185436.2
270610,202205,241,192,49,232704.75,59388.1,292092.85
270620,202205,16,16,0,19392,,19392.0
270630,202205,3659,2773,886,3364529.25,1075046.89,4439576.14
270640,202205,861,646,215,782956.62,260580.5,1043537.12
270642,202205,209,175,34,212100.2,41208,253308.2
270644,202205,253,169,84,205717.44,101808,307525.44
270650,202205,342,208,134,252097.25,162408.56,414505.81
270660,202205,193,172,21,208465.26,25452,233917.26
270670,202205,2918,2232,686,2705435.41,832645.25,3538080.66
270680,202205,392,249,143,301789.3,173316,475105.3
270690,202205,1211,814,397,987786.17,481164.93,1468951.10
270700,202205,26,21,5,25452,6060,31512
270710,202205,850,674,176,818100.91,213312,1031412.91
270720,202205,222,177,45,214524.53,54540,269064.53
270730,202205,1887,1182,705,1432589.68,856884.79,2289474.47
270740,202205,35,24,11,29088,13332,42420
270750,202205,615,470,145,570853.44,175740.65,746594.09
270760,202205,291,209,82,253309,99384,352693
270770,202205,2799,1900,899,2304024.22,1090801.57,3394825.79
270780,202205,65,40,25,48480,30300.9,78780.9
270790,202205,226,146,80,178164.21,96960,275124.21
270800,202205,2044,1633,411,1979205.47,499344,2478549.47
270810,202205,219,182,37,220584.2,44844,265428.2
270820,202205,122,87,35,105444.6,42420,147864.6
270830,202205,823,627,196,759932.21,237552.3,997484.51
270840,202205,1318,1016,302,1231395.64,366024.96,1597420.60
270850,202205,1511,984,527,1192609.28,639936.1,1832545.38
270860,202205,2552,1730,822,2096771.49,996269.59,3093041.08
270870,202205,119,69,50,83628.2,60600.11,144228.31
270880,202205,850,675,175,818101.6,213312.4,1031414.0
270890,202205,265,203,62,247249.07,75144.16,322393.23
270895,202205,58,56,2,67872,2424,70296
270900,202205,63,53,10,64236.2,12120,76356.2
270910,202205,304,250,54,303003.95,65448,368451.95
270915,202205,1920,1266,654,1538034.12,792649.06,2330683.18
270920,202205,416,346,70,419353.12,84840.2,504193.32
270930,202205,5671,4354,1317,5277073.32,1596206,6873279.32
270940,202205,2192,1738,454,2107677.34,551460,2659137.34
280010,202205,37,31,6,37572.51,7272,44844.51
280020,202205,492,421,71,510254.01,86052.97,596306.98
280030,202205,21245,13827,7418,16769451.65,8996754.15,25766205.80
280040,202205,322,206,116,249672.2,140592.2,390264.4
280050,202205,414,318,96,385416,116352,501768
280060,202205,371,241,130,294518.47,157560.92,452079.39
280067,202205,1124,809,315,980511.74,381780.92,1362292.66
280070,202205,127,107,20,129684.8,24240,153924.8
280100,202205,653,504,149,610850.07,180588.85,791438.92
280110,202205,78,70,8,84840.4,9696,94536.4
280120,202205,666,556,110,673872.58,133321.18,807193.76
280130,202205,1746,1148,598,1391378.83,724777,2116155.83
280140,202205,500,420,80,509041.95,96960,606001.95
280150,202205,420,296,124,359964.73,150288,510252.73
280160,202205,140,111,29,135744,35148,170892
280170,202205,424,297,127,359966.64,153924.2,513890.84
280190,202205,29,24,5,29088,6060,35148
280200,202205,36,29,7,35148.2,8484,43632.2
280210,202205,2973,2142,831,2596032.74,1008392.45,3604425.19
280220,202205,51,41,10,49692.91,12120.6,61813.51
280230,202205,330,265,65,321181.21,78780,399961.21
280240,202205,129,120,9,145440.3,10908,156348.3
280250,202205,19,11,8,13332,9696,23028
280260,202205,77,70,7,84840.65,8484,93324.65
280270,202205,138,106,32,128472,38784.1,167256.1
280280,202205,184,120,64,145441.19,77568,223009.19
280290,202205,3577,2595,982,3145073.68,1191399.03,4336472.71
280300,202205,1615,1293,322,1571975.27,391476.4,1963451.67
280310,202205,94,90,4,109080.4,4848,113928.4
280320,202205,661,467,194,566006.65,235128.95,801135.60
280330,202205,311,230,81,278760.7,98172.4,376933.1
280340,202205,423,354,69,429049.68,83628,512677.68
280350,202205,3744,2869,875,3478460.27,1061718.43,4540178.70
280360,202205,465,315,150,381780.48,181800,563580.48
280370,202205,89,78,11,94536.13,13332,107868.13
280380,202205,48,37,11,44844,13332,58176
280390,202205,177,151,26,183012.2,31512,214524.2
280400,202205,394,269,125,326031.42,151500.9,477532.32
280410,202205,294,245,49,296941.37,59388.1,356329.47
280420,202205,131,112,19,135744.7,23028,158772.7
280430,202205,90,72,18,87264.4,21816,109080.4
280440,202205,717,587,130,711448.72,157560.2,869008.92
280445,202205,118,111,7,134532.42,8484,143016.42
280450,202205,1268,1088,180,1319871.39,218160.4,1538031.79
280460,202205,655,478,177,579339.02,214524.31,793863.33
280470,202205,101,93,8,112716.19,9696,122412.19
280480,202205,3001,2052,949,2487054.64,1150198.04,3637252.68
280490,202205,199,188,11,227858.42,13332,241190.42
280500,202205,42,39,3,47268.42,3636.17,50904.59
280510,202205,136,109,27,132108.56,32725.2,164833.76
280520,202205,53,39,14,47268.8,16968,64236.8
280530,202205,70,49,21,59388.58,25452,84840.58
280540,202205,546,469,77,569641.91,93324,662965.91
280550,202205,728,671,57,813257.16,69084,882341.16
280560,202205,477,428,49,518737.41,59388.6,578126.01
280570,202205,2320,1836,484,2228879.63,587820.09,2816699.72
280580,202205,580,456,124,552674.38,150288.2,702962.58
280590,202205,221,141,80,170897.46,96960.75,267858.21
280600,202205,397,328,69,397595.73,83628,481223.73
280610,202205,111,80,31,96960,37572,134532
280620,202205,547,444,103,538129,124836,662965
280630,202205,148,122,26,147864.87,31512.2,179377.07
280640,202205,182,147,35,178164,42420,220584
280650,202205,85,52,33,63024.2,39996.52,103020.72
280660,202205,126,95,31,115141.65,37572,152713.65
280670,202205,1980,1253,727,1521134.17,882343,2403477.17
280680,202205,239,206,33,249672.6,39996,289668.6
280690,202205,78,68,10,82416,12120,94536
280700,202205,19,19,0,23028,,23028.0
280710,202205,1489,1164,325,1410779.48,395112.94,1805892.42
280720,202205,126,85,41,103021.43,49692,152713.43
280730,202205,28,24,4,29088,4848,33936
280740,202205,2541,1907,634,2312504.23,769621.87,3082126.10
280750,202205,221,193,28,233919.12,33936,267855.12
280760,202205,886,603,283,730845.24,342997.27,1073842.51
290010,202205,196,138,58,167256,70296,237552
290020,202205,186,168,18,203616.4,21816,225432.4
290030,202205,611,394,217,477529.12,263004,740533.12
290035,202205,130,106,24,128472,29088,157560
290040,202205,297,205,92,248461.13,111504,359965.13
290050,202205,87,71,16,86052,19392,105444
290060,202205,253,111,142,134532,172104,306636
290070,202205,5741,2737,3004,3319680.9,3645707.27,6965388.17
290080,202205,446,189,257,229068.2,315120,544188.2
290090,202205,355,163,192,197556,232704.61,430260.61
290100,202205,1697,1075,622,1305333.6,753864.2,2059197.8
290110,202205,842,483,359,585400.43,435109.29,1020509.72
290115,202205,188,170,18,206040.68,21816,227856.68
290120,202205,795,533,262,647209.79,317544,964753.79
290130,202205,447,277,170,335724,206040.16,541764.16
290135,202205,292,223,69,270276.46,83628,353904.46
290140,202205,309,256,53,310272.61,64236,374508.61
290150,202205,133,92,41,111504,49692,161196
290160,202205,240,184,56,223009.72,67872.1,290881.82
290170,202205,103,73,30,88476,36360,124836
290180,202205,191,140,51,169680.6,61812,231492.6
290190,202205,361,285,76,345422.32,92112,437534.32
290195,202205,298,192,106,232704,128472.2,361176.2
290200,202205,261,214,47,259368,56964,316332
290205,202205,143,89,54,107868.6,65448,173316.6
290210,202205,1204,884,320,1071414.18,387840.6,1459254.78
290220,202205,177,100,77,121200.2,93324.2,214524.4
290225,202205,290,115,175,139380,212100.2,351480.2
290230,202205,77,47,30,56964,36360,93324
290240,202205,357,122,235,147864.2,286032.5,433896.7
290250,202205,242,225,17,272701.58,20604,293305.58
290260,202205,337,267,70,323605.4,84840,408445.4
290265,202205,185,161,24,195132.33,29088.3,224220.63
290270,202205,1367,1132,235,1373207.15,284822.8,1658029.95
290280,202205,474,336,138,407232.88,167256,574488.88
290290,202205,1366,818,548,991419.2,665389,1656808.2
290300,202205,396,338,58,409658.29,70296,479954.29
290310,202205,282,134,148,162408.2,180588,342996.2
290320,202205,4170,2541,1629,3082142.65,1976780.72,5058923.37
290323,202205,201,176,25,213312,30300,243612
290327,202205,156,120,36,145440.5,43632,189072.5
290330,202205,119,56,63,67872,76356,144228
290340,202205,768,321,447,389053.97,541764.2,930818.17
290350,202205,659,403,256,488437.35,310272,798709.35
290360,202205,321,250,71,303002.24,86052.71,389054.95
290370,202205,893,399,494,483590.35,598728,1082318.35
290380,202205,330,210,120,254521.68,145440.1,399961.78
290390,202205,2381,1491,890,1808312.04,1079892.4,2888204.44
290395,202205,236,136,100,164832,121200,286032
290400,202205,280,202,78,244824,94536,339360
290405,202205,240,205,35,248460.1,42420,290880.1
290410,202205,621,518,103,627816.38,124836,752652.38
290420,202205,267,214,53,259368.2,64236,323604.2
290430,202205,474,303,171,367237.04,207252,574489.04
290440,202205,82,72,10,87264,12120,99384
290450,202205,193,142,51,172104,61812,233916
290460,202205,1926,1157,769,1402289.93,932029.03,2334318.96
290470,202205,1353,594,759,719930.4,919911.47,1639841.87
290475,202205,554,517,37,626606.32,44844,671450.32
290480,202205,274,157,117,190284.4,141804,332088.4
290485,202205,238,217,21,263004.28,25452,288456.28
290490,202205,1248,880,368,1067774.38,446017.85,1513792.23
290500,202205,756,401,355,486014.49,430261.46,916275.95
290510,202205,194,156,38,189073.75,46056,235129.75
290515,202205,169,102,67,123624,81204,204828
290520,202205,1380,898,482,1089590.94,584184.38,1673775.32
290530,202205,278,253,25,306639.03,30300.2,336939.23
290540,202205,111,57,54,69084,65448,134532
290550,202205,158,133,25,161196.2,30300,191496.2
290560,202205,3202,1420,1782,1722259.7,2160998.9,3883258.6
290570,202205,6407,3061,3346,3711167.13,4056586.88,7767754.01
290580,202205,1242,746,496,904152.54,601152.4,1505304.94
290590,202205,560,447,113,541771.57,136957.49,678729.06
290600,202205,1747,1202,545,1456833.69,660544.74,2117378.43
290610,202205,175,160,15,193922.26,18180,212102.26
290620,202205,367,332,35,402385.87,42420.2,444806.07
290630,202205,1963,850,1113,1030207.03,1348959.16,2379166.19
290640,202205,134,107,27,129684.39,32724.05,162408.44
290650,202205,1841,850,991,1030205.18,1201094.43,2231299.61
290660,202205,258,214,44,259368,53328.72,312696.72
290670,202205,989,503,486,609639.41,590245.92,1199885.33
290680,202205,1238,991,247,1201095.37,299364,1500459.37
290682,202205,316,234,82,283610.39,99384.38,382994.77
290685,202205,242,150,92,181800,111504,293304
290687,202205,1137,738,399,894657.27,483589.26,1378246.53
290689,202205,147,78,69,94536,83628,178164
290690,202205,575,249,326,301789.36,395112.1,696901.46
290700,202205,245,125,120,152712,145441.2,298153.2
290710,202205,753,516,237,625394.55,287244.36,912638.91
290720,202205,1036,828,208,1004754.47,252096.7,1256851.17
290730,202205,1206,703,503,852042.21,609638.56,1461680.77
290740,202205,22,19,3,23028,3636,26664
290750,202205,1423,621,802,753866.45,972027.75,1725894.20
290755,202205,72,63,9,76356,10908,87264
290760,202205,255,226,29,273913.53,35148,309061.53
290770,202205,179,172,7,208464.27,8484,216948.27
290780,202205,1101,871,230,1056866.53,279973.79,1336840.32
290790,202205,370,250,120,303003.63,145440.45,448444.08
290800,202205,2415,978,1437,1185339.49,1744071.25,2929410.74
290810,202205,479,328,151,397537.21,183012.5,580549.71
290820,202205,402,232,170,281185.45,206041.27,487226.72
290830,202205,440,309,131,374508.59,158772,533280.59
290840,202205,1798,1127,671,1367143.39,814468.47,2181611.86
290850,202205,958,494,464,598729.39,562368.93,1161098.32
290860,202205,641,294,347,356329.19,420564,776893.19
290870,202205,607,426,181,516312.66,219372.96,735685.62
290880,202205,116,65,51,78780,61812,140592
290890,202205,442,269,173,326029.28,209676.4,535705.68
290900,202205,164,122,42,147864,50904,198768
290910,202205,386,294,92,356328.35,111504,467832.35
290920,202205,199,174,25,210889.49,30300,241189.49
290930,202205,519,397,122,481167.82,147865.3,629033.12
290940,202205,223,190,33,230280.2,39996,270276.2
290950,202205,159,91,68,111504,82416,193920
290960,202205,476,331,145,401172.72,175740.95,576913.67
290970,202205,238,209,29,253308.2,35148.3,288456.5
290980,202205,1811,1239,572,1501672.63,693266.14,2194938.77
290990,202205,399,336,63,407235.26,76358.06,483593.32
291000,202205,897,276,621,334512.2,752652,1087164.2
291005,202205,2499,1064,1435,1290790.59,1739226.06,3030016.65
291010,202205,170,150,20,181800,24240,206040
291020,202205,93,73,20,88476,24240.2,112716.2
291030,202205,96,69,27,83628,32724.6,116352.6
291040,202205,633,366,267,443592,323604.07,767196.07
291050,202205,1511,800,711,969607.38,861732.59,1831339.97
291060,202205,1642,916,726,1110197.76,882337.46,1992535.22
291070,202205,1929,1437,492,1742864.19,597519.74,2340383.93
291072,202205,7222,2731,4491,3309999.5,5447952.54,8757952.04
291075,202205,239,195,44,236340,53328.2,289668.2
291077,202205,58,40,18,48480,21816,70296
291080,202205,20742,8861,11881,10742018.06,14405889.53,25147907.59
291085,202205,265,218,47,266640.26,56964,323604.26
291090,202205,273,113,160,136956.6,193920,330876.6
291100,202205,988,333,655,403596,793860,1197456
291110,202205,443,340,103,413292.6,124836.2,538128.8
291120,202205,2411,1259,1152,1525909.99,1397437.3,2923347.29
291125,202205,61,31,30,37572,36360,73932
291130,202205,184,161,23,195132.2,27876,223008.2
291140,202205,125,101,24,122412,29088.7,151500.7
291150,202205,370,138,232,167256,282396,449652
291160,202205,398,309,89,374511.86,107868.1,482379.96
291165,202205,47,36,11,43632,13332,56964
291170,202205,3253,1615,1638,1957393.03,1988896.54,3946289.57
291180,202205,1227,502,725,608425.1,878700.86,1487125.96
291185,202205,112,103,9,124836.2,10908,135744.2
291190,202205,1381,660,721,801134.87,875064.5,1676199.37
291200,202205,170,124,46,150288,55752,206040
291210,202205,2400,966,1434,1170794.86,1739222.15,2910017.01
291220,202205,299,231,68,279972.39,82416,362388.39
291230,202205,965,339,626,410868.6,759924.3,1170792.9
291240,202205,405,380,25,460560.8,30300,490860.8
291250,202205,417,336,81,407232,98172,505404
291260,202205,63,55,8,66660,9696,76356
291270,202205,1033,450,583,545404.77,707811.5,1253216.27
291280,202205,361,168,193,204829.35,233916,438745.35
291290,202205,1647,866,781,1049598.41,946574.78,1996173.19
291300,202205,231,182,49,220584,59388,279972
291310,202205,225,196,29,237553.13,35148,272701.13
291320,202205,1309,913,396,1106561.24,479953.38,1586514.62
291330,202205,139,119,20,144228,24240,168468
291340,202205,220,131,89,158772.16,107868,266640.16
291345,202205,121,84,37,101808.15,44844,146652.15
291350,202205,1746,651,1095,789013.21,1331988.9,2121002.11
291360,202205,8366,3998,4368,4849249.18,5301310.48,10150559.66
291370,202205,1112,655,457,793865.08,553884.95,1347750.03
291380,202205,250,198,52,239976,63024,303000
291390,202205,4009,1781,2228,2159793.49,2701549.9,4861343.39
291400,202205,2075,1451,624,1759837.46,756295.54,2516133.00
291410,202205,203,173,30,209676.6,36360,246036.6
291420,202205,112,85,27,103020,32724,135744
291430,202205,176,106,70,128472,84840.84,213312.84
291440,202205,520,421,99,510253.6,119988,630241.6
291450,202205,926,608,318,736899.31,385416.52,1122315.83
291460,202205,1946,1544,402,1873769.01,488441.67,2362210.68
291465,202205,2255,1078,1177,1307751.62,1426526.81,2734278.43
291470,202205,2884,1457,1427,1765891.63,1729528.48,3495420.11
291480,202205,11918,5144,6774,6239418.01,8216168.26,14455586.27
291490,202205,656,266,390,323604.6,472680,796284.6
291500,202205,362,216,146,261792,176952.1,438744.1
291510,202205,1185,458,727,555097.23,882336.2,1437433.43
291520,202205,926,414,512,501769.17,620544.2,1122313.37
291530,202205,926,265,661,321180,801132,1122312
291535,202205,123,101,22,122412.2,26664.8,149077.0
291540,202205,349,114,235,138168,284820.3,422988.3
291550,202205,1273,606,667,735687.02,809616.3,1545303.32
291560,202205,5116,2580,2536,3128181.11,3073633.13,6201814.24
291570,202205,223,111,112,134532,135744.2,270276.2
291580,202205,1196,744,452,901732.91,547824,1449556.91
291590,202205,93,41,52,49692,64236,113928
291600,202205,1117,561,556,679933.1,673872.4,1353805.5
291610,202205,1381,674,707,816902.21,859315.77,1676217.98
291620,202205,556,262,294,317545.02,358752.7,676297.72
291630,202205,477,148,329,179376.6,398748,578124.6
291640,202205,3998,1980,2018,2399775.7,2445823.46,4845599.16
291650,202205,437,299,138,362392.12,167257.09,529649.21
291660,202205,374,152,222,184225.48,269064.72,453290.20
291670,202205,170,106,64,128472,77568,206040
291680,202205,638,392,246,475112.48,298152.96,773265.44
291685,202205,575,331,244,401173.68,295728.6,696902.28
291690,202205,460,299,161,362388.1,196344.2,558732.3
291700,202205,1039,801,238,970815.03,289668.4,1260483.43
291710,202205,1571,775,796,939304.46,965967.82,1905272.28
291720,202205,429,291,138,352692,167256,519948
291730,202205,915,530,385,642364.74,467833.62,1110198.36
291733,202205,296,198,98,239976.2,118776,358752.2
291735,202205,83,62,21,76356.45,25452,101808.45
291740,202205,336,252,84,305424.2,101808,407232.2
291750,202205,2283,1475,808,1787722.23,979305.86,2767028.09
291760,202205,3039,1662,1377,2015556.99,1671348,3686904.99
291770,202205,729,495,234,599945.57,283610.1,883555.67
291780,202205,76,47,29,56964,35148,92112
291790,202205,156,81,75,98172,90900,189072
291800,202205,10248,4313,5935,5228601.26,7198081.86,12426683.12
291810,202205,1055,793,262,961120.11,317544.7,1278664.81
291820,202205,286,203,83,246036,100596,346632
291830,202205,1031,427,604,517526.14,732050.22,1249576.36
291835,202205,556,515,41,624181.01,49692,673873.01
291840,202205,5056,2535,2521,3074875.14,3056685.91,6131561.05
291845,202205,272,86,186,104232,225432,329664
291850,202205,315,279,36,338150.86,43632.4,381783.26
291855,202205,262,113,149,136956,180588,317544
291860,202205,164,106,58,128472,70296.9,198768.9
291870,202205,81,36,45,43632,54540,98172
291875,202205,158,148,10,179376.65,12120,191496.65
291880,202205,428,353,75,427836.6,90900.2,518736.8
291890,202205,245,87,158,105444.1,191496.6,296940.7
291900,202205,55,33,22,39996,26664,66660
291905,202205,115,88,27,106656.4,32724,139380.4
291910,202205,155,124,31,150288,37572,187860
291915,202205,434,386,48,469044.52,58176.56,527221.08
291920,202205,5392,2639,2753,3200917.13,3340287.65,6541204.78
291930,202205,167,101,66,122412.36,79992,202404.36
291940,202205,372,216,156,261792.2,189072,450864.2
291950,202205,1146,909,237,1101709.6,287244,1388953.6
291955,202205,1368,826,542,1001112.5,658116.36,1659228.86
291960,202205,192,144,48,174528.2,58176,232704.2
291970,202205,758,562,196,681146.23,237552,918698.23
291980,202205,1433,1255,178,1522277.66,215736.8,1738014.46
291990,202205,137,126,11,152712.48,13332,166044.48
291992,202205,182,89,93,107869.3,112717.78,220587.08
291995,202205,184,115,69,139381.36,83628,223009.36
292000,202205,410,302,108,366025.99,130896,496921.99
292010,202205,324,222,102,270276.2,123624.13,393900.33
292020,202205,292,216,76,261792,92112,353904
292030,202205,146,112,34,135744,41208,176952
292040,202205,580,304,276,368448,334512,702960
292045,202205,119,106,13,128472,15756,144228
292050,202205,928,674,254,816889.82,307849.08,1124738.90
292060,202205,894,726,168,879922.37,203617.11,1083539.48
292070,202205,60,23,37,27876,44844,72720
292080,202205,153,107,46,129684,55752,185436
292090,202205,538,191,347,231492.47,420564.2,652056.67
292100,202205,1488,637,851,773260.95,1031415.49,1804676.44
292105,202205,169,151,18,183012,21816,204828
292110,202205,2269,841,1428,1019294.5,1730737.84,2750032.34
292120,202205,693,532,161,644790.21,195132.72,839922.93
292130,202205,466,259,207,315120.8,250884,566004.8
292140,202205,209,167,42,202405.03,50904.2,253309.23
292145,202205,164,86,78,104232,94536,198768
292150,202205,1492,1237,255,1499248.19,309061.72,1808309.91
292160,202205,164,128,36,155136.8,43632.2,198769.0
292170,202205,1168,1000,168,1213221.27,204828.2,1418049.47
292180,202205,224,163,61,197556,73932,271488
292190,202205,151,96,55,116352,66660,183012
292200,202205,1422,522,900,632665.3,1093225.76,1725891.06
292205,202205,113,96,17,116352,20604,136956
292210,202205,388,262,126,317544.72,152712.85,470257.57
292220,202205,34,22,12,26664,14544,41208
292225,202205,46,38,8,46056,9696,55752
292230,202205,991,750,241,909008.99,292092.2,1201101.19
292240,202205,626,456,170,552673.27,206040.2,758713.47
292250,202205,1656,1075,581,1304119.89,704172.68,2008292.57
292260,202205,402,242,160,293304.2,193920.4,487224.6
292265,202205,245,183,62,221796.3,75144.2,296940.5
292270,202205,723,352,371,426624.65,449652,876276.65
292273,202205,210,122,88,147864,106656.2,254520.2
292275,202205,169,87,82,105444,99384,204828
292280,202205,146,101,45,122412,54540,176952
292285,202205,88,69,19,83628,23028,106656
292290,202205,582,391,191,473894.34,231493.52,705387.86
292300,202205,1779,679,1100,822949.48,1333202.58,2156152.06
292303,202205,126,83,43,100596,52116,152712
292305,202205,117,85,32,103020,38784,141804
292310,202205,971,633,338,767198.78,409656.94,1176855.72
292320,202205,581,432,149,523585.24,180588,704173.24
292330,202205,175,108,67,130896.2,81204,212100.2
292335,202205,296,237,59,287244.1,71508,358752.1
292340,202205,549,379,170,460561.26,206040,666601.26
292350,202205,270,146,124,176952.2,150288,327240.2
292360,202205,718,543,175,658118.17,212100,870218.17
292370,202205,720,548,172,664176.89,208464,872640.89
292380,202205,615,507,108,614485.3,130896,745381.3
292390,202205,392,157,235,190284.15,284820,475104.15
292400,202205,3608,2225,1383,2697934.54,1676200.7,4374135.24
292405,202205,272,183,89,221796,107868,329664
292410,202205,115,69,46,83628,55752,139380
292420,202205,280,240,40,290880.72,48480,339360.72
292430,202205,538,392,146,476316.54,176952,653268.54
292440,202205,631,526,105,637513.73,127260,764773.73
292450,202205,230,175,55,212100.2,66660,278760.2
292460,202205,513,383,130,464197.32,157560,621757.32
292465,202205,203,173,30,209676,36360.65,246036.65
292467,202205,153,101,52,122412,63024,185436
292470,202205,316,215,101,260581.46,122412,382993.46
292480,202205,392,268,124,324820.62,150289.22,475109.84
292490,202205,237,175,62,212100.2,75144.4,287244.6
292500,202205,874,399,475,484803.18,575701.2,1060504.38
292510,202205,3580,1708,1872,2072526.71,2268867.16,4341393.87
292520,202205,1123,521,602,631454.02,729627.78,1361081.80
292525,202205,418,306,112,370877.37,135745.39,506622.76
292530,202205,4795,1926,2869,2337958.04,3477237.33,5815195.37
292540,202205,484,279,205,340572.1,248460.65,589032.75
292550,202205,1124,611,513,740535.03,622968.5,1363503.53
292560,202205,327,299,28,362391.32,33936,396327.32
292570,202205,321,250,71,303000.23,86052,389052.23
292575,202205,547,389,158,472684.55,191496.2,664180.75
292580,202205,1006,675,331,818100.4,401172.6,1219273.0
292590,202205,551,491,60,595092.91,72720,667812.91
292593,202205,147,116,31,140592,37572,178164
292595,202205,198,157,41,190284,49692,239976
292600,202205,1240,888,352,1076260.81,426626.47,1502887.28
292610,202205,117,94,23,113929.04,27877.24,141806.28
292620,202205,522,441,81,534497.25,98173.1,632670.35
292630,202205,1509,832,677,1008388.13,821736.85,1830124.98
292640,202205,869,599,270,725992.01,327240.4,1053232.41
292650,202205,183,143,40,173318.73,48480,221798.73
292660,202205,1920,1355,565,1642274.8,684787.04,2327061.84
292665,202205,138,98,40,118776,48480,167256
292670,202205,390,303,87,367236,105444,472680
292680,202205,264,195,69,236340,83628,319968
292690,202205,203,143,60,173316.6,72720.2,246036.8
292700,202205,996,653,343,791439.92,415717.16,1207157.08
292710,202205,114,100,14,121200,16968,138168
292720,202205,973,558,415,677509.5,502980.7,1180490.2
292730,202205,202,94,108,113928,130896,244824
292740,202205,72190,34751,37439,42148867.21,45421129.31,87569996.52
292750,202205,380,277,103,335724.85,124836.5,460561.35
292760,202205,338,282,56,341785.05,67872.1,409657.15
292770,202205,859,368,491,446016,596305.11,1042321.11
292780,202205,19,10,9,12120,10908,23028
292790,202205,775,407,368,494496.89,446016,940512.89
292800,202205,1256,752,504,911426.56,610849.22,1522275.78
292805,202205,382,133,249,161196.4,301788.2,462984.6
292810,202205,1804,1072,732,1300482.79,887184.92,2187667.71
292820,202205,695,589,106,713871.58,128473.73,842345.31
292830,202205,129,101,28,122412.3,33936.1,156348.4
292840,202205,687,564,123,684782.92,149076.2,833859.12
292850,202205,139,92,47,111504.2,56964.34,168468.54
292860,202205,2075,1187,888,1438650.51,1076263.13,2514913.64
292870,202205,3651,2389,1262,2895480.58,1531971.47,4427452.05
292880,202205,1415,936,479,1136858.05,581761.04,1718619.09
292890,202205,528,439,89,532070.45,107868.4,639938.85
292895,202205,145,98,47,118776,56964,175740
292900,202205,331,236,95,286033.31,115140.5,401173.81
292905,202205,485,232,253,281185.52,306636,587821.52
292910,202205,479,355,124,430261.49,150288.3,580549.79
292920,202205,517,220,297,266641.72,359964.92,626606.64
292925,202205,472,433,39,527220.85,47268,574488.85
292930,202205,675,406,269,492073.1,326028.17,818101.27
292935,202205,271,116,155,140592.35,187860,328452.35
292937,202205,221,154,67,186648,81204,267852
292940,202205,185,141,44,170892,53328,224220
292950,202205,1234,593,641,718722.86,776894.42,1495617.28
292960,202205,510,363,147,439959.17,178164.9,618124.07
292970,202205,234,170,64,206041.46,77568.5,283609.96
292975,202205,89,51,38,61812.47,46056.6,107869.07
292980,202205,331,228,103,276336.1,126048,402384.1
292990,202205,1315,975,340,1181701.6,412080.2,1593781.8
293000,202205,108,78,30,94536,36360.1,130896.1
293010,202205,2944,1738,1206,2106483.72,1461687.02,3568170.74
293015,202205,610,501,109,607212.91,132108,739320.91
293020,202205,318,255,63,310275.03,77568.96,387843.99
293030,202205,571,505,66,612061.5,81204,693265.5
293040,202205,371,297,74,359964,89688,449652
293050,202205,2927,1720,1207,2085858.32,1464107.22,3549965.54
293060,202205,248,195,53,236344.19,64236.99,300581.18
293070,202205,3677,1866,1811,2264032,2198575.74,4462607.74
293075,202205,96,66,30,79992,36360,116352
293076,202205,76,56,20,67872,24240,92112
293077,202205,576,329,247,398750.98,300576.24,699327.22
293080,202205,429,381,48,461774.74,58176.66,519951.40
293090,202205,131,117,14,141804,16968,158772
293100,202205,515,353,162,427837.69,196344.17,624181.86
293105,202205,351,255,96,309060,116352,425412
293110,202205,119,79,40,95748.4,48482.98,144231.38
293120,202205,299,209,90,253309.67,109080.2,362389.87
293130,202205,245,163,82,197558.2,99384,296942.2
293135,202205,8303,3271,5032,3964474.61,6101215.57,10065690.18
293140,202205,186,114,72,138168.67,87264,225432.67
293150,202205,307,268,39,324818.12,47268,372086.12
293160,202205,423,259,164,313908.6,198768.2,512676.8
293170,202205,209,131,78,158773.3,94536,253309.3
293180,202205,578,388,190,470257.23,230280,700537.23
293190,202205,1365,946,419,1146558.6,507832.74,1654391.34
293200,202205,545,481,64,582974.4,77568.2,660542.6
293210,202205,419,321,98,389053.11,118776,507829.11
293220,202205,2368,1031,1337,1249575.36,1622868.7,2872444.06
293230,202205,1829,685,1144,831434.35,1387740.6,2219174.95
293240,202205,228,210,18,254520.94,21816,276336.94
293245,202205,129,106,23,128472.82,27876,156348.82
293250,202205,772,317,455,384206.78,551461.34,935668.12
293260,202205,304,249,55,301788,66660,368448
293270,202205,1174,534,640,648421.72,775680,1424101.72
293280,202205,300,180,120,218160.72,145440.96,363601.68
293290,202205,3027,1960,1067,2375529.97,1294417.72,3669947.69
293300,202205,806,566,240,685993.85,290880.36,976874.21
293305,202205,190,147,43,178164,52116,230280
293310,202205,170,127,43,153925.37,52116.2,206041.57
293315,202205,163,126,37,152712.4,44844,197556.4
293317,202205,90,67,23,81204.08,27876,109080.08
293320,202205,1096,588,508,712669.25,616913.75,1329583.00
293325,202205,204,76,128,92112,155136.07,247248.07
293330,202205,14275,6516,7759,7899858.41,9406358.51,17306216.92
293340,202205,286,203,83,246036,100596,346632
293345,202205,260,211,49,255733.02,59388,315121.02
293350,202205,589,364,225,441169.56,272700,713869.56
293360,202205,1494,1067,427,1293209.25,518736.88,1811946.13
310010,202205,145,75,70,90900,84840,175740
310020,202205,1007,547,460,662966.43,557520.8,1220487.23
310030,202205,308,246,62,298152.69,75145.17,373297.86
310040,202205,46,30,16,36360,19392,55752
310050,202205,155,99,56,119988,67872,187860
310060,202205,267,182,85,220585.27,103020.4,323605.67
310070,202205,16,9,7,10908,8484,19392
310080,202205,49,34,15,41208,18180,59388
310090,202205,1057,575,482,696905.35,584184.95,1281090.30
310100,202205,327,233,94,282396.84,113928,396324.84
310110,202205,691,365,326,442381.12,395112,837493.12
310120,202205,378,222,156,269064,190284,459348
310130,202205,28,16,12,19392,14544,33936
310140,202205,24,8,16,9696,19392,29088
310150,202205,1153,774,379,938094.64,459350.96,1397445.60
310160,202205,2050,1015,1035,1231396.61,1254421.63,2485818.24
310163,202205,92,51,41,61812,49692,111504
310170,202205,2497,1146,1351,1388956.54,1637417.04,3026373.58
310180,202205,164,68,96,82416,116352,198768
310190,202205,480,320,160,387841.05,193920,581761.05
310200,202205,438,277,161,335724,195132,530856
310205,202205,68,45,23,54540,27876,82416
310210,202205,267,220,47,266640,56964,323604
310220,202205,61,36,25,43632,30300,73932
310230,202205,271,194,77,235128.2,93324,328452.2
310240,202205,114,95,19,115140,23028,138168
310250,202205,96,76,20,92113.74,24240,116353.74
310260,202205,715,376,339,455714.61,413293.35,869007.96
310270,202205,269,176,93,213312.75,112716.2,326028.95
310280,202205,378,269,109,326028.4,132108,458136.4
310285,202205,198,150,48,181800.2,58176,239976.2
310290,202205,222,123,99,149076,121200,270276
310300,202205,168,134,34,162408,41208.66,203616.66
310310,202205,11,8,3,9696,3636,13332
310320,202205,28,9,19,10908.17,23028,33936.17
310330,202205,39,27,12,32724.88,14544,47268.88
310340,202205,1765,1223,542,1483494.66,656905.78,2140400.44
310350,202205,2745,1437,1308,1741663.12,1586509.28,3328172.40
310360,202205,48,40,8,48480,9696,58176
310370,202205,124,105,19,128472,23028,151500
310375,202205,109,42,67,50904,81204,132108
310380,202205,52,31,21,37572,25452,63024
310390,202205,108,69,39,83628,47268,130896
310400,202205,2433,1568,865,1901645.81,1050806.01,2952451.82
310410,202205,118,68,50,82416.2,60600,143016.2
310420,202205,670,344,326,416929.39,395113.96,812043.35
310430,202205,280,176,104,213312,126048,339360
310440,202205,71,43,28,52116,33936,86052
310445,202205,80,68,12,82416.16,14544,96960.16
310450,202205,639,418,221,506617.95,269064.2,775682.15
310460,202205,247,172,75,208464.24,90900,299364.24
310470,202205,516,334,182,406021.38,220585.42,626606.80
310480,202205,92,57,35,69084,42420,111504
310490,202205,545,253,292,306638.8,353904.66,660543.46
310500,202205,127,51,76,61812.1,92112,153924.1
310510,202205,605,428,177,519949.81,214524.95,734474.76
310520,202205,141,101,40,122412,48480,170892
310530,202205,110,44,66,53328,79992,133320
310540,202205,479,272,207,329664.71,250884,580548.71
310550,202205,71,48,23,58176.22,27876,86052.22
310560,202205,3078,2103,975,2551271.25,1181700,3732971.25
310570,202205,101,61,40,73932,48480,122412
310590,202205,378,233,145,282396.71,175740,458136.71
310600,202205,135,66,69,81204,83628,164832
310610,202205,52,22,30,26664,36360,63024
310620,202205,47903,22496,25407,27289467.7,30829718.16,58119185.86
310630,202205,698,414,284,501770.38,345420.2,847190.58
310640,202205,139,96,43,116352,52116,168468
310650,202205,150,133,17,161196,20604,181800
310660,202205,108,75,33,90900,39996,130896
310665,202205,65,46,19,55752,23028,78780
310670,202205,7033,2992,4041,3627555.22,4900122.41,8527677.63
310680,202205,68,40,28,48480,33936,82416
310690,202205,617,430,187,521160.93,226644.2,747805.13
310700,202205,62,39,23,47268,27876,75144
310710,202205,1269,853,416,1034182.9,504192.7,1538375.6
310720,202205,147,40,107,48480,129684,178164
310730,202205,1498,1021,477,1237463.27,578127.94,1815591.21
310740,202205,1001,549,452,665391.07,547825.9,1213216.97
310750,202205,251,155,96,187860.04,116352,304212.04
310760,202205,67,53,14,64236.8,16968,81204.8
310770,202205,85,41,44,49692,53328,103020
310780,202205,357,291,66,352694.37,79992.6,432686.97
310790,202205,109,86,23,104232,27876,132108
310800,202205,475,221,254,267852,307848,575700
310810,202205,172,115,57,139380.92,69085.29,208466.21
310820,202205,312,248,64,300578.02,77568,378146.02
310825,202205,209,176,33,213312,39996,253308
310830,202205,451,212,239,256944.2,289668,546612.2
310840,202205,355,210,145,255732.2,175740.36,431472.56
310850,202205,75,62,13,75144.65,15756,90900.65
310855,202205,407,319,88,386628.3,106656,493284.3
310860,202205,1601,1179,422,1428959.13,511466.06,1940425.19
310870,202205,51,43,8,52116,9696,61812
310880,202205,83,68,15,82416,18180,100596
310890,202205,291,168,123,203616,149076,352692
310900,202205,616,274,342,332093.74,414513.36,746607.10
310910,202205,241,165,76,199982,92112,292094
310920,202205,432,251,181,304214.29,219374.19,523588.48
310925,202205,36,28,8,33936,9696,43632
310930,202205,1291,847,444,1026568.81,538129.4,1564698.21
310940,202205,675,341,334,413293.52,404809.4,818102.92
310945,202205,130,81,49,98172,59388,157560
310950,202205,218,174,44,210888,53328,264216
310960,202205,77,24,53,29088,64236.2,93324.2
310970,202205,165,96,69,116352.6,83628.6,199981.2
310980,202205,46,31,15,37573.09,18180,55753.09
310990,202205,163,85,78,103020,94536,197556
311000,202205,822,404,418,489649.96,506618.57,996268.53
311010,202205,47,38,9,46056,10908,56964
311020,202205,39,24,15,29088.55,18180,47268.55
311030,202205,389,221,168,267854.27,203616,471470.27
311040,202205,44,35,9,42420,10908,53328
311050,202205,491,188,303,227856.69,368448,596304.69
311060,202205,794,440,354,533281.03,429048.2,962329.23
311070,202205,326,144,182,174528,220584,395112
311080,202205,110,63,47,76356.1,56964,133320.1
311090,202205,341,163,178,198768.58,216948,415716.58
311100,202205,553,331,222,401173.2,269064,670237.2
311110,202205,710,509,201,616910,243612.7,860522.7
311115,202205,77,52,25,63024,30300.1,93324.1
311120,202205,1078,578,500,701752.21,606001.97,1307754.18
311130,202205,292,170,122,206040.68,149076.35,355117.03
311140,202205,163,85,78,103020,94536.69,197556.69
311150,202205,336,211,125,255732.1,151500.6,407232.7
311160,202205,752,530,222,643574.65,269064,912638.65
311170,202205,90,75,15,90900,18180,109080
311180,202205,310,209,101,253309.68,122412.68,375722.36
311190,202205,35,17,18,20604,21816,42420
311200,202205,341,232,109,281184.1,132108.2,413292.3
311205,202205,33,25,8,30300,9696,39996
311210,202205,36,31,5,37572.6,6060,43632.6
311220,202205,31,27,4,32724,4848,37572
311230,202205,1649,1082,567,1312609.32,688416.5,2001025.82
311240,202205,207,128,79,155136,95748,250884
311250,202205,61,23,38,27876,46056,73932
311260,202205,548,342,206,414506.98,249672,664178.98
311265,202205,121,81,40,98172,48480,146652
311270,202205,283,196,87,238764.45,105444.44,344208.89
311280,202205,200,86,114,104232,138168,242400
311290,202205,101,84,17,101808,20604,122412
311300,202205,579,367,212,444805,256945.1,701750.1
311310,202205,18,15,3,18180,3636,21816
311320,202205,621,462,159,559945.91,192708,752653.91
311330,202205,1126,827,299,1002326.5,362389.17,1364715.67
311340,202205,2604,1840,764,2230091.27,928392.58,3158483.85
311350,202205,267,207,60,250884.2,72720,323604.2
311360,202205,180,107,73,129684,88476,218160
311370,202205,1230,510,720,619337.41,873853.17,1493190.58
311380,202205,7,6,1,7272,1212,8484
311390,202205,246,141,105,170892,127260,298152
311400,202205,139,85,54,103020,65448,168468
311410,202205,113,56,57,67872,70296,138168
311420,202205,314,159,155,192708.5,187860,380568.5
311430,202205,825,544,281,661752.32,341784.87,1003537.19
311440,202205,450,307,143,372090.33,173317.4,545407.73
311450,202205,308,181,127,219372,153924,373296
311455,202205,267,183,84,221796.77,101808.57,323605.34
311460,202205,132,58,74,70296,89688,159984
311470,202205,29,14,15,16968,18180,35148
311480,202205,51,25,26,30300,31512,61812
311490,202205,10,6,4,7272,4848,12120
311500,202205,30,14,16,16968.2,19392,36360.2
311510,202205,656,448,208,545405.94,252096,797501.94
311520,202205,39,32,7,38784,8484,47268
311530,202205,1774,1278,496,1551377.86,601152.83,2152530.69
311535,202205,62,41,21,49692,25452,75144
311540,202205,34,30,4,36360,4848,41208
311545,202205,162,115,47,139380.2,56964,196344.2
311547,202205,46,35,11,42420,13332,55752
311550,202205,643,289,354,351481.01,429048.75,780529.76
311560,202205,44,26,18,31512,21816,53328
311570,202205,287,193,94,233916.73,113928.4,347845.13
311580,202205,409,253,156,307849.05,189072,496921.05
311590,202205,28,24,4,29088,4848,33936
311600,202205,96,80,16,96960.14,19392,116352.14
311610,202205,245,210,35,254520.6,42420,296940.6
311615,202205,131,108,23,130896,27876.72,158772.72
311620,202205,28,16,12,19392,14544,33936
311630,202205,101,86,15,104232,18180,122412
311640,202205,136,64,72,77568.88,88476.4,166045.28
311650,202205,124,87,37,105444,44844.74,150288.74
311660,202205,426,195,231,237552,279972.2,517524.2
311670,202205,144,99,45,119989.4,54540,174529.4
311680,202205,208,158,50,191496,60600.26,252096.26
311690,202205,13,10,3,12120,3636,15756
311700,202205,191,139,52,168468.49,63024,231492.49
311710,202205,180,121,59,146652.6,71508,218160.6
311720,202205,38,28,10,33936.6,12120,46056.6
311730,202205,560,389,171,471472.07,207252.1,678724.17
311740,202205,26,18,8,21816,9696,31512
311750,202205,721,492,229,596305.5,277548,873853.5
311760,202205,78,33,45,39996,54540,94536
311770,202205,381,179,202,216948.7,244824,461772.7
311780,202205,192,96,96,116352,116352,232704
311783,202205,88,82,6,99384,7272,106656
311787,202205,39,14,25,16968,30300,47268
311790,202205,260,114,146,138168,176952.6,315120.6
311800,202205,710,436,274,528434.12,333300,861734.12
311810,202205,51,39,12,47268,14544,61812
311820,202205,119,92,27,111504,32724.3,144228.3
311830,202205,1903,1147,756,1391382.85,917484.41,2308867.26
311840,202205,1033,580,453,704176.68,550252.16,1254428.84
311850,202205,15,11,4,13332,4848,18180
311860,202205,9782,4142,5640,5023767.58,6845396.94,11869164.52
311870,202205,108,62,46,76356.41,56964,133320.41
311880,202205,957,692,265,838706.11,321184.96,1159891.07
311890,202205,198,93,105,112616,127260,239876
311900,202205,65,27,38,32724,46056,78780
311910,202205,1385,860,525,1042324.32,637513.2,1679837.52
311920,202205,223,151,72,183012.1,87264,270276.1
311930,202205,899,507,392,614484.57,475104.74,1089589.31
311940,202205,2604,1387,1217,1681056.06,1478640.99,3159697.05
311950,202205,164,99,65,119988.72,78780.93,198769.65
311960,202205,64,45,19,54540.5,23028,77568.5
311970,202205,23,12,11,14544,13332,27876
311980,202205,41,30,11,36360,13332,49692
311990,202205,37,26,11,31512,13332,44844
311995,202205,49,28,21,33936,25452,59388
312000,202205,23,14,9,16968,10908,27876
312010,202205,73,55,18,66660,21816.52,88476.52
312015,202205,78,60,18,72720,21816,94536
312020,202205,135,96,39,116352,47268,163620
312030,202205,69,52,17,63024,20604,83628
312040,202205,78,49,29,59388,35148,94536
312050,202205,194,110,84,134532.6,101808,236340.6
312060,202205,23,14,9,16968,10908,27876
312070,202205,80,52,28,63024.2,33936,96960.2
312080,202205,551,249,302,301788,366024.3,667812.3
312083,202205,62,39,23,47268.2,27876,75144.2
312087,202205,95,72,23,87264,29088,116352
312090,202205,3339,2031,1308,2464025.13,1587725.18,4051750.31
312100,202205,146,103,43,124558.16,52116.48,176674.64
312110,202205,114,70,44,84840,53328,138168
312120,202205,127,91,36,110293.15,43632,153925.15
312125,202205,85,53,32,64236.13,38784,103020.13
312130,202205,130,86,44,104232,53328,157560
312140,202205,138,107,31,129684.6,37572,167256.6
312150,202205,38,30,8,37572,10908,48480
312160,202205,1488,988,500,1198782.83,609636.3,1808419.13
312170,202205,11,8,3,9696,3636,13332
312180,202205,100,66,34,79992,41208,121200
312190,202205,36,32,4,38784,4848,43632
312200,202205,737,634,103,769626.15,124836.84,894462.99
312210,202205,118,61,57,73932,69084.2,143016.2
312220,202205,132,100,32,121200.2,38784,159984.2
312230,202205,3860,1734,2126,2102832.51,2576715.9,4679548.41
312235,202205,154,104,50,126048,60600,186648
312240,202205,79,56,23,67872.99,27876,95748.99
312245,202205,204,143,61,173316.2,75144,248460.2
312247,202205,83,60,23,72720,27876,100596
312250,202205,173,89,84,107868.6,101808,209676.6
312260,202205,100,65,35,78780,42420,121200
312270,202205,135,81,54,98172,65448,163620
312280,202205,33,17,16,20604,19392,39996
312290,202205,143,96,47,116352.2,56964.9,173317.1
312300,202205,205,135,70,163620.44,84840.1,248460.54
312310,202205,58,50,8,60600,9696,70296
312320,202205,415,256,159,311484.08,192708,504192.08
312330,202205,87,74,13,89688,15756,105444
312340,202205,36,17,19,20604,23028,43632
312350,202205,14,8,6,9696,7272,16968
312352,202205,97,69,28,83628.6,33936,117564.6
312360,202205,567,243,324,294516.75,392688,687204.75
312370,202205,336,185,151,224220.5,183012.09,407232.59
312380,202205,141,94,47,113930.29,56964,170894.29
312385,202205,157,130,27,157560.68,32724,190284.68
312390,202205,291,186,105,225432,127260.6,352692.6
312400,202205,373,278,95,336936,115141.79,452077.79
312410,202205,1136,390,746,472684.25,904154.02,1376838.27
312420,202205,654,493,161,597518.5,195132,792650.5
312430,202205,870,627,243,759925.4,295728.3,1055653.7
312440,202205,39,31,8,37572,9696,47268
312450,202205,190,122,68,149076,82416,231492
312460,202205,28,13,15,15756,18180,33936
312470,202205,46,31,15,37572,18180,55752
312480,202205,166,101,65,122412.1,78780,201192.1
312490,202205,298,204,94,247249.55,113928.2,361177.75
312500,202205,35,24,11,29088,13332,42420
312510,202205,593,226,367,273915.22,447229.79,721145.01
312520,202205,28,8,20,9696,24240,33936
312530,202205,35,25,10,30300.6,12120.1,42420.7
312540,202205,86,77,9,93324,10908,104232
312550,202205,35,28,7,33936,8484,42420
312560,202205,193,152,41,184224.42,49692,233916.42
312570,202205,452,269,183,326028.5,221796.9,547825.4
312580,202205,92,49,43,59388,52116,111504
312590,202205,225,179,46,216948.19,55752,272700.19
312595,202205,128,106,22,129684,26664,156348
312600,202205,75,32,43,38784.4,52116,90900.4
312610,202205,1553,791,762,958701.19,924756.66,1883457.85
312620,202205,223,161,62,195132.58,75144,270276.58
312630,202205,68,55,13,67872,15756,83628
312640,202205,39,10,29,12120,35148,47268
312650,202205,148,124,24,150697.94,29088,179785.94
312660,202205,104,74,30,89689.93,36360.2,126050.13
312670,202205,909,584,325,707810.96,393900.83,1101711.79
312675,202205,42,31,11,37572,13332,50904
312680,202205,69,43,26,52116,31512,83628
312690,202205,234,119,115,144229.19,139380,283609.19
312695,202205,28,24,4,29088,4848,33936
312700,202205,241,141,100,170893.44,121200,292093.44
312705,202205,81,65,16,78780,19392,98172
312707,202205,132,93,39,113928.49,47268,161196.49
312710,202205,1868,1037,831,1258064.36,1009597.22,2267661.58
312720,202205,48,23,25,27876,30300,58176
312730,202205,268,158,110,191496.05,133321.14,324817.19
312733,202205,47,36,11,43632,13332,56964
312735,202205,20,15,5,18180,6060,24240
312737,202205,73,40,33,48480,39996,88476
312738,202205,65,41,24,49692.48,29088,78780.48
312740,202205,80,54,26,65448,31512,96960
312750,202205,99,67,32,81204,38784,119988
312760,202205,278,192,86,232704,104232.59,336936.59
312770,202205,8633,4048,4585,4909839.59,5563086.4,10472925.99
312780,202205,439,334,105,404808.1,127261.54,532069.64
312790,202205,20,15,5,18180,6060,24240
312800,202205,1603,1113,490,1350172.18,593881.58,1944053.76
312810,202205,341,233,108,282396.78,130896,413292.78
312820,202205,185,140,45,169680,54540,224220
312825,202205,38,27,11,32724,13332,46056
312830,202205,200,112,88,135744.71,106656.3,242401.01
312840,202205,188,129,59,156348,71508,227856
312850,202205,40,37,3,44844,3636,48480
312860,202205,141,94,47,113928,56964,170892
312870,202205,1121,579,542,701755.34,656904,1358659.34
312880,202205,117,84,33,101808.81,39996,141804.81
312890,202205,164,117,47,141804.66,56964,198768.66
312900,202205,173,128,45,155136,54540,209676
312910,202205,177,102,75,123624.58,90900,214524.58
312920,202205,128,71,57,86052,69084,155136
312930,202205,322,222,100,269064,121200.9,390264.9
312940,202205,132,93,39,112716,47268,159984
312950,202205,718,493,225,597520.14,272701.13,870221.27
312960,202205,149,109,40,132109.52,48480,180589.52
312965,202205,107,85,22,103020,26664,129684
312970,202205,275,223,52,270276.75,63024,333300.75
312980,202205,2570,1310,1260,1588945.84,1527121.59,3116067.43
312990,202205,50,22,28,26664.1,33936,60600.1
313000,202205,53,30,23,36360,27876,64236
313005,202205,176,136,40,164832.2,48480,213312.2
313010,202205,946,397,549,481165.22,665389.68,1146554.90
313020,202205,193,101,92,122412,111504,233916
313030,202205,199,130,69,157560.76,83628,241188.76
313040,202205,88,26,62,32724,75144,107868
313050,202205,200,144,56,175740,67872,243612
313055,202205,40,31,9,38784,12120,50904
313060,202205,135,91,44,110292,53328.65,163620.65
313065,202205,60,45,15,54540,18180.6,72720.6
313070,202205,127,66,61,79992.89,73932,153924.89
313080,202205,40,20,20,24240.6,24240,48480.6
313090,202205,668,434,234,526009.58,284820.8,810830.38
313100,202205,204,74,130,89688,157560,247248
313110,202205,149,82,67,99384,81204.6,180588.6
313115,202205,221,119,102,144228,123624,267852
313120,202205,849,481,368,584185.34,446016.8,1030202.14
313130,202205,5912,3231,2681,3918423.48,3254226.52,7172650.00
313140,202205,129,74,55,89688,66660,156348
313150,202205,294,233,61,282397.03,73932,356329.03
313160,202205,188,143,45,173320.07,54540,227860.07
313170,202205,1371,890,481,1078685.56,584185.59,1662871.15
313180,202205,321,193,128,235130.2,155136.8,390267.0
313190,202205,729,425,304,515102.37,368448.88,883551.25
313200,202205,32,25,7,30300,8484,38784
313210,202205,1002,858,144,1039903.74,174530.28,1214434.02
313220,202205,306,177,129,214524.2,157560,372084.2
313230,202205,265,202,63,246036.2,76356,322392.2
313240,202205,2216,1107,1109,1342903.88,1346533.16,2689437.04
313250,202205,1241,937,304,1135649.23,368449.28,1504098.51
313260,202205,93,43,50,52116,60600,112716
313270,202205,1016,597,419,723567.02,507832.04,1231399.06
313280,202205,45,38,7,46056,8484,54540
313290,202205,220,178,42,215737.18,50904,266641.18
313300,202205,323,164,159,198768.2,192708,391476.2
313310,202205,242,108,134,130896,162408.8,293304.8
313320,202205,387,282,105,341785.55,127260,469045.55
313330,202205,1422,870,552,1054446.1,669025.22,1723471.32
313340,202205,329,238,91,289668.2,110292,399960.2
313350,202205,461,294,167,356328.77,202404,558732.77
313360,202205,180,83,97,100596,117564,218160
313370,202205,229,79,150,95748.95,181800,277548.95
313375,202205,311,181,130,219372.1,158772,378144.1
313380,202205,1338,711,627,861737.32,759925.1,1621662.42
313390,202205,53,49,4,59388,4848,64236
313400,202205,397,271,126,328455.28,152712.6,481167.88
313410,202205,37,18,19,21816.2,23028,44844.2
313420,202205,4627,2559,2068,3103969.42,2507632.7,5611602.12
313430,202205,127,62,65,75144,78780.6,153924.6
313440,202205,1358,959,399,1162324.79,484803.53,1647128.32
313450,202205,68,33,35,39996,43632,83628
313460,202205,376,161,215,195134.06,261792.48,456926.54
313470,202205,517,241,276,292094.62,334514.09,626608.71
313480,202205,156,115,41,139380.7,49692,189072.7
313490,202205,551,248,303,300577.04,367239.36,667816.40
313500,202205,29,15,14,18180,16968,35148
313505,202205,1058,816,242,988995.58,293304.44,1282300.02
313507,202205,94,64,30,77568.9,36360,113928.9
313510,202205,2845,1766,1079,2141742.66,1308964.32,3450706.98
313520,202205,3420,2663,757,3227591.98,917487.27,4145079.25
313530,202205,34,20,14,24240,16968,41208
313535,202205,83,69,14,83628.3,16968,100596.3
313540,202205,68,49,19,59388,23028,82416
313545,202205,111,95,16,115140.5,19392,134532.5
313550,202205,209,175,34,212100,41208.6,253308.6
313560,202205,344,161,183,195132.87,221797.46,416930.33
313570,202205,73,24,49,29088,59388,88476
313580,202205,1313,759,554,919911.42,671449.4,1591360.82
313590,202205,64,37,27,44844,32724,77568
313600,202205,667,401,266,486012.74,323604.63,809617.37
313610,202205,50,40,10,48480.99,12120,60600.99
313620,202205,1375,662,713,802353.2,864157.56,1666510.76
313630,202205,1618,1228,390,1488356.77,472681,1961037.77
313640,202205,117,72,45,87264,54540,141804
313650,202205,226,111,115,134532.2,139380,273912.2
313652,202205,24,24,0,29088,,29088.0
313655,202205,79,49,30,59388,36360,95748
313657,202205,49,44,5,53328,6060,59388
313660,202205,130,84,46,101809.21,55752,157561.21
313665,202205,684,312,372,378147.85,450865.96,829013.81
313670,202205,10495,7210,3285,8748290.08,3983852.56,12732142.64
313680,202205,45,33,12,39996,14544,54540
313690,202205,130,95,35,115140,42420,157560
313695,202205,75,57,18,69084.67,21816,90900.67
313700,202205,329,258,71,312696.98,86052.2,398749.18
313710,202205,126,93,33,112716.1,39996,152712.1
313720,202205,1181,537,644,652061.55,780529.8,1432591.35
313730,202205,69,40,29,48480,35148,83628
313740,202205,143,111,32,134532.43,38784,173316.43
313750,202205,408,288,120,349057.15,145440,494497.15
313753,202205,225,164,61,198768,73932,272700
313760,202205,1340,511,829,620545.55,1005961.96,1626507.51
313770,202205,408,281,127,340574.45,153925.22,494499.67
313780,202205,828,437,391,529648.69,473892.36,1003541.05
313790,202205,30,29,1,35148,1212,36360
313800,202205,158,97,61,117564.2,73933.95,191498.15
313810,202205,84,49,35,59388,42420,101808
313820,202205,1338,636,702,770834.77,852037.51,1622872.28
313830,202205,54,37,17,44844,20604,65448
313835,202205,61,52,9,63024.2,12120,75144.2
313840,202205,1656,991,665,1201098.52,807192,2008290.52
313850,202205,214,90,124,109080.24,150288,259368.24
313860,202205,471,359,112,435110.48,135744.64,570855.12
313862,202205,172,117,55,141805.24,66660,208465.24
313865,202205,160,109,51,132108,61812.1,193920.1
313867,202205,57,45,12,54540,14544,69084
313868,202205,42,26,16,31512,19392,50904
313870,202205,94,51,43,61812,52116,113928
313880,202205,384,239,145,289668,175740,465408
313890,202205,330,180,150,218160.59,181800,399960.59
313900,202205,816,436,380,528435.36,461773.21,990208.57
313910,202205,144,96,48,116352,58176,174528
313920,202205,626,429,197,521160.61,238765.02,759925.63
313925,202205,35,30,5,36360,6060,42420
313930,202205,875,675,200,818104.03,242400.4,1060504.43
313940,202205,1900,1153,747,1397439.03,905366.58,2302805.61
313950,202205,840,511,329,620546.57,399960,1020506.57
313960,202205,1443,827,616,1002327.5,747807.54,1750135.04
313970,202205,184,108,76,130896,92112,223008
313980,202205,225,147,78,178166.89,94537.61,272704.50
313990,202205,250,161,89,195132,107868,303000
314000,202205,855,564,291,684781.9,352692.16,1037474.06
314010,202205,88,49,39,59388.72,47268,106656.72
314015,202205,78,19,59,23028.71,71508,94536.71
314020,202205,59,40,19,48480.1,23028,71508.1
314030,202205,73,36,37,43632,44844,88476
314040,202205,44,23,21,27876,25452,53328
314050,202205,292,166,126,201192.71,152712,353904.71
314053,202205,97,59,38,71508.71,46056,117564.71
314055,202205,293,180,113,218160.98,136956,355116.98
314060,202205,121,104,17,127261.04,20604,147865.04
314070,202205,1071,528,543,639937.68,658117.38,1298055.06
314080,202205,214,135,79,163620.4,95748.84,259369.24
314085,202205,167,116,51,140592,61812,202404
314090,202205,381,269,112,326029.2,135744,461773.2
314100,202205,527,418,109,506616.81,132108.2,638725.01
314110,202205,759,345,414,419353.63,501768.83,921122.46
314120,202205,69,39,30,47268,36360,83628
314130,202205,24,16,8,19392,9696,29088
314140,202205,1118,696,422,845985.03,512677.25,1358662.28
314150,202205,185,121,64,146652.2,77568,224220.2
314160,202205,318,241,77,292093.57,93324,385417.57
314170,202205,82,63,19,76356.2,23028,99384.2
314180,202205,736,645,91,781744.37,110292,892036.37
314190,202205,88,55,33,66660,39996,106656
314200,202205,496,337,159,408448.36,192708.32,601156.68
314210,202205,255,194,61,235128.2,73932.6,309060.8
314220,202205,301,213,88,258157.65,106656.43,364814.08
314225,202205,54,35,19,42420.7,23028,65448.7
314230,202205,119,55,64,66660,77568,144228
314240,202205,170,122,48,147864,58176,206040
314250,202205,58,36,22,44844.63,26664,71508.63
314260,202205,221,108,113,130896,136956,267852
314270,202205,406,318,88,385418.48,106656,492074.48
314280,202205,734,399,335,483535.46,406020,889555.46
314290,202205,525,411,114,498132.27,138168.3,636300.57
314300,202205,338,256,82,310273.73,99384,409657.73
314310,202205,1340,920,420,1115355.81,509040,1624395.81
314315,202205,41,31,10,37572,12120,49692
314320,202205,592,397,195,481165.45,236340,717505.45
314330,202205,11450,5589,5861,6777579.5,7110818.76,13888398.26
314340,202205,623,281,342,340572.2,415718.41,756290.61
314345,202205,58,42,16,50904,19392,70296
314350,202205,175,109,66,132108,79992,212100
314360,202205,53,28,25,33937.5,30300,64237.5
314370,202205,70,49,21,59388,25452,84840
314380,202205,115,67,48,81204.5,58176,139380.5
314390,202205,3365,2176,1189,2638536.11,1441070,4079606.11
314400,202205,690,480,210,581763.72,254520.9,836284.62
314410,202205,500,325,175,393900.44,212101.66,606002.10
314420,202205,15,8,7,9696,8484,18180
314430,202205,2444,901,1543,1092017.77,1870121.44,2962139.21
314435,202205,170,100,70,121200,84840,206040
314437,202205,39,27,12,32724,14544,47268
314440,202205,95,63,32,76356,38784.1,115140.1
314450,202205,163,111,52,134532,63024.84,197556.84
314460,202205,623,300,323,363601.47,392689.1,756290.57
314465,202205,106,67,39,81204.1,47268,128472.1
314467,202205,73,59,14,71508,16968,88476
314470,202205,403,202,201,244825.28,243612.2,488437.48
314480,202205,1039,470,569,569643.1,690841.42,1260484.52
314490,202205,38,21,17,25452,20604,46056
314500,202205,281,194,87,236340.18,105444,341784.18
314505,202205,108,70,38,84840,46056,130896
314510,202205,249,204,45,247248.8,54540,301788.8
314520,202205,1406,733,673,890827.78,816893.13,1707720.91
314530,202205,748,591,157,716295.95,190284,906579.95
314535,202205,162,100,62,121200,75144,196344
314537,202205,65,39,26,47268,31512,78780
314540,202205,18,11,7,13332,8484,21816
314545,202205,57,39,18,47268,21816,69084
314550,202205,70,37,33,44844,39996.92,84840.92
314560,202205,865,459,406,556309.4,493284.86,1049594.26
314570,202205,16,13,3,15756,3636,19392
314580,202205,13,6,7,7272,8484,15756
314585,202205,26,19,7,23028,8484,31512
314587,202205,83,71,12,86052,14544,100596
314590,202205,564,386,178,467832.4,215736,683568.4
314600,202205,942,607,335,735689.95,406022.6,1141712.55
314610,202205,949,489,460,595092.7,557521.1,1152613.8
314620,202205,140,106,34,128472.2,41208,169680.2
314625,202205,96,71,25,86052,31512,117564
314630,202205,1126,607,519,736900,630240,1367140
314640,202205,88,55,33,66660.46,39996.6,106657.06
314650,202205,161,91,70,110292.32,84840,195132.32
314655,202205,59,44,15,53328,18180,71508
314660,202205,17,12,5,14544,6060,20604
314670,202205,213,165,48,199982.6,58176,258158.6
314675,202205,208,124,84,150289.66,101808,252097.66
314690,202205,590,316,274,382992.4,332088.8,715081.2
314700,202205,2191,1162,1029,1409564.81,1248360.54,2657925.35
314710,202205,1824,1015,809,1230183.65,980508,2210691.65
314720,202205,387,221,166,267852.6,201192.2,469044.8
314730,202205,511,274,237,332088.2,287244,619332.2
314740,202205,756,345,411,418141.6,500556.15,918697.75
314750,202205,21,16,5,19392,6060,25452
314760,202205,353,147,206,180588,249672.2,430260.2
314770,202205,102,68,34,82416,41208,123624
314780,202205,22,9,13,10908,15756,26664
314790,202205,2483,1562,921,1898007.08,1117464.44,3015471.52
314795,202205,56,50,6,60600,7272,67872
314800,202205,2926,1700,1226,2060412.03,1488336,3548748.03
314810,202205,1474,839,635,1018086.12,769621.3,1787707.42
314820,202205,110,66,44,79992.9,53328,133320.9
314830,202205,207,171,36,207252,43632,250884
314840,202205,84,47,37,56964,44844,101808
314850,202205,411,201,210,243612.5,254520,498132.5
314860,202205,647,496,151,601152.4,183012.6,784165.0
314870,202205,1589,827,762,1003538.46,923546.32,1927084.78
314875,202205,55,52,3,63024,3636,66660
314880,202205,40,29,11,35148,13332,48480
314890,202205,52,29,23,35148,27876,63024
314900,202205,27,21,6,25452,7272.92,32724.92
314910,202205,232,153,79,185436.14,95748,281184.14
314915,202205,130,115,15,139380.07,18180.18,157560.25
314920,202205,82,53,29,64236,35148,99384
314930,202205,1014,484,530,586616.52,642361.7,1228978.22
314940,202205,39,31,8,37572,9696.1,47268.1
314950,202205,22,19,3,23028,3636,26664
314960,202205,25,18,7,21816,8484,30300
314970,202205,170,80,90,96960.4,109080.2,206040.6
314980,202205,294,184,110,223008.2,133320.75,356328.95
314990,202205,451,240,211,290880.4,255732,546612.4
314995,202205,150,64,86,77568,104232,181800
315000,202205,88,70,18,86052.49,21816,107868.49
315010,202205,32,20,12,24240,14544,38784
315015,202205,157,124,33,150288.2,39996,190284.2
315020,202205,69,58,11,70296,13332,83628
315030,202205,106,80,26,96960,31512,128472
315040,202205,81,49,32,59388,38784,98172
315050,202205,207,127,80,153924.2,96960.32,250884.52
315053,202205,52,36,16,43632,19392,63024
315057,202205,120,94,26,113928,31512,145440
315060,202205,67,55,12,66660.88,14544,81204.88
315070,202205,102,59,43,71508,52116.9,123624.9
315080,202205,386,303,83,367236.5,100596.2,467832.7
315090,202205,94,54,40,65448,48480,113928
315100,202205,83,41,42,49692.44,50904,100596.44
315110,202205,272,138,134,167256,163620,330876
315120,202205,1803,864,939,1047175.08,1139284.46,2186459.54
315130,202205,330,235,95,284820.2,115140.08,399960.28
315140,202205,535,293,242,355116.23,293305.3,648421.53
315150,202205,982,463,519,561158.98,629029.38,1190188.36
315160,202205,190,95,95,116353.9,115140.63,231494.53
315170,202205,293,195,98,236340.6,118776,355116.6
315180,202205,3193,1347,1846,1633786.48,2240991.99,3874778.47
315190,202205,295,179,116,216948.8,140592,357540.8
315200,202205,1165,694,471,841132.76,570852.08,1411984.84
315210,202205,1646,959,687,1162317.85,833857.35,1996175.20
315213,202205,26,15,11,18180,13332,31512
315217,202205,198,157,41,190284,49692,239976
315220,202205,1590,1176,414,1425319.25,501770.35,1927089.60
315230,202205,176,134,42,162408.54,50904,213312.54
315240,202205,377,244,133,295728.4,161197,456925.4
315250,202205,2584,1230,1354,1490766.47,1642261.4,3133027.87
315260,202205,135,74,61,89688,73932,163620
315270,202205,134,94,40,113928,48480,162408
315280,202205,599,395,204,478745.94,247251.23,725997.17
315290,202205,186,116,70,140592,84840,225432
315300,202205,98,74,24,89688,29088,118776
315310,202205,80,72,8,87264,9696,96960
315320,202205,141,86,55,104232.4,66660,170892.4
315330,202205,60,48,12,58176,14544,72720
315340,202205,394,287,107,347844.77,130896.24,478741.01
315350,202205,153,97,56,117564,67872,185436
315360,202205,97,43,54,53328,65448,118776
315370,202205,56,34,22,41208,26664,67872
315380,202205,5,5,0,6060,,6060.0
315390,202205,60,19,41,23028,49693.43,72721.43
315400,202205,797,597,200,723568.46,242400,965968.46
315410,202205,312,181,131,219375.33,158774.3,378149.63
315415,202205,52,41,11,49692,14544,64236
315420,202205,190,140,50,169680.54,60600,230280.54
315430,202205,654,366,288,443592.8,349056,792648.8
315440,202205,88,59,29,71508,35148,106656
315445,202205,220,183,37,221796.4,44844,266640.4
315450,202205,176,129,47,156348,56964,213312
315460,202205,4421,2051,2370,2487038.73,2874870.62,5361909.35
315470,202205,43,17,26,20604,31512,52116
315480,202205,74,21,53,25452,64236.3,89688.3
315490,202205,701,435,266,527220.68,322392,849612.68
315500,202205,16,13,3,15756,3636,19392
315510,202205,139,98,41,118776,49692,168468
315520,202205,79,67,12,81204,14544,95748
315530,202205,42,23,19,27876,23028,50904
315540,202205,270,190,80,230280.4,96960.68,327241.08
315550,202205,177,143,34,173316.2,41208,214524.2
315560,202205,705,559,146,678721.67,178164,856885.67
315570,202205,308,150,158,181801.93,193920.4,375722.33
315580,202205,737,496,241,601152.2,292092.6,893244.8
315590,202205,189,99,90,119988.66,109080,229068.66
315600,202205,323,248,75,300576.6,90900,391476.6
315610,202205,102,49,53,59388,64236,123624
315620,202205,38,29,9,35148,10908,46056
315630,202205,126,88,38,106656,46056,152712
315640,202205,64,38,26,46056,31512,77568
315645,202205,49,31,18,37572,21816,59388
315650,202205,165,119,46,144228.1,55752,199980.1
315660,202205,449,201,248,243614.67,300577.09,544191.76
315670,202205,2382,1108,1274,1342902.94,1545302.16,2888205.10
315680,202205,783,565,218,684781.84,264216,948997.84
315690,202205,679,454,225,550248.95,272700,822948.95
315700,202205,1962,1026,936,1245944.39,1134437.45,2380381.84
315710,202205,355,112,243,135744,294516,430260
315720,202205,496,301,195,364812.32,236340.39,601152.71
315725,202205,187,149,38,180588.87,46056,226644.87
315727,202205,66,36,30,43632.2,36360.2,79992.4
315730,202205,50,45,5,54540,6060,60600
315733,202205,84,52,32,63024,38784,101808
315737,202205,49,37,12,44844,14544,59388
315740,202205,31,23,8,27876,9696,37572
315750,202205,154,112,42,135744,50904,186648
315760,202205,44,33,11,39996,13332,53328
315765,202205,126,73,53,88476.74,64236.46,152713.20
315770,202205,225,145,80,175740,96960,272700
315780,202205,3792,1877,1915,2276150.48,2320980.5,4597130.98
315790,202205,242,186,56,225432.17,67872,293304.17
315800,202205,306,201,105,243612.74,127260,370872.74
315810,202205,57,34,23,42420.84,29088,71508.84
315820,202205,738,540,198,654483.79,239977.82,894461.61
315830,202205,120,75,45,90900.1,54540,145440.1
315840,202205,77,52,25,63024,30300,93324
315850,202205,263,179,84,216949.32,101808.69,318758.01
315860,202205,16,5,11,6060,13332,19392
315870,202205,40,31,9,37572,10908,48480
315880,202205,94,65,29,78780,35148,113928
315890,202205,102,75,27,90900,32724,123624
315895,202205,400,261,139,317545.22,168469.65,486014.87
315900,202205,79,38,41,46056,49692,95748
315910,202205,45,27,18,32724,21816,54540
315920,202205,155,103,52,124836,63024,187860
315930,202205,53,17,36,20604,43632,64236
315935,202205,121,97,24,117565,29088.23,146653.23
315940,202205,99,73,26,88476,31512,119988
315950,202205,30,21,9,25452,10908,36360
315960,202205,552,263,289,318757.18,350271.67,669028.85
315970,202205,30,23,7,27876.9,8484,36360.9
315980,202205,664,332,332,402387.17,403596.81,805983.98
315990,202205,261,149,112,180588,135744.13,316332.13
316000,202205,46,30,16,36360,19392,55752
316010,202205,86,72,14,87264.28,16968,104232.28
316020,202205,107,93,14,112716,16968,129684
316030,202205,374,212,162,256945.42,196345.55,453290.97
316040,202205,545,215,330,260581.18,399960.6,660541.78
316045,202205,51,46,5,55752,6060,61812
316050,202205,19,14,5,16968,6060,23028
316060,202205,106,72,34,87264.3,41208,128472.3
316070,202205,1157,767,390,929606.59,475105.46,1404712.05
316080,202205,94,61,33,74038.65,39996,114034.65
316090,202205,38,19,19,23028,23028,46056
316095,202205,85,71,14,86052.72,16968,103020.72
316100,202205,322,181,141,219373.37,172104.8,391478.17
316105,202205,42,24,18,29088.6,21816,50904.6
316110,202205,1867,1455,412,1764681.31,500556.8,2265238.11
316120,202205,78,52,26,63024,31512,94536
316130,202205,115,84,31,101809.3,37572,139381.3
316140,202205,34,23,11,27876,13332,41208
316150,202205,210,146,64,176952,78780,255732
316160,202205,80,48,32,58176,38784,96960
316165,202205,71,47,24,56964,29088,86052
316170,202205,187,120,67,145440.1,81204,226644.1
316180,202205,215,84,131,101809.2,158772.6,260581.8
316190,202205,146,106,40,128472,48480,176952
316200,202205,656,355,301,430260.76,364812.19,795072.95
316210,202205,754,503,251,609846.39,305424,915270.39
316220,202205,118,74,44,89688,53328,143016
316225,202205,35,21,14,25452,16968,42420
316230,202205,39,21,18,25452,21816,47268
316240,202205,650,520,130,630243.05,158772.1,789015.15
316245,202205,156,138,18,167257.11,21816,189073.11
316250,202205,1623,1093,530,1325934.13,642360.37,1968294.50
316255,202205,134,108,26,130896,31512,162408
316257,202205,172,88,84,106656,101808,208464
316260,202205,189,129,60,156348,73932.2,230280.2
316265,202205,31,22,9,26664,10908,37572
316270,202205,671,476,195,576914.88,236341.24,813256.12
316280,202205,543,339,204,410869.95,247248.63,658118.58
316290,202205,823,567,256,687208.42,310272.64,997481.06
316292,202205,560,230,330,278760.9,401172.65,679933.55
316294,202205,105,66,39,79992.1,47268.2,127260.3
316295,202205,352,159,193,192708.6,236340.59,429049.19
316300,202205,8,6,2,7272,2424,9696
316310,202205,26,14,12,16968,14544,31512
316320,202205,55,29,26,35149.03,31512,66661.03
316330,202205,174,119,55,144228,66660,210888
316340,202205,137,91,46,111504,55752,167256
316350,202205,187,130,57,157560.2,69084,226644.2
316360,202205,27,15,12,18180,14544,32724
316370,202205,1194,586,608,711447.89,736898.4,1448346.29
316380,202205,112,86,26,104232.5,31512,135744.5
316390,202205,101,73,28,88476,33936,122412
316400,202205,144,109,35,133320,42420,175740
316410,202205,302,215,87,260580,105444,366024
316420,202205,218,148,70,179377.58,84840.5,264218.08
316430,202205,153,83,70,100596,84840,185436
316440,202205,73,39,34,47268,41208,88476
316443,202205,42,36,6,43632,7272,50904
316447,202205,44,35,9,42420.61,10908,53328.61
316450,202205,228,176,52,214524.05,63024,277548.05
316460,202205,43,14,29,16968,35148,52116
316470,202205,1717,1251,466,1516209.96,564792,2081001.96
316480,202205,12,9,3,10908,3636,14544
316490,202205,21,7,14,8484,16968,25452
316500,202205,161,104,57,126048,69084,195132
316510,202205,141,112,29,135744,35148,170892
316520,202205,188,106,82,128472.15,99384,227856.15
316530,202205,165,103,62,124836,75144,199980
316540,202205,151,76,75,92112,90900,183012
316550,202205,141,85,56,103020.9,67872,170892.9
316553,202205,379,182,197,220584.75,238764.92,459349.67
316555,202205,51,45,6,54540.6,7272,61812.6
316556,202205,13,9,4,10908,4848,15756
316557,202205,28,22,6,26664,7272,33936
316560,202205,73,50,23,60600,27876,88476
316570,202205,205,188,17,227856.2,20604,248460.2
316580,202205,22,16,6,19392,7272,26664
316590,202205,92,78,14,94536.62,16968,111504.62
316600,202205,175,144,31,174528,37572,212100
316610,202205,69,50,19,60600.63,23028,83628.63
316620,202205,142,101,41,122412.2,49692,172104.2
316630,202205,43,34,9,41208,10908,52116
316640,202205,21,13,8,15756,9696,25452
316650,202205,95,78,17,94536,20604,115140
316660,202205,7,2,5,2424,6060,8484
316670,202205,432,150,282,181801.53,341784,523585.53
316680,202205,161,122,39,147864.91,47268.4,195133.31
316690,202205,163,98,65,118776,78780,197556
316695,202205,54,47,7,56964,8484,65448
316700,202205,23,16,7,19392,8484,27876
316710,202205,772,590,182,715082.42,220584.65,935667.07
316720,202205,5038,2413,2625,2924576.44,3182715.26,6107291.70
316730,202205,15,14,1,16968,1212,18180
316740,202205,153,95,58,115140,70296,185436
316750,202205,22,14,8,16968,9696,26664
316760,202205,309,247,62,299364.95,75144.09,374509.04
316770,202205,167,86,81,104232,98172,202404
316780,202205,68,42,26,50904.6,31512,82416.6
316790,202205,58,41,17,49692,20604,70296
316800,202205,1767,1083,684,1312600.54,829011.15,2141611.69
316805,202205,26,18,8,21816,9696,31512
316810,202205,60,36,24,43632,29088.38,72720.38
316820,202205,38,21,17,25452,20604,46056
316830,202205,98,44,54,53328.2,65448,118776.2
316840,202205,505,302,203,366025.15,246036.6,612061.75
316850,202205,305,206,99,249672.2,119988,369660.2
316860,202205,6147,2720,3427,3300299.8,4157166.74,7457466.54
316870,202205,1627,1042,585,1264128.59,709021.93,1973150.52
316880,202205,153,77,76,93324.97,92112.31,185437.28
316890,202205,228,153,75,185436.68,90900,276336.68
316900,202205,407,287,120,347845.98,145440,493285.98
316905,202205,21,9,12,10908,14544,25452
316910,202205,70,30,40,36360,48480,84840
316920,202205,143,111,32,134532.26,38784,173316.26
316930,202205,1930,974,956,1180493.88,1158673,2339166.88
316935,202205,935,557,378,675086,458136.84,1133222.84
316940,202205,1097,632,465,765985.78,564792.6,1330778.38
316950,202205,181,85,96,103021.19,116352,219373.19
316960,202205,1096,612,484,742962.76,586609.64,1329572.40
316970,202205,628,498,130,603578.61,157560.64,761139.25
316980,202205,78,40,38,48480,46056,94536
316990,202205,2208,1496,712,1814373.74,862945.78,2677319.52
317000,202205,327,253,74,306638.79,89688,396326.79
317005,202205,216,152,64,184224.55,77568,261792.55
317010,202205,6548,3682,2866,4465056.52,3473608.41,7938664.93
317020,202205,15631,6873,8758,8335030.93,10620784.2,18955815.13
317030,202205,88,38,50,46056,60600,106656
317040,202205,3093,1977,1116,2397350.51,1352594.81,3749945.32
317043,202205,76,57,19,69085.93,23028.8,92114.73
317047,202205,39,23,16,27876.64,19392,47268.64
317050,202205,141,109,32,132108,38784,170892
317052,202205,146,115,31,139380.2,37572,176952.2
317057,202205,172,129,43,156348.8,52116,208464.8
317060,202205,63,38,25,46056,30300.2,76356.2
317065,202205,51,37,14,44844,16968,61812
317070,202205,1907,881,1026,1067775.75,1244725.19,2312500.94
317075,202205,93,51,42,61812,50904,112716
317080,202205,923,473,450,573284.97,547824,1121108.97
317090,202205,695,544,151,659329.38,183013.8,842343.18
317100,202205,423,319,104,386628.95,126048,512676.95
317103,202205,119,95,24,115140,29088,144228
317107,202205,48,40,8,48480,9696,58176
317110,202205,83,46,37,55752.2,44844.09,100596.29
317115,202205,45,41,4,49692,4848,54540
317120,202205,2009,966,1043,1170804.82,1265329.93,2436134.75
317130,202205,2060,1379,681,1672564.5,826584.8,2499149.3
317140,202205,11,10,1,12120,1212,13332
317150,202205,280,169,111,204829.5,134532,339361.5
317160,202205,336,251,85,304213.65,103020.46,407234.11
317170,202205,237,157,80,190284.23,96960.1,287244.33
317180,202205,427,291,136,353905.02,164832.88,518737.90
317190,202205,260,188,72,227856,87264,315120
317200,202205,816,560,256,678730.97,310274.2,989005.17
317210,202205,183,95,88,115141.67,106656,221797.67
317220,202205,22,11,11,13332,13332,26664
320010,202205,559,402,157,487225.34,190285.04,677510.38
320013,202205,126,86,40,104232.2,48480,152712.2
320016,202205,259,164,95,198768.82,115140,313908.82
320020,202205,720,425,295,515104.03,357542.34,872646.37
320030,202205,160,107,53,129684.06,64237.6,193921.66
320035,202205,135,96,39,116352,47268,163620
320040,202205,492,253,239,306636.3,289668.2,596304.5
320050,202205,117,82,35,99384.4,42420.64,141805.04
320060,202205,1770,823,947,997482.61,1147766.75,2145249.36
320070,202205,96,60,36,72720,43632,116352
320080,202205,803,456,347,552676.16,421777.71,974453.87
320090,202205,1262,812,450,984146.82,546614.52,1530761.34
320100,202205,338,196,142,237552.07,172104.32,409656.39
320110,202205,122,76,46,92115.65,55752.2,147867.85
320115,202205,110,92,18,111504,21816,133320
320120,202205,3629,1880,1749,2282209.3,2119796.03,4402005.33
320130,202205,7778,3408,4370,4135367.61,5298883.44,9434251.05
320140,202205,448,290,158,351481.4,191497.4,542978.8
320150,202205,2095,1165,930,1414413.28,1128375.15,2542788.43
320160,202205,640,281,359,340573.55,436320.9,776894.45
320170,202205,109,86,23,104232.1,27876.02,132108.12
320180,202205,55,34,21,41209.18,26664,67873.18
320190,202205,236,141,95,170892.86,115140.2,286033.06
320200,202205,64,50,14,60600.3,16968,77568.3
320210,202205,898,486,412,589036.35,499348.12,1088384.47
320220,202205,291,104,187,126048.45,226644.2,352692.65
320225,202205,76,62,14,75144.07,16968.2,92112.27
320230,202205,688,436,252,529653.24,305425.44,835078.68
320240,202205,3488,1604,1884,1946481.36,2287051.1,4233532.46
320245,202205,495,340,155,413295.51,187861.62,601157.13
320250,202205,226,105,121,127260.3,146652,273912.3
320255,202205,128,98,30,118776,36360.1,155136.1
320260,202205,245,140,105,169680.23,127260.12,296940.35
320265,202205,147,115,32,139380,38784,178164
320270,202205,154,118,36,143016.6,43632,186648.6
320280,202205,1208,682,526,826587.29,638725.65,1465312.94
320290,202205,61,48,13,58176,15756,73932
320300,202205,609,410,199,498135.57,241191.17,739326.74
320305,202205,715,383,332,464199.18,403598.14,867797.32
320310,202205,201,117,84,141807.34,101808,243615.34
320313,202205,343,156,187,189073.92,226644,415717.92
320316,202205,108,79,29,95749.07,35148,130897.07
320320,202205,3424,1522,1902,1844673.19,2308862.79,4153535.98
320330,202205,273,199,74,241188,89688,330876
320332,202205,778,457,321,553889.22,389057.25,942946.47
320334,202205,276,153,123,185436.22,150289.1,335725.32
320335,202205,142,91,51,110292,63024.3,173316.3
320340,202205,569,399,170,484803.23,206042.06,690845.29
320350,202205,1068,435,633,527224.52,768410.59,1295635.11
320360,202205,171,82,89,99384,107868,207252
320370,202205,227,169,58,204829.44,70296.6,275126.04
320380,202205,296,209,87,253309.77,105444,358753.77
320390,202205,1147,670,477,813256.41,578124.4,1391380.81
320400,202205,317,222,95,270276.17,115140,385416.17
320405,202205,963,392,571,475108.98,692056.02,1167165.00
320410,202205,947,476,471,576915.75,570853.55,1147769.30
320420,202205,540,251,289,304215.42,350268.84,654484.26
320425,202205,205,111,94,134532.1,113928,248460.1
320430,202205,384,198,186,239978.39,225432.92,465411.31
320435,202205,165,111,54,134532.2,65448.62,199980.82
320440,202205,201,109,92,132108.24,111504.2,243612.44
320450,202205,136,73,63,88476,76356.1,164832.1
320455,202205,231,182,49,220584.86,59388,279972.86
320460,202205,287,178,109,216949.46,132108.38,349057.84
320465,202205,109,73,36,88476.99,43632.1,132109.09
320470,202205,709,421,288,510254.94,349056.93,859311.87
320480,202205,206,137,69,166044.89,83628.2,249673.09
320490,202205,3225,1506,1719,1825288.35,2084656.56,3909944.91
320495,202205,117,67,50,81204.1,60600.6,141804.7
320500,202205,9801,4749,5052,5760686.39,6125475.63,11886162.02
320501,202205,550,279,271,338149.1,328453.1,666602.2
320503,202205,303,214,89,259368.36,107868.12,367236.48
320506,202205,255,177,78,214524,94536,309060
320510,202205,1178,513,665,621758.45,805982.87,1427741.32
320515,202205,83,63,20,76356.2,24240,100596.2
320517,202205,212,152,60,184224.22,73932,258156.22
320520,202205,7498,3115,4383,3775403.92,5314657.35,9090061.27
320530,202205,6733,3227,3506,3914757.65,4249287.51,8164045.16
330010,202205,3307,1625,1682,1970727.03,2042224.24,4012951.27
330015,202205,196,86,110,104232.64,133320.1,237552.74
330020,202205,3882,1554,2328,1884668.98,2823972.03,4708641.01
330022,202205,270,133,137,161197.15,166044.2,327241.35
330023,202205,747,218,529,264216,641150.41,905366.41
330025,202205,663,124,539,150288.38,653272.04,803560.42
330030,202205,1842,1142,700,1384108.42,848401.24,2232509.66
330040,202205,2583,1291,1292,1564702.43,1567117.45,3131819.88
330045,202205,9868,2952,6916,3577844.96,8396768.07,11974613.03
330050,202205,876,547,329,662966.4,398748.6,1061715.0
330060,202205,1123,657,466,797499.62,566005.62,1363505.24
330070,202205,4173,1411,2762,1711357.35,3349980.67,5061338.02
330080,202205,1601,697,904,844768.01,1096866.05,1941634.06
330090,202205,397,223,174,270276,210889.23,481165.23
330093,202205,235,98,137,118776,167256,286032
330095,202205,64,39,25,47268,30300,77568
330100,202205,10479,5142,5337,6234556.18,6476951.56,12711507.74
330110,202205,463,212,251,256946.82,304212,561158.82
330115,202205,515,259,256,313909.26,310272.82,624182.08
330120,202205,398,210,188,254520.6,229068.6,483589.2
330130,202205,1622,416,1206,504197.64,1461679.43,1965877.07
330140,202205,664,350,314,424200.2,380568,804768.2
330150,202205,514,302,212,366026,256944.66,622970.66
330160,202205,207,119,88,146652,106656,253308
330170,202205,27185,9171,18014,11120178.21,21856096.22,32976274.43
330180,202205,256,135,121,163621.06,146652.32,310273.38
330185,202205,1042,362,680,438744.86,824163.57,1262908.43
330187,202205,492,146,346,176952.2,419353.06,596305.26
330190,202205,6200,2272,3928,2756100.36,4761962.25,7518062.61
330200,202205,4654,1455,3199,1767103.03,3879627.96,5646730.99
330205,202205,461,260,201,315120.85,243614.48,558735.33
330210,202205,960,570,390,690845.73,472681.2,1163526.93
330220,202205,2827,1652,1175,2002237.4,1424103.99,3426341.39
330225,202205,568,297,271,359966.61,328452.31,688418.92
330227,202205,2406,742,1664,899310.86,2019200.42,2918511.28
330230,202205,256,136,120,166044,145440,311484
330240,202205,4163,1954,2209,2368261.51,2677314.84,5045576.35
330245,202205,153,70,83,84840.36,100596,185436.36
330250,202205,6756,3249,3507,3941451.15,4255350,8196801.15
330260,202205,713,188,525,227856.66,636300.8,864157.46
330270,202205,3866,1215,2651,1472589.07,3217871.76,4690460.83
330280,202205,449,276,173,335730.49,209677,545407.49
330285,202205,6728,2111,4617,2559763.15,5603107.77,8162870.92
330290,202205,725,247,478,299368.16,579336.85,878705.01
330300,202205,747,466,281,565540.1,340573.91,906114.01
330310,202205,464,264,200,319968.7,242400.15,562368.85
330320,202205,7912,2796,5116,3388776.41,6210316.08,9599092.49
330330,202205,9351,3433,5918,4163243.91,7182338.47,11345582.38
330340,202205,2716,1529,1187,1853153.71,1439858.16,3293011.87
330350,202205,19633,7184,12449,8715555.42,15099170.79,23814726.21
330360,202205,2072,965,1107,1169591,1344117.75,2513708.75
330370,202205,974,498,476,603580.98,578127.04,1181708.02
330380,202205,961,384,577,465408.89,699324.82,1164733.71
330385,202205,645,327,318,396325.52,386628.46,782953.98
330390,202205,5977,3062,2915,3712376.03,3539051.29,7251427.32
330395,202205,365,230,135,278762.18,163622.17,442384.35
330400,202205,719,358,361,433899.82,439956.17,873855.99
330410,202205,517,371,146,450869.09,178164.3,629033.39
330411,202205,314,163,151,197556.2,183012,380568.2
330412,202205,224,94,130,113928.2,158772,272700.2
330414,202205,5404,2116,3288,2568245.96,3986274.23,6554520.19
330415,202205,618,262,356,317545.02,431474.35,749019.37
330420,202205,2377,1218,1159,1478647.23,1404709.64,2883356.87
330430,202205,1781,756,1025,917488.35,1243514.64,2161002.99
330440,202205,354,169,185,204828.99,224220,429048.99
330450,202205,117,54,63,65448,76356,141804
330452,202205,2353,967,1386,1172015.09,1681047.12,2853062.21
330455,202205,121290,41210,80080,49978477.78,97175054.24,147153532.02
330460,202205,254,113,141,136956.17,170892,307848.17
330470,202205,1238,660,578,801137.64,701751.44,1502889.08
330475,202205,1759,501,1258,607214.18,1524698.74,2131912.92
330480,202205,796,434,362,528434.97,438744.93,967179.90
330490,202205,15877,4894,10983,5934096.6,13322343.99,19256440.59
330500,202205,1496,638,858,773260.31,1039897.72,1813158.03
330510,202205,10965,3730,7235,4523212.84,8782190.29,13305403.13
330513,202205,102,52,50,63024,60600,123624
330515,202205,737,309,428,374509.24,518738.06,893247.30
330520,202205,2540,859,1681,1042326.72,2039806.12,3082132.84
330530,202205,192,108,84,130896,101808.4,232704.4
330540,202205,330,167,163,202404.56,197556.97,399961.53
330550,202205,2812,947,1865,1147769.05,2262812.11,3410581.16
330555,202205,921,348,573,421777.2,694476.8,1116254.0
330560,202205,737,246,491,298152.96,595093.51,893246.47
330570,202205,294,204,90,247248.61,109080,356328.61
330575,202205,834,301,533,364817.62,647209.87,1012027.49
330580,202205,3388,1802,1586,2184030.97,1924666.63,4108697.60
330590,202205,260,133,127,161196.38,153924,315120.38
330600,202205,1310,779,531,944152.87,643573.2,1587726.07
330610,202205,1660,852,808,1032628.42,979298.4,2011926.82
330615,202205,222,178,44,215736.8,53329,269065.8
330620,202205,1042,404,638,489651.28,773256.77,1262908.05
330630,202205,4432,2631,1801,3190009.19,2184030.88,5374040.07
350010,202205,600,397,203,481170.32,246036.88,727207.20
350020,202205,57,19,38,23028,46056,69084
350030,202205,545,330,215,402388.15,260582,662970.15
350040,202205,118,48,70,58177.02,84840.19,143017.21
350050,202205,355,175,180,212100.6,219372,431472.6
350055,202205,125,53,72,64236,87264,151500
350060,202205,89,38,51,46056.31,61812,107868.31
350070,202205,800,455,345,551470.19,418142.25,969612.44
350075,202205,74,45,29,54540,35148,89688
350080,202205,56,25,31,30300.74,37572.2,67872.94
350090,202205,86,49,37,59388.2,44844,104232.2
350100,202205,269,168,101,203616.2,122412,326028.2
350110,202205,48,30,18,36360.4,21816,58176.4
350115,202205,165,91,74,110292.1,89688.6,199980.7
350120,202205,114,72,42,87264.52,50904.2,138168.72
350130,202205,394,172,222,208465.24,269065.05,477530.29
350140,202205,39,23,16,27876.44,19392,47268.44
350150,202205,68,48,20,58176,24240.2,82416.2
350160,202205,2399,954,1445,1157464.73,1753766.06,2911230.79
350170,202205,401,228,173,276337.4,209676.8,486014.2
350180,202205,166,95,71,115141.33,86052.81,201194.14
350190,202205,1020,549,471,665401.78,570852,1236253.78
350200,202205,56,25,31,30301,37572,67873
350210,202205,1323,721,602,873860.63,729631.22,1603491.85
350220,202205,644,527,117,638731.71,143016.63,781748.34
350230,202205,71,46,25,55752,30300,86052
350240,202205,62,38,24,46056.48,29089.02,75145.50
350250,202205,1130,517,613,626611.04,744173.41,1370784.45
350260,202205,97,70,27,84840.7,32724,117564.7
350270,202205,959,641,318,778107.71,387842.22,1165949.93
350275,202205,316,120,196,145441.85,237552.15,382994.00
350280,202205,4491,2170,2321,2633714.93,2817907.13,5451622.06
350290,202205,463,194,269,237552.4,326029.62,563582.02
350300,202205,50,24,26,29089.03,31512,60601.03
350310,202205,80,48,32,58176,39996,98172
350315,202205,69,28,41,35148,49692,84840
350320,202205,3394,1605,1789,1947699.89,2173122.17,4120822.06
350330,202205,1679,867,812,1050816.2,984146.39,2034962.59
350335,202205,18,11,7,13332,8484,21816
350340,202205,125,51,74,61812,89688.2,151500.2
350350,202205,94,46,48,55752,58176,113928
350360,202205,102,66,36,79992.3,43632.18,123624.48
350370,202205,83,45,38,55752.95,46056,101808.95
350380,202205,811,339,472,410872.67,572065.02,982937.69
350390,202205,1774,656,1118,795076.55,1356232.05,2151308.60
350395,202205,22,17,5,20604,6060,26664
350400,202205,1733,836,897,1014457.83,1093225.77,2107683.60
350410,202205,3027,1260,1767,1527127.72,2141611.08,3668738.80
350420,202205,271,161,110,195134.51,133320,328454.51
350430,202205,95,48,47,58177.29,56966.39,115143.68
350440,202205,148,107,41,129685.31,49692,179377.31
350450,202205,1737,962,775,1165956.71,940512.2,2106468.91
350460,202205,399,137,262,166044.78,318757.63,484802.41
350470,202205,20,13,7,15756,8484,24240
350480,202205,196,102,94,123626.19,113928.8,237554.99
350490,202205,247,114,133,139380.2,162408,301788.2
350500,202205,58,23,35,27876,42420,70296
350510,202205,154,94,60,113928.4,72720,186648.4
350520,202205,444,235,209,284822.02,253309.06,538131.08
350530,202205,439,208,231,253310.39,279975.54,533285.93
350535,202205,90,61,29,73932.75,35148.2,109080.95
350540,202205,369,193,176,235129.02,213312.63,448441.65
350550,202205,2776,1573,1203,1906500.97,1459252.65,3365753.62
350560,202205,586,398,188,482377.52,227856.1,710233.62
350570,202205,4581,1870,2711,2266448.72,3288163.26,5554611.98
350580,202205,373,177,196,214524.82,238765.2,453290.02
350590,202205,973,524,449,636302.39,544190.54,1180492.93
350600,202205,6410,2974,3436,3609370.02,4168078.62,7777448.64
350610,202205,1505,773,732,936885.28,887185.82,1824071.10
350620,202205,25,16,9,19392,12120,31512
350630,202205,257,130,127,158773.2,153924.15,312697.35
350635,202205,1155,471,684,570857.75,830223.34,1401081.09
350640,202205,116,84,32,101808.93,38784,140592.93
350650,202205,1875,1237,638,1500480.38,775680,2276160.38
350660,202205,775,305,470,369662.06,569640.4,939302.46
350670,202205,304,149,155,180588,187860,368448
350680,202205,164,82,82,99386.08,99384.79,198770.87
350690,202205,202,92,110,111504,133320,244824
350700,202205,886,421,465,510253.91,563580.71,1073834.62
350710,202205,413,153,260,185436.21,316333.8,501770.01
350715,202205,54,43,11,52116.51,13332,65448.51
350720,202205,18,11,7,13332,8484,21816
350730,202205,41,26,15,31512,18180,49692
350740,202205,238,129,109,156349.63,132110.05,288459.68
350745,202205,29,13,16,15756,19392,35148
350750,202205,2404,1412,992,1711365.69,1203521.13,2914886.82
350760,202205,3899,1630,2269,1976785.68,2753666.8,4730452.48
350770,202205,55,35,20,42420,24240,66660
350775,202205,47,35,12,42421.56,14544,56965.56
350780,202205,448,225,223,272702.15,270276.5,542978.65
350790,202205,367,154,213,186648.99,258156.5,444805.49
350800,202205,527,316,211,382993.99,255733.5,638727.49
350810,202205,515,399,116,483593.47,140592.95,624186.42
350820,202205,94,53,41,64236,50904,115140
350830,202205,72,39,33,47269.1,39996,87265.1
350840,202205,793,321,472,390267.11,572064.68,962331.79
350850,202205,1865,973,892,1179283.95,1081104.88,2260388.83
350860,202205,659,346,313,419356.2,379358.4,798714.6
350870,202205,455,300,155,363600.78,187860.2,551460.98
350880,202205,273,154,119,186648.63,144229.39,330878.02
350890,202205,39,23,16,27876.2,19392.9,47269.1
350900,202205,1629,500,1129,606001.97,1369564.93,1975566.90
350910,202205,22,11,11,13332,13332,26664
350920,202205,768,399,369,484801.77,447228,932029.77
350925,202205,1184,609,575,739323.5,696903.58,1436227.08
350930,202205,111,61,50,73932.18,60600,134532.18
350940,202205,743,388,355,470260.15,432687.2,902947.35
350945,202205,112,81,31,98173.41,37572.2,135745.61
350950,202205,17570,8051,9519,9763948.92,11550385.84,21314334.76
350960,202205,1595,649,946,786590.7,1147767.81,1934358.51
350970,202205,1091,537,554,651928.87,671450.35,1323379.22
350980,202205,95,64,31,77568.9,37572,115140.9
350990,202205,386,136,250,164834.08,303000.85,467834.93
350995,202205,42,18,24,21817.18,29088,50905.18
351000,202205,618,402,216,487227.49,261794.27,749021.76
351010,202205,49,33,16,39996.91,19392,59388.91
351015,202205,44,29,15,35148.6,18180,53328.6
351020,202205,1491,882,609,1071412.91,738109.16,1809522.07
351030,202205,343,202,141,244824,170892,415716
351040,202205,1000,522,478,632668.72,579336.51,1212005.23
351050,202205,3562,1589,1973,1927100.73,2392493.2,4319593.93
351060,202205,5927,2135,3792,2593697.31,4600756.71,7194454.02
351070,202205,403,252,151,305428.2,183013.43,488441.63
351080,202205,736,535,201,649635.52,246038.2,895673.72
351090,202205,46,22,24,26664.2,29088,55752.2
351100,202205,424,226,198,273914.18,239977.93,513892.11
351110,202205,2075,956,1119,1158688.75,1357441.97,2516130.72
351120,202205,64,30,34,36360.85,41208.9,77569.75
351130,202205,192,61,131,75144.4,158772,233916.4
351140,202205,329,196,133,237552.81,162408.6,399961.41
351150,202205,486,248,238,300576.92,289668.7,590245.62
351160,202205,290,173,117,210888.33,143016,353904.33
351170,202205,220,118,102,143016.09,123624,266640.09
351190,202205,90,57,33,69084,39996,109080
351200,202205,349,224,125,271489.74,151501.05,422990.79
351210,202205,121,60,61,72720,73932,146652
351220,202205,565,325,240,393903.78,290880,684783.78
351230,202205,287,195,92,236340.92,111504,347844.92
351240,202205,235,111,124,135744.51,150289.55,286034.06
351250,202205,84,55,29,66661.02,35148.99,101810.01
351260,202205,151,106,45,128472,54540.22,183012.22
351270,202205,45,20,25,24240,30300,54540
351280,202205,1053,491,562,595095.46,681148.48,1276243.94
351290,202205,244,106,138,128472,167256.2,295728.2
351300,202205,3928,1676,2252,2033651.48,2729431.41,4763082.89
351310,202205,738,357,381,432689.68,461773.7,894463.38
351320,202205,118,64,54,77568.29,65448.8,143017.09
351330,202205,39,25,14,30300,16968,47268
351340,202205,1395,765,630,927192.05,763562.64,1690754.69
351350,202205,2374,1373,1001,1667723.66,1215639.01,2883362.67
351360,202205,806,375,431,454502.73,522372,976874.73
351370,202205,413,201,212,243614.94,256944.2,500559.14
351380,202205,8946,3836,5110,4656536.32,6198177.39,10854713.71
351385,202205,25,14,11,18180,13332,31512
351390,202205,278,204,74,247249.16,89688,336937.16
351400,202205,62,42,20,50904,24240,75144
351410,202205,463,280,183,340575.95,221796,562371.95
351420,202205,72,51,21,61812,25452,87264
351430,202205,75,41,34,49692,41208,90900
351440,202205,800,520,280,630249.38,340573.65,970823.03
351450,202205,274,127,147,153925.72,178164.07,332089.79
351460,202205,134,57,77,69084.95,93324,162408.95
351470,202205,143,74,69,89688.2,83628.72,173316.92
351480,202205,480,285,195,345421.55,237552,582973.55
351490,202205,293,109,184,132108,223008.55,355116.55
351492,202205,26,16,10,19392,12120,31512
351495,202205,24,17,7,20604,8484,29088
351500,202205,3505,1409,2096,1707712.97,2542780.91,4250493.88
351510,202205,2088,757,1331,918699.1,1613175.34,2531874.44
351512,202205,13,9,4,10908,4848,15756
351515,202205,203,119,84,145440.3,101808,247248.3
351518,202205,696,412,284,501771.29,344212.26,845983.55
351519,202205,80,44,36,53328,43632,96960
351520,202205,163,98,65,118777.25,78801.93,197579.18
351530,202205,23,12,11,14544,13332,27876
351535,202205,139,83,56,100599.24,67872.2,168471.44
351540,202205,468,310,158,375722.81,192708,568430.81
351550,202205,1503,880,623,1071425.7,755077.43,1826503.13
351560,202205,74,44,30,53328.67,36360,89688.67
351565,202205,11,6,5,7272.32,7272,14544.32
351570,202205,2805,1279,1526,1550154.93,1849515.28,3399670.21
351580,202205,37,33,4,39996,4848,44844
351590,202205,67,44,23,53329.57,27876,81205.57
351600,202205,180,130,50,157563.2,60600,218163.2
351610,202205,52,24,28,29088,33936,63024
351620,202205,5908,3172,2736,3849341.57,3319675.69,7169017.26
351630,202205,3240,1536,1704,1865273.49,2066468.05,3931741.54
351640,202205,2344,999,1345,1212007.8,1631356.33,2843364.13
351650,202205,30,25,5,30300,6060,36360
351660,202205,139,86,53,104232,64236,168468
351670,202205,749,440,309,533285.04,374510.55,907795.59
351680,202205,79,60,19,72720,23028,95748
351685,202205,10,7,3,8484,3636,12120
351690,202205,298,198,100,239978.52,121200,361178.52
351700,202205,183,121,62,146913.2,76356,223269.2
351710,202205,67,43,24,52116,29088,81204
351720,202205,129,73,56,88476.59,67872,156348.59
351730,202205,113,76,37,92112,44844,136956
351740,202205,785,491,294,595098.81,357542.85,952641.66
351750,202205,375,146,229,176952.31,277548.2,454500.51
351760,202205,721,554,167,671451.56,202404.2,873855.76
351770,202205,296,238,58,288457.41,70296,358753.41
351780,202205,153,91,62,110292.95,75144,185436.95
351790,202205,263,136,127,166045.21,155136.02,321181.23
351800,202205,42,27,15,32724,18180,50904
351810,202205,125,81,44,98172.2,53328.3,151500.5
351820,202205,764,540,224,656918.11,271490.22,928408.33
351830,202205,622,197,425,238764,515100,753864
351840,202205,2176,992,1184,1202320.08,1437433.52,2639753.60
351850,202205,245,170,75,207252.49,92112,299364.49
351860,202205,616,409,207,495718.15,250884,746602.15
351870,202205,5763,2596,3167,3148795.23,3845696.06,6994491.29
351880,202205,21437,8241,13196,9988149.02,16015394.52,26003543.54
351885,202205,88,49,39,59389.4,47268.2,106657.6
351890,202205,68,48,20,58176,24240.82,82416.82
351900,202205,231,126,105,152712.4,127260,279972.4
351905,202205,94,43,51,52116,61812,113928
351907,202205,3662,1474,2188,1786501.05,2654287.17,4440788.22
351910,202205,161,70,91,84840.1,110292.1,195132.2
351920,202205,111,60,51,72720,61812,134532
351925,202205,88,54,34,65448.2,41208,106656.2
351930,202205,428,273,155,330880.27,187863.24,518743.51
351940,202205,240,99,141,119988.51,170892,290880.51
351950,202205,144,74,70,89688,84840.82,174528.82
351960,202205,942,453,489,550252.13,592671.8,1142923.93
351970,202205,2097,1006,1091,1219274.63,1323507.44,2542782.07
351980,202205,157,71,86,86053.36,104232,190285.36
351990,202205,249,157,92,191497.4,111504.47,303001.87
352000,202205,322,203,119,248461.98,144228.2,392690.18
352010,202205,428,278,150,337020.99,183016.14,520037.13
352020,202205,192,69,123,83628,149076,232704
352030,202205,1178,557,621,676300.4,752654.39,1428954.79
352040,202205,636,244,392,295731,475104.95,770835.95
352042,202205,317,79,238,95748.05,288457.76,384205.81
352044,202205,362,208,154,253309.86,187861.18,441171.04
352050,202205,3292,1203,2089,1458042.95,2535509.11,3993552.06
352060,202205,99,58,41,70296,49692.21,119988.21
352070,202205,92,66,26,79994.57,31512,111506.57
352080,202205,67,43,24,52116,29088,81204
352090,202205,175,113,62,136956,75144,212100
352100,202205,304,145,159,175740,192708.6,368448.6
352110,202205,113,34,79,41208,95748,136956
352115,202205,62,21,41,25452,50904,76356
352120,202205,67,46,21,55752.95,25452,81204.95
352130,202205,217,163,54,197557.03,65448.1,263005.13
352140,202205,178,82,96,99384.8,116352,215736.8
352150,202205,125,64,61,77568.1,73933.26,151501.36
352160,202205,141,90,51,109080.2,61812,170892.2
352170,202205,406,277,129,336937.28,156348.08,493285.36
352180,202205,687,418,269,507833.59,327243.61,835077.20
352190,202205,245,100,145,121200.38,175740.21,296940.59
352200,202205,29,11,18,13332,21816.1,35148.1
352210,202205,4441,1768,2673,2145262.45,3243316.82,5388579.27
352215,202205,71,39,32,47268,38784,86052
352220,202205,6379,2353,4026,2854270.55,4884372.04,7738642.59
352230,202205,3504,2219,1285,2689467.92,1557425.87,4246893.79
352240,202205,2709,1523,1186,1847098.44,1438646.85,3285745.29
352250,202205,3347,1491,1856,1808316.32,2253111.67,4061427.99
352260,202205,1015,538,477,652060.1,578126.33,1230186.43
352265,202205,65,36,29,43632,35148,78780
352270,202205,382,208,174,252097.45,210891.05,462988.50
352280,202205,495,296,199,358755.25,241188,599943.25
352290,202205,171,99,72,119988.96,87265,207253.96
352300,202205,99,62,37,75145.7,44844,119989.7
352310,202205,7052,3024,4028,3668751.8,4888001.7,8556753.5
352320,202205,1148,597,551,723565.52,671450.29,1395015.81
352330,202205,545,283,262,342997.4,318756,661753.4
352340,202205,1364,622,742,756295.18,900519.8,1656814.98
352350,202205,364,200,164,242400.83,198769.5,441170.33
352360,202205,221,99,122,119988.1,147864.92,267853.02
352370,202205,119,72,47,87264,58176.2,145440.2
352380,202205,112,79,33,95749.47,39996,135745.47
352390,202205,2636,1136,1500,1376838.77,1818004.73,3194843.50
352400,202205,540,233,307,282396.07,372084,654480.07
352410,202205,930,614,316,744177.11,384208.78,1128385.89
352420,202205,87,67,20,81204,24240,105444
352430,202205,1785,781,1004,946582.16,1216857.93,2163440.09
352440,202205,3440,1593,1847,1930731.67,2243417.42,4174149.09
352450,202205,203,159,44,192708.6,53328.72,246037.32
352460,202205,637,316,321,382994.02,390264,773258.02
352470,202205,657,238,419,288458.99,509040.89,797499.88
352480,202205,1576,867,709,1052024.6,860523.34,1912547.94
352490,202205,52,21,31,25452,37572,63024
352500,202205,1298,517,781,626607.13,950208.4,1576815.53
352510,202205,709,364,345,441171.34,419353.8,860525.14
352520,202205,862,369,493,447229.22,598732.72,1045961.94
352530,202205,1853,941,912,1140507.49,1106561.73,2247069.22
352540,202205,67,44,23,53328.4,27876,81204.4
352550,202205,209,117,92,141804.18,111504,253308.18
352560,202205,49,37,12,44844.88,14544,59388.88
352570,202205,734,347,387,420571.84,470261.1,890832.94
352580,202205,55,42,13,50905.58,15756,66661.58
352585,202205,24,6,18,7272,21816,29088
352590,202205,4437,2163,2274,2622790.14,2757416.22,5380206.36
352600,202205,360,250,110,303002.14,133321.1,436323.24
352610,202205,926,413,513,501770.1,622969.46,1124739.56
352620,202205,1114,414,700,501769.63,848400.77,1350170.40
352630,202205,190,74,116,89688.62,140592,230280.62
352640,202205,512,326,186,395114.3,225433.2,620547.5
352650,202205,83,64,19,77568.2,23028,100596.2
352660,202205,64,36,28,43632,33936,77568
352670,202205,1730,913,817,1106567.96,995053.55,2101621.51
352680,202205,953,576,377,699328.77,458139.37,1157468.14
352690,202205,4678,2036,2642,2468868.04,3206958.15,5675826.19
352700,202205,85,49,36,59388.75,43632,103020.75
352710,202205,1518,781,737,946581.56,896881.08,1843462.64
352720,202205,1552,655,897,793867.57,1088382.31,1882249.88
352725,202205,24,19,5,23028,6060,29088
352730,202205,393,190,203,230280.72,246036.88,476317.60
352740,202205,402,260,142,315124.56,173316.49,488441.05
352750,202205,23,15,8,18180,9696,27876
352760,202205,216,138,78,167256.81,94536.1,261792.91
352770,202205,79,60,19,72720,23028.18,95748.18
352780,202205,75,38,37,46056,44844,90900
352790,202205,23,17,6,20605.46,7272,27877.46
352800,202205,237,180,57,218161.67,69084,287245.67
352810,202205,163,102,61,123624.2,73932,197556.2
352820,202205,46,34,12,41208,14544,55752
352830,202205,76,50,26,60601.28,31512.01,92113.29
352840,202205,695,305,390,372086.3,473892.4,845978.7
352850,202205,1774,532,1242,647209.96,1506517.06,2153727.02
352860,202205,114,71,43,86052,52116,138168
352870,202205,51,31,20,37572,24240,61812
352880,202205,176,101,75,122413.86,90900.2,213314.06
352885,202205,33,21,12,25452,14544,39996
352890,202205,55,35,20,42420,25452.6,67872.6
352900,202205,4672,2185,2487,2651885.31,3020310.35,5672195.66
352910,202205,35,29,6,35148,7272,42420
352920,202205,647,373,274,452082.32,332090.4,784172.72
352930,202205,1198,556,642,673877.84,779316,1453193.84
352940,202205,6304,2398,3906,2912455.59,4738929.14,7651384.73
352950,202205,116,46,70,55752.82,84840.5,140593.32
352960,202205,66,40,26,48480,31512,79992
352965,202205,15,9,6,10908,7272,18180
352970,202205,526,384,142,465411.48,173316.2,638727.68
352980,202205,163,94,69,113929.4,83628.45,197557.85
352990,202205,983,459,524,557523.81,635088.8,1192612.61
353000,202205,56,24,32,29088,38784,67872
353010,202205,518,313,205,379358.51,248460,627818.51
353020,202205,321,219,102,265430.85,123624.2,389055.05
353030,202205,1396,615,781,745387.69,947789.57,1693177.26
353040,202205,87,47,40,56965.33,48480.8,105446.13
353050,202205,1325,860,465,1044756.99,566004.67,1610761.66
353060,202205,9020,3822,5198,4634719.89,6304836.22,10939556.11
353070,202205,1944,1144,800,1386547.29,969385.79,2355933.08
353080,202205,1313,706,607,856894.88,735685.82,1592580.70
353090,202205,64,35,29,42420.8,35148,77568.8
353100,202205,42,32,10,38784.4,12120,50904.4
353110,202205,2219,711,1508,861736.34,1830131.78,2691868.12
353120,202205,133,68,65,82416.2,78780,161196.2
353130,202205,860,407,453,494501.46,549038.21,1043539.67
353140,202205,579,257,322,311488.55,390266.11,701754.66
353150,202205,322,169,153,204829.05,186648.8,391477.85
353160,202205,109,83,26,100596.4,31512,132108.4
353170,202205,204,66,138,79992,168468.2,248460.2
353180,202205,1184,534,650,647211.06,789013.97,1436225.03
353190,202205,490,350,140,424204.1,169680.3,593884.4
353200,202205,253,120,133,145440.12,161196,306636.12
353205,202205,19,12,7,14544,8484,23028
353210,202205,68,40,28,48480.2,33936,82416.2
353215,202205,41,23,18,27876.2,21816,49692.2
353220,202205,83,45,38,54540,46056,100596
353230,202205,156,65,91,78780.4,110292,189072.4
353240,202205,373,172,201,208464.58,243612,452076.58
353250,202205,193,95,98,115140.08,118776.2,233916.28
353260,202205,455,299,156,362392.41,189072.85,551465.26
353270,202205,73,54,19,65448.5,23028,88476.5
353280,202205,107,48,59,58177.22,71508,129685.22
353282,202205,123,84,39,101808.1,47268,149076.1
353284,202205,28,19,9,23028.96,10908,33936.96
353286,202205,8,3,5,3636,6060,9696
353290,202205,86,46,40,55752,48480,104232
353300,202205,446,225,221,272703.63,269065.59,541769.22
353310,202205,40,33,7,39996.2,8484.15,48480.35
353320,202205,40,25,15,30300.78,18180.3,48481.08
353325,202205,43,25,18,30300,21816,52116
353330,202205,66,45,21,54540.8,25452,79992.8
353340,202205,685,234,451,283608,546613.42,830221.42
353350,202205,921,446,475,540554.57,576914.49,1117469.06
353360,202205,102,81,21,98172,25452,123624
353370,202205,111,63,48,76356,58176,134532
353380,202205,27,13,14,15756,16968,32724
353390,202205,1126,522,604,633882.49,732050.57,1365933.06
353400,202205,47,28,19,33936,23028.91,56964.91
353410,202205,115,64,51,77568,61812.6,139380.6
353420,202205,51,22,29,26664,35148,61812
353430,202205,582,383,199,464199.49,241190.76,705390.25
353440,202205,12514,5338,7176,6475741.48,8703384.39,15179125.87
353450,202205,58,31,27,37572,32724.2,70296.2
353460,202205,641,325,316,395117.18,387842.76,782959.94
353470,202205,2291,1103,1188,1338065.62,1439857.81,2777923.43
353475,202205,278,177,101,215738.83,122412.1,338150.93
353480,202205,179,143,36,173316.85,43632,216948.85
353490,202205,224,130,94,157560,113928.6,271488.6
353500,202205,211,119,92,144229.12,111504.42,255733.54
353510,202205,82,54,28,65448.1,33936.1,99384.2
353520,202205,230,168,62,203616.2,75144.6,278760.8
353530,202205,471,240,231,290881.22,279972.2,570853.42
353540,202205,407,255,152,309061.29,184225,493286.29
353550,202205,751,472,279,573281.1,338153.59,911434.69
353560,202205,558,225,333,272700.72,403596.96,676297.68
353570,202205,62,40,22,48480.64,26664,75144.64
353580,202205,347,225,122,272700.2,147864.1,420564.3
353590,202205,86,61,25,73932,30300,104232
353600,202205,273,159,114,192709.85,139380,332089.85
353610,202205,133,70,63,84840.1,76356,161196.1
353620,202205,678,340,338,412081.89,410868.2,822950.09
353625,202205,52,28,24,33937.6,29088,63025.6
353630,202205,217,154,63,186649.42,76356.2,263005.62
353640,202205,121,79,42,95748.16,50904,146652.16
353650,202205,1020,388,632,470256.27,768409.1,1238665.37
353657,202205,23,18,5,21816,6060,27876
353660,202205,286,148,138,179376.65,167256.37,346633.02
353670,202205,712,409,303,495710.91,367237.87,862948.78
353680,202205,132,88,44,106656,53328,159984
353690,202205,42,28,14,33936,16968.19,50904.19
353700,202205,284,198,86,239978.18,104232.26,344210.44
353710,202205,502,237,265,287245.26,321183.05,608428.31
353715,202205,43,26,17,31512.1,20604,52116.1
353720,202205,336,154,182,186650.05,220584.08,407234.13
353730,202205,1174,704,470,853258.92,573276,1426534.92
353740,202205,607,334,273,404810.77,330878.45,735689.22
353750,202205,72,41,31,49692.03,37572,87264.03
353760,202205,3237,1216,2021,1476228.2,2453098.61,3929326.81
353770,202205,79,64,15,77568,18180,95748
353780,202205,1367,622,745,753867.34,906578.16,1660445.50
353790,202205,490,292,198,353905.13,239978.14,593883.27
353800,202205,3638,1700,1938,2062872.74,2348858.64,4411731.38
353810,202205,235,117,118,143017.08,143016.3,286033.38
353820,202205,247,100,147,121200,178164.6,299364.6
353830,202205,62,50,12,60600.02,14544,75144.02
353850,202205,197,86,111,104232,134532,238764
353860,202205,541,231,310,279972.84,376934.19,656907.03
353870,202205,5727,2896,2831,3509981.87,3436027.69,6946009.56
353880,202205,718,463,255,562373.54,310273.24,872646.78
353890,202205,565,323,242,391479.87,293306.64,684786.51
353900,202205,133,68,65,82416,78780.75,161196.75
353910,202205,195,78,117,94536,141804,236340
353920,202205,442,234,208,283609.18,252097.11,535706.29
353930,202205,1058,618,440,750230.93,533280.8,1283511.73
353940,202205,199,97,102,117564.2,124836,242400.2
353950,202205,496,309,187,375720.57,226644.5,602365.07
353960,202205,72,58,14,70296,16968,87264
353970,202205,40,28,12,33936.2,14544.2,48480.4
353980,202205,1881,828,1053,1004754.6,1276239.86,2280994.46
353990,202205,79,46,33,55752.4,39996,95748.4
354000,202205,383,174,209,210889.97,253308.4,464198.37
354010,202205,91,51,40,61812,48480,110292
354020,202205,511,316,195,382995.7,236341.46,619337.16
354025,202205,36,30,6,36360,7272,43632
354030,202205,43,23,20,27876,24240,52116
354040,202205,100,74,26,89688.1,31512,121200.1
354050,202205,169,89,80,107868.72,96961.05,204829.77
354060,202205,782,358,424,433898.28,515100.36,948998.64
354070,202205,935,532,403,644786.5,489649.74,1134436.24
354075,202205,185,86,99,104232.3,119988.2,224220.5
354080,202205,310,136,174,164833.87,210888,375721.87
354085,202205,21,13,8,15756.72,9696,25452.72
354090,202205,270,162,108,196242.77,130896,327138.77
354100,202205,5966,2420,3546,2934269.89,4301405.28,7235675.17
354105,202205,100,49,51,59388.3,61812,121200.3
354110,202205,40,19,21,23028,25452.2,48480.2
354120,202205,150,97,53,117564,65448.3,183012.3
354130,202205,729,435,294,527224.55,356330.04,883554.59
354140,202205,3305,1468,1837,1784088.14,2232514.86,4016603.00
354150,202205,635,358,277,433899.87,335724.65,769624.52
354160,202205,661,424,237,513899.63,287247.17,801146.80
354165,202205,12,9,3,10908.49,3636,14544.49
354170,202205,176,117,59,141804.27,71508,213312.27
354180,202205,55,32,23,38784,27876.85,66660.85
354190,202205,201,78,123,94536,149076.95,243612.95
354200,202205,113,54,59,65448,71508.4,136956.4
354210,202205,75,32,43,38784,52116,90900
354220,202205,615,388,227,471474.44,275126.7,746601.14
354230,202205,170,73,97,88476.5,117564,206040.5
354240,202205,325,203,122,247250.12,147864,395114.12
354250,202205,80,49,31,59388,37572,96960
354260,202205,2180,1014,1166,1230185,1413197.06,2643382.06
354270,202205,86,59,27,71508,32724,104232
354280,202205,55,29,26,35148,31512,66660
354290,202205,140,94,46,113929.58,55752.1,169681.68
354300,202205,337,236,101,288457.35,122412,410869.35
354310,202205,87,63,24,76356.75,29088,105444.75
354320,202205,216,106,110,128472.2,134532,263004.2
354323,202205,8,8,0,9696,,9696.0
354325,202205,127,66,61,79992.5,73932,153924.5
354330,202205,2477,826,1651,1000947.29,2002228.43,3003175.72
354340,202205,10565,4820,5745,5848912.84,6966595.81,12815508.65
354350,202205,138,91,47,111504,56964,168468
354360,202205,73,43,30,52116.22,36360,88476.22
354370,202205,232,117,115,141804.44,139380,281184.44
354380,202205,176,101,75,122412.4,90900,213312.4
354390,202205,2773,983,1790,1193826.08,2173119.82,3366945.90
354400,202205,321,174,147,210888,178164,389052
354410,202205,671,300,371,363603.54,450866.24,814469.78
354420,202205,276,181,95,219373.68,116352.78,335726.46
354425,202205,329,179,150,217005.42,181800.28,398805.70
354430,202205,181,98,83,118776.2,100596,219372.2
354440,202205,30,24,6,29088.2,7272,36360.2
354450,202205,54,36,18,43632,21816,65448
354460,202205,95,54,41,65448.71,49692.29,115141.00
354470,202205,28,14,14,16968,16968.35,33936.35
354480,202205,109,59,50,71508.8,60600.15,132108.95
354490,202205,131,76,55,92113.3,66660,158773.3
354500,202205,410,185,225,224220,272701,496921
354510,202205,90,61,29,73932.2,35148.2,109080.4
354515,202205,47,15,32,18180.2,38784,56964.2
354520,202205,1620,682,938,826414.99,1138069.39,1964484.38
354530,202205,864,422,442,511467.91,536916.56,1048384.47
354540,202205,260,131,129,158772.68,157560,316332.68
354550,202205,42,22,20,26664.82,24240,50904.82
354560,202205,154,84,70,101808.1,84840,186648.1
354570,202205,137,92,45,111504,54540,166044
354580,202205,1880,880,1000,1067777.35,1213213.07,2280990.42
354600,202205,277,135,142,163620.44,172104,335724.44
354610,202205,65,53,12,64236.96,14544,78780.96
354620,202205,67,19,48,23028,58176,81204
354625,202205,12,8,4,9696.74,4848,14544.74
354630,202205,334,219,115,265430.12,139380.6,404810.72
354640,202205,840,500,340,607213.22,413292.62,1020505.84
354650,202205,65,38,27,46056.18,32724,78780.18
354660,202205,819,596,223,722359.3,270276.2,992635.5
354670,202205,219,82,137,99384.6,166044,265428.6
354680,202205,1346,470,876,569643.79,1061714.61,1631358.40
354690,202205,73,48,25,58177.57,30300.7,88478.27
354700,202205,76,55,21,66660,25452,92112
354710,202205,49,35,14,42420,16968,59388
354720,202205,20,18,2,21816.86,2424,24240.86
354730,202205,1812,730,1082,885973.2,1311385.76,2197358.96
354740,202205,72,49,23,59388,27876,87264
354750,202205,413,231,182,279973.36,220585.64,500559.00
354760,202205,510,311,199,378151.77,242402.74,620554.51
354765,202205,6,2,4,2424,4848,7272
354770,202205,349,222,127,269065.73,153925.06,422990.79
354780,202205,8530,3161,5369,3833579.47,6520568.82,10354148.29
354790,202205,86,51,35,61812,42420,104232
354800,202205,438,235,203,284772.07,246036.82,530808.89
354805,202205,77,35,42,42420,50904.68,93324.68
354810,202205,96,53,43,64236,52116,116352
354820,202205,212,84,128,101808.72,155137.44,256946.16
354830,202205,40,21,19,25452,23028,48480
354840,202205,55,39,16,48480,19392,67872
354850,202205,4620,2010,2610,2436138.07,3173022.27,5609160.34
354860,202205,333,154,179,186648,216948.2,403596.2
354870,202205,12207,5228,6979,6342444.22,8462199.85,14804644.07
354880,202205,2698,975,1723,1184129.22,2091975.5,3276104.72
354890,202205,2983,1552,1431,1883470.89,1734376.84,3617847.73
354900,202205,63,44,19,53328.19,23028,76356.19
354910,202205,1284,648,636,785385.64,772045.04,1557430.68
354920,202205,39,32,7,38784,8484,47268
354925,202205,21,10,11,12120,13332,25452
354930,202205,32,28,4,33936.4,4848,38784.4
354940,202205,766,532,234,644789.08,283610.14,928399.22
354950,202205,208,128,80,155137.85,96961.15,252099.00
354960,202205,132,51,81,61812.2,98172,159984.2
354970,202205,1121,759,362,919925.6,438745.87,1358671.47
354980,202205,9445,3364,6081,4078424.66,7381099.51,11459524.17
354990,202205,10271,4471,5800,5423730.98,7032038.82,12455769.80
354995,202205,589,190,399,230281.22,484802.08,715083.30
355000,202205,455,158,297,191497.33,359964.1,551461.43
355010,202205,615,378,237,458142.23,288460.09,746602.32
355020,202205,798,494,304,598732.02,369661.24,968393.26
355030,202205,215597,79772,135825,96761753.69,164779077.08,261540830.77
355040,202205,947,458,489,555101.51,592670.47,1147771.98
355050,202205,170,92,78,111504.58,94536,206040.58
355060,202205,1782,847,935,1026570.93,1134434.34,2161005.27
355070,202205,1609,711,898,861737.1,1088383,1950120.1
355080,202205,198,117,81,141804,98172,239976
355090,202205,306,182,124,220585.92,151501,372086.92
355100,202205,5406,2515,2891,3049293.75,3506322.88,6555616.63
355110,202205,230,149,81,180588,98172,278760
355120,202205,57,35,22,42420.2,26664,69084.2
355130,202205,53,29,24,35148.2,29088,64236.2
355140,202205,195,115,80,139380.07,98172.18,237552.25
355150,202205,691,405,286,492075.44,346632.34,838707.78
355160,202205,486,233,253,282398.5,306637.72,589036.22
355170,202205,2101,1076,1025,1306549.17,1243515,2550064.17
355180,202205,696,269,427,326029.14,517524.4,843553.54
355190,202205,225,154,71,186649.17,86053.28,272702.45
355200,202205,115,56,59,67872.55,71508.6,139381.15
355210,202205,710,382,328,462984.62,397536.3,860520.92
355220,202205,7732,3696,4036,4488071.97,4896498.14,9384570.11
355230,202205,95,53,42,64236,50904,115140
355240,202205,4687,1877,2810,2276149.48,3408152.32,5684301.80
355250,202205,6757,2945,3812,3574246.42,4622574.99,8196821.41
355255,202205,49,31,18,37572,21816,59388
355260,202205,187,105,82,127262.34,99384,226646.34
355270,202205,158,99,59,119988.6,72720,192708.6
355280,202205,7059,2608,4451,3164548.67,5399470.17,8564018.84
355290,202205,70,54,16,65448,19392,84840
355300,202205,231,131,100,158772.86,121200.41,279973.27
355310,202205,111,58,53,70296,66660,136956
355320,202205,94,47,47,56964.2,56964,113928.2
355330,202205,317,184,133,224221.9,161198.05,385419.95
355340,202205,1403,492,911,596313.67,1104145.26,1700458.93
355350,202205,165,80,85,96960,103020,199980
355360,202205,167,108,59,130897.4,71508,202405.4
355365,202205,18,13,5,15756,6060,21816
355370,202205,1023,607,416,738119.72,507829.08,1245948.80
355380,202205,832,511,321,620550.34,389053.17,1009603.51
355385,202205,87,58,29,70296.15,35148.2,105444.35
355390,202205,109,56,53,67872,64236,132108
355395,202205,194,102,92,123624.98,111504,235128.98
355400,202205,1782,1018,764,1233725.17,928393.05,2162118.22
355410,202205,5119,2313,2806,2805805.88,3403300.13,6209106.01
355420,202205,44,31,13,37572,15756,53328
355430,202205,414,249,165,301792.18,199981.53,501773.71
355440,202205,87,50,37,60600,44844,105444
355450,202205,445,220,225,266640.2,272701.82,539342.02
355460,202205,59,44,15,53328.69,18180,71508.69
355465,202205,51,30,21,36360,25452,61812
355470,202205,192,76,116,92112.8,140593.13,232705.93
355475,202205,8,6,2,7272.2,2424,9696.2
355480,202205,616,244,372,295733.34,452076.17,747809.51
355490,202205,110,77,33,93324.5,39996,133320.5
355495,202205,84,29,55,35148,66660.2,101808.2
355500,202205,1595,847,748,1026576.91,906578.47,1933155.38
355510,202205,271,191,80,232708.76,96960.4,329669.16
355520,202205,28,21,7,25452,8484,33936
355530,202205,24,12,12,14544,14544,29088
355535,202205,75,32,43,38784,52116,90900
355540,202205,2748,1073,1675,1300655.62,2030105.02,3330760.64
355550,202205,62,36,26,43632,31512,75144
355560,202205,247,111,136,134533.26,164832,299365.26
355570,202205,13,9,4,10908,4848,15756
355580,202205,241,161,80,195132.2,96960.6,292092.8
355590,202205,18,11,7,13332,8484,21816
355600,202205,271,132,139,159984,168468.3,328452.3
355610,202205,238,147,91,178166.24,110293.13,288459.37
355620,202205,1302,567,735,688426.62,892032.2,1580458.82
355630,202205,417,298,119,361178.77,144228.59,505407.36
355635,202205,125,52,73,64236,88476.79,152712.79
355640,202205,565,297,268,359965.1,326028.94,685994.04
355645,202205,905,324,581,392688.6,705386.05,1098074.65
355650,202205,1913,815,1098,989001.58,1331988.42,2320990.00
355660,202205,233,122,111,147864.18,134532,282396.18
355670,202205,641,270,371,327240.2,450864,778104.2
355680,202205,197,109,88,132108.4,106656.98,238765.38
355690,202205,93,46,47,55752,56964,112716
355695,202205,27,17,10,20604,12120,32724
355700,202205,1221,615,606,746596.71,734475.39,1481072.10
355710,202205,2288,1242,1046,1505330.45,1268965.22,2774295.67
355715,202205,16,14,2,16968,2424,19392
355720,202205,256,159,97,192708.36,117564,310272.36
355730,202205,105,62,43,75144.2,52116,127260.2
410010,202205,130,102,28,123624.6,33936,157560.6
410020,202205,116,84,32,101808,38784,140592
410030,202205,164,90,74,109080.24,89688,198768.24
410040,202205,1355,649,706,787800.86,855675.28,1643476.14
410045,202205,46,34,12,41208,14544,55752
410050,202205,517,296,221,358753.01,267852,626605.01
410060,202205,286,205,81,249673.31,98172.2,347845.51
410070,202205,289,244,45,295729.51,54540.2,350269.71
410080,202205,182,109,73,132108.1,88476,220584.1
410090,202205,60,50,10,60601,12120,72721
410100,202205,260,166,94,201192.2,113928,315120.2
410105,202205,50,29,21,35148,25452,60600
410110,202205,345,211,134,255732.24,162408.7,418140.94
410115,202205,47,30,17,36360.2,20604,56964.2
410120,202205,451,207,244,250884.96,295729.55,546614.51
410130,202205,60,32,28,38784,33936,72720
410140,202205,3217,1446,1771,1752557.29,2146459.75,3899017.04
410150,202205,2700,1075,1625,1304121.46,1970716.98,3274838.44
410160,202205,485,278,207,336936.2,252096,589032.2
410165,202205,50,29,21,35148,25452,60600
410170,202205,209,126,83,152712.2,100596,253308.2
410180,202205,2329,1239,1090,1501678.48,1321086.23,2822764.71
410185,202205,35,29,6,35148,7272,42420
410190,202205,487,309,178,374509.26,215736,590245.26
410200,202205,991,702,289,850828.41,350268.1,1201096.51
410210,202205,633,326,307,395113.81,372084.36,767198.17
410220,202205,49,20,29,24240,35148,59388
410230,202205,182,80,102,96960,123624.4,220584.4
410240,202205,731,463,268,561159.94,324816.6,885976.54
410250,202205,381,263,118,319968.05,144228.78,464196.83
410260,202205,301,165,136,199980.59,164832.2,364812.79
410270,202205,30,22,8,26664,9696,36360
410275,202205,61,45,16,54540,19392,73932
410280,202205,320,187,133,226644.79,162408,389052.79
410290,202205,289,162,127,196344.71,153924.5,350269.21
410300,202205,89,55,34,66660,41208,107868
410302,202205,25,13,12,15756,14544,30300
410304,202205,40,27,13,32724,15756,48480
410305,202205,224,128,96,155136,117564.2,272700.2
410310,202205,187,109,78,132108,94536,226644
410315,202205,43,32,11,38784,13332,52116
410320,202205,137,92,45,111504,54540,166044
410322,202205,35,22,13,26664,15756,42420
410330,202205,173,113,60,136956.1,72720,209676.1
410335,202205,99,53,46,64236,55752,119988
410337,202205,43,33,10,39996,12120,52116
410340,202205,38,31,7,37572.2,8484,46056.2
410345,202205,195,114,81,138168.6,98172,236340.6
410347,202205,45,33,12,39996.44,14544,54540.44
410350,202205,256,148,108,179376.32,130896.82,310273.14
410360,202205,447,272,175,329666.48,212100.93,541767.41
410370,202205,2362,990,1372,1199886.34,1666503.64,2866389.98
410380,202205,197,113,84,136956,101808.2,238764.2
410390,202205,407,263,144,319969.74,174528,494497.74
410395,202205,33,21,12,25452,14544,39996
410400,202205,879,371,508,449653.86,616911.42,1066565.28
410405,202205,79,61,18,73932.4,21816,95748.4
410410,202205,24,16,8,19392.91,9696,29088.91
410420,202205,1768,793,975,961011.01,1181703.14,2142714.15
410425,202205,192,79,113,95748.1,136956,232704.1
410430,202205,2359,1228,1131,1488782.71,1370774.1,2859556.81
410440,202205,355,250,105,304212,127260,431472
410442,202205,361,219,142,265429.33,172104.2,437533.53
410445,202205,416,286,130,346632.2,158772.49,505404.69
410450,202205,390,184,206,223008,249672,472680
410460,202205,556,288,268,349056.94,324816,673872.94
410465,202205,261,139,122,168468.1,147864.6,316332.7
410470,202205,276,151,125,183012,151500.45,334512.45
410480,202205,6670,3196,3474,3875995.51,4220199.12,8096194.63
410490,202205,1434,805,629,976877.54,762352.21,1739229.75
410500,202205,276,156,120,189072.1,145440.5,334512.6
410510,202205,187,139,48,168469.3,58176.55,226645.85
410520,202205,272,189,83,229068,100596.2,329664.2
410530,202205,297,93,204,112716.51,247248,359964.51
410540,202205,340,248,92,300576.24,111504.1,412080.34
410550,202205,1713,705,1008,855672.7,1224122.98,2079795.68
410560,202205,167,111,56,134532,67872,202404
410570,202205,445,291,154,353904.88,187860.97,541765.85
410580,202205,3733,1541,2192,1867697.58,2657923.05,4525620.63
410590,202205,428,275,153,333281.07,185436.2,518717.27
410600,202205,196,170,26,206040.2,31512,237552.2
410610,202205,50,40,10,48480,12120,60600
410620,202205,271,172,99,208465.65,119989.61,328455.26
410630,202205,449,247,202,299365.36,244824,544189.36
410640,202205,1065,655,410,793864.14,496921.71,1290785.85
410645,202205,114,83,31,100597.5,37572,138169.5
410650,202205,374,225,149,272701,180588.69,453289.69
410655,202205,87,63,24,76356,29088.58,105444.58
410657,202205,37,14,23,16968,27876,44844
410660,202205,641,430,211,521163.35,256946.57,778109.92
410670,202205,80,64,16,77568,19392,96960
410680,202205,188,153,35,185436,42420,227856
410685,202205,26,17,9,20604,10908,31512
410690,202205,28887,11839,17048,14362248.68,20693751.92,35056000.60
410700,202205,324,235,89,284821.05,107868,392689.05
410710,202205,128,104,24,126048,29088.2,155136.2
410712,202205,44,31,13,37572,15756,53328
410715,202205,96,69,27,83628.2,32724,116352.2
410720,202205,650,366,284,444805.31,345420.15,790225.46
410725,202205,191,135,56,163620.56,67872,231492.56
410730,202205,104,46,58,55752.75,70296,126048.75
410740,202205,96,69,27,83628,32724,116352
410750,202205,283,188,95,227857.23,115140,342997.23
410752,202205,20,13,7,15756,8484,24240
410753,202205,61,23,38,27876,46056,73932
410754,202205,53,26,27,31512,32724,64236
410755,202205,77,42,35,50904,42420,93324
410760,202205,770,412,358,499346.3,433897.34,933243.64
410765,202205,1904,845,1059,1025357.51,1283515.37,2308872.88
410770,202205,118,84,34,101808.61,41208.48,143017.09
410773,202205,65,44,21,53328.13,25452,78780.13
410775,202205,177,129,48,156348.37,58176.5,214524.87
410780,202205,85,46,39,55752,47268,103020
410785,202205,52,43,9,52116,10908,63024
410790,202205,88,38,50,46056,60600,106656
410800,202205,285,177,108,214524.4,130896.65,345421.05
410810,202205,28,14,14,16968.16,16968.6,33936.76
410820,202205,154,108,46,130896,55752.2,186648.2
410830,202205,9167,3801,5366,4606832.06,6506027.69,11112859.75
410832,202205,117,75,42,90900.24,50904,141804.24
410840,202205,1444,767,677,929606.63,820526.4,1750133.03
410845,202205,50,28,22,33936.2,26664,60600.2
410850,202205,164,119,45,144230.03,54540,198770.03
410855,202205,72,63,9,76356.32,10908.4,87264.72
410860,202205,805,407,398,493286.05,482377.3,975663.35
410865,202205,94,65,29,78780.93,35148,113928.93
410870,202205,143,117,26,141804,31512,173316
410880,202205,1186,583,603,706600.21,733260.5,1439860.71
410890,202205,99,64,35,77569.07,42420,119989.07
410895,202205,77,57,20,69084,24240,93324
410900,202205,32,24,8,29088,9696,38784
410910,202205,14,8,6,9696,7272,16968
410920,202205,44,29,15,35148,18180,53328
410930,202205,554,333,221,403596.2,267852,671448.2
410940,202205,4478,2300,2178,2788834.6,2644596.72,5433431.32
410950,202205,102,77,25,93324.22,30300.2,123624.42
410960,202205,913,345,568,418143.76,689631.31,1107775.07
410965,202205,63,41,22,49692,26664,76356
410970,202205,612,413,199,500558,241188.25,741746.25
410975,202205,122,75,47,90900.13,56964,147864.13
410980,202205,1647,735,912,890827.69,1108982.58,1999810.27
410990,202205,276,201,75,243612.2,90900,334512.2
411000,202205,64,35,29,42420,35148.6,77568.6
411005,202205,34,27,7,32724,8484,41208
411007,202205,250,141,109,170892,132108,303000
411010,202205,606,393,213,477530.29,259368.49,736898.78
411020,202205,287,179,108,216949.39,130896.86,347846.25
411030,202205,23,12,11,14544,13332,27876
411040,202205,58,37,21,44844,25452,70296
411050,202205,221,153,68,185436,82416,267852
411060,202205,542,362,180,438746.75,218161.83,656908.58
411065,202205,45,41,4,49692.6,4848,54540.6
411070,202205,1293,734,559,890823.67,677509.67,1568333.34
411080,202205,243,171,72,207252,87264,294516
411090,202205,91,67,24,81204,29088,110292
411095,202205,343,119,224,144228,272700,416928
411100,202205,110,86,24,104232.93,29088,133320.93
411110,202205,137,81,56,98172,67872,166044
411120,202205,202,131,71,158772,86052,244824
411125,202205,312,148,164,180588.6,198770.44,379359.04
411130,202205,118,99,19,119988.34,23028,143016.34
411140,202205,209,144,65,174528,78780,253308
411150,202205,1254,801,453,974450.11,549038.3,1523488.41
411155,202205,120,83,37,100596,44844,145440
411160,202205,32,13,19,15756,23028,38784
411170,202205,51,46,5,55752,6060,61812
411180,202205,1002,653,349,793866.35,422988.96,1216855.31
411190,202205,339,183,156,221796,189072,410868
411200,202205,666,374,292,454502.09,355116.71,809618.80
411210,202205,691,351,340,425412.1,412080.25,837492.35
411220,202205,159,111,48,134532.97,58176,192708.97
411230,202205,38,30,8,36360,9696.1,46056.1
411240,202205,116,70,46,84840,55752,140592
411250,202205,425,307,118,372084,143016,515100
411260,202205,14,10,4,12120,4848,16968
411270,202205,267,135,132,163621.14,161196.88,324818.02
411275,202205,186,158,28,191496.45,33936,225432.45
411280,202205,201,143,58,174528.97,70296,244824.97
411290,202205,69,56,13,67872,15756,83628
411295,202205,123,95,28,115140,33936,149076
411300,202205,80,38,42,46056,50904,96960
411310,202205,96,68,28,82416,33936,116352
411320,202205,819,512,307,621759.15,372084.8,993843.95
411325,202205,63,44,19,53328,23028,76356
411330,202205,891,570,321,693273.06,390265.92,1083538.98
411340,202205,35,24,11,29088,13332,42420
411342,202205,61,45,16,54540,19392,73932
411345,202205,102,48,54,58176.1,65448,123624.1
411350,202205,511,381,130,462986.6,157560.6,620547.2
411360,202205,59,39,20,47268.2,24240,71508.2
411370,202205,14004,5627,8377,6826018.31,10168703.17,16994721.48
411373,202205,179,118,61,144228,73932,218160
411375,202205,78,63,15,76356,18180,94536
411380,202205,77,53,24,64237.2,29088.2,93325.4
411390,202205,143,77,66,93324,79992,173316
411400,202205,419,274,145,332089.95,175740,507829.95
411410,202205,504,233,271,282396.9,329665.68,612062.58
411420,202205,975,398,577,482378.74,699324.74,1181703.48
411430,202205,524,282,242,341787.11,293305.8,635092.91
411435,202205,28,17,11,20604,13332.97,33936.97
411440,202205,473,372,101,450864.8,122412,573276.8
411450,202205,396,330,66,399961.25,79992,479953.25
411460,202205,812,302,510,366025.07,618120.37,984145.44
411470,202205,107,74,33,89688.91,39996,129684.91
411480,202205,707,363,344,439958.32,416929.65,856887.97
411490,202205,280,170,110,206040,133320.6,339360.6
411500,202205,99,79,20,95748,24240,119988
411510,202205,230,178,52,215736.21,63024,278760.21
411520,202205,6241,2125,4116,2576720.32,4995872.1,7572592.42
411530,202205,120,78,42,94536,50904,145440
411535,202205,48,14,34,16968,41208,58176
411540,202205,375,251,124,304212.4,150288.2,454500.6
411545,202205,60,43,17,52116.2,20604,72720.2
411550,202205,93,70,23,84840,27876,112716
411560,202205,401,161,240,195132,290880,486012
411570,202205,957,321,636,389052.86,770834.51,1159887.37
411573,202205,24,16,8,19392.2,9696,29088.2
411575,202205,322,195,127,236340.63,153924,390264.63
411580,202205,1247,446,801,540553.77,970812.95,1511366.72
411585,202205,72,36,36,43632,43632,87264
411590,202205,18,12,6,14544,7272,21816
411600,202205,21,9,12,10908,14544.1,25452.1
411605,202205,248,90,158,109080,191496,300576
411610,202205,236,146,90,176953.11,109080.2,286033.31
411620,202205,387,182,205,220586.37,248461.31,469047.68
411630,202205,47,32,15,38784,18180,56964
411640,202205,33,23,10,27876,12120,39996
411650,202205,8,5,3,6060,3636,9696
411660,202205,42,30,12,36360,14544,50904
411670,202205,247,174,73,210889.62,88476,299365.62
411680,202205,156,126,30,152712.1,36360,189072.1
411690,202205,618,320,298,387841.36,361176,749017.36
411695,202205,66,47,19,58176,23028,81204
411700,202205,139,111,28,134532.2,35148.1,169680.3
411705,202205,99,65,34,78780.2,41208,119988.2
411710,202205,299,198,101,241188.2,123624.2,364812.4
411720,202205,148,96,52,116352,63024,179376
411721,202205,89,71,18,86052,21816,107868
411722,202205,105,49,56,59388,67872,127260
411725,202205,170,123,47,149076,58176.72,207252.72
411727,202205,101,80,21,96960.2,25452.2,122412.4
411729,202205,50,36,14,43632.2,16968,60600.2
411730,202205,563,354,209,429048.05,253309.42,682357.47
411740,202205,30,18,12,21816,14544,36360
411745,202205,66,51,15,61812,18180,79992
411750,202205,847,349,498,422988.53,603576.2,1026564.73
411760,202205,1252,891,361,1079905.89,438748.61,1518654.50
411770,202205,431,279,152,338149.13,184225.6,522374.73
411780,202205,372,240,132,290880.5,161196,452076.5
411790,202205,594,337,257,408444.6,311484,719928.6
411800,202205,152,110,42,133320.75,50904.38,184225.13
411810,202205,177,134,43,162408.8,52116.2,214525.0
411820,202205,2475,984,1491,1192616.84,1808319.86,3000936.70
411830,202205,15,13,2,15756,2424,18180
411840,202205,2166,1278,888,1551364.67,1078682.36,2630047.03
411845,202205,64,21,43,25452,52116,77568
411850,202205,1260,676,584,820528.85,709022.51,1529551.36
411860,202205,52,30,22,36360.6,26664,63024.6
411870,202205,66,40,26,49692,31512,81204
411880,202205,425,247,178,299365.23,215736,515101.23
411885,202205,112,70,42,84840.2,50904.1,135744.3
411890,202205,317,217,100,263005.39,122412,385417.39
411900,202205,107,77,30,93324,36360,129684
411910,202205,195,139,56,168468.56,67872.8,236341.36
411915,202205,2417,945,1472,1146555.95,1784069.44,2930625.39
411920,202205,109,83,26,100597.64,31512,132109.64
411925,202205,16,9,7,10908,8484,19392
411930,202205,787,541,246,658198.17,298153.99,956352.16
411940,202205,603,377,226,456925.28,273912.26,730837.54
411950,202205,1194,539,655,654483.17,793866.37,1448349.54
411960,202205,1147,719,428,872641.72,518736.3,1391378.02
411965,202205,24,15,9,18180,10908.52,29088.52
411970,202205,90,76,14,92112.6,16968,109080.6
411980,202205,214,115,99,139380,119988,259368
411990,202205,5218,2780,2438,3371450.26,2957376.65,6328826.91
411995,202205,596,176,420,213312,509044.14,722356.14
412000,202205,327,213,114,258158.85,138168.45,396327.30
412010,202205,52,27,25,32724.1,30300,63024.1
412015,202205,37,30,7,36360.1,8484,44844.1
412020,202205,21,16,5,19392,6060,25452
412030,202205,35,32,3,38784,4848,43632
412033,202205,50,27,23,32724,27876,60600
412035,202205,70,44,26,53328,31512,84840
412040,202205,35,15,20,18180.6,24240,42420.6
412050,202205,216,160,56,193920.2,67872.97,261793.17
412060,202205,797,568,229,689631.44,277549.06,967180.50
412065,202205,52,29,23,35148,27876,63024
412070,202205,163,113,50,136956,60600.92,197556.92
412080,202205,330,154,176,186648.1,213313.1,399961.2
412085,202205,38,14,24,16968,29088,46056
412090,202205,854,522,332,632665.73,402384.78,1035050.51
412100,202205,262,219,43,265430.6,53328.6,318759.2
412110,202205,71,54,17,65448.8,20604,86052.8
412120,202205,346,184,162,224220.28,197556,421776.28
412125,202205,67,40,27,48480.2,32724,81204.2
412130,202205,48,30,18,36360.84,21816,58176.84
412135,202205,29,17,12,20604,14544,35148
412140,202205,440,282,158,342996.6,191497.19,534493.79
412150,202205,240,153,87,185436,105444.9,290880.9
412160,202205,82,53,29,64236,35148,99384
412170,202205,719,476,243,576912.75,294516.08,871428.83
412175,202205,37,27,10,32724.25,12120,44844.25
412180,202205,167,124,43,152712.96,52116,204828.96
412190,202205,331,251,80,304214.89,96960,401174.89
412200,202205,194,117,77,141804,93324,235128
412210,202205,96,71,25,86052,30300,116352
412215,202205,237,160,77,193920.4,94536.5,288456.9
412217,202205,66,53,13,64236.17,15756,79992.17
412220,202205,840,551,289,667815.9,350271.1,1018087.0
412230,202205,287,169,118,204828.68,143017.46,347846.14
412240,202205,1347,661,686,801137.09,832646.29,1633783.38
412250,202205,406,250,156,303000.86,189072,492072.86
412260,202205,127,81,46,98172.91,55752,153924.91
412265,202205,170,129,41,156348,49692,206040
412270,202205,90,56,34,67872,41208.37,109080.37
412280,202205,86,68,18,82416,21816,104232
412290,202205,88,55,33,66660,39996,106656
412300,202205,201,142,59,172104.85,71508,243612.85
412310,202205,53,41,12,49692.2,14544,64236.2
412320,202205,89,69,20,83628.95,24240,107868.95
412330,202205,189,149,40,180588.2,48480,229068.2
412340,202205,175,115,60,139380,72720,212100
412350,202205,650,293,357,356328.08,432684.4,789012.48
412360,202205,23,20,3,24240,3636,27876
412370,202205,145,123,22,149076.2,26664,175740.2
412380,202205,198,149,49,180588.2,59388,239976.2
412382,202205,65,34,31,41208,37572,78780
412385,202205,151,108,43,130896.2,52116,183012.2
412390,202205,318,239,79,289669.33,95748.98,385418.31
412395,202205,64,51,13,61812,15756,77568
412400,202205,99,65,34,78781.42,41208,119989.42
412402,202205,233,120,113,145441.28,138168.6,283609.88
412405,202205,968,318,650,385416.84,789012,1174428.84
412410,202205,969,576,393,698739.77,476318.05,1175057.82
412420,202205,16,16,0,19392,,19392.0
412430,202205,24,22,2,26664,2424,29088
412440,202205,660,329,331,398749.7,401172.25,799921.95
412450,202205,72,62,10,75144,12120,87264
412460,202205,91,67,24,81204.8,29088,110292.8
412470,202205,213,167,46,202406.47,55752,258158.47
412480,202205,152,107,45,129684.91,54540.2,184225.11
412490,202205,168,144,24,174528,29088,203616
412500,202205,407,322,85,390266.01,103020,493286.01
412510,202205,164,135,29,163621.75,35148,198769.75
412520,202205,88,57,31,69084,37572,106656
412530,202205,104,50,54,61812.2,65448,127260.2
412535,202205,83,64,19,77568.98,23028,100596.98
412540,202205,85,40,45,48480,54540.8,103020.8
412545,202205,81,54,27,65448,32724,98172
412550,202205,4092,1651,2441,2001019.49,2960925.24,4961944.73
412555,202205,10,6,4,7272,4848,12120
412560,202205,657,437,220,529647.09,266640,796287.09
412570,202205,819,386,433,467832.2,524796.9,992629.1
412575,202205,92,64,28,77568.17,33936,111504.17
412580,202205,175,116,59,140592.9,71508,212100.9
412590,202205,34,29,5,35148.4,6060,41208.4
412600,202205,186,128,58,156349.73,70296,226645.73
412610,202205,41,19,22,23028,26664,49692
412620,202205,130,107,23,129685.47,27876.98,157562.45
412625,202205,2107,1019,1088,1235032.55,1318658.92,2553691.47
412627,202205,66,50,16,60600,19392,79992
412630,202205,380,253,127,306638.43,153924.32,460562.75
412635,202205,76,22,54,26664,65448,92112
412640,202205,109,75,34,90900,41208,132108
412650,202205,318,209,109,254520.8,132108.19,386628.99
412660,202205,453,264,189,319968,229068,549036
412665,202205,43,39,4,47268,4848,52116
412667,202205,285,184,101,224220.66,122412,346632.66
412670,202205,71,57,14,69084,16968,86052
412680,202205,322,245,77,299364.8,93324.12,392688.92
412690,202205,119,77,42,93324.1,50904,144228.1
412700,202205,193,125,68,151500,82416,233916
412710,202205,1351,760,591,921125.49,716294.21,1637419.70
412720,202205,232,128,104,155136,126048,281184
412730,202205,203,172,31,208464.69,37572,246036.69
412740,202205,411,209,202,253308.85,244824.2,498133.05
412750,202205,420,229,191,277549.29,231492.92,509042.21
412760,202205,347,174,173,210888.6,210888.6,421777.2
412770,202205,2116,1133,983,1373201.97,1193822.88,2567024.85
412780,202205,144,107,37,129684.97,44844,174528.97
412785,202205,317,160,157,193920,190284,384204
412788,202205,48,27,21,32724.82,25452,58176.82
412790,202205,124,100,24,121200.58,29088,150288.58
412795,202205,149,101,48,122412,58176,180588
412796,202205,295,182,113,220584.4,136956,357540.4
412800,202205,680,396,284,479953.3,345420.66,825373.96
412810,202205,3099,1677,1422,2032544.91,1724679.49,3757224.40
412820,202205,964,567,397,687208.71,481167.8,1168376.51
412830,202205,12,11,1,13332,1212,14544
412840,202205,261,175,86,213312,104232,317544
412850,202205,683,425,258,515102,312696.4,827798.4
412853,202205,167,77,90,93324,109080,202404
412855,202205,202,110,92,133320.91,111504,244824.91
412860,202205,96,62,34,75144.4,41208.3,116352.7
412862,202205,78,49,29,59388,35148,94536
412863,202205,9,6,3,7272,3636,10908
412865,202205,42,31,11,37572,13332,50904
412870,202205,111,68,43,82416.2,52116.2,134532.4
412880,202205,92,64,28,77569.93,33936,111505.93
420005,202205,43,36,7,43632.2,8484,52116.2
420010,202205,362,238,124,288456.55,150288.19,438744.74
420020,202205,95,74,21,89688,25452,115140
420030,202205,27,22,5,26664,6060,32724
420040,202205,92,69,23,83628.4,27876,111504.4
420050,202205,58,37,21,44844.88,25452,70296.88
420055,202205,18,16,2,19392,2424,21816
420060,202205,26,19,7,23028,8484,31512
420070,202205,99,84,15,101808,18180,119988
420075,202205,10,10,0,12120,,12120.0
420080,202205,43,37,6,44844,7272,52116
420090,202205,40,31,9,37572.66,10908,48480.66
420100,202205,147,124,23,150288.3,27876,178164.3
420110,202205,22,22,0,26664,,26664.0
420120,202205,56,40,16,48480.2,19392,67872.2
420125,202205,90,71,19,86052,23028,109080
420127,202205,34,29,5,35148,6060,41208
420130,202205,467,282,185,342998.46,224221.56,567220.02
420140,202205,1327,731,596,887188.63,722355.15,1609543.78
420150,202205,46,33,13,39996,15756,55752
420160,202205,32,29,3,35148,3636,38784
420165,202205,17,12,5,14544,6060,20604
420170,202205,68,41,27,49692,32724,82416
420180,202205,22,18,4,21816,4848,26664
420190,202205,26,23,3,27876,3636,31512
420195,202205,140,61,79,73932.2,95749.06,169681.26
420200,202205,1323,558,765,676300.18,928394.34,1604694.52
420205,202205,105,62,43,75144.26,52116.32,127260.58
420207,202205,140,76,64,92112,77568,169680
420208,202205,19,15,4,18180,4848,23028
420209,202205,13,11,2,13332,2424,15756
420210,202205,570,265,305,321180.44,369660.58,690841.02
420213,202205,53,41,12,49692,14544,64236
420215,202205,27,23,4,27876,4848,32724
420220,202205,59,36,23,43632.6,27876,71508.6
420230,202205,949,570,379,690843.82,459348.7,1150192.52
420240,202205,2304,1516,788,1838608.9,956271.08,2794879.98
420243,202205,44,34,10,41208.1,12120,53328.1
420245,202205,200,95,105,115140.5,127260.5,242401.0
420250,202205,62,42,20,50904.2,25452,76356.2
420253,202205,26,20,6,24240.4,7272,31512.4
420257,202205,13,9,4,10908,4848,15756
420260,202205,115,92,23,111504.98,27876,139380.98
420270,202205,30,23,7,27876.2,8484,36360.2
420280,202205,273,205,68,248462.7,82417.37,330880.07
420285,202205,25,19,6,23028,7272,30300
420287,202205,51,34,17,41208.7,20604,61812.7
420290,202205,925,631,294,765984.2,357540.05,1123524.25
420300,202205,1547,1226,321,1485924.98,391479.65,1877404.63
420310,202205,47,33,14,39996.2,16968,56964.2
420315,202205,29,24,5,29088.68,6060,35148.68
420320,202205,1012,465,547,564795.46,662965.77,1227761.23
420325,202205,4,1,3,1212,3636,4848
420330,202205,117,76,41,92112,49692,141804
420340,202205,186,124,62,150288.8,75144.18,225432.98
420350,202205,248,171,77,207254.24,93324.19,300578.43
420360,202205,699,537,162,650848.14,196344.2,847192.34
420370,202205,134,72,62,87264,76356,163620
420380,202205,1210,827,383,1004755.02,464197.24,1468952.26
420390,202205,231,159,72,192708.14,87264,279972.14
420395,202205,188,139,49,168468.15,59388,227856.15
420400,202205,231,177,54,214525.91,65448.2,279974.11
420410,202205,55,39,16,47268.1,19392,66660.1
420415,202205,35,29,6,35148,7272,42420
420417,202205,54,42,12,50904,14544,65448
420419,202205,11,10,1,12120,1212,13332
420420,202205,2835,1755,1080,2128283.36,1310174.37,3438457.73
420425,202205,66,51,15,61812.95,18180,79992.95
420430,202205,1056,761,295,922334.4,358752,1281086.4
420435,202205,14,12,2,14544,2424,16968
420440,202205,94,66,28,79992.6,33936,113928.6
420445,202205,31,28,3,33936.1,3636,37572.1
420450,202205,86,45,41,54540.2,49692,104232.2
420455,202205,186,144,42,174529.47,50904,225433.47
420460,202205,2337,1452,885,1759834.48,1072623.22,2832457.70
420470,202205,88,61,27,73932,32724,106656
420475,202205,10,9,1,10908,1212,12120
420480,202205,878,664,214,804775.95,259369.54,1064145.49
420490,202205,95,72,23,87264.2,27876,115140.2
420500,202205,414,233,181,282397.12,219372.2,501769.32
420510,202205,25,22,3,26664,3636,30300
420515,202205,28,15,13,18180.98,15756,33936.98
420517,202205,7,6,1,7272,1212,8484
420519,202205,0,,,,,0.0
420520,202205,62,48,14,58176,18180,76356
420530,202205,144,92,52,111504,63024,174528
420535,202205,15,13,2,15756,2424,18180
420540,202205,6298,3917,2381,4753801.87,2885783.61,7639585.48
420543,202205,30,28,2,33936,2424,36360
420545,202205,209,145,64,175740.5,77568,253308.5
420550,202205,783,649,134,787808.72,162408.27,950216.99
420555,202205,27,20,7,24240,8484,32724
420560,202205,56,45,11,54540,13332,67872
420570,202205,187,95,92,115140.95,111504.2,226645.15
420580,202205,301,147,154,179376,186648.6,366024.6
420590,202205,482,310,172,375720.85,208464.15,584185.00
420600,202205,144,78,66,94536,79992,174528
420610,202205,37,34,3,41208,3636,44844
420620,202205,79,57,22,69084,26664,95748
420630,202205,153,101,52,122412.1,63024,185436.1
420640,202205,67,58,9,70296,10908,81204
420650,202205,271,145,126,176952.2,152712,329664.2
420660,202205,41,33,8,39996,9696,49692
420665,202205,43,27,16,32724.2,19392,52116.2
420670,202205,240,187,53,226647.61,64236,290883.61
420675,202205,15,13,2,15756,2424,18180
420680,202205,34,27,7,32724,8484,41208
420690,202205,193,144,49,174528,59388,233916
420700,202205,713,458,255,555099.97,309060.65,864160.62
420710,202205,142,74,68,89688,82416,172104
420720,202205,98,79,19,95748,23028.1,118776.1
420730,202205,688,404,284,490863.54,344208.92,835072.46
420740,202205,56,56,0,67872,,67872.0
420750,202205,484,317,167,384204.67,202404.51,586609.18
420757,202205,19,16,3,19392,3636,23028
420760,202205,36,27,9,32724,10908,43632
420765,202205,75,54,21,65448,25452,90900
420768,202205,57,47,10,56964,12120,69084
420770,202205,71,60,11,72720.53,13332,86052.53
420775,202205,37,33,4,41208.2,4848,46056.2
420780,202205,207,161,46,195133.32,55752,250885.32
420785,202205,23,15,8,18180,9696,27876
420790,202205,143,117,26,141804,31512,173316
420800,202205,57,43,14,52116,16968,69084
420810,202205,268,217,51,263004.69,61812,324816.69
420820,202205,2491,1378,1113,1670143.03,1350171.65,3020314.68
420830,202205,662,345,317,418143.85,384207.05,802350.90
420840,202205,138,96,42,116352.4,50904,167256.4
420845,202205,435,181,254,219373.33,307850.66,527223.99
420850,202205,266,200,66,242400,79992,322392
420860,202205,60,51,9,61812.57,10908,72720.57
420870,202205,133,92,41,111504.1,49692,161196.1
420880,202205,188,121,67,146653.82,81204,227857.82
420890,202205,949,457,492,556309.72,597516.5,1153826.22
420895,202205,9,9,0,10908,,10908.0
420900,202205,413,332,81,403596.19,98172.2,501768.39
420910,202205,5847,3148,2699,3815400.8,3272409.77,7087810.57
420915,202205,60,54,6,65448,7272,72720
420917,202205,20,16,4,19392.2,4848,24240.2
420920,202205,22,15,7,18180,8484,26664
420930,202205,3162,2039,1123,2471206.98,1365929.7,3837136.68
420940,202205,577,412,165,500560.95,199982.8,700543.75
420945,202205,11,8,3,9696,3636,13332
420950,202205,47,35,12,42420,14544,56964
420960,202205,113,91,22,110293.26,26664.1,136957.36
420970,202205,279,224,55,271490.81,66660,338150.81
420980,202205,23,22,1,26664,1212,27876
420985,202205,53,45,8,54540,9696,64236
420990,202205,82,62,20,75144,24240.6,99384.6
421000,202205,52,30,22,36360,26664,63024
421003,202205,37,26,11,31512,13332,44844
421005,202205,7,5,2,6060,2424,8484
421010,202205,848,554,294,671453.27,356330.92,1027784.19
421020,202205,21,17,4,20604,4848,25452
421030,202205,114,98,16,118776,19392.2,138168.2
421040,202205,66,45,21,54540.18,25452,79992.18
421050,202205,337,234,103,283609.52,124836,408445.52
421055,202205,19,15,4,18180,4848,23028
421060,202205,104,57,47,69084,56964,126048
421070,202205,41,34,7,41208.61,8484,49692.61
421080,202205,39,34,5,41208,6060,47268
421085,202205,18,15,3,18180,3636,21816
421090,202205,36,29,7,35148,8484,43632
421100,202205,114,87,27,105444,32724,138168
421105,202205,188,152,36,184225.66,43632,227857.66
421110,202205,113,80,33,96960,39996,136956
421120,202205,175,127,48,153925.31,59388.1,213313.41
421125,202205,19,11,8,13332,9696.11,23028.11
421130,202205,824,506,318,613274.32,385417.67,998691.99
421140,202205,34,23,11,27876.2,13332,41208.2
421145,202205,44,37,7,44844,8484,53328
421150,202205,87,67,20,81204,24240.97,105444.97
421160,202205,62,38,24,46056,29088.1,75144.1
421165,202205,14,11,3,13332,3636,16968
421170,202205,164,137,27,166191.36,32724.61,198915.97
421175,202205,186,131,55,158772.58,66660,225432.58
421180,202205,41,28,13,33936.56,15756,49692.56
421185,202205,17,14,3,16968,3636,20604
421187,202205,3,2,1,2424,1212,3636
421189,202205,44,31,13,37572.3,15756,53328.3
421190,202205,1913,1200,713,1455625.12,865374.49,2320999.61
421200,202205,89,62,27,75144.6,32724,107868.6
421205,202205,27,19,8,23028.53,9696,32724.53
421210,202205,173,125,48,151500.52,58176,209676.52
421220,202205,252,195,57,236340,69084,305424
421223,202205,48,39,9,47268.4,10908,58176.4
421225,202205,69,46,23,55752,27876.98,83628.98
421227,202205,69,56,13,67872,15756,83628
421230,202205,72,49,23,60600.2,27876,88476.2
421240,202205,16,15,1,18180,1212,19392
421250,202205,379,224,155,271489.03,189073.07,460562.10
421260,202205,21,17,4,20604,4848,25452
421265,202205,5,3,2,3636,2424,6060
421270,202205,55,49,6,59388,7272,66660
421280,202205,353,182,171,220585.07,208464.97,429050.04
421290,202205,309,204,105,247248.19,127261.21,374509.40
421300,202205,25,21,4,25452,4848,30300
421310,202205,51,34,17,41208,20604,61812
421315,202205,32,19,13,23028,15756,38784
421320,202205,134,88,46,106656,55752,162408
421330,202205,108,81,27,98172.7,32724,130896.7
421335,202205,45,32,13,38784.58,15756,54540.58
421340,202205,244,159,85,192708.9,103020,295728.9
421350,202205,181,108,73,130897.75,88476,219373.75
421360,202205,717,497,220,602367.85,266640.48,869008.33
421370,202205,189,139,50,168468.02,61812.7,230280.72
421380,202205,147,109,38,132108.2,46056,178164.2
421390,202205,16,10,6,12120,7272,19392
421400,202205,120,98,22,118776,26664,145440
421410,202205,21,18,3,21816,3636,25452
421415,202205,20,17,3,20604,3636,24240
421420,202205,105,89,16,107868.2,19392,127260.2
421430,202205,19,12,7,14544,8484,23028
421440,202205,59,51,8,63024,9696,72720
421450,202205,87,71,16,86052,19392.44,105444.44
421460,202205,58,45,13,54540,15756,70296
421470,202205,77,43,34,52116,42420,94536
421480,202205,759,571,188,692052.42,227856,919908.42
421490,202205,24,23,1,27876,1212,29088
421500,202205,474,281,193,341787.59,233917.17,575704.76
421505,202205,31,24,7,29088,8484,37572
421507,202205,31,25,6,30300,7272,37572
421510,202205,65,39,26,47268,31512,78780
421520,202205,51,43,8,52116.4,9696,61812.4
421530,202205,51,41,10,49692.2,12120,61812.2
421535,202205,22,21,1,25452,1212,26664
421540,202205,50,39,11,47268,13332,60600
421545,202205,84,59,25,71509.51,30300,101809.51
421550,202205,294,207,87,252096.47,105444,357540.47
421555,202205,17,15,2,18180.7,2424,20604.7
421560,202205,9,8,1,9696,1212,10908
421565,202205,124,81,43,98172.95,53328,151500.95
421567,202205,33,27,6,32724,7272,39996
421568,202205,45,42,3,50904,3636,54540
421569,202205,11,11,0,13332,,13332.0
421570,202205,237,156,81,189072,98172,287244
421575,202205,26,23,3,27876,3636,31512
421580,202205,716,417,299,506696.55,362389.92,869086.47
421590,202205,17,16,1,19392,1212,20604
421600,202205,155,106,49,128472.6,59388,187860.6
421605,202205,105,69,36,83628.64,43632,127260.64
421610,202205,171,129,42,156348,50904.03,207252.03
421620,202205,1048,594,454,721150.52,551462.32,1272612.84
421625,202205,21,19,2,23028.6,2424,25452.6
421630,202205,352,214,138,259368.88,167257.15,426626.03
421635,202205,20,10,10,12120,12120,24240
421640,202205,100,84,16,101809.5,19392,121201.5
421650,202205,307,179,128,216948.5,155136,372084.5
421660,202205,2524,1521,1003,1843468.88,1216852.02,3060320.90
421670,202205,162,116,46,140592.7,56964,197556.7
421680,202205,191,173,18,209676.8,21816,231492.8
421690,202205,344,231,113,279973.6,138168.36,418141.96
421700,202205,60,41,19,49692,23028.2,72720.2
421710,202205,19,19,0,23028,,23028.0
421715,202205,5,4,1,4848,1212,6060
421720,202205,636,436,200,528437.54,242400.8,770838.34
421725,202205,26,10,16,12120.2,19392,31512.2
421730,202205,26,20,6,24240,7272,31512
421740,202205,108,40,68,48480.7,82416,130896.7
421750,202205,199,146,53,176952,64236,241188
421755,202205,18,16,2,19392,2424,21816
421760,202205,101,69,32,83628.45,38784,122412.45
421770,202205,694,445,249,539343.48,301789,841132.48
421775,202205,29,18,11,21816,13332,35148
421780,202205,178,141,37,170892,44844,215736
421790,202205,153,131,22,158772.41,26664,185436.41
421795,202205,16,13,3,15756,3636,19392
421800,202205,542,327,215,396327.64,260581.93,656909.57
421810,202205,69,57,12,69084,14544,83628
421820,202205,303,192,111,233916.6,134532,368448.6
421825,202205,153,126,27,152713.12,32724,185437.12
421830,202205,150,89,61,107869.48,73932.8,181802.28
421835,202205,7,2,5,2424.19,6060,8484.19
421840,202205,43,37,6,44844.92,7272,52116.92
421850,202205,75,63,12,76356,14544,90900
421860,202205,38,27,11,32724,13332,46056
421870,202205,1062,768,294,930823.08,356333.21,1287156.29
421875,202205,49,39,10,47268,12120,59388
421880,202205,180,121,59,147864.3,72720,220584.3
421885,202205,24,18,6,21816,7272,29088
421890,202205,146,104,42,126048.17,50904.46,176952.63
421895,202205,43,37,6,44844.57,7272,52116.57
421900,202205,125,95,30,115142.27,36360,151502.27
421910,202205,62,39,23,47268,27876,75144
421915,202205,33,27,6,32724.88,7272,39996.88
421917,202205,45,34,11,41208.7,13332,54540.7
421920,202205,37,32,5,38784,6060,44844
421930,202205,622,493,129,597521.63,157560.77,755082.40
421935,202205,46,39,7,47268,8484,55752
421940,202205,52,44,8,53328.4,9696,63024.4
421950,202205,880,579,301,701750.62,364812.91,1066563.53
421960,202205,41,34,7,41208,8484,49692
421970,202205,322,210,112,255733.15,135744,391477.15
421985,202205,18,11,7,13332,8484,21816
422000,202205,8,4,4,4848,4848,9696
430003,202205,188,54,134,65448,162408,227856
430005,202205,33,24,9,29088,10908,39996
430010,202205,252,181,71,219373.52,86052,305425.52
430020,202205,141,96,45,116352,54540,170892
430030,202205,118,97,21,117564,25452,143016
430040,202205,2919,1729,1190,2095553.75,1444704.64,3540258.39
430045,202205,74,63,11,76356,13332,89688
430047,202205,7,5,2,6060,2424,8484
430050,202205,86,73,13,88476,15756,104232
430055,202205,13,12,1,14544,1212,15756
430057,202205,6,4,2,4848,2424,7272
430060,202205,4004,2313,1691,2805788.37,2055556.83,4861345.20
430063,202205,51,42,9,50904,10908,61812
430064,202205,165,128,37,155136,44844,199980
430066,202205,7,3,4,3636,4848,8484
430070,202205,46,34,12,41208,14544,55752
430080,202205,79,49,30,60600,37572,98172
430085,202205,28,12,16,14544.8,19392,33936.8
430087,202205,27,20,7,24240.8,8484,32724.8
430090,202205,64,53,11,64236,13332,77568
430100,202205,138,96,42,116353.21,50904.2,167257.41
430105,202205,153,90,63,109081.44,77568.45,186649.89
430107,202205,18,14,4,16968.53,4848,21816.53
430110,202205,498,272,226,329664.48,273912,603576.48
430120,202205,158,145,13,175740,15756,191496
430130,202205,794,478,316,580548.93,382992,963540.93
430140,202205,133,122,11,147864,13332,161196
430150,202205,105,64,41,77568,49692,127260
430155,202205,30,24,6,29088,7272,36360
430160,202205,3653,2085,1568,2527034.43,1902842.13,4429876.56
430163,202205,415,191,224,231494.67,271488.73,502983.40
430165,202205,32,20,12,24240,14544,38784
430170,202205,80,66,14,79992,16968,96960
430175,202205,78,62,16,75144,19392,94536
430180,202205,107,85,22,103020,26664,129684
430185,202205,27,18,9,21816,10908,32724
430187,202205,51,28,23,33936,27876,61812
430190,202205,231,120,111,145440,134532,279972
430192,202205,16,12,4,14544,4848,19392
430195,202205,16,12,4,14544,4848,19392
430200,202205,153,128,25,156348,30300,186648
430205,202205,18,18,0,21816,,21816.0
430210,202205,747,561,186,682358.64,225432.2,907790.84
430215,202205,10,9,1,10908,1212,12120
430220,202205,75,50,25,60600,30300,90900
430222,202205,13,5,8,6060,9696,15756
430223,202205,16,11,5,13332,6060,19392
430225,202205,3,2,1,2424,1212,3636
430230,202205,320,196,124,237552.2,150288,387840.2
430235,202205,47,31,16,37572,19392,56964
430237,202205,21,16,5,19392,6060,25452
430240,202205,113,77,36,93324,43632,136956
430245,202205,68,55,13,66660,15756,82416
430250,202205,186,105,81,127260,98172,225432
430258,202205,9,8,1,9696,1212,10908
430260,202205,31,27,4,32724,4848,37572
430265,202205,35,30,5,36360,6060,42420
430270,202205,515,368,147,446018.68,178164,624182.68
430280,202205,1077,631,446,764773.36,541764.1,1306537.46
430290,202205,435,222,213,269064.2,259368,528432.2
430300,202205,2137,1156,981,1401075.92,1193822.76,2594898.68
430310,202205,2073,1015,1058,1231401.17,1288362.55,2519763.72
430320,202205,56,45,11,54540,13332,67872
430330,202205,89,76,13,92112.38,15756,107868.38
430340,202205,65,52,13,63024,15756,78780
430350,202205,1685,1086,599,1316232.38,725988.6,2042220.98
430355,202205,20,18,2,21816,2424,24240
430360,202205,96,48,48,58176,58176,116352
430367,202205,44,31,13,37572,15756,53328
430370,202205,60,53,7,64236,8484,72720
430380,202205,113,85,28,104232.37,33936,138168.37
430390,202205,595,368,227,446017.38,275124,721141.38
430400,202205,259,179,80,216948.6,96960,313908.6
430410,202205,55,44,11,54540,14544,69084
430420,202205,523,328,195,397537.58,236340.8,633878.38
430430,202205,53,51,2,61004.8,2424,63428.8
430435,202205,141,106,35,128472,42420,170892
430440,202205,550,342,208,414505.03,252096,666601.03
430450,202205,1202,977,225,1184127.43,272700.7,1456828.13
430460,202205,5798,2946,2852,3577840.59,3465118.89,7042959.48
430461,202205,16,14,2,16968,2424,19392
430462,202205,5,3,2,3636,2424,6060
430463,202205,1174,625,549,757501.45,665389.29,1422890.74
430465,202205,26,15,11,18180,13332,31512
430466,202205,670,470,200,570855.37,243614.52,814469.89
430467,202205,123,71,52,86052,63024,149076
430468,202205,141,80,61,96960,73932,170892
430469,202205,18,14,4,16968,4848,21816
430470,202205,1155,629,526,763921.3,639936.49,1403857.79
430471,202205,65,43,22,52116,26664,78780
430480,202205,124,87,37,105444.67,44844,150288.67
430485,202205,8,8,0,9696.6,,9696.6
430490,202205,75,59,16,71508,19392,90900
430495,202205,32,22,10,26664,12120,38784
430500,202205,187,125,62,151500,75144,226644
430510,202205,3786,2470,1316,2996070.62,1601054.94,4597125.56
430511,202205,14,14,0,16968,,16968.0
430512,202205,159,108,51,130896.6,61812,192708.6
430513,202205,51,40,11,48480,13332,61812
430515,202205,25,24,1,29088,1212,30300
430517,202205,178,148,30,179376,36360,215736
430520,202205,343,241,102,292092.98,123624.1,415717.08
430530,202205,78,44,34,53328,41208,94536
430535,202205,449,293,156,356328.81,189072,545400.81
430537,202205,10,10,0,12120,,12120.0
430540,202205,86,55,31,66660,37572,104232
430543,202205,398,124,274,150288,332088,482376
430544,202205,47,44,3,53328,3636,56964
430545,202205,409,192,217,232706.51,264217.39,496923.90
430550,202205,44,35,9,42420,10908,53328
430558,202205,1,1,0,1212,,1212.0
430560,202205,55,31,24,37572,29088,66660
430570,202205,122,53,69,64236,83628,147864
430580,202205,126,100,26,121200,31512,152712
430583,202205,15,15,0,18180,,18180.0
430585,202205,13,9,4,10908,4848,15756
430587,202205,14,8,6,9696,7272.2,16968.2
430590,202205,169,135,34,163621.51,41208,204829.51
430593,202205,1,1,0,1212,,1212.0
430595,202205,16,13,3,15756,3636,19392
430597,202205,43,24,19,29088,23028,52116
430600,202205,222,167,55,202404,66660,269064
430605,202205,170,96,74,116352,89688,206040
430607,202205,29,23,6,27876,7272,35148
430610,202205,1730,819,911,993841.58,1105345.75,2099187.33
430613,202205,6,6,0,7272,,7272.0
430620,202205,95,68,27,82416,32724,115140
430630,202205,47,39,8,47268,9696,56964
430632,202205,32,27,5,32724,6060,38784
430635,202205,37,31,6,37572,7272,44844
430637,202205,67,33,34,39996,41208,81204
430640,202205,175,99,76,119988,92112,212100
430642,202205,18,16,2,19392,2424,21816
430645,202205,30,25,5,30300,6060,36360
430650,202205,248,196,52,237552.6,63024,300576.6
430655,202205,5,4,1,4848,1212,6060
430660,202205,984,476,508,576912.1,615697.05,1192609.15
430670,202205,70,47,23,56964,27876,84840
430673,202205,83,55,28,66660.6,33936,100596.6
430675,202205,8,6,2,7272,2424,9696
430676,202205,593,350,243,424200.2,294516.1,718716.3
430680,202205,244,162,82,196344.6,99384,295728.6
430690,202205,548,331,217,401172.2,263005.35,664177.55
430692,202205,9,7,2,8484,2424,10908
430693,202205,139,86,53,104232,65448,169680
430695,202205,66,54,12,65448,14544,79992
430697,202205,64,40,24,48480,29088,77568
430700,202205,1381,929,452,1125949.54,547824.2,1673773.74
430705,202205,29,26,3,31512,3636,35148
430710,202205,260,159,101,192708,122412,315120
430720,202205,107,90,17,110292,20604,130896
430730,202205,146,123,23,149076,27876,176952
430740,202205,77,51,26,61812,31512,93324
430745,202205,29,17,12,20604,14544,35148
430750,202205,331,215,116,260580.2,140592,401172.2
430755,202205,86,45,41,54540,49692,104232
430760,202205,403,219,184,265428.63,223010.49,488439.12
430770,202205,1584,833,751,1012025.53,911424.7,1923450.23
430780,202205,331,207,124,250884,150288,401172
430781,202205,24,23,1,27876,1212,29088
430783,202205,63,49,14,59388.62,16968,76356.62
430786,202205,6,4,2,4848,2424,7272
430790,202205,512,327,185,397536,225432.2,622968.2
430800,202205,155,120,35,145440.33,42420,187860.33
430805,202205,37,31,6,37572,7272,44844
430807,202205,64,33,31,39996,37572,77568
430810,202205,80,54,26,65448,31512,96960
430820,202205,154,98,56,118776.78,67872,186648.78
430825,202205,12,9,3,10908,3636,14544
430830,202205,248,230,18,278760.6,21816,300576.6
430840,202205,131,86,45,104232.1,54540,158772.1
430843,202205,5,3,2,3636,2424,6060
430845,202205,76,45,31,54540,37572,92112
430850,202205,591,423,168,512676.72,203616,716292.72
430860,202205,163,102,61,123624.2,73932,197556.2
430865,202205,76,40,36,48480,43632,92112
430870,202205,74,60,14,73932,16968,90900
430880,202205,165,118,47,143016,56964,199980
430885,202205,12,11,1,13332,1212,14544
430890,202205,341,202,139,244824,168468,413292
430900,202205,531,367,164,444804.8,201192,645996.8
430905,202205,123,50,73,60600,89688,150288
430910,202205,278,152,126,184224.6,152712,336936.6
430912,202205,4,4,0,4848,,4848.0
430915,202205,43,39,4,47268,4848,52116
430920,202205,4620,2403,2217,2914875.33,2693078.54,5607953.87
430925,202205,7,5,2,6060,2424,8484
430930,202205,2090,1192,898,1445920.37,1088377.35,2534297.72
430940,202205,254,163,91,197556.28,110292.86,307849.14
430950,202205,150,121,29,147864.1,35148,183012.1
430955,202205,24,14,10,16968,12120,29088
430957,202205,22,19,3,23028,3636,26664
430960,202205,252,160,92,193920,111504,305424
430965,202205,103,67,36,81204,43632,124836
430970,202205,89,72,17,87264,20604,107868
430975,202205,47,41,6,49692,7272,56964
430980,202205,50,30,20,36360,24240,60600
430990,202205,97,74,23,89688,27876,117564
430995,202205,111,103,8,124836,9696,134532
431000,202205,296,147,149,178164.8,180588.81,358753.61
431010,202205,359,208,151,253309.97,184225.1,437535.07
431020,202205,1883,1089,794,1321081.57,964752,2285833.57
431030,202205,39,31,8,37572,9696,47268
431033,202205,450,202,248,244825.78,300576.5,545402.28
431036,202205,13,7,6,8484,7272,15756
431040,202205,142,89,53,107868.55,64236,172104.55
431041,202205,37,21,16,25452,19392,44844
431043,202205,40,24,16,29088,19392,48480
431046,202205,13,10,3,12120,3636,15756
431050,202205,205,126,79,152712,95748,248460
431053,202205,72,38,34,46056,41208.4,87264.4
431055,202205,65,42,23,50904,27876,78780
431057,202205,17,17,0,20604,,20604.0
431060,202205,1575,1009,566,1224123.41,685992,1910115.41
431065,202205,16,8,8,9696,9696,19392
431070,202205,64,55,9,66660,10908,77568
431075,202205,8,8,0,9696,,9696.0
431080,202205,124,71,53,86052,64236,150288
431085,202205,32,28,4,33936,4848,38784
431087,202205,15,12,3,14544,3636,18180
431090,202205,52,39,13,47268,15756,63024
431100,202205,1264,755,509,915062.81,616908.85,1531971.66
431110,202205,217,130,87,157560.78,105444,263004.78
431112,202205,29,20,9,24240,10908,35148
431113,202205,32,24,8,29088,9696,38784
431115,202205,150,106,44,128472,53328,181800
431120,202205,593,340,253,412081.18,306636,718717.18
431123,202205,5,5,0,6060,,6060.0
431125,202205,96,83,13,100596,15756,116352
431127,202205,5,3,2,3636,2424,6060
431130,202205,722,480,242,582974.68,293305.45,876280.13
431140,202205,784,556,228,673873.54,277548,951421.54
431142,202205,20,18,2,21816.84,2424,24240.84
431150,202205,200,147,53,178164.07,64236,242400.07
431160,202205,46,42,4,50904,4848,55752
431162,202205,5,5,0,6060,,6060.0
431164,202205,4,4,0,4848,,4848.0
431170,202205,113,80,33,98172,39996,138168
431171,202205,72,40,32,48480,38784,87264
431173,202205,4,2,2,2424,2424,4848
431175,202205,207,108,99,130896.6,119988.15,250884.75
431177,202205,95,65,30,78780,36360,115140
431179,202205,15,11,4,13332,4848,18180
431180,202205,402,249,153,303000.2,185436.2,488436.4
431190,202205,73,53,20,64236,24240.1,88476.1
431198,202205,71,48,23,57995.41,27876,85871.41
431200,202205,21,17,4,21816,4848,26664
431205,202205,22,20,2,24240,2424,26664
431210,202205,106,67,39,81204,47268,128472
431213,202205,34,28,6,33936,7272,41208
431215,202205,25,23,2,27876,2424,30300
431217,202205,6,5,1,6060,1212,7272
431220,202205,66,56,10,67872,12120,79992
431225,202205,168,107,61,129684,73932,203616
431230,202205,98,82,16,99384,19392,118776
431235,202205,6,5,1,6060,1212,7272
431237,202205,16,11,5,13332,6060,19392
431238,202205,12,9,3,10908,3636,14544
431240,202205,1092,662,430,802347.06,522372.7,1324719.76
431242,202205,40,38,2,46056,2424,48480
431244,202205,23,18,5,21816,6060,27876
431245,202205,53,38,15,46056,18180,64236
431247,202205,12,8,4,9696,4848,14544
431250,202205,284,140,144,169680,174528,344208
431260,202205,55,46,9,55752,10908,66660
431261,202205,16,11,5,13332,6060,19392
431262,202205,15,12,3,14544,3636,18180
431265,202205,147,79,68,95748,83628,179376
431267,202205,18,16,2,19392,2424,21816
431270,202205,327,253,74,306637.03,89688,396325.03
431275,202205,40,35,5,42420,6060,48480
431280,202205,21,16,5,19392,6060,25452
431290,202205,21,19,2,23028,2424,25452
431295,202205,2,1,1,1212,1212,2424
431300,202205,21,19,2,23028,2424,25452
431301,202205,7,7,0,8484,,8484.0
431303,202205,60,37,23,44844,27876,72720
431306,202205,243,124,119,150288,144228,294516
431308,202205,7,5,2,6060,2424,8484
431310,202205,64,51,13,61812,15756,77568
431320,202205,183,110,73,133320,88476,221796
431330,202205,208,133,75,161196.2,90900,252096.2
431333,202205,28,22,6,26664,7272,33936
431335,202205,7,5,2,6060,2424,8484
431337,202205,402,194,208,235128,252096,487224
431339,202205,22,17,5,20604,6060,26664
431340,202205,3189,1728,1461,2094246.92,1773561.9,3867808.82
431342,202205,34,22,12,26664.6,14544,41208.6
431344,202205,21,21,0,25452,,25452.0
431346,202205,5,4,1,4848,1212,6060
431349,202205,30,27,3,32724.23,3636,36360.23
431350,202205,1058,572,486,695692.48,589033.05,1284725.53
431360,202205,51,39,12,47268,14544,61812
431365,202205,356,152,204,184224.2,247248.4,431472.6
431370,202205,1187,682,505,827798.34,612060,1439858.34
431380,202205,98,87,11,105444.6,13332,118776.6
431390,202205,500,269,231,326028,279972,606000
431395,202205,325,138,187,167256,227856,395112
431400,202205,37,24,13,29088,16968,46056
431402,202205,101,73,28,88476,33936.69,122412.69
431403,202205,27,17,10,20604,12120,32724
431405,202205,709,401,308,486012.6,373296.3,859308.9
431406,202205,35,27,8,32724,9696,42420
431407,202205,46,36,10,43632,12120,55752
431410,202205,3478,2109,1369,2558537.6,1660442.14,4218979.74
431413,202205,15,12,3,14544,3636,18180
431415,202205,70,48,22,58176,26664,84840
431417,202205,24,11,13,13332,15756,29088
431420,202205,349,231,118,279972.18,143016,422988.18
431430,202205,62,32,30,38784,36360,75144
431440,202205,9108,6201,2907,7518088.26,3525779.27,11043867.53
431442,202205,26,13,13,15756,15756,31512
431445,202205,28,26,2,31512,2424,33936
431446,202205,4,3,1,3636,1212,4848
431447,202205,84,61,23,73932,27876,101808
431449,202205,54,43,11,52116,14544,66660
431450,202205,422,279,143,338148.05,173316,511464.05
431454,202205,11,6,5,7272,6060,13332
431455,202205,47,37,10,44844.1,12120,56964.1
431460,202205,507,347,160,420565.36,193920,614485.36
431470,202205,134,98,36,118776.2,43632,162408.2
431475,202205,10,8,2,10908,2424,13332
431477,202205,40,24,16,29088,19392,48480
431478,202205,7,7,0,8484,,8484.0
431480,202205,588,352,236,426624.2,286033.4,712657.6
431490,202205,29256,16244,13012,19708275.92,15797258.05,35505533.97
431500,202205,77,60,17,72720,20604,93324
431505,202205,29,19,10,23028,12120,35148
431507,202205,10,9,1,10908,1212,12120
431510,202205,233,167,66,202404.4,79992,282396.4
431513,202205,20,19,1,23028,1212,24240
431514,202205,5,3,2,3636,2424,6060
431515,202205,86,72,14,87264.1,16968,104232.1
431517,202205,7,4,3,4848,3636,8484
431520,202205,37,32,5,38784,6060,44844
431530,202205,1427,628,799,761136.82,968388.48,1729525.30
431531,202205,22,20,2,24240,2424,26664
431532,202205,37,27,10,32724,12120,44844
431535,202205,28,14,14,16968,16968,33936
431540,202205,134,110,24,133320,29088.6,162408.6
431545,202205,13,10,3,12120,3636,15756
431550,202205,358,189,169,229069.37,204828,433897.37
431555,202205,10,10,0,12120,,12120.0
431560,202205,4741,3154,1587,3828739.63,1927092.18,5755831.81
431570,202205,841,439,402,533282.27,488438.53,1021720.80
431575,202205,48,28,20,33936,24240,58176
431580,202205,85,57,28,69084,35148,104232
431590,202205,141,117,24,141804,29088,170892
431595,202205,19,16,3,19392,3636,23028
431600,202205,251,147,104,178166.47,126048.2,304214.67
431610,202205,113,84,29,101808,35148,136956
431620,202205,41,33,8,39996,9696,49692
431630,202205,125,102,23,123624,27876,151500
431640,202205,1320,829,491,1004750.67,596304.7,1601055.37
431642,202205,34,31,3,37572,3636,41208
431643,202205,42,17,25,20604,30300,50904
431645,202205,315,182,133,220584,161196,381780
431647,202205,9,8,1,9696,1212,10908
431650,202205,33,17,16,20604,19392,39996
431660,202205,271,170,101,207252,122412.19,329664.19
431670,202205,223,98,125,118776,151500,270276
431673,202205,12,10,2,12120,2424,14544
431675,202205,25,20,5,24240,6060,30300
431680,202205,1176,854,322,1036264.65,390264.66,1426529.31
431690,202205,4948,2937,2011,3560870.77,2439767,6000637.77
431695,202205,19,13,6,15756,7272,23028
431697,202205,3,1,2,1212,2424,3636
431700,202205,187,141,46,170892,55752,226644
431710,202205,4048,1746,2302,2119796.56,2790025.46,4909822.02
431720,202205,1279,784,495,949604.08,599940.2,1549544.28
431725,202205,1,1,0,1212,,1212.0
431730,202205,1161,770,391,934465.97,473895.03,1408361.00
431740,202205,1338,646,692,782952.36,838706.9,1621659.26
431750,202205,1817,1189,628,1442282.87,762351.75,2204634.62
431755,202205,6,5,1,6060,1212,7272
431760,202205,975,604,371,732050.66,449653.23,1181703.89
431770,202205,416,282,134,341784.1,162408,504192.1
431775,202205,23,17,6,20604,7272,27876
431780,202205,558,334,224,406020,271488,677508
431790,202205,156,120,36,145440.02,43632,189072.02
431795,202205,13,10,3,12120,3636,15756
431800,202205,3148,1656,1492,2008289.27,1809520.22,3817809.49
431805,202205,17,15,2,18180,2424,20604
431810,202205,591,385,206,466620.74,249672.6,716293.34
431820,202205,342,197,145,238764,175740,414504
431830,202205,2310,1396,914,1693167.56,1111404.8,2804572.36
431840,202205,479,314,165,381781.48,199980.8,581762.28
431842,202205,34,28,6,33936,7272,41208
431843,202205,12,9,3,10908,3636,14544
431844,202205,17,12,5,14544,6060,20604
431845,202205,25,22,3,26664,3636,30300
431846,202205,25,22,3,26664,3636,30300
431848,202205,15,13,2,15756,2424,18180
431849,202205,5,4,1,4848,1212,6060
431850,202205,767,598,169,724778.9,204828.1,929607.0
431860,202205,123,77,46,93324.15,55752,149076.15
431861,202205,6,2,4,2424,4848,7272
431862,202205,60,43,17,52116,20604,72720
431870,202205,3717,2127,1590,2579151.65,1930718.02,4509869.67
431880,202205,980,691,289,838705.42,350268,1188973.42
431890,202205,1254,726,528,879913.9,641148,1521061.9
431900,202205,186,128,58,156348,70296,226644
431910,202205,45,35,10,42420,12120,54540
431912,202205,50,31,19,37572,23028,60600
431915,202205,144,109,35,132108,42420,174528
431920,202205,149,106,43,128472,52116,180588
431930,202205,76,62,14,75144,16968,92112
431935,202205,5,4,1,4848,1212,6060
431936,202205,3,3,0,3636,,3636.0
431937,202205,19,16,3,19392,3636,23028
431940,202205,469,321,148,389052,180588,569640
431950,202205,476,310,166,375720.85,202404.3,578125.15
431960,202205,735,396,339,481165.17,412080.6,893245.77
431970,202205,68,61,7,73932,8484,82416
431971,202205,4,3,1,3636,2424,6060
431973,202205,18,15,3,18180.1,3636,21816.1
431975,202205,10,10,0,12120,,12120.0
431980,202205,199,116,83,140592.6,100596,241188.6
431990,202205,1082,571,511,693187.79,621758.91,1314946.70
432000,202205,1848,963,885,1168378.29,1072624.13,2241002.42
432010,202205,268,178,90,215736,109080,324816
432020,202205,182,154,28,186648.56,33936,220584.56
432023,202205,14,12,2,14544,2424,16968
432026,202205,56,49,7,59388,8484,67872
432030,202205,64,32,32,38784,38784,77568
432032,202205,16,12,4,14544,4848,19392
432035,202205,63,47,16,56964,19392,76356
432040,202205,88,59,29,71508,35148,106656
432045,202205,2,2,0,2424,,2424.0
432050,202205,81,48,33,58176,39996,98172
432055,202205,134,96,38,116352.42,46056,162408.42
432057,202205,6,4,2,4848.6,2424,7272.6
432060,202205,32,28,4,33936,4848,38784
432065,202205,30,26,4,31512,4848,36360
432067,202205,88,81,7,98172.1,8484,106656.1
432070,202205,394,310,84,375721.04,103020,478741.04
432080,202205,819,575,244,699327.84,296941.01,996268.85
432085,202205,11,9,2,10908,2424,13332
432090,202205,265,180,85,218160,103020,321180
432100,202205,173,112,61,135744,73932,209676
432110,202205,555,365,190,442380.48,230280.1,672660.58
432120,202205,1040,582,458,706597.84,555096.29,1261694.13
432130,202205,504,358,146,435108.8,178164,613272.8
432132,202205,21,19,2,23028,2424,25452
432135,202205,79,65,14,78780,16968,95748
432140,202205,270,202,68,244824.83,82416,327240.83
432143,202205,215,130,85,157560,103020.85,260580.85
432145,202205,278,192,86,232704.5,104232,336936.5
432146,202205,13,12,1,14544,1212,15756
432147,202205,101,59,42,71508,50904,122412
432149,202205,16,9,7,10908,8484,19392
432150,202205,995,609,386,739322.53,469044.93,1208367.46
432160,202205,1696,873,823,1058079.33,999902.66,2057981.99
432162,202205,4,2,2,2424,2424,4848
432163,202205,15,10,5,12120,6060,18180
432166,202205,124,89,35,109383.1,42420,151803.1
432170,202205,226,115,111,139380,134532.81,273912.81
432180,202205,570,361,209,437532,254520.6,692052.6
432183,202205,11,10,1,12120,1212,13332
432185,202205,79,63,16,76356,19392.97,95748.97
432190,202205,510,300,210,363600.8,254520,618120.8
432195,202205,94,78,16,94536,19392,113928
432200,202205,410,255,155,309060.9,187860,496920.9
432210,202205,114,67,47,81204,56964,138168
432215,202205,31,29,2,35148,2424,37572
432218,202205,19,19,0,23028,,23028.0
432220,202205,641,325,316,393900,382992.52,776892.52
432225,202205,18,12,6,14544,7272,21816
432230,202205,122,81,41,98172,49692,147864
432232,202205,23,20,3,24240,3636,27876
432234,202205,4,2,2,2424,2424,4848
432235,202205,2,2,0,2424,,2424.0
432237,202205,25,16,9,19392,10908,30300
432240,202205,4528,2538,1990,3082126.53,2415522.45,5497648.98
432250,202205,1134,737,397,894456.3,483588,1378044.3
432252,202205,47,47,0,56964,,56964.0
432253,202205,65,51,14,61812.2,16968,78780.2
432254,202205,27,12,15,14544,18180,32724
432255,202205,11,10,1,12120,1212,13332
432260,202205,852,681,171,826585.42,207252,1033837.42
432270,202205,219,164,55,198768.59,66660,265428.59
432280,202205,154,116,38,140593.63,46056,186649.63
432285,202205,1,1,0,1212,,1212.0
432290,202205,55,48,7,58176,8484,66660
432300,202205,4996,2657,2339,3223849.74,2840936.42,6064786.16
432310,202205,130,109,21,132108,25452,157560
432320,202205,22,17,5,20604,6060,26664
432330,202205,15,11,4,13332,4848,18180
432335,202205,8,6,2,7272,2424,9696
432340,202205,37,30,7,36360,8484,44844
432345,202205,110,74,36,89688.2,43632,133320.2
432350,202205,23,22,1,26664,1212,27876
432360,202205,5,4,1,4848,1212,6060
432370,202205,25,25,0,30300.2,,30300.2
432375,202205,28,26,2,31512,2424,33936
432377,202205,7,7,0,8484,,8484.0
432380,202205,194,85,109,103020,132109.41,235129.41
500020,202205,270,144,126,174529.27,152712,327241.27
500025,202205,138,68,70,82416.2,84840.63,167256.83
500060,202205,1424,904,520,1096866.25,631454.06,1728320.31
500070,202205,729,349,380,422994.82,461773.23,884768.05
500080,202205,136,108,28,130896.88,33936,164832.88
500085,202205,131,103,28,124838.15,33936,158774.15
500090,202205,373,173,200,209676,242400.28,452076.28
500100,202205,701,361,340,437533.8,412082.46,849616.26
500110,202205,2305,1099,1206,1333207.54,1461680.8,2794888.34
500124,202205,264,146,118,176952.49,143016.42,319968.91
500150,202205,327,133,194,161196.58,235128,396324.58
500190,202205,555,371,184,450869.27,223008.2,673877.47
500200,202205,203,172,31,208464.32,38784,247248.32
500210,202205,1621,546,1075,661754.65,1302901.46,1964656.11
500215,202205,199,114,85,138168.1,103020.6,241188.7
500220,202205,713,454,259,551465.25,313908.46,865373.71
500230,202205,223,135,88,164832.26,106656,271488.26
500240,202205,647,428,219,519949.86,265428.6,785378.46
500260,202205,590,235,355,284821.5,430261.16,715082.66
500270,202205,30132,13065,17067,15842682.43,20707118.43,36549800.86
500280,202205,199,67,132,81204.05,159984,241188.05
500290,202205,1164,717,447,871433.2,541764.5,1413197.7
500295,202205,459,297,162,361179.32,196344,557523.32
500310,202205,110,39,71,47268.6,86052,133320.6
500315,202205,807,443,364,536916.57,441168.2,978084.77
500320,202205,3636,1744,1892,2113744.12,2293111.1,4406855.22
500325,202205,891,498,393,603584.92,476319.3,1079904.22
500330,202205,1493,708,785,859240.26,951426.41,1810666.67
500345,202205,306,227,79,275125.38,95748.21,370873.59
500348,202205,240,145,95,175740.5,115140,290880.5
500350,202205,108,52,56,63024,67872,130896
500370,202205,5693,2590,3103,3143961.81,3764479.35,6908441.16
500375,202205,351,237,114,287244.2,138168,425412.2
500380,202205,610,351,259,425412.7,313909.41,739322.11
500390,202205,69,32,37,38784,44844,83628
500400,202205,210,137,73,167256,88476,255732
500410,202205,493,211,282,255733.22,341785.65,597518.87
500430,202205,540,367,173,444805.5,209676.19,654481.69
500440,202205,206,110,96,133320,116352,249672
500450,202205,412,178,234,216949.58,283608.8,500558.38
500460,202205,268,143,125,173317.78,151500,324817.78
500470,202205,419,310,109,375720.51,133320,509040.51
500480,202205,100,58,42,71508,50904,122412
500490,202205,95,42,53,50904.48,64236.8,115141.28
500500,202205,1423,527,896,639938.67,1085954.3,1725892.97
500510,202205,39,33,6,39996,7272,47268
500515,202205,106,75,31,90900.08,37572.55,128472.63
500520,202205,276,144,132,174529.9,159984,334513.9
500525,202205,90,49,41,59388,49692,109080
500540,202205,896,400,496,484801.65,601154.41,1085956.06
500560,202205,882,493,389,597517.68,472682.15,1070199.83
500568,202205,1009,532,477,644786.95,578125.23,1222912.18
500570,202205,1161,680,481,825377.59,582972.77,1408350.36
500580,202205,317,162,155,196346.64,187860,384206.64
500600,202205,350,173,177,209677.48,214524.9,424202.38
500620,202205,942,655,287,795074.55,347844.2,1142918.75
500625,202205,81,65,16,78780.47,19392,98172.47
500627,202205,40,18,22,21816.15,26664,48480.15
500630,202205,1570,900,670,1090298.11,812041.55,1902339.66
500635,202205,509,304,205,368448,248460,616908
500640,202205,363,197,166,238767.36,201192.5,439959.86
500660,202205,5723,2073,3650,2518547.7,4426228.78,6944776.48
500690,202205,609,224,385,271488.2,466620,738108.2
500710,202205,395,195,200,236341.53,242400.6,478742.13
500720,202205,929,508,421,615698.67,510252,1125950.67
500730,202205,158,94,64,113930.85,77568,191498.85
500740,202205,926,388,538,471469.87,652057.55,1123527.42
500750,202205,171,57,114,69084.2,138168.38,207252.58
500755,202205,117,90,27,109080.8,32724,141804.8
500769,202205,739,407,332,494499.05,402385.56,896884.61
500770,202205,416,228,188,276336.14,227856,504192.14
500780,202205,135,89,46,107869.31,55752,163621.31
500790,202205,1051,517,534,627817.84,647209,1275026.84
500793,202205,287,148,139,179376.2,168469.1,347845.3
500795,202205,174,119,55,144228.67,66660.5,210889.17
500797,202205,49,34,15,41208,18180,59388
500800,202205,425,184,241,223009.32,292092,515101.32
500830,202205,2240,1209,1031,1465323.7,1253211.71,2718535.41
500840,202205,118,87,31,105445.2,37572,143017.2
510010,202205,166,91,75,110292,90900,201192
510020,202205,525,241,284,292093.2,345421.34,637514.54
510025,202205,1676,936,740,1134441.24,896883.87,2031325.11
510030,202205,652,339,313,410873.53,380569.37,791442.90
510035,202205,132,69,63,83628,76356,159984
510040,202205,408,195,213,236340.3,258156.96,494497.26
510050,202205,377,204,173,247249.32,210888.39,458137.71
510060,202205,122,60,62,72720.2,75144,147864.2
510080,202205,249,96,153,116352,185436.6,301788.6
510100,202205,66,27,39,32724,47268,79992
510120,202205,30,19,11,23028,13332,36360
510125,202205,387,241,146,292092.6,176952.5,469045.1
510130,202205,536,321,215,389055.09,260581.25,649636.34
510140,202205,445,143,302,173316.2,366024.83,539341.03
510160,202205,106,36,70,43632,84840.6,128472.6
510170,202205,743,451,292,546614.26,353904.6,900518.86
510180,202205,2852,1319,1533,1598644.68,1861639.95,3460284.63
510185,202205,25,12,13,14544,15756,30300
510190,202205,231,77,154,93324.2,186648.1,279972.3
510250,202205,2667,1662,1005,2016784.46,1219274.28,3236058.74
510260,202205,171,124,47,150288,56964,207252
510263,202205,480,272,208,329664.55,252097.47,581762.02
510267,202205,607,332,275,402387.86,333300.49,735688.35
510268,202205,62,29,33,35148.3,39996,75144.3
510269,202205,76,35,41,42420,49692,92112
510270,202205,374,184,190,223008.19,230280.6,453288.79
510279,202205,195,149,46,180588.9,55752,236340.9
510285,202205,178,71,107,86052,129684,215736
510300,202205,517,272,245,329664.4,296940.5,626604.9
510305,202205,200,91,109,110292,132108,242400
510310,202205,104,53,51,64236,61812,126048
510320,202205,810,503,307,609641.6,372084.2,981725.8
510325,202205,424,177,247,214524,299365.25,513889.25
510330,202205,428,240,188,290880.9,227856.65,518737.55
510335,202205,658,390,268,472682.88,324816.2,797499.08
510336,202205,52,36,16,43632,19392.1,63024.1
510337,202205,106,50,56,60600,67872,128472
510340,202205,17645,7844,9801,9509423.43,11883712.06,21393135.49
510343,202205,61,47,14,56964,16968,73932
510345,202205,155,95,60,115140.27,72720.6,187860.87
510350,202205,636,337,299,408447.04,362388.8,770835.84
510360,202205,220,139,81,169680.2,98172,267852.2
510370,202205,154,71,83,86052,100596,186648
510380,202205,79,58,21,70296,25452,95748
510385,202205,59,26,33,31512,39996,71508
510390,202205,95,45,50,54540,60600.2,115140.2
510395,202205,53,37,16,44844,19392,64236
510410,202205,752,476,276,576914.29,334512.1,911426.39
510420,202205,549,267,282,323604.75,341784,665388.75
510450,202205,51,26,25,31512,30300,61812
510452,202205,55,26,29,31512,35148,66660
510454,202205,52,25,27,30300.2,32724.08,63024.28
510455,202205,122,70,52,86052,63024,149076
510460,202205,182,82,100,99384,121200,220584
510480,202205,719,430,289,521163.94,350270,871433.94
510490,202205,339,167,172,202404,208464,410868
510500,202205,229,170,59,206040,71508,277548
510510,202205,799,461,338,558736.05,409656.4,968392.45
510515,202205,1258,655,603,795074.24,732049.1,1527123.34
510517,202205,270,125,145,151501.48,175740.9,327242.38
510520,202205,210,136,74,164833.71,89688,254521.71
510523,202205,114,90,24,109080,29088,138168
510525,202205,857,523,334,635091.13,404808.1,1039899.23
510530,202205,20,13,7,15756,8484,24240
510550,202205,238,112,126,135744,152712,288456
510558,202205,301,147,154,178164.6,186648,364812.6
510560,202205,380,213,167,258157.62,202404.77,460562.39
510562,202205,648,468,180,567219.07,219372,786591.07
510590,202205,710,353,357,429049.71,432684,861733.71
510600,202205,220,114,106,138168.1,129684,267852.1
510610,202205,223,96,127,116352.13,153924,270276.13
510615,202205,195,93,102,112716,123624,236340
510617,202205,25,12,13,14544,15756,30300
510618,202205,122,55,67,67872,81204,149076
510619,202205,88,61,27,73932,32724,106656
510620,202205,160,90,70,109080,84840,193920
510621,202205,172,109,63,132108,76356,208464
510622,202205,481,263,218,318760.41,264216.69,582977.10
510623,202205,289,195,94,236341.02,113928,350269.02
510624,202205,85,45,40,54540.1,48480,103020.1
510625,202205,520,325,195,393900.73,236341.15,630241.88
510626,202205,108,63,45,76356.87,54540,130896.87
510627,202205,89,61,28,73932.2,33936,107868.2
510628,202205,160,97,63,117564,76356,193920
510629,202205,278,164,114,198768,138190.41,336958.41
510630,202205,433,215,218,260580.37,264216.7,524797.07
510631,202205,18,8,10,9696,12120,21816
510637,202205,346,198,148,239976.89,179376.5,419353.39
510642,202205,1074,579,495,701754.04,599941.45,1301695.49
510645,202205,8,1,7,1212,8484,9696
510650,202205,1313,859,454,1041117.35,550249.93,1591367.28
510665,202205,83,35,48,42420,58176,100596
510670,202205,55,32,23,38784,27876,66660
510675,202205,1091,701,390,850060.34,472680.8,1322741.14
510677,202205,355,188,167,227857,202404.2,430261.2
510680,202205,89,56,33,67872,39996,107868
510682,202205,193,97,96,117564.52,116352,233916.52
510685,202205,56,41,15,49692,18180,67872
510700,202205,563,319,244,386630.06,295728,682358.06
510704,202205,1179,610,569,740538.37,689630.23,1430168.60
510706,202205,142,75,67,90900,82416.51,173316.51
510710,202205,419,287,132,347845.99,159984.6,507830.59
510715,202205,56,40,16,48480,19392,67872
510718,202205,237,114,123,138168.74,149076.1,287244.84
510719,202205,45,18,27,21816,32724,54540
510720,202205,181,129,52,156348.1,63024,219372.1
510724,202205,79,30,49,36360,59388,95748
510726,202205,64,30,34,36360,41208,77568
510729,202205,14,6,8,7272,9696,16968
510730,202205,453,244,209,296940,253308,550248
510735,202205,115,47,68,56964,82416,139380
510740,202205,21,12,9,14544.24,10908,25452.24
510757,202205,25,20,5,24240,6060,30300
510760,202205,7386,3768,3618,4568063.71,4389871.62,8957935.33
510770,202205,683,323,360,391478.21,436321.19,827799.40
510774,202205,18,8,10,9696,12120,21816
510775,202205,117,90,27,109080,32724,141804
510776,202205,39,12,27,14544,32724.6,47268.6
510777,202205,191,80,111,96960,134532,231492
510779,202205,35,22,13,26664,15756,42420
510780,202205,265,143,122,173316.34,147864.3,321180.64
510785,202205,349,194,155,236342.04,187860,424202.04
510787,202205,189,90,99,109080.3,119988.41,229068.71
510788,202205,6,1,5,1212,6060,7272
510790,202205,2613,1347,1266,1632631.02,1536817.31,3169448.33
510792,202205,1100,606,494,735485.95,598728.5,1334214.45
510794,202205,110,61,49,73932,59388,133320
510795,202205,2268,1326,942,1609544.82,1146554.61,2756099.43
510800,202205,188,112,76,135744,92112,227856
510805,202205,198,130,68,157560.2,82416.2,239976.4
510810,202205,97,40,57,48480,69084,117564
510820,202205,234,119,115,144228.92,139381.64,283610.56
510830,202205,72,39,33,47269.44,39996,87265.44
510835,202205,19,13,6,15756,7272,23028
510840,202205,9088,4254,4834,5157104.36,5864885.33,11021989.69
510850,202205,204,86,118,104232.2,143016,247248.2
510860,202205,410,198,212,239976,256944.59,496920.59
510880,202205,71,49,22,59388,26664,86052
510885,202205,70,43,27,52116.45,32724,84840.45
510890,202205,68,38,30,46056.2,36360,82416.2
510895,202205,167,100,67,122412,81204,203616
520005,202205,138,55,83,66660,100596,167256
520010,202205,284,121,163,146652.6,197556.7,344209.3
520013,202205,738,504,234,613274.47,283609.85,896884.32
520015,202205,44,31,13,37572,15756,53328
520017,202205,86,52,34,63024,41208,104232
520020,202205,13,6,7,7272,8484,15756
520025,202205,2687,1422,1265,1727113.81,1535615.13,3262728.94
520030,202205,787,426,361,516619.06,439956,956575.06
520050,202205,65,48,17,58176,20604,78780
520055,202205,69,45,24,54540,30300,84840
520060,202205,175,111,64,135745.18,77569.1,213314.28
520080,202205,581,420,161,510252,195132,705384
520082,202205,15,11,4,13332,4848,18180
520085,202205,87,66,21,79992,25452,105444
520090,202205,88,63,25,76356,30300.51,106656.51
520110,202205,9047,3884,5163,4708647.3,6262423.32,10971070.62
520120,202205,10,5,5,6060,6060,12120
520130,202205,796,565,231,684781.71,282396.2,967177.91
520140,202205,11891,6559,5332,7955638.36,6472097.49,14427735.85
520145,202205,54,31,23,37572,27876,65448
520150,202205,153,121,32,146652,38784,185436
520160,202205,45,30,15,36360,18180,54540
520170,202205,226,128,98,155138.55,118778.1,273916.65
520180,202205,183,87,96,105444.2,116352,221796.2
520215,202205,203,138,65,167256.72,78780,246036.72
520235,202205,81,62,19,75144,23028,98172
520250,202205,132,73,59,88476,71508,159984
520260,202205,113,68,45,82416.2,54540.2,136956.4
520280,202205,45,33,12,39996,14544,54540
520310,202205,46,27,19,32724,23028,55752
520320,202205,171,105,66,127260,79992,207252
520330,202205,815,449,366,544192.62,443592.3,987784.92
520340,202205,363,208,155,252098.59,187860.88,439959.47
520350,202205,483,247,236,299364.2,286032.2,585396.4
520355,202205,88,51,37,61812,44844,106656
520357,202205,30,24,6,29088,7272,36360
520360,202205,3,2,1,2424,1212,3636
520380,202205,136,77,59,93324,71508,164832
520390,202205,242,105,137,127260.3,166044,293304.3
520393,202205,15,12,3,14544,3636,18180
520396,202205,73,50,23,60600,27876,88476
520400,202205,199,120,79,145440.78,95748.2,241188.98
520410,202205,192,96,96,116352,116352,232704
520420,202205,21,13,8,15756,9696,25452
520425,202205,246,125,121,151500,146652.4,298152.4
520430,202205,513,246,267,298152.33,323604.6,621756.93
520440,202205,644,463,181,562371.33,220584.8,782956.13
520450,202205,2066,884,1182,1071417.66,1435010.37,2506428.03
520455,202205,54,30,24,36360.19,29088,65448.19
520460,202205,38,24,14,29088.2,16968,46056.2
520465,202205,36,30,6,36360,7272,43632
520470,202205,433,278,155,338149.4,187860,526009.4
520480,202205,78,46,32,55752,38784,94536
520485,202205,104,39,65,47268,78780.1,126048.1
520490,202205,439,327,112,396325.46,135744.4,532069.86
520495,202205,155,91,64,110292.1,77568.55,187860.65
520500,202205,186,148,38,179376.9,46056,225432.9
520505,202205,199,116,83,140592,100596,241188
520510,202205,1884,893,991,1083534.15,1201095,2284629.15
520520,202205,51,35,16,42420,19392,61812
520530,202205,200,160,40,193920.9,48480,242400.9
520540,202205,662,452,210,547827.05,255732,803559.05
520545,202205,139,78,61,94536.72,73932,168468.72
520547,202205,54,31,23,37572.2,27876,65448.2
520549,202205,1365,642,723,778110.72,877491.66,1655602.38
520551,202205,324,169,155,204828.39,187860,392688.39
520552,202205,34,26,8,31512,9696,41208
520570,202205,14,10,4,12120,4848,16968
520580,202205,271,169,102,204829.98,123624.97,328454.95
520590,202205,140,78,62,94536.8,75144,169680.8
520620,202205,1138,531,607,643577.27,735685.6,1379262.87
520630,202205,43,23,20,27876,24240,52116
520640,202205,374,220,154,266641.01,186648,453289.01
520650,202205,65,31,34,37572,41208,78780
520660,202205,40,21,19,25452.1,23028.38,48480.48
520670,202205,43,35,8,42420.6,9696,52116.6
520680,202205,31,21,10,25452,12120,37572
520690,202205,39,10,29,12120,35148.1,47268.1
520710,202205,33,28,5,33936,6060,39996
520725,202205,198,145,53,175741.02,64236,239977.02
520735,202205,56,37,19,44844,23028,67872
520740,202205,460,220,240,269065.34,290880,559945.34
520750,202205,34,24,10,29088,12120,41208
520753,202205,73,51,22,61812,26664,88476
520760,202205,99,65,34,78780.2,41208,119988.2
520780,202205,265,205,60,248460.9,72720.18,321181.08
520790,202205,154,93,61,112716,73932,186648
520800,202205,3334,1850,1484,2243432.99,1803459.53,4046892.52
520810,202205,140,108,32,130896,38784,169680
520815,202205,4,3,1,3636,1212,4848
520830,202205,141,94,47,113928.1,56964,170892.1
520840,202205,388,252,136,305424,164832,470256
520850,202205,101,56,45,67872.4,54540,122412.4
520860,202205,1764,1132,632,1373201.84,767197.42,2140399.26
520870,202205,31515,14520,16995,17606816.36,20617398.16,38224214.52
520880,202205,1196,639,557,774474.75,675087.27,1449562.02
520890,202205,811,502,309,608425.73,374508.75,982934.48
520910,202205,977,523,454,633879.06,550248.59,1184127.65
520915,202205,90,69,21,83628.9,25452,109080.9
520920,202205,432,203,229,247248.4,278760.5,526008.9
520929,202205,16,14,2,16968.02,2424,19392.02
520940,202205,64,45,19,54540.2,23028,77568.2
520945,202205,12,8,4,9696,4848,14544
520960,202205,39,23,16,27876,19392,47268
520970,202205,374,214,160,259368.12,193920,453288.12
520980,202205,91,65,26,78780,31512,110292
520990,202205,438,311,127,376932,155136,532068
520993,202205,127,65,62,78781.24,75144,153925.24
520995,202205,254,140,114,169680.38,138168,307848.38
521000,202205,1558,899,659,1089592.57,799922.14,1889514.71
521010,202205,649,343,306,415718.94,370872.91,786591.85
521015,202205,11,7,4,8484,4848,13332
521020,202205,1386,969,417,1175645.97,505405.65,1681051.62
521030,202205,58,39,19,47268.2,23028,70296.2
521040,202205,958,634,324,768410.21,392688.7,1161098.91
521056,202205,56,36,20,43632,24240,67872
521060,202205,120,78,42,94536,50904,145440
521080,202205,340,263,77,318762.28,93324,412086.28
521090,202205,561,370,191,448441.14,231492.89,679934.03
521100,202205,261,192,69,232704,83628,316332
521120,202205,1044,732,312,888401.42,379357.35,1267758.77
521130,202205,328,238,90,288457.96,109080.6,397538.56
521140,202205,193,109,84,132109.2,101808.81,233918.01
521150,202205,2506,1090,1416,1322298.56,1717410.68,3039709.24
521160,202205,24,10,14,12120,16968,29088
521170,202205,223,123,100,149076.71,121200,270276.71
521180,202205,1158,744,414,902945,501773.08,1404718.08
521190,202205,2533,1076,1457,1305334.1,1767099.38,3072433.48
521200,202205,55,37,18,44844,21816,66660
521205,202205,11,8,3,9696,3636.19,13332.19
521210,202205,122,77,45,93324.35,54540,147864.35
521220,202205,724,507,217,614485.1,263004.1,877489.2
521225,202205,23,16,7,19392.2,8484.2,27876.4
521230,202205,100,62,38,75144,46056,121200
521250,202205,6198,3484,2714,4225062.84,3289381.25,7514444.09
521260,202205,34,15,19,18180,23028,41208
521270,202205,135,103,32,124836,38784,163620
521280,202205,407,254,153,307848,185436,493284
521290,202205,27,17,10,20604.2,12120,32724.2
521295,202205,102,68,34,82416,41208,123624
521300,202205,228,125,103,151500,124836,276336
521305,202205,37,28,9,33936,10908,44844
521308,202205,996,763,233,924766.71,282396.8,1207163.51
521310,202205,1323,748,575,906583.76,696903.15,1603486.91
521340,202205,21,16,5,19392,6060,25452
521350,202205,113,86,27,104232,32724,136956
521370,202205,159,112,47,135744.2,56964.1,192708.3
521375,202205,190,93,97,112717.15,118776,231493.15
521377,202205,50,40,10,48480,12120,60600
521380,202205,1043,634,409,768415.01,495710.57,1264125.58
521385,202205,11,7,4,8484,4848,13332
521390,202205,105,84,21,101808.1,25452,127260.1
521400,202205,367,258,109,312697.81,132108,444805.81
521405,202205,144,83,61,100596.52,73932,174528.52
521410,202205,74,55,19,66660,23028,89688
521440,202205,203,144,59,174528.2,71508,246036.2
521450,202205,752,409,343,498134.61,416928.25,915062.86
521460,202205,1076,727,349,881126.56,424200.2,1305326.76
521470,202205,13,9,4,10908,4848,15756
521480,202205,38,27,11,32724,13332.6,46056.6
521483,202205,319,198,121,239978.14,146652,386630.14
521486,202205,296,193,103,233916,124836,358752
521487,202205,23,10,13,12120,15756,27876
521490,202205,23,13,10,15756,12120,27876
521500,202205,134,60,74,73932.21,89688,163620.21
521520,202205,43,32,11,38784,13332,52116
521523,202205,897,528,369,641150.02,448440.23,1089590.25
521525,202205,52,35,17,42420,20604,63024
521530,202205,236,137,99,166044,119988,286032
521540,202205,41,20,21,24240,25452,49692
521550,202205,100,42,58,50904,70296,121200
521560,202205,843,564,279,684782.4,338148.8,1022931.2
521565,202205,66,49,17,59388.96,20604,79992.96
521570,202205,531,339,192,410869.15,232704.6,643573.75
521580,202205,50,32,18,38784,21816,60600
521590,202205,32,15,17,18180,20604,38784
521600,202205,25,11,14,13332,16968,30300
521630,202205,225,117,108,141805.16,130897.78,272702.94
521640,202205,300,161,139,195133.73,168468,363601.73
521645,202205,36,20,16,24240,19392,43632
521680,202205,245,151,94,183012.2,113928.4,296940.6
521690,202205,11,10,1,12120,1212,13332
521710,202205,1122,534,588,648423.75,712656.8,1361080.55
521720,202205,521,360,161,438745.6,195133.06,633878.66
521730,202205,661,318,343,385416.78,415716.27,801133.05
521740,202205,882,399,483,483591.68,585397.16,1068988.84
521760,202205,2221,1165,1056,1414451.2,1279878.11,2694329.31
521770,202205,808,510,298,618122.86,361176,979298.86
521800,202205,1958,1301,657,1578031.95,797496.2,2375528.15
521805,202205,36,19,17,23028,20604,43632
521810,202205,93,54,39,65448.2,47268,112716.2
521830,202205,961,693,268,839920.48,326030.59,1165951.07
521839,202205,74,44,30,53328,36360,89688
521850,202205,1113,556,557,675092.53,679933.72,1355026.25
521860,202205,329,207,122,250885.39,147864,398749.39
521870,202205,75,46,29,55752,35148,90900
521878,202205,35,13,22,15756,26664,42420
521880,202205,4815,2115,2700,2563399.09,3276044.21,5839443.30
521890,202205,590,402,188,487226.19,227856,715082.19
521900,202205,276,218,58,264216.8,71508,335724.8
521910,202205,171,118,53,143016.18,64236,207252.18
521920,202205,40,23,17,27876,20604,48480
521925,202205,49,29,20,35148,24240,59388
521930,202205,1160,648,512,786590.84,621757.22,1408348.06
521935,202205,31,22,9,26664,10908,37572
521940,202205,230,101,129,122412.1,156348,278760.1
521945,202205,17,13,4,15756,4848,20604
521950,202205,14,10,4,12120,4848,16968
521960,202205,65,48,17,58176,20604,78780
521970,202205,397,253,144,306636.9,174528,481164.9
521971,202205,111,57,54,69084,65448,134532
521973,202205,39,19,20,23028,24240,47268
521975,202205,1590,815,775,988998.56,940518.32,1929516.88
521980,202205,245,163,82,197556.11,99384.49,296940.60
521990,202205,72,54,18,65448,21816,87264
522000,202205,284,186,98,225010.13,118776,343786.13
522005,202205,18,11,7,13332,8484,21816
522010,202205,1101,621,480,753873.03,581761.59,1335634.62
522015,202205,57,36,21,43632,25452,69084
522020,202205,900,540,360,654480.99,437532.39,1092013.38
522026,202205,24,15,9,18180,10908,29088
522028,202205,18,15,3,18180,3636,21816
522040,202205,792,340,452,412082.36,547826.41,959908.77
522045,202205,2560,1529,1031,1853164.3,1251999.05,3105163.35
522050,202205,156,75,81,90900.6,98172,189072.6
522060,202205,533,338,195,409656.2,236340,645996.2
522068,202205,105,76,29,92112,35148,127260
522070,202205,13,11,2,13332,2424,15756
522100,202205,36,23,13,27876,15756,43632
522108,202205,43,32,11,38785.1,13332,52117.1
522119,202205,56,32,24,38784,29088,67872
522130,202205,73,27,46,32724,55752.2,88476.2
522140,202205,4097,2159,1938,2616724.27,2350069.64,4966793.91
522145,202205,43,33,10,39996,12120,52116
522150,202205,101,68,33,83628,39996,123624
522155,202205,52,40,12,48480,14544,63024
522157,202205,10,6,4,7272,4848,12120
522160,202205,1647,983,664,1192614.6,804769.64,1997384.24
522170,202205,398,270,128,327243.31,155136,482379.31
522180,202205,33,12,21,14544,25452,39996
522185,202205,2281,975,1306,1181705.18,1582880.08,2764585.26
522190,202205,68,37,31,44844.2,37572.6,82416.8
522200,202205,300,178,122,215736.3,147864,363600.3
522205,202205,147,102,45,123625.2,54540,178165.2
522220,202205,134,100,34,121200,41208,162408
522230,202205,32,29,3,35148,3636,38784
530010,202205,54123,27560,26563,33417552.24,32216390.86,65633943.10
110001,202206,507,412,95,499345.50,115140.00,614485.50
110002,202206,2773,1776,997,2157214.49,1209582.71,3366797.20
110003,202206,81,66,15,79992.30,18180.00,98172.30
110004,202206,1978,1330,648,1611974.62,785379.48,2397354.10
110005,202206,427,338,89,409658.36,107868.00,517526.36
110006,202206,424,313,111,380569.60,134533.15,515102.75
110007,202206,72,57,15,69084.00,18180.00,87264.00
110008,202206,246,139,107,168468.97,129684.20,298153.17
110009,202206,909,686,223,831434.14,270276.40,1101710.54
110010,202206,1628,959,669,1162314.26,810828.80,1973143.06
110011,202206,1661,1292,369,1565928.33,448446.20,2014374.53
110012,202206,3984,2317,1667,2809437.73,2021623.69,4831061.42
110013,202206,707,557,150,675091.76,183012.50,858104.26
110014,202206,351,310,41,375722.32,49692.00,425414.32
110015,202206,1314,1033,281,1252003.23,340576.99,1592580.22
110018,202206,996,616,380,747811.18,460561.11,1208372.29
110020,202206,15592,8837,6755,10716650.12,8200459.98,18917110.10
110025,202206,649,474,175,574489.97,212100.77,786590.74
110026,202206,34,22,12,26664.93,14544.00,41208.93
110028,202206,1560,1109,451,1344130.52,546618.97,1890749.49
110029,202206,121,109,12,133320.60,14544.00,147864.60
110030,202206,2360,1559,801,1890540.65,970816.04,2861356.69
110032,202206,302,231,71,279977.72,86052.86,366030.58
110033,202206,619,449,170,544198.91,206041.68,750240.59
110034,202206,311,229,82,277548.10,100596.20,378144.30
110037,202206,84,75,9,90900.20,10908.00,101808.20
110040,202206,394,272,122,329664.00,149076.52,478740.52
110045,202206,906,644,262,780537.16,318757.18,1099294.34
110050,202206,86,75,11,90900.99,13332.33,104233.32
110060,202206,62,37,25,44844.92,30300.00,75144.92
110070,202206,110,73,37,88476.29,44844.00,133320.29
110080,202206,504,290,214,351483.57,260580.50,612064.07
110090,202206,26,22,4,26664.00,4848.00,31512.00
110092,202206,105,56,49,67872.71,59388.00,127260.71
110094,202206,187,131,56,158772.66,67872.00,226644.66
110100,202206,48,34,14,41208.59,16968.05,58176.64
110110,202206,108,64,44,77568.40,53328.00,130896.40
110120,202206,64,56,8,67872.76,9696.65,77569.41
110130,202206,261,210,51,254522.20,61812.20,316334.40
110140,202206,242,174,68,210889.46,82416.10,293305.56
110143,202206,54,44,10,53328.00,12120.00,65448.00
110145,202206,41,31,10,37572.00,12120.00,49692.00
110146,202206,26,11,15,13332.00,18180.00,31512.00
110147,202206,36,25,11,30300.00,13332.00,43632.00
110148,202206,35,27,8,32724.00,9696.00,42420.00
110149,202206,307,217,90,263004.43,109080.50,372084.93
110150,202206,133,102,31,123624.00,37572.00,161196.00
110155,202206,11,9,2,10908.00,2424.00,13332.00
110160,202206,62,48,14,58176.87,16968.00,75144.87
110170,202206,210,157,53,190284.29,64236.06,254520.35
110175,202206,60,47,13,56964.00,15756.00,72720.00
110180,202206,90,72,18,87264.00,21816.00,109080.00
120001,202206,199,148,51,179378.08,61812.70,241190.78
120005,202206,196,114,82,138168.95,99384.10,237553.05
120010,202206,1111,674,437,818103.09,529644.20,1347747.29
120013,202206,152,103,49,124836.15,59388.10,184224.25
120017,202206,117,65,52,78780.57,63024.00,141804.57
120020,202206,3339,2711,628,3285817.42,761149.40,4046966.82
120025,202206,564,310,254,375725.30,307849.62,683574.92
120030,202206,1070,919,151,1113878.67,183020.80,1296899.47
120032,202206,46,41,5,49694.82,6060.00,55754.82
120033,202206,221,193,28,233926.07,33936.55,267862.62
120034,202206,171,126,45,152712.20,54540.00,207252.20
120035,202206,46,39,7,47268.10,8484.00,55752.10
120038,202206,390,251,139,304218.44,168469.63,472688.07
120039,202206,30,29,1,35149.65,1212.00,36361.65
120040,202206,13876,9361,4515,11351689.71,5476146.10,16827835.81
120042,202206,44,40,4,48481.10,4848.55,53329.65
120043,202206,15,3,12,3636.00,14544.00,18180.00
120045,202206,519,335,184,406027.92,223010.08,629038.00
120050,202206,1253,963,290,1167218.68,351490.91,1518709.59
120060,202206,1420,1187,233,1438701.42,282402.80,1721104.22
120070,202206,397,289,108,350271.27,130896.00,481167.27
120080,202206,183,115,68,139382.00,82416.65,221798.65
130002,202206,155,113,42,136956.00,50904.00,187860.00
130006,202206,102,68,34,82416.00,41208.00,123624.00
130008,202206,122,70,52,84840.00,63024.00,147864.00
130010,202206,184,122,62,147864.90,76356.47,224221.37
130014,202206,283,200,83,242703.10,100596.00,343299.10
130020,202206,118,75,43,90900.20,52116.00,143016.20
130030,202206,925,529,396,641151.17,479952.22,1121103.39
130040,202206,387,184,203,223008.80,247248.00,470256.80
130050,202206,530,282,248,341785.43,301791.06,643576.49
130060,202206,849,578,271,700536.58,328452.00,1028988.58
130063,202206,617,380,237,460560.20,287244.00,747804.20
130068,202206,226,149,77,180590.49,93324.56,273915.05
130070,202206,1335,893,442,1082322.63,535705.78,1618028.41
130080,202206,667,447,220,541765.83,266641.29,808407.12
130083,202206,82,52,30,63025.40,36360.00,99385.40
130090,202206,317,181,136,219372.00,164832.00,384204.00
130100,202206,1217,570,647,690841.75,785376.30,1476218.05
130110,202206,724,323,401,391476.10,486012.28,877488.38
130115,202206,148,76,72,92112.60,87264.00,179376.60
130120,202206,1627,1021,606,1237456.59,734472.20,1971928.79
130130,202206,602,412,190,499344.00,230280.10,729624.10
130140,202206,1535,1189,346,1441071.12,419352.00,1860423.12
130150,202206,389,340,49,412081.00,59388.00,471469.00
130160,202206,433,266,167,322393.30,202404.00,524797.30
130165,202206,79,65,14,78780.85,16968.00,95748.85
130170,202206,992,691,301,837425.57,364815.53,1202241.10
130180,202206,256,187,69,226644.50,83628.20,310272.70
130185,202206,2185,1044,1141,1265340.90,1382899.01,2648239.91
130190,202206,3296,2054,1242,2489467.67,1507734.70,3997202.37
130195,202206,274,215,59,260580.00,71508.00,332088.00
130200,202206,174,90,84,109080.00,101808.00,210888.00
130210,202206,90,44,46,53328.00,55752.00,109080.00
130220,202206,200,139,61,168468.00,73932.00,242400.00
130230,202206,364,242,122,293304.00,147864.00,441168.00
130240,202206,1307,844,463,1022929.40,561156.20,1584085.60
130250,202206,4956,3135,1821,3799659.17,2207067.38,6006726.55
130255,202206,411,211,200,255732.00,242400.00,498132.00
130260,202206,59198,27680,31518,33556926.64,38220965.38,71777892.02
130270,202206,1496,1025,471,1242411.36,570852.45,1813263.81
130280,202206,134,78,56,94536.00,67872.00,162408.00
130290,202206,2031,1335,696,1618040.59,843558.11,2461598.70
130300,202206,425,296,129,358755.68,156349.11,515104.79
130310,202206,875,455,420,552672.39,509040.10,1061712.49
130320,202206,542,295,247,358754.60,299364.00,658118.60
130330,202206,726,461,265,559945.53,321180.20,881125.73
130340,202206,3368,1859,1509,2254342.38,1830132.60,4084474.98
130350,202206,456,313,143,379356.35,173316.00,552672.35
130353,202206,912,408,504,494502.84,615697.65,1110200.49
130356,202206,766,345,421,418140.51,510252.20,928392.71
130360,202206,100,79,21,95748.00,25452.00,121200.00
130370,202206,675,525,150,636300.00,181800.00,818100.00
130380,202206,629,494,135,598728.20,164832.00,763560.20
130390,202206,449,364,85,441168.20,103020.00,544188.20
130395,202206,158,48,110,58176.00,134532.82,192708.82
130400,202206,97,76,21,92115.60,25452.00,117567.60
130406,202206,2144,1261,883,1528338.74,1071409.49,2599748.23
130410,202206,437,218,219,264216.00,266640.00,530856.00
130420,202206,2714,2203,511,2671282.05,619333.10,3290615.15
130423,202206,206,132,74,159984.60,89688.00,249672.60
130426,202206,182,99,83,119988.85,100596.00,220584.85
130430,202206,398,228,170,276336.00,206040.00,482376.00
130440,202206,201,67,134,81204.78,162409.70,243614.48
140002,202206,27,6,21,7272.00,26664.38,33936.38
140005,202206,213,129,84,156349.74,101808.60,258158.34
140010,202206,11059,6694,4365,8116904.14,5292861.64,13409765.78
140015,202206,147,66,81,79993.05,98172.00,178165.05
140017,202206,123,75,48,90902.31,58177.74,149080.05
140020,202206,427,279,148,338152.56,179379.15,517531.71
140023,202206,52,25,27,30300.00,32724.00,63024.00
140028,202206,23,12,11,14544.00,13332.45,27876.45
140030,202206,365,239,126,289671.05,152712.10,442383.15
140040,202206,61,43,18,52116.00,21816.00,73932.00
140045,202206,273,99,174,119988.00,212100.10,332088.10
140047,202206,502,326,176,395116.64,213312.40,608429.04
140050,202206,136,85,51,103021.21,61812.00,164833.21
140060,202206,71,46,25,55752.00,30300.40,86052.40
140070,202206,25,23,2,27876.20,2424.00,30300.20
150010,202206,4889,2950,1939,3575429.41,2351293.36,5926722.77
150013,202206,162,113,49,136956.20,59388.80,196345.00
150020,202206,1066,578,488,700538.67,591457.73,1291996.40
150030,202206,686,303,383,367240.31,464196.60,831436.91
150034,202206,202,123,79,149076.52,95748.00,244824.52
150040,202206,1585,887,698,1075056.00,845985.34,1921041.34
150050,202206,699,403,296,488439.90,358752.71,847192.61
150060,202206,4741,2977,1764,3608052.47,2139692.98,5747745.45
150070,202206,442,226,216,273912.10,261792.60,535704.70
150080,202206,16343,7600,8743,9213742.77,10603898.54,19817641.31
150085,202206,405,254,151,309063.35,183013.82,492077.17
150090,202206,663,546,117,661754.32,141804.33,803558.65
150095,202206,46,31,15,37572.98,18180.63,55753.61
150100,202206,68,41,27,49692.00,32724.67,82416.67
150110,202206,213,120,93,145440.00,112716.00,258156.00
150120,202206,393,285,108,345422.06,132108.40,477530.46
150125,202206,46,17,29,20604.00,35148.00,55752.00
150130,202206,2131,1060,1071,1284730.82,1299270.62,2584001.44
150140,202206,57814,25218,32596,30571926.87,39538288.42,70110215.29
150145,202206,248,137,111,166045.14,134532.00,300577.14
150150,202206,3332,1471,1861,1782876.36,2255552.31,4038428.67
150157,202206,371,266,105,322396.43,127260.00,449656.43
150160,202206,131,101,30,122412.00,36360.00,158772.00
150170,202206,3803,2767,1036,3354843.72,1256850.02,4611693.74
150172,202206,359,251,108,304212.46,130896.66,435109.12
150175,202206,80,46,34,55752.30,41208.00,96960.30
150178,202206,761,519,242,629032.84,293306.26,922339.10
150180,202206,3183,1547,1636,1874987.36,1982837.52,3857824.88
150190,202206,366,238,128,288459.53,155136.87,443596.40
150195,202206,118,60,58,72720.20,70296.13,143016.33
150200,202206,198,94,104,113928.00,126048.48,239976.48
150210,202206,3136,2454,682,2974274.17,826589.36,3800863.53
150215,202206,596,367,229,444807.92,277552.07,722359.99
150220,202206,3433,2277,1156,2760966.95,1401080.51,4162047.46
150230,202206,1313,1056,257,1279878.00,312698.44,1592576.44
150240,202206,6890,3840,3050,4654138.74,3697853.75,8351992.49
150250,202206,71,40,31,48480.00,37572.00,86052.00
150260,202206,106,74,32,89688.50,38784.00,128472.50
150270,202206,2101,1363,738,1651968.24,896886.20,2548854.44
150275,202206,523,331,192,402388.51,233916.74,636305.25
150276,202206,107,38,69,46056.00,83628.00,129684.00
150277,202206,816,365,451,443596.51,546617.40,990213.91
150280,202206,339,231,108,279972.68,130896.00,410868.68
150285,202206,145,69,76,84840.57,91918.08,176758.65
150290,202206,1213,687,526,832654.67,637517.33,1470172.00
150293,202206,758,362,396,438749.99,479953.19,918703.18
150295,202206,549,257,292,311489.14,353906.38,665395.52
150300,202206,93,44,49,53328.10,59388.40,112716.50
150304,202206,187,113,74,136956.00,89688.55,226644.55
150307,202206,428,351,77,425415.78,93324.80,518740.58
150309,202206,596,420,176,509046.58,213315.90,722362.48
150310,202206,271,180,91,218162.02,110292.00,328454.02
150320,202206,1830,1269,561,1538037.45,681149.09,2219186.54
150330,202206,2020,1160,860,1405928.06,1042323.62,2448251.68
150340,202206,190,126,64,152712.00,77568.00,230280.00
150345,202206,612,342,270,414507.17,327240.81,741747.98
150350,202206,396,312,84,378151.48,101809.14,479960.62
150360,202206,4700,2801,1899,3397278.50,2301599.14,5698877.64
150370,202206,798,546,252,661759.60,305428.68,967188.28
150375,202206,186,81,105,98172.00,127260.18,225432.18
150380,202206,1498,987,511,1197473.82,619335.24,1816809.06
150390,202206,878,500,378,606006.78,458139.11,1064145.89
150400,202206,106,88,18,106656.00,21816.00,128472.00
150405,202206,1596,1016,580,1231402.71,702961.97,1934364.68
150410,202206,108,67,41,81204.00,49692.00,130896.00
150420,202206,7521,4024,3497,4877368.48,4246911.92,9124280.40
150430,202206,624,387,237,469057.28,287246.44,756303.72
150440,202206,438,269,169,326033.19,204829.23,530862.42
150442,202206,2352,1238,1114,1500474.23,1350178.08,2850652.31
150445,202206,528,346,182,419354.86,220584.00,639938.86
150450,202206,216,123,93,149076.00,112716.00,261792.00
150460,202206,697,529,168,642364.97,203616.37,845981.34
150470,202206,1251,742,509,899308.21,616909.20,1516217.41
150475,202206,239,182,57,220585.54,70297.14,290882.68
150480,202206,1377,966,411,1170806.73,498136.77,1668943.50
150490,202206,604,355,249,430260.10,301788.00,732048.10
150495,202206,322,241,81,292092.00,98172.00,390264.00
150497,202206,273,178,95,215736.94,115140.00,330876.94
150500,202206,257,155,102,187861.93,123624.10,311486.03
150503,202206,1294,646,648,785387.50,785379.76,1570767.26
150506,202206,886,605,281,733265.34,340572.92,1073838.26
150510,202206,1330,725,605,878711.64,733262.32,1611973.96
150520,202206,320,217,103,263005.27,124836.20,387841.47
150530,202206,1902,1058,844,1282328.93,1022956.97,2305285.90
150540,202206,206,152,54,184224.60,65448.00,249672.60
150543,202206,828,438,390,530864.16,472686.60,1003550.76
150548,202206,432,312,120,378145.48,145440.00,523585.48
150549,202206,81,56,25,67872.10,30300.00,98172.10
150550,202206,3043,1510,1533,1830132.83,1859215.25,3689348.08
150553,202206,3429,1917,1512,2323434.70,1834986.41,4158421.11
150555,202206,145,77,68,93324.20,82416.26,175740.46
150560,202206,57,25,32,30300.00,38784.00,69084.00
150563,202206,118,62,56,75145.41,67872.66,143018.07
150565,202206,208,127,81,153924.40,98172.00,252096.40
150570,202206,415,275,140,333300.00,169680.10,502980.10
150580,202206,1709,836,873,1013235.69,1058076.50,2071312.19
150590,202206,827,538,289,652063.13,350270.38,1002333.51
150600,202206,517,308,209,373301.69,253311.66,626613.35
150610,202206,154,122,32,147864.00,39996.00,187860.00
150611,202206,130,85,45,103020.00,54540.00,157560.00
150613,202206,3289,1872,1417,2268894.29,1719905.67,3988799.96
150616,202206,576,316,260,382996.06,315120.96,698117.02
150618,202206,1368,704,664,853250.52,804768.20,1658018.72
150619,202206,392,298,94,361177.94,113928.49,475106.43
150620,202206,1219,702,517,852046.96,626605.22,1478652.18
150630,202206,152,103,49,124839.69,59388.42,184228.11
150635,202206,462,202,260,244825.24,315123.24,559948.48
150640,202206,41,17,24,20604.00,29088.00,49692.00
150650,202206,2406,1388,1018,1682280.97,1236253.80,2918534.77
150655,202206,247,181,66,219372.20,79992.00,299364.20
150658,202206,73,44,29,53328.00,35148.00,88476.00
150660,202206,576,376,200,455717.15,242400.00,698117.15
150670,202206,1114,403,711,488439.12,864162.36,1352601.48
150680,202206,10738,5665,5073,6868488.91,6152184.71,13020673.62
150690,202206,29,15,14,18180.18,16968.00,35148.18
150700,202206,503,333,170,403605.10,206043.10,609648.20
150710,202206,277,162,115,196345.24,139380.40,335725.64
150715,202206,822,516,306,625397.05,370872.75,996269.80
150720,202206,408,316,92,382994.31,111504.73,494499.04
150730,202206,1049,503,546,609641.38,661756.41,1271397.79
150740,202206,232,151,81,183012.85,98172.00,281184.85
150745,202206,769,426,343,517532.40,415716.48,933248.88
150746,202206,69,37,32,44844.00,38784.00,83628.00
150747,202206,242,177,65,214526.14,78780.37,293306.51
150750,202206,132,71,61,86052.40,73932.96,159985.36
150760,202206,1809,1172,637,1420476.11,773259.62,2193735.73
150770,202206,393,221,172,267852.74,208464.00,476316.74
150775,202206,96,50,46,60600.20,55752.73,116352.93
150780,202206,201,117,84,141804.20,101808.00,243612.20
150790,202206,673,387,286,469047.73,347846.78,816894.51
150795,202206,1624,993,631,1204736.85,764775.64,1969512.49
150796,202206,319,182,137,220584.00,166044.20,386628.20
150797,202206,392,185,207,224221.08,250884.34,475105.42
150800,202206,1570,873,697,1058079.52,844765.00,1902844.52
150803,202206,493,384,109,465412.04,132108.10,597520.14
150805,202206,199,119,80,144228.40,96960.00,241188.40
150808,202206,1013,525,488,636301.72,591457.34,1227759.06
150810,202206,3096,2091,1005,2534309.86,1218063.60,3752373.46
150812,202206,499,258,241,312697.40,293304.99,606002.39
150815,202206,1157,728,429,882337.70,521160.20,1403497.90
150820,202206,1549,929,620,1125969.05,751451.25,1877420.30
150830,202206,546,403,143,488438.24,173317.10,661755.34
150835,202206,236,137,99,166044.10,119988.74,286032.84
150840,202206,1402,824,578,998696.01,701752.66,1700448.67
160005,202206,64,43,21,52116.08,25452.12,77568.20
160010,202206,188,119,69,144229.42,83628.37,227857.79
160015,202206,168,113,55,136959.25,66660.30,203619.55
160020,202206,130,66,64,79992.93,77568.00,157560.93
160021,202206,63,28,35,33936.84,42420.02,76356.86
160023,202206,63,39,24,47268.54,29088.52,76357.06
160025,202206,22,10,12,12120.52,14544.12,26664.64
160027,202206,1462,818,644,992645.77,782955.67,1775601.44
160030,202206,16600,8495,8105,10296105.42,9828201.48,20124306.90
160040,202206,305,186,119,225434.91,144229.00,369663.91
160050,202206,706,339,367,410873.11,444807.40,855680.51
160053,202206,286,169,117,204831.57,141804.34,346635.91
160055,202206,22,16,6,19392.02,7272.00,26664.02
160060,202206,6616,3525,3091,4274790.64,3747539.10,8022329.74
160070,202206,187,109,78,132108.12,94536.65,226644.77
160080,202206,125,64,61,77568.66,73932.02,151500.68
170025,202206,27,16,11,19392.00,13332.00,32724.00
170030,202206,168,135,33,163621.63,39996.00,203617.63
170035,202206,200,97,103,117564.40,124837.06,242401.46
170040,202206,177,130,47,157560.00,56964.00,214524.00
170070,202206,317,202,115,244828.06,139380.47,384208.53
170100,202206,337,248,89,300579.61,107868.59,408448.20
170105,202206,43,37,6,44844.00,7272.10,52116.10
170110,202206,116,70,46,84840.00,55752.10,140592.10
170130,202206,71,37,34,44844.00,41208.00,86052.00
170190,202206,95,56,39,67872.32,47268.00,115140.32
170200,202206,336,232,104,281184.47,126048.00,407232.47
170210,202206,6428,3454,2974,4185994.99,3606929.27,7792924.26
170215,202206,114,59,55,71508.00,66661.82,138169.82
170220,202206,1315,951,364,1152624.91,441171.63,1593796.54
170230,202206,142,93,49,112716.86,59389.09,172105.95
170240,202206,494,336,158,407235.95,191496.30,598732.25
170255,202206,986,791,195,958697.37,236340.20,1195037.57
170270,202206,43,31,12,37572.00,14544.00,52116.00
170290,202206,133,84,49,101808.60,59388.00,161196.60
170300,202206,107,68,39,82416.00,47268.00,129684.00
170305,202206,47,37,10,44844.90,12120.00,56964.90
170307,202206,54,42,12,50904.80,14544.00,65448.80
170310,202206,119,73,46,88476.38,55752.00,144228.38
170320,202206,30,19,11,23028.00,13332.00,36360.00
170330,202206,29,22,7,26664.00,8484.10,35148.10
170360,202206,32,19,13,23028.20,15757.07,38785.27
170370,202206,78,42,36,50905.28,44844.00,95749.28
170380,202206,75,56,19,67872.00,23028.00,90900.00
170382,202206,37,32,5,38784.00,6060.00,44844.00
170384,202206,140,107,33,129684.94,39996.20,169681.14
170386,202206,67,28,39,33936.00,47268.00,81204.00
170388,202206,46,19,27,23028.00,32724.96,55752.96
170389,202206,23,20,3,24240.20,3636.00,27876.20
170390,202206,71,43,28,52116.00,33936.00,86052.00
170410,202206,24,22,2,26664.00,2424.00,29088.00
170460,202206,17,10,7,12120.10,8484.00,20604.10
170510,202206,34,25,9,30300.10,10908.00,41208.10
170550,202206,1536,898,638,1088388.63,773261.02,1861649.65
170555,202206,104,78,26,94538.55,31512.00,126050.55
170560,202206,101,71,30,86052.00,36360.54,122412.54
170600,202206,39,13,26,15756.20,31512.00,47268.20
170610,202206,176,95,81,115140.88,98172.20,213313.08
170625,202206,34,20,14,24240.00,16968.00,41208.00
170650,202206,90,63,27,76356.00,32724.00,109080.00
170700,202206,562,415,147,502980.30,179376.00,682356.30
170710,202206,144,91,53,110292.80,64236.28,174529.08
170720,202206,101,78,23,94536.20,27876.20,122412.40
170730,202206,96,58,38,70296.00,46056.00,116352.00
170740,202206,83,59,24,71508.00,29088.00,100596.00
170755,202206,50,27,23,32725.17,27876.10,60601.27
170765,202206,124,71,53,86053.43,64236.00,150289.43
170770,202206,190,122,68,147864.20,83628.00,231492.20
170820,202206,581,385,196,466623.10,237554.18,704177.28
170825,202206,43,25,18,30300.00,21816.00,52116.00
170830,202206,88,69,19,83628.00,23028.00,106656.00
170900,202206,167,130,37,157560.40,44844.00,202404.40
170930,202206,936,509,427,618124.31,517528.15,1135652.46
170950,202206,3142,1489,1653,1804684.37,2003444.79,3808129.16
170980,202206,18,10,8,12120.60,9696.00,21816.60
171050,202206,141,108,33,130896.00,39996.00,170892.00
171070,202206,55,47,8,56964.57,9696.00,66660.57
171090,202206,45,33,12,39996.00,14544.00,54540.00
171110,202206,24,18,6,21816.40,7272.00,29088.40
171150,202206,40,23,17,27876.00,20604.00,48480.00
171180,202206,23,9,14,10908.20,16968.20,27876.40
171190,202206,174,99,75,119988.20,92112.00,212100.20
171195,202206,57,47,10,56964.31,12120.00,69084.31
171200,202206,35,16,19,19392.00,23028.00,42420.00
171215,202206,9,7,2,8484.00,2424.00,10908.00
171240,202206,61,44,17,53328.00,20604.00,73932.00
171245,202206,51,43,8,52117.98,9696.20,61814.18
171250,202206,74,42,32,50904.30,38784.00,89688.30
171270,202206,12,8,4,9696.00,4848.10,14544.10
171280,202206,44,36,8,43633.80,9696.10,53329.90
171320,202206,984,570,414,690843.28,502980.51,1193823.79
171330,202206,422,215,207,260580.00,250884.10,511464.10
171360,202206,95,68,27,82416.00,32724.00,115140.00
171370,202206,34,19,15,23028.10,18180.10,41208.20
171380,202206,132,114,18,138168.64,21816.00,159984.64
171395,202206,42,24,18,29088.00,21816.00,50904.00
171420,202206,254,166,88,201193.34,106656.20,307849.54
171430,202206,68,55,13,66660.10,15756.05,82416.15
171488,202206,200,113,87,136956.14,105444.12,242400.26
171500,202206,58,31,27,37572.00,32724.00,70296.00
171510,202206,76,49,27,59388.00,32724.00,92112.00
171515,202206,37,30,7,36360.00,8484.00,44844.00
171525,202206,24,22,2,26664.00,2424.00,29088.00
171550,202206,14,8,6,9696.20,7272.00,16968.20
171570,202206,53,26,27,31512.00,32724.00,64236.00
171575,202206,260,173,87,209676.20,105444.00,315120.20
171610,202206,1778,891,887,1079901.72,1075050.80,2154952.52
171620,202206,140,96,44,116352.40,54540.00,170892.40
171630,202206,50,29,21,35148.00,25452.00,60600.00
171650,202206,335,228,107,276340.98,129684.40,406025.38
171660,202206,253,147,106,178165.72,128472.00,306637.72
171665,202206,82,51,31,61812.08,37572.00,99384.08
171670,202206,418,259,159,313908.59,192708.00,506616.59
171700,202206,63,55,8,66660.00,9696.00,76356.00
171720,202206,29,11,18,13332.00,21816.00,35148.00
171750,202206,102,51,51,61812.20,61812.20,123624.40
171780,202206,72,57,15,69084.00,18180.00,87264.00
171790,202206,84,68,16,82416.00,19392.00,101808.00
171800,202206,33,26,7,31512.00,8484.00,39996.00
171820,202206,2011,1170,841,1420472.03,1019293.46,2439765.49
171830,202206,31,23,8,27876.20,9696.00,37572.20
171840,202206,57,39,18,47269.19,21816.00,69085.19
171845,202206,28,18,10,21816.16,12120.00,33936.16
171850,202206,40,33,7,39996.00,8484.00,48480.00
171855,202206,72,53,19,64236.00,23028.00,87264.00
171865,202206,4,3,1,3636.00,1212.00,4848.00
171870,202206,31,19,12,23028.00,14544.45,37572.45
171875,202206,83,60,23,72720.00,27876.00,100596.00
171880,202206,40,24,16,29088.20,19392.00,48480.20
171884,202206,55,31,24,37572.00,29088.00,66660.00
171886,202206,129,60,69,72720.20,83628.20,156348.40
171888,202206,25,20,5,24240.17,6060.00,30300.17
171889,202206,11,5,6,6060.00,7272.00,13332.00
171890,202206,55,46,9,55753.29,10908.00,66661.29
171900,202206,32,22,10,26664.70,12120.00,38784.70
172000,202206,34,29,5,35148.00,6060.00,41208.00
172010,202206,53,42,11,50904.00,13332.00,64236.00
172015,202206,22,16,6,19392.52,7272.00,26664.52
172020,202206,142,90,52,109080.10,63024.10,172104.20
172025,202206,37,24,13,29088.00,15756.00,44844.00
172030,202206,44,26,18,31512.00,21816.00,53328.00
172049,202206,82,51,31,61812.00,37572.00,99384.00
172065,202206,108,70,38,84840.20,46056.00,130896.20
172080,202206,113,68,45,82416.54,54540.40,136956.94
172085,202206,30,16,14,19392.00,16968.00,36360.00
172090,202206,427,319,108,386631.30,130896.20,517527.50
172093,202206,14,12,2,14544.00,2424.00,16968.00
172097,202206,18,9,9,10908.00,10908.00,21816.00
172100,202206,5483,3127,2356,3791180.24,2855495.28,6646675.52
172110,202206,80,53,27,64236.00,32724.00,96960.00
172120,202206,1678,1401,277,1698041.44,335726.53,2033767.97
172125,202206,11,10,1,12120.00,1212.00,13332.00
172130,202206,25,15,10,18180.00,12120.70,30300.70
172208,202206,192,117,75,141804.00,90900.68,232704.68
172210,202206,351,179,172,216949.78,208464.76,425414.54
210005,202206,2954,1866,1088,2261626.89,1322306.44,3583933.33
210010,202206,143,90,53,109080.40,64236.00,173316.40
210015,202206,41,30,11,36360.49,13332.00,49692.49
210020,202206,370,214,156,259368.55,189072.53,448441.08
210030,202206,309,211,98,255736.85,118777.19,374514.04
210040,202206,134,107,27,129684.10,32724.00,162408.10
210043,202206,265,213,52,258159.85,63024.00,321183.85
210047,202206,467,287,180,347844.64,218160.00,566004.64
210050,202206,265,195,70,236340.00,84840.00,321180.00
210055,202206,52,42,10,50904.00,12120.00,63024.00
210060,202206,516,422,94,511470.72,113929.34,625400.06
210070,202206,436,335,101,406020.00,122412.00,528432.00
210080,202206,134,123,11,149076.40,13332.00,162408.40
210083,202206,282,142,140,172104.00,169680.00,341784.00
210087,202206,5,4,1,4848.00,1212.00,6060.00
210090,202206,422,302,120,366029.39,145441.82,511471.21
210095,202206,400,308,92,373297.05,111505.24,484802.29
210100,202206,683,545,138,660541.73,167256.00,827797.73
210110,202206,117,81,36,98172.54,43632.00,141804.54
210120,202206,4812,3816,996,4626286.98,1207158.36,5833445.34
210125,202206,177,111,66,134532.00,79992.85,214524.85
210130,202206,443,262,181,317545.54,219372.00,536917.54
210135,202206,27,20,7,24240.00,8484.00,32724.00
210140,202206,4366,3365,1001,4078437.10,1213220.44,5291657.54
210150,202206,353,226,127,273916.35,153925.18,427841.53
210160,202206,3159,2690,469,3261533.36,568431.21,3829964.57
210170,202206,1191,957,234,1159902.53,283608.20,1443510.73
210173,202206,123,111,12,134532.00,14544.00,149076.00
210177,202206,303,174,129,210889.04,156348.00,367237.04
210180,202206,29,16,13,19392.20,15756.00,35148.20
210190,202206,431,290,141,351480.00,170892.70,522372.70
210193,202206,7,5,2,6060.00,2424.00,8484.00
210197,202206,66,49,17,59388.00,20604.00,79992.00
210200,202206,582,495,87,601157.45,105444.30,706601.75
210203,202206,206,147,59,178166.16,71508.72,249674.88
210207,202206,349,290,59,351483.02,71508.00,422991.02
210210,202206,690,643,47,779321.64,56964.00,836285.64
210215,202206,73,63,10,76357.15,12120.00,88477.15
210220,202206,350,303,47,367237.69,56965.09,424202.78
210230,202206,300,243,57,294518.20,69084.00,363602.20
210232,202206,1203,854,349,1037478.22,424200.20,1461678.42
210235,202206,182,139,43,168469.41,52116.40,220585.81
210237,202206,37,19,18,23028.89,21816.00,44844.89
210240,202206,75,65,10,78780.00,12120.00,90900.00
210250,202206,175,151,24,183013.10,29088.00,212101.10
210255,202206,359,273,86,330879.39,104232.60,435111.99
210260,202206,373,258,115,312696.20,139380.00,452076.20
210270,202206,594,410,184,496922.45,223008.00,719930.45
210275,202206,95,75,20,90900.12,24240.00,115140.12
210280,202206,1038,688,350,833860.08,424200.60,1258060.68
210290,202206,492,329,163,398750.28,197556.20,596306.48
210300,202206,4777,3074,1703,3726929.56,2065251.18,5792180.74
210310,202206,115,77,38,93324.62,46056.00,139380.62
210312,202206,118,83,35,100596.00,42420.00,143016.00
210315,202206,113,95,18,115140.00,21816.00,136956.00
210317,202206,135,102,33,123624.00,39996.00,163620.00
210320,202206,2323,1996,327,2419174.20,396324.20,2815498.40
210325,202206,143,86,57,104233.15,69084.20,173317.35
210330,202206,4096,2404,1692,2914881.70,2050706.00,4965587.70
210340,202206,1184,907,277,1100506.71,335725.39,1436232.10
210350,202206,659,551,108,667814.16,130896.00,798710.16
210355,202206,137,117,20,141804.91,24240.00,166044.91
210360,202206,1975,1409,566,1707723.02,685992.87,2393715.89
210370,202206,1188,615,573,745384.02,695688.40,1441072.42
210375,202206,184,90,94,109084.69,113928.90,223013.59
210380,202206,712,558,154,676298.00,186648.93,862946.93
210390,202206,185,156,29,189072.83,35148.00,224220.83
210400,202206,383,334,49,404812.59,59388.00,464200.59
210405,202206,1004,716,288,867798.67,349056.97,1216855.64
210407,202206,69,56,13,67872.00,15756.00,83628.00
210408,202206,44,40,4,48480.20,4848.00,53328.20
210409,202206,322,282,40,341784.16,48480.00,390264.16
210410,202206,432,344,88,416928.00,106656.00,523584.00
210420,202206,199,165,34,199980.50,42420.18,242400.68
210430,202206,53,38,15,46056.00,18180.00,64236.00
210440,202206,368,249,119,301791.82,144228.00,446019.82
210450,202206,106,91,15,110294.20,18180.00,128474.20
210455,202206,232,126,106,152716.13,128472.99,281189.12
210460,202206,302,208,94,252097.80,113928.00,366025.80
210462,202206,67,57,10,69084.10,12120.00,81204.10
210465,202206,134,107,27,129685.03,32724.00,162409.03
210467,202206,516,383,133,464198.02,161196.90,625394.92
210470,202206,47,40,7,48480.00,8484.00,56964.00
210480,202206,1269,921,348,1116259.64,422991.10,1539250.74
210490,202206,183,130,53,157561.06,64236.00,221797.06
210500,202206,469,293,176,355121.03,213312.00,568433.03
210510,202206,514,421,93,510252.60,112716.20,622968.80
210515,202206,343,220,123,266640.20,149076.20,415716.40
210520,202206,390,355,35,430261.59,42420.00,472681.59
210530,202206,9368,4871,4497,5904952.76,5450443.97,11355396.73
210535,202206,118,89,29,107868.40,35148.00,143016.40
210540,202206,1476,990,486,1199893.57,589033.97,1788927.54
210542,202206,1094,562,532,681151.01,644791.61,1325942.62
210545,202206,24,22,2,26664.20,2424.00,29088.20
210547,202206,122,107,15,129685.19,18180.31,147865.50
210550,202206,581,419,162,507834.06,196345.11,704179.17
210560,202206,153,131,22,158772.20,26664.00,185436.20
210565,202206,21,15,6,18180.00,7272.08,25452.08
210570,202206,1262,1059,203,1284729.86,246036.00,1530765.86
210580,202206,123,107,16,129684.00,19392.00,149076.00
210590,202206,699,583,116,706596.90,140592.00,847188.90
210592,202206,43,40,3,48480.00,3636.00,52116.00
210594,202206,102,89,13,107868.20,15756.00,123624.20
210596,202206,113,98,15,118776.00,18180.00,136956.00
210598,202206,135,104,31,127260.00,37572.00,164832.00
210600,202206,295,257,38,311487.48,46056.00,357543.48
210610,202206,236,222,14,269065.73,16968.00,286033.73
210620,202206,43,28,15,33936.00,18180.20,52116.20
210630,202206,68,65,3,78780.00,3636.00,82416.00
210632,202206,958,685,273,830221.00,330876.00,1161097.00
210635,202206,24,21,3,25452.00,3636.00,29088.00
210637,202206,123,89,34,107868.20,41208.00,149076.20
210640,202206,560,499,61,604788.42,73932.00,678720.42
210650,202206,379,322,57,390266.60,69084.00,459350.60
210660,202206,342,275,67,333304.35,81204.20,414508.55
210663,202206,53,41,12,49692.10,14544.00,64236.10
210667,202206,92,42,50,50904.40,60600.80,111505.20
210670,202206,244,218,26,264217.52,31512.60,295730.12
210675,202206,482,278,204,336942.30,247249.69,584191.99
210680,202206,222,140,82,169680.40,99384.00,269064.40
210690,202206,73,65,8,78780.00,9696.00,88476.00
210700,202206,153,116,37,140592.30,44844.00,185436.30
210710,202206,223,141,82,172105.63,99384.60,271490.23
210720,202206,128,113,15,136956.43,18180.00,155136.43
210725,202206,59,50,9,60601.93,10908.00,71509.93
210730,202206,20,16,4,19392.00,4848.00,24240.00
210735,202206,279,204,75,247248.83,90900.60,338149.43
210740,202206,506,440,66,533285.21,79992.00,613277.21
210745,202206,150,113,37,136956.50,44844.00,181800.50
210750,202206,2421,1264,1157,1533202.12,1404713.24,2937915.36
210760,202206,236,184,52,224220.20,63024.00,287244.20
210770,202206,237,194,43,235134.64,52116.40,287251.04
210780,202206,401,306,95,370877.60,115140.20,486017.80
210790,202206,183,156,27,189072.20,32724.00,221796.20
210800,202206,165,128,37,155138.37,44844.20,199982.57
210805,202206,58,52,6,63024.00,7272.00,70296.00
210810,202206,439,357,82,432687.52,99384.00,532071.52
210820,202206,1928,1614,314,1956191.55,380568.07,2336759.62
210825,202206,146,87,59,105444.40,71508.00,176952.40
210830,202206,669,464,205,562369.60,248460.20,810829.80
210840,202206,194,142,52,172104.00,63024.00,235128.00
210845,202206,223,171,52,207252.23,63024.00,270276.23
210850,202206,696,484,212,586614.63,256944.99,843559.62
210860,202206,3322,1963,1359,2379174.08,1648321.30,4027495.38
210870,202206,407,326,81,395115.65,98172.20,493287.85
210880,202206,79,62,17,75145.17,20604.00,95749.17
210890,202206,309,270,39,327245.16,47268.00,374513.16
210900,202206,649,424,225,513896.57,272701.40,786597.97
210905,202206,66,41,25,49692.00,30300.00,79992.00
210910,202206,2068,1556,512,1885889.10,620547.47,2506436.57
210920,202206,144,62,82,75144.00,99384.00,174528.00
210923,202206,79,65,14,78780.15,16968.00,95748.15
210927,202206,406,210,196,254521.55,237552.00,492073.55
210930,202206,70,57,13,69084.00,15756.00,84840.00
210940,202206,78,62,16,75144.20,19392.00,94536.20
210945,202206,193,112,81,135744.88,98172.00,233916.88
210950,202206,492,363,129,439956.13,156348.00,596304.13
210955,202206,85,54,31,65448.00,37572.00,103020.00
210960,202206,2230,1139,1091,1381687.21,1322292.20,2703979.41
210970,202206,105,91,14,110292.20,16968.90,127261.10
210975,202206,78,74,4,89688.20,4848.00,94536.20
210980,202206,1037,521,516,631454.66,625392.80,1256847.46
210990,202206,4294,3009,1285,3650578.52,1557427.78,5208006.30
211000,202206,1225,1009,216,1222917.03,261793.13,1484710.16
211003,202206,937,683,254,827799.45,307848.20,1135647.65
211010,202206,465,422,43,511464.77,52117.01,563581.78
211020,202206,1326,589,737,713873.05,893246.42,1607119.47
211023,202206,42,37,5,44844.00,6060.00,50904.00
211027,202206,75,56,19,67872.00,23028.00,90900.00
211030,202206,353,252,101,305424.20,122412.00,427836.20
211040,202206,280,235,45,284821.46,54540.00,339361.46
211050,202206,1073,736,337,892041.25,408445.50,1300486.75
211060,202206,600,532,68,644794.33,82416.43,727210.76
211065,202206,24,19,5,23029.13,6060.11,29089.24
211070,202206,815,688,127,833868.27,153924.20,987792.47
211080,202206,81,79,2,95748.63,2424.00,98172.63
211085,202206,59,33,26,39996.20,31512.00,71508.20
211090,202206,73,63,10,76356.00,12120.00,88476.00
211100,202206,442,374,68,453291.45,82416.20,535707.65
211102,202206,219,157,62,190284.00,75144.00,265428.00
211105,202206,209,148,61,179376.60,73932.26,253308.86
211107,202206,121,77,44,93324.00,53328.00,146652.00
211110,202206,929,629,300,762356.20,363604.79,1125960.99
211120,202206,4845,2529,2316,3066414.51,2807009.31,5873423.82
211125,202206,20,13,7,15756.00,8484.00,24240.00
211130,202206,39408,18640,20768,22594434.71,25174585.86,47769020.57
211140,202206,388,341,47,413296.77,56964.00,470260.77
211150,202206,1150,809,341,980518.05,413293.29,1393811.34
211153,202206,161,98,63,118776.00,76356.00,195132.00
211157,202206,68,57,11,69084.20,13332.00,82416.20
211160,202206,657,565,92,684785.09,111504.20,796289.29
211163,202206,4,4,0,4848.00,,4848.00
211167,202206,12,11,1,13332.00,1212.00,14544.00
211170,202206,401,298,103,361176.00,124836.00,486012.00
211172,202206,113,81,32,98172.02,38784.00,136956.02
211174,202206,18,16,2,19392.00,2424.60,21816.60
211176,202206,439,318,121,385419.08,146652.20,532071.28
211178,202206,91,62,29,75144.00,35148.20,110292.20
211180,202206,210,171,39,207252.99,47268.04,254521.03
211190,202206,71,64,7,77568.00,8484.00,86052.00
211195,202206,32,22,10,26664.78,12120.00,38784.78
211200,202206,144,124,20,150288.00,24240.20,174528.20
211210,202206,385,293,92,355117.89,111504.00,466621.89
211220,202206,4115,2457,1658,2977931.11,2009523.05,4987454.16
211223,202206,106,100,6,121200.46,7272.00,128472.46
211227,202206,52,43,9,52116.20,10908.00,63024.20
211230,202206,693,573,120,694482.74,145441.00,839923.74
211240,202206,366,303,63,367237.00,76356.00,443593.00
211245,202206,174,93,81,112716.14,98172.00,210888.14
211250,202206,1455,1262,193,1530781.17,233916.90,1764698.07
211260,202206,760,644,116,780529.10,140592.00,921121.10
211270,202206,1810,1499,311,1816804.04,376932.54,2193736.58
211280,202206,1698,1145,553,1387746.71,671448.00,2059194.71
211285,202206,207,134,73,163620.20,88476.00,252096.20
211290,202206,706,505,201,612061.93,243612.00,855673.93
211300,202206,737,592,145,717509.90,175741.28,893251.18
211400,202206,1499,968,531,1173231.93,644785.16,1818017.09
220005,202206,16,15,1,18180.00,1212.00,19392.00
220010,202206,80,67,13,81204.00,15756.00,96960.00
220020,202206,700,573,127,694478.81,153924.40,848403.21
220025,202206,99,96,3,116353.78,3636.00,119989.78
220027,202206,50,41,9,49692.00,10908.00,60600.00
220030,202206,116,98,18,118776.89,21816.00,140592.89
220040,202206,1215,940,275,1139286.50,334514.26,1473800.76
220045,202206,29,20,9,24240.27,10908.40,35148.67
220050,202206,670,556,114,673875.75,138168.39,812044.14
220060,202206,172,151,21,183013.86,25452.20,208466.06
220070,202206,110,96,14,116352.71,16968.00,133320.71
220080,202206,12,11,1,13332.00,1212.00,14544.00
220090,202206,37,27,10,32724.00,12120.00,44844.00
220095,202206,1,1,0,1212.00,,1212.00
220100,202206,20,17,3,20604.20,3636.00,24240.20
220105,202206,26,24,2,29088.60,2424.00,31512.60
220110,202206,231,215,16,260580.00,19392.00,279972.00
220115,202206,39,35,4,42420.00,4848.00,47268.00
220117,202206,21,19,2,23028.00,2424.00,25452.00
220120,202206,1440,1107,333,1341688.52,404808.00,1746496.52
220130,202206,27,26,1,31512.00,1212.00,32724.00
220140,202206,94,75,19,90900.20,23028.20,113928.40
220150,202206,480,363,117,439961.41,141806.30,581767.71
220155,202206,14,13,1,15756.00,1212.00,16968.00
220157,202206,20,17,3,20604.20,3636.00,24240.20
220160,202206,98,86,12,104232.00,14544.00,118776.00
220170,202206,38,33,5,39996.00,6060.00,46056.00
220173,202206,9,8,1,9696.00,1212.00,10908.00
220177,202206,11,11,0,13332.00,,13332.00
220180,202206,64,63,1,76356.20,1212.00,77568.20
220190,202206,1079,941,138,1140498.23,167256.49,1307754.72
220191,202206,37,32,5,38784.46,6060.79,44845.25
220192,202206,88,83,5,100596.00,6060.00,106656.00
220194,202206,58,52,6,63024.00,7272.00,70296.00
220196,202206,80,66,14,79992.94,16968.00,96960.94
220198,202206,1,1,0,1212.00,,1212.00
220200,202206,400,337,63,408447.23,76356.88,484804.11
220202,202206,36,31,5,37572.00,6060.00,43632.00
220205,202206,62,54,8,65448.00,9696.00,75144.00
220207,202206,14,14,0,16968.00,,16968.00
220208,202206,73,44,29,53328.20,35148.00,88476.20
220209,202206,32,27,5,32724.00,6060.00,38784.00
220210,202206,19,15,4,18180.00,4848.00,23028.00
220211,202206,31,29,2,35148.00,2424.00,37572.00
220213,202206,31,28,3,33936.84,3636.00,37572.84
220217,202206,38,31,7,37572.20,8484.00,46056.20
220220,202206,2245,1497,748,1814373.08,907791.61,2722164.69
220225,202206,8,3,5,3636.20,6060.00,9696.20
220230,202206,964,740,224,896885.99,271490.72,1168376.71
220240,202206,164,144,20,174528.64,24240.32,198768.96
220245,202206,35,32,3,38784.55,3636.00,42420.55
220250,202206,119,102,17,123626.45,20604.00,144230.45
220253,202206,51,45,6,54540.00,7272.00,61812.00
220255,202206,43,37,6,44844.00,7272.00,52116.00
220260,202206,692,530,162,642362.67,196344.64,838707.31
220265,202206,7,6,1,7272.00,1212.00,8484.00
220270,202206,816,737,79,893246.71,95748.00,988994.71
220271,202206,38,29,9,35148.30,10908.00,46056.30
220272,202206,14,14,0,16968.00,,16968.00
220273,202206,16,15,1,18180.20,1212.00,19392.20
220275,202206,59,50,9,60600.00,10908.00,71508.00
220277,202206,21,16,5,19392.00,6060.70,25452.70
220280,202206,17,11,6,13332.00,7272.00,20604.00
220285,202206,38,36,2,43632.00,2424.00,46056.00
220290,202206,1479,1271,208,1540468.05,253311.06,1793779.11
220300,202206,34,33,1,39996.40,1212.00,41208.40
220310,202206,329,278,51,338150.89,61812.48,399963.37
220320,202206,430,397,33,481170.68,39996.00,521166.68
220323,202206,2,1,1,1212.80,1212.00,2424.80
220325,202206,8,7,1,8484.00,1212.00,9696.00
220327,202206,12,12,0,14544.00,,14544.00
220330,202206,222,158,64,192708.20,77568.00,270276.20
220335,202206,132,111,21,134533.20,25452.00,159985.20
220340,202206,46,33,13,39996.00,15756.00,55752.00
220342,202206,53,44,9,53329.22,10908.00,64237.22
220345,202206,80,68,12,82416.00,14544.00,96960.00
220350,202206,455,395,60,478740.47,72720.00,551460.47
220360,202206,42,32,10,38784.00,12120.00,50904.00
220370,202206,1273,1063,210,1288364.05,254520.94,1542884.99
220375,202206,14,14,0,16968.20,,16968.20
220380,202206,26,19,7,23028.20,8484.00,31512.20
220385,202206,14,13,1,15756.00,1212.66,16968.66
220390,202206,2297,1281,1016,1552586.60,1231402.36,2783988.96
220400,202206,35,30,5,36360.00,6060.00,42420.00
220410,202206,22,21,1,25452.00,1212.00,26664.00
220415,202206,13,12,1,14544.40,1212.00,15756.40
220420,202206,123,104,19,126048.40,23028.00,149076.40
220430,202206,130,115,15,139380.00,18180.00,157560.00
220435,202206,21,16,5,19392.00,6060.00,25452.00
220440,202206,259,221,38,267856.71,46056.00,313912.71
220450,202206,335,165,170,199982.73,206041.20,406023.93
220455,202206,48,47,1,56964.20,1212.00,58176.20
220460,202206,18,16,2,19392.40,2424.99,21817.39
220465,202206,67,44,23,53328.10,27876.28,81204.38
220470,202206,227,199,28,241190.34,33936.00,275126.34
220480,202206,69,64,5,78780.00,6060.00,84840.00
220490,202206,85,73,12,88476.00,14544.00,103020.00
220500,202206,114,96,18,116352.00,21816.00,138168.00
220510,202206,362,280,82,339362.06,99384.00,438746.06
220515,202206,20,18,2,21816.00,2424.00,24240.00
220520,202206,368,326,42,395114.75,50904.40,446019.15
220525,202206,7,3,4,3636.00,4848.00,8484.00
220527,202206,16,13,3,15756.00,3636.00,19392.00
220530,202206,43,22,21,26664.00,25452.00,52116.00
220535,202206,5,4,1,4848.20,1212.00,6060.20
220540,202206,86,75,11,90900.40,13332.00,104232.40
220545,202206,25,16,9,19392.20,10908.00,30300.20
220550,202206,702,554,148,671454.46,179376.70,850831.16
220551,202206,12,10,2,12120.00,2424.00,14544.00
220552,202206,11,11,0,13332.00,,13332.00
220553,202206,52,46,6,55752.67,7272.20,63024.87
220554,202206,8,5,3,6060.20,3636.00,9696.20
220555,202206,42,35,7,42420.68,8484.00,50904.68
220556,202206,37,35,2,42420.00,2424.00,44844.00
220557,202206,58,50,8,60600.40,9696.00,70296.40
220558,202206,7,3,4,3636.00,4848.00,8484.00
220559,202206,3,3,0,3636.00,,3636.00
220560,202206,73,48,25,58176.00,30300.00,88476.00
220570,202206,700,438,262,530857.91,317544.40,848402.31
220580,202206,539,494,45,598741.37,54541.00,653282.37
220585,202206,12,11,1,13332.20,1212.20,14544.40
220590,202206,13,12,1,14544.00,1212.00,15756.00
220595,202206,75,57,18,69084.62,21816.10,90900.72
220600,202206,22,15,7,18180.00,8484.00,26664.00
220605,202206,27,24,3,29088.00,3636.00,32724.00
220610,202206,86,72,14,88476.00,16968.00,105444.00
220620,202206,545,461,84,558734.66,101808.84,660543.50
220630,202206,4,2,2,2424.00,2424.00,4848.00
220635,202206,32,29,3,35148.00,3636.00,38784.00
220640,202206,105,86,19,104232.00,23028.00,127260.00
220650,202206,114,108,6,130896.00,7272.00,138168.00
220660,202206,61,46,15,55752.82,18180.20,73933.02
220665,202206,8,8,0,9696.00,,9696.00
220667,202206,16,14,2,16968.77,2424.00,19392.77
220669,202206,33,27,6,32724.20,7272.00,39996.20
220670,202206,65,51,14,61812.00,16968.00,78780.00
220672,202206,79,58,21,70296.81,25452.00,95748.81
220675,202206,29,22,7,26664.67,8484.00,35148.67
220680,202206,54,47,7,56964.00,8484.00,65448.00
220690,202206,51,48,3,58176.20,3636.00,61812.20
220695,202206,26,14,12,16968.14,14544.00,31512.14
220700,202206,1788,1377,411,1668931.93,498132.78,2167064.71
220710,202206,7,5,2,6060.00,2424.00,8484.00
220720,202206,109,93,16,112716.00,19392.00,132108.00
220730,202206,19,18,1,21816.00,1212.00,23028.00
220735,202206,5,2,3,2424.00,3636.00,6060.00
220740,202206,47,42,5,50904.00,6060.00,56964.00
220750,202206,109,92,17,111504.20,20605.09,132109.29
220755,202206,17,17,0,20604.77,,20604.77
220760,202206,65,57,8,69084.60,9696.00,78780.60
220770,202206,5705,3236,2469,3924505.41,2993667.30,6918172.71
220775,202206,12,9,3,10908.00,3636.80,14544.80
220777,202206,19,18,1,23028.00,1212.00,24240.00
220779,202206,2,0,2,,2424.00,2424.00
220780,202206,883,749,134,907789.30,163621.56,1071410.86
220785,202206,4,1,3,1212.00,3636.00,4848.00
220790,202206,1161,932,229,1129592.39,277551.44,1407143.83
220793,202206,5,4,1,4848.00,1212.00,6060.00
220795,202206,17,15,2,18180.20,2424.00,20604.20
220800,202206,3969,3042,927,3689572.67,1127164.26,4816736.93
220810,202206,70,62,8,75144.99,9696.00,84840.99
220820,202206,239,217,22,263007.02,26665.80,289672.82
220830,202206,1245,1091,154,1322297.67,186649.10,1508946.77
220840,202206,2447,1728,719,2094350.47,872644.22,2966994.69
220850,202206,68,61,7,73932.00,8484.00,82416.00
220855,202206,9,5,4,6060.00,4848.00,10908.00
220860,202206,10,8,2,9696.30,2424.00,12120.30
220865,202206,28,24,4,29088.00,4848.00,33936.00
220870,202206,84,76,8,92112.60,9696.00,101808.60
220880,202206,330,271,59,328454.94,72721.05,401175.99
220885,202206,26,25,1,30300.49,1212.00,31512.49
220887,202206,6,5,1,6060.20,1212.00,7272.20
220890,202206,84,72,12,87264.73,14544.00,101808.73
220900,202206,26,14,12,16968.00,14544.00,31512.00
220910,202206,48,38,10,46056.20,12120.00,58176.20
220915,202206,9,8,1,9696.00,1212.00,10908.00
220920,202206,46,40,6,48481.31,7272.00,55753.31
220930,202206,45,43,2,52116.00,2424.00,54540.00
220935,202206,13,13,0,15756.00,,15756.00
220937,202206,34,30,4,36360.40,4848.00,41208.40
220940,202206,54,50,4,60600.00,4848.00,65448.00
220945,202206,2,2,0,2424.00,,2424.00
220950,202206,33,26,7,31512.00,8484.00,39996.00
220955,202206,14,14,0,16968.72,,16968.72
220960,202206,28,26,2,31512.60,2424.00,33936.60
220965,202206,40,37,3,44844.00,3636.00,48480.00
220970,202206,62,52,10,63024.00,12120.00,75144.00
220975,202206,11,10,1,12120.20,1212.00,13332.20
220980,202206,31,29,2,35148.00,2424.00,37572.00
220985,202206,54,47,7,56964.00,8484.00,65448.00
220987,202206,30,28,2,33936.20,2424.00,36360.20
220990,202206,23,22,1,26664.00,1212.00,27876.00
220995,202206,11,9,2,10908.21,2424.00,13332.21
220997,202206,59,53,6,64236.20,7272.00,71508.20
221000,202206,1215,1083,132,1312606.02,159984.36,1472590.38
221005,202206,40,37,3,44844.00,3636.20,48480.20
221010,202206,23,17,6,20604.00,7272.00,27876.00
221020,202206,32,31,1,37572.42,1212.00,38784.42
221030,202206,36,29,7,35052.25,8484.00,43536.25
221035,202206,22,21,1,25452.20,1212.00,26664.20
221037,202206,13,9,4,10908.00,4848.00,15756.00
221038,202206,26,23,3,27876.00,3636.00,31512.00
221039,202206,24,23,1,27876.94,1212.20,29089.14
221040,202206,262,227,35,275124.66,42420.00,317544.66
221050,202206,222,186,36,225433.64,43632.20,269065.84
221060,202206,1916,1648,268,1997396.34,324818.35,2322214.69
221062,202206,28,27,1,32724.34,1212.00,33936.34
221063,202206,17,12,5,14544.00,6060.00,20604.00
221065,202206,69,56,13,67872.00,15756.00,83628.00
221070,202206,140,122,18,147864.94,21816.00,169680.94
221080,202206,378,322,56,390268.42,67872.00,458140.42
221090,202206,18,14,4,16969.05,4848.00,21817.05
221093,202206,42,31,11,37572.00,13332.00,50904.00
221095,202206,4,4,0,4848.00,,4848.00
221097,202206,12,10,2,12120.00,2424.00,14544.00
221100,202206,25682,15454,10228,18734164.88,12417054.93,31151219.81
221110,202206,1106,848,258,1027789.66,312697.53,1340487.19
221120,202206,544,397,147,481166.62,178164.00,659330.62
221130,202206,976,789,187,956271.96,226644.14,1182916.10
221135,202206,31,27,4,32724.00,4848.00,37572.00
221140,202206,45,38,7,46056.24,8484.00,54540.24
221150,202206,9,7,2,8484.00,2424.00,10908.00
221160,202206,12,12,0,14544.90,,14544.90
221170,202206,19,17,2,20604.00,2424.00,23028.00
230010,202206,153,135,18,163620.11,21816.00,185436.11
230015,202206,149,123,26,149076.00,31512.00,180588.00
230020,202206,1660,1360,300,1648330.15,363607.48,2011937.63
230030,202206,1645,1191,454,1444720.68,550250.54,1994971.22
230040,202206,220,175,45,212100.00,54540.00,266640.00
230050,202206,233,167,66,202404.00,79992.00,282396.00
230060,202206,160,128,32,155136.00,38784.70,193920.70
230070,202206,298,255,43,309061.07,52116.00,361177.07
230075,202206,858,722,136,875067.80,164832.32,1039900.12
230080,202206,205,174,31,210888.00,37572.00,248460.00
230090,202206,155,116,39,140592.00,47268.00,187860.00
230100,202206,2447,1388,1059,1683481.84,1283514.20,2966996.04
230110,202206,2920,1851,1069,2243434.27,1296849.51,3540283.78
230120,202206,1106,856,250,1037482.84,303000.67,1340483.51
230125,202206,162,129,33,156348.20,39996.00,196344.20
230130,202206,477,422,55,511468.12,66660.00,578128.12
230140,202206,206,168,38,203616.20,46056.00,249672.20
230150,202206,151,116,35,140592.20,42420.20,183012.40
230160,202206,954,785,169,951420.70,204828.48,1156249.18
230170,202206,626,557,69,675092.04,83628.27,758720.31
230180,202206,68,62,6,75144.00,7272.00,82416.00
230185,202206,407,344,63,416929.00,76356.00,493285.00
230190,202206,2439,1877,562,2274951.63,683570.02,2958521.65
230195,202206,492,424,68,513892.02,82416.00,596308.02
230200,202206,429,335,94,406023.34,113928.20,519951.54
230205,202206,395,266,129,322392.00,156348.00,478740.00
230210,202206,1400,1071,329,1298060.87,398749.08,1696809.95
230220,202206,1574,1055,519,1278668.70,629031.86,1907700.56
230230,202206,973,812,161,984147.50,195134.13,1179281.63
230240,202206,1869,1627,242,1971939.78,293307.02,2265246.80
230250,202206,1767,1447,320,1753782.77,389056.69,2142839.46
230260,202206,3214,1989,1225,2410674.86,1485914.07,3896588.93
230270,202206,1340,1051,289,1275029.61,351482.10,1626511.71
230280,202206,2801,2129,672,2580370.48,816893.51,3397263.99
230290,202206,351,308,43,373301.72,52117.15,425418.87
230300,202206,502,365,137,442380.94,166044.00,608424.94
230310,202206,427,331,96,402384.42,116352.00,518736.42
230320,202206,922,778,144,942944.49,174528.20,1117472.69
230330,202206,311,247,64,299364.29,77568.60,376932.89
230340,202206,441,356,85,431473.20,103020.00,534493.20
230350,202206,3318,2051,1267,2485836.04,1535613.56,4021449.60
230360,202206,272,223,49,270277.82,59388.36,329666.18
230365,202206,125,101,24,122412.73,29088.00,151500.73
230370,202206,10908,5412,5496,6565507.13,6666065.52,13231572.65
230380,202206,488,420,68,509042.52,82416.85,591459.37
230390,202206,527,302,225,366026.19,272700.60,638726.79
230393,202206,233,193,40,233916.67,49692.50,283609.17
230395,202206,353,287,66,347847.17,79993.59,427840.76
230400,202206,638,510,128,618122.99,155137.00,773259.99
230410,202206,2733,1705,1028,2066481.25,1245945.71,3312426.96
230420,202206,6479,4310,2169,5225005.66,2638547.70,7863553.36
230423,202206,335,291,44,352692.20,53328.00,406020.20
230425,202206,469,375,94,454501.90,113929.35,568431.25
230426,202206,111,86,25,104232.00,30300.00,134532.00
230427,202206,71,66,5,79992.00,6060.00,86052.00
230428,202206,1601,798,803,967180.37,974450.78,1941631.15
230430,202206,457,370,87,449656.04,105444.96,555101.00
230435,202206,944,691,253,839917.77,307848.85,1147766.62
230440,202206,94413,43007,51406,52145478.07,62345779.60,114491257.67
230445,202206,326,223,103,270278.95,124836.00,395114.95
230450,202206,577,454,123,550248.70,149076.00,699324.70
230460,202206,86,63,23,76356.87,27876.00,104232.87
230465,202206,315,258,57,312697.89,69084.00,381781.89
230470,202206,2023,1581,442,1916178.78,535706.15,2451884.93
230480,202206,149,136,13,164832.00,15756.00,180588.00
230490,202206,328,258,70,312696.00,84840.00,397536.00
230495,202206,485,343,142,415719.36,172106.65,587826.01
230500,202206,1076,808,268,979298.56,324816.23,1304114.79
230510,202206,61,44,17,53328.00,20604.00,73932.00
230520,202206,406,312,94,378144.62,113928.00,492072.62
230523,202206,2498,1547,951,1877401.01,1153834.23,3031235.24
230526,202206,253,217,36,263004.93,43632.00,306636.93
230530,202206,685,504,181,610852.30,219373.57,830225.87
230533,202206,216,197,19,238764.77,23028.20,261792.97
230535,202206,375,278,97,338149.15,117564.20,455713.35
230540,202206,1771,1579,192,1913763.24,232705.29,2146468.53
230550,202206,4000,2561,1439,3105194.21,1744091.64,4849285.85
230560,202206,591,448,143,542978.99,173316.52,716295.51
230565,202206,219,164,55,198768.00,66660.00,265428.00
230570,202206,291,248,43,300576.40,52116.00,352692.40
230580,202206,1206,855,351,1036263.87,425414.52,1461678.39
230590,202206,1021,790,231,958695.68,279974.06,1238669.74
230600,202206,261,236,25,286033.14,30300.00,316333.14
230610,202206,445,332,113,402384.87,136956.37,539341.24
230620,202206,165,144,21,174530.07,25452.00,199982.07
230625,202206,820,558,262,676298.64,317544.40,993843.04
230630,202206,1383,1047,336,1268973.66,407234.42,1676208.08
230640,202206,3845,3182,663,3856625.98,804779.85,4661405.83
230650,202206,495,421,74,510253.24,89688.64,599941.88
230655,202206,708,577,131,699329.39,158773.20,858102.59
230660,202206,348,288,60,349057.45,72721.14,421778.59
230670,202206,463,376,87,455718.59,105444.71,561163.30
230680,202206,208,184,24,223008.60,29088.00,252096.60
230690,202206,946,795,151,963549.58,183012.10,1146561.68
230700,202206,941,788,153,955062.11,185437.02,1140499.13
230710,202206,654,612,42,741752.09,50904.00,792656.09
230720,202206,144,124,20,150288.00,24240.00,174528.00
230725,202206,250,191,59,231492.05,71508.00,303000.05
230730,202206,12600,6727,5873,8155565.06,7121760.00,15277325.06
230740,202206,680,538,142,652067.74,172104.20,824171.94
230750,202206,823,687,136,832649.83,164832.30,997482.13
230760,202206,1519,1305,214,1582889.30,259368.76,1842258.06
230763,202206,329,269,60,326030.00,72720.00,398750.00
230765,202206,8159,3817,4342,4626270.36,5266201.53,9892471.89
230770,202206,5028,2543,2485,3082151.35,3014260.81,6096412.16
230780,202206,788,686,102,831433.75,123624.19,955057.94
230790,202206,313,256,57,310272.00,69084.00,379356.00
230800,202206,1151,828,323,1003538.53,391476.20,1395014.73
230810,202206,1410,1232,178,1493203.46,216949.02,1710152.48
230820,202206,374,250,124,303001.00,150288.20,453289.20
230830,202206,954,807,147,978091.63,178164.00,1156255.63
230835,202206,275,230,45,279973.95,54540.00,334513.95
230837,202206,172,139,33,168468.49,39996.50,208464.99
230840,202206,947,732,215,887185.87,261793.40,1148979.27
230850,202206,1384,1187,197,1439878.59,238766.79,1678645.38
230860,202206,317,238,79,288456.00,95754.06,384210.06
230870,202206,1844,1561,283,1891942.10,342996.67,2234938.77
230880,202206,81,63,18,76356.00,21816.00,98172.00
230890,202206,542,483,59,585397.75,71508.19,656905.94
230900,202206,296,220,76,266640.30,92112.88,358753.18
230910,202206,223,171,52,207252.00,63024.00,270276.00
230920,202206,483,376,107,456925.37,129684.00,586609.37
230930,202206,1060,737,323,894462.75,391478.32,1285941.07
230940,202206,836,644,192,780533.52,232705.35,1013238.87
230945,202206,539,433,106,524802.43,128475.77,653278.20
230950,202206,432,372,60,450867.57,72720.52,523588.09
230960,202206,2780,1836,944,2226471.64,1144147.97,3370619.61
230970,202206,1757,966,791,1170805.07,959910.60,2130715.67
230980,202206,202,160,42,193921.14,50904.00,244825.14
230990,202206,140,112,28,135744.00,33936.90,169680.90
231000,202206,201,185,16,224220.00,19392.00,243612.00
231010,202206,161,115,46,139380.20,55752.72,195132.92
231020,202206,1415,961,454,1164746.28,550254.87,1715001.15
231025,202206,1104,773,331,936885.44,401177.34,1338062.78
231030,202206,1036,854,182,1037477.49,220585.64,1258063.13
231040,202206,165,112,53,135744.80,64236.00,199980.80
231050,202206,942,815,127,989327.15,153927.99,1143255.14
231060,202206,159,129,30,156349.59,36360.73,192710.32
231070,202206,1496,1034,462,1253215.83,559946.33,1813162.16
231080,202206,268,238,30,288457.10,36360.00,324817.10
231085,202206,656,400,256,484804.68,310272.69,795077.37
231090,202206,257,207,50,250884.47,60600.65,311485.12
231095,202206,156,123,33,149076.00,39996.77,189072.77
231100,202206,173,141,32,170892.00,38784.00,209676.00
231110,202206,367,309,58,374510.27,70296.00,444806.27
231120,202206,260,216,44,261792.45,53328.10,315120.55
231123,202206,157,147,10,178165.15,12120.00,190285.15
231126,202206,320,242,78,293304.00,94536.00,387840.00
231130,202206,4961,3858,1103,4675961.26,1336853.28,6012814.54
231135,202206,208,185,23,224220.20,27876.00,252096.20
231140,202206,3063,2207,856,2674906.95,1038690.59,3713597.54
231150,202206,383,362,21,439957.68,25452.00,465409.68
231160,202206,1225,994,231,1204740.62,279972.10,1484712.72
231170,202206,518,360,158,436320.07,191496.00,627816.07
231180,202206,1800,1560,240,1891949.83,292094.01,2184043.84
231190,202206,212,176,36,213312.10,43632.00,256944.10
231195,202206,222,185,37,224220.00,44844.60,269064.60
231200,202206,828,668,160,809621.55,193923.38,1003544.93
231210,202206,515,433,82,524797.65,99384.20,624181.85
231220,202206,1047,744,303,902949.80,369660.65,1272610.45
231230,202206,1487,1129,358,1368354.52,433896.05,1802250.57
231240,202206,1537,1053,484,1276246.13,587822.32,1864068.45
231250,202206,94,88,6,106656.17,7272.00,113928.17
231260,202206,249,166,83,202404.90,100596.00,303000.90
231270,202206,996,777,219,941735.52,265429.81,1207165.33
231280,202206,75,59,16,71508.00,19392.00,90900.00
231290,202206,7818,4383,3435,5313452.86,4164459.82,9477912.68
231300,202206,587,537,50,650848.08,60600.00,711448.08
231310,202206,780,713,67,866584.90,81205.10,947790.00
231320,202206,586,439,147,532069.75,179376.50,711446.25
231325,202206,98,83,15,100596.00,18180.00,118776.00
231330,202206,1923,1467,456,1778025.63,553888.47,2331914.10
231335,202206,247,220,27,266641.79,32724.00,299365.79
231340,202206,1823,1276,547,1546522.83,662971.53,2209494.36
231350,202206,1345,1065,280,1292010.46,339368.05,1631378.51
231355,202206,405,337,68,409657.05,82416.00,492073.05
231360,202206,536,370,166,448443.22,201192.38,649635.60
231370,202206,98,83,15,100596.00,18180.00,118776.00
231375,202206,293,216,77,261792.91,93324.30,355117.21
231380,202206,488,391,97,473893.31,117564.00,591457.31
231390,202206,204,156,48,189072.00,58176.00,247248.00
231395,202206,770,475,295,575700.40,358752.30,934452.70
231400,202206,1174,978,196,1185343.44,237556.79,1422900.23
231410,202206,1354,1106,248,1340481.50,300577.14,1641058.64
240010,202206,373,163,210,197560.53,254524.92,452085.45
240020,202206,2265,1844,421,2234959.76,511469.49,2746429.25
240030,202206,115,94,21,113930.14,25452.00,139382.14
240040,202206,32,31,1,37572.00,1212.00,38784.00
240050,202206,514,442,72,535714.55,87264.30,622978.85
240060,202206,70,64,6,77568.30,7272.00,84840.30
240070,202206,247,188,59,227856.78,71508.59,299365.37
240080,202206,556,378,178,458142.96,215738.46,673881.42
240090,202206,98,88,10,107868.70,12120.00,119988.70
240100,202206,1490,1403,87,1700450.32,105446.03,1805896.35
240110,202206,1024,678,346,821751.92,419364.49,1241116.41
240120,202206,145,107,38,129684.90,46056.71,175741.61
240130,202206,270,248,22,300578.94,26664.60,327243.54
240140,202206,82,53,29,64236.30,35149.37,99385.67
240145,202206,706,621,85,752658.13,104232.12,856890.25
240150,202206,26,20,6,24240.00,7272.00,31512.00
240160,202206,40,31,9,37572.00,10908.00,48480.00
240165,202206,39,31,8,37572.35,9696.00,47268.35
240170,202206,140,96,44,116353.30,53328.00,169681.30
240180,202206,105,80,25,96962.30,30300.00,127262.30
240185,202206,48,42,6,50904.00,7272.00,58176.00
240190,202206,14,12,2,14544.98,2424.00,16968.98
240200,202206,3077,1670,1407,2024060.86,1706503.86,3730564.72
240210,202206,165,126,39,152712.00,47268.00,199980.00
240220,202206,1085,757,328,917503.20,398750.23,1316253.43
240230,202206,816,742,74,899318.14,89688.37,989006.51
240240,202206,71,46,25,55752.00,30300.20,86052.20
240250,202206,88,75,13,90900.90,15756.00,106656.90
240260,202206,1805,1284,521,1556217.28,632669.01,2188886.29
240270,202206,172,148,24,179376.80,29088.00,208464.80
240280,202206,54,42,12,50904.14,14544.00,65448.14
240290,202206,40,38,2,46056.00,2424.00,48480.00
240300,202206,173,91,82,110292.20,99384.00,209676.20
240310,202206,2461,1324,1137,1604714.15,1378059.46,2982773.61
240320,202206,176,162,14,196344.00,16968.00,213312.00
240325,202206,4707,2711,1996,3285787.14,2420395.72,5706182.86
240330,202206,74,70,4,84840.00,4848.00,89688.00
240340,202206,87,58,29,70296.00,35148.20,105444.20
240350,202206,90,74,16,89688.00,19392.00,109080.00
240360,202206,614,378,236,458147.40,286036.07,744183.47
240370,202206,53,46,7,55752.00,8484.00,64236.00
240375,202206,55,36,19,43632.20,23028.20,66660.40
240380,202206,221,177,44,214527.85,53328.70,267856.55
240390,202206,15,13,2,15756.00,2424.00,18180.00
240400,202206,85,76,9,92112.30,10908.00,103020.30
240410,202206,11,7,4,8484.00,4848.00,13332.00
240420,202206,1079,785,294,952647.19,356330.81,1308978.00
240430,202206,254,232,22,281186.10,26664.24,307850.34
240440,202206,126,68,58,82417.26,70296.10,152713.36
240450,202206,247,154,93,186649.04,112716.90,299365.94
240460,202206,75,59,16,71508.00,19392.00,90900.00
240470,202206,209,190,19,230283.28,23028.00,253311.28
240480,202206,16,14,2,16968.00,2424.00,19392.00
240485,202206,82,65,17,78780.20,20604.00,99384.20
240490,202206,55,49,6,59388.00,7272.00,66660.00
240500,202206,93,71,22,86052.00,26664.00,112716.00
240510,202206,40,29,11,35148.60,13332.00,48480.60
240520,202206,96,91,5,110292.50,6060.04,116352.54
240530,202206,55,46,9,55752.10,10908.00,66660.10
240540,202206,86,73,13,88476.10,15756.00,104232.10
240550,202206,12,10,2,12120.00,2424.00,14544.00
240560,202206,381,269,112,327241.88,135744.00,462985.88
240570,202206,432,272,160,329664.30,193920.20,523584.50
240580,202206,1304,1003,301,1216861.06,364813.75,1581674.81
240590,202206,30,29,1,35148.16,1212.00,36360.16
240600,202206,96,91,5,110292.81,6060.00,116352.81
240610,202206,491,405,86,490866.48,104233.90,595100.38
240615,202206,11,10,1,12120.00,1212.00,13332.00
240620,202206,84,80,4,96961.56,4848.00,101809.56
240630,202206,40,33,7,39996.00,8484.08,48480.08
240640,202206,25,21,4,25452.00,4848.00,30300.00
240650,202206,235,190,45,230280.80,54540.20,284821.00
240660,202206,108,93,15,112716.20,18180.20,130896.40
240670,202206,305,165,140,199983.65,169681.59,369665.24
240680,202206,54,41,13,49692.00,15756.10,65448.10
240690,202206,48,46,2,55752.00,2424.00,58176.00
240700,202206,173,139,34,168468.00,41208.00,209676.00
240710,202206,2140,1282,858,1553810.00,1039907.72,2593717.72
240720,202206,1029,735,294,890831.01,357543.63,1248374.64
240725,202206,69,64,5,77568.42,6060.00,83628.42
240730,202206,145,121,24,146652.00,29088.00,175740.00
240740,202206,225,191,34,231494.90,41208.20,272703.10
240750,202206,48,30,18,36360.00,21816.00,58176.00
240760,202206,56,46,10,55752.00,12120.00,67872.00
240770,202206,142,108,34,130896.90,41208.30,172105.20
240780,202206,714,589,125,713878.25,151500.79,865379.04
240790,202206,40,38,2,46057.70,2424.00,48481.70
240800,202206,9443,6377,3066,7736375.20,3722128.17,11458503.37
240810,202206,20939,11066,9873,13419530.70,11969859.50,25389390.20
240820,202206,240,137,103,166046.90,124836.60,290883.50
240830,202206,1579,1299,280,1574408.75,339363.28,1913772.03
240840,202206,74,65,9,78780.80,10908.00,89688.80
240850,202206,84,76,8,92112.00,9696.00,101808.00
240860,202206,107,103,4,124836.40,4848.00,129684.40
240870,202206,57,48,9,58176.80,10908.00,69084.80
240880,202206,31,27,4,32724.00,4848.00,37572.00
240890,202206,1147,640,507,775688.73,614488.41,1390177.14
240895,202206,61,49,12,59388.44,14544.00,73932.44
240910,202206,168,142,26,172104.43,31512.00,203616.43
240920,202206,12,11,1,13332.88,1212.00,14544.88
240930,202206,413,367,46,444813.52,55753.99,500567.51
240933,202206,57,36,21,43632.95,25452.00,69084.95
240940,202206,2270,1994,276,2416748.31,335728.12,2752476.43
240950,202206,43,38,5,46056.00,6060.00,52116.00
240960,202206,24,20,4,24240.00,4848.20,29088.20
240970,202206,103,77,26,93324.20,31512.00,124836.20
240980,202206,196,160,36,193920.20,43632.15,237552.35
240990,202206,133,87,46,105444.00,55752.00,161196.00
241000,202206,60,55,5,66660.30,6060.00,72720.30
241010,202206,78,59,19,71508.00,23028.00,94536.00
241020,202206,104,95,9,115140.60,10908.00,126048.60
241025,202206,15,9,6,10908.35,7272.50,18180.85
241030,202206,104,82,22,99384.00,26664.00,126048.00
241040,202206,37,28,9,33936.00,10908.00,44844.00
241050,202206,76,69,7,83628.00,8484.00,92112.00
241060,202206,25,21,4,25452.00,4848.00,30300.00
241070,202206,18,18,0,21816.00,,21816.00
241080,202206,55,48,7,58176.00,8484.00,66660.00
241090,202206,49,35,14,42421.71,16968.00,59389.71
241100,202206,74,63,11,76356.00,13332.69,89688.69
241105,202206,14,6,8,7272.00,9696.20,16968.20
241110,202206,47,39,8,47268.00,9696.00,56964.00
241120,202206,1586,1195,391,1448351.01,473895.19,1922246.20
241140,202206,202,167,35,202404.60,42420.00,244824.60
241142,202206,49,36,13,43632.00,15756.45,59388.45
241150,202206,1171,1016,155,1232626.69,187860.99,1420487.68
241160,202206,20,15,5,18180.00,6060.00,24240.00
241170,202206,47,40,7,48480.00,8484.00,56964.00
241180,202206,43,31,12,37572.00,14544.00,52116.00
241190,202206,39,36,3,43632.00,3636.00,47268.00
241200,202206,4179,2215,1964,2685838.14,2381621.99,5067460.13
241210,202206,69,58,11,70296.72,13332.00,83628.72
241220,202206,1463,948,515,1150204.63,624188.23,1774392.86
241230,202206,245,203,42,246036.70,50904.00,296940.70
241240,202206,52,38,14,46056.00,16968.00,63024.00
241250,202206,1137,1042,95,1264127.42,115140.00,1379267.42
241255,202206,58,48,10,58177.23,12120.00,70297.23
241260,202206,688,528,160,639941.29,193920.50,833861.79
241270,202206,64,45,19,54540.00,23028.00,77568.00
241280,202206,95,84,11,101808.20,13332.00,115140.20
241290,202206,124,92,32,111504.03,38784.10,150288.13
241300,202206,79,54,25,65448.30,30300.50,95748.80
241310,202206,45,30,15,36360.80,18180.00,54540.80
241320,202206,26,12,14,14544.00,16968.00,31512.00
241330,202206,57,50,7,60600.00,8484.00,69084.00
241335,202206,84,74,10,89688.68,12120.00,101808.68
241340,202206,184,135,49,163620.00,59388.00,223008.00
241350,202206,60,52,8,63024.30,9696.00,72720.30
241355,202206,51,43,8,52116.72,9696.00,61812.72
241360,202206,48,46,2,55752.00,2424.00,58176.00
241370,202206,59,47,12,56964.00,14544.00,71508.00
241380,202206,37,33,4,39996.20,4848.00,44844.20
241390,202206,81,63,18,76356.00,21816.00,98172.00
241400,202206,206,155,51,188738.70,61812.00,250550.70
241410,202206,176,161,15,195132.43,18180.69,213313.12
241415,202206,102,81,21,98172.00,25452.80,123624.80
241420,202206,116,80,36,96960.73,43632.00,140592.73
241430,202206,20,18,2,21816.00,2424.00,24240.00
241440,202206,510,431,79,522380.65,95748.95,618129.60
241445,202206,39,34,5,41208.00,6060.10,47268.10
241450,202206,261,219,42,265430.04,50904.80,316334.84
241460,202206,148,133,15,161196.00,18180.00,179376.00
241470,202206,35,29,6,35148.40,7272.00,42420.40
241475,202206,51,46,5,55752.00,6060.00,61812.00
241480,202206,120,89,31,107869.49,37572.20,145441.69
241490,202206,13,12,1,14544.00,1212.10,15756.10
241500,202206,43,33,10,39996.20,12120.02,52116.22
250010,202206,99,84,15,101808.60,18180.00,119988.60
250020,202206,30,26,4,31512.00,4848.00,36360.00
250030,202206,872,641,231,776898.16,279974.21,1056872.37
250040,202206,389,310,79,375722.18,95748.80,471470.98
250050,202206,276,227,49,275124.19,59388.01,334512.20
250053,202206,59,46,13,55752.00,15756.00,71508.00
250057,202206,1,1,0,1212.00,,1212.00
250060,202206,604,439,165,532071.52,199981.40,732052.92
250070,202206,679,541,138,655701.26,167256.20,822957.46
250073,202206,10,9,1,10908.00,1212.00,12120.00
250077,202206,179,132,47,159985.20,56964.00,216949.20
250080,202206,414,328,86,397539.79,105445.70,502985.49
250090,202206,219,142,77,172104.00,93324.00,265428.00
250100,202206,546,448,98,542978.95,118777.80,661756.75
250110,202206,653,477,176,578126.61,213313.42,791440.03
250115,202206,15,4,11,4848.00,13332.26,18180.26
250120,202206,121,86,35,104232.20,42420.35,146652.55
250130,202206,556,449,107,544191.17,129684.20,673875.37
250135,202206,24,10,14,12120.00,16968.00,29088.00
250140,202206,83,73,10,88476.12,12120.00,100596.12
250150,202206,610,433,177,524798.98,215737.61,740536.59
250153,202206,12,9,3,10908.00,3636.00,14544.00
250157,202206,29,24,5,29088.00,6060.00,35148.00
250160,202206,239,183,56,221797.33,67872.00,289669.33
250170,202206,76,49,27,59388.00,32724.00,92112.00
250180,202206,4620,3155,1465,3825144.43,1775608.81,5600753.24
250190,202206,801,535,266,648422.81,322392.98,970815.79
250200,202206,64,50,14,60600.00,16968.00,77568.00
250205,202206,23,19,4,23028.00,4848.00,27876.00
250210,202206,86,74,12,89688.18,14544.00,104232.18
250215,202206,71,53,18,64236.00,21816.00,86052.00
250220,202206,28,20,8,24240.00,9696.00,33936.00
250230,202206,77,68,9,82416.00,10908.00,93324.00
250240,202206,233,181,52,219373.54,63024.00,282397.54
250250,202206,370,320,50,387842.23,60600.00,448442.23
250260,202206,44,36,8,43632.00,9696.00,53328.00
250270,202206,77,54,23,65448.00,27876.00,93324.00
250280,202206,376,306,70,370874.00,84840.40,455714.40
250290,202206,91,81,10,98172.00,12120.00,110292.00
250300,202206,525,354,171,429050.50,207252.33,636302.83
250310,202206,46,42,4,50904.00,4848.70,55752.70
250320,202206,1944,1292,652,1568359.75,792656.56,2361016.31
250330,202206,112,94,18,113928.20,21817.09,135745.29
250340,202206,30,24,6,29088.20,7272.00,36360.20
250350,202206,187,123,64,149076.00,77568.00,226644.00
250355,202206,32,24,8,29088.00,9696.00,38784.00
250360,202206,188,155,33,187861.24,39997.07,227858.31
250370,202206,2337,1523,814,1845903.62,987789.77,2833693.39
250375,202206,14,8,6,9696.00,7272.41,16968.41
250380,202206,53,45,8,54540.00,9696.00,64236.00
250390,202206,44,34,10,41208.16,12120.00,53328.16
250400,202206,16432,8286,8146,10045153.12,9880324.23,19925477.35
250403,202206,303,235,68,284820.30,82416.00,367236.30
250407,202206,66,53,13,64236.00,15756.85,79992.85
250410,202206,29,25,4,30300.00,4848.00,35148.00
250415,202206,42,25,17,30300.00,20604.00,50904.00
250420,202206,38,30,8,36360.00,9696.00,46056.00
250430,202206,1442,1246,196,1510464.95,237552.59,1748017.54
250435,202206,27,21,6,25452.00,7272.00,32724.00
250440,202206,665,553,112,670239.20,135744.00,805983.20
250450,202206,83,63,20,76356.80,24240.20,100597.00
250460,202206,444,288,156,349058.20,189073.12,538131.32
250470,202206,98,68,30,82416.00,36360.00,118776.00
250480,202206,319,254,65,307850.92,78780.00,386630.92
250485,202206,6,6,0,7272.00,,7272.00
250490,202206,228,187,41,226645.31,49692.00,276337.31
250500,202206,95,75,20,90900.00,24240.00,115140.00
250510,202206,788,624,164,756289.20,198768.13,955057.33
250520,202206,172,114,58,138168.00,70296.00,208464.00
250523,202206,118,98,20,118776.00,24240.00,143016.00
250527,202206,114,87,27,105444.00,33936.00,139380.00
250530,202206,6,2,4,2424.00,4848.00,7272.00
250535,202206,28,21,7,25452.00,8484.00,33936.00
250540,202206,145,112,33,135744.78,39996.00,175740.78
250550,202206,67,66,1,79992.00,1212.00,81204.00
250560,202206,64,39,25,47268.20,30300.00,77568.20
250570,202206,157,129,28,157560.00,33936.55,191496.55
250580,202206,95,73,22,88554.00,26664.05,115218.05
250590,202206,22,12,10,14544.00,12120.60,26664.60
250600,202206,1519,1004,515,1219280.56,625392.10,1844672.66
250610,202206,156,125,31,151501.69,37572.20,189073.89
250620,202206,20,16,4,19392.10,4848.00,24240.10
250625,202206,68,54,14,65448.43,16968.00,82416.43
250630,202206,3111,1959,1152,2375777.64,1397451.95,3773229.59
250640,202206,190,150,40,181800.96,48481.49,230282.45
250650,202206,30,20,10,24240.00,12120.45,36360.45
250660,202206,61,45,16,54540.00,19392.00,73932.00
250670,202206,69,53,16,64236.00,19392.00,83628.00
250680,202206,406,325,81,393903.07,98172.25,492075.32
250690,202206,2123,1455,668,1764695.33,810831.38,2575526.71
250700,202206,908,768,140,930818.71,169680.20,1100498.91
250710,202206,461,365,96,442386.10,116354.25,558740.35
250720,202206,119,87,32,105444.20,38784.00,144228.20
250730,202206,406,335,71,406020.92,86053.03,492073.95
250740,202206,63,59,4,71508.48,4848.00,76356.48
250750,202206,23026,13645,9381,16543941.32,11382048.50,27925989.82
250760,202206,111,90,21,109080.00,25452.00,134532.00
250770,202206,354,232,122,281187.36,147864.70,429052.06
250780,202206,69,46,23,55752.00,27876.20,83628.20
250790,202206,446,280,166,339361.97,201194.10,540556.07
250800,202206,143,129,14,156348.00,16968.00,173316.00
250810,202206,75,61,14,73932.00,16968.00,90900.00
250820,202206,153,129,24,156348.20,29088.00,185436.20
250830,202206,445,289,156,350269.30,189073.40,539342.70
250840,202206,57,50,7,60600.00,8484.00,69084.00
250850,202206,59,50,9,60600.00,10908.00,71508.00
250855,202206,16,14,2,16968.62,2424.00,19392.62
250860,202206,243,158,85,191496.96,103020.80,294517.76
250870,202206,27,24,3,29088.80,3636.00,32724.80
250880,202206,89,68,21,82416.22,25452.00,107868.22
250890,202206,3109,2291,818,2776720.46,992631.95,3769352.41
250900,202206,58,48,10,58176.83,12120.00,70296.83
250905,202206,121,92,29,111504.00,35148.00,146652.00
250910,202206,990,722,268,876284.68,324817.35,1201102.03
250915,202206,106,72,34,87264.84,41209.20,128474.04
250920,202206,142,104,38,126048.00,46056.00,172104.00
250930,202206,179,102,77,123624.00,93324.20,216948.20
250933,202206,8,5,3,6060.00,3636.00,9696.00
250937,202206,16,16,0,19392.00,,19392.00
250939,202206,33,27,6,32724.00,7272.00,39996.00
250940,202206,123,90,33,109080.97,39996.54,149077.51
250950,202206,75,53,22,64236.00,26664.00,90900.00
250960,202206,86,48,38,58177.08,46056.30,104233.38
250970,202206,1246,876,370,1061720.78,448443.30,1510164.08
250980,202206,100,68,32,82417.19,38784.00,121201.19
250990,202206,165,127,38,153924.00,46056.00,199980.00
251000,202206,77,67,10,81204.00,12120.00,93324.00
251010,202206,124,90,34,109080.00,41208.00,150288.00
251020,202206,75,61,14,73932.68,16968.00,90900.68
251030,202206,48,34,14,41208.00,16968.00,58176.00
251040,202206,58,38,20,46056.00,24240.00,70296.00
251050,202206,25,20,5,24240.00,6060.00,30300.00
251060,202206,51,40,11,48480.68,13332.00,61812.68
251065,202206,6,3,3,3636.00,3636.00,7272.00
251070,202206,16,13,3,15756.00,3636.00,19392.00
251080,202206,5278,2475,2803,2999783.62,3398477.99,6398261.61
251090,202206,190,159,31,192708.18,37572.68,230280.86
251100,202206,23,22,1,26664.00,1212.00,27876.00
251110,202206,57,38,19,46056.00,23028.00,69084.00
251120,202206,1911,1180,731,1430185.04,885983.30,2316168.34
251130,202206,429,352,77,426624.43,93324.05,519948.48
251140,202206,591,376,215,455715.03,260581.47,716296.50
251150,202206,335,277,58,335726.77,70296.52,406023.29
251160,202206,94,75,19,90900.10,23028.00,113928.10
251170,202206,88,72,16,87264.32,19392.00,106656.32
251180,202206,289,167,122,202405.64,147864.97,350270.61
251190,202206,188,121,67,146653.51,81204.29,227857.80
251200,202206,276,214,62,259371.04,75144.10,334515.14
251203,202206,33,30,3,36360.00,3636.00,39996.00
251207,202206,82,69,13,83628.00,15756.00,99384.00
251210,202206,1496,1093,403,1324729.06,488437.86,1813166.92
251220,202206,47,37,10,44844.20,12120.00,56964.20
251230,202206,556,465,91,563581.63,112717.50,676299.13
251240,202206,110,77,33,93324.00,39996.00,133320.00
251250,202206,1460,1042,418,1262812.86,506620.39,1769433.25
251260,202206,11,7,4,8484.00,4848.00,13332.00
251270,202206,303,242,61,293308.14,73932.00,367240.14
251272,202206,66,58,8,70296.00,9696.00,79992.00
251274,202206,27,21,6,25452.00,7272.00,32724.00
251275,202206,33,19,14,23028.00,16968.10,39996.10
251276,202206,28,22,6,26664.73,7272.00,33936.73
251278,202206,14,12,2,14544.00,2424.00,16968.00
251280,202206,96,91,5,110292.00,6060.00,116352.00
251290,202206,971,698,273,845986.79,330880.82,1176867.61
251300,202206,16,11,5,13332.00,6060.00,19392.00
251310,202206,295,212,83,256945.14,100596.89,357542.03
251315,202206,39,36,3,43632.00,3636.00,47268.00
251320,202206,73,59,14,71508.20,16968.10,88476.30
251330,202206,82,71,11,86052.00,13332.96,99384.96
251335,202206,22,11,11,13332.30,13332.10,26664.40
251340,202206,791,455,336,551465.40,408444.10,959909.50
251350,202206,35,34,1,41208.00,1212.00,42420.00
251360,202206,84,73,11,88476.99,13332.00,101808.99
251365,202206,7,7,0,8484.10,,8484.10
251370,202206,5651,3844,1807,4661412.33,2190103.20,6851515.53
251380,202206,46,35,11,42420.00,13332.00,55752.00
251385,202206,3,3,0,3636.00,,3636.00
251390,202206,940,694,246,841136.31,298157.50,1139293.81
251392,202206,30,20,10,24240.00,12120.00,36360.00
251394,202206,11,9,2,10908.00,2424.00,13332.00
251396,202206,13,8,5,9696.00,6060.20,15756.20
251398,202206,16,13,3,15756.00,3636.00,19392.00
251400,202206,50,39,11,47268.00,13332.00,60600.00
251410,202206,41,35,6,42420.20,7272.00,49692.20
251420,202206,104,77,27,93325.30,32724.10,126049.40
251430,202206,43,39,4,47268.70,4848.00,52116.70
251440,202206,51,27,24,32724.00,29088.00,61812.00
251445,202206,62,51,11,61813.24,13332.00,75145.24
251450,202206,375,325,50,393903.60,60600.80,454504.40
251455,202206,5,4,1,4848.00,1212.00,6060.00
251460,202206,22,18,4,21816.00,4848.00,26664.00
251465,202206,8,5,3,6060.00,3636.00,9696.00
251470,202206,53,38,15,46056.00,18180.00,64236.00
251480,202206,29,24,5,29088.00,6060.00,35148.00
251490,202206,112,68,44,82416.83,53329.10,135745.93
251500,202206,113,94,19,113929.10,23028.00,136957.10
251510,202206,77,48,29,58177.02,35148.00,93325.02
251520,202206,34,29,5,35148.00,6060.00,41208.00
251530,202206,4243,2983,1260,3620269.90,1529550.96,5149820.86
251540,202206,89,73,16,88476.00,19392.20,107868.20
251550,202206,404,309,95,374511.80,115140.57,489652.37
251560,202206,22,16,6,19392.10,7272.00,26664.10
251570,202206,17,15,2,18180.00,2424.00,20604.00
251580,202206,128,100,28,121200.00,33936.00,155136.00
251590,202206,105,73,32,88476.00,38784.00,127260.00
251593,202206,26,14,12,16968.00,14544.00,31512.00
251597,202206,101,77,24,93324.00,29089.15,122413.15
251600,202206,1093,758,335,919000.44,406020.70,1325021.14
251610,202206,241,177,64,214524.20,77568.00,292092.20
251615,202206,15,13,2,15756.00,2424.00,18180.00
251620,202206,4152,2652,1500,3215465.90,1819228.49,5034694.39
251630,202206,460,338,122,409661.76,147865.68,557527.44
251640,202206,116,87,29,105445.37,35148.00,140593.37
251650,202206,286,209,77,253309.00,93324.20,346633.20
251660,202206,194,172,22,208465.54,26664.80,235130.34
251670,202206,386,300,86,363602.47,105444.10,469046.57
251675,202206,10,8,2,9696.00,2424.00,12120.00
251680,202206,104,88,16,106656.00,19392.00,126048.00
251690,202206,312,258,54,312697.71,65448.20,378145.91
251700,202206,272,237,35,287245.32,42420.00,329665.32
251710,202206,22,12,10,14544.00,12120.00,26664.00
251720,202206,25,18,7,21816.00,8484.00,30300.00
251740,202206,13,10,3,12120.00,3636.00,15756.00
260005,202206,3542,1869,1673,2267168.10,2030115.49,4297283.59
260010,202206,1697,1261,436,1528347.40,528434.93,2056782.33
260020,202206,392,342,50,414505.03,60600.20,475105.23
260030,202206,605,409,196,495709.43,237552.77,733262.20
260040,202206,795,493,302,597522.45,366026.81,963549.26
260050,202206,1148,824,324,998699.95,392691.32,1391391.27
260060,202206,362,333,29,403600.64,35148.00,438748.64
260070,202206,1313,800,513,969615.33,621761.93,1591377.26
260080,202206,724,549,175,666603.14,212100.00,878703.14
260090,202206,472,304,168,368448.30,203616.95,572065.25
260100,202206,212,147,65,178164.35,78780.00,256944.35
260105,202206,251,144,107,174529.34,129684.00,304213.34
260110,202206,2920,2120,800,2570667.26,970817.37,3541484.63
260120,202206,2680,1442,1238,1748042.63,1502892.40,3250935.03
260130,202206,186,129,57,157560.00,69084.00,226644.00
260140,202206,2209,1434,775,1738025.72,939307.19,2677332.91
260150,202206,191,125,66,151500.20,79992.00,231492.20
260160,202206,345,280,65,339363.13,79992.88,419356.01
260170,202206,3328,1971,1357,2390086.79,1645909.70,4035996.49
260180,202206,176,144,32,174528.60,38784.56,213313.16
260190,202206,2354,1549,805,1878613.84,975664.59,2854278.43
260200,202206,979,765,214,927188.31,260580.60,1187768.91
260210,202206,1366,970,396,1175652.25,481165.38,1656817.63
260220,202206,639,576,63,698120.16,76357.47,774477.63
260230,202206,1243,923,320,1119897.13,389054.90,1508952.03
260240,202206,208,157,51,190285.26,61813.55,252098.81
260250,202206,94,71,23,86052.00,27876.00,113928.00
260260,202206,1056,736,320,892034.91,387840.89,1279875.80
260270,202206,257,186,71,225433.93,87264.00,312697.93
260280,202206,1121,901,220,1093233.94,267853.70,1361087.64
260290,202206,6805,3686,3119,4468673.31,3783875.84,8252549.15
260300,202206,980,834,146,1012042.69,176952.58,1188995.27
260310,202206,504,403,101,488437.59,122412.00,610849.59
260320,202206,819,593,226,718718.77,273912.29,992631.06
260330,202206,76,55,21,66660.20,25452.62,92112.82
260340,202206,81,59,22,71508.31,26664.00,98172.31
260345,202206,5633,2941,2692,3573018.16,3269997.57,6843015.73
260350,202206,481,339,142,410871.00,172105.22,582976.22
260360,202206,241,137,104,166044.40,126048.39,292092.79
260370,202206,734,470,264,569641.54,319969.00,889610.54
260380,202206,565,401,164,486015.00,198768.19,684783.19
260390,202206,291,247,44,299364.86,53328.00,352692.86
260392,202206,113,96,17,116352.30,20604.00,136956.30
260400,202206,4357,2486,1871,3015469.82,2267662.94,5283132.76
260410,202206,15035,7827,7208,9491252.23,8748254.07,18239506.30
260415,202206,144,123,21,149076.74,25452.00,174528.74
260420,202206,1732,1070,662,1296850.92,802344.99,2099195.91
260430,202206,170,153,17,185438.12,20604.00,206042.12
260440,202206,189,129,60,156350.29,72720.00,229070.29
260450,202206,418,313,105,380570.78,127260.00,507830.78
260460,202206,816,426,390,516319.00,476319.47,992638.47
260470,202206,340,205,135,249676.85,164833.28,414510.13
260480,202206,256,162,94,196344.00,113928.20,310272.20
260490,202206,221,177,44,214524.00,53328.00,267852.00
260500,202206,1121,752,369,911429.41,447229.72,1358659.13
260510,202206,812,644,168,780530.90,203616.00,984146.90
260515,202206,226,204,22,247248.20,26664.00,273912.20
260520,202206,3189,1963,1226,2379166.55,1485920.01,3865086.56
260530,202206,812,660,152,799929.34,184224.61,984153.95
260540,202206,527,417,110,505405.00,133320.20,638725.20
260545,202206,17,11,6,13332.00,7272.00,20604.00
260550,202206,337,214,123,259368.50,149076.00,408444.50
260560,202206,514,389,125,471470.77,151502.24,622973.01
260570,202206,993,789,204,956280.44,247249.27,1203529.71
260580,202206,343,276,67,334512.00,81204.83,415716.83
260590,202206,617,355,262,430260.57,317544.20,747804.77
260600,202206,7695,4443,3252,5386178.53,3943869.72,9330048.25
260610,202206,492,327,165,396326.67,199981.37,596308.04
260620,202206,3730,1936,1794,2347666.45,2175567.09,4523233.54
260630,202206,84,75,9,90900.00,10908.00,101808.00
260640,202206,3347,1957,1390,2373110.70,1685895.91,4059006.61
260650,202206,309,221,88,267854.07,106657.20,374511.27
260660,202206,573,368,205,446021.45,248460.27,694481.72
260670,202206,103,75,28,90900.00,33936.12,124836.12
260680,202206,3958,2160,1798,2617958.81,2180413.80,4798372.61
260690,202206,129,96,33,116352.74,39996.57,156349.31
260700,202206,304,202,102,244826.13,123624.15,368450.28
260710,202206,48,40,8,48480.00,9696.00,58176.00
260720,202206,2651,1548,1103,1876184.26,1336838.70,3213022.96
260730,202206,727,534,193,647210.76,235128.00,882338.76
260740,202206,74,59,15,71508.00,18180.00,89688.00
260750,202206,559,410,149,496924.02,180588.82,677512.84
260760,202206,717,349,368,422996.31,446020.13,869016.44
260765,202206,979,503,476,609641.52,579340.87,1188982.39
260770,202206,212,154,58,186628.19,70296.74,256924.93
260775,202206,781,419,362,507831.84,438746.62,946578.46
260780,202206,228,140,88,169680.00,106656.60,276336.60
260790,202206,15318,7518,7800,9117971.28,9460913.43,18578884.71
260795,202206,154,100,54,121200.62,65448.00,186648.62
260800,202206,290,236,54,286032.50,65448.96,351481.46
260805,202206,170,111,59,134532.10,71508.47,206040.57
260810,202206,814,663,151,804769.72,183012.80,987782.52
260820,202206,293,190,103,230280.27,124836.00,355116.27
260825,202206,210,140,70,169680.00,84840.00,254520.00
260830,202206,287,183,104,221796.00,126048.72,347844.72
260840,202206,260,185,75,224220.55,90900.93,315121.48
260845,202206,177,115,62,139380.17,75144.10,214524.27
260850,202206,405,303,102,367237.67,123624.00,490861.67
260860,202206,246,185,61,224223.12,73932.00,298155.12
260870,202206,343,263,80,318758.01,96960.71,415718.72
260875,202206,728,531,197,644798.31,238765.03,883563.34
260880,202206,1556,1040,516,1260491.21,626604.30,1887095.51
260890,202206,2386,1646,740,1994967.81,896886.47,2891854.28
260900,202206,997,723,274,876281.69,332088.00,1208369.69
260910,202206,243,189,54,229069.83,66660.00,295729.83
260915,202206,276,207,69,250884.00,84840.00,335724.00
260920,202206,207,110,97,133320.00,117564.00,250884.00
260930,202206,352,296,56,358754.57,67872.86,426627.43
260940,202206,2570,1368,1202,1658032.98,1459258.17,3117291.15
260950,202206,1990,1133,857,1373215.26,1038693.13,2411908.39
260960,202206,13673,6648,7025,8061154.09,8521645.23,16582799.32
260970,202206,415,339,76,410869.40,92112.87,502982.27
260980,202206,200,181,19,219374.18,23028.10,242402.28
260990,202206,2625,2093,532,2536755.47,646000.03,3182755.50
261000,202206,4206,2585,1621,3133038.03,1967082.72,5100120.75
261010,202206,146,101,45,122412.00,54540.00,176952.00
261020,202206,585,434,151,526010.18,183012.00,709022.18
261030,202206,254,185,69,224220.40,83628.00,307848.40
261040,202206,366,308,58,373298.00,70296.00,443594.00
261050,202206,507,431,76,523588.88,92112.65,615701.53
261060,202206,1471,904,567,1095651.82,687205.10,1782856.92
261070,202206,9345,4450,4895,5398368.99,5936462.26,11334831.25
261080,202206,361,275,86,333301.94,104232.00,437533.94
261090,202206,2090,1602,488,1941648.98,591456.56,2533105.54
261100,202206,1212,845,367,1025357.16,444805.75,1470162.91
261110,202206,8961,5552,3409,6730342.18,4134177.47,10864519.65
261120,202206,230,197,33,238764.38,39996.00,278760.38
261130,202206,555,322,233,390269.95,282399.27,672669.22
261140,202206,210,132,78,159984.88,94536.00,254520.88
261150,202206,679,431,248,523585.67,300576.00,824161.67
261153,202206,69,65,4,78780.00,4848.00,83628.00
261160,202206,75039,36807,38232,44621776.49,46364201.23,90985977.72
261170,202206,467,348,119,421777.65,144228.70,566006.35
261180,202206,1758,1101,657,1334700.20,796289.34,2130989.54
261190,202206,565,389,176,471470.11,213312.92,684783.03
261200,202206,220,179,41,216950.63,49692.00,266642.63
261210,202206,40,31,9,37572.00,10908.00,48480.00
261220,202206,2709,1887,822,2287064.23,997482.37,3284546.60
261230,202206,351,260,91,315120.30,110292.97,425413.27
261240,202206,436,375,61,454506.41,73932.96,528439.37
261245,202206,240,201,39,243612.00,48480.00,292092.00
261247,202206,168,127,41,153924.45,49692.22,203616.67
261250,202206,3550,1680,1870,2038593.28,2266443.66,4305036.94
261255,202206,244,216,28,261792.00,33936.00,295728.00
261260,202206,811,702,109,850840.04,132111.17,982951.21
261270,202206,196,138,58,167256.00,70296.00,237552.00
261280,202206,194,154,40,186648.79,48480.00,235128.79
261290,202206,105,75,30,90900.00,36360.20,127260.20
261300,202206,1344,992,352,1204739.65,426628.46,1631368.11
261310,202206,781,522,259,633882.84,313909.23,947792.07
261320,202206,542,371,171,449659.85,207252.79,656912.64
261330,202206,904,710,194,860534.89,235134.95,1095669.84
261340,202206,309,173,136,209677.28,164832.45,374509.73
261350,202206,884,617,267,747813.02,323607.59,1071420.61
261360,202206,1379,878,501,1064141.25,607213.80,1671355.05
261370,202206,4863,2839,2024,3442113.34,2455527.73,5897641.07
261380,202206,559,432,127,523586.96,153924.60,677511.56
261390,202206,3649,2460,1189,2983984.26,1441087.08,4425071.34
261400,202206,268,241,27,292093.98,32724.04,324818.02
261410,202206,1125,741,384,898099.61,465409.99,1363509.60
261420,202206,940,576,364,698118.83,441169.23,1139288.06
261430,202206,317,286,31,346633.80,37572.00,384205.80
261440,202206,100,96,4,116352.44,4848.00,121200.44
261450,202206,2511,1977,534,2396133.70,648423.88,3044557.58
261460,202206,774,603,171,730842.00,207253.25,938095.25
261470,202206,222,181,41,219373.30,49692.49,269065.79
261480,202206,462,351,111,425415.46,134478.63,559894.09
261485,202206,378,228,150,276337.49,181800.10,458137.59
261500,202206,607,404,203,489649.20,246036.00,735685.20
261510,202206,51,33,18,39997.28,21816.10,61813.38
261520,202206,92,76,16,92112.18,19392.20,111504.38
261530,202206,4061,2594,1467,3148807.91,1780439.15,4929247.06
261540,202206,1453,833,620,1009602.20,751446.03,1761048.23
261550,202206,247,120,127,145440.30,153924.00,299364.30
261560,202206,909,597,312,723571.72,378147.18,1101718.90
261570,202206,387,308,79,373299.33,95748.00,469047.33
261580,202206,383,307,76,372085.65,92112.00,464197.65
261590,202206,189,158,31,191496.20,37572.80,229069.00
261600,202206,298,236,62,286035.06,75144.20,361179.26
261610,202206,83,72,11,87264.00,13332.00,100596.00
261618,202206,74,54,20,65448.00,24240.00,89688.00
261620,202206,197,128,69,155136.56,83628.22,238764.78
261630,202206,659,517,142,626607.13,172104.00,798711.13
261640,202206,6481,3400,3081,4123259.59,3739047.50,7862307.09
261650,202206,458,296,162,358752.80,196344.70,555097.50
270010,202206,512,452,60,547828.51,72720.50,620549.01
270020,202206,244,202,42,244827.51,50904.20,295731.71
270030,202206,8661,5573,3088,6759402.39,3742627.35,10502029.74
270040,202206,2062,1345,717,1633785.10,871434.41,2505219.51
270050,202206,212,166,46,201192.48,55752.00,256944.48
270060,202206,69,48,21,58177.50,26664.00,84841.50
270070,202206,804,586,218,712171.80,264217.10,976388.90
270080,202206,42,36,6,43632.00,7272.00,50904.00
270090,202206,20,16,4,19392.00,4848.00,24240.00
270100,202206,1311,898,413,1089595.94,500557.16,1590153.10
270110,202206,67,57,10,69084.00,12120.00,81204.00
270120,202206,240,200,40,242403.42,48480.00,290883.42
270130,202206,322,239,83,289669.22,100596.00,390265.22
270135,202206,118,82,36,99384.40,43632.00,143016.40
270140,202206,1377,905,472,1099298.26,572069.49,1671367.75
270150,202206,244,187,57,226645.26,70296.10,296941.36
270160,202206,480,375,105,454501.47,127260.00,581761.47
270170,202206,803,530,273,643577.64,330876.39,974454.03
270180,202206,56,44,12,53328.00,14544.76,67872.76
270190,202206,107,93,14,112716.64,16968.00,129684.64
270200,202206,113,100,13,121200.20,15756.00,136956.20
270210,202206,536,330,206,399960.50,249672.00,649632.50
270220,202206,188,139,49,168468.10,59388.65,227856.75
270230,202206,2107,1325,782,1607123.32,947785.49,2554908.81
270235,202206,477,374,103,453294.46,124836.10,578130.56
270240,202206,3291,2616,675,3170618.59,819314.79,3989933.38
270250,202206,122,90,32,109080.20,38784.00,147864.20
270255,202206,204,174,30,210888.38,36360.00,247248.38
270260,202206,351,287,64,349058.87,77568.84,426627.71
270270,202206,94,48,46,58176.00,55752.00,113928.00
270280,202206,216,137,79,166044.00,95748.00,261792.00
270290,202206,1103,866,237,1049601.29,287247.39,1336848.68
270300,202206,365,268,97,324816.00,117564.00,442380.00
270310,202206,806,673,133,816896.14,161196.20,978092.34
270320,202206,760,656,104,795076.45,127260.00,922336.45
270330,202206,302,260,42,315120.48,50904.00,366024.48
270340,202206,62,52,10,63024.00,12120.00,75144.00
270350,202206,87,51,36,61812.53,43632.00,105444.53
270360,202206,72,41,31,49692.00,37572.00,87264.00
270370,202206,59,48,11,58176.00,13332.00,71508.00
270375,202206,78,49,29,59388.00,35148.00,94536.00
270380,202206,1053,715,338,866580.98,409656.00,1276236.98
270390,202206,141,81,60,98172.00,72720.48,170892.48
270400,202206,727,558,169,676303.31,204828.92,881132.23
270410,202206,608,448,160,542979.23,193920.30,736899.53
270420,202206,404,284,120,344209.32,145440.20,489649.52
270430,202206,33680,24173,9507,29319291.65,11531102.41,40850394.06
270440,202206,474,376,98,455714.12,118776.10,574490.22
270450,202206,833,490,343,593882.04,415718.54,1009600.58
270460,202206,173,138,35,167258.04,42420.00,209678.04
270470,202206,1567,1099,468,1331999.84,569640.94,1901640.78
270480,202206,532,429,103,519952.88,124836.00,644788.88
270490,202206,19,15,4,18180.00,4848.00,23028.00
270500,202206,453,380,73,460560.77,88476.00,549036.77
270510,202206,866,567,299,689632.81,363601.30,1053234.11
270520,202206,266,176,90,213312.58,109080.00,322392.58
270530,202206,60,51,9,61812.20,10908.00,72720.20
270540,202206,94,69,25,83628.00,30300.00,113928.00
270550,202206,1659,1287,372,1559858.04,452076.40,2011934.44
270560,202206,253,153,100,185437.18,121200.50,306637.68
270570,202206,556,396,160,479955.55,193920.00,673875.55
270580,202206,10,7,3,8484.00,3636.00,12120.00
270590,202206,58,46,12,55752.30,14544.00,70296.30
270600,202206,150,131,19,158772.39,23028.10,181800.49
270610,202206,241,192,49,232705.40,59388.10,292093.50
270620,202206,17,16,1,19392.00,1212.00,20604.00
270630,202206,3584,2716,868,3294249.22,1053232.98,4347482.20
270640,202206,852,640,212,775686.13,256945.15,1032631.28
270642,202206,208,175,33,212100.80,39996.00,252096.80
270644,202206,254,169,85,204828.81,103020.65,307849.46
270650,202206,341,209,132,253309.89,159984.56,413294.45
270660,202206,192,171,21,207254.83,25452.00,232706.83
270670,202206,2893,2209,684,2678418.21,829010.70,3507428.91
270680,202206,389,247,142,299366.07,172104.00,471470.07
270690,202206,1205,812,393,984760.24,476319.48,1461079.72
270700,202206,26,21,5,25452.00,6060.00,31512.00
270710,202206,538,419,119,509041.51,144228.00,653269.51
270720,202206,219,175,44,212101.68,53328.43,265430.11
270730,202206,1882,1175,707,1425321.28,856886.53,2282207.81
270740,202206,35,25,10,30300.00,12120.00,42420.00
270750,202206,606,464,142,562370.29,172105.02,734475.31
270760,202206,288,209,79,253309.94,95748.00,349057.94
270770,202206,2776,1892,884,2295792.70,1071413.27,3367205.97
270780,202206,65,40,25,48480.00,30300.90,78780.90
270790,202206,218,139,79,168468.21,95748.20,264216.41
270800,202206,2027,1627,400,1974366.49,484800.99,2459167.48
270810,202206,216,180,36,218161.23,43632.00,261793.23
270820,202206,126,90,36,109082.19,44844.00,153926.19
270830,202206,829,633,196,767211.66,237552.59,1004764.25
270840,202206,1307,1007,300,1221701.20,363601.38,1585302.58
270850,202206,1498,971,527,1176855.04,638724.40,1815579.44
270860,202206,2538,1718,820,2082232.55,993848.76,3076081.31
270870,202206,120,70,50,84840.20,60600.20,145440.40
270880,202206,829,659,170,799926.51,206040.53,1005967.04
270890,202206,262,199,63,241188.97,76356.00,317544.97
270895,202206,58,55,3,66660.00,3636.00,70296.00
270900,202206,62,52,10,63024.20,12120.00,75144.20
270910,202206,303,249,54,301792.52,65448.60,367241.12
270915,202206,1910,1262,648,1529553.06,785377.44,2314930.50
270920,202206,416,344,72,416930.48,87264.20,504194.68
270930,202206,5615,4309,1306,5224979.66,1582877.43,6807857.09
270940,202206,2169,1717,452,2083447.36,547824.90,2631272.26
280010,202206,38,32,6,39996.51,7272.00,47268.51
280020,202206,486,415,71,502982.76,86052.97,589035.73
280030,202206,21221,13808,7413,16738091.48,8989535.22,25727626.70
280040,202206,321,205,116,248460.20,140592.20,389052.40
280050,202206,421,326,95,395112.40,115140.00,510252.40
280060,202206,375,244,131,295729.06,158772.83,454501.89
280067,202206,1122,806,316,976876.58,382993.07,1359869.65
280070,202206,121,102,19,123624.80,23028.00,146652.80
280100,202206,655,511,144,620547.91,174529.40,795077.31
280110,202206,78,70,8,84840.40,9696.00,94536.40
280120,202206,666,559,107,678723.21,129685.78,808408.99
280130,202206,1722,1129,593,1369563.09,718717.00,2088280.09
280140,202206,500,420,80,509042.50,96960.00,606002.50
280150,202206,417,295,122,358753.55,147864.00,506617.55
280160,202206,139,109,30,132108.00,36360.00,168468.00
280170,202206,421,294,127,356333.84,153925.81,510259.65
280190,202206,28,22,6,26664.00,7272.00,33936.00
280200,202206,37,29,8,35148.20,9696.30,44844.50
280210,202206,2963,2138,825,2592408.36,1001119.40,3593527.76
280220,202206,51,41,10,49692.91,12120.00,61812.91
280230,202206,336,268,68,324817.75,82416.08,407233.83
280240,202206,127,118,9,144229.19,10908.00,155137.19
280250,202206,18,10,8,12120.00,9696.00,21816.00
280260,202206,78,71,7,86053.25,8484.00,94537.25
280270,202206,136,104,32,126048.00,38784.47,164832.47
280280,202206,185,118,67,144229.19,81204.00,225433.19
280290,202206,3571,2595,976,3146296.85,1184127.75,4330424.60
280300,202206,1614,1289,325,1563495.94,393900.75,1957396.69
280310,202206,95,90,5,109080.89,6060.00,115140.89
280320,202206,652,458,194,555100.96,235128.99,790229.95
280330,202206,309,229,80,277549.34,96960.20,374509.54
280340,202206,423,353,70,427837.06,84840.00,512677.06
280350,202206,3710,2841,869,3443324.63,1054450.51,4497775.14
280360,202206,467,318,149,385416.66,180588.20,566004.86
280370,202206,89,78,11,94536.13,13332.00,107868.13
280380,202206,48,37,11,44844.00,13332.00,58176.00
280390,202206,180,153,27,185436.38,32724.00,218160.38
280400,202206,394,268,126,324821.98,153925.75,478747.73
280410,202206,290,241,49,292093.57,59388.30,351481.87
280420,202206,130,111,19,134533.15,23028.00,157561.15
280430,202206,91,73,18,88476.89,21816.00,110292.89
280440,202206,710,581,129,704179.01,156348.20,860527.21
280445,202206,119,112,7,135745.42,8484.00,144229.42
280450,202206,1271,1092,179,1323507.30,216950.04,1540457.34
280460,202206,658,481,177,582977.07,214524.68,797501.75
280470,202206,99,91,8,110292.19,9696.00,119988.19
280480,202206,2990,2042,948,2476162.40,1150206.99,3626369.39
280490,202206,201,190,11,230284.06,13332.00,243616.06
280500,202206,42,39,3,47268.42,3636.17,50904.59
280510,202206,136,109,27,132108.56,32725.20,164833.76
280520,202206,55,41,14,49692.80,16968.00,66660.80
280530,202206,70,48,22,58176.93,26664.00,84840.93
280540,202206,544,469,75,568431.82,90900.00,659331.82
280550,202206,725,667,58,808411.35,70296.00,878707.35
280560,202206,474,427,47,517526.65,58176.60,575703.25
280570,202206,2320,1843,477,2234942.74,579336.09,2814278.83
280580,202206,578,455,123,551463.70,149076.20,700539.90
280590,202206,219,139,80,168472.89,98174.30,266647.19
280600,202206,395,327,68,396384.01,82416.00,478800.01
280610,202206,115,80,35,96961.05,42420.93,139381.98
280620,202206,550,447,103,541765.10,124836.00,666601.10
280630,202206,149,122,27,147865.07,32724.00,180589.07
280640,202206,179,145,34,175740.00,41208.00,216948.00
280650,202206,86,52,34,63024.20,41208.52,104232.72
280660,202206,129,98,31,119989.95,37572.10,157562.05
280670,202206,1985,1264,721,1532048.72,873863.43,2405912.15
280680,202206,234,200,34,242400.65,41208.00,283608.65
280690,202206,79,68,11,82416.00,13332.00,95748.00
280700,202206,18,18,0,21816.00,,21816.00
280710,202206,1484,1161,323,1407145.70,391477.12,1798622.82
280720,202206,125,85,40,103021.14,48480.00,151501.14
280730,202206,29,25,4,30300.00,4848.00,35148.00
280740,202206,2541,1915,626,2324627.51,759927.12,3084554.63
280750,202206,221,192,29,233919.10,35148.15,269067.25
280760,202206,891,607,284,736908.81,344209.69,1081118.50
290010,202206,194,137,57,167256.20,69084.00,236340.20
290020,202206,183,165,18,199981.30,21816.00,221797.30
290030,202206,611,393,218,476317.72,264216.20,740533.92
290035,202206,129,106,23,128472.10,27876.00,156348.10
290040,202206,291,203,88,247250.08,106656.00,353906.08
290050,202206,84,68,16,82416.00,19392.00,101808.00
290060,202206,252,111,141,134532.00,172104.20,306636.20
290070,202206,5729,2735,2994,3317271.13,3636024.88,6953296.01
290080,202206,449,191,258,231492.90,312696.00,544188.90
290090,202206,348,160,188,193920.30,227856.61,421776.91
290100,202206,1666,1048,618,1270188.92,749017.09,2019206.01
290110,202206,827,474,353,574495.43,429051.61,1003547.04
290115,202206,184,166,18,201193.39,21816.00,223009.39
290120,202206,797,536,261,650847.18,316332.00,967179.18
290130,202206,449,277,172,335724.00,208464.16,544188.16
290135,202206,291,222,69,269064.74,83628.00,352692.74
290140,202206,304,252,52,305426.48,63024.20,368450.68
290150,202206,133,92,41,111504.00,49692.00,161196.00
290160,202206,234,180,54,218162.62,65448.24,283610.86
290170,202206,105,75,30,90900.60,36360.36,127260.96
290180,202206,194,143,51,173317.16,61812.00,235129.16
290190,202206,353,280,73,339363.24,88476.90,427840.14
290195,202206,297,191,106,231492.20,128472.20,359964.40
290200,202206,258,211,47,255732.17,56964.00,312696.17
290205,202206,147,90,57,109080.60,69084.00,178164.60
290210,202206,1205,886,319,1073841.64,386628.77,1460470.41
290220,202206,175,100,75,121201.55,90900.70,212102.25
290225,202206,288,114,174,138168.20,210888.20,349056.40
290230,202206,77,48,29,58177.17,35148.00,93325.17
290240,202206,357,122,235,147864.20,284822.35,432686.55
290250,202206,238,222,16,269066.18,20604.00,289670.18
290260,202206,338,268,70,324817.67,84840.00,409657.67
290265,202206,186,162,24,196344.53,29088.29,225432.82
290270,202206,1351,1118,233,1355031.54,283610.80,1638642.34
290280,202206,470,331,139,401172.40,168468.40,569640.80
290290,202206,1366,821,545,995059.14,661753.98,1656813.12
290300,202206,395,338,57,409659.69,69084.20,478743.89
290310,202206,281,132,149,159984.20,180588.00,340572.20
290320,202206,4135,2511,1624,3043373.86,1968302.90,5011676.76
290323,202206,198,173,25,209676.00,30300.00,239976.00
290327,202206,157,121,36,146653.28,43632.00,190285.28
290330,202206,121,56,65,67872.53,78780.00,146652.53
290340,202206,763,320,443,387844.49,536916.30,924760.79
290350,202206,657,404,253,489650.42,306637.04,796287.46
290360,202206,316,244,72,296943.95,87265.19,384209.14
290370,202206,894,398,496,482378.36,602364.00,1084742.36
290380,202206,330,210,120,254522.48,145440.60,399963.08
290390,202206,2354,1472,882,1785290.84,1068986.11,2854276.95
290395,202206,231,134,97,162408.00,117564.00,279972.00
290400,202206,276,201,75,243612.00,90900.00,334512.00
290405,202206,240,205,35,248460.10,42420.00,290880.10
290410,202206,621,518,103,627817.53,124836.00,752653.53
290420,202206,269,215,54,260580.57,65448.00,326028.57
290430,202206,472,302,170,366025.70,206040.00,572065.70
290440,202206,82,72,10,87264.22,12120.00,99384.22
290450,202206,192,141,51,170892.00,61812.00,232704.00
290460,202206,1926,1156,770,1401083.43,933242.77,2334326.20
290470,202206,1335,584,751,707813.66,910218.84,1618032.50
290475,202206,555,519,36,629035.47,43632.00,672667.47
290480,202206,272,155,117,187861.00,141804.33,329665.33
290485,202206,231,210,21,254521.02,26664.00,281185.02
290490,202206,1243,878,365,1064140.15,442381.85,1506522.00
290500,202206,754,400,354,484803.80,429050.15,913853.95
290510,202206,187,153,34,185438.81,41208.34,226647.15
290515,202206,171,104,67,126048.00,81204.00,207252.00
290520,202206,1394,908,486,1100500.25,589032.38,1689532.63
290530,202206,270,245,25,296945.43,30300.20,327245.63
290540,202206,115,63,52,76356.00,63024.00,139380.00
290550,202206,158,131,27,158772.87,32724.00,191496.87
290560,202206,3199,1419,1780,1719840.05,2157365.49,3877205.54
290570,202206,6374,3038,3336,3685737.57,4045694.20,7731431.77
290580,202206,1235,745,490,902941.64,595093.20,1498034.84
290590,202206,560,447,113,541776.17,136958.27,678734.44
290600,202206,1742,1201,541,1456841.64,656911.59,2113753.23
290610,202206,173,158,15,191498.74,18180.00,209678.74
290620,202206,364,329,35,398749.92,42420.20,441170.12
290630,202206,1972,855,1117,1036273.27,1353807.46,2390080.73
290640,202206,130,103,27,124837.33,32724.05,157561.38
290650,202206,1831,838,993,1015665.81,1203519.73,2219185.54
290660,202206,257,212,45,256944.00,54540.72,311484.72
290670,202206,994,506,488,613279.87,591458.40,1204738.27
290680,202206,1240,994,246,1205946.68,298152.82,1504099.50
290682,202206,320,239,81,289672.51,98172.38,387844.89
290685,202206,245,151,94,183012.98,113928.20,296941.18
290687,202206,1126,734,392,892236.09,475105.56,1367341.65
290689,202206,145,77,68,93324.00,82416.00,175740.00
290690,202206,572,249,323,301790.64,391476.30,693266.94
290700,202206,242,125,117,151500.00,141805.30,293305.30
290710,202206,752,517,235,626609.95,284822.61,911432.56
290720,202206,1007,807,200,978096.26,246037.63,1224133.89
290730,202206,1206,700,506,848406.25,613274.66,1461680.91
290740,202206,24,21,3,25452.00,3636.00,29088.00
290750,202206,1415,617,798,747810.31,968394.59,1716204.90
290755,202206,71,62,9,75144.00,10908.00,86052.00
290760,202206,251,224,27,271489.70,32724.20,304213.90
290770,202206,172,167,5,202404.79,6060.00,208464.79
290780,202206,1092,867,225,1050808.16,272702.46,1323510.62
290790,202206,366,248,118,300578.50,143017.78,443596.28
290800,202206,2423,982,1441,1190191.04,1748920.46,2939111.50
290810,202206,483,329,154,398748.60,186648.95,585397.55
290820,202206,401,233,168,282398.94,203617.60,486016.54
290830,202206,451,321,130,389052.62,157560.43,546613.05
290840,202206,1800,1130,670,1369572.21,813256.98,2182829.19
290850,202206,959,496,463,601156.58,561159.19,1162315.77
290860,202206,645,297,348,359965.96,421776.00,781741.96
290870,202206,607,427,180,517526.18,218160.96,735687.14
290880,202206,116,65,51,78780.00,61812.00,140592.00
290890,202206,442,269,173,326030.17,209676.90,535707.07
290900,202206,165,125,40,151500.00,48480.00,199980.00
290910,202206,383,292,91,353905.42,111504.00,465409.42
290920,202206,199,174,25,210890.27,30300.00,241190.27
290930,202206,520,398,122,482380.54,147865.30,630245.84
290940,202206,213,180,33,218160.20,39996.00,258156.20
290950,202206,158,91,67,110292.00,81204.00,191496.00
290960,202206,469,330,139,399962.25,169681.14,569643.39
290970,202206,227,200,27,242400.20,32724.00,275124.20
290980,202206,1800,1236,564,1499254.41,688419.93,2187674.34
290990,202206,397,335,62,406025.39,75145.66,481171.05
291000,202206,902,277,625,335724.75,757500.00,1093224.75
291005,202206,2526,1074,1452,1304128.94,1761050.88,3065179.82
291010,202206,164,145,19,175740.00,23028.00,198768.00
291020,202206,92,72,20,87264.00,24240.80,111504.80
291030,202206,96,70,26,84840.00,31512.60,116352.60
291040,202206,636,369,267,447228.58,323604.20,770832.78
291050,202206,1482,776,706,942944.79,855675.58,1798620.37
291060,202206,1631,906,725,1099295.38,879914.55,1979209.93
291070,202206,1921,1432,489,1735598.63,593883.90,2329482.53
291072,202206,7253,2739,4514,3323346.85,5474625.38,8797972.23
291075,202206,234,192,42,232704.10,50904.20,283608.30
291077,202206,59,41,18,49692.00,21816.00,71508.00
291080,202206,20658,8796,11862,10664505.84,14386556.71,25051062.55
291085,202206,266,219,47,265428.26,56964.10,322392.36
291090,202206,271,111,160,134532.60,193920.00,328452.60
291100,202206,981,332,649,402384.00,787800.00,1190184.00
291110,202206,438,337,101,408445.84,123624.20,532070.04
291120,202206,2411,1257,1154,1523489.81,1399863.44,2923353.25
291125,202206,63,31,32,37572.00,38784.00,76356.00
291130,202206,188,165,23,199980.94,27876.00,227856.94
291140,202206,124,100,24,121200.00,29088.70,150288.70
291150,202206,372,138,234,167256.00,283608.00,450864.00
291160,202206,394,302,92,366028.99,113928.10,479957.09
291165,202206,49,38,11,46056.00,13332.20,59388.20
291170,202206,3239,1601,1638,1941641.56,1986473.61,3928115.17
291180,202206,1231,507,724,614486.95,877488.83,1491975.78
291185,202206,112,102,10,123624.20,12120.00,135744.20
291190,202206,1380,660,720,801137.63,873855.26,1674992.89
291200,202206,171,125,46,151500.00,55752.00,207252.00
291210,202206,2402,964,1438,1168375.68,1742861.36,2911237.04
291220,202206,300,231,69,279972.39,83628.00,363600.39
291230,202206,968,341,627,413293.65,759924.80,1173218.45
291240,202206,406,379,27,459348.80,32724.00,492072.80
291250,202206,411,332,79,403596.00,96960.00,500556.00
291260,202206,62,54,8,65448.00,9696.00,75144.00
291270,202206,1024,447,577,541775.81,699330.22,1241106.03
291280,202206,356,167,189,202405.99,229068.20,431474.19
291290,202206,1623,853,770,1033849.27,934457.36,1968306.63
291300,202206,233,182,51,220584.00,61812.00,282396.00
291310,202206,224,196,28,238765.88,33936.00,272701.88
291320,202206,1289,896,393,1085965.60,476317.28,1562282.88
291330,202206,138,118,20,143016.60,24240.00,167256.60
291340,202206,222,131,91,158772.80,110292.50,269065.30
291345,202206,119,83,36,100596.75,43632.00,144228.75
291350,202206,1742,653,1089,793860.39,1321081.00,2114941.39
291360,202206,8306,3963,4343,4805646.52,5267398.65,10073045.17
291370,202206,1102,649,453,786598.28,549039.68,1335637.96
291380,202206,254,200,54,242400.20,65448.00,307848.20
291390,202206,3989,1770,2219,2145255.87,2691855.96,4837111.83
291400,202206,2049,1430,619,1733179.40,751450.26,2484629.66
291410,202206,201,172,29,208465.20,35148.00,243613.20
291420,202206,112,86,26,104232.00,31512.00,135744.00
291430,202206,177,106,71,128472.61,86052.34,214524.95
291440,202206,522,423,99,512681.15,119988.00,632669.15
291450,202206,927,612,315,741750.23,381783.69,1123533.92
291460,202206,1941,1547,394,1876203.27,477535.46,2353738.73
291465,202206,2256,1074,1182,1302909.51,1432587.30,2735496.81
291470,202206,2892,1461,1431,1773174.18,1735589.27,3508763.45
291480,202206,11966,5186,6780,6285500.45,8225881.34,14511381.79
291490,202206,658,265,393,321181.31,476316.20,797497.51
291500,202206,351,211,140,255735.06,169680.10,425415.16
291510,202206,1185,459,726,556308.59,879912.20,1436220.79
291520,202206,914,408,506,495710.37,615696.60,1111406.97
291530,202206,926,264,662,319968.91,803556.85,1123525.76
291535,202206,123,101,22,122412.44,26665.20,149077.64
291540,202206,350,115,235,139380.98,284820.47,424201.45
291550,202206,1273,604,669,732052.97,810828.70,1542881.67
291560,202206,5141,2596,2545,3147580.61,3086968.10,6234548.71
291570,202206,222,111,111,134532.20,134532.40,269064.60
291580,202206,1197,747,450,906584.97,545400.50,1451985.47
291590,202206,90,40,50,48480.00,60600.00,109080.00
291600,202206,1115,558,557,676301.11,675085.00,1351386.11
291610,202206,1375,672,703,815700.19,852051.00,1667751.19
291620,202206,560,264,296,319971.60,358752.89,678724.49
291630,202206,474,147,327,178164.20,397536.00,575700.20
291640,202206,3990,1976,2014,2394938.78,2443406.92,4838345.70
291650,202206,436,298,138,361181.61,167257.45,528439.06
291660,202206,371,151,220,183013.33,266640.72,449654.05
291670,202206,168,104,64,126048.20,77568.00,203616.20
291680,202206,626,383,243,464206.82,296943.65,761150.47
291685,202206,580,335,245,407234.99,298153.29,705388.28
291690,202206,461,297,164,359964.10,198768.30,558732.40
291700,202206,1034,798,236,968392.75,286033.20,1254425.95
291710,202206,1579,779,800,944156.66,970815.58,1914972.24
291720,202206,423,288,135,349056.00,163620.00,512676.00
291730,202206,904,522,382,632669.07,464197.82,1096866.89
291733,202206,297,199,98,241188.46,118776.20,359964.66
291735,202206,83,63,20,76356.87,24240.00,100596.87
291740,202206,340,255,85,309060.33,103020.00,412080.33
291750,202206,2294,1474,820,1786520.74,995069.44,2781590.18
291760,202206,3045,1667,1378,2021619.42,1670136.20,3691755.62
291770,202206,732,499,233,604800.98,283612.52,888413.50
291780,202206,81,52,29,63024.00,35148.00,98172.00
291790,202206,155,81,74,98172.00,89688.20,187860.20
291800,202206,10237,4324,5913,5241955.78,7171432.25,12413388.03
291810,202206,1041,788,253,955060.29,306637.29,1261697.58
291820,202206,285,201,84,243612.00,101808.00,345420.00
291830,202206,1028,425,603,515104.90,730840.14,1245945.04
291835,202206,561,521,40,631454.82,48480.00,679934.82
291840,202206,5010,2525,2485,3061573.56,3017913.39,6079486.95
291845,202206,270,86,184,104232.00,223008.00,327240.00
291850,202206,309,275,34,333303.84,41208.40,374512.24
291855,202206,260,112,148,135744.10,179376.20,315120.30
291860,202206,163,105,58,127260.00,70297.50,197557.50
291870,202206,78,34,44,41208.00,53328.00,94536.00
291875,202206,160,150,10,181801.28,12120.00,193921.28
291880,202206,418,344,74,418141.76,89689.00,507830.76
291890,202206,244,86,158,104232.10,191496.60,295728.70
291900,202206,55,33,22,39996.00,26664.00,66660.00
291905,202206,116,88,28,106657.01,33936.00,140593.01
291910,202206,158,127,31,153924.00,37572.00,191496.00
291915,202206,437,388,49,470258.47,59389.01,529647.48
291920,202206,5393,2637,2756,3198517.49,3341515.24,6540032.73
291930,202206,163,98,65,118776.36,78780.00,197556.36
291940,202206,370,218,152,264216.82,186648.20,450865.02
291950,202206,1127,891,236,1079894.63,286032.00,1365926.63
291955,202206,1339,807,532,981725.45,644786.50,1626511.95
291960,202206,191,143,48,173316.20,58176.00,231492.20
291970,202206,759,562,197,681149.99,238765.10,919915.09
291980,202206,1409,1231,178,1491978.98,215737.50,1707716.48
291990,202206,138,127,11,153924.48,13332.00,167256.48
291992,202206,185,90,95,109082.17,115143.15,224225.32
291995,202206,182,113,69,136957.36,83628.20,220585.56
292000,202206,410,299,111,362390.20,134532.00,496922.20
292010,202206,325,223,102,270276.20,123624.13,393900.33
292020,202206,294,217,77,263004.62,93325.13,356329.75
292030,202206,145,112,33,135744.00,39996.00,175740.00
292040,202206,576,300,276,363600.00,334512.00,698112.00
292045,202206,119,105,14,127260.00,16968.00,144228.00
292050,202206,924,670,254,812041.85,309061.46,1121103.31
292060,202206,903,733,170,888410.20,206042.14,1094452.34
292070,202206,58,23,35,27876.20,42420.00,70296.20
292080,202206,154,108,46,130896.00,55752.00,186648.00
292090,202206,548,198,350,239977.02,424201.39,664178.41
292100,202206,1493,640,853,775690.18,1033845.98,1809536.16
292105,202206,169,151,18,183012.00,21816.00,204828.00
292110,202206,2282,851,1431,1031419.33,1736798.64,2768217.97
292120,202206,695,534,161,648428.74,195134.58,843563.32
292130,202206,469,259,210,313910.55,254520.20,568430.75
292140,202206,209,167,42,202405.63,50904.93,253310.56
292145,202206,165,87,78,105444.00,94536.00,199980.00
292150,202206,1483,1232,251,1495615.68,305425.21,1801040.89
292160,202206,163,128,35,155136.80,42420.73,197557.53
292170,202206,1170,1001,169,1213226.64,204828.98,1418055.62
292180,202206,224,163,61,197556.00,73932.00,271488.00
292190,202206,150,96,54,116352.00,65448.00,181800.00
292200,202206,1416,517,899,626608.81,1090802.77,1717411.58
292205,202206,114,95,19,115140.00,23028.00,138168.00
292210,202206,393,262,131,317546.90,158772.20,476319.10
292220,202206,34,22,12,26664.15,14544.00,41208.15
292225,202206,44,37,7,44844.00,8484.00,53328.00
292230,202206,992,752,240,911439.16,290880.90,1202320.06
292240,202206,619,454,165,550250.93,199980.20,750231.13
292250,202206,1630,1056,574,1281098.86,695689.68,1976788.54
292260,202206,399,242,157,293304.20,190285.01,483589.21
292265,202206,244,182,62,220584.61,75144.20,295728.81
292270,202206,718,347,371,420566.20,449652.55,870218.75
292273,202206,210,123,87,149076.00,105444.20,254520.20
292275,202206,171,88,83,106656.00,100596.00,207252.00
292280,202206,146,100,46,121200.00,55752.00,176952.00
292285,202206,89,70,19,84840.00,23028.00,107868.00
292290,202206,585,394,191,477532.63,231493.56,709026.19
292300,202206,1772,676,1096,819315.96,1328356.42,2147672.38
292303,202206,127,85,42,103020.20,50904.00,153924.20
292305,202206,119,87,32,105444.37,38784.00,144228.37
292310,202206,970,634,336,768415.63,408446.14,1176861.77
292320,202206,584,434,150,526010.61,181800.82,707811.43
292330,202206,177,110,67,133320.20,81204.00,214524.20
292335,202206,296,236,60,286033.04,72720.00,358753.04
292340,202206,547,380,167,460561.66,202404.33,662965.99
292350,202206,266,144,122,174528.20,147864.00,322392.20
292360,202206,713,537,176,650846.03,213312.00,864158.03
292370,202206,718,550,168,667813.98,203616.50,871430.48
292380,202206,616,507,109,614485.81,132108.00,746593.81
292390,202206,394,157,237,190284.40,287244.50,477528.90
292400,202206,3568,2192,1376,2656738.33,1670143.33,4326881.66
292405,202206,269,181,88,219372.00,106656.00,326028.00
292410,202206,110,67,43,81204.00,52116.00,133320.00
292420,202206,277,237,40,287244.92,48480.00,335724.92
292430,202206,534,389,145,471468.74,176952.32,648421.06
292440,202206,623,519,104,629032.10,126048.00,755080.10
292450,202206,228,174,54,210890.27,65448.00,276338.27
292460,202206,519,390,129,472682.29,157560.00,630242.29
292465,202206,204,175,29,212100.00,35148.65,247248.65
292467,202206,152,99,53,119988.00,64236.00,184224.00
292470,202206,312,213,99,258157.11,119988.00,378145.11
292480,202206,398,273,125,330880.92,151501.94,482382.86
292490,202206,238,176,62,213312.94,75144.40,288457.34
292500,202206,878,405,473,490864.13,573279.26,1064143.39
292510,202206,3575,1709,1866,2072532.80,2262810.31,4335343.11
292520,202206,1121,523,598,633885.65,725992.15,1359877.80
292525,202206,419,307,112,372088.71,135746.72,507835.43
292530,202206,4825,1947,2878,2363418.44,3489361.71,5852780.15
292540,202206,486,285,201,345420.70,243612.51,589033.21
292550,202206,1129,615,514,745385.55,622968.65,1368354.20
292560,202206,328,300,28,364816.07,33936.00,398752.07
292570,202206,322,250,72,303000.62,87264.00,390264.62
292575,202206,567,410,157,496926.18,190285.48,687211.66
292580,202206,1013,681,332,825373.95,402386.12,1227760.07
292590,202206,551,491,60,595094.33,72720.80,667815.13
292593,202206,146,115,31,139380.00,37572.00,176952.00
292595,202206,191,152,39,184224.51,47268.00,231492.51
292600,202206,1231,880,351,1066569.88,427839.40,1494409.28
292610,202206,118,95,23,115141.04,27877.34,143018.38
292620,202206,515,434,81,526017.19,98173.10,624190.29
292630,202206,1515,835,680,1012023.97,824161.80,1836185.77
292640,202206,866,599,267,725994.27,323604.40,1049598.67
292650,202206,180,143,37,174531.29,44844.00,219375.29
292660,202206,1922,1355,567,1642281.51,687212.83,2329494.34
292665,202206,137,98,39,118776.00,48480.00,167256.00
292670,202206,388,303,85,367236.64,103020.00,470256.64
292680,202206,264,195,69,236340.60,83628.00,319968.60
292690,202206,202,142,60,172104.60,72720.20,244824.80
292700,202206,985,645,340,782960.33,412083.90,1195044.23
292710,202206,109,96,13,116352.00,15756.31,132108.31
292720,202206,982,565,417,687207.53,505404.78,1192612.31
292730,202206,204,94,110,113928.20,133320.40,247248.60
292740,202206,72804,35050,37754,42503124.25,45783740.14,88286864.39
292750,202206,373,271,102,329667.41,123625.30,453292.71
292760,202206,335,279,56,338149.65,67872.30,406021.95
292770,202206,854,363,491,439957.01,596306.36,1036263.37
292780,202206,21,12,9,14544.00,10908.00,25452.00
292790,202206,773,407,366,493285.38,443592.00,936877.38
292800,202206,1247,754,493,913852.91,598731.02,1512583.93
292805,202206,383,133,250,161196.40,303000.45,464196.85
292810,202206,1801,1073,728,1304120.60,882336.92,2186457.52
292820,202206,684,582,102,705389.08,123626.53,829015.61
292830,202206,127,100,27,121200.20,32724.64,153924.84
292840,202206,681,558,123,677515.23,149076.50,826591.73
292850,202206,142,96,46,116352.40,55752.54,172104.94
292860,202206,2072,1188,884,1439872.47,1072633.56,2512506.03
292870,202206,3614,2355,1259,2854284.72,1525914.06,4380198.78
292880,202206,1400,926,474,1123526.60,574488.82,1698015.42
292890,202206,524,434,90,526009.75,109082.65,635092.40
292895,202206,143,97,46,117564.20,55752.00,173316.20
292900,202206,322,228,94,276339.74,113928.61,390268.35
292905,202206,480,235,245,284823.49,296940.20,581763.69
292910,202206,479,354,125,430261.03,151501.43,581762.46
292920,202206,527,225,302,272701.43,366027.26,638728.69
292925,202206,466,427,39,517525.85,48480.50,566006.35
292930,202206,671,402,269,487227.13,326029.07,813256.20
292935,202206,273,120,153,145441.34,185436.00,330877.34
292937,202206,218,151,67,183012.17,81204.00,264216.17
292940,202206,191,146,45,176952.42,54540.00,231492.42
292950,202206,1240,595,645,721151.61,781746.65,1502898.26
292960,202206,502,356,146,431477.83,176953.30,608431.13
292970,202206,234,171,63,207253.46,76357.23,283610.69
292975,202206,85,47,38,56965.25,46056.60,103021.85
292980,202206,331,229,102,277548.82,123624.00,401172.82
292990,202206,1309,972,337,1178066.27,409656.20,1587722.47
293000,202206,111,79,32,95748.20,38784.10,134532.30
293010,202206,2936,1731,1205,2099228.91,1464115.40,3563344.31
293015,202206,607,499,108,604791.96,130896.00,735687.96
293020,202206,319,255,64,309063.44,77568.86,386632.30
293030,202206,568,502,66,608428.14,79992.00,688420.14
293040,202206,368,295,73,358752.90,88476.00,447228.90
293050,202206,2925,1716,1209,2079801.90,1466531.58,3546333.48
293060,202206,251,197,54,238770.50,65449.11,304219.61
293070,202206,3625,1843,1782,2233737.40,2161013.98,4394751.38
293075,202206,93,64,29,77568.00,35148.00,112716.00
293076,202206,76,56,20,67872.00,24240.00,92112.00
293077,202206,567,325,242,393907.47,293305.99,687213.46
293080,202206,427,378,49,458141.01,59388.86,517529.87
293090,202206,131,117,14,141804.00,16968.00,158772.00
293100,202206,510,347,163,421778.15,197556.17,619334.32
293105,202206,344,251,93,304212.00,113928.00,418140.00
293110,202206,118,79,39,95749.36,47269.86,143019.22
293120,202206,294,204,90,248462.97,109081.07,357544.04
293130,202206,237,159,78,192710.75,94536.00,287246.75
293135,202206,8325,3297,5028,3996012.14,6101222.54,10097234.68
293140,202206,184,113,71,136957.85,87264.20,224222.05
293150,202206,306,267,39,323606.89,47268.20,370875.09
293160,202206,424,259,165,313908.60,199980.47,513889.07
293170,202206,212,133,79,161197.50,95749.19,256946.69
293180,202206,577,385,192,467833.57,232704.00,700537.57
293190,202206,1353,941,412,1140505.88,499351.30,1639857.18
293200,202206,542,477,65,578127.61,78780.05,656907.66
293210,202206,417,320,97,387842.48,117564.00,505406.48
293220,202206,2348,1023,1325,1239881.89,1608328.51,2848210.40
293230,202206,1815,686,1129,832649.69,1369560.70,2202210.39
293240,202206,229,210,19,255733.08,23028.59,278761.67
293245,202206,133,108,25,130896.39,30300.00,161196.39
293250,202206,772,315,457,381784.58,553886.58,935671.16
293260,202206,302,247,55,299364.20,66660.00,366024.20
293270,202206,1167,525,642,636302.52,778104.00,1414406.52
293280,202206,299,182,117,220584.72,146655.21,367239.93
293290,202206,2945,1899,1046,2301603.17,1268966.36,3570569.53
293300,202206,831,577,254,699326.97,307848.20,1007175.17
293305,202206,190,146,44,176952.00,53328.00,230280.00
293310,202206,169,126,43,152713.24,52116.20,204829.44
293315,202206,163,124,39,151501.00,47268.00,198769.00
293317,202206,97,74,23,89688.48,27876.00,117564.48
293320,202206,1104,587,517,711465.48,626615.17,1338080.65
293325,202206,204,77,127,93324.00,153924.07,247248.07
293330,202206,14292,6533,7759,7921708.47,9410015.32,17331723.79
293340,202206,281,200,81,242400.00,98172.00,340572.00
293345,202206,255,209,46,253309.43,55752.00,309061.43
293350,202206,585,361,224,437534.95,271488.20,709023.15
293360,202206,1475,1054,421,1277458.79,510254.12,1787712.91
310010,202206,144,75,69,90900.00,83628.00,174528.00
310020,202206,1005,547,458,662968.45,555096.80,1218065.25
310030,202206,305,244,61,295728.69,73932.91,369661.60
310040,202206,46,30,16,36360.00,19392.00,55752.00
310050,202206,152,96,56,116352.00,67872.00,184224.00
310060,202206,268,183,85,221798.15,103020.40,324818.55
310070,202206,16,10,6,12120.00,7272.20,19392.20
310080,202206,50,34,16,41208.00,19392.00,60600.00
310090,202206,1069,587,482,711449.69,584185.41,1295635.10
310100,202206,332,238,94,288456.70,113928.15,402384.85
310110,202206,687,362,325,439957.32,393900.00,833857.32
310120,202206,377,219,158,265428.00,192708.10,458136.10
310130,202206,28,16,12,19392.00,14544.00,33936.00
310140,202206,23,8,15,9696.00,18180.00,27876.00
310150,202206,1158,778,380,942944.56,460563.32,1403507.88
310160,202206,2037,1010,1027,1224130.02,1247152.63,2471282.65
310163,202206,93,52,41,63024.00,49692.00,112716.00
310170,202206,2513,1156,1357,1402290.75,1644690.70,3046981.45
310180,202206,171,74,97,89688.24,117564.00,207252.24
310190,202206,475,317,158,384204.68,191497.20,575701.88
310200,202206,437,277,160,335724.30,193920.20,529644.50
310205,202206,71,45,26,54540.00,31512.00,86052.00
310210,202206,269,223,46,270276.60,55752.00,326028.60
310220,202206,64,38,26,46056.00,31512.00,77568.00
310230,202206,271,194,77,235129.12,93324.00,328453.12
310240,202206,114,95,19,116352.00,23028.00,139380.00
310250,202206,98,78,20,94537.74,24240.00,118777.74
310260,202206,713,377,336,456927.56,407234.91,864162.47
310270,202206,270,177,93,214525.05,112716.20,327241.25
310280,202206,380,273,107,330877.65,129684.00,460561.65
310285,202206,193,146,47,176953.00,56964.00,233917.00
310290,202206,223,122,101,147864.00,122412.00,270276.00
310300,202206,163,130,33,157560.51,39996.66,197557.17
310310,202206,11,8,3,9696.00,3636.00,13332.00
310320,202206,27,9,18,10908.17,21816.00,32724.17
310330,202206,39,27,12,32724.25,14544.00,47268.25
310340,202206,1792,1249,543,1515009.45,658118.94,2173128.39
310350,202206,2734,1435,1299,1740461.26,1576814.27,3317275.53
310360,202206,48,40,8,48480.00,9696.30,58176.30
310370,202206,120,103,17,124836.00,20604.00,145440.00
310375,202206,109,42,67,50904.00,81204.13,132108.13
310380,202206,53,32,21,38784.00,25452.00,64236.00
310390,202206,108,69,39,83628.00,47268.00,130896.00
310400,202206,2438,1575,863,1908928.49,1047171.75,2956100.24
310410,202206,113,64,49,77568.86,59388.00,136956.86
310420,202206,667,343,324,415717.41,392691.56,808408.97
310430,202206,281,179,102,216948.10,123624.00,340572.10
310440,202206,72,44,28,53328.00,33936.00,87264.00
310445,202206,78,66,12,79992.16,14544.00,94536.16
310450,202206,641,418,223,506620.30,270276.20,776896.50
310460,202206,238,165,73,199980.97,88476.00,288456.97
310470,202206,523,338,185,409657.68,224222.02,633879.70
310480,202206,90,56,34,67872.00,41208.00,109080.00
310490,202206,548,254,294,307852.94,356328.88,664181.82
310500,202206,129,53,76,64236.10,92112.00,156348.10
310510,202206,599,424,175,513892.02,212100.95,725992.97
310520,202206,144,103,41,124836.10,49692.00,174528.10
310530,202206,110,44,66,53328.20,81204.00,134532.20
310540,202206,479,271,208,328454.42,252097.17,580551.59
310550,202206,68,46,22,55752.85,26664.00,82416.85
310560,202206,3068,2104,964,2551286.81,1170792.39,3722079.20
310570,202206,102,62,40,75144.00,48480.00,123624.00
310590,202206,376,229,147,277548.85,178164.00,455712.85
310600,202206,132,63,69,76356.20,83628.00,159984.20
310610,202206,51,22,29,26664.00,35148.00,61812.00
310620,202206,47790,22550,25240,27344132.17,30621289.27,57965421.44
310630,202206,693,409,284,495710.33,344208.88,839919.21
310640,202206,135,93,42,112716.00,50904.00,163620.00
310650,202206,148,130,18,157560.07,21816.00,179376.07
310660,202206,109,76,33,92112.00,39996.00,132108.00
310665,202206,66,46,20,55752.00,24240.00,79992.00
310670,202206,7082,3027,4055,3669995.65,4917099.76,8587095.41
310680,202206,64,38,26,46056.00,31512.00,77568.00
310690,202206,619,436,183,528435.23,223010.00,751445.23
310700,202206,60,37,23,44844.00,27876.00,72720.00
310710,202206,1279,860,419,1041458.15,507828.70,1549286.85
310720,202206,145,42,103,50904.00,124836.00,175740.00
310730,202206,1502,1024,478,1242318.08,579343.32,1821661.40
310740,202206,988,541,447,655696.84,542979.20,1198676.04
310750,202206,248,154,94,187860.04,113928.00,301788.04
310760,202206,65,51,14,61812.92,16968.00,78780.92
310770,202206,85,41,44,49692.00,53328.00,103020.00
310780,202206,350,287,63,347847.62,76357.55,424205.17
310790,202206,112,90,22,109080.00,26664.74,135744.74
310800,202206,477,225,252,272700.61,305424.00,578124.61
310810,202206,167,113,54,136956.20,65450.04,202406.24
310820,202206,313,251,62,304214.67,75144.04,379358.71
310825,202206,209,175,34,212101.10,41208.00,253309.10
310830,202206,445,207,238,250884.90,288456.60,539341.50
310840,202206,355,210,145,254520.20,175740.29,430260.49
310850,202206,74,61,13,73932.65,15756.00,89688.65
310855,202206,406,318,88,385418.12,106656.00,492074.12
310860,202206,1598,1180,418,1430175.41,506621.62,1936797.03
310870,202206,52,44,8,53329.67,9696.00,63025.67
310880,202206,83,68,15,82416.00,18180.00,100596.00
310890,202206,287,167,120,202404.00,145440.00,347844.00
310900,202206,594,268,326,324819.46,395115.28,719934.74
310910,202206,241,165,76,199982.00,92112.00,292094.00
310920,202206,427,245,182,296945.27,221799.04,518744.31
310925,202206,37,27,10,32724.00,12120.00,44844.00
310930,202206,1308,860,448,1042328.28,542977.51,1585305.79
310940,202206,675,342,333,414506.75,403599.19,818105.94
310945,202206,131,84,47,101808.20,56964.00,158772.20
310950,202206,217,171,46,207252.20,55752.00,263004.20
310960,202206,77,24,53,29088.00,64236.20,93324.20
310970,202206,170,100,70,121201.20,84840.60,206041.80
310980,202206,48,33,15,39998.01,18180.00,58178.01
310990,202206,161,82,79,99384.00,95748.20,195132.20
311000,202206,811,398,413,482378.78,500558.03,982936.81
311010,202206,47,38,9,46056.07,10908.00,56964.07
311020,202206,40,25,15,30300.24,18180.00,48480.24
311030,202206,388,222,166,269066.01,202404.00,471470.01
311040,202206,42,33,9,39996.00,10908.00,50904.00
311050,202206,488,187,301,226645.00,364812.60,591457.60
311060,202206,799,441,358,534493.23,433897.62,968390.85
311070,202206,327,146,181,176952.00,220584.00,397536.00
311080,202206,114,64,50,77568.58,60601.29,138169.87
311090,202206,336,161,175,195133.66,213313.08,408446.74
311100,202206,545,326,219,395112.90,266640.25,661753.15
311110,202206,716,510,206,618126.13,249674.26,867800.39
311115,202206,77,51,26,61812.47,31512.00,93324.47
311120,202206,1079,580,499,704180.96,606003.56,1310184.52
311130,202206,288,168,120,203616.94,145440.00,349056.94
311140,202206,157,82,75,99384.00,90900.69,190284.69
311150,202206,334,210,124,254521.12,150288.60,404809.72
311160,202206,756,531,225,643575.67,272700.10,916275.77
311170,202206,89,75,14,90900.00,16968.00,107868.00
311180,202206,308,209,99,253310.57,119988.68,373299.25
311190,202206,37,18,19,21816.00,23028.00,44844.00
311200,202206,342,232,110,281184.44,133320.20,414504.64
311205,202206,31,24,7,29088.00,8484.00,37572.00
311210,202206,35,30,5,36360.60,6060.00,42420.60
311220,202206,30,26,4,31512.00,4848.00,36360.00
311230,202206,1662,1090,572,1321096.46,693267.71,2014364.17
311240,202206,204,127,77,153924.60,93324.50,247249.10
311250,202206,60,23,37,27876.00,44844.00,72720.00
311260,202206,550,342,208,414508.80,253308.00,667816.80
311265,202206,122,83,39,100596.00,47268.00,147864.00
311270,202206,279,193,86,233917.69,104232.44,338150.13
311280,202206,203,90,113,109080.00,136956.00,246036.00
311290,202206,99,83,16,100596.00,20604.20,121200.20
311300,202206,574,364,210,443230.92,254520.78,697751.70
311310,202206,18,15,3,18180.00,3636.00,21816.00
311320,202206,620,461,159,559945.36,192708.19,752653.55
311330,202206,1146,845,301,1025358.07,364813.66,1390171.73
311340,202206,2583,1821,762,2209499.72,924759.07,3134258.79
311350,202206,266,205,61,249672.20,73932.00,323604.20
311360,202206,178,107,71,129684.00,86052.00,215736.00
311370,202206,1237,514,723,622978.32,877491.02,1500469.34
311380,202206,7,6,1,7272.00,1212.00,8484.00
311390,202206,246,141,105,170892.00,127260.00,298152.00
311400,202206,137,83,54,100596.00,65448.00,166044.00
311410,202206,115,58,57,70296.00,69084.00,139380.00
311420,202206,312,159,153,192709.54,187860.60,380570.14
311430,202206,825,547,278,662965.69,336937.08,999902.77
311440,202206,450,307,143,372090.53,173318.32,545408.85
311450,202206,306,180,126,218160.00,152712.00,370872.00
311455,202206,263,181,82,219374.64,100597.74,319972.38
311460,202206,132,58,74,70296.00,89688.00,159984.00
311470,202206,27,12,15,14544.00,18180.00,32724.00
311480,202206,51,25,26,30300.00,31512.00,61812.00
311490,202206,10,6,4,7272.00,4848.00,12120.00
311500,202206,30,14,16,16968.80,19392.00,36360.80
311510,202206,652,450,202,545408.39,244824.60,790232.99
311520,202206,40,33,7,39996.00,8484.00,48480.00
311530,202206,1781,1283,498,1555023.42,603577.78,2158601.20
311535,202206,62,40,22,49692.00,26664.00,76356.00
311540,202206,33,29,4,35148.00,4848.00,39996.00
311545,202206,163,115,48,140592.20,58176.00,198768.20
311547,202206,46,35,11,42420.00,13332.20,55752.20
311550,202206,645,294,351,356329.84,425413.53,781743.37
311560,202206,44,26,18,31512.00,21816.00,53328.00
311570,202206,283,190,93,230281.17,112716.40,342997.57
311580,202206,412,257,155,311484.43,187860.20,499344.63
311590,202206,28,25,3,30300.00,3636.00,33936.00
311600,202206,96,80,16,96960.74,19392.93,116353.67
311610,202206,249,214,35,259368.22,42420.00,301788.22
311615,202206,131,110,21,133320.00,25452.72,158772.72
311620,202206,29,17,12,20604.00,14544.00,35148.00
311630,202206,100,86,14,104232.00,16968.00,121200.00
311640,202206,132,65,67,78780.60,81206.08,159986.68
311650,202206,125,87,38,105444.00,46056.74,151500.74
311660,202206,423,195,228,236340.00,276336.20,512676.20
311670,202206,144,99,45,119989.40,54540.43,174529.83
311680,202206,213,164,49,198768.26,59388.26,258156.52
311690,202206,13,10,3,12120.50,3636.00,15756.50
311700,202206,192,141,51,170892.94,61812.00,232704.94
311710,202206,181,122,59,147864.80,71508.00,219372.80
311720,202206,37,27,10,32724.60,13332.00,46056.60
311730,202206,566,397,169,481168.86,204828.70,685997.56
311740,202206,24,17,7,20604.00,8484.00,29088.00
311750,202206,722,491,231,595093.76,279972.00,875065.76
311760,202206,78,33,45,39996.00,54540.00,94536.00
311770,202206,376,176,200,213312.44,242400.00,455712.44
311780,202206,189,94,95,113928.00,115140.00,229068.00
311783,202206,88,82,6,99384.20,7272.00,106656.20
311787,202206,38,15,23,18180.00,27876.10,46056.10
311790,202206,256,111,145,134532.00,175740.76,310272.76
311800,202206,713,442,271,535709.94,329664.00,865373.94
311810,202206,51,39,12,47268.00,14544.00,61812.00
311820,202206,118,91,27,110292.00,32724.98,143016.98
311830,202206,1860,1111,749,1346546.26,907788.17,2254334.43
311840,202206,1044,585,459,709026.63,557525.96,1266552.59
311850,202206,15,11,4,13332.00,4848.00,18180.00
311860,202206,9873,4195,5678,5086811.92,6896318.15,11983130.07
311870,202206,107,61,46,73932.77,55752.00,129684.77
311880,202206,961,696,265,845979.44,321185.88,1167165.32
311890,202206,197,92,105,111404.20,127260.00,238664.20
311900,202206,64,27,37,32724.00,44844.00,77568.00
311910,202206,1393,865,528,1048387.99,639940.25,1688328.24
311920,202206,227,152,75,184224.10,90900.00,275124.10
311930,202206,891,500,391,606004.20,473892.82,1079897.02
311940,202206,2618,1405,1213,1702879.82,1470159.04,3173038.86
311950,202206,159,94,65,113929.96,78780.80,192710.76
311960,202206,64,46,18,55752.50,21816.00,77568.50
311970,202206,22,12,10,14544.00,12120.00,26664.00
311980,202206,41,30,11,36360.00,13332.00,49692.00
311990,202206,36,25,11,30300.00,13332.64,43632.64
311995,202206,48,28,20,33936.00,24240.00,58176.00
312000,202206,22,14,8,16968.00,9696.00,26664.00
312010,202206,71,54,17,65448.00,20604.10,86052.10
312015,202206,79,60,19,72720.69,23028.00,95748.69
312020,202206,135,96,39,116352.00,47268.00,163620.00
312030,202206,69,52,17,63024.98,20604.00,83628.98
312040,202206,78,49,29,59388.00,35148.00,94536.00
312050,202206,193,110,83,133321.20,100596.00,233917.20
312060,202206,20,12,8,14544.00,9696.00,24240.00
312070,202206,79,51,28,61813.38,33936.00,95749.38
312080,202206,554,255,299,309060.00,362388.30,671448.30
312083,202206,63,40,23,48480.20,27876.00,76356.20
312087,202206,96,73,23,88476.00,27876.00,116352.00
312090,202206,3345,2030,1315,2462838.36,1593787.23,4056625.59
312100,202206,145,101,44,122134.36,53328.48,175462.84
312110,202206,116,70,46,84840.00,55752.00,140592.00
312120,202206,129,92,37,111505.59,44844.00,156349.59
312125,202206,86,56,30,67872.28,36360.00,104232.28
312130,202206,129,85,44,103020.00,53328.00,156348.00
312140,202206,134,104,30,126048.60,36360.00,162408.60
312150,202206,38,30,8,36360.00,9696.00,46056.00
312160,202206,1476,986,490,1195147.75,593880.30,1789028.05
312170,202206,11,8,3,9696.00,3636.00,13332.00
312180,202206,99,65,34,78780.00,41208.00,119988.00
312190,202206,39,34,5,41208.00,6060.00,47268.00
312200,202206,734,631,103,765993.52,124836.84,890830.36
312210,202206,119,62,57,76356.00,69084.92,145440.92
312220,202206,132,100,32,121200.20,38784.00,159984.20
312230,202206,3842,1734,2108,2101629.49,2559749.37,4661378.86
312235,202206,155,104,51,126048.08,61812.00,187860.08
312240,202206,77,54,23,65448.99,27876.00,93324.99
312245,202206,207,147,60,178165.40,72720.20,250885.60
312247,202206,86,63,23,76356.00,27876.38,104232.38
312250,202206,173,91,82,110292.44,99384.00,209676.44
312260,202206,101,66,35,79992.00,42420.00,122412.00
312270,202206,137,81,56,98172.92,67872.00,166044.92
312280,202206,34,18,16,21816.00,19392.00,41208.00
312290,202206,142,95,47,115140.20,56964.90,172105.10
312300,202206,204,133,71,161197.24,86052.10,247249.34
312310,202206,58,50,8,60600.00,9696.00,70296.00
312320,202206,412,253,159,307848.43,192708.00,500556.43
312330,202206,88,76,12,92112.00,14544.00,106656.00
312340,202206,33,17,16,20604.00,20604.00,41208.00
312350,202206,14,8,6,9696.00,7272.00,16968.00
312352,202206,96,68,28,82416.60,33936.00,116352.60
312360,202206,564,242,322,294517.10,390264.00,684781.10
312370,202206,336,185,151,224220.60,183012.73,407233.33
312380,202206,142,94,48,113932.44,58177.05,172109.49
312385,202206,159,132,27,159984.80,32724.10,192708.90
312390,202206,291,186,105,225432.00,127260.94,352692.94
312400,202206,370,274,96,332088.00,116354.14,448442.14
312410,202206,1154,408,746,495714.09,905367.76,1401081.85
312420,202206,658,501,157,607214.62,190286.31,797500.93
312430,202206,865,624,241,756290.20,292094.08,1048384.28
312440,202206,40,31,9,37572.00,10908.00,48480.00
312450,202206,193,124,69,150288.00,83628.00,233916.00
312460,202206,28,14,14,16968.00,16968.00,33936.00
312470,202206,47,32,15,38784.00,18180.00,56964.00
312480,202206,166,102,64,123624.10,77568.00,201192.10
312490,202206,305,208,97,252097.55,117564.70,369662.25
312500,202206,34,23,11,27876.20,13332.00,41208.20
312510,202206,604,233,371,282399.96,449655.55,732055.51
312520,202206,28,8,20,9696.00,24240.00,33936.00
312530,202206,36,26,10,31512.60,12120.10,43632.70
312540,202206,86,77,9,93324.00,10908.00,104232.00
312550,202206,34,27,7,32724.00,8484.00,41208.00
312560,202206,196,154,42,186648.62,50904.00,237552.62
312570,202206,455,270,185,327242.66,224221.00,551463.66
312580,202206,90,48,42,58176.00,50904.00,109080.00
312590,202206,223,178,45,215736.19,54540.00,270276.19
312595,202206,128,105,23,127260.05,27876.00,155136.05
312600,202206,73,33,40,39996.40,48480.00,88476.40
312610,202206,1562,800,762,969611.60,923544.65,1893156.25
312620,202206,223,161,62,195133.08,75144.00,270277.08
312630,202206,67,55,12,66660.00,14544.00,81204.00
312640,202206,41,11,30,13332.00,36360.00,49692.00
312650,202206,150,126,24,153121.94,29088.10,182210.04
312660,202206,105,76,29,92115.59,35148.60,127264.19
312670,202206,903,582,321,705388.63,389053.98,1094442.61
312675,202206,42,31,11,37572.00,13332.00,50904.00
312680,202206,71,44,27,53328.00,32724.00,86052.00
312690,202206,240,122,118,147864.97,143016.00,290880.97
312695,202206,27,23,4,27876.00,4848.00,32724.00
312700,202206,240,139,101,168470.60,122412.00,290882.60
312705,202206,82,66,16,79992.00,19392.00,99384.00
312707,202206,131,93,38,112716.49,46056.00,158772.49
312710,202206,1855,1023,832,1239892.92,1009597.74,2249490.66
312720,202206,46,22,24,26664.00,29088.00,55752.00
312730,202206,267,157,110,190285.06,133322.96,323608.02
312733,202206,47,36,11,43632.00,13332.00,56964.00
312735,202206,20,15,5,18180.00,6060.20,24240.20
312737,202206,73,41,32,49692.00,38784.00,88476.00
312738,202206,66,42,24,50904.08,29088.00,79992.08
312740,202206,77,51,26,61812.00,31512.00,93324.00
312750,202206,102,69,33,83628.00,39996.00,123624.00
312760,202206,279,193,86,233916.46,104232.59,338149.05
312770,202206,8598,4039,4559,4898958.00,5527942.12,10426900.12
312780,202206,440,335,105,406020.30,127260.94,533281.24
312790,202206,20,15,5,18180.00,6060.00,24240.00
312800,202206,1603,1112,491,1348963.21,596306.35,1945269.56
312810,202206,345,238,107,288456.71,130896.00,419352.71
312820,202206,184,139,45,168468.00,54540.00,223008.00
312825,202206,39,27,12,32724.00,14544.00,47268.00
312830,202206,192,107,85,129684.00,103020.30,232704.30
312840,202206,183,126,57,152712.00,69084.00,221796.00
312850,202206,40,36,4,43632.00,4848.00,48480.00
312860,202206,139,94,45,113928.00,55752.00,169680.00
312870,202206,1122,578,544,701757.57,659328.00,1361085.57
312880,202206,114,81,33,98172.81,39996.00,138168.81
312890,202206,166,118,48,143016.03,58176.00,201192.03
312900,202206,174,129,45,156348.00,54540.00,210888.00
312910,202206,176,102,74,123626.00,89688.00,213314.00
312920,202206,128,72,56,87264.00,67872.00,155136.00
312930,202206,324,222,102,269064.50,123625.46,392689.96
312940,202206,136,94,42,113928.00,50904.00,164832.00
312950,202206,724,498,226,603580.99,273913.84,877494.83
312960,202206,146,105,41,127262.52,49692.04,176954.56
312965,202206,108,87,21,105444.10,25452.00,130896.10
312970,202206,283,228,55,277550.45,66660.21,344210.66
312980,202206,2597,1326,1271,1609558.29,1540457.11,3150015.40
312990,202206,48,21,27,26664.10,32724.00,59388.10
313000,202206,52,29,23,35148.00,27876.00,63024.00
313005,202206,177,137,40,166044.50,48480.00,214524.50
313010,202206,943,396,547,479953.51,664178.12,1144131.63
313020,202206,195,104,91,126048.00,110292.00,236340.00
313030,202206,197,128,69,155136.76,83628.00,238764.76
313040,202206,89,27,62,32724.08,76356.00,109080.08
313050,202206,197,142,55,172104.00,66660.00,238764.00
313055,202206,38,30,8,36360.00,9696.00,46056.00
313060,202206,137,92,45,111504.60,54540.65,166045.25
313065,202206,59,44,15,53328.00,18180.60,71508.60
313070,202206,127,66,61,79992.91,73932.00,153924.91
313080,202206,39,21,18,25452.60,21816.00,47268.60
313090,202206,660,428,232,518738.60,282397.10,801135.70
313100,202206,203,77,126,93324.00,153924.00,247248.00
313110,202206,149,83,66,100596.10,79993.23,180589.33
313115,202206,219,117,102,141804.10,123624.00,265428.10
313120,202206,840,477,363,578127.91,441169.71,1019297.62
313130,202206,5887,3223,2664,3909949.48,3231204.42,7141153.90
313140,202206,131,73,58,88476.00,70296.00,158772.00
313150,202206,289,229,60,277548.47,72720.00,350268.47
313160,202206,190,144,46,174530.82,55752.00,230282.82
313170,202206,1364,888,476,1076266.65,576914.20,1653180.85
313180,202206,317,193,124,233919.07,150288.77,384207.84
313190,202206,718,417,301,507830.44,366025.48,873855.92
313200,202206,32,25,7,30300.00,8484.20,38784.20
313210,202206,1001,859,142,1041127.00,172107.08,1213234.08
313220,202206,303,176,127,213312.20,153924.00,367236.20
313230,202206,266,202,64,246036.20,77568.00,323604.20
313240,202206,2224,1114,1110,1350180.49,1348956.78,2699137.27
313250,202206,1238,932,306,1129592.95,370875.79,1500468.74
313260,202206,92,43,49,52116.00,59388.00,111504.00
313270,202206,1025,600,425,727202.11,515103.96,1242306.07
313280,202206,45,38,7,46056.00,8484.00,54540.00
313290,202206,218,176,42,214525.51,50904.00,265429.51
313300,202206,320,162,158,196344.40,193920.00,390264.40
313310,202206,240,107,133,129684.20,161196.80,290881.00
313320,202206,384,280,104,339361.07,126048.90,465409.97
313330,202206,1435,881,554,1068990.46,672661.42,1741651.88
313340,202206,327,237,90,287244.38,110292.10,397536.48
313350,202206,459,292,167,353904.53,202404.00,556308.53
313360,202206,183,85,98,103020.13,118776.00,221796.13
313370,202206,226,76,150,92112.55,181800.00,273912.55
313375,202206,312,184,128,223009.10,156348.00,379357.10
313380,202206,1333,714,619,865378.21,751443.03,1616821.24
313390,202206,54,49,5,59388.00,6060.00,65448.00
313400,202206,397,272,125,329668.25,152712.60,482380.85
313410,202206,39,20,19,24240.80,23028.18,47268.98
313420,202206,4639,2576,2063,3124597.07,2506424.44,5631021.51
313430,202206,125,62,63,75144.28,76357.22,151501.50
313440,202206,1360,961,399,1167177.78,483592.94,1650770.72
313450,202206,68,34,34,41208.00,41208.00,82416.00
313460,202206,375,160,215,193921.45,260580.68,454502.13
313470,202206,514,241,273,292098.79,332091.13,624189.92
313480,202206,158,118,40,143017.62,48480.00,191497.62
313490,202206,543,247,296,300577.14,358755.74,659332.88
313500,202206,29,15,14,18180.00,16968.00,35148.00
313505,202206,1057,813,244,985362.22,295728.90,1281091.12
313507,202206,97,66,31,79992.90,37572.00,117564.90
313510,202206,2830,1754,1076,2125991.94,1305333.94,3431325.88
313520,202206,3393,2640,753,3200948.36,916278.62,4117226.98
313530,202206,35,20,15,24240.00,18180.00,42420.00
313535,202206,84,69,15,83628.55,18180.00,101808.55
313540,202206,66,49,17,59388.00,20604.00,79992.00
313545,202206,111,95,16,115141.13,19392.00,134533.13
313550,202206,207,175,32,212100.20,38784.79,250884.99
313560,202206,344,164,180,198769.66,218163.90,416933.56
313570,202206,73,24,49,29088.00,59388.00,88476.00
313580,202206,1320,764,556,925973.97,673874.37,1599848.34
313590,202206,64,37,27,46056.00,32724.00,78780.00
313600,202206,675,406,269,492073.25,326029.47,818102.72
313610,202206,50,40,10,48480.99,12120.00,60600.99
313620,202206,1362,657,705,796296.95,854461.88,1650758.83
313630,202206,1617,1228,389,1488366.48,471469.60,1959836.08
313640,202206,117,72,45,87264.00,54540.00,141804.00
313650,202206,227,113,114,136956.80,138169.18,275125.98
313652,202206,24,24,0,29088.00,,29088.00
313655,202206,78,48,30,58176.10,36360.19,94536.29
313657,202206,50,45,5,54540.46,6060.00,60600.46
313660,202206,126,84,42,101810.28,50904.30,152714.58
313665,202206,689,313,376,379360.25,455713.42,835073.67
313670,202206,10430,7154,3276,8675631.55,3972955.59,12648587.14
313680,202206,41,32,9,38784.00,10908.00,49692.00
313690,202206,127,93,34,112716.10,41208.00,153924.10
313695,202206,79,61,18,73932.84,21816.00,95748.84
313700,202206,329,257,72,311485.43,87264.20,398749.63
313710,202206,127,93,34,112716.52,41208.20,153924.72
313720,202206,1185,541,644,655703.29,784168.58,1439871.87
313730,202206,69,39,30,47268.00,36360.00,83628.00
313740,202206,144,111,33,134532.20,39996.00,174528.20
313750,202206,410,289,121,350269.10,146652.00,496921.10
313753,202206,227,168,59,203616.88,71508.10,275124.98
313760,202206,1342,514,828,622971.67,1003539.06,1626510.73
313770,202206,404,280,124,339364.92,152713.50,492078.42
313780,202206,834,446,388,541769.46,470256.56,1012026.02
313790,202206,30,29,1,35148.00,1212.00,36360.00
313800,202206,160,99,61,119988.95,73934.15,193923.10
313810,202206,83,48,35,58176.00,42420.00,100596.00
313820,202206,1344,642,702,778111.75,852039.58,1630151.33
313830,202206,54,37,17,44844.00,20604.00,65448.00
313835,202206,61,52,9,63024.20,10908.00,73932.20
313840,202206,1662,993,669,1204743.81,810829.83,2015573.64
313850,202206,214,91,123,110293.31,149076.00,259369.31
313860,202206,470,356,114,431475.40,138168.64,569644.04
313862,202206,175,120,55,145441.09,66660.20,212101.29
313865,202206,165,113,52,136956.20,63024.30,199980.50
313867,202206,57,46,11,55752.00,13332.00,69084.00
313868,202206,43,27,16,33936.00,19392.00,53328.00
313870,202206,89,49,40,59388.00,48480.00,107868.00
313880,202206,385,240,145,290881.83,175740.40,466622.23
313890,202206,335,183,152,221797.90,184224.00,406021.90
313900,202206,814,436,378,528436.65,458141.75,986578.40
313910,202206,146,97,49,117564.00,59388.00,176952.00
313920,202206,636,433,203,524796.61,246037.02,770833.63
313925,202206,35,30,5,36360.00,6060.00,42420.00
313930,202206,875,671,204,813257.46,247248.73,1060506.19
313940,202206,1910,1158,752,1407142.54,912638.81,2319781.35
313950,202206,842,515,327,624186.28,396324.20,1020510.48
313960,202206,1444,830,614,1005967.24,744171.60,1750138.84
313970,202206,183,107,76,129684.00,92112.00,221796.00
313980,202206,225,148,77,179379.19,93325.11,272704.30
313990,202206,256,167,89,202404.60,107868.00,310272.60
314000,202206,849,560,289,678722.50,350268.59,1028991.09
314010,202206,87,50,37,60600.00,44844.00,105444.00
314015,202206,80,21,59,25452.71,71508.46,96961.17
314020,202206,58,39,19,47268.10,23028.00,70296.10
314030,202206,74,37,37,44844.10,44844.00,89688.10
314040,202206,45,23,22,27876.00,26664.00,54540.00
314050,202206,292,165,127,199981.89,153924.00,353905.89
314053,202206,94,59,35,71508.71,42420.00,113928.71
314055,202206,296,181,115,219373.98,139380.00,358753.98
314060,202206,120,102,18,123624.84,21816.00,145440.84
314070,202206,1074,534,540,647212.45,655696.90,1302909.35
314080,202206,206,129,77,156349.60,93324.84,249674.44
314085,202206,169,118,51,143016.00,61812.00,204828.00
314090,202206,381,271,110,328454.05,133320.00,461774.05
314100,202206,526,418,108,507830.71,130897.76,638728.47
314110,202206,757,344,413,418144.32,500557.20,918701.52
314120,202206,67,38,29,46056.00,35148.00,81204.00
314130,202206,26,18,8,21816.00,9696.00,31512.00
314140,202206,1121,699,422,847198.58,511466.67,1358665.25
314150,202206,186,122,64,147864.91,77568.86,225433.77
314160,202206,314,235,79,286033.94,95748.00,381781.94
314170,202206,82,63,19,76357.98,23028.00,99385.98
314180,202206,740,649,91,786595.14,110293.77,896888.91
314190,202206,86,54,32,65448.00,38784.00,104232.00
314200,202206,494,336,158,407237.81,191497.76,598735.57
314210,202206,258,196,62,237552.30,75144.60,312696.90
314220,202206,298,210,88,254522.21,106656.93,361179.14
314225,202206,54,35,19,42421.69,23028.00,65449.69
314230,202206,116,53,63,64236.00,76356.00,140592.00
314240,202206,172,124,48,150288.20,58176.07,208464.27
314250,202206,59,36,23,43632.73,27876.00,71508.73
314260,202206,218,105,113,127260.00,136956.00,264216.00
314270,202206,409,321,88,389056.65,107868.00,496924.65
314280,202206,737,401,336,485958.75,407232.30,893191.05
314290,202206,513,402,111,487224.98,134533.70,621758.68
314300,202206,343,259,84,313910.96,101808.00,415718.96
314310,202206,1328,916,412,1114154.31,500556.98,1614711.29
314315,202206,42,31,11,37572.00,13332.00,50904.00
314320,202206,591,402,189,487227.83,230280.38,717508.21
314330,202206,11473,5605,5868,6795804.71,7118103.51,13913908.22
314340,202206,620,280,340,339361.30,412083.98,751445.28
314345,202206,55,39,16,47268.00,19392.00,66660.00
314350,202206,175,108,67,130896.00,81204.00,212100.00
314360,202206,53,29,24,35149.90,29088.84,64238.74
314370,202206,72,51,21,61812.00,25452.00,87264.00
314380,202206,119,69,50,83628.50,60600.00,144228.50
314390,202206,3374,2184,1190,2648251.09,1443494.03,4091745.12
314400,202206,678,472,206,572069.46,249673.77,821743.23
314410,202206,511,333,178,403597.17,215737.13,619334.30
314420,202206,17,9,8,10908.00,9696.00,20604.00
314430,202206,2462,910,1552,1102928.45,1882248.56,2985177.01
314435,202206,168,99,69,119988.68,83628.00,203616.68
314437,202206,42,30,12,36360.00,14544.00,50904.00
314440,202206,94,61,33,73932.00,39996.10,113928.10
314450,202206,165,113,52,136956.00,63024.84,199980.84
314460,202206,624,300,324,363602.37,392689.38,756291.75
314465,202206,111,72,39,87264.04,47268.00,134532.04
314467,202206,72,58,14,70296.10,16968.00,87264.10
314470,202206,404,202,202,244826.35,244824.20,489650.55
314480,202206,1030,465,565,563585.75,684781.89,1248367.64
314490,202206,41,24,17,29088.00,20604.00,49692.00
314500,202206,277,193,84,233916.18,103020.00,336936.18
314505,202206,111,73,38,88476.92,46056.00,134532.92
314510,202206,242,197,45,238764.80,54540.00,293304.80
314520,202206,1414,741,673,899312.18,815683.06,1714995.24
314530,202206,753,596,157,723574.52,191498.02,915072.54
314535,202206,165,103,62,124836.00,75144.00,199980.00
314537,202206,65,40,25,48480.13,30300.00,78780.13
314540,202206,18,11,7,13332.00,8484.00,21816.00
314545,202206,59,41,18,49692.00,21816.00,71508.00
314550,202206,69,36,33,43632.29,39997.07,83629.36
314560,202206,871,459,412,556310.61,499346.90,1055657.51
314570,202206,16,13,3,15756.00,3636.00,19392.00
314580,202206,14,7,7,8484.00,8484.00,16968.00
314585,202206,26,19,7,23028.00,8484.00,31512.00
314587,202206,82,71,11,86052.00,13332.00,99384.00
314590,202206,568,391,177,473894.06,214524.24,688418.30
314600,202206,944,613,331,742965.54,402387.59,1145353.13
314610,202206,958,493,465,597517.52,563582.61,1161100.13
314620,202206,145,110,35,133320.20,42420.00,175740.20
314625,202206,100,75,25,90900.00,30300.00,121200.00
314630,202206,1131,610,521,740539.43,631452.90,1371992.33
314640,202206,88,55,33,66661.89,39996.60,106658.49
314650,202206,154,88,66,106656.44,79992.06,186648.50
314655,202206,60,45,15,54540.00,18180.00,72720.00
314660,202206,17,12,5,14544.00,6060.00,20604.00
314670,202206,213,166,47,201194.71,56964.00,258158.71
314675,202206,206,121,85,146653.76,103020.00,249673.76
314690,202206,592,316,276,382992.70,334512.90,717505.60
314700,202206,2173,1157,1016,1403514.53,1231395.14,2634909.67
314710,202206,1805,1011,794,1226553.88,963540.20,2190094.08
314720,202206,393,224,169,271488.75,204828.20,476316.95
314730,202206,507,272,235,330876.00,284820.00,615696.00
314740,202206,756,344,412,416930.51,500556.15,917486.66
314750,202206,20,16,4,19392.00,4848.00,24240.00
314760,202206,352,146,206,176952.00,249672.20,426624.20
314770,202206,103,69,34,83628.00,41208.00,124836.00
314780,202206,22,9,13,10908.00,15756.00,26664.00
314790,202206,2490,1571,919,1904080.60,1115040.79,3019121.39
314795,202206,61,53,8,64236.00,9696.00,73932.00
314800,202206,2924,1697,1227,2059205.88,1488337.25,3547543.13
314810,202206,1465,837,628,1014453.58,761137.36,1775590.94
314820,202206,114,70,44,84841.10,53328.10,138169.20
314830,202206,209,173,36,209676.00,43632.00,253308.00
314840,202206,86,48,38,58176.00,46056.00,104232.00
314850,202206,412,201,211,244824.50,255732.00,500556.50
314860,202206,638,487,151,590244.47,183012.60,773257.07
314870,202206,1591,826,765,1001117.69,928398.16,1929515.85
314875,202206,57,54,3,65448.00,3636.00,69084.00
314880,202206,39,28,11,33936.00,13332.00,47268.00
314890,202206,50,27,23,32724.00,27876.00,60600.00
314900,202206,25,19,6,23028.00,7272.92,30300.92
314910,202206,228,151,77,183012.44,93324.00,276336.44
314915,202206,129,114,15,138168.89,18180.18,156349.07
314920,202206,81,52,29,63024.85,35148.00,98172.85
314930,202206,1008,474,534,575711.98,647211.01,1222922.99
314940,202206,39,31,8,37572.00,9696.10,47268.10
314950,202206,22,19,3,23028.00,3636.00,26664.00
314960,202206,27,20,7,24240.00,8484.00,32724.00
314970,202206,171,82,89,99385.00,107868.40,207253.40
314980,202206,296,185,111,224220.87,134532.75,358753.62
314990,202206,450,241,209,292093.32,253308.85,545402.17
314995,202206,151,64,87,77568.00,105444.00,183012.00
315000,202206,90,71,19,86052.49,23028.00,109080.49
315010,202206,33,21,12,25452.00,14544.00,39996.00
315015,202206,156,124,32,150288.20,38784.00,189072.20
315020,202206,66,56,10,67872.00,12120.00,79992.00
315030,202206,103,77,26,93324.00,31512.00,124836.00
315040,202206,80,48,32,58176.00,38784.00,96960.00
315050,202206,207,127,80,153924.65,96960.32,250884.97
315053,202206,53,36,17,43632.00,20604.00,64236.00
315057,202206,120,94,26,113928.00,31512.00,145440.00
315060,202206,66,54,12,65448.88,14544.00,79992.88
315070,202206,99,58,41,70296.69,49692.17,119988.86
315080,202206,389,308,81,373297.73,98172.37,471470.10
315090,202206,95,55,40,66660.00,48480.00,115140.00
315100,202206,81,40,41,48480.79,49692.00,98172.79
315110,202206,271,137,134,166044.74,162408.00,328452.74
315120,202206,1800,861,939,1043541.72,1139289.75,2182831.47
315130,202206,330,236,94,286032.20,113928.08,399960.28
315140,202206,540,293,247,355117.39,299366.65,654484.04
315150,202206,991,476,515,576915.46,625396.16,1202311.62
315160,202206,187,95,92,115142.01,111504.73,226646.74
315170,202206,295,196,99,237553.25,119988.60,357541.85
315180,202206,3168,1338,1830,1622883.16,2219177.83,3842060.99
315190,202206,293,179,114,216949.00,138168.00,355117.00
315200,202206,1162,697,465,845983.78,563581.86,1409565.64
315210,202206,1658,970,688,1176866.01,833858.99,2010725.00
315213,202206,26,15,11,18180.00,13332.00,31512.00
315217,202206,197,155,42,187860.20,50904.00,238764.20
315220,202206,1589,1175,414,1426534.83,502983.53,1929518.36
315230,202206,177,136,41,164832.54,49692.00,214524.54
315240,202206,376,243,133,294519.07,161198.33,455717.40
315250,202206,2578,1226,1352,1485923.96,1641050.31,3126974.27
315260,202206,135,75,60,90900.00,72720.00,163620.00
315270,202206,132,92,40,111504.51,48480.00,159984.51
315280,202206,605,398,207,482384.64,250890.13,733274.77
315290,202206,186,115,71,139380.50,86052.49,225432.99
315300,202206,101,77,24,93324.00,29088.00,122412.00
315310,202206,81,73,8,88476.00,9696.00,98172.00
315320,202206,140,84,56,101809.27,67872.00,169681.27
315330,202206,61,48,13,58176.00,15756.00,73932.00
315340,202206,390,282,108,341785.18,130897.20,472682.38
315350,202206,156,99,57,119988.00,69084.00,189072.00
315360,202206,99,44,55,53328.00,66660.00,119988.00
315370,202206,56,34,22,41208.85,26664.00,67872.85
315380,202206,5,5,0,6060.00,,6060.00
315390,202206,58,18,40,21816.00,48481.08,70297.08
315400,202206,787,588,199,712660.45,241189.20,953849.65
315410,202206,312,182,130,220590.39,157562.88,378153.27
315415,202206,55,43,12,52116.00,14544.00,66660.00
315420,202206,189,141,48,170892.74,58176.00,229068.74
315430,202206,662,374,288,453288.80,349056.00,802344.80
315440,202206,90,60,30,72720.00,36360.00,109080.00
315445,202206,218,180,38,218161.42,46056.00,264217.42
315450,202206,174,126,48,152712.00,58176.00,210888.00
315460,202206,4468,2068,2400,2507661.30,2914876.39,5422537.69
315470,202206,44,17,27,20604.00,32724.00,53328.00
315480,202206,71,21,50,25452.20,60600.74,86052.94
315490,202206,706,439,267,532070.14,323604.20,855674.34
315500,202206,18,15,3,18180.00,3636.00,21816.00
315510,202206,140,98,42,118776.00,50904.00,169680.00
315520,202206,76,65,11,78780.00,13332.00,92112.00
315530,202206,42,23,19,27876.00,23028.00,50904.00
315540,202206,271,189,82,230281.01,99384.18,329665.19
315550,202206,183,149,34,180588.12,41208.00,221796.12
315560,202206,705,558,147,677513.43,178165.31,855678.74
315570,202206,306,150,156,181801.42,189072.79,370874.21
315580,202206,740,498,242,603576.30,293304.80,896881.10
315590,202206,189,99,90,119989.24,109080.51,229069.75
315600,202206,329,252,77,305426.35,93324.00,398750.35
315610,202206,99,47,52,56964.00,63024.00,119988.00
315620,202206,37,29,8,35148.00,9696.00,44844.00
315630,202206,125,89,36,107868.00,43632.00,151500.00
315640,202206,63,37,26,44844.00,31512.00,76356.00
315645,202206,48,30,18,36360.00,21816.00,58176.00
315650,202206,165,120,45,145440.24,54540.00,199980.24
315660,202206,447,200,247,242403.85,299366.61,541770.46
315670,202206,2380,1106,1274,1340486.60,1545306.80,2885793.40
315680,202206,780,558,222,677509.81,269064.50,946574.31
315690,202206,676,447,229,541768.20,277548.90,819317.10
315700,202206,1969,1033,936,1252011.84,1135654.11,2387665.95
315710,202206,357,116,241,140592.32,292092.00,432684.32
315720,202206,499,301,198,366025.20,239976.30,606001.50
315725,202206,188,149,39,180588.87,47268.00,227856.87
315727,202206,65,36,29,43632.57,36360.10,79992.67
315730,202206,49,44,5,53328.00,6060.00,59388.00
315733,202206,83,51,32,61812.00,38784.00,100596.00
315737,202206,48,36,12,43632.20,14544.00,58176.20
315740,202206,28,21,7,25452.00,8484.00,33936.00
315750,202206,157,115,42,139380.00,50904.00,190284.00
315760,202206,44,33,11,39996.00,13332.00,53328.00
315765,202206,129,75,54,90901.74,65448.46,156350.20
315770,202206,223,145,78,176952.00,94536.00,271488.00
315780,202206,3784,1858,1926,2253137.51,2335526.89,4588664.40
315790,202206,243,188,55,227856.98,66660.18,294517.16
315800,202206,305,201,104,243612.94,126048.00,369660.94
315810,202206,58,34,24,41208.84,29088.00,70296.84
315820,202206,742,543,199,658126.85,242402.25,900529.10
315830,202206,120,77,43,93324.10,52116.10,145440.20
315840,202206,79,53,26,64236.00,31512.00,95748.00
315850,202206,265,176,89,213313.29,107868.69,321181.98
315860,202206,16,5,11,6060.00,13332.00,19392.00
315870,202206,40,31,9,37572.00,10908.00,48480.00
315880,202206,94,64,30,77568.00,36360.00,113928.00
315890,202206,101,75,26,90900.00,31512.00,122412.00
315895,202206,401,264,137,319971.37,166045.65,486017.02
315900,202206,80,38,42,46056.00,50904.00,96960.00
315910,202206,45,27,18,32724.00,21816.00,54540.00
315920,202206,154,102,52,123624.30,63024.00,186648.30
315930,202206,53,17,36,20604.00,43632.84,64236.84
315935,202206,121,96,25,116354.95,30300.23,146655.18
315940,202206,99,74,25,89688.00,30300.00,119988.00
315950,202206,30,21,9,25452.00,10908.00,36360.00
315960,202206,551,262,289,318758.64,351484.27,670242.91
315970,202206,28,22,6,26664.57,7272.00,33936.57
315980,202206,655,328,327,397539.81,396324.75,793864.56
315990,202206,261,149,112,180588.00,135744.13,316332.13
316000,202206,46,30,16,36360.00,19392.00,55752.00
316010,202206,88,73,15,88476.64,18180.00,106656.64
316020,202206,108,93,15,112716.49,18180.00,130896.49
316030,202206,376,214,162,259368.60,196345.55,455714.15
316040,202206,548,219,329,265429.27,398748.60,664177.87
316045,202206,50,46,4,55752.00,4848.00,60600.00
316050,202206,19,14,5,16968.00,6060.00,23028.00
316060,202206,107,73,34,88476.30,41208.00,129684.30
316070,202206,1160,772,388,935669.93,470258.61,1405928.54
316080,202206,90,58,32,70402.65,38784.00,109186.65
316090,202206,37,18,19,21816.00,23028.86,44844.86
316095,202206,85,72,13,87264.72,15756.00,103020.72
316100,202206,329,185,144,224222.71,174528.00,398750.71
316105,202206,42,24,18,29088.60,21816.00,50904.60
316110,202206,1856,1447,409,1756203.81,495713.66,2251917.47
316120,202206,78,52,26,63024.00,31512.00,94536.00
316130,202206,117,85,32,103021.21,38784.00,141805.21
316140,202206,34,23,11,27876.00,13332.00,41208.00
316150,202206,210,146,64,176952.20,77568.83,254521.03
316160,202206,81,49,32,59388.00,38784.00,98172.00
316165,202206,73,49,24,59388.00,29088.00,88476.00
316170,202206,185,121,64,146652.10,77568.00,224220.10
316180,202206,215,85,130,103020.81,157560.60,260581.41
316190,202206,145,107,38,129684.00,46056.00,175740.00
316200,202206,650,354,296,429051.64,359964.19,789015.83
316210,202206,742,496,246,602577.20,299365.56,901942.76
316220,202206,118,74,44,89688.00,53328.00,143016.00
316225,202206,36,22,14,26664.00,16968.67,43632.67
316230,202206,40,20,20,24240.00,24240.00,48480.00
316240,202206,649,518,131,627819.75,158773.44,786593.19
316245,202206,152,135,17,163621.11,20604.00,184225.11
316250,202206,1612,1086,526,1316245.85,637513.05,1953758.90
316255,202206,135,109,26,132108.00,31512.60,163620.60
316257,202206,174,89,85,107868.20,103020.00,210888.20
316260,202206,190,130,60,157560.61,72720.20,230280.81
316265,202206,30,21,9,25452.10,10908.00,36360.10
316270,202206,666,473,193,573280.56,235129.79,808410.35
316280,202206,537,332,205,403599.96,248460.75,652060.71
316290,202206,826,569,257,689635.13,311484.98,1001120.11
316292,202206,566,230,336,278761.55,409657.26,688418.81
316294,202206,100,63,37,76356.00,44844.18,121200.18
316295,202206,356,165,191,199980.97,231492.79,431473.76
316300,202206,10,8,2,9696.00,2424.00,12120.00
316310,202206,26,14,12,16968.00,14544.00,31512.00
316320,202206,56,29,27,35149.17,32724.00,67873.17
316330,202206,175,119,56,144228.00,67872.00,212100.00
316340,202206,137,91,46,110292.00,55752.00,166044.00
316350,202206,187,128,59,156348.20,71508.00,227856.20
316360,202206,26,15,11,18180.00,13332.00,31512.00
316370,202206,1208,592,616,717509.72,747807.15,1465316.87
316380,202206,115,89,26,107868.50,31512.00,139380.50
316390,202206,100,73,27,88476.00,32724.00,121200.00
316400,202206,144,109,35,132108.60,42420.00,174528.60
316410,202206,294,208,86,252096.30,104232.00,356328.30
316420,202206,216,146,70,176954.52,84840.30,261794.82
316430,202206,153,85,68,103020.00,83628.00,186648.00
316440,202206,74,38,36,46056.00,43632.35,89688.35
316443,202206,42,37,5,44844.87,6060.00,50904.87
316447,202206,45,36,9,43633.60,10908.00,54541.60
316450,202206,231,178,53,215736.20,64236.00,279972.20
316460,202206,44,14,30,16968.00,36360.00,53328.00
316470,202206,1727,1260,467,1528339.06,566004.00,2094343.06
316480,202206,11,9,2,10908.00,2424.00,13332.00
316490,202206,21,7,14,8484.00,16968.00,25452.00
316500,202206,162,105,57,127260.00,69084.00,196344.00
316510,202206,137,108,29,130896.00,35148.00,166044.00
316520,202206,189,107,82,129684.17,99384.32,229068.49
316530,202206,163,103,60,126048.00,73932.00,199980.00
316540,202206,156,77,79,93324.00,95748.00,189072.00
316550,202206,142,84,58,101809.02,70296.00,172105.02
316553,202206,380,185,195,225433.93,236340.60,461774.53
316555,202206,52,46,6,55752.55,7272.00,63024.55
316556,202206,13,9,4,10908.00,4848.00,15756.00
316557,202206,28,22,6,26664.00,7272.00,33936.00
316560,202206,73,50,23,60600.00,27876.60,88476.60
316570,202206,202,185,17,224220.86,20604.00,244824.86
316580,202206,19,14,5,16968.00,6060.00,23028.00
316590,202206,90,76,14,92112.62,16968.56,109081.18
316600,202206,175,143,32,173316.00,38784.00,212100.00
316610,202206,65,48,17,58176.77,20604.00,78780.77
316620,202206,139,98,41,118776.20,49692.28,168468.48
316630,202206,45,36,9,43632.00,10908.00,54540.00
316640,202206,21,13,8,15756.00,9696.00,25452.00
316650,202206,97,80,17,96960.00,20604.00,117564.00
316660,202206,6,2,4,2424.00,4848.00,7272.00
316670,202206,427,147,280,178165.75,339360.00,517525.75
316680,202206,161,123,38,149076.91,46056.40,195133.31
316690,202206,166,101,65,122412.00,78780.00,201192.00
316695,202206,55,48,7,58176.00,8484.00,66660.00
316700,202206,24,17,7,20604.79,8484.00,29088.79
316710,202206,773,590,183,715082.62,221796.65,936879.27
316720,202206,4939,2347,2592,2847023.23,3147568.80,5994592.03
316730,202206,14,14,0,16968.00,,16968.00
316740,202206,150,93,57,112716.00,70296.00,183012.00
316750,202206,21,13,8,15756.20,9696.00,25452.20
316760,202206,309,248,61,300576.95,73932.49,374509.44
316770,202206,168,87,81,105444.00,98172.00,203616.00
316780,202206,68,41,27,49692.60,32724.00,82416.60
316790,202206,59,42,17,50904.00,20604.00,71508.00
316800,202206,1764,1081,683,1310180.51,829013.00,2139193.51
316805,202206,28,20,8,24240.00,9696.00,33936.00
316810,202206,60,36,24,43632.00,29088.38,72720.38
316820,202206,38,21,17,25452.00,20604.00,46056.00
316830,202206,97,44,53,53328.20,64236.00,117564.20
316840,202206,497,296,201,358755.15,244825.80,603580.95
316850,202206,303,206,97,250885.79,117564.03,368449.82
316860,202206,6188,2741,3447,3323356.71,4181413.40,7504770.11
316870,202206,1635,1049,586,1271410.24,710236.38,1981646.62
316880,202206,150,77,73,93324.98,88477.15,181802.13
316890,202206,227,153,74,185436.88,90900.69,276337.57
316900,202206,402,282,120,342997.46,145440.00,488437.46
316905,202206,21,8,13,9696.00,15756.00,25452.00
316910,202206,70,31,39,37572.00,47268.00,84840.00
316920,202206,141,109,32,132108.96,38784.00,170892.96
316930,202206,1911,971,940,1178073.73,1139281.12,2317354.85
316935,202206,947,565,382,684784.41,462986.25,1147770.66
316940,202206,1097,634,463,768410.56,561156.60,1329567.16
316950,202206,181,85,96,103020.40,116352.00,219372.40
316960,202206,1099,615,484,746604.40,589034.82,1335639.22
316970,202206,635,503,132,609641.51,159986.01,769627.52
316980,202206,81,41,40,49692.00,48480.00,98172.00
316990,202206,2201,1491,710,1807107.14,860522.10,2667629.24
317000,202206,324,251,73,304214.94,88476.00,392690.94
317005,202206,209,148,61,179376.55,73932.00,253308.55
317010,202206,6591,3715,2876,4502664.50,3490582.26,7993246.76
317020,202206,15656,6861,8795,8316906.05,10671710.00,18988616.05
317030,202206,90,39,51,47268.00,61812.00,109080.00
317040,202206,3089,1988,1101,2409482.35,1334415.23,3743897.58
317043,202206,77,58,19,70297.98,23028.80,93326.78
317047,202206,39,23,16,27876.64,19392.00,47268.64
317050,202206,140,108,32,130896.20,38784.00,169680.20
317052,202206,146,116,30,140593.05,36360.00,176953.05
317057,202206,170,127,43,153924.19,52116.00,206040.19
317060,202206,63,37,26,44844.00,31512.20,76356.20
317065,202206,51,37,14,44844.00,16968.00,61812.00
317070,202206,1883,868,1015,1053236.92,1230182.12,2283419.04
317075,202206,95,52,43,63024.95,52116.00,115140.95
317080,202206,924,473,451,573294.19,546612.06,1119906.25
317090,202206,696,544,152,659332.43,184226.31,843558.74
317100,202206,424,319,105,386628.40,127260.00,513888.40
317103,202206,119,95,24,115140.06,29088.00,144228.06
317107,202206,48,40,8,48480.00,9696.00,58176.00
317110,202206,82,45,37,54540.71,44844.09,99384.80
317115,202206,44,40,4,48480.00,4848.00,53328.00
317120,202206,1993,956,1037,1159901.85,1258058.84,2417960.69
317130,202206,2055,1374,681,1665301.15,827796.93,2493098.08
317140,202206,11,10,1,12120.10,1212.00,13332.10
317150,202206,281,171,110,207253.94,134532.00,341785.94
317160,202206,339,254,85,307849.65,103020.46,410870.11
317170,202206,236,156,80,189072.23,96960.10,286032.33
317180,202206,423,288,135,349057.11,163620.88,512677.99
317190,202206,256,185,71,224220.46,86052.00,310272.46
317200,202206,816,562,254,681157.79,307852.34,989010.13
317210,202206,183,95,88,115141.42,106656.00,221797.42
317220,202206,23,12,11,14544.00,13332.00,27876.00
320010,202206,552,397,155,481166.17,189074.65,670240.82
320013,202206,123,82,41,100596.60,49692.00,150288.60
320016,202206,249,154,95,186648.82,115140.00,301788.82
320020,202206,717,423,294,513896.98,356331.24,870228.22
320030,202206,160,109,51,132108.54,61814.75,193923.29
320035,202206,135,98,37,118776.00,46056.00,164832.00
320040,202206,486,247,239,299364.70,289671.33,589036.03
320050,202206,115,78,37,94537.83,44845.64,139383.47
320060,202206,1775,823,952,998696.90,1153830.16,2152527.06
320070,202206,95,59,36,71508.10,43632.00,115140.10
320080,202206,806,461,345,559951.47,418142.78,978094.25
320090,202206,1261,809,452,980515.38,549041.03,1529556.41
320100,202206,334,193,141,233918.06,170892.32,404810.38
320110,202206,122,75,47,90904.44,56964.20,147868.64
320115,202206,107,90,17,109080.00,20604.00,129684.00
320120,202206,3610,1868,1742,2264035.97,2111320.87,4375356.84
320130,202206,7693,3360,4333,4073570.07,5254057.15,9327627.22
320140,202206,448,289,159,350270.68,192710.35,542981.03
320150,202206,2083,1154,929,1399872.02,1127166.33,2527038.35
320160,202206,626,276,350,334515.01,425412.90,759927.91
320170,202206,106,84,22,101808.10,26664.02,128472.12
320180,202206,58,34,24,41209.16,29088.00,70297.16
320190,202206,237,142,95,172105.54,115141.14,287246.68
320200,202206,62,51,11,61813.07,13332.00,75145.07
320210,202206,898,484,414,586615.11,502984.25,1089599.36
320220,202206,295,104,191,126048.20,232704.20,358752.40
320225,202206,80,66,14,79992.07,16968.05,96960.12
320230,202206,689,436,253,529656.97,306639.56,836296.53
320240,202206,3471,1594,1877,1931941.16,2276147.67,4208088.83
320245,202206,500,341,159,413297.40,192710.76,606008.16
320250,202206,226,105,121,127261.21,146652.30,273913.51
320255,202206,124,94,30,113928.00,36360.22,150288.22
320260,202206,247,137,110,166044.23,133320.33,299364.56
320265,202206,146,114,32,138168.05,38784.11,176952.16
320270,202206,156,120,36,145441.84,43633.15,189074.99
320280,202206,1204,677,527,820532.48,641153.89,1461686.37
320290,202206,64,50,14,60600.00,16968.00,77568.00
320300,202206,609,409,200,495715.39,242402.34,738117.73
320305,202206,721,386,335,467839.52,406023.21,873862.73
320310,202206,201,117,84,141805.76,101808.20,243613.96
320313,202206,342,156,186,189075.26,225432.20,414507.46
320316,202206,106,77,29,93324.82,35148.00,128472.82
320320,202206,3389,1502,1887,1821651.84,2288267.59,4109919.43
320330,202206,269,195,74,236340.00,89688.00,326028.00
320332,202206,776,455,321,551469.36,389060.42,940529.78
320334,202206,277,152,125,184224.22,151502.15,335726.37
320335,202206,141,91,50,110292.00,60600.58,170892.58
320340,202206,561,394,167,478747.32,202406.52,681153.84
320350,202206,1063,434,629,526014.42,762353.66,1288368.08
320360,202206,174,85,89,103020.08,107868.00,210888.08
320370,202206,224,167,57,202405.58,69084.60,271490.18
320380,202206,301,213,88,258157.50,106656.00,364813.50
320390,202206,1141,664,477,804773.26,578124.80,1382898.06
320400,202206,306,216,90,261793.89,109080.00,370873.89
320405,202206,961,387,574,469053.12,695694.92,1164748.04
320410,202206,944,471,473,570857.39,573278.29,1144135.68
320420,202206,540,246,294,298159.44,356331.14,654490.58
320425,202206,205,111,94,134532.79,113928.73,248461.52
320430,202206,383,198,185,239979.48,224221.13,464200.61
320435,202206,163,109,54,132108.20,65448.87,197557.07
320440,202206,200,107,93,129685.52,112716.73,242402.25
320450,202206,137,74,63,89688.00,76356.10,166044.10
320455,202206,233,182,51,220584.33,61812.00,282396.33
320460,202206,287,176,111,213313.06,134532.00,347845.06
320465,202206,110,74,36,89690.32,43632.65,133322.97
320470,202206,705,420,285,509044.54,346635.65,855680.19
320480,202206,207,138,69,167257.38,83628.80,250886.18
320490,202206,3223,1499,1724,1820450.89,2089521.41,3909972.30
320495,202206,116,66,50,79992.10,60600.60,140592.70
320500,202206,9737,4721,5016,5725566.84,6080647.73,11806214.57
320501,202206,543,275,268,333302.54,324818.20,658120.74
320503,202206,306,216,90,261793.03,109080.41,370873.44
320506,202206,257,178,79,215737.18,95748.00,311485.18
320510,202206,1187,514,673,622971.17,818107.29,1441078.46
320515,202206,81,61,20,73932.00,24240.00,98172.00
320517,202206,211,150,61,181801.48,73932.00,255733.48
320520,202206,7470,3088,4382,3743908.95,5314669.70,9058578.65
320530,202206,6710,3208,3502,3894166.02,4245666.77,8139832.79
330010,202206,3303,1623,1680,1967104.55,2038591.12,4005695.67
330015,202206,196,84,112,101808.74,135744.10,237552.84
330020,202206,3828,1522,2306,1844677.64,2797315.56,4641993.20
330022,202206,271,133,138,161197.79,168468.35,329666.14
330023,202206,755,218,537,264216.00,650850.90,915066.90
330025,202206,687,127,560,153924.91,678727.01,832651.92
330030,202206,1804,1109,695,1345333.14,843557.53,2188890.67
330040,202206,2538,1265,1273,1534409.99,1546517.86,3080927.85
330045,202206,9822,2952,6870,3581491.36,8339827.05,11921318.41
330050,202206,882,551,331,667818.65,401173.20,1068991.85
330060,202206,1123,657,466,796292.18,564796.66,1361088.84
330070,202206,4142,1406,2736,1705305.22,3319691.80,5024997.02
330080,202206,1591,685,906,831442.21,1100507.57,1931949.78
330090,202206,400,222,178,270276.30,215737.33,486013.63
330093,202206,230,96,134,116352.00,162408.00,278760.00
330095,202206,66,37,29,44844.00,35148.00,79992.00
330100,202206,10475,5163,5312,6260029.89,6439396.21,12699426.10
330110,202206,457,209,248,253310.16,300576.88,553887.04
330115,202206,508,254,254,307850.45,307848.82,615699.27
330120,202206,396,211,185,255732.60,224220.60,479953.20
330130,202206,1616,416,1200,505409.82,1455626.35,1961036.17
330140,202206,663,349,314,422989.95,380568.00,803557.95
330150,202206,528,314,214,380572.46,259369.09,639941.55
330160,202206,206,119,87,144228.00,105444.00,249672.00
330170,202206,27005,9151,17854,11103268.98,21646505.95,32749774.93
330180,202206,248,133,115,161197.41,139380.71,300578.12
330185,202206,1057,370,687,448442.60,832651.51,1281094.11
330187,202206,504,148,356,179377.60,433898.46,613276.06
330190,202206,6179,2277,3902,2760960.61,4731677.01,7492637.62
330200,202206,4605,1446,3159,1752569.82,3833586.88,5586156.70
330205,202206,458,261,197,317547.91,238766.95,556314.86
330210,202206,951,568,383,688427.35,466622.69,1155050.04
330220,202206,2815,1645,1170,1993761.13,1420476.38,3414237.51
330225,202206,568,297,271,359966.99,328453.82,688420.81
330227,202206,2380,732,1648,887192.99,1998605.49,2885798.48
330230,202206,256,135,121,163620.00,146652.00,310272.00
330240,202206,4115,1913,2202,2319795.49,2670050.11,4989845.60
330245,202206,153,70,83,84840.40,100596.46,185436.86
330250,202206,6645,3192,3453,3874811.15,4189912.14,8064723.29
330260,202206,717,186,531,225433.98,644785.08,870219.06
330270,202206,3811,1208,2603,1464107.98,3162131.90,4626239.88
330280,202206,452,276,176,334523.21,214527.19,549050.40
330285,202206,6620,2082,4538,2524628.43,5506175.92,8030804.35
330290,202206,734,250,484,303004.53,586610.13,889614.66
330300,202206,746,463,283,561906.17,342999.57,904905.74
330310,202206,465,265,200,321181.49,242400.48,563581.97
330320,202206,7820,2767,5053,3357287.07,6129132.70,9486419.77
330330,202206,9281,3396,5885,4115992.14,7138724.51,11254716.65
330340,202206,2718,1523,1195,1849520.95,1449557.90,3299078.85
330350,202206,19535,7110,12425,8619852.49,15075003.34,23694855.83
330360,202206,2073,954,1119,1156271.58,1356248.88,2512520.46
330370,202206,974,501,473,607221.70,573279.00,1180500.70
330380,202206,961,379,582,459754.46,707810.57,1167565.03
330385,202206,643,325,318,393902.49,385416.12,779318.61
330390,202206,6061,3112,2949,3772993.39,3580268.58,7353261.97
330395,202206,366,230,136,278761.99,164834.47,443596.46
330400,202206,714,352,362,427842.34,438745.09,866587.43
330410,202206,516,371,145,449659.25,175741.28,625400.53
330411,202206,319,165,154,199980.52,186648.00,386628.52
330412,202206,221,95,126,115140.60,152712.10,267852.70
330414,202206,5299,2071,3228,2511294.14,3918418.02,6429712.16
330415,202206,614,259,355,313911.24,431474.35,745385.59
330420,202206,2366,1210,1156,1467741.51,1401076.26,2868817.77
330430,202206,1787,755,1032,916277.98,1252000.40,2168278.38
330440,202206,360,169,191,204828.71,231492.00,436320.71
330450,202206,117,54,63,65448.00,76356.00,141804.00
330452,202206,2339,970,1369,1175656.05,1660452.41,2836108.46
330455,202206,120893,40994,79899,49706032.09,96945226.49,146651258.58
330460,202206,259,116,143,140592.17,173316.40,313908.57
330470,202206,1246,660,586,799927.49,710238.29,1510165.78
330475,202206,1788,515,1273,624184.11,1544095.42,2168279.53
330480,202206,793,431,362,522376.40,438748.38,961124.78
330490,202206,15584,4780,10804,5797164.49,13106648.63,18903813.12
330500,202206,1490,632,858,767203.05,1041110.45,1808313.50
330510,202206,10874,3687,7187,4472333.39,8714346.56,13186679.95
330513,202206,101,52,49,63024.00,59388.00,122412.00
330515,202206,732,308,424,373297.80,513891.84,887189.64
330520,202206,2489,848,1641,1027786.19,1992545.98,3020332.17
330530,202206,190,108,82,130896.56,99384.40,230280.96
330540,202206,325,168,157,203617.09,190285.65,393902.74
330550,202206,2806,935,1871,1133226.73,2271307.47,3404534.20
330555,202206,947,352,595,426628.03,722353.10,1148981.13
330560,202206,731,247,484,299365.69,586609.97,885975.66
330570,202206,293,203,90,246036.80,109080.00,355116.80
330575,202206,824,297,527,359970.65,638727.65,998698.30
330580,202206,3352,1787,1565,2168279.66,1898006.54,4066286.20
330590,202206,256,131,125,158773.65,151500.00,310273.65
330600,202206,1316,780,536,946578.17,649636.92,1596215.09
330610,202206,1665,852,813,1033841.53,986573.87,2020415.40
330615,202206,223,178,45,215737.72,54541.70,270279.42
330620,202206,1038,403,635,488440.67,769624.18,1258064.85
330630,202206,4418,2630,1788,3190020.90,2169494.75,5359515.65
350010,202206,607,402,205,487232.32,248460.70,735693.02
350020,202206,57,19,38,23028.20,46056.00,69084.20
350030,202206,547,327,220,396334.06,266642.13,662976.19
350040,202206,116,47,69,56966.22,83628.89,140595.11
350050,202206,352,171,181,208464.80,219372.54,427837.34
350055,202206,123,53,70,64236.00,86052.10,150288.10
350060,202206,91,40,51,48480.71,61812.20,110292.91
350070,202206,812,460,352,557532.49,427842.55,985375.04
350075,202206,77,46,31,55752.20,37572.00,93324.20
350080,202206,58,25,33,30300.01,39996.40,70296.41
350090,202206,85,48,37,58177.56,44844.00,103021.56
350100,202206,270,167,103,202404.61,124836.00,327240.61
350110,202206,48,30,18,36360.80,21816.00,58176.80
350115,202206,172,90,82,109080.73,99384.60,208465.33
350120,202206,112,69,43,83628.85,52116.18,135745.03
350130,202206,397,170,227,207258.39,275126.73,482385.12
350140,202206,39,23,16,27876.44,19392.00,47268.44
350150,202206,70,50,20,60600.53,24240.80,84841.33
350160,202206,2383,937,1446,1135653.95,1752556.27,2888210.22
350170,202206,403,232,171,281186.36,207253.89,488440.25
350180,202206,166,94,72,113930.31,87264.81,201195.12
350190,202206,1016,547,469,664194.67,568428.83,1232623.50
350200,202206,54,25,29,30300.91,35148.00,65448.91
350210,202206,1318,715,603,866595.26,730847.53,1597442.79
350220,202206,635,517,118,626613.51,143016.67,769630.18
350230,202206,70,44,26,53328.00,31512.10,84840.10
350240,202206,63,39,24,47268.28,29089.02,76357.30
350250,202206,1113,510,603,619341.45,730841.86,1350183.31
350260,202206,95,68,27,82416.70,32724.00,115140.70
350270,202206,953,636,317,770837.37,385417.58,1156254.95
350275,202206,321,118,203,143018.53,246037.35,389055.88
350280,202206,4471,2145,2326,2602228.26,2822760.46,5424988.72
350290,202206,466,195,271,236341.97,329665.77,566007.74
350300,202206,49,23,26,27877.71,31513.10,59390.81
350310,202206,80,48,32,58176.20,38784.39,96960.59
350315,202206,69,29,40,35148.00,48480.00,83628.00
350320,202206,3403,1598,1805,1939227.71,2190096.56,4129324.27
350330,202206,1670,857,813,1039913.09,985360.70,2025273.79
350335,202206,20,12,8,14544.00,9696.00,24240.00
350340,202206,124,50,74,60600.00,89688.98,150288.98
350350,202206,98,47,51,56964.00,61812.00,118776.00
350360,202206,99,63,36,76356.60,43632.18,119988.78
350370,202206,82,45,37,54540.95,44844.00,99384.95
350380,202206,800,335,465,406024.03,566008.27,972032.30
350390,202206,1786,662,1124,802352.99,1363506.65,2165859.64
350395,202206,22,17,5,20604.37,6060.00,26664.37
350400,202206,1738,830,908,1005980.93,1100501.59,2106482.52
350410,202206,2982,1223,1759,1483506.29,2133129.62,3616635.91
350420,202206,274,163,111,197559.02,135744.14,333303.16
350430,202206,96,48,48,58177.89,58179.08,116356.97
350440,202206,149,108,41,130898.85,49692.40,180591.25
350450,202206,1742,956,786,1158694.71,952633.10,2111327.81
350460,202206,403,138,265,167258.20,322397.29,489655.49
350470,202206,20,13,7,15756.00,8484.00,24240.00
350480,202206,194,101,93,122415.64,112716.99,235132.63
350490,202206,242,113,129,136956.20,156348.00,293304.20
350500,202206,57,22,35,26664.00,42420.00,69084.00
350510,202206,152,92,60,111506.10,72720.00,184226.10
350520,202206,443,238,205,288460.78,249675.19,538135.97
350530,202206,438,210,228,254523.95,276341.04,530864.99
350535,202206,91,60,31,72720.20,37573.00,110293.20
350540,202206,370,193,177,233917.82,215736.59,449654.41
350550,202206,2741,1538,1203,1864098.60,1460467.16,3324565.76
350560,202206,587,398,189,482379.52,229069.83,711449.35
350570,202206,4577,1860,2717,2254338.63,3294228.19,5548566.82
350580,202206,376,177,199,214525.90,241189.40,455715.30
350590,202206,946,512,434,621761.61,526011.78,1147773.39
350600,202206,6374,2944,3430,3569405.77,4163238.83,7732644.60
350610,202206,1499,765,734,927196.88,889612.87,1816809.75
350620,202206,24,16,8,19392.00,9696.00,29088.00
350630,202206,256,128,128,155137.80,155136.15,310273.95
350635,202206,1151,463,688,561161.68,833864.39,1395026.07
350640,202206,115,84,31,101809.16,37572.20,139381.36
350650,202206,1876,1242,634,1506548.95,769620.25,2276169.20
350660,202206,766,303,463,367238.33,562369.53,929607.86
350670,202206,299,147,152,178164.00,185436.60,363600.60
350680,202206,161,81,80,99386.80,99384.79,198771.59
350690,202206,207,92,115,111504.10,139380.00,250884.10
350700,202206,891,421,470,511466.28,569642.34,1081108.62
350710,202206,417,153,264,185436.41,319970.87,505407.28
350715,202206,54,44,10,53328.51,12120.00,65448.51
350720,202206,17,10,7,12120.00,8484.10,20604.10
350730,202206,41,26,15,31512.00,18180.00,49692.00
350740,202206,236,127,109,153926.32,132109.93,286036.25
350745,202206,27,13,14,15756.20,16968.00,32724.20
350750,202206,2377,1389,988,1683501.06,1197464.53,2880965.59
350760,202206,3904,1624,2280,1970738.85,2764578.10,4735316.95
350770,202206,56,35,21,42420.00,25452.00,67872.00
350775,202206,49,35,14,42423.20,16968.00,59391.20
350780,202206,450,226,224,273918.37,271490.03,545408.40
350790,202206,370,155,215,187862.37,260580.87,448443.24
350800,202206,529,316,213,382994.34,259368.88,642363.22
350810,202206,516,397,119,481170.63,144228.95,625399.58
350820,202206,94,53,41,64236.00,49692.00,113928.00
350830,202206,72,39,33,47269.10,39996.00,87265.10
350840,202206,793,318,475,385419.56,577022.22,962441.78
350850,202206,1862,962,900,1165962.47,1090802.31,2256764.78
350860,202206,658,346,312,420568.81,378147.14,798715.95
350870,202206,455,301,154,364813.21,186648.20,551461.41
350880,202206,269,153,116,185437.19,141805.69,327242.88
350890,202206,40,23,17,27876.00,20604.90,48480.90
350900,202206,1643,498,1145,603581.65,1390173.56,1993755.21
350910,202206,25,12,13,14544.74,15756.00,30300.74
350920,202206,764,392,372,475107.04,450864.70,925971.74
350925,202206,1177,602,575,733266.19,698117.53,1431383.72
350930,202206,110,61,49,73933.12,59388.00,133321.12
350940,202206,736,381,355,461784.69,430266.24,892050.93
350945,202206,112,81,31,98172.76,37573.03,135745.79
350950,202206,17416,7959,9457,9653700.11,11472844.41,21126544.52
350960,202206,1600,649,951,786592.57,1152617.22,1939209.79
350970,202206,1084,529,555,641025.67,672666.70,1313692.37
350980,202206,97,65,32,79992.90,38784.00,118776.90
350990,202206,387,136,251,164834.43,304212.85,469047.28
350995,202206,42,18,24,21817.18,29088.84,50906.02
351000,202206,618,399,219,483592.68,265434.19,749026.87
351010,202206,46,30,16,36360.03,19392.00,55752.03
351015,202206,42,27,15,33936.60,18180.00,52116.60
351020,202206,1492,876,616,1064143.43,747807.11,1811950.54
351030,202206,343,200,143,242400.00,174528.00,416928.00
351040,202206,1002,524,478,636304.50,580549.71,1216854.21
351050,202206,3590,1605,1985,1946509.31,2407039.79,4353549.10
351060,202206,5932,2136,3796,2591293.02,4605609.41,7196902.43
351070,202206,410,254,156,307854.96,189074.00,496928.96
351080,202206,734,533,201,647214.10,243615.40,890829.50
351090,202206,47,23,24,27876.60,29088.00,56964.60
351100,202206,413,219,194,265433.65,235131.08,500564.73
351110,202206,2072,938,1134,1139307.41,1375623.53,2514930.94
351120,202206,63,29,34,35148.85,41208.60,76357.45
351130,202206,193,59,134,71508.73,162408.83,233917.56
351140,202206,325,194,131,235130.51,158772.60,393903.11
351150,202206,490,247,243,299366.04,294517.10,593883.14
351160,202206,285,172,113,208464.72,136956.83,345421.55
351170,202206,224,126,98,152712.02,119988.00,272700.02
351190,202206,91,57,34,69084.53,41208.00,110292.53
351200,202206,346,222,124,269066.41,150289.44,419355.85
351210,202206,119,57,62,69084.00,76356.00,145440.00
351220,202206,568,324,244,393904.24,296940.87,690845.11
351230,202206,288,195,93,236343.74,113928.20,350271.94
351240,202206,235,112,123,135745.48,149077.50,284822.98
351250,202206,84,55,29,66661.62,35149.09,101810.71
351260,202206,153,106,47,128472.00,56964.00,185436.00
351270,202206,43,19,24,23028.85,29088.00,52116.85
351280,202206,1040,484,556,589038.48,673876.95,1262915.43
351290,202206,247,107,140,129684.10,169680.30,299364.40
351300,202206,3927,1662,2265,2015479.50,2748834.38,4764313.88
351310,202206,738,354,384,430268.14,465412.50,895680.64
351320,202206,122,67,55,81204.29,66661.54,147865.83
351330,202206,41,25,16,30300.00,19392.00,49692.00
351340,202206,1397,762,635,923559.17,772048.32,1695607.49
351350,202206,2337,1347,990,1632587.75,1199884.14,2832471.89
351360,202206,809,372,437,450866.38,530857.19,981723.57
351370,202206,422,205,217,248465.32,263004.20,511469.52
351380,202206,8797,3775,5022,4577781.04,6090316.71,10668097.75
351385,202206,26,15,11,18180.00,13332.00,31512.00
351390,202206,278,202,76,244825.36,92112.00,336937.36
351400,202206,60,40,20,48480.00,24240.00,72720.00
351410,202206,464,279,185,338151.78,224220.20,562371.98
351420,202206,69,49,20,59388.00,24240.00,83628.00
351430,202206,70,37,33,44844.00,39996.00,84840.00
351440,202206,781,509,272,616923.22,329666.54,946589.76
351450,202206,273,127,146,153925.65,176954.57,330880.22
351460,202206,133,56,77,67872.94,93324.00,161196.94
351470,202206,141,73,68,88476.73,82416.72,170893.45
351480,202206,477,281,196,341787.13,237552.99,579340.12
351490,202206,294,110,184,133320.00,223008.55,356328.55
351492,202206,25,16,9,19392.00,10908.00,30300.00
351495,202206,24,17,7,20604.00,8484.00,29088.00
351500,202206,3467,1381,2086,1676205.22,2530664.87,4206870.09
351510,202206,2101,758,1343,919913.14,1627724.62,2547637.76
351512,202206,13,9,4,10908.00,4848.00,15756.00
351515,202206,201,116,85,140593.14,103020.00,243613.14
351518,202206,694,409,285,495715.32,345428.20,841143.52
351519,202206,84,47,37,56964.00,44844.00,101808.00
351520,202206,162,97,65,117566.41,78801.93,196368.34
351530,202206,23,12,11,14544.20,13332.00,27876.20
351535,202206,136,78,58,95752.04,70296.20,166048.24
351540,202206,470,310,160,376936.22,193921.60,570857.82
351550,202206,1514,882,632,1070216.42,765987.82,1836204.24
351560,202206,75,44,31,53328.02,37572.00,90900.02
351565,202206,12,6,6,7272.32,7272.00,14544.32
351570,202206,2791,1268,1523,1536836.08,1847094.49,3383930.57
351580,202206,36,33,3,39996.00,3636.00,43632.00
351590,202206,69,44,25,53330.32,30300.00,83630.32
351600,202206,180,128,52,155139.70,63024.00,218163.70
351610,202206,53,24,29,29088.00,35148.00,64236.00
351620,202206,5864,3138,2726,3804509.20,3306349.45,7110858.65
351630,202206,3243,1519,1724,1841043.43,2090712.61,3931756.04
351640,202206,2368,1004,1364,1218074.24,1653175.64,2871249.88
351650,202206,30,24,6,30300.00,7272.00,37572.00
351660,202206,139,87,52,105444.00,63024.00,168468.00
351670,202206,749,436,313,528439.59,379360.58,907800.17
351680,202206,80,60,20,72720.00,24240.00,96960.00
351685,202206,10,7,3,8484.00,3636.00,12120.00
351690,202206,300,196,104,237554.40,126048.00,363602.40
351700,202206,187,124,63,150550.08,76356.10,226906.18
351710,202206,66,42,24,50904.00,29088.00,79992.00
351720,202206,129,71,58,86052.86,70296.00,156348.86
351730,202206,110,73,37,88476.20,44844.00,133320.20
351740,202206,775,482,293,584194.84,356331.73,940526.57
351750,202206,369,145,224,175740.24,272700.20,448440.44
351760,202206,715,549,166,665393.69,201192.62,866586.31
351770,202206,299,241,58,292096.79,70296.56,362393.35
351780,202206,152,91,61,110292.75,75144.00,185436.75
351790,202206,265,137,128,166045.33,155137.03,321182.36
351800,202206,45,28,17,33937.18,20604.00,54541.18
351810,202206,125,81,44,98172.50,53328.30,151500.80
351820,202206,758,540,218,654494.23,265430.77,919925.00
351830,202206,636,199,437,241188.30,529644.84,770833.14
351840,202206,2200,990,1210,1199904.00,1466525.49,2666429.49
351850,202206,246,171,75,207252.89,90900.00,298152.89
351860,202206,603,396,207,479963.70,250884.25,730847.95
351870,202206,5751,2573,3178,3123350.82,3852989.31,6976340.13
351880,202206,21425,8167,13258,9900924.83,16080876.71,25981801.54
351885,202206,91,48,43,58177.60,52116.93,110294.53
351890,202206,69,48,21,58176.20,25452.00,83628.20
351900,202206,236,129,107,156349.45,129684.00,286033.45
351905,202206,94,44,50,53328.20,60600.00,113928.20
351907,202206,3652,1459,2193,1769544.20,2657930.83,4427475.03
351910,202206,160,69,91,83628.10,111504.10,195132.20
351920,202206,109,58,51,70296.00,61812.00,132108.00
351925,202206,89,53,36,64236.85,43632.00,107868.85
351930,202206,436,274,162,332093.23,196347.47,528440.70
351940,202206,241,101,140,122412.51,169680.00,292092.51
351950,202206,143,75,68,90900.00,82417.46,173317.46
351960,202206,948,449,499,544196.56,604794.95,1148991.51
351970,202206,2118,1009,1109,1222913.12,1344115.39,2567028.51
351980,202206,157,69,88,83630.08,106656.68,190286.76
351990,202206,251,157,94,190286.13,113928.77,304214.90
352000,202206,320,202,118,244828.03,144228.00,389056.03
352010,202206,433,279,154,339448.77,186653.06,526101.83
352020,202206,197,71,126,86052.00,152712.00,238764.00
352030,202206,1172,547,625,662971.87,757503.68,1420475.55
352040,202206,645,248,397,300579.52,481165.22,781744.74
352042,202206,321,78,243,96960.21,294518.56,391478.77
352044,202206,366,209,157,253311.80,191498.52,444810.32
352050,202206,3253,1180,2073,1431382.47,2513694.54,3945077.01
352060,202206,96,58,38,70296.00,46056.39,116352.39
352070,202206,95,65,30,78783.47,36360.00,115143.47
352080,202206,68,44,24,53328.48,29088.00,82416.48
352090,202206,171,111,60,134532.70,72720.00,207252.70
352100,202206,302,145,157,175740.64,191496.60,367237.24
352110,202206,111,33,78,39996.51,95748.00,135744.51
352115,202206,62,22,40,26664.00,48480.20,75144.20
352120,202206,67,46,21,55752.00,25452.00,81204.00
352130,202206,216,161,55,195135.96,66660.10,261796.06
352140,202206,178,82,96,99385.62,116352.00,215737.62
352150,202206,127,65,62,78780.70,75146.18,153926.88
352160,202206,140,89,51,107868.20,61812.04,169680.24
352170,202206,404,274,130,332089.34,157560.08,489649.42
352180,202206,680,413,267,501774.83,323607.34,825382.17
352190,202206,245,101,144,122413.21,174528.84,296942.05
352200,202206,29,11,18,13332.00,21816.10,35148.10
352210,202206,4429,1763,2666,2136799.08,3232418.18,5369217.26
352215,202206,72,40,32,48480.00,38784.00,87264.00
352220,202206,6235,2289,3946,2775511.03,4784998.12,7560509.15
352230,202206,3525,2226,1299,2699188.66,1576820.07,4276008.73
352240,202206,2696,1507,1189,1827715.43,1443495.66,3271211.09
352250,202206,3364,1482,1882,1797416.90,2282203.55,4079620.45
352260,202206,1008,532,476,644792.08,576916.73,1221708.81
352265,202206,63,35,28,42420.93,35148.00,77568.93
352270,202206,382,207,175,250887.00,212103.39,462990.39
352280,202206,502,300,202,363603.32,244824.00,608427.32
352290,202206,166,95,71,115140.96,86052.77,201193.73
352300,202206,100,63,37,76358.06,44844.00,121202.06
352310,202206,7048,2996,4052,3639688.30,4914668.08,8554356.38
352320,202206,1148,598,550,724780.72,667814.78,1392595.50
352330,202206,537,279,258,338150.60,312696.09,650846.69
352340,202206,1356,606,750,736905.09,910217.38,1647122.47
352350,202206,365,200,165,242401.03,199981.90,442382.93
352360,202206,217,96,121,116352.10,146652.92,263005.02
352370,202206,121,72,49,87264.10,59388.20,146652.30
352380,202206,112,79,33,95751.60,39996.73,135748.33
352390,202206,2607,1116,1491,1355028.70,1807099.91,3162128.61
352400,202206,535,231,304,279972.67,369660.00,649632.67
352410,202206,932,612,320,744181.81,389065.59,1133247.40
352420,202206,87,66,21,79992.10,25452.00,105444.10
352430,202206,1775,774,1001,938102.32,1213223.52,2151325.84
352440,202206,3425,1570,1855,1905288.05,2249479.73,4154767.78
352450,202206,202,156,46,190284.60,55752.32,246036.92
352460,202206,635,314,321,380570.66,390265.08,770835.74
352470,202206,648,237,411,288459.24,498133.39,786592.63
352480,202206,1582,868,714,1052025.18,865373.09,1917398.27
352490,202206,52,20,32,24240.00,39996.10,64236.10
352500,202206,1295,513,782,622973.81,948998.67,1571972.48
352510,202206,717,372,345,450869.88,418141.20,869011.08
352520,202206,852,367,485,444807.12,589040.79,1033847.91
352530,202206,1860,940,920,1139302.17,1117472.95,2256775.12
352540,202206,66,43,23,52116.60,27876.00,79992.60
352550,202206,215,121,94,146652.85,115140.00,261792.85
352560,202206,49,38,11,46057.03,13332.00,59389.03
352570,202206,741,349,392,424210.18,475111.39,899321.57
352580,202206,56,43,13,52117.16,16968.00,69085.16
352585,202206,24,6,18,7272.14,21816.00,29088.14
352590,202206,4391,2120,2271,2574326.18,2756103.45,5330429.63
352600,202206,361,251,110,304217.01,134534.77,438751.78
352610,202206,921,410,511,496923.29,621759.49,1118682.78
352620,202206,1106,411,695,500560.13,843554.26,1344114.39
352630,202206,192,72,120,87265.34,145440.00,232705.34
352640,202206,503,317,186,385419.87,225433.34,610853.21
352650,202206,82,63,19,76356.30,23028.00,99384.30
352660,202206,64,36,28,43632.00,33936.00,77568.00
352670,202206,1724,895,829,1085973.07,1007174.03,2093147.10
352680,202206,955,571,384,692062.96,465416.31,1157479.27
352690,202206,4640,2003,2637,2430094.96,3199690.85,5629785.81
352700,202206,84,48,36,59388.95,43632.00,103020.95
352710,202206,1509,767,742,929616.33,899305.28,1828921.61
352720,202206,1545,641,904,779327.05,1095657.70,1874984.75
352725,202206,26,20,6,24240.00,7272.00,31512.00
352730,202206,391,192,199,232705.42,242401.83,475107.25
352740,202206,401,256,145,310280.26,175740.72,486020.98
352750,202206,24,16,8,19392.00,9696.14,29088.14
352760,202206,212,134,78,162409.71,94536.10,256945.81
352770,202206,76,57,19,69084.62,23028.18,92112.80
352780,202206,75,39,36,47268.00,43632.00,90900.00
352790,202206,24,17,7,20605.45,8484.18,29089.63
352800,202206,240,182,58,220587.34,70296.00,290883.34
352810,202206,160,100,60,121200.30,72720.00,193920.30
352820,202206,46,34,12,41208.70,14544.00,55752.70
352830,202206,75,49,26,59388.58,31512.71,90901.29
352840,202206,693,301,392,364815.69,475106.19,839921.88
352850,202206,1776,527,1249,641150.31,1513789.41,2154939.72
352860,202206,117,72,45,87264.00,54540.14,141804.14
352870,202206,52,31,21,37572.10,25452.50,63024.60
352880,202206,174,100,74,121201.52,89688.40,210889.92
352885,202206,34,22,12,26664.00,14544.00,41208.00
352890,202206,53,33,20,39996.10,24240.60,64236.70
352900,202206,4655,2171,2484,2632509.48,3015462.71,5647972.19
352910,202206,36,29,7,35148.00,8484.00,43632.00
352920,202206,644,369,275,447239.09,333302.73,780541.82
352930,202206,1181,549,632,665397.23,767196.91,1432594.14
352940,202206,6190,2337,3853,2833686.59,4679560.33,7513246.92
352950,202206,120,47,73,56964.50,88477.31,145441.81
352960,202206,66,40,26,48480.00,31512.00,79992.00
352965,202206,15,9,6,10908.00,7272.00,18180.00
352970,202206,518,377,141,456930.46,170893.94,627824.40
352980,202206,158,91,67,110294.45,81204.45,191498.90
352990,202206,976,455,521,551468.56,631454.88,1182923.44
353000,202206,56,24,32,29088.00,38784.00,67872.00
353010,202206,518,310,208,375725.76,252096.60,627822.36
353020,202206,322,218,104,266644.19,126048.80,392692.99
353030,202206,1411,620,791,751453.55,958699.21,1710152.76
353040,202206,88,49,39,59389.63,47268.80,106658.43
353050,202206,1324,860,464,1043556.27,564792.67,1608348.94
353060,202206,8946,3800,5146,4605662.91,6247881.32,10853544.23
353070,202206,1953,1138,815,1379288.09,987568.13,2366856.22
353080,202206,1306,700,606,848414.66,735687.55,1584102.21
353090,202206,65,36,29,43632.80,35148.00,78780.80
353100,202206,41,32,9,38784.40,10908.00,49692.40
353110,202206,2227,711,1516,861741.36,1839836.44,2701577.80
353120,202206,135,69,66,83628.20,79992.00,163620.20
353130,202206,841,396,445,479961.97,539344.23,1019306.20
353140,202206,577,256,321,310277.90,389056.43,699334.33
353150,202206,319,166,153,201194.13,185437.35,386631.48
353160,202206,110,82,28,99385.20,33936.00,133321.20
353170,202206,202,64,138,77568.00,167257.63,244825.63
353180,202206,1194,540,654,654485.61,792650.82,1447136.43
353190,202206,489,347,142,420569.02,172104.40,592673.42
353200,202206,258,124,134,150288.27,162408.00,312696.27
353205,202206,19,12,7,14544.00,8484.00,23028.00
353210,202206,68,40,28,48480.20,33936.36,82416.56
353215,202206,41,23,18,27876.20,21816.00,49692.20
353220,202206,85,45,40,54540.00,48480.60,103020.60
353230,202206,154,65,89,78780.54,107868.00,186648.54
353240,202206,372,167,205,203617.50,248460.00,452077.50
353250,202206,190,95,95,115140.08,115140.30,230280.38
353260,202206,457,300,157,363605.69,190285.25,553890.94
353270,202206,72,53,19,64236.20,23028.00,87264.20
353280,202206,110,47,63,56965.18,76356.36,133321.54
353282,202206,123,83,40,100596.10,48480.00,149076.10
353284,202206,28,19,9,23028.71,10908.00,33936.71
353286,202206,9,4,5,4848.00,6060.00,10908.00
353290,202206,84,44,40,54540.00,48480.00,103020.00
353300,202206,442,223,219,270282.67,265430.28,535712.95
353310,202206,39,32,7,38784.20,8484.15,47268.35
353320,202206,41,26,15,31512.82,18180.60,49693.42
353325,202206,40,24,16,29088.00,19392.00,48480.00
353330,202206,63,43,20,52116.80,24240.00,76356.80
353340,202206,679,235,444,284821.68,538132.44,822954.12
353350,202206,917,441,476,534495.95,578130.29,1112626.24
353360,202206,103,80,23,96961.61,27876.38,124837.99
353370,202206,105,63,42,76356.20,50904.00,127260.20
353380,202206,27,13,14,15756.00,16968.00,32724.00
353390,202206,1135,523,612,635098.65,741750.76,1376849.41
353400,202206,47,27,20,32724.00,24241.14,56965.14
353410,202206,115,66,49,79992.00,59389.00,139381.00
353420,202206,51,23,28,27876.00,33936.00,61812.00
353430,202206,582,378,204,458143.23,247251.39,705394.62
353440,202206,12427,5274,7153,6394554.34,8679156.06,15073710.40
353450,202206,55,29,26,35148.00,31512.20,66660.20
353460,202206,640,320,320,387850.05,387843.32,775693.37
353470,202206,2289,1095,1194,1328388.49,1449559.36,2777947.85
353475,202206,280,178,102,215738.11,123624.35,339362.46
353480,202206,179,143,36,173317.37,43632.00,216949.37
353490,202206,222,128,94,156349.97,113928.70,270278.67
353500,202206,210,118,92,143017.92,112716.42,255734.34
353510,202206,82,54,28,65448.79,33936.10,99384.89
353520,202206,232,169,63,204829.85,76356.60,281186.45
353530,202206,476,241,235,292094.53,284821.56,576916.09
353540,202206,403,250,153,303003.97,185438.77,488442.74
353550,202206,753,473,280,573285.23,340579.30,913864.53
353560,202206,553,221,332,267852.92,402385.53,670238.45
353570,202206,63,41,22,49692.64,26664.00,76356.64
353580,202206,346,222,124,269065.70,150288.10,419353.80
353590,202206,87,62,25,75144.20,30300.00,105444.20
353600,202206,279,160,119,193922.92,144228.10,338151.02
353610,202206,136,72,64,87264.63,77568.00,164832.63
353620,202206,687,344,343,416931.94,415720.35,832652.29
353625,202206,54,29,25,35149.01,30300.00,65449.01
353630,202206,215,153,62,185438.26,76356.20,261794.46
353640,202206,122,79,43,95748.16,52117.15,147865.31
353650,202206,1020,391,629,473894.58,762351.11,1236245.69
353657,202206,22,17,5,20604.00,6060.00,26664.00
353660,202206,286,148,138,179377.25,167256.37,346633.62
353670,202206,715,407,308,493291.27,374510.92,867802.19
353680,202206,132,87,45,105444.33,55752.00,161196.33
353690,202206,43,28,15,33936.00,18180.19,52116.19
353700,202206,287,199,88,241190.58,106656.46,347847.04
353710,202206,502,238,264,288459.60,321183.12,609642.72
353715,202206,43,26,17,31512.42,20604.00,52116.42
353720,202206,329,148,181,179377.94,220586.48,399964.42
353730,202206,1157,686,471,832656.91,572064.10,1404721.01
353740,202206,594,327,267,397542.05,323606.21,721148.26
353750,202206,73,41,32,49692.03,38784.00,88476.03
353760,202206,3251,1218,2033,1477449.23,2466437.10,3943886.33
353770,202206,78,63,15,76356.00,18180.20,94536.20
353780,202206,1371,619,752,750233.31,915063.33,1665296.64
353790,202206,492,291,201,352694.79,243614.91,596309.70
353800,202206,3637,1694,1943,2054403.77,2356133.76,4410537.53
353810,202206,231,113,118,138170.46,143016.73,281187.19
353820,202206,252,102,150,123624.85,181800.60,305425.45
353830,202206,61,49,12,59389.03,14544.00,73933.03
353850,202206,195,86,109,104232.53,132108.55,236341.08
353860,202206,539,231,308,279972.88,374510.20,654483.08
353870,202206,5751,2905,2846,3525770.07,3455424.73,6981194.80
353880,202206,718,462,256,561165.71,310273.96,871439.67
353890,202206,556,319,237,386633.89,289672.83,676306.72
353900,202206,133,69,64,83628.00,77569.63,161197.63
353910,202206,195,75,120,90900.00,145440.15,236340.15
353920,202206,449,237,212,287244.87,256948.01,544192.88
353930,202206,1050,614,436,744175.40,530857.99,1275033.39
353940,202206,201,98,103,118776.30,124836.95,243613.25
353950,202206,493,306,187,370875.01,227858.58,598733.59
353960,202206,73,59,14,71508.00,16968.00,88476.00
353970,202206,42,28,14,33936.80,16969.10,50905.90
353980,202206,1899,837,1062,1014454.44,1287151.26,2301605.70
353990,202206,80,48,32,58176.40,38784.00,96960.40
354000,202206,386,175,211,212103.00,255733.80,467836.80
354010,202206,91,51,40,61812.00,48480.00,110292.00
354020,202206,508,312,196,378151.08,237553.53,615704.61
354025,202206,35,29,6,35148.68,7272.00,42420.68
354030,202206,47,23,24,27876.20,29088.15,56964.35
354040,202206,100,75,25,90901.05,30300.00,121201.05
354050,202206,166,88,78,106656.72,94537.05,201193.77
354060,202206,771,348,423,421778.05,512677.36,934455.41
354070,202206,934,532,402,644792.07,487226.31,1132018.38
354075,202206,182,83,99,100596.80,119988.95,220585.75
354080,202206,315,137,178,166046.96,215736.98,381783.94
354085,202206,21,13,8,15756.60,9696.00,25452.60
354090,202206,272,162,110,196243.67,133320.60,329564.27
354100,202206,5952,2391,3561,2900349.57,4317177.72,7217527.29
354105,202206,102,51,51,61813.00,61812.00,123625.00
354110,202206,39,19,20,23028.00,24240.20,47268.20
354120,202206,149,95,54,115140.00,65448.30,180588.30
354130,202206,739,440,299,533290.16,362390.93,895681.09
354140,202206,3302,1459,1843,1768342.61,2238577.00,4006919.61
354150,202206,622,348,274,421779.10,332089.28,753868.38
354160,202206,655,420,235,509054.87,284824.46,793879.33
354165,202206,13,10,3,12120.49,3636.00,15756.49
354170,202206,177,117,60,141805.04,72720.00,214525.04
354180,202206,54,31,23,37572.00,27876.85,65448.85
354190,202206,201,78,123,94537.09,149076.95,243614.04
354200,202206,113,55,58,66660.00,70297.88,136957.88
354210,202206,73,31,42,37572.00,50904.00,88476.00
354220,202206,615,385,230,469053.43,279977.10,749030.53
354230,202206,167,71,96,86052.50,116353.56,202406.06
354240,202206,323,199,124,241190.65,150288.00,391478.65
354250,202206,80,48,32,58176.00,38784.00,96960.00
354260,202206,2175,1006,1169,1219283.66,1418048.74,2637332.40
354270,202206,87,60,27,72720.00,32724.00,105444.00
354280,202206,55,29,26,35148.00,31512.00,66660.00
354290,202206,140,95,45,115140.17,54540.10,169680.27
354300,202206,341,237,104,287246.75,126048.00,413294.75
354310,202206,90,64,26,77570.15,31512.00,109082.15
354320,202206,217,106,111,128472.20,134532.23,263004.43
354323,202206,7,7,0,8484.00,,8484.00
354325,202206,127,66,61,79992.63,73932.00,153924.63
354330,202206,2468,818,1650,991253.80,2002231.77,2993485.57
354340,202206,10568,4789,5779,5808967.94,7007823.32,12816791.26
354350,202206,142,94,48,113928.30,58176.00,172104.30
354360,202206,73,42,31,50905.22,37572.00,88477.22
354370,202206,230,115,115,139381.20,139380.08,278761.28
354380,202206,174,101,73,122412.40,88476.00,210888.40
354390,202206,2777,985,1792,1193829.46,2173125.32,3366954.78
354400,202206,323,175,148,212100.55,179376.50,391477.05
354410,202206,676,299,377,362394.20,456926.67,819320.87
354420,202206,279,185,94,224224.66,113929.08,338153.74
354425,202206,322,174,148,210945.70,180588.69,391534.39
354430,202206,174,93,81,112716.20,98172.00,210888.20
354440,202206,29,23,6,27876.20,7272.00,35148.20
354450,202206,54,35,19,42420.00,23028.00,65448.00
354460,202206,95,53,42,64236.16,50904.86,115141.02
354470,202206,28,14,14,16968.61,16968.35,33936.96
354480,202206,110,59,51,71508.80,61812.40,133321.20
354490,202206,130,74,56,89690.29,67872.30,157562.59
354500,202206,408,182,226,220584.81,273913.27,494498.08
354510,202206,88,60,28,72720.40,33936.20,106656.60
354515,202206,48,16,32,19392.35,38784.10,58176.45
354520,202206,1615,677,938,820361.16,1139281.43,1959642.59
354530,202206,871,423,448,512682.74,542977.08,1055659.82
354540,202206,259,129,130,156349.22,157560.46,313909.68
354550,202206,41,22,19,26665.02,23028.00,49693.02
354560,202206,156,84,72,101808.10,87264.00,189072.10
354570,202206,138,92,46,111504.85,55752.00,167256.85
354580,202206,1869,871,998,1055661.09,1212004.03,2267665.12
354600,202206,281,134,147,162408.20,178164.00,340572.20
354610,202206,63,52,11,63025.95,13332.00,76357.95
354620,202206,71,20,51,24240.00,61812.00,86052.00
354625,202206,12,8,4,9696.74,4848.00,14544.74
354630,202206,337,221,116,267855.18,140592.74,408447.92
354640,202206,843,502,341,608427.06,414506.52,1022933.58
354650,202206,65,38,27,46056.74,32724.00,78780.74
354660,202206,817,591,226,716302.55,273914.01,990216.56
354670,202206,223,85,138,103021.37,167256.20,270277.57
354680,202206,1345,468,877,567222.53,1064141.57,1631364.10
354690,202206,78,48,30,58176.84,36360.70,94537.54
354700,202206,77,54,23,65448.00,27876.00,93324.00
354710,202206,50,36,14,43632.00,16968.00,60600.00
354720,202206,20,18,2,21816.20,2424.00,24240.20
354730,202206,1812,723,1089,877492.41,1319874.97,2197367.38
354740,202206,72,49,23,59388.00,27876.00,87264.00
354750,202206,418,233,185,282396.56,224221.07,506617.63
354760,202206,511,313,198,380580.16,239979.45,620559.61
354765,202206,6,2,4,2424.00,4848.00,7272.00
354770,202206,346,222,124,269067.95,151502.01,420569.96
354780,202206,8430,3087,5343,3743904.06,6484218.19,10228122.25
354790,202206,85,50,35,60600.00,42420.74,103020.74
354800,202206,437,233,204,282348.76,247249.17,529597.93
354805,202206,74,34,40,41208.69,48480.70,89689.39
354810,202206,99,55,44,66660.00,53328.00,119988.00
354820,202206,214,83,131,100597.32,158772.84,259370.16
354830,202206,39,20,19,24240.00,23028.00,47268.00
354840,202206,57,40,17,48480.00,20604.00,69084.00
354850,202206,4606,1993,2613,2415550.69,3168185.52,5583736.21
354860,202206,336,155,181,187860.00,220584.30,408444.30
354870,202206,12084,5173,6911,6278235.77,8385856.12,14664091.89
354880,202206,2665,964,1701,1168375.34,2065315.79,3233691.13
354890,202206,2975,1548,1427,1879842.44,1729532.21,3609374.65
354900,202206,63,44,19,53328.19,23028.00,76356.19
354910,202206,1294,652,642,790241.57,780529.60,1570771.17
354920,202206,39,32,7,38784.00,8484.00,47268.00
354925,202206,23,12,11,14544.20,13332.00,27876.20
354930,202206,32,28,4,33937.10,4848.00,38785.10
354940,202206,767,536,231,650853.85,279976.44,930830.29
354950,202206,206,125,81,151501.94,98173.45,249675.39
354960,202206,129,49,80,59388.20,96960.00,156348.20
354970,202206,1113,755,358,915084.34,433897.62,1348981.96
354980,202206,9478,3371,6107,4085712.75,7416258.91,11501971.66
354990,202206,10303,4480,5823,5433508.28,7065984.66,12499492.94
354995,202206,587,190,397,230282.27,481166.21,711448.48
355000,202206,449,156,293,189073.09,356328.30,545401.39
355010,202206,629,385,244,467841.08,295734.54,763575.62
355020,202206,796,494,302,599946.79,366026.18,965972.97
355030,202206,211946,77993,133953,94576770.28,162481530.51,257058300.79
355040,202206,960,460,500,559953.58,607214.93,1167168.51
355050,202206,173,93,80,112716.58,96960.00,209676.58
355060,202206,1796,840,956,1018095.44,1159889.17,2177984.61
355070,202206,1598,700,898,848408.04,1088383.15,1936791.19
355080,202206,200,118,82,144228.08,99384.00,243612.08
355090,202206,299,173,126,209680.42,152714.52,362394.94
355100,202206,5394,2489,2905,3017796.93,3520875.14,6538672.07
355110,202206,225,147,78,178164.10,94536.53,272700.63
355120,202206,56,34,22,41208.36,26664.00,67872.36
355130,202206,54,30,24,36360.42,29088.00,65448.42
355140,202206,198,116,82,140593.80,99384.68,239978.48
355150,202206,693,403,290,490865.08,351482.03,842347.11
355160,202206,487,228,259,276339.35,313910.60,590249.95
355170,202206,2084,1067,1017,1293231.39,1232611.03,2525842.42
355180,202206,699,271,428,328454.42,518737.20,847191.62
355190,202206,224,151,73,183016.93,88476.49,271493.42
355200,202206,109,55,54,66661.51,65448.60,132110.11
355210,202206,686,367,319,447230.62,387841.84,835072.46
355220,202206,7741,3666,4075,4449313.33,4941353.19,9390666.52
355230,202206,93,52,41,63024.59,49692.52,112717.11
355240,202206,4650,1841,2809,2233738.64,3406945.65,5640684.29
355250,202206,6829,2957,3872,3590031.42,4698935.07,8288966.49
355255,202206,47,29,18,35148.00,21816.00,56964.00
355260,202206,186,106,80,128474.27,96960.20,225434.47
355270,202206,157,97,60,117565.09,72720.00,190285.09
355280,202206,7039,2588,4451,3136681.81,5394639.32,8531321.13
355290,202206,71,55,16,66660.20,19392.45,86052.65
355300,202206,231,130,101,157560.76,122412.61,279973.37
355310,202206,113,60,53,72720.00,64236.00,136956.00
355320,202206,90,44,46,53328.80,55752.00,109080.80
355330,202206,315,182,133,220586.68,162409.40,382996.08
355340,202206,1394,494,900,598744.26,1090816.95,1689561.21
355350,202206,167,78,89,94536.25,107868.00,202404.25
355360,202206,168,111,57,134533.55,69084.00,203617.55
355365,202206,18,13,5,15756.00,6060.00,21816.00
355370,202206,1025,607,418,736916.97,509042.90,1245959.87
355380,202206,839,509,330,616917.89,401177.39,1018095.28
355385,202206,91,60,31,72720.15,37572.20,110292.35
355390,202206,109,57,52,69084.20,63024.62,132108.82
355395,202206,194,102,92,123627.31,111505.11,235132.42
355400,202206,1770,1005,765,1217974.09,928393.34,2146367.43
355410,202206,5093,2277,2816,2762189.33,3416637.20,6178826.53
355420,202206,44,31,13,37572.00,15756.00,53328.00
355430,202206,410,243,167,295736.36,202407.67,498144.03
355440,202206,87,50,37,60600.20,44844.62,105444.82
355450,202206,450,220,230,266641.18,278761.28,545402.46
355460,202206,57,43,14,52116.10,16968.00,69084.10
355465,202206,51,29,22,35148.00,26664.00,61812.00
355470,202206,195,75,120,90901.31,145441.03,236342.34
355475,202206,7,5,2,6060.21,2424.00,8484.21
355480,202206,617,242,375,293311.04,454502.38,747813.42
355490,202206,109,76,33,92113.23,39996.79,132110.02
355495,202206,88,30,58,36360.00,70297.20,106657.20
355500,202206,1585,836,749,1014459.55,909004.34,1923463.89
355510,202206,272,189,83,229074.20,100597.00,329671.20
355520,202206,27,20,7,24240.00,8484.00,32724.00
355530,202206,23,12,11,14544.00,14544.00,29088.00
355535,202206,77,33,44,39996.00,53328.00,93324.00
355540,202206,2751,1069,1682,1298238.13,2038599.47,3336837.60
355550,202206,63,36,27,43632.00,32724.00,76356.00
355560,202206,248,112,136,135745.98,164832.95,300578.93
355570,202206,13,9,4,10908.00,4848.00,15756.00
355580,202206,241,160,81,193921.84,98172.70,292094.54
355590,202206,18,11,7,13332.00,8484.00,21816.00
355600,202206,274,133,141,161196.30,172104.62,333300.92
355610,202206,241,148,93,179380.78,112717.99,292098.77
355620,202206,1282,553,729,671460.89,883548.80,1555009.69
355630,202206,416,296,120,359967.41,145440.70,505408.11
355635,202206,122,50,72,60600.00,87264.16,147864.16
355640,202206,567,298,269,362390.05,326029.74,688419.79
355645,202206,895,315,580,381783.46,702964.83,1084748.29
355650,202206,1885,804,1081,974459.68,1312597.02,2287056.70
355660,202206,230,121,109,146653.49,132109.38,278762.87
355670,202206,648,270,378,327241.26,458136.85,785378.11
355680,202206,198,111,87,134532.72,105445.56,239978.28
355690,202206,93,47,46,56964.10,56964.00,113928.10
355695,202206,28,18,10,21816.00,12120.00,33936.00
355700,202206,1220,609,611,738114.57,740535.89,1478650.46
355710,202206,2290,1233,1057,1494434.32,1285936.27,2780370.59
355715,202206,18,15,3,18180.00,3636.00,21816.00
355720,202206,257,160,97,195132.84,117564.89,312697.73
355730,202206,106,64,42,77568.20,50904.15,128472.35
410010,202206,110,85,25,103021.40,30300.00,133321.40
410020,202206,120,85,35,103020.00,42420.00,145440.00
410030,202206,159,87,72,105444.76,87265.12,192709.88
410040,202206,1354,644,710,782953.93,860525.10,1643479.03
410045,202206,46,33,13,39996.00,15756.00,55752.00
410050,202206,515,296,219,358753.53,265428.64,624182.17
410060,202206,285,204,81,247251.04,98172.00,345423.04
410070,202206,286,240,46,290882.76,55752.44,346635.20
410080,202206,177,109,68,132108.20,82416.00,214524.20
410090,202206,59,48,11,58177.20,13332.00,71509.20
410100,202206,256,163,93,197556.20,112716.00,310272.20
410105,202206,49,29,20,35148.00,24240.00,59388.00
410110,202206,345,210,135,254522.40,163622.76,418145.16
410115,202206,47,29,18,35148.57,21816.00,56964.57
410120,202206,454,208,246,252098.39,298154.33,550252.72
410130,202206,63,33,30,39996.00,36360.00,76356.00
410140,202206,3189,1428,1761,1730745.51,2137980.11,3868725.62
410150,202206,2689,1059,1630,1283522.59,1979205.55,3262728.14
410160,202206,488,278,210,338149.08,254521.20,592670.28
410165,202206,49,28,21,33936.00,25452.00,59388.00
410170,202206,209,122,87,147864.20,105444.00,253308.20
410180,202206,2334,1234,1100,1496834.44,1335633.23,2832467.67
410185,202206,35,29,6,35148.00,7272.00,42420.00
410190,202206,479,301,178,364813.92,215736.00,580549.92
410200,202206,1015,715,300,867800.68,363600.10,1231400.78
410210,202206,630,323,307,391479.23,372085.21,763564.44
410220,202206,47,20,27,24240.00,32724.00,56964.00
410230,202206,181,80,101,96960.37,122412.40,219372.77
410240,202206,720,457,263,553892.00,318757.29,872649.29
410250,202206,375,262,113,317545.04,138168.78,455713.82
410260,202206,300,166,134,201193.49,162408.98,363602.47
410270,202206,28,20,8,25452.00,9696.00,35148.00
410275,202206,62,45,17,54540.00,20604.00,75144.00
410280,202206,324,188,136,227859.28,164832.20,392691.48
410290,202206,278,156,122,189073.06,147865.00,336938.06
410300,202206,87,53,34,64236.00,41208.00,105444.00
410302,202206,25,13,12,15756.00,14544.00,30300.00
410304,202206,38,26,12,31512.00,14544.00,46056.00
410305,202206,224,129,95,156348.10,115140.20,271488.30
410310,202206,184,106,78,128472.00,94536.00,223008.00
410315,202206,41,31,10,37572.20,12120.40,49692.60
410320,202206,138,92,46,111504.00,55752.00,167256.00
410322,202206,35,22,13,26664.00,15756.00,42420.00
410330,202206,173,113,60,136956.74,72720.00,209676.74
410335,202206,99,53,46,64236.00,55752.00,119988.00
410337,202206,41,32,9,38784.00,10908.00,49692.00
410340,202206,39,32,7,38784.80,8484.00,47268.80
410345,202206,193,112,81,135744.98,98172.20,233917.18
410347,202206,43,31,12,37572.14,14544.00,52116.14
410350,202206,247,144,103,174530.05,124836.82,299366.87
410360,202206,445,272,173,329667.66,209676.93,539344.59
410370,202206,2359,989,1370,1198678.65,1660449.52,2859128.17
410380,202206,193,111,82,134532.00,99384.20,233916.20
410390,202206,403,260,143,315121.81,174528.00,489649.81
410395,202206,33,21,12,25452.10,14544.20,39996.30
410400,202206,872,364,508,443594.86,616912.69,1060507.55
410405,202206,78,60,18,72720.50,21816.74,94537.24
410410,202206,22,14,8,16969.81,9696.00,26665.81
410420,202206,1762,788,974,954951.46,1181707.78,2136659.24
410425,202206,193,76,117,92112.10,141804.20,233916.30
410430,202206,2432,1260,1172,1527127.61,1420469.81,2947597.42
410440,202206,355,248,107,300576.20,129684.25,430260.45
410442,202206,346,212,134,258158.31,163620.20,421778.51
410445,202206,356,244,112,295728.20,135744.49,431472.69
410450,202206,387,180,207,218160.92,250884.00,469044.92
410460,202206,560,289,271,350269.52,328452.20,678721.72
410465,202206,263,138,125,167256.10,151501.34,318757.44
410470,202206,219,126,93,152712.95,112716.45,265429.40
410480,202206,6678,3179,3499,3852981.69,4243236.64,8096218.33
410490,202206,1428,798,630,968397.84,763567.79,1731965.63
410500,202206,273,156,117,189072.10,141804.50,330876.60
410510,202206,188,139,49,168471.00,59389.40,227860.40
410520,202206,270,186,84,225432.00,101808.00,327240.00
410530,202206,297,90,207,109080.00,252096.00,361176.00
410540,202206,334,243,91,295728.50,110292.00,406020.50
410550,202206,1697,694,1003,841131.28,1216851.55,2057982.83
410560,202206,169,110,59,134532.00,71508.00,206040.00
410570,202206,443,290,153,351481.07,186649.93,538131.00
410580,202206,3723,1531,2192,1856795.01,2657935.17,4514730.18
410590,202206,430,276,154,334493.02,186648.40,521141.42
410600,202206,95,85,10,103020.80,12120.00,115140.80
410610,202206,50,40,10,48480.40,12120.00,60600.40
410620,202206,268,172,96,208465.77,117565.20,326030.97
410630,202206,447,246,201,298154.73,244824.00,542978.73
410640,202206,1154,723,431,877491.84,522373.94,1399865.78
410645,202206,112,83,29,100597.34,37572.00,138169.34
410650,202206,375,227,148,275124.30,179376.00,454500.30
410655,202206,86,62,24,75144.00,29088.08,104232.08
410657,202206,36,13,23,15756.00,27876.00,43632.00
410660,202206,649,429,220,519956.47,266643.19,786599.66
410670,202206,80,64,16,77568.57,19392.00,96960.57
410680,202206,187,152,35,184224.00,42420.00,226644.00
410685,202206,28,18,10,21816.00,12120.00,33936.00
410690,202206,28817,11812,17005,14330779.29,20627147.67,34957926.96
410700,202206,319,231,88,279974.21,106656.00,386630.21
410710,202206,130,105,25,127260.22,30300.20,157560.42
410712,202206,43,29,14,35148.00,16968.00,52116.00
410715,202206,105,73,32,88476.78,38784.00,127260.78
410720,202206,648,364,284,441170.10,345420.20,786590.30
410725,202206,191,133,58,161196.56,70296.00,231492.56
410730,202206,106,47,59,56964.95,71508.00,128472.95
410740,202206,96,68,28,82416.00,33936.00,116352.00
410750,202206,281,187,94,227856.86,113928.00,341784.86
410752,202206,20,13,7,15756.00,8484.00,24240.00
410753,202206,60,23,37,27876.00,44844.12,72720.12
410754,202206,55,28,27,33936.00,32724.00,66660.00
410755,202206,77,42,35,50904.20,42420.00,93324.20
410760,202206,768,410,358,496922.30,433897.34,930819.64
410765,202206,1898,835,1063,1012032.49,1289584.08,2301616.57
410770,202206,119,83,36,100597.31,43632.55,144229.86
410773,202206,66,45,21,54540.72,25452.00,79992.72
410775,202206,176,128,48,155137.54,58176.50,213314.04
410780,202206,82,45,37,54540.00,44844.00,99384.00
410785,202206,53,44,9,53328.00,10908.00,64236.00
410790,202206,87,36,51,43632.80,61812.00,105444.80
410800,202206,286,174,112,210891.14,135745.19,346636.33
410810,202206,30,16,14,19392.16,16969.24,36361.40
410820,202206,151,105,46,127260.98,55752.00,183012.98
410830,202206,9172,3764,5408,4565641.60,6561793.70,11127435.30
410832,202206,116,74,42,89688.24,50904.00,140592.24
410840,202206,1436,764,672,928397.38,814467.50,1742864.88
410845,202206,51,28,23,33936.20,27876.00,61812.20
410850,202206,165,120,45,145442.01,54540.00,199982.01
410855,202206,73,65,8,78780.32,9696.00,88476.32
410860,202206,810,402,408,487227.03,494498.67,981725.70
410865,202206,93,64,29,77569.13,35148.00,112717.13
410870,202206,137,111,26,134532.00,31512.00,166044.00
410880,202206,1179,575,604,696905.19,732050.15,1428955.34
410890,202206,98,62,36,75145.80,43632.00,118777.80
410895,202206,76,56,20,67872.00,24240.00,92112.00
410900,202206,31,22,9,26664.00,10908.00,37572.00
410910,202206,13,8,5,9696.00,6060.00,15756.00
410920,202206,41,26,15,31512.00,18180.00,49692.00
410930,202206,557,333,224,403597.12,271488.35,675085.47
410940,202206,4469,2278,2191,2763396.87,2657938.42,5421335.29
410950,202206,101,77,24,93324.42,29088.89,122413.31
410960,202206,923,351,572,425416.72,694481.66,1119898.38
410965,202206,63,41,22,49692.00,26664.00,76356.00
410970,202206,610,409,201,495713.44,243614.37,739327.81
410975,202206,122,76,46,92112.73,55752.00,147864.73
410980,202206,1625,722,903,876285.52,1095651.50,1971937.02
410990,202206,272,200,72,242400.32,87264.98,329665.30
411000,202206,63,35,28,42420.00,33937.02,76357.02
411005,202206,36,29,7,35148.00,8484.00,43632.00
411007,202206,246,136,110,166044.00,133320.00,299364.00
411010,202206,601,390,211,472683.86,256945.61,729629.47
411020,202206,284,173,111,209678.13,134532.93,344211.06
411030,202206,22,11,11,13332.00,14544.03,27876.03
411040,202206,57,36,21,43632.00,25452.00,69084.00
411050,202206,221,154,67,186648.00,81204.00,267852.00
411060,202206,548,369,179,448443.10,216950.58,665393.68
411065,202206,31,30,1,36360.80,1212.00,37572.80
411070,202206,1289,730,559,884765.82,678723.28,1563489.10
411080,202206,244,171,73,207252.03,88476.00,295728.03
411090,202206,87,64,23,77568.19,27876.00,105444.19
411095,202206,354,115,239,140592.00,289668.20,430260.20
411100,202206,109,84,25,101809.12,30300.00,132109.12
411110,202206,133,78,55,95748.00,66660.00,162408.00
411120,202206,199,129,70,156348.65,84840.00,241188.65
411125,202206,315,151,164,183013.03,198771.52,381784.55
411130,202206,116,97,19,117564.34,23028.00,140592.34
411140,202206,209,144,65,174528.19,78780.00,253308.19
411150,202206,1241,790,451,958696.53,547828.12,1506524.65
411155,202206,121,82,39,99384.46,47268.00,146652.46
411160,202206,34,13,21,15756.00,25452.00,41208.00
411170,202206,52,46,6,55752.00,7272.00,63024.00
411180,202206,1003,647,356,784175.39,431474.92,1215650.31
411190,202206,337,182,155,220584.83,187860.00,408444.83
411200,202206,659,363,296,441170.25,358754.74,799924.99
411210,202206,674,341,333,413292.21,404809.01,818101.22
411220,202206,154,106,48,128474.19,58176.80,186650.99
411230,202206,36,30,6,36360.00,7272.10,43632.10
411240,202206,112,67,45,81204.25,54540.00,135744.25
411250,202206,422,303,119,367236.93,144228.00,511464.93
411260,202206,14,10,4,12120.00,4848.00,16968.00
411270,202206,259,130,129,157562.19,156348.94,313911.13
411275,202206,187,159,28,192708.97,33936.00,226644.97
411280,202206,252,166,86,201193.57,104232.00,305425.57
411290,202206,66,52,14,63024.20,16968.00,79992.20
411295,202206,124,95,29,115140.97,35148.00,150288.97
411300,202206,79,38,41,46056.00,49692.00,95748.00
411310,202206,94,68,26,82416.00,31512.00,113928.00
411320,202206,825,513,312,621761.49,378145.00,999906.49
411325,202206,63,44,19,53328.00,23028.00,76356.00
411330,202206,929,593,336,718728.41,407233.61,1125962.02
411340,202206,35,24,11,29088.00,13332.00,42420.00
411342,202206,59,43,16,52116.00,19392.00,71508.00
411345,202206,101,49,52,59388.10,63024.00,122412.10
411350,202206,503,374,129,454501.52,156349.07,610850.59
411360,202206,63,41,22,49692.20,26665.12,76357.32
411370,202206,13883,5557,8326,6737566.35,10104491.49,16842057.84
411373,202206,176,116,60,140592.00,72720.00,213312.00
411375,202206,78,63,15,76356.10,18180.00,94536.10
411380,202206,76,54,22,65449.40,26664.20,92113.60
411390,202206,144,79,65,95748.00,78780.00,174528.00
411400,202206,349,232,117,281189.01,141804.00,422993.01
411410,202206,501,232,269,281186.44,326029.28,607215.72
411420,202206,979,398,581,482379.18,705385.50,1187764.68
411430,202206,527,281,246,340577.08,298155.98,638733.06
411435,202206,27,17,10,20604.00,12120.00,32724.00
411440,202206,468,367,101,446017.10,122412.00,568429.10
411450,202206,395,327,68,396326.69,82416.09,478742.78
411460,202206,806,300,506,363602.84,614486.64,978089.48
411470,202206,104,72,32,87264.91,38784.00,126048.91
411480,202206,698,355,343,430263.81,415718.50,845982.31
411490,202206,278,168,110,203616.25,133320.68,336936.93
411500,202206,98,79,19,95749.26,23028.00,118777.26
411510,202206,231,179,52,216949.01,63024.00,279973.01
411520,202206,6254,2110,4144,2558544.80,5026179.54,7584724.34
411530,202206,121,78,43,94536.65,52116.00,146652.65
411535,202206,46,13,33,15756.00,41208.00,56964.00
411540,202206,375,249,126,301789.00,152712.20,454501.20
411545,202206,59,43,16,52116.20,19392.00,71508.20
411550,202206,92,69,23,83628.00,27876.00,111504.00
411560,202206,399,161,238,195132.69,288456.00,483588.69
411570,202206,961,318,643,386630.63,779320.68,1165951.31
411573,202206,24,16,8,19392.20,9696.00,29088.20
411575,202206,318,193,125,236340.98,152712.00,389052.98
411580,202206,1266,449,817,544191.01,990205.94,1534396.95
411585,202206,72,36,36,43632.00,43632.00,87264.00
411590,202206,16,10,6,12120.00,7272.00,19392.00
411600,202206,20,8,12,9696.00,14544.70,24240.70
411605,202206,176,68,108,82416.00,130896.00,213312.00
411610,202206,236,146,90,176954.01,109080.20,286034.21
411620,202206,388,181,207,219376.85,252098.31,471475.16
411630,202206,45,31,14,37572.00,16968.55,54540.55
411640,202206,33,23,10,27876.00,12120.00,39996.00
411650,202206,7,4,3,4848.00,3636.00,8484.00
411660,202206,40,30,10,36360.00,12120.00,48480.00
411670,202206,238,164,74,198770.77,89688.00,288458.77
411680,202206,154,123,31,149076.10,37572.00,186648.10
411690,202206,636,333,303,403596.81,367238.52,770835.33
411695,202206,65,46,19,55752.00,23028.00,78780.00
411700,202206,139,112,27,135745.04,32724.00,168469.04
411705,202206,97,63,34,76356.20,41208.30,117564.50
411710,202206,302,201,101,243612.40,122412.20,366024.60
411720,202206,146,94,52,113928.00,63024.00,176952.00
411721,202206,86,69,17,83628.00,20604.00,104232.00
411722,202206,105,49,56,59388.00,67872.00,127260.00
411725,202206,166,120,46,146652.00,55752.00,202404.00
411727,202206,100,79,21,95748.20,25452.20,121200.40
411729,202206,48,35,13,42420.48,15756.00,58176.48
411730,202206,560,355,205,430261.25,249673.48,679934.73
411740,202206,27,16,11,19392.00,13332.12,32724.12
411745,202206,66,50,16,60600.00,19392.00,79992.00
411750,202206,841,344,497,416928.93,602364.55,1019293.48
411760,202206,1235,873,362,1058094.45,439962.53,1498056.98
411770,202206,430,277,153,335725.13,185437.20,521162.33
411780,202206,369,237,132,287244.71,159984.21,447228.92
411790,202206,596,335,261,406021.59,317544.00,723565.59
411800,202206,153,112,41,135744.75,50904.38,186649.13
411810,202206,176,133,43,162408.80,52116.89,214525.69
411820,202206,2465,965,1500,1170811.34,1819230.42,2990041.76
411830,202206,16,13,3,15756.00,3636.00,19392.00
411840,202206,2163,1267,896,1536826.80,1085961.95,2622788.75
411845,202206,64,21,43,25452.90,52116.00,77568.90
411850,202206,1243,666,577,809623.62,699326.70,1508950.32
411860,202206,56,33,23,39996.81,27876.00,67872.81
411870,202206,67,41,26,49692.00,31512.00,81204.00
411880,202206,415,241,174,293306.66,212100.00,505406.66
411885,202206,112,71,41,86052.20,49692.12,135744.32
411890,202206,318,216,102,261793.66,123624.97,385418.63
411900,202206,106,76,30,92112.00,36360.00,128472.00
411910,202206,200,141,59,170892.66,71508.80,242401.46
411915,202206,2401,933,1468,1130803.90,1780445.59,2911249.49
411920,202206,108,81,27,98173.96,32724.00,130897.96
411925,202206,18,10,8,12120.00,9696.00,21816.00
411930,202206,788,538,250,652142.43,304213.02,956355.45
411940,202206,605,378,227,458138.33,276337.10,734475.43
411950,202206,1169,523,646,633880.95,782960.79,1416841.74
411960,202206,1133,707,426,856888.14,516312.30,1373200.44
411965,202206,24,14,10,16968.38,12120.52,29088.90
411970,202206,90,76,14,92112.60,16968.00,109080.60
411980,202206,214,112,102,135744.00,123624.00,259368.00
411990,202206,5185,2755,2430,3341542.36,2950124.07,6291666.43
411995,202206,596,168,428,203617.55,518743.83,722361.38
412000,202206,326,210,116,254523.98,140592.45,395116.43
412010,202206,54,28,26,33936.13,31512.00,65448.13
412015,202206,37,30,7,36360.10,8484.00,44844.10
412020,202206,22,17,5,20604.20,6060.00,26664.20
412030,202206,37,34,3,41208.00,3636.00,44844.00
412033,202206,51,27,24,32724.00,29088.00,61812.00
412035,202206,69,43,26,52116.00,31512.00,83628.00
412040,202206,35,15,20,18180.60,24240.00,42420.60
412050,202206,216,159,57,192709.29,69085.53,261794.82
412060,202206,797,568,229,689634.96,278761.74,968396.70
412065,202206,53,28,25,33936.00,30300.00,64236.00
412070,202206,161,111,50,134533.00,60600.52,195133.52
412080,202206,331,154,177,186648.67,214525.17,401173.84
412085,202206,38,14,24,16968.00,29088.00,46056.00
412090,202206,855,517,338,626608.85,409656.98,1036265.83
412100,202206,254,212,42,256947.41,50904.51,307851.92
412110,202206,71,54,17,65448.80,20604.00,86052.80
412120,202206,352,187,165,226646.66,199980.46,426627.12
412125,202206,64,38,26,46056.20,31512.00,77568.20
412130,202206,48,30,18,36360.84,21816.00,58176.84
412135,202206,30,18,12,21816.00,14544.00,36360.00
412140,202206,436,282,154,341785.01,187861.19,529646.20
412150,202206,236,150,86,181800.20,104232.90,286033.10
412160,202206,82,53,29,64236.00,35148.00,99384.00
412170,202206,716,471,245,570852.95,296940.50,867793.45
412175,202206,41,28,13,33936.57,15756.08,49692.65
412180,202206,164,122,42,147865.51,50904.20,198769.71
412190,202206,333,260,73,315122.56,89688.00,404810.56
412200,202206,193,115,78,139380.15,94536.00,233916.15
412210,202206,96,71,25,86052.00,30300.00,116352.00
412215,202206,239,160,79,193920.40,95749.19,289669.59
412217,202206,65,52,13,63024.20,15756.00,78780.20
412220,202206,827,543,284,658121.27,345424.27,1003545.54
412230,202206,281,166,115,202404.68,139382.82,341787.50
412240,202206,1343,662,681,802348.56,827800.88,1630149.44
412250,202206,407,248,159,300576.86,192708.00,493284.86
412260,202206,128,82,46,99385.56,55752.00,155137.56
412265,202206,168,129,39,156348.00,47268.00,203616.00
412270,202206,90,55,35,66660.00,42420.37,109080.37
412280,202206,80,62,18,75144.00,21816.00,96960.00
412290,202206,89,55,34,66660.46,41208.00,107868.46
412300,202206,201,142,59,172104.20,71508.00,243612.20
412310,202206,53,41,12,49692.20,14544.00,64236.20
412320,202206,87,67,20,81204.95,24240.00,105444.95
412330,202206,193,151,42,183012.27,50904.00,233916.27
412340,202206,171,111,60,134532.00,72720.00,207252.00
412350,202206,666,296,370,358752.28,448440.60,807192.88
412360,202206,22,19,3,23028.00,3636.00,26664.00
412370,202206,139,117,22,141804.40,26664.00,168468.40
412380,202206,193,147,46,178164.60,55752.00,233916.60
412382,202206,64,34,30,41208.00,36360.00,77568.00
412385,202206,151,109,42,132108.20,50904.00,183012.20
412390,202206,313,235,78,286038.40,94536.98,380575.38
412395,202206,66,52,14,63024.00,16968.00,79992.00
412400,202206,100,65,35,78782.16,42420.00,121202.16
412402,202206,237,124,113,150289.28,136956.00,287245.28
412405,202206,964,319,645,386628.84,781740.37,1168369.21
412410,202206,986,580,406,702378.11,492076.45,1194454.56
412420,202206,16,16,0,19392.00,,19392.00
412430,202206,25,23,2,27876.00,2424.00,30300.00
412440,202206,659,327,332,396325.99,402384.40,798710.39
412450,202206,67,59,8,71508.00,10908.00,82416.00
412460,202206,74,53,21,64236.40,25452.00,89688.40
412470,202206,212,167,45,202407.56,54540.00,256947.56
412480,202206,149,105,44,127260.44,53328.20,180588.64
412490,202206,168,143,25,173316.20,30300.00,203616.20
412500,202206,402,316,86,382995.23,104232.69,487227.92
412510,202206,164,136,28,164834.81,33936.10,198770.91
412520,202206,89,58,31,70296.00,37572.00,107868.00
412530,202206,103,50,53,60600.32,64236.00,124836.32
412535,202206,79,59,20,71508.47,24240.00,95748.47
412540,202206,41,21,20,25452.00,24240.23,49692.23
412545,202206,79,52,27,63024.18,32724.00,95748.18
412550,202206,4090,1645,2445,1994968.05,2966997.38,4961965.43
412555,202206,10,6,4,7272.00,4848.00,12120.00
412560,202206,655,432,223,523587.16,270276.20,793863.36
412570,202206,813,383,430,465409.32,521162.19,986571.51
412575,202206,88,61,27,73932.77,32724.00,106656.77
412580,202206,173,115,58,139381.83,71508.18,210890.01
412590,202206,34,29,5,35148.21,6060.00,41208.21
412600,202206,185,129,56,156349.66,67872.02,224221.68
412610,202206,41,19,22,23028.00,26664.00,49692.00
412620,202206,126,103,23,124837.22,27876.33,152713.55
412625,202206,2080,991,1089,1202312.54,1319875.53,2522188.07
412627,202206,66,49,17,59388.00,20604.00,79992.00
412630,202206,375,252,123,305427.10,149076.49,454503.59
412635,202206,76,21,55,25452.00,66660.00,92112.00
412640,202206,106,74,32,89688.20,38784.00,128472.20
412650,202206,308,200,108,242401.87,130896.19,373298.06
412660,202206,574,307,267,372084.96,324816.84,696901.80
412665,202206,44,40,4,48480.00,4848.00,53328.00
412667,202206,281,181,100,219373.01,121200.38,340573.39
412670,202206,72,56,16,67872.20,19392.00,87264.20
412680,202206,322,243,79,294519.66,95749.30,390268.96
412690,202206,117,76,41,92112.45,49692.00,141804.45
412700,202206,191,123,68,149076.00,82416.23,231492.23
412710,202206,1340,745,595,904160.44,722354.80,1626515.24
412720,202206,231,127,104,155136.80,126048.32,281185.12
412730,202206,201,170,31,206040.69,37572.00,243612.69
412740,202206,406,206,200,250885.16,242400.20,493285.36
412750,202206,416,227,189,275124.20,229068.52,504192.72
412760,202206,348,174,174,210889.64,212100.60,422990.24
412770,202206,2091,1113,978,1353813.41,1185338.80,2539152.21
412780,202206,143,103,40,124837.10,48480.00,173317.10
412785,202206,314,158,156,192708.00,189072.00,381780.00
412788,202206,47,27,20,32724.82,24240.00,56964.82
412790,202206,126,101,25,122413.57,30300.00,152713.57
412795,202206,145,98,47,119988.20,56964.00,176952.20
412796,202206,298,183,115,221796.44,139380.00,361176.44
412800,202206,682,393,289,476317.79,350268.66,826586.45
412810,202206,3074,1656,1418,2010740.74,1721054.21,3731794.95
412820,202206,972,571,401,694482.41,486018.01,1180500.42
412830,202206,12,11,1,13332.00,1212.00,14544.00
412840,202206,260,175,85,212100.00,103020.00,315120.00
412850,202206,595,394,201,478742.01,244824.58,723566.59
412853,202206,169,79,90,95748.00,109080.00,204828.00
412855,202206,185,104,81,126049.67,98172.10,224221.77
412860,202206,94,61,33,73932.85,39997.50,113930.35
412862,202206,76,49,27,59388.00,32724.00,92112.00
412863,202206,9,6,3,7272.00,3636.00,10908.00
412865,202206,45,34,11,41208.00,13332.00,54540.00
412870,202206,109,68,41,82416.20,49692.20,132108.40
412880,202206,93,64,29,77570.40,35148.00,112718.40
420005,202206,43,37,6,44844.20,7272.00,52116.20
420010,202206,359,234,125,283610.38,151500.67,435111.05
420020,202206,93,73,20,88476.00,24240.00,112716.00
420030,202206,27,22,5,26664.00,6060.00,32724.00
420040,202206,92,69,23,83628.40,29088.00,112716.40
420050,202206,60,39,21,47268.16,25452.00,72720.16
420055,202206,17,16,1,19392.20,1212.00,20604.20
420060,202206,27,20,7,24240.00,8484.20,32724.20
420070,202206,100,84,16,101808.00,19392.00,121200.00
420075,202206,11,10,1,12120.00,1212.00,13332.00
420080,202206,40,34,6,41208.00,7272.00,48480.00
420090,202206,37,30,7,36360.66,8484.00,44844.66
420100,202206,146,122,24,147864.30,29088.00,176952.30
420110,202206,22,21,1,25452.00,1212.00,26664.00
420120,202206,58,41,17,49692.20,20604.00,70296.20
420125,202206,88,67,21,81204.00,25452.00,106656.00
420127,202206,34,29,5,35148.00,6060.00,41208.00
420130,202206,477,287,190,349062.31,230282.96,579345.27
420140,202206,1330,735,595,890829.28,721151.09,1611980.37
420150,202206,48,34,14,41208.00,16968.00,58176.00
420160,202206,32,29,3,35148.00,3636.00,38784.00
420165,202206,17,11,6,13332.00,7272.30,20604.30
420170,202206,67,40,27,48480.00,32724.59,81204.59
420180,202206,22,18,4,21816.00,4848.00,26664.00
420190,202206,26,23,3,27876.00,3636.00,31512.00
420195,202206,136,60,76,72721.30,92113.86,164835.16
420200,202206,1325,561,764,681148.86,927189.06,1608337.92
420205,202206,107,63,44,76356.30,53328.56,129684.86
420207,202206,137,75,62,90900.00,75144.00,166044.00
420208,202206,19,15,4,18180.11,4848.00,23028.11
420209,202206,12,10,2,12120.00,2424.00,14544.00
420210,202206,574,269,305,326029.97,370872.88,696902.85
420213,202206,51,39,12,47268.00,14544.00,61812.00
420215,202206,27,23,4,27877.04,4848.00,32725.04
420220,202206,58,36,22,43632.60,26664.00,70296.60
420230,202206,948,575,373,696909.02,452077.04,1148986.06
420240,202206,2268,1493,775,1813160.59,940516.45,2753677.04
420243,202206,43,34,9,41208.90,10908.00,52116.90
420245,202206,196,92,104,111504.59,126048.00,237552.59
420250,202206,59,39,20,47268.19,24240.00,71508.19
420253,202206,22,16,6,19393.07,7272.00,26665.07
420257,202206,13,9,4,10908.00,4848.00,15756.00
420260,202206,116,92,24,111505.59,29088.00,140593.59
420270,202206,31,23,8,27876.20,9696.00,37572.20
420280,202206,269,201,68,244828.52,82417.48,327246.00
420285,202206,25,19,6,23028.00,7272.00,30300.00
420287,202206,50,33,17,39996.20,20604.00,60600.20
420290,202206,908,620,288,752655.22,350268.86,1102924.08
420300,202206,1552,1234,318,1495631.53,387843.49,1883475.02
420310,202206,48,35,13,42420.02,15756.00,58176.02
420315,202206,28,23,5,27876.68,6060.00,33936.68
420320,202206,995,459,536,556311.56,649636.41,1205947.97
420325,202206,3,1,2,1212.00,2424.20,3636.20
420330,202206,113,72,41,87264.00,49692.00,136956.00
420340,202206,185,123,62,149076.80,75144.18,224220.98
420350,202206,248,170,78,206044.07,94536.19,300580.26
420360,202206,696,536,160,649637.20,193920.80,843558.00
420370,202206,133,72,61,87265.43,73932.00,161197.43
420380,202206,1198,813,385,986580.35,466623.05,1453203.40
420390,202206,229,157,72,190284.34,87264.40,277548.74
420395,202206,186,136,50,164833.61,60600.10,225433.71
420400,202206,227,173,54,209677.60,65448.20,275125.80
420410,202206,51,37,14,44845.34,16968.00,61813.34
420415,202206,32,27,5,32724.00,6060.00,38784.00
420417,202206,54,42,12,50904.00,14544.00,65448.00
420419,202206,11,10,1,12120.00,1212.00,13332.00
420420,202206,2838,1757,1081,2131925.65,1312600.28,3444525.93
420425,202206,65,50,15,60600.00,18180.43,78780.43
420430,202206,1027,741,286,898095.90,347844.00,1245939.90
420435,202206,13,12,1,14544.00,1212.00,15756.00
420440,202206,92,66,26,79992.60,31512.00,111504.60
420445,202206,31,28,3,33936.10,3636.00,37572.10
420450,202206,82,44,38,53328.20,46056.00,99384.20
420455,202206,183,141,42,170893.57,50904.10,221797.67
420460,202206,2277,1411,866,1710148.96,1050808.22,2760957.18
420470,202206,88,60,28,72720.00,33936.00,106656.00
420475,202206,10,9,1,10908.00,1212.00,12120.00
420480,202206,863,652,211,790236.58,255733.54,1045970.12
420490,202206,95,72,23,87265.40,27876.00,115141.40
420500,202206,383,226,157,273915.01,190284.20,464199.21
420510,202206,24,21,3,25452.68,3636.00,29088.68
420515,202206,28,15,13,18180.00,15756.00,33936.00
420517,202206,7,6,1,7272.00,1212.00,8484.00
420519,202206,1,0,1,,1212.00,1212.00
420520,202206,62,48,14,58176.00,16968.00,75144.00
420530,202206,143,91,52,110292.10,63024.20,173316.30
420535,202206,14,12,2,14544.00,2424.00,16968.00
420540,202206,6213,3848,2365,4665342.61,2868820.71,7534163.32
420543,202206,29,27,2,32724.88,2424.00,35148.88
420545,202206,200,136,64,164834.20,77568.00,242402.20
420550,202206,773,638,135,773272.11,164832.27,938104.38
420555,202206,28,21,7,25452.00,8484.00,33936.00
420560,202206,56,44,12,53328.00,14544.00,67872.00
420570,202206,188,92,96,112717.15,116352.80,229069.95
420580,202206,297,146,151,176952.48,183012.80,359965.28
420590,202206,478,306,172,370874.29,208464.75,579339.04
420600,202206,139,74,65,90900.00,78780.00,169680.00
420610,202206,36,33,3,39996.00,3636.00,43632.00
420620,202206,78,56,22,67872.40,26664.00,94536.40
420630,202206,148,99,49,119988.26,59388.00,179376.26
420640,202206,69,59,10,71508.00,12120.00,83628.00
420650,202206,273,145,128,175740.60,155136.40,330877.00
420660,202206,41,33,8,39996.00,9696.00,49692.00
420665,202206,41,26,15,31512.20,18180.00,49692.20
420670,202206,234,181,53,219377.01,64236.00,283613.01
420675,202206,14,12,2,14544.00,2424.00,16968.00
420680,202206,33,26,7,31512.00,8484.00,39996.00
420690,202206,191,145,46,175740.00,55752.10,231492.10
420700,202206,702,450,252,545407.99,306638.19,852046.18
420710,202206,139,74,65,89688.00,78780.26,168468.26
420720,202206,94,73,21,88476.49,25452.10,113928.59
420730,202206,670,391,279,473897.21,339365.73,813262.94
420740,202206,55,55,0,66660.00,,66660.00
420750,202206,474,308,166,373296.67,201192.51,574489.18
420757,202206,19,16,3,19392.00,3636.00,23028.00
420760,202206,36,27,9,32724.00,10908.00,43632.00
420765,202206,73,52,21,63024.20,25452.00,88476.20
420768,202206,57,47,10,56964.20,12120.00,69084.20
420770,202206,66,56,10,67873.32,12120.00,79993.32
420775,202206,37,33,4,39996.80,4848.00,44844.80
420780,202206,202,157,45,190284.40,55752.00,246036.40
420785,202206,24,16,8,19392.00,9696.00,29088.00
420790,202206,141,114,27,138168.07,32724.00,170892.07
420800,202206,59,42,17,50904.00,20604.00,71508.00
420810,202206,271,216,55,261793.68,66660.00,328453.68
420820,202206,2454,1341,1113,1625302.73,1353812.88,2979115.61
420830,202206,658,340,318,412085.67,385421.67,797507.34
420840,202206,135,93,42,112716.40,50904.00,163620.40
420845,202206,431,181,250,219373.33,303002.53,522375.86
420850,202206,258,194,64,235128.49,77568.00,312696.49
420860,202206,59,50,9,60601.23,10908.00,71509.23
420870,202206,130,90,40,109080.20,48480.00,157560.20
420880,202206,187,120,67,145441.82,81204.20,226646.02
420890,202206,951,455,496,551463.36,601153.30,1152616.66
420895,202206,7,7,0,8484.00,,8484.00
420900,202206,409,329,80,398750.95,96960.20,495711.15
420910,202206,5818,3118,2700,3783903.80,3274842.59,7058746.39
420915,202206,58,52,6,63024.00,7272.00,70296.00
420917,202206,20,16,4,19392.20,4848.00,24240.20
420920,202206,23,15,8,18180.00,9696.00,27876.00
420930,202206,3123,2012,1111,2439709.60,1346546.25,3786255.85
420940,202206,565,403,162,489656.88,196347.34,686004.22
420945,202206,11,8,3,9696.00,3636.00,13332.00
420950,202206,48,35,13,42420.00,15756.00,58176.00
420960,202206,107,85,22,103022.05,26664.10,129686.15
420970,202206,274,217,57,263007.71,69084.93,332092.64
420980,202206,23,22,1,26664.00,1212.00,27876.00
420985,202206,54,46,8,55752.00,9696.00,65448.00
420990,202206,84,65,19,78780.00,23028.00,101808.00
421000,202206,55,32,23,38784.00,27876.00,66660.00
421003,202206,37,26,11,31512.00,13332.00,44844.00
421005,202206,7,5,2,6060.00,2424.00,8484.00
421010,202206,847,551,296,669032.52,359968.88,1029001.40
421020,202206,21,17,4,20604.00,4848.00,25452.00
421030,202206,111,95,16,115141.08,19392.20,134533.28
421040,202206,64,44,20,53329.16,24240.00,77569.16
421050,202206,323,224,99,271488.88,119988.00,391476.88
421055,202206,19,15,4,18180.00,4848.00,23028.00
421060,202206,100,55,45,66660.20,55752.00,122412.20
421070,202206,41,36,5,43632.76,6060.00,49692.76
421080,202206,40,34,6,41208.90,7272.00,48480.90
421085,202206,18,15,3,18180.00,3636.00,21816.00
421090,202206,36,30,6,36360.31,7272.00,43632.31
421100,202206,113,87,26,105445.27,31512.00,136957.27
421105,202206,184,150,34,181802.78,41208.20,223010.98
421110,202206,114,81,33,99384.00,39996.49,139380.49
421120,202206,173,125,48,151502.58,58176.70,209679.28
421125,202206,17,10,7,12120.00,8484.11,20604.11
421130,202206,814,500,314,606003.62,380570.49,986574.11
421140,202206,34,23,11,27876.20,13332.00,41208.20
421145,202206,42,36,6,43632.00,7272.00,50904.00
421150,202206,84,65,19,78780.00,23028.97,101808.97
421160,202206,61,38,23,46056.00,27876.70,73932.70
421165,202206,13,10,3,12120.00,3636.00,15756.00
421170,202206,156,130,26,157708.13,31512.61,189220.74
421175,202206,182,129,53,156349.60,64236.19,220585.79
421180,202206,39,27,12,32724.56,14544.00,47268.56
421185,202206,18,15,3,18180.00,3636.00,21816.00
421187,202206,4,3,1,3636.20,1212.00,4848.20
421189,202206,44,31,13,37572.90,15756.00,53328.90
421190,202206,1876,1173,703,1422901.72,853256.60,2276158.32
421200,202206,90,63,27,76357.88,32724.00,109081.88
421205,202206,27,19,8,23028.78,9696.00,32724.78
421210,202206,169,123,46,149076.52,56964.00,206040.52
421220,202206,246,188,58,227856.74,70296.90,298153.64
421223,202206,46,37,9,44844.76,10908.00,55752.76
421225,202206,71,47,24,56964.00,29089.26,86053.26
421227,202206,66,55,11,66660.00,14544.00,81204.00
421230,202206,72,49,23,59388.80,27876.00,87264.80
421240,202206,17,15,2,18180.60,2424.00,20604.60
421250,202206,380,222,158,269065.15,191500.02,460565.17
421260,202206,20,16,4,19392.00,4848.00,24240.00
421265,202206,6,4,2,4848.00,2424.00,7272.00
421270,202206,57,51,6,61812.00,7272.00,69084.00
421280,202206,353,180,173,218161.86,209676.84,427838.70
421290,202206,308,201,107,243612.19,129685.21,373297.40
421300,202206,22,18,4,21816.20,4848.00,26664.20
421310,202206,48,32,16,38784.78,19392.00,58176.78
421315,202206,31,19,12,23028.00,14544.00,37572.00
421320,202206,133,87,46,105444.00,55752.00,161196.00
421330,202206,109,81,28,98172.10,33936.00,132108.10
421335,202206,45,32,13,38785.01,15756.00,54541.01
421340,202206,238,155,83,187860.80,100596.00,288456.80
421350,202206,179,107,72,129685.97,87264.10,216950.07
421360,202206,711,494,217,598733.66,263004.89,861738.55
421370,202206,185,136,49,164832.02,59389.17,224221.19
421380,202206,148,109,39,132108.48,47268.00,179376.48
421390,202206,16,10,6,12120.00,7272.00,19392.00
421400,202206,115,93,22,113928.80,26664.00,140592.80
421410,202206,21,18,3,21816.00,3636.00,25452.00
421415,202206,19,16,3,19392.00,3636.00,23028.00
421420,202206,102,87,15,105444.20,18180.00,123624.20
421430,202206,19,12,7,14544.00,8484.00,23028.00
421440,202206,58,50,8,60600.00,9696.00,70296.00
421450,202206,87,71,16,86052.00,19392.44,105444.44
421460,202206,57,45,12,54540.00,15756.00,70296.00
421470,202206,73,40,33,48480.20,39996.00,88476.20
421480,202206,747,557,190,675085.80,230280.59,905366.39
421490,202206,24,23,1,27876.00,1212.00,29088.00
421500,202206,466,273,193,332092.32,235129.17,567221.49
421505,202206,29,21,8,25452.00,9696.00,35148.00
421507,202206,31,25,6,30300.00,7272.00,37572.00
421510,202206,64,40,24,48480.00,29088.00,77568.00
421520,202206,51,43,8,52116.40,9696.00,61812.40
421530,202206,48,41,7,49692.20,8484.00,58176.20
421535,202206,23,21,2,25452.00,2424.00,27876.00
421540,202206,50,39,11,47268.00,13332.00,60600.00
421545,202206,78,55,23,66661.47,27876.15,94537.62
421550,202206,293,207,86,250886.61,104232.85,355119.46
421555,202206,16,14,2,16968.70,2424.00,19392.70
421560,202206,9,8,1,9696.00,1212.00,10908.00
421565,202206,122,79,43,95749.05,52116.00,147865.05
421567,202206,33,27,6,33936.00,7272.00,41208.00
421568,202206,43,40,3,48480.00,3636.00,52116.00
421569,202206,10,10,0,12120.00,,12120.00
421570,202206,233,150,83,181800.18,100596.00,282396.18
421575,202206,26,23,3,27876.00,3636.00,31512.00
421580,202206,711,413,298,500637.68,361177.92,861815.60
421590,202206,17,15,2,18180.00,2424.00,20604.00
421600,202206,159,108,51,130896.60,61812.00,192708.60
421605,202206,100,66,34,79992.44,41208.20,121200.64
421610,202206,170,127,43,153924.00,52116.00,206040.00
421620,202206,1047,596,451,722363.55,546617.62,1268981.17
421625,202206,20,19,1,23028.60,1212.00,24240.60
421630,202206,350,212,138,258157.43,167258.63,425416.06
421635,202206,19,8,11,9696.00,13332.00,23028.00
421640,202206,99,82,17,100596.80,20604.00,121200.80
421650,202206,304,179,125,216949.30,151500.90,368450.20
421660,202206,2525,1515,1010,1837071.40,1224129.06,3061200.46
421670,202206,161,116,45,140592.90,54540.00,195132.90
421680,202206,185,167,18,202405.33,21816.00,224221.33
421690,202206,339,229,110,278762.15,133320.36,412082.51
421700,202206,59,40,19,48480.00,23028.20,71508.20
421710,202206,19,19,0,23028.00,,23028.00
421715,202206,5,4,1,4848.00,1212.00,6060.00
421720,202206,627,430,197,521165.63,238765.38,759931.01
421725,202206,26,10,16,12120.20,19392.20,31512.40
421730,202206,24,18,6,21816.00,7272.00,29088.00
421740,202206,106,39,67,47268.84,81204.00,128472.84
421750,202206,193,142,51,172104.00,61812.00,233916.00
421755,202206,17,15,2,18180.00,2424.00,20604.00
421760,202206,99,68,31,82416.80,37572.00,119988.80
421770,202206,690,442,248,535708.65,300578.12,836286.77
421775,202206,29,18,11,21816.10,13332.00,35148.10
421780,202206,179,139,40,168468.00,48480.00,216948.00
421790,202206,153,131,22,158772.56,26664.66,185437.22
421795,202206,15,12,3,14544.00,3636.00,18180.00
421800,202206,537,321,216,390270.55,261795.15,652065.70
421810,202206,68,56,12,67872.98,14544.00,82416.98
421820,202206,297,187,110,226645.30,133320.00,359965.30
421825,202206,146,118,28,143017.32,33936.00,176953.32
421830,202206,150,89,61,107869.07,73933.11,181802.18
421835,202206,6,2,4,2424.19,4848.00,7272.19
421840,202206,39,34,5,41208.53,6060.99,47269.52
421850,202206,75,63,12,76356.00,14544.00,90900.00
421860,202206,36,25,11,30300.00,13332.00,43632.00
421870,202206,1042,758,284,918705.76,347850.84,1266556.60
421875,202206,48,38,10,47268.00,12120.00,59388.00
421880,202206,179,121,58,146652.30,70296.00,216948.30
421885,202206,24,18,6,21816.00,7272.00,29088.00
421890,202206,149,106,43,128472.74,52116.70,180589.44
421895,202206,43,37,6,44844.99,7272.00,52116.99
421900,202206,123,92,31,111506.23,37572.00,149078.23
421910,202206,61,38,23,46056.00,27876.00,73932.00
421915,202206,31,25,6,30300.00,7272.00,37572.00
421917,202206,46,34,12,41208.40,14544.00,55752.40
421920,202206,35,30,5,36360.00,6060.00,42420.00
421930,202206,607,480,127,581765.00,153924.67,735689.67
421935,202206,44,37,7,44844.00,8484.00,53328.00
421940,202206,51,44,7,53328.40,8484.00,61812.40
421950,202206,873,573,300,694480.95,363601.11,1058082.06
421960,202206,42,35,7,42420.00,8484.00,50904.00
421970,202206,320,207,113,250884.75,136956.00,387840.75
421985,202206,18,11,7,13332.00,8484.00,21816.00
422000,202206,8,4,4,4848.00,4848.00,9696.00
430003,202206,176,52,124,63024.00,150288.00,213312.00
430005,202206,30,21,9,25452.00,10908.00,36360.00
430010,202206,248,179,69,216949.78,84840.00,301789.78
430020,202206,141,96,45,116352.08,54540.00,170892.08
430030,202206,115,96,19,116352.00,23028.00,139380.00
430040,202206,2898,1715,1183,2082231.73,1436221.83,3518453.56
430045,202206,68,58,10,70296.00,12120.00,82416.00
430047,202206,7,5,2,6060.00,2424.00,8484.00
430050,202206,86,74,12,89688.00,14544.00,104232.00
430055,202206,13,12,1,14544.00,1212.00,15756.00
430057,202206,6,4,2,4848.00,2424.00,7272.00
430060,202206,3909,2233,1676,2710046.08,2032531.22,4742577.30
430063,202206,48,39,9,47268.00,10908.00,58176.00
430064,202206,165,127,38,153924.00,46056.00,199980.00
430066,202206,7,3,4,3636.00,4848.00,8484.00
430070,202206,47,34,13,41208.00,15756.00,56964.00
430080,202206,79,50,29,60600.00,35148.00,95748.00
430085,202206,28,13,15,15756.50,18180.00,33936.50
430087,202206,27,20,7,24240.80,8484.00,32724.80
430090,202206,64,54,10,65448.00,12120.00,77568.00
430100,202206,138,95,43,115140.71,52116.00,167256.71
430105,202206,150,87,63,105445.07,76357.10,181802.17
430107,202206,17,13,4,15756.53,4848.00,20604.53
430110,202206,494,269,225,326028.83,272700.00,598728.83
430120,202206,156,143,13,173316.20,16968.00,190284.20
430130,202206,788,475,313,575700.79,380568.06,956268.85
430140,202206,130,120,10,145440.00,12120.00,157560.00
430150,202206,106,65,41,78780.00,49692.00,128472.00
430155,202206,30,24,6,29088.00,7272.00,36360.00
430160,202206,3585,2037,1548,2471286.81,1877391.90,4348678.71
430163,202206,411,188,223,227858.46,270277.43,498135.89
430165,202206,31,19,12,23028.00,14544.00,37572.00
430170,202206,79,65,14,78780.00,16968.00,95748.00
430175,202206,76,60,16,72720.00,19392.70,92112.70
430180,202206,107,85,22,103020.00,26664.00,129684.00
430185,202206,29,19,10,23028.00,12120.00,35148.00
430187,202206,56,30,26,36360.00,31512.00,67872.00
430190,202206,229,117,112,141804.00,135744.00,277548.00
430192,202206,16,12,4,14544.00,4848.00,19392.00
430195,202206,15,12,3,14544.00,3636.00,18180.00
430200,202206,150,126,24,152712.20,29088.00,181800.20
430205,202206,18,18,0,21816.00,,21816.00
430210,202206,742,555,187,672664.58,226644.20,899308.78
430215,202206,10,9,1,10908.00,1212.00,12120.00
430220,202206,76,51,25,61812.00,30300.00,92112.00
430222,202206,13,5,8,6060.00,9696.00,15756.00
430223,202206,16,11,5,13332.00,6060.00,19392.00
430225,202206,3,2,1,2424.00,1212.00,3636.00
430230,202206,328,201,127,243613.04,153924.00,397537.04
430235,202206,50,33,17,39996.00,20604.00,60600.00
430237,202206,20,15,5,18180.00,6060.00,24240.00
430240,202206,113,76,37,92112.22,44844.00,136956.22
430245,202206,65,51,14,61812.00,16968.00,78780.00
430250,202206,186,105,81,127260.00,98172.00,225432.00
430258,202206,10,9,1,10908.00,1212.00,12120.00
430260,202206,32,27,5,32724.00,6060.00,38784.00
430265,202206,34,29,5,35148.84,6060.00,41208.84
430270,202206,508,361,147,437535.61,178164.00,615699.61
430280,202206,1053,613,440,744170.08,533280.10,1277450.18
430290,202206,431,223,208,270276.00,252096.00,522372.00
430300,202206,2101,1135,966,1378053.43,1172010.30,2550063.73
430310,202206,2074,1014,1060,1231405.46,1284729.80,2516135.26
430320,202206,56,45,11,54540.00,13332.00,67872.00
430330,202206,88,75,13,90900.22,15756.00,106656.22
430340,202206,65,52,13,63024.00,15756.00,78780.00
430350,202206,1656,1067,589,1294418.39,715080.60,2009498.99
430355,202206,20,18,2,21816.00,2424.00,24240.00
430360,202206,98,48,50,58176.00,60600.00,118776.00
430367,202206,43,30,13,36360.00,15756.00,52116.00
430370,202206,61,53,8,64236.00,9696.00,73932.00
430380,202206,111,83,28,100597.68,33936.00,134533.68
430390,202206,582,356,226,431475.02,273913.55,705388.57
430400,202206,253,173,80,209676.60,96960.00,306636.60
430410,202206,56,45,11,54540.00,13332.00,67872.00
430420,202206,520,324,196,392692.53,237552.89,630245.42
430430,202206,49,47,2,56156.80,2424.00,58580.80
430435,202206,138,105,33,127260.00,39996.00,167256.00
430440,202206,552,339,213,410869.72,258156.70,669026.42
430450,202206,1189,967,222,1172008.62,270277.00,1442285.62
430460,202206,5744,2910,2834,3528152.42,3437251.38,6965403.80
430461,202206,16,14,2,16968.00,2424.00,19392.00
430462,202206,4,2,2,3636.00,2424.00,6060.00
430463,202206,1176,623,553,756290.76,672661.84,1428952.60
430465,202206,27,16,11,19392.00,13332.00,32724.00
430466,202206,667,467,200,566010.37,243615.33,809625.70
430467,202206,122,70,52,84840.50,63024.00,147864.50
430468,202206,133,76,57,92112.00,69084.00,161196.00
430469,202206,19,14,5,16968.00,6060.00,23028.00
430470,202206,1157,632,525,768769.74,637513.50,1406283.24
430471,202206,67,45,22,54540.00,26664.00,81204.00
430480,202206,122,85,37,103020.20,44844.00,147864.20
430485,202206,8,8,0,9696.60,,9696.60
430490,202206,72,56,16,67872.00,19392.00,87264.00
430495,202206,32,22,10,26664.00,12120.00,38784.00
430500,202206,185,125,60,151500.00,72720.00,224220.00
430510,202206,3780,2451,1329,2973050.20,1611962.94,4585013.14
430511,202206,14,14,0,16968.00,,16968.00
430512,202206,155,105,50,128472.70,60600.00,189072.70
430513,202206,49,37,12,44844.00,14544.00,59388.00
430515,202206,24,23,1,27876.00,1212.00,29088.00
430517,202206,172,141,31,172104.00,37572.00,209676.00
430520,202206,341,240,101,290881.23,122412.10,413293.33
430530,202206,80,45,35,54540.00,42420.00,96960.00
430535,202206,435,283,152,342997.59,184224.80,527222.39
430537,202206,8,8,0,9696.00,,9696.00
430540,202206,85,55,30,66660.00,36360.00,103020.00
430543,202206,397,127,270,153924.00,327240.00,481164.00
430544,202206,47,44,3,53328.28,3636.00,56964.28
430545,202206,408,193,215,233918.78,260581.51,494500.29
430550,202206,45,35,10,42420.00,12120.00,54540.00
430558,202206,1,1,0,1212.00,,1212.00
430560,202206,55,31,24,37572.00,29088.00,66660.00
430570,202206,121,53,68,64236.60,82416.00,146652.60
430580,202206,126,100,26,122412.66,31512.00,153924.66
430583,202206,14,14,0,16968.00,,16968.00
430585,202206,13,10,3,12120.00,3636.00,15756.00
430587,202206,14,8,6,9696.00,7272.20,16968.20
430590,202206,169,133,36,162409.52,43632.00,206041.52
430593,202206,1,1,0,1212.00,,1212.00
430595,202206,16,13,3,15756.00,3636.00,19392.00
430597,202206,43,25,18,30300.00,21816.00,52116.00
430600,202206,218,165,53,199980.00,64236.00,264216.00
430605,202206,168,98,70,118776.00,84840.00,203616.00
430607,202206,30,23,7,27876.00,8484.00,36360.00
430610,202206,1735,822,913,997478.68,1107770.13,2105248.81
430613,202206,5,5,0,6060.00,,6060.00
430620,202206,94,68,26,82416.00,31512.00,113928.00
430630,202206,47,39,8,47268.00,9696.00,56964.00
430632,202206,31,27,4,32724.00,4848.00,37572.00
430635,202206,37,31,6,37572.00,7272.00,44844.00
430637,202206,65,31,34,37572.00,41208.00,78780.00
430640,202206,173,97,76,117564.00,92112.54,209676.54
430642,202206,18,16,2,19392.00,2424.00,21816.00
430645,202206,29,25,4,30300.00,4848.00,35148.00
430650,202206,247,195,52,236340.60,63024.00,299364.60
430655,202206,5,4,1,4848.00,1212.00,6060.00
430660,202206,966,471,495,570855.10,601154.47,1172009.57
430670,202206,71,47,24,56964.00,29088.00,86052.00
430673,202206,84,55,29,66660.60,35148.00,101808.60
430675,202206,8,6,2,7272.00,2424.00,9696.00
430676,202206,591,350,241,424200.20,292093.69,716293.89
430680,202206,244,161,83,195132.60,100596.00,295728.60
430690,202206,542,331,211,401172.20,255733.35,656905.55
430692,202206,9,7,2,8484.20,2424.00,10908.20
430693,202206,135,83,52,100596.00,63024.00,163620.00
430695,202206,64,51,13,61812.00,15756.00,77568.00
430697,202206,64,41,23,49692.00,27876.00,77568.00
430700,202206,1370,921,449,1117468.01,544188.89,1661656.90
430705,202206,29,26,3,31512.00,3636.00,35148.00
430710,202206,257,156,101,189072.00,122412.00,311484.00
430720,202206,104,87,17,105444.00,20604.00,126048.00
430730,202206,145,122,23,147864.00,27876.00,175740.00
430740,202206,76,50,26,60600.00,31512.00,92112.00
430745,202206,27,15,12,18180.00,14544.00,32724.00
430750,202206,325,209,116,253308.74,140593.05,393901.79
430755,202206,84,45,39,54540.00,47268.00,101808.00
430760,202206,395,217,178,263004.56,215738.49,478743.05
430770,202206,1576,825,751,1002334.62,910214.34,1912548.96
430780,202206,328,205,123,249672.00,149076.00,398748.00
430781,202206,25,24,1,29088.00,1212.00,30300.00
430783,202206,63,49,14,59388.99,16968.00,76356.99
430786,202206,6,4,2,4848.00,2424.00,7272.00
430790,202206,510,325,185,393900.75,224221.60,618122.35
430800,202206,159,122,37,147865.35,46056.00,193921.35
430805,202206,38,31,7,37572.00,8484.00,46056.00
430807,202206,63,31,32,37572.00,38784.00,76356.00
430810,202206,80,53,27,64236.00,32724.00,96960.00
430820,202206,152,96,56,116352.80,67872.00,184224.80
430825,202206,12,9,3,10908.00,3636.00,14544.00
430830,202206,250,232,18,281184.60,21816.00,303000.60
430840,202206,126,84,42,101808.10,50904.00,152712.10
430843,202206,5,3,2,3636.00,2424.00,6060.00
430845,202206,76,44,32,53328.00,38784.00,92112.00
430850,202206,587,419,168,508636.72,204828.00,713464.72
430860,202206,158,100,58,121200.20,71508.00,192708.20
430865,202206,75,41,34,49692.00,41208.00,90900.00
430870,202206,74,60,14,72720.00,16968.00,89688.00
430880,202206,166,117,49,141804.10,59388.00,201192.10
430885,202206,11,10,1,12120.00,1212.00,13332.00
430890,202206,339,202,137,244824.66,166044.00,410868.66
430900,202206,529,362,167,438746.67,202404.00,641150.67
430905,202206,129,53,76,64236.80,92112.00,156348.80
430910,202206,280,154,126,186648.60,152712.20,339360.80
430912,202206,3,3,0,3636.00,,3636.00
430915,202206,43,39,4,47268.00,4848.00,52116.00
430920,202206,4622,2393,2229,2905185.85,2705212.05,5610397.90
430925,202206,5,4,1,4848.00,1212.00,6060.00
430930,202206,2068,1162,906,1410775.10,1099286.52,2510061.62
430940,202206,255,162,93,196344.82,112716.86,309061.68
430950,202206,149,119,30,144228.10,36360.00,180588.10
430955,202206,23,13,10,16968.46,12120.00,29088.46
430957,202206,21,18,3,21816.00,3636.00,25452.00
430960,202206,254,163,91,197556.63,110292.57,307849.20
430965,202206,101,66,35,79992.00,42420.00,122412.00
430970,202206,89,72,17,87264.00,20604.00,107868.00
430975,202206,45,40,5,48480.00,6060.00,54540.00
430980,202206,48,28,20,33936.00,24240.00,58176.00
430990,202206,97,74,23,89688.20,27876.10,117564.30
430995,202206,112,104,8,126048.00,9696.00,135744.00
431000,202206,295,146,149,176952.90,180588.81,357541.71
431010,202206,359,207,152,252099.07,184225.78,436324.85
431020,202206,1866,1073,793,1301690.44,961116.70,2262807.14
431030,202206,40,32,8,38784.00,9696.00,48480.00
431033,202206,455,208,247,252101.63,300578.25,552679.88
431036,202206,12,8,4,9696.00,4848.00,14544.00
431040,202206,142,90,52,109080.55,63024.00,172104.55
431041,202206,38,22,16,26664.00,19392.00,46056.00
431043,202206,39,23,16,27876.00,19392.00,47268.00
431046,202206,13,10,3,12120.00,3636.00,15756.00
431050,202206,201,120,81,145440.36,98172.00,243612.36
431053,202206,73,38,35,46056.36,42420.90,88477.26
431055,202206,62,41,21,49692.00,25452.00,75144.00
431057,202206,17,17,0,20604.00,,20604.00
431060,202206,1565,1001,564,1213217.61,683568.63,1896786.24
431065,202206,15,7,8,8484.00,9696.00,18180.00
431070,202206,64,55,9,66660.00,10908.00,77568.00
431075,202206,8,8,0,9696.00,,9696.00
431080,202206,123,70,53,84840.00,64236.00,149076.00
431085,202206,32,28,4,33936.00,4848.00,38784.00
431087,202206,16,13,3,15756.00,3636.00,19392.00
431090,202206,51,38,13,46056.00,15756.00,61812.00
431100,202206,1253,748,505,906582.07,612061.05,1518643.12
431110,202206,219,131,88,158772.76,106656.00,265428.76
431112,202206,30,21,9,25452.00,10908.00,36360.00
431113,202206,28,21,7,25452.00,8484.00,33936.00
431115,202206,150,103,47,124836.00,56964.00,181800.00
431120,202206,583,335,248,406021.18,300576.00,706597.18
431123,202206,6,5,1,6060.00,1212.00,7272.00
431125,202206,94,81,13,98172.00,15756.00,113928.00
431127,202206,5,3,2,3636.00,2424.00,6060.00
431130,202206,701,463,238,563583.04,289669.45,853252.49
431140,202206,761,543,218,658118.34,264216.00,922334.34
431142,202206,20,18,2,21816.84,2424.00,24240.84
431150,202206,198,145,53,175740.07,64236.00,239976.07
431160,202206,46,42,4,50904.00,4848.00,55752.00
431162,202206,5,5,0,6060.00,,6060.00
431164,202206,4,4,0,4848.00,,4848.00
431170,202206,111,80,31,96960.00,37572.00,134532.00
431171,202206,70,38,32,46056.00,38784.00,84840.00
431173,202206,3,1,2,1212.00,2424.00,3636.00
431175,202206,200,102,98,123624.60,118776.15,242400.75
431177,202206,94,66,28,79992.00,35148.00,115140.00
431179,202206,16,11,5,13332.00,6060.00,19392.00
431180,202206,398,243,155,294516.86,187860.76,482377.62
431190,202206,74,54,20,65448.00,24240.10,89688.10
431198,202206,73,49,24,59207.41,29088.00,88295.41
431200,202206,20,16,4,19392.00,4848.00,24240.00
431205,202206,22,20,2,24240.00,2424.00,26664.00
431210,202206,103,66,37,79992.00,44844.00,124836.00
431213,202206,34,28,6,33936.00,7272.00,41208.00
431215,202206,24,22,2,26664.00,2424.00,29088.00
431217,202206,5,4,1,4848.00,1212.00,6060.00
431220,202206,65,55,10,66660.00,12120.00,78780.00
431225,202206,165,103,62,124836.00,75144.00,199980.00
431230,202206,94,78,16,94536.00,19392.00,113928.00
431235,202206,6,5,1,6060.00,1212.00,7272.00
431237,202206,15,10,5,12120.00,6060.00,18180.00
431238,202206,12,9,3,10908.00,3636.00,14544.00
431240,202206,1071,643,428,780533.77,519948.86,1300482.63
431242,202206,38,37,1,44844.00,1212.00,46056.00
431244,202206,23,18,5,21816.00,6060.00,27876.00
431245,202206,53,38,15,46056.00,18180.00,64236.00
431247,202206,13,9,4,10908.00,4848.00,15756.00
431250,202206,280,138,142,167256.00,172104.00,339360.00
431260,202206,54,46,8,55752.00,9696.00,65448.00
431261,202206,18,13,5,15756.00,6060.00,21816.00
431262,202206,15,12,3,14544.00,3636.00,18180.00
431265,202206,148,82,66,99384.08,79992.00,179376.08
431267,202206,18,16,2,19392.00,2424.00,21816.00
431270,202206,324,252,72,305425.23,87264.00,392689.23
431275,202206,38,33,5,39996.00,6060.00,46056.00
431280,202206,22,16,6,19392.00,7272.00,26664.00
431290,202206,22,20,2,24240.00,2424.00,26664.00
431295,202206,2,1,1,1212.00,1212.00,2424.00
431300,202206,21,19,2,23028.00,2424.00,25452.00
431301,202206,7,7,0,8484.00,,8484.00
431303,202206,55,35,20,42420.00,24240.00,66660.00
431306,202206,237,122,115,147864.00,140592.00,288456.00
431308,202206,8,6,2,7272.00,2424.00,9696.00
431310,202206,64,50,14,60600.00,16968.00,77568.00
431320,202206,183,112,71,135744.00,86052.00,221796.00
431330,202206,203,129,74,156348.66,89688.00,246036.66
431333,202206,26,21,5,25452.00,6060.00,31512.00
431335,202206,7,5,2,6060.00,2424.00,8484.00
431337,202206,400,190,210,230280.80,254520.22,484801.02
431339,202206,22,17,5,20604.00,6060.00,26664.00
431340,202206,3091,1668,1423,2025164.08,1727104.74,3752268.82
431342,202206,35,23,12,27876.60,14544.00,42420.60
431344,202206,20,20,0,24240.00,,24240.00
431346,202206,5,4,1,4848.00,1212.00,6060.00
431349,202206,29,26,3,31512.23,3636.00,35148.23
431350,202206,1070,570,500,690846.22,606001.35,1296847.57
431360,202206,52,39,13,47268.00,15756.00,63024.00
431365,202206,344,146,198,176953.00,241188.40,418141.40
431370,202206,1170,667,503,808408.46,610848.99,1419257.45
431380,202206,95,84,11,101808.55,13332.00,115140.55
431390,202206,491,265,226,321180.15,273912.20,595092.35
431395,202206,326,138,188,167256.00,229068.00,396324.00
431400,202206,37,24,13,29088.00,15756.00,44844.00
431402,202206,100,72,28,87264.00,33936.80,121200.80
431403,202206,26,17,9,20604.00,10908.00,31512.00
431405,202206,700,393,307,476317.72,373296.75,849614.47
431406,202206,34,26,8,31512.00,9696.00,41208.00
431407,202206,45,36,9,43632.00,10908.00,54540.00
431410,202206,3449,2089,1360,2531880.28,1651962.28,4183842.56
431413,202206,15,12,3,14544.00,3636.00,18180.00
431415,202206,69,47,22,56964.00,26664.00,83628.00
431417,202206,24,11,13,13332.00,15756.00,29088.00
431420,202206,345,226,119,275125.22,144228.00,419353.22
431430,202206,64,34,30,41208.02,36360.00,77568.02
431440,202206,9000,6108,2892,7410259.13,3511244.75,10921503.88
431442,202206,26,13,13,15756.00,15756.00,31512.00
431445,202206,28,26,2,31512.00,2424.00,33936.00
431446,202206,4,3,1,3636.00,1212.00,4848.00
431447,202206,82,59,23,71508.00,27876.00,99384.00
431449,202206,53,42,11,50904.80,13332.00,64236.80
431450,202206,419,276,143,335724.05,173316.00,509040.05
431454,202206,11,6,5,7272.00,6060.00,13332.00
431455,202206,46,37,9,44844.10,10908.00,55752.10
431460,202206,503,339,164,412082.14,198768.00,610850.14
431470,202206,133,96,37,116352.80,44844.00,161196.80
431475,202206,11,9,2,10908.00,2424.00,13332.00
431477,202206,39,24,15,29088.00,18180.00,47268.00
431478,202206,7,7,0,8484.00,,8484.00
431480,202206,578,348,230,421776.48,278761.40,700537.88
431490,202206,28732,15881,12851,19260784.61,15588833.28,34849617.89
431500,202206,76,59,17,72720.00,20604.60,93324.60
431505,202206,27,18,9,21816.00,10908.00,32724.00
431507,202206,9,8,1,10908.00,1212.00,12120.00
431510,202206,230,167,63,202404.40,76356.00,278760.40
431513,202206,20,19,1,23028.00,1212.00,24240.00
431514,202206,5,3,2,3636.00,2424.00,6060.00
431515,202206,84,71,13,86052.04,15756.00,101808.04
431517,202206,7,4,3,4848.00,3636.00,8484.00
431520,202206,38,32,6,38784.00,7272.00,46056.00
431530,202206,1396,608,788,736897.76,955056.43,1691954.19
431531,202206,21,20,1,24240.00,1212.00,25452.00
431532,202206,36,26,10,31512.00,12120.00,43632.00
431535,202206,28,14,14,16968.00,16968.00,33936.00
431540,202206,134,109,25,132108.00,30300.60,162408.60
431545,202206,13,10,3,12120.00,3636.00,15756.00
431550,202206,350,186,164,225432.69,198768.17,424200.86
431555,202206,10,10,0,12120.00,,12120.00
431560,202206,4719,3129,1590,3799670.92,1928316.40,5727987.32
431570,202206,828,434,394,526010.76,477532.66,1003543.42
431575,202206,51,29,22,35148.00,26664.00,61812.00
431580,202206,81,55,26,66660.00,31512.00,98172.00
431590,202206,141,116,25,140592.00,30300.00,170892.00
431595,202206,17,15,2,18180.00,2424.00,20604.00
431600,202206,251,149,102,180591.47,123624.82,304216.29
431610,202206,115,85,30,103020.00,36360.00,139380.00
431620,202206,42,33,9,39996.00,10908.00,50904.00
431630,202206,123,101,22,122412.00,26664.00,149076.00
431640,202206,1294,807,487,979299.15,591456.59,1570755.74
431642,202206,34,31,3,37572.00,3636.00,41208.00
431643,202206,43,18,25,21816.00,30300.00,52116.00
431645,202206,316,182,134,220584.00,162408.00,382992.00
431647,202206,8,7,1,8484.00,1212.00,9696.00
431650,202206,31,16,15,19392.00,18180.00,37572.00
431660,202206,269,168,101,203616.00,122412.79,326028.79
431670,202206,222,96,126,116352.00,152712.00,269064.00
431673,202206,12,10,2,12120.00,2424.00,14544.00
431675,202206,25,20,5,24240.00,6060.00,30300.00
431680,202206,1155,840,315,1019300.24,382995.22,1402295.46
431690,202206,4842,2870,1972,3479684.00,2391294.62,5870978.62
431695,202206,16,10,6,12120.00,7272.00,19392.00
431697,202206,5,1,4,1212.00,4848.00,6060.00
431700,202206,180,135,45,163620.00,54540.00,218160.00
431710,202206,4015,1724,2291,2090714.07,2777907.52,4868621.59
431720,202206,1264,780,484,944755.77,587820.20,1532575.97
431725,202206,2,1,1,1212.00,1212.00,2424.00
431730,202206,1168,773,395,936893.82,478742.85,1415636.67
431740,202206,1335,644,691,780529.01,838708.01,1619237.02
431750,202206,1811,1179,632,1428953.61,765988.62,2194942.23
431755,202206,6,5,1,6060.00,1212.00,7272.00
431760,202206,958,592,366,717508.45,443594.82,1161103.27
431770,202206,412,279,133,338148.10,161196.00,499344.10
431775,202206,23,17,6,20604.00,7272.00,27876.00
431780,202206,555,334,221,404808.57,267852.00,672660.57
431790,202206,151,115,36,140592.02,43632.00,184224.02
431795,202206,13,10,3,12120.00,3636.00,15756.00
431800,202206,3093,1615,1478,1961025.48,1792552.10,3753577.58
431805,202206,17,15,2,18180.00,2424.00,20604.00
431810,202206,594,387,207,469044.82,250884.00,719928.82
431820,202206,341,195,146,236340.10,176952.00,413292.10
431830,202206,2295,1381,914,1673775.88,1108980.90,2782756.78
431840,202206,476,307,169,372087.37,204829.00,576916.37
431842,202206,33,28,5,33936.00,6060.00,39996.00
431843,202206,12,9,3,10908.10,3636.00,14544.10
431844,202206,17,12,5,14544.00,6060.00,20604.00
431845,202206,25,22,3,26664.00,3636.00,30300.00
431846,202206,25,22,3,26664.00,3636.00,30300.00
431848,202206,14,12,2,14544.00,2424.00,16968.00
431849,202206,5,4,1,4848.00,1212.00,6060.00
431850,202206,764,594,170,721146.44,206041.84,927188.28
431860,202206,123,77,46,93324.15,55752.00,149076.15
431861,202206,5,1,4,1212.00,4848.00,6060.00
431862,202206,60,44,16,53328.00,19392.00,72720.00
431870,202206,3685,2103,1582,2548860.63,1918599.71,4467460.34
431880,202206,976,683,293,829010.30,355116.89,1184127.19
431890,202206,1233,715,518,869005.70,633876.45,1502882.15
431900,202206,185,129,56,156348.00,67872.00,224220.00
431910,202206,44,34,10,41208.00,12120.00,53328.00
431912,202206,47,29,18,35148.00,21816.00,56964.00
431915,202206,143,108,35,130896.00,42420.00,173316.00
431920,202206,146,104,42,126048.00,50904.00,176952.00
431930,202206,72,59,13,71508.00,15756.00,87264.00
431935,202206,5,4,1,4848.00,1212.00,6060.00
431936,202206,3,3,0,3636.00,,3636.00
431937,202206,19,14,5,16968.63,6060.00,23028.63
431940,202206,468,319,149,386629.29,180588.00,567217.29
431950,202206,471,305,166,369662.30,201193.98,570856.28
431960,202206,734,398,336,482377.47,407232.60,889610.07
431970,202206,60,55,5,66660.00,6060.00,72720.00
431971,202206,4,3,1,3636.00,1212.00,4848.00
431973,202206,19,15,4,18180.20,4848.00,23028.20
431975,202206,10,10,0,12120.00,,12120.00
431980,202206,197,115,82,139380.60,99384.00,238764.60
431990,202206,1067,561,506,681069.88,613276.97,1294346.85
432000,202206,1857,973,884,1179291.67,1071416.84,2250708.51
432010,202206,259,170,89,206040.70,107868.20,313908.90
432020,202206,183,156,27,189073.26,32724.00,221797.26
432023,202206,14,12,2,14544.00,2424.00,16968.00
432026,202206,58,51,7,61812.00,8484.00,70296.00
432030,202206,63,31,32,37572.20,38784.00,76356.20
432032,202206,15,12,3,14544.00,3636.00,18180.00
432035,202206,62,46,16,55752.00,19392.00,75144.00
432040,202206,87,58,29,70296.60,35148.00,105444.60
432045,202206,2,2,0,2424.00,,2424.00
432050,202206,81,48,33,58176.00,39996.00,98172.00
432055,202206,132,95,37,115140.20,44844.00,159984.20
432057,202206,6,4,2,4848.60,2424.00,7272.60
432060,202206,32,28,4,33936.00,4848.00,38784.00
432065,202206,29,25,4,30300.00,4848.00,35148.00
432067,202206,85,78,7,94536.50,8484.00,103020.50
432070,202206,390,308,82,375720.60,99384.00,475104.60
432080,202206,816,571,245,692056.63,296941.10,988997.73
432085,202206,10,8,2,9696.00,2424.00,12120.00
432090,202206,269,181,88,219372.10,106656.00,326028.10
432100,202206,172,110,62,133320.00,75144.00,208464.00
432110,202206,553,359,194,435108.80,236340.58,671449.38
432120,202206,1023,569,454,692053.87,551461.08,1243514.95
432130,202206,494,349,145,422988.80,175740.00,598728.80
432132,202206,22,20,2,24240.00,2424.00,26664.00
432135,202206,78,65,13,78780.00,15756.00,94536.00
432140,202206,260,193,67,233917.01,81204.00,315121.01
432143,202206,210,127,83,153924.00,101808.85,255732.85
432145,202206,282,196,86,237552.00,104232.00,341784.00
432146,202206,15,13,2,15756.00,2424.00,18180.00
432147,202206,88,54,34,65448.00,41208.00,106656.00
432149,202206,16,9,7,10908.00,8484.00,19392.00
432150,202206,988,606,382,734475.23,462986.17,1197461.40
432160,202206,1684,865,819,1048386.05,993846.04,2042232.09
432162,202206,4,2,2,2424.00,2424.00,4848.00
432163,202206,15,10,5,12120.00,6060.00,18180.00
432166,202206,120,87,33,105747.10,39996.00,145743.10
432170,202206,229,115,114,139380.70,138168.81,277549.51
432180,202206,570,358,212,433896.00,259368.60,693264.60
432183,202206,11,10,1,12120.00,1212.00,13332.00
432185,202206,78,62,16,75144.00,19392.97,94536.97
432190,202206,502,300,202,363601.00,244824.20,608425.20
432195,202206,88,72,16,87264.00,19392.00,106656.00
432200,202206,410,256,154,310272.30,186648.00,496920.30
432210,202206,112,67,45,81204.00,54540.00,135744.00
432215,202206,31,29,2,35148.00,2424.00,37572.00
432218,202206,19,19,0,23028.00,,23028.00
432220,202206,630,319,311,386628.95,376933.99,763562.94
432225,202206,16,11,5,13332.20,6060.00,19392.20
432230,202206,121,82,39,99384.00,47268.00,146652.00
432232,202206,24,21,3,25452.00,3636.00,29088.00
432234,202206,4,2,2,2424.00,2424.00,4848.00
432235,202206,1,1,0,1212.00,,1212.00
432237,202206,23,15,8,18180.00,9696.00,27876.00
432240,202206,4497,2519,1978,3053050.10,2398561.33,5451611.43
432250,202206,1104,717,387,870217.89,469044.90,1339262.79
432252,202206,48,48,0,58176.00,,58176.00
432253,202206,64,50,14,60600.00,16968.00,77568.00
432254,202206,28,13,15,15756.00,18180.00,33936.00
432255,202206,11,10,1,12120.00,1212.00,13332.00
432260,202206,846,673,173,815678.85,212100.00,1027778.85
432270,202206,216,161,55,195133.04,66660.63,261793.67
432280,202206,155,116,39,140594.68,47268.00,187862.68
432285,202206,1,1,0,1212.00,,1212.00
432290,202206,55,48,7,58176.00,8484.00,66660.00
432300,202206,4920,2603,2317,3158408.44,2810638.48,5969046.92
432310,202206,130,109,21,132108.00,25452.00,157560.00
432320,202206,19,14,5,16968.00,6060.00,23028.00
432330,202206,14,10,4,12120.00,4848.00,16968.00
432335,202206,8,6,2,7272.00,2424.00,9696.00
432340,202206,35,28,7,35148.00,8484.00,43632.00
432345,202206,114,76,38,92112.20,46056.00,138168.20
432350,202206,23,22,1,26664.00,1212.00,27876.00
432360,202206,5,4,1,4848.00,1212.00,6060.00
432370,202206,25,25,0,30300.42,,30300.42
432375,202206,28,26,2,31512.00,2424.00,33936.00
432377,202206,7,7,0,8484.00,,8484.00
432380,202206,194,86,108,104232.20,130897.57,235129.77
500020,202206,269,141,128,170895.10,155136.00,326031.10
500025,202206,135,65,70,78780.20,84840.63,163620.83
500060,202206,1430,909,521,1101719.12,631455.75,1733174.87
500070,202206,725,345,380,419358.71,460563.13,879921.84
500080,202206,138,110,28,133321.81,33936.00,167257.81
500085,202206,128,101,27,122413.91,32724.00,155137.91
500090,202206,373,174,199,210889.15,241188.63,452077.78
500100,202206,684,347,337,421780.00,408446.88,830226.88
500110,202206,2288,1085,1203,1315030.55,1458046.70,2773077.25
500124,202206,260,145,115,175740.84,139380.62,315121.46
500150,202206,323,133,190,161197.56,230280.99,391478.55
500190,202206,541,361,180,438752.93,218160.20,656913.13
500200,202206,200,169,31,204828.88,37572.00,242400.88
500210,202206,1615,533,1082,647215.37,1311387.95,1958603.32
500215,202206,197,114,83,138168.80,100596.60,238765.40
500220,202206,706,453,253,549044.73,306636.76,855681.49
500230,202206,225,134,91,162409.55,110292.79,272702.34
500240,202206,636,416,220,504195.72,266642.28,770838.00
500260,202206,596,236,360,286033.79,438745.17,724778.96
500270,202206,30150,13086,17064,15867050.27,20691463.60,36558513.87
500280,202206,199,69,130,83628.66,157560.00,241188.66
500290,202206,1173,730,443,884767.47,536917.10,1421684.57
500295,202206,460,299,161,362393.51,195132.20,557525.71
500310,202206,107,37,70,44844.10,84840.00,129684.10
500315,202206,816,453,363,549037.57,439956.20,988993.77
500320,202206,3627,1742,1885,2112552.30,2284630.41,4397182.71
500325,202206,893,500,393,606016.48,476320.41,1082336.89
500330,202206,1482,706,776,855609.24,940523.08,1796132.32
500345,202206,306,227,79,275126.52,95748.21,370874.73
500348,202206,241,146,95,176953.42,115140.00,292093.42
500350,202206,107,51,56,61812.00,67872.00,129684.00
500370,202206,5678,2593,3085,3143982.00,3740248.04,6884230.04
500375,202206,348,236,112,286032.89,135744.00,421776.89
500380,202206,613,350,263,424203.48,318757.22,742960.70
500390,202206,71,32,39,38784.10,47268.20,86052.30
500400,202206,208,136,72,164832.80,87264.20,252097.00
500410,202206,482,208,274,253310.91,332091.66,585402.57
500430,202206,549,376,173,455715.12,209676.19,665391.31
500440,202206,206,110,96,133320.54,116352.00,249672.54
500450,202206,411,176,235,213313.78,286032.80,499346.58
500460,202206,263,143,120,173317.44,145440.00,318757.44
500470,202206,418,309,109,374509.01,132108.90,506617.91
500480,202206,98,58,40,70296.00,48480.00,118776.00
500490,202206,101,46,55,55752.73,66660.95,122413.68
500500,202206,1428,528,900,641155.03,1090804.07,1731959.10
500510,202206,39,33,6,39996.00,7272.00,47268.00
500515,202206,110,76,34,92112.20,41208.20,133320.40
500520,202206,276,143,133,173318.65,161196.00,334514.65
500525,202206,90,49,41,59388.00,49692.00,109080.00
500540,202206,895,399,496,483592.14,601156.09,1084748.23
500560,202206,877,491,386,595097.85,467836.13,1062933.98
500568,202206,994,518,476,631457.30,579337.03,1210794.33
500570,202206,1155,672,483,814472.58,585397.60,1399870.18
500580,202206,314,163,151,197558.88,183012.40,380571.28
500600,202206,351,169,182,204829.35,220585.10,425414.45
500620,202206,934,645,289,782960.83,350268.40,1133229.23
500625,202206,80,64,16,77568.20,19392.00,96960.20
500627,202206,41,18,23,21816.15,27876.00,49692.15
500630,202206,1573,902,671,1095148.42,813254.63,1908403.05
500635,202206,494,297,197,359964.00,239976.00,599940.00
500640,202206,363,199,164,241193.57,198768.90,439962.47
500660,202206,5651,2055,3596,2490680.85,4358365.22,6849046.07
500690,202206,608,223,385,270276.80,469044.04,739320.84
500710,202206,402,200,202,243615.32,244825.00,488440.32
500720,202206,923,503,420,609641.35,509040.95,1118682.30
500730,202206,159,96,63,116356.51,76356.00,192712.51
500740,202206,932,395,537,478742.56,652058.95,1130801.51
500750,202206,176,63,113,76356.20,136956.80,213313.00
500755,202206,115,88,27,107869.80,32724.00,140593.80
500769,202206,729,402,327,487228.66,396326.41,883555.07
500770,202206,406,221,185,267852.33,224220.00,492072.33
500780,202206,132,89,43,107868.81,52116.00,159984.81
500790,202206,1037,507,530,615701.28,642363.98,1258065.26
500793,202206,288,150,138,181800.30,167257.81,349058.11
500795,202206,177,118,59,143016.80,71508.50,214525.30
500797,202206,48,33,15,39996.00,18180.00,58176.00
500800,202206,410,176,234,213313.52,283608.00,496921.52
500830,202206,2228,1204,1024,1460484.92,1241092.61,2701577.53
500840,202206,115,85,30,103021.40,36360.00,139381.40
510010,202206,166,89,77,109080.00,93324.00,202404.00
510020,202206,526,240,286,290882.36,346635.66,637518.02
510025,202206,1688,945,743,1145352.76,904155.53,2049508.29
510030,202206,651,342,309,414513.10,374511.00,789024.10
510035,202206,131,69,62,83628.22,75144.00,158772.22
510040,202206,402,192,210,232704.62,254521.28,487225.90
510050,202206,374,203,171,246040.34,207252.39,453292.73
510060,202206,121,58,63,70296.85,76356.00,146652.85
510080,202206,251,99,152,119988.00,185436.60,305424.60
510100,202206,65,26,39,31512.00,47268.00,78780.00
510120,202206,32,19,13,23028.00,15756.20,38784.20
510125,202206,380,241,139,292093.57,168468.00,460561.57
510130,202206,532,321,211,389056.46,255733.45,644789.91
510140,202206,447,144,303,174529.10,367236.93,541766.03
510160,202206,109,40,69,48480.20,83628.86,132109.06
510170,202206,746,449,297,544191.41,359965.71,904157.12
510180,202206,2860,1319,1541,1598648.07,1868918.52,3467566.59
510185,202206,25,12,13,14544.00,15756.00,30300.00
510190,202206,232,76,156,92112.18,189072.58,281184.76
510250,202206,2652,1652,1000,2003465.46,1214428.81,3217894.27
510260,202206,164,117,47,141804.34,56964.00,198768.34
510263,202206,475,267,208,323605.38,252098.52,575703.90
510267,202206,608,330,278,399965.32,336936.89,736902.21
510268,202206,63,30,33,36360.30,39996.00,76356.30
510269,202206,76,35,41,42420.00,49692.20,92112.20
510270,202206,371,181,190,219372.56,230280.00,449652.56
510279,202206,199,153,46,186649.10,55752.00,242401.10
510285,202206,178,71,107,86052.05,129684.00,215736.05
510300,202206,513,268,245,324818.07,296940.50,621758.57
510305,202206,197,91,106,110292.55,130896.00,241188.55
510310,202206,102,52,50,63024.00,60600.00,123624.00
510320,202206,804,500,304,607217.44,370872.30,978089.74
510325,202206,430,180,250,218161.30,303001.45,521162.75
510330,202206,419,234,185,283609.72,225433.22,509042.94
510335,202206,656,388,268,470261.25,324816.80,795078.05
510336,202206,50,34,16,41208.20,19392.23,60600.43
510337,202206,102,47,55,56964.00,66660.00,123624.00
510340,202206,17635,7767,9868,9417371.94,11966181.58,21383553.52
510343,202206,61,49,12,59388.20,14544.00,73932.20
510345,202206,150,90,60,109080.56,72720.60,181801.16
510350,202206,636,340,296,412083.50,358753.10,770836.60
510360,202206,223,139,84,168468.20,101808.00,270276.20
510370,202206,154,71,83,86052.00,100596.00,186648.00
510380,202206,78,57,21,69084.52,25452.00,94536.52
510385,202206,60,28,32,33936.00,38784.00,72720.00
510390,202206,99,49,50,59388.00,60600.37,119988.37
510395,202206,53,37,16,44844.00,19392.00,64236.00
510410,202206,746,469,277,569649.34,335724.96,905374.30
510420,202206,548,266,282,322392.40,342996.00,665388.40
510450,202206,49,26,23,31512.00,27876.00,59388.00
510452,202206,56,26,30,31512.00,36360.00,67872.00
510454,202206,53,25,28,30300.20,33936.08,64236.28
510455,202206,122,70,52,84840.00,63024.00,147864.00
510460,202206,184,82,102,99384.20,123624.00,223008.20
510480,202206,714,426,288,517530.04,350270.36,867800.40
510490,202206,337,163,174,197556.00,210888.00,408444.00
510500,202206,228,168,60,203616.00,72720.00,276336.00
510510,202206,815,476,339,576917.02,410869.72,987786.74
510515,202206,1247,644,603,781742.52,730837.84,1512580.36
510517,202206,266,119,147,144229.46,178164.90,322394.36
510520,202206,215,139,76,168469.71,92112.00,260581.71
510523,202206,115,90,25,109080.00,30300.00,139380.00
510525,202206,866,529,337,641153.74,408445.23,1049598.97
510530,202206,20,13,7,15756.00,8484.00,24240.00
510550,202206,236,108,128,131906.20,155137.00,287043.20
510558,202206,304,147,157,178165.40,190284.00,368449.40
510560,202206,372,210,162,254521.92,197557.54,452079.46
510562,202206,652,466,186,564798.52,225432.53,790231.05
510590,202206,700,346,354,419354.44,429048.08,848402.52
510600,202206,222,116,106,140593.67,128472.00,269065.67
510610,202206,221,97,124,117564.13,150288.50,267852.63
510615,202206,199,97,102,117564.38,123624.00,241188.38
510617,202206,25,12,13,14544.00,15756.00,30300.00
510618,202206,122,54,68,65448.00,82416.99,147864.99
510619,202206,85,59,26,71508.00,31512.00,103020.00
510620,202206,159,89,70,107868.00,84840.00,192708.00
510621,202206,171,108,63,130896.94,76356.23,207253.17
510622,202206,477,261,216,316339.37,261794.69,578134.06
510623,202206,285,192,93,232704.86,112716.00,345420.86
510624,202206,83,43,40,52116.75,48480.20,100596.95
510625,202206,515,320,195,387844.06,236341.77,624185.83
510626,202206,112,68,44,82416.48,53328.85,135745.33
510627,202206,89,62,27,75145.10,32724.00,107869.10
510628,202206,159,95,64,115140.25,77568.00,192708.25
510629,202206,278,165,113,201192.20,136977.81,338170.01
510630,202206,426,214,212,259369.12,259368.70,518737.82
510631,202206,19,9,10,10908.00,12120.00,23028.00
510637,202206,348,200,148,242400.45,180588.50,422988.95
510642,202206,1074,579,495,702970.75,599944.99,1302915.74
510645,202206,8,1,7,1212.00,8484.00,9696.00
510650,202206,1297,852,445,1032639.20,539342.70,1571981.90
510665,202206,86,38,48,46056.00,58176.00,104232.00
510670,202206,55,32,23,38784.00,27876.00,66660.00
510675,202206,1081,693,388,839923.99,471471.84,1311395.83
510677,202206,349,182,167,220584.89,202404.58,422989.47
510680,202206,87,55,32,66660.80,38784.00,105444.80
510682,202206,186,96,90,116352.52,109080.00,225432.52
510685,202206,54,40,14,48480.00,16968.00,65448.00
510700,202206,565,322,243,390269.53,294516.83,684786.36
510704,202206,1178,603,575,730847.91,698119.26,1428967.17
510706,202206,144,77,67,93324.88,81204.97,174529.85
510710,202206,421,289,132,350269.84,159984.60,510254.44
510715,202206,57,39,18,47268.00,21816.00,69084.00
510718,202206,232,109,123,132108.85,150289.20,282398.05
510719,202206,44,17,27,20604.00,32724.00,53328.00
510720,202206,178,126,52,152712.10,63024.00,215736.10
510724,202206,78,30,48,36360.00,58176.00,94536.00
510726,202206,64,29,35,35148.00,42420.00,77568.00
510729,202206,15,6,9,7272.00,10908.10,18180.10
510730,202206,443,238,205,288457.03,248460.00,536917.03
510735,202206,114,46,68,55752.00,82416.00,138168.00
510740,202206,22,12,10,14544.24,12120.20,26664.44
510757,202206,26,21,5,25452.00,6060.00,31512.00
510760,202206,7388,3768,3620,4570515.43,4394732.55,8965247.98
510770,202206,683,322,361,390266.40,438744.86,829011.26
510774,202206,17,7,10,8484.00,12120.00,20604.00
510775,202206,115,88,27,106656.00,32724.00,139380.00
510776,202206,38,11,27,13332.15,32724.80,46056.95
510777,202206,192,80,112,96960.00,135744.00,232704.00
510779,202206,36,22,14,26664.00,16968.00,43632.00
510780,202206,267,143,124,173317.82,150288.30,323606.12
510785,202206,346,192,154,232705.89,187860.00,420565.89
510787,202206,192,93,99,112716.30,119989.44,232705.74
510788,202206,6,1,5,1212.00,6060.00,7272.00
510790,202206,2592,1332,1260,1615670.46,1530759.46,3146429.92
510792,202206,1088,603,485,732054.82,587824.61,1319879.43
510794,202206,108,59,49,71508.00,59388.00,130896.00
510795,202206,2248,1309,939,1590160.07,1139283.61,2729443.68
510800,202206,188,112,76,135744.57,92112.14,227856.71
510805,202206,196,129,67,156348.57,82416.20,238764.77
510810,202206,99,41,58,49692.65,70296.00,119988.65
510820,202206,235,119,116,144230.75,140593.64,284824.39
510830,202206,75,39,36,47269.44,43632.00,90901.44
510835,202206,19,13,6,15756.00,7272.00,23028.00
510840,202206,9074,4230,4844,5126845.43,5874606.32,11001451.75
510850,202206,204,85,119,103021.09,145440.71,248461.80
510860,202206,404,195,209,236341.20,253309.10,489650.30
510880,202206,71,49,22,59388.00,26664.00,86052.00
510885,202206,71,42,29,50904.45,35148.00,86052.45
510890,202206,71,38,33,46056.20,39996.00,86052.20
510895,202206,167,98,69,118777.37,83628.00,202405.37
520005,202206,145,57,88,69084.70,106656.00,175740.70
520010,202206,282,121,161,146652.09,195133.35,341785.44
520013,202206,740,504,236,610854.88,286034.40,896889.28
520015,202206,42,30,12,36360.00,14544.00,50904.00
520017,202206,86,52,34,63024.00,41208.00,104232.00
520020,202206,13,6,7,7272.00,8484.00,15756.00
520025,202206,2682,1410,1272,1708947.94,1542896.95,3251844.89
520030,202206,774,418,356,506923.52,431472.33,938395.85
520050,202206,63,46,17,55752.00,20604.00,76356.00
520055,202206,72,47,25,56964.00,30300.00,87264.00
520060,202206,174,111,63,134534.40,76357.88,210892.28
520080,202206,582,422,160,511466.89,193920.54,705387.43
520082,202206,15,11,4,13332.00,4848.00,18180.00
520085,202206,94,70,24,84840.80,29088.00,113928.80
520090,202206,82,60,22,72720.00,26664.00,99384.00
520110,202206,8992,3835,5157,4650488.99,6261223.53,10911712.52
520120,202206,9,4,5,4848.00,6060.00,10908.00
520130,202206,791,557,234,675088.56,283609.06,958697.62
520140,202206,11779,6460,5319,7835707.79,6447870.46,14283578.25
520145,202206,53,31,22,37572.80,26664.00,64236.80
520150,202206,147,115,32,139380.30,38784.00,178164.30
520160,202206,42,28,14,33936.00,16968.00,50904.00
520170,202206,223,126,97,152714.51,117567.88,270282.39
520180,202206,181,85,96,103020.20,116352.00,219372.20
520215,202206,202,139,63,168468.30,76356.00,244824.30
520235,202206,83,63,20,76356.00,24240.00,100596.00
520250,202206,135,73,62,88476.88,75144.00,163620.88
520260,202206,115,70,45,84842.08,54540.20,139382.28
520280,202206,44,33,11,39996.00,13332.00,53328.00
520310,202206,47,28,19,33936.00,23028.20,56964.20
520320,202206,172,105,67,127260.20,81204.19,208464.39
520330,202206,810,448,362,542979.33,438744.91,981724.24
520340,202206,364,205,159,249675.67,192708.38,442384.05
520350,202206,481,245,236,296943.25,286032.20,582975.45
520355,202206,93,53,40,64236.57,48480.00,112716.57
520357,202206,30,24,6,29088.00,7272.00,36360.00
520360,202206,2,2,0,2424.00,,2424.00
520380,202206,135,77,58,93324.00,70296.00,163620.00
520390,202206,242,107,135,129684.70,163620.00,293304.70
520393,202206,15,12,3,14544.00,3636.00,18180.00
520396,202206,74,52,22,63024.00,26664.00,89688.00
520400,202206,200,122,78,147866.17,94537.04,242403.21
520410,202206,194,98,96,118777.05,116352.20,235129.25
520420,202206,20,13,7,15756.00,8484.00,24240.00
520425,202206,247,126,121,152712.20,146652.56,299364.76
520430,202206,512,244,268,295728.33,326028.50,621756.83
520440,202206,628,448,180,542981.08,218162.78,761143.86
520450,202206,2073,881,1192,1067784.57,1444708.64,2512493.21
520455,202206,57,33,24,39997.18,29088.00,69085.18
520460,202206,39,23,16,27876.20,19392.00,47268.20
520465,202206,36,30,6,36360.00,7272.00,43632.00
520470,202206,434,273,161,330877.90,195132.00,526009.90
520480,202206,78,47,31,56964.60,37572.00,94536.60
520485,202206,106,42,64,50904.12,77568.10,128472.22
520490,202206,443,330,113,399963.44,136957.00,536920.44
520495,202206,156,92,64,111504.10,77568.90,189073.00
520500,202206,186,148,38,179377.25,46056.00,225433.25
520505,202206,199,115,84,140592.00,101808.00,242400.00
520510,202206,1892,893,999,1082324.33,1212004.63,2294328.96
520520,202206,54,37,17,44844.00,20604.00,65448.00
520530,202206,200,161,39,195133.30,47268.00,242401.30
520540,202206,661,450,211,545402.58,256944.37,802346.95
520545,202206,141,79,62,95750.05,75144.00,170894.05
520547,202206,55,32,23,38784.89,27876.00,66660.89
520549,202206,1378,650,728,787810.68,882341.12,1670151.80
520551,202206,326,172,154,208465.00,186648.00,395113.00
520552,202206,34,25,9,30300.20,10908.00,41208.20
520570,202206,12,9,3,10908.00,3636.00,14544.00
520580,202206,266,165,101,199981.42,122412.07,322393.49
520590,202206,136,76,60,92112.15,72720.20,164832.35
520620,202206,1136,534,602,649638.39,732050.29,1381688.68
520630,202206,43,21,22,25452.00,26664.00,52116.00
520640,202206,372,221,151,267853.01,183013.12,450866.13
520650,202206,63,30,33,36360.00,39996.00,76356.00
520660,202206,40,21,19,25453.26,23028.38,48481.64
520670,202206,44,35,9,42420.23,10908.00,53328.23
520680,202206,29,19,10,23028.00,12120.00,35148.00
520690,202206,38,10,28,12120.00,33936.10,46056.10
520710,202206,33,28,5,33936.00,6060.00,39996.00
520725,202206,193,144,49,174530.39,59388.00,233918.39
520735,202206,59,40,19,48480.00,23028.00,71508.00
520740,202206,466,223,243,270278.87,294516.10,564794.97
520750,202206,33,24,9,29088.00,10908.00,39996.00
520753,202206,75,53,22,64236.00,26664.00,90900.00
520760,202206,98,64,34,77568.40,41208.10,118776.50
520780,202206,260,200,60,242400.96,72720.13,315121.09
520790,202206,150,92,58,111504.00,70296.00,181800.00
520800,202206,3321,1838,1483,2227688.14,1802254.90,4029943.04
520810,202206,136,104,32,126049.86,38784.00,164833.86
520815,202206,5,4,1,4848.00,1212.00,6060.00
520830,202206,141,94,47,113928.60,56964.00,170892.60
520840,202206,386,249,137,303000.16,166044.00,469044.16
520850,202206,104,58,46,70297.00,55752.00,126049.00
520860,202206,1751,1124,627,1364720.39,761138.54,2125858.93
520870,202206,31272,14382,16890,17444482.90,20499879.23,37944362.13
520880,202206,1206,639,567,775692.31,687211.48,1462903.79
520890,202206,808,501,307,607218.48,372085.15,979303.63
520910,202206,973,521,452,632669.98,547825.10,1180495.08
520915,202206,92,71,21,86054.59,25452.00,111506.59
520920,202206,434,207,227,250885.79,275124.70,526010.49
520929,202206,13,11,2,13332.80,2424.00,15756.80
520940,202206,61,44,17,53328.50,20604.10,73932.60
520945,202206,12,8,4,9696.00,4848.00,14544.00
520960,202206,39,23,16,27876.00,19392.00,47268.00
520970,202206,375,221,154,267853.82,187860.00,455713.82
520980,202206,90,64,26,77568.00,31512.00,109080.00
520990,202206,434,308,126,373297.65,152712.00,526009.65
520993,202206,124,63,61,76358.39,73932.30,150290.69
520995,202206,256,142,114,172105.79,138168.00,310273.79
521000,202206,1547,892,655,1081114.91,793864.35,1874979.26
521010,202206,630,333,297,403599.40,359965.62,763565.02
521015,202206,11,7,4,8484.00,4848.00,13332.00
521020,202206,1378,958,420,1161105.27,509044.51,1670149.78
521030,202206,58,40,18,48480.80,21816.00,70296.80
521040,202206,946,624,322,756292.79,391478.13,1147770.92
521056,202206,56,36,20,43632.00,24240.00,67872.00
521060,202206,120,77,43,93324.00,52116.00,145440.00
521080,202206,336,259,77,313916.86,93324.30,407241.16
521090,202206,566,376,190,455714.31,230280.69,685995.00
521100,202206,254,184,70,223008.20,86052.80,309061.00
521120,202206,1043,735,308,890829.28,374509.97,1265339.25
521130,202206,328,238,90,289671.96,109080.60,398752.56
521140,202206,192,108,84,130896.29,101808.81,232705.10
521150,202206,2501,1086,1415,1316244.84,1716202.31,3032447.15
521160,202206,24,10,14,12120.00,16968.00,29088.00
521170,202206,215,114,101,138168.71,122412.00,260580.71
521180,202206,1165,749,416,909008.39,505413.02,1414421.41
521190,202206,2532,1072,1460,1299276.59,1770738.35,3070014.94
521200,202206,53,35,18,42420.00,21816.00,64236.00
521205,202206,9,7,2,8484.00,2424.00,10908.00
521210,202206,122,78,44,94536.91,53328.00,147864.91
521220,202206,728,509,219,616909.10,265428.70,882337.80
521225,202206,22,15,7,18180.20,8484.20,26664.40
521230,202206,101,62,39,75144.00,47268.44,122412.44
521250,202206,6175,3461,2714,4198425.21,3289393.11,7487818.32
521260,202206,34,16,18,19392.00,21816.00,41208.00
521270,202206,131,99,32,119988.00,38784.00,158772.00
521280,202206,407,255,152,309060.81,184224.00,493284.81
521290,202206,28,17,11,20604.20,13332.00,33936.20
521295,202206,103,68,35,82416.00,42420.00,124836.00
521300,202206,221,123,98,149077.38,118776.00,267853.38
521305,202206,37,28,9,33936.11,10908.00,44844.11
521308,202206,990,761,229,923558.93,278761.69,1202320.62
521310,202206,1318,746,572,905377.51,693271.30,1598648.81
521340,202206,21,16,5,19392.00,6060.00,25452.00
521350,202206,114,87,27,105444.00,32724.00,138168.00
521370,202206,158,110,48,133320.00,58176.95,191496.95
521375,202206,188,92,96,111505.15,116352.00,227857.15
521377,202206,50,40,10,48480.00,12120.00,60600.00
521380,202206,1035,625,410,757512.37,496924.58,1254436.95
521385,202206,10,6,4,7272.00,4848.00,12120.00
521390,202206,106,84,22,103020.10,26664.00,129684.10
521400,202206,369,262,107,317548.18,129684.00,447232.18
521405,202206,144,83,61,100596.52,73932.00,174528.52
521410,202206,75,55,20,66660.00,24240.00,90900.00
521440,202206,206,147,59,178167.09,71508.00,249675.09
521450,202206,752,412,340,499347.71,413292.96,912640.67
521460,202206,1072,732,340,887194.04,412082.37,1299276.41
521470,202206,13,9,4,10908.00,4848.00,15756.00
521480,202206,38,26,12,31512.00,14544.60,46056.60
521483,202206,323,202,121,244825.54,146652.00,391477.54
521486,202206,290,192,98,232704.07,118776.84,351480.91
521487,202206,24,11,13,13332.00,15756.00,29088.00
521490,202206,22,13,9,15756.00,10908.00,26664.00
521500,202206,132,58,74,70296.21,89688.52,159984.73
521520,202206,44,33,11,39996.00,13332.00,53328.00
521523,202206,926,533,393,646001.19,476316.59,1122317.78
521525,202206,53,36,17,43632.00,20604.00,64236.00
521530,202206,237,137,100,166044.60,121200.00,287244.60
521540,202206,38,19,19,23028.00,23028.00,46056.00
521550,202206,105,46,59,55752.00,71508.00,127260.00
521560,202206,844,562,282,681151.92,341785.20,1022937.12
521565,202206,67,48,19,58176.96,23028.00,81204.96
521570,202206,523,332,191,403597.74,231492.70,635090.44
521580,202206,51,33,18,39996.00,21816.00,61812.00
521590,202206,31,14,17,16968.00,20604.00,37572.00
521600,202206,26,12,14,14544.00,16968.00,31512.00
521630,202206,227,116,111,140594.32,134536.34,275130.66
521640,202206,296,156,140,189074.37,169680.48,358754.85
521645,202206,37,21,16,25452.00,19392.00,44844.00
521680,202206,244,150,94,181800.20,115140.40,296940.60
521690,202206,12,11,1,13332.00,1212.00,14544.00
521710,202206,1117,528,589,639940.25,713869.19,1353809.44
521720,202206,514,354,160,429049.81,195133.18,624182.99
521730,202206,664,321,343,389055.11,416928.74,805983.85
521740,202206,879,397,482,481167.61,584185.74,1065353.35
521760,202206,2217,1156,1061,1401171.11,1285943.17,2687114.28
521770,202206,807,508,299,615700.41,362388.20,978088.61
521800,202206,1946,1292,654,1565914.51,793860.30,2359774.81
521805,202206,37,19,18,23028.00,21816.00,44844.00
521810,202206,91,53,38,64236.14,46056.40,110292.54
521830,202206,960,691,269,837501.62,326032.95,1163534.57
521839,202206,73,43,30,52116.00,36360.00,88476.00
521850,202206,1114,554,560,671458.97,678725.35,1350184.32
521860,202206,324,205,119,248460.54,144228.00,392688.54
521870,202206,76,46,30,55752.00,36360.00,92112.00
521878,202206,36,14,22,16968.00,26664.10,43632.10
521880,202206,4772,2100,2672,2546442.96,3238478.40,5784921.36
521890,202206,589,400,189,484803.68,229068.00,713871.68
521900,202206,274,216,58,261793.20,70296.00,332089.20
521910,202206,175,121,54,146652.38,65448.00,212100.38
521920,202206,40,23,17,27876.00,20604.00,48480.00
521925,202206,47,29,18,35148.00,21816.00,56964.00
521930,202206,1160,653,507,791442.01,615698.14,1407140.15
521935,202206,31,22,9,26664.00,10908.00,37572.00
521940,202206,231,102,129,123625.02,156348.20,279973.22
521945,202206,16,13,3,15756.00,3636.00,19392.00
521950,202206,15,12,3,14544.00,3636.00,18180.00
521960,202206,64,47,17,56964.00,20604.00,77568.00
521970,202206,398,255,143,309062.77,173316.20,482378.97
521971,202206,111,57,54,69084.00,65448.00,134532.00
521973,202206,41,21,20,25452.20,24240.00,49692.20
521975,202206,1567,806,761,976885.48,922343.15,1899228.63
521980,202206,244,161,83,195132.63,100596.00,295728.63
521990,202206,71,52,19,63024.28,23028.00,86052.28
522000,202206,289,192,97,232282.84,117564.00,349846.84
522005,202206,18,11,7,13332.00,8484.00,21816.00
522010,202206,1107,626,481,758727.33,582974.84,1341702.17
522015,202206,58,37,21,44844.00,25452.00,70296.00
522020,202206,891,534,357,647211.36,433897.94,1081109.30
522026,202206,22,15,7,18180.00,8484.00,26664.00
522028,202206,18,15,3,18180.00,3636.00,21816.00
522040,202206,796,342,454,414509.17,551464.03,965973.20
522045,202206,2565,1535,1030,1860457.99,1249578.36,3110036.35
522050,202206,160,76,84,92113.49,101808.00,193921.49
522060,202206,532,335,197,406020.34,238764.00,644784.34
522068,202206,103,75,28,90900.00,33936.00,124836.00
522070,202206,14,12,2,14544.00,2424.00,16968.00
522100,202206,37,24,13,29088.00,15756.00,44844.00
522108,202206,43,32,11,38784.93,13332.00,52116.93
522119,202206,55,32,23,38784.00,27876.00,66660.00
522130,202206,70,24,46,29088.20,55752.40,84840.60
522140,202206,4073,2157,1916,2614317.02,2327047.27,4941364.29
522145,202206,43,33,10,39996.00,12120.00,52116.00
522150,202206,99,67,32,81204.00,38784.00,119988.00
522155,202206,52,39,13,47268.20,15756.00,63024.20
522157,202206,12,8,4,9696.00,4848.00,14544.00
522160,202206,1639,981,658,1188986.86,797499.14,1986486.00
522170,202206,392,265,127,321181.96,153925.12,475107.08
522180,202206,32,12,20,14544.00,24240.00,38784.00
522185,202206,2296,982,1314,1190196.19,1592586.90,2782783.09
522190,202206,73,42,31,50904.39,37572.00,88476.39
522200,202206,302,178,124,215736.30,150288.00,366024.30
522205,202206,144,99,45,119989.40,54540.10,174529.50
522220,202206,136,102,34,123624.00,41208.00,164832.00
522230,202206,33,30,3,36360.00,3636.00,39996.00
530010,202206,52631,26690,25941,32365718.02,31471097.87,63836815.89
110001,202207,515,420,95,509042.69,115140,624182.69
110002,202207,2813,1801,1012,2185253.84,1227762.91,3413016.75
110003,202207,82,66,16,79992.3,19392,99384.3
110004,202207,2033,1376,657,1668942.53,796288.34,2465230.87
110005,202207,431,341,90,413294.73,109080,522374.73
110006,202207,424,316,108,383600.26,130897.15,514497.41
110007,202207,73,58,15,70296,18180,88476
110008,202207,248,138,110,167256.97,133320.2,300577.17
110009,202207,913,691,222,837493.2,269064.4,1106557.6
110010,202207,1651,963,688,1167165.72,833857.99,2001023.71
110011,202207,1684,1307,377,1585322.37,458143.8,2043466.17
110012,202207,4047,2356,1691,2855493.12,2054350.24,4909843.36
110013,202207,714,560,154,678731.33,186649.84,865381.17
110014,202207,355,315,40,381783.11,48480,430263.11
110015,202207,1330,1045,285,1266550.57,346636.77,1613187.34
110018,202207,1008,626,382,758720.81,462984.59,1221705.40
110020,202207,15918,8988,6930,10898496.65,8406514.48,19305011.13
110025,202207,650,474,176,575702.49,214525.01,790227.50
110026,202207,36,23,13,27877.18,15756,43633.18
110028,202207,1583,1126,457,1364736.43,555103.3,1919839.73
110029,202207,122,110,12,133321.8,14544,147865.8
110030,202207,2386,1576,810,1911150.34,981723.64,2892873.98
110032,202207,309,235,74,284826.52,89689.68,374516.20
110033,202207,636,462,174,561166.11,210890.06,772056.17
110034,202207,319,235,84,284820.56,101809.41,386629.97
110037,202207,84,75,9,90900.2,10908,101808.2
110040,202207,397,276,121,334512.6,146652,481164.6
110045,202207,918,658,260,797506.36,315120.98,1112627.34
110050,202207,86,75,11,90900.57,13332.33,104232.90
110060,202207,62,39,23,47268.95,27876,75144.95
110070,202207,107,69,38,83628.29,46056,129684.29
110080,202207,525,297,228,359967.46,276336.7,636304.16
110090,202207,25,21,4,26664,4848,31512
110092,202207,110,57,53,69084.71,64236,133320.71
110094,202207,194,134,60,162410.09,72720,235130.09
110100,202207,48,33,15,39996.45,18180.54,58176.99
110110,202207,110,65,45,78780.73,54540,133320.73
110120,202207,64,56,8,67872.22,9696.65,77568.87
110130,202207,266,214,52,259370.6,63024.2,322394.8
110140,202207,243,174,69,210889.36,83628.1,294517.46
110143,202207,54,44,10,53328,12120,65448
110145,202207,38,29,9,35148,10908,46056
110146,202207,24,11,13,13332,15756,29088
110147,202207,37,26,11,31512.73,13332,44844.73
110148,202207,33,26,7,31512,8484,39996
110149,202207,302,212,90,256944,109080,366024
110150,202207,138,106,32,128472,38784,167256
110155,202207,10,8,2,9696,2424,12120
110160,202207,66,51,15,61812.87,18180,79992.87
110170,202207,213,159,54,192708.59,65448,258156.59
110175,202207,63,50,13,60600,15756,76356
110180,202207,88,70,18,84840,21816,106656
120001,202207,202,150,52,181803.3,63024.7,244828.0
120005,202207,201,117,84,141805.47,101808.1,243613.57
120010,202207,1143,698,445,845981.92,540553.32,1386535.24
120013,202207,156,106,50,128472,60600.1,189072.1
120017,202207,117,64,53,77568.8,64236,141804.8
120020,202207,3378,2742,636,3324600.2,772056.6,4096656.8
120025,202207,561,311,250,376944.26,303004.37,679948.63
120030,202207,1090,939,151,1138122.27,183020.26,1321142.53
120032,202207,48,42,6,50906.8,7272,58178.8
120033,202207,220,193,27,233924.73,32724.55,266649.28
120034,202207,171,127,44,153924.39,54540,208464.39
120035,202207,47,40,7,48480.8,8484,56964.8
120038,202207,393,251,142,304218.61,172104.96,476323.57
120039,202207,31,29,2,35149.65,2424,37573.65
120040,202207,14211,9576,4635,11609866.17,5619167.5,17229033.67
120042,202207,46,42,4,50906.5,4848.55,55755.05
120043,202207,15,3,12,3636,14544,18180
120045,202207,519,333,186,403606.89,225434.08,629040.97
120050,202207,1265,969,296,1174487.58,359976.21,1534463.79
120060,202207,1453,1218,235,1476274.56,284826.8,1761101.36
120070,202207,401,292,109,353910.42,132108,486018.42
120080,202207,189,122,67,147866.05,82416.65,230282.70
130002,202207,160,115,45,139380,54540,193920
130006,202207,103,68,35,82416,42420,124836
130008,202207,126,72,54,87264,65448,152712
130010,202207,193,132,61,159985.51,73932.8,233918.31
130014,202207,287,202,85,245127.77,103020,348147.77
130020,202207,122,79,43,95748.4,52116,147864.4
130030,202207,938,533,405,646001.26,490861.59,1136862.85
130040,202207,389,187,202,226644.2,244824,471468.2
130050,202207,537,287,250,347845.03,303002.27,650847.30
130060,202207,848,576,272,698112.78,329664,1027776.78
130063,202207,623,384,239,465408,289668,755076
130068,202207,235,156,79,189074.84,95748.56,284823.40
130070,202207,1345,898,447,1089599.89,541767.19,1631367.08
130080,202207,674,451,223,546614.58,270277.46,816892.04
130083,202207,81,51,30,61812.2,36360,98172.2
130090,202207,317,179,138,216948.45,167256,384204.45
130100,202207,1251,603,648,730837.77,786590.45,1517428.22
130110,202207,748,336,412,407232.3,499346.33,906578.63
130115,202207,146,75,71,90900,86052,176952
130120,202207,1633,1028,605,1245942.29,734472.8,1980415.09
130130,202207,606,414,192,501768,232704.1,734472.1
130140,202207,1541,1193,348,1445920.97,421776,1867696.97
130150,202207,388,340,48,412081,58176,470257
130160,202207,435,267,168,323604.7,204828,528432.7
130165,202207,87,73,14,88476.95,16968,105444.95
130170,202207,1008,702,306,850763.5,370877.58,1221641.08
130180,202207,257,188,69,227858.04,83628.2,311486.24
130185,202207,2210,1060,1150,1285951.71,1395023.75,2680975.46
130190,202207,3317,2061,1256,2499169.06,1522281.47,4021450.53
130195,202207,274,214,60,259368,72720,332088
130200,202207,178,91,87,110292,105444,215736
130210,202207,90,44,46,53328,55752,109080
130220,202207,202,141,61,170892.92,76356,247248.92
130230,202207,359,239,120,289668,145440,435108
130240,202207,1326,856,470,1038686.48,570852.2,1609538.68
130250,202207,4702,3034,1668,3679675.35,2025267.98,5704943.33
130255,202207,413,213,200,258156,242400,500556
130260,202207,60572,28288,32284,34303668.21,39162849.88,73466518.09
130270,202207,1506,1029,477,1247261.22,578124.44,1825385.66
130280,202207,135,78,57,94536.2,69084,163620.2
130290,202207,2034,1327,707,1608344.63,856893.37,2465238.00
130300,202207,430,301,129,364816.58,156349.11,521165.69
130310,202207,883,459,424,556308.56,513888.8,1070197.36
130320,202207,549,297,252,359964.9,305424,665388.9
130330,202207,725,458,267,555099.8,323604.2,878704.0
130340,202207,3405,1873,1532,2270107.12,1856803.04,4126910.16
130350,202207,456,314,142,380568,172104,552672
130353,202207,921,416,505,504200.87,614486.23,1118687.10
130356,202207,777,351,426,425413.09,517526.29,942939.38
130360,202207,104,83,21,100596.1,25452,126048.1
130370,202207,682,529,153,641148,185436,826584
130380,202207,632,494,138,598728.6,167256,765984.6
130390,202207,453,367,86,444804.2,104232,549036.2
130395,202207,158,47,111,56964,134533,191497
130400,202207,109,87,22,105448.74,26664,132112.74
130406,202207,2147,1259,888,1525915.71,1076257.71,2602173.42
130410,202207,437,218,219,264216,265428,529644
130420,202207,2712,2200,512,2667660.53,621757.86,3289418.39
130423,202207,238,164,74,198774.99,89688,288462.99
130426,202207,188,102,86,123624,104232,227856
130430,202207,400,228,172,276336,208464,484800
130440,202207,200,68,132,82416.73,159985.7,242402.43
140002,202207,32,7,25,8484,30300.68,38784.68
140005,202207,220,133,87,161197.94,105445,266642.94
140010,202207,11366,6848,4518,8308450.6,5480752.96,13789203.56
140015,202207,153,69,84,83628.36,101808.2,185436.56
140017,202207,130,76,54,92115.66,66661.09,158776.75
140020,202207,428,282,146,341791.44,178165.67,519957.11
140023,202207,55,29,26,35148,31512,66660
140028,202207,23,12,11,14544,13332.72,27876.72
140030,202207,374,243,131,294520.59,158772.2,453292.79
140040,202207,63,43,20,52116,24240,76356
140045,202207,279,100,179,121200.2,218160.9,339361.1
140047,202207,515,332,183,402388.38,221796.79,624185.17
140050,202207,137,87,50,105445.97,60600,166045.97
140060,202207,74,48,26,58176.3,32724.39,90900.69
140070,202207,25,23,2,27876.2,2424,30300.2
150010,202207,4956,2983,1973,3615432.83,2391291.63,6006724.46
150013,202207,164,114,50,138168.2,60600.9,198769.1
150020,202207,1089,594,495,719933.12,599942.08,1319875.20
150030,202207,690,304,386,368454.8,467833.75,836288.55
150034,202207,199,121,78,146653.79,94536.1,241189.89
150040,202207,1619,917,702,1111421.99,850837.15,1962259.14
150050,202207,702,405,297,490863.88,359965.15,850829.03
150060,202207,4839,3027,1812,3668658.67,2196659.56,5865318.23
150070,202207,452,235,217,284822.06,263004.6,547826.66
150080,202207,16758,7812,8946,9470732.71,10842704.48,20313437.19
150085,202207,414,260,154,315126.04,186651.46,501777.50
150090,202207,680,555,125,672663.66,151500.33,824163.99
150095,202207,50,34,16,41209.84,19392.5,60602.34
150100,202207,72,43,29,52116,35148.3,87264.3
150110,202207,217,123,94,149076.38,113928.2,263004.58
150120,202207,389,280,109,339362.36,132108.5,471470.86
150125,202207,46,17,29,20604,35148,55752
150130,202207,2181,1080,1101,1310185.93,1334425.6,2644611.53
150140,202207,58913,25596,33317,31029014.39,40395317.79,71424332.18
150145,202207,246,135,111,163621.62,134532.3,298153.92
150150,202207,3421,1495,1926,1813184.76,2334336.1,4147520.86
150157,202207,368,266,102,322397.24,123624.4,446021.64
150160,202207,136,103,33,124836.03,39996,164832.03
150170,202207,3857,2796,1061,3389997,1285940.13,4675937.13
150172,202207,357,246,111,298153.03,134533.87,432686.90
150175,202207,83,48,35,58176.3,42420,100596.3
150178,202207,768,527,241,638734.84,292094.91,930829.75
150180,202207,3240,1587,1653,1923471.26,2003445.15,3926916.41
150190,202207,374,244,130,295730.62,157560.9,453291.52
150195,202207,116,60,56,72720,67872.3,140592.3
150200,202207,192,92,100,111504,121200.48,232704.48
150210,202207,3173,2477,696,3002163.94,843560.67,3845724.61
150215,202207,619,377,242,456928.26,293311.07,750239.33
150220,202207,3474,2303,1171,2792487.29,1421686.25,4214173.54
150230,202207,1353,1087,266,1319881.53,322393.61,1642275.14
150240,202207,7016,3894,3122,4723248.47,3783915.39,8507163.86
150250,202207,72,41,31,49692.1,37572,87264.1
150260,202207,107,74,33,89688.5,39996,129684.5
150270,202207,2113,1373,740,1665301.78,896886.48,2562188.26
150275,202207,533,340,193,412084.84,233916.84,646001.68
150276,202207,111,40,71,48480,86052,134532
150277,202207,843,376,467,455717.87,566012.81,1021730.68
150280,202207,342,232,110,281185.21,133320,414505.21
150285,202207,147,70,77,84840.57,93130.08,177970.65
150290,202207,1243,699,544,847201.09,659335.44,1506536.53
150293,202207,783,367,416,444812.72,504194.78,949007.50
150295,202207,559,264,295,319974.04,357542.38,677516.42
150300,202207,95,45,50,54540.1,60601,115141.1
150304,202207,193,116,77,140592.2,93324.75,233916.95
150307,202207,437,359,78,435113.98,94536.2,529650.18
150309,202207,597,421,176,510261.77,214528.89,724790.66
150310,202207,272,180,92,218160.96,111504,329664.96
150320,202207,1840,1277,563,1547736.28,682363.23,2230099.51
150330,202207,2061,1183,878,1433806.94,1064138.76,2497945.70
150340,202207,191,123,68,149076,82416,231492
150345,202207,620,344,276,416931.34,334512.92,751444.26
150350,202207,401,318,83,385428.63,100598.41,486027.04
150360,202207,4764,2842,1922,3446982.78,2329483.4,5776466.18
150370,202207,814,560,254,678730.57,307852.36,986582.93
150375,202207,187,81,106,98172,128472.18,226644.18
150380,202207,1516,999,517,1210808.56,626609.75,1837418.31
150390,202207,889,505,384,612069.5,465412.03,1077481.53
150400,202207,106,88,18,106656.2,21816,128472.2
150405,202207,1613,1026,587,1244736.5,711446.91,1956183.41
150410,202207,105,65,40,78780,48480,127260
150420,202207,7669,4097,3572,4967093.5,4330556.25,9297649.75
150430,202207,637,401,236,486028.82,286035.95,772064.77
150440,202207,442,269,173,326033.18,209677.78,535710.96
150442,202207,2401,1259,1142,1527151.29,1384117.58,2911268.87
150445,202207,538,354,184,429051.01,223008,652059.01
150450,202207,219,124,95,150288,115140,265428
150460,202207,700,530,170,642367.18,206040.37,848407.55
150470,202207,1266,753,513,912646.89,621757.38,1534404.27
150475,202207,244,190,54,230283.85,65448.86,295732.71
150480,202207,1402,983,419,1191417.93,507833.21,1699251.14
150490,202207,611,361,250,437533.44,303000,740533.44
150495,202207,328,247,81,299364.13,98172,397536.13
150497,202207,280,182,98,220584.54,119988,340572.54
150500,202207,262,155,107,187862.07,129684.1,317546.17
150503,202207,1317,655,662,793874.46,803561.85,1597436.31
150506,202207,894,611,283,741750.47,342996.92,1084747.39
150510,202207,1335,730,605,884774.63,734474.76,1619249.39
150520,202207,318,217,101,263005.65,122412,385417.65
150530,202207,1941,1089,852,1319905.1,1032662.92,2352568.02
150540,202207,210,155,55,187860.7,66660.56,254521.26
150543,202207,868,453,415,550258.31,502987.55,1053245.86
150548,202207,436,314,122,380569.24,147864,528433.24
150549,202207,83,56,27,67873.11,32724,100597.11
150550,202207,3114,1554,1560,1884677.21,1891941.62,3776618.83
150553,202207,3533,1974,1559,2392569.57,1890747.8,4283317.37
150555,202207,145,76,69,92112.2,83628,175740.2
150560,202207,57,26,31,31512,37572,69084
150563,202207,123,63,60,76357.78,72720.66,149078.44
150565,202207,214,131,83,158772.4,100596,259368.4
150570,202207,415,274,141,332088,170892.1,502980.1
150580,202207,1709,834,875,1010813.35,1061712.5,2072525.85
150590,202207,835,545,290,660548.1,351482.09,1012030.19
150600,202207,514,308,206,374514.92,249677.95,624192.87
150610,202207,160,128,32,155136,38784.5,193920.5
150611,202207,132,82,50,99384,60600,159984
150613,202207,3367,1902,1465,2305269.55,1776879.13,4082148.68
150616,202207,578,318,260,386633.02,315121.59,701754.61
150618,202207,1391,719,672,871431.94,816888.69,1688320.63
150619,202207,399,301,98,364814.05,118776.63,483590.68
150620,202207,1244,716,528,867802.64,641149.77,1508952.41
150630,202207,153,100,53,121204.79,64237.04,185441.83
150635,202207,481,213,268,258158.13,324818.63,582976.76
150640,202207,40,17,23,20604,27876,48480
150650,202207,2450,1411,1039,1711374.28,1259286.55,2970660.83
150655,202207,259,188,71,227856.2,86052,313908.2
150658,202207,72,45,27,54540.2,32724,87264.2
150660,202207,586,378,208,458141.6,253308.01,711449.61
150670,202207,1137,411,726,498135.06,879918.65,1378053.71
150680,202207,10960,5776,5184,7003041.25,6284326.55,13287367.80
150690,202207,32,17,15,20604.49,18180,38784.49
150700,202207,525,346,179,419361.23,216950.26,636311.49
150710,202207,281,164,117,198768.75,141804.6,340573.35
150715,202207,831,519,312,629036.55,378145.05,1007181.60
150720,202207,414,320,94,387842.92,113928.73,501771.65
150730,202207,1074,516,558,625401.4,676302.06,1301703.46
150740,202207,238,154,84,186648.3,101808,288456.3
150745,202207,776,429,347,519956.18,420565.01,940521.19
150746,202207,70,36,34,43632,41208,84840
150747,202207,247,181,66,219374.21,79992.37,299366.58
150750,202207,130,71,59,86053.14,71509.67,157562.81
150760,202207,1842,1197,645,1450778.21,781744.32,2232522.53
150770,202207,405,230,175,278761.64,212100.2,490861.84
150775,202207,97,50,47,60600.2,56964.06,117564.26
150780,202207,203,120,83,145440.79,100596,246036.79
150790,202207,675,387,288,469048.52,349058.68,818107.20
150795,202207,1647,1005,642,1218073.22,778110.36,1996183.58
150796,202207,321,180,141,219372,170892.2,390264.2
150797,202207,398,184,214,223010.38,259368.34,482378.72
150800,202207,1595,883,712,1070200.32,862944.5,1933144.82
150803,202207,503,392,111,475108.88,134532.1,609640.98
150805,202207,207,123,84,149077.39,101808.84,250886.23
150808,202207,1049,537,512,650846.57,620545.94,1271392.51
150810,202207,3132,2110,1022,2558564.2,1241092.07,3799656.27
150812,202207,518,266,252,322394.21,305425.29,627819.50
150815,202207,1160,732,428,887187.91,518737.66,1405925.57
150820,202207,1569,940,629,1139308.66,762364.33,1901672.99
150830,202207,550,409,141,496927.09,172105.1,669032.19
150835,202207,238,141,97,170892.13,117564.74,288456.87
150840,202207,1423,832,591,1008397.77,716299.62,1724697.39
160005,202207,64,44,20,53328.39,24240.12,77568.51
160010,202207,195,124,71,150289.86,86052.37,236342.23
160015,202207,182,126,56,152719.19,67872.63,220591.82
160020,202207,135,69,66,83630.1,79992.87,163622.97
160021,202207,64,27,37,32725.46,44844.12,77569.58
160023,202207,67,39,28,47268.54,33936.3,81204.84
160025,202207,23,11,12,13332.52,14544.12,27876.64
160027,202207,1477,825,652,999925.02,790228.31,1790153.33
160030,202207,16929,8662,8267,10500989.02,10023363.43,20524352.45
160040,202207,312,192,120,232707.53,145440.96,378148.49
160050,202207,727,347,380,420573.85,460565.51,881139.36
160053,202207,300,177,123,214527.52,149076.52,363604.04
160055,202207,23,15,8,18180.32,9697.47,27877.79
160060,202207,6730,3612,3118,4377834.37,3781488.83,8159323.20
160070,202207,190,110,80,133320.32,96961.13,230281.45
160080,202207,128,67,61,81204.84,73932.02,155136.86
170025,202207,26,15,11,18180,13332.2,31512.2
170030,202207,167,134,33,162409.92,39996,202405.92
170035,202207,202,97,105,117565.2,127261.26,244826.46
170040,202207,178,130,48,157560,58176.1,215736.1
170070,202207,321,205,116,249675.99,140593.13,390269.12
170100,202207,343,251,92,304217.59,111505.56,415723.15
170105,202207,43,37,6,44844.1,7272.1,52116.2
170110,202207,114,69,45,83628.6,54540.1,138168.7
170130,202207,74,38,36,46056,43632,89688
170190,202207,98,59,39,71508.32,47268,118776.32
170200,202207,333,230,103,278761.66,126048,404809.66
170210,202207,6520,3519,3001,4264783.94,3638450.09,7903234.03
170215,202207,137,71,66,86052,79994.05,166046.05
170220,202207,1316,945,371,1145353.75,450868.03,1596221.78
170230,202207,139,92,47,111504.49,56964.69,168469.18
170240,202207,501,342,159,414512.08,192709.39,607221.47
170255,202207,989,795,194,963548.08,235128.4,1198676.48
170270,202207,42,30,12,36360,14544,50904
170290,202207,133,82,51,99384.6,61812,161196.6
170300,202207,110,69,41,83628.2,49692,133320.2
170305,202207,48,37,11,44844,13332,58176
170307,202207,57,45,12,54540.8,14544,69084.8
170310,202207,119,72,47,87264.26,56964,144228.26
170320,202207,30,18,12,21816,14544,36360
170330,202207,31,23,8,27876.2,9696.1,37572.3
170360,202207,31,18,13,23028.2,15757.07,38785.27
170370,202207,76,39,37,47269.48,44844,92113.48
170380,202207,75,57,18,69084,21816,90900
170382,202207,37,32,5,38784,6060,44844
170384,202207,141,108,33,130896.94,39996.2,170893.14
170386,202207,67,28,39,33936,47268,81204
170388,202207,46,20,26,24240,31512.96,55752.96
170389,202207,23,20,3,24240.4,3636,27876.4
170390,202207,73,44,29,53328,35148,88476
170410,202207,24,22,2,26664,2424,29088
170460,202207,15,9,6,10908.2,7272.2,18180.4
170510,202207,33,24,9,29088.1,10908,39996.1
170550,202207,1553,907,646,1100509.63,782959.32,1883468.95
170555,202207,104,78,26,94539.21,31512,126051.21
170560,202207,102,72,30,87264,36360.7,123624.7
170600,202207,40,13,27,15756.2,32724,48480.2
170610,202207,177,97,80,117566.65,96960.2,214526.85
170625,202207,33,20,13,24240,15756,39996
170650,202207,93,65,28,78780,33936.2,112716.2
170700,202207,568,419,149,507830.25,180588,688418.25
170710,202207,147,91,56,110293.86,67872.56,178166.42
170720,202207,108,82,26,99384.2,31512.2,130896.4
170730,202207,96,58,38,70296,46056,116352
170740,202207,85,60,25,72720.1,30300,103020.1
170755,202207,51,28,23,33937.8,27876.1,61813.9
170765,202207,127,73,54,88477.14,65448,153925.14
170770,202207,194,126,68,152712.2,82416,235128.2
170820,202207,586,385,201,466624.43,243614.29,710238.72
170825,202207,46,27,19,32724.2,23028,55752.2
170830,202207,88,70,18,84840.8,21816,106656.8
170900,202207,171,133,38,161197.15,46056,207253.15
170930,202207,958,523,435,633883.93,527225.1,1161109.03
170950,202207,3192,1512,1680,1832564.63,2036171.71,3868736.34
170980,202207,17,10,7,12120.8,8484,20604.8
171050,202207,144,111,33,134532,39996,174528
171070,202207,54,46,8,55752.57,9696.46,65449.03
171090,202207,46,34,12,41208,14544,55752
171110,202207,24,18,6,21816.75,7272,29088.75
171150,202207,40,23,17,27876,20604,48480
171180,202207,24,9,15,10908.2,18180.2,29088.4
171190,202207,174,99,75,119988.2,90900,210888.2
171195,202207,60,50,10,60600.52,12120,72720.52
171200,202207,32,14,18,16968,21816,38784
171215,202207,9,7,2,8484,2424,10908
171240,202207,60,43,17,52116,20604,72720
171245,202207,52,45,7,54542.42,8484.77,63027.19
171250,202207,75,43,32,52116.3,38784,90900.3
171270,202207,12,8,4,9696.6,4848.1,14544.7
171280,202207,46,38,8,46058.46,9696.1,55754.56
171320,202207,1001,583,418,706599.85,509041.29,1215641.14
171330,202207,424,213,211,259328.28,255732.1,515060.38
171360,202207,96,69,27,83628,32724,116352
171370,202207,35,18,17,21816,20604.1,42420.1
171380,202207,137,119,18,144228.84,21816,166044.84
171395,202207,42,24,18,29088,21816,50904
171420,202207,257,169,88,204829.47,106656.2,311485.67
171430,202207,73,59,14,71508.15,16968.05,88476.20
171488,202207,202,113,89,136956.14,109080.72,246036.86
171500,202207,59,30,29,36360,35148,71508
171510,202207,75,48,27,58176,32724,90900
171515,202207,37,30,7,36360.05,8484,44844.05
171525,202207,24,22,2,26664.2,2424,29088.2
171550,202207,14,8,6,9696.2,7272,16968.2
171570,202207,56,29,27,35148,32724.1,67872.1
171575,202207,260,174,86,210888.2,104232,315120.2
171610,202207,1806,915,891,1108991.53,1082326.81,2191318.34
171620,202207,140,96,44,116353,53328,169681
171630,202207,49,28,21,33936,25452,59388
171650,202207,335,229,106,277554.11,128472.6,406026.71
171660,202207,253,146,107,176954.58,129684,306638.58
171665,202207,83,51,32,61812.08,38784.94,100597.02
171670,202207,418,258,160,312698.26,193920,506618.26
171700,202207,63,55,8,66660,9696,76356
171720,202207,29,11,18,13332,21816,35148
171750,202207,105,52,53,63024.26,64236.2,127260.46
171780,202207,74,58,16,70296,19392,89688
171790,202207,87,70,17,84840,20604,105444
171800,202207,35,27,8,32724,9696,42420
171820,202207,2045,1188,857,1441081.49,1038687.81,2479769.30
171830,202207,32,24,8,29088.2,9696,38784.2
171840,202207,57,39,18,47268.76,21816,69084.76
171845,202207,29,19,10,23028.16,12120,35148.16
171850,202207,43,36,7,43632.41,8484,52116.41
171855,202207,73,54,19,65448,23028,88476
171865,202207,4,3,1,3636,1212,4848
171870,202207,33,22,11,26664,13332.45,39996.45
171875,202207,82,59,23,71508,27876,99384
171880,202207,42,26,16,31512,19392,50904
171884,202207,56,31,25,37572,30300,67872
171886,202207,132,60,72,72720.2,87264.2,159984.4
171888,202207,25,20,5,24240.17,6060,30300.17
171889,202207,12,6,6,7272,7272,14544
171890,202207,56,47,9,56965.94,10908,67873.94
171900,202207,29,19,10,23028.7,12120,35148.7
172000,202207,33,29,4,35148,4848,39996
172010,202207,53,41,12,49692,14544,64236
172015,202207,21,16,5,19392.52,6060,25452.52
172020,202207,137,85,52,103020.1,63024.1,166044.2
172025,202207,39,25,14,30300,16968,47268
172030,202207,53,33,20,39996.85,24240,64236.85
172049,202207,81,51,30,61812.1,36360,98172.1
172065,202207,108,70,38,84840.2,46056.46,130896.66
172080,202207,116,71,45,86052.14,54540.49,140592.63
172085,202207,31,16,15,19392,18180,37572
172090,202207,432,318,114,385420.29,138168.8,523589.09
172093,202207,14,12,2,14544,2424,16968
172097,202207,17,9,8,10908,9696,20604
172100,202207,5643,3227,2416,3911181.17,2930643.88,6841825.05
172110,202207,81,53,28,64236.2,33936,98172.2
172120,202207,1697,1414,283,1715017.59,342999.13,2058016.72
172125,202207,12,11,1,13332,1212,14544
172130,202207,26,16,10,19392,12120.7,31512.7
172208,202207,197,122,75,147864,90901.07,238765.07
172210,202207,352,180,172,218161.56,208464.43,426625.99
210005,202207,3006,1898,1108,2301636.21,1345341.12,3646977.33
210010,202207,145,94,51,113928.6,61812,175740.6
210015,202207,43,31,12,37572.19,14544,52116.19
210020,202207,370,212,158,256945.37,191496.73,448442.10
210030,202207,307,209,98,253313.27,119989.99,373303.26
210040,202207,130,105,25,127260.1,30300,157560.1
210043,202207,267,216,51,261795.08,61812,323607.08
210047,202207,473,293,180,355117.64,218160,573277.64
210050,202207,265,194,71,235128,86052.55,321180.55
210055,202207,52,42,10,50904.6,12120,63024.6
210060,202207,526,429,97,519955.53,117566.44,637521.97
210070,202207,445,338,107,409656,129684,539340
210080,202207,136,125,11,151500.4,13332,164832.4
210083,202207,284,143,141,173316.2,170892,344208.2
210087,202207,7,6,1,7272,1212,8484
210090,202207,426,302,124,366030.04,150289.87,516319.91
210095,202207,408,319,89,387841.45,107870.17,495711.62
210100,202207,686,546,140,661754.43,169680.2,831434.63
210110,202207,118,81,37,98173.66,44844,143017.66
210120,202207,4867,3866,1001,4685704.8,1213221.5,5898926.3
210125,202207,175,111,64,134532,77568.85,212100.85
210130,202207,441,263,178,318758.67,215736.2,534494.87
210135,202207,27,20,7,24240,8484,32724
210140,202207,4412,3398,1014,4118442.99,1228977.74,5347420.73
210150,202207,361,228,133,276340.88,161197.38,437538.26
210160,202207,3176,2707,469,3280937.06,569643.62,3850580.68
210170,202207,1209,969,240,1174449.32,290880.2,1465329.52
210173,202207,124,113,11,136956.61,13332,150288.61
210177,202207,302,174,128,210889.74,155136,366025.74
210180,202207,29,16,13,19392.2,15756,35148.2
210190,202207,430,295,135,357540,163620.7,521160.7
210193,202207,7,5,2,6060,2424,8484
210197,202207,67,49,18,59388,21816,81204
210200,202207,585,497,88,602372.38,106656.3,709028.68
210203,202207,207,147,60,178166.53,72720.84,250887.37
210207,202207,348,289,59,351484.09,71508,422992.09
210210,202207,689,641,48,778109.98,59388.6,837498.58
210215,202207,74,65,9,78781.35,10908,89689.35
210220,202207,349,301,48,364815.1,58177.09,422992.19
210230,202207,305,247,58,299366.51,70296,369662.51
210232,202207,1218,867,351,1050812.74,425412.2,1476224.94
210235,202207,182,137,45,166044.91,54540.4,220585.31
210237,202207,41,22,19,26665.09,23028,49693.09
210240,202207,76,66,10,79992,12120,92112
210250,202207,174,150,24,181800.3,29088,210888.3
210255,202207,371,279,92,339364.67,111505.73,450870.40
210260,202207,372,258,114,312696.15,138168,450864.15
210270,202207,600,416,184,504195.21,223008.8,727204.01
210275,202207,97,76,21,92112.32,25452,117564.32
210280,202207,1061,699,362,847196.71,438744.6,1285941.31
210290,202207,500,336,164,407236.63,198768.67,606005.30
210300,202207,4806,3108,1698,3766931.98,2059192.43,5826124.41
210310,202207,116,77,39,93324.39,47268,140592.39
210312,202207,119,84,35,101808.59,42420,144228.59
210315,202207,112,95,17,115140.2,20604,135744.2
210317,202207,135,103,32,124836,38784,163620
210320,202207,2364,2029,335,2459181.11,407233,2866414.11
210325,202207,148,90,58,109081.15,70296.2,179377.35
210330,202207,4109,2413,1696,2924585.55,2055555.39,4980140.94
210340,202207,1189,912,277,1105361.87,335725.39,1441087.26
210350,202207,662,555,107,672662.13,129684,802346.13
210355,202207,142,121,21,146652.2,25452,172104.2
210360,202207,1983,1427,556,1729545.8,673873.64,2403419.44
210370,202207,1197,618,579,749021.15,701749.96,1450771.11
210375,202207,188,92,96,111509.27,116353.1,227862.37
210380,202207,720,562,158,681146.6,191497.63,872644.23
210390,202207,190,160,30,193920.83,36360,230280.83
210400,202207,386,337,49,408450.1,59388,467838.1
210405,202207,1033,734,299,889616.8,363600.97,1253217.77
210407,202207,69,56,13,67872,15756,83628
210408,202207,45,40,5,48480.2,6060,54540.2
210409,202207,325,285,40,345420.56,48480.2,393900.76
210410,202207,438,348,90,421776.9,109080,530856.9
210420,202207,200,165,35,199980.5,42420.49,242400.99
210430,202207,54,40,14,48480,16968,65448
210440,202207,373,253,120,306640.69,145440,452080.69
210450,202207,106,92,14,111506.2,16968,128474.2
210455,202207,234,127,107,153928.69,129684.99,283613.68
210460,202207,306,211,95,255735.2,115140.05,370875.25
210462,202207,67,57,10,69084.38,12120.1,81204.48
210465,202207,131,105,26,127260.21,31512,158772.21
210467,202207,527,395,132,478743.06,159984.42,638727.48
210470,202207,47,40,7,48480,8484,56964
210480,202207,1306,947,359,1147774.93,436323.2,1584098.13
210490,202207,182,130,52,157561.96,63024,220585.96
210500,202207,478,301,177,364818.18,214524.93,579343.11
210510,202207,513,423,90,512676.2,109081.2,621757.4
210515,202207,345,220,125,266640.4,151500.2,418140.6
210520,202207,396,359,37,435109.59,44844,479953.59
210530,202207,9595,4947,4648,5995875.79,5634691.72,11630567.51
210535,202207,120,90,30,109080.6,36360,145440.6
210540,202207,1491,996,495,1207170.37,601154.7,1808325.07
210542,202207,1107,567,540,687214.28,654490.2,1341704.48
210545,202207,25,22,3,26664.2,3636,30300.2
210547,202207,124,108,16,130897.2,19392.31,150289.51
210550,202207,587,416,171,504201.91,207253.21,711455.12
210560,202207,155,134,21,162408.2,25452,187860.2
210565,202207,22,15,7,18180,8484.08,26664.08
210570,202207,1268,1066,202,1292003.71,246036.77,1538040.48
210580,202207,124,108,16,130896,19392,150288
210590,202207,697,582,115,705386.07,139380,844766.07
210592,202207,44,40,4,48480,4848,53328
210594,202207,110,96,14,117564.2,16968.2,134532.4
210596,202207,115,100,15,121200,18180,139380
210598,202207,136,105,31,127260,37572.4,164832.4
210600,202207,294,255,39,309063.78,47268.2,356331.98
210610,202207,242,223,19,271491.82,23028.1,294519.92
210620,202207,43,28,15,33936,18180.2,52116.2
210630,202207,71,68,3,82416.2,3636,86052.2
210632,202207,959,685,274,830222.23,332088,1162310.23
210635,202207,24,21,3,25452,3636,29088
210637,202207,122,89,33,107868.2,39996,147864.2
210640,202207,564,503,61,609636.42,73932,683568.42
210650,202207,384,325,59,393902.36,71508,465410.36
210660,202207,349,278,71,336943.98,86052.2,422996.18
210663,202207,58,46,12,55752.1,14544,70296.1
210667,202207,90,41,49,49692.56,59388.8,109081.36
210670,202207,247,221,26,267853.62,31512,299365.62
210675,202207,477,277,200,336943.33,242402.2,579345.53
210680,202207,220,139,81,168469.41,98172,266641.41
210690,202207,74,68,6,82416.2,7272,89688.2
210700,202207,154,117,37,141804.3,44844,186648.3
210710,202207,226,146,80,176954.09,96960.6,273914.69
210720,202207,130,115,15,139380.13,18180,157560.13
210725,202207,58,50,8,60603.17,9696,70299.17
210730,202207,22,16,6,19392,7272,26664
210735,202207,281,206,75,249672.01,90900,340572.01
210740,202207,509,442,67,535712.41,81204,616916.41
210745,202207,156,117,39,141804.5,47268,189072.5
210750,202207,2482,1300,1182,1575626.48,1432591.78,3008218.26
210760,202207,241,189,52,229068.73,63024,292092.73
210770,202207,239,194,45,235135.97,54541.28,289677.25
210780,202207,398,302,96,366030.85,116352.2,482383.05
210790,202207,183,157,26,190284.4,31512,221796.4
210800,202207,180,132,48,159988.45,58176.55,218165.00
210805,202207,59,53,6,64236,7272,71508
210810,202207,442,360,82,436326.54,99384,535710.54
210820,202207,1933,1623,310,1967106.47,375720.27,2342826.74
210825,202207,144,84,60,101808.6,72720.2,174528.8
210830,202207,679,473,206,573280.15,249672.2,822952.35
210840,202207,199,145,54,175740.2,65448,241188.2
210845,202207,222,170,52,206040.79,63024,269064.79
210850,202207,704,494,210,598738.69,254522.23,853260.92
210860,202207,3331,1974,1357,2394937.1,1644686.47,4039623.57
210870,202207,396,318,78,385423.53,94536.2,479959.73
210880,202207,77,61,16,73933.37,19392,93325.37
210890,202207,312,273,39,330880.76,47268,378148.76
210900,202207,664,429,235,519958.06,284822.73,804780.79
210905,202207,64,38,26,46056.75,31512,77568.75
210910,202207,2081,1568,513,1900434.98,622972.13,2523407.11
210920,202207,147,64,83,77569.28,100596,178165.28
210923,202207,76,62,14,75144.78,16968,92112.78
210927,202207,401,206,195,249673.55,236340,486013.55
210930,202207,70,58,12,70296.2,14544,84840.2
210940,202207,74,59,15,71509.23,18180,89689.23
210945,202207,201,116,85,140594.12,103020,243614.12
210950,202207,502,370,132,448441.01,159984.65,608425.66
210955,202207,89,56,33,67872,39996.2,107868.2
210960,202207,2270,1157,1113,1402292.25,1351380.2,2753672.45
210970,202207,106,91,15,110292.26,18180.9,128473.16
210975,202207,80,75,5,90900.2,6060.36,96960.56
210980,202207,1038,523,515,633880.6,624180.8,1258061.4
210990,202207,4336,3042,1294,3688161.61,1568339.45,5256501.06
211000,202207,1238,1016,222,1231405.1,270277.33,1501682.43
211003,202207,946,690,256,837495.98,310272.4,1147768.38
211010,202207,478,433,45,524797.92,54541.17,579339.09
211020,202207,1334,597,737,723571.89,894460.74,1618032.63
211023,202207,42,37,5,44844,6060,50904
211027,202207,77,58,19,70296,23028,93324
211030,202207,355,254,101,307848.4,122412,430260.4
211040,202207,277,232,45,281185.46,54540,335725.46
211050,202207,1087,747,340,905377.54,412082.49,1317460.03
211060,202207,600,532,68,644800.29,82416.2,727216.49
211065,202207,25,20,5,24241.13,6060.11,30301.24
211070,202207,825,693,132,839934.28,159984.4,999918.68
211080,202207,81,79,2,95748.94,2424,98172.94
211085,202207,60,33,27,39996.2,32724,72720.2
211090,202207,74,63,11,76356.85,13332,89688.85
211100,202207,447,379,68,459353.48,82416.4,541769.88
211102,202207,222,160,62,193920.4,75144,269064.4
211105,202207,211,151,60,183012.65,72720.26,255732.91
211107,202207,124,79,45,95748.4,54540,150288.4
211110,202207,943,636,307,770841.82,372088.79,1142930.61
211120,202207,4915,2575,2340,3120974.48,2836103.36,5957077.84
211125,202207,20,13,7,15756,8484,24240
211130,202207,39857,18965,20892,22988437.59,25327351.35,48315788.94
211140,202207,387,342,45,414511.56,54540,469051.56
211150,202207,1157,814,343,986584.8,415717.41,1402302.21
211153,202207,162,99,63,119988,76356,196344
211157,202207,71,57,14,69084,16968,86052
211160,202207,668,570,98,690847.48,118776.2,809623.68
211163,202207,5,5,0,6060.4,,6060.4
211167,202207,12,11,1,13332,1212,14544
211170,202207,408,305,103,369660.2,124836,494496.2
211172,202207,111,80,31,96961.2,37572,134533.2
211174,202207,18,16,2,19392,2424.6,21816.6
211176,202207,448,324,124,393902,150289.77,544191.77
211178,202207,92,64,28,77568,33936,111504
211180,202207,213,173,40,209676.99,48480.04,258157.03
211190,202207,71,63,8,76356.2,9696,86052.2
211195,202207,33,23,10,27876.98,12120,39996.98
211200,202207,149,128,21,155136.5,25452.64,180589.14
211210,202207,391,298,93,361179.32,112716,473895.32
211220,202207,4185,2500,1685,3031275.16,2042252.02,5073527.18
211223,202207,110,102,8,123624.1,9696,133320.1
211227,202207,55,45,10,54540.2,12120,66660.2
211230,202207,697,576,121,698123.3,146653,844776.3
211240,202207,362,299,63,362389.2,76356,438745.2
211245,202207,174,92,82,111504.24,99384,210888.24
211250,202207,1463,1267,196,1535642.09,238764.9,1774406.99
211260,202207,764,652,112,790225.7,135744,925969.7
211270,202207,1817,1509,308,1828932.38,374508.54,2203440.92
211280,202207,1710,1163,547,1409566.89,662964,2072530.89
211285,202207,206,133,73,161196,89688,250884
211290,202207,726,515,211,624182.57,255732,879914.57
211300,202207,746,602,144,729632.38,174529.35,904161.73
211400,202207,1500,972,528,1178085.34,639937.36,1818022.70
220005,202207,17,16,1,19392,1212,20604
220010,202207,78,66,12,79992.2,15756,95748.2
220020,202207,709,583,126,706601.2,152712.4,859313.6
220025,202207,100,97,3,117565.95,3636,121201.95
220027,202207,50,41,9,49692,10908,60600
220030,202207,119,100,19,121200.91,23028,144228.91
220040,202207,1239,958,281,1161105.36,341786.06,1502891.42
220045,202207,31,21,10,25452.78,12120.4,37573.18
220050,202207,672,558,114,676300.54,138168.59,814469.13
220060,202207,174,153,21,185438.67,25452.35,210891.02
220070,202207,110,95,15,115141.91,18180,133321.91
220080,202207,13,11,2,13332,2424,15756
220090,202207,39,28,11,33936.2,13332,47268.2
220095,202207,2,2,0,2424,,2424.0
220100,202207,21,17,4,20604.2,4848,25452.2
220105,202207,26,24,2,29088.6,2424,31512.6
220110,202207,235,216,19,261792,23028,284820
220115,202207,42,37,5,44844,6060,50904
220117,202207,21,19,2,23028,2424,25452
220120,202207,1459,1125,334,1363506.64,404808.98,1768315.62
220130,202207,26,26,0,31512,,31512.0
220140,202207,88,71,17,86052.2,20605,106657.2
220150,202207,482,363,119,439964.3,144230.21,584194.51
220155,202207,17,16,1,19392,1212,20604
220157,202207,20,17,3,20604.2,3636,24240.2
220160,202207,101,88,13,106656,15756,122412
220170,202207,39,34,5,41208,6060,47268
220173,202207,10,8,2,9696.2,2424,12120.2
220177,202207,13,13,0,15756.18,,15756.18
220180,202207,64,63,1,76356.59,1212,77568.59
220190,202207,1091,948,143,1148982.27,173316.69,1322298.96
220191,202207,42,37,5,44845.51,6060,50905.51
220192,202207,90,84,6,101808.33,7272,109080.33
220194,202207,60,53,7,64236,8484,72720
220196,202207,79,65,14,78781.18,16968,95749.18
220198,202207,1,1,0,1212,,1212.0
220200,202207,401,337,64,408449.45,77568.6,486018.05
220202,202207,35,30,5,36360.2,6060,42420.2
220205,202207,61,53,8,64236,9696,73932
220207,202207,15,15,0,18180,,18180.0
220208,202207,74,46,28,55752.2,33936.2,89688.4
220209,202207,32,27,5,32724,6060,38784
220210,202207,20,16,4,19392,4848,24240
220211,202207,31,29,2,35148.77,2424,37572.77
220213,202207,31,28,3,33936.84,3636,37572.84
220217,202207,40,33,7,39996.83,8484,48480.83
220220,202207,2276,1510,766,1830139.05,928397.02,2758536.07
220225,202207,7,2,5,2424.8,6060,8484.8
220230,202207,971,741,230,898100.29,278764.22,1176864.51
220240,202207,166,146,20,176952.64,24240.32,201192.96
220245,202207,35,32,3,38784.55,3636,42420.55
220250,202207,130,111,19,134535.05,23028,157563.05
220253,202207,49,43,6,52116,7272,59388
220255,202207,43,37,6,44844,7272,52116
220260,202207,698,533,165,647213.3,199980.77,847194.07
220265,202207,9,8,1,9696,1212,10908
220270,202207,821,738,83,896884.99,100596,997480.99
220271,202207,38,29,9,35148.3,10908,46056.3
220272,202207,13,13,0,15756,,15756.0
220273,202207,14,13,1,15756.2,1212,16968.2
220275,202207,64,54,10,65448,12120,77568
220277,202207,26,19,7,23028,8484.7,31512.7
220280,202207,18,12,6,14544,7272,21816
220285,202207,41,39,2,47268,2424,49692
220290,202207,1511,1288,223,1561075.31,270279.32,1831354.63
220300,202207,37,36,1,43632.6,1212,44844.6
220310,202207,329,277,52,335729.97,63025.83,398755.80
220320,202207,435,401,34,487234.46,41208,528442.46
220323,202207,3,1,2,1212.8,2424.2,3637.0
220325,202207,8,7,1,8484,1212,9696
220327,202207,13,13,0,15756,,15756.0
220330,202207,221,155,66,187861.4,79992,267853.4
220335,202207,134,113,21,136957.45,25452,162409.45
220340,202207,46,33,13,39996,15756,55752
220342,202207,54,45,9,54541.42,10908,65449.42
220345,202207,82,70,12,84840.91,14544.36,99385.27
220350,202207,454,395,59,478742.26,71508.35,550250.61
220360,202207,45,32,13,38784,15756,54540
220370,202207,1305,1089,216,1319882.8,261792.94,1581675.74
220375,202207,15,15,0,18180.6,,18180.6
220380,202207,28,20,8,24240.8,9696,33936.8
220385,202207,14,13,1,15756,1212.66,16968.66
220390,202207,2349,1302,1047,1578042.84,1268975.67,2847018.51
220400,202207,36,31,5,37572,6060,43632
220410,202207,22,21,1,25452,1212,26664
220415,202207,13,12,1,14545,1212,15757
220420,202207,123,103,20,124837,24240,149077
220430,202207,133,117,16,141804.25,19392,161196.25
220435,202207,21,16,5,19392.5,6060,25452.5
220440,202207,266,230,36,278765.47,44845.2,323610.67
220450,202207,343,168,175,203620.49,212102.41,415722.90
220455,202207,48,47,1,56964.4,1212,58176.4
220460,202207,23,20,3,24240.6,3636.19,27876.79
220465,202207,66,43,23,52116.2,27876.28,79992.48
220470,202207,229,200,29,242402.54,35148.01,277550.55
220480,202207,68,63,5,76356,6060,82416
220490,202207,85,73,12,88476,14544,103020
220500,202207,115,96,19,116352,23028,139380
220510,202207,361,281,80,340575.77,96960.18,437535.95
220515,202207,22,20,2,24240.35,2424,26664.35
220520,202207,370,327,43,396328.02,52116.99,448445.01
220525,202207,8,3,5,3636,6060,9696
220527,202207,16,13,3,15756,3636,19392
220530,202207,43,22,21,26664,25452.87,52116.87
220535,202207,5,4,1,4848.2,1212,6060.2
220540,202207,88,76,12,92112.86,14544,106656.86
220545,202207,25,16,9,19392.23,10908.1,30300.33
220550,202207,718,562,156,681151.87,189072.9,870224.77
220551,202207,11,9,2,10908,2424,13332
220552,202207,12,12,0,14544,,14544.0
220553,202207,52,47,5,56964.67,6060.2,63024.87
220554,202207,8,5,3,6060.2,3636,9696.2
220555,202207,43,36,7,43632.68,8484,52116.68
220556,202207,38,36,2,43632,2424,46056
220557,202207,58,51,7,61812.6,8484,70296.6
220558,202207,7,3,4,3636,4848,8484
220559,202207,6,6,0,7273.67,,7273.67
220560,202207,76,50,26,60600,31512,92112
220570,202207,712,442,270,535706.71,327242.44,862949.15
220580,202207,536,491,45,595109.24,54541,649650.24
220585,202207,14,11,3,13332.2,3636.2,16968.4
220590,202207,13,12,1,14544,1212,15756
220595,202207,77,58,19,70296.62,23028.1,93324.72
220600,202207,23,16,7,19392,8484,27876
220605,202207,29,25,4,30300,4848,35148
220610,202207,87,73,14,88476,16968.52,105444.52
220620,202207,544,461,83,558736.48,100596.84,659333.32
220630,202207,4,2,2,2424,2424,4848
220635,202207,32,29,3,35148,3636,38784
220640,202207,107,89,18,107868,21816,129684
220650,202207,114,108,6,130896,7272,138168
220660,202207,66,49,17,59389.79,20604.2,79993.99
220665,202207,7,7,0,8484,,8484.0
220667,202207,15,13,2,15756.77,2424,18180.77
220669,202207,32,27,5,32724.2,6060,38784.2
220670,202207,66,52,14,63024,16968,79992
220672,202207,81,59,22,71509.71,26664.2,98173.91
220675,202207,28,21,7,25452.67,8484,33936.67
220680,202207,56,49,7,59388,8484,67872
220690,202207,51,48,3,58176.22,3636,61812.22
220695,202207,26,14,12,16968.34,14544,31512.34
220700,202207,1804,1389,415,1683478.02,504193.44,2187671.46
220710,202207,8,6,2,7272,2424,9696
220720,202207,110,94,16,113928.25,19392,133320.25
220730,202207,21,20,1,24240,1212,25452
220735,202207,5,2,3,2424,3636,6060
220740,202207,48,43,5,52116,6060,58176
220750,202207,114,95,19,115140.2,23029.09,138169.29
220755,202207,16,16,0,19392.77,,19392.77
220760,202207,66,58,8,70296.6,9696,79992.6
220770,202207,5812,3297,2515,3996036.83,3048226.01,7044262.84
220775,202207,11,7,4,8484,4848.8,13332.8
220777,202207,20,19,1,23028,1212,24240
220779,202207,3,1,2,1212,2424,3636
220780,202207,905,766,139,928394.13,168468.78,1096862.91
220785,202207,4,1,3,1212,3636,4848
220790,202207,1175,942,233,1141715.48,282398.88,1424114.36
220793,202207,7,5,2,6060,2424,8484
220795,202207,16,15,1,18180.06,1212,19392.06
220800,202207,4012,3065,947,3715035.79,1147768.4,4862804.19
220810,202207,70,62,8,75144.99,9696,84840.99
220820,202207,244,220,24,266644.09,29089.8,295733.89
220830,202207,1261,1103,158,1336844.18,191496.46,1528340.64
220840,202207,2501,1749,752,2119808.97,911430.14,3031239.11
220850,202207,72,64,8,77568,9696,87264
220855,202207,9,5,4,6060,4848,10908
220860,202207,13,12,1,14544.61,1212,15756.61
220865,202207,29,25,4,30300,4848,35148
220870,202207,85,77,8,93324.6,9696,103020.6
220880,202207,330,271,59,329667.4,71509.05,401176.45
220885,202207,27,26,1,31512.82,1212,32724.82
220887,202207,6,5,1,6060.2,1212,7272.2
220890,202207,85,73,12,88476.99,14544,103020.99
220900,202207,25,13,12,15756,14544,30300
220910,202207,48,38,10,46056.85,12120,58176.85
220915,202207,9,8,1,9696,1212,10908
220920,202207,47,41,6,49693.31,7272,56965.31
220930,202207,48,46,2,55752,2424,58176
220935,202207,14,14,0,16968,,16968.0
220937,202207,35,30,5,36360.6,6060,42420.6
220940,202207,55,50,5,60600,6060,66660
220945,202207,4,3,1,3636,1212,4848
220950,202207,34,26,8,31512.08,9696,41208.08
220955,202207,15,15,0,18180.72,,18180.72
220960,202207,38,35,3,42421,3636,46057
220965,202207,43,39,4,47268,4848,52116
220970,202207,62,52,10,63024,12120,75144
220975,202207,11,10,1,12120.4,1212,13332.4
220980,202207,29,27,2,32724,2424,35148
220985,202207,52,45,7,54540,8484,63024
220987,202207,30,29,1,35150.5,1212.2,36362.7
220990,202207,23,23,0,27876,,27876.0
220995,202207,11,9,2,10908.21,2424,13332.21
220997,202207,59,53,6,64236.2,7272,71508.2
221000,202207,1238,1096,142,1328363.69,172104.36,1500468.05
221005,202207,45,42,3,50904,3636.22,54540.22
221010,202207,26,18,8,21816,9696,31512
221020,202207,38,34,4,41208.76,4848,46056.76
221030,202207,38,31,7,37476.25,8484,45960.25
221035,202207,22,21,1,25452.4,1212,26664.4
221037,202207,14,10,4,12120,4848,16968
221038,202207,26,23,3,27876,3636,31512
221039,202207,25,24,1,29088.11,1212.2,30300.31
221040,202207,263,227,36,275124.66,43632,318756.66
221050,202207,224,188,36,227859.35,43632.2,271491.55
221060,202207,1949,1675,274,2032548.39,333302.35,2365850.74
221062,202207,28,27,1,32724.34,1212,33936.34
221063,202207,19,14,5,16968,6060,23028
221065,202207,72,57,15,69084,18180,87264
221070,202207,143,125,18,151502.29,21816,173318.29
221080,202207,383,326,57,395116.69,69084,464200.69
221090,202207,21,16,5,19393.05,6060,25453.05
221093,202207,43,31,12,37572,14544,52116
221095,202207,4,4,0,4848,,4848.0
221097,202207,13,11,2,13332,2424,15756
221100,202207,26364,15770,10594,19118458.81,12854624.64,31973083.45
221110,202207,1130,868,262,1052030.07,317545.91,1369575.98
221120,202207,556,403,153,488442.09,185436,673878.09
221130,202207,990,800,190,969607.75,232704.14,1202311.89
221135,202207,32,28,4,33936,4848,38784
221140,202207,47,40,7,48480.24,8484,56964.24
221150,202207,10,7,3,8484.18,3636,12120.18
221160,202207,12,12,0,14544.9,,14544.9
221170,202207,20,18,2,21816,2424,24240
230010,202207,156,136,20,164832.11,24240,189072.11
230015,202207,155,127,28,153924.6,33936,187860.6
230020,202207,1712,1387,325,1683483.07,395119.61,2078602.68
230030,202207,1652,1189,463,1442299.02,561159.58,2003458.60
230040,202207,221,175,46,212100,55752,267852
230050,202207,239,168,71,203616,86052.2,289668.2
230060,202207,167,133,34,161196.51,41209.3,202405.81
230070,202207,298,256,42,311486.38,50904,362390.38
230075,202207,890,740,150,896886.13,181801.51,1078687.64
230080,202207,211,177,34,214524,41208.82,255732.82
230090,202207,162,118,44,143016,53328,196344
230100,202207,2543,1420,1123,1723488.21,1361084.38,3084572.59
230110,202207,2989,1887,1102,2287077.8,1335637.87,3622715.67
230120,202207,1127,864,263,1047182.1,318756.87,1365938.97
230125,202207,168,131,37,158772.2,44844,203616.2
230130,202207,492,435,57,527225.84,69084.53,596310.37
230140,202207,213,172,41,208465.16,49692,258157.16
230150,202207,154,118,36,143016.2,43632.2,186648.4
230160,202207,984,805,179,975661.79,219372.68,1195034.47
230170,202207,640,565,75,686005.87,90901.18,776907.05
230180,202207,74,66,8,79992.1,9696,89688.1
230185,202207,411,346,65,419353.65,78780.16,498133.81
230190,202207,2488,1894,594,2295558.68,719930.76,3015489.44
230195,202207,503,433,70,524802.51,84840,609642.51
230200,202207,445,340,105,412084.32,127260.2,539344.52
230205,202207,416,275,141,333300.2,170892,504192.2
230210,202207,1410,1079,331,1307760.32,402385.08,1710145.40
230220,202207,1613,1072,541,1299279.33,656910.96,1956190.29
230230,202207,1013,833,180,1009601.8,218161.54,1227763.34
230240,202207,1940,1678,262,2034969.93,317546.8,2352516.73
230250,202207,1815,1477,338,1790147.8,409660.57,2199808.37
230260,202207,3312,2033,1279,2465220.22,1551362.75,4016582.97
230270,202207,1375,1072,303,1299269.33,367238.1,1666507.43
230280,202207,2830,2143,687,2600984.3,833862.49,3434846.79
230290,202207,355,310,45,375724.72,54541.48,430266.20
230300,202207,512,372,140,450865.7,169680,620545.7
230310,202207,441,339,102,410868.5,123624,534492.5
230320,202207,943,797,146,967186.09,178164.2,1145350.29
230330,202207,315,251,64,304212.31,78780.6,382992.91
230340,202207,445,358,87,433900.16,105444,539344.16
230350,202207,3388,2076,1312,2517358.18,1591365.45,4108723.63
230360,202207,282,230,52,279973.32,63024.69,342998.01
230365,202207,126,101,25,122412.73,30300,152712.73
230370,202207,11252,5546,5706,6726732.52,6919411.12,13646143.64
230380,202207,495,425,70,515104.19,84840.85,599945.04
230390,202207,535,303,232,367238.19,281184.6,648422.79
230393,202207,234,191,43,231492.67,52116.5,283609.17
230395,202207,359,287,72,347847.21,87265.86,435113.07
230400,202207,647,512,135,621760.46,163621.2,785381.66
230410,202207,2800,1735,1065,2104056.92,1290793.87,3394850.79
230420,202207,6611,4375,2236,5306232.5,2711283.4,8017515.9
230423,202207,341,295,46,357540.82,55752,413292.82
230425,202207,486,386,100,467835.6,121201.73,589037.33
230426,202207,116,88,28,106656,33936,140592
230427,202207,73,67,6,81204,7272,88476
230428,202207,1661,821,840,995058.61,1019294.8,2014353.41
230430,202207,467,376,91,455717.17,110293.25,566010.42
230435,202207,963,701,262,849616.6,317544.2,1167160.8
230440,202207,97167,44035,53132,53398933.33,64448778.75,117847712.08
230445,202207,329,225,104,272704.66,126048,398752.66
230450,202207,595,469,126,568428.78,152712,721140.78
230460,202207,100,70,30,84840.3,36360,121200.3
230465,202207,321,259,62,313910.86,75144,389054.86
230470,202207,2050,1596,454,1934363.46,550249.75,2484613.21
230480,202207,151,137,14,166044,16968.56,183012.56
230490,202207,332,260,72,315120.26,87264,402384.26
230495,202207,495,344,151,416934.68,183013.87,599948.55
230500,202207,1111,825,286,999903.58,346633.1,1346536.68
230510,202207,62,43,19,52116,23028,75144
230520,202207,418,318,100,385417.08,122412.62,507829.70
230523,202207,2565,1578,987,1912559.43,1196256.39,3108815.82
230526,202207,255,218,37,264217.1,44844,309061.1
230530,202207,691,504,187,610851.95,226646.11,837498.06
230533,202207,219,198,21,239977.12,25452.2,265429.32
230535,202207,391,293,98,355118.22,118776.35,473894.57
230540,202207,1797,1602,195,1941641.92,237553.49,2179195.41
230550,202207,4096,2605,1491,3158531.45,1807119.81,4965651.26
230560,202207,601,453,148,549042.31,179376.52,728418.83
230565,202207,222,164,58,198768,70296.6,269064.6
230570,202207,300,253,47,306637.14,56964,363601.14
230580,202207,1220,858,362,1039900.24,438747.18,1478647.42
230590,202207,1037,798,239,967085.67,290882.06,1257967.73
230600,202207,269,242,27,294517.77,32724,327241.77
230610,202207,451,333,118,403598.28,143016.43,546614.71
230620,202207,172,146,26,176954.34,31512,208466.34
230625,202207,837,565,272,685999.76,329664.3,1015664.06
230630,202207,1431,1072,359,1301702,435110.82,1736812.82
230640,202207,3964,3258,706,3948752.57,856902.02,4805654.59
230650,202207,497,420,77,509041.57,93324.76,602366.33
230655,202207,723,585,138,709030.08,167257.45,876287.53
230660,202207,353,292,61,353904.98,73933.14,427838.12
230670,202207,470,382,88,462992.03,106656.19,569648.22
230680,202207,214,187,27,226645.73,32724,259369.73
230690,202207,962,806,156,976880.88,189072.9,1165953.78
230700,202207,970,806,164,978094.68,198769.72,1176864.40
230710,202207,665,621,44,752661.2,54540,807201.2
230720,202207,145,124,21,150288,25452.2,175740.2
230725,202207,259,196,63,237552.96,76356.46,313909.42
230730,202207,12979,6884,6095,8350052.47,7389629.5,15739681.97
230740,202207,696,550,146,666614.26,176952.6,843566.86
230750,202207,834,690,144,836288.98,174528.3,1010817.28
230760,202207,1590,1352,238,1639859.58,288457.75,1928317.33
230763,202207,341,277,64,335726.87,77569.08,413295.95
230765,202207,8430,3899,4531,4726888.43,5495298.73,10222187.16
230770,202207,5137,2574,2563,3119736.25,3110009.53,6229745.78
230780,202207,788,684,104,830224.49,126048.19,956272.68
230790,202207,320,262,58,317544,70296,387840
230800,202207,1179,839,340,1016871.76,412080.4,1428952.16
230810,202207,1434,1249,185,1515023.97,224221.91,1739245.88
230820,202207,380,251,129,304212.8,156348.53,460561.33
230830,202207,964,811,153,982939.51,185436,1168375.51
230835,202207,277,230,47,278761.59,56964.68,335726.27
230837,202207,177,142,35,172104.85,42420.5,214525.35
230840,202207,963,741,222,898095.61,270278.22,1168373.83
230850,202207,1410,1200,210,1455633.44,254523.43,1710156.87
230860,202207,322,244,78,295728,94542.06,390270.06
230870,202207,1891,1596,295,1934370.57,357541.22,2291911.79
230880,202207,81,64,17,77568.88,20604,98172.88
230890,202207,559,494,65,598731.45,78780.19,677511.64
230900,202207,305,227,78,275124.68,95748.88,370873.56
230910,202207,223,172,51,208464.25,61812,270276.25
230920,202207,491,381,110,462986.59,133320,596306.59
230930,202207,1087,749,338,907799.91,409657.97,1317457.88
230940,202207,852,647,205,784173.76,249673.35,1033847.11
230945,202207,550,441,109,534502.13,132113.19,666615.32
230950,202207,432,371,61,449655.74,73933.22,523588.96
230960,202207,2841,1879,962,2277387.78,1165968.66,3443356.44
230970,202207,1821,990,831,1199897.07,1007180.13,2207077.20
230980,202207,206,161,45,195133,54540,249673
230990,202207,140,111,29,134532,35148,169680
231000,202207,204,188,16,227856.1,19392,247248.1
231010,202207,173,120,53,145441.09,64237.05,209678.14
231020,202207,1463,987,476,1196266.28,576921.07,1773187.35
231025,202207,1122,778,344,942953.82,416933.39,1359887.21
231030,202207,1065,867,198,1050809.46,239977.45,1290786.91
231040,202207,169,114,55,138168.8,66660,204828.8
231050,202207,955,826,129,1001129.08,156352.7,1157481.78
231060,202207,163,134,29,162409.47,35148.06,197557.53
231070,202207,1537,1054,483,1277459.86,586610.86,1864070.72
231080,202207,269,237,32,287246.17,38784,326030.17
231085,202207,680,410,270,496927.42,327240.89,824168.31
231090,202207,262,209,53,253309.42,64237.64,317547.06
231095,202207,163,128,35,155136,42420.77,197556.77
231100,202207,175,140,35,169680.24,42420,212100.24
231110,202207,374,312,62,379360.32,75144,454504.32
231120,202207,260,217,43,263004.45,53329.59,316334.04
231123,202207,157,147,10,178165.15,12120,190285.15
231126,202207,331,248,83,300576.46,100596,401172.46
231130,202207,5011,3879,1132,4705057.99,1371999.69,6077057.68
231135,202207,219,191,28,231492.2,33936,265428.2
231140,202207,3107,2223,884,2694308.61,1071415.19,3765723.80
231150,202207,388,363,25,439958.57,30300,470258.57
231160,202207,1252,1019,233,1236253.75,282396.46,1518650.21
231170,202207,540,375,165,454500.82,199980,654480.82
231180,202207,1847,1599,248,1938010.05,300578.24,2238588.29
231190,202207,218,178,40,215736.1,48480,264216.1
231195,202207,229,190,39,231492,47268.6,278760.6
231200,202207,844,677,167,821743.56,203618.52,1025362.08
231210,202207,528,443,85,536919.82,104232.2,641152.02
231220,202207,1073,759,314,923555.89,380568.97,1304124.86
231230,202207,1547,1156,391,1403503.12,473892.43,1877395.55
231240,202207,1579,1065,514,1293215.45,622972.36,1916187.81
231250,202207,95,89,6,107868.17,7272,115140.17
231260,202207,260,175,85,212100.9,103020.37,315121.27
231270,202207,1003,776,227,940527.5,275125.81,1215653.31
231280,202207,75,58,17,70296,20604,90900
231290,202207,8094,4488,3606,5440740.76,4372936.15,9813676.91
231300,202207,594,542,52,656909.8,63024.54,719934.34
231310,202207,797,727,70,881131.43,84841.2,965972.63
231320,202207,596,443,153,536917.08,185436.68,722353.76
231325,202207,102,85,17,103020,20604,123624
231330,202207,1963,1490,473,1805905.08,573282.93,2379188.01
231335,202207,255,223,32,270278.09,38784,309062.09
231340,202207,1873,1289,584,1562285.54,710240.32,2272525.86
231350,202207,1376,1084,292,1315046.27,353915.53,1668961.80
231355,202207,417,343,74,415718.52,89688,505406.52
231360,202207,553,381,172,461775.93,208464.21,670240.14
231370,202207,96,81,15,98172,18180,116352
231375,202207,298,220,78,266640.9,94536.3,361177.2
231380,202207,495,393,102,476316.9,123624,599940.9
231390,202207,202,155,47,187860.29,56964,244824.29
231395,202207,782,474,308,574488.5,373296.5,947785.0
231400,202207,1193,988,205,1197465.5,248464.46,1445929.96
231410,202207,1388,1130,258,1370785.02,312697.35,1683482.37
240010,202207,377,164,213,198772.8,259374.13,458146.93
240020,202207,2301,1870,431,2268905.76,522378.49,2791284.25
240030,202207,116,93,23,112717.94,27876,140593.94
240040,202207,31,30,1,36360,1212,37572
240050,202207,523,450,73,546627.03,88476.1,635103.13
240060,202207,73,67,6,81204.3,7272,88476.3
240070,202207,255,194,61,235128.78,73932.38,309061.16
240080,202207,572,384,188,465418.42,227858.73,693277.15
240090,202207,100,89,11,107868.7,13332,121200.7
240100,202207,1526,1430,96,1733179.58,116353.74,1849533.32
240110,202207,1042,690,352,836300.66,427852.2,1264152.86
240120,202207,149,108,41,130896.77,49692.87,180589.64
240130,202207,275,252,23,305428.56,27876.6,333305.16
240140,202207,90,58,32,70297.39,38785.37,109082.76
240145,202207,723,636,87,770841.25,105444.1,876285.35
240150,202207,27,20,7,24240,8484,32724
240160,202207,40,31,9,37572,10908,48480
240165,202207,39,31,8,37572.35,9696,47268.35
240170,202207,143,99,44,119989.7,53328,173317.7
240180,202207,107,81,26,98174.44,31512,129686.44
240185,202207,52,45,7,54540,8484,63024
240190,202207,14,12,2,14544.53,2424,16968.53
240200,202207,3128,1686,1442,2044664.81,1747713.91,3792378.72
240210,202207,166,126,40,152712,48480,201192
240220,202207,1120,775,345,940534.37,418142.5,1358676.87
240230,202207,825,747,78,906597.18,94537.16,1001134.34
240240,202207,73,48,25,58176,30300.2,88476.2
240250,202207,96,82,14,99384.9,16968,116352.9
240260,202207,1856,1302,554,1580462.67,671453.87,2251916.54
240270,202207,173,149,24,180589.4,29088,209677.4
240280,202207,63,50,13,60600.45,15756,76356.45
240290,202207,41,38,3,46056,3636,49692
240300,202207,167,89,78,107868.6,94536,202404.6
240310,202207,2517,1336,1181,1619260.51,1432602.48,3051862.99
240320,202207,175,160,15,195132,18180,213312
240325,202207,4828,2747,2081,3334285.85,2523422.85,5857708.70
240330,202207,75,71,4,86052.12,4848,90900.12
240340,202207,90,60,30,72720.61,36360.15,109080.76
240350,202207,92,75,17,90900.2,20604,111504.2
240360,202207,654,399,255,483601.34,309064.36,792665.70
240370,202207,58,50,8,60600.2,9696,70296.2
240375,202207,55,35,20,42420.2,24240.2,66660.4
240380,202207,214,174,40,210892.03,48480.7,259372.73
240390,202207,15,13,2,15756,2424,18180
240400,202207,85,76,9,92112.3,10908,103020.3
240410,202207,11,7,4,8484,4848,13332
240420,202207,1099,790,309,957498.21,374511.28,1332009.49
240430,202207,257,234,23,283613.97,27876.7,311490.67
240440,202207,131,68,63,82417.49,76356.66,158774.15
240450,202207,253,154,99,186649.3,119989.71,306639.01
240460,202207,77,60,17,72720,20604,93324
240470,202207,214,194,20,235132.16,24240.99,259373.15
240480,202207,16,14,2,16968,2424,19392
240485,202207,79,62,17,75144.8,20604,95748.8
240490,202207,58,51,7,61812,8484,70296
240500,202207,96,73,23,88476,27876,116352
240510,202207,39,29,10,35148.6,12120,47268.6
240520,202207,98,92,6,111504.5,7272.04,118776.54
240530,202207,66,56,10,67872.06,12120,79992.06
240540,202207,89,76,13,92112.1,15756.15,107868.25
240550,202207,12,10,2,12120,2424,14544
240560,202207,386,272,114,329666.68,138168,467834.68
240570,202207,433,272,161,329665.3,195132.2,524797.5
240580,202207,1326,1002,324,1215650.87,393901.15,1609552.02
240590,202207,30,29,1,35148.16,1212,36360.16
240600,202207,97,91,6,110293.69,7272,117565.69
240610,202207,501,409,92,495716.93,111505.9,607222.83
240615,202207,10,9,1,10908,1212,12120
240620,202207,84,80,4,96962.18,4848,101810.18
240630,202207,40,33,7,39996,8484.39,48480.39
240640,202207,30,24,6,29088,7272,36360
240650,202207,239,191,48,231492.81,58176.2,289669.01
240660,202207,110,94,16,113928.4,19392.2,133320.6
240670,202207,305,165,140,199985.65,169681.59,369667.24
240680,202207,54,41,13,49692,15756.1,65448.1
240690,202207,49,47,2,56964,2424,59388
240700,202207,174,139,35,168468,42420.2,210888.2
240710,202207,2197,1301,896,1576844.08,1087177.9,2664021.98
240720,202207,1065,752,313,911438.22,379358.05,1290796.27
240725,202207,70,64,6,77568.42,7272,84840.42
240730,202207,147,123,24,149076,29088,178164
240740,202207,228,192,36,232707.79,43632.2,276339.99
240750,202207,51,31,20,37572,24240,61812
240760,202207,57,46,11,55752,13332,69084
240770,202207,145,112,33,135745.07,39996.71,175741.78
240780,202207,711,587,124,711452.39,150289.16,861741.55
240790,202207,40,38,2,46056.71,2424,48480.71
240800,202207,9634,6476,3158,7852791.29,3828808.83,11681600.12
240810,202207,21442,11258,10184,13649887.28,12350465.43,26000352.71
240820,202207,249,142,107,172107.4,130897.24,303004.64
240830,202207,1597,1312,285,1591383.87,345422.72,1936806.59
240840,202207,72,63,9,76356.8,10908,87264.8
240850,202207,86,75,11,90900,13332,104232
240860,202207,108,103,5,124837.38,6060,130897.38
240870,202207,56,46,10,55752.8,12120,67872.8
240880,202207,32,28,4,33936,4848,38784
240890,202207,1175,651,524,789024.71,636305.13,1425329.84
240895,202207,60,48,12,58176.64,14544,72720.64
240910,202207,168,143,25,173316.43,30300,203616.43
240920,202207,12,11,1,13332.61,1212,14544.61
240930,202207,422,372,50,450874.69,60602.68,511477.37
240933,202207,59,37,22,44844.95,26664,71508.95
240940,202207,2309,2023,286,2451904.06,346636.19,2798540.25
240950,202207,42,37,5,44844,6060,50904
240960,202207,24,20,4,24240,4848.2,29088.2
240970,202207,103,75,28,90900,33936,124836
240980,202207,206,163,43,197556.61,52116.48,249673.09
240990,202207,139,89,50,107868,60600,168468
241000,202207,61,55,6,66661.02,7272,73933.02
241010,202207,82,61,21,73932,25452,99384
241020,202207,109,99,10,119988.6,12120,132108.6
241025,202207,16,9,7,10908.35,8484.5,19392.85
241030,202207,102,82,20,99384,24240,123624
241040,202207,40,31,9,37572,10908,48480
241050,202207,74,68,6,82416,7272,89688
241060,202207,22,18,4,21816,4848,26664
241070,202207,18,18,0,21816.2,,21816.2
241080,202207,57,50,7,60600.2,8484,69084.2
241090,202207,53,38,15,46058.36,18180,64238.36
241100,202207,76,65,11,78780,13332,92112
241105,202207,16,7,9,8484,10909,19393
241110,202207,49,40,9,48480.15,10908,59388.15
241120,202207,1619,1219,400,1477444.25,484802.29,1962246.54
241140,202207,201,166,35,201192.6,42420,243612.6
241142,202207,48,35,13,42420,15756.45,58176.45
241150,202207,1180,1017,163,1232633.72,197557.8,1430191.52
241160,202207,22,17,5,20604,6060,26664
241170,202207,47,40,7,48480,8484,56964
241180,202207,43,31,12,37572,14544,52116
241190,202207,38,35,3,42420.2,3636,46056.2
241200,202207,4388,2298,2090,2785236.2,2534344.97,5319581.17
241210,202207,71,59,12,71508.03,14544,86052.03
241220,202207,1510,963,547,1167177.24,665399.25,1832576.49
241230,202207,244,202,42,244825.09,50904,295729.09
241240,202207,52,38,14,46056,16968,63024
241250,202207,1151,1050,101,1272614.58,122412.91,1395027.49
241255,202207,58,48,10,58177.34,13332,71509.34
241260,202207,710,541,169,656910.76,204828.93,861739.69
241270,202207,65,46,19,55752,23028,78780
241280,202207,95,84,11,101808.2,13332,115140.2
241290,202207,139,104,35,126048.13,42420.37,168468.50
241300,202207,80,55,25,66660.21,30300.5,96960.71
241310,202207,47,32,15,38784.8,18180,56964.8
241320,202207,30,15,15,18180.1,18180,36360.1
241330,202207,56,49,7,59389.6,8484,67873.6
241335,202207,87,77,10,93324.99,12120,105444.99
241340,202207,184,133,51,161196,61812,223008
241350,202207,62,54,8,65448.3,9696,75144.3
241355,202207,52,43,9,52116.72,10908,63024.72
241360,202207,51,47,4,56964,4848,61812
241370,202207,60,48,12,58176,14544,72720
241380,202207,37,33,4,39996.4,4848,44844.4
241390,202207,84,64,20,77568,24240,101808
241400,202207,212,161,51,196010.7,61812,257822.7
241410,202207,180,162,18,196344.73,21816.09,218160.82
241415,202207,102,81,21,98172,25452.8,123624.8
241420,202207,122,82,40,99384.73,48480,147864.73
241430,202207,20,18,2,21816,2424,24240
241440,202207,513,433,80,524804.23,96961.05,621765.28
241445,202207,40,34,6,41208,7272.1,48480.1
241450,202207,262,217,45,263007.95,54540.8,317548.75
241460,202207,153,136,17,166044.9,20604,186648.9
241470,202207,35,29,6,35148.6,7272.4,42421.0
241475,202207,52,47,5,56964,6060,63024
241480,202207,128,92,36,111506.82,43632.2,155139.02
241490,202207,13,12,1,14544,1212.1,15756.1
241500,202207,46,36,10,43632.2,12120.02,55752.22
250010,202207,100,84,16,101808.6,19392,121200.6
250020,202207,31,26,5,31512,6060,37572
250030,202207,892,650,242,789021.28,293307.06,1082328.34
250040,202207,395,315,80,381783.69,96960.8,478744.49
250050,202207,280,227,53,275124.19,64236.01,339360.20
250053,202207,60,47,13,56964.2,15756,72720.2
250057,202207,3,2,1,2424.2,1212,3636.2
250060,202207,618,442,176,535711.3,213313.39,749024.69
250070,202207,676,539,137,653279.29,167256.6,820535.89
250073,202207,11,10,1,12120,1212,13332
250077,202207,178,133,45,161197.5,54540,215737.5
250080,202207,414,328,86,397540.18,104233.7,501773.88
250090,202207,225,145,80,175740.79,96960,272700.79
250100,202207,562,456,106,552674.13,128473.8,681147.93
250110,202207,665,483,182,585401.2,220585.42,805986.62
250115,202207,14,4,10,4848,12120.26,16968.26
250120,202207,123,86,37,104232.8,44844.35,149077.15
250130,202207,558,453,105,549043.79,127261.16,676304.95
250135,202207,27,11,16,13332,19392,32724
250140,202207,82,72,10,87264.12,12120,99384.12
250150,202207,619,436,183,528437.9,221796.79,750234.69
250153,202207,11,9,2,10908,2424,13332
250157,202207,30,24,6,29088,7272,36360
250160,202207,239,183,56,221797.64,67872,289669.64
250170,202207,79,51,28,61812,33936,95748
250180,202207,4738,3215,1523,3897885.82,1849548.03,5747433.85
250190,202207,808,536,272,649637.59,329665.18,979302.77
250200,202207,69,54,15,65448,18180,83628
250205,202207,25,20,5,24240,6060,30300
250210,202207,86,74,12,89688.18,14544,104232.18
250215,202207,78,56,22,67872,26664,94536
250220,202207,28,20,8,24240,9696,33936
250230,202207,76,67,9,81204,10908,92112
250240,202207,234,180,54,218162.43,65448,283610.43
250250,202207,375,323,52,391480.4,63024,454504.4
250260,202207,46,37,9,44844,10908,55752
250270,202207,77,54,23,65448,27876,93324
250280,202207,376,304,72,368449.79,87264.2,455713.99
250290,202207,100,89,11,107868,13332,121200
250300,202207,533,359,174,435112.14,210888.33,646000.47
250310,202207,46,43,3,52116,3636,55752
250320,202207,1993,1317,676,1596240.33,819322.45,2415562.78
250330,202207,115,97,18,117565.17,21816.1,139381.27
250340,202207,30,24,6,29088.2,7272,36360.2
250350,202207,193,125,68,151500,82416,233916
250355,202207,35,26,9,31512,10908,42420
250360,202207,187,154,33,186650.69,39997.07,226647.76
250370,202207,2373,1532,841,1856818.72,1019303.99,2876122.71
250375,202207,16,10,6,12120,7272.73,19392.73
250380,202207,55,47,8,56964,9696.9,66660.9
250390,202207,45,35,10,42420.16,12120,54540.16
250400,202207,16785,8386,8399,10170024.45,10189413.82,20359438.27
250403,202207,305,233,72,282396.2,87264,369660.2
250407,202207,66,53,13,64236,15756.85,79992.85
250410,202207,30,26,4,31512.31,4848.8,36361.11
250415,202207,41,24,17,29088,20604,49692
250420,202207,39,32,7,38784,8484,47268
250430,202207,1455,1259,196,1526222.06,237552.89,1763774.95
250435,202207,32,23,9,27876.55,10908,38784.55
250440,202207,663,549,114,665391.21,138168,803559.21
250450,202207,82,62,20,75144.8,24240,99384.8
250460,202207,464,303,161,367238.04,196346.04,563584.08
250470,202207,101,69,32,83628,38784,122412
250480,202207,325,256,69,310276.29,83628,393904.29
250485,202207,6,6,0,7272,,7272.0
250490,202207,243,198,45,239978.28,54540.37,294518.65
250500,202207,96,75,21,90900.55,25452,116352.55
250510,202207,804,634,170,768411.29,206040.65,974451.94
250520,202207,171,112,59,135744,71508,207252
250523,202207,119,97,22,117564,26664,144228
250527,202207,116,87,29,105444.53,35148,140592.53
250530,202207,7,3,4,3636,4848,8484
250535,202207,28,21,7,25452,8484,33936
250540,202207,147,113,34,136956.1,41208,178164.1
250550,202207,68,67,1,81204.13,1212,82416.13
250560,202207,67,41,26,49692.4,31512,81204.4
250570,202207,163,132,31,159984.2,37572.2,197556.4
250580,202207,95,73,22,88554,26664.05,115218.05
250590,202207,23,13,10,15756,12120.6,27876.6
250600,202207,1545,1013,532,1227765.16,645997.07,1873762.23
250610,202207,157,125,32,151503.27,38784.5,190287.77
250620,202207,21,17,4,20604.1,4848,25452.1
250625,202207,68,54,14,65448.43,16968,82416.43
250630,202207,3135,1954,1181,2368519.74,1433815.21,3802334.95
250640,202207,198,154,44,187861.3,53329.5,241190.8
250650,202207,30,19,11,23028,13332.05,36360.05
250660,202207,62,46,16,55752,19392,75144
250670,202207,70,53,17,64236,20604.94,84840.94
250680,202207,415,330,85,399963.47,103020.25,502983.72
250690,202207,2173,1463,710,1773180.92,860528.41,2633709.33
250700,202207,908,769,139,933245.16,168468.2,1101713.36
250710,202207,470,364,106,441177.71,128474.25,569651.96
250720,202207,120,88,32,106656.3,38784,145440.3
250730,202207,412,337,75,408446.12,90901.1,499347.22
250740,202207,64,59,5,71508.48,6060,77568.48
250750,202207,23945,14072,9873,17062779.23,11977190.57,29039969.80
250760,202207,116,93,23,112716,27876,140592
250770,202207,355,234,121,283612.33,146652.7,430265.03
250780,202207,67,45,22,54540,26664,81204
250790,202207,456,279,177,338152.63,214526.4,552679.03
250800,202207,144,130,14,157560,16968,174528
250810,202207,76,62,14,75144,16968,92112
250820,202207,153,126,27,152712.75,32724,185436.75
250830,202207,461,297,164,359967.36,198769.4,558736.76
250840,202207,56,49,7,59388.17,8484.2,67872.37
250850,202207,60,51,9,61812,10908,72720
250855,202207,17,15,2,18180.62,2424,20604.62
250860,202207,248,160,88,193920.24,106656.8,300577.04
250870,202207,30,27,3,32724.8,3636,36360.8
250880,202207,90,68,22,82416.22,26664,109080.22
250890,202207,3149,2312,837,2802183.53,1018088.26,3820271.79
250900,202207,61,51,10,61812.4,12120,73932.4
250905,202207,127,95,32,115140.9,38784,153924.9
250910,202207,1003,730,273,884770.71,330877.15,1215647.86
250915,202207,108,73,35,88476.01,42421.2,130897.21
250920,202207,144,104,40,126048,48480.96,174528.96
250930,202207,184,103,81,124836.2,98172.2,223008.4
250933,202207,10,7,3,8484,3636,12120
250937,202207,15,15,0,18180,,18180.0
250939,202207,34,27,7,32724.2,8484,41208.2
250940,202207,124,91,33,110293.74,39997.06,150290.80
250950,202207,79,56,23,67873.47,27876,95749.47
250960,202207,87,48,39,58177.25,47268.3,105445.55
250970,202207,1265,887,378,1075053.97,459350.83,1534404.80
250980,202207,103,69,34,83628.41,41208,124836.41
250990,202207,166,126,40,152712,48480,201192
251000,202207,80,67,13,81204,15756,96960
251010,202207,129,93,36,112716,43632,156348
251020,202207,81,66,15,79992.68,18180,98172.68
251030,202207,49,34,15,41208,18180,59388
251040,202207,61,40,21,48480,25452,73932
251050,202207,26,21,5,25452,6060,31512
251060,202207,51,40,11,48480.68,13332,61812.68
251065,202207,6,3,3,3636,3636,7272
251070,202207,17,14,3,16968,3636,20604
251080,202207,5400,2511,2889,3043422.23,3502722.7,6546144.93
251090,202207,188,158,30,191496.49,36360.68,227857.17
251100,202207,23,22,1,26664.2,1212,27876.2
251110,202207,62,40,22,48480,26664,75144
251120,202207,1943,1191,752,1443528.87,911437.01,2354965.88
251130,202207,429,353,76,427837.56,92112.05,519949.61
251140,202207,599,382,217,462986.3,263005.47,725991.77
251150,202207,337,279,58,338151.91,70296.22,408448.13
251160,202207,94,75,19,90900.1,23028,113928.1
251170,202207,90,74,16,89688.32,19392,109080.32
251180,202207,287,166,121,201194.44,146653.18,347847.62
251190,202207,192,122,70,149077.18,84840.88,233918.06
251200,202207,282,216,66,261796.8,79992.1,341788.9
251203,202207,32,29,3,35148,3636,38784
251207,202207,83,70,13,84840,15756,100596
251210,202207,1525,1109,416,1345332.38,504194.17,1849526.55
251220,202207,47,37,10,44844.2,12120,56964.2
251230,202207,561,468,93,567219.46,112717.6,679937.06
251240,202207,115,79,36,95748,43632,139380
251250,202207,1503,1064,439,1290692.13,532073.24,1822765.37
251260,202207,11,7,4,8484,4848,13332
251270,202207,308,242,66,293309.26,79993.22,373302.48
251272,202207,63,56,7,67872.4,8484,76356.4
251274,202207,27,21,6,25452,7272,32724
251275,202207,33,19,14,23028,16968,39996
251276,202207,29,22,7,26664.91,8484,35148.91
251278,202207,15,13,2,15756,2424,18180
251280,202207,99,94,5,113928,6060,119988
251290,202207,1012,719,293,871451.29,355122.61,1226573.90
251300,202207,16,11,5,13332,6060,19392
251310,202207,304,217,87,263005.71,105445.2,368450.91
251315,202207,40,36,4,43632,4848.1,48480.1
251320,202207,73,60,13,72720.2,15756.1,88476.3
251330,202207,82,71,11,86052,13332.13,99384.13
251335,202207,22,11,11,13332.3,13332,26664.3
251340,202207,802,454,348,550254.4,421777.46,972031.86
251350,202207,36,34,2,41208,2424,43632
251360,202207,85,74,11,89688,13332,103020
251365,202207,8,7,1,8484.1,1212,9696.1
251370,202207,5809,3923,1886,4754744.72,2285855.7,7040600.42
251380,202207,47,35,12,42420,14544,56964
251385,202207,5,5,0,6060,,6060.0
251390,202207,964,705,259,855685.62,313913.41,1169599.03
251392,202207,32,21,11,25452,13332,38784
251394,202207,12,10,2,12120,2424,14544
251396,202207,13,8,5,9696,6060.2,15756.2
251398,202207,15,12,3,14544,3636,18180
251400,202207,51,40,11,48480,13332,61812
251410,202207,42,35,7,42420.2,8484,50904.2
251420,202207,107,78,29,94536.77,35148.74,129685.51
251430,202207,43,39,4,47268.7,4848,52116.7
251440,202207,53,27,26,32724,31512,64236
251445,202207,66,56,10,67874.04,12120,79994.04
251450,202207,377,325,52,395119.1,63024.8,458143.9
251455,202207,5,4,1,4848,1212,6060
251460,202207,25,18,7,21816,8484,30300
251465,202207,8,5,3,6060,3636,9696
251470,202207,53,38,15,46056,18180,64236
251480,202207,29,24,5,29088,6060,35148
251490,202207,111,66,45,79993.47,54541.1,134534.57
251500,202207,115,95,20,115141.1,24240,139381.1
251510,202207,85,52,33,63024.92,39996,103020.92
251520,202207,38,31,7,37572,8484,46056
251530,202207,4296,3010,1286,3648154.96,1558638.84,5206793.80
251540,202207,90,73,17,89688,20604.65,110292.65
251550,202207,413,310,103,375723.33,124836.27,500559.60
251560,202207,23,17,6,20604.1,7272,27876.1
251570,202207,17,15,2,18180,2424,20604
251580,202207,130,101,29,122412,35148,157560
251590,202207,106,74,32,89688,38784,128472
251593,202207,28,15,13,18180,15756,33936
251597,202207,107,81,26,98172,31512.77,129684.77
251600,202207,1096,760,336,921426.58,407232.7,1328659.28
251610,202207,249,180,69,218160.2,84840,303000.2
251615,202207,16,13,3,15756,3636,19392
251620,202207,4197,2666,1531,3232439.95,1856804.93,5089244.88
251630,202207,469,344,125,416934.33,151501.15,568435.48
251640,202207,123,91,32,110293.15,38784,149077.15
251650,202207,290,211,79,255732.94,95748.2,351481.14
251660,202207,202,175,27,212100.72,32724.8,244825.52
251670,202207,397,305,92,369662.83,111504.96,481167.79
251675,202207,13,9,4,10908,4848,15756
251680,202207,106,90,16,109080,19392,128472
251690,202207,312,257,55,311486.84,66661.12,378147.96
251700,202207,273,237,36,288457.32,43632,332089.32
251710,202207,24,13,11,15756,13332,29088
251720,202207,27,19,8,23028,9696,32724
251740,202207,13,10,3,12120,3636,15756
260005,202207,3633,1907,1726,2312024.69,2093144.67,4405169.36
260010,202207,1724,1277,447,1547742.51,541768.19,2089510.70
260020,202207,413,358,55,433898.53,66660.2,500558.73
260030,202207,614,413,201,500559.09,243612.77,744171.86
260040,202207,807,500,307,606006.1,372087.28,978093.38
260050,202207,1163,833,330,1009610.37,399965.14,1409575.51
260060,202207,366,335,31,406026.97,37572,443598.97
260070,202207,1341,815,526,987800.95,638733.75,1626534.70
260080,202207,733,552,181,669028.95,219372,888400.95
260090,202207,473,305,168,370872.96,203616.95,574489.91
260100,202207,210,146,64,176952.56,77568,254520.56
260105,202207,261,149,112,180589.27,135744,316333.27
260110,202207,2976,2151,825,2608240.85,1001118.56,3609359.41
260120,202207,2747,1466,1281,1777135.36,1555010.46,3332145.82
260130,202207,197,137,60,166044,72720,238764
260140,202207,2244,1442,802,1747727.58,972032.6,2719760.18
260150,202207,192,128,64,155136.2,77568.6,232704.8
260160,202207,347,276,71,334517.21,86052.88,420570.09
260170,202207,3417,2013,1404,2439782.77,1702879.68,4142662.45
260180,202207,180,147,33,178164.96,39996.73,218161.69
260190,202207,2394,1571,823,1904066.37,997480.83,2901547.20
260200,202207,992,770,222,933248.46,269064.99,1202313.45
260210,202207,1382,982,400,1190198.5,484803.49,1675001.99
260220,202207,642,576,66,698121.45,79993.47,778114.92
260230,202207,1276,936,340,1134445.3,412083,1546528.3
260240,202207,206,155,51,187861.53,61813.55,249675.08
260250,202207,99,74,25,89688,30300,119988
260260,202207,1077,750,327,909003.19,396324.99,1305328.18
260270,202207,259,186,73,225434.27,88476.6,313910.87
260280,202207,1136,909,227,1102934.43,275125.98,1378060.41
260290,202207,6980,3738,3242,4531714.56,3931743.29,8463457.85
260300,202207,1003,848,155,1029014.47,187860.75,1216875.22
260310,202207,507,405,102,490862.69,123624,614486.69
260320,202207,827,597,230,723567.14,278760.94,1002328.08
260330,202207,82,62,20,75145,24240.62,99385.62
260340,202207,82,59,23,71508.2,27876,99384.2
260345,202207,5813,2991,2822,3629990.72,3425146.7,7055137.42
260350,202207,482,339,143,410871.46,173316.7,584188.16
260360,202207,245,137,108,166044.4,130897.05,296941.45
260370,202207,742,475,267,576914.73,323605,900519.73
260380,202207,563,402,161,487229.94,195133.05,682362.99
260390,202207,288,247,41,299364.17,49692,349056.17
260392,202207,116,99,17,119988.2,20604.26,140592.46
260400,202207,4455,2528,1927,3065163.67,2335535.61,5400699.28
260410,202207,15431,7961,7470,9653687.39,9058539.55,18712226.94
260415,202207,145,122,23,147865.64,27876,175741.64
260420,202207,1749,1078,671,1306551.53,813253.24,2119804.77
260430,202207,171,153,18,185437.73,21816.2,207253.93
260440,202207,200,133,67,161198.36,81204.16,242402.52
260450,202207,413,310,103,375725.78,124836,500561.78
260460,202207,846,439,407,533287.18,493287.08,1026574.26
260470,202207,341,205,136,248466.08,164833.28,413299.36
260480,202207,253,159,94,192708,113928,306636
260490,202207,225,177,48,214524,58176,272700
260500,202207,1143,760,383,922343.51,464198.93,1386542.44
260510,202207,823,650,173,787804.7,210888.38,998693.08
260515,202207,230,209,21,253309.32,25452.91,278762.23
260520,202207,3226,1973,1253,2393655.91,1522282.74,3915938.65
260530,202207,827,671,156,813262.69,189072.1,1002334.79
260540,202207,535,423,112,512679.64,136956.8,649636.44
260545,202207,19,11,8,13332.64,9696,23028.64
260550,202207,338,215,123,260581.2,149076,409657.2
260560,202207,513,387,126,469049.68,152714.31,621763.99
260570,202207,1013,805,208,976888.59,252097.08,1228985.67
260580,202207,339,273,66,332088,81204.83,413292.83
260590,202207,626,360,266,436320.87,322392.2,758713.07
260600,202207,7859,4526,3333,5485573.33,4043257.61,9528830.94
260610,202207,494,328,166,397538.82,201193.67,598732.49
260620,202207,3807,1954,1853,2368277.7,2247079.42,4615357.12
260630,202207,82,74,8,89688,9696,99384
260640,202207,3407,2000,1407,2426440.43,1708925.26,4135365.69
260650,202207,314,225,89,272701.74,107869.2,380570.94
260660,202207,582,373,209,452081.71,255732.44,707814.15
260670,202207,104,76,28,92112,33936.12,126048.12
260680,202207,4049,2184,1865,2648272.08,2261627.07,4909899.15
260690,202207,128,95,33,115140.74,39996,155136.74
260700,202207,309,205,104,248462.17,126048,374510.17
260710,202207,48,41,7,49692,8484,58176
260720,202207,2707,1573,1134,1907701.28,1375625.44,3283326.72
260730,202207,735,540,195,654485.04,236340,890825.04
260740,202207,75,60,15,72720,18180,90900
260750,202207,562,414,148,501775.13,180589.02,682364.15
260760,202207,739,360,379,436331.09,459355.41,895686.50
260765,202207,1015,519,496,629038.07,601158.6,1230196.67
260770,202207,211,153,58,185417.59,70296.74,255714.33
260775,202207,808,425,383,515109.81,464201.91,979311.72
260780,202207,237,147,90,178164.2,109080.6,287244.8
260790,202207,15729,7652,8077,9276792.36,9791811.32,19068603.68
260795,202207,158,103,55,124836.62,66660,191496.62
260800,202207,301,244,57,295728.5,69084.96,364813.46
260805,202207,172,113,59,136956,71508.7,208464.7
260810,202207,830,671,159,813255.08,192708.8,1005963.88
260820,202207,302,197,105,238765.09,127260,366025.09
260825,202207,214,143,71,173316,86052,259368
260830,202207,290,187,103,226644,124836,351480
260840,202207,272,192,80,232704.88,96960.1,329664.98
260845,202207,188,116,72,140592,87264.1,227856.1
260850,202207,413,310,103,375722,124836,500558
260860,202207,247,187,60,226646.44,72720,299366.44
260870,202207,351,268,83,324818.52,100596.71,425415.23
260875,202207,743,538,205,652070.4,248460.93,900531.33
260880,202207,1572,1044,528,1265342.55,639936.3,1905278.85
260890,202207,2431,1671,760,2025269.14,921128.74,2946397.88
260900,202207,1006,730,276,884766.58,334512,1219278.58
260910,202207,250,195,55,236341,66660,303001
260915,202207,276,205,71,248460,86052,334512
260920,202207,211,110,101,133320,122412,255732
260930,202207,350,294,56,356331.4,67872.86,424204.26
260940,202207,2600,1381,1219,1675010.15,1479865.81,3154875.96
260950,202207,2018,1145,873,1388973.57,1059300.78,2448274.35
260960,202207,14010,6740,7270,8172695.92,8812543.89,16985239.81
260970,202207,425,345,80,418142.39,96960.87,515103.26
260980,202207,207,188,19,227858.38,23028.1,250886.48
260990,202207,2655,2110,545,2557368.22,660545.28,3217913.50
261000,202207,4276,2616,1660,3170619.43,2013142.37,5183761.80
261010,202207,143,102,41,123624.92,49692,173316.92
261020,202207,592,435,157,527223.75,190284,717507.75
261030,202207,252,184,68,223008.16,82416,305424.16
261040,202207,370,308,62,373298.19,76356,449654.19
261050,202207,522,435,87,527224.33,105444.26,632668.59
261060,202207,1513,929,584,1125954.67,707810.14,1833764.81
261070,202207,9668,4539,5129,5505058.69,6222520.24,11727578.93
261080,202207,360,276,84,334516.08,101808,436324.08
261090,202207,2105,1610,495,1952564.93,601153.65,2553718.58
261100,202207,1237,854,383,1035059.6,464198.56,1499258.16
261110,202207,9200,5685,3515,6892774.66,4263864.15,11156638.81
261120,202207,233,198,35,239976.38,42420,282396.38
261130,202207,571,329,242,398753.52,293308.04,692061.56
261140,202207,210,132,78,159984.85,94536,254520.85
261150,202207,678,433,245,524798.7,298152,822950.7
261153,202207,72,68,4,82416,4848,87264
261160,202207,76895,37369,39526,45315279.86,47943591.99,93258871.85
261170,202207,484,358,126,433897.65,152712.7,586610.35
261180,202207,1788,1118,670,1355308.23,813258.23,2168566.46
261190,202207,583,397,186,481168.14,225432.45,706600.59
261200,202207,222,180,42,218162.27,50904,269066.27
261210,202207,44,34,10,41208,12120,53328
261220,202207,2789,1939,850,2351309.7,1032631.06,3383940.76
261230,202207,360,265,95,321181.02,115140.97,436321.99
261240,202207,440,379,61,459354,73932.96,533286.96
261245,202207,246,207,39,250884.2,47268,298152.2
261247,202207,171,128,43,155137.53,52116,207253.53
261250,202207,3641,1723,1918,2088288.96,2325832.69,4414121.65
261255,202207,243,214,29,259368.52,35148,294516.52
261260,202207,825,710,115,860543.42,139382.82,999926.24
261270,202207,201,141,60,170892,72720,243612
261280,202207,194,154,40,186648.79,48480,235128.79
261290,202207,104,74,30,90900,36360.2,127260.2
261300,202207,1366,1009,357,1224135.33,432688.02,1656823.35
261310,202207,804,531,273,644792.81,332089.59,976882.40
261320,202207,546,370,176,448447.09,213313.16,661760.25
261330,202207,924,724,200,877510.01,243620.5,1121130.51
261340,202207,319,180,139,218160.9,170892.1,389053.0
261350,202207,902,624,278,756303,336940.02,1093243.02
261360,202207,1406,890,516,1078683.24,625394.2,1704077.44
261370,202207,4978,2890,2088,3502730.72,2533102.26,6035832.98
261380,202207,562,436,126,528435.28,152712,681147.28
261390,202207,3727,2504,1223,3038539.16,1483510.76,4522049.92
261400,202207,270,243,27,294518.13,32724.88,327243.01
261410,202207,1143,748,395,907799.42,479953.98,1387753.40
261420,202207,968,587,381,711453.53,464197.82,1175651.35
261430,202207,319,286,33,346634.83,39996,386630.83
261440,202207,102,97,5,117564.59,6060,123624.59
261450,202207,2564,2010,554,2437386.77,673877.11,3111263.88
261460,202207,783,605,178,734482.39,215738.9,950221.29
261470,202207,224,180,44,219373.5,53328.79,272702.29
261480,202207,468,354,114,429052.92,138114.63,567167.55
261485,202207,392,231,161,279974.63,195132.2,475106.83
261500,202207,613,402,211,487225.36,255732.97,742958.33
261510,202207,51,33,18,39997.28,21816.1,61813.38
261520,202207,93,78,15,94536.5,18180.2,112716.7
261530,202207,4156,2640,1516,3199717.78,1838617.24,5038335.02
261540,202207,1486,851,635,1031418.58,769626.24,1801044.82
261550,202207,256,124,132,150289.11,159984,310273.11
261560,202207,932,607,325,735693.19,393905.02,1129598.21
261570,202207,389,310,79,375723.67,95748,471471.67
261580,202207,394,315,79,381783.2,95748,477531.2
261590,202207,191,158,33,191497.94,39996.8,231494.74
261600,202207,310,242,68,293307.99,82417.13,375725.12
261610,202207,88,75,13,90900,15756,106656
261618,202207,76,56,20,67872,24240,92112
261620,202207,203,130,73,158772.56,89688.8,248461.36
261630,202207,666,520,146,630242.96,176952,807194.96
261640,202207,6640,3464,3176,4198419.05,3855410.54,8053829.59
261650,202207,464,297,167,359964.73,202404.7,562369.43
270010,202207,513,453,60,549040.95,72720.5,621761.45
270020,202207,243,201,42,244827.03,50904.2,295731.23
270030,202207,8791,5624,3167,6821236.24,3839593.6,10660829.84
270040,202207,2072,1354,718,1642275,873858.42,2516133.42
270050,202207,215,168,47,203617.61,56964.48,260582.09
270060,202207,69,48,21,58179.32,25452.83,83632.15
270070,202207,804,587,217,711445.83,263005.1,974450.93
270080,202207,46,39,7,47268,8484,55752
270090,202207,22,17,5,20604,6060,26664
270100,202207,1313,895,418,1084747.8,507830.67,1592578.47
270110,202207,68,57,11,69084,13332,82416
270120,202207,245,200,45,242403.3,54540,296943.3
270130,202207,333,246,87,298154.23,105444,403598.23
270135,202207,121,84,37,101808.6,44844.3,146652.9
270140,202207,1397,912,485,1105362.41,589037.86,1694400.27
270150,202207,244,187,57,227777.06,69084.1,296861.16
270160,202207,489,382,107,462987.27,129684,592671.27
270170,202207,803,528,275,639940.27,333300.39,973240.66
270180,202207,56,45,11,54540,13332.76,67872.76
270190,202207,107,93,14,112716.64,16968,129684.64
270200,202207,117,102,15,123624.2,18180,141804.2
270210,202207,537,329,208,398748.5,253308,652056.5
270220,202207,193,139,54,168468.1,66660.96,235129.06
270230,202207,2132,1329,803,1612340.73,973240.12,2585580.85
270235,202207,491,382,109,462992.6,132108.9,595101.5
270240,202207,3311,2628,683,3187589.57,829012.72,4016602.29
270250,202207,120,89,31,107868.26,37572,145440.26
270255,202207,207,175,32,212101.01,38784,250885.01
270260,202207,362,294,68,356332.9,82417.02,438749.92
270270,202207,95,49,46,59388,55752,115140
270280,202207,216,135,81,163620,98172,261792
270290,202207,1108,867,241,1050815.18,292095.6,1342910.78
270300,202207,369,271,98,328452.2,118776.56,447228.76
270310,202207,814,680,134,824212.09,162409.09,986621.18
270320,202207,765,663,102,803561.24,123624,927185.24
270330,202207,302,261,41,316332.48,49692,366024.48
270340,202207,64,54,10,65448,12120,77568
270350,202207,87,51,36,61812.98,43632,105444.98
270360,202207,75,41,34,49692,41208,90900
270370,202207,65,51,14,61812,16968,78780
270375,202207,79,50,29,60600,35148,95748
270380,202207,1061,719,342,872641.1,415716,1288357.1
270390,202207,139,81,58,98172,72720.1,170892.1
270400,202207,728,558,170,676303.68,206040.92,882344.60
270410,202207,605,446,159,540555.21,192708.74,733263.95
270420,202207,408,287,121,347847.03,146652.2,494499.23
270430,202207,34154,24392,9762,29582071.46,11840206.25,41422277.71
270440,202207,476,379,97,459353.29,117564.1,576917.39
270450,202207,842,496,346,601154.63,419353.91,1020508.54
270460,202207,177,139,38,168470.47,46056,214526.47
270470,202207,1590,1108,482,1346830.72,584184.89,1931015.61
270480,202207,540,433,107,524803.05,129684,654487.05
270490,202207,20,15,5,18180,6060,24240
270500,202207,460,386,74,467835.12,89688,557523.12
270510,202207,872,571,301,692058.09,364813.5,1056871.59
270520,202207,265,175,90,212100.98,109080,321180.98
270530,202207,62,52,10,63024.2,12120,75144.2
270540,202207,92,66,26,79992,31512,111504
270550,202207,1661,1285,376,1558647.49,455712.93,2014360.42
270560,202207,255,154,101,186649.09,122412.5,309061.59
270570,202207,564,401,163,486016.45,197556,683572.45
270580,202207,13,9,4,10908,4848,15756
270590,202207,57,45,12,54540.3,14544,69084.3
270600,202207,150,131,19,158772.55,23028.1,181800.65
270610,202207,244,196,48,237554.3,58176.1,295730.4
270620,202207,16,16,0,19392,,19392.0
270630,202207,3622,2736,886,3316078.46,1075050.08,4391128.54
270640,202207,865,647,218,784169.4,264217.95,1048387.35
270642,202207,206,173,33,209677.14,39996,249673.14
270644,202207,264,168,96,203616.91,116352.15,319969.06
270650,202207,351,214,137,260581.25,166044.66,426625.91
270660,202207,191,170,21,206045.32,25452,231497.32
270670,202207,2922,2227,695,2700363.56,843554.57,3543918.13
270680,202207,392,252,140,305426.97,169680,475106.97
270690,202207,1216,817,399,990216.61,483591.86,1473808.47
270700,202207,25,20,5,24240.42,6060,30300.42
270710,202207,547,425,122,515102.34,147865.25,662967.59
270720,202207,223,179,44,216950.9,53328.5,270279.4
270730,202207,1897,1177,720,1427744.1,873855.27,2301599.37
270740,202207,35,24,11,29088,13332,42420
270750,202207,615,469,146,569646.66,176952.47,746599.13
270760,202207,289,210,79,254522.67,95748,350270.67
270770,202207,2814,1913,901,2319801.2,1092017.34,3411818.54
270780,202207,66,40,26,48480,31513.86,79993.86
270790,202207,224,137,87,166044.21,105445.48,271489.69
270800,202207,2034,1627,407,1973159.31,493284.99,2466444.30
270810,202207,220,181,39,219372.84,47268,266640.84
270820,202207,128,91,37,110296.34,44844,155140.34
270830,202207,835,637,198,772062.63,241188.77,1013251.40
270840,202207,1318,1019,299,1235035.83,362389.26,1597425.09
270850,202207,1506,977,529,1188652.6,647209.81,1835862.41
270860,202207,2545,1724,821,2090723.49,995060.18,3085783.67
270870,202207,125,72,53,87264.2,64236.2,151500.4
270880,202207,840,666,174,808412.82,210888.74,1019301.56
270890,202207,263,199,64,241188.97,77568.8,318757.77
270895,202207,61,58,3,70296.31,3636,73932.31
270900,202207,63,53,10,64236.2,12120,76356.2
270910,202207,302,249,53,301793.83,64236.6,366030.43
270915,202207,1929,1272,657,1541677.62,796286.04,2337963.66
270920,202207,420,348,72,421779.65,87264,509043.65
270930,202207,5608,4303,1305,5216508.11,1582878.01,6799386.12
270940,202207,2192,1735,457,2105270.42,553886.74,2659157.16
280010,202207,36,30,6,36360.51,7272,43632.51
280020,202207,502,424,78,513891.22,94536.97,608428.19
280030,202207,21646,13986,7660,16963611.49,9288928.56,26252540.05
280040,202207,326,205,121,248460.2,146652.2,395112.4
280050,202207,429,331,98,401173,119988,521161
280060,202207,385,243,142,294518.71,172105.82,466624.53
280067,202207,1135,813,322,985362.27,390264.31,1375626.58
280070,202207,122,103,19,124836.8,23028,147864.8
280100,202207,658,510,148,618123.62,179377.57,797501.19
280110,202207,85,76,9,92112.4,10908,103020.4
280120,202207,674,561,113,679936.48,136957.44,816893.92
280130,202207,1755,1153,602,1398654.49,730837,2129491.49
280140,202207,509,425,84,515102.7,101808,616910.7
280150,202207,426,300,126,363602.51,152712,516314.51
280160,202207,140,109,31,133320,37572,170892
280170,202207,424,296,128,358758.62,155137.81,513896.43
280190,202207,31,24,7,29088,8484,37572
280200,202207,40,31,9,37572.43,10908.3,48480.73
280210,202207,3009,2166,843,2625134.06,1022935.16,3648069.22
280220,202207,53,43,10,52116.91,12120,64236.91
280230,202207,329,265,64,321185.62,77568.23,398753.85
280240,202207,126,117,9,141805.7,10908,152713.7
280250,202207,18,10,8,12120,9696.45,21816.45
280260,202207,78,71,7,86052.7,8484,94536.7
280270,202207,140,107,33,129684,39996.7,169680.7
280280,202207,191,123,68,149077.19,82416,231493.19
280290,202207,3660,2660,1000,3226287.76,1214429.87,4440717.63
280300,202207,1623,1296,327,1573193.25,398749.29,1971942.54
280310,202207,96,91,5,110293.2,6060,116353.2
280320,202207,662,464,198,562374.06,239978.06,802352.12
280330,202207,314,231,83,279973.7,100596.2,380569.9
280340,202207,422,352,70,426626.67,84840,511466.67
280350,202207,3763,2884,879,3499083.6,1066573.84,4565657.44
280360,202207,473,318,155,385418.6,187860.2,573278.8
280370,202207,90,77,13,93324.13,15756,109080.13
280380,202207,49,38,11,46056,13332,59388
280390,202207,182,153,29,185436.88,35148,220584.88
280400,202207,401,269,132,326034.7,159985.75,486020.45
280410,202207,293,244,49,295728.77,59388,355116.77
280420,202207,133,114,19,138170.41,23028,161198.41
280430,202207,94,75,19,90900.94,23028,113928.94
280440,202207,717,588,129,715090.66,156348.58,871439.24
280445,202207,121,114,7,138169.42,8484,146653.42
280450,202207,1283,1099,184,1334419.85,223011.1,1557430.95
280460,202207,662,484,178,586613.33,216948.19,803561.52
280470,202207,98,90,8,109080.39,9696,118776.39
280480,202207,3084,2088,996,2533135.47,1207175.51,3740310.98
280490,202207,199,189,10,229073.07,12120,241193.07
280500,202207,43,39,4,47268.46,4848.17,52116.63
280510,202207,137,110,27,133320.56,32725.2,166045.76
280520,202207,51,37,14,44844.2,16968,61812.2
280530,202207,69,48,21,58176.1,25452,83628.1
280540,202207,546,471,75,570857.76,90900,661757.76
280550,202207,729,672,57,814471.17,69084,883555.17
280560,202207,477,430,47,521163.96,56964.6,578128.56
280570,202207,2339,1855,484,2250699.36,586608.09,2837307.45
280580,202207,583,459,124,556313.06,150288.2,706601.26
280590,202207,223,139,84,168472.85,101810.3,270283.15
280600,202207,398,326,72,395171.64,87264,482435.64
280610,202207,118,83,35,100598.23,42421.47,143019.70
280620,202207,554,450,104,545403.52,126048,671451.52
280630,202207,152,122,30,147865.33,36360,184225.33
280640,202207,178,144,34,174528.1,41208,215736.1
280650,202207,85,50,35,60600.2,42420.52,103020.72
280660,202207,126,96,30,116355.03,36360.2,152715.23
280670,202207,2037,1291,746,1564778.7,904169.41,2468948.11
280680,202207,238,204,34,247248.5,41208,288456.5
280690,202207,79,68,11,82416,13332,95748
280700,202207,18,18,0,21816,,21816.0
280710,202207,1514,1181,333,1432599.62,403597.32,1836196.94
280720,202207,125,85,40,103021.14,48480,151501.14
280730,202207,29,25,4,30300.97,4848,35148.97
280740,202207,2570,1929,641,2337964.65,778108.06,3116072.71
280750,202207,223,194,29,235131.41,35148.35,270279.76
280760,202207,920,623,297,756303.5,359965.87,1116269.37
290010,202207,195,137,58,166044.2,70296,236340.2
290020,202207,186,165,21,199981,25452.6,225433.6
290030,202207,623,397,226,481166.05,273912.78,755078.83
290035,202207,128,105,23,127260.1,27876,155136.1
290040,202207,294,204,90,247251.52,109080,356331.52
290050,202207,89,71,18,86052,21816,107868
290060,202207,255,111,144,134532,174528.2,309060.2
290070,202207,5873,2770,3103,3359703.03,3765718.98,7125422.01
290080,202207,462,200,262,242401,317544.09,559945.09
290090,202207,348,161,187,195132.3,226645.3,421777.6
290100,202207,1688,1062,626,1287158.33,758715.4,2045873.73
290110,202207,858,489,369,592677.61,447233.15,1039910.76
290115,202207,185,167,18,202405.42,21816,224221.42
290120,202207,808,539,269,653272.31,326028.3,979300.61
290130,202207,457,276,181,334512.87,219372.16,553885.03
290135,202207,292,222,70,269064.54,84840.13,353904.67
290140,202207,310,258,52,312699.18,63024.2,375723.38
290150,202207,133,90,43,109080,52116,161196
290160,202207,242,185,57,224222.34,69085.57,293307.91
290170,202207,103,73,30,88476.6,36360.58,124837.18
290180,202207,196,144,52,174528.96,63024,237552.96
290190,202207,363,287,76,347849.77,92112.9,439962.67
290195,202207,299,193,106,233916.4,128472.2,362388.6
290200,202207,260,211,49,255732.45,59388.1,315120.55
290205,202207,149,91,58,110292.94,70296,180588.94
290210,202207,1249,911,338,1104146.22,409658.74,1513804.96
290220,202207,173,99,74,121202.21,90900.7,212102.91
290225,202207,294,114,180,138168.06,218160.3,356328.36
290230,202207,84,52,32,63025.17,38784,101809.17
290240,202207,357,122,235,147864.2,284821.3,432685.5
290250,202207,240,224,16,271490.08,19392,290882.08
290260,202207,341,271,70,328456.87,84841.37,413298.24
290265,202207,190,166,24,201193.28,29088.45,230281.73
290270,202207,1368,1130,238,1369578.5,288458.8,1658037.3
290280,202207,482,339,143,410868.6,173316.4,584185.0
290290,202207,1396,831,565,1007183.62,685994.63,1693178.25
290300,202207,391,335,56,406024.05,69084.56,475108.61
290310,202207,286,135,151,163620.4,183012,346632.4
290320,202207,4225,2544,1681,3087020.82,2038600.06,5125620.88
290323,202207,203,175,28,212101.16,33936.2,246037.36
290327,202207,162,125,37,151501.58,44844,196345.58
290330,202207,120,58,62,70296.13,75144.1,145440.23
290340,202207,768,319,449,386673.97,544188.3,930862.27
290350,202207,665,405,260,490863.5,315121.83,805985.33
290360,202207,324,247,77,299368.61,93325.19,392693.80
290370,202207,897,399,498,483589.87,603576,1087165.87
290380,202207,337,213,124,258158.68,150288.8,408447.48
290390,202207,2382,1486,896,1802265.91,1088380.13,2890646.04
290395,202207,231,134,97,162408,117564,279972
290400,202207,285,207,78,250884,94536,345420
290405,202207,240,204,36,247248.15,43632,290880.15
290410,202207,632,524,108,635090.64,130896,765986.64
290420,202207,275,220,55,266640.57,66660,333300.57
290430,202207,481,304,177,368450.25,214524,582974.25
290440,202207,84,73,11,88476.22,13332,101808.22
290450,202207,198,145,53,175740,64236,239976
290460,202207,1970,1174,796,1422901.69,965965.8,2388867.49
290470,202207,1354,589,765,713875.21,927189.11,1641064.32
290475,202207,564,527,37,638733.94,44844,683577.94
290480,202207,277,159,118,192709,143016.33,335725.33
290485,202207,233,211,22,255733.53,26664,282397.53
290490,202207,1261,885,376,1073836,456926.35,1530762.35
290500,202207,770,408,362,494500.11,441170.15,935670.26
290510,202207,191,156,35,189075.53,42420.34,231495.87
290515,202207,176,107,69,129684,83628,213312
290520,202207,1422,926,496,1122317.32,601152.76,1723470.08
290530,202207,276,248,28,300582.38,33936.2,334518.58
290540,202207,118,60,58,72720.25,70296,143016.25
290550,202207,161,133,28,161197.05,33936,195133.05
290560,202207,3221,1430,1791,1733181.78,2173124.21,3906305.99
290570,202207,6584,3107,3477,3766960.6,4217809.24,7984769.84
290580,202207,1257,754,503,913851.19,609637.2,1523488.39
290590,202207,570,454,116,550260.37,140594.58,690854.95
290600,202207,1764,1212,552,1468965.47,669033.73,2137999.20
290610,202207,175,159,16,192712.87,19392,212104.87
290620,202207,378,340,38,412082.1,46056.6,458138.7
290630,202207,2005,855,1150,1037486.66,1393805.24,2431291.90
290640,202207,131,103,28,124837.67,33936.05,158773.72
290650,202207,1882,866,1016,1049606.72,1231397.63,2281004.35
290660,202207,257,211,46,255732,55752.72,311484.72
290670,202207,1016,508,508,616916.43,615700.32,1232616.75
290680,202207,1246,999,247,1212010.64,299365.77,1511376.41
290682,202207,328,245,83,296942.65,100596.38,397539.03
290685,202207,250,152,98,184224.98,118776.2,303001.18
290687,202207,1162,759,403,920115.38,489649.84,1409765.22
290689,202207,149,76,73,92112,88476,180588
290690,202207,583,254,329,307849.78,398748.61,706598.39
290700,202207,251,124,127,150290.13,153925.3,304215.43
290710,202207,756,518,238,627822.28,288459.92,916282.20
290720,202207,1042,833,209,1009610.48,253311.22,1262921.70
290730,202207,1229,710,519,860528.57,630243.98,1490772.55
290740,202207,24,21,3,25452,3636,29088
290750,202207,1456,626,830,759936.66,1007182.91,1767119.57
290755,202207,74,65,9,78780,10908,89688
290760,202207,257,226,31,273915.68,37572.2,311487.88
290770,202207,175,170,5,206040.62,6060,212100.62
290780,202207,1109,878,231,1064143.97,279975.06,1344119.03
290790,202207,381,259,122,313911.77,147866.07,461777.84
290800,202207,2448,990,1458,1199889.07,1768313.52,2968202.59
290810,202207,487,333,154,403598.68,187861.02,591459.70
290820,202207,415,241,174,292097.27,210890.17,502987.44
290830,202207,456,323,133,391477.15,161196.43,552673.58
290840,202207,1843,1151,692,1395026.45,839921.82,2234948.27
290850,202207,1001,511,490,619335.89,595094.45,1214430.34
290860,202207,660,305,355,369663.06,430260.64,799923.70
290870,202207,611,429,182,519953.96,221796.96,741750.92
290880,202207,115,64,51,77568,61812,139380
290890,202207,462,278,184,336940.3,223009.97,559950.27
290900,202207,163,124,39,150288,47268,197556
290910,202207,386,295,91,358753.52,110292,469045.52
290920,202207,199,175,24,212101.83,29088,241189.83
290930,202207,525,404,121,489653.55,146653.3,636306.85
290940,202207,218,185,33,224220.3,39996,264216.3
290950,202207,158,90,68,109080,82416,191496
290960,202207,482,335,147,406022.01,178165.14,584187.15
290970,202207,227,201,26,243612.2,31512.2,275124.4
290980,202207,1849,1271,578,1540466.08,700541.09,2241007.17
290990,202207,407,342,65,414510.21,78781.32,493291.53
291000,202207,913,282,631,341784.73,765984,1107768.73
291005,202207,2592,1092,1500,1323527.46,1819233.86,3142761.32
291010,202207,167,144,23,174528,27876,202404
291020,202207,91,71,20,86052,24240.8,110292.8
291030,202207,96,70,26,84840,31512.6,116352.6
291040,202207,642,373,269,452076.58,326028.2,778104.78
291050,202207,1501,782,719,947793.21,871433.51,1819226.72
291060,202207,1673,920,753,1116264.89,912638.27,2028903.16
291070,202207,1948,1450,498,1757419.88,604792.45,2362212.33
291072,202207,7339,2776,4563,3365778.06,5532805.04,8898583.10
291075,202207,237,196,41,237552.1,49692.2,287244.3
291077,202207,60,42,18,50904,21816,72720
291080,202207,21184,8982,12202,10898467.92,14796249.4,25694717.32
291085,202207,271,221,50,267853.05,60600.75,328453.80
291090,202207,267,110,157,133321.29,191496,324817.29
291100,202207,991,337,654,408444,793860,1202304
291110,202207,438,337,101,408445.76,122412.2,530857.96
291120,202207,2437,1268,1169,1539246.64,1418044.74,2957291.38
291125,202207,66,34,32,41208,38784,79992
291130,202207,189,166,23,201192.94,27876,229068.94
291140,202207,128,102,26,123624,31512.7,155136.7
291150,202207,366,138,228,167256,277548,444804
291160,202207,399,305,94,369666.16,113928.55,483594.71
291165,202207,50,37,13,44844,15756.2,60600.2
291170,202207,3321,1635,1686,1984071.06,2044652.34,4028723.40
291180,202207,1247,517,730,626610.01,885973.14,1512583.15
291185,202207,112,102,10,123624.78,12120,135744.78
291190,202207,1382,656,726,796291.41,879919.59,1676211.00
291200,202207,173,126,47,152712,56964,209676
291210,202207,2429,974,1455,1180498.94,1764680.28,2945179.22
291220,202207,306,231,75,279972.39,90900,370872.39
291230,202207,975,344,631,416928.91,765984.97,1182913.88
291240,202207,405,379,26,459349.47,31512,490861.47
291250,202207,407,331,76,401172,93324,494496
291260,202207,64,56,8,67872.87,9696,77568.87
291270,202207,1031,449,582,544203.33,706605.31,1250808.64
291280,202207,364,171,193,207254.67,233916.8,441171.47
291290,202207,1640,858,782,1039915.48,949002.86,1988918.34
291300,202207,240,186,54,225432,65448,290880
291310,202207,228,201,27,243615.32,32724,276339.32
291320,202207,1296,900,396,1090817.79,479954.13,1570771.92
291330,202207,138,117,21,141804.6,25452,167256.6
291340,202207,225,133,92,161197,111504.5,272701.5
291345,202207,118,83,35,100596.3,42420,143016.3
291350,202207,1772,670,1102,812041.21,1336837,2148878.21
291360,202207,8477,4024,4453,4879603.76,5399524.37,10279128.13
291370,202207,1111,655,456,793871.73,552676.48,1346548.21
291380,202207,259,203,56,246037.64,67872,313909.64
291390,202207,4062,1783,2279,2161017.45,2763367.52,4924384.97
291400,202207,2072,1441,631,1747729.81,765995.76,2513725.57
291410,202207,207,178,29,215737.2,35148,250885.2
291420,202207,119,90,29,109080.2,35148,144228.2
291430,202207,175,105,70,128472.61,84840,213312.61
291440,202207,532,430,102,522378.19,123624.8,646002.99
291450,202207,942,622,320,755083.15,387843.31,1142926.46
291460,202207,1989,1569,420,1904086.47,509048.63,2413135.10
291465,202207,2278,1079,1199,1307763.8,1455616.41,2763380.21
291470,202207,2915,1462,1453,1774389.22,1762256.59,3536645.81
291480,202207,12109,5233,6876,6342485.25,8339820.61,14682305.86
291490,202207,663,266,397,322393.8,481164.2,803558.0
291500,202207,355,211,144,255735.23,174528.72,430263.95
291510,202207,1193,458,735,557521.27,890820.2,1448341.47
291520,202207,924,411,513,498137.07,621757.55,1119894.62
291530,202207,936,269,667,326029.1,808404.85,1134433.95
291535,202207,123,102,21,123624,25453.2,149077.2
291540,202207,351,114,237,138168.98,287244.47,425413.45
291550,202207,1283,607,676,736902.33,819312.9,1556215.23
291560,202207,5173,2600,2573,3153644.6,3122117.96,6275762.56
291570,202207,229,114,115,138168.2,139382.36,277550.56
291580,202207,1207,750,457,909010.35,555096.88,1464107.23
291590,202207,97,43,54,52116,65448,117564
291600,202207,1128,563,565,682360.1,684782.59,1367142.69
291610,202207,1416,685,731,830252.08,885987.96,1716240.04
291620,202207,564,264,300,319973.11,363601.84,683574.95
291630,202207,478,148,330,179376.2,399960,579336.2
291640,202207,4027,1979,2048,2398583.46,2482192.66,4880776.12
291650,202207,440,301,139,364819.21,168469.61,533288.82
291660,202207,374,152,222,184224.38,271489.03,455713.41
291670,202207,187,122,65,147864.8,78780,226644.8
291680,202207,626,384,242,465424.21,293308.2,758732.41
291685,202207,585,339,246,412083.69,298154.04,710237.73
291690,202207,471,302,169,366024.1,204829.07,570853.17
291700,202207,1047,804,243,974455.89,294518.45,1268974.34
291710,202207,1588,781,807,946580.28,980515,1927095.28
291720,202207,431,294,137,356328,166044,522372
291730,202207,919,528,391,639943.72,473894.12,1113837.84
291733,202207,302,203,99,246037.36,119988.2,366025.56
291735,202207,84,64,20,77568,24240,101808
291740,202207,341,256,85,310272.89,103020,413292.89
291750,202207,2357,1498,859,1816832.54,1041128.97,2857961.51
291760,202207,3066,1683,1383,2041012.01,1677408.2,3718420.21
291770,202207,738,500,238,606014.42,288461.99,894476.41
291780,202207,85,53,32,64236.62,38784.8,103021.42
291790,202207,154,81,73,98172.39,88476.22,186648.61
291800,202207,10379,4349,6030,5273488.13,7314456.36,12587944.49
291810,202207,1057,800,257,970819.81,311485.5,1282305.31
291820,202207,288,206,82,249672,99384,349056
291830,202207,1033,425,608,515105.93,736900.73,1252006.66
291835,202207,560,520,40,630243.15,48480,678723.15
291840,202207,5172,2591,2581,3145224.51,3130637.69,6275862.20
291845,202207,277,90,187,109080,226644,335724
291850,202207,311,277,34,335728.56,41208.4,376936.96
291855,202207,267,115,152,139380.32,184224.78,323605.10
291860,202207,163,105,58,127260,70297.5,197557.5
291870,202207,78,34,44,41208,53328,94536
291875,202207,160,149,11,180590.18,13332,193922.18
291880,202207,420,343,77,416931.9,93324.4,510256.3
291890,202207,247,87,160,105444.1,195132.6,300576.7
291900,202207,55,33,22,39996,26664,66660
291905,202207,119,91,28,110292.51,33936,144228.51
291910,202207,159,128,31,155136,37572,192708
291915,202207,434,385,49,466623.1,59389.07,526012.17
291920,202207,5674,2752,2922,3337918.61,3543933.68,6881852.29
291930,202207,165,101,64,122412.56,77568,199980.56
291940,202207,378,218,160,264216.62,193920,458136.62
291950,202207,1145,897,248,1087167.11,300576.82,1387743.93
291955,202207,1387,832,555,1009602.69,672663.17,1682265.86
291960,202207,196,145,51,176952.2,61812,238764.2
291970,202207,764,561,203,679942.76,246037.1,925979.86
291980,202207,1412,1233,179,1494406.02,216950.32,1711356.34
291990,202207,142,130,12,157560.48,14544,172104.48
291992,202207,192,90,102,109082.16,123627.15,232709.31
291995,202207,183,114,69,138169.36,83628.46,221797.82
292000,202207,423,303,120,367237.9,145440,512677.9
292010,202207,332,228,104,276336.4,127260.13,403596.53
292020,202207,297,218,79,264217.42,96960.28,361177.70
292030,202207,149,115,34,139380,41208,180588
292040,202207,575,299,276,362388,334512,696900
292045,202207,119,104,15,127260,18180,145440
292050,202207,926,669,257,810828.87,311484.8,1122313.67
292060,202207,917,742,175,899322.6,212101.33,1111423.93
292070,202207,61,24,37,29088.2,44844,73932.2
292080,202207,155,109,46,132109.4,55752,187861.4
292090,202207,556,197,359,238765.02,435110.56,673875.58
292100,202207,1525,649,876,786600.47,1061726.87,1848327.34
292105,202207,172,153,19,185436,23028,208464
292110,202207,2302,852,1450,1033845.39,1757403.83,2791249.22
292120,202207,705,539,166,653281.75,201194.95,854476.70
292130,202207,475,264,211,319970.02,255732.2,575702.22
292140,202207,209,170,39,206042.35,47269.01,253311.36
292145,202207,165,87,78,105444,95748,201192
292150,202207,1505,1247,258,1511372.65,312696.81,1824069.46
292160,202207,165,131,34,158772.8,41209.03,199981.83
292170,202207,1178,1004,174,1216865.78,212101.19,1428966.97
292180,202207,230,165,65,199980,78780,278760
292190,202207,150,96,54,116352,65448,181800
292200,202207,1436,521,915,631458.43,1111408.1,1742866.53
292205,202207,117,98,19,118776,23028,141804
292210,202207,395,262,133,317547.1,162408.37,479955.47
292220,202207,33,21,12,25452.75,14544,39996.75
292225,202207,46,39,7,47268,8484,55752
292230,202207,1009,760,249,921137.68,301789.1,1222926.78
292240,202207,629,459,170,556314.7,206040.2,762354.9
292250,202207,1636,1059,577,1285948.87,699326.17,1985275.04
292260,202207,407,243,164,294517,198769.01,493286.01
292265,202207,250,189,61,229069.5,73932.2,303001.7
292270,202207,728,351,377,425415.45,456924.4,882339.85
292273,202207,212,124,88,150288,106656.8,256944.8
292275,202207,171,88,83,106656,100596,207252
292280,202207,147,99,48,119988,58176,178164
292285,202207,89,70,19,84840,23028,107868
292290,202207,592,396,196,479958.13,237553.39,717511.52
292300,202207,1825,700,1125,849615.47,1363503.95,2213119.42
292303,202207,129,86,43,104232.2,53328,157560.2
292305,202207,117,86,31,104232.37,37572,141804.37
292310,202207,986,644,342,780537.67,414506.9,1195044.57
292320,202207,586,433,153,524799.04,185437.02,710236.06
292330,202207,177,109,68,132108.98,82416,214524.98
292335,202207,303,242,61,293304.96,73932,367236.96
292340,202207,553,383,170,464197.22,206040.33,670237.55
292350,202207,270,145,125,175740.2,151500,327240.2
292360,202207,732,546,186,661753.21,225432,887185.21
292370,202207,723,552,171,670240.36,207252.5,877492.86
292380,202207,621,512,109,620546.37,133320,753866.37
292390,202207,398,159,239,192708.73,289668.7,482377.43
292400,202207,3657,2235,1422,2708862.06,1724684.23,4433546.29
292405,202207,272,182,90,220584.65,109080,329664.65
292410,202207,108,67,41,81204,49692,130896
292420,202207,277,237,40,287245.72,48480,335725.72
292430,202207,533,388,145,470257.13,175740.31,645997.44
292440,202207,636,529,107,641152.93,129684,770836.93
292450,202207,235,179,56,216950.3,67872,284822.3
292460,202207,518,391,127,473895.02,153924,627819.02
292465,202207,211,180,31,218160.8,37572.75,255733.55
292467,202207,160,103,57,124836,69084,193920
292470,202207,318,216,102,261793.11,123624,385417.11
292480,202207,406,274,132,332093.65,159985.94,492079.59
292490,202207,239,176,63,213312.3,76356.4,289668.7
292500,202207,905,423,482,512683.71,584189.18,1096872.89
292510,202207,3636,1742,1894,2112532.01,2295537.61,4408069.62
292520,202207,1145,531,614,643582.85,744173.49,1387756.34
292525,202207,428,314,114,380573.39,138171.26,518744.65
292530,202207,4925,1994,2931,2416751.32,3556025.23,5972776.55
292540,202207,493,286,207,346632.2,250884.51,597516.71
292550,202207,1138,623,515,756296.55,624181.98,1380478.53
292560,202207,330,302,28,366027.69,33936.16,399963.85
292570,202207,328,254,74,307848.98,89688,397536.98
292575,202207,572,415,157,502990.01,190285.02,693275.03
292580,202207,1032,690,342,836283.19,414506.67,1250789.86
292590,202207,558,495,63,599942.9,76356.8,676299.7
292593,202207,145,114,31,138168.58,37572,175740.58
292595,202207,194,153,41,185437.11,49692,235129.11
292600,202207,1264,902,362,1093235.11,438748.28,1531983.39
292610,202207,117,95,22,115141.04,26665.34,141806.38
292620,202207,526,439,87,533293.5,105444.5,638738.0
292630,202207,1542,845,697,1024148.23,845980.56,1870128.79
292640,202207,879,602,277,729631.98,335726.49,1065358.47
292650,202207,184,143,41,173320.93,49692,223012.93
292660,202207,1937,1361,576,1649559.29,698120.88,2347680.17
292665,202207,139,99,40,119988,48480,168468
292670,202207,395,309,86,374508.88,104232,478740.88
292680,202207,263,193,70,233916.76,84840,318756.76
292690,202207,205,143,62,173317.01,75144.2,248461.21
292700,202207,1001,649,352,787810.03,427840.45,1215650.48
292710,202207,115,101,14,122412,16968.31,139380.31
292720,202207,988,569,419,689631.63,507828.98,1197460.61
292730,202207,203,92,111,111504.2,134532.4,246036.6
292740,202207,74921,35671,39250,43254800.27,47604308.86,90859109.13
292750,202207,380,275,105,333303.95,127261.76,460565.71
292760,202207,335,278,57,336938.55,69084.2,406022.75
292770,202207,875,368,507,446018,615700.49,1061718.49
292780,202207,28,12,16,14544,19392,33936
292790,202207,781,412,369,499344.88,448440,947784.88
292800,202207,1271,762,509,923549.75,616911.79,1540461.54
292805,202207,396,137,259,166045.07,313909.07,479954.14
292810,202207,1816,1073,743,1300487.6,900517.6,2201005.2
292820,202207,689,582,107,705393.85,129687.13,835080.98
292830,202207,130,100,30,121200.2,36360.8,157561.0
292840,202207,697,568,129,688424.61,156349.9,844774.51
292850,202207,140,94,46,113929.03,55753.34,169682.37
292860,202207,2114,1204,910,1459272.17,1102938.1,2562210.27
292870,202207,3670,2380,1290,2884594.47,1563487.68,4448082.15
292880,202207,1417,936,481,1134437.25,582974.18,1717411.43
292890,202207,539,447,92,542978.55,111507.26,654485.81
292895,202207,147,100,47,121200.2,56964,178164.2
292900,202207,329,231,98,279976.23,118777.43,398753.66
292905,202207,488,238,250,288457.92,303001.23,591459.15
292910,202207,492,363,129,439957.86,156348.17,596306.03
292920,202207,540,228,312,276337.6,378147.25,654484.85
292925,202207,467,427,40,518739.28,48480.5,567219.78
292930,202207,679,403,276,488440.38,334513.07,822953.45
292935,202207,279,123,156,149076.95,189072.7,338149.65
292937,202207,221,154,67,186649.32,81204,267853.32
292940,202207,197,150,47,181800.24,56964,238764.24
292950,202207,1285,613,672,745392.99,814469.63,1559862.62
292960,202207,504,357,147,432692.56,178166.33,610858.89
292970,202207,234,169,65,204829.46,78780.73,283610.19
292975,202207,88,48,40,58178.06,48480.8,106658.86
292980,202207,338,234,104,283609.39,126048.97,409658.36
292990,202207,1318,982,336,1190189.18,407232.4,1597421.58
293000,202207,114,80,34,96960.2,41208.1,138168.3
293010,202207,3005,1770,1235,2145301.13,1496840.57,3642141.70
293015,202207,610,501,109,607216.89,132108.72,739325.61
293020,202207,322,258,64,312701.57,77569.65,390271.22
293030,202207,577,510,67,618122.76,81204,699326.76
293040,202207,374,299,75,362389.49,90900,453289.49
293050,202207,2987,1747,1240,2117378.99,1502893.57,3620272.56
293060,202207,249,197,52,238770.67,63025.13,301795.80
293070,202207,3711,1873,1838,2270105.84,2227677.39,4497783.23
293075,202207,94,65,29,78780,35148,113928
293076,202207,78,56,22,67872,26664,94536
293077,202207,584,332,252,402392.22,305427.97,707820.19
293080,202207,430,380,50,460566.38,60600.86,521167.24
293090,202207,134,119,15,144228,18180,162408
293100,202207,518,348,170,422991.01,206040.17,629031.18
293105,202207,347,252,95,305424,115140,420564
293110,202207,120,80,40,96961.76,48482.46,145444.22
293120,202207,298,209,89,253312,107869.07,361181.07
293130,202207,243,162,81,196346.95,98172,294518.95
293135,202207,8423,3317,5106,4022686.49,6192127.1,10214813.59
293140,202207,188,115,73,139380.95,88476.45,227857.40
293150,202207,304,264,40,321184.98,48480.2,369665.18
293160,202207,429,264,165,319969.4,199980.47,519949.87
293170,202207,229,142,87,172105.81,105446.18,277551.99
293180,202207,587,391,196,473893.9,237552,711445.9
293190,202207,1375,949,426,1152631.93,516323.34,1668955.27
293200,202207,551,485,66,587824.24,79992.23,667816.47
293210,202207,414,317,97,384206.87,117564,501770.87
293220,202207,2401,1043,1358,1264125.63,1647113.45,2911239.08
293230,202207,1826,688,1138,835077.69,1380469.28,2215546.97
293240,202207,233,211,22,255733.78,26664.59,282398.37
293245,202207,136,109,27,132110.19,32724,164834.19
293250,202207,791,320,471,387845.83,572070.97,959916.80
293260,202207,308,247,61,299364.2,73932,373296.2
293270,202207,1185,533,652,645998.94,791436.6,1437435.54
293280,202207,310,193,117,233916.72,141806.98,375723.70
293290,202207,2992,1928,1064,2339178.56,1294420.46,3633599.02
293300,202207,858,591,267,716294.9,323604.2,1039899.1
293305,202207,191,147,44,178164,53328,231492
293310,202207,174,131,43,158773.59,52116.2,210889.79
293315,202207,164,124,40,150289.2,48480.2,198769.4
293317,202207,98,74,24,89690.22,29088,118778.22
293320,202207,1136,600,536,727225.94,649647.09,1376873.03
293325,202207,204,78,126,94536,152712,247248
293330,202207,14566,6602,7964,8005359.2,9657277.73,17662636.93
293340,202207,286,202,84,244824,101808,346632
293345,202207,259,213,46,258159.09,55752,313911.09
293350,202207,587,362,225,438750.39,272700.2,711450.59
293360,202207,1490,1055,435,1278674.72,527222.06,1805896.78
310010,202207,144,75,69,90900,83628,174528
310020,202207,1006,547,459,664181.92,556310.37,1220492.29
310030,202207,311,249,62,301788.69,75144.41,376933.10
310040,202207,45,29,16,35148,19392,54540
310050,202207,155,96,59,116352.89,71508,187860.89
310060,202207,267,181,86,219375.98,104232.91,323608.89
310070,202207,15,9,6,10908,7272.2,18180.2
310080,202207,50,34,16,41208,19392,60600
310090,202207,1073,591,482,716299.09,584186.05,1300485.14
310100,202207,338,245,93,296941.34,112716.49,409657.83
310110,202207,691,364,327,441170.09,396324,837494.09
310120,202207,381,218,163,264216,197556.1,461772.1
310130,202207,29,17,12,20604,14544,35148
310140,202207,23,7,16,8484,19392.76,27876.76
310150,202207,1172,780,392,945371.57,475108.76,1420480.33
310160,202207,2061,1022,1039,1238677.68,1260485.43,2499163.11
310163,202207,98,54,44,65448,53328,118776
310170,202207,2541,1175,1366,1425321.79,1655600.47,3080922.26
310180,202207,173,74,99,89688.8,119988,209676.8
310190,202207,486,327,159,396324.17,192709.5,589033.67
310200,202207,437,278,159,336937.07,192708.2,529645.27
310205,202207,72,47,25,56964,30300,87264
310210,202207,272,226,46,273913.34,55752,329665.34
310220,202207,64,39,25,47268,31512,78780
310230,202207,276,197,79,238765.36,95748,334513.36
310240,202207,118,97,21,117564,25452,143016
310250,202207,98,78,20,94537.74,24240,118777.74
310260,202207,740,389,351,471475.41,426627.09,898102.50
310270,202207,271,177,94,214525.06,113928.2,328453.26
310280,202207,384,274,110,332089.87,133320,465409.87
310285,202207,200,152,48,184225,58176,242401
310290,202207,228,123,105,149076,127260,276336
310300,202207,164,131,33,158772.52,39996.66,198769.18
310310,202207,11,8,3,9696,3636,13332
310320,202207,29,10,19,12120.17,23028,35148.17
310330,202207,39,27,12,32724.23,14544,47268.23
310340,202207,1818,1277,541,1548948.7,656907.18,2205855.88
310350,202207,2775,1455,1320,1765926.62,1601057.41,3366984.03
310360,202207,49,40,9,48480,10908.3,59388.3
310370,202207,121,103,18,124836,21816,146652
310375,202207,114,44,70,53328,84840.71,138168.71
310380,202207,53,33,20,39996,25452,65448
310390,202207,105,67,38,81204,46056,127260
310400,202207,2477,1600,877,1939232.59,1062929.76,3002162.35
310410,202207,114,67,47,81204.45,56964,138168.45
310420,202207,679,346,333,419353.16,403600.89,822954.05
310430,202207,285,183,102,221797.13,123624,345421.13
310440,202207,74,46,28,55752,33936,89688
310445,202207,78,66,12,79992.16,14544,94536.16
310450,202207,642,422,220,511470.41,266640.47,778110.88
310460,202207,244,167,77,202405.13,93324,295729.13
310470,202207,525,338,187,410871.83,226646.02,637517.85
310480,202207,93,58,35,70296,42420,112716
310490,202207,555,256,299,311490.64,362389.05,673879.69
310500,202207,127,53,74,64236.7,89688,153924.7
310510,202207,596,422,174,511466.34,212100.95,723567.29
310520,202207,143,102,41,123624.1,49692,173316.1
310530,202207,109,45,64,54540.2,77568,132108.2
310540,202207,484,272,212,329666.86,256946.25,586613.11
310550,202207,70,48,22,58177.47,26664,84841.47
310560,202207,3124,2133,991,2585228.94,1201094.18,3786323.12
310570,202207,103,63,40,76356,48480,124836
310590,202207,378,231,147,279974.24,178164.1,458138.34
310600,202207,138,67,71,81204.8,86052,167256.8
310610,202207,50,21,29,25452,35148,60600
310620,202207,49212,23227,25985,28166016.93,31515761.11,59681778.04
310630,202207,708,417,291,505407.13,352692.88,858100.01
310640,202207,138,95,43,115140,52116,167256
310650,202207,148,130,18,157560.62,21816,179376.62
310660,202207,110,77,33,93324,39996,133320
310665,202207,65,46,19,55752,23028,78780
310670,202207,7217,3092,4125,3750011.5,5001945.92,8751957.42
310680,202207,64,38,26,46056,31512,77568
310690,202207,624,440,184,533282.67,223009.65,756292.32
310700,202207,60,36,24,43632,29088,72720
310710,202207,1296,870,426,1054793.39,516313.44,1571106.83
310720,202207,153,43,110,52116,133320,185436
310730,202207,1529,1035,494,1255654.85,599948.89,1855603.74
310740,202207,996,547,449,662972.17,544190.59,1207162.76
310750,202207,247,151,96,183012.58,116352,299364.58
310760,202207,64,51,13,61812.45,15756,77568.45
310770,202207,85,41,44,49692,53328,103020
310780,202207,351,285,66,345422.39,79993.55,425415.94
310790,202207,110,90,20,109080.2,24240.59,133320.79
310800,202207,474,226,248,273912.92,300576,574488.92
310810,202207,171,114,57,138168.69,69085.22,207253.91
310820,202207,312,252,60,305425.91,73932.04,379357.95
310825,202207,214,178,36,215737.1,43632,259369.1
310830,202207,454,214,240,259369.72,290880.6,550250.32
310840,202207,358,212,146,258156.2,176952.28,435108.48
310850,202207,74,61,13,73932.65,15756,89688.65
310855,202207,408,320,88,387842.71,106656,494498.71
310860,202207,1622,1195,427,1448360.39,517531.53,1965891.92
310870,202207,55,47,8,56965.32,9696,66661.32
310880,202207,86,69,17,83628,20604,104232
310890,202207,288,166,122,201192.26,147864,349056.26
310900,202207,609,277,332,335725.49,402385.72,738111.21
310910,202207,235,161,74,195134,89688,284822
310920,202207,431,247,184,300583.86,223010.35,523594.21
310925,202207,40,30,10,36360,12120,48480
310930,202207,1319,871,448,1056873.43,542979.43,1599852.86
310940,202207,685,344,341,416933.41,413297.29,830230.70
310945,202207,132,84,48,101808.3,58176,159984.3
310950,202207,217,172,45,208464.19,54540,263004.19
310960,202207,73,24,49,29088,60600,89688
310970,202207,172,100,72,121200.96,87264.6,208465.56
310980,202207,48,33,15,39999.22,18180,58179.22
310990,202207,159,81,78,98172.1,94536.2,192708.3
311000,202207,837,411,426,499348.03,516313.96,1015661.99
311010,202207,50,39,11,47268.07,13332,60600.07
311020,202207,40,25,15,30300.55,18180,48480.55
311030,202207,389,220,169,269065.57,204828,473893.57
311040,202207,43,34,9,41208,10908,52116
311050,202207,494,190,304,230281,368448.6,598729.6
311060,202207,814,449,365,544189.56,442382.02,986571.58
311070,202207,332,149,183,181800.39,221796,403596.39
311080,202207,112,62,50,75144.58,60600.76,135745.34
311090,202207,335,160,175,193923.07,212101.08,406024.15
311100,202207,556,337,219,408446.61,265428.25,673874.86
311110,202207,720,511,209,619339.64,253312.45,872652.09
311115,202207,78,53,25,64236.13,30300,94536.13
311120,202207,1098,593,505,719938.39,613274.69,1333213.08
311130,202207,294,173,121,209677.18,146652,356329.18
311140,202207,161,85,76,103020.2,92113.04,195133.24
311150,202207,337,214,123,259369.96,150288.6,409658.56
311160,202207,760,535,225,649637.61,273912.31,923549.92
311170,202207,89,76,13,92112,15756,107868
311180,202207,313,212,101,256946.8,122412.68,379359.48
311190,202207,37,19,18,23028,21816,44844
311200,202207,345,235,110,284820.44,133320.2,418140.64
311205,202207,32,25,7,30300,8484,38784
311210,202207,36,31,5,37572.6,6060,43632.6
311220,202207,30,26,4,31512,4848,36360
311230,202207,1665,1097,568,1332008.03,689633.84,2021641.87
311240,202207,206,127,79,155136.6,95748.5,250885.1
311250,202207,65,27,38,32724,46056,78780
311260,202207,545,340,205,412084.72,248460,660544.72
311265,202207,125,84,41,101808.2,49692,151500.2
311270,202207,287,196,91,237553.65,110294.3,347847.95
311280,202207,200,87,113,105444,136956,242400
311290,202207,103,86,17,104232,20604.2,124836.2
311300,202207,579,369,210,447233.15,254521.16,701754.31
311310,202207,18,15,3,18180,3636,21816
311320,202207,625,467,158,566008.04,191496,757504.04
311330,202207,1171,861,310,1044752.88,375725.27,1420478.15
311340,202207,2618,1838,780,2228896.94,945364.49,3174261.43
311350,202207,266,204,62,247249.2,75144,322393.2
311360,202207,179,109,70,132108,84840,216948
311370,202207,1245,519,726,630252.67,879915.51,1510168.18
311380,202207,7,6,1,7272,1212,8484
311390,202207,247,141,106,170892.2,128472,299364.2
311400,202207,139,85,54,103020,65448,168468
311410,202207,117,56,61,67872,73932,141804
311420,202207,311,159,152,193921.8,184224,378145.8
311430,202207,830,551,279,667815.65,338149.08,1005964.73
311440,202207,455,307,148,372091.77,179377.48,551469.25
311450,202207,308,181,127,219372,153924,373296
311455,202207,273,188,85,227858.46,103022.34,330880.80
311460,202207,131,57,74,69084,89688,158772
311470,202207,27,12,15,14544,18180,32724
311480,202207,50,26,24,32724,29088,61812
311490,202207,11,6,5,7272,6060,13332
311500,202207,31,15,16,18180.8,19392,37572.8
311510,202207,664,454,210,550257.28,254521.33,804778.61
311520,202207,42,34,8,41208,9696,50904
311530,202207,1792,1287,505,1562300.82,612061.38,2174362.20
311535,202207,63,41,22,49692,26664.52,76356.52
311540,202207,31,27,4,32724,4848,37572
311545,202207,166,116,50,140592.83,61812,202404.83
311547,202207,47,35,12,42420,14544.2,56964.2
311550,202207,655,300,355,363601.52,432685.73,796287.25
311560,202207,44,26,18,31512,21816,53328
311570,202207,289,190,99,231493.96,119988.4,351482.36
311580,202207,419,265,154,322392.6,186648.2,509040.8
311590,202207,28,24,4,29088,4848,33936
311600,202207,96,80,16,96961.37,19392.93,116354.30
311610,202207,252,217,35,263004.58,42420,305424.58
311615,202207,137,116,21,140592.6,25453.24,166045.84
311620,202207,29,17,12,20604,14544,35148
311630,202207,102,87,15,105444,18180,123624
311640,202207,134,68,66,82417.2,79994.28,162411.48
311650,202207,127,89,38,107868,46056.24,153924.24
311660,202207,429,198,231,239976,279972.52,519948.52
311670,202207,147,100,47,121201.57,56964.43,178166.00
311680,202207,212,164,48,199980.2,58176.26,258156.46
311690,202207,13,10,3,12120.5,3636,15756.5
311700,202207,193,142,51,172104.27,61813.02,233917.29
311710,202207,185,124,61,150288.8,73932,224220.8
311720,202207,38,29,9,35148.6,10908,46056.6
311730,202207,571,403,168,488765.95,203616.75,692382.70
311740,202207,25,18,7,21816,8484,30300
311750,202207,728,495,233,599942.96,282396,882338.96
311760,202207,80,34,46,41208,55752.2,96960.2
311770,202207,378,180,198,218160.22,239976,458136.22
311780,202207,193,96,97,116352,117564.2,233916.2
311783,202207,90,82,8,99384.2,9696,109080.2
311787,202207,41,17,24,20604,29088.17,49692.17
311790,202207,261,112,149,135744.8,180588.92,316333.72
311800,202207,724,447,277,541772.69,335724.99,877497.68
311810,202207,51,39,12,47268,14544,61812
311820,202207,118,91,27,110292.87,32724.98,143017.85
311830,202207,1895,1128,767,1367153.2,929604.3,2296757.5
311840,202207,1059,596,463,722358.7,561160.52,1283519.22
311850,202207,15,10,5,12120,6060,18180
311860,202207,10120,4299,5821,5216516.01,7063581.72,12280097.73
311870,202207,107,61,46,73934.03,55752,129686.03
311880,202207,963,698,265,845981.25,322399.8,1168381.05
311890,202207,199,92,107,111404.2,129684,241088.2
311900,202207,64,27,37,32724,44844,77568
311910,202207,1409,877,532,1062931.97,644788.39,1707720.36
311920,202207,230,154,76,186648.34,92112,278760.34
311930,202207,902,507,395,614489.78,481165.72,1095655.50
311940,202207,2652,1424,1228,1725916.4,1488339.04,3214255.44
311950,202207,159,94,65,113929.64,78781.55,192711.19
311960,202207,65,46,19,55752.2,23028,78780.2
311970,202207,22,12,10,14544,12120,26664
311980,202207,41,30,11,36360,13332,49692
311990,202207,38,27,11,32724,13332.64,46056.64
311995,202207,48,28,20,33936,24240.22,58176.22
312000,202207,22,14,8,16968,9696,26664
312010,202207,71,53,18,64236,21816.87,86052.87
312015,202207,81,62,19,75144.69,23028,98172.69
312020,202207,134,95,39,115140,47268,162408
312030,202207,72,52,20,63024.08,24240,87264.08
312040,202207,82,51,31,61812,37572,99384
312050,202207,196,110,86,133321.2,105444,238765.2
312060,202207,21,13,8,15756,9696,25452
312070,202207,78,50,28,60600.55,33936,94536.55
312080,202207,559,258,301,313908.6,364812.3,678720.9
312083,202207,68,42,26,50904.2,32724,83628.2
312087,202207,99,74,25,89688.2,30300,119988.2
312090,202207,3386,2062,1324,2499215.95,1605912.96,4105128.91
312100,202207,148,104,44,125770.5,53328.48,179098.98
312110,202207,119,71,48,86052,58176,144228
312120,202207,130,94,36,115141.17,43632,158773.17
312125,202207,85,56,29,67872.28,35148,103020.28
312130,202207,131,87,44,105444.1,53328,158772.1
312140,202207,135,105,30,127261.16,36360,163621.16
312150,202207,39,31,8,37572,9696,47268
312160,202207,1493,1000,493,1212116.03,597517.4,1809633.43
312170,202207,11,8,3,9696,3636,13332
312180,202207,100,67,33,81204,39996,121200
312190,202207,42,37,5,44844,6060,50904
312200,202207,738,633,105,767206.29,127261.64,894467.93
312210,202207,117,61,56,73932,67873.15,141805.15
312220,202207,134,101,33,122412.4,39996,162408.4
312230,202207,3876,1752,2124,2124663.76,2576720.19,4701383.95
312235,202207,158,104,54,126048,65448,191496
312240,202207,79,56,23,67873.6,27876,95749.6
312245,202207,211,150,61,181801.76,73932.2,255733.96
312247,202207,87,63,24,76356,29088.38,105444.38
312250,202207,173,90,83,109080.44,100596,209676.44
312260,202207,103,67,36,81204,43632,124836
312270,202207,136,79,57,95748.92,69084,164832.92
312280,202207,33,17,16,20604,19392,39996
312290,202207,142,95,47,115141.55,56965.3,172106.85
312300,202207,207,136,71,164834.07,86052.1,250886.17
312310,202207,58,50,8,60600,9696,70296
312320,202207,416,256,160,310272.82,195132,505404.82
312330,202207,92,78,14,94536,16968.1,111504.1
312340,202207,34,17,17,20604,20604,41208
312350,202207,13,7,6,8484,7272,15756
312352,202207,97,69,28,83628.6,33936,117564.6
312360,202207,571,246,325,298153.9,395112.2,693266.1
312370,202207,347,189,158,229068.6,191497.33,420565.93
312380,202207,142,93,49,112720.48,59389.12,172109.60
312385,202207,160,132,28,159985.68,33936.3,193921.98
312390,202207,289,185,104,224220,126048,350268
312400,202207,377,279,98,338148,119989.55,458137.55
312410,202207,1182,425,757,515106.76,917488.33,1432595.09
312420,202207,664,505,159,612064.73,192709.23,804773.96
312430,202207,868,631,237,764775.13,287245.46,1052020.59
312440,202207,41,32,9,38784,10908,49692
312450,202207,195,124,71,150288,86052,236340
312460,202207,28,14,14,16968,16968,33936
312470,202207,46,31,15,37572,18180,55752
312480,202207,164,100,64,121200.1,77568.99,198769.09
312490,202207,311,211,100,255733.64,121200.7,376934.34
312500,202207,33,22,11,26664.2,13332,39996.2
312510,202207,619,238,381,288459.51,461775.9,750235.41
312520,202207,28,8,20,9696,24240,33936
312530,202207,35,25,10,30300.6,12120.1,42420.7
312540,202207,87,77,10,93324,12120,105444
312550,202207,35,28,7,33936,8484,42420
312560,202207,201,157,44,190285.4,53328,243613.4
312570,202207,459,271,188,328457.13,227858.09,556315.22
312580,202207,89,51,38,61812,47268,109080
312590,202207,221,175,46,212100.71,55752,267852.71
312595,202207,132,108,24,130896.05,29088,159984.05
312600,202207,73,33,40,39996.4,48480,88476.4
312610,202207,1564,803,761,973255.38,923544.1,1896799.48
312620,202207,225,163,62,197556.9,75144,272700.9
312630,202207,68,55,13,66660,15756,82416
312640,202207,41,11,30,13332,36360,49692
312650,202207,152,127,25,154333.94,30300.1,184634.04
312660,202207,106,77,29,93328.93,35149.2,128478.13
312670,202207,932,599,333,727206.26,403600.78,1130807.04
312675,202207,44,33,11,39996,13332,53328
312680,202207,69,43,26,52116,31512,83628
312690,202207,248,127,121,153925.02,146652,300577.02
312695,202207,27,24,3,29088,3636,32724
312700,202207,245,139,106,168470.76,128472,296942.76
312705,202207,83,67,16,81204,19392,100596
312707,202207,131,93,38,112716.49,46056,158772.49
312710,202207,1882,1043,839,1265352.63,1018083.41,2283436.04
312720,202207,46,21,25,25452,30300,55752
312730,202207,263,155,108,189073.81,130898.72,319972.53
312733,202207,48,37,11,44844,13332,58176
312735,202207,22,15,7,18180,8484.2,26664.2
312737,202207,74,41,33,49692,39996,89688
312738,202207,66,42,24,50904.08,29088,79992.08
312740,202207,74,49,25,59388,30300,89688
312750,202207,101,68,33,82416,39996,122412
312760,202207,281,195,86,236341.88,104233,340574.88
312770,202207,8735,4115,4620,4989884.11,5601876.42,10591760.53
312780,202207,445,339,106,410868.67,128472.94,539341.61
312790,202207,21,15,6,18180,7272,25452
312800,202207,1623,1128,495,1368358.61,599943.06,1968301.67
312810,202207,348,239,109,289669.34,132108,421777.34
312820,202207,187,140,47,169680.2,56964,226644.2
312825,202207,40,28,12,33936,14544,48480
312830,202207,193,107,86,129684,104232.49,233916.49
312840,202207,184,127,57,153924,69084,223008
312850,202207,38,35,3,42420,3636,46056
312860,202207,142,94,48,113928,58176,172104
312870,202207,1139,588,551,712671.17,669024.73,1381695.90
312880,202207,115,82,33,99384.81,39996,139380.81
312890,202207,166,120,46,145440.21,55752,201192.21
312900,202207,171,127,44,153924.42,53328,207252.42
312910,202207,174,102,72,123626.58,88476.2,212102.78
312920,202207,129,70,59,84840,71508,156348
312930,202207,323,220,103,266641.46,124837.46,391478.92
312940,202207,140,97,43,117564,52116,169680
312950,202207,739,511,228,619339.45,276337.32,895676.77
312960,202207,143,105,38,127262.01,47269.03,174531.04
312965,202207,111,90,21,109080.43,25452,134532.43
312970,202207,282,230,52,278764.07,64236,343000.07
312980,202207,2651,1354,1297,1643497.53,1571970.96,3215468.49
312990,202207,47,20,27,24240.82,32724,56964.82
313000,202207,52,29,23,35148,27876,63024
313005,202207,181,139,42,168468.4,50904.2,219372.6
313010,202207,956,402,554,488438.4,672662.23,1161100.63
313020,202207,190,99,91,119988,110292,230280
313030,202207,202,132,70,159984.76,84840,244824.76
313040,202207,92,28,64,33936.08,77568,111504.08
313050,202207,194,140,54,169680,65448,235128
313055,202207,40,30,10,36360,12120,48480
313060,202207,143,96,47,116352.6,56964.65,173317.25
313065,202207,59,44,15,53328,18180.6,71508.6
313070,202207,128,67,61,81205.46,73932,155137.46
313080,202207,40,21,19,25452.6,23028,48480.6
313090,202207,675,434,241,526009.91,292092.98,818102.89
313100,202207,209,78,131,94536.2,158772,253308.2
313110,202207,149,83,66,100596.1,79993.72,180589.82
313115,202207,219,118,101,143016.6,122412.1,265428.7
313120,202207,846,483,363,585400.78,439958.01,1025358.79
313130,202207,5980,3268,2712,3963287.63,3286961.72,7250249.35
313140,202207,131,74,57,89688.79,69084,158772.79
313150,202207,294,231,63,279972.47,76356,356328.47
313160,202207,191,145,46,175744.38,55752,231496.38
313170,202207,1391,895,496,1084754.01,601154.85,1685908.86
313180,202207,319,197,122,238767.65,147865.45,386633.10
313190,202207,736,428,308,518738.22,373296.98,892035.20
313200,202207,34,27,7,32724,8484.2,41208.2
313210,202207,1003,863,140,1045977.28,169682.84,1215660.12
313220,202207,303,178,125,215736.96,151500,367236.96
313230,202207,268,202,66,244824.52,79992,324816.52
313240,202207,2271,1133,1138,1373213.34,1379257.76,2752471.10
313250,202207,1253,939,314,1139294.33,381783.79,1521078.12
313260,202207,89,41,48,49692,58176,107868
313270,202207,1028,602,426,729628.85,517528.08,1247156.93
313280,202207,46,39,7,47268,8484,55752
313290,202207,221,178,43,215738.01,52116,267854.01
313300,202207,326,165,161,199980.4,195132,395112.4
313310,202207,240,106,134,128472.2,162408.8,290881.0
313320,202207,385,280,105,339362.74,127260.9,466623.64
313330,202207,1451,892,559,1081115.25,677510.12,1758625.37
313340,202207,331,240,91,290881.13,110292.7,401173.83
313350,202207,461,293,168,355116.36,203616,558732.36
313360,202207,187,88,99,106656.73,119988,226644.73
313370,202207,234,81,153,98172.74,186648,284820.74
313375,202207,315,186,129,225433.44,156348,381781.44
313380,202207,1338,716,622,869016.77,755079.01,1624095.78
313390,202207,54,48,6,58176,7272,65448
313400,202207,400,277,123,335731.25,149076.6,484807.85
313410,202207,44,21,23,25452.8,27876,53328.8
313420,202207,4672,2603,2069,3157335.74,2510062.49,5667398.23
313430,202207,121,61,60,75144,72720.62,147864.62
313440,202207,1376,970,406,1175665.9,492077.43,1667743.33
313450,202207,67,33,34,39996.15,41208,81204.15
313460,202207,388,167,221,202407.06,269064.64,471471.70
313470,202207,518,243,275,294523.37,333303.19,627826.56
313480,202207,161,119,42,144229.8,50904,195133.8
313490,202207,548,249,299,301791.4,362391.2,664182.6
313500,202207,31,17,14,20604,16968,37572
313505,202207,1085,834,251,1013241.13,306637.83,1319878.96
313507,202207,98,66,32,79993.42,38784,118777.42
313510,202207,2889,1789,1100,2169629.81,1336846.9,3506476.71
313520,202207,3440,2673,767,3243382.06,930824.22,4174206.28
313530,202207,35,20,15,24240,18180,42420
313535,202207,84,70,14,84840.45,16968,101808.45
313540,202207,64,47,17,56964,20604,77568
313545,202207,115,99,16,119988.76,19392,139380.76
313550,202207,218,185,33,224220.3,39997.39,264217.69
313560,202207,350,165,185,199981.81,224224.57,424206.38
313570,202207,76,28,48,33936.97,58176,92112.97
313580,202207,1330,770,560,934459.08,678722.55,1613181.63
313590,202207,66,40,26,48480,31512,79992
313600,202207,678,407,271,493285.55,328453.77,821739.32
313610,202207,53,43,10,52116.99,12120,64236.99
313620,202207,1403,674,729,816901.3,883550.66,1700451.96
313630,202207,1636,1244,392,1507773.92,475106.97,1982880.89
313640,202207,118,72,46,87264.37,55752,143016.37
313650,202207,227,115,112,139380.6,136956.95,276337.55
313652,202207,26,26,0,31512,,31512.0
313655,202207,84,52,32,63024.76,38784.51,101809.27
313657,202207,49,44,5,53328.7,6060,59388.7
313660,202207,129,86,43,104234.11,52116.62,156350.73
313665,202207,706,324,382,392693.24,462988.47,855681.71
313670,202207,10587,7255,3332,8798087.51,4043259.68,12841347.19
313680,202207,41,32,9,38784.2,10908,49692.2
313690,202207,133,95,38,115140.1,46056,161196.1
313695,202207,84,64,20,78780.62,24240,103020.62
313700,202207,335,258,77,312698.89,93324.2,406023.09
313710,202207,127,93,34,112717.59,41208.2,153925.79
313720,202207,1191,547,644,662976.17,781745.95,1444722.12
313730,202207,69,38,31,46056,37572,83628
313740,202207,147,112,35,135744.2,42420,178164.2
313750,202207,412,290,122,351481.49,147864,499345.49
313753,202207,229,170,59,206040.88,71508.1,277548.98
313760,202207,1366,527,839,638728.85,1016872.54,1655601.39
313770,202207,409,284,125,344212.97,151500.92,495713.89
313780,202207,845,453,392,549040.69,477529.47,1026570.16
313790,202207,32,32,0,38784,,38784.0
313800,202207,160,101,59,122412.97,72722.65,195135.62
313810,202207,85,49,36,59388,43632,103020
313820,202207,1372,660,712,799928.48,862947.18,1662875.66
313830,202207,53,37,16,44844,19392,64236
313835,202207,62,53,9,64236.2,10908,75144.2
313840,202207,1692,1012,680,1226562.37,824162.44,2050724.81
313850,202207,215,91,124,110293.62,150288,260581.62
313860,202207,469,355,114,430265.42,138168.64,568434.06
313862,202207,177,120,57,145441.53,69084.2,214525.73
313865,202207,172,118,54,143016,65448.3,208464.3
313867,202207,57,46,11,55752,13332,69084
313868,202207,45,29,16,35148,19392,54540
313870,202207,86,46,40,55752,48480,104232
313880,202207,383,238,145,289669.29,175740.4,465409.69
313890,202207,338,184,154,223012.02,186648,409660.02
313900,202207,826,446,380,541770.61,460564.85,1002335.46
313910,202207,147,98,49,118776,59388,178164
313920,202207,643,435,208,527221.21,252096.7,779317.91
313925,202207,36,31,5,37572,6060,43632
313930,202207,901,692,209,838713.04,253308.84,1092021.88
313940,202207,1937,1170,767,1420479.32,930819.68,2351299.00
313950,202207,853,521,332,631457.61,402384.2,1033841.81
313960,202207,1457,828,629,1004756.23,762352.94,1767109.17
313970,202207,183,106,77,128472,93324,221796
313980,202207,223,144,79,174530.76,95749.41,270280.17
313990,202207,257,163,94,197556.7,113928,311484.7
314000,202207,865,571,294,692053.81,356328.8,1048382.61
314010,202207,90,53,37,64236,44844,109080
314015,202207,85,22,63,26664.71,76356.62,103021.33
314020,202207,57,39,18,47268.16,21816,69084.16
314030,202207,73,37,36,44844.7,43632,88476.7
314040,202207,44,23,21,27876,25452,53328
314050,202207,290,164,126,199983.02,153924,353907.02
314053,202207,94,59,35,71509.21,42420,113929.21
314055,202207,302,188,114,227857.37,138168,366025.37
314060,202207,118,101,17,122412.64,20604,143016.64
314070,202207,1079,540,539,654484.57,654485.49,1308970.06
314080,202207,207,130,77,157562.68,93324.84,250887.52
314085,202207,170,119,51,144228,61812,206040
314090,202207,385,276,109,334513.47,132108,466621.47
314100,202207,529,419,110,509046.22,133322.68,642368.90
314110,202207,765,345,420,418145.68,509042.78,927188.46
314120,202207,66,37,29,44844,35148,79992
314130,202207,25,18,7,21816,8484,30300
314140,202207,1137,716,421,869021.4,511467.25,1380488.65
314150,202207,187,120,67,145440.91,81204,226644.91
314160,202207,313,234,79,283610.25,95748,379358.25
314170,202207,81,63,18,76356.99,21816,98172.99
314180,202207,757,665,92,805989.04,111507.43,917496.47
314190,202207,85,53,32,64236,38784,103020
314200,202207,503,340,163,412090.01,197558.97,609648.98
314210,202207,255,195,60,236340.3,72720.6,309060.9
314220,202207,302,215,87,260583.09,105445.69,366028.78
314225,202207,53,35,18,42421.79,21816,64237.79
314230,202207,120,54,66,65448,79992,145440
314240,202207,172,124,48,150288.2,58176.07,208464.27
314250,202207,58,36,22,43632.82,26664,70296.82
314260,202207,219,104,115,126048.2,139380,265428.2
314270,202207,414,325,89,393905.26,107868.2,501773.46
314280,202207,735,401,334,487170.77,404808.2,891978.97
314290,202207,536,419,117,507830.04,141805.7,649635.74
314300,202207,344,259,85,313912.55,103020,416932.55
314310,202207,1338,925,413,1122647.45,501769.85,1624417.30
314315,202207,43,32,11,38784,13332,52116
314320,202207,589,403,186,489650.5,225432.38,715082.88
314330,202207,11641,5670,5971,6875816.9,7241732.07,14117548.97
314340,202207,630,283,347,342996.35,420568.43,763564.78
314345,202207,57,41,16,49692,19392,69084
314350,202207,180,111,69,134532,83628,218160
314360,202207,53,30,23,36362.66,27877.44,64240.10
314370,202207,70,51,19,61812,23028,84840
314380,202207,123,72,51,87264.5,61812,149076.5
314390,202207,3416,2210,1206,2682199.33,1462886.98,4145086.31
314400,202207,687,478,209,579342.83,253310.34,832653.17
314410,202207,520,344,176,416930.36,213312.02,630242.38
314420,202207,18,9,9,10908,10908,21816
314430,202207,2477,917,1560,1111412.18,1890735.37,3002147.55
314435,202207,171,99,72,119988.68,87264,207252.68
314437,202207,42,30,12,36360,14544,50904
314440,202207,93,60,33,72720.2,39996.1,112716.3
314450,202207,166,115,51,139380,61812.84,201192.84
314460,202207,628,304,324,368450.99,392691.2,761142.19
314465,202207,113,75,38,90900.77,46056,136956.77
314467,202207,74,60,14,72720.1,16968,89688.1
314470,202207,413,206,207,249674.3,250886.16,500560.46
314480,202207,1050,474,576,574492.25,698113.09,1272605.34
314490,202207,40,22,18,26664,21816,48480
314500,202207,278,195,83,236341.47,100596.45,336937.92
314505,202207,115,74,41,89689.43,49692,139381.43
314510,202207,242,195,47,236341.46,56964,293305.46
314520,202207,1433,753,680,912645.17,824170.14,1736815.31
314530,202207,755,596,159,724795.22,192710.03,917505.25
314535,202207,169,105,64,127260,77568,204828
314537,202207,69,42,27,50904.13,32724,83628.13
314540,202207,17,10,7,12120,8484,20604
314545,202207,60,41,19,49692,23028,72720
314550,202207,70,37,33,44844.29,39997.07,84841.36
314560,202207,875,464,411,562371.6,498135.6,1060507.2
314570,202207,17,14,3,16968.3,3636,20604.3
314580,202207,13,7,6,8484.77,7272,15756.77
314585,202207,26,19,7,23028,8484,31512
314587,202207,82,71,11,86052,13332,99384
314590,202207,579,397,182,482379.79,220585.04,702964.83
314600,202207,969,628,341,762358.15,413295.95,1175654.10
314610,202207,963,493,470,597517.78,572067.1,1169584.88
314620,202207,146,109,37,132108.2,44844,176952.2
314625,202207,99,75,24,90900,30300,121200
314630,202207,1140,616,524,746603.61,635091.83,1381695.44
314640,202207,86,54,32,65449.68,38784.6,104234.28
314650,202207,155,88,67,106656.46,81204.06,187860.52
314655,202207,60,45,15,54540,18180,72720
314660,202207,17,11,6,13332,7272,20604
314670,202207,213,168,45,203619.78,54540.48,258160.26
314675,202207,209,125,84,151501.24,101808,253309.24
314690,202207,592,317,275,385417.16,334513.1,719930.26
314700,202207,2183,1163,1020,1410793.79,1238668.63,2649462.42
314710,202207,1834,1030,804,1250797.47,974449.18,2225246.65
314720,202207,395,223,172,270276.75,208464.05,478740.80
314730,202207,514,276,238,335724,289668,625392
314740,202207,768,351,417,425417.24,506616.76,932034.00
314750,202207,20,16,4,19392,4848,24240
314760,202207,360,146,214,176952,259368.8,436320.8
314770,202207,104,69,35,83628,42420,126048
314780,202207,21,8,13,9696,15756,25452
314790,202207,2500,1573,927,1908614.71,1127160.6,3035775.31
314795,202207,61,54,7,65448.1,8484,73932.1
314800,202207,2943,1706,1237,2068906.16,1499246.18,3568152.34
314810,202207,1479,844,635,1022939.55,769620.78,1792560.33
314820,202207,114,69,45,83629.1,54540.1,138169.2
314830,202207,213,177,36,214525.46,43632,258157.46
314840,202207,88,49,39,59388,47268,106656
314850,202207,417,203,214,246036.82,259368,505404.82
314860,202207,637,484,153,586609.95,185436,772045.95
314870,202207,1614,843,771,1021723.52,934461.02,1956184.54
314875,202207,59,56,3,67872,3636,71508
314880,202207,39,28,11,33936,13332,47268
314890,202207,50,27,23,32724,27876,60600
314900,202207,26,20,6,24240,7272.92,31512.92
314910,202207,230,152,78,184224.44,94536,278760.44
314915,202207,138,120,18,145440.89,21816.18,167257.07
314920,202207,79,52,27,63024.85,32724,95748.85
314930,202207,1018,480,538,581769.59,653273.34,1235042.93
314940,202207,40,31,9,37572,10908.1,48480.1
314950,202207,22,19,3,23028,3636,26664
314960,202207,26,20,6,24240,7272,31512
314970,202207,172,82,90,99384.93,109081.04,208465.97
314980,202207,300,188,112,227856.87,135744.75,363601.62
314990,202207,453,242,211,293306.38,255732.99,549039.37
314995,202207,152,65,87,78780.2,105444,184224.2
315000,202207,92,71,21,86052.49,25452.8,111505.29
315010,202207,32,20,12,24240,14544,38784
315015,202207,159,126,33,153924.2,39996,193920.2
315020,202207,64,54,10,65448,12120,77568
315030,202207,103,77,26,93324,31512,124836
315040,202207,83,48,35,58176,42420,100596
315050,202207,210,130,80,157560.65,96960.32,254520.97
315053,202207,52,35,17,42420,20604,63024
315057,202207,119,93,26,112716,31512,144228
315060,202207,66,54,12,65449.48,14544,79993.48
315070,202207,104,60,44,72720.19,53328.17,126048.36
315080,202207,393,309,84,374511.48,101808.83,476320.31
315090,202207,96,55,41,66660.69,49692,116352.69
315100,202207,83,42,41,50904.96,49692,100596.96
315110,202207,274,138,136,167256.74,164832,332088.74
315120,202207,1841,879,962,1066576.72,1167173.21,2233749.93
315130,202207,337,242,95,293305.09,115140.08,408445.17
315140,202207,547,297,250,359964.83,303001.41,662966.24
315150,202207,996,481,515,582976.52,624183.3,1207159.82
315160,202207,190,98,92,118779.55,111505.57,230285.12
315170,202207,295,194,101,236341.64,122412.6,358754.24
315180,202207,3239,1375,1864,1666523.09,2262813.22,3929336.31
315190,202207,293,180,113,218162.41,136956,355118.41
315200,202207,1184,704,480,854471.13,584186.81,1438657.94
315210,202207,1687,990,697,1199900.72,844767.94,2044668.66
315213,202207,27,16,11,19392.46,13332,32724.46
315217,202207,202,160,42,193920.2,50904,244824.2
315220,202207,1611,1190,421,1442291.18,510258.66,1952549.84
315230,202207,178,137,41,166044.54,49692,215736.54
315240,202207,374,244,130,295733.35,157563.86,453297.21
315250,202207,2618,1241,1377,1506532.59,1671351.01,3177883.60
315260,202207,136,75,61,90900,73932,164832
315270,202207,135,95,40,115140.51,48480,163620.51
315280,202207,605,399,206,483596.5,249679.29,733275.79
315290,202207,183,114,69,138168.5,83628.84,221797.34
315300,202207,103,79,24,95748.9,29088,124836.9
315310,202207,83,75,8,90900,9696,100596
315320,202207,144,90,54,109080.77,65448,174528.77
315330,202207,61,48,13,58176,15756,73932
315340,202207,390,281,109,341785.47,132109.2,473894.67
315350,202207,163,102,61,123624,73932,197556
315360,202207,101,44,57,53328,69084,122412
315370,202207,56,35,21,42420.32,25452,67872.32
315380,202207,5,5,0,6060,,6060.0
315390,202207,61,21,40,25452,48481.08,73933.08
315400,202207,793,596,197,722360.4,239977.2,962337.6
315410,202207,308,181,127,219378.67,153927.28,373305.95
315415,202207,57,42,15,50904,18180,69084
315420,202207,192,142,50,172104.8,60600,232704.8
315430,202207,664,375,289,454501.5,350268,804769.5
315440,202207,93,62,31,75144.6,37572,112716.6
315445,202207,222,184,38,223011.09,46056.37,269067.46
315450,202207,177,128,49,156348,59388,215736
315460,202207,4580,2121,2459,2571911.95,2981541.3,5553453.25
315470,202207,47,19,28,23028,33936,56964
315480,202207,70,21,49,25452.2,59388.3,84840.5
315490,202207,715,448,267,542980.19,323605.31,866585.50
315500,202207,18,15,3,18180.8,3636,21816.8
315510,202207,143,99,44,119988,53328,173316
315520,202207,76,65,11,78780,13332,92112
315530,202207,42,24,18,29088,21816.2,50904.2
315540,202207,271,188,83,229071.51,100596.18,329667.69
315550,202207,185,149,36,180589.27,44844,225433.27
315560,202207,713,562,151,682362.93,183012.9,865375.83
315570,202207,302,149,153,180591.84,185438.05,366029.89
315580,202207,752,506,246,613272.3,299364.8,912637.1
315590,202207,190,98,92,118778.1,111504.51,230282.61
315600,202207,332,254,78,307849.67,95748.78,403598.45
315610,202207,99,46,53,55752,64236,119988
315620,202207,36,29,7,35148,8484,43632
315630,202207,128,93,35,112716,42420,155136
315640,202207,63,37,26,44844,31512.8,76356.8
315645,202207,47,31,16,37572,19392,56964
315650,202207,169,122,47,147865.58,56964,204829.58
315660,202207,444,200,244,242404.97,295729.65,538134.62
315670,202207,2414,1114,1300,1350183.7,1576822.76,2927006.46
315680,202207,777,557,220,675087.48,267852.5,942939.98
315690,202207,678,446,232,541767.32,281185.94,822953.26
315700,202207,2003,1051,952,1273836.23,1153840.39,2427676.62
315710,202207,362,119,243,144229.36,294516.94,438746.30
315720,202207,504,301,203,364814.74,246036.42,610851.16
315725,202207,193,153,40,185436.87,48480,233916.87
315727,202207,70,39,31,47268.87,37572,84840.87
315730,202207,52,46,6,55752,7272,63024
315733,202207,84,52,32,63024,38784,101808
315737,202207,50,38,12,46056.4,14544,60600.4
315740,202207,30,22,8,26664,9696,36360
315750,202207,159,115,44,139380,53328.96,192708.96
315760,202207,45,33,12,39996,14544,54540
315765,202207,129,76,53,92113.82,64236.92,156350.74
315770,202207,224,146,78,176952,94536,271488
315780,202207,3850,1891,1959,2291924.8,2375525.08,4667449.88
315790,202207,242,185,57,224221.59,69084.38,293305.97
315800,202207,309,203,106,246036.94,128472,374508.94
315810,202207,60,35,25,42420.84,30300,72720.84
315820,202207,753,551,202,667823.08,244826.54,912649.62
315830,202207,122,78,44,94536.1,53328.7,147864.8
315840,202207,79,53,26,64236,31512,95748
315850,202207,271,179,92,216948.81,111505.15,328453.96
315860,202207,18,6,12,7272,14544,21816
315870,202207,41,31,10,37572,12120,49692
315880,202207,93,63,30,76356,36360,112716
315890,202207,104,77,27,93324,32724,126048
315895,202207,403,266,137,322396.94,166046.63,488443.57
315900,202207,83,39,44,48480,53328.08,101808.08
315910,202207,45,27,18,32724,21816,54540
315920,202207,153,101,52,122412.3,63024,185436.3
315930,202207,53,17,36,20605.2,43633,64238.2
315935,202207,125,99,26,119991.38,31512.23,151503.61
315940,202207,100,75,25,90900,30300,121200
315950,202207,30,21,9,25452,10908,36360
315960,202207,564,269,295,327242.84,357545.15,684787.99
315970,202207,29,23,6,27876.62,7272,35148.62
315980,202207,662,333,329,403604.61,398749.96,802354.57
315990,202207,260,148,112,180588.92,135744.48,316333.40
316000,202207,48,31,17,37572,20604,58176
316010,202207,88,73,15,88476.69,18180,106656.69
316020,202207,109,94,15,113928.49,18180,132108.49
316030,202207,374,214,160,259368.86,193921.55,453290.41
316040,202207,554,223,331,270277.46,401172.2,671449.66
316045,202207,50,45,5,54540,6060,60600
316050,202207,20,14,6,16968,7272,24240
316060,202207,106,72,34,87264.3,41208,128472.3
316070,202207,1187,791,396,958699.64,479954.69,1438654.33
316080,202207,91,59,32,71615.5,38784,110399.5
316090,202207,37,18,19,21816,23028.95,44844.95
316095,202207,85,72,13,87265.29,15756,103021.29
316100,202207,331,186,145,225435.06,175740,401175.06
316105,202207,41,24,17,29089.49,20604,49693.49
316110,202207,1882,1466,416,1776809.51,504199.81,2281009.32
316120,202207,78,52,26,63024,31512,94536
316130,202207,117,86,31,104234.39,37572,141806.39
316140,202207,34,23,11,27876,13332,41208
316150,202207,212,147,65,178164.2,78780.33,256944.53
316160,202207,80,49,31,59388,37572,96960
316165,202207,75,49,26,59388,31512,90900
316170,202207,184,119,65,144228.1,78780,223008.1
316180,202207,214,84,130,103020.6,158772.6,261793.2
316190,202207,146,106,40,128472,48480,176952
316200,202207,655,356,299,431476.3,362388.29,793864.59
316210,202207,756,507,249,615908.37,301790.53,917698.90
316220,202207,118,74,44,89688,53328,143016
316225,202207,38,24,14,29088.2,16968,46056.2
316230,202207,41,21,20,25452,24240,49692
316240,202207,664,528,136,639941.66,164832.92,804774.58
316245,202207,160,141,19,170893.22,23028,193921.22
316250,202207,1635,1102,533,1339276.1,645997.84,1985273.94
316255,202207,136,109,27,132108,32724.6,164832.6
316257,202207,177,91,86,110292,104232,214524
316260,202207,197,135,62,163620.3,75144.2,238764.5
316265,202207,32,22,10,26664.1,12120,38784.1
316270,202207,675,482,193,584187.32,235129.76,819317.08
316280,202207,550,341,209,413297.71,253310.9,666608.61
316290,202207,836,573,263,694485.08,318758.76,1013243.84
316292,202207,595,242,353,293305.55,427837.22,721142.77
316294,202207,100,63,37,76356.41,44844.29,121200.70
316295,202207,370,169,201,204829.65,243614.38,448444.03
316300,202207,11,9,2,10908,2424,13332
316310,202207,26,14,12,16968,14544,31512
316320,202207,62,30,32,36361.59,38784,75145.59
316330,202207,179,121,58,146652.2,70296,216948.2
316340,202207,135,88,47,106656,56964,163620
316350,202207,193,133,60,161196.2,72720,233916.2
316360,202207,26,15,11,18180,13332,31512
316370,202207,1242,605,637,733267.52,772047.88,1505315.40
316380,202207,113,87,26,105444.5,31512,136956.5
316390,202207,100,73,27,88476,32724,121200
316400,202207,145,110,35,133320.4,42420,175740.4
316410,202207,296,209,87,253308.2,105444.2,358752.4
316420,202207,218,147,71,178167.31,86052.4,264219.71
316430,202207,155,85,70,103020,84840,187860
316440,202207,74,38,36,46056,43632.97,89688.97
316443,202207,45,38,7,46056.87,8484,54540.87
316447,202207,46,38,8,47269.23,9696,56965.23
316450,202207,231,176,55,214524.2,66660,281184.2
316460,202207,47,16,31,19392.1,37572.2,56964.3
316470,202207,1742,1274,468,1544101.94,568428,2112529.94
316480,202207,10,8,2,9696,2424,12120
316490,202207,20,7,13,8484,15756,24240
316500,202207,163,105,58,127260.16,70296,197556.16
316510,202207,140,110,30,133320,36360,169680
316520,202207,188,106,82,129684.85,99384.42,229069.27
316530,202207,167,107,60,129684,72720,202404
316540,202207,159,79,80,95748.17,98172,193920.17
316550,202207,148,88,60,106656.72,72720,179376.72
316553,202207,387,184,203,224221,246036.97,470257.97
316555,202207,56,50,6,60600.73,7272,67872.73
316556,202207,13,9,4,10908,4848,15756
316557,202207,30,23,7,27876,8484,36360
316560,202207,74,51,23,61812,27876,89688
316570,202207,206,188,18,227856.92,21816,249672.92
316580,202207,20,15,5,18180,6060,24240
316590,202207,89,75,14,90900.62,16968.6,107869.22
316600,202207,178,146,32,176952,38784,215736
316610,202207,67,49,18,59389.07,21816,81205.07
316620,202207,136,95,41,116352.2,49692.59,166044.79
316630,202207,47,36,11,43632,13332,56964
316640,202207,22,13,9,15756,10908,26664
316650,202207,98,81,17,98172,20604,118776
316660,202207,6,2,4,2424,4848,7272
316670,202207,433,148,285,179377.75,345421.22,524798.97
316680,202207,161,123,38,149077.47,46056.4,195133.87
316690,202207,169,103,66,124836,79992,204828
316695,202207,56,48,8,58176,9696,67872
316700,202207,24,17,7,20604.79,8484,29088.79
316710,202207,784,597,187,723567.63,226645.79,950213.42
316720,202207,5060,2389,2671,2895515.5,3237258.66,6132774.16
316730,202207,14,14,0,16968,,16968.0
316740,202207,153,95,58,115140,70296,185436
316750,202207,22,13,9,15756,10908,26664
316760,202207,314,251,63,305424.95,77568.49,382993.44
316770,202207,171,88,83,106656,100596,207252
316780,202207,67,39,28,47268.6,33936,81204.6
316790,202207,59,42,17,50904,20604,71508
316800,202207,1787,1092,695,1323516.95,842349.64,2165866.59
316805,202207,31,23,8,27876,9696,37572
316810,202207,60,36,24,43632,29088.7,72720.7
316820,202207,38,21,17,25452,20604,46056
316830,202207,97,44,53,53328.61,64236.12,117564.73
316840,202207,505,301,204,364815.72,248463.95,613279.67
316850,202207,307,209,98,253310.67,118776.97,372087.64
316860,202207,6267,2783,3484,3374276.17,4225048.65,7599324.82
316870,202207,1646,1050,596,1275053.8,723570.03,1998623.83
316880,202207,154,78,76,94536.32,92112.95,186649.27
316890,202207,227,153,74,185436.88,89688.69,275125.57
316900,202207,409,287,122,347846.76,147864,495710.76
316905,202207,23,10,13,12120,15756,27876
316910,202207,77,35,42,42420,50904,93324
316920,202207,141,108,33,130898.36,39996,170894.36
316930,202207,1945,987,958,1196256.08,1161098.05,2357354.13
316935,202207,958,572,386,693271,469049.2,1162320.2
316940,202207,1113,646,467,782956.18,566004.6,1348960.78
316950,202207,178,83,95,100596.95,116352,216948.95
316960,202207,1103,620,483,751454.04,587822.99,1339277.03
316970,202207,645,510,135,618127.93,164834.01,782961.94
316980,202207,83,42,41,50904,49692,100596
316990,202207,2231,1510,721,1830138.49,873854.16,2703992.65
317000,202207,337,262,75,317549.04,90900.76,408449.80
317005,202207,213,150,63,181801.35,76356,258157.35
317010,202207,6728,3797,2931,4605710.66,3554826.4,8160537.06
317020,202207,15833,6953,8880,8432082.78,10772319,19204401.78
317030,202207,93,41,52,49692.19,63024,112716.19
317040,202207,3116,2008,1108,2433729.23,1342899.89,3776629.12
317043,202207,75,57,18,69086.98,21816.8,90903.78
317047,202207,39,23,16,27876,19392,47268
317050,202207,145,112,33,135744.89,39996,175740.89
317052,202207,151,121,30,146652.2,36360,183012.2
317057,202207,182,135,47,163621.34,56964,220585.34
317060,202207,64,38,26,46056,31512.2,77568.2
317065,202207,52,38,14,46056,16968,63024
317070,202207,1906,877,1029,1062938.23,1247152.57,2310090.80
317075,202207,95,52,43,63024.15,52116,115140.15
317080,202207,939,479,460,580568.96,558732.29,1139301.25
317090,202207,700,548,152,664180.17,185440.25,849620.42
317100,202207,426,320,106,387841.66,128472,516313.66
317103,202207,122,95,27,116352.75,32724,149076.75
317107,202207,48,40,8,48480,9696,58176
317110,202207,81,43,38,52116.91,46056.09,98173.00
317115,202207,44,40,4,48480,4848,53328
317120,202207,2061,1006,1055,1219294.96,1278662.8,2497957.76
317130,202207,2077,1388,689,1682278.85,836281.25,2518560.10
317140,202207,13,10,3,12120.1,3636,15756.1
317150,202207,279,167,112,202404.84,135744.71,338149.55
317160,202207,347,259,88,313910.15,106656.46,420566.61
317170,202207,239,158,81,191496.73,98172.1,289668.83
317180,202207,424,289,135,350269.11,163621.47,513890.58
317190,202207,258,185,73,224220.2,88476,312696.2
317200,202207,829,571,258,693277.4,312702.64,1005980.04
317210,202207,180,94,86,113931.58,104232,218163.58
317220,202207,23,12,11,14544,13332,27876
320010,202207,556,399,157,483592.37,190286.64,673879.01
320013,202207,126,83,43,100596.6,53328,153924.6
320016,202207,251,154,97,186648.92,117564,304212.92
320020,202207,729,431,298,523593.63,362392.36,885985.99
320030,202207,164,112,52,135744.54,63024.46,198769.00
320035,202207,133,96,37,116352.2,44844,161196.2
320040,202207,493,245,248,296941.63,300580.01,597521.64
320050,202207,115,79,36,95750.42,43633,139383.42
320060,202207,1831,840,991,1018090.82,1202311.08,2220401.90
320070,202207,97,61,36,73932.25,43632,117564.25
320080,202207,817,468,349,567224.89,422990.5,990215.39
320090,202207,1286,826,460,1002334.35,557526.26,1559860.61
320100,202207,336,197,139,238766.68,168469.4,407236.08
320110,202207,125,77,48,93329.41,58176.2,151505.61
320115,202207,107,91,16,110292,19392,129684
320120,202207,3683,1902,1781,2307677.53,2161020.9,4468698.43
320130,202207,7947,3454,4493,4188725.27,5446784.06,9635509.33
320140,202207,463,295,168,357546.17,203620.41,561166.58
320150,202207,2123,1168,955,1416845.78,1158680.98,2575526.76
320160,202207,631,276,355,334516.72,430262.22,764778.94
320170,202207,107,85,22,103020.1,26664.02,129684.12
320180,202207,57,34,23,41208.61,27876,69084.61
320190,202207,244,146,98,176953.84,118776.2,295730.04
320200,202207,62,51,11,61813.15,13332,75145.15
320210,202207,914,495,419,601160.62,507834.69,1108995.31
320220,202207,301,104,197,126048.2,238764.2,364812.4
320225,202207,81,67,14,81204.07,16968.87,98172.94
320230,202207,698,444,254,538141.24,309064.54,847205.78
320240,202207,3535,1614,1921,1958612.59,2329482.26,4288094.85
320245,202207,511,348,163,421780.63,197560.45,619341.08
320250,202207,227,106,121,128474.7,146652.53,275127.23
320255,202207,120,90,30,110293.73,36360.22,146653.95
320260,202207,255,140,115,169680.23,139381.58,309061.81
320265,202207,145,113,32,136956.25,38784.11,175740.36
320270,202207,159,122,37,147865.42,44845.15,192710.57
320280,202207,1235,691,544,837500.62,660547.15,1498047.77
320290,202207,66,50,16,60600,19392,79992
320300,202207,626,422,204,511475.76,247252.13,758727.89
320305,202207,737,399,338,486020.87,409662.18,895683.05
320310,202207,200,116,84,140593.51,103021.15,243614.66
320313,202207,348,154,194,187862.66,235128.2,422990.86
320316,202207,107,78,29,94536.25,35148,129684.25
320320,202207,3464,1530,1934,1855591.99,2345240.75,4200832.74
320330,202207,272,197,75,238764,90900,329664
320332,202207,788,460,328,557531.96,397547.47,955079.43
320334,202207,282,154,128,186648.22,155137.45,341785.67
320335,202207,143,93,50,112716,60601,173317
320340,202207,570,399,171,483598.35,207257.01,690855.36
320350,202207,1088,448,640,542986.05,775689.55,1318675.60
320360,202207,174,85,89,103020.08,107868,210888.08
320370,202207,228,170,58,206042.01,70296.6,276338.61
320380,202207,311,217,94,264217.79,113928.89,378146.68
320390,202207,1152,670,482,812046.03,584185.72,1396231.75
320400,202207,311,221,90,267854.59,110292,378146.59
320405,202207,983,402,581,487238.51,705395.12,1192633.63
320410,202207,943,469,474,568432.9,574491.79,1142924.69
320420,202207,554,250,304,303006.82,368454.4,671461.22
320425,202207,206,111,95,134532.79,115140.8,249673.59
320430,202207,389,201,188,243616.71,227860.31,471477.02
320435,202207,165,111,54,134532.85,65448.35,199981.20
320440,202207,203,110,93,133321.52,112718.19,246039.71
320450,202207,141,75,66,90900.21,79993.06,170893.27
320455,202207,231,180,51,218161.1,61812,279973.1
320460,202207,293,177,116,214526.9,140592.1,355119.0
320465,202207,112,76,36,92113.66,43632.65,135746.31
320470,202207,716,426,290,516317.97,351488.2,867806.17
320480,202207,203,137,66,166046.24,79992.8,246039.04
320490,202207,3293,1533,1760,1859238.92,2134374.6,3993613.52
320495,202207,119,67,52,81204.1,63024.6,144228.7
320500,202207,10002,4826,5176,5851643.77,6278228.64,12129872.41
320501,202207,559,283,276,343000.29,335730.82,678731.11
320503,202207,312,220,92,269065.91,111504.78,380570.69
320506,202207,257,180,77,218161.36,93324.1,311485.46
320510,202207,1210,517,693,626608.9,842346.99,1468955.89
320515,202207,83,63,20,76356,24240,100596
320517,202207,216,155,61,187861.98,73932,261793.98
320520,202207,7755,3202,4553,3884521.62,5520727.93,9405249.55
320530,202207,6884,3283,3601,3983863.69,4364453.01,8348316.70
330010,202207,3442,1689,1753,2050741.18,2127069.88,4177811.06
330015,202207,203,88,115,106656.74,139380.1,246036.84
330020,202207,3976,1549,2427,1881046.2,2947606.89,4828653.09
330022,202207,271,133,138,161199.13,167256.35,328455.48
330023,202207,791,227,564,275125.33,683579.7,958705.03
330025,202207,724,135,589,163620.24,715088.58,878708.82
330030,202207,1863,1153,710,1398670.91,861738.02,2260408.93
330040,202207,2639,1308,1331,1585317.85,1614394.81,3199712.66
330045,202207,10198,3096,7102,3754817.34,8613753.95,12368571.29
330050,202207,895,558,337,677515.4,409658.34,1087173.74
330060,202207,1155,671,484,813262.75,587827.82,1401090.57
330070,202207,4266,1456,2810,1765910.13,3409386.95,5175297.08
330080,202207,1637,710,927,860532.3,1124749.24,1985281.54
330090,202207,397,221,176,267852.2,213313.81,481166.01
330093,202207,232,96,136,116352.2,164832,281184.2
330095,202207,69,38,31,46056.96,37572,83628.96
330100,202207,11091,5457,5634,6623644.81,6832098.62,13455743.43
330110,202207,460,209,251,253309.99,304212.87,557522.86
330115,202207,522,260,262,315123.57,317544.92,632668.49
330120,202207,403,215,188,260580.96,227856.4,488437.36
330130,202207,1648,426,1222,516321.75,1481080.53,1997402.28
330140,202207,672,351,321,425414.15,389053.2,814467.35
330150,202207,531,315,216,381785.6,261793.29,643578.89
330160,202207,210,122,88,147864,106656,254520
330170,202207,27700,9469,18231,11487508.61,22116831.44,33604340.05
330180,202207,251,136,115,164833.14,139380.95,304214.09
330185,202207,1092,386,706,469046.5,856893.13,1325939.63
330187,202207,541,160,381,193921.6,461776.43,655698.03
330190,202207,6417,2395,4022,2905192.85,4884398.75,7789591.60
330200,202207,4705,1489,3216,1805905.82,3901468.2,5707374.02
330205,202207,466,267,199,323606.83,241192.08,564798.91
330210,202207,953,568,385,688428.7,466622.51,1155051.21
330220,202207,2886,1679,1207,2036188.74,1462903.04,3499091.78
330225,202207,585,304,281,368454.97,340573.52,709028.49
330227,202207,2435,749,1686,907803.6,2048300.03,2956103.63
330230,202207,262,141,121,170892.41,146652,317544.41
330240,202207,4284,1978,2306,2401004.81,2798537.01,5199541.82
330245,202207,158,72,86,87264.4,104232.46,191496.86
330250,202207,6789,3245,3544,3934211.55,4303855.14,8238066.69
330260,202207,740,196,544,237554.72,660541.08,898095.80
330270,202207,3927,1247,2680,1513805.97,3250609.26,4764415.23
330280,202207,467,278,189,336946.57,229072.13,566018.70
330285,202207,6789,2175,4614,2638567.3,5599521.46,8238088.76
330290,202207,754,257,497,311487.89,603579.81,915067.70
330300,202207,753,463,290,563119.23,352696.01,915815.24
330310,202207,474,269,205,326030.92,249673.18,575704.10
330320,202207,8126,2865,5261,3474916.63,6382458.42,9857375.05
330330,202207,9620,3509,6111,4259020.54,7417499.46,11676520.00
330340,202207,2776,1544,1232,1872551.89,1495616.64,3368168.53
330350,202207,20178,7314,12864,8871989.97,15611998.97,24483988.94
330360,202207,2104,963,1141,1167183.82,1382915.02,2550098.84
330370,202207,994,508,486,618130.74,591462.36,1209593.10
330380,202207,997,394,603,477532,730840.05,1208372.05
330385,202207,652,327,325,396326.55,395112.14,791438.69
330390,202207,6179,3163,3016,3840871.19,3663907.44,7504778.63
330395,202207,374,236,138,288458.65,167259.54,455718.19
330400,202207,725,357,368,432691.45,446017.19,878708.64
330410,202207,525,377,148,456930.64,179377.75,636308.39
330411,202207,347,186,161,225433.55,195132,420565.55
330412,202207,228,99,129,119989.41,156348.1,276337.51
330414,202207,5442,2113,3329,2563427.38,4040836.54,6604263.92
330415,202207,623,261,362,316338.49,438746.15,755084.64
330420,202207,2465,1264,1201,1531981.64,1455619.94,2987601.58
330430,202207,1844,777,1067,942943.23,1293210.69,2236153.92
330440,202207,371,173,198,209677.13,239976,449653.13
330450,202207,121,55,66,66660,79992,146652
330452,202207,2419,991,1428,1201116.45,1730752.11,2931868.56
330455,202207,127573,43616,83957,52937387.04,101868717.09,154806104.13
330460,202207,265,118,147,143016.2,178164.4,321180.6
330470,202207,1267,667,600,809629.19,728420.18,1538049.37
330475,202207,1843,535,1308,648426.13,1586516.72,2234942.85
330480,202207,802,435,367,528435.93,444807.35,973243.28
330490,202207,16256,4989,11267,6051701.25,13673898.58,19725599.83
330500,202207,1528,644,884,781747.16,1072623.23,1854370.39
330510,202207,11236,3846,7390,4662626.25,8976163.24,13638789.49
330513,202207,102,53,49,64236,59388,123624
330515,202207,734,307,427,372085.97,517529.02,889614.99
330520,202207,2552,868,1684,1053243.31,2044665.49,3097908.80
330530,202207,192,109,83,132108.56,100596.4,232704.96
330540,202207,337,173,164,209677.6,198769.55,408447.15
330550,202207,2859,946,1913,1146560.81,2318578.58,3465139.39
330555,202207,997,369,628,447232.82,761138.76,1208371.58
330560,202207,765,255,510,309061.59,618126.68,927188.27
330570,202207,305,212,93,256944.8,112716,369660.8
330575,202207,845,307,538,372090.56,652063.19,1024153.75
330580,202207,3414,1798,1616,2182830.65,1964667.8,4147498.45
330590,202207,263,135,128,163622.64,155136,318758.64
330600,202207,1350,794,556,964761.55,673877.3,1638638.85
330610,202207,1673,856,817,1037480.68,990210.14,2027690.82
330615,202207,226,180,46,218161.57,55753.7,273915.27
330620,202207,1034,404,630,489654.41,763567.13,1253221.54
330630,202207,4547,2680,1867,3251843.63,2264036.64,5515880.27
350010,202207,611,407,204,493294.91,247248.7,740543.61
350020,202207,55,18,37,21816.2,44844,66660.2
350030,202207,561,336,225,408455.72,272702.57,681158.29
350040,202207,114,46,68,55754.08,82417.49,138171.57
350050,202207,353,171,182,207253.1,220585.46,427838.56
350055,202207,127,54,73,65448,88476.1,153924.1
350060,202207,92,41,51,49692.51,61812.2,111504.71
350070,202207,809,455,354,551474.93,430270.09,981745.02
350075,202207,82,48,34,58176.56,41208,99384.56
350080,202207,58,25,33,30300.67,39996.4,70297.07
350090,202207,83,47,36,56966.16,44844,101810.16
350100,202207,273,169,104,204828.6,126048,330876.6
350110,202207,47,30,17,36361.49,20604,56965.49
350115,202207,176,92,84,111504.79,101808.7,213313.49
350120,202207,110,68,42,82418,50904.49,133322.49
350130,202207,405,175,230,212107.87,279977.6,492085.47
350140,202207,38,23,15,27876.44,18180.2,46056.64
350150,202207,69,49,20,59388.83,24240.8,83629.63
350160,202207,2423,958,1465,1161111.47,1779223.29,2940334.76
350170,202207,408,238,170,288458.01,206043.42,494501.43
350180,202207,166,94,72,113929.05,87264.81,201193.86
350190,202207,1017,548,469,665418.1,568428.36,1233846.46
350200,202207,57,26,31,31512.71,37572,69084.71
350210,202207,1324,717,607,870237.77,738122.88,1608360.65
350220,202207,634,513,121,624190.7,146653.3,770844.0
350230,202207,68,42,26,50904,31512.1,82416.1
350240,202207,60,37,23,44844,27876.96,72720.96
350250,202207,1124,511,613,619342.61,745385.48,1364728.09
350260,202207,98,71,27,86052.7,32724,118776.7
350270,202207,960,641,319,776898.44,386629.82,1163528.26
350275,202207,330,123,207,149077.61,250886.31,399963.92
350280,202207,4496,2154,2342,2611941.13,2840945,5452886.13
350290,202207,471,199,272,241190.52,330878.52,572069.04
350300,202207,51,25,26,30302.16,31513.1,61815.26
350310,202207,80,48,32,58176.3,38784.39,96960.69
350315,202207,73,31,42,37572,50904,88476
350320,202207,3451,1621,1830,1965948.19,2217980.29,4183928.48
350330,202207,1672,851,821,1032645.97,995056.92,2027702.89
350335,202207,20,12,8,14544,9696,24240
350340,202207,128,51,77,61812.1,93326.53,155138.63
350350,202207,98,47,51,56964,61812,118776
350360,202207,99,64,35,77568.79,43632.18,121200.97
350370,202207,84,46,38,55752.95,46056,101808.95
350380,202207,830,349,481,422991.1,584189.64,1007180.74
350390,202207,1819,675,1144,818111.89,1387750.83,2205862.72
350395,202207,21,16,5,19392.55,6060,25452.55
350400,202207,1758,842,916,1020529.41,1113833.47,2134362.88
350410,202207,3064,1261,1803,1529563.91,2186459.23,3716023.14
350420,202207,276,162,114,196345.63,138168,334513.63
350430,202207,95,48,47,58177.18,56966.91,115144.09
350440,202207,145,104,41,126051.09,49692.4,175743.49
350450,202207,1764,965,799,1172035.28,968390.11,2140425.39
350460,202207,404,135,269,163622.2,326037.66,489659.86
350470,202207,20,13,7,15756,8484,24240
350480,202207,192,98,94,118779.27,113928.32,232707.59
350490,202207,241,113,128,136956.26,155136,292092.26
350500,202207,57,22,35,26664,42420,69084
350510,202207,153,92,61,111505.39,75144,186649.39
350520,202207,441,238,203,288461.26,247251.85,535713.11
350530,202207,449,215,234,261798.16,284826.15,546624.31
350535,202207,97,63,34,76356.59,41208.2,117564.79
350540,202207,369,193,176,233918.25,213312.85,447231.10
350550,202207,2779,1563,1216,1895621.09,1475013.69,3370634.78
350560,202207,599,406,193,492076.44,233917.56,725994.00
350570,202207,4701,1933,2768,2344034.06,3360894.55,5704928.61
350580,202207,374,176,198,214527.06,239978.12,454505.18
350590,202207,991,535,456,650851.3,552676.96,1203528.26
350600,202207,6483,2995,3488,3632455.88,4234748.39,7867204.27
350610,202207,1528,779,749,944173.71,907793.23,1851966.94
350620,202207,24,16,8,19392,9696,29088
350630,202207,258,128,130,155137.8,157561.33,312699.13
350635,202207,1199,485,714,589040.75,865378.21,1454418.96
350640,202207,117,86,31,104233.64,37572.2,141805.84
350650,202207,1900,1254,646,1521104.1,785377.7,2306481.8
350660,202207,788,312,476,378145.76,576915.6,955061.36
350670,202207,295,147,148,178164,179376.6,357540.6
350680,202207,166,86,80,104235.41,98173.69,202409.10
350690,202207,207,90,117,109080.1,141804,250884.1
350700,202207,920,429,491,521166.16,595097.37,1116263.53
350710,202207,415,154,261,186648.61,316335.41,502984.02
350715,202207,55,45,10,54540.51,12120,66660.51
350720,202207,17,11,6,13332.62,7272,20604.62
350730,202207,40,26,14,31512,16968,48480
350740,202207,244,135,109,163622.41,132110.39,295732.80
350745,202207,29,13,16,15756.58,19392,35148.58
350750,202207,2452,1434,1018,1738051.39,1235038.88,2973090.27
350760,202207,3964,1657,2307,2009538.42,2798521.71,4808060.13
350770,202207,56,35,21,42420,25452,67872
350775,202207,50,36,14,43634.93,16968.49,60603.42
350780,202207,453,226,227,273919.61,275126.03,549045.64
350790,202207,369,154,215,186650.71,260582.74,447233.45
350800,202207,533,319,214,386631.69,259368.34,646000.03
350810,202207,516,396,120,479962.61,145441.55,625404.16
350820,202207,95,54,41,65448.88,49692,115140.88
350830,202207,73,39,34,47269.47,41208,88477.47
350840,202207,804,320,484,387842.88,586720.28,974563.16
350850,202207,1882,973,909,1179298.12,1101712.53,2281010.65
350860,202207,674,349,325,422996.59,393904.61,816901.20
350870,202207,454,299,155,362389.74,187860.2,550249.94
350880,202207,269,151,118,183013.11,143018.46,326031.57
350890,202207,40,24,16,29088,19392.9,48480.9
350900,202207,1678,520,1158,630246.04,1404724.69,2034970.73
350910,202207,22,10,12,12120,14544,26664
350920,202207,781,404,377,489652.29,458137.1,947789.39
350925,202207,1189,611,578,740543.38,702969.26,1443512.64
350930,202207,113,63,50,76357.12,60600,136957.12
350940,202207,744,386,358,467845.21,433907.61,901752.82
350945,202207,116,83,33,100596.93,39997.03,140593.96
350950,202207,17898,8190,9708,9931305.45,11778285.6,21709591.05
350960,202207,1632,667,965,808412.39,1172011.62,1980424.01
350970,202207,1098,533,565,645878.54,684788.02,1330666.56
350980,202207,96,66,30,79994.1,37572,117566.1
350990,202207,400,141,259,170894.45,313909.08,484803.53
350995,202207,45,20,25,24241.18,30300.9,54542.08
351000,202207,617,397,220,482386.31,267857.76,750244.07
351010,202207,51,34,17,41208.96,20604,61812.96
351015,202207,42,27,15,32725.49,18180,50905.49
351020,202207,1504,886,618,1073844.84,749020.45,1822865.29
351030,202207,345,203,142,246036.2,172104,418140.2
351040,202207,1016,535,481,648426.33,582974.43,1231400.76
351050,202207,3658,1646,2012,1997422.29,2440979.91,4438402.20
351060,202207,6065,2182,3883,2645839.29,4707423.55,7353262.84
351070,202207,416,256,160,310279.09,193921.5,504200.59
351080,202207,740,539,201,653276.13,243615.04,896891.17
351090,202207,49,25,24,30300.6,29088,59388.6
351100,202207,420,221,199,267860.61,241192.39,509053.00
351110,202207,2101,951,1150,1152646.98,1396231.06,2548878.04
351120,202207,64,30,34,36360.85,41208,77568.85
351130,202207,197,61,136,73933.95,164833.15,238767.10
351140,202207,324,195,129,236344.47,156349.26,392693.73
351150,202207,495,250,245,303003.71,296942.05,599945.76
351160,202207,295,176,119,213314.64,144228,357542.64
351170,202207,234,130,104,158772.02,126048,284820.02
351190,202207,92,57,35,69084.2,42420,111504.2
351200,202207,353,228,125,276338.84,151501.44,427840.28
351210,202207,120,58,62,70296,75144,145440
351220,202207,576,328,248,397543.86,300577.07,698120.93
351230,202207,294,197,97,238769.6,117564.2,356333.8
351240,202207,238,117,121,141804.88,146652.83,288457.71
351250,202207,84,57,27,69086.13,32724.1,101810.23
351260,202207,145,101,44,122412,53328,175740
351270,202207,44,19,25,23028.85,30300,53328.85
351280,202207,1057,495,562,602371.72,681149.78,1283521.50
351290,202207,250,109,141,132108,170892.1,303000.1
351300,202207,4021,1691,2330,2049518.68,2825196.11,4874714.79
351310,202207,744,355,389,431482.07,471475.56,902957.63
351320,202207,121,67,54,81204.34,65449.27,146653.61
351330,202207,43,26,17,31512,20604,52116
351340,202207,1416,770,646,933257.63,782957.01,1716214.64
351350,202207,2426,1397,1029,1693191.52,1249581.51,2942773.03
351360,202207,819,378,441,458140.44,534495.84,992636.28
351370,202207,428,206,222,249677.08,271489.18,521166.26
351380,202207,9032,3876,5156,4700200.18,6255159.4,10955359.58
351385,202207,25,14,11,16968,13332,30300
351390,202207,277,200,77,243614.54,94536.2,338150.74
351400,202207,60,39,21,47268,25452,72720
351410,202207,467,281,186,341788.79,225432.43,567221.22
351420,202207,72,51,21,61812,25452,87264
351430,202207,69,35,34,42420,41208.2,83628.2
351440,202207,796,516,280,625405.63,339363.5,964769.13
351450,202207,276,129,147,156348.84,178166.33,334515.17
351460,202207,135,56,79,67873.59,95749.2,163622.79
351470,202207,141,73,68,88477.24,82416.98,170894.22
351480,202207,481,284,197,344211.88,238764.78,582976.66
351490,202207,301,111,190,134532.38,230280.55,364812.93
351492,202207,25,15,10,18180,12120,30300
351495,202207,24,17,7,20604,8484,29088
351500,202207,3509,1401,2108,1698023.57,2558543.07,4256566.64
351510,202207,2138,771,1367,935674.55,1661666.17,2597340.72
351512,202207,12,9,3,10908,3636,14544
351515,202207,206,119,87,144229.14,105444,249673.14
351518,202207,698,412,286,499355.22,346642.92,845998.14
351519,202207,86,49,37,59388,44844,104232
351520,202207,166,102,64,123626.19,78801.93,202428.12
351530,202207,23,12,11,14544,13332,27876
351535,202207,137,82,55,99387.59,66661.09,166048.68
351540,202207,480,314,166,380574.54,201194.76,581769.30
351550,202207,1536,899,637,1089614.33,772047.69,1861662.02
351560,202207,76,44,32,53328.2,38784,92112.2
351565,202207,14,7,7,8484.32,8484,16968.32
351570,202207,2867,1313,1554,1593808.78,1885881.96,3479690.74
351580,202207,37,34,3,41208.8,3636,44844.8
351590,202207,65,42,23,50905.34,27876,78781.34
351600,202207,178,127,51,153931.24,63024,216955.24
351610,202207,55,24,31,29088.58,37572,66660.58
351620,202207,5967,3183,2784,3857850.56,3377861.39,7235711.95
351630,202207,3329,1563,1766,1894376.72,2140407,4034783.72
351640,202207,2434,1039,1395,1259287.62,1695596.43,2954884.05
351650,202207,31,25,6,30300,7272,37572
351660,202207,140,87,53,105444,64236,169680
351670,202207,760,446,314,540562.63,380572.49,921135.12
351680,202207,80,60,20,72720,24240,96960
351685,202207,10,7,3,8484,3636,12120
351690,202207,301,195,106,236342.69,128472,364814.69
351700,202207,187,125,62,151762.39,76356.1,228118.49
351710,202207,66,42,24,50904,29088,79992
351720,202207,128,72,56,87265.1,67872,155137.1
351730,202207,110,73,37,88476.44,44844,133320.44
351740,202207,795,493,302,598745.32,366026.95,964772.27
351750,202207,379,148,231,179376.43,281185,460561.43
351760,202207,718,551,167,667718.96,202404.17,870123.13
351770,202207,299,239,60,290884.72,72720.91,363605.63
351780,202207,153,92,61,111504.95,73932,185436.95
351790,202207,270,139,131,168469.08,158773.06,327242.14
351800,202207,46,29,17,35148.27,20604,55752.27
351810,202207,124,80,44,96961.7,53329.09,150290.79
351820,202207,771,550,221,666623.25,267855.21,934478.46
351830,202207,633,195,438,236340.5,533281.01,769621.51
351840,202207,2246,1009,1237,1224147.68,1499250.2,2723397.88
351850,202207,246,170,76,206041.82,92112,298153.82
351860,202207,606,398,208,482388.5,252096.37,734484.87
351870,202207,5938,2672,3266,3239710.2,3959655.29,7199365.49
351880,202207,22067,8448,13619,10243955.25,16520854.96,26764810.21
351885,202207,95,50,45,60602.22,54540.25,115142.47
351890,202207,70,48,22,58176.2,26664,84840.2
351900,202207,241,129,112,156349.68,135744,292093.68
351905,202207,98,46,52,55752.4,63024,118776.4
351907,202207,3741,1503,2238,1821669.63,2713686.71,4535356.34
351910,202207,160,68,92,82416.91,111504.79,193921.70
351920,202207,111,59,52,71508.1,63024,134532.1
351925,202207,90,55,35,66661.14,42420,109081.14
351930,202207,447,285,162,345429.17,196347.14,541776.31
351940,202207,242,99,143,119988.61,173316.6,293305.21
351950,202207,143,75,68,90900.72,82417.46,173318.18
351960,202207,959,458,501,555107.79,609647.15,1164754.94
351970,202207,2146,1023,1123,1241095.46,1363508.98,2604604.44
351980,202207,156,66,90,79995.9,110293.28,190289.18
351990,202207,250,158,92,192710.14,111505.42,304215.56
352000,202207,322,203,119,246042.03,144230.63,390272.66
352010,202207,436,279,157,338238.28,190291.86,528530.14
352020,202207,202,73,129,88476,156348,244824
352030,202207,1206,552,654,669033.31,792654.41,1461687.72
352040,202207,653,249,404,303003.66,489650.93,792654.59
352042,202207,324,79,245,95749.41,296942.4,392691.81
352044,202207,372,211,161,255736.53,195135.5,450872.03
352050,202207,3305,1199,2106,1453206.33,2554902.15,4008108.48
352060,202207,99,59,40,71508,48480.39,119988.39
352070,202207,95,67,28,81207.64,33936,115143.64
352080,202207,68,42,26,50904.79,31512,82416.79
352090,202207,180,117,63,141806,76356,218162
352100,202207,316,152,164,185438.49,198768.73,384207.22
352110,202207,111,33,78,39996.51,94536,134532.51
352115,202207,65,24,41,29088,49692.2,78780.2
352120,202207,69,47,22,56964,26664,83628
352130,202207,218,162,56,196349.11,67872.57,264221.68
352140,202207,180,82,98,99384.8,118776,218160.8
352150,202207,128,66,62,79992.16,75145.86,155138.02
352160,202207,139,88,51,107870.3,61812.04,169682.34
352170,202207,409,278,131,336937.63,158772.08,495709.71
352180,202207,686,417,269,505412.42,326033.35,831445.77
352190,202207,245,102,143,123625.38,173316.84,296942.22
352200,202207,29,11,18,13332,21816.1,35148.1
352210,202207,4528,1817,2711,2202258.46,3289392.63,5491651.09
352215,202207,76,41,35,49692,42420,92112
352220,202207,6306,2305,4001,2798542.3,4852876.65,7651418.95
352230,202207,3575,2251,1324,2730715.51,1609546.37,4340261.88
352240,202207,2748,1537,1211,1864084.23,1470164.18,3334248.41
352250,202207,3472,1538,1934,1866503.43,2344015.34,4210518.77
352260,202207,1044,546,498,661762.63,603584.15,1265346.78
352265,202207,65,36,29,43632.93,35148,78780.93
352270,202207,392,209,183,253312.04,221800.04,475112.08
352280,202207,509,302,207,366028.61,252096,618124.61
352290,202207,169,95,74,115140.97,89689.06,204830.03
352300,202207,98,62,36,75146.88,43632.6,118779.48
352310,202207,7253,3100,4153,3760906.58,5039505.6,8800412.18
352320,202207,1164,600,564,727207.1,683570.58,1410777.68
352330,202207,541,280,261,340575.1,317544.09,658119.19
352340,202207,1379,620,759,752663.73,919914.8,1672578.53
352350,202207,371,205,166,249673.71,201195.16,450868.87
352360,202207,219,97,122,117564.1,147864.92,265429.02
352370,202207,124,74,50,89688.57,60600.45,150289.02
352380,202207,111,79,32,95750.78,38784.92,134535.70
352390,202207,2650,1136,1514,1376846.45,1837400.32,3214246.77
352400,202207,550,236,314,286032,381780.8,667812.8
352410,202207,937,612,325,742971.77,393914.95,1136886.72
352420,202207,86,64,22,77568.62,26664,104232.62
352430,202207,1797,780,1017,946589.68,1232615.3,2179204.98
352440,202207,3513,1609,1904,1952564.56,2310086.29,4262650.85
352450,202207,196,152,44,184224.6,53328.32,237552.92
352460,202207,640,315,325,381782.91,395114.33,776897.24
352470,202207,659,243,416,294518.82,504194.65,798713.47
352480,202207,1619,897,722,1087179.19,876282.34,1963461.53
352490,202207,52,20,32,24240.75,38784.1,63024.85
352500,202207,1314,529,785,642366.4,951423.71,1593790.11
352510,202207,728,375,353,454507.42,429051.58,883559.00
352520,202207,865,377,488,456928.85,591468.55,1048397.40
352530,202207,1890,959,931,1163223.21,1128385.82,2291609.03
352540,202207,68,45,23,54540.88,27876,82416.88
352550,202207,210,120,90,145442.11,109080,254522.11
352560,202207,51,38,13,46057.03,15756.22,61813.25
352570,202207,749,355,394,430270.82,477539.42,907810.24
352580,202207,55,42,13,50905.18,15756,66661.18
352585,202207,21,5,16,6060.6,19392,25452.6
352590,202207,4550,2198,2352,2668868.45,2853067.53,5521935.98
352600,202207,366,254,112,307855.97,135747.76,443603.73
352610,202207,937,420,517,509045.32,626607.42,1135652.74
352620,202207,1115,414,701,501772.66,852040.12,1353812.78
352630,202207,190,72,118,87265.54,143016,230281.54
352640,202207,516,327,189,396329.33,229070.14,625399.47
352650,202207,87,64,23,77569.25,27876,105445.25
352660,202207,66,37,29,44844.65,35148,79992.65
352670,202207,1747,914,833,1107796.56,1012020.85,2119817.41
352680,202207,957,568,389,688426.68,471475.79,1159902.47
352690,202207,4704,2031,2673,2462834.31,3242116.29,5704950.60
352700,202207,87,50,37,61812.95,44844,106656.95
352710,202207,1517,770,747,935680.81,909002.36,1844683.17
352720,202207,1562,647,915,784178.33,1111422.01,1895600.34
352725,202207,25,19,6,23028,7272,30300
352730,202207,399,194,205,235129.99,248460.7,483590.69
352740,202207,405,258,147,312704.63,178166.06,490870.69
352750,202207,22,14,8,16968,9696.14,26664.14
352760,202207,219,139,80,168469.39,96960.1,265429.49
352770,202207,78,58,20,70297.28,24240.18,94537.46
352780,202207,73,38,35,46056,42420.78,88476.78
352790,202207,24,17,7,20605.45,8484.18,29089.63
352800,202207,244,186,58,225435.67,70296.67,295732.34
352810,202207,162,102,60,123626.61,72721.12,196347.73
352820,202207,49,36,13,43632.7,15756,59388.7
352830,202207,76,50,26,60600.7,31512.71,92113.41
352840,202207,699,301,398,364818.53,484802.19,849620.72
352850,202207,1806,535,1271,649637.38,1545303.68,2194941.06
352860,202207,115,71,44,86052,54540.51,140592.51
352870,202207,50,31,19,37573.99,23028.06,60602.05
352880,202207,181,104,77,126050.07,93324.68,219374.75
352885,202207,33,21,12,25452.2,14544,39996.2
352890,202207,53,33,20,39996.9,24240.6,64237.5
352900,202207,4715,2206,2509,2677371,3044554.04,5721925.04
352910,202207,37,30,7,36360,8484,44844
352920,202207,646,369,277,447239.44,336940.5,784179.94
352930,202207,1194,554,640,672671.91,776893.6,1449565.51
352940,202207,6342,2407,3935,2919741.46,4775316.9,7695058.36
352950,202207,123,52,71,63024.41,86053.52,149077.93
352960,202207,66,40,26,48480,31512,79992
352965,202207,15,9,6,10908,7272,18180
352970,202207,530,387,143,469052.65,173320.04,642372.69
352980,202207,160,92,68,111506.85,82416.89,193923.74
352990,202207,983,460,523,557528.6,633881.99,1191410.59
353000,202207,55,24,31,29088.2,37572.6,66660.8
353010,202207,521,310,211,375727.72,255733.3,631461.02
353020,202207,330,220,110,266645.59,133320.96,399966.55
353030,202207,1422,624,798,757512.8,968402.47,1725915.27
353040,202207,87,47,40,56964.61,48481.19,105445.80
353050,202207,1336,867,469,1050839.05,568430.64,1619269.69
353060,202207,9180,3906,5274,4737793.07,6398179.75,11135972.82
353070,202207,1983,1157,826,1402324.65,1003323.52,2405648.17
353080,202207,1319,707,612,856901.51,745383.3,1602284.81
353090,202207,66,38,28,46056.8,33936,79992.8
353100,202207,45,33,12,39998.47,14544,54542.47
353110,202207,2283,735,1548,890833.43,1878629.59,2769463.02
353120,202207,138,75,63,90900.2,77568,168468.2
353130,202207,858,404,454,489658.9,552677.71,1042336.61
353140,202207,577,260,317,315126.81,384209.34,699336.15
353150,202207,322,167,155,202407.91,187861.62,390269.53
353160,202207,112,84,28,101810.2,33936.44,135746.64
353170,202207,205,68,137,82416.2,166045.34,248461.54
353180,202207,1219,558,661,676303.79,802347.51,1478651.30
353190,202207,500,351,149,425419.53,180588.74,606008.27
353200,202207,261,125,136,151500.9,164832.19,316333.09
353205,202207,19,12,7,14544,8484,23028
353210,202207,68,40,28,48480.8,33936.52,82417.32
353215,202207,41,23,18,27876.2,21816,49692.2
353220,202207,84,45,39,54540,47268.6,101808.6
353230,202207,156,67,89,81204.85,107868,189072.85
353240,202207,378,168,210,203617.5,254520,458137.5
353250,202207,190,96,94,116353.28,115140.81,231494.09
353260,202207,460,302,158,366030.09,191498.68,557528.77
353270,202207,74,54,20,65448.2,24240,89688.2
353280,202207,112,48,64,58176.9,77568.65,135745.55
353282,202207,127,88,39,106656.1,47268,153924.1
353284,202207,28,19,9,23028.88,10908,33936.88
353286,202207,9,4,5,4848,6060.6,10908.6
353290,202207,84,44,40,54540,48480,103020
353300,202207,447,220,227,269070.97,275128.96,544199.93
353310,202207,39,32,7,38784.2,8484.6,47268.8
353320,202207,42,26,16,31512.82,19392.6,50905.42
353325,202207,42,25,17,30300,20604,50904
353330,202207,64,43,21,52116.8,25452.2,77569.0
353340,202207,696,241,455,293306.91,551466.05,844772.96
353350,202207,931,455,476,551465.26,578132.19,1129597.45
353360,202207,105,81,24,98173.35,29088.57,127261.92
353370,202207,109,64,45,77568.4,54540,132108.4
353380,202207,27,13,14,15756,16968,32724
353390,202207,1145,529,616,641157.89,747814.05,1388971.94
353400,202207,50,28,22,33936,26665.14,60601.14
353410,202207,115,64,51,77568,61813.86,139381.86
353420,202207,53,24,29,29088,35148,64236
353430,202207,584,381,203,461781.73,246040.47,707822.20
353440,202207,12701,5375,7326,6515770.66,8885201.97,15400972.63
353450,202207,55,29,26,35148,31512.2,66660.2
353460,202207,638,319,319,386639.32,386633.04,773272.36
353470,202207,2289,1096,1193,1330817.52,1447134.32,2777951.84
353475,202207,286,179,107,216951.07,129685.26,346636.33
353480,202207,183,145,38,175741.42,46056,221797.42
353490,202207,224,129,95,156349.52,116352.7,272702.22
353500,202207,211,119,92,144229.92,111505.34,255735.26
353510,202207,83,55,28,66661.4,33936.1,100597.5
353520,202207,239,173,66,209678.26,79992.6,289670.86
353530,202207,474,238,236,288460.84,286035.68,574496.52
353540,202207,413,255,158,310277.44,191498.85,501776.29
353550,202207,757,474,283,574498.25,343004.44,917502.69
353560,202207,554,220,334,269064.6,406021.3,675085.9
353570,202207,65,42,23,50904.64,27876,78780.64
353580,202207,348,222,126,271490.18,152712,424202.18
353590,202207,88,62,26,75144.2,31512,106656.2
353600,202207,282,161,121,195135.02,146652.2,341787.22
353610,202207,140,78,62,94537.87,75144,169681.87
353620,202207,690,343,347,415721.15,422991.6,838712.75
353625,202207,55,29,26,35149.03,31512,66661.03
353630,202207,224,160,64,193921.6,77568.56,271490.16
353640,202207,121,80,41,96960.74,49692.95,146653.69
353650,202207,1048,407,641,493286.11,776895.48,1270181.59
353657,202207,22,17,5,20604,6060,26664
353660,202207,289,147,142,178165.39,172105.1,350270.49
353670,202207,725,417,308,505411.26,373299.93,878711.19
353680,202207,137,88,49,106656.33,59388,166044.33
353690,202207,44,28,16,33936,19392.19,53328.19
353700,202207,291,201,90,243616.3,109080.9,352697.2
353710,202207,516,245,271,296942.47,329665.09,626607.56
353715,202207,42,25,17,30300.7,20604,50904.7
353720,202207,335,149,186,180591.25,225434.86,406026.11
353730,202207,1177,701,476,849635.4,576913.11,1426548.51
353740,202207,611,335,276,406028.52,334515.16,740543.68
353750,202207,80,46,34,55752.89,41208,96960.89
353760,202207,3317,1242,2075,1505334.66,2518558.38,4023893.04
353770,202207,78,62,16,75144,19392.2,94536.2
353780,202207,1393,631,762,765990.65,924760.59,1690751.24
353790,202207,492,290,202,352696.65,244826.81,597523.46
353800,202207,3702,1716,1986,2079869.68,2409463,4489332.68
353810,202207,237,114,123,138170.4,149077.32,287247.72
353820,202207,253,103,150,124837.8,181800.88,306638.68
353830,202207,64,52,12,63024.93,14544,77568.93
353850,202207,200,90,110,109081.14,134533.15,243614.29
353860,202207,546,235,311,284820.69,378145.53,662966.22
353870,202207,5815,2945,2870,3574262.38,3482095.2,7056357.58
353880,202207,724,464,260,562378.17,315122.97,877501.14
353890,202207,559,323,236,391482.44,286038.66,677521.10
353900,202207,136,71,65,86052.07,78781.63,164833.70
353910,202207,194,75,119,90901.28,145440.64,236341.92
353920,202207,453,235,218,286033.73,264219.63,550253.36
353930,202207,1059,618,441,751451.22,535705.79,1287157.01
353940,202207,210,102,108,123624.3,130897.05,254521.35
353950,202207,500,316,184,382996.15,223010,606006.15
353960,202207,75,61,14,73932.2,16968,90900.2
353970,202207,43,28,15,33937,18181.7,52118.7
353980,202207,1939,860,1079,1042334.62,1308971.46,2351306.08
353990,202207,80,47,33,56965.27,39996,96961.27
354000,202207,390,176,214,213316.36,260583.8,473900.16
354010,202207,91,51,40,61812.6,48480.69,110293.29
354020,202207,521,323,198,391485.13,239979.42,631464.55
354025,202207,34,29,5,35149.53,6060,41209.53
354030,202207,47,23,24,27876.98,29088.15,56965.13
354040,202207,102,75,27,90900.85,32724,123624.85
354050,202207,166,88,78,106656.72,94537.4,201194.12
354060,202207,796,361,435,437533.45,527221.56,964755.01
354070,202207,948,537,411,652064.21,498136.23,1150200.44
354075,202207,182,83,99,100597.26,119989.35,220586.61
354080,202207,309,135,174,163623.14,210888.98,374512.12
354085,202207,22,13,9,15757.07,10908,26665.07
354090,202207,275,163,112,197456.38,135744.82,333201.20
354100,202207,6205,2520,3685,3056709.16,4473538.79,7530247.95
354105,202207,101,50,51,60601,61812,122413
354110,202207,39,19,20,23028,24240.09,47268.09
354120,202207,150,95,55,115140.7,66660.41,181801.11
354130,202207,748,447,301,542988.67,364814.04,907802.71
354140,202207,3350,1483,1867,1798650.58,2264032.93,4062683.51
354150,202207,640,362,278,438748.55,336936.78,775685.33
354160,202207,666,425,241,515118.52,292098.22,807216.74
354165,202207,12,9,3,10908.49,3636,14544.49
354170,202207,183,118,65,143017.76,78780,221797.76
354180,202207,54,31,23,37572,27876.85,65448.85
354190,202207,207,81,126,98173.29,152712.95,250886.24
354200,202207,116,56,60,67872.2,72723.06,140595.26
354210,202207,74,31,43,37572,52116,89688
354220,202207,621,386,235,467843.46,286037.5,753880.96
354230,202207,166,71,95,86052.5,115141.65,201194.15
354240,202207,328,203,125,246040.06,152712.72,398752.78
354250,202207,81,48,33,58176,39996,98172
354260,202207,2197,1021,1176,1237465.22,1426539.25,2664004.47
354270,202207,90,62,28,75144,33936,109080
354280,202207,56,29,27,35148,32724,67872
354290,202207,143,96,47,116352.55,56964.1,173316.65
354300,202207,338,236,102,286034.82,123624,409658.82
354310,202207,92,64,28,77571.29,33936,111507.29
354320,202207,223,108,115,130896.44,139380,270276.44
354323,202207,7,6,1,7272,1212,8484
354325,202207,128,67,61,81205.23,73932,155137.23
354330,202207,2502,839,1663,1016712.44,2017991.15,3034703.59
354340,202207,10747,4866,5881,5899899.74,7131467.02,13031366.76
354350,202207,143,96,47,116352.3,56964,173316.3
354360,202207,76,44,32,53329.59,38784,92113.59
354370,202207,233,118,115,143017.32,140592.47,283609.79
354380,202207,173,101,72,122413.2,87264,209677.2
354390,202207,2795,988,1807,1197469.33,2194944.83,3392414.16
354400,202207,322,177,145,215736.69,175740.94,391477.63
354410,202207,693,304,389,369669.43,471471.26,841140.69
354420,202207,281,189,92,230286.02,111505.08,341791.10
354425,202207,326,178,148,215793.49,179376.59,395170.08
354430,202207,177,96,81,116352.2,98172,214524.2
354440,202207,29,23,6,27876.4,7272,35148.4
354450,202207,53,35,18,42420.26,21816,64236.26
354460,202207,97,55,42,66661.35,50905.39,117566.74
354470,202207,28,14,14,16968.61,16968.35,33936.96
354480,202207,112,62,50,75144.8,60600.75,135745.55
354490,202207,130,72,58,87266.77,70296.91,157563.68
354500,202207,413,183,230,221797.33,278761.16,500558.49
354510,202207,88,60,28,72720.81,33936.9,106657.71
354515,202207,51,18,33,21816.92,39996.29,61813.21
354520,202207,1645,688,957,834910.24,1161098.07,1996008.31
354530,202207,873,423,450,512682.17,545402.18,1058084.35
354540,202207,260,128,132,155137.79,161196.88,316334.67
354550,202207,40,21,19,26665.02,23028,49693.02
354560,202207,157,85,72,103020.1,87264,190284.1
354570,202207,137,92,45,111504,54540,166044
354580,202207,1878,880,998,1066575.9,1214431.64,2281007.54
354600,202207,283,133,150,161197.19,181800,342997.19
354610,202207,65,53,12,64237.95,14544,78781.95
354620,202207,75,20,55,24240,66660.6,90900.6
354625,202207,14,9,5,10908.74,6060,16968.74
354630,202207,338,223,115,270282.14,140594.22,410876.36
354640,202207,850,504,346,610854.49,421780.3,1032634.79
354650,202207,64,37,27,44844.74,32724,77568.74
354660,202207,825,595,230,722369.72,278763.89,1001133.61
354670,202207,228,89,139,107868.98,168468.2,276337.18
354680,202207,1361,474,887,574495.14,1077474.56,1651969.70
354690,202207,79,49,30,59389.13,36360.7,95749.83
354700,202207,76,54,22,65448,26664,92112
354710,202207,51,38,13,46056,15756,61812
354720,202207,19,17,2,20604.2,2424,23028.2
354730,202207,1836,739,1097,895675.75,1334424.18,2230099.93
354740,202207,71,48,23,58176.2,27876,86052.2
354750,202207,413,231,182,282397.51,220589.13,502986.64
354760,202207,520,314,206,380581.54,249677.36,630258.90
354765,202207,6,2,4,2424,4848,7272
354770,202207,353,227,126,275129.12,152713.33,427842.45
354780,202207,8669,3196,5473,3873594.02,6642995.02,10516589.04
354790,202207,86,50,36,60600,43632.98,104232.98
354800,202207,439,235,204,285985.87,247251.31,533237.18
354805,202207,76,36,40,43632.69,48480.7,92113.39
354810,202207,100,56,44,67872,53328,121200
354820,202207,217,87,130,105445.92,157561.62,263007.54
354830,202207,43,23,20,27876,24240,52116
354840,202207,55,37,18,44844,21816,66660
354850,202207,4740,2070,2670,2512519.05,3240909.53,5753428.58
354860,202207,343,157,186,190284.81,225432.9,415717.71
354870,202207,12457,5353,7104,6496417.17,8620999.58,15117416.75
354880,202207,2752,993,1759,1204742.76,2131979.07,3336721.83
354890,202207,3040,1587,1453,1925902.53,1763473.1,3689375.63
354900,202207,64,45,19,54540.19,23028.19,77568.38
354910,202207,1305,659,646,801150.77,782954.43,1584105.20
354920,202207,39,32,7,38784,8484,47268
354925,202207,23,12,11,14544,13332,27876
354930,202207,32,28,4,33937.1,4848,38785.1
354940,202207,773,536,237,649646.14,287250.88,936897.02
354950,202207,210,128,82,155137.94,99386.05,254523.99
354960,202207,130,49,81,59388.8,98172,157560.8
354970,202207,1136,771,365,934484.2,443594.5,1378078.7
354980,202207,9620,3429,6191,4159671.15,7512013.68,11671684.83
354990,202207,10495,4570,5925,5543757.11,7190828.84,12734585.95
354995,202207,601,197,404,238766,490863.65,729629.65
355000,202207,453,156,297,189073.55,359964.3,549037.85
355010,202207,645,394,251,477538.32,304218.23,781756.55
355020,202207,799,494,305,598738.26,369662.6,968400.86
355030,202207,218820,81221,137599,98546449.68,166940845.13,265487294.81
355040,202207,976,472,504,573287.65,610852.29,1184139.94
355050,202207,180,97,83,117564.5,100596,218160.5
355060,202207,1824,861,963,1044767.75,1169586.01,2214353.76
355070,202207,1627,715,912,867802.78,1106567.71,1974370.49
355080,202207,201,119,82,144229.34,99384,243613.34
355090,202207,309,185,124,224226.26,150290.91,374517.17
355100,202207,5578,2595,2983,3146289.94,3617842.39,6764132.33
355110,202207,227,148,79,179376.3,95748.74,275125.04
355120,202207,55,33,22,39996.39,26664,66660.39
355130,202207,51,28,23,33937.46,29088,63025.46
355140,202207,201,117,84,143018.45,101808.68,244827.13
355150,202207,702,409,293,496926.35,355117.75,852044.10
355160,202207,492,232,260,281188.67,316335.15,597523.82
355170,202207,2101,1069,1032,1298085.26,1253216.37,2551301.63
355180,202207,706,276,430,334516.48,521162.69,855679.17
355190,202207,226,152,74,184229.7,89688.89,273918.59
355200,202207,115,58,57,70296.61,69084.6,139381.21
355210,202207,712,375,337,454502.24,408562.36,863064.60
355220,202207,7916,3742,4174,4537805.79,5061350.87,9599156.66
355230,202207,94,52,42,63024.59,50905.16,113929.75
355240,202207,4713,1873,2840,2270053.64,3449372.72,5719426.36
355250,202207,7006,3073,3933,3729431.66,4768021.9,8497453.56
355255,202207,50,31,19,37572,23028,60600
355260,202207,185,104,81,126049.79,99385.4,225435.19
355270,202207,158,96,62,117565.48,75144.78,192710.26
355280,202207,7198,2651,4547,3215474.31,5518275.29,8733749.60
355290,202207,69,54,15,65448,18180.45,83628.45
355300,202207,231,131,100,158773.34,121200.61,279973.95
355310,202207,114,61,53,73932,64236,138168
355320,202207,92,47,45,56964.06,54540,111504.06
355330,202207,327,190,137,230284.95,166046.11,396331.06
355340,202207,1398,500,898,607230.34,1090823.61,1698053.95
355350,202207,165,78,87,94536.6,105444.1,199980.7
355360,202207,170,112,58,135745.81,70296,206041.81
355365,202207,18,12,6,14544,7272,21816
355370,202207,1035,612,423,741768.49,512680.66,1254449.15
355380,202207,848,515,333,624193.55,406026.2,1030219.75
355385,202207,93,61,32,73932.15,38784.2,112716.35
355390,202207,107,56,51,67872,61812.62,129684.62
355395,202207,197,103,94,124839.54,113929.7,238769.24
355400,202207,1814,1032,782,1250706.24,947786.34,2198492.58
355410,202207,5203,2328,2875,2824013.05,3492999.52,6317012.57
355420,202207,44,30,14,36360,16968,53328
355430,202207,418,253,165,309070.1,199984.76,509054.86
355440,202207,91,52,39,63024.2,47268.78,110292.98
355450,202207,452,226,226,273915.81,273913.59,547829.40
355460,202207,56,42,14,50904,16968,67872
355465,202207,51,30,21,36360,25452,61812
355470,202207,199,76,123,92113.24,149077.1,241190.34
355475,202207,8,5,3,6060.81,3636,9696.81
355480,202207,625,244,381,295735.95,461775.59,757511.54
355490,202207,110,77,33,93326.55,39997.27,133323.82
355495,202207,89,31,58,37572,70297.52,107869.52
355500,202207,1614,855,759,1036282.16,921126.25,1957408.41
355510,202207,279,191,88,231499.27,106658.65,338157.92
355520,202207,28,20,8,24240.18,9696,33936.18
355530,202207,22,11,11,13332,13332,26664
355535,202207,78,34,44,41208.66,53328,94536.66
355540,202207,2801,1083,1718,1312791.42,2084666.33,3397457.75
355550,202207,62,36,26,43632,31512,75144
355560,202207,248,112,136,135746.18,164833.75,300579.93
355570,202207,15,10,5,12120,6060,18180
355580,202207,237,161,76,195134.62,92112.9,287247.52
355590,202207,18,11,7,13332,8484,21816
355600,202207,278,134,144,162408.3,174528.62,336936.92
355610,202207,245,151,94,183017.12,113929.86,296946.98
355620,202207,1305,564,741,683581.76,898093.54,1581675.30
355630,202207,421,301,120,366030.33,145441.3,511471.63
355635,202207,124,51,73,61812,88476.6,150288.6
355640,202207,582,306,276,370874.37,334515.37,705389.74
355645,202207,904,320,584,387843.48,707816.78,1095660.26
355650,202207,1923,819,1104,993853.53,1339262.4,2333115.93
355660,202207,230,121,109,146654.52,132109.38,278763.90
355670,202207,663,276,387,334513.92,469044.7,803558.62
355680,202207,207,120,87,145440.7,105445.23,250885.93
355690,202207,93,47,46,56964.1,55752,112716.1
355695,202207,28,18,10,21816,12120,33936
355700,202207,1235,613,622,742963.79,755080.42,1498044.21
355710,202207,2323,1261,1062,1528385.03,1287149.47,2815534.50
355715,202207,16,14,2,18180,2424,20604
355720,202207,260,160,100,193921.34,121201.04,315122.38
355730,202207,110,66,44,79992.5,53328.15,133320.65
410010,202207,113,89,24,107870.87,29088,136958.87
410020,202207,118,85,33,103020,41208,144228
410030,202207,161,90,71,109081.04,86054.29,195135.33
410040,202207,1354,645,709,782954.48,865375.63,1648330.11
410045,202207,46,33,13,39996.59,15756,55752.59
410050,202207,521,299,222,362389.65,270277.02,632666.67
410060,202207,283,201,82,243615.56,99384,342999.56
410070,202207,289,242,47,293309.34,56964.24,350273.58
410080,202207,179,109,70,132108.2,84840,216948.2
410090,202207,58,48,10,58177.2,12120,70297.2
410100,202207,258,164,94,198768.2,113928,312696.2
410105,202207,49,29,20,35148,24240,59388
410110,202207,345,208,137,254523.37,166048.39,420571.76
410115,202207,46,28,18,33936.23,21816,55752.23
410120,202207,453,207,246,250886.95,298155.16,549042.11
410130,202207,63,34,29,41208,35148,76356
410140,202207,3220,1440,1780,1746503.57,2159800.95,3906304.52
410150,202207,2698,1061,1637,1285949.04,1985267.33,3271216.37
410160,202207,490,279,211,338150.71,256945.68,595096.39
410165,202207,50,29,21,35148,25452,60600
410170,202207,206,120,86,145440.2,104232,249672.2
410180,202207,2348,1236,1112,1499262.01,1348971.66,2848233.67
410185,202207,34,28,6,33936,7272,41208
410190,202207,483,305,178,370874.74,215736,586610.74
410200,202207,1020,718,302,870226.36,367236.1,1237462.46
410210,202207,634,324,310,392691.98,376934.82,769626.80
410220,202207,47,20,27,24240,32724,56964
410230,202207,187,84,103,101809.27,124836.4,226645.67
410240,202207,721,460,261,557530.23,318758.24,876288.47
410250,202207,377,262,115,318758.43,139380.87,458139.30
410260,202207,304,169,135,204829.49,163621.37,368450.86
410270,202207,27,19,8,23028,9696,32724
410275,202207,62,45,17,54540,20604,75144
410280,202207,327,191,136,231496.16,166044.2,397540.36
410290,202207,276,156,120,189072.86,145441.24,334514.10
410300,202207,86,54,32,65448,38784,104232
410302,202207,26,14,12,16968,14544,31512
410304,202207,39,27,12,32724,14544,47268
410305,202207,225,130,95,157561.3,115141.07,272702.37
410310,202207,183,106,77,128472.35,93324,221796.35
410315,202207,41,31,10,37572.2,12120.73,49692.93
410320,202207,137,92,45,111504,54540,166044
410322,202207,36,22,14,26664,16968,43632
410330,202207,173,112,61,138169,73932.2,212101.2
410335,202207,98,52,46,63024,55752,118776
410337,202207,43,33,10,39996,12120,52116
410340,202207,39,32,7,38785,8484,47269
410345,202207,195,114,81,138168.98,98172.8,236341.78
410347,202207,44,32,12,38784.14,14544,53328.14
410350,202207,244,142,102,172105.49,123624.12,295729.61
410360,202207,448,275,173,333303.78,209676.93,542980.71
410370,202207,2357,991,1366,1202315.87,1662875.27,2865191.14
410380,202207,191,110,81,133320.51,98172.72,231493.23
410390,202207,401,256,145,310274.3,175740.8,486015.1
410395,202207,33,21,12,25452.85,14544.61,39997.46
410400,202207,891,368,523,446022.4,633880.89,1079903.29
410405,202207,78,60,18,72721.06,21816.74,94537.80
410410,202207,23,15,8,18180.4,9696,27876.4
410420,202207,1772,793,979,961013.59,1187767.89,2148781.48
410425,202207,193,79,114,95748.91,138168.2,233917.11
410430,202207,2435,1269,1166,1538039.65,1420475.78,2958515.43
410440,202207,353,246,107,298152,129684.25,427836.25
410442,202207,353,215,138,260583.56,167256.2,427839.76
410445,202207,359,243,116,294516.25,140593.37,435109.62
410450,202207,382,179,203,216950.32,247248,464198.32
410460,202207,556,287,269,349057.32,326028.4,675085.72
410465,202207,267,140,127,169680.1,155137.34,324817.44
410470,202207,218,127,91,153925.21,110292.45,264217.66
410480,202207,6712,3202,3510,3882086.34,4258999.68,8141086.02
410490,202207,1432,800,632,969612.26,767203.14,1736815.40
410500,202207,274,157,117,190285.1,141804.5,332089.6
410510,202207,190,139,51,168472.56,61812.71,230285.27
410520,202207,274,190,84,231492,103020,334512
410530,202207,291,87,204,105444,247248,352692
410540,202207,333,243,90,294516.5,109080.36,403596.86
410550,202207,1706,700,1006,848405.4,1221701.11,2070106.51
410560,202207,171,112,59,135744.2,71508,207252.2
410570,202207,442,288,154,349057.91,186648.97,535706.88
410580,202207,3773,1551,2222,1879828.48,2695518.18,4575346.66
410590,202207,437,277,160,335706.08,193920.4,529626.48
410600,202207,93,83,10,100596.8,12120,112716.8
410610,202207,53,43,10,52117,12120,64237
410620,202207,274,173,101,209677.54,122413.2,332090.74
410630,202207,450,248,202,301791.06,244824,546615.06
410640,202207,1158,726,432,879917.88,523587.34,1403505.22
410645,202207,113,84,29,101809.4,35148,136957.4
410650,202207,377,229,148,277548.3,179376.91,456925.21
410655,202207,87,63,24,76356.35,29088.08,105444.43
410657,202207,36,13,23,15756,27876,43632
410660,202207,650,432,218,526019.03,265431.79,791450.82
410670,202207,79,64,15,77568.87,18180,95748.87
410680,202207,189,151,38,183012.56,46056,229068.56
410685,202207,30,19,11,23028,13332,36360
410690,202207,29115,11942,17173,14476253.63,20836868.73,35313122.36
410700,202207,320,232,88,281187.73,106656,387843.73
410710,202207,130,106,24,128472.86,30300.2,158773.06
410712,202207,41,29,12,35148,14544,49692
410715,202207,102,73,29,88477.06,35148,123625.06
410720,202207,638,357,281,432686.69,340572.59,773259.28
410725,202207,192,133,59,161196.28,71508,232704.28
410730,202207,105,46,59,55752.97,71508,127260.97
410740,202207,95,69,26,83628,31512,115140
410750,202207,282,187,95,226645.41,115140,341785.41
410752,202207,20,13,7,15756,8484,24240
410753,202207,61,23,38,29088,46056.12,75144.12
410754,202207,54,27,27,32724.32,32724,65448.32
410755,202207,76,41,35,49692.2,42420,92112.2
410760,202207,777,419,358,507829.81,435110.64,942940.45
410765,202207,1919,847,1072,1026579.63,1299285.34,2325864.97
410770,202207,122,85,37,103021.21,44845.05,147866.26
410773,202207,67,46,21,55752.82,25452,81204.82
410775,202207,179,129,50,156350.33,60600,216950.33
410780,202207,81,45,36,54540,43632,98172
410785,202207,53,44,9,53328,10908,64236
410790,202207,88,37,51,44844.8,61812,106656.8
410800,202207,284,174,110,210891.52,133321.14,344212.66
410810,202207,31,17,14,20604.16,16969.24,37573.40
410820,202207,149,103,46,124837,55752,180589
410830,202207,9239,3798,5441,4606861.36,6603016.11,11209877.47
410832,202207,115,73,42,88476.56,50904,139380.56
410840,202207,1427,756,671,916283.18,813255.5,1729538.68
410845,202207,56,31,25,37572.2,30300.48,67872.68
410850,202207,160,115,45,139382.21,54540,193922.21
410855,202207,77,68,9,82416.32,10908,93324.32
410860,202207,821,406,415,493287.45,502983.37,996270.82
410865,202207,95,66,29,79993.13,35148,115141.13
410870,202207,139,112,27,135744,32724,168468
410880,202207,1186,578,608,700545.99,738110.91,1438656.90
410890,202207,99,61,38,73933.98,46056,119989.98
410895,202207,76,56,20,67872.35,24240,92112.35
410900,202207,32,23,9,27876,10908,38784
410910,202207,12,7,5,8484,6060,14544
410920,202207,41,25,16,30300,19392,49692
410930,202207,555,331,224,402386.04,272700.19,675086.23
410940,202207,4487,2288,2199,2773102.96,2667639.52,5440742.48
410950,202207,102,78,24,94537.73,29088.2,123625.93
410960,202207,933,357,576,432691.38,699332.27,1132023.65
410965,202207,64,41,23,49692,27876,77568
410970,202207,613,411,202,498138.14,244824.84,742962.98
410975,202207,123,77,46,93324.73,55752,149076.73
410980,202207,1645,735,910,890831.05,1104138.4,1994969.45
410990,202207,270,200,70,242401.17,84840.98,327242.15
411000,202207,63,35,28,42420.57,33937.62,76358.19
411005,202207,35,29,6,35148,7272,42420
411007,202207,249,141,108,170892,130896,301788
411010,202207,602,390,212,472685.21,256945.61,729630.82
411020,202207,286,175,111,212101.52,134532.77,346634.29
411030,202207,22,11,11,13332,13332.96,26664.96
411040,202207,59,37,22,44844,26664,71508
411050,202207,223,156,67,189072,81204.03,270276.03
411060,202207,547,370,177,448443.2,215738.13,664181.33
411065,202207,30,29,1,35149.14,1212,36361.14
411070,202207,1286,727,559,882342.91,677512.43,1559855.34
411080,202207,247,172,75,208464.03,90900.2,299364.23
411090,202207,87,64,23,77568.99,27876.96,105445.95
411095,202207,356,114,242,138168.7,293304.2,431472.9
411100,202207,107,83,24,100597.12,29088,129685.12
411110,202207,134,78,56,94536.19,67872.2,162408.39
411120,202207,205,135,70,163620.65,84840,248460.65
411125,202207,323,155,168,187862.26,203621.18,391483.44
411130,202207,116,98,18,118778.07,21816,140594.07
411140,202207,209,144,65,174528.19,78780,253308.19
411150,202207,1255,801,454,972029.07,551465.07,1523494.14
411155,202207,120,83,37,100596.46,44844,145440.46
411160,202207,34,13,21,15756,25452,41208
411170,202207,52,45,7,54540,8484,63024
411180,202207,1022,661,361,802357.97,437536.07,1239894.04
411190,202207,341,185,156,225432.31,189072,414504.31
411200,202207,666,365,301,442384.88,364815.44,807200.32
411210,202207,680,346,334,420564.28,406020.72,826585.00
411220,202207,159,111,48,134534.19,58176.8,192710.99
411230,202207,34,28,6,33936,7272.1,41208.1
411240,202207,111,67,44,81204.96,53328,134532.96
411250,202207,421,301,120,364812.93,145440,510252.93
411260,202207,14,10,4,12120,4848,16968
411270,202207,265,135,130,163623.45,158773.33,322396.78
411275,202207,185,157,28,190284.97,33936,224220.97
411280,202207,254,169,85,204830.41,103020,307850.41
411290,202207,64,51,13,61812.2,15756,77568.2
411295,202207,125,95,30,115141.37,36360.47,151501.84
411300,202207,80,39,41,47268.51,49692,96960.51
411310,202207,94,68,26,82416,31512,113928
411320,202207,822,508,314,615700.74,380570.19,996270.93
411325,202207,64,45,19,54540.1,23028,77568.1
411330,202207,927,594,333,719944.44,403597.66,1123542.10
411340,202207,34,23,11,27876,13332,41208
411342,202207,59,44,15,53328,18180,71508
411345,202207,103,50,53,60600.3,64236.39,124836.69
411350,202207,509,378,131,458137.8,158774.02,616911.82
411360,202207,62,40,22,48480.3,26665.12,75145.42
411370,202207,13952,5612,8340,6809102.44,10117837.85,16926940.29
411373,202207,178,118,60,143016,72720,215736
411375,202207,77,63,14,76357.42,18180,94537.42
411380,202207,79,54,25,65449.75,30300.2,95749.95
411390,202207,145,80,65,96960,78780,175740
411400,202207,356,237,119,287251.18,144228,431479.18
411410,202207,509,235,274,284822.4,333300.65,618123.05
411420,202207,980,401,579,486017.35,701750.62,1187767.97
411430,202207,529,280,249,339364.6,301792.21,641156.81
411435,202207,26,17,9,20604,10908,31512
411440,202207,469,369,100,447229.6,121200,568429.6
411450,202207,397,327,70,396326.59,84840.09,481166.68
411460,202207,817,305,512,369663.74,620547.89,990211.63
411470,202207,106,72,34,87265.64,41208,128473.64
411480,202207,707,357,350,432690.15,426625.96,859316.11
411490,202207,278,170,108,206041.49,130896,336937.49
411500,202207,102,81,21,98172.27,25452,123624.27
411510,202207,231,179,52,216949.81,63024,279973.81
411520,202207,6392,2181,4211,2645851.04,5104965.21,7750816.25
411530,202207,123,80,43,96960.96,52116,149076.96
411535,202207,47,14,33,16968.1,39996,56964.1
411540,202207,375,251,124,304213,150288,454501
411545,202207,59,43,16,52116.19,19392,71508.19
411550,202207,90,69,21,83628,25452,109080
411560,202207,400,163,237,197557.23,287244,484801.23
411570,202207,979,326,653,396328.12,791444.1,1187772.22
411573,202207,24,16,8,19392.2,9696,29088.2
411575,202207,316,192,124,232705.39,150288,382993.39
411580,202207,1272,448,824,542981.08,999903.12,1542884.20
411585,202207,74,37,37,44844,44844,89688
411590,202207,16,10,6,12120,7272,19392
411600,202207,19,8,11,9696,13332.7,23028.7
411605,202207,177,67,110,81204.51,133320,214524.51
411610,202207,238,148,90,179378.01,110292.2,289670.21
411620,202207,394,186,208,225437.95,252100.49,477538.44
411630,202207,47,33,14,39996.2,16968.55,56964.75
411640,202207,32,22,10,26664,12120,38784
411650,202207,7,4,3,4848,3636,8484
411660,202207,42,30,12,36360,14544,50904
411670,202207,234,161,73,195133.97,88476,283609.97
411680,202207,156,125,31,151500.2,37572,189072.2
411690,202207,635,328,307,397536.01,372086.87,769622.88
411695,202207,66,46,20,55752,24240,79992
411700,202207,142,113,29,136958.24,35148,172106.24
411705,202207,98,65,33,78781.75,39996.3,118778.05
411710,202207,298,199,99,241188.66,119988.95,361177.61
411720,202207,148,95,53,115140.2,64236.2,179376.4
411721,202207,87,68,19,82416,23028,105444
411722,202207,106,50,56,60600,67872,128472
411725,202207,167,120,47,145440,56964,202404
411727,202207,99,78,21,94536.4,25452.2,119988.6
411729,202207,50,36,14,43632.79,16968,60600.79
411730,202207,562,358,204,433900.12,247250.05,681150.17
411740,202207,27,16,11,19392,13332.12,32724.12
411745,202207,66,50,16,60600,19392,79992
411750,202207,841,341,500,414506.3,606000.74,1020507.04
411760,202207,1241,878,363,1065372.35,441175.31,1506547.66
411770,202207,428,276,152,334513.88,185437.2,519951.08
411780,202207,374,241,133,293304.71,161196.21,454500.92
411790,202207,590,334,256,404811.72,310272,715083.72
411800,202207,157,114,43,138168.75,52116.38,190285.13
411810,202207,176,133,43,161196.8,52116.89,213313.69
411820,202207,2513,987,1526,1198693.99,1849535.21,3048229.20
411830,202207,15,12,3,14544,3636,18180
411840,202207,2173,1278,895,1548948.72,1084753.4,2633702.12
411845,202207,63,22,41,26664.9,49692,76356.9
411850,202207,1259,671,588,813260.1,712661.42,1525921.52
411860,202207,57,34,23,41208.81,27876,69084.81
411870,202207,68,42,26,50904,31512,82416
411880,202207,416,242,174,294521.85,210888.46,505410.31
411885,202207,113,71,42,86052.39,50904.8,136957.19
411890,202207,325,223,102,270277.66,123624.97,393902.63
411900,202207,108,77,31,93324,37572,130896
411910,202207,206,142,64,172104.66,77569.14,249673.80
411915,202207,2426,936,1490,1135655.05,1807115,2942770.05
411920,202207,107,82,25,99385.43,30300,129685.43
411925,202207,17,10,7,12120,8484,20604
411930,202207,788,539,249,654567.62,303002.18,957569.80
411940,202207,609,380,229,460564.39,278760.6,739324.99
411950,202207,1189,525,664,636306.56,804779.99,1441086.55
411960,202207,1142,708,434,859314.79,526008.3,1385323.09
411965,202207,22,13,9,15756.38,10908.52,26664.90
411970,202207,87,74,13,89689.54,15756,105445.54
411980,202207,218,115,103,139380,124836,264216
411990,202207,5245,2776,2469,3367009.51,2997403.4,6364412.91
411995,202207,609,177,432,214526.85,523595.28,738122.13
412000,202207,325,210,115,254523.72,139380.85,393904.57
412010,202207,54,28,26,33936.13,31512,65448.13
412015,202207,37,30,7,36360.1,8484,44844.1
412020,202207,23,18,5,21816.2,6060,27876.2
412030,202207,37,34,3,41208,3636,44844
412033,202207,51,28,23,33936.52,27876,61812.52
412035,202207,69,43,26,52116,31512,83628
412040,202207,32,14,18,16968.6,21816,38784.6
412050,202207,218,160,58,193922.02,70296.76,264218.78
412060,202207,797,571,226,692060.74,273913.42,965974.16
412065,202207,55,29,26,35148,31512,66660
412070,202207,160,111,49,134533.6,60600.52,195134.12
412080,202207,330,153,177,185436.51,216949.45,402385.96
412085,202207,38,13,25,15756,30300,46056
412090,202207,854,517,337,626612.32,408445.94,1035058.26
412100,202207,258,215,43,260585.79,52116.68,312702.47
412110,202207,73,56,17,67872.8,20604,88476.8
412120,202207,355,189,166,229070.5,201193.82,430264.32
412125,202207,67,40,27,48480.2,32724,81204.2
412130,202207,47,29,18,35148.74,21816,56964.74
412135,202207,30,18,12,21816,14544,36360
412140,202207,445,287,158,347844.6,191497.19,539341.79
412150,202207,242,152,90,184224.87,109080.9,293305.77
412160,202207,79,51,28,61812,33936,95748
412170,202207,717,473,244,573277.31,296941.21,870218.52
412175,202207,39,26,13,31512.15,15756.08,47268.23
412180,202207,163,120,43,145440.8,52116.2,197557.0
412190,202207,332,260,72,315810.27,88476,404286.27
412200,202207,190,113,77,136956.15,93324,230280.15
412210,202207,97,72,25,87264,30300.73,117564.73
412215,202207,240,160,80,193920.4,96961.19,290881.59
412217,202207,66,51,15,63024.2,18180,81204.2
412220,202207,840,547,293,664185.31,355122.9,1019308.21
412230,202207,274,165,109,199980.98,132110.12,332091.10
412240,202207,1353,666,687,807197.12,833860.44,1641057.56
412250,202207,405,245,160,296941.01,193920,490861.01
412260,202207,127,79,48,95749.56,58176,153925.56
412265,202207,168,126,42,152712,50904,203616
412270,202207,90,55,35,66660.2,42420,109080.2
412280,202207,79,61,18,73932,21816,95748
412290,202207,89,55,34,66660.46,42420,109080.46
412300,202207,201,143,58,173316.2,70296,243612.2
412310,202207,52,40,12,48480.4,14544,63024.4
412320,202207,88,68,20,82417.14,24240,106657.14
412330,202207,198,153,45,185437.47,54540,239977.47
412340,202207,172,112,60,136956.98,73932,210888.98
412350,202207,665,299,366,362388.6,443593.5,805982.1
412360,202207,21,18,3,21816,3636,25452
412370,202207,140,116,24,141805.06,29088,170893.06
412380,202207,193,147,46,178165.79,55752,233917.79
412382,202207,64,34,30,41208,36360,77568
412385,202207,151,109,42,132108.2,50904,183012.2
412390,202207,317,238,79,288461.79,95748.98,384210.77
412395,202207,66,52,14,63024,16968,79992
412400,202207,99,64,35,77569.76,42420,119989.76
412402,202207,234,123,111,149076.6,135744,284820.6
412405,202207,960,314,646,380569.78,786588.37,1167158.15
412410,202207,985,583,402,706015.59,489653.98,1195669.57
412420,202207,17,17,0,20604,,20604.0
412430,202207,23,21,2,25452,2424,27876
412440,202207,660,328,332,397539.15,402384.4,799923.55
412450,202207,68,60,8,72720.3,9696,82416.3
412460,202207,76,53,23,64236.4,27876,92112.4
412470,202207,214,168,46,204831.71,55752.11,260583.82
412480,202207,150,106,44,128472.9,53328.2,181801.1
412490,202207,163,139,24,169680.88,29088,198768.88
412500,202207,402,317,85,384208.09,103021.28,487229.37
412510,202207,166,137,29,166046.02,35148.1,201194.12
412520,202207,88,58,30,70296,36360,106656
412530,202207,104,51,53,61812.32,64236,126048.32
412535,202207,74,57,17,69084.31,20604,89688.31
412540,202207,45,24,21,29088,25452.23,54540.23
412545,202207,79,52,27,63024.41,32724,95748.41
412550,202207,4131,1656,2475,2007097.54,3002155.91,5009253.45
412555,202207,10,6,4,7272,4848,12120
412560,202207,664,439,225,532072.11,272700.2,804772.31
412570,202207,818,383,435,464198.13,529646.03,993844.16
412575,202207,91,64,27,77568.76,32724,110292.76
412580,202207,173,116,57,140595.34,69085.15,209680.49
412590,202207,35,30,5,36362.01,6060,42422.01
412600,202207,188,131,57,158774.85,69084.85,227859.70
412610,202207,39,17,22,20604,26664,47268
412620,202207,126,104,22,126050.16,26664.5,152714.66
412625,202207,2107,994,1113,1204738,1352597.74,2557335.74
412627,202207,67,49,18,59388,21816,81204
412630,202207,374,253,121,306641.86,147865.11,454506.97
412635,202207,77,21,56,25452,67872,93324
412640,202207,107,74,33,89688.2,39996.07,129684.27
412650,202207,314,203,111,246038.97,134532.19,380571.16
412660,202207,574,308,266,373296,322392.83,695688.83
412665,202207,43,39,4,47268,4848,52116
412667,202207,278,180,98,218161.36,118776,336937.36
412670,202207,72,56,16,67872.2,19392,87264.2
412680,202207,317,237,80,288461.52,96960.62,385422.14
412690,202207,119,78,41,94536.95,49692,144228.95
412700,202207,193,124,69,150288,84840.23,235128.23
412710,202207,1354,758,596,919919.03,722354.9,1642273.93
412720,202207,231,129,102,156348.39,123624.32,279972.71
412730,202207,200,169,31,204828.59,37572.99,242401.58
412740,202207,413,210,203,254521.33,246036.2,500557.53
412750,202207,413,223,190,270276.99,230280.52,500557.51
412760,202207,351,177,174,214525.64,210890.81,425416.45
412770,202207,2100,1122,978,1362301.08,1186551.42,2548852.50
412780,202207,143,104,39,126050.85,47268,173318.85
412785,202207,319,159,160,192708.99,193920,386628.99
412788,202207,47,27,20,32724.82,24240,56964.82
412790,202207,126,102,24,123625.57,29088,152713.57
412795,202207,146,98,48,118776.2,58176,176952.2
412796,202207,302,185,117,224220.44,141804,366024.44
412800,202207,687,393,294,477530.34,356328.66,833859.00
412810,202207,3095,1658,1437,2011953.22,1741662.67,3753615.89
412820,202207,984,575,409,696907.74,495714.34,1192622.08
412830,202207,13,12,1,14544.18,1212,15756.18
412840,202207,265,178,87,215736,105444,321180
412850,202207,599,399,200,483590.59,242400.88,725991.47
412853,202207,170,79,91,95748,110292,206040
412855,202207,189,106,83,128473.1,100596.1,229069.2
412860,202207,97,63,34,76357.16,41209.89,117567.05
412862,202207,78,50,28,60600.2,33936,94536.2
412863,202207,9,6,3,7272,3636,10908
412865,202207,46,36,10,43632,12120,55752
412870,202207,109,68,41,83629.49,49692.26,133321.75
412880,202207,92,62,30,75147.29,36360,111507.29
420005,202207,43,37,6,44844.21,7272,52116.21
420010,202207,361,237,124,287246.86,150288.67,437535.53
420020,202207,91,72,19,87264,23028,110292
420030,202207,26,22,4,26664,4848,31512
420040,202207,92,70,22,84840.4,26664,111504.4
420050,202207,62,40,22,48480.16,26664,75144.16
420055,202207,16,15,1,18180.8,1212,19392.8
420060,202207,26,19,7,23028,8484.2,31512.2
420070,202207,102,86,16,104232,19392,123624
420075,202207,10,10,0,12120,,12120.0
420080,202207,40,34,6,41208,7272,48480
420090,202207,34,28,6,33936.66,7272.2,41208.86
420100,202207,149,125,24,151500.3,29088,180588.3
420110,202207,21,20,1,24240,1212,25452
420120,202207,59,42,17,50904.31,20604.85,71509.16
420125,202207,82,63,19,76356,23028,99384
420127,202207,36,31,5,37572,6060,43632
420130,202207,478,289,189,350275.73,229073.37,579349.10
420140,202207,1363,749,614,907797.97,746602.54,1654400.51
420150,202207,46,34,12,41208,14544,55752
420160,202207,32,29,3,35148,3636,38784
420165,202207,17,12,5,14544,6060.3,20604.3
420170,202207,67,40,27,48480,32724.59,81204.59
420180,202207,23,19,4,23028,4848,27876
420190,202207,26,23,3,27876,3636,31512
420195,202207,134,59,75,71509.06,90904.43,162413.49
420200,202207,1332,562,770,682361.44,933250.12,1615611.56
420205,202207,111,66,45,79992.9,54540.56,134533.46
420207,202207,134,76,58,92112.65,70296,162408.65
420208,202207,18,14,4,16968,4848,21816
420209,202207,13,11,2,13332.1,2424,15756.1
420210,202207,579,270,309,327241.47,375723.21,702964.68
420213,202207,50,38,12,46056,14544.2,60600.2
420215,202207,26,23,3,27877.03,3636,31513.03
420220,202207,57,36,21,43632.6,25452,69084.6
420230,202207,959,577,382,699335.73,462986.29,1162322.02
420240,202207,2283,1509,774,1828917.28,939306.35,2768223.63
420243,202207,43,34,9,41208.77,10908,52116.77
420245,202207,202,96,106,116352.85,128473.77,244826.62
420250,202207,61,41,20,49692.39,24240,73932.39
420253,202207,24,17,7,20605.07,8484,29089.07
420257,202207,13,9,4,10908,4848,15756
420260,202207,117,94,23,113928.79,27876.14,141804.93
420270,202207,33,24,9,29088.2,10908,39996.2
420280,202207,271,200,71,242405.29,86053.48,328458.77
420285,202207,24,19,5,23028,6060,29088
420287,202207,50,33,17,39996.59,20604,60600.59
420290,202207,919,626,293,759928.33,356328.83,1116257.16
420300,202207,1577,1254,323,1519874.12,393904.38,1913778.50
420310,202207,45,32,13,38784.9,15756,54540.9
420315,202207,27,22,5,26664.68,6060,32724.68
420320,202207,998,461,537,558740.21,652061.06,1210801.27
420325,202207,3,1,2,1212,2424.8,3636.8
420330,202207,114,74,40,89688.34,48480,138168.34
420340,202207,186,123,63,149076.8,76356.18,225432.98
420350,202207,254,176,78,213316.72,95748.8,309065.52
420360,202207,694,535,159,649637.87,193920.8,843558.67
420370,202207,134,72,62,87265.42,75144,162409.42
420380,202207,1212,825,387,999914.58,469046.25,1468960.83
420390,202207,227,157,70,190285.34,87264.77,277550.11
420395,202207,191,139,52,168469.81,63024.1,231493.91
420400,202207,225,172,53,208465.6,64236.2,272701.8
420410,202207,53,38,15,46057.52,18180,64237.52
420415,202207,31,26,5,31512.97,6060,37572.97
420417,202207,56,43,13,52116,15756,67872
420419,202207,11,10,1,12120,1212,13332
420420,202207,2844,1758,1086,2133148.79,1316236.38,3449385.17
420425,202207,65,50,15,60600.58,18180.44,78781.02
420430,202207,1042,756,286,916277.59,346632.3,1262909.89
420435,202207,13,12,1,14544,1212,15756
420440,202207,91,65,26,78780.6,31512,110292.6
420445,202207,31,28,3,33936.1,3636,37572.1
420450,202207,79,42,37,50904.81,44844,95748.81
420455,202207,180,137,43,167257.92,52116,219373.92
420460,202207,2315,1432,883,1735607.26,1070201.69,2805808.95
420470,202207,90,61,29,73932.6,35148,109080.6
420475,202207,10,9,1,10908,1212,12120
420480,202207,871,662,209,803573.09,254521.51,1058094.60
420490,202207,96,73,23,88477.4,27876,116353.4
420500,202207,388,228,160,276339.11,193920.2,470259.31
420510,202207,23,20,3,24240.68,3636,27876.68
420515,202207,28,15,13,18180.02,15756,33936.02
420517,202207,8,7,1,8484,1212,9696
420519,202207,1,0,1,,1212,1212.0
420520,202207,60,45,15,54540,18180,72720
420530,202207,140,88,52,107868.1,63024.4,170892.5
420535,202207,14,12,2,14544,2424,16968
420540,202207,6295,3913,2382,4744141.9,2889430.46,7633572.36
420543,202207,30,28,2,33936.88,2424,36360.88
420545,202207,204,141,63,170894.83,76356.2,247251.03
420550,202207,769,639,130,776911.62,157560.27,934471.89
420555,202207,29,21,8,25452.3,9696,35148.3
420560,202207,58,45,13,54540,15756,70296
420570,202207,192,93,99,113929.95,119989.66,233919.61
420580,202207,298,146,152,176953.28,184224.8,361178.08
420590,202207,477,306,171,370874.2,207252.35,578126.55
420600,202207,140,73,67,88476,81204,169680
420610,202207,39,36,3,43632,3636,47268
420620,202207,80,57,23,69084.99,27876.65,96961.64
420630,202207,147,96,51,116352.59,61812,178164.59
420640,202207,69,59,10,71508,12120,83628
420650,202207,280,149,131,180589.2,158773.2,339362.4
420660,202207,40,32,8,38784,9696,48480
420665,202207,42,26,16,31512.2,19392,50904.2
420670,202207,235,181,54,219378.61,65448,284826.61
420675,202207,15,13,2,15756,2424,18180
420680,202207,33,27,6,32724,7272,39996
420690,202207,193,147,46,178164.5,55752.34,233916.84
420700,202207,708,456,252,552681.42,305426.37,858107.79
420710,202207,139,73,66,88476,79992.44,168468.44
420720,202207,94,74,20,89688.69,25452.1,115140.79
420730,202207,684,407,277,493290.18,335730.84,829021.02
420740,202207,54,54,0,65448,,65448.0
420750,202207,487,318,169,385418.51,204828.51,590247.02
420757,202207,19,16,3,19392,3636,23028
420760,202207,39,29,10,35148,12120,47268
420765,202207,74,52,22,63024.2,26664,89688.2
420768,202207,58,48,10,58177.04,12120,70297.04
420770,202207,66,57,9,69084.72,10908,79992.72
420775,202207,37,33,4,39996.8,4848,44844.8
420780,202207,202,157,45,190285.54,54540,244825.54
420785,202207,24,16,8,19392,9696,29088
420790,202207,138,112,26,135744.07,31512,167256.07
420800,202207,60,44,16,53328,19392,72720
420810,202207,273,215,58,260581.87,70296.37,330878.24
420820,202207,2474,1360,1114,1653102.25,1353816.46,3006918.71
420830,202207,671,349,322,425419.76,391485.29,816905.05
420840,202207,136,93,43,112717,52116,164833
420845,202207,430,177,253,215738.55,306639.23,522377.78
420850,202207,266,202,64,244824.67,78780,323604.67
420860,202207,58,49,9,59389.19,10908,70297.19
420870,202207,129,89,40,109080.91,48480,157560.91
420880,202207,185,118,67,143016.69,81204.6,224221.29
420890,202207,963,461,502,559947.29,609637.22,1169584.51
420895,202207,6,6,0,7272,,7272.0
420900,202207,417,337,80,408448.01,96960.2,505408.21
420910,202207,5877,3160,2717,3836029.37,3306362.84,7142392.21
420915,202207,58,52,6,63024,7272,70296
420917,202207,19,15,4,18180.4,4848,23028.4
420920,202207,23,15,8,18180,9696,27876
420930,202207,3151,2038,1113,2471233.5,1350184.85,3821418.35
420940,202207,582,417,165,505416.92,199984.51,705401.43
420945,202207,10,8,2,9696,2424,12120
420950,202207,48,35,13,42420,15756,58176
420960,202207,108,87,21,105445.69,25452.1,130897.79
420970,202207,275,218,57,264220.17,69084.93,333305.10
420980,202207,23,22,1,26664,1212,27876
420985,202207,52,45,7,54540,8484,63024
420990,202207,84,64,20,77568,24240,101808
421000,202207,56,29,27,35148,32724,67872
421003,202207,36,25,11,30300,13332,43632
421005,202207,7,5,2,6060,2424,8484
421010,202207,843,546,297,664188.47,361181.26,1025369.73
421020,202207,19,17,2,20604,2424,23028
421030,202207,112,94,18,113929.92,21816.2,135746.12
421040,202207,66,46,20,55753.16,24240,79993.16
421050,202207,323,226,97,273912.88,119988.19,393901.07
421055,202207,18,14,4,16968,4848,21816
421060,202207,100,55,45,66660,54540,121200
421070,202207,42,37,5,44844.76,6060,50904.76
421080,202207,40,34,6,41208.22,7272,48480.22
421085,202207,18,15,3,18180,3636,21816
421090,202207,37,29,8,35148.11,9696,44844.11
421100,202207,115,89,26,107868.11,31512.95,139381.06
421105,202207,185,148,37,179378.38,44844.2,224222.58
421110,202207,117,84,33,101808,39996,141804
421120,202207,178,129,49,156350.23,59388,215738.23
421125,202207,16,9,7,10908,8484.11,19392.11
421130,202207,815,502,313,608427.95,379359.27,987787.22
421140,202207,34,23,11,27876.87,13332,41208.87
421145,202207,42,35,7,42420,8484,50904
421150,202207,83,64,19,77568.2,24240.97,101809.17
421160,202207,62,37,25,44844,30300.7,75144.7
421165,202207,13,10,3,12120,3636,15756
421170,202207,160,134,26,162555.7,31513.5,194069.2
421175,202207,181,129,52,156350.2,63024.79,219374.99
421180,202207,39,27,12,32724.56,14544.2,47268.76
421185,202207,17,14,3,16968,3636,20604
421187,202207,4,3,1,3636.8,1212,4848.8
421189,202207,43,31,12,37572.9,14544,52116.9
421190,202207,1895,1185,710,1436237.41,860531.87,2296769.28
421200,202207,92,64,28,77569.1,33936,111505.1
421205,202207,27,19,8,23028.94,9696,32724.94
421210,202207,173,125,48,151500.52,58176,209676.52
421220,202207,246,189,57,229069.74,69085,298154.74
421223,202207,45,36,9,43632.76,10908,54540.76
421225,202207,70,46,24,55752,29090.66,84842.66
421227,202207,66,55,11,66660,13332,79992
421230,202207,73,49,24,59388.8,29088,88476.8
421240,202207,18,16,2,19392.6,2424,21816.6
421250,202207,376,215,161,260580.73,195136.12,455716.85
421260,202207,21,16,5,19392,6060,25452
421265,202207,6,4,2,4848,2424,7272
421270,202207,57,51,6,61812,7272,69084
421280,202207,363,183,180,223009.56,218160.5,441170.06
421290,202207,314,204,110,247248.38,133321.22,380569.60
421300,202207,22,19,3,23028.2,4848,27876.2
421310,202207,45,31,14,37572.78,16968,54540.78
421315,202207,30,18,12,21816,14544.08,36360.08
421320,202207,135,89,46,107868.2,55752,163620.2
421330,202207,109,81,28,98172.1,33936,132108.1
421335,202207,44,31,13,37573.01,15756,53329.01
421340,202207,235,154,81,187862.06,98172,286034.06
421350,202207,178,106,72,128474.72,87264.1,215738.82
421360,202207,706,487,219,590248.4,266642.04,856890.44
421370,202207,187,137,50,166044.02,60601.17,226645.19
421380,202207,150,110,40,133320.6,48480,181800.6
421390,202207,16,10,6,12120,7272,19392
421400,202207,116,94,22,115140,26664,141804
421410,202207,21,18,3,21816,3636,25452
421415,202207,19,16,3,19392,3636,23028
421420,202207,103,88,15,106656.2,18180,124836.2
421430,202207,20,12,8,14544,9696,24240
421440,202207,60,52,8,63024,9696,72720
421450,202207,84,68,16,82416,19392.44,101808.44
421460,202207,55,43,12,52116,14544,66660
421470,202207,72,40,32,48480.2,38784,87264.2
421480,202207,752,563,189,682358.43,229069.01,911427.44
421490,202207,23,22,1,26664,1212,27876
421500,202207,471,274,197,332093.07,238765.21,570858.28
421505,202207,29,21,8,25452,9696,35148
421507,202207,31,25,6,30300,7272,37572
421510,202207,65,41,24,49692,29088,78780
421520,202207,50,42,8,50904.4,9696,60600.4
421530,202207,50,43,7,52116.2,8484,60600.2
421535,202207,21,20,1,24240,1212,25452
421540,202207,49,38,11,46056,13332,59388
421545,202207,82,56,26,67874.07,31512.4,99386.47
421550,202207,288,204,84,247252.01,101808.85,349060.86
421555,202207,14,12,2,14545,2424,16969
421560,202207,9,8,1,9696,1212,10908
421565,202207,129,84,45,101808.65,54540,156348.65
421567,202207,33,27,6,32724,7272,39996
421568,202207,42,40,2,48480,2424,50904
421569,202207,10,10,0,12120,,12120.0
421570,202207,237,154,83,186648.98,100596,287244.98
421575,202207,25,22,3,26664,3636,30300
421580,202207,719,420,299,509122.83,362390.19,871513.02
421590,202207,19,17,2,20604,2424,23028
421600,202207,165,114,51,138168.6,61812,199980.6
421605,202207,102,68,34,82416.64,41208.2,123624.84
421610,202207,169,126,43,152712.55,52116,204828.55
421620,202207,1044,592,452,718731.87,547830.68,1266562.55
421625,202207,21,20,1,24240.6,1212,25452.6
421630,202207,346,207,139,250886.18,168472.65,419358.83
421635,202207,19,8,11,9696,13332,23028
421640,202207,101,83,18,100597.17,21816,122413.17
421650,202207,306,179,127,216950.25,153926.38,370876.63
421660,202207,2540,1530,1010,1854043.79,1224133.62,3078177.41
421670,202207,162,116,46,140592.14,55752,196344.14
421680,202207,185,166,19,201193.13,23028,224221.13
421690,202207,341,231,110,279974.54,133320.36,413294.90
421700,202207,60,40,20,48480,24240.2,72720.2
421710,202207,19,19,0,23028,,23028.0
421715,202207,5,4,1,4848,1212,6060
421720,202207,641,434,207,526013.2,250885.38,776898.58
421725,202207,26,10,16,12120.2,19392.2,31512.4
421730,202207,24,18,6,21816,7272,29088
421740,202207,107,41,66,49693.04,79992,129685.04
421750,202207,192,139,53,168468,64236,232704
421755,202207,17,15,2,18180,2424,20604
421760,202207,101,69,32,83628.61,38784,122412.61
421770,202207,691,447,244,542981.43,296942.45,839923.88
421775,202207,31,19,12,23028.1,14544,37572.1
421780,202207,183,140,43,169680,52116,221796
421790,202207,153,132,21,159984.56,25452.66,185437.22
421795,202207,15,12,3,14544,3636,18180
421800,202207,541,323,218,391484.43,264219.19,655703.62
421810,202207,70,57,13,69085.58,15756,84841.58
421820,202207,297,187,110,226644.61,133320,359964.61
421825,202207,147,121,26,146653.92,31512,178165.92
421830,202207,150,90,60,109082.51,73933.91,183016.42
421835,202207,7,2,5,2424,6060,8484
421840,202207,40,34,6,41208.78,7272,48480.78
421850,202207,76,63,13,76356,15756,92112
421860,202207,35,25,10,30300,12120,42420
421870,202207,1077,782,295,947798.61,358758.55,1306557.16
421875,202207,47,37,10,44844,12120,56964
421880,202207,180,124,56,151500.47,67872.2,219372.67
421885,202207,22,17,5,20604,6060,26664
421890,202207,150,107,43,129684.37,52116.7,181801.07
421895,202207,43,37,6,44845.7,7272,52117.7
421900,202207,123,92,31,111506.24,37572,149078.24
421910,202207,62,38,24,46056,29088,75144
421915,202207,31,25,6,30300,7272,37572
421917,202207,46,35,11,42420.4,13332,55752.4
421920,202207,35,30,5,36360,6060,42420
421930,202207,607,482,125,584193.74,151500.27,735694.01
421935,202207,43,36,7,43632,8484,52116
421940,202207,52,45,7,54540.4,8484,63024.4
421950,202207,882,579,303,701754.48,367238.49,1068992.97
421960,202207,41,34,7,41208,8484,49692
421970,202207,322,206,116,249673.35,140592.6,390265.95
421985,202207,18,11,7,13332,8484,21816
422000,202207,9,4,5,4848,6060.59,10908.59
430003,202207,178,52,126,63024,152712,215736
430005,202207,31,22,9,26664.67,10908,37572.67
430010,202207,248,180,68,218162.08,82416,300578.08
430020,202207,139,95,44,115140.46,53328,168468.46
430030,202207,115,96,19,116352,23028,139380
430040,202207,2898,1715,1183,2079812.91,1436222.77,3516035.68
430045,202207,72,62,10,75144,12120,87264
430047,202207,7,5,2,6060,2424,8484
430050,202207,85,74,11,89688,13332,103020
430055,202207,13,12,1,14544,1212,15756
430057,202207,6,4,2,4848,2424,7272
430060,202207,3971,2277,1694,2764592.96,2056774.57,4821367.53
430063,202207,49,40,9,48480,10908,59388
430064,202207,168,130,38,157560,46056,203616
430066,202207,6,2,4,2424,4848,7272
430070,202207,45,33,12,39996,14544,54540
430080,202207,80,52,28,63024,35148,98172
430085,202207,27,13,14,15756,16968,32724
430087,202207,27,21,6,25452.8,7272,32724.8
430090,202207,66,55,11,66660.16,13332,79992.16
430100,202207,139,95,44,115140,53328,168468
430105,202207,154,87,67,106658.15,81205.1,187863.25
430107,202207,17,13,4,15756.53,4848,20604.53
430110,202207,494,270,224,327240.83,271488,598728.83
430120,202207,157,144,13,174528.3,15756,190284.3
430130,202207,792,476,316,576914.88,382992.06,959906.94
430140,202207,131,121,10,147864,12120,159984
430150,202207,108,66,42,79992,50904,130896
430155,202207,30,24,6,29088,7272,36360
430160,202207,3629,2059,1570,2495527.49,1905268.46,4400795.95
430163,202207,407,184,223,223011.04,270277.43,493288.47
430165,202207,31,19,12,23028,14544,37572
430170,202207,78,64,14,77568,16968,94536
430175,202207,77,60,17,72720,20604.7,93324.7
430180,202207,109,85,24,103020,29088,132108
430185,202207,27,19,8,23028,9696,32724
430187,202207,61,31,30,37572,36360,73932
430190,202207,230,117,113,141804.44,136956,278760.44
430192,202207,16,12,4,14544,4848,19392
430195,202207,15,12,3,14544,3636,18180
430200,202207,154,129,25,156348.8,30300,186648.8
430205,202207,18,18,0,21816,,21816.0
430210,202207,740,552,188,670241.18,229068.8,899309.98
430215,202207,10,9,1,10908,1212,12120
430220,202207,77,52,25,63024,30300,93324
430222,202207,13,5,8,6060,9696,15756
430223,202207,16,11,5,13332,6060,19392
430225,202207,3,2,1,2424,1212,3636
430230,202207,327,199,128,241188.6,155136,396324.6
430235,202207,51,33,18,39996,21816,61812
430237,202207,20,15,5,18180,6060,24240
430240,202207,113,77,36,93324.22,43632,136956.22
430245,202207,66,52,14,63024,16968,79992
430250,202207,184,105,79,127260,96960,224220
430258,202207,10,9,1,10908,1212,12120
430260,202207,32,27,5,32724,6060,38784
430265,202207,36,31,5,37572,6060,43632
430270,202207,516,368,148,446020.4,180588,626608.4
430280,202207,1045,609,436,739321.87,532068.1,1271389.97
430290,202207,441,226,215,273913.33,260580,534493.33
430300,202207,2130,1145,985,1388964.33,1196253.7,2585218.03
430310,202207,2091,1025,1066,1243531.94,1293217.51,2536749.45
430320,202207,57,46,11,55752.6,13332,69084.6
430330,202207,86,73,13,88476.22,15756,104232.22
430340,202207,64,52,12,63024,14544,77568
430350,202207,1662,1069,593,1295630.85,718716.2,2014347.05
430355,202207,19,17,2,21816,2424,24240
430360,202207,97,49,48,59388,58176,117564
430367,202207,43,31,12,37572,14544,52116
430370,202207,62,54,8,65448,9696,75144
430380,202207,111,83,28,100597.35,33936,134533.35
430390,202207,584,359,225,435113.08,273913.54,709026.62
430400,202207,253,173,80,209676.6,96960,306636.6
430410,202207,58,47,11,56964,13332,70296
430420,202207,524,331,193,401176.73,235128.89,636305.62
430430,202207,48,46,2,56156.8,2424,58580.8
430435,202207,140,107,33,129684,39996,169680
430440,202207,558,343,215,415718.24,261792.7,677510.94
430450,202207,1189,967,222,1173219.62,269065,1442284.62
430460,202207,5807,2954,2853,3586340.96,3462713.4,7049054.36
430461,202207,16,14,2,16968,2424,19392
430462,202207,4,2,2,2424,2424,4848
430463,202207,1174,617,557,749020.35,677511.45,1426531.80
430465,202207,27,16,11,19392,13332,32724
430466,202207,678,476,202,578133.46,244828.11,822961.57
430467,202207,122,69,53,83628.5,64236,147864.5
430468,202207,135,76,59,92112,71508.08,163620.08
430469,202207,19,14,5,16968,6060,23028
430470,202207,1174,635,539,771194.04,654481.37,1425675.41
430471,202207,70,47,23,56964,27876.57,84840.57
430480,202207,124,88,36,106656.4,43632,150288.4
430485,202207,8,8,0,9696.6,,9696.6
430490,202207,73,57,16,69084,19392,88476
430495,202207,34,24,10,29088,12120,41208
430500,202207,186,126,60,152712.77,72720,225432.77
430510,202207,3816,2486,1330,3014258.24,1613174.95,4627433.19
430511,202207,14,14,0,16968,,16968.0
430512,202207,158,108,50,130896.76,60600,191496.76
430513,202207,51,38,13,46056,15756,61812
430515,202207,24,23,1,27876,1212,29088
430517,202207,176,145,31,175740,37572,213312
430520,202207,341,239,102,289668.63,123624.1,413292.73
430530,202207,76,42,34,52116,42420,94536
430535,202207,447,286,161,347845.39,196345.36,544190.75
430537,202207,8,8,0,9696,,9696.0
430540,202207,83,54,29,65448,35148,100596
430543,202207,401,127,274,153924.16,332088.7,486012.86
430544,202207,49,45,4,54541.25,4848,59389.25
430545,202207,410,196,214,237555.43,259370.18,496925.61
430550,202207,45,37,8,44844,10908,55752
430558,202207,1,1,0,1212,,1212.0
430560,202207,54,30,24,36360,29088,65448
430570,202207,121,53,68,64236,82416,146652
430580,202207,123,97,26,117564,31512,149076
430583,202207,14,14,0,16968,,16968.0
430585,202207,13,10,3,12120,3636,15756
430587,202207,15,9,6,10908,7272.2,18180.2
430590,202207,169,134,35,162409.7,42420,204829.7
430593,202207,1,1,0,1212,,1212.0
430595,202207,16,13,3,15756,3636,19392
430597,202207,44,26,18,31512,21816,53328
430600,202207,217,166,51,201192,61812,263004
430605,202207,173,100,73,121200,88476,209676
430607,202207,29,23,6,27876,7272,35148
430610,202207,1737,821,916,996268.54,1112618.15,2108886.69
430613,202207,5,5,0,6060,,6060.0
430620,202207,94,69,25,83628,31512,115140
430630,202207,47,39,8,47268.95,9696,56964.95
430632,202207,31,27,4,32724,4848,37572
430635,202207,37,31,6,37572,7272,44844
430637,202207,66,31,35,37572,42420,79992
430640,202207,172,95,77,115140,93324.54,208464.54
430642,202207,18,16,2,19392,2424,21816
430645,202207,31,26,5,31512,6060,37572
430650,202207,247,194,53,235128.6,64236,299364.6
430655,202207,5,4,1,4848,1212,6060
430660,202207,977,480,497,581764.76,602368.87,1184133.63
430670,202207,71,47,24,56964,29088,86052
430673,202207,83,55,28,66660,33936,100596
430675,202207,8,6,2,7272,2424,9696
430676,202207,598,358,240,433896.2,290881.69,724777.89
430680,202207,250,161,89,196344.6,107868,304212.6
430690,202207,548,335,213,406020.58,258157.95,664178.53
430692,202207,9,7,2,8484.2,2424,10908.2
430693,202207,134,82,52,99384,63024.2,162408.2
430695,202207,65,52,13,63024,15756,78780
430697,202207,61,38,23,46056,27876,73932
430700,202207,1374,926,448,1123529.08,544189.28,1667718.36
430705,202207,29,26,3,31512,3636,35148
430710,202207,257,157,100,190284,121200,311484
430720,202207,102,85,17,103020,20604,123624
430730,202207,146,123,23,149076,27876,176952
430740,202207,76,50,26,60600,31512,92112
430745,202207,28,16,12,19392,14544,33936
430750,202207,326,213,113,258156.44,138168.72,396325.16
430755,202207,83,44,39,53328,47268,100596
430760,202207,390,213,177,259369.44,216950.57,476320.01
430770,202207,1590,836,754,1013242.64,913852.48,1927095.12
430780,202207,339,213,126,258156,152712,410868
430781,202207,25,24,1,29088,1212,30300
430783,202207,64,50,14,60600,16968,77568
430786,202207,6,4,2,4848,2424,7272
430790,202207,516,329,187,398748.79,226646.16,625394.95
430800,202207,157,120,37,145440.41,44844,190284.41
430805,202207,39,32,7,38784,8484,47268
430807,202207,64,32,32,38784,38784,77568
430810,202207,77,50,27,61812,32724,94536
430820,202207,151,97,54,117564.8,65448,183012.8
430825,202207,13,10,3,12120,3636,15756
430830,202207,252,234,18,284820.8,21816,306636.8
430840,202207,127,85,42,103020,50904,153924
430843,202207,5,3,2,3636,2424,6060
430845,202207,77,45,32,54540,38784,93324
430850,202207,584,416,168,504192.75,203616,707808.75
430860,202207,161,104,57,126048.2,69084.58,195132.78
430865,202207,73,41,32,49692,38784,88476
430870,202207,73,59,14,71508,16968,88476
430880,202207,166,118,48,143016.43,58176,201192.43
430885,202207,11,10,1,12120,1212,13332
430890,202207,344,206,138,249672,167256,416928
430900,202207,524,362,162,439958.1,196344,636302.1
430905,202207,133,56,77,67872.8,93324,161196.8
430910,202207,281,155,126,187860.6,152712.2,340572.8
430912,202207,3,3,0,3636,,3636.0
430915,202207,42,39,3,47268,3636,50904
430920,202207,4679,2428,2251,2943984.34,2730670.55,5674654.89
430925,202207,5,4,1,4848,1212,6060
430930,202207,2086,1178,908,1430168.17,1104135.32,2534303.49
430940,202207,260,166,94,201193.18,113928.4,315121.58
430950,202207,148,118,30,143016.66,36360,179376.66
430955,202207,24,14,10,16968,12120,29088
430957,202207,22,19,3,23028,3636,26664
430960,202207,254,163,91,197556.2,111504.57,309060.77
430965,202207,102,66,36,79992,43632,123624
430970,202207,88,72,16,87264,19392,106656
430975,202207,46,41,5,49692,6060,55752
430980,202207,49,29,20,35148,24240,59388
430990,202207,98,75,23,90900,27876.58,118776.58
430995,202207,111,103,8,124836,9696,134532
431000,202207,290,145,145,175740.7,176952,352692.7
431010,202207,360,211,149,256947.29,180590.29,437537.58
431020,202207,1875,1076,799,1305325.97,968389.89,2273715.86
431030,202207,41,33,8,39996,9696,49692
431033,202207,456,209,247,254526.94,299368.85,553895.79
431036,202207,12,8,4,9696,4848,14544
431040,202207,140,90,50,109080.55,61812,170892.55
431041,202207,39,22,17,26664,20604,47268
431043,202207,39,23,16,27876,19392,47268
431046,202207,13,10,3,12120,3636,15756
431050,202207,203,122,81,147864,98172,246036
431053,202207,72,37,35,44844.67,42420.62,87265.29
431055,202207,64,41,23,49692,27876,77568
431057,202207,17,17,0,20604,,20604.0
431060,202207,1572,1008,564,1222914.35,683568.95,1906483.30
431065,202207,16,8,8,9696,9696,19392
431070,202207,63,55,8,66660,9696,76356
431075,202207,8,8,0,9696,,9696.0
431080,202207,124,70,54,84840,65448,150288
431085,202207,32,28,4,33936,4848,38784
431087,202207,15,12,3,14544,3636,18180
431090,202207,51,38,13,46056,15756,61812
431100,202207,1263,756,507,916282.29,615698.49,1531980.78
431110,202207,219,130,89,157561.07,107868,265429.07
431112,202207,31,23,8,27876,9696,37572
431113,202207,28,21,7,25452,8484,33936
431115,202207,152,105,47,127260,56964,184224
431120,202207,590,340,250,413293.56,303000,716293.56
431123,202207,6,6,0,7272,,7272.0
431125,202207,95,82,13,99384,15756,115140
431127,202207,5,3,2,3636,2424,6060
431130,202207,703,461,242,559946.24,293305.76,853252.00
431140,202207,784,556,228,673875.4,276336,950211.4
431142,202207,20,18,2,21816.84,2424,24240.84
431150,202207,200,146,54,176952.2,65448,242400.2
431160,202207,45,41,4,49692,4848,54540
431162,202207,5,5,0,6060.26,,6060.26
431164,202207,4,4,0,4848,,4848.0
431170,202207,111,78,33,94536,39996,134532
431171,202207,69,38,31,46056,37572,83628
431173,202207,3,1,2,1212,2424,3636
431175,202207,199,102,97,123624.8,117564.15,241188.95
431177,202207,93,66,27,79992,32724,112716
431179,202207,15,10,5,12120.19,6060.99,18181.18
431180,202207,402,246,156,299364.17,190284.76,489648.93
431190,202207,72,53,19,65448,23028.7,88476.7
431198,202207,72,49,23,59207.41,27876,87083.41
431200,202207,20,16,4,19392,4848,24240
431205,202207,21,19,2,23028,2424,25452
431210,202207,102,64,38,77568,46056,123624
431213,202207,33,27,6,32724,7272,39996
431215,202207,23,22,1,26664,1212,27876
431217,202207,5,4,1,4848,1212,6060
431220,202207,66,55,11,66660,13332,79992
431225,202207,165,104,61,126048,73932,199980
431230,202207,95,79,16,95748,19392,115140
431235,202207,6,5,1,6060,1212,7272
431237,202207,15,10,5,12120,6060,18180
431238,202207,14,10,4,12120,4848,16968
431240,202207,1098,667,431,809623.49,522373.06,1331996.55
431242,202207,38,37,1,44844,1212,46056
431244,202207,25,20,5,24240,6060,30300
431245,202207,51,36,15,43632,18180,61812
431247,202207,12,8,4,9696,4848,14544
431250,202207,277,135,142,163620,172104,335724
431260,202207,53,45,8,54540,9696,64236
431261,202207,17,12,5,14544,6060,20604
431262,202207,15,12,3,14544,3636,18180
431265,202207,151,85,66,103020,79992,183012
431267,202207,17,15,2,18180,2424,20604
431270,202207,325,253,72,307849.37,87264,395113.37
431275,202207,38,33,5,39996,6060,46056
431280,202207,21,15,6,18180,7272,25452
431290,202207,22,20,2,24240,2424,26664
431295,202207,3,1,2,1212,2424,3636
431300,202207,20,18,2,21816,2424,24240
431301,202207,7,7,0,8484,,8484.0
431303,202207,55,35,20,42420,24240,66660
431306,202207,242,125,117,151500.05,141804,293304.05
431308,202207,8,6,2,7272,2424,9696
431310,202207,63,49,14,59388,16968,76356
431320,202207,190,115,75,139380.7,90900,230280.7
431330,202207,206,132,74,159984,89688.2,249672.2
431333,202207,27,22,5,26664,6060,32724
431335,202207,8,5,3,6060,3636,9696
431337,202207,402,193,209,233919.25,253308.22,487227.47
431339,202207,21,16,5,19392,6060,25452
431340,202207,3153,1693,1460,2053653.17,1770737,3824390.17
431342,202207,35,23,12,27876.6,14544,42420.6
431344,202207,19,19,0,23028,,23028.0
431346,202207,6,5,1,6060,1212,7272
431349,202207,30,27,3,32724,3636,36360
431350,202207,1065,569,496,689633.56,601152.5,1290786.06
431360,202207,53,39,14,47268,16968,64236
431365,202207,361,153,208,185437.6,252096.4,437534.0
431370,202207,1176,668,508,812044.68,615696.78,1427741.46
431380,202207,94,83,11,100596,13332,113928
431390,202207,486,262,224,317544.15,271488.26,589032.41
431395,202207,323,136,187,164832,226644,391476
431400,202207,37,24,13,29088,15756,44844
431402,202207,99,71,28,86052,33936.8,119988.8
431403,202207,27,18,9,21816,10908,32724
431405,202207,713,405,308,490862.12,373298.6,864160.72
431406,202207,34,26,8,31512,9696,41208
431407,202207,46,36,10,43632,12120,55752
431410,202207,3469,2110,1359,2558547.77,1649542.75,4208090.52
431413,202207,15,12,3,14544,3636,18180
431415,202207,70,48,22,58176,26664,84840
431417,202207,23,11,12,13332,14544,27876
431420,202207,349,228,121,276338.27,146652,422990.27
431430,202207,64,34,30,41209.12,36360,77569.12
431440,202207,9082,6163,2919,7475730.36,3542757.95,11018488.31
431442,202207,26,13,13,15756,15756,31512
431445,202207,27,25,2,30300,2424,32724
431446,202207,4,3,1,3636,1212,4848
431447,202207,84,61,23,73932,27876,101808
431449,202207,54,43,11,52116.8,13332,65448.8
431450,202207,422,278,144,336936.05,174528,511464.05
431454,202207,11,6,5,7272,6060,13332
431455,202207,46,37,9,46056.1,10908,56964.1
431460,202207,502,341,161,413295.92,195132,608427.92
431470,202207,135,98,37,118776,44844,163620
431475,202207,11,9,2,10908,2424,13332
431477,202207,38,23,15,27876,18180,46056
431478,202207,7,7,0,8484,,8484.0
431480,202207,593,358,235,433896.2,284821.5,718717.7
431490,202207,29352,16281,13071,19748170.85,15860352.91,35608523.76
431500,202207,77,60,17,72720,20604.6,93324.6
431505,202207,26,17,9,20604,10908,31512
431507,202207,11,9,2,10908,2424,13332
431510,202207,230,165,65,199980.4,78780,278760.4
431513,202207,20,19,1,23028,1212,24240
431514,202207,5,3,2,3636,2424,6060
431515,202207,84,71,13,87264.04,15756,103020.04
431517,202207,7,4,3,4848,3636,8484
431520,202207,38,32,6,38784,7272,46056
431530,202207,1404,611,793,740534.8,961116.43,1701651.23
431531,202207,21,20,1,24240,1212,25452
431532,202207,37,27,10,32724,12120,44844
431535,202207,28,14,14,16968,16968,33936
431540,202207,134,109,25,132108,30300.6,162408.6
431545,202207,13,10,3,12120,3636,15756
431550,202207,348,186,162,225432.69,196344.17,421776.86
431555,202207,11,11,0,13332,,13332.0
431560,202207,4770,3160,1610,3836041.63,1954988.26,5791029.89
431570,202207,835,442,393,535707.53,479955.37,1015662.90
431575,202207,51,29,22,35148,26664,61812
431580,202207,79,54,25,65448,30300,95748
431590,202207,141,117,24,141804,29088,170892
431595,202207,17,15,2,18180,2424,20604
431600,202207,254,151,103,183015.53,124836.82,307852.35
431610,202207,113,83,30,100596,36360.2,136956.2
431620,202207,41,33,8,39996,9696,49692
431630,202207,123,100,23,121200.81,27876,149076.81
431640,202207,1305,815,490,987786.17,593880.44,1581666.61
431642,202207,33,31,2,37572,2424,39996
431643,202207,42,17,25,20604,30300,50904
431645,202207,317,183,134,221796.33,162408,384204.33
431647,202207,8,7,1,8484,1212,9696
431650,202207,31,16,15,19392,18180,37572
431660,202207,268,167,101,202404,123624,326028
431670,202207,221,97,124,117564,150288.99,267852.99
431673,202207,12,10,2,12120,2424,14544
431675,202207,25,20,5,24240,6060,30300
431680,202207,1160,844,316,1025361.47,386631.37,1411992.84
431690,202207,4903,2903,2000,3523322.18,2428873.47,5952195.65
431695,202207,16,10,6,12120,7272,19392
431697,202207,5,1,4,1212,4848,6060
431700,202207,179,135,44,163620,53328,216948
431710,202207,4038,1734,2304,2106471.47,2794877.75,4901349.22
431720,202207,1263,776,487,941121.12,591457.44,1532578.56
431725,202207,2,1,1,1212,1212,2424
431730,202207,1173,775,398,940534.06,482380.4,1422914.46
431740,202207,1340,646,694,782956.36,841133.16,1624089.52
431750,202207,1815,1180,635,1430167.78,773260.95,2203428.73
431755,202207,6,5,1,6060,1212,7272
431760,202207,967,598,369,725992.65,447231.87,1173224.52
431770,202207,412,279,133,338148,161196,499344
431775,202207,23,17,6,20604,7272,27876
431780,202207,559,335,224,406020.57,271488,677508.57
431790,202207,152,117,35,141804.02,42420,184224.02
431795,202207,13,10,3,12120,3636,15756
431800,202207,3099,1620,1479,1965876.25,1792553.47,3758429.72
431805,202207,17,15,2,18180,2424,20604
431810,202207,594,384,210,465408.44,254521.2,719929.64
431820,202207,338,194,144,235128,174528,409656
431830,202207,2309,1392,917,1688324.31,1112616.9,2800941.21
431840,202207,478,305,173,369663.19,209677,579340.19
431842,202207,34,28,6,33936,7272,41208
431843,202207,11,8,3,9696.1,3636,13332.1
431844,202207,18,13,5,15756,6060,21816
431845,202207,25,22,3,26664,3636,30300
431846,202207,27,23,4,27876,4848,32724
431848,202207,13,11,2,13332,2424,15756
431849,202207,5,4,1,4848,1212,6060
431850,202207,767,598,169,724784.56,204829.3,929613.86
431860,202207,122,77,45,93324.15,54540,147864.15
431861,202207,5,1,4,1212,4848,6060
431862,202207,62,44,18,53328,21816,75144
431870,202207,3737,2126,1611,2576738.06,1954964.85,4531702.91
431880,202207,979,684,295,831432.99,357540.89,1188973.88
431890,202207,1234,714,520,866582.14,630240.45,1496822.59
431900,202207,186,130,56,157560,69084,226644
431910,202207,43,34,9,41208,10908,52116
431912,202207,47,31,16,37572,19392,56964
431915,202207,144,109,35,132108,42420,174528
431920,202207,145,104,41,126048,49692,175740
431930,202207,72,59,13,71508,15756,87264
431935,202207,5,4,1,4848,1212,6060
431936,202207,2,2,0,2424,,2424.0
431937,202207,19,14,5,16968.63,6060,23028.63
431940,202207,468,319,149,386629.64,180588,567217.64
431950,202207,477,309,168,374511.63,203616.5,578128.13
431960,202207,735,399,336,483589.47,408444.8,892034.27
431970,202207,66,59,7,71508,8484,79992
431971,202207,3,3,0,3636,,3636.0
431973,202207,18,15,3,18180.84,3636,21816.84
431975,202207,10,10,0,12120,,12120.0
431980,202207,198,116,82,140592.64,99384,239976.64
431990,202207,1080,571,509,691978.75,616916.02,1308894.77
432000,202207,1872,978,894,1186565.15,1085962.34,2272527.49
432010,202207,261,171,90,207252.7,109080.2,316332.9
432020,202207,186,158,28,191497.26,33936,225433.26
432023,202207,14,12,2,14544,2424,16968
432026,202207,60,53,7,64236,8484,72720
432030,202207,60,28,32,33936.36,38784,72720.36
432032,202207,15,12,3,14544,4848,19392
432035,202207,62,46,16,55752,19392,75144
432040,202207,87,59,28,71508,33936,105444
432045,202207,2,2,0,2424,,2424.0
432050,202207,81,48,33,58176,39996.6,98172.6
432055,202207,130,92,38,111504,46056,157560
432057,202207,6,4,2,4848.6,2424,7272.6
432060,202207,32,28,4,33936,4848,38784
432065,202207,29,26,3,31512,3636,35148
432067,202207,86,79,7,95748.5,8484,104232.5
432070,202207,388,306,82,370872.6,99384,470256.6
432080,202207,817,571,246,692059.85,299365.28,991425.13
432085,202207,14,12,2,14544,2424,16968
432090,202207,270,178,92,215736.1,111504,327240.1
432100,202207,174,112,62,135744,75144,210888
432110,202207,556,365,191,442381.63,231492.58,673874.21
432120,202207,1027,577,450,699327.02,546614.04,1245941.06
432130,202207,503,357,146,432684,176952,609636
432132,202207,22,20,2,24240,2424,26664
432135,202207,78,65,13,78780,15756,94536
432140,202207,259,194,65,235129.93,78780,313909.93
432143,202207,210,127,83,153924,100596.85,254520.85
432145,202207,282,196,86,237552,104232,341784
432146,202207,15,13,2,15756,2424,18180
432147,202207,90,54,36,65448,43632,109080
432149,202207,16,9,7,10908,8484,19392
432150,202207,1001,612,389,744173.25,472685.15,1216858.40
432160,202207,1722,879,843,1066568.33,1022936.11,2089504.44
432162,202207,4,2,2,2424,2424,4848
432163,202207,15,10,5,12120,6060,18180
432166,202207,117,82,35,99687.1,42420,142107.1
432170,202207,227,114,113,138168.9,136957.21,275126.11
432180,202207,567,359,208,435108,254520.6,689628.6
432183,202207,11,10,1,12120,1212,13332
432185,202207,77,62,15,75144,18180.97,93324.97
432190,202207,505,304,201,368448.4,244824.8,613273.2
432195,202207,88,72,16,87264,19392,106656
432200,202207,414,255,159,309061.13,192708,501769.13
432210,202207,115,68,47,82416.2,56964,139380.2
432215,202207,32,30,2,36360,2424,38784
432218,202207,19,19,0,23028,,23028.0
432220,202207,640,322,318,390264.3,385418.86,775683.16
432225,202207,18,12,6,14544.2,7272,21816.2
432230,202207,123,83,40,100596,48480,149076
432232,202207,25,22,3,26664,3636,30300
432234,202207,4,2,2,2424,2424,4848
432235,202207,1,1,0,1212,,1212.0
432237,202207,23,15,8,18180,9696,27876
432240,202207,4506,2529,1977,3067612.63,2396143.41,5463756.04
432250,202207,1113,721,392,873854.23,475105.33,1348959.56
432252,202207,46,46,0,55752,,55752.0
432253,202207,67,53,14,64236.2,16968,81204.2
432254,202207,29,13,16,15756,19392,35148
432255,202207,12,10,2,12120,2424,14544
432260,202207,847,674,173,819314.85,209676.2,1028991.05
432270,202207,216,161,55,195134.25,66661.04,261795.29
432280,202207,160,120,40,145442.03,48480,193922.03
432285,202207,1,1,0,1212,,1212.0
432290,202207,55,47,8,56964,9696,66660
432300,202207,4975,2641,2334,3203262.49,2836095.15,6039357.64
432310,202207,130,107,23,129684,27876,157560
432320,202207,19,14,5,16968,6060,23028
432330,202207,14,10,4,12120,4848,16968
432335,202207,8,6,2,7272,2424,9696
432340,202207,35,28,7,33936,8484,42420
432345,202207,115,76,39,92112.3,47268,139380.3
432350,202207,23,22,1,26664,1212,27876
432360,202207,5,4,1,4848,1212,6060
432370,202207,25,25,0,30300.48,,30300.48
432375,202207,28,26,2,31512,2424,33936
432377,202207,7,7,0,8484,,8484.0
432380,202207,196,87,109,105444.61,132109.7,237554.31
500020,202207,275,143,132,173318.7,159984.78,333303.48
500025,202207,134,65,69,78780.2,84840.92,163621.12
500060,202207,1463,934,529,1132022.97,642365.3,1774388.27
500070,202207,734,350,384,424208.72,465411.49,889620.21
500080,202207,137,110,27,133322.68,32724,166046.68
500085,202207,128,100,28,121201.86,33936,155137.86
500090,202207,379,174,205,210889.27,248461.13,459350.40
500100,202207,690,354,336,429055.25,407235.79,836291.04
500110,202207,2305,1089,1216,1321094.84,1473807.8,2794902.64
500124,202207,261,144,117,174528.01,141805.93,316333.94
500150,202207,325,133,192,161198.33,232705.69,393904.02
500190,202207,553,362,191,438751.1,231492.48,670243.58
500200,202207,200,168,32,203617.8,38784,242401.8
500210,202207,1655,543,1112,658123.18,1347751.83,2005875.01
500215,202207,196,113,83,136957.76,100596.6,237554.36
500220,202207,717,459,258,556319.57,312697.02,869016.59
500230,202207,224,133,91,161198.1,110292.2,271490.3
500240,202207,648,424,224,513893.55,271490.8,785384.35
500260,202207,598,239,359,289669.43,435109.1,724778.53
500270,202207,30536,13284,17252,16114025.03,20920605.97,37034631.00
500280,202207,201,70,131,84840,158772,243612
500290,202207,1185,742,443,899315.22,538129.41,1437444.63
500295,202207,463,301,162,364817.54,196344.19,561161.73
500310,202207,111,38,73,46056.1,88476.18,134532.28
500315,202207,836,465,371,563582.17,449652.2,1013234.37
500320,202207,3679,1762,1917,2135588.05,2323415.92,4459003.97
500325,202207,915,512,403,621776.67,489653.08,1111429.75
500330,202207,1495,714,781,866520.56,947796.51,1814317.07
500345,202207,305,223,82,271491.73,99384.21,370875.94
500348,202207,239,147,92,178165.93,112716,290881.93
500350,202207,109,52,57,63024.71,69084,132108.71
500370,202207,5776,2632,3144,3197320.3,3812978.66,7010298.96
500375,202207,359,241,118,292092.8,143016,435108.8
500380,202207,630,354,276,429054.7,334514.19,763568.89
500390,202207,71,32,39,38784.1,47268.8,86052.9
500400,202207,215,140,75,169682.91,90900.2,260583.11
500410,202207,487,213,274,258159.04,332091.4,590250.44
500430,202207,552,375,177,455719.11,214525.92,670245.03
500440,202207,208,113,95,136956.7,115140.2,252096.9
500450,202207,419,183,236,221797.78,286032.8,507830.58
500460,202207,271,148,123,179378.25,149076,328454.25
500470,202207,426,315,111,381783.45,134532.9,516316.35
500480,202207,99,58,41,70296.94,49692.94,119989.88
500490,202207,100,45,55,54540.79,66662.27,121203.06
500500,202207,1465,544,921,659334.47,1116257.45,1775591.92
500510,202207,40,33,7,39996.2,8484,48480.2
500515,202207,111,76,35,92112.4,42420.2,134532.6
500520,202207,285,147,138,178167.11,167256,345423.11
500525,202207,93,49,44,60600,53328,113928
500540,202207,902,401,501,486018.93,607216.34,1093235.27
500560,202207,881,488,393,591462.06,477532.13,1068994.19
500568,202207,1019,524,495,636309.27,599942.35,1236251.62
500570,202207,1177,683,494,827803.71,598730.4,1426534.11
500580,202207,314,163,151,197559.75,183012.6,380572.35
500600,202207,357,173,184,209677.35,223009.3,432686.65
500620,202207,949,650,299,787812.19,362389.48,1150201.67
500625,202207,81,65,16,78780.2,19392,98172.2
500627,202207,40,17,23,20604.15,27876,48480.15
500630,202207,1578,903,675,1093942.09,818103.42,1912045.51
500635,202207,496,297,199,359964,241188,601152
500640,202207,361,198,163,239981.87,197558.3,437540.17
500660,202207,5770,2086,3684,2528258.46,4466238.62,6994497.08
500690,202207,611,223,388,270278.36,470256.33,740534.69
500710,202207,402,202,200,244828.91,242401.53,487230.44
500720,202207,931,507,424,615703.99,515100.57,1130804.56
500730,202207,155,94,61,113932.17,73932,187864.17
500740,202207,948,403,545,488442.5,660543.74,1148986.24
500750,202207,178,63,115,76356.4,139381.32,215737.72
500755,202207,115,88,27,106658.92,32724,139382.92
500769,202207,739,411,328,498138.86,397538.63,895677.49
500770,202207,407,221,186,267852.41,225432,493284.41
500780,202207,130,89,41,107869.81,49692,157561.81
500790,202207,1064,520,544,630246.24,660543.93,1290790.17
500793,202207,289,150,139,181801,168470.01,350271.01
500795,202207,184,123,61,149077.48,73932.5,223009.98
500797,202207,48,33,15,39996,18180,58176
500800,202207,427,184,243,223009.88,295728,518737.88
500830,202207,2289,1227,1062,1489576.56,1289572.27,2779148.83
500840,202207,115,86,29,104234.44,35148,139382.44
510010,202207,167,90,77,109080,93324,202404
510020,202207,539,245,294,296946.08,357544.14,654490.22
510025,202207,1707,961,746,1164746.53,904157.84,2068904.37
510030,202207,660,347,313,420574.82,381784.19,802359.01
510035,202207,133,69,64,83628.22,77568,161196.22
510040,202207,402,192,210,232704.8,254521.28,487226.08
510050,202207,375,202,173,244829.07,209677.37,454506.44
510060,202207,124,59,65,71509.45,81204,152713.45
510080,202207,254,100,154,121200.93,186648.6,307849.53
510100,202207,67,26,41,31512,50904,82416
510120,202207,33,19,14,23028,16968.2,39996.2
510125,202207,381,240,141,290881.29,172104,462985.29
510130,202207,536,320,216,387846.83,261792.97,649639.80
510140,202207,454,146,308,176952.2,373297.19,550249.39
510160,202207,113,42,71,50904.2,86053.9,136958.1
510170,202207,748,450,298,545404.32,361178.57,906582.89
510180,202207,2920,1351,1569,1637437.55,1901648.53,3539086.08
510185,202207,27,14,13,16968,15756,32724
510190,202207,232,76,156,92113.03,189072.4,281185.43
510250,202207,2666,1651,1015,2002265.42,1232609.25,3234874.67
510260,202207,167,121,46,146652.65,55752.19,202404.84
510263,202207,487,270,217,327242.48,263006.16,590248.64
510267,202207,614,338,276,409661.84,334513.09,744174.93
510268,202207,66,32,34,38784.9,41208,79992.9
510269,202207,76,36,40,43632,48480.8,92112.8
510270,202207,372,181,191,219373.06,231492,450865.06
510279,202207,201,153,48,185436.6,58176,243612.6
510285,202207,179,71,108,86052.05,130896.9,216948.95
510300,202207,519,269,250,326029.79,303000.56,629030.35
510305,202207,195,89,106,107868.75,128472,236340.75
510310,202207,101,52,49,63024,60600,123624
510320,202207,807,503,304,609641.28,368448.3,978089.58
510325,202207,432,183,249,221797.7,301789.45,523587.15
510330,202207,435,236,199,286034.88,241189.41,527224.29
510335,202207,668,397,271,481172.06,330877,812049.06
510336,202207,50,34,16,41208.3,19392.07,60600.37
510337,202207,98,44,54,53328,65448,118776
510340,202207,17987,7893,10094,9574299.59,12244979.45,21819279.04
510343,202207,63,50,13,60600.52,15756,76356.52
510345,202207,152,94,58,113929.33,70296.6,184225.93
510350,202207,644,345,299,418143.95,362389.4,780533.35
510360,202207,225,140,85,169681.09,103020,272701.09
510370,202207,161,74,87,89688.93,105444,195132.93
510380,202207,80,59,21,71508.52,25452,96960.52
510385,202207,64,30,34,36360.2,41208,77568.2
510390,202207,96,45,51,54540,61812.37,116352.37
510395,202207,53,37,16,44844,19392,64236
510410,202207,780,492,288,596314.33,349057.16,945371.49
510420,202207,553,268,285,324816.6,345420,670236.6
510450,202207,51,28,23,33936,27876,61812
510452,202207,58,28,30,33936,36360,70296
510454,202207,53,25,28,30300.2,33936.08,64236.28
510455,202207,121,69,52,83628,63024,146652
510460,202207,191,83,108,100598,130896,231494
510480,202207,725,432,293,524802.85,355119.05,879921.90
510490,202207,339,164,175,198768,212100,410868
510500,202207,227,166,61,201192,73932,275124
510510,202207,826,480,346,581766.75,419353.71,1001120.46
510515,202207,1268,653,615,791444.54,745383.27,1536827.81
510517,202207,272,121,151,147866.23,183012.9,330879.13
510520,202207,219,141,78,170893.81,94536.37,265430.18
510523,202207,115,88,27,107868.31,32724,140592.31
510525,202207,880,538,342,652067.1,414506.56,1066573.66
510530,202207,22,14,8,16968,9696,26664
510550,202207,243,111,132,134532.49,159985.2,294517.69
510558,202207,308,153,155,185437.4,187860,373297.4
510560,202207,372,213,159,259369.32,192709.74,452079.06
510562,202207,658,469,189,568433.83,229069.25,797503.08
510590,202207,704,346,358,419355.2,435108.27,854463.47
510600,202207,224,115,109,139382.59,132108,271490.59
510610,202207,232,103,129,124837.54,156348.6,281186.14
510615,202207,211,103,108,124836.38,130896,255732.38
510617,202207,25,12,13,14544,15756,30300
510618,202207,127,57,70,69084,84841.19,153925.19
510619,202207,84,59,25,71508,31512,103020
510620,202207,158,87,71,105444,86052,191496
510621,202207,175,110,65,133320.11,78780.23,212100.34
510622,202207,488,268,220,324826.23,267855.26,592681.49
510623,202207,283,190,93,230282.13,112716,342998.13
510624,202207,87,45,42,54540.06,50904.53,105444.59
510625,202207,519,326,193,395118.51,235129.97,630248.48
510626,202207,114,69,45,83630.93,55752.85,139383.78
510627,202207,88,61,27,73933.1,32724.2,106657.3
510628,202207,155,94,61,113928.25,76356,190284.25
510629,202207,280,167,113,202404.4,136977.81,339382.21
510630,202207,437,218,219,264217.22,265428.3,529645.52
510631,202207,19,9,10,10908,12120,23028
510637,202207,352,203,149,246037.91,180588.5,426626.41
510642,202207,1106,596,510,723575.21,619337.92,1342913.13
510645,202207,9,1,8,1212,9696,10908
510650,202207,1288,845,443,1024161.08,536918.75,1561079.83
510665,202207,88,41,47,49692,56964,106656
510670,202207,56,33,23,39996,27876,67872
510675,202207,1085,700,385,848410.75,466624.04,1315034.79
510677,202207,349,182,167,220585.33,202404.58,422989.91
510680,202207,86,54,32,66661,38784,105445
510682,202207,187,95,92,115140.52,111504,226644.52
510685,202207,53,40,13,48480,15756,64236
510700,202207,573,326,247,395114.62,299365.24,694479.86
510704,202207,1197,613,584,744182.41,707817.5,1451999.91
510706,202207,154,83,71,100597.08,86053.03,186650.11
510710,202207,422,290,132,351485.23,159984.6,511469.83
510715,202207,57,39,18,47268,21816.06,69084.06
510718,202207,232,108,124,130897.51,150289.67,281187.18
510719,202207,48,18,30,21816,36360,58176
510720,202207,183,129,54,156348.91,65448,221796.91
510724,202207,79,29,50,35148,60600,95748
510726,202207,64,31,33,37572.52,39996,77568.52
510729,202207,15,5,10,6060,12120.1,18180.1
510730,202207,448,241,207,292093.35,250884,542977.35
510735,202207,113,47,66,56964,79992,136956
510740,202207,22,12,10,14544.24,12120.2,26664.44
510757,202207,26,22,4,26665.69,4848,31513.69
510760,202207,7475,3798,3677,4606898.51,4463822.88,9070721.39
510770,202207,695,325,370,393903.55,448441.03,842344.58
510774,202207,16,7,9,8484,10908,19392
510775,202207,116,87,29,105444,35148,140592
510776,202207,39,11,28,13332.1,33936.8,47268.9
510777,202207,188,79,109,95748,132108,227856
510779,202207,37,22,15,26664,18180,44844
510780,202207,267,140,127,169682.63,153924.2,323606.83
510785,202207,346,190,156,230281.63,189072,419353.63
510787,202207,194,93,101,112716.4,122413.14,235129.54
510788,202207,6,1,5,1212.5,6060,7272.5
510790,202207,2633,1365,1268,1654459.88,1538034.2,3192494.08
510792,202207,1103,608,495,737957.9,599945.36,1337903.26
510794,202207,112,62,50,75144,60600,135744
510795,202207,2279,1317,962,1596230.37,1165948.46,2762178.83
510800,202207,188,110,78,133320.89,94536.14,227857.03
510805,202207,199,132,67,159984.2,82416.2,242400.4
510810,202207,104,45,59,54540.65,71508.22,126048.87
510820,202207,235,119,116,144230.55,140593.2,284823.75
510830,202207,76,40,36,48481.44,43632,92113.44
510835,202207,19,13,6,15756,7272,23028
510840,202207,9212,4278,4934,5186267.73,5984912.88,11171180.61
510850,202207,203,83,120,100597.4,145440.71,246038.11
510860,202207,402,193,209,233918.06,253309.48,487227.54
510880,202207,72,50,22,60600,27876,88476
510885,202207,70,41,29,49692.45,35148,84840.45
510890,202207,74,41,33,49692,39996,89688
510895,202207,171,100,71,121201.57,86052,207253.57
520005,202207,148,59,89,71509.14,107869,179378.14
520010,202207,290,124,166,150289.32,201194.51,351483.83
520013,202207,746,508,238,615702.61,288458.89,904161.50
520015,202207,40,28,12,33936,14544,48480
520017,202207,86,52,34,63024,41208,104232
520020,202207,13,6,7,7272,8484,15756
520025,202207,2716,1430,1286,1734406.46,1559869.38,3294275.84
520030,202207,799,428,371,519045.69,449652.48,968698.17
520050,202207,63,46,17,55752,20604.9,76356.9
520055,202207,73,48,25,58176,30300,88476
520060,202207,179,114,65,138171.48,78781.27,216952.75
520080,202207,571,406,165,492074.22,199980.54,692054.76
520082,202207,15,11,4,13332,4848,18180
520085,202207,97,73,24,88476.8,29088,117564.8
520090,202207,82,59,23,71508,27876,99384
520110,202207,9109,3865,5244,4688077.25,6363044.13,11051121.38
520120,202207,10,4,6,4848,7272,12120
520130,202207,811,566,245,685998.17,296941.83,982940.00
520140,202207,11896,6514,5382,7897553.17,6527878.55,14425431.72
520145,202207,52,31,21,37572.2,25452,63024.2
520150,202207,144,113,31,136956.29,37572,174528.29
520160,202207,42,26,16,31512,19392,50904
520170,202207,219,124,95,151503.94,115144.13,266648.07
520180,202207,186,86,100,104232.2,122412.2,226644.4
520215,202207,203,140,63,169681.4,76356,246037.4
520235,202207,83,63,20,76356,24240,100596
520250,202207,138,75,63,90901.57,76356,167257.57
520260,202207,116,71,45,86054.23,54540.2,140594.43
520280,202207,46,33,13,39996,15756,55752
520310,202207,47,28,19,33936.9,23028.2,56965.1
520320,202207,175,106,69,128473.05,83628.39,212101.44
520330,202207,827,454,373,551464.76,452077.7,1003542.46
520340,202207,369,207,162,250888.21,196344.77,447232.98
520350,202207,481,246,235,298155.09,286032.2,584187.29
520355,202207,97,56,41,67872.52,49692,117564.52
520357,202207,34,27,7,32724,8484,41208
520360,202207,6,2,4,2424,4848,7272
520380,202207,138,78,60,94536,72720,167256
520390,202207,239,106,133,128474.23,161196,289670.23
520393,202207,15,12,3,14544,3636,18180
520396,202207,76,54,22,65448,26664,92112
520400,202207,198,119,79,144230.41,95749.24,239979.65
520410,202207,194,97,97,117564.85,117564.2,235129.05
520420,202207,21,13,8,15756,9696,25452
520425,202207,247,125,122,151500.4,147864.4,299364.8
520430,202207,514,247,267,299364.56,323604.5,622969.06
520440,202207,632,450,182,545407.15,220586.02,765993.17
520450,202207,2133,909,1224,1101722.62,1484706.86,2586429.48
520455,202207,56,32,24,38785.28,29088,67873.28
520460,202207,41,25,16,30300.2,19392,49692.2
520465,202207,33,28,5,33936,6060,39996
520470,202207,439,276,163,334512.5,197556,532068.5
520480,202207,75,45,30,54540.8,36360,90900.8
520485,202207,111,45,66,54541.15,79992.1,134533.25
520490,202207,457,335,122,406024.89,147864.87,553889.76
520495,202207,158,94,64,113928.1,77568,191496.1
520500,202207,185,148,37,179377.25,46056,225433.25
520505,202207,201,114,87,138168,105444.6,243612.6
520510,202207,1924,914,1010,1107777.12,1224127.63,2331904.75
520520,202207,54,37,17,44844,20604,65448
520530,202207,199,161,38,195133.3,46056,241189.3
520540,202207,692,470,222,569645.22,269064.37,838709.59
520545,202207,140,79,61,95750.36,73932,169682.36
520547,202207,58,31,27,37572.2,32724,70296.2
520549,202207,1409,661,748,801143.79,909007.72,1710151.51
520551,202207,329,172,157,208465.3,190284.6,398749.9
520552,202207,35,25,10,30300.3,12120,42420.3
520570,202207,13,9,4,10908,4848,15756
520580,202207,266,164,102,198769.18,124836.36,323605.54
520590,202207,140,80,60,96960.32,72720.2,169680.52
520620,202207,1165,540,625,655697.66,758715.56,1414413.22
520630,202207,42,22,20,26664,24240,50904
520640,202207,375,223,152,270277.01,184224.39,454501.40
520650,202207,63,30,33,36360,39996,76356
520660,202207,39,21,18,25453.57,21816.38,47269.95
520670,202207,43,34,9,41208.6,10908,52116.6
520680,202207,28,19,9,23028,10908,33936
520690,202207,38,10,28,12120,33936.1,46056.1
520710,202207,33,28,5,33936,6060,39996
520725,202207,196,145,51,175742.21,61812.67,237554.88
520735,202207,58,39,19,47268.2,23028.2,70296.4
520740,202207,474,227,247,277550.87,299364.1,576914.97
520750,202207,32,23,9,27876,10908,38784
520753,202207,76,55,21,66660,25452,92112
520760,202207,100,64,36,77568.2,43632.1,121200.3
520780,202207,265,203,62,246037.83,75144.13,321181.96
520790,202207,146,90,56,111504,67872,179376
520800,202207,3375,1888,1487,2289508.96,1807106.69,4096615.65
520810,202207,139,106,33,128473.86,39996,168469.86
520815,202207,5,4,1,4848,1212,6060
520830,202207,140,93,47,112717.26,56965.82,169683.08
520840,202207,386,249,137,301789.33,166044,467833.33
520850,202207,104,58,46,70296.6,55752,126048.6
520860,202207,1778,1135,643,1375632.19,779319.54,2154951.73
520870,202207,31906,14612,17294,17716039.93,20976228.67,38692268.60
520880,202207,1222,649,573,786605,694485.52,1481090.52
520890,202207,821,512,309,620552.28,374509.15,995061.43
520910,202207,987,526,461,637521.73,558733.58,1196255.31
520915,202207,94,72,22,87267.36,26664,113931.36
520920,202207,444,211,233,255735.96,282399.26,538135.22
520929,202207,14,12,2,14544.8,2424,16968.8
520940,202207,61,44,17,53328.5,20604.1,73932.6
520945,202207,12,8,4,9696,4848,14544
520960,202207,40,24,16,29088,19392,48480
520970,202207,388,229,159,277550.39,192708.1,470258.49
520980,202207,92,66,26,79992,31512,111504
520990,202207,438,311,127,376934.75,153924,530858.75
520993,202207,124,65,59,78782.77,71508.3,150291.07
520995,202207,259,142,117,172105.96,143016,315121.96
521000,202207,1569,898,671,1088387.91,813257.18,1901645.09
521010,202207,628,329,299,398753.43,362390.82,761144.25
521015,202207,13,7,6,8484,7272,15756
521020,202207,1395,974,421,1180502.38,510256.18,1690758.56
521030,202207,58,40,18,48480.8,21816,70296.8
521040,202207,951,623,328,755084.14,397538.22,1152622.36
521056,202207,55,36,19,43632,23028,66660
521060,202207,121,77,44,93324.2,53328,146652.2
521080,202207,333,257,76,311495.99,93324.7,404820.69
521090,202207,567,378,189,458138.53,229068.69,687207.22
521100,202207,255,185,70,224220.2,84840.2,309060.4
521120,202207,1046,733,313,888408.7,379357.64,1267766.34
521130,202207,330,238,92,288458.82,111504.6,399963.42
521140,202207,194,110,84,133320.37,103020.88,236341.25
521150,202207,2531,1103,1428,1336854.5,1731962.31,3068816.81
521160,202207,24,10,14,12120,16968,29088
521170,202207,220,116,104,140592.71,126048,266640.71
521180,202207,1181,754,427,916282.22,517532.53,1433814.75
521190,202207,2565,1081,1484,1310189.04,1798614.83,3108803.87
521200,202207,57,39,18,47268,21816,69084
521205,202207,9,7,2,8484,2424,10908
521210,202207,121,77,44,93325.85,53328,146653.85
521220,202207,743,513,230,622525.03,278761.66,901286.69
521225,202207,24,17,7,20604.2,8484.2,29088.4
521230,202207,100,62,38,75144,46056.9,121200.9
521250,202207,6271,3493,2778,4233593.52,3370610.88,7604204.40
521260,202207,33,16,17,19392,20604,39996
521270,202207,129,97,32,117564,38784,156348
521280,202207,409,257,152,311484.81,184224,495708.81
521290,202207,29,17,12,20604.2,14544,35148.2
521295,202207,104,69,35,83628.26,42420,126048.26
521300,202207,225,124,101,150289.79,122412,272701.79
521305,202207,39,30,9,36360.31,10908,47268.31
521308,202207,1018,779,239,944162.98,289669.98,1233832.96
521310,202207,1333,751,582,910228.05,705392.47,1615620.52
521340,202207,21,16,5,19392,6060,25452
521350,202207,116,88,28,106656.66,33936,140592.66
521370,202207,158,109,49,132108,59388,191496
521375,202207,187,92,95,111506.09,116352.61,227858.70
521377,202207,49,39,10,47268,12120,59388
521380,202207,1050,631,419,764788.25,510256.92,1275045.17
521385,202207,12,6,6,7272,7272,14544
521390,202207,106,84,22,101808.1,26664,128472.1
521400,202207,370,263,107,318760.57,129684.8,448445.37
521405,202207,150,89,61,107869.04,73932.66,181801.70
521410,202207,75,55,20,66660.1,24240,90900.1
521440,202207,211,146,65,176954.99,78780.15,255735.14
521450,202207,774,426,348,516318.86,422989.04,939307.90
521460,202207,1096,741,355,898104.76,430260.86,1328365.62
521470,202207,12,8,4,9696,4848,14544
521480,202207,39,27,12,32724.17,14544.6,47268.77
521483,202207,331,211,120,255733.47,145440,401173.47
521486,202207,290,191,99,231492.93,119988.84,351481.77
521487,202207,23,11,12,13332,14544,27876
521490,202207,22,13,9,15756,10908,26664
521500,202207,134,59,75,71508.21,90900.79,162409.00
521520,202207,42,32,10,38784,12120,50904
521523,202207,961,547,414,662971.73,502980.13,1165951.86
521525,202207,52,37,15,44844,18180,63024
521530,202207,239,139,100,168468,121200,289668
521540,202207,39,20,19,24240,23028,47268
521550,202207,106,48,58,58176,70296.99,128472.99
521560,202207,863,575,288,696911.17,349058.13,1045969.30
521565,202207,68,49,19,59388.96,23028,82416.96
521570,202207,534,339,195,410873.31,236340.7,647214.01
521580,202207,51,33,18,39996,21816,61812
521590,202207,32,14,18,16968,21816,38784
521600,202207,27,12,15,14544,18180,32724
521630,202207,226,115,111,139384.22,134536.85,273921.07
521640,202207,296,156,140,189074.17,169680.1,358754.27
521645,202207,39,22,17,26664,20604,47268
521680,202207,247,151,96,183012.2,116352.4,299364.6
521690,202207,14,12,2,14544,2424,16968
521710,202207,1134,535,599,648425.27,725989.59,1374414.86
521720,202207,516,357,159,432686.53,192709.64,625396.17
521730,202207,670,321,349,389055.1,422988.74,812043.84
521740,202207,889,406,483,492076.73,587822.5,1079899.23
521760,202207,2260,1182,1078,1432688.73,1307765.49,2740454.22
521770,202207,813,507,306,614488.19,370873.1,985361.29
521800,202207,1965,1304,661,1584096.9,802344.61,2386441.51
521805,202207,37,20,17,24240,20604,44844
521810,202207,93,53,40,64236.8,48480.4,112717.2
521830,202207,972,701,271,849625.29,329669.82,1179295.11
521839,202207,72,42,30,50904,36360,87264
521850,202207,1134,566,568,686002.58,688421.86,1374424.44
521860,202207,331,208,123,252098.43,149076,401174.43
521870,202207,78,49,29,59388,35148,94536
521878,202207,34,14,20,16968,24240.12,41208.12
521880,202207,4824,2118,2706,2569477.95,3279695.91,5849173.86
521890,202207,591,404,187,489653.36,226644.31,716297.67
521900,202207,271,216,55,261793.2,66660,328453.2
521910,202207,176,121,55,146653.68,66660,213313.68
521920,202207,38,22,16,26664,19392,46056
521925,202207,48,29,19,35148,23028,58176
521930,202207,1174,661,513,802353.39,625395.27,1427748.66
521935,202207,31,21,10,25452.91,12120,37572.91
521940,202207,231,103,128,124836.64,155136,279972.64
521945,202207,16,13,3,15756,3636,19392
521950,202207,18,12,6,14544,7272,21816
521960,202207,65,49,16,59388,20604,79992
521970,202207,402,257,145,311487.37,175740.2,487227.57
521971,202207,111,56,55,67872,66660,134532
521973,202207,42,22,20,26665,24240,50905
521975,202207,1602,828,774,1004763.98,938100.61,1942864.59
521980,202207,240,160,80,193920.24,99384,293304.24
521990,202207,75,53,22,64236.65,26664,90900.65
522000,202207,285,190,95,229859.77,115140,344999.77
522005,202207,18,11,7,13332,8484,21816
522010,202207,1109,627,482,759936.4,585400,1345336.4
522015,202207,58,38,20,46056,24240,70296
522020,202207,897,535,362,648424.12,439957.94,1088382.06
522026,202207,23,16,7,19392,8484,27876
522028,202207,20,17,3,20604,3636,24240
522040,202207,801,342,459,414513.08,556313.47,970826.55
522045,202207,2611,1549,1062,1877428.47,1287152.43,3164580.90
522050,202207,162,75,87,90901.87,105444.72,196346.59
522060,202207,538,339,199,410869,242400.4,653269.4
522068,202207,107,80,27,96960.8,32724,129684.8
522070,202207,17,14,3,16968,3636,20604
522100,202207,38,25,13,30300,15756,46056
522108,202207,41,31,10,37572.93,12120.2,49693.13
522119,202207,55,32,23,38784,27876,66660
522130,202207,68,23,45,27876.2,54540.4,82416.6
522140,202207,4112,2161,1951,2619180.88,2364620.71,4983801.59
522145,202207,44,32,12,38784,14544,53328
522150,202207,100,69,31,83628.08,37572,121200.08
522155,202207,49,36,13,43632.2,15756,59388.2
522157,202207,13,9,4,10908,4848,15756
522160,202207,1653,988,665,1197473.94,805983.25,2003457.19
522170,202207,401,272,129,329666.01,156348.9,486014.91
522180,202207,32,12,20,14544,24240,38784
522185,202207,2372,1028,1344,1245953.96,1630166.23,2876120.19
522190,202207,72,42,30,50904.8,36360,87264.8
522200,202207,306,179,127,216948.3,153924.34,370872.64
522205,202207,146,100,46,121201.39,55752.7,176954.09
522220,202207,140,107,33,129684.6,39996,169680.6
522230,202207,33,30,3,36360,3636,39996
530010,202207,53815,27338,26477,33152835.18,32126871.72,65279706.90
110001,202208,526,427,99,518739.75,119988,638727.75
110002,202208,2873,1830,1043,2220403.72,1268973.65,3489377.37
110003,202208,82,64,18,77568.3,21816,99384.3
110004,202208,2075,1400,675,1699241.5,818105.09,2517346.59
110005,202208,439,343,96,415718.85,116353,532071.85
110006,202208,429,322,107,390266.86,129684.2,519951.06
110007,202208,76,61,15,73932.16,18180,92112.16
110008,202208,255,143,112,173316.97,135744.2,309061.17
110009,202208,944,714,230,865371.24,278760.4,1144131.64
110010,202208,1677,970,707,1175652.49,859310.2,2034962.69
110011,202208,1712,1322,390,1603502.77,472688.39,2076191.16
110012,202208,4125,2381,1744,2888219.89,2114951.79,5003171.68
110013,202208,726,569,157,689639.24,190285.84,879925.08
110014,202208,361,320,41,387841.89,49692,437533.89
110015,202208,1351,1050,301,1272611.44,364816.73,1637428.17
110018,202208,1037,642,395,778114.58,478740.59,1256855.17
110020,202208,16326,9133,7193,11074263.77,8721645.85,19795909.62
110025,202208,653,474,179,574491.29,216948.81,791440.10
110026,202208,37,24,13,29089.18,15756,44845.18
110028,202208,1617,1148,469,1391402.51,568436.04,1959838.55
110029,202208,122,110,12,133321.4,14544,147865.4
110030,202208,2416,1590,826,1931759.64,1002330.24,2934089.88
110032,202208,315,239,76,289674.81,92113.68,381788.49
110033,202208,656,472,184,572074.53,223010.96,795085.49
110034,202208,321,235,86,284820.68,104232.57,389053.25
110037,202208,85,77,8,93324.2,9696,103020.2
110040,202208,398,275,123,333300.6,149076,482376.6
110045,202208,938,669,269,812051.63,327241.58,1139293.21
110050,202208,89,77,12,93324.57,14544.33,107868.90
110060,202208,62,39,23,47268.95,27876,75144.95
110070,202208,110,72,38,87264.29,46056,133320.29
110080,202208,540,308,232,373299.21,281184.7,654483.91
110090,202208,29,23,6,27876.2,7272,35148.2
110092,202208,117,62,55,75145.62,66660,141805.62
110094,202208,200,136,64,164834.09,77568,242402.09
110100,202208,49,34,15,41208.8,18180.54,59389.34
110110,202208,118,68,50,82417.44,60600,143017.44
110120,202208,66,58,8,70296.83,9696.65,79993.48
110130,202208,267,214,53,259372.15,64236.2,323608.35
110140,202208,247,176,71,213313.36,86052.1,299365.46
110143,202208,58,46,12,55752.6,14544,70296.6
110145,202208,39,30,9,36360.79,10908,47268.79
110146,202208,25,12,13,14544,15756,30300
110147,202208,40,27,13,32724.73,15756,48480.73
110148,202208,34,27,7,32724.84,8484,41208.84
110149,202208,301,210,91,254520,110292,364812
110150,202208,140,107,33,129684.2,39996,169680.2
110155,202208,10,8,2,9696,2424,12120
110160,202208,67,52,15,63025.21,18180,81205.21
110170,202208,215,159,56,192708.59,67872,260580.59
110175,202208,67,52,15,63025.77,18180,81205.77
110180,202208,90,70,20,84840,24240,109080
120001,202208,209,152,57,184228.6,69084.9,253313.5
120005,202208,214,126,88,152713.76,106656.1,259369.86
120010,202208,1169,711,458,862951.31,555096.6,1418047.91
120013,202208,163,109,54,132108.15,65448.1,197556.25
120017,202208,119,67,52,81204.8,63024,144228.8
120020,202208,3431,2767,664,3354902.8,804781.7,4159684.5
120025,202208,575,317,258,384217.99,312701.76,696919.75
120030,202208,1133,971,162,1176910.33,196352.26,1373262.59
120032,202208,48,42,6,50907.15,7272,58179.15
120033,202208,227,197,30,238773.79,36360.55,275134.34
120034,202208,179,133,46,161884.14,55752,217636.14
120035,202208,46,39,7,47268.1,8484,55752.1
120038,202208,400,254,146,307854.72,176952.76,484807.48
120039,202208,31,29,2,35149.65,2424,37573.65
120040,202208,14565,9797,4768,11876515.1,5788851.22,17665366.32
120042,202208,50,46,4,55754.3,4848.55,60602.85
120043,202208,15,3,12,3636,14544,18180
120045,202208,534,343,191,415726.85,232706.35,648433.20
120050,202208,1281,980,301,1190242.42,366035.71,1556278.13
120060,202208,1491,1247,244,1511424.66,295734.64,1807159.30
120070,202208,407,293,114,355122.67,138168.09,493290.76
120080,202208,193,123,70,149078,84841.05,233919.05
130002,202208,161,115,46,139380,55752,195132
130006,202208,103,68,35,82416,42420,124836
130008,202208,130,74,56,89688,67872,157560
130010,202208,183,123,60,149078.82,72720.02,221798.84
130014,202208,293,207,86,251187.5,104232,355419.5
130020,202208,123,80,43,96960.6,52116,149076.6
130030,202208,954,535,419,648425.31,509042.42,1157467.73
130040,202208,396,190,206,230280.2,250884,481164.2
130050,202208,544,288,256,349057.18,310276.42,659333.60
130060,202208,854,578,276,700536.58,334512,1035048.58
130063,202208,621,383,238,464196.97,288456,752652.97
130068,202208,239,152,87,184229.62,105445.35,289674.97
130070,202208,1361,902,459,1093241.13,556311.11,1649552.24
130080,202208,669,444,225,538132.69,272701.6,810834.29
130083,202208,83,53,30,64236.2,36360.2,100596.4
130090,202208,317,179,138,216948.45,167256,384204.45
130100,202208,1278,625,653,757503.91,791438.7,1548942.61
130110,202208,777,352,425,426624.3,515100.91,941725.21
130115,202208,152,74,78,89688,94536,184224
130120,202208,1664,1034,630,1253217.72,763560.73,2016778.45
130130,202208,614,413,201,500556,243612,744168
130140,202208,1556,1197,359,1450770.81,435108,1885878.81
130150,202208,392,343,49,415716.8,59388,475104.8
130160,202208,444,268,176,324816.7,213312,538128.7
130165,202208,89,74,15,89690.03,18180,107870.03
130170,202208,1031,722,309,875004.62,375727.19,1250731.81
130180,202208,258,191,67,231492.66,82416.2,313908.86
130185,202208,2254,1081,1173,1312615.85,1422904.95,2735520.80
130190,202208,3338,2070,1268,2508869.09,1538039.22,4046908.31
130195,202208,284,224,60,271488,72720,344208
130200,202208,182,96,86,116352,104232,220584
130210,202208,93,46,47,55752,56964,112716
130220,202208,208,148,60,179376.74,73932,253308.74
130230,202208,361,241,120,292092,146652,438744
130240,202208,1349,866,483,1049595.8,586609.09,1636204.89
130250,202208,4796,3085,1711,3740279.11,2076175.48,5816454.59
130255,202208,418,214,204,259368.52,247248.2,506616.72
130260,202208,62458,28849,33609,34987344.83,40751885.27,75739230.10
130270,202208,1530,1040,490,1261805.75,593881.43,1855687.18
130280,202208,137,78,59,94536.2,71508,166044.2
130290,202208,2056,1337,719,1621677.23,871437.41,2493114.64
130300,202208,427,293,134,355118.58,162410.1,517528.68
130310,202208,898,469,429,568428.86,519948.9,1088377.76
130320,202208,548,295,253,358752.6,306636,665388.6
130330,202208,730,460,270,558738.34,327240.2,885978.54
130340,202208,3500,1915,1585,2321016.56,1921041,4242057.56
130350,202208,465,321,144,389052,174528,563580
130353,202208,942,424,518,513900.64,629033.13,1142933.77
130356,202208,800,359,441,436322.06,534493.99,970816.05
130360,202208,107,84,23,101808.3,27876,129684.3
130370,202208,686,532,154,644784,186648,831432
130380,202208,643,502,141,608424.8,170892,779316.8
130390,202208,456,370,86,448440.2,104232,552672.2
130395,202208,167,54,113,65448,136957.06,202405.06
130400,202208,103,82,21,99390.28,25452,124842.28
130406,202208,2173,1266,907,1534400.37,1099286.84,2633687.21
130410,202208,444,225,219,272700,266640,539340
130420,202208,2742,2216,526,2688275.51,637513.86,3325789.37
130423,202208,242,166,76,201200.97,92112,293312.97
130426,202208,190,103,87,124836,105444,230280
130430,202208,403,227,176,275124,213312,488436
130440,202208,201,69,132,83628.73,159985.7,243614.43
140002,202208,41,9,32,10908.2,38784.9,49693.1
140005,202208,230,137,93,166046.8,112717.35,278764.15
140010,202208,11771,7018,4753,8514525.21,5765582.15,14280107.36
140015,202208,162,69,93,83628.22,112716.28,196344.50
140017,202208,154,84,70,101813.16,84841.21,186654.37
140020,202208,443,293,150,356336.61,183014.52,539351.13
140023,202208,62,34,28,41208.2,33936,75144.2
140028,202208,25,13,12,15756.2,14544.72,30300.92
140030,202208,388,246,142,298158.61,172104.2,470262.81
140040,202208,68,46,22,55752.99,26664,82416.99
140045,202208,303,105,198,127260.2,241190.03,368450.23
140047,202208,536,342,194,414508.75,235128.99,649637.74
140050,202208,145,93,52,112719.19,63024,175743.19
140060,202208,80,52,28,63024.3,33936.39,96960.69
140070,202208,27,24,3,29088.2,3636,32724.2
150010,202208,5084,3035,2049,3678463.55,2485830.87,6164294.42
150013,202208,168,115,53,139380.2,64236.99,203617.19
150020,202208,1114,605,509,733266.63,616909.83,1350176.46
150030,202208,702,311,391,376939.43,473894.2,850833.63
150034,202208,213,126,87,152713.85,105444.3,258158.15
150040,202208,1673,948,725,1148999.07,878712.82,2027711.89
150050,202208,726,423,303,512680.07,367236.4,879916.47
150060,202208,4965,3084,1881,3737756.52,2283928.53,6021685.05
150070,202208,472,245,227,296943.15,275124.89,572068.04
150080,202208,17478,8063,9415,9776208.77,11423286.56,21199495.33
150085,202208,432,266,166,322397.95,201195.21,523593.16
150090,202208,692,563,129,683573.12,156348.1,839921.22
150095,202208,56,39,17,47269.84,20604.5,67874.34
150100,202208,74,44,30,53328,36360.6,89688.6
150110,202208,218,125,93,151500.5,112716,264216.5
150120,202208,404,288,116,350272.23,140592.4,490864.63
150125,202208,47,18,29,21816,35148,56964
150130,202208,2268,1114,1154,1351398.21,1398665.78,2750063.99
150140,202208,60709,26111,34598,31654510.79,41948001.05,73602511.84
150145,202208,258,141,117,170894.16,141804.3,312698.46
150150,202208,3520,1527,1993,1850762.53,2416760.05,4267522.58
150157,202208,375,271,104,328457.69,126048.82,454506.51
150160,202208,141,105,36,127260.32,43632,170892.32
150170,202208,3921,2820,1101,3417880.18,1334421.98,4752302.16
150172,202208,364,251,113,304213.39,136957.29,441170.68
150175,202208,84,49,35,59388.3,42420,101808.3
150178,202208,793,542,251,656914.9,304217.54,961132.44
150180,202208,3309,1615,1694,1958624.1,2053136.41,4011760.51
150190,202208,384,252,132,305425.53,159984.9,465410.43
150195,202208,122,66,56,79992.23,67872.36,147864.59
150200,202208,197,94,103,113928,124836.3,238764.3
150210,202208,3258,2525,733,3060350.73,888406.78,3948757.51
150215,202208,649,389,260,472687.43,316339.01,789026.44
150220,202208,3540,2334,1206,2830066.64,1462895.07,4292961.71
150230,202208,1375,1103,272,1336853.38,329665.77,1666519.15
150240,202208,7228,3972,3256,4815377.84,3946338.35,8761716.19
150250,202208,75,43,32,52116.1,38784,90900.1
150260,202208,118,83,35,100598.15,42420,143018.15
150270,202208,2145,1394,751,1690760.01,910219.96,2600979.97
150275,202208,535,340,195,412084.93,236341.44,648426.37
150276,202208,114,40,74,48480,89688,138168
150277,202208,864,384,480,465414.59,581769.04,1047183.63
150280,202208,342,233,109,282397.21,132108,414505.21
150285,202208,150,73,77,88476.77,93130.08,181606.85
150290,202208,1271,710,561,860534.92,679941.89,1540476.81
150293,202208,803,374,429,453297.72,519952.57,973250.29
150295,202208,582,278,304,336943.71,369662.58,706606.29
150300,202208,95,44,51,53328.1,61812.8,115140.9
150304,202208,195,114,81,138168.2,98172.75,236340.95
150307,202208,449,369,80,447234.69,96960.5,544195.19
150309,202208,607,426,181,516323.43,219376.25,735699.68
150310,202208,275,181,94,219373.3,113928,333301.3
150320,202208,1870,1281,589,1555011.07,713877.05,2268888.12
150330,202208,2100,1205,895,1460473.33,1084743.67,2545217.00
150340,202208,196,125,71,151500,86052,237552
150345,202208,636,346,290,420568.68,351480.02,772048.70
150350,202208,407,321,86,389069.1,104233.83,493302.93
150360,202208,4927,2888,2039,3500321.09,2472503.75,5972824.84
150370,202208,823,561,262,679943.97,317548.55,997492.52
150375,202208,191,81,110,98172,133320.18,231492.18
150380,202208,1545,1013,532,1227777.26,644790.13,1872567.39
150390,202208,904,511,393,619341.67,476320.99,1095662.66
150400,202208,109,91,18,110292.2,21816,132108.2
150405,202208,1653,1046,607,1267765.3,735686.06,2003451.36
150410,202208,104,64,40,77568,48480.2,126048.2
150420,202208,7855,4167,3688,5053157.69,4476007.51,9529165.20
150430,202208,663,412,251,499365.61,304216.5,803582.11
150440,202208,460,276,184,334517.7,223009.94,557527.64
150442,202208,2464,1296,1168,1571997.74,1416843.71,2988841.45
150445,202208,556,360,196,436323,237552.2,673875.2
150450,202208,224,127,97,153924,117564,271488
150460,202208,700,524,176,635099.9,213312.37,848412.27
150470,202208,1294,770,524,935678.78,636302.43,1571981.21
150475,202208,247,189,58,229073,70296.77,299369.77
150480,202208,1423,999,424,1210810.51,513894.12,1724704.63
150490,202208,612,362,250,438748.08,303000,741748.08
150495,202208,338,253,85,306636.25,103020,409656.25
150497,202208,284,183,101,221797.54,122412,344209.54
150500,202208,271,157,114,190286.21,138168.1,328454.31
150503,202208,1375,678,697,821751.39,844770.29,1666521.68
150506,202208,907,621,286,752659.64,346632.92,1099292.56
150510,202208,1352,737,615,893256.25,745383.08,1638639.33
150520,202208,325,220,105,266641.65,127260,393901.65
150530,202208,1976,1103,873,1338092.55,1058116.12,2396208.67
150540,202208,217,160,57,193920.9,69084.56,263005.46
150543,202208,897,461,436,558744.61,528440.94,1087185.55
150548,202208,446,321,125,389053.44,151500.83,540554.27
150549,202208,90,57,33,69085.83,39996,109081.83
150550,202208,3199,1593,1606,1931947.66,1947694.95,3879642.61
150553,202208,3662,2021,1641,2450709.36,1990138.49,4440847.85
150555,202208,149,80,69,96960.2,83628,180588.2
150560,202208,61,28,33,33936,39996,73932
150563,202208,128,64,64,77571.4,77568.66,155140.06
150565,202208,220,136,84,164832.4,101808,266640.4
150570,202208,412,270,142,327240,172104.1,499344.1
150580,202208,1729,843,886,1021721.96,1073832.8,2095554.76
150590,202208,858,561,297,679943.01,359966.88,1039909.89
150600,202208,521,313,208,379363.49,252101.55,631465.04
150610,202208,165,130,35,157560,42420,199980
150611,202208,137,86,51,104232,61812,166044
150613,202208,3454,1940,1514,2351331.2,1836268.37,4187599.57
150616,202208,584,321,263,389059,318757.74,707816.74
150618,202208,1416,725,691,878703.79,837494.03,1716197.82
150619,202208,403,304,99,368449.75,119990.07,488439.82
150620,202208,1263,718,545,871441.36,661754.15,1533195.51
150630,202208,164,106,58,128477.78,70297.16,198774.94
150635,202208,489,219,270,266643.48,328455.9,595099.38
150640,202208,46,22,24,26664.1,29088,55752.1
150650,202208,2502,1429,1073,1732794.02,1302926.22,3035720.24
150655,202208,274,199,75,241188.2,90900,332088.2
150658,202208,75,44,31,53328.2,37572,90900.2
150660,202208,592,382,210,462991.73,254521.21,717512.94
150670,202208,1166,418,748,506620.14,907796.86,1414417.00
150680,202208,11265,5883,5382,7136304.7,6526741.65,13663046.35
150690,202208,34,17,17,20604.7,20604,41208.7
150700,202208,543,355,188,430272.79,227858.35,658131.14
150710,202208,293,169,124,204829.79,150289.68,355119.47
150715,202208,842,525,317,636311.46,385417.47,1021728.93
150720,202208,423,324,99,392692.6,119988.73,512681.33
150730,202208,1128,530,598,642370.43,724782.53,1367152.96
150740,202208,251,157,94,190284.3,113928,304212.3
150745,202208,805,443,362,536924.98,438745.5,975670.48
150746,202208,70,36,34,43632,41208.1,84840.1
150747,202208,256,181,75,219374.43,90900.47,310274.90
150750,202208,130,71,59,86053.14,71509.87,157563.01
150760,202208,1866,1216,650,1473809.78,789017.12,2262826.90
150770,202208,403,230,173,278761.28,209676.2,488437.48
150775,202208,100,51,49,61812.4,59388.28,121200.68
150780,202208,211,123,88,149117.2,106656,255773.2
150790,202208,688,395,293,478745.18,355119.33,833864.51
150795,202208,1697,1031,666,1250797.36,807200.89,2057998.25
150796,202208,323,181,142,219372,172104.2,391476.2
150797,202208,401,184,217,225434.86,263005.04,488439.90
150800,202208,1644,902,742,1093231.2,899304.6,1992535.8
150803,202208,517,397,120,481168.71,146652.1,627820.81
150805,202208,211,124,87,150288.46,105445.4,255733.86
150808,202208,1081,550,531,666602.26,643575.58,1310177.84
150810,202208,3187,2140,1047,2593712.68,1268968.25,3862680.93
150812,202208,539,276,263,334513.84,318757.88,653271.72
150815,202208,1200,745,455,902944.42,551462.39,1454406.81
150820,202208,1613,958,655,1161128.09,796298.98,1957427.07
150830,202208,578,433,145,524806.39,175741.55,700547.94
150835,202208,254,148,106,179376.71,128472.74,307849.45
150840,202208,1475,850,625,1031426.27,757513.1,1788939.37
160005,202208,70,47,23,56964.63,27876.12,84840.75
160010,202208,202,125,77,151502.09,93324.37,244826.46
160015,202208,191,133,58,161203.74,70296.16,231499.90
160020,202208,140,72,68,87266.56,82416,169682.56
160021,202208,75,33,42,39998.53,50904.12,90902.65
160023,202208,70,40,30,48481.14,36360.44,84841.58
160025,202208,26,12,14,14544.52,16968.12,31512.64
160027,202208,1515,842,673,1020533.65,815680.87,1836214.52
160030,202208,17354,8854,8500,10732510.24,10311839.88,21044350.12
160040,202208,319,197,122,238767.5,149076.65,387844.15
160050,202208,755,355,400,430270.43,486020.65,916291.08
160053,202208,305,181,124,219376.66,150289.08,369665.74
160055,202208,23,15,8,18180.36,9696.47,27876.83
160060,202208,6857,3669,3188,4452991.29,3863910.04,8316901.33
160070,202208,193,111,82,134532.96,99385.19,233918.15
160080,202208,138,70,68,84841.21,82416.02,167257.23
170025,202208,28,15,13,18180,15756.2,33936.2
170030,202208,173,139,34,168471.32,41208,209679.32
170035,202208,202,97,105,117565.16,127261.86,244827.02
170040,202208,176,130,46,157560,55752,213312
170070,202208,325,205,120,248463.68,145441.45,393905.13
170100,202208,350,253,97,306643.72,117565.56,424209.28
170105,202208,41,36,5,43632.7,6060,49692.7
170110,202208,113,68,45,82416.79,54540.1,136956.89
170130,202208,79,39,40,47268,48480,95748
170190,202208,99,59,40,71508.98,48480,119988.98
170200,202208,338,232,106,281185.64,128472,409657.64
170210,202208,6682,3621,3061,4388414.35,3712384.45,8100798.80
170215,202208,177,92,85,111504.21,103021.63,214525.84
170220,202208,1335,963,372,1167169.56,450868.38,1618037.94
170230,202208,143,95,48,115140.86,58176.69,173317.55
170240,202208,505,343,162,416937.08,196345.3,613282.38
170255,202208,1003,798,205,967185.52,248460.4,1215645.92
170270,202208,44,31,13,37572,15756,53328
170290,202208,135,83,52,100597.88,63024,163621.88
170300,202208,112,72,40,87264.2,48480,135744.2
170305,202208,49,39,10,47268,12120,59388
170307,202208,58,44,14,53328.8,16968.9,70297.7
170310,202208,125,73,52,88476.26,63024,151500.26
170320,202208,32,19,13,23028.2,15756,38784.2
170330,202208,33,25,8,30300,9696.1,39996.1
170360,202208,32,18,14,21816.2,16968.66,38784.86
170370,202208,81,41,40,49692.82,48480,98172.82
170380,202208,79,60,19,72720,23028,95748
170382,202208,36,31,5,37572,6060,43632
170384,202208,143,110,33,133320.94,39996.2,173317.14
170386,202208,66,27,39,32724,47268,79992
170388,202208,47,20,27,24240,32724.96,56964.96
170389,202208,24,20,4,24240.4,4848,29088.4
170390,202208,71,42,29,50904,35148,86052
170410,202208,24,22,2,26664.2,2424,29088.2
170460,202208,15,9,6,10908.2,7272.23,18180.43
170510,202208,34,25,9,30300.3,10908,41208.3
170550,202208,1588,920,668,1115056.37,809623.17,1924679.54
170555,202208,106,78,28,94539.56,33936,128475.56
170560,202208,106,75,31,90900,37572.7,128472.7
170600,202208,41,13,28,15756.88,33936,49692.88
170610,202208,183,100,83,121203.08,100596.2,221799.28
170625,202208,33,20,13,24240,15756,39996
170650,202208,94,65,29,78780,35148.2,113928.2
170700,202208,575,423,152,512679.65,184224,696903.65
170710,202208,149,92,57,111506.81,69084.86,180591.67
170720,202208,110,83,27,100596.2,32724.2,133320.4
170730,202208,97,57,40,69084.2,48480,117564.2
170740,202208,81,57,24,69084.1,29088,98172.1
170755,202208,51,28,23,33938.21,27876.2,61814.41
170765,202208,129,74,55,89688.71,66660,156348.71
170770,202208,198,127,71,153924.2,86052.2,239976.4
170820,202208,597,389,208,471470.63,252098.29,723568.92
170825,202208,49,30,19,36360,23028,59388
170830,202208,92,71,21,87264.8,25452,112716.8
170900,202208,169,131,38,158773.75,46056,204829.75
170930,202208,987,546,441,661759.75,535710,1197469.75
170950,202208,3240,1529,1711,1853171.23,2074957.56,3928128.79
170980,202208,17,10,7,12120.8,8484,20604.8
171050,202208,144,109,35,132108,42420,174528
171070,202208,56,48,8,58176.57,9696.46,67873.03
171090,202208,47,35,12,42420,14544,56964
171110,202208,24,18,6,21817,7272,29089
171150,202208,42,26,16,31512,19392,50904
171180,202208,25,10,15,12120.2,18180.2,30300.4
171190,202208,181,102,79,123625.59,95748,219373.59
171195,202208,61,50,11,60601.13,13332,73933.13
171200,202208,34,15,19,18180,23028,41208
171215,202208,9,7,2,8484,2424,10908
171240,202208,63,46,17,55752,20604,76356
171245,202208,53,46,7,55753.5,8484.77,64238.27
171250,202208,79,46,33,55752.3,39996,95748.3
171270,202208,11,7,4,8484.6,4848.22,13332.82
171280,202208,44,36,8,43634.46,9696.1,53330.56
171320,202208,1040,602,438,729628.05,530857.41,1260485.46
171330,202208,435,218,217,264217.2,263004.1,527221.3
171360,202208,102,72,30,87264,36360,123624
171370,202208,44,26,18,31512,21816.1,53328.1
171380,202208,143,124,19,150289.72,23028,173317.72
171395,202208,43,25,18,30300,21816,52116
171420,202208,260,172,88,208465.99,106656.2,315122.19
171430,202208,72,59,13,71508.51,15756.05,87264.56
171488,202208,207,114,93,138168.14,112716,250884.14
171500,202208,60,32,28,38784,33936,72720
171510,202208,76,49,27,59388,32724,92112
171515,202208,38,31,7,37572.41,8484,46056.41
171525,202208,25,22,3,26664.2,3636,30300.2
171550,202208,15,9,6,10908.2,7272,18180.2
171570,202208,60,31,29,37572,35148.1,72720.1
171575,202208,263,177,86,214524.2,104232,318756.2
171610,202208,1873,958,915,1161110.41,1110205.82,2271316.23
171620,202208,142,97,45,117565,54540,172105
171630,202208,50,28,22,33936,26664,60600
171650,202208,341,231,110,279977.47,133320.6,413298.07
171660,202208,256,149,107,180590.84,129684,310274.84
171665,202208,93,56,37,67872.08,44844.94,112717.02
171670,202208,427,264,163,319970.18,197556,517526.18
171700,202208,63,54,9,65448,10908,76356
171720,202208,28,11,17,13332,20604.2,33936.2
171750,202208,102,48,54,58176.26,65448.73,123624.99
171780,202208,75,58,17,70296,20604,90900
171790,202208,91,71,20,86052,24240,110292
171800,202208,34,25,9,30300,10908,41208
171820,202208,2099,1212,887,1468958.19,1076261.64,2545219.83
171830,202208,33,25,8,30300.2,9696,39996.2
171840,202208,56,38,18,46056.96,21816,67872.96
171845,202208,32,20,12,24240.96,14544,38784.96
171850,202208,44,36,8,43632.4,9696,53328.4
171855,202208,73,53,20,64236,24240,88476
171865,202208,6,4,2,4848,2424,7272
171870,202208,34,22,12,26664,14544.45,41208.45
171875,202208,87,61,26,73932,31512,105444
171880,202208,44,27,17,32724.6,20604.1,53328.7
171884,202208,55,29,26,35148,31512,66660
171886,202208,136,60,76,72720.2,92112.2,164832.4
171888,202208,27,21,6,25452.17,7272,32724.17
171889,202208,12,6,6,7272,7272,14544
171890,202208,57,47,10,56964.52,12120,69084.52
171900,202208,28,19,9,23028.9,10908,33936.9
172000,202208,33,29,4,35148,4848,39996
172010,202208,53,41,12,49692,14544.86,64236.86
172015,202208,21,16,5,19392,6060,25452
172020,202208,139,86,53,104232.91,64236.1,168469.01
172025,202208,40,26,14,31512,16968,48480
172030,202208,53,33,20,39996.82,24240,64236.82
172049,202208,81,51,30,61813.03,36360.2,98173.23
172065,202208,108,70,38,84841.72,46056.46,130898.18
172080,202208,123,75,48,90900.24,58176.59,149076.83
172085,202208,31,16,15,19392,18180,37572
172090,202208,441,324,117,392692.69,141804.8,534497.49
172093,202208,18,16,2,19392,2424,21816
172097,202208,17,9,8,10908,9696,20604
172100,202208,5811,3325,2486,4031179.71,3014276.67,7045456.38
172110,202208,80,52,28,63024.2,33936,96960.2
172120,202208,1732,1441,291,1746539.67,352695.3,2099234.97
172125,202208,12,11,1,13332,1212,14544
172130,202208,27,17,10,20604,12120.7,32724.7
172208,202208,201,127,74,153924,89689.07,243613.07
172210,202208,354,182,172,220585.71,208465.2,429050.91
210005,202208,3040,1916,1124,2322248.46,1362310.78,3684559.24
210010,202208,145,95,50,115140.68,60600,175740.68
210015,202208,44,31,13,37572.39,15756,53328.39
210020,202208,374,216,158,261793.37,191496.82,453290.19
210030,202208,308,210,98,254526,118778.44,373304.44
210040,202208,128,103,25,124836.1,30300,155136.1
210043,202208,269,218,51,264220.64,61812,326032.64
210047,202208,482,300,182,363601.89,220584,584185.89
210050,202208,266,197,69,238764,83628.2,322392.2
210055,202208,53,43,10,52116.6,12120,64236.6
210060,202208,527,427,100,517532.06,121201.9,638733.96
210070,202208,451,342,109,414504,132108,546612
210080,202208,143,131,12,158773.4,14544,173317.4
210083,202208,289,144,145,174528.2,175740.34,350268.54
210087,202208,6,5,1,6060,1212,7272
210090,202208,434,307,127,372090.37,153925.81,526016.18
210095,202208,418,326,92,395113.83,111506.17,506620.00
210100,202208,692,549,143,665391.47,173316.4,838707.87
210110,202208,117,81,36,98172.79,43632,141804.79
210120,202208,4885,3889,996,4713599.61,1207160.37,5920759.98
210125,202208,183,114,69,138168.6,83628.89,221797.49
210130,202208,443,265,178,321183.25,215736.2,536919.45
210135,202208,27,20,7,24240.19,8484,32724.19
210140,202208,4463,3434,1029,4166935.92,1248370.17,5415306.09
210150,202208,365,229,136,277553.59,164834.9,442388.49
210160,202208,3214,2737,477,3317295.85,578129.09,3895424.94
210170,202208,1223,982,241,1190209.22,293304.2,1483513.42
210173,202208,129,118,11,143018,13332,156350
210177,202208,299,171,128,207253.79,155136,362389.79
210180,202208,30,16,14,19392.2,16968,36360.2
210190,202208,431,296,135,358752,163620.7,522372.7
210193,202208,7,5,2,6060,2424,8484
210197,202208,68,50,18,60600,21816.2,82416.2
210200,202208,588,502,86,608433.07,104232.1,712665.17
210203,202208,217,154,63,186650.59,76356.84,263007.43
210207,202208,346,286,60,346636.28,72720,419356.28
210210,202208,689,642,47,778111.51,56964.6,835076.11
210215,202208,75,67,8,81206.11,10908,92114.11
210220,202208,349,298,51,362393.54,61813.59,424207.13
210230,202208,307,249,58,301789.99,70296.51,372086.50
210232,202208,1225,878,347,1064149.03,420564.2,1484713.23
210235,202208,187,140,47,169681.2,56964.4,226645.6
210237,202208,44,23,21,27877.85,25452,53329.85
210240,202208,75,65,10,78780.21,12120,90900.21
210250,202208,174,150,24,181800.72,29088,210888.72
210255,202208,377,283,94,343000.67,113929.66,456930.33
210260,202208,379,263,116,318756.2,140592,459348.2
210270,202208,599,416,183,504195.33,221796,725991.33
210275,202208,94,73,21,88476.68,25452,113928.68
210280,202208,1070,702,368,850830.95,446016.6,1296847.55
210290,202208,512,347,165,420568.83,199980.9,620549.73
210300,202208,4849,3143,1706,3810566.67,2067676.6,5878243.27
210310,202208,117,78,39,94536.2,47268,141804.2
210312,202208,119,84,35,101808.65,42420,144228.65
210315,202208,114,97,17,117564.89,20604,138168.89
210317,202208,138,106,32,128472,39996,168468
210320,202208,2393,2050,343,2485849.11,415717,2901566.11
210325,202208,151,92,59,111505.15,71508.2,183013.35
210330,202208,4145,2434,1711,2952470.42,2073735.59,5026206.01
210340,202208,1200,923,277,1118695.8,335725.61,1454421.41
210350,202208,677,565,112,684782.26,135744,820526.26
210355,202208,144,123,21,149077.16,25452,174529.16
210360,202208,1998,1440,558,1745304.66,677509.7,2422814.36
210370,202208,1220,630,590,763566.6,716295.47,1479862.07
210375,202208,189,93,96,112721.84,116353.1,229074.94
210380,202208,724,565,159,684783.46,192709.94,877493.40
210390,202208,194,164,30,198769.74,36360,235129.74
210400,202208,391,342,49,414510.86,59388,473898.86
210405,202208,1067,763,304,924767.05,369661.98,1294429.03
210407,202208,70,57,13,69084,15756,84840
210408,202208,46,41,5,49692.64,6060,55752.64
210409,202208,328,287,41,347844.56,49692.2,397536.76
210410,202208,442,351,91,425412.9,110292,535704.9
210420,202208,199,163,36,197556.5,43632.7,241189.2
210430,202208,56,41,15,49692.5,18180,67872.5
210440,202208,376,256,120,310277.11,145440.2,455717.31
210450,202208,107,93,14,112718.4,16968,129686.4
210455,202208,243,130,113,157563.75,136956.99,294520.74
210460,202208,310,212,98,256947.78,118776.05,375723.83
210462,202208,69,59,10,71508.38,12120.62,83629.00
210465,202208,131,104,27,126048.26,32724,158772.26
210467,202208,535,406,129,492078.34,156348.92,648427.26
210470,202208,47,40,7,48480,8484,56964
210480,202208,1318,953,365,1155047.81,442384.24,1597432.05
210490,202208,181,128,53,155137.18,64236,219373.18
210500,202208,493,310,183,375726.28,221797.39,597523.67
210510,202208,520,427,93,517525.1,112717.8,630242.9
210515,202208,340,217,123,263004.78,149076.2,412080.98
210520,202208,395,358,37,436321.59,44844,481165.59
210530,202208,9706,4984,4722,6040733.39,5723179.26,11763912.65
210535,202208,124,94,30,113928.6,36360,150288.6
210540,202208,1497,1004,493,1216869.17,597518.41,1814387.58
210542,202208,1112,565,547,684792.82,662975.48,1347768.30
210545,202208,23,20,3,24240.2,3636,27876.2
210547,202208,126,110,16,133322.28,19392.31,152714.59
210550,202208,593,418,175,506626.18,212101.21,718727.39
210560,202208,159,137,22,166044.2,26664.2,192708.4
210565,202208,21,14,7,16968,8484.08,25452.08
210570,202208,1288,1084,204,1313821.36,247248.97,1561070.33
210580,202208,124,108,16,130896,19392,150288
210590,202208,700,583,117,707811.62,141804,849615.62
210592,202208,45,42,3,50904,3636,54540
210594,202208,114,100,14,121200.2,16968,138168.2
210596,202208,117,102,15,123624,18180,141804
210598,202208,139,107,32,129684.2,38784.6,168468.8
210600,202208,299,259,40,313911.78,48480.2,362391.98
210610,202208,245,225,20,272703.82,24240.13,296943.95
210620,202208,43,28,15,33936,18180,52116
210630,202208,80,75,5,90900.2,6060,96960.2
210632,202208,962,688,274,833857.45,332088.2,1165945.65
210635,202208,24,21,3,25452,3636,29088
210637,202208,122,89,33,107868.2,39996,147864.2
210640,202208,565,503,62,609636.62,75144,684780.62
210650,202208,393,334,59,404811.7,71508,476319.7
210660,202208,356,284,72,344217.68,87264.2,431481.88
210663,202208,59,47,12,56964,14544,71508
210667,202208,92,41,51,49692.56,61813,111505.56
210670,202208,251,222,29,269065.62,35148.6,304214.22
210675,202208,488,283,205,343003.72,248462.2,591465.92
210680,202208,222,140,82,169682.94,99384,269066.94
210690,202208,79,73,6,88476.58,7272,95748.58
210700,202208,158,118,40,143016.5,48480,191496.5
210710,202208,229,149,80,180589.93,96960.6,277550.53
210720,202208,128,115,13,139380,15756,155136
210725,202208,58,50,8,60602.97,9696,70298.97
210730,202208,23,17,6,20604,7272,27876
210735,202208,282,206,76,249672.38,92112,341784.38
210740,202208,515,448,67,544198.33,81204,625402.33
210745,202208,158,118,40,143016.5,48480.2,191496.7
210750,202208,2558,1350,1208,1637439.59,1466530.36,3103969.95
210760,202208,249,196,53,237552.93,64236,301788.93
210770,202208,245,199,46,241195.55,55753.39,296948.94
210780,202208,407,306,101,370880.2,122412.4,493292.6
210790,202208,185,159,26,192709.32,31512,224221.32
210800,202208,184,135,49,163626.58,59389.08,223015.66
210805,202208,60,53,7,64236,8484,72720
210810,202208,439,358,81,433903.27,98172,532075.27
210820,202208,1954,1641,313,1990142.08,379356.27,2369498.35
210825,202208,146,85,61,103020.82,73932.2,176953.02
210830,202208,689,480,209,581765.21,253308.4,835073.61
210840,202208,203,145,58,175740.2,70296,246036.2
210845,202208,225,175,50,212101.54,60600,272701.54
210850,202208,708,497,211,602375.21,255734.38,858109.59
210860,202208,3359,1995,1364,2417972.63,1653171.21,4071143.84
210870,202208,409,331,78,401182.63,94536.2,495718.83
210880,202208,79,62,17,75145.37,20604,95749.37
210890,202208,310,271,39,328455.17,47268,375723.17
210900,202208,676,437,239,529655.88,289670.58,819326.46
210905,202208,74,42,32,50904.2,38784,89688.2
210910,202208,2114,1586,528,1924678.02,639942.14,2564620.16
210920,202208,144,63,81,76356.9,98172,174528.9
210923,202208,78,63,15,76356.63,18180,94536.63
210927,202208,408,211,197,255734.77,238764.78,494499.55
210930,202208,72,60,12,72720,14544,87264
210940,202208,77,62,15,75144.89,18180,93324.89
210945,202208,204,118,86,143017.47,104232,247249.47
210950,202208,509,375,134,454500.43,162408.65,616909.08
210955,202208,91,57,34,69084,41208.2,110292.2
210960,202208,2313,1188,1125,1439863.36,1363501.2,2803364.56
210970,202208,106,91,15,110292.26,18180.9,128473.16
210975,202208,79,75,4,90900.2,4848.36,95748.56
210980,202208,1039,523,516,633881.91,625392.8,1259274.71
210990,202208,4368,3075,1293,3726954.97,1567129.39,5294084.36
211000,202208,1254,1029,225,1247162.6,272701.33,1519863.93
211003,202208,954,699,255,847195.01,309060.66,1156255.67
211010,202208,481,436,45,528434.16,54541.01,582975.17
211020,202208,1350,611,739,741752.97,895674.94,1637427.91
211023,202208,43,38,5,46056,6060,52116
211027,202208,80,60,20,72720,24240,96960
211030,202208,357,256,101,310273.91,122412,432685.91
211040,202208,280,235,45,284821.26,54540,339361.26
211050,202208,1105,763,342,924772.35,414506.49,1339278.84
211060,202208,605,536,69,649648.58,83628.4,733276.98
211065,202208,24,19,5,23029.13,6060.11,29089.24
211070,202208,825,695,130,844783.83,157560.6,1002344.43
211080,202208,83,80,3,96960.16,3636,100596.16
211085,202208,63,34,29,41208.11,35148,76356.11
211090,202208,74,63,11,76356.85,13332,89688.85
211100,202208,454,384,70,465415.48,84840.4,550255.88
211102,202208,223,160,63,193920.4,76356,270276.4
211105,202208,216,155,61,187860.4,73932.26,261792.66
211107,202208,127,81,46,98172.4,55752,153924.4
211110,202208,950,640,310,775691.67,375724.83,1151416.50
211120,202208,4987,2618,2369,3174317.58,2871257.94,6045575.52
211125,202208,20,13,7,15756,8484,24240
211130,202208,40501,19329,21172,23433309.97,25669170.9,49102480.87
211140,202208,384,338,46,409664.44,55752,465416.44
211150,202208,1170,823,347,997493.07,420566.32,1418059.39
211153,202208,163,98,65,119988,78780.2,198768.2
211157,202208,70,58,12,70296,14544,84840
211160,202208,676,573,103,694483.63,124836.2,819319.83
211163,202208,3,3,0,3636.2,,3636.2
211167,202208,12,11,1,13332,1212,14544
211170,202208,407,304,103,368448.18,126048,494496.18
211172,202208,112,80,32,96960.4,38784,135744.4
211174,202208,20,16,4,19392,4848.6,24240.6
211176,202208,454,329,125,398751.54,151501.14,550252.68
211178,202208,93,65,28,78780.2,33936,112716.2
211180,202208,217,175,42,212101.19,50904.04,263005.23
211190,202208,71,64,7,77568.2,8484,86052.2
211195,202208,33,22,11,26664.78,13332,39996.78
211200,202208,149,127,22,153924,26665.2,180589.2
211210,202208,392,299,93,362391.36,112716.18,475107.54
211220,202208,4260,2546,1714,3085827.04,2079830.5,5165657.54
211223,202208,118,110,8,133320.84,9696,143016.84
211227,202208,57,47,10,56964.2,12120,69084.2
211230,202208,705,582,123,705399.01,149077.6,854476.61
211240,202208,359,298,61,361178,73932,435110
211245,202208,179,97,82,117564.55,99384,216948.55
211250,202208,1467,1268,199,1536858.14,241189.44,1778047.58
211260,202208,775,664,111,804771.72,134532,939303.72
211270,202208,1828,1520,308,1842274.49,373296.54,2215571.03
211280,202208,1732,1180,552,1430174.35,669024.7,2099199.05
211285,202208,212,138,74,167256,89688,256944
211290,202208,757,524,233,635091.76,282396,917487.76
211300,202208,749,602,147,729634.07,178165.55,907799.62
211400,202208,1525,997,528,1208387.08,639937.36,1848324.44
220005,202208,17,16,1,19392,1212,20604
220010,202208,80,69,11,83628.62,13332,96960.62
220020,202208,718,591,127,718722.99,153924.6,872647.59
220025,202208,102,98,4,118777.56,4848,123625.56
220027,202208,51,42,9,50904,10908,61812
220030,202208,118,99,19,119989.09,23028,143017.09
220040,202208,1263,973,290,1180497.82,351482.66,1531980.48
220045,202208,31,22,9,26664.31,10908.4,37572.71
220050,202208,681,566,115,685998.35,140592.59,826590.94
220060,202208,175,153,22,185438.87,26664.35,212103.22
220070,202208,108,94,14,113930.51,16968.2,130898.71
220080,202208,13,11,2,13332,2424,15756
220090,202208,40,29,11,35148.82,13332,48480.82
220095,202208,2,2,0,2424,,2424.0
220100,202208,21,17,4,20604.2,4848,25452.2
220105,202208,29,26,3,31512.6,3636,35148.6
220110,202208,242,221,21,267852.1,25452,293304.1
220115,202208,45,39,6,47268,7272,54540
220117,202208,22,20,2,24240,2424,26664
220120,202208,1484,1147,337,1390173.73,408444.2,1798617.93
220130,202208,26,26,0,31512.13,,31512.13
220140,202208,90,72,18,87264.2,21817,109081.2
220150,202208,486,367,119,444811.92,144230.01,589041.93
220155,202208,17,16,1,19392,1212,20604
220157,202208,21,18,3,21816.2,3636,25452.2
220160,202208,109,94,15,113928,18180,132108
220170,202208,40,34,6,41208,7272,48480
220173,202208,11,8,3,9696,3636,13332
220177,202208,16,16,0,19392,,19392.0
220180,202208,63,61,2,75144.59,2424,77568.59
220190,202208,1106,957,149,1159892.82,180589.29,1340482.11
220191,202208,44,39,5,47270.16,6060,53330.16
220192,202208,89,83,6,100596,7272,107868
220194,202208,64,55,9,66660,10908,77568
220196,202208,82,68,14,82417.18,16968.2,99385.38
220198,202208,1,1,0,1212,,1212.0
220200,202208,404,339,65,410875.49,78780.74,489656.23
220202,202208,36,31,5,37572.2,6060,43632.2
220205,202208,63,54,9,65448,10908,76356
220207,202208,15,15,0,18180,,18180.0
220208,202208,76,48,28,58176.2,33936.2,92112.4
220209,202208,32,27,5,32724,6060,38784
220210,202208,20,16,4,19392,4848,24240
220211,202208,31,29,2,35149.58,2424,37573.58
220213,202208,30,27,3,32724.84,3636,36360.84
220217,202208,40,33,7,39996.2,8484,48480.2
220220,202208,2324,1537,787,1864072.09,953849.53,2817921.62
220225,202208,7,2,5,2424.8,6060,8484.8
220230,202208,983,748,235,906586.85,284824.48,1191411.33
220240,202208,163,143,20,173316.64,24240.32,197556.96
220245,202208,36,33,3,39997.05,3636,43633.05
220250,202208,136,116,20,140597.55,24240,164837.55
220253,202208,51,45,6,54540,7272,61812
220255,202208,44,37,7,44844,8484,53328
220260,202208,706,539,167,653273.1,202404.72,855677.82
220265,202208,8,7,1,8484,1212,9696
220270,202208,834,750,84,909006,101808,1010814
220271,202208,38,29,9,35148.3,10908,46056.3
220272,202208,14,14,0,16968,,16968.0
220273,202208,16,15,1,18180.2,1212,19392.2
220275,202208,63,53,10,64236,12120,76356
220277,202208,27,19,8,23028,9696.7,32724.7
220280,202208,17,11,6,13332,7272,20604
220285,202208,42,40,2,48480.2,2424,50904.2
220290,202208,1525,1302,223,1578046.79,270279.45,1848326.24
220300,202208,39,39,0,47268.6,,47268.6
220310,202208,331,280,51,339370.24,61813.66,401183.90
220320,202208,440,404,36,489660.42,43632.91,533293.33
220323,202208,4,2,2,2424.8,2424.2,4849.0
220325,202208,7,6,1,7272,1212,8484
220327,202208,14,14,0,16968,,16968.0
220330,202208,218,155,63,187861.4,77568,265429.4
220335,202208,134,114,20,138170.41,24240,162410.41
220340,202208,47,34,13,41208,15756,56964
220342,202208,55,46,9,55754.22,10908,66662.22
220345,202208,83,71,12,86052,14544.3,100596.3
220350,202208,455,396,59,479954.26,71508.35,551462.61
220360,202208,48,33,15,39996,18180,58176
220370,202208,1326,1107,219,1341700.91,265428.74,1607129.65
220375,202208,18,17,1,20604.6,1212,21816.6
220380,202208,26,18,8,21816.8,9696,31512.8
220385,202208,16,14,2,16968,2424.66,19392.66
220390,202208,2379,1315,1064,1593801.95,1290796.02,2884597.97
220400,202208,36,31,5,37572,6060,43632
220410,202208,22,21,1,25452,1212,26664
220415,202208,13,12,1,14545,1212,15757
220420,202208,124,104,20,126049.5,24240,150289.5
220430,202208,136,120,16,145440.4,19392,164832.4
220435,202208,23,18,5,21816.5,6060,27876.5
220440,202208,270,231,39,279978.94,47268,327246.94
220450,202208,350,172,178,208467.67,215738.91,424206.58
220455,202208,50,49,1,59388.26,1212,60600.26
220460,202208,24,21,3,25452.6,3636.19,29088.79
220465,202208,68,45,23,54540.2,27876.28,82416.48
220470,202208,231,202,29,244826.54,35148.01,279974.55
220480,202208,68,63,5,76356,6060,82416
220490,202208,85,73,12,88476,14544,103020
220500,202208,116,98,18,118776.2,21816,140592.2
220510,202208,361,282,79,341789.06,95748.88,437537.94
220515,202208,23,21,2,25452,2424,27876
220520,202208,373,328,45,397540,54540.79,452080.79
220525,202208,8,3,5,3636.29,6060,9696.29
220527,202208,16,13,3,15756,3636,19392
220530,202208,47,25,22,30300.65,26664.87,56965.52
220535,202208,7,6,1,7272.2,1212,8484.2
220540,202208,93,80,13,96960.86,15756,112716.86
220545,202208,24,16,8,19392.43,9696.1,29088.53
220550,202208,718,566,152,686000.86,184224.75,870225.61
220551,202208,11,9,2,10908,2424,13332
220552,202208,12,12,0,14544,,14544.0
220553,202208,53,48,5,58176.67,6060.2,64236.87
220554,202208,10,7,3,8484.2,3636,12120.2
220555,202208,42,35,7,42420.68,8484,50904.68
220556,202208,39,37,2,44844,2424,47268
220557,202208,59,52,7,63024.6,8484,71508.6
220558,202208,10,5,5,6060,6060,12120
220559,202208,5,5,0,6060.74,,6060.74
220560,202208,77,51,26,61812,31512,93324
220570,202208,716,445,271,539342.67,328453.41,867796.08
220580,202208,542,496,46,601173.75,55753,656926.75
220585,202208,15,13,2,15756.2,2424.2,18180.4
220590,202208,13,12,1,14544,1212,15756
220595,202208,77,58,19,70296.85,23028.1,93324.95
220600,202208,22,15,7,18180,8484,26664
220605,202208,29,25,4,30300,4848,35148
220610,202208,91,76,15,92112,18180.52,110292.52
220620,202208,551,467,84,566010.4,101808.84,667819.24
220630,202208,5,3,2,3636,2424,6060
220635,202208,32,29,3,35148.46,3636,38784.46
220640,202208,109,89,20,107868,24240,132108
220650,202208,114,108,6,130896,7272,138168
220660,202208,68,51,17,61813.1,20604.2,82417.3
220665,202208,8,8,0,9696,,9696.0
220667,202208,19,17,2,20604.19,2424,23028.19
220669,202208,33,28,5,33936.2,6060,39996.2
220670,202208,68,54,14,65448,16968,82416
220672,202208,83,60,23,72721.71,27876.8,100598.51
220675,202208,28,21,7,25452.67,8484,33936.67
220680,202208,57,49,8,59388,9696,69084
220690,202208,50,48,2,58176.57,3636,61812.57
220695,202208,26,15,11,18180.54,13332,31512.54
220700,202208,1821,1400,421,1696810.67,510254.07,2207064.74
220710,202208,9,7,2,8484,2424,10908
220720,202208,109,93,16,112716,19392,132108
220730,202208,21,20,1,24240,1212,25452
220735,202208,5,2,3,2424,3636,6060
220740,202208,50,44,6,53328,7272.66,60600.66
220750,202208,118,98,20,118776.4,24240.21,143016.61
220755,202208,16,16,0,19393.57,,19393.57
220760,202208,70,62,8,75144.6,9696,84840.6
220770,202208,5921,3374,2547,4090579.29,3087016.12,7177595.41
220775,202208,12,8,4,9696,4848.8,14544.8
220777,202208,20,19,1,23028,1212,24240
220779,202208,3,1,2,1212,2424,3636
220780,202208,915,776,139,940515.49,168468.88,1108984.37
220785,202208,4,1,3,1212,3636,4848
220790,202208,1202,961,241,1165957.34,293308.55,1459265.89
220793,202208,7,5,2,6060,2424,8484
220795,202208,19,18,1,21816.06,1212,23028.06
220800,202208,4074,3106,968,3764729.44,1173222.29,4937951.73
220810,202208,70,61,9,73932.99,10908,84840.99
220820,202208,248,224,24,271493.36,29089.8,300583.16
220830,202208,1281,1124,157,1362297.86,190284.86,1552582.72
220840,202208,2544,1784,760,2162232.49,923553.06,3085785.55
220850,202208,74,65,9,78780,10908,89688
220855,202208,9,5,4,6060,4848,10908
220860,202208,13,12,1,14544.82,1212,15756.82
220865,202208,28,25,3,30300,3636,33936
220870,202208,86,78,8,94536.4,9696,104232.4
220880,202208,331,271,60,328456.3,72721.35,401177.65
220885,202208,28,27,1,32725.04,1212,33937.04
220887,202208,6,5,1,6060.2,1212,7272.2
220890,202208,88,75,13,90900.99,15756,106656.99
220900,202208,26,14,12,16968,14544,31512
220910,202208,49,39,10,47268.85,12120,59388.85
220915,202208,9,8,1,9696,1212,10908
220920,202208,46,41,5,49693.06,6060,55753.06
220930,202208,50,48,2,58176,2424,60600
220935,202208,13,13,0,15756,,15756.0
220937,202208,35,30,5,36360.6,6060,42420.6
220940,202208,57,51,6,61812,7272,69084
220945,202208,5,4,1,4848.9,1212,6060.9
220950,202208,33,26,7,31512.2,8484,39996.2
220955,202208,15,15,0,18180.72,,18180.72
220960,202208,43,38,5,46057.93,6060,52117.93
220965,202208,46,42,4,50904,4848,55752
220970,202208,66,56,10,67872,12120,79992
220975,202208,11,10,1,12120.6,1212,13332.6
220980,202208,29,26,3,31512,3636,35148
220985,202208,52,45,7,54540,8484,63024
220987,202208,31,30,1,36362.71,1212.8,37575.51
220990,202208,22,22,0,26664,,26664.0
220995,202208,12,9,3,10908,3636,14544
220997,202208,61,54,7,65448.2,8484,73932.2
221000,202208,1252,1108,144,1342909.52,174529.02,1517438.54
221005,202208,44,41,3,49692.9,3636.57,53329.47
221010,202208,26,18,8,21816,9696,31512
221020,202208,38,34,4,41208.76,4848,46056.76
221030,202208,41,34,7,41112.25,8484,49596.25
221035,202208,22,21,1,25452.4,1212,26664.4
221037,202208,15,11,4,13332,4848,18180
221038,202208,26,23,3,27876,3636,31512
221039,202208,25,24,1,29088.18,1212.2,30300.38
221040,202208,265,228,37,277549.06,44844,322393.06
221050,202208,229,190,39,230283.81,47268.2,277552.01
221060,202208,1969,1690,279,2049518.65,338150.95,2387669.60
221062,202208,25,25,0,30300.31,,30300.31
221063,202208,19,14,5,16968,6060,23028
221065,202208,74,58,16,70296.47,19392,89688.47
221070,202208,147,129,18,156350.51,21816,178166.51
221080,202208,391,330,61,399964.69,73932,473896.69
221090,202208,22,17,5,20605.05,6060,26665.05
221093,202208,46,32,14,38784,16968,55752
221095,202208,4,4,0,4848,,4848.0
221097,202208,13,11,2,13332,2424,15756
221100,202208,26897,16065,10832,19478494.23,13129768.56,32608262.79
221110,202208,1145,874,271,1059302.01,328454.51,1387756.52
221120,202208,555,403,152,488441.24,185436,673877.24
221130,202208,1001,809,192,981729.27,232704.14,1214433.41
221135,202208,33,29,4,35148,4848,39996
221140,202208,49,42,7,50904.2,8484,59388.2
221150,202208,10,7,3,8484.18,3636,12120.18
221160,202208,12,12,0,14544.9,,14544.9
221170,202208,19,18,1,21816,1212,23028
230010,202208,160,139,21,168468.11,25452,193920.11
230015,202208,161,132,29,159984,35148,195132
230020,202208,1756,1421,335,1723479.14,406028.96,2129508.10
230030,202208,1678,1207,471,1462906.53,573281.05,2036187.58
230040,202208,226,180,46,218160,55752,273912
230050,202208,245,170,75,206040,90900.2,296940.2
230060,202208,172,138,34,167256.51,41209.3,208465.81
230070,202208,299,256,43,310274.54,52116,362390.54
230075,202208,914,759,155,921128.44,187861.55,1108989.99
230080,202208,220,182,38,220584.3,46056,266640.3
230090,202208,168,124,44,150288,53328,203616
230100,202208,2641,1469,1172,1780459.49,1420473.37,3200932.86
230110,202208,3028,1903,1125,2310109.48,1363513.85,3673623.33
230120,202208,1157,882,275,1068997.46,333300.87,1402298.33
230125,202208,170,134,36,162408.2,43632,206040.2
230130,202208,502,442,60,535709.31,72721.07,608430.38
230140,202208,217,177,40,214524.58,48480,263004.58
230150,202208,154,117,37,141804.2,44844.2,186648.4
230160,202208,1000,816,184,988995.39,223009.54,1212004.93
230170,202208,649,570,79,690854.33,95750.94,786605.27
230180,202208,73,65,8,78780.1,9696,88476.1
230185,202208,419,355,64,430263.55,77568.16,507831.71
230190,202208,2541,1929,612,2337985.27,741746.76,3079732.03
230195,202208,514,441,73,535713.66,88476,624189.66
230200,202208,450,344,106,416931.78,128472.2,545403.98
230205,202208,422,281,141,340572.2,170892.2,511464.4
230210,202208,1433,1094,339,1327152.08,410869.08,1738021.16
230220,202208,1640,1091,549,1322307.83,665394.31,1987702.14
230230,202208,1028,838,190,1016875.08,230281.63,1247156.71
230240,202208,1991,1723,268,2089508.71,324819.16,2414327.87
230250,202208,1836,1486,350,1801064.32,424206.28,2225270.60
230260,202208,3386,2069,1317,2512491.47,1596207.29,4108698.76
230270,202208,1406,1096,310,1328359.22,375722.44,1704081.66
230280,202208,2859,2160,699,2617955.7,848406.29,3466361.99
230290,202208,357,311,46,376938.42,55753.82,432692.24
230300,202208,521,379,142,459350.53,172104.1,631454.63
230310,202208,443,342,101,414504.86,122412,536916.86
230320,202208,961,809,152,980518.61,184224.2,1164742.81
230330,202208,320,254,66,307849.17,79992.6,387841.77
230340,202208,449,362,87,438747.85,106656,545403.85
230350,202208,3444,2109,1335,2556147.71,1618031.35,4174179.06
230360,202208,281,228,53,277549.52,64237.11,341786.63
230365,202208,128,102,26,123624.73,31512,155136.73
230370,202208,11539,5663,5876,6867354.44,7124256.86,13991611.30
230380,202208,511,435,76,527222.74,92112.85,619335.59
230390,202208,542,304,238,368451.21,288456.6,656907.81
230393,202208,232,189,43,229068.31,52116.5,281184.81
230395,202208,370,296,74,358755.5,89689.96,448445.46
230400,202208,653,516,137,625396.07,166044.4,791440.47
230410,202208,2833,1757,1076,2130724.84,1305340.14,3436064.98
230420,202208,6738,4455,2283,5400797.54,2767042.6,8167840.14
230423,202208,345,299,46,362390.59,55752.1,418142.69
230425,202208,501,399,102,483592.83,123625.78,607218.61
230426,202208,118,89,29,107868,35148,143016
230427,202208,72,66,6,81204.2,7272,88476.2
230428,202208,1730,857,873,1038695.05,1058080.26,2096775.31
230430,202208,471,379,92,459352.09,111505.25,570857.34
230435,202208,989,716,273,867796.37,332088.98,1199885.35
230440,202208,99391,45038,54353,54603837.07,65916656.62,120520493.69
230445,202208,330,225,105,272705.97,127260,399965.97
230450,202208,597,467,130,566004.78,157560.6,723565.38
230460,202208,105,76,29,92113.66,35148,127261.66
230465,202208,323,261,62,316334.86,75144,391478.86
230470,202208,2074,1613,461,1956182.04,558733.75,2514915.79
230480,202208,154,138,16,167256,19392.56,186648.56
230490,202208,340,267,73,323605.14,88476,412081.14
230495,202208,502,347,155,420571.58,187862.67,608434.25
230500,202208,1127,835,292,1012025.78,353905.19,1365930.97
230510,202208,67,44,23,53328,27876,81204
230520,202208,422,319,103,386629.43,124836.77,511466.20
230523,202208,2621,1603,1018,1944074.27,1233830.15,3177904.42
230526,202208,255,216,39,261793.26,47268,309061.26
230530,202208,703,509,194,616913.45,235130.17,852043.62
230533,202208,220,199,21,241189.85,25452.2,266642.05
230535,202208,417,316,101,382995.39,122412.35,505407.74
230540,202208,1834,1630,204,1975579.5,247249.49,2222828.99
230550,202208,4201,2664,1537,3230053.52,1862876.05,5092929.57
230560,202208,603,454,149,550253.7,180588.52,730842.22
230565,202208,224,165,59,201192,71508.2,272700.2
230570,202208,312,263,49,318756.6,59388.6,378145.2
230580,202208,1240,865,375,1048384.96,454504.03,1502888.99
230590,202208,1054,804,250,977994.19,303002.69,1280996.88
230600,202208,279,251,28,304214.59,33936,338150.59
230610,202208,465,345,120,418142.99,145440.2,563583.19
230620,202208,175,146,29,176953.68,35148,212101.68
230625,202208,853,572,281,693271.51,340572.3,1033843.81
230630,202208,1458,1092,366,1323515.91,444807.27,1768323.18
230640,202208,4080,3345,735,4054203.51,890836.92,4945040.43
230650,202208,501,424,77,513893.41,93324.57,607217.98
230655,202208,742,600,142,727211.03,172105.45,899316.48
230660,202208,358,297,61,359966.06,73933.14,433899.20
230670,202208,479,385,94,466631.05,113928.19,580559.24
230680,202208,216,188,28,227858.88,33936,261794.88
230690,202208,985,825,160,999912.99,193920.39,1193833.38
230700,202208,994,821,173,995061.67,209677.12,1204738.79
230710,202208,677,625,52,757512.62,63024.3,820536.92
230720,202208,146,124,22,151500,26664.2,178164.2
230725,202208,272,205,67,248461.92,81204.46,329666.38
230730,202208,13256,6990,6266,8474375.89,7599320.12,16073696.01
230740,202208,713,566,147,686010.03,178165.2,864175.23
230750,202208,848,700,148,848408.4,179376.56,1027784.96
230760,202208,1629,1379,250,1671377.75,303002.13,1974379.88
230763,202208,352,287,65,347846.39,78780.99,426627.38
230765,202208,8626,3988,4638,4834778.31,5625002.91,10459781.22
230770,202208,5228,2619,2609,3177927.04,3163340.66,6341267.70
230780,202208,799,692,107,839919.94,129685.18,969605.12
230790,202208,321,262,59,317544,71508,389052
230800,202208,1204,854,350,1035052.68,424200.6,1459253.28
230810,202208,1468,1278,190,1548963.84,230282.36,1779246.20
230820,202208,388,254,134,307848.8,162408.53,470257.33
230830,202208,990,829,161,1004757.17,195132.8,1199889.97
230835,202208,286,235,51,284822.07,61812.68,346634.75
230837,202208,183,146,37,176952.85,44844.5,221797.35
230840,202208,971,743,228,900519.82,276338.44,1176858.26
230850,202208,1433,1213,220,1471397.02,266643.57,1738040.59
230860,202208,326,248,78,300576.56,94542.06,395118.62
230870,202208,1921,1621,300,1965883.78,363601.57,2329485.35
230880,202208,81,64,17,77568.22,20604,98172.22
230890,202208,564,496,68,602367.97,82416.1,684784.07
230900,202208,311,232,79,281184.72,95748.88,376933.60
230910,202208,225,174,51,210888.45,61812,272700.45
230920,202208,508,393,115,477530.79,139380,616910.79
230930,202208,1103,763,340,924771.1,413295.06,1338066.16
230940,202208,864,655,209,793869.11,253309.35,1047178.46
230945,202208,568,452,116,547834.82,140596.95,688431.77
230950,202208,445,379,66,459353.84,79992.9,539346.74
230960,202208,2888,1902,986,2305271.58,1196268.77,3501540.35
230970,202208,1862,1008,854,1221720.24,1035057.11,2256777.35
230980,202208,213,164,49,199981.2,59388,259369.2
230990,202208,144,113,31,136956,37572,174528
231000,202208,209,191,18,231492.91,21816,253308.91
231010,202208,188,132,56,159986,67872.77,227858.77
231020,202208,1493,1005,488,1218087.5,591467.13,1809554.63
231025,202208,1165,802,363,972048.95,439963.21,1412012.16
231030,202208,1079,874,205,1059295.38,248461.45,1307756.83
231040,202208,176,120,56,145440.8,67872,213312.8
231050,202208,972,838,134,1015672.12,162413.75,1178085.87
231060,202208,164,135,29,163621.48,35148.48,198769.96
231070,202208,1548,1057,491,1282308.08,595095.8,1877403.88
231080,202208,271,239,32,289671.99,38784,328455.99
231085,202208,709,429,280,519955.37,339361.09,859316.46
231090,202208,271,216,55,261793.78,66661.64,328455.42
231095,202208,163,127,36,153924,43632.77,197556.77
231100,202208,180,143,37,173316.24,44844,218160.24
231110,202208,381,318,63,385420.32,76356,461776.32
231120,202208,262,219,43,265428.71,52117.02,317545.73
231123,202208,156,146,10,176953.15,12120,189073.15
231126,202208,339,255,84,309060.66,101808,410868.66
231130,202208,5060,3909,1151,4739007.18,1396240.14,6135247.32
231135,202208,219,193,26,233916.4,31512,265428.4
231140,202208,3142,2247,895,2725826.32,1084747.85,3810574.17
231150,202208,396,371,25,449654.7,30300,479954.7
231160,202208,1278,1039,239,1259280.57,289668.46,1548949.03
231170,202208,545,377,168,456924.82,203616,660540.82
231180,202208,1919,1661,258,2014373.14,312698.79,2327071.93
231190,202208,221,178,43,215736.1,52116,267852.1
231195,202208,237,194,43,235128,52116.6,287244.6
231200,202208,864,691,173,837502.85,209679.52,1047182.37
231210,202208,534,445,89,539346.56,107868.43,647214.99
231220,202208,1098,777,321,941736.4,389052.53,1330788.93
231230,202208,1573,1165,408,1411991.06,494496.49,1906487.55
231240,202208,1630,1103,527,1336849.08,641153.51,1978002.59
231250,202208,100,94,6,113928.17,7272,121200.17
231260,202208,263,174,89,210889.1,107868.37,318757.47
231270,202208,1016,779,237,944163.58,287246.01,1231409.59
231280,202208,78,59,19,71508,23028,94536
231290,202208,8280,4577,3703,5552255.97,4490515.93,10042771.90
231300,202208,604,550,54,667818.58,65448.54,733267.12
231310,202208,823,749,74,907795,89689.2,997484.2
231320,202208,611,454,157,550249.5,190284.68,740534.18
231325,202208,104,88,16,106656,19392,126048
231330,202208,1994,1505,489,1824089.24,592673.66,2416762.90
231335,202208,260,226,34,273913.31,41208,315121.31
231340,202208,1925,1326,599,1607129.61,725996.71,2333126.32
231350,202208,1412,1112,300,1347771.77,363612.4,1711384.17
231355,202208,421,345,76,418142.35,92112,510254.35
231360,202208,571,395,176,478744.78,213312.93,692057.71
231370,202208,101,84,17,101808,20604,122412
231375,202208,306,225,81,272700.9,98172.47,370873.37
231380,202208,521,412,109,499345.47,132108,631453.47
231390,202208,204,157,47,190284.29,56964,247248.29
231395,202208,789,475,314,575700.53,380568.5,956269.03
231400,202208,1217,1006,211,1219323.45,255736.54,1475059.99
231410,202208,1410,1144,266,1386543.69,323605.85,1710149.54
240010,202208,384,166,218,201196.91,264222.65,465419.56
240020,202208,2350,1913,437,2319817.04,529651.14,2849468.18
240030,202208,117,93,24,112718.43,29088,141806.43
240040,202208,32,31,1,37572,1212,38784
240050,202208,527,453,74,549051,89688.1,638739.1
240060,202208,75,69,6,83628.3,7272,90900.3
240070,202208,265,200,65,242400.78,78780.38,321181.16
240080,202208,583,391,192,475117.82,232707.62,707825.44
240090,202208,102,91,11,110292.7,13332,123624.7
240100,202208,1550,1453,97,1761060.15,117565.07,1878625.22
240110,202208,1062,703,359,852061.14,435126.26,1287187.40
240120,202208,151,111,40,134533.14,48480.88,183014.02
240130,202208,278,253,25,306643.51,30300.6,336944.11
240140,202208,85,56,29,69085.99,35148.64,104234.63
240145,202208,736,646,90,782963.9,109080.1,892044.0
240150,202208,29,20,9,24240,10908,35148
240160,202208,39,31,8,37572,9696,47268
240165,202208,44,36,8,43633.5,9696,53329.5
240170,202208,147,101,46,122413.7,55752.1,178165.8
240180,202208,116,86,30,104234.27,36360,140594.27
240185,202208,56,48,8,58177.29,9696,67873.29
240190,202208,14,12,2,14544.43,2424,16968.43
240200,202208,3177,1706,1471,2071331.78,1785287.79,3856619.57
240210,202208,164,125,39,151500,47268,198768
240220,202208,1157,798,359,967206.68,435110.71,1402317.39
240230,202208,834,756,78,916298.91,94537.51,1010836.42
240240,202208,79,53,26,64236,31512.2,95748.2
240250,202208,101,86,15,104233.82,18180,122413.82
240260,202208,1907,1339,568,1622889.55,689635.46,2312525.01
240270,202208,173,148,25,179377.6,30300,209677.6
240280,202208,67,54,13,65449.5,15756,81205.5
240290,202208,43,41,2,49692,2424,52116
240300,202208,170,92,78,111504.4,94536,206040.4
240310,202208,2564,1358,1206,1645932.64,1462903.16,3108835.80
240320,202208,177,162,15,196344,18180,214524
240325,202208,4963,2817,2146,3416713.5,2604635.09,6021348.59
240330,202208,77,73,4,88476,4848,93324
240340,202208,96,65,31,78780.6,37572.15,116352.75
240350,202208,93,74,19,89688.2,23028,112716.2
240360,202208,682,425,257,516325.03,311490.64,827815.67
240370,202208,63,55,8,66660.27,9696,76356.27
240375,202208,55,35,20,42420.2,24240.2,66660.4
240380,202208,212,172,40,208468.64,48480.7,256949.34
240390,202208,15,13,2,15756,2424,18180
240400,202208,88,78,10,94536.3,12120.76,106657.06
240410,202208,12,8,4,9696,4848,14544
240420,202208,1128,802,326,972046.38,395116.83,1367163.21
240430,202208,262,238,24,288461.93,29089.52,317551.45
240440,202208,144,77,67,93325.56,81204.87,174530.43
240450,202208,260,158,102,192712.05,123626.26,316338.31
240460,202208,82,63,19,76356,23028,99384
240470,202208,218,195,23,236345.99,27876.99,264222.98
240480,202208,17,14,3,16968,3636,20604
240485,202208,82,64,18,77568.8,21816,99384.8
240490,202208,61,54,7,65448,8484,73932
240500,202208,102,75,27,90900,32724,123624
240510,202208,39,29,10,35148.6,12120,47268.6
240520,202208,99,94,5,113928.5,6060.04,119988.54
240530,202208,63,52,11,63024.54,13332,76356.54
240540,202208,95,82,13,99384.1,15756.15,115140.25
240550,202208,12,10,2,12120,2424,14544
240560,202208,398,279,119,338152.91,144228,482380.91
240570,202208,434,271,163,329666.39,197556.87,527223.26
240580,202208,1349,1015,334,1231409.26,404809.2,1636218.46
240590,202208,30,29,1,35148.16,1212,36360.16
240600,202208,98,92,6,111505.7,7272,118777.7
240610,202208,510,416,94,504200.02,113929.8,618129.82
240615,202208,11,10,1,12120,1212,13332
240620,202208,86,82,4,99385.39,4848,104233.39
240630,202208,42,35,7,42420,8484.6,50904.6
240640,202208,35,27,8,32724,9696,42420
240650,202208,242,192,50,232705.18,60600.3,293305.48
240660,202208,112,95,17,115140.2,20604.2,135744.4
240670,202208,309,167,142,202411.09,172107.02,374518.11
240680,202208,54,41,13,49692,15756.1,65448.1
240690,202208,50,48,2,58176.8,2424,60600.8
240700,202208,174,141,33,170892,39996.2,210888.2
240710,202208,2249,1338,911,1621691.86,1106570.4,2728262.26
240720,202208,1084,763,321,924772.26,389055.52,1313827.78
240725,202208,72,65,7,78780.42,8484,87264.42
240730,202208,151,128,23,155136.66,27876,183012.66
240740,202208,228,192,36,232708.41,43632.2,276340.61
240750,202208,51,31,20,37572,24240,61812
240760,202208,57,45,12,54540,14544.7,69084.7
240770,202208,147,114,33,138168.98,39996.19,178165.17
240780,202208,727,599,128,727212.25,155137.71,882349.96
240790,202208,40,38,2,46056.71,2424,48480.71
240800,202208,9875,6638,3237,8047961.34,3924568.38,11972529.72
240810,202208,21991,11585,10406,14051132.95,12619561.85,26670694.80
240820,202208,265,153,112,185439.63,135745.6,321185.23
240830,202208,1621,1333,288,1615630.04,349059.15,1964689.19
240840,202208,74,63,11,76356.8,13332,89688.8
240850,202208,88,77,11,93324,13332,106656
240860,202208,108,103,5,124837.38,6060,130897.38
240870,202208,58,46,12,55753,14544,70297
240880,202208,31,27,4,32724,4848.2,37572.2
240890,202208,1196,661,535,801147.32,648425.19,1449572.51
240895,202208,63,51,12,61813.36,14544,76357.36
240910,202208,172,145,27,175740.43,32724,208464.43
240920,202208,12,11,1,13332.84,1212,14544.84
240930,202208,423,374,49,453299.26,59389.98,512689.24
240933,202208,63,39,24,47268.95,29088,76356.95
240940,202208,2330,2041,289,2473724.75,350272.39,2823997.14
240950,202208,42,37,5,44844,6060,50904
240960,202208,24,20,4,24240,4848.2,29088.2
240970,202208,105,75,30,90900,36360,127260
240980,202208,207,161,46,195132.96,55752.7,250885.66
240990,202208,141,88,53,106656.03,64236,170892.03
241000,202208,61,55,6,66660.3,7272,73932.3
241010,202208,91,69,22,83628.3,26664,110292.3
241020,202208,108,98,10,118776.6,12120.81,130897.41
241025,202208,20,12,8,14544.17,9696.5,24240.67
241030,202208,105,84,21,101808,25452,127260
241040,202208,42,33,9,39996.1,10908,50904.1
241050,202208,75,69,6,83628,7272,90900
241060,202208,25,21,4,25452,4848,30300
241070,202208,22,22,0,26664.58,,26664.58
241080,202208,60,53,7,64236.2,8484,72720.2
241090,202208,54,38,16,47270.36,19392,66662.36
241100,202208,78,67,11,81204,13332.22,94536.22
241105,202208,21,10,11,12120.5,13332.2,25452.7
241110,202208,49,40,9,48480.15,10908,59388.15
241120,202208,1667,1258,409,1525926.53,495711.9,2021638.43
241140,202208,205,170,35,207253.2,42420,249673.2
241142,202208,49,36,13,43632,15756.45,59388.45
241150,202208,1191,1029,162,1247179.51,196344.98,1443524.49
241160,202208,23,17,6,20604,7272,27876
241170,202208,48,41,7,49692,8484,58176
241180,202208,44,32,12,38784,14544,53328
241190,202208,39,36,3,43633.27,3636,47269.27
241200,202208,4584,2385,2199,2891902.96,2666463.12,5558366.08
241210,202208,72,60,12,72720.25,14544,87264.25
241220,202208,1540,980,560,1187783.02,678731.35,1866514.37
241230,202208,247,203,44,246036.65,53328,299364.65
241240,202208,52,38,14,46056,16968,63024
241250,202208,1168,1063,105,1289586.78,127260.91,1416847.69
241255,202208,63,51,12,61813.94,14544,76357.94
241260,202208,722,549,173,665395.62,209677.67,875073.29
241270,202208,72,50,22,60600.6,26664,87264.6
241280,202208,98,85,13,103020.2,15756,118776.2
241290,202208,142,105,37,127260.33,44844.34,172104.67
241300,202208,82,57,25,69084,30300.5,99384.5
241310,202208,49,34,15,41208.8,18180,59388.8
241320,202208,36,17,19,20604.3,23028,43632.3
241330,202208,56,49,7,59389,8484,67873
241335,202208,93,82,11,99384.85,13332,112716.85
241340,202208,184,133,51,162408,61812,224220
241350,202208,63,52,11,63024.36,13332,76356.36
241355,202208,53,43,10,52116.72,12120,64236.72
241360,202208,53,50,3,60600,3636,64236
241370,202208,62,50,12,60600,14544,75144
241380,202208,36,32,4,38784.4,4848,43632.4
241390,202208,85,65,20,78780,24240,103020
241400,202208,220,167,53,203282.7,64236,267518.7
241410,202208,183,163,20,197556.95,24240.09,221797.04
241415,202208,102,81,21,98172,25452.8,123624.8
241420,202208,129,89,40,107869.33,48480,156349.33
241430,202208,19,17,2,20604,2424,23028
241440,202208,523,439,84,532078.61,101809.65,633888.26
241445,202208,42,36,6,43632,7272.1,50904.1
241450,202208,264,220,44,266645.1,53329.24,319974.34
241460,202208,164,148,16,179377.53,19392,198769.53
241470,202208,33,27,6,32725.2,7272.4,39997.6
241475,202208,52,47,5,56964.15,6060,63024.15
241480,202208,137,99,38,119989.32,46056.2,166045.52
241490,202208,13,11,2,13332,2424.1,15756.1
241500,202208,47,36,11,43632.84,13332.02,56964.86
250010,202208,101,84,17,101808.6,20604,122412.6
250020,202208,32,27,5,32724,6060,38784
250030,202208,893,652,241,790237.22,293307.06,1083544.28
250040,202208,400,319,81,386632.41,98172,484804.41
250050,202208,283,230,53,278761.09,64236,342997.09
250053,202208,60,47,13,56964.2,15756,72720.2
250057,202208,4,3,1,3636.2,1212,4848.2
250060,202208,627,451,176,546620.1,213313.19,759933.29
250070,202208,674,538,136,652068.52,164832.84,816901.36
250073,202208,9,8,1,9696.88,1212.01,10908.89
250077,202208,182,135,47,163621.72,56964.6,220586.32
250080,202208,416,328,88,397541.15,106657.7,504198.85
250090,202208,222,143,79,173316.01,95748,269064.01
250100,202208,574,463,111,561158.94,135745.8,696904.74
250110,202208,679,490,189,593885.29,229069.42,822954.71
250115,202208,14,4,10,4848,12120.26,16968.26
250120,202208,123,85,38,103020.8,46056.35,149077.15
250130,202208,564,460,104,557529.53,126050.27,683579.80
250135,202208,29,13,16,15756,19392,35148
250140,202208,85,73,12,88476.12,14544,103020.12
250150,202208,633,443,190,538133.97,230280.85,768414.82
250153,202208,13,11,2,13332,2424,15756
250157,202208,33,26,7,31512,8484,39996
250160,202208,242,183,59,221798.31,71508,293306.31
250170,202208,84,55,29,66660,35148,101808
250180,202208,4801,3266,1535,3958504.52,1864100.93,5822605.45
250190,202208,819,545,274,660547.38,332090.16,992637.54
250200,202208,71,56,15,67872,18180,86052
250205,202208,25,20,5,24240,6060,30300
250210,202208,87,74,13,89688.18,15756,105444.18
250215,202208,81,56,25,67872,30300,98172
250220,202208,28,20,8,24240.1,9696,33936.1
250230,202208,76,69,7,83628.6,8484,92112.6
250240,202208,245,186,59,225434.48,71508,296942.48
250250,202208,384,329,55,398752.63,66660,465412.63
250260,202208,47,37,10,44844,12120,56964
250270,202208,79,55,24,66660,29088,95748
250280,202208,386,315,71,381781.79,86052.2,467833.99
250290,202208,100,89,11,107868,13332,121200
250300,202208,538,363,175,439961.78,213312.37,653274.15
250310,202208,46,43,3,52116,3636,55752
250320,202208,2039,1344,695,1628967.7,842355.22,2471322.92
250330,202208,116,98,18,118777.17,21816.1,140593.27
250340,202208,33,26,7,31512.51,8484,39996.51
250350,202208,200,128,72,155136.2,87264,242400.2
250355,202208,34,26,8,31512,9696,41208
250360,202208,187,154,33,186650.97,39996.97,226647.94
250370,202208,2405,1541,864,1867723.15,1048392.13,2916115.28
250375,202208,16,10,6,12120,7272.79,19392.79
250380,202208,57,48,9,58176.12,10908.25,69084.37
250390,202208,46,36,10,43632.16,12120,55752.16
250400,202208,17154,8577,8577,10399123.83,10403954.99,20803078.82
250403,202208,306,234,72,283609.39,87264,370873.39
250407,202208,68,55,13,66660,15756.85,82416.85
250410,202208,31,26,5,31512.31,6060.8,37573.11
250415,202208,44,26,18,31512,21816,53328
250420,202208,40,34,6,41208,7272,48480
250430,202208,1482,1282,200,1554099.23,243613.11,1797712.34
250435,202208,33,25,8,30300.55,9696,39996.55
250440,202208,667,551,116,667815.44,140592,808407.44
250450,202208,82,62,20,75145.58,24240,99385.58
250460,202208,471,303,168,367238.63,203618.04,570856.67
250470,202208,103,71,32,86052,38784.6,124836.6
250480,202208,329,258,71,312701.78,86052,398753.78
250485,202208,6,6,0,7272,,7272.0
250490,202208,247,198,49,239979.49,59388.97,299368.46
250500,202208,97,75,22,90900.55,26664,117564.55
250510,202208,816,642,174,778107.41,210888.74,988996.15
250520,202208,171,113,58,136956,70296,207252
250523,202208,123,99,24,119988,29088,149076
250527,202208,117,87,30,105444.53,36360,141804.53
250530,202208,8,4,4,4848,4848,9696
250535,202208,30,23,7,27876,8484,36360
250540,202208,148,115,33,139380.92,39996,179376.92
250550,202208,70,68,2,82416.13,2424,84840.13
250560,202208,68,41,27,49692.4,32724,82416.4
250570,202208,164,132,32,159984.8,38784.74,198769.54
250580,202208,97,75,22,90978,26664,117642
250590,202208,24,13,11,15756,13332.6,29088.6
250600,202208,1579,1031,548,1249585.01,664177.92,1913762.93
250610,202208,159,127,32,153928.69,38784.5,192713.19
250620,202208,21,17,4,20604.1,4848,25452.1
250625,202208,69,54,15,65448.43,18180,83628.43
250630,202208,3169,1968,1201,2385490.38,1455629.14,3841119.52
250640,202208,199,156,43,189075.52,52117.32,241192.84
250650,202208,30,19,11,23028,13332.05,36360.05
250660,202208,62,46,16,55752,19392,75144
250670,202208,76,59,17,71508,20604.94,92112.94
250680,202208,425,339,86,410873.48,104232.25,515105.73
250690,202208,2208,1483,725,1797423.72,878708.84,2676132.56
250700,202208,916,777,139,941729.48,168468.2,1110197.68
250710,202208,482,375,107,454513.13,129686.52,584199.65
250720,202208,121,88,33,106656.3,39996,146652.3
250730,202208,414,339,75,410870.56,90901.1,501771.66
250740,202208,66,61,5,73932.48,6060,79992.48
250750,202208,24495,14340,10155,17387659.82,12320226.08,29707885.90
250760,202208,116,93,23,112716.4,27876,140592.4
250770,202208,363,239,124,289671.63,150288.7,439960.33
250780,202208,70,47,23,56964,27876,84840
250790,202208,466,282,184,341789.37,223010.62,564799.99
250800,202208,147,133,14,161196,16968,178164
250810,202208,74,61,13,73932,15756,89688
250820,202208,152,125,27,151500.93,32724.7,184225.63
250830,202208,479,309,170,374511.28,206041.4,580552.68
250840,202208,57,48,9,58176.17,10908.2,69084.37
250850,202208,62,53,9,64236,10908,75144
250855,202208,16,14,2,16968.62,2424,19392.62
250860,202208,250,158,92,191496.3,111504.8,303001.1
250870,202208,30,27,3,32724.8,3636,36360.8
250880,202208,92,69,23,83628.22,27876,111504.22
250890,202208,3202,2348,854,2845825.39,1036268.21,3882093.60
250900,202208,64,53,11,64236.4,13332,77568.4
250905,202208,132,99,33,119989.33,39996,159985.33
250910,202208,1010,732,278,887195.88,338150.07,1225345.95
250915,202208,114,76,38,92112.07,46057.2,138169.27
250920,202208,145,106,39,128472,47269.74,175741.74
250930,202208,196,109,87,132108.4,105444.2,237552.6
250933,202208,10,6,4,7272,4848,12120
250937,202208,16,16,0,19392,,19392.0
250939,202208,39,29,10,35148.2,12120,47268.2
250940,202208,124,90,34,109081.74,41208.28,150290.02
250950,202208,82,58,24,70297.6,29088,99385.6
250960,202208,88,49,39,59389.31,47268.3,106657.61
250970,202208,1283,902,381,1093236.52,461776.51,1555013.03
250980,202208,104,71,33,86052.41,39996,126048.41
250990,202208,171,129,42,156348,50904,207252
251000,202208,79,67,12,81204,14544,95748
251010,202208,134,94,40,113928,48480,162408
251020,202208,83,68,15,82416.68,18180,100596.68
251030,202208,49,34,15,41208,18180,59388
251040,202208,62,41,21,49692,25452,75144
251050,202208,26,21,5,25452,6060,31512
251060,202208,51,40,11,48480.68,13332,61812.68
251065,202208,6,3,3,3636,3636,7272
251070,202208,18,15,3,18180,3636,21816
251080,202208,5515,2547,2968,3088272.25,3600902.55,6689174.80
251090,202208,190,159,31,192708.7,37572.68,230281.38
251100,202208,23,22,1,26664.2,1212,27876.2
251110,202208,64,42,22,50904,26664,77568
251120,202208,1971,1204,767,1459294.77,930830.75,2390125.52
251130,202208,443,362,81,438747.03,98172.05,536919.08
251140,202208,607,390,217,472682.22,264217.47,736899.69
251150,202208,343,283,60,344211.07,72721.23,416932.30
251160,202208,97,78,19,94536.1,23028,117564.1
251170,202208,87,73,14,88476.32,16968,105444.32
251180,202208,291,167,124,202406.24,150289.58,352695.82
251190,202208,195,124,71,150289.18,86052.18,236341.36
251200,202208,287,220,67,266643.74,81204.1,347847.84
251203,202208,32,29,3,35148,3636,38784
251207,202208,84,71,13,87264,15756,103020
251210,202208,1555,1126,429,1364725.7,519950.35,1884676.05
251220,202208,48,37,11,44844.2,13332,58176.2
251230,202208,578,480,98,581764.32,118777.6,700541.92
251240,202208,116,80,36,96960,43632,140592
251250,202208,1536,1089,447,1320997.03,541770.44,1862767.47
251260,202208,11,7,4,8484,4848,13332
251270,202208,308,240,68,290885.48,82416.52,373302.00
251272,202208,62,55,7,66660.2,8484,75144.2
251274,202208,28,21,7,25452,8484,33936
251275,202208,35,19,16,23028,19392,42420
251276,202208,31,23,8,27876.96,9696,37572.96
251278,202208,16,14,2,18180,2424,20604
251280,202208,105,100,5,121200,6060,127260
251290,202208,1055,742,313,899332.07,379362.39,1278694.46
251300,202208,19,14,5,16968,6060,23028
251310,202208,310,221,89,267853.74,107868.42,375722.16
251315,202208,40,36,4,43632,4848.1,48480.1
251320,202208,75,62,13,75144.2,15756.1,90900.3
251330,202208,83,72,11,87264,13332.8,100596.8
251335,202208,25,14,11,16968.35,13332,30300.35
251340,202208,813,457,356,553891.14,432685.46,986576.60
251350,202208,37,35,2,42420,2424,44844
251360,202208,87,75,12,90900,14544,105444
251365,202208,8,7,1,8484.1,1212,9696.1
251370,202208,5898,3971,1927,4814145.47,2341609.49,7155754.96
251380,202208,48,36,12,43632,14544,58176
251385,202208,4,4,0,4848,,4848.0
251390,202208,986,717,269,869019.01,326034.2,1195053.21
251392,202208,34,23,11,27876,13332,41208
251394,202208,12,10,2,12120,2424,14544
251396,202208,12,7,5,8484,6060.2,14544.2
251398,202208,17,14,3,16968,3636,20604
251400,202208,50,39,11,47268,13332,60600
251410,202208,45,38,7,46056.2,8484,54540.2
251420,202208,109,79,30,95749.05,36360.96,132110.01
251430,202208,44,39,5,47268.7,6060,53328.7
251440,202208,52,26,26,31512,31512,63024
251445,202208,67,57,10,69084.56,12120,81204.56
251450,202208,381,328,53,397543.54,64237.4,461780.94
251455,202208,5,4,1,4848,1212,6060
251460,202208,25,18,7,21816,8484,30300
251465,202208,8,5,3,6060,3636,9696
251470,202208,52,38,14,46056,16968,63024
251480,202208,30,25,5,30300,6060,36360
251490,202208,113,66,47,79993.69,56965.1,136958.79
251500,202208,117,96,21,116353.7,25452,141805.7
251510,202208,86,50,36,60600.43,43632,104232.43
251520,202208,39,31,8,37572,9696,47268
251530,202208,4334,3032,1302,3676033.9,1579245.44,5255279.34
251540,202208,91,74,17,89688,20604.09,110292.09
251550,202208,416,310,106,375723.65,128473.3,504196.95
251560,202208,24,17,7,20604.1,8484,29088.1
251570,202208,17,15,2,18180,2424,20604
251580,202208,130,101,29,122412,35148,157560
251590,202208,106,73,33,88476,39996.6,128472.6
251593,202208,28,15,13,18180,15756,33936
251597,202208,112,85,27,103020.88,32724.99,135745.87
251600,202208,1107,766,341,928698.79,413293.98,1341992.77
251610,202208,255,183,72,221796.8,87264,309060.8
251615,202208,17,14,3,16968,3636,20604
251620,202208,4238,2687,1551,3256686.16,1879834.31,5136520.47
251630,202208,481,353,128,427846.24,155137.2,582983.44
251640,202208,119,87,32,105445.79,38784,144229.79
251650,202208,292,214,78,259369.34,94536.2,353905.54
251660,202208,202,176,26,213312.78,32724.8,246037.58
251670,202208,404,308,96,373298.29,116352.21,489650.50
251675,202208,14,8,6,9696,7272,16968
251680,202208,106,91,15,111504,18180,129684
251690,202208,314,258,56,312700.83,67873.11,380573.94
251700,202208,277,236,41,286033.32,49692,335725.32
251710,202208,22,13,9,15756,10908,26664
251720,202208,29,21,8,25452,9696,35148
251740,202208,14,11,3,13332,3636,16968
260005,202208,3690,1928,1762,2336271.23,2135569.87,4471841.10
260010,202208,1742,1293,449,1567132.02,545404.54,2112536.56
260020,202208,423,368,55,446018.13,66660.2,512678.33
260030,202208,620,414,206,501772.02,249673.35,751445.37
260040,202208,815,503,312,609641.9,378148.6,987790.5
260050,202208,1174,839,335,1018095.52,406026.45,1424121.97
260060,202208,373,342,31,415723.08,37572,453295.08
260070,202208,1354,825,529,999928.38,641162.78,1641091.16
260080,202208,735,555,180,672664.84,218160,890824.84
260090,202208,471,304,167,368449.97,202404,570853.97
260100,202208,209,142,67,172104.66,81204,253308.66
260105,202208,266,155,111,187861.27,135744,323605.27
260110,202208,3034,2180,854,2642181.59,1035056.34,3677237.93
260120,202208,2802,1482,1320,1796530.34,1599854.5,3396384.84
260130,202208,206,144,62,174528,75144,249672
260140,202208,2294,1470,824,1782874.7,1001120.92,2783995.62
260150,202208,193,127,66,153924.9,79993.4,233918.3
260160,202208,356,279,77,338154.74,93325.08,431479.82
260170,202208,3464,2043,1421,2479784.76,1722272.7,4202057.46
260180,202208,187,155,32,187862.2,38784.79,226646.99
260190,202208,2446,1594,852,1933158.83,1032629.46,2965788.29
260200,202208,1013,790,223,957491.42,270276.99,1227768.41
260210,202208,1403,996,407,1207165.17,493287.93,1700453.10
260220,202208,651,579,72,702968.76,87265.47,790234.23
260230,202208,1293,950,343,1151415.97,416931.44,1568347.41
260240,202208,209,158,51,191497.97,61813.63,253311.60
260250,202208,103,76,27,92112,32724,124836
260260,202208,1104,772,332,935668.32,402384.99,1338053.31
260270,202208,260,185,75,224222.62,90900,315122.62
260280,202208,1168,928,240,1124752.33,290882.27,1415634.60
260290,202208,7111,3798,3313,4609301.47,4019011.01,8628312.48
260300,202208,1033,873,160,1058104.52,193920.81,1252025.33
260310,202208,524,413,111,500560.13,134532,635092.13
260320,202208,827,592,235,717505.96,284820.94,1002326.90
260330,202208,87,66,21,79993.2,25452.71,105445.91
260340,202208,86,63,23,76356.2,27876,104232.2
260345,202208,5935,3040,2895,3686965.23,3511204.17,7198169.40
260350,202208,488,345,143,418144.88,173316.7,591461.58
260360,202208,249,137,112,166044.4,135745.1,301789.5
260370,202208,750,480,270,581763.3,327241,909004.3
260380,202208,564,398,166,482380.7,201193.05,683573.75
260390,202208,294,252,42,305424.68,50904,356328.68
260392,202208,120,102,18,123624.2,21816.26,145440.46
260400,202208,4515,2562,1953,3107588.48,2368260.19,5475848.67
260410,202208,15651,8063,7588,9777330.45,9212469.62,18989800.07
260415,202208,150,126,24,152713.24,29088,181801.24
260420,202208,1771,1097,674,1329580.83,816889.34,2146470.17
260430,202208,173,155,18,189073.62,21816.8,210890.42
260440,202208,203,135,68,163623.34,82416.53,246039.87
260450,202208,423,313,110,379360.83,133320,512680.83
260460,202208,865,442,423,535711.11,512679.24,1048390.35
260470,202208,342,205,137,248464.71,166045.28,414509.99
260480,202208,254,160,94,193920,113928,307848
260490,202208,233,184,49,223008,59388,282396
260500,202208,1163,772,391,936889.12,473895.17,1410784.29
260510,202208,833,661,172,801137.94,208464.38,1009602.32
260515,202208,232,212,20,256945.32,24240.91,281186.23
260520,202208,3265,1986,1279,2408202,1553797.82,3961999.82
260530,202208,848,679,169,822960.71,204828.95,1027789.66
260540,202208,545,426,119,517527.23,144228.2,661755.43
260545,202208,23,12,11,14544.86,13332,27876.86
260550,202208,350,224,126,271489.6,152712,424201.6
260560,202208,515,391,124,473897.6,150290.31,624187.91
260570,202208,1036,824,212,998705.03,256945.14,1255650.17
260580,202208,346,279,67,338148,81204.83,419352.83
260590,202208,628,362,266,438744.09,322392.2,761136.29
260600,202208,8020,4636,3384,5618891.01,4102649.08,9721540.09
260610,202208,503,337,166,410870.1,201194.26,612064.36
260620,202208,3903,1995,1908,2417979.34,2313744.47,4731723.81
260630,202208,82,74,8,89688,9696,99384
260640,202208,3461,2049,1412,2483409.1,1712562.24,4195971.34
260650,202208,321,231,90,279975.26,109081.2,389056.46
260660,202208,598,387,211,469050.48,255734.51,724784.99
260670,202208,105,75,30,90900,36360.12,127260.12
260680,202208,4102,2201,1901,2668886.78,2305261.93,4974148.71
260690,202208,130,96,34,116352.74,41208,157560.74
260700,202208,316,211,105,255734.65,127260,382994.65
260710,202208,48,41,7,49692,8484,58176
260720,202208,2764,1601,1163,1941637.15,1410773.43,3352410.58
260730,202208,754,553,201,670242.08,244824.22,915066.30
260740,202208,77,62,15,75144,18180,93324
260750,202208,573,423,150,512683.09,181801.02,694484.11
260760,202208,753,372,381,452090.28,461780.63,913870.91
260765,202208,1029,529,500,643582.88,606007.12,1249590.00
260770,202208,218,159,59,192689.79,71508.74,264198.53
260775,202208,829,434,395,526019.72,478746.15,1004765.87
260780,202208,234,144,90,174529.6,109081.2,283610.8
260790,202208,16003,7780,8223,9430744.26,9971192.8,19401937.06
260795,202208,160,104,56,126048.62,67872,193920.62
260800,202208,310,251,59,304213.1,71509.47,375722.57
260805,202208,171,113,58,136956.4,70296.7,207253.1
260810,202208,836,675,161,818103.88,195132.8,1013236.68
260820,202208,308,199,109,242401.97,132108,374509.97
260825,202208,217,146,71,176952,86052,263004
260830,202208,300,191,109,231492,132108,363600
260840,202208,274,194,80,235128.1,96960.16,332088.26
260845,202208,196,120,76,145441.17,92112.1,237553.27
260850,202208,425,317,108,384207.26,130896,515103.26
260860,202208,243,184,59,223010.67,71508,294518.67
260870,202208,353,271,82,328455.33,99384,427839.33
260875,202208,757,546,211,661771.83,255733.89,917505.72
260880,202208,1603,1066,537,1292005.54,650844.97,1942850.51
260890,202208,2476,1696,780,2055575.23,945370.48,3000945.71
260900,202208,1017,740,277,898100.93,335724.88,1233825.81
260910,202208,257,203,54,246038.01,65448,311486.01
260915,202208,281,210,71,254520.2,86052,340572.2
260920,202208,218,115,103,139380,124836,264216
260930,202208,353,296,57,358755.27,69084.86,427840.13
260940,202208,2649,1412,1237,1711377.75,1499261.66,3210639.41
260950,202208,2045,1164,881,1410789.58,1067787.42,2478577.00
260960,202208,14307,6873,7434,8332711.78,9016178.76,17348890.54
260970,202208,432,347,85,420565.41,103020,523585.41
260980,202208,206,186,20,225434.38,24240.1,249674.48
260990,202208,2697,2143,554,2597372.73,671453.13,3268825.86
261000,202208,4311,2633,1678,3191229.91,2033750.77,5224980.68
261010,202208,141,101,40,122412.92,48480,170892.92
261020,202208,601,441,160,534499.03,193920,728419.03
261030,202208,254,186,68,225432,82416,307848
261040,202208,374,312,62,378146.49,75144,453290.49
261050,202208,532,437,95,530860.6,115141.4,646002.0
261060,202208,1549,947,602,1147773.09,729627.05,1877400.14
261070,202208,9981,4686,5295,5682033.12,6426196.66,12108229.78
261080,202208,367,279,88,338152.51,106656,444808.51
261090,202208,2135,1627,508,1973173.33,615698.86,2588872.19
261100,202208,1251,867,384,1050817.37,465410.76,1516228.13
261110,202208,9503,5887,3616,7135186.95,4386284.6,11521471.55
261120,202208,235,200,35,242400.38,42420,284820.38
261130,202208,576,332,244,402391.04,295732.71,698123.75
261140,202208,214,134,80,162408.85,96960,259368.85
261150,202208,679,434,245,526010.77,296940,822950.77
261153,202208,75,71,4,86052.2,4848,90900.2
261160,202208,78353,37992,40361,46067122.04,48955708.85,95022830.89
261170,202208,489,364,125,441169.93,151501,592670.93
261180,202208,1811,1129,682,1369856.14,826590.4,2196446.54
261190,202208,584,399,185,483593.38,225432.67,709026.05
261200,202208,220,177,43,214526.97,52116,266642.97
261210,202208,47,35,12,42420,14544,56964
261220,202208,2846,1976,870,2394947.84,1054452.58,3449400.42
261230,202208,370,273,97,330878.47,117564.97,448443.44
261240,202208,443,380,63,460566.89,76356.96,536923.85
261245,202208,252,213,39,258156.2,47268,305424.2
261247,202208,173,131,42,159985.65,50904,210889.65
261250,202208,3778,1783,1995,2161013.89,2417947.46,4578961.35
261255,202208,251,220,31,267852.52,37572,305424.52
261260,202208,860,739,121,895693.77,146654.94,1042348.71
261270,202208,210,148,62,179376.13,75144,254520.13
261280,202208,199,157,42,190284.8,50904,241188.8
261290,202208,104,74,30,89688.24,36360.2,126048.44
261300,202208,1408,1042,366,1262918.21,443596.69,1706514.90
261310,202208,820,543,277,658126.58,336937.36,995063.94
261320,202208,541,369,172,447235.7,208465.43,655701.13
261330,202208,926,725,201,879937,244831.69,1124768.69
261340,202208,328,185,143,224220.9,173316.89,397537.79
261350,202208,919,629,290,762361.88,351485.42,1113847.30
261360,202208,1421,896,525,1085955.85,636303.15,1722259.00
261370,202208,5074,2939,2135,3562121.21,2590072.58,6152193.79
261380,202208,570,443,127,536918.94,153924,690842.94
261390,202208,3847,2595,1252,3145203.35,1519875.41,4665078.76
261400,202208,272,244,28,295729.55,33937.05,329666.60
261410,202208,1155,755,400,915072.74,486013.61,1401086.35
261420,202208,981,596,385,723574.12,467833.7,1191407.82
261430,202208,318,285,33,345422.86,39996,385418.86
261440,202208,104,99,5,119989.37,6060,126049.37
261450,202208,2616,2034,582,2466438.64,705391.33,3171829.97
261460,202208,789,608,181,736908.6,219374.01,956282.61
261470,202208,228,183,45,221797.5,54540.79,276338.29
261480,202208,482,360,122,436324.89,149023.56,585348.45
261485,202208,392,232,160,281185.98,193920.2,475106.18
261500,202208,631,405,226,490864.15,273912.97,764777.12
261510,202208,54,36,18,43633.28,21816.1,65449.38
261520,202208,95,80,15,96960.78,18180.2,115140.98
261530,202208,4238,2695,1543,3266381.12,1871342.44,5137723.56
261540,202208,1514,869,645,1053237.57,781746.64,1834984.21
261550,202208,268,131,137,158772.32,166044.8,324817.12
261560,202208,954,622,332,753874.32,402389.04,1156263.36
261570,202208,387,310,77,375724.12,93324.95,469049.07
261580,202208,402,322,80,390267.16,96960,487227.16
261590,202208,191,158,33,192709.98,39996.8,232706.78
261600,202208,314,244,70,295732.46,84841.13,380573.59
261610,202208,87,73,14,90900,16968,107868
261618,202208,79,58,21,70296,25452,95748
261620,202208,206,131,75,158772.2,90900.8,249673.0
261630,202208,673,527,146,638727.06,176952,815679.06
261640,202208,6783,3550,3233,4302655.16,3918437.34,8221092.50
261650,202208,470,301,169,364812.99,204828.1,569641.09
270010,202208,517,456,61,552679.86,73932.5,626612.36
270020,202208,250,206,44,249674.2,53328.2,303002.4
270030,202208,8930,5720,3210,6933967.86,3891710.73,10825678.59
270040,202208,2089,1367,722,1661668.58,875069.56,2536738.14
270050,202208,226,174,52,210888.82,63024.54,273913.36
270060,202208,72,49,23,59391.23,27876.96,87268.19
270070,202208,806,589,217,713870.67,263005.1,976875.77
270080,202208,46,38,8,46056.35,9696,55752.35
270090,202208,22,17,5,20604,6060,26664
270100,202208,1329,903,426,1094606.76,517525.77,1612132.53
270110,202208,66,55,11,66660,13332,79992
270120,202208,248,200,48,242405.2,58176.6,300581.8
270130,202208,334,248,86,300578.25,104232,404810.25
270135,202208,121,84,37,101809.3,44844,146653.3
270140,202208,1414,929,485,1125968.86,589038.41,1715007.27
270150,202208,245,188,57,227857.86,69084.1,296941.96
270160,202208,487,381,106,462988.11,128472,591460.11
270170,202208,812,531,281,643576.49,340572.39,984148.88
270180,202208,57,46,11,56964,13332.76,70296.76
270190,202208,110,96,14,116355.25,16968,133323.25
270200,202208,117,102,15,123624.3,18180,141804.3
270210,202208,544,333,211,404810.25,255732,660542.25
270220,202208,197,140,57,169680.1,69084.78,238764.88
270230,202208,2165,1356,809,1643489.88,980511.83,2624001.71
270235,202208,497,386,111,467843.11,134532.1,602375.21
270240,202208,3340,2647,693,3208196.3,842343.64,4050539.94
270250,202208,122,91,31,110292.91,38784,149076.91
270255,202208,210,175,35,212100.97,42420,254520.97
270260,202208,370,304,66,368453.94,79992.1,448446.04
270270,202208,96,49,47,59388,56964,116352
270280,202208,208,130,78,157560.48,94536,252096.48
270290,202208,1117,872,245,1056874.93,298154.9,1355029.83
270300,202208,375,275,100,333300,121200.56,454500.56
270310,202208,816,681,135,825382.96,163620.61,989003.57
270320,202208,776,673,103,815683.02,124836,940519.02
270330,202208,311,268,43,324816.48,52116,376932.48
270340,202208,62,52,10,63024,12120,75144
270350,202208,87,52,35,63025.77,42420,105445.77
270360,202208,76,42,34,50904,41208,92112
270370,202208,64,50,14,60600,16968,77568
270375,202208,80,51,29,61812,35148,96960
270380,202208,1066,722,344,876277.1,418140,1294417.1
270390,202208,140,83,57,100596,70296.1,170892.1
270400,202208,741,568,173,689635.77,210888.92,900524.69
270410,202208,604,446,158,540555.84,191496.9,732052.74
270420,202208,409,287,122,347846.74,147864.2,495710.94
270430,202208,34814,24801,10013,30073885.46,12144454.67,42218340.13
270440,202208,474,377,97,456930.53,118776.1,575706.63
270450,202208,856,505,351,612063.11,426626.11,1038689.22
270460,202208,178,140,38,169683.29,46056,215739.29
270470,202208,1622,1130,492,1369580.27,596304.54,1965884.81
270480,202208,557,448,109,542983.39,132108,675091.39
270490,202208,21,16,5,19392,6060,25452
270500,202208,469,390,79,472684.03,95748,568432.03
270510,202208,893,585,308,708967.42,373297.5,1082264.92
270520,202208,264,174,90,210888.78,109080,319968.78
270530,202208,62,52,10,63024.2,12120,75144.2
270540,202208,94,67,27,81204,32724,113928
270550,202208,1665,1286,379,1561074.12,459349.8,2020423.92
270560,202208,257,156,101,189073.72,122412.5,311486.22
270570,202208,573,408,165,494501.3,199980,694481.3
270580,202208,20,15,5,18180,6060,24240
270590,202208,57,44,13,53328.5,15756,69084.5
270600,202208,152,131,21,158773.9,25452.1,184226.0
270610,202208,244,195,49,236341.52,60600.1,296941.62
270620,202208,17,17,0,20604,,20604.0
270630,202208,3670,2766,904,3355037.47,1095654.16,4450691.63
270640,202208,882,651,231,790231.55,279974.41,1070205.96
270642,202208,209,175,34,212101.82,41208,253309.82
270644,202208,319,174,145,210889.11,176953.67,387842.78
270650,202208,351,215,136,260583.39,164833.35,425416.74
270660,202208,191,170,21,206046.94,25452,231498.94
270670,202208,2959,2246,713,2722181.23,865370.78,3587552.01
270680,202208,393,255,138,310275.55,167256.46,477532.01
270690,202208,1240,841,399,1021728.59,483591.68,1505320.27
270700,202208,24,19,5,23028.42,6060,29088.42
270710,202208,548,428,120,518739.58,145440.65,664180.23
270720,202208,225,181,44,219376.7,53328.5,272705.2
270730,202208,1927,1198,729,1451985.57,884763.29,2336748.86
270740,202208,37,25,12,30300,14544,44844
270750,202208,624,478,146,579340.99,178164.37,757505.36
270760,202208,298,217,81,263007.41,98172,361179.41
270770,202208,2881,1970,911,2388885.18,1107774.09,3496659.27
270780,202208,64,39,25,47268,30301.24,77569.24
270790,202208,219,136,83,164833.13,100596.63,265429.76
270800,202208,2051,1641,410,1988918.41,498132.77,2487051.18
270810,202208,221,182,39,220585.46,47268,267853.46
270820,202208,126,88,38,106660.72,46056,152716.72
270830,202208,837,639,198,774489.58,239977.43,1014467.01
270840,202208,1331,1032,299,1250791.71,362390.36,1613182.07
270850,202208,1526,991,535,1201096.34,648421.91,1849518.25
270860,202208,2586,1754,832,2125881.18,1008392.98,3134274.16
270870,202208,128,73,55,88476.53,66660.2,155136.73
270880,202208,848,673,175,815685.72,212101.07,1027786.79
270890,202208,266,201,65,244824.97,78780.8,323605.77
270895,202208,65,62,3,75144.2,3636,78780.2
270900,202208,64,53,11,64236.93,13332,77568.93
270910,202208,302,249,53,301792.95,64236.6,366029.55
270915,202208,1949,1292,657,1565921.28,796286.84,2362208.12
270920,202208,420,348,72,421780.24,87264,509044.24
270930,202208,5635,4324,1311,5241974.02,1588938.36,6830912.38
270940,202208,2203,1749,454,2119858.29,550250.85,2670109.14
280010,202208,36,29,7,35148.51,8484,43632.51
280020,202208,505,426,79,516315.01,95748.97,612063.98
280030,202208,22025,14193,7832,17209714.38,9497419.67,26707134.05
280040,202208,333,209,124,254520.2,150288.2,404808.4
280050,202208,438,338,100,409658.44,121200,530858.44
280060,202208,395,250,145,304215.71,175741.82,479957.53
280067,202208,1151,826,325,1002332.53,395112.31,1397444.84
280070,202208,123,105,18,127261,21816,149077
280100,202208,666,514,152,622972.85,184224.63,807197.48
280110,202208,85,76,9,92112.4,10908,103020.4
280120,202208,681,566,115,685997.19,139381.17,825378.36
280130,202208,1766,1156,610,1402291.14,739321.2,2141612.34
280140,202208,504,420,84,509043.62,101808,610851.62
280150,202208,430,301,129,364817.32,156348,521165.32
280160,202208,145,110,35,133320,42420,175740
280170,202208,434,303,131,369666.57,158774.41,528440.98
280190,202208,32,25,7,30300,8484,38784
280200,202208,43,33,10,39997.76,12120.3,52118.06
280210,202208,3060,2195,865,2660290.79,1049600.73,3709891.52
280220,202208,54,44,10,53328.91,12120,65448.91
280230,202208,336,270,66,327247.42,79992.62,407240.04
280240,202208,127,117,10,143018.52,12120,155138.52
280250,202208,19,11,8,13332,9697.08,23029.08
280260,202208,79,71,8,86052.33,9696,95748.33
280270,202208,141,108,33,130896,39996.7,170892.7
280280,202208,189,124,65,150289.19,78780,229069.19
280290,202208,3727,2707,1020,3282045.22,1236247.85,4518293.07
280300,202208,1648,1319,329,1598646.6,398749.66,1997396.26
280310,202208,98,93,5,112717.2,6060,118777.2
280320,202208,677,471,206,570858.98,249674.06,820533.04
280330,202208,318,232,86,281186.3,104232.2,385418.5
280340,202208,423,353,70,427838.79,84840.46,512679.25
280350,202208,3797,2908,889,3525752.31,1078696.47,4604448.78
280360,202208,480,323,157,391480.14,190284.4,581764.54
280370,202208,96,81,15,98172.13,18180,116352.13
280380,202208,49,38,11,46056,13332,59388
280390,202208,181,152,29,184224.5,35148,219372.5
280400,202208,408,271,137,328458.81,166045.75,494504.56
280410,202208,296,247,49,299365.05,59388,358753.05
280420,202208,139,120,19,145443.01,23028.95,168471.96
280430,202208,97,76,21,92113,25452,117565
280440,202208,726,597,129,724785.95,156349.18,881135.13
280445,202208,124,116,8,140594.57,9696,150290.57
280450,202208,1296,1110,186,1345331.22,225435.53,1570766.75
280460,202208,674,490,184,593884.48,223008.19,816892.67
280470,202208,100,90,10,109080.39,12120,121200.39
280480,202208,3140,2110,1030,2557388.67,1249598.01,3806986.68
280490,202208,201,191,10,231496.49,12120,243616.49
280500,202208,42,38,4,46056.06,4848.17,50904.23
280510,202208,136,109,27,132108.76,32725.2,164833.96
280520,202208,53,39,14,47268.2,16968,64236.2
280530,202208,72,49,23,59388.16,27876,87264.16
280540,202208,557,483,74,586613.49,89688,676301.49
280550,202208,739,683,56,827804.45,67872,895676.45
280560,202208,481,434,47,526012.6,56964.6,582977.2
280570,202208,2358,1867,491,2262821.69,596304.09,2859125.78
280580,202208,585,461,124,559947.47,150288.76,710236.23
280590,202208,227,143,84,173322.17,101810.1,275132.27
280600,202208,403,331,72,401230.95,87264,488494.95
280610,202208,119,84,35,101811.13,42422.46,144233.59
280620,202208,560,455,105,551463.21,127260.08,678723.29
280630,202208,152,122,30,147866.3,36360,184226.3
280640,202208,183,146,37,176952.1,44844,221796.1
280650,202208,86,51,35,61812.2,42420.52,104232.72
280660,202208,125,95,30,115143.03,36360.2,151503.23
280670,202208,2055,1301,754,1579326.98,915079.2,2494406.18
280680,202208,239,204,35,247249.21,42420,289669.21
280690,202208,78,68,10,82416,12120,94536
280700,202208,19,19,0,23028,,23028.0
280710,202208,1526,1186,340,1437447.8,412081.68,1849529.48
280720,202208,126,85,41,103020.95,49692,152712.95
280730,202208,30,26,4,31512.97,4848,36360.97
280740,202208,2597,1944,653,2357358,792649.6,3150007.6
280750,202208,223,194,29,235130.11,35148.34,270278.45
280760,202208,932,629,303,762366.24,367238.58,1129604.82
290010,202208,198,140,58,169680.42,70296,239976.42
290020,202208,186,166,20,201192.89,24240,225432.89
290030,202208,628,402,226,487227.03,273912.88,761139.91
290035,202208,130,106,24,128473.17,29088,157561.17
290040,202208,248,171,77,207255.52,94536,301791.52
290050,202208,88,70,18,84840,21816,106656
290060,202208,256,112,144,135744.95,174528.2,310273.15
290070,202208,6013,2826,3187,3425162.18,3864100.48,7289262.66
290080,202208,465,200,265,242401.48,321180.29,563581.77
290090,202208,347,160,187,193920.5,226645.3,420565.8
290100,202208,1720,1084,636,1313824.59,770835.72,2084660.31
290110,202208,891,506,385,615706.78,467836.67,1083543.45
290115,202208,184,166,18,201193.31,21816,223009.31
290120,202208,809,542,267,656909.11,324816.3,981725.41
290130,202208,466,282,184,341785.24,223008.16,564793.40
290135,202208,294,220,74,266641.03,89688.13,356329.16
290140,202208,315,264,51,319972.35,61812.2,381784.55
290150,202208,138,93,45,112716,54540,167256
290160,202208,243,185,58,224222.85,70297.17,294520.02
290170,202208,105,75,30,92112,36360,128472
290180,202208,197,142,55,172106.05,66660,238766.05
290190,202208,369,291,78,352697.96,94536.9,447234.86
290195,202208,300,196,104,237552.4,126048,363600.4
290200,202208,264,214,50,259368.31,60600.1,319968.41
290205,202208,150,92,58,111504,70296,181800
290210,202208,1268,923,345,1118694.39,418142.8,1536837.19
290220,202208,176,102,74,124838.07,89688.2,214526.27
290225,202208,299,115,184,139381.75,223009.64,362391.39
290230,202208,89,54,35,65449.17,42420,107869.17
290240,202208,363,126,237,152712.4,288457.3,441169.7
290250,202208,243,225,18,272703.49,21816,294519.49
290260,202208,352,277,75,335771.92,90902.03,426673.95
290265,202208,192,168,24,203617.63,29088.49,232706.12
290270,202208,1393,1149,244,1392610.54,295731,1688341.54
290280,202208,477,335,142,406020.6,172104.4,578125.0
290290,202208,1417,843,574,1021728.9,695690.22,1717419.12
290300,202208,393,335,58,406026.3,70297.51,476323.81
290310,202208,284,133,151,161196.4,183012,344208.4
290320,202208,4312,2586,1726,3136720.88,2091928.43,5228649.31
290323,202208,205,178,27,215737.16,32724.2,248461.36
290327,202208,167,129,38,156349.55,46056,202405.55
290330,202208,120,57,63,69084.13,76356.1,145440.23
290340,202208,785,326,459,395117.21,556308.92,951426.13
290350,202208,673,407,266,493287.81,322394.43,815682.24
290360,202208,332,255,77,309064.61,93325.19,402389.80
290370,202208,900,401,499,486014.09,604788.6,1090802.69
290380,202208,337,212,125,256946.88,151500.8,408447.68
290390,202208,2432,1514,918,1834993.03,1112622.04,2947615.07
290395,202208,232,134,98,162408,118776,281184
290400,202208,290,211,79,255732.59,95748,351480.59
290405,202208,243,206,37,249672.15,44844,294516.15
290410,202208,639,533,106,645997.54,129684,775681.54
290420,202208,278,222,56,269064.96,67872,336936.96
290430,202208,486,308,178,373298.25,215736,589034.25
290440,202208,88,75,13,90900.22,15756.69,106656.91
290450,202208,195,142,53,172104,64236,236340
290460,202208,1988,1180,808,1431386.25,979298.57,2410684.82
290470,202208,1372,598,774,724784.57,938097.24,1662881.81
290475,202208,568,532,36,644793.51,43632,688425.51
290480,202208,209,121,88,146653,106656.33,253309.33
290485,202208,238,213,25,258158.28,30300,288458.28
290490,202208,1293,899,394,1089592.59,477529.92,1567122.51
290500,202208,785,415,370,502984.71,448442.35,951427.06
290510,202208,193,156,37,189076.48,44844.34,233920.82
290515,202208,177,107,70,129684,84840,214524
290520,202208,1427,933,494,1132013.71,598728.96,1730742.67
290530,202208,278,249,29,301795.17,35148.2,336943.37
290540,202208,119,59,60,71508.25,72720,144228.25
290550,202208,163,135,28,163621.11,33936,197557.11
290560,202208,3251,1450,1801,1757427.35,2184035.68,3941463.03
290570,202208,6795,3199,3596,3878477.5,4364473.04,8242950.54
290580,202208,1286,765,521,927184.93,631453.1,1558638.03
290590,202208,581,463,118,561170.21,143018.98,704189.19
290600,202208,1787,1224,563,1483514.42,682365.82,2165880.24
290610,202208,180,164,16,198773.21,19392,218165.21
290620,202208,379,342,37,414505.4,44844.4,459349.8
290630,202208,2025,858,1167,1039911.02,1414409.44,2454320.46
290640,202208,130,102,28,123625.67,33936.05,157561.72
290650,202208,1935,894,1041,1083545.85,1262909.79,2346455.64
290660,202208,256,209,47,253308,56964.72,310272.72
290670,202208,1047,518,529,627825.89,641153.26,1268979.15
290680,202208,1257,1008,249,1221709.72,301790.37,1523500.09
290682,202208,332,246,86,298153.3,104232.38,402385.68
290685,202208,257,155,102,187861.46,123624.2,311485.66
290687,202208,1178,772,406,935870.26,492073.41,1427943.67
290689,202208,150,77,73,93324,88476,181800
290690,202208,584,257,327,311486.66,396325.74,707812.40
290700,202208,256,127,129,153925.64,156349.1,310274.74
290710,202208,768,527,241,638730.63,293308.6,932039.23
290720,202208,1060,847,213,1026579.19,258158.01,1284737.20
290730,202208,1254,731,523,887193.86,635094.02,1522287.88
290740,202208,26,22,4,26664,4848,31512
290750,202208,1492,640,852,775692.92,1035060.88,1810753.80
290755,202208,75,66,9,79992,10908,90900
290760,202208,261,228,33,276343.02,39996.2,316339.22
290770,202208,186,178,8,215737.67,9696,225433.67
290780,202208,1125,890,235,1078688.39,284824.29,1363512.68
290790,202208,391,265,126,321184.81,152714.9,473899.71
290800,202208,2456,994,1462,1204737.47,1771949.92,2976687.39
290810,202208,496,339,157,413294.5,190285.96,603580.46
290820,202208,415,242,173,293310.2,209678.9,502989.1
290830,202208,472,331,141,401174.21,170892.43,572066.64
290840,202208,1876,1174,702,1422903.62,850829.47,2273733.09
290850,202208,1020,519,501,629032.85,607216.33,1236249.18
290860,202208,669,311,358,376934.46,435109.34,812043.80
290870,202208,619,434,185,526014.41,224220.96,750235.37
290880,202208,116,65,51,78780,61812,140592
290890,202208,484,292,192,353908.02,232705.97,586613.99
290900,202208,163,124,39,150288,47268,197556
290910,202208,390,299,91,362389.16,110292,472681.16
290920,202208,198,176,22,213314.66,26664,239978.66
290930,202208,532,408,124,494501.42,150289.3,644790.72
290940,202208,221,188,33,227856.3,41208,269064.3
290950,202208,158,90,68,109080,82416,191496
290960,202208,491,343,148,415718.54,179377,595095.54
290970,202208,231,203,28,247248.2,33936.2,281184.4
290980,202208,1915,1315,600,1593799.43,729630.49,2323429.92
290990,202208,414,348,66,421783.36,79993.98,501777.34
291000,202208,921,285,636,345421.23,770832,1116253.23
291005,202208,2639,1116,1523,1355041.27,1845900.95,3200942.22
291010,202208,118,103,15,124836,18180,143016
291020,202208,90,71,19,86052,23028.8,109080.8
291030,202208,99,71,28,86052,33936,119988
291040,202208,650,376,274,456924.78,332088.2,789012.98
291050,202208,1528,797,731,967185.28,888400.25,1855585.53
291060,202208,1692,933,759,1130813.15,919911.82,2050724.97
291070,202208,1977,1474,503,1787720.48,609640.95,2397361.43
291072,202208,7412,2805,4607,3400940.27,5589772.12,8990712.39
291075,202208,239,199,40,241188.98,48480.2,289669.18
291077,202208,61,43,18,52116,21816,73932
291080,202208,21618,9160,12458,11105786.47,15110181.61,26215968.08
291085,202208,274,224,50,271488.33,60600.75,332089.08
291090,202208,263,105,158,127261.29,191496,318757.29
291100,202208,998,336,662,407232,802344,1209576
291110,202208,444,341,103,413294.69,124836.2,538130.89
291120,202208,2460,1280,1180,1552581.4,1430164.44,2982745.84
291125,202208,68,35,33,42420,39996,82416
291130,202208,190,166,24,201193.26,29088,230281.26
291140,202208,127,100,27,121200,32724.7,153924.7
291150,202208,364,136,228,166044,276336,442380
291160,202208,410,310,100,375726.09,121200.8,496926.89
291165,202208,49,37,12,44844,14544,59388
291170,202208,3377,1655,1722,2008313,2087069.87,4095382.87
291180,202208,1245,515,730,624187.7,885973.36,1510161.06
291185,202208,115,105,10,127260.78,12120,139380.78
291190,202208,1397,668,729,809624.92,884768.9,1694393.82
291200,202208,173,127,46,153924.2,55752,209676.2
291210,202208,2456,987,1469,1196257.49,1780435.79,2976693.28
291220,202208,311,235,76,284821.19,92112,376933.19
291230,202208,978,345,633,418141.51,767198.81,1185340.32
291240,202208,406,378,28,458139.2,33936,492075.2
291250,202208,411,334,77,404808,93324,498132
291260,202208,64,55,9,66660.25,10908,77568.25
291270,202208,1031,450,581,545416.04,704183.24,1249599.28
291280,202208,367,173,194,209678.32,235128.8,444807.12
291290,202208,1644,858,786,1041131.6,953852.82,1994984.42
291300,202208,244,189,55,229068,66660,295728
291310,202208,229,201,28,244827.7,33936,278763.7
291320,202208,1313,912,401,1105363.77,486014.63,1591378.40
291330,202208,143,120,23,145441.2,27876,173317.2
291340,202208,227,134,93,162408.37,112717.24,275125.61
291345,202208,120,84,36,101808.19,43632,145440.19
291350,202208,1801,685,1116,830221.3,1352593,2182814.3
291360,202208,8607,4084,4523,4953550.65,5485588.35,10439139.00
291370,202208,1125,668,457,809630.5,553889.86,1363520.36
291380,202208,261,203,58,246036.86,70296,316332.86
291390,202208,4113,1800,2313,2181625.08,2803365.41,4984990.49
291400,202208,2107,1470,637,1781670.67,772057.43,2553728.10
291410,202208,209,180,29,218161.87,35148,253309.87
291420,202208,120,91,29,110292.54,35148,145440.54
291430,202208,177,107,70,129684.61,84840,214524.61
291440,202208,539,435,104,527226.27,126048.2,653274.47
291450,202208,1011,672,339,814472.37,410872.47,1225344.84
291460,202208,2031,1588,443,1924693.62,536926.31,2461619.93
291465,202208,2312,1094,1218,1327155.78,1477432.73,2804588.51
291470,202208,2947,1470,1477,1781663.82,1790135.69,3571799.51
291480,202208,12250,5271,6979,6389748,8463447.96,14853195.96
291490,202208,668,264,404,321181.8,489648.2,810830.0
291500,202208,360,216,144,261796.09,174528.1,436324.19
291510,202208,1190,459,731,556310.23,885973.19,1442283.42
291520,202208,932,419,513,507833.57,621757.55,1129591.12
291530,202208,940,271,669,329665.55,810828.9,1140494.45
291535,202208,127,105,22,127260,26665.2,153925.2
291540,202208,353,118,235,143017.31,286032.47,429049.78
291550,202208,1290,611,679,740537.59,822948.9,1563486.49
291560,202208,5215,2623,2592,3179095.53,3146359.14,6325454.67
291570,202208,232,115,117,139380.99,141804.86,281185.85
291580,202208,1212,754,458,913859.17,556309.08,1470168.25
291590,202208,104,47,57,56964.2,69084,126048.2
291600,202208,1144,574,570,695693.87,692053.08,1387746.95
291610,202208,1459,704,755,853283.23,915076.38,1768359.61
291620,202208,571,269,302,326034.32,367237.94,693272.26
291630,202208,487,154,333,186648.2,403596,590244.2
291640,202208,4147,2034,2113,2467671.41,2562188.71,5029860.12
291650,202208,446,304,142,368455.48,172105.28,540560.76
291660,202208,377,154,223,186648.43,270277.8,456926.23
291670,202208,178,111,67,134534.14,81204,215738.14
291680,202208,630,389,241,471486.69,292096.2,763582.89
291685,202208,596,343,253,415720.11,306638.63,722358.74
291690,202208,483,310,173,375721.21,209677.33,585398.54
291700,202208,1060,812,248,984152.08,300578.66,1284730.74
291710,202208,1607,787,820,955065.93,993846.28,1948912.21
291720,202208,439,302,137,366024,166044,532068
291730,202208,944,543,401,658126.1,486014.12,1144140.22
291733,202208,308,206,102,249673.62,123624.2,373297.82
291735,202208,86,66,20,79992,24240,104232
291740,202208,346,259,87,313909.7,105444,419353.7
291750,202208,2423,1532,891,1856833.16,1079917.37,2936750.53
291760,202208,3105,1702,1403,2064041.52,1702861.13,3766902.65
291770,202208,741,499,242,607228.2,293310.63,900538.83
291780,202208,94,58,36,70296.62,43632.8,113929.42
291790,202208,160,85,75,103020.39,90900.63,193921.02
291800,202208,10536,4442,6094,5387417.91,7390820.07,12778237.98
291810,202208,1072,807,265,978093.87,321182.5,1299276.37
291820,202208,290,208,82,252096.9,99384,351480.9
291830,202208,1034,427,607,517532.25,735688,1253220.25
291835,202208,563,523,40,633879.61,48480,682359.61
291840,202208,5315,2666,2649,3232480.23,3213055.97,6445536.20
291845,202208,286,95,191,115140,231492,346632
291850,202208,316,280,36,339365.41,43632.4,382997.81
291855,202208,273,116,157,141804.48,190284.78,332089.26
291860,202208,166,108,58,130896,70297.5,201193.5
291870,202208,77,34,43,41208,52116,93324
291875,202208,166,155,11,187862.37,13332,201194.37
291880,202208,435,355,80,430263.12,96960.4,527223.52
291890,202208,248,88,160,106656.1,193920.6,300576.7
291900,202208,54,33,21,39996,25452,65448
291905,202208,123,94,29,113928.51,35148,149076.51
291910,202208,159,127,32,153924,38784.1,192708.1
291915,202208,438,387,51,469048.85,61813.07,530861.92
291920,202208,5849,2816,3033,3415496.21,3678470.65,7093966.86
291930,202208,167,101,66,122413.51,79992,202405.51
291940,202208,388,225,163,272700.71,197556,470256.71
291950,202208,1210,947,263,1147768.44,318756.2,1466524.64
291955,202208,1423,849,574,1028995.13,695691.87,1724687.00
291960,202208,195,145,50,175740.2,60600,236340.2
291970,202208,779,571,208,692063.25,252097.1,944160.35
291980,202208,1428,1244,184,1510165.04,223010.32,1733175.36
291990,202208,143,132,11,159984.48,13332,173316.48
291992,202208,197,95,102,115143.25,124839.22,239982.47
291995,202208,184,115,69,139381.36,83628.36,223009.72
292000,202208,427,304,123,368451.51,149076,517527.51
292010,202208,332,228,104,276337.08,126048.63,402385.71
292020,202208,302,222,80,269065.42,96960.28,366025.70
292030,202208,156,119,37,144228,44844,189072
292040,202208,583,303,280,367236,339360,706596
292045,202208,121,105,16,127260,19392.67,146652.67
292050,202208,941,677,264,820525.41,319969.88,1140495.29
292060,202208,933,754,179,915081.73,216951.06,1132032.79
292070,202208,64,27,37,32724.2,44844,77568.2
292080,202208,156,109,47,132109.4,56964,189073.4
292090,202208,558,196,362,237553.02,438744.85,676297.87
292100,202208,1571,672,899,814482.58,1089607.68,1904090.26
292105,202208,172,154,18,186648,23028,209676
292110,202208,2330,866,1464,1049601.09,1774372.63,2823973.72
292120,202208,720,549,171,665400.16,207254.95,872655.11
292130,202208,478,266,212,322394.24,256944.2,579338.44
292140,202208,211,173,38,209678.49,46057.68,255736.17
292145,202208,165,87,78,105444,94536,199980
292150,202208,1527,1263,264,1530765.06,319968.81,1850733.87
292160,202208,172,133,39,161196.2,47268.45,208464.65
292170,202208,1192,1015,177,1230200.26,214525.74,1444726.00
292180,202208,236,167,69,202404,83628,286032
292190,202208,152,97,55,117564,67872,185436
292200,202208,1464,536,928,650850.57,1125953.32,1776803.89
292205,202208,119,99,20,119988,24240,144228
292210,202208,397,262,135,317547.2,163620.43,481167.63
292220,202208,35,23,12,27876.75,14544,42420.75
292225,202208,48,40,8,48480,9696,58176
292230,202208,1034,781,253,946591.11,307849.7,1254440.81
292240,202208,645,473,172,573283.94,208464.2,781748.14
292250,202208,1669,1080,589,1308982.61,714235.97,2023218.58
292260,202208,415,245,170,296941,206041.38,502982.38
292265,202208,255,190,65,230281.09,78780.2,309061.29
292270,202208,737,355,382,430264,462984.4,893248.4
292273,202208,217,127,90,153924,109080.8,263004.8
292275,202208,174,89,85,107868,103020,210888
292280,202208,153,105,48,127260,58176,185436
292285,202208,90,70,20,84840,24240,109080
292290,202208,602,404,198,489653.26,239977.18,729630.44
292300,202208,1861,717,1144,869010.16,1387747.19,2256757.35
292303,202208,131,88,43,106656.38,52116.38,158772.76
292305,202208,119,85,34,103020.37,41208,144228.37
292310,202208,996,651,345,789021.69,418143.47,1207165.16
292320,202208,592,437,155,529647.81,187861.9,717509.71
292330,202208,174,108,66,130896.38,79992,210888.38
292335,202208,307,244,63,295728.96,76356,372084.96
292340,202208,560,389,171,471470.02,207252.53,678722.55
292350,202208,276,146,130,176952.2,157560,334512.2
292360,202208,746,552,194,669026.43,235128.5,904154.93
292370,202208,730,557,173,675089.25,209676.5,884765.75
292380,202208,623,515,108,624466.02,130896,755362.02
292390,202208,398,157,241,190285.15,292093.79,482378.94
292400,202208,3709,2259,1450,2739163.81,1757410.42,4496574.23
292405,202208,279,186,93,225432.65,112716.2,338148.85
292410,202208,109,68,41,82416,49692,132108
292420,202208,279,239,40,289669.72,48480,338149.72
292430,202208,544,396,148,479952.79,179376.31,659329.10
292440,202208,639,530,109,642365.52,132108,774473.52
292450,202208,235,178,57,215738.35,69084.87,284823.22
292460,202208,518,393,125,476320.1,151500.92,627821.02
292465,202208,211,179,32,216948.6,38784.75,255733.35
292467,202208,165,108,57,130896,69084,199980
292470,202208,316,215,101,260581.11,122412,382993.11
292480,202208,412,275,137,333306.83,166046.31,499353.14
292490,202208,243,177,66,214524.3,79992.6,294516.9
292500,202208,925,435,490,527230.79,593885.8,1121116.59
292510,202208,3661,1759,1902,2131922.89,2307657,4439579.89
292520,202208,1179,552,627,670248.01,759931.11,1430179.12
292525,202208,444,322,122,390271.58,147867.45,538139.03
292530,202208,5006,2023,2983,2454323.29,3617842.1,6072165.39
292540,202208,499,289,210,350269.11,254520.51,604789.62
292550,202208,1154,632,522,765993.97,632666.81,1398660.78
292560,202208,333,305,28,369664.99,33936.16,403601.15
292570,202208,331,256,75,310274.03,90900,401174.03
292575,202208,584,421,163,510264.18,197557.82,707822.00
292580,202208,1052,706,346,855676.04,419354.86,1275030.90
292590,202208,576,510,66,618123.81,79992.8,698116.61
292593,202208,145,115,30,139380.58,36360,175740.58
292595,202208,198,156,42,189073.17,50904,239977.17
292600,202208,1281,912,369,1105356.99,449657.12,1555014.11
292610,202208,117,95,22,115140.85,26665.34,141806.19
292620,202208,528,441,87,534508.99,105444.7,639953.69
292630,202208,1569,865,704,1048390.26,853252.72,1901642.98
292640,202208,885,606,279,734479.78,338150.82,1072630.60
292650,202208,189,147,42,178168.9,50904,229072.9
292660,202208,1960,1376,584,1668956.05,707816.37,2376772.42
292665,202208,137,96,41,116352,49692,166044
292670,202208,399,309,90,374508.88,109080.37,483589.25
292680,202208,268,197,71,238764.76,86052.77,324817.53
292690,202208,206,143,63,173317.23,76356.2,249673.43
292700,202208,1014,658,356,797508.59,431475.76,1228984.35
292710,202208,115,100,15,121200,18180.31,139380.31
292720,202208,1002,578,424,701751.97,515100.78,1216852.75
292730,202208,210,97,113,117564.4,136956.4,254520.8
292740,202208,76864,36508,40356,44275393.38,48943642.62,93219036.00
292750,202208,393,283,110,343001.53,133321.86,476323.39
292760,202208,338,281,57,340573.86,69084.2,409658.06
292770,202208,887,370,517,449654.9,626607.58,1076262.48
292780,202208,31,13,18,15756,21816,37572
292790,202208,789,416,373,504193.59,452076,956269.59
292800,202208,1287,768,519,932035.73,629032.17,1561067.90
292805,202208,399,142,257,172104.4,311484.77,483589.17
292810,202208,1852,1099,753,1331999.97,912638.65,2244638.62
292820,202208,699,588,111,712667.83,134535.13,847202.96
292830,202208,134,102,32,123624.61,38784.8,162409.41
292840,202208,709,576,133,698123.35,161197.7,859321.05
292850,202208,141,94,47,113929.03,56966.18,170895.21
292860,202208,2152,1224,928,1483519.58,1124754.28,2608273.86
292870,202208,3743,2433,1310,2950047.34,1587727.07,4537774.41
292880,202208,1441,947,494,1148984.63,598730.19,1747714.82
292890,202208,547,454,93,550655.6,112719.47,663375.07
292895,202208,148,100,48,121200.2,58176,179376.2
292900,202208,340,241,99,293308.91,119989.06,413297.97
292905,202208,502,246,256,298155.4,310273.23,608428.63
292910,202208,510,378,132,458138.39,159984.17,618122.56
292920,202208,560,241,319,292094.2,386632.01,678726.21
292925,202208,473,433,40,524799.34,48481.22,573280.56
292930,202208,699,416,283,504198,342997.19,847195.19
292935,202208,280,123,157,149077.15,190284.7,339361.85
292937,202208,223,154,69,186649.16,83628,270277.16
292940,202208,199,151,48,183012.24,58176,241188.24
292950,202208,1335,641,694,778118.71,841134.95,1619253.66
292960,202208,512,362,150,439964.92,181802.33,621767.25
292970,202208,236,170,66,206042.63,79992.79,286035.42
292975,202208,89,48,41,58179.04,49692.96,107872.00
292980,202208,349,241,108,292093.56,130897.68,422991.24
292990,202208,1339,999,340,1210793.01,412080.63,1622873.64
293000,202208,112,80,32,96960.2,38784.1,135744.3
293010,202208,3034,1782,1252,2159846.21,1518658.53,3678504.74
293015,202208,615,507,108,614488.81,130896,745384.81
293020,202208,332,266,66,322399.48,79994.5,402393.98
293030,202208,582,515,67,624185.36,81204,705389.36
293040,202208,383,305,78,369661.53,94536,464197.53
293050,202208,3053,1785,1268,2163443.57,1536829.44,3700273.01
293060,202208,240,191,49,231497.36,59388.96,290886.32
293070,202208,3804,1909,1895,2318633.28,2299190.24,4617823.52
293075,202208,96,67,29,81204.2,35148,116352.2
293076,202208,80,58,22,70296,26664,96960
293077,202208,597,336,261,407241.5,316334.95,723576.45
293080,202208,434,383,51,465413.91,61812.66,527226.57
293090,202208,137,122,15,147864,18180,166044
293100,202208,537,362,175,438748.12,212100.17,650848.29
293105,202208,348,253,95,306636.98,115140,421776.98
293110,202208,127,82,45,99387.25,54543.16,153930.41
293120,202208,300,210,90,254524.04,109081.27,363605.31
293130,202208,245,163,82,197558.95,99384,296942.95
293135,202208,8511,3371,5140,4086919.17,6233336.54,10320255.71
293140,202208,195,117,78,141804.51,94536.82,236341.33
293150,202208,314,272,42,329669.49,50904.2,380573.69
293160,202208,428,264,164,319969.52,198768.47,518737.99
293170,202208,244,154,90,186651.09,109082.18,295733.27
293180,202208,593,396,197,481165.76,238764,719929.76
293190,202208,1401,968,433,1173241.02,524808.55,1698049.57
293200,202208,556,491,65,595097.3,78780.28,673877.58
293210,202208,415,316,99,384207.06,119988.87,504195.93
293220,202208,2410,1051,1359,1275033.47,1648325.52,2923358.99
293230,202208,1844,691,1153,839925.45,1398649.63,2238575.08
293240,202208,236,213,23,258157.78,27876.59,286034.37
293245,202208,136,109,27,132111.17,32724,164835.17
293250,202208,805,326,479,395119.34,580554.92,975674.26
293260,202208,315,251,64,304212.4,77568,381780.4
293270,202208,1203,540,663,654482.51,804768.6,1459251.11
293280,202208,317,201,116,243613.58,141806.98,385420.56
293290,202208,3070,1980,1090,2400997.31,1321086.36,3722083.67
293300,202208,882,608,274,736900.3,332088.4,1068988.7
293305,202208,192,148,44,179376.11,53328,232704.11
293310,202208,175,131,44,158773.59,53328.2,212101.79
293315,202208,167,126,41,152714.17,49692.2,202406.37
293317,202208,101,75,26,90903.65,31512,122415.65
293320,202208,1196,625,571,758739.6,692066.28,1450805.88
293325,202208,214,85,129,103020.6,156348,259368.6
293330,202208,14822,6724,8098,8149589.09,9819699.46,17969288.55
293340,202208,290,203,87,246036.46,105444,351480.46
293345,202208,265,218,47,264219.48,56964,321183.48
293350,202208,596,370,226,448446.82,273912.45,722359.27
293360,202208,1505,1061,444,1287161.76,538130.85,1825292.61
310010,202208,148,77,71,93324,86052,179376
310020,202208,1008,548,460,664185.55,558734.83,1222920.38
310030,202208,313,251,62,304212.69,75146.02,379358.71
310040,202208,46,30,16,36360,19392,55752
310050,202208,161,102,59,123624.89,71508,195132.89
310060,202208,267,181,86,219374.97,104233.46,323608.43
310070,202208,18,10,8,12120,9696.2,21816.2
310080,202208,49,33,16,39996,19392,59388
310090,202208,1093,607,486,735694.04,591459.69,1327153.73
310100,202208,348,250,98,304214.95,118776.59,422991.54
310110,202208,695,368,327,447230.44,397536.73,844767.17
310120,202208,383,219,164,266640,201192.1,467832.1
310130,202208,27,16,11,19392,13332,32724
310140,202208,26,9,17,10908,20604.76,31512.76
310150,202208,1185,778,407,942948.54,493289.71,1436238.25
310160,202208,2090,1039,1051,1260490.22,1273816.24,2534306.46
310163,202208,100,55,45,66660,54540,121200
310170,202208,2589,1206,1383,1461684.39,1676205.24,3137889.63
310180,202208,178,77,101,93325.84,122412,215737.84
310190,202208,482,321,161,389052.35,195133.5,584185.85
310200,202208,440,278,162,336936.31,196344.2,533280.51
310205,202208,75,49,26,59388,31512,90900
310210,202208,275,227,48,275126.01,58176,333302.01
310220,202208,68,43,25,52116.1,30300,82416.1
310230,202208,279,200,79,242401.36,95748,338149.36
310240,202208,119,96,23,116352,27876,144228
310250,202208,99,79,20,95749.83,24240.64,119990.47
310260,202208,746,396,350,479962.4,424204.36,904166.76
310270,202208,281,180,101,218161.18,122412.2,340573.38
310280,202208,385,275,110,333302.09,133320,466622.09
310285,202208,201,154,47,186649,56964.63,243613.63
310290,202208,232,126,106,152712,128472,281184
310300,202208,166,134,32,162409.39,38784.66,201194.05
310310,202208,12,9,3,10908,3636,14544
310320,202208,33,12,21,14544.17,25452,39996.17
310330,202208,40,28,12,33936.2,14544,48480.2
310340,202208,1839,1295,544,1569553.26,659331.18,2228884.44
310350,202208,2801,1462,1339,1771977.42,1624085.11,3396062.53
310360,202208,49,40,9,48480,10908.3,59388.3
310370,202208,124,106,18,128472,21816,150288
310375,202208,111,43,68,52116,82416.66,134532.66
310380,202208,52,32,20,38784,25452,64236
310390,202208,106,66,40,79992,48480,128472
310400,202208,2524,1629,895,1974387.25,1085958.39,3060345.64
310410,202208,115,68,47,82416.64,56964.32,139380.96
310420,202208,680,346,334,421778.18,404814.02,826592.20
310430,202208,286,184,102,224221.96,124836,349057.96
310440,202208,73,46,27,55752,32724,88476
310445,202208,80,67,13,81204.16,15756,96960.16
310450,202208,645,426,219,516318.98,266640.95,782959.93
310460,202208,253,171,82,207253.49,99384,306637.49
310470,202208,532,345,187,418144.24,226646.02,644790.26
310480,202208,98,62,36,75144,43632,118776
310490,202208,562,261,301,316334.69,364812.48,681147.17
310500,202208,128,54,74,65449.3,89688,155137.3
310510,202208,598,423,175,513891.68,213312.95,727204.63
310520,202208,146,104,42,126048.1,50904,176952.1
310530,202208,112,46,66,55752.2,79992,135744.2
310540,202208,492,273,219,330879.24,265430.25,596309.49
310550,202208,71,48,23,58178.51,27876,86054.51
310560,202208,3179,2175,1004,2636129.93,1218061.69,3854191.62
310570,202208,104,63,41,76356,49692,126048
310590,202208,384,232,152,282397.3,185436.1,467833.4
310600,202208,141,68,73,83628.8,88476,172104.8
310610,202208,50,21,29,25452,35148,60600
310620,202208,50301,23823,26478,28884624.04,32109690.12,60994314.16
310630,202208,734,439,295,533283.86,357540.48,890824.34
310640,202208,141,97,44,117564,53328.2,170892.2
310650,202208,156,138,18,167256.64,21816,189072.64
310660,202208,112,78,34,94536,41208,135744
310665,202208,65,46,19,55752,23028,78780
310670,202208,7406,3195,4211,3873604.69,5107384.51,8980989.20
310680,202208,66,39,27,47268,32724,79992
310690,202208,625,439,186,532071.44,225434.15,757505.59
310700,202208,61,37,24,44844,29088,73932
310710,202208,1304,876,428,1062064.78,518737.67,1580802.45
310720,202208,154,43,111,52116,134532,186648
310730,202208,1546,1044,502,1267776.57,608434.58,1876211.15
310740,202208,1006,551,455,667820.08,551464.13,1219284.21
310750,202208,252,154,98,186649.9,118776.37,305426.27
310760,202208,64,51,13,61812.45,15756,77568.45
310770,202208,84,41,43,49692,52116,101808
310780,202208,360,291,69,352694.51,83629.55,436324.06
310790,202208,114,90,24,109080.2,29088.59,138168.79
310800,202208,483,230,253,278761.14,306636,585397.14
310810,202208,172,114,58,138168.69,70296.67,208465.36
310820,202208,313,252,61,305426.32,73932.04,379358.36
310825,202208,221,182,39,220585.1,47268,267853.1
310830,202208,458,213,245,259368.9,296940.26,556309.16
310840,202208,364,217,147,264216.25,178164.28,442380.53
310850,202208,77,62,15,75144,18180,93324
310855,202208,411,324,87,392692.8,105444,498136.8
310860,202208,1634,1203,431,1458056.23,522379.57,1980435.80
310870,202208,57,49,8,59388.19,9696,69084.19
310880,202208,89,71,18,86052,21816,107868
310890,202208,294,168,126,203616.26,152712,356328.26
310900,202208,629,287,342,347847.82,415718.07,763565.89
310910,202208,237,162,75,196346,92112,288458
310920,202208,433,246,187,298160.76,226647.22,524807.98
310925,202208,41,31,10,37572,12120,49692
310930,202208,1336,884,452,1073319.66,547828.42,1621148.08
310940,202208,697,345,352,418145.33,426630.02,844775.35
310945,202208,136,86,50,104232.9,60600,164832.9
310950,202208,218,173,45,209676.86,54540,264216.86
310960,202208,74,25,49,30300.18,59388,89688.18
310970,202208,176,102,74,123626.38,89688.6,213314.98
310980,202208,50,34,16,41212.08,19392,60604.08
310990,202208,163,84,79,101808.1,95748.2,197556.3
311000,202208,864,427,437,517530.05,529647.19,1047177.24
311010,202208,51,39,12,47268.07,14544.87,61812.94
311020,202208,39,25,14,30300.78,16968,47268.78
311030,202208,394,223,171,270276.62,207252,477528.62
311040,202208,42,33,9,39996,10908,50904
311050,202208,504,195,309,236341,374508,610849
311060,202208,821,451,370,546614.06,448441.19,995055.25
311070,202208,340,147,193,178164.68,233916,412080.68
311080,202208,114,63,51,76357.51,61812.76,138170.27
311090,202208,345,164,181,198770.74,219373.08,418143.82
311100,202208,564,342,222,414505.23,269064.85,683570.08
311110,202208,721,511,210,619341.1,254524.45,873865.55
311115,202208,82,56,26,67872.13,31512,99384.13
311120,202208,1108,598,510,726001.31,618124.07,1344125.38
311130,202208,293,171,122,207253.46,147864,355117.46
311140,202208,166,91,75,110293.12,90901.04,201194.16
311150,202208,341,217,124,264219.31,150288.6,414507.91
311160,202208,770,542,228,658121.61,276338.83,934460.44
311170,202208,94,78,16,94536,19392,113928
311180,202208,316,214,102,259371.93,123624.68,382996.61
311190,202208,37,17,20,20604,24240,44844
311200,202208,348,235,113,286032.44,136956.2,422988.64
311205,202208,32,25,7,30300,8484,38784
311210,202208,36,31,5,37572.6,6060,43632.6
311220,202208,29,25,4,30300,4848,35148
311230,202208,1683,1108,575,1342920.39,696906.45,2039826.84
311240,202208,210,133,77,161196.59,93324.5,254521.09
311250,202208,66,27,39,32724,47268,79992
311260,202208,548,339,209,412084.62,253308,665392.62
311265,202208,132,87,45,105444.8,54540,159984.8
311270,202208,288,196,92,237553.67,111506.66,349060.33
311280,202208,200,87,113,105444.2,136956,242400.2
311290,202208,104,86,18,104232,21816.2,126048.2
311300,202208,596,382,214,462987.72,259369.32,722357.04
311310,202208,19,16,3,19392,3636,23028
311320,202208,630,469,161,570855.59,196344.64,767200.23
311330,202208,1189,870,319,1054450.09,386631.55,1441081.64
311340,202208,2643,1860,783,2254340.93,948998.73,3203339.66
311350,202208,267,205,62,248461.27,75144,323605.27
311360,202208,180,110,70,133320,84840,218160
311370,202208,1252,523,729,633891.7,883552.63,1517444.33
311380,202208,7,6,1,7272,1212,8484
311390,202208,247,143,104,173316.2,126048,299364.2
311400,202208,139,85,54,103020.39,65448,168468.39
311410,202208,123,59,64,71508,77568,149076
311420,202208,313,160,153,193921,185436.97,379357.97
311430,202208,846,559,287,677512.94,349057.08,1026570.02
311440,202208,456,305,151,369668.33,183013.4,552681.73
311450,202208,313,184,129,223008.02,156349.12,379357.14
311455,202208,273,189,84,229071.6,101810.54,330882.14
311460,202208,129,57,72,69084,88476,157560
311470,202208,28,13,15,15756,18180,33936
311480,202208,52,27,25,32724,30300,63024
311490,202208,11,6,5,7272,6060,13332
311500,202208,31,15,16,18180.8,19392,37572.8
311510,202208,668,454,214,550258.11,260581.93,810840.04
311520,202208,42,34,8,41208,9696,50904
311530,202208,1809,1303,506,1579255.31,614484.95,2193740.26
311535,202208,64,42,22,50904,26664.52,77568.52
311540,202208,32,28,4,33936,4848,38784
311545,202208,172,121,51,146652.95,61812,208464.95
311547,202208,50,38,12,46056,14544.2,60600.2
311550,202208,676,311,365,376934.61,442382.49,819317.10
311560,202208,43,26,17,31512,20604,52116
311570,202208,292,194,98,236342.48,118776.84,355119.32
311580,202208,425,268,157,324817.06,190284.2,515101.26
311590,202208,28,24,4,29088.2,4848,33936.2
311600,202208,95,79,16,95749.09,19393.2,115142.29
311610,202208,255,220,35,266640.58,42420,309060.58
311615,202208,144,123,21,149076,25452.52,174528.52
311620,202208,31,19,12,23028,14544,37572
311630,202208,102,87,15,105444,18180,123624
311640,202208,133,66,67,79993.2,81206.96,161200.16
311650,202208,132,92,40,111504,48480.24,159984.24
311660,202208,437,200,237,242400,287244.62,529644.62
311670,202208,148,99,49,119989.57,59388.43,179378.00
311680,202208,218,167,51,202404.8,61812.26,264217.06
311690,202208,10,10,0,12120.5,,12120.5
311700,202208,195,144,51,174528.94,61813.32,236342.26
311710,202208,188,128,60,155136.8,72720,227856.8
311720,202208,40,30,10,36360.6,12120,48480.6
311730,202208,572,404,168,489655.49,203616.75,693272.24
311740,202208,26,18,8,21816,9696,31512
311750,202208,735,496,239,601154.97,289668,890822.97
311760,202208,82,36,46,43632,55752.4,99384.4
311770,202208,378,182,196,220584.78,238764,459348.78
311780,202208,197,97,100,117564,121200.2,238764.2
311783,202208,89,81,8,98172.7,9696,107868.7
311787,202208,41,17,24,20604,29088.37,49692.37
311790,202208,263,113,150,136956.2,181800.92,318757.12
311800,202208,739,452,287,547828.55,349056.99,896885.54
311810,202208,51,39,12,47268.7,14544,61812.7
311820,202208,121,93,28,112716.87,33937.14,146654.01
311830,202208,1934,1149,785,1392600.57,955056,2347656.57
311840,202208,1089,610,479,739327.56,580551.6,1319879.16
311850,202208,16,10,6,12120,7272,19392
311860,202208,10313,4391,5922,5326806.38,7188418.19,12515224.57
311870,202208,108,62,46,75145.59,55752.26,130897.85
311880,202208,976,704,272,854465.8,329673.24,1184139.04
311890,202208,201,92,109,111404.53,132108.1,243512.63
311900,202208,66,27,39,32724,47268.05,79992.05
311910,202208,1426,887,539,1075053.61,653273.93,1728327.54
311920,202208,230,150,80,181800.34,98172,279972.34
311930,202208,910,510,400,619339.4,486013.56,1105352.96
311940,202208,2714,1468,1246,1779235.99,1510153.01,3289389.00
311950,202208,163,97,66,117565.64,79994.15,197559.79
311960,202208,65,47,18,56964.2,21816,78780.2
311970,202208,24,13,11,15756,13332,29088
311980,202208,42,31,11,37572,13332,50904
311990,202208,40,27,13,32724,15756.64,48480.64
311995,202208,48,28,20,33936,24240.22,58176.22
312000,202208,24,16,8,19392,9696,29088
312010,202208,76,59,17,71509.49,20604.25,92113.74
312015,202208,80,60,20,72720.69,24240,96960.69
312020,202208,132,94,38,113928.05,46056,159984.05
312030,202208,77,53,24,64236,29088,93324
312040,202208,83,53,30,64236,37572,101808
312050,202208,196,110,86,133320.97,104232,237552.97
312060,202208,20,13,7,15756,8484,24240
312070,202208,81,53,28,64236.62,33936.36,98172.98
312080,202208,565,264,301,319968.2,366024.3,685992.5
312083,202208,71,45,26,54540.2,31512,86052.2
312087,202208,100,75,25,90900.2,30300,121200.2
312090,202208,3420,2077,1343,2519801.72,1627726.46,4147528.18
312100,202208,148,104,44,125769.63,53328.48,179098.11
312110,202208,120,72,48,87264,58176,145440
312120,202208,128,93,35,112717.92,42420,155137.92
312125,202208,84,55,29,66660.28,35148,101808.28
312130,202208,134,88,46,106656.1,55752,162408.1
312140,202208,138,108,30,130897.16,36360,167257.16
312150,202208,39,31,8,37572,9696,47268
312160,202208,1500,1003,497,1215755.45,602365.6,1818121.05
312170,202208,12,8,4,9696,4848,14544
312180,202208,98,67,31,81204.48,37572,118776.48
312190,202208,44,39,5,47268,6060,53328
312200,202208,746,639,107,774479.49,129684.84,904164.33
312210,202208,123,65,58,78780,70297.15,149077.15
312220,202208,135,101,34,122412.4,41208,163620.4
312230,202208,3912,1767,2145,2141626.5,2602172.86,4743799.36
312235,202208,159,105,54,127260,65448,192708
312240,202208,79,57,22,69085.95,26664,95749.95
312245,202208,218,156,62,189074.88,75144.3,264219.18
312247,202208,90,64,26,77568,31512.38,109080.38
312250,202208,176,91,85,110292.89,103020.2,213313.09
312260,202208,105,67,38,81204,46056,127260
312270,202208,137,78,59,94537.77,71508,166045.77
312280,202208,33,17,16,20604,19392,39996
312290,202208,145,97,48,117566.35,58177.55,175743.90
312300,202208,203,133,70,162410.09,84840.1,247250.19
312310,202208,58,51,7,61812,8484,70296
312320,202208,416,256,160,310273.67,193920,504193.67
312330,202208,94,80,14,96960,16968.48,113928.48
312340,202208,34,17,17,20604,20604,41208
312350,202208,13,7,6,8484,7272,15756
312352,202208,95,68,27,82416.6,32724,115140.6
312360,202208,581,249,332,301789.79,403596.2,705385.99
312370,202208,360,196,164,237552.96,198769.49,436322.45
312380,202208,145,95,50,115145.26,60601.12,175746.38
312385,202208,161,134,27,162409.68,32724.29,195133.97
312390,202208,293,187,106,226644.2,128472,355116.2
312400,202208,383,285,98,345421.06,118778.25,464199.31
312410,202208,1223,449,774,544195.91,941730.95,1485926.86
312420,202208,678,516,162,625398.13,196345.23,821743.36
312430,202208,877,638,239,773259.58,289669.46,1062929.04
312440,202208,43,34,9,41208,10908,52116
312450,202208,200,127,73,153924,88476,242400
312460,202208,30,16,14,19392,16968,36360
312470,202208,46,31,15,37572,18180,55752
312480,202208,167,102,65,123624.88,78780.99,202405.87
312490,202208,316,216,100,261794.45,121200.7,382995.15
312500,202208,33,22,11,26664.2,13332,39996.2
312510,202208,632,241,391,292096.33,473897.21,765993.54
312520,202208,28,8,20,9696,24240,33936
312530,202208,37,26,11,31512.6,13332.1,44844.7
312540,202208,87,76,11,92112,13332,105444
312550,202208,35,28,7,33936,8484,42420
312560,202208,202,157,45,190284.57,54540,244824.57
312570,202208,476,282,194,341790.95,235130.8,576921.75
312580,202208,88,50,38,60600,46056,106656
312590,202208,220,174,46,210888.75,55752,266640.75
312595,202208,141,116,25,140592.05,30300,170892.05
312600,202208,76,34,42,41208.4,50904,92112.4
312610,202208,1563,803,760,973247.54,923544.1,1896791.64
312620,202208,230,166,64,201193.4,77568,278761.4
312630,202208,71,58,13,70296,15756,86052
312640,202208,42,11,31,13332,37572,50904
312650,202208,156,131,25,159182.69,30300.1,189482.79
312660,202208,110,81,29,98178.39,35149.2,133327.59
312670,202208,945,604,341,732057.69,413296.08,1145353.77
312675,202208,46,34,12,41208,14544,55752
312680,202208,72,45,27,54540,32724,87264
312690,202208,251,129,122,156349.91,147864.85,304214.76
312695,202208,29,25,4,30300,4848,35148
312700,202208,250,142,108,172107.95,130896,303003.95
312705,202208,83,66,17,79992,20604,100596
312707,202208,131,93,38,112716.64,46056,158772.64
312710,202208,1903,1058,845,1283536.24,1024143.94,2307680.18
312720,202208,48,22,26,26664,31512,58176
312730,202208,267,157,110,190285.67,133322.72,323608.39
312733,202208,48,37,11,44844,13332,58176
312735,202208,22,16,6,19392,7272.8,26664.8
312737,202208,74,41,33,49692.81,39996,89688.81
312738,202208,68,44,24,53328.08,29088,82416.08
312740,202208,76,51,25,61812,30300,92112
312750,202208,106,69,37,83628,44844,128472
312760,202208,282,197,85,238766.37,103020.41,341786.78
312770,202208,8964,4248,4716,5155899.17,5720653.5,10876552.67
312780,202208,445,338,107,409658.22,129684.94,539343.16
312790,202208,21,15,6,18180,7272,25452
312800,202208,1647,1140,507,1381691.73,614487,1996178.73
312810,202208,354,243,111,294517.59,134532,429049.59
312820,202208,190,142,48,172104.2,58176,230280.2
312825,202208,40,29,11,35148,13332,48480
312830,202208,196,108,88,130896.8,106656.49,237553.29
312840,202208,188,131,57,158772,69084,227856
312850,202208,39,36,3,43632,3636,47268
312860,202208,141,94,47,113928,56964,170892
312870,202208,1157,604,553,732055.75,672660,1404715.75
312880,202208,115,83,32,100596.05,38784,139380.05
312890,202208,168,122,46,147865,55752,203617
312900,202208,167,125,42,151501.29,50904,202405.29
312910,202208,175,103,72,124839.41,87264.2,212103.61
312920,202208,130,69,61,83628.2,73932,157560.2
312930,202208,327,223,104,270277.68,126049.46,396327.14
312940,202208,144,99,45,119988,54540,174528
312950,202208,742,514,228,624190.44,276338.11,900528.55
312960,202208,146,106,40,128474.65,48481.03,176955.68
312965,202208,113,91,22,110292.1,26664,136956.1
312970,202208,287,233,54,282400.69,65448.2,347848.89
312980,202208,2691,1379,1312,1672579.85,1592572.19,3265152.04
312990,202208,45,20,25,24240.92,30300,54540.92
313000,202208,53,29,24,35148,29088,64236
313005,202208,184,141,43,170892.4,52116.2,223008.6
313010,202208,985,420,565,509043.62,685994.75,1195038.37
313020,202208,191,101,90,122412,109080,231492
313030,202208,208,135,73,163620.76,88476,252096.76
313040,202208,94,29,65,35148.24,78780,113928.24
313050,202208,207,147,60,178164,72720,250884
313055,202208,41,31,10,37572,12120,49692
313060,202208,148,98,50,118776.6,60600.65,179377.25
313065,202208,59,44,15,53328,18180.6,71508.6
313070,202208,130,69,61,83630.02,73932,157562.02
313080,202208,41,22,19,26664.6,23028,49692.6
313090,202208,684,441,243,536921.25,294516.18,831437.43
313100,202208,213,77,136,93324.85,164832,258156.85
313110,202208,153,86,67,104232.1,81205.72,185437.82
313115,202208,234,125,109,151501.06,132108.1,283609.16
313120,202208,851,488,363,592674.98,439957.75,1032632.73
313130,202208,6071,3322,2749,4027521.83,3339077.93,7366599.76
313140,202208,133,75,58,90900.96,70296,161196.96
313150,202208,297,232,65,281185.07,78780,359965.07
313160,202208,191,145,46,175745.14,55752,231497.14
313170,202208,1408,902,506,1093232.57,614484.69,1707717.26
313180,202208,323,200,123,242405.02,149077.44,391482.46
313190,202208,752,435,317,527223.6,384204.98,911428.58
313200,202208,33,26,7,31512,8484.2,39996.2
313210,202208,1015,871,144,1055676.68,174531.47,1230208.15
313220,202208,302,178,124,216948.19,151500,368448.19
313230,202208,271,205,66,248461.11,79992.54,328453.65
313240,202208,2318,1163,1155,1409567.49,1402285.03,2811852.52
313250,202208,1260,945,315,1145357.13,381783.95,1527141.08
313260,202208,93,43,50,52116,60600,112716
313270,202208,1040,611,429,740537.71,519951.25,1260488.96
313280,202208,47,39,8,47268,9696,56964
313290,202208,228,183,45,221798.57,54540,276338.57
313300,202208,334,166,168,201192.4,204828,406020.4
313310,202208,245,106,139,129684.2,168468.8,298153.0
313320,202208,388,281,107,340574.07,129685.44,470259.51
313330,202208,1470,899,571,1089602.84,692054.12,1781656.96
313340,202208,339,246,93,298153.53,112716.7,410870.23
313350,202208,463,292,171,353905.36,207252,561157.36
313360,202208,190,89,101,107868.8,122412,230280.8
313370,202208,245,86,159,104233.77,193920.25,298154.02
313375,202208,319,189,130,230281.92,158772.2,389054.12
313380,202208,1337,717,620,870224.33,751441.88,1621666.21
313390,202208,56,50,6,60600,7272,67872
313400,202208,407,283,124,343005.66,150289.57,493295.23
313410,202208,100,61,39,73933.06,47268,121201.06
313420,202208,4738,2647,2091,3213062.92,2535512.75,5748575.67
313430,202208,121,61,60,73932,72720.5,146652.5
313440,202208,1396,986,410,1195059.84,496925.56,1691985.40
313450,202208,66,32,34,38784.15,41208,79992.15
313460,202208,395,172,223,208465.64,270276.88,478742.52
313470,202208,519,243,276,294525.17,335727.46,630252.63
313480,202208,167,125,42,151501.86,50904,202405.86
313490,202208,548,250,298,304215.66,362391.82,666607.48
313500,202208,30,16,14,19392,16968,36360
313505,202208,1104,851,253,1032634.82,306639.28,1339274.10
313507,202208,103,67,36,81205.02,43632,124837.02
313510,202208,2922,1814,1108,2198721.45,1345334.15,3544055.60
313520,202208,3485,2705,780,3279736.86,946579.06,4226315.92
313530,202208,36,21,15,25452,18180,43632
313535,202208,85,70,15,84840.45,18180,103020.45
313540,202208,66,47,19,56964,23028,79992
313545,202208,117,99,18,119988.96,21816,141804.96
313550,202208,220,187,33,226644.9,39997.39,266642.29
313560,202208,355,168,187,203618.69,226648.1,430266.79
313570,202208,75,27,48,32724.97,58176,90900.97
313580,202208,1358,794,564,962336.83,685994.22,1648331.05
313590,202208,65,39,26,47268,31512,78780
313600,202208,686,410,276,496923.43,334513.13,831436.56
313610,202208,53,42,11,50905.93,13332,64237.93
313620,202208,1450,696,754,843562.2,913850.74,1757412.94
313630,202208,1662,1261,401,1529566.45,486013.9,2015580.35
313640,202208,120,72,48,87264.79,58176,145440.79
313650,202208,226,118,108,143016.8,130897.17,273913.97
313652,202208,31,30,1,36360,1212,37572
313655,202208,87,56,31,67872.76,37572.88,105445.64
313657,202208,50,45,5,54541.25,6060,60601.25
313660,202208,128,85,43,103021.05,52116.94,155137.99
313665,202208,716,329,387,398753.1,470262.71,869015.81
313670,202208,10837,7421,3416,8998029.22,4142644.07,13140673.29
313680,202208,42,33,9,39996.2,10908,50904.2
313690,202208,135,96,39,116352.1,47268,163620.1
313695,202208,86,67,19,81204.86,23028,104232.86
313700,202208,341,263,78,318759.28,94536.2,413295.48
313710,202208,130,95,35,115141.12,42420.2,157561.32
313720,202208,1194,544,650,659339.3,789018.93,1448358.23
313730,202208,72,40,32,48480,38784,87264
313740,202208,149,114,35,138168.2,42420,180588.2
313750,202208,411,288,123,349057.59,149076,498133.59
313753,202208,233,173,60,209677.12,72720.1,282397.22
313760,202208,1395,543,852,658120.79,1033842.44,1691963.23
313770,202208,419,288,131,349063.11,158773.18,507836.29
313780,202208,861,463,398,561160.12,482377.68,1043537.80
313790,202208,34,34,0,41208,,41208.0
313800,202208,162,101,61,122412.99,73934.35,196347.34
313810,202208,86,50,36,60600,43632,104232
313820,202208,1391,673,718,816894.11,872642.01,1689536.12
313830,202208,52,35,17,43632,20604,64236
313835,202208,64,54,10,65448.2,12120,77568.2
313840,202208,1722,1033,689,1252009.86,836281.7,2088291.56
313850,202208,216,91,125,110292.84,151500,261792.84
313860,202208,473,356,117,431477.2,141804.64,573281.84
313862,202208,179,123,56,149077.33,67872.2,216949.53
313865,202208,180,124,56,150288.61,67872.3,218160.91
313867,202208,58,47,11,56964,13332,70296
313868,202208,47,31,16,37572,19392,56964
313870,202208,86,47,39,56964,47268,104232
313880,202208,388,240,148,290882.67,179376.4,470259.07
313890,202208,337,185,152,224223.67,184224,408447.67
313900,202208,837,452,385,547831.65,467837.44,1015669.09
313910,202208,149,100,49,121200,59388,180588
313920,202208,648,439,209,532069.28,253308.7,785377.98
313925,202208,35,30,5,36360,6060,42420
313930,202208,918,707,211,856897.58,255734.24,1112631.82
313940,202208,1959,1179,780,1428963.37,945363.84,2374327.21
313950,202208,865,531,334,643578.89,404808.6,1048387.49
313960,202208,1482,847,635,1026576.02,770836.76,1797412.78
313970,202208,186,107,79,129684,95748,225432
313980,202208,229,148,81,179378.67,98172.63,277551.30
313990,202208,258,163,95,197556.6,115140,312696.6
314000,202208,873,573,300,694479.29,363600.8,1058080.09
314010,202208,92,55,37,66660,44844.5,111504.5
314015,202208,88,23,65,27876.71,78780.8,106657.51
314020,202208,56,39,17,47268.31,21816,69084.31
314030,202208,73,38,35,46056.7,42420,88476.7
314040,202208,47,26,21,31512,25452,56964
314050,202208,293,166,127,201194.98,153924,355118.98
314053,202208,95,59,36,71508.7,43632,115140.7
314055,202208,305,189,116,229069.56,140592,369661.56
314060,202208,122,105,17,127260.2,20604,147864.2
314070,202208,1088,547,541,662968.43,655698.52,1318666.95
314080,202208,214,135,79,163622.19,95748.84,259371.03
314085,202208,178,125,53,151500.2,64236,215736.2
314090,202208,401,287,114,347846.63,138168,486014.63
314100,202208,528,418,110,506621.88,133321.72,639943.60
314110,202208,778,347,431,420571.99,522375.14,942947.13
314120,202208,67,38,29,46056,35148,81204
314130,202208,24,17,7,20604,8484,29088
314140,202208,1165,737,428,893259.08,518739.6,1411998.68
314150,202208,189,121,68,146653.26,82416,229069.26
314160,202208,311,233,78,282398.73,94536,376934.73
314170,202208,82,64,18,77568.37,21816,99384.37
314180,202208,765,674,91,818115.07,110294.87,928409.94
314190,202208,84,53,31,64236,37572,101808
314200,202208,508,344,164,416940.75,198773.28,615714.03
314210,202208,253,193,60,233916.85,72720.6,306637.45
314220,202208,301,212,89,256947.28,107868.93,364816.21
314225,202208,52,34,18,41209.99,21816,63025.99
314230,202208,120,53,67,64236,81204,145440
314240,202208,174,125,49,152712.2,59388.07,212100.27
314250,202208,59,35,24,42420.82,29088,71508.82
314260,202208,217,105,112,127260.2,135744,263004.2
314270,202208,421,329,92,398754.47,111504.2,510258.67
314280,202208,741,402,339,487172.96,410869.53,898042.49
314290,202208,546,425,121,515102.28,146653.7,661755.98
314300,202208,346,259,87,315123.88,105444,420567.88
314310,202208,1349,932,417,1129900.37,505404.47,1635304.84
314315,202208,45,35,10,42420,12120,54540
314320,202208,594,407,187,493287.77,226646.31,719934.08
314330,202208,11876,5787,6089,7013928.98,7382317.26,14396246.24
314340,202208,639,288,351,349056.35,425418.64,774474.99
314345,202208,57,41,16,49692,19392,69084
314350,202208,182,112,70,135744,84840.66,220584.66
314360,202208,52,30,22,36363.75,26665.05,63028.80
314370,202208,71,51,20,61812,24240,86052
314380,202208,127,73,54,88476.5,65448,153924.5
314390,202208,3465,2241,1224,2717331.6,1484701.85,4202033.45
314400,202208,702,485,217,589039.06,263006.64,852045.70
314410,202208,538,354,184,429049.74,223008.59,652058.33
314420,202208,19,11,8,13332,9696,23028
314430,202208,2489,925,1564,1121112.93,1895588.56,3016701.49
314435,202208,171,96,75,116354.47,90900.08,207254.55
314437,202208,48,36,12,43632,14544,58176
314440,202208,97,63,34,76356.2,41208.1,117564.3
314450,202208,169,117,52,141804,63025.64,204829.64
314460,202208,642,309,333,374511.52,403599.2,778110.72
314465,202208,118,77,41,93324.77,49692,143016.77
314467,202208,77,61,16,73932.1,19392,93324.1
314470,202208,420,210,210,254522.08,255733.76,510255.84
314480,202208,1080,487,593,590251.02,718717.56,1308968.58
314490,202208,39,22,17,26664.74,20604,47268.74
314500,202208,280,196,84,237554.49,101808.45,339362.94
314505,202208,117,76,41,92113.2,49692,141805.2
314510,202208,248,199,49,241190.38,59388,300578.38
314520,202208,1442,755,687,916284.05,832652.96,1748937.01
314530,202208,772,612,160,741763.46,195133.47,936896.93
314535,202208,169,104,65,126048,78780,204828
314537,202208,71,44,27,53328.13,32724,86052.13
314540,202208,17,10,7,12120,8484,20604
314545,202208,62,42,20,50904,24240,75144
314550,202208,71,38,33,46056.67,39997.07,86053.74
314560,202208,882,467,415,566009.19,502983.76,1068992.95
314570,202208,17,14,3,16968.3,3636,20604.3
314580,202208,13,7,6,8484.15,7272,15756.15
314585,202208,27,20,7,24240,8484,32724
314587,202208,86,74,12,89688,14544,104232
314590,202208,591,407,184,493287.87,223008.24,716296.11
314600,202208,986,636,350,770843.66,424204.06,1195047.72
314610,202208,981,499,482,606001.91,584187.27,1190189.18
314620,202208,151,114,37,138168.2,44844,183012.2
314625,202208,99,75,24,90900.19,29088,119988.19
314630,202208,1147,623,524,756302.86,636304.01,1392606.87
314640,202208,86,54,32,65450.06,38784.6,104234.66
314650,202208,159,90,69,109081.29,83628.79,192710.08
314655,202208,64,48,16,59388,19392,78780
314660,202208,19,13,6,15756,7272,23028
314670,202208,221,175,46,212106.63,55753.44,267860.07
314675,202208,212,127,85,154935.29,103020,257955.29
314690,202208,591,316,275,382994.05,333301.15,716295.20
314700,202208,2202,1167,1035,1415637.9,1254423.09,2670060.99
314710,202208,1857,1043,814,1264122.5,987780.83,2251903.33
314720,202208,396,223,173,270277.45,209676.05,479953.50
314730,202208,520,279,241,338148.02,292092,630240.02
314740,202208,786,360,426,436323.87,516314.05,952637.92
314750,202208,20,16,4,19392,4848,24240
314760,202208,361,145,216,175740,263004.8,438744.8
314770,202208,105,71,34,86052,41208,127260
314780,202208,22,9,13,10908,15756,26664
314790,202208,2517,1591,926,1929527.94,1123524.7,3053052.64
314795,202208,65,57,8,69084.1,9696,78780.1
314800,202208,2983,1736,1247,2104045.37,1513791.57,3617836.94
314810,202208,1505,857,648,1038690.05,785376.5,1824066.55
314820,202208,114,68,46,82417.1,55752.1,138169.2
314830,202208,216,180,36,218161.8,43632,261793.8
314840,202208,89,48,41,58176,49692,107868
314850,202208,423,204,219,247248.32,265428,512676.32
314860,202208,647,491,156,595095.19,189072.18,784167.37
314870,202208,1639,863,776,1045967.02,940524.16,1986491.18
314875,202208,62,58,4,70296,4848,75144
314880,202208,41,29,12,35148,14544,49692
314890,202208,51,28,23,33936,27876,61812
314900,202208,26,20,6,24240,7272.92,31512.92
314910,202208,232,154,78,186648.44,94536,281184.44
314915,202208,140,122,18,147864.89,21816.18,169681.07
314920,202208,80,53,27,64236.85,32724,96960.85
314930,202208,1039,488,551,591462.17,669026.15,1260488.32
314940,202208,39,30,9,36360,10908.1,47268.1
314950,202208,23,20,3,24240,3636,27876
314960,202208,28,21,7,25452,8484,33936
314970,202208,174,84,90,101808.43,109080.73,210889.16
314980,202208,307,193,114,233918.1,138168.75,372086.85
314990,202208,457,246,211,298154.02,255733.86,553887.88
314995,202208,152,64,88,77568.8,106656,184224.8
315000,202208,97,73,24,88476.49,29088.9,117565.39
315010,202208,33,21,12,25452,14544,39996
315015,202208,159,125,34,151500.2,41208,192708.2
315020,202208,69,59,10,71508,12120,83628
315030,202208,106,80,26,96960,31512,128472
315040,202208,84,49,35,59388,42420,101808
315050,202208,211,131,80,158772.56,96960.68,255733.24
315053,202208,53,35,18,42420,21816,64236
315057,202208,124,96,28,116352.05,33936,150288.05
315060,202208,67,55,12,67872.88,14544,82416.88
315070,202208,107,63,44,76356.26,53328.17,129684.43
315080,202208,394,310,84,375722.77,101809.07,477531.84
315090,202208,99,57,42,69084.29,50904,119988.29
315100,202208,86,43,43,52116.67,52116,104232.67
315110,202208,276,138,138,167258.38,167256,334514.38
315120,202208,1865,889,976,1078701.59,1184143.63,2262845.22
315130,202208,339,243,96,294516.98,117564.08,412081.06
315140,202208,553,299,254,362389.44,309061.12,671450.56
315150,202208,1004,484,520,586611.79,632708.87,1219320.66
315160,202208,193,100,93,122417.08,112717.84,235134.92
315170,202208,298,195,103,236342.13,124836.6,361178.73
315180,202208,3282,1391,1891,1690759.39,2291901.06,3982660.45
315190,202208,294,181,113,219374.41,136956.15,356330.56
315200,202208,1208,721,487,873868.02,590247.76,1464115.78
315210,202208,1724,1012,712,1227769.23,864158.21,2091927.44
315213,202208,26,15,11,18180.69,13332,31512.69
315217,202208,206,163,43,197556.2,52116,249672.2
315220,202208,1629,1204,425,1459262.83,516318.77,1975581.60
315230,202208,177,136,41,164832.74,49692,214524.74
315240,202208,379,245,134,296945.12,162412.04,459357.16
315250,202208,2675,1274,1401,1546521.27,1704074.94,3250596.21
315260,202208,135,75,60,90900,72720,163620
315270,202208,138,99,39,119988,47268,167256
315280,202208,607,398,209,483599.82,253315.81,736915.63
315290,202208,191,118,73,143016.36,88476.74,231493.10
315300,202208,103,79,24,95748.9,29088,124836.9
315310,202208,83,75,8,90900,9696,100596
315320,202208,145,90,55,109082.53,66660,175742.53
315330,202208,62,48,14,58176,16968,75144
315340,202208,395,284,111,344210.3,134533.2,478743.5
315350,202208,163,103,60,124836,72720,197556
315360,202208,103,46,57,55752,69084.2,124836.2
315370,202208,56,36,20,43633.3,25452.13,69085.43
315380,202208,5,5,0,6060,,6060.0
315390,202208,64,24,40,29088,48481.9,77569.9
315400,202208,806,606,200,734479.96,242401.4,976881.36
315410,202208,309,183,126,221804.91,152715.25,374520.16
315415,202208,61,45,16,54540,19392,73932
315420,202208,196,145,51,175741.15,61812,237553.15
315430,202208,613,337,276,408446,335724,744170
315440,202208,95,63,32,77568.6,38784.6,116353.2
315445,202208,230,189,41,229072.65,49692.37,278765.02
315450,202208,180,130,50,157560,60600,218160
315460,202208,4714,2192,2522,2657957.75,3057898.52,5715856.27
315470,202208,48,20,28,24240,33936,58176
315480,202208,75,23,52,27876.33,63024.3,90900.63
315490,202208,724,456,268,552677.37,324816.55,877493.92
315500,202208,18,17,1,20604,1212,21816
315510,202208,146,101,45,122412,54540,176952
315520,202208,78,67,11,81204,13332,94536
315530,202208,43,25,18,30300,21816.2,52116.2
315540,202208,274,189,85,229070.63,104232.18,333302.81
315550,202208,189,152,37,184225.49,44844,229069.49
315560,202208,723,565,158,684789.77,191498.34,876288.11
315570,202208,310,153,157,185440.06,190285.49,375725.55
315580,202208,764,516,248,625393.87,300576.8,925970.67
315590,202208,193,99,94,119989.4,113928.51,233917.91
315600,202208,335,257,78,311486,94536.78,406022.78
315610,202208,100,46,54,55752,65448,121200
315620,202208,36,29,7,35148.87,8484,43632.87
315630,202208,131,95,36,115140,43632,158772
315640,202208,63,37,26,44844.98,31512.8,76357.78
315645,202208,49,32,17,38784,20604,59388
315650,202208,171,123,48,149076.49,58176,207252.49
315660,202208,440,202,238,244829.47,288459.39,533288.86
315670,202208,2457,1129,1328,1368366.73,1610762.71,2979129.44
315680,202208,777,556,221,673876.26,267852.5,941728.76
315690,202208,684,447,237,541769,287246.38,829015.38
315700,202208,2028,1061,967,1287168.18,1173236.03,2460404.21
315710,202208,365,121,244,146653.25,295728.94,442382.19
315720,202208,515,310,205,375723.23,250884.42,626607.65
315725,202208,200,158,42,191496.87,50904,242400.87
315727,202208,75,42,33,50904.69,39996,90900.69
315730,202208,52,46,6,55752,7272,63024
315733,202208,83,51,32,63024,38784,101808
315737,202208,50,38,12,46056.4,14544,60600.4
315740,202208,31,23,8,27876,9696,37572
315750,202208,164,117,47,141804,56964.82,198768.82
315760,202208,46,34,12,41208,14544,55752
315765,202208,136,78,58,94537.69,70297.81,164835.50
315770,202208,232,153,79,185436.23,95748,281184.23
315780,202208,3938,1934,2004,2345247.75,2430063.55,4775311.30
315790,202208,244,188,56,227857.85,67872.38,295730.23
315800,202208,311,206,105,249673.12,127260,376933.12
315810,202208,60,35,25,42420.84,30300,72720.84
315820,202208,761,562,199,681158.32,241191.37,922349.69
315830,202208,124,79,45,95748.1,54540.7,150288.8
315840,202208,80,53,27,64236,32724,96960
315850,202208,274,181,93,220588.13,112717.77,333305.90
315860,202208,18,6,12,7272,14544,21816
315870,202208,41,31,10,37572,12120,49692
315880,202208,94,63,31,76356,37572,113928
315890,202208,106,76,30,92112.6,36360,128472.6
315895,202208,407,266,141,322398.74,170893.93,493292.67
315900,202208,86,39,47,47268,56964.08,104232.08
315910,202208,46,27,19,32724,23028,55752
315920,202208,156,104,52,126048.3,63024,189072.3
315930,202208,53,17,36,20604.8,43633.38,64238.18
315935,202208,128,102,26,123626.33,31512.23,155138.56
315940,202208,102,76,26,92112,31512,123624
315950,202208,30,21,9,25452,10908.65,36360.65
315960,202208,581,276,305,334515.43,369665,704180.43
315970,202208,31,25,6,30300.92,7272,37572.92
315980,202208,670,339,331,410876.82,401173.3,812050.12
315990,202208,259,146,113,176952.97,136956.48,313909.45
316000,202208,50,31,19,37572.2,23028,60600.2
316010,202208,92,75,17,90901.02,20604,111505.02
316020,202208,107,92,15,111504.49,18180,129684.49
316030,202208,379,217,162,264217.17,196345.55,460562.72
316040,202208,562,228,334,276338.14,406020.2,682358.34
316045,202208,50,45,5,54540,6060,60600
316050,202208,21,15,6,18180,7272,25452
316060,202208,106,73,33,88476.3,39996,128472.3
316070,202208,1206,806,400,976879.72,484803.45,1461683.17
316080,202208,92,61,31,74039.5,37572,111611.5
316090,202208,36,18,18,21816,21816.95,43632.95
316095,202208,85,72,13,87265.84,15756,103021.84
316100,202208,343,190,153,230283.05,185436,415719.05
316105,202208,45,28,17,33937.3,20604,54541.3
316110,202208,1901,1480,421,1793780.85,510260.71,2304041.56
316120,202208,77,51,26,63024,31512,94536
316130,202208,116,86,30,104233.95,36360,140593.95
316140,202208,35,24,11,29088,13332,42420
316150,202208,213,149,64,180588.2,77568.33,258156.53
316160,202208,84,52,32,63024,38784.28,101808.28
316165,202208,80,53,27,64236,32724,96960
316170,202208,186,121,65,146652.1,79992,226644.1
316180,202208,219,86,133,104232.31,161196.8,265429.11
316190,202208,149,108,41,130896,49692,180588
316200,202208,674,367,307,444810.67,372084.29,816894.96
316210,202208,764,514,250,623182.62,303002.59,926185.21
316220,202208,121,76,45,92112.1,54540,146652.1
316225,202208,38,24,14,29088.49,16968,46056.49
316230,202208,41,22,19,26664,23028,49692
316240,202208,662,527,135,638729.89,164834.7,803564.59
316245,202208,167,148,19,179376.76,23028,202404.76
316250,202208,1659,1109,550,1344117.12,666603.96,2010721.08
316255,202208,138,110,28,133320,33936.6,167256.6
316257,202208,181,93,88,112716.2,106656,219372.2
316260,202208,202,138,64,167256.5,77568.2,244824.7
316265,202208,36,24,12,29088.1,14544,43632.1
316270,202208,680,483,197,585400.83,238766.6,824167.43
316280,202208,559,347,212,420568.06,256946.97,677515.03
316290,202208,848,580,268,702972.03,324818.9,1027790.93
316292,202208,608,243,365,294518.63,442381.77,736900.40
316294,202208,109,72,37,87265.13,44844,132109.13
316295,202208,383,180,203,219375.84,246039.02,465414.86
316300,202208,13,9,4,10908,4848,15756
316310,202208,26,14,12,16968,14544,31512
316320,202208,67,33,34,39998.4,41208,81206.4
316330,202208,178,122,56,147864.2,69084,216948.2
316340,202208,140,91,49,110292,59388,169680
316350,202208,193,134,59,162408.59,71508,233916.59
316360,202208,26,15,11,18180,13332,31512
316370,202208,1263,617,646,747813.8,782956.31,1530770.11
316380,202208,119,89,30,107868.5,36360,144228.5
316390,202208,100,73,27,88476,32724,121200
316400,202208,147,112,35,135745.66,42420,178165.66
316410,202208,298,212,86,256944.34,104232.2,361176.54
316420,202208,224,149,75,180590.06,90901.75,271491.81
316430,202208,160,87,73,105444.26,88476,193920.26
316440,202208,77,41,36,49692,43632.97,93324.97
316443,202208,47,39,8,47268.87,9696,56964.87
316447,202208,44,36,8,43633.59,9696,53329.59
316450,202208,235,176,59,213313.1,71508,284821.1
316460,202208,47,15,32,18180.7,38784.2,56964.9
316470,202208,1760,1283,477,1554997.43,578124,2133121.43
316480,202208,11,9,2,10908,2424,13332
316490,202208,20,7,13,8484,15756,24240
316500,202208,162,104,58,126048.76,70296.19,196344.95
316510,202208,140,111,29,134532,35148,169680
316520,202208,191,108,83,130896.85,101809.51,232706.36
316530,202208,168,106,62,128472,75144,203616
316540,202208,163,82,81,99384.77,98172.73,197557.50
316550,202208,153,93,60,112716.72,72720,185436.72
316553,202208,409,196,213,237554.69,258156.97,495711.66
316555,202208,58,52,6,63024.98,7272,70296.98
316556,202208,13,9,4,10908.41,4848,15756.41
316557,202208,29,24,5,29088,6060,35148
316560,202208,73,50,23,60600,27876,88476
316570,202208,206,188,18,227856.92,21816,249672.92
316580,202208,21,16,5,19392,6060,25452
316590,202208,89,75,14,90900.62,16968.6,107869.22
316600,202208,181,149,32,180588,38784,219372
316610,202208,67,48,19,58177.43,23028,81205.43
316620,202208,139,97,42,117564,50904.81,168468.81
316630,202208,48,37,11,44844,13332,58176
316640,202208,23,14,9,16968,10908,27876
316650,202208,98,80,18,96960,21816,118776
316660,202208,6,2,4,2424,4848,7272
316670,202208,445,154,291,186651.07,352692.93,539344.00
316680,202208,163,124,39,150290.09,47268.4,197558.49
316690,202208,171,105,66,127260,79992,207252
316695,202208,57,49,8,59388,9696,69084
316700,202208,23,16,7,19392.79,8484,27876.79
316710,202208,802,610,192,739324.49,232705.79,972030.28
316720,202208,5144,2415,2729,2928222.45,3309974.18,6238196.63
316730,202208,15,15,0,18180,,18180.0
316740,202208,152,94,58,113928,70296,184224
316750,202208,21,12,9,14544,10908,25452
316760,202208,323,260,63,315121.01,76356.49,391477.50
316770,202208,179,92,87,111504,105444,216948
316780,202208,68,39,29,47268.6,35148,82416.6
316790,202208,62,42,20,52116,24240.1,76356.1
316800,202208,1807,1103,704,1336853.37,854473.2,2191326.57
316805,202208,32,23,9,27876,10908,38784
316810,202208,59,35,24,42420.21,29088.7,71508.91
316820,202208,39,22,17,26664,20604,47268
316830,202208,98,45,53,54540.27,64236.12,118776.39
316840,202208,512,305,207,369663.05,250886.48,620549.53
316850,202208,308,211,97,255735.01,117564.01,373299.02
316860,202208,6351,2829,3522,3431220.53,4273526.41,7704746.94
316870,202208,1692,1082,610,1311404.38,739324.91,2050729.29
316880,202208,157,80,77,98172.77,93325.55,191498.32
316890,202208,230,155,75,187861.44,90900.69,278762.13
316900,202208,415,290,125,351482.49,151500,502982.49
316905,202208,24,10,14,12120,16968,29088
316910,202208,80,36,44,43632,53328,96960
316920,202208,142,109,33,132110.36,39996,172106.36
316930,202208,1977,1007,970,1220495.27,1175641.99,2396137.26
316935,202208,966,573,393,694484.66,476321.98,1170806.64
316940,202208,1131,655,476,793866.81,578124.6,1371991.41
316950,202208,188,89,99,107869.03,119988,227857.03
316960,202208,1108,620,488,751455.42,591460.06,1342915.48
316970,202208,651,515,136,624188.08,166046.01,790234.09
316980,202208,83,42,41,50904,49692,100596
316990,202208,2256,1528,728,1851961.9,883550.51,2735512.41
317000,202208,339,264,75,319973.93,90901.68,410875.61
317005,202208,218,151,67,183014.41,81204,264218.41
317010,202208,6852,3884,2968,4711129.6,3599673.87,8310803.47
317020,202208,15991,7005,8986,8491416.64,10897191.37,19388608.01
317030,202208,96,43,53,52116.19,64236,116352.19
317040,202208,3171,2047,1124,2481002.75,1364717.97,3845720.72
317043,202208,78,60,18,72723.83,21816.8,94540.63
317047,202208,38,22,16,26664,19392,46056
317050,202208,147,115,32,139380.8,38784,178164.8
317052,202208,157,128,29,155136.92,35148,190284.92
317057,202208,183,136,47,164833.71,56964,221797.71
317060,202208,64,39,25,47268,30300.2,77568.2
317065,202208,52,39,13,47268,16968,64236
317070,202208,1950,902,1048,1093235.67,1271389.91,2364625.58
317075,202208,96,53,43,64236.37,52116,116352.37
317080,202208,955,492,463,596317.73,562368,1158685.73
317090,202208,706,552,154,669030.77,186651.75,855682.52
317100,202208,434,326,108,395113.88,130896,526009.88
317103,202208,129,100,29,121200.75,35148,156348.75
317107,202208,50,42,8,50904,9696,60600
317110,202208,80,42,38,50904.4,46056.69,96961.09
317115,202208,44,40,4,48480,4848,53328
317120,202208,2122,1034,1088,1253235.13,1321087.34,2574322.47
317130,202208,2108,1412,696,1711352.95,845976.76,2557329.71
317140,202208,14,10,4,12120.1,4848,16968.1
317150,202208,282,167,115,202404.09,139380.71,341784.80
317160,202208,355,263,92,318758.15,111504.46,430262.61
317170,202208,240,158,82,191496.73,99384.3,290881.03
317180,202208,423,288,135,349057.11,163622.46,512679.57
317190,202208,260,186,74,226644.2,89688,316332.2
317200,202208,833,575,258,696914.11,313914.84,1010828.95
317210,202208,184,96,88,116357.54,106656,223013.54
317220,202208,22,11,11,13332,13332,26664
320010,202208,559,399,160,483591.47,195135.04,678726.51
320013,202208,128,84,44,101808.7,53328,155136.7
320016,202208,257,158,99,191497.02,119988,311485.02
320020,202208,745,437,308,529655,373303.7,902958.7
320030,202208,165,114,51,138168.54,61812.44,199980.98
320035,202208,131,94,37,113928.2,44844,158772.2
320040,202208,503,251,252,304215.05,306640.25,610855.30
320050,202208,119,80,39,96963.63,47268.91,144232.54
320060,202208,1865,860,1005,1042333.52,1219281.17,2261614.69
320070,202208,101,64,37,77568.25,44844,122412.25
320080,202208,827,471,356,570862.67,431474.35,1002337.02
320090,202208,1308,834,474,1012032.88,574495.79,1586528.67
320100,202208,343,200,143,243614.01,173318,416932.01
320110,202208,126,76,50,92117.18,60600.2,152717.38
320115,202208,108,92,16,111504,19392,130896
320120,202208,3757,1933,1824,2342831.1,2211932.71,4554763.81
320130,202208,8141,3512,4629,4265089.66,5614056.38,9879146.04
320140,202208,477,303,174,367242.94,210892.07,578135.01
320150,202208,2162,1191,971,1444722.38,1178075.98,2622798.36
320160,202208,649,283,366,343000.47,443594.22,786594.69
320170,202208,109,86,23,104233.09,27876.02,132109.11
320180,202208,58,34,24,41208.83,29088,70296.83
320190,202208,249,146,103,176954.59,124836.2,301790.79
320200,202208,61,50,11,60601.17,13332,73933.17
320210,202208,925,500,425,606012.88,515107.99,1121120.87
320220,202208,306,105,201,128472.2,243612.2,372084.4
320225,202208,78,64,14,77568.07,16968.58,94536.65
320230,202208,704,447,257,541778.65,311489.15,853267.80
320240,202208,3612,1637,1975,1986493.05,2396148.05,4382641.10
320245,202208,520,353,167,427840.77,202409.1,630249.87
320250,202208,231,107,124,129686.8,150290.1,279976.9
320255,202208,124,92,32,111504.6,38784.22,150288.82
320260,202208,263,143,120,173317.15,145441.58,318758.73
320265,202208,146,114,32,138168.25,38784.11,176952.36
320270,202208,160,123,37,149077.42,44845.15,193922.57
320280,202208,1276,705,571,854471.99,692061.62,1546533.61
320290,202208,67,51,16,61812,19392,81204
320300,202208,635,427,208,517537.98,252100.27,769638.25
320305,202208,758,406,352,492085.37,427844.68,919930.05
320310,202208,197,116,81,140594.88,98172.2,238767.08
320313,202208,354,157,197,190286.9,238764.2,429051.1
320316,202208,109,80,29,96960.73,35148,132108.73
320320,202208,3544,1565,1979,1896805.73,2400996.18,4297801.91
320330,202208,279,202,77,244824,93324,338148
320332,202208,802,473,329,573291.24,398761.9,972053.14
320334,202208,286,156,130,189072.22,157561.45,346633.67
320335,202208,145,95,50,116352,60601.06,176953.06
320340,202208,581,409,172,495721.58,208469.41,704190.99
320350,202208,1109,452,657,550258.76,796292.91,1346551.67
320360,202208,176,86,90,104232.08,109080,213312.08
320370,202208,232,172,60,208506.41,72720.6,281227.01
320380,202208,320,222,98,269065.72,118776.89,387842.61
320390,202208,1162,679,483,824169.66,586609.84,1410779.50
320400,202208,320,224,96,271491.59,116352.06,387843.65
320405,202208,997,409,588,496934.2,712668.73,1209602.93
320410,202208,962,476,486,576919.7,589037.28,1165956.98
320420,202208,572,256,316,310282.7,382999.41,693282.11
320425,202208,213,112,101,135744.79,122412.8,258157.59
320430,202208,395,206,189,249676.59,229072.98,478749.57
320435,202208,171,115,56,139381.64,67873.6,207255.24
320440,202208,205,113,92,136957.5,111506.75,248464.25
320450,202208,145,76,69,92112.91,83629.06,175741.97
320455,202208,233,180,53,218160.93,64236,282396.93
320460,202208,299,179,120,216949.56,145440.6,362390.16
320465,202208,116,79,37,95750.04,44844.65,140594.69
320470,202208,736,435,301,527225.48,364819.93,892045.41
320480,202208,207,140,67,169682.27,81204.8,250887.07
320490,202208,3353,1567,1786,1899235.1,2168312.97,4067548.07
320495,202208,122,69,53,83628.1,64236.6,147864.7
320500,202208,10257,4942,5315,5992249.05,6449132.42,12441381.47
320501,202208,566,288,278,350273.59,338156.67,688430.26
320503,202208,318,224,94,271491.62,113929.51,385421.13
320506,202208,269,187,82,226645.84,99384.38,326030.22
320510,202208,1257,535,722,649636.86,876284.96,1525921.82
320515,202208,83,63,20,76356,24240,100596
320517,202208,219,156,63,189074.93,76356,265430.93
320520,202208,7998,3294,4704,3996030.87,5704963.57,9700994.44
320530,202208,7038,3354,3684,4066291.38,4466270.36,8532561.74
330010,202208,3554,1734,1820,2102862.08,2208283.94,4311146.02
330015,202208,204,88,116,106656.74,140592.1,247248.84
330020,202208,4077,1561,2516,1893167.66,3051840.79,4945008.45
330022,202208,268,129,139,156351.28,168468.35,324819.63
330023,202208,815,233,582,282397.33,706607.7,989005.03
330025,202208,773,142,631,172104.2,765993.29,938097.49
330030,202208,1913,1179,734,1431398.96,892039.2,2323438.16
330040,202208,2707,1346,1361,1631374.12,1649547.31,3280921.43
330045,202208,10413,3140,7273,3806947.61,8817381.99,12624329.60
330050,202208,909,566,343,685998.29,415718.53,1101716.82
330060,202208,1184,687,497,833871.05,602371.84,1436242.89
330070,202208,4390,1486,2904,1802277.72,3522108.94,5324386.66
330080,202208,1672,720,952,873863.14,1155050.22,2028913.36
330090,202208,403,222,181,270277.8,219373.81,489651.61
330093,202208,233,97,136,117564.8,166044,283608.8
330095,202208,68,37,31,44844.96,37572,82416.96
330100,202208,11319,5554,5765,6736373.47,6990884.01,13727257.48
330110,202208,468,211,257,256947.48,311486.02,568433.50
330115,202208,534,265,269,321184.33,326028.92,647213.25
330120,202208,405,213,192,258156.86,232704.85,490861.71
330130,202208,1678,435,1243,529654.13,1508962.86,2038616.99
330140,202208,690,356,334,431474.25,404808.7,836282.95
330150,202208,539,316,223,382996.66,270277.29,653273.95
330160,202208,213,123,90,149076.43,109080,258156.43
330170,202208,28114,9591,18523,11637877.61,22474407.61,34112285.22
330180,202208,254,139,115,168469.72,139381.55,307851.27
330185,202208,1143,406,737,493286.21,894464.6,1387750.81
330187,202208,567,169,398,204829.89,483591.78,688421.67
330190,202208,6560,2436,4124,2954885.72,4999543.02,7954428.74
330200,202208,4790,1522,3268,1847116.32,3964497.86,5811614.18
330205,202208,477,269,208,326031.5,252100.11,578131.61
330210,202208,957,570,387,690852.17,470258.74,1161110.91
330220,202208,2921,1694,1227,2056796.91,1488358.32,3545155.23
330225,202208,603,316,287,382999.27,347845.97,730845.24
330227,202208,2494,766,1728,928406.8,2096783.61,3025190.41
330230,202208,264,144,120,174528.95,145440,319968.95
330240,202208,4412,2024,2388,2455551.8,2894292.97,5349844.77
330245,202208,169,77,92,93324.4,111504.46,204828.86
330250,202208,6928,3288,3640,3986373.2,4417789.59,8404162.79
330260,202208,758,203,555,246038.27,672662.04,918700.31
330270,202208,4027,1278,2749,1548957.24,3333034.06,4881991.30
330280,202208,477,281,196,340583.96,237556.65,578140.61
330285,202208,6846,2176,4670,2641001.42,5672259.34,8313260.76
330290,202208,773,263,510,318761.59,619334.45,938096.04
330300,202208,769,467,302,566756.54,366030.42,932786.96
330310,202208,492,277,215,335726.53,260582.04,596308.57
330320,202208,8224,2865,5359,3476095.92,6501251.12,9977347.04
330330,202208,9866,3575,6291,4334175.37,7628397.38,11962572.75
330340,202208,2833,1562,1271,1894368.68,1540461.82,3434830.50
330350,202208,20566,7433,13133,9011399.53,15927127.64,24938527.17
330360,202208,2109,965,1144,1172035.38,1386556.21,2558591.59
330370,202208,1012,515,497,624192.27,604794.96,1228987.23
330380,202208,1024,406,618,493287.84,749020.88,1242308.72
330385,202208,666,331,335,401176.68,406020.34,807197.02
330390,202208,6323,3213,3110,3896631.45,3771784.2,7668415.65
330395,202208,387,246,141,298156.2,170896.9,469053.1
330400,202208,737,361,376,437539.42,455713.52,893252.94
330410,202208,530,379,151,459355.33,183014.83,642370.16
330411,202208,361,192,169,232706.54,204828,437534.54
330412,202208,231,102,129,123625.41,156348.1,279973.51
330414,202208,5561,2138,3423,2594948.8,4152345.25,6747294.05
330415,202208,635,265,370,321187.63,449654.15,770841.78
330420,202208,2543,1305,1238,1582888.69,1504102.77,3086991.46
330430,202208,1873,791,1082,958701.42,1312604.77,2271306.19
330440,202208,379,176,203,213313.74,246036,459349.74
330450,202208,125,55,70,66660.46,84840,151500.46
330452,202208,2472,1006,1466,1219298.78,1779234.21,2998532.99
330455,202208,130235,44268,85967,53680478.54,104279600.74,157960079.28
330460,202208,270,121,149,146652.2,180588.4,327240.6
330470,202208,1286,675,611,819323.76,741754,1561077.76
330475,202208,1899,560,1339,678725.46,1624089.39,2302814.85
330480,202208,811,435,376,527225.55,455715.82,982941.37
330490,202208,16827,5110,11717,6198368.16,14218112.92,20416481.08
330500,202208,1579,665,914,805987.47,1108988.3,1914975.77
330510,202208,11473,3930,7543,4765668.09,9149493.08,13915161.17
330513,202208,104,54,50,65448,60600,126048
330515,202208,729,306,423,370873.78,513895.21,884768.99
330520,202208,2597,879,1718,1067788.77,2082241.29,3150030.06
330530,202208,192,110,82,133321.57,99384.49,232706.06
330540,202208,346,178,168,215737.06,203617.55,419354.61
330550,202208,2936,957,1979,1161106.16,2399784,3560890.16
330555,202208,1033,379,654,461776.57,792651.78,1254428.35
330560,202208,781,260,521,315121.61,631460.46,946582.07
330570,202208,316,220,96,266640.94,116352.43,382993.37
330575,202208,879,323,556,392694.52,673879.72,1066574.24
330580,202208,3499,1813,1686,2197377.04,2045875.08,4243252.12
330590,202208,265,137,128,166045.76,155136,321181.76
330600,202208,1381,810,571,981727.77,692058.87,1673786.64
330610,202208,1694,867,827,1050814.1,1004756.71,2055570.81
330615,202208,230,184,46,223009.78,55753.7,278763.48
330620,202208,1060,412,648,500565.07,785383.29,1285948.36
330630,202208,4675,2737,1938,3320932.33,2348880.5,5669812.83
350010,202208,616,411,205,498143.45,248461.87,746605.32
350020,202208,57,19,38,23028.2,46056,69084.2
350030,202208,568,342,226,414517.58,273916.24,688433.82
350040,202208,117,48,69,58178.68,83630.06,141808.74
350050,202208,365,176,189,213315.23,229069.46,442384.69
350055,202208,130,56,74,67872,89688.2,157560.2
350060,202208,92,41,51,49692.86,61812.8,111505.66
350070,202208,816,462,354,559961.31,431482.8,991444.11
350075,202208,85,51,34,61813.07,41208,103021.07
350080,202208,58,26,32,31512.93,38784.4,70297.33
350090,202208,83,47,36,56965.56,43632,100597.56
350100,202208,282,176,106,214525.43,128472,342997.43
350110,202208,48,31,17,37573.5,20604,58177.5
350115,202208,179,93,86,112716.7,104232.7,216949.4
350120,202208,111,69,42,83630.12,50905.17,134535.29
350130,202208,421,180,241,218168.13,293309.41,511477.54
350140,202208,38,23,15,27876.44,18180.8,46057.24
350150,202208,69,49,20,59388.05,24240.8,83628.85
350160,202208,2436,961,1475,1165955.89,1788918.42,2954874.31
350170,202208,420,245,175,296942.95,213315.52,510258.47
350180,202208,164,91,73,110293.95,88476.81,198770.76
350190,202208,1029,550,479,670253.87,581760.36,1252014.23
350200,202208,58,26,32,31513.34,38784,70297.34
350210,202208,1344,723,621,876297.07,753880.97,1630178.04
350220,202208,640,519,121,629041.06,146653.8,775694.86
350230,202208,69,42,27,50904.84,32724.1,83628.94
350240,202208,63,38,25,46056,30300.95,76356.95
350250,202208,1124,511,613,620557.22,744172.99,1364730.21
350260,202208,100,73,27,88476.73,32724,121200.73
350270,202208,976,648,328,785382.43,397537.62,1182920.05
350275,202208,336,126,210,152714.07,254522.31,407236.38
350280,202208,4523,2163,2360,2625238.29,2863968.54,5489206.83
350290,202208,478,200,278,243614.7,336940.31,580555.01
350300,202208,51,25,26,30302.81,31513.1,61815.91
350310,202208,83,49,34,59388.3,41208.39,100596.69
350315,202208,74,32,42,38784,50904,89688
350320,202208,3500,1637,1863,1985291.87,2261610.87,4246902.74
350330,202208,1687,854,833,1036274.74,1012022.53,2048297.27
350335,202208,21,13,8,15756,9696,25452
350340,202208,126,49,77,59388.7,93326.73,152715.43
350350,202208,99,48,51,58176,61812,119988
350360,202208,104,67,37,81204.6,44844.18,126048.78
350370,202208,89,48,41,58177.46,49692,107869.46
350380,202208,842,350,492,425417.06,596310.12,1021727.18
350390,202208,1826,678,1148,821748.56,1393811.59,2215560.15
350395,202208,20,15,5,18180.14,6060,24240.14
350400,202208,1786,847,939,1026574.93,1138070.19,2164645.12
350410,202208,3135,1282,1853,1553800.37,2248271.76,3802072.13
350420,202208,283,167,116,202406.6,140592.64,342999.24
350430,202208,96,48,48,58177.12,58179.16,116356.28
350440,202208,149,105,44,127262.75,53328.4,180591.15
350450,202208,1790,972,818,1180512.78,991416.93,2171929.71
350460,202208,408,135,273,163622.62,330885.27,494507.89
350470,202208,19,12,7,14544,8484,23028
350480,202208,195,100,95,122417.21,115140.8,237558.01
350490,202208,246,113,133,136956.74,161196,298152.74
350500,202208,57,22,35,26664,42420,69084
350510,202208,151,89,62,107869.78,75144,183013.78
350520,202208,447,241,206,292098.5,249676.35,541774.85
350530,202208,452,215,237,260586.42,287251.43,547837.85
350535,202208,95,63,32,76356.59,38784.58,115141.17
350540,202208,374,194,180,235129.45,218163.21,453292.66
350550,202208,2817,1581,1236,1917423.66,1498037.11,3415460.77
350560,202208,601,407,194,496926.3,236342.58,733268.88
350570,202208,4763,1944,2819,2357360.69,3422710.59,5780071.28
350580,202208,382,180,202,218162.27,244826.75,462989.02
350590,202208,1004,545,459,661762.2,557525.82,1219288.02
350600,202208,6552,3017,3535,3656684.68,4291713.8,7948398.48
350610,202208,1545,792,753,961129.95,912640.44,1873770.39
350620,202208,25,16,9,19392,10908,30300
350630,202208,266,131,135,158773.87,163622.28,322396.15
350635,202208,1227,494,733,599949.24,888407.2,1488356.44
350640,202208,119,86,33,104233.82,39996.2,144230.02
350650,202208,1933,1275,658,1545322.66,798709.11,2344031.77
350660,202208,799,311,488,376935.09,591459.96,968395.05
350670,202208,296,146,150,176952,181800.6,358752.6
350680,202208,166,84,82,101811.17,99385.09,201196.26
350690,202208,209,92,117,111504.1,141804,253308.1
350700,202208,935,437,498,529649.86,603582.85,1133232.71
350710,202208,414,153,261,185438.01,316335.22,501773.23
350715,202208,55,45,10,54540.51,12120,66660.51
350720,202208,16,11,5,13332.62,6060,19392.62
350730,202208,40,26,14,31512,16968,48480
350740,202208,249,134,115,162410.09,139381.85,301791.94
350745,202208,31,14,17,16968.8,20604.2,37573.0
350750,202208,2486,1447,1039,1753798.55,1259277.06,3013075.61
350760,202208,4032,1693,2339,2053159.18,2839732.68,4892891.86
350770,202208,58,37,21,44844,25452,70296
350775,202208,52,38,14,46059.4,16968.49,63027.89
350780,202208,465,231,234,279981.99,283610.03,563592.02
350790,202208,370,154,216,186649.87,261796.18,448446.05
350800,202208,535,320,215,387844.7,260580.41,648425.11
350810,202208,516,396,120,479965.89,145440.95,625406.84
350820,202208,97,55,42,66660.88,50904,117564.88
350830,202208,77,40,37,48481.07,44844,93325.07
350840,202208,822,319,503,386632.11,610960.7,997592.81
350850,202208,1909,985,924,1195047.08,1119890.56,2314937.64
350860,202208,682,356,326,431478.02,395117.88,826595.90
350870,202208,463,305,158,369666.01,191496,561162.01
350880,202208,274,152,122,184224.81,147867.21,332092.02
350890,202208,39,24,15,29088,18180.9,47268.9
350900,202208,1700,523,1177,636308.72,1427755.31,2064064.03
350910,202208,24,12,12,14544,14544,29088
350920,202208,802,412,390,499347.84,472682.43,972030.27
350925,202208,1192,613,579,742969.42,701757.38,1444726.80
350930,202208,120,68,52,82417.12,63024,145441.12
350940,202208,761,394,367,477543.63,444816.35,922359.98
350945,202208,117,84,33,101809.01,39997.02,141806.03
350950,202208,18210,8340,9870,10116711.38,11977055.47,22093766.85
350960,202208,1690,685,1005,830229.61,1218068.99,2048298.60
350970,202208,1116,538,578,651937.94,700547.5,1352485.44
350980,202208,96,65,31,78781.15,37572,116353.15
350990,202208,400,142,258,172106.39,312697.59,484803.98
350995,202208,45,19,26,23029.18,31513.25,54542.43
351000,202208,622,399,223,483601.88,272705.42,756307.30
351010,202208,53,35,18,42420.96,21816.99,64237.95
351015,202208,44,29,15,35149.54,18180,53329.54
351020,202208,1515,899,616,1092023.28,747809.93,1839833.21
351030,202208,347,204,143,247248.43,173316.36,420564.79
351040,202208,1034,552,482,669032.51,584187.19,1253219.70
351050,202208,3743,1692,2051,2051960.94,2487037.78,4538998.72
351060,202208,6191,2238,3953,2713707.22,4795900.13,7509607.35
351070,202208,415,256,159,310279.84,193923.17,504203.01
351080,202208,750,547,203,664186.38,246038.78,910225.16
351090,202208,49,25,24,30300.6,29088,59388.6
351100,202208,422,223,199,270285.52,242406.8,512692.32
351110,202208,2125,963,1162,1167177.47,1408345.5,2575522.97
351120,202208,65,29,36,36360.63,43632,79992.63
351130,202208,198,62,136,75145.95,164834.51,239980.46
351140,202208,324,196,128,237556.33,155136.7,392693.03
351150,202208,509,257,252,312699.41,305425.6,618125.01
351160,202208,304,180,124,218162.21,150288.72,368450.93
351170,202208,236,131,105,158772.02,127260,286032.02
351190,202208,93,57,36,69084.8,43632,112716.8
351200,202208,353,229,124,277550.76,150289.44,427840.20
351210,202208,126,62,64,75144,77568,152712
351220,202208,581,331,250,401180.44,304213.25,705393.69
351230,202208,297,198,99,239982.07,119988.29,359970.36
351240,202208,239,119,120,145442.78,145442.22,290885.00
351250,202208,85,57,28,69086.4,33936.1,103022.5
351260,202208,147,101,46,122412,55752,178164
351270,202208,42,19,23,23028.85,27876,50904.85
351280,202208,1068,499,569,604795.79,689635.22,1294431.01
351290,202208,249,109,140,132108.86,170892.48,303001.34
351300,202208,4093,1713,2380,2078608.65,2889436.6,4968045.25
351310,202208,749,358,391,435120.07,473901.69,909021.76
351320,202208,121,68,53,82416.69,64237.4,146654.09
351330,202208,43,26,17,31512,20604,52116
351340,202208,1436,782,654,949011.2,792651.67,1741662.87
351350,202208,2449,1414,1035,1713788.92,1255640.7,2969429.62
351360,202208,831,386,445,469048.53,539346.28,1008394.81
351370,202208,439,211,228,255737.35,276337.18,532074.53
351380,202208,9121,3920,5201,4755939.1,6310913.36,11066852.46
351385,202208,24,14,10,16968,12120,29088
351390,202208,281,203,78,246038.93,94536.2,340575.13
351400,202208,61,40,21,48480,25452,73932
351410,202208,474,287,187,347850.04,227857.86,575707.90
351420,202208,71,51,20,61812,24240,86052
351430,202208,74,38,36,46056,43632.2,89688.2
351440,202208,815,531,284,643590.55,345424.54,989015.09
351450,202208,284,137,147,166045.95,178165.94,344211.89
351460,202208,143,59,84,71509.67,101809.85,173319.52
351470,202208,146,76,70,92114,86052.98,178166.98
351480,202208,479,282,197,342999.65,238764.2,581763.85
351490,202208,308,114,194,138168.2,235128.55,373296.75
351492,202208,29,18,11,21816,13332,35148
351495,202208,24,17,7,20604,8484,29088
351500,202208,3548,1414,2134,1713783.36,2591270.29,4305053.65
351510,202208,2174,780,1394,945371.3,1690756.71,2636128.01
351512,202208,13,10,3,12120,3636,15756
351515,202208,210,120,90,145442.09,109080,254522.09
351518,202208,712,416,296,504205.06,358765.33,862970.39
351519,202208,88,51,37,61812,44844,106656
351520,202208,169,104,65,126049.67,78801.93,204851.60
351530,202208,23,12,11,14544,13332,27876
351535,202208,138,83,55,100599.13,66660.89,167260.02
351540,202208,484,318,166,385427.3,201195.05,586622.35
351550,202208,1565,919,646,1115059.48,784167.06,1899226.54
351560,202208,80,46,34,55752.25,41208,96960.25
351565,202208,16,8,8,9696.32,9696,19392.32
351570,202208,2893,1309,1584,1587755.12,1921034.09,3508789.21
351580,202208,37,34,3,41208.8,3636,44844.8
351590,202208,69,43,26,52117.34,31512,83629.34
351600,202208,179,128,51,155142.62,61812,216954.62
351610,202208,53,24,29,29088.95,35148,64236.95
351620,202208,6076,3232,2844,3924507.53,3449373.79,7373881.32
351630,202208,3410,1597,1813,1935592.02,2197372.55,4132964.57
351640,202208,2481,1062,1419,1288370,1719838.6,3008208.6
351650,202208,31,25,6,30300,7272,37572
351660,202208,141,88,53,106656.8,64236,170892.8
351670,202208,764,451,313,546622.97,384210.71,930833.68
351680,202208,79,59,20,71508,24240,95748
351685,202208,10,7,3,8484,3636,12120
351690,202208,303,196,107,237555.48,129685.42,367240.90
351700,202208,189,126,63,152973.56,78780,231753.56
351710,202208,67,42,25,50904.8,30300,81204.8
351720,202208,127,72,55,87265.49,66660,153925.49
351730,202208,113,74,39,89688.44,47268,136956.44
351740,202208,814,507,307,615719.89,372086.46,987806.35
351750,202208,381,151,230,183013.09,279973,462986.09
351760,202208,719,551,168,668934.13,203616.23,872550.36
351770,202208,299,239,60,290885.81,72720.68,363606.49
351780,202208,151,92,59,111504.95,71508,183012.95
351790,202208,269,138,131,167257.35,158773.58,326030.93
351800,202208,46,29,17,35148.58,20604,55752.58
351810,202208,123,76,47,92114.06,56964.98,149079.04
351820,202208,775,548,227,664201.84,275128.13,939329.97
351830,202208,658,201,457,243613.6,553886.06,797499.66
351840,202208,2291,1022,1269,1238681.82,1539245.45,2777927.27
351850,202208,251,174,77,210890.03,93324,304214.03
351860,202208,610,404,206,489659.9,250884.86,740544.76
351870,202208,6001,2693,3308,3265211.9,4012995.24,7278207.14
351880,202208,22438,8557,13881,10372409.79,16844468.31,27216878.10
351885,202208,101,52,49,63025.62,59388.67,122414.29
351890,202208,70,47,23,56964,27876,84840
351900,202208,245,130,115,157562.55,139380.69,296943.24
351905,202208,98,46,52,55752.4,63024,118776.4
351907,202208,3798,1527,2271,1853172.15,2757317.35,4610489.50
351910,202208,159,68,91,82416,110293.04,192709.04
351920,202208,110,59,51,71508.1,61812,133320.1
351925,202208,90,55,35,66661.05,42420.41,109081.46
351930,202208,455,288,167,349066.29,202408.37,551474.66
351940,202208,242,99,143,119988.61,173317.36,293305.97
351950,202208,145,76,69,92112.72,83630.42,175743.14
351960,202208,981,470,511,569651.29,620556.13,1190207.42
351970,202208,2177,1028,1149,1245946.77,1395022.3,2640969.07
351980,202208,156,65,91,79995.56,110293.28,190288.84
351990,202208,256,160,96,195134.95,116353.14,311488.09
352000,202208,324,202,122,246042.19,147866.41,393908.60
352010,202208,436,280,156,340666.1,189078.93,529745.03
352020,202208,205,74,131,89688,158772,248460
352030,202208,1217,555,662,673880.56,805990.87,1479871.43
352040,202208,662,251,411,304215.7,499347.23,803562.93
352042,202208,338,82,256,100598.55,310274.6,410873.15
352044,202208,377,214,163,259373.43,197559.09,456932.52
352050,202208,3360,1217,2143,1476232.43,2597322.73,4073555.16
352060,202208,101,60,41,72720,49692.44,122412.44
352070,202208,96,67,29,82419.9,35148,117567.9
352080,202208,68,41,27,49692.01,32724,82416.01
352090,202208,178,113,65,136957.44,78780,215737.44
352100,202208,315,152,163,184225.53,197558.33,381783.86
352110,202208,113,34,79,41208.71,95748,136956.71
352115,202208,66,24,42,29088,50904.2,79992.2
352120,202208,69,47,22,56964,26664,83628
352130,202208,215,162,53,196349.41,65448.57,261797.98
352140,202208,182,82,100,99385.3,121200,220585.3
352150,202208,132,67,65,81205.52,78781.86,159987.38
352160,202208,138,88,50,106658.4,60600.04,167258.44
352170,202208,411,278,133,336938.59,161196.08,498134.67
352180,202208,698,425,273,515110.42,330881.41,845991.83
352190,202208,250,103,147,124837.03,178164.84,303001.87
352200,202208,29,11,18,13332,21816.1,35148.1
352210,202208,4594,1834,2760,2224104.54,3347561.6,5571666.14
352215,202208,77,41,36,49692,43632,93324
352220,202208,6387,2339,4048,2834907.35,4911058.28,7745965.63
352230,202208,3641,2286,1355,2771899.28,1645903.29,4417802.57
352240,202208,2800,1559,1241,1891956,1504100.18,3396056.18
352250,202208,3557,1575,1982,1910132.61,2403399.38,4313531.99
352260,202208,1059,553,506,670247.87,616916.92,1287164.79
352265,202208,65,37,28,44844.93,33936,78780.93
352270,202208,398,218,180,264220.15,218166.58,482386.73
352280,202208,520,307,213,372089.39,258156,630245.39
352290,202208,170,94,76,113929.88,92114.26,206044.14
352300,202208,99,63,36,76358.78,43632.6,119991.38
352310,202208,7407,3161,4246,3833614.16,5149794.13,8983408.29
352320,202208,1188,605,583,735692.54,706599.35,1442291.89
352330,202208,549,280,269,339362.57,326028.09,665390.66
352340,202208,1390,630,760,765994.95,922338.37,1688333.32
352350,202208,376,206,170,249675.25,206045.13,455720.38
352360,202208,222,98,124,118776.83,150288.2,269065.03
352370,202208,122,73,49,88476.77,59388.81,147865.58
352380,202208,113,81,32,98175.2,38784.16,136959.36
352390,202208,2671,1143,1528,1385329.9,1851943.43,3237273.33
352400,202208,564,242,322,293304.1,390265.7,683569.8
352410,202208,939,609,330,739340.26,401187.08,1140527.34
352420,202208,88,65,23,78780.62,27876.37,106656.99
352430,202208,1808,783,1025,949015.9,1242316.74,2191332.64
352440,202208,3547,1619,1928,1962255.87,2340382.63,4302638.50
352450,202208,199,154,45,186648.6,54540.32,241188.92
352460,202208,648,318,330,385418.79,399962.43,785381.22
352470,202208,679,246,433,298155.24,524798.65,822953.89
352480,202208,1655,917,738,1111425.43,894466,2005891.43
352490,202208,54,20,34,24240.6,41208.7,65449.3
352500,202208,1322,530,792,643578.71,959910.46,1603489.17
352510,202208,733,378,355,459356.59,430263.31,889619.90
352520,202208,878,386,492,467837.05,596318.88,1064155.93
352530,202208,1919,967,952,1173233.59,1155045.13,2328278.72
352540,202208,74,50,24,60601.19,29088,89689.19
352550,202208,215,123,92,149077.73,111504.4,260582.13
352560,202208,51,38,13,46057.03,15756.22,61813.25
352570,202208,765,362,403,438757.98,489660.47,928418.45
352580,202208,53,41,12,49693.38,15756,65449.38
352585,202208,21,5,16,6060.6,19392,25452.6
352590,202208,4620,2228,2392,2705219.68,2901549.24,5606768.92
352600,202208,368,256,112,310279.37,135747.8,446027.17
352610,202208,947,423,524,513892.72,635092.65,1148985.37
352620,202208,1148,426,722,516318.42,875071.49,1391389.91
352630,202208,197,74,123,89689.57,149076,238765.57
352640,202208,526,336,190,407240.65,230282.63,637523.28
352650,202208,88,65,23,79992.6,27876,107868.6
352660,202208,66,36,30,43632,36360,79992
352670,202208,1769,920,849,1116271.07,1030200.49,2146471.56
352680,202208,979,580,399,702971.69,483596.48,1186568.17
352690,202208,4784,2066,2718,2505237.19,3302716.48,5807953.67
352700,202208,89,51,38,61813.15,46056,107869.15
352710,202208,1529,777,752,941733.44,912638.1,1854371.54
352720,202208,1591,653,938,792664.31,1136876.05,1929540.36
352725,202208,26,19,7,23028,8484,31512
352730,202208,398,197,201,239978.25,244825.03,484803.28
352740,202208,406,259,147,313915.66,178166.06,492081.72
352750,202208,23,14,9,16968.2,10908.14,27876.34
352760,202208,220,140,80,169681.35,96960.74,266642.09
352770,202208,79,58,21,70296.94,25452.18,95749.12
352780,202208,73,36,37,43632,44844.78,88476.78
352790,202208,25,18,7,21818.05,8484.18,30302.23
352800,202208,242,184,58,224223.71,71508.67,295732.38
352810,202208,162,101,61,122413.3,73933.12,196346.42
352820,202208,48,36,12,43632.7,15756,59388.7
352830,202208,74,50,24,60600.57,29088.01,89688.58
352840,202208,712,309,403,374515.65,489651.16,864166.81
352850,202208,1835,541,1294,656908.26,1569543.52,2226451.78
352860,202208,116,72,44,87264.6,53328.51,140593.11
352870,202208,49,31,18,37573.58,21816.27,59389.85
352880,202208,180,104,76,126050.75,92112.9,218163.65
352885,202208,34,22,12,26664.34,14544,41208.34
352890,202208,55,33,22,39997.18,26664.6,66661.78
352900,202208,4740,2215,2525,2688248.03,3062732.93,5750980.96
352910,202208,38,32,6,38784,7272,46056
352920,202208,651,372,279,450874.42,338152.76,789027.18
352930,202208,1202,555,647,672667.28,785378.13,1458045.41
352940,202208,6438,2417,4021,2930651.17,4877131.29,7807782.46
352950,202208,122,53,69,64237.13,83629.94,147867.07
352960,202208,67,41,26,49692,31512,81204
352965,202208,16,10,6,12120,7272,19392
352970,202208,539,390,149,472689.61,180592.66,653282.27
352980,202208,162,95,67,115143.34,81204.89,196348.23
352990,202208,996,466,530,566015.52,642369.1,1208384.62
353000,202208,58,25,33,30300.2,39996.6,70296.8
353010,202208,527,314,213,380576.38,258158.88,638735.26
353020,202208,336,222,114,270283.36,138168.96,408452.32
353030,202208,1435,623,812,756301.38,986584.68,1742886.06
353040,202208,88,46,42,55752.51,50905.8,106658.31
353050,202208,1350,873,477,1058100.94,578125.01,1636225.95
353060,202208,9344,3981,5363,4829891.07,6502416.57,11332307.64
353070,202208,2013,1166,847,1413217.92,1029985.01,2443202.93
353080,202208,1333,713,620,865379.79,751441.91,1616821.70
353090,202208,65,37,28,44844.6,33936,78780.6
353100,202208,44,33,11,39997.85,13332,53329.85
353110,202208,2314,751,1563,910226.04,1895608.58,2805834.62
353120,202208,141,78,63,94536.2,76356,170892.2
353130,202208,868,411,457,500570.06,555101.77,1055671.83
353140,202208,580,264,316,319976.35,382996.89,702973.24
353150,202208,326,169,157,204831.57,190286.14,395117.71
353160,202208,112,84,28,101811.8,33936.44,135748.24
353170,202208,206,72,134,87264.2,162408.74,249672.94
353180,202208,1240,565,675,686002.58,818105.1,1504107.68
353190,202208,509,360,149,437541,180589.2,618130.2
353200,202208,262,128,134,155138.14,162408.19,317546.33
353205,202208,19,12,7,14544,8484,23028
353210,202208,69,40,29,48480.8,35148.56,83629.36
353215,202208,42,23,19,27876.2,23028,50904.2
353220,202208,84,44,40,53328,48480.6,101808.6
353230,202208,157,66,91,79992.59,110292,190284.59
353240,202208,382,168,214,206040.8,259368,465408.8
353250,202208,188,94,94,113929.28,113928.81,227858.09
353260,202208,463,302,161,366030.4,195136.01,561166.41
353270,202208,73,55,18,66661.11,21816,88477.11
353280,202208,118,50,68,60601.71,82416.36,143018.07
353282,202208,126,87,39,105444.53,47268,152712.53
353284,202208,28,19,9,23028.88,10908,33936.88
353286,202208,9,4,5,4848,6060.6,10908.6
353290,202208,86,46,40,55752,48480,104232
353300,202208,455,225,230,272707.23,278764.84,551472.07
353310,202208,39,32,7,38785.06,8484.6,47269.66
353320,202208,43,26,17,31512.82,20604.6,52117.42
353325,202208,44,25,19,30300.2,23028,53328.2
353330,202208,61,41,20,50904.8,24240.2,75145.0
353340,202208,707,244,463,295730.92,562374.48,858105.40
353350,202208,949,463,486,561164.99,589041.88,1150206.87
353360,202208,106,82,24,99384.7,29088.65,128473.35
353370,202208,109,62,47,75145.06,56964.38,132109.44
353380,202208,30,14,16,16968,19392,36360
353390,202208,1149,528,621,639949.04,752661.81,1392610.85
353400,202208,54,29,25,35148,30301.12,65449.12
353410,202208,119,65,54,78780,65449.2,144229.2
353420,202208,55,25,30,30300,36360,66660
353430,202208,588,385,203,466631.16,247254.08,713885.24
353440,202208,12873,5435,7438,6590915.52,9027008.85,15617924.37
353450,202208,54,27,27,32724.2,32724.2,65448.4
353460,202208,656,331,325,402396.25,393906.67,796302.92
353470,202208,2313,1109,1204,1344138.81,1460464.64,2804603.45
353475,202208,291,182,109,221801.13,132109.2,353910.33
353480,202208,184,145,39,175741.12,47268,223009.12
353490,202208,231,132,99,159986.32,119988.7,279975.02
353500,202208,214,121,93,146653.32,112717.73,259371.05
353510,202208,83,55,28,66661.35,33936.7,100598.05
353520,202208,244,176,68,213313.75,82416.6,295730.35
353530,202208,477,240,237,292097.55,287247.08,579344.63
353540,202208,419,258,161,312703.05,195133.34,507836.39
353550,202208,769,481,288,582986.54,349065.67,932052.21
353560,202208,559,224,335,271489.6,406021.3,677510.9
353570,202208,67,44,23,53329.31,27876,81205.31
353580,202208,351,222,129,270278.73,156348,426626.73
353590,202208,90,64,26,77568.2,31512,109080.2
353600,202208,288,164,124,198771.08,150288.2,349059.28
353610,202208,138,77,61,93326.43,73932,167258.43
353620,202208,691,345,346,420569.84,419356.52,839926.36
353625,202208,57,30,27,36361.38,32724.19,69085.57
353630,202208,225,161,64,196345.8,77568.89,273914.69
353640,202208,125,80,45,96960.74,54540.95,151501.69
353650,202208,1053,409,644,495710.5,781744.69,1277455.19
353657,202208,23,18,5,21816,6060,27876
353660,202208,296,148,148,179379.56,180589.35,359968.91
353670,202208,733,423,310,512685.52,376936.54,889622.06
353680,202208,139,90,49,109080.33,59388,168468.33
353690,202208,45,29,16,35148,19392.19,54540.19
353700,202208,292,201,91,243616.92,110292.9,353909.82
353710,202208,520,246,274,298155.86,332089.22,630245.08
353715,202208,41,24,17,29088,20604,49692
353720,202208,337,151,186,183015.09,226645.41,409660.50
353730,202208,1187,707,480,858108.18,581761.62,1439869.80
353740,202208,615,338,277,409666.34,335727.18,745393.52
353750,202208,80,45,35,54540.89,42420,96960.89
353760,202208,3373,1272,2101,1541696.51,2548865.37,4090561.88
353770,202208,78,62,16,75144.24,19392.2,94536.44
353780,202208,1403,634,769,769628.18,933245.6,1702873.78
353790,202208,504,293,211,355122.89,255734.92,610857.81
353800,202208,3785,1746,2039,2116213.7,2471272.12,4587485.82
353810,202208,241,117,124,141806.97,150289.4,292096.37
353820,202208,257,104,153,126049.8,185436.88,311486.68
353830,202208,65,54,11,65449.28,13332,78781.28
353850,202208,200,89,111,107868.8,134533.68,242402.48
353860,202208,550,242,308,293306.16,374509.95,667816.11
353870,202208,5901,2984,2917,3617931.3,3539059.5,7156990.8
353880,202208,728,471,257,572075.27,313911.47,885986.74
353890,202208,563,321,242,391482.62,293309.64,684792.26
353900,202208,136,72,64,87264.74,78781.63,166046.37
353910,202208,199,77,122,93325.24,147864.26,241189.50
353920,202208,463,243,220,295730,266642.94,562372.94
353930,202208,1072,628,444,761144.68,539341.37,1300486.05
353940,202208,213,101,112,122412.3,135745.05,258157.35
353950,202208,510,322,188,390269.49,229070.44,619339.93
353960,202208,76,62,14,75144.44,16968,92112.44
353970,202208,42,27,15,32725,19393.7,52118.7
353980,202208,1993,876,1117,1062942.1,1355029.2,2417971.3
353990,202208,81,47,34,56965.27,41208,98173.27
354000,202208,394,177,217,214527.52,264220.34,478747.86
354010,202208,92,52,40,63024.91,48480.69,111505.60
354020,202208,533,327,206,397545.84,249675.83,647221.67
354025,202208,36,30,6,36361.54,7272,43633.54
354030,202208,44,22,22,26664.98,26664.15,53329.13
354040,202208,103,75,28,90901.43,33936,124837.43
354050,202208,165,87,78,105445.67,94537.4,199983.07
354060,202208,816,369,447,447229.65,541765.58,988995.23
354070,202208,955,542,413,659340.28,500561.17,1159901.45
354075,202208,182,84,98,101809.97,119989.27,221799.24
354080,202208,311,137,174,166048.88,210888.98,376937.86
354085,202208,22,13,9,15757.41,10908,26665.41
354090,202208,279,165,114,199881.21,139380.82,339262.03
354100,202208,6287,2548,3739,3091868.27,4538997.42,7630865.69
354105,202208,101,51,50,61812.8,60600,122412.8
354110,202208,38,19,19,23028,24240.56,47268.56
354120,202208,151,94,57,113928.89,69084.93,183013.82
354130,202208,765,458,307,556321.67,372086.48,928408.15
354140,202208,3394,1497,1897,1819238.83,2300390.1,4119628.93
354150,202208,651,367,284,444809.35,345423.38,790232.73
354160,202208,681,428,253,519968.16,306642.21,826610.37
354165,202208,11,8,3,10908.49,3636,14544.49
354170,202208,185,121,64,146653.69,77568.2,224221.89
354180,202208,54,31,23,37572.2,27876.85,65449.05
354190,202208,208,81,127,98173.7,153924.05,252097.75
354200,202208,118,56,62,67872.36,76359.06,144231.42
354210,202208,74,30,44,36360,53328,89688
354220,202208,623,386,237,467845.3,287248.66,755093.96
354230,202208,169,75,94,90901.23,113929,204830.23
354240,202208,325,203,122,247252.67,149076.91,396329.58
354250,202208,81,48,33,58176,39996,98172
354260,202208,2234,1030,1204,1248377.15,1460480.6,2708857.75
354270,202208,87,61,26,73932,31512,105444
354280,202208,58,30,28,36360,33936,70296
354290,202208,151,101,50,122413.22,60600.1,183013.32
354300,202208,336,235,101,286036.24,123624.1,409660.34
354310,202208,93,65,28,78783.38,33936,112719.38
354320,202208,227,110,117,133321.16,141804,275125.16
354323,202208,7,5,2,6060,2424,8484
354325,202208,128,67,61,81205.39,73932,155137.39
354330,202208,2530,846,1684,1025188.23,2042224.72,3067412.95
354340,202208,10911,4926,5985,5975024.9,7259936.58,13234961.48
354350,202208,148,98,50,118776.79,60600,179376.79
354360,202208,78,45,33,54542.8,39996,94538.8
354370,202208,229,117,112,141806.08,135746.03,277552.11
354380,202208,174,102,72,123626.37,87264,210890.37
354390,202208,2840,1000,1840,1214436.75,2232518.85,3446955.60
354400,202208,332,180,152,218160.81,184224.94,402385.75
354410,202208,702,305,397,370884.39,483594.22,854478.61
354420,202208,282,191,91,231498.4,110293.08,341791.48
354425,202208,335,183,152,221853.83,184224.59,406078.42
354430,202208,181,96,85,116353.15,103020,219373.15
354440,202208,30,24,6,29088.59,7272,36360.59
354450,202208,56,36,20,43632.26,24240,67872.26
354460,202208,100,57,43,69086.71,52117.11,121203.82
354470,202208,27,14,13,16969.23,15756.35,32725.58
354480,202208,113,63,50,76356.8,60600.75,136957.55
354490,202208,129,71,58,86054.78,70296.9,156351.68
354500,202208,419,185,234,224221.33,284820.82,509042.15
354510,202208,90,61,29,73933.16,35148.9,109082.06
354515,202208,51,17,34,20604.84,41208.1,61812.94
354520,202208,1676,707,969,857933.64,1174428.42,2032362.06
354530,202208,880,427,453,517531.99,550251.07,1067783.06
354540,202208,261,128,133,155137.69,161196.26,316333.95
354550,202208,42,22,20,26664.86,24240,50904.86
354560,202208,159,86,73,104232.7,88476,192708.7
354570,202208,138,94,44,113928,53328,167256
354580,202208,1903,889,1014,1077483.25,1231397.45,2308880.70
354600,202208,286,134,152,162409.79,184224.5,346634.29
354610,202208,64,52,12,63024.99,14544,77568.99
354620,202208,75,20,55,24240,66660.1,90900.1
354625,202208,16,11,5,13332.94,6060,19392.94
354630,202208,344,229,115,277555.04,139382.99,416938.03
354640,202208,864,509,355,618126.06,431476.3,1049602.36
354650,202208,66,38,28,46056.74,33936,79992.74
354660,202208,833,601,232,729645.64,281186.92,1010832.56
354670,202208,228,87,141,105444.2,172104.2,277548.4
354680,202208,1378,476,902,576918.72,1093230.76,1670149.48
354690,202208,80,50,30,60601.7,36360.7,96962.4
354700,202208,78,54,24,65448,29088,94536
354710,202208,51,38,13,47268,15756,63024
354720,202208,19,17,2,20604.2,2424,23028.2
354730,202208,1849,740,1109,899315.58,1346543.89,2245859.47
354740,202208,74,51,23,61812.2,27876,89688.2
354750,202208,416,232,184,281185.67,223011.88,504197.55
354760,202208,533,324,209,392702.36,254526.18,647228.54
354765,202208,7,2,5,2424,6060,8484
354770,202208,359,227,132,276341.52,159986.46,436327.98
354780,202208,8759,3220,5539,3905098.95,6721778.04,10626876.99
354790,202208,88,50,38,60600,46056.11,106656.11
354800,202208,440,233,207,282350.05,250887.01,533237.06
354805,202208,77,37,40,44844.69,48480.7,93325.39
354810,202208,101,56,45,67872,54540,122412
354820,202208,218,87,131,106657.92,158773.62,265431.54
354830,202208,42,23,19,27876,23028,50904
354840,202208,57,38,19,46056,23028,69084
354850,202208,4811,2104,2707,2551294.9,3290607.22,5841902.12
354860,202208,345,157,188,190284.17,227856.7,418140.87
354870,202208,12631,5425,7206,6585006.82,8743410.69,15328417.51
354880,202208,2784,1001,1783,1213226.95,2163491.53,3376718.48
354890,202208,3081,1617,1464,1961040.98,1780437.95,3741478.93
354900,202208,65,46,19,55752.19,23028.19,78780.38
354910,202208,1336,678,658,821746.49,798708.2,1620454.69
354920,202208,39,32,7,38784,8484,47268
354925,202208,24,13,11,15756,13332,29088
354930,202208,32,28,4,33936.31,4848,38784.31
354940,202208,778,539,239,655708.62,289675.01,945383.63
354950,202208,213,129,84,156351.06,101810.05,258161.11
354960,202208,130,49,81,59388.8,98172.59,157561.39
354970,202208,1163,797,366,965982.99,444805.54,1410788.53
354980,202208,9768,3490,6278,4232377.5,7616245.9,11848623.4
354990,202208,10706,4656,6050,5645560.93,7342330.19,12987891.12
354995,202208,611,203,408,246038.15,494500.32,740538.47
355000,202208,458,155,303,187860.95,367236.5,555097.45
355010,202208,654,401,253,486025.86,306641.79,792667.65
355020,202208,818,500,318,606011.85,385419.7,991431.55
355030,202208,223216,82642,140574,100235491.46,170541987.46,270777478.92
355040,202208,982,467,515,567226.82,625397.85,1192624.67
355050,202208,183,98,85,118777.19,103020,221797.19
355060,202208,1849,867,982,1050822.62,1190185.96,2241008.58
355070,202208,1657,723,934,876288.36,1133232.06,2009520.42
355080,202208,204,120,84,145441.98,101809.1,247251.08
355090,202208,313,193,120,233922.57,145443.45,379366.02
355100,202208,5683,2643,3040,3204453.47,3684503.16,6888956.63
355110,202208,230,150,80,181800.3,96960.96,278761.26
355120,202208,54,32,22,38785.4,26664,65449.4
355130,202208,51,28,23,33937.52,27876,61813.52
355140,202208,203,119,84,144229.76,101808.68,246038.44
355150,202208,713,418,295,506625.87,357542.85,864168.72
355160,202208,501,240,261,290884.89,316334.91,607219.80
355170,202208,2138,1088,1050,1318679.27,1273818.02,2592497.29
355180,202208,717,280,437,339365.07,529647.99,869013.06
355190,202208,225,151,74,183016.46,89688.89,272705.35
355200,202208,116,58,58,70296.97,70296.6,140593.57
355210,202208,728,380,348,462987.82,423106.28,886094.10
355220,202208,8012,3788,4224,4592332.89,5129220.69,9721553.58
355230,202208,94,52,42,63024.59,50905.95,113930.54
355240,202208,4784,1900,2884,2305197.04,3502693.43,5807890.47
355250,202208,7177,3143,4034,3813033.84,4891646.6,8704680.44
355255,202208,49,31,18,37572,21816,59388
355260,202208,189,108,81,130898.49,98173.9,229072.39
355270,202208,158,98,60,118777.43,72720.78,191498.21
355280,202208,7353,2702,4651,3278501.61,5644332.19,8922833.80
355290,202208,66,52,14,63024,16968.45,79992.45
355300,202208,233,131,102,158773.34,123624.81,282398.15
355310,202208,115,63,52,76356,64236,140592
355320,202208,94,49,45,59388.06,54540,113928.06
355330,202208,331,190,141,230284.82,173318.2,403603.02
355340,202208,1400,500,900,607229.4,1092045.36,1699274.76
355350,202208,164,76,88,92112,106656.1,198768.1
355360,202208,178,117,61,141808.93,73932,215740.93
355365,202208,17,12,5,14544,6060,20604
355370,202208,1045,617,428,747821.14,518737.16,1266558.30
355380,202208,852,516,336,625410.72,407237.18,1032647.90
355385,202208,93,60,33,73932.15,41208.2,115140.35
355390,202208,105,53,52,64236,63024.97,127260.97
355395,202208,199,104,95,126051.14,115142.67,241193.81
355400,202208,1850,1047,803,1268878.72,974450.33,2243329.05
355410,202208,5305,2383,2922,2890660.13,3543896.95,6434557.08
355420,202208,44,30,14,36360.2,16968,53328.2
355430,202208,428,255,173,309071.06,209681.28,518752.34
355440,202208,90,51,39,61812.2,47269.02,109081.22
355450,202208,458,231,227,279976.9,276337.3,556314.2
355460,202208,56,42,14,50904,16968,67872
355465,202208,52,29,23,35148,27876,63024
355470,202208,199,76,123,92113.43,149076.81,241190.24
355475,202208,8,5,3,6060.79,3636,9696.79
355480,202208,637,249,388,301797.87,470261.13,772059.00
355490,202208,111,78,33,94539.3,39997.62,134536.92
355495,202208,94,35,59,42420,71508.91,113928.91
355500,202208,1620,860,760,1045973.79,921125.5,1967099.29
355510,202208,280,192,88,232713.05,106658,339371.05
355520,202208,26,19,7,23028.18,8484,31512.18
355530,202208,21,10,11,12120,13332,25452
355535,202208,77,35,42,42420.66,50904,93324.66
355540,202208,2862,1107,1755,1342927.85,2128304.01,3471231.86
355550,202208,64,38,26,46056,31512,77568
355560,202208,253,115,138,139384.04,167259.05,306643.09
355570,202208,15,10,5,12120,6060,18180
355580,202208,241,164,77,198771.71,93325.78,292097.49
355590,202208,19,11,8,13332,9696,23028
355600,202208,284,138,146,167256.31,176953.3,344209.61
355610,202208,246,149,97,181804.4,117566.19,299370.59
355620,202208,1321,568,753,688423.03,912637.73,1601060.76
355630,202208,426,303,123,367243.83,149077.3,516321.13
355635,202208,127,52,75,63024,90900.6,153924.6
355640,202208,585,310,275,375721.92,333303.75,709025.67
355645,202208,915,326,589,395117.38,716300.4,1111417.78
355650,202208,1937,828,1109,1003544.75,1344109.99,2347654.74
355660,202208,229,120,109,145442.31,132109.48,277551.79
355670,202208,668,277,391,336937.98,473892.7,810830.68
355680,202208,213,120,93,145441.62,112717.03,258158.65
355690,202208,94,48,46,58176.1,55752,113928.1
355695,202208,28,18,10,21816,12120,33936
355700,202208,1256,615,641,747810.18,776896.91,1524707.09
355710,202208,2348,1278,1070,1550182.14,1298054.49,2848236.63
355715,202208,16,14,2,16968,2424,19392
355720,202208,267,165,102,199981.53,123625.79,323607.32
355730,202208,110,67,43,81204.59,52116.15,133320.74
410010,202208,113,89,24,109082.45,29088,138170.45
410020,202208,119,86,33,104232.88,39996,144228.88
410030,202208,170,95,75,115141.33,92114.49,207255.82
410040,202208,1366,652,714,790229.53,869013.73,1659243.26
410045,202208,45,33,12,39996.59,14544,54540.59
410050,202208,530,309,221,374509.28,267852.74,642362.02
410060,202208,287,204,83,247251.68,101808,349059.68
410070,202208,290,243,47,295734.59,56964.24,352698.83
410080,202208,183,111,72,134532.2,87264,221796.2
410090,202208,59,49,10,59389.53,12120,71509.53
410100,202208,261,166,95,201192.2,115140,316332.2
410105,202208,50,29,21,35148,25452,60600
410110,202208,350,209,141,253313.39,170895.79,424209.18
410115,202208,46,27,19,33936.89,23028,56964.89
410120,202208,462,212,250,256947.6,304215.6,561163.2
410130,202208,63,36,27,43632,32724,76356
410140,202208,3262,1475,1787,1788925.79,2167071.69,3955997.48
410150,202208,2725,1080,1645,1310190.16,1994963.33,3305153.49
410160,202208,497,281,216,340575.11,261794.67,602369.78
410165,202208,53,31,22,37572,26664,64236
410170,202208,211,121,90,146652.2,109080,255732.2
410180,202208,2366,1247,1119,1513810.92,1357459.82,2871270.74
410185,202208,34,28,6,33936,7272,41208
410190,202208,489,311,178,376933.84,215736,592669.84
410200,202208,1045,732,313,887193.7,379356.1,1266549.8
410210,202208,644,330,314,399962.84,380570.42,780533.26
410220,202208,48,20,28,24240,33936,58176
410230,202208,191,87,104,105445.49,126048.4,231493.89
410240,202208,726,464,262,562378.12,317545.15,879923.27
410250,202208,378,263,115,318758.56,139381.78,458140.34
410260,202208,305,169,136,204829.61,166045.56,370875.17
410270,202208,28,19,9,23028,10908,33936
410275,202208,61,45,16,54540,19392,73932
410280,202208,328,192,136,232708.51,164832.35,397540.86
410290,202208,272,154,118,186649.56,143017.24,329666.80
410300,202208,88,54,34,65448,41208,106656
410302,202208,26,14,12,16968,14544,31512
410304,202208,43,30,13,36360,15756,52116
410305,202208,224,131,93,158773.68,112716.8,271490.48
410310,202208,183,108,75,130896.35,90900.2,221796.55
410315,202208,40,31,9,37572.2,10908,48480.2
410320,202208,139,94,45,113928.54,54540,168468.54
410322,202208,36,23,13,27876,15756,43632
410330,202208,175,112,63,135745.2,76356.2,212101.4
410335,202208,99,54,45,65448,54540,119988
410337,202208,47,36,11,43632,13332,56964
410340,202208,39,32,7,38785,8484,47269
410345,202208,197,117,80,141804.98,96960.8,238765.78
410347,202208,44,31,13,37572.14,15756,53328.14
410350,202208,246,143,103,173317.29,124836,298153.29
410360,202208,453,279,174,338152.43,210888.93,549041.36
410370,202208,2386,1016,1370,1232620.54,1662874.11,2895494.65
410380,202208,192,112,80,135744.89,96960.72,232705.61
410390,202208,406,259,147,313910.47,178164.64,492075.11
410395,202208,33,21,12,25452.85,14544.8,39997.65
410400,202208,903,374,529,454505.59,641153.64,1095659.23
410405,202208,82,62,20,75145.93,24240.74,99386.67
410410,202208,25,17,8,20604.51,9696,30300.51
410420,202208,1796,798,998,968286.77,1209586.94,2177873.71
410425,202208,199,83,116,100596.93,140592.2,241189.13
410430,202208,2466,1286,1180,1559859.57,1430177.64,2990037.21
410440,202208,355,248,107,300576,129684.25,430260.25
410442,202208,359,222,137,269067.88,166045.16,435113.04
410445,202208,359,244,115,296941.26,141805.37,438746.63
410450,202208,383,180,203,218161.52,246036.07,464197.59
410460,202208,567,291,276,352694.87,334513.02,687207.89
410465,202208,269,143,126,173316.2,152713.34,326029.54
410470,202208,226,133,93,161197.35,112716.65,273914.00
410480,202208,6787,3254,3533,3943899.96,4284459.38,8228359.34
410490,202208,1433,801,632,970824.8,765992.37,1736817.17
410500,202208,272,155,117,189072.79,141804.5,330877.29
410510,202208,193,142,51,172109.2,61814.53,233923.73
410520,202208,280,194,86,235128.31,104232,339360.31
410530,202208,289,88,201,106656,243612,350268
410540,202208,339,246,93,298152.7,112716,410868.7
410550,202208,1723,712,1011,864162.81,1225337.64,2089500.45
410560,202208,173,113,60,136956.85,72720.59,209677.44
410570,202208,447,292,155,353907.51,187860.97,541768.48
410580,202208,3843,1580,2263,1914977.23,2744004.76,4658981.99
410590,202208,432,277,155,335705.46,187860.2,523565.66
410600,202208,95,82,13,99385.4,15756,115141.4
410610,202208,56,45,11,54540.61,13332,67872.61
410620,202208,275,174,101,210889.54,123625.2,334514.74
410630,202208,462,255,207,309064.01,250884,559948.01
410640,202208,1173,733,440,888403.5,533281.91,1421685.41
410645,202208,114,85,29,103022.51,35148,138170.51
410650,202208,384,234,150,283608.3,181801.72,465410.02
410655,202208,88,64,24,77568.35,29088.08,106656.43
410657,202208,35,13,22,15756,27876,43632
410660,202208,656,437,219,529654.29,265430.97,795085.26
410670,202208,79,63,16,76356.69,19392.6,95749.29
410680,202208,191,151,40,183012.56,48480,231492.56
410685,202208,35,24,11,29088,13332,42420
410690,202208,29485,12105,17380,14685961.03,21090211.13,35776172.16
410700,202208,329,240,89,291143.81,107868,399011.81
410710,202208,128,106,22,128472.18,26664.2,155136.38
410712,202208,42,30,12,36360,14544,50904
410715,202208,105,76,29,92112.27,35148,127260.27
410720,202208,648,360,288,436321.92,349057.28,785379.20
410725,202208,194,135,59,164832.28,71508,236340.28
410730,202208,106,46,60,55753.32,72720,128473.32
410740,202208,95,69,26,83629.33,31512.8,115142.13
410750,202208,286,186,100,225433.23,121200,346633.23
410752,202208,21,14,7,16968,8484,25452
410753,202208,61,23,38,27876,46056.12,73932.12
410754,202208,55,27,28,32724.65,33936,66660.65
410755,202208,77,40,37,48480.2,44844,93324.2
410760,202208,785,425,360,515101.21,436323.18,951424.39
410765,202208,1954,868,1086,1054460.85,1317468.37,2371929.22
410770,202208,123,84,39,103021.41,47269.05,150290.46
410773,202208,70,47,23,56965.02,27876,84841.02
410775,202208,182,131,51,158774.87,61812,220586.87
410780,202208,83,46,37,55752.26,44844,100596.26
410785,202208,54,45,9,54540,10908,65448
410790,202208,90,37,53,44844.8,64236,109080.8
410800,202208,295,183,112,221799.86,135745.14,357545.00
410810,202208,32,17,15,20604.16,18181.24,38785.40
410820,202208,151,106,45,128473.47,54540,183013.47
410830,202208,9343,3845,5498,4662627.27,6678170.48,11340797.75
410832,202208,115,74,41,89688.56,49692.36,139380.92
410840,202208,1434,763,671,924768.3,815681.09,1740449.39
410845,202208,59,34,25,41208.2,30300.49,71508.69
410850,202208,157,114,43,140594.41,52116,192710.41
410855,202208,78,70,8,84840.32,9696,94536.32
410860,202208,841,417,424,505407.91,513891.84,1019299.75
410865,202208,95,65,30,78781.13,36360,115141.13
410870,202208,143,115,28,139380.76,33936,173316.76
410880,202208,1205,584,621,710241.8,752655.5,1462897.3
410890,202208,107,65,42,78781.98,50904,129685.98
410895,202208,78,58,20,70296.35,24240.95,94537.30
410900,202208,32,23,9,27876,10908,38784
410910,202208,13,7,6,8484,7272,15756
410920,202208,41,25,16,30300,19392,49692
410930,202208,557,333,224,403598.79,271488.97,675087.76
410940,202208,4523,2308,2215,2798565.53,2687035.48,5485601.01
410950,202208,103,79,24,95750.02,29088.36,124838.38
410960,202208,949,365,584,442389.34,707816.41,1150205.75
410965,202208,63,40,23,48480,27876,76356
410970,202208,618,413,205,500562.69,248461.7,749024.39
410975,202208,121,75,46,90901.95,55752,146653.95
410980,202208,1659,743,916,901741.01,1111411.44,2013152.45
410990,202208,270,199,71,242400.77,86052.98,328453.75
411000,202208,62,34,28,41208.83,33937.18,75146.01
411005,202208,35,28,7,33936,8484,42420
411007,202208,252,144,108,174528,130896,305424
411010,202208,607,391,216,473898.01,261793.61,735691.62
411020,202208,293,180,113,218161.71,136956.77,355118.48
411030,202208,23,12,11,14544,13332,27876
411040,202208,60,38,22,46056.48,26664,72720.48
411050,202208,218,152,66,184224.2,79992.03,264216.23
411060,202208,554,375,179,454504.26,216948.61,671452.87
411065,202208,31,29,2,35149.14,2424,37573.14
411070,202208,1288,726,562,881133.03,683573.11,1564706.14
411080,202208,249,170,79,206040.03,95748.2,301788.23
411090,202208,89,64,25,77568.99,30300.96,107869.95
411095,202208,360,114,246,138168.7,299364.37,437533.07
411100,202208,108,85,23,103021.12,27876,130897.12
411110,202208,135,78,57,94536,69084.2,163620.2
411120,202208,207,135,72,163621.63,87264,250885.63
411125,202208,328,156,172,189072.9,208468.15,397541.05
411130,202208,118,100,18,121201.77,21816,143017.77
411140,202208,205,142,63,173316.19,77568,250884.19
411150,202208,1266,809,457,980514.84,556312.24,1536827.08
411155,202208,121,85,36,103020,43632,146652
411160,202208,34,13,21,15756,25452,41208
411170,202208,54,46,8,55752,9696,65448
411180,202208,1033,670,363,812056.45,439959.82,1252016.27
411190,202208,343,186,157,225432.63,190284,415716.63
411200,202208,675,367,308,444810.38,373298.74,818109.12
411210,202208,682,349,333,422990.83,406020.9,829011.73
411220,202208,160,112,48,135746.31,58176.8,193923.11
411230,202208,35,28,7,33936,8484.1,42420.1
411240,202208,112,69,43,83629.36,52116,135745.36
411250,202208,427,303,124,367237.44,150288.14,517525.58
411260,202208,14,10,4,12120,4848,16968
411270,202208,265,136,129,164836.28,156349.14,321185.42
411275,202208,186,158,28,191497.17,33936,225433.17
411280,202208,258,172,86,209678.73,104232,313910.73
411290,202208,66,52,14,63024.2,16968,79992.2
411295,202208,124,95,29,115142.01,35148.47,150290.48
411300,202208,81,39,42,47268,50904,98172
411310,202208,95,69,26,83628,31512,115140
411320,202208,833,514,319,622973.1,386630.79,1009603.89
411325,202208,65,45,20,54540.1,24240,78780.1
411330,202208,933,600,333,727217.14,403598.91,1130816.05
411340,202208,34,24,10,29088,12120,41208
411342,202208,59,44,15,53328,18180,71508
411345,202208,102,50,52,60600.44,63024.39,123624.83
411350,202208,521,386,135,467833.9,163622.22,631456.12
411360,202208,62,41,21,49693.06,25453.12,75146.18
411370,202208,14039,5692,8347,6902441.42,10136028.85,17038470.27
411373,202208,183,122,61,147864,73932,221796
411375,202208,81,66,15,79993.14,18180,98173.14
411380,202208,78,52,26,63024.95,31512.2,94537.15
411390,202208,149,80,69,96960,83628,180588
411400,202208,358,237,121,287252.35,146652,433904.35
411410,202208,522,240,282,292095,341784.33,633879.33
411420,202208,982,405,577,490864.34,701750.61,1192614.95
411430,202208,541,284,257,344214.68,311489.98,655704.66
411435,202208,29,20,9,24240,10908,35148
411440,202208,484,379,105,459349.35,127260,586609.35
411450,202208,404,329,75,398753.89,92112.09,490865.98
411460,202208,817,306,511,370875.4,619335.17,990210.57
411470,202208,106,72,34,87267.23,42420,129687.23
411480,202208,717,362,355,439963.98,430263.39,870227.37
411490,202208,280,172,108,208465.69,130896,339361.69
411500,202208,105,83,22,101808.2,27876,129684.2
411510,202208,231,178,53,216950.41,64236.35,281186.76
411520,202208,6444,2208,4236,2677330.72,5141336.57,7818667.29
411530,202208,125,83,42,100596.18,50904,151500.18
411535,202208,46,14,32,16968.1,38784,55752.1
411540,202208,383,252,131,306638.03,158774.23,465412.26
411545,202208,60,44,16,53328.19,19392,72720.19
411550,202208,91,70,21,84840,25452,110292
411560,202208,397,164,233,198768.4,282396,481164.4
411570,202208,991,330,661,401176.43,801142.59,1202319.02
411573,202208,27,16,11,19392.2,13332,32724.2
411575,202208,311,189,122,229070.13,147864,376934.13
411580,202208,1284,452,832,547828.37,1008388.78,1556217.15
411585,202208,75,37,38,44844,46056,90900
411590,202208,16,10,6,12120.2,7272,19392.2
411600,202208,18,8,10,9696.2,12120.7,21816.9
411605,202208,176,68,108,82416.51,130896,213312.51
411610,202208,239,149,90,180590.01,109080.2,289670.21
411620,202208,393,186,207,225436.8,250889.09,476325.89
411630,202208,47,33,14,39996.2,16968.99,56965.19
411640,202208,32,22,10,26664,12120,38784
411650,202208,7,4,3,4848,3636,8484
411660,202208,42,30,12,36360,14544,50904
411670,202208,233,161,72,195134.53,88476,283610.53
411680,202208,160,127,33,153924.2,39996,193920.2
411690,202208,647,329,318,399960.61,385418.87,785379.48
411695,202208,65,45,20,55752.2,24240,79992.2
411700,202208,141,112,29,135746.61,35148,170894.61
411705,202208,101,66,35,79993.75,42420.3,122414.05
411710,202208,295,199,96,241188.84,117564.95,358753.79
411720,202208,149,98,51,118776.96,61812.2,180589.16
411721,202208,90,70,20,84840,24240,109080
411722,202208,106,50,56,60600,67872,128472
411725,202208,166,119,47,144228,56964,201192
411727,202208,99,79,20,95748.98,24240.2,119989.18
411729,202208,51,37,14,44844.65,16968,61812.65
411730,202208,571,361,210,437899.06,254521.91,692420.97
411740,202208,27,16,11,19392,13332.12,32724.12
411745,202208,67,51,16,61812,19392,81204
411750,202208,843,342,501,414506.53,608425.37,1022931.90
411760,202208,1258,896,362,1085979.84,439962.95,1525942.79
411770,202208,422,273,149,330877.88,180589.2,511467.08
411780,202208,375,243,132,294517.31,159984.21,454501.52
411790,202208,597,339,258,410872.35,313908,724780.35
411800,202208,155,114,41,138168.32,49692.38,187860.70
411810,202208,181,136,45,164832.8,54540.89,219373.69
411820,202208,2557,1006,1551,1220512.14,1881048.68,3101560.82
411830,202208,16,13,3,15756,3636,19392
411840,202208,2204,1290,914,1568343.37,1110206.83,2678550.20
411845,202208,64,22,42,26664.9,50904,77568.9
411850,202208,1269,673,596,815687.74,722357.18,1538044.92
411860,202208,58,35,23,42420.81,27876,70296.81
411870,202208,69,43,26,52116,31512,83628
411880,202208,417,245,172,296945.45,208464.26,505409.71
411885,202208,111,70,41,84840.4,49694.02,134534.42
411890,202208,324,224,100,271490.65,121200.97,392691.62
411900,202208,109,78,31,94536.18,37572,132108.18
411910,202208,204,139,65,168468.84,78781.15,247249.99
411915,202208,2443,952,1491,1153839.59,1810753.28,2964592.87
411920,202208,108,83,25,100597.23,30300.98,130898.21
411925,202208,18,11,7,13332.59,8484,21816.59
411930,202208,792,540,252,656185.56,305426.1,961611.66
411940,202208,613,383,230,464200.1,278760.7,742960.8
411950,202208,1211,541,670,655702.57,813266.01,1468968.58
411960,202208,1151,713,438,864163.74,530856.49,1395020.23
411965,202208,23,14,9,16968.5,10908.52,27877.02
411970,202208,89,76,13,92113.57,15756,107869.57
411980,202208,225,117,108,141804,130896,272700
411990,202208,5308,2809,2499,3406568.71,3031340.38,6437909.09
411995,202208,618,177,441,214527.29,534502.61,749029.90
412000,202208,331,215,116,260583.36,140594.44,401177.80
412010,202208,57,31,26,37572.13,32724,70296.13
412015,202208,37,29,8,35148.1,9696,44844.1
412020,202208,23,18,5,21816.2,6060,27876.2
412030,202208,37,34,3,41208,3636,44844
412033,202208,50,27,23,32725.4,27876,60601.4
412035,202208,71,45,26,54540,31512,86052
412040,202208,34,16,18,19392.6,21816,41208.6
412050,202208,221,161,60,195134.04,72720.76,267854.80
412060,202208,794,568,226,688424.2,273914.4,962338.6
412065,202208,58,30,28,36360,33936,70296
412070,202208,165,117,48,141805.6,58176,199981.6
412080,202208,338,160,178,193921.79,215738.27,409660.06
412085,202208,40,15,25,18180,30300,48480
412090,202208,859,518,341,627822.35,413293.61,1041115.96
412100,202208,259,216,43,261798.54,53328.83,315127.37
412110,202208,76,56,20,67873.2,24240,92113.2
412120,202208,357,191,166,232707.52,201193.04,433900.56
412125,202208,72,41,31,49692.2,37572,87264.2
412130,202208,48,30,18,36360.74,21816,58176.74
412135,202208,30,18,12,21816,14544,36360
412140,202208,449,289,160,350269.04,193921.19,544190.23
412150,202208,245,154,91,186648.45,110293.5,296941.95
412160,202208,78,51,27,61812,33936,95748
412170,202208,717,472,245,572066.18,298153.8,870219.98
412175,202208,41,27,14,32724.15,16968.08,49692.23
412180,202208,166,122,44,147864.8,53328.2,201193.0
412190,202208,334,261,73,316335.27,88476,404811.27
412200,202208,190,113,77,136956.15,93324,230280.15
412210,202208,96,72,24,87264,29088.73,116352.73
412215,202208,241,162,79,196344.97,95749.67,292094.64
412217,202208,66,51,15,61813.13,18180,79993.13
412220,202208,847,552,295,670245.94,357547.33,1027793.27
412230,202208,272,164,108,198770.4,130899.82,329670.22
412240,202208,1376,679,697,822956.35,844769.82,1667726.17
412250,202208,404,245,159,296941.01,192708,489649.01
412260,202208,125,79,46,95749.56,55752.2,151501.76
412265,202208,166,124,42,150288.83,50904,201192.83
412270,202208,92,57,35,69084.2,42420,111504.2
412280,202208,78,60,18,72720,21816,94536
412290,202208,90,55,35,66660.46,42420,109080.46
412300,202208,202,145,57,175740.2,69084,244824.2
412310,202208,55,42,13,50905.44,15756,66661.44
412320,202208,90,70,20,84841.32,24240,109081.32
412330,202208,200,153,47,185437.59,56964,242401.59
412340,202208,175,113,62,136956.98,75144,212100.98
412350,202208,671,299,372,362389.13,450866.25,813255.38
412360,202208,21,18,3,21816,3636,25452
412370,202208,142,117,25,141804.8,30300,172104.8
412380,202208,191,145,46,175741,55752,231493
412382,202208,63,33,30,39996.2,36360,76356.2
412385,202208,154,110,44,133320.5,53328,186648.5
412390,202208,322,244,78,295733.83,94537.91,390271.74
412395,202208,67,53,14,64236,16968,81204
412400,202208,101,66,35,79993.72,42420,122413.72
412402,202208,237,127,110,153924.6,133320,287244.6
412405,202208,970,317,653,386629.78,791436,1178065.78
412410,202208,1002,592,410,718139.2,498136.43,1216275.63
412420,202208,17,17,0,20604,,20604.0
412430,202208,25,23,2,27876.2,2424,30300.2
412440,202208,660,324,336,395116.73,407232.54,802349.27
412450,202208,69,60,9,72720.3,10908,83628.3
412460,202208,74,52,22,63024.4,26664,89688.4
412470,202208,218,172,46,208467.44,55752.11,264219.55
412480,202208,153,108,45,130897.34,54540.2,185437.54
412490,202208,169,144,25,174528.45,30300,204828.45
412500,202208,401,315,86,381786.03,104233.28,486019.31
412510,202208,172,140,32,169681.79,38784.1,208465.89
412520,202208,89,58,31,70296,37572,107868
412530,202208,107,52,55,63024.32,66660,129684.32
412535,202208,71,54,17,65448.87,20604.96,86053.83
412540,202208,45,24,21,29088,25452.23,54540.23
412545,202208,79,53,26,64237.14,31512,95749.14
412550,202208,4197,1707,2490,2070130.12,3020341.71,5090471.83
412555,202208,10,6,4,7272,4848,12120
412560,202208,674,446,228,540556.23,276336.2,816892.43
412570,202208,829,384,445,465409.99,539343.01,1004753.00
412575,202208,93,66,27,79993.3,32724,112717.3
412580,202208,173,116,57,140595.81,69085.35,209681.16
412590,202208,34,30,4,36362.15,4848,41210.15
412600,202208,190,134,56,162410.34,67872.83,230283.17
412610,202208,39,17,22,20604,26664,47268
412620,202208,126,104,22,126051.21,26664.56,152715.77
412625,202208,2136,1013,1123,1228980.31,1361081.21,2590061.52
412627,202208,69,49,20,59388,24240,83628
412630,202208,380,257,123,311491.59,149076.91,460568.50
412635,202208,77,23,54,27876,65448,93324
412640,202208,107,76,31,92112.2,37572,129684.2
412650,202208,317,204,113,247250.65,136956.19,384206.84
412660,202208,575,305,270,369660.6,328453.98,698114.58
412665,202208,43,39,4,47268,4848,52116
412667,202208,283,183,100,221798.95,121200,342998.95
412670,202208,76,59,17,71508.2,20604,92112.2
412680,202208,319,240,79,290886.02,96961.41,387847.43
412690,202208,123,80,43,96961.58,52116,149077.58
412700,202208,196,127,69,153924,83628.23,237552.23
412710,202208,1362,766,596,929616.11,722356.52,1651972.63
412720,202208,233,131,102,158772.19,123624.32,282396.51
412730,202208,205,173,32,209677.1,38784.99,248462.09
412740,202208,415,210,205,254521.96,248460.2,502982.16
412750,202208,411,225,186,272700.99,225432.52,498133.51
412760,202208,359,180,179,218162.98,216950.21,435113.19
412770,202208,2114,1133,981,1374422.72,1191400.59,2565823.31
412780,202208,144,103,41,124838.57,49692,174530.57
412785,202208,322,163,159,197557.8,192708,390265.8
412788,202208,51,31,20,37572.82,24240,61812.82
412790,202208,125,101,24,122414.21,29088,151502.21
412795,202208,147,100,47,121200.2,56964,178164.2
412796,202208,307,189,118,229068.44,143016,372084.44
412800,202208,689,395,294,479953.73,356328.66,836282.39
412810,202208,3129,1683,1446,2039831.61,1752572.52,3792404.13
412820,202208,997,583,414,707819.04,501775.31,1209594.35
412830,202208,13,12,1,14544,1212,15756
412840,202208,272,183,89,221796,107868,329664
412850,202208,597,396,201,479954.64,243614.03,723568.67
412853,202208,169,80,89,96960,107868,204828
412855,202208,194,106,88,128473.28,106656,235129.28
412860,202208,95,63,32,76357.26,38785.11,115142.37
412862,202208,82,51,31,61812.2,37572,99384.2
412863,202208,9,7,2,8484,2424,10908
412865,202208,47,35,12,42420,14544,56964
412870,202208,111,69,42,83629.67,50904.46,134534.13
412880,202208,96,66,30,79994.71,36360,116354.71
420005,202208,43,37,6,44844.21,7272,52116.21
420010,202208,360,238,122,288458.86,149076.67,437535.53
420020,202208,94,73,21,88476.55,25452,113928.55
420030,202208,27,22,5,26664,6060,32724
420040,202208,92,70,22,84840.7,26664,111504.7
420050,202208,58,38,20,46056.16,24240,70296.16
420055,202208,16,15,1,18180.99,1212,19392.99
420060,202208,26,19,7,23028,8484.2,31512.2
420070,202208,102,86,16,104232,19392,123624
420075,202208,10,10,0,12120,,12120.0
420080,202208,41,35,6,42420,7272,49692
420090,202208,37,29,8,35148.66,9696,44844.66
420100,202208,154,128,26,155136.9,31512,186648.9
420110,202208,22,21,1,25452,1212,26664
420120,202208,62,43,19,52116.31,23028.53,75144.84
420125,202208,81,62,19,75144,23028,98172
420127,202208,37,32,5,38784,6060,44844
420130,202208,490,296,194,358758.89,235133.37,593892.26
420140,202208,1377,758,619,918708.48,750240.37,1668948.85
420150,202208,47,35,12,42420,14544,56964
420160,202208,32,29,3,35148.19,3636,38784.19
420165,202208,17,12,5,14544,6060.3,20604.3
420170,202208,67,40,27,48480,32724.59,81204.59
420180,202208,24,20,4,24240,4848,29088
420190,202208,26,23,3,27876,3636,31512
420195,202208,134,60,74,72723.45,89690.61,162414.06
420200,202208,1348,570,778,690846.49,944161.9,1635008.39
420205,202208,114,67,47,81204.9,56964.56,138169.46
420207,202208,137,77,60,93325.06,72720,166045.06
420208,202208,19,15,4,18180,4848,23028
420209,202208,13,11,2,13332,2424,15756
420210,202208,585,271,314,328453.45,381781.87,710235.32
420213,202208,53,40,13,48480,15756.2,64236.2
420215,202208,26,23,3,27877.03,3636,31513.03
420220,202208,58,37,21,44844.6,25452,70296.6
420230,202208,976,590,386,715134.46,467835.5,1182969.96
420240,202208,2320,1533,787,1860431.96,953851.7,2814283.66
420243,202208,44,35,9,43632.54,10908,54540.54
420245,202208,211,101,110,122413.58,133321.6,255735.18
420250,202208,61,41,20,49692.99,24240,73932.99
420253,202208,24,17,7,20605.07,8484,29089.07
420257,202208,15,10,5,12120,6060,18180
420260,202208,121,98,23,118776.79,27876.14,146652.93
420270,202208,35,25,10,30300.2,12120,42420.2
420280,202208,284,211,73,255738.49,88477.48,344215.97
420285,202208,24,19,5,23028,6060,29088
420287,202208,49,32,17,38784,20604,59388
420290,202208,920,629,291,763564.8,352692.83,1116257.63
420300,202208,1603,1275,328,1547756.27,397540.98,1945297.25
420310,202208,43,30,13,36360,15756,52116
420315,202208,27,22,5,26664.68,6060.5,32725.18
420320,202208,1014,472,542,573284.56,658122.73,1231407.29
420325,202208,3,1,2,1212,2424.8,3636.8
420330,202208,116,76,40,92112.34,48480,140592.34
420340,202208,193,128,65,155137,78780.18,233917.18
420350,202208,260,181,79,219378.02,95748.8,315126.82
420360,202208,696,535,161,648426.14,196344.8,844770.94
420370,202208,134,72,62,87265.02,75145.34,162410.36
420380,202208,1229,839,390,1018098.17,475106.05,1493204.22
420390,202208,230,160,70,193921.54,86052.69,279974.23
420395,202208,189,138,51,167259.06,61813.94,229073.00
420400,202208,227,174,53,212102.61,64236.2,276338.81
420410,202208,54,40,14,48482.01,18180,66662.01
420415,202208,32,26,6,31512.96,7272,38784.96
420417,202208,60,46,14,55752,16968,72720
420419,202208,12,11,1,13332,1212,14544
420420,202208,2878,1788,1090,2168304.2,1322297.28,3490601.48
420425,202208,66,50,16,60600.58,19392.19,79992.77
420430,202208,1052,764,288,927186.25,349056.3,1276242.55
420435,202208,12,11,1,14544,1212,15756
420440,202208,92,65,27,78780.6,32724,111504.6
420445,202208,31,28,3,33936.7,3636,37572.7
420450,202208,80,42,38,50904.86,47268,98172.86
420455,202208,185,143,42,173317.92,50904,224221.92
420460,202208,2332,1444,888,1750153.37,1076263.48,2826416.85
420470,202208,89,59,30,71508,36360,107868
420475,202208,10,9,1,10908,1212,12120
420480,202208,887,673,214,815692.49,259369.88,1075062.37
420490,202208,97,73,24,88477.6,29088,117565.6
420500,202208,396,231,165,279976.97,199980.2,479957.17
420510,202208,24,21,3,25452.68,3636,29088.68
420515,202208,27,15,12,18180.02,14544,32724.02
420517,202208,9,7,2,8484,2424,10908
420519,202208,1,0,1,,1212,1212.0
420520,202208,60,46,14,55753.89,16968,72721.89
420530,202208,141,88,53,106656.1,64236.4,170892.5
420535,202208,14,12,2,14544,2424,16968
420540,202208,6458,4020,2438,4873841.75,2958517.75,7832359.50
420543,202208,31,29,2,35148.88,2424,37572.88
420545,202208,209,145,64,175743.2,77568.8,253312.0
420550,202208,771,643,128,779334.81,156348.87,935683.68
420555,202208,30,22,8,26664.3,9696,36360.3
420560,202208,59,46,13,56964.02,15756,72720.02
420570,202208,203,96,107,116353.95,129685.09,246039.04
420580,202208,302,150,152,181802.17,184225,366027.17
420590,202208,478,305,173,369663.7,209676.55,579340.25
420600,202208,144,77,67,93324,82416,175740
420610,202208,37,34,3,41208,3636,44844
420620,202208,81,59,22,71508.99,26664.65,98173.64
420630,202208,148,97,51,117564.82,61812,179376.82
420640,202208,68,58,10,71508,12120,83628
420650,202208,289,150,139,181801.2,168469.4,350270.6
420660,202208,40,31,9,38784,10908,49692
420665,202208,42,26,16,31512.2,19392,50904.2
420670,202208,235,181,54,219379.09,65448,284827.09
420675,202208,15,13,2,15756,2424,18180
420680,202208,33,27,6,32724,7272,39996
420690,202208,199,150,49,181800.5,59388.34,241188.84
420700,202208,708,459,249,556317.71,303001.97,859319.68
420710,202208,140,75,65,90900,78780.44,169680.44
420720,202208,92,73,19,88477.29,24240.1,112717.39
420730,202208,701,419,282,507836.41,341790.66,849627.07
420740,202208,55,55,0,66660,,66660.0
420750,202208,496,327,169,396326.7,206040.51,602367.21
420757,202208,19,16,3,19392,3636,23028
420760,202208,40,30,10,36360.2,12120,48480.2
420765,202208,74,52,22,63024.2,26664,89688.2
420768,202208,57,47,10,56965.83,12120,69085.83
420770,202208,65,56,9,67872.72,10908,78780.72
420775,202208,36,32,4,38784.8,4848,43632.8
420780,202208,199,154,45,186649.6,54540,241189.6
420785,202208,23,15,8,18180,9696,27876
420790,202208,140,113,27,136956.07,32724,169680.07
420800,202208,61,45,16,54540,19392,73932
420810,202208,278,216,62,261794.19,75144,336938.19
420820,202208,2533,1398,1135,1696817.1,1376845.87,3073662.97
420830,202208,692,362,330,438752.57,399971.68,838724.25
420840,202208,134,92,42,111504.8,50904,162408.8
420845,202208,435,182,253,220586.67,306638.37,527225.04
420850,202208,268,204,64,247248.77,77568,324816.77
420860,202208,61,52,9,63025.52,10908,73933.52
420870,202208,129,91,38,110292.86,46056,156348.86
420880,202208,189,121,68,146653.23,82416.6,229069.83
420890,202208,970,467,503,567220.77,609637.36,1176858.13
420895,202208,6,6,0,7272,,7272.0
420900,202208,423,342,81,414507.98,98172,512679.98
420910,202208,5959,3227,2732,3914819.46,3313637.51,7228456.97
420915,202208,58,52,6,63024,7272,70296
420917,202208,22,17,5,20604.43,6060,26664.43
420920,202208,23,15,8,18180,9696,27876
420930,202208,3243,2113,1130,2563352.54,1373216.23,3936568.77
420940,202208,585,415,170,502994.89,206044.88,709039.77
420945,202208,9,7,2,8484,2424,10908
420950,202208,48,35,13,42420,15756.74,58176.74
420960,202208,109,88,21,106660.14,25452.1,132112.24
420970,202208,279,223,56,270280.3,67872.93,338153.23
420980,202208,23,22,1,26664,1212,27876
420985,202208,51,44,7,53328,8484,61812
420990,202208,84,64,20,77568,24240.18,101808.18
421000,202208,57,29,28,35148,33936.52,69084.52
421003,202208,36,26,10,31512,12120,43632
421005,202208,8,6,2,7272.8,2424,9696.8
421010,202208,860,553,307,672673.52,372090.23,1044763.75
421020,202208,19,17,2,20604,2424,23028
421030,202208,115,97,18,117565.24,21816.2,139381.44
421040,202208,64,44,20,53329.16,24240,77569.16
421050,202208,319,223,96,270277.44,116352,386629.44
421055,202208,18,14,4,16968,4848,21816
421060,202208,103,59,44,71508.53,54540,126048.53
421070,202208,42,37,5,44845.89,6060,50905.89
421080,202208,41,34,7,41208.98,8484,49692.98
421085,202208,19,15,4,18180,4848,23028
421090,202208,38,30,8,36360.11,9696,46056.11
421100,202208,114,88,26,106656.11,31512.95,138169.06
421105,202208,193,154,39,186650.67,47268.2,233918.87
421110,202208,118,85,33,104232,39996.1,144228.1
421120,202208,178,130,48,157562.23,58176,215738.23
421125,202208,16,9,7,10908,8484.11,19392.11
421130,202208,829,506,323,613275.95,392692.97,1005968.92
421140,202208,34,23,11,27876.96,13332,41208.96
421145,202208,41,35,6,42420,7272,49692
421150,202208,84,64,20,77568.2,24240.97,101809.17
421160,202208,62,37,25,44844,30300.7,75144.7
421165,202208,13,10,3,12120,3636,15756
421170,202208,164,137,27,166192.38,32725.5,198917.88
421175,202208,184,132,52,159986,63024.79,223010.79
421180,202208,39,27,12,32724.56,14544,47268.56
421185,202208,17,14,3,16968,3636,20604
421187,202208,4,3,1,3636.8,1212,4848.8
421189,202208,44,32,12,38785,14544,53329
421190,202208,1945,1221,724,1481084.38,877499.52,2358583.90
421200,202208,95,66,29,79993.99,35148,115141.99
421205,202208,26,19,7,23028.94,9696,32724.94
421210,202208,174,126,48,152712.52,58176,210888.52
421220,202208,249,193,56,233919.55,67873,301792.55
421223,202208,46,37,9,44845.7,10908,55753.7
421225,202208,69,46,23,55752,27878.62,83630.62
421227,202208,67,55,12,66660.79,14544,81204.79
421230,202208,74,50,24,60600.99,29088,89688.99
421240,202208,20,17,3,20604.6,3636,24240.6
421250,202208,388,221,167,267853.9,202408.98,470262.88
421260,202208,21,16,5,19392,6060,25452
421265,202208,7,5,2,6060,2424,8484
421270,202208,55,50,5,60600,7272,67872
421280,202208,369,188,181,227859.25,219372.72,447231.97
421290,202208,317,207,110,250884.38,133320.72,384205.10
421300,202208,21,19,2,23028,2424,25452
421310,202208,45,31,14,37572.78,16968,54540.78
421315,202208,31,18,13,21816,15756.08,37572.08
421320,202208,137,91,46,110292.91,55752,166044.91
421330,202208,111,83,28,100596.13,33936,134532.13
421335,202208,45,32,13,38785.61,15756,54541.61
421340,202208,237,157,80,190286.2,96960,287246.2
421350,202208,182,106,76,128474.81,92112.25,220587.06
421360,202208,716,492,224,596309.47,272702.59,869012.06
421370,202208,192,141,51,170892.22,61812.57,232704.79
421380,202208,150,111,39,134532.88,47268,181800.88
421390,202208,16,10,6,12120,7272,19392
421400,202208,119,98,21,118776,25452,144228
421410,202208,21,18,3,21816,3636,25452
421415,202208,20,17,3,20604,3636,24240
421420,202208,101,86,15,104232.2,18180,122412.2
421430,202208,21,13,8,15756,9696,25452
421440,202208,60,52,8,63024.8,9696,72720.8
421450,202208,83,69,14,83628.86,16968.44,100597.30
421460,202208,55,43,12,52116,14544,66660
421470,202208,71,38,33,46056.2,39996,86052.2
421480,202208,765,574,191,695690.66,233917.3,929607.96
421490,202208,24,23,1,27876,1212,29088
421500,202208,477,277,200,335730.82,242401.21,578132.03
421505,202208,32,24,8,29088.6,9696,38784.6
421507,202208,31,25,6,30300,7272,37572
421510,202208,66,41,25,49692,30300,79992
421520,202208,51,43,8,52116.4,9696,61812.4
421530,202208,51,44,7,53328.2,8484,61812.2
421535,202208,22,21,1,25452,1212,26664
421540,202208,48,37,11,44844,13332,58176
421545,202208,81,56,25,67874.5,30300.4,98174.9
421550,202208,290,207,83,252102.06,100597.61,352699.67
421555,202208,14,12,2,14544.75,2424,16968.75
421560,202208,8,7,1,8484,1212,9696
421565,202208,127,82,45,99384.9,54540.15,153925.05
421567,202208,33,26,7,32724,8484,41208
421568,202208,42,40,2,48480,2424,50904
421569,202208,10,10,0,12120,,12120.0
421570,202208,245,158,87,192708.98,105444,298152.98
421575,202208,27,24,3,29088,3636,32724
421580,202208,730,425,305,515182.84,370874.19,886057.03
421590,202208,21,18,3,21816,3636,25452
421600,202208,172,120,52,145440.6,63024,208464.6
421605,202208,104,69,35,83628.8,42420.2,126049.0
421610,202208,172,128,44,155137.15,53328,208465.15
421620,202208,1051,602,449,729640.86,545408.91,1275049.77
421625,202208,22,20,2,24240.71,2424,26664.71
421630,202208,357,215,142,260582.18,172108.35,432690.53
421635,202208,21,9,12,10908,14544,25452
421640,202208,100,82,18,99385.77,21816,121201.77
421650,202208,314,182,132,220591.36,159987.18,380578.54
421660,202208,2590,1561,1029,1895982.58,1248375.21,3144357.79
421670,202208,163,118,45,143016.67,54540,197556.67
421680,202208,188,169,19,206041.36,23028,229069.36
421690,202208,345,236,109,286034.74,132108.56,418143.30
421700,202208,59,39,20,47268,24240.2,71508.2
421710,202208,19,19,0,23028,,23028.0
421715,202208,5,4,1,4848,1212,6060
421720,202208,650,439,211,532074.55,255734.03,787808.58
421725,202208,26,10,16,12120.2,19392.2,31512.4
421730,202208,23,17,6,20604,7272,27876
421740,202208,109,42,67,50904.94,81204,132108.94
421750,202208,190,138,52,167256.29,64236,231492.29
421755,202208,17,15,2,18180,2424,20604
421760,202208,103,70,33,84840.26,39996,124836.26
421770,202208,699,450,249,545405.74,301790.94,847196.68
421775,202208,29,19,10,23028.97,12120,35148.97
421780,202208,186,142,44,172104,53328,225432
421790,202208,152,131,21,158772.56,25452.66,184225.22
421795,202208,15,12,3,14544,3636,18180
421800,202208,544,327,217,396333.36,264220.09,660553.45
421810,202208,68,55,13,66661.58,15756,82417.58
421820,202208,299,187,112,227857.33,135744,363601.33
421825,202208,149,123,26,149078.08,31512.06,180590.14
421830,202208,153,92,61,111506.79,73933.8,185440.59
421835,202208,7,2,5,2424.19,6060,8484.19
421840,202208,41,34,7,41209.38,8484,49693.38
421850,202208,76,63,13,76356.5,15756,92112.5
421860,202208,35,25,10,30300,12120,42420
421870,202208,1103,794,309,962344.05,374517.52,1336861.57
421875,202208,47,37,10,44844,12120,56964
421880,202208,185,129,56,156348.46,67872.2,224220.66
421885,202208,21,16,5,19392,6060,25452
421890,202208,153,110,43,133320.37,52116.77,185437.14
421895,202208,44,38,6,46057.7,7272,53329.7
421900,202208,126,95,31,115143.82,37572,152715.82
421910,202208,63,40,23,48480,27876,76356
421915,202208,32,26,6,31512,7272,38784
421917,202208,49,38,11,46056.4,13332,59388.4
421920,202208,34,29,5,35148,6060,41208
421930,202208,623,497,126,602374.96,152712.27,755087.23
421935,202208,45,37,8,44844,9696,54540
421940,202208,52,45,7,54540.6,8484,63024.6
421950,202208,897,592,305,717510.58,369661.91,1087172.49
421960,202208,41,34,7,41208.57,8484,49692.57
421970,202208,321,206,115,249674.03,140592.93,390266.96
421985,202208,19,12,7,14544,8484,23028
422000,202208,10,5,5,6060,6060.61,12120.61
430003,202208,180,52,128,63024,155136,218160
430005,202208,31,23,8,27876.67,9696,37572.67
430010,202208,248,180,68,218161.81,83628,301789.81
430020,202208,141,96,45,116352.5,54540,170892.5
430030,202208,118,96,22,116352,26664,143016
430040,202208,2921,1742,1179,2112538.47,1431375.15,3543913.62
430045,202208,72,62,10,75144,12120,87264
430047,202208,7,5,2,6060,2424,8484
430050,202208,86,75,11,90900,13332,104232
430055,202208,13,12,1,14544,1212,15756
430057,202208,6,4,2,4848,2424,7272
430060,202208,4083,2357,1726,2859137.7,2095561.05,4954698.75
430063,202208,50,41,9,49692,10908,60600
430064,202208,166,130,36,157560,43632,201192
430066,202208,6,2,4,2424,4848,7272
430070,202208,45,33,12,39996,14544,54540
430080,202208,81,52,29,63024,35148,98172
430085,202208,29,14,15,16968,18180,35148
430087,202208,26,20,6,24240.8,7272,31512.8
430090,202208,68,57,11,69084.76,13332,82416.76
430100,202208,143,98,45,118776,54540,173316
430105,202208,161,89,72,107871.13,87265.1,195136.23
430107,202208,17,13,4,15756.53,4848,20604.53
430110,202208,492,269,223,326028.79,270276,596304.79
430120,202208,159,145,14,175740.65,16968,192708.65
430130,202208,800,479,321,580551.59,390264.06,970815.65
430140,202208,132,122,10,147864,12120,159984
430150,202208,106,65,41,78780,49692,128472
430155,202208,30,24,6,29088,7272,36360
430160,202208,3662,2077,1585,2517352.15,1922240.13,4439592.28
430163,202208,413,192,221,232707.51,267854.21,500561.72
430165,202208,31,19,12,23028.28,14544,37572.28
430170,202208,80,66,14,79992,16968,96960
430175,202208,78,61,17,73932,20604.7,94536.7
430180,202208,109,85,24,104232,29088,133320
430185,202208,27,19,8,23028,9696,32724
430187,202208,68,32,36,38784,43632,82416
430190,202208,230,116,114,140592.44,138169.59,278762.03
430192,202208,14,10,4,12120,4848,16968
430195,202208,17,13,4,15756,4848,20604
430200,202208,156,131,25,158772.8,30300,189072.8
430205,202208,18,18,0,21816,,21816.0
430210,202208,741,552,189,670241.21,229068.8,899310.01
430215,202208,11,10,1,12120,1212,13332
430220,202208,76,51,25,61812.3,30300,92112.3
430222,202208,14,6,8,7272,9696,16968
430223,202208,16,11,5,13332,6060,19392
430225,202208,3,2,1,2424,1212,3636
430230,202208,338,210,128,254520.6,155136,409656.6
430235,202208,55,34,21,41208,25452,66660
430237,202208,23,17,6,20604,7272,27876
430240,202208,112,76,36,92112.22,43632,135744.22
430245,202208,68,54,14,65448,16968,82416
430250,202208,187,108,79,130896,95748.84,226644.84
430258,202208,11,10,1,12120,1212,13332
430260,202208,33,28,5,33936,6060,39996
430265,202208,36,31,5,37572,6060,43632
430270,202208,521,372,149,450870.56,180588,631458.56
430280,202208,1058,612,446,741747.21,540552.1,1282299.31
430290,202208,440,224,216,272701.55,261792,534493.55
430300,202208,2148,1159,989,1405934.54,1202313.78,2608248.32
430310,202208,2136,1044,1092,1266559.77,1323520.59,2590080.36
430320,202208,56,45,11,54540.6,13332,67872.6
430330,202208,84,72,12,87264,14544,101808
430340,202208,67,53,14,64236,16968,81204
430350,202208,1669,1074,595,1301693.14,723564.58,2025257.72
430355,202208,19,17,2,20604,2424,23028
430360,202208,96,47,49,58176,59388,117564
430367,202208,44,32,12,38784,14544,53328
430370,202208,62,54,8,65448,9696,75144
430380,202208,111,82,29,99385.35,35148,134533.35
430390,202208,597,369,228,448445.44,276338,724783.44
430400,202208,256,175,81,212100.6,98172,310272.6
430410,202208,58,47,11,56964.2,13332,70296.2
430420,202208,527,333,194,403600.75,235128.89,638729.64
430430,202208,48,46,2,54944.8,2424,57368.8
430435,202208,148,111,37,134532,44844,179376
430440,202208,571,351,220,427838.12,266640.7,694478.82
430450,202208,1206,980,226,1187765.52,275125,1462890.52
430460,202208,5893,3013,2880,3654218.7,3494227.61,7148446.31
430461,202208,17,15,2,18180,2424,20604
430462,202208,4,2,2,2424,2424,4848
430463,202208,1196,629,567,765988.45,688420.4,1454408.85
430465,202208,29,16,13,19392,15756,35148
430466,202208,699,493,206,597528.77,249676.05,847204.82
430467,202208,123,71,52,86052.5,63024,149076.5
430468,202208,141,79,62,95748,75144.89,170892.89
430469,202208,20,15,5,18180,6060,24240
430470,202208,1187,638,549,774833.01,665389.89,1440222.90
430471,202208,71,49,22,59388,26664.57,86052.57
430480,202208,129,90,39,109080.8,47268,156348.8
430485,202208,8,8,0,9696.6,,9696.6
430490,202208,73,58,15,71508.95,18180,89688.95
430495,202208,33,23,10,27876,12120,39996
430500,202208,190,130,60,157560.77,72720,230280.77
430510,202208,3859,2522,1337,3060316.85,1621661.32,4681978.17
430511,202208,14,14,0,16968,,16968.0
430512,202208,163,112,51,135745.31,61812.1,197557.41
430513,202208,53,40,13,48480,15756,64236
430515,202208,24,23,1,27876,1212,29088
430517,202208,178,147,31,178164,37572,215736
430520,202208,341,238,103,288457.73,124836.1,413293.83
430530,202208,77,42,35,50904,42420,93324
430535,202208,457,295,162,357542.26,196345.36,553887.62
430537,202208,9,9,0,10908,,10908.0
430540,202208,81,54,27,65448,32724,98172
430543,202208,407,131,276,158772.96,335724.71,494497.67
430544,202208,49,45,4,54541.27,4848,59389.27
430545,202208,412,196,216,237557.62,263009.14,500566.76
430550,202208,45,37,8,44844,9696,54540
430558,202208,1,1,0,1212,,1212.0
430560,202208,54,30,24,36360,29088,65448
430570,202208,123,52,71,63024.2,86052,149076.2
430580,202208,125,98,27,118776,32724,151500
430583,202208,14,14,0,16968,,16968.0
430585,202208,14,11,3,13332,3636,16968
430587,202208,16,10,6,12120,7272.73,19392.73
430590,202208,174,139,35,168469.76,43632,212101.76
430593,202208,1,1,0,1212,,1212.0
430595,202208,16,13,3,15756,3636,19392
430597,202208,44,25,19,30300,23028,53328
430600,202208,221,168,53,203616.46,64236,267852.46
430605,202208,175,100,75,122412,90900,213312
430607,202208,30,24,6,29088,7272,36360
430610,202208,1771,846,925,1025355.89,1121103.98,2146459.87
430613,202208,5,5,0,6060,,6060.0
430620,202208,94,69,25,83628,30300,113928
430630,202208,49,41,8,49692.95,9696,59388.95
430632,202208,33,28,5,33936,6060,39996
430635,202208,36,30,6,36360,7272,43632
430637,202208,65,30,35,36360,42420,78780
430640,202208,173,94,79,113928,95748.54,209676.54
430642,202208,19,17,2,20604,2424,23028
430645,202208,32,26,6,31512,7272,38784
430650,202208,246,194,52,237552.6,63024,300576.6
430655,202208,5,4,1,4848,1212,6060
430660,202208,989,485,504,587823.95,612064.7,1199888.65
430670,202208,71,47,24,56964,29088,86052
430673,202208,87,59,28,71508,33936,105444
430675,202208,8,6,2,7272,2424,9696
430676,202208,615,375,240,454500.95,290881.69,745382.64
430680,202208,254,165,89,201192.6,107868,309060.6
430690,202208,555,338,217,409657.6,263005.95,672663.55
430692,202208,9,7,2,8484.2,2424,10908.2
430693,202208,138,85,53,103020,64236.2,167256.2
430695,202208,64,52,12,63024,14544,77568
430697,202208,61,38,23,46056,27876,73932
430700,202208,1378,930,448,1128377.67,545402.42,1673780.09
430705,202208,29,26,3,31512,3636,35148
430710,202208,264,162,102,196344,123624,319968
430720,202208,101,85,16,103020,19392,122412
430730,202208,150,128,22,155136.2,26664,181800.2
430740,202208,77,50,27,60600,32724,93324
430745,202208,28,17,11,20604,13332,33936
430750,202208,329,216,113,263004.6,136956.71,399961.31
430755,202208,83,45,38,54540,46056,100596
430760,202208,401,217,184,263005.35,224223.67,487229.02
430770,202208,1621,861,760,1044756.16,923548.52,1968304.68
430780,202208,342,216,126,261792,153924,415716
430781,202208,24,23,1,27876,1212,29088
430783,202208,64,50,14,60600,16968,77568
430786,202208,6,4,2,4848,2424,7272
430790,202208,523,336,187,407232,227858.29,635090.29
430800,202208,160,122,38,147864.41,46056,193920.41
430805,202208,40,33,7,39996,8484,48480
430807,202208,65,33,32,39996,38784,78780
430810,202208,79,53,26,64236,31512,95748
430820,202208,150,98,52,118776.8,63024,181800.8
430825,202208,12,9,3,10908,3636,14544
430830,202208,259,240,19,290880.8,23028,313908.8
430840,202208,129,85,44,103020,53328,156348
430843,202208,5,3,2,3636,2424,6060
430845,202208,79,47,32,56964,38784,95748
430850,202208,584,417,167,507828.75,203616,711444.75
430860,202208,164,107,57,130896.8,69084.58,199981.38
430865,202208,72,40,32,48480,38784,87264
430870,202208,73,59,14,71508,16968,88476
430880,202208,167,118,49,143016.77,59388,202404.77
430885,202208,11,10,1,12120,1212,13332
430890,202208,340,202,138,246036,167256,413292
430900,202208,531,368,163,446018.3,197556,643574.3
430905,202208,140,60,80,72721.35,96960,169681.35
430910,202208,285,155,130,189072.88,157560.2,346633.08
430912,202208,3,3,0,3636,,3636.0
430915,202208,42,39,3,47268,3636,50904
430920,202208,4741,2480,2261,3005808.36,2742795.93,5748604.29
430925,202208,6,5,1,6060,1212,7272
430930,202208,2108,1194,914,1449561.21,1108983.87,2558545.08
430940,202208,266,169,97,204829.45,117564.4,322393.85
430950,202208,148,119,29,144228.04,35148,179376.04
430955,202208,25,15,10,18180,12120,30300
430957,202208,22,19,3,23028,3636,26664
430960,202208,258,164,94,198768.05,113928.57,312696.62
430965,202208,99,63,36,77568,43632,121200
430970,202208,88,72,16,87264,19392,106656
430975,202208,47,42,5,50904,6060,56964
430980,202208,50,30,20,36360,24240,60600
430990,202208,98,75,23,90900,27876.58,118776.58
430995,202208,109,101,8,122412,9696,132108
431000,202208,293,148,145,179376.9,175740,355116.9
431010,202208,368,214,154,259372.28,186650.58,446022.86
431020,202208,1917,1105,812,1339262.62,985357.56,2324620.18
431030,202208,42,34,8,41208,9696,50904
431033,202208,463,212,251,256950.64,305432.36,562383.00
431036,202208,12,8,4,9696,4848,14544
431040,202208,143,93,50,112716.55,60600,173316.55
431041,202208,40,23,17,27876,20604,48480
431043,202208,41,24,17,29088,20604,49692
431046,202208,13,10,3,12120,3636,15756
431050,202208,207,124,83,150288,100596,250884
431053,202208,75,40,35,48480.88,42420.62,90901.50
431055,202208,64,42,22,50904,26664,77568
431057,202208,17,17,0,20604,,20604.0
431060,202208,1581,1015,566,1233823.66,685992.17,1919815.83
431065,202208,16,8,8,9696,9696,19392
431070,202208,65,57,8,69084,9696,78780
431075,202208,8,8,0,9696,,9696.0
431080,202208,126,71,55,86052,66660,152712
431085,202208,32,28,4,33936,4848,38784
431087,202208,16,13,3,15756.6,3636,19392.6
431090,202208,53,40,13,48480.24,15756,64236.24
431100,202208,1280,769,511,932038.86,620547.64,1552586.50
431110,202208,220,131,89,158774.28,107868,266642.28
431112,202208,29,22,7,26664,8484,35148
431113,202208,30,21,9,25452,10908,36360
431115,202208,155,107,48,130896,58176,189072
431120,202208,598,345,253,418142.39,307848,725990.39
431123,202208,6,6,0,7272,,7272.0
431125,202208,95,82,13,99384,15756,115140
431127,202208,5,3,2,3636,2424,6060
431130,202208,707,463,244,561158.33,296941.17,858099.50
431140,202208,794,562,232,681148.94,282396,963544.94
431142,202208,20,18,2,21816.84,2424,24240.84
431150,202208,201,148,53,179376.76,64236,243612.76
431160,202208,46,42,4,50904,4848,55752
431162,202208,6,6,0,7272.67,,7272.67
431164,202208,4,4,0,4848,,4848.0
431170,202208,112,80,32,96960,38784,135744
431171,202208,71,40,31,48480,37572,86052
431173,202208,5,3,2,3636,2424.8,6060.8
431175,202208,203,105,98,128472.8,118776.15,247248.95
431177,202208,95,68,27,82416.61,32724,115140.61
431179,202208,15,11,4,13332.19,4848,18180.19
431180,202208,405,248,157,301788.96,190284.76,492073.72
431190,202208,71,52,19,63024,23028.7,86052.7
431198,202208,74,50,24,60474.05,29088,89562.05
431200,202208,21,17,4,20604.8,4848,25452.8
431205,202208,22,20,2,24240,2424,26664
431210,202208,102,64,38,77568,46056,123624
431213,202208,33,27,6,32724,7272,39996
431215,202208,22,21,1,25452,1212,26664
431217,202208,6,5,1,6060,1212,7272
431220,202208,66,55,11,66660,13332,79992
431225,202208,169,106,63,128472.91,76356,204828.91
431230,202208,97,81,16,98172,19392,117564
431235,202208,6,5,1,6060,1212,7272
431237,202208,14,9,5,10908,6060,16968
431238,202208,12,8,4,9696,4848,14544
431240,202208,1115,683,432,830228.23,524798.66,1355026.89
431242,202208,39,38,1,46056.6,1212,47268.6
431244,202208,26,21,5,25452,6060,31512
431245,202208,51,36,15,43632,18180,61812
431247,202208,13,9,4,10908,4848,15756
431250,202208,281,137,144,166044.99,174528,340572.99
431260,202208,53,45,8,54540,9696,64236
431261,202208,18,13,5,15756,6060,21816
431262,202208,15,12,3,14544,3636,18180
431265,202208,151,84,67,103020,81204,184224
431267,202208,17,15,2,18180,2424,20604
431270,202208,329,258,71,312697.77,87264.61,399962.38
431275,202208,38,34,4,41208,4848,46056
431280,202208,21,15,6,18180,7272,25452
431290,202208,22,20,2,24240,2424,26664
431295,202208,3,1,2,1212,2424,3636
431300,202208,20,18,2,21816,2424,24240
431301,202208,7,7,0,8484,,8484.0
431303,202208,56,36,20,43632,24240,67872
431306,202208,244,127,117,153924.05,141804,295728.05
431308,202208,8,6,2,7272,2424,9696
431310,202208,62,48,14,58176.1,16968,75144.1
431320,202208,197,118,79,143016,95748,238764
431330,202208,209,135,74,163620,90900.2,254520.2
431333,202208,27,22,5,26664,6060,32724
431335,202208,7,5,2,6060,2424,8484
431337,202208,414,197,217,238768.21,263004.48,501772.69
431339,202208,22,16,6,19392,7272,26664
431340,202208,3181,1708,1473,2074861.89,1785282.54,3860144.43
431342,202208,33,23,10,27876.7,12120,39996.7
431344,202208,18,18,0,21816,,21816.0
431346,202208,6,5,1,6060,1212,7272
431349,202208,29,27,2,32724,2424,35148
431350,202208,1095,586,509,711452.87,616910.26,1328363.13
431360,202208,53,39,14,47268,16968,64236
431365,202208,368,156,212,189073.6,256944.4,446018.0
431370,202208,1179,665,514,807198.37,622968.92,1430167.29
431380,202208,97,86,11,104232,13332,117564
431390,202208,485,259,226,313908.15,273912.46,587820.61
431395,202208,328,141,187,170892,227856.19,398748.19
431400,202208,37,24,13,29088,15756,44844
431402,202208,98,72,26,87264,31512.8,118776.8
431403,202208,28,19,9,23028,10908,33936
431405,202208,720,412,308,499347.05,374510.6,873857.65
431406,202208,35,27,8,32724,9696,42420
431407,202208,48,37,11,44844,13332,58176
431410,202208,3504,2138,1366,2592490.45,1658025.8,4250516.25
431413,202208,15,12,3,14544,3636,18180
431415,202208,71,49,22,59388,26664,86052
431417,202208,22,11,11,13332,14544,27876
431420,202208,360,235,125,284824.12,151500,436324.12
431430,202208,62,32,30,38785.19,36360,75145.19
431440,202208,9194,6241,2953,7567902.93,3586395.6,11154298.53
431442,202208,26,13,13,15756,15756,31512
431445,202208,27,25,2,30300,2424,32724
431446,202208,3,3,0,3636,,3636.0
431447,202208,81,59,22,71508,26664,98172
431449,202208,55,44,11,53328.2,13332,66660.2
431450,202208,424,278,146,336936.05,176952,513888.05
431454,202208,11,6,5,7272,6060,13332
431455,202208,46,37,9,44844,10908,55752
431460,202208,500,339,161,410871.54,195132,606003.54
431470,202208,139,102,37,123624,44844,168468
431475,202208,11,9,2,10908,2424,13332
431477,202208,38,22,16,26664,19392,46056
431478,202208,7,7,0,8484,,8484.0
431480,202208,603,361,242,437532.2,293305.5,730837.7
431490,202208,29942,16696,13246,20253866.71,16068840.24,36322706.95
431500,202208,77,60,17,72720,20604,93324
431505,202208,26,17,9,20604,10908,31512
431507,202208,11,9,2,10908,2424,13332
431510,202208,233,168,65,203616.4,78780,282396.4
431513,202208,20,19,1,23028,1212,24240
431514,202208,7,5,2,6060,2424,8484
431515,202208,84,71,13,86052.04,15756,101808.04
431517,202208,8,5,3,6060,3636,9696
431520,202208,38,32,6,38784,7272,46056
431530,202208,1403,610,793,739323.24,961116.43,1700439.67
431531,202208,21,20,1,24240,1212,25452
431532,202208,37,27,10,32724,12120,44844
431535,202208,28,14,14,16968,16968,33936
431540,202208,137,109,28,132108.1,33936.6,166044.7
431545,202208,14,11,3,13332,3636,16968
431550,202208,348,186,162,225432.69,196344.27,421776.96
431555,202208,11,11,0,13332,,13332.0
431560,202208,4865,3220,1645,3905136.56,1994984.47,5900121.03
431570,202208,841,449,392,544193.06,476319.7,1020512.76
431575,202208,52,29,23,35148.64,27876,63024.64
431580,202208,80,55,25,66660,30300,96960
431590,202208,145,121,24,146652,29088,175740
431595,202208,17,15,2,18180,2424,20604
431600,202208,249,146,103,176955.65,124836.82,301792.47
431610,202208,116,86,30,104232,36360.2,140592.2
431620,202208,42,34,8,41208,9696,50904
431630,202208,125,102,23,123624.81,27876,151500.81
431640,202208,1317,824,493,998694.19,599940.44,1598634.63
431642,202208,33,31,2,37572,2424,39996
431643,202208,44,17,27,20604,32724,53328
431645,202208,321,186,135,225432.71,163620,389052.71
431647,202208,9,8,1,9696,1212,10908
431650,202208,34,19,15,23028,18180,41208
431660,202208,270,171,99,207252,119988,327240
431670,202208,221,96,125,116352,152712.99,269064.99
431673,202208,14,12,2,14544,2424,16968
431675,202208,25,19,6,23028,7272,30300
431680,202208,1167,851,316,1032634.49,382996.77,1415631.26
431690,202208,4988,2948,2040,3575449.3,2473721.42,6049170.72
431695,202208,16,10,6,12120,7272,19392
431697,202208,5,2,3,2424,3636,6060
431700,202208,184,138,46,167256.54,55752,223008.54
431710,202208,4085,1757,2328,2129503.09,2821541.97,4951045.06
431720,202208,1282,791,491,960515.31,596304.95,1556820.26
431725,202208,2,1,1,1212,1212,2424
431730,202208,1202,798,404,967200.67,489652.66,1456853.33
431740,202208,1339,646,693,784168.16,839918.59,1624086.75
431750,202208,1845,1205,640,1460466.61,776896.86,2237363.47
431755,202208,6,5,1,6060,1212,7272
431760,202208,980,611,369,740538.71,447231.13,1187769.84
431770,202208,414,281,133,340572,161196.1,501768.1
431775,202208,24,17,7,20604,8484,29088
431780,202208,564,339,225,410868.57,272700,683568.57
431790,202208,152,117,35,143016.27,42420,185436.27
431795,202208,13,10,3,12120,3636,15756
431800,202208,3114,1632,1482,1980423.82,1799826.44,3780250.26
431805,202208,17,15,2,18180,2424,20604
431810,202208,590,382,208,462984.64,252097.2,715081.84
431820,202208,335,193,142,233916,172104,406020
431830,202208,2330,1404,926,1701656.93,1123525.43,2825182.36
431840,202208,482,305,177,369663.79,214525.8,584189.59
431842,202208,34,28,6,33936,7272,41208
431843,202208,12,9,3,10908.1,3636,14544.1
431844,202208,18,13,5,15756,6060,21816
431845,202208,25,22,3,26664,3636,30300
431846,202208,26,22,4,26664,4848,31512
431848,202208,12,10,2,12120,2424,14544
431849,202208,5,4,1,4848,1212,6060
431850,202208,789,614,175,744177.33,212101.3,956278.63
431860,202208,122,77,45,95748.15,54540,150288.15
431861,202208,4,0,4,1212,4848,6060
431862,202208,63,46,17,55752,20604,76356
431870,202208,3790,2172,1618,2633704.16,1964663.26,4598367.42
431880,202208,990,690,300,836284.08,363600.89,1199884.97
431890,202208,1241,720,521,872641.69,631452.45,1504094.14
431900,202208,188,129,59,157560,71508,229068
431910,202208,44,34,10,41208,12120,53328
431912,202208,48,31,17,37572,20604,58176
431915,202208,147,111,36,134532,43632,178164
431920,202208,148,106,42,128472,50904,179376
431930,202208,74,60,14,72720,16968,89688
431935,202208,5,4,1,4848,1212,6060
431936,202208,2,2,0,2424,,2424.0
431937,202208,19,14,5,16968.63,6060,23028.63
431940,202208,470,320,150,389054.7,181800,570854.7
431950,202208,481,311,170,376935.63,206040.49,582976.12
431960,202208,740,402,338,487225.47,409657.4,896882.87
431970,202208,65,59,6,71508,7272,78780
431971,202208,3,3,0,3636,,3636.0
431973,202208,21,18,3,21816.8,3636,25452.8
431975,202208,10,10,0,12120,,12120.0
431980,202208,201,118,83,143016,100596,243612
431990,202208,1092,580,512,702886.84,621763.59,1324650.43
432000,202208,1908,999,909,1213231.84,1104144.89,2317376.73
432010,202208,261,171,90,208464.7,109080.2,317544.9
432020,202208,189,160,29,193921.67,35148.37,229070.04
432023,202208,14,12,2,14544,2424,16968
432026,202208,61,53,8,64236,9696,73932
432030,202208,59,27,32,32724.74,38784,71508.74
432032,202208,15,12,3,14544,3636,18180
432035,202208,62,46,16,55752.58,19392,75144.58
432040,202208,86,59,27,71508,32724,104232
432045,202208,3,3,0,3636,,3636.0
432050,202208,80,48,32,58176,38784.6,96960.6
432055,202208,132,93,39,112716,47268,159984
432057,202208,6,4,2,4848.6,2424,7272.6
432060,202208,32,28,4,33936,4848,38784
432065,202208,29,26,3,31512,3636,35148
432067,202208,87,80,7,96960.5,8484,105444.5
432070,202208,388,306,82,370872.6,99384,470256.6
432080,202208,829,583,246,707816.26,298153.93,1005970.19
432085,202208,15,13,2,15756,2424,18180
432090,202208,276,180,96,218160.1,116352,334512.1
432100,202208,174,110,64,133320,77568,210888
432110,202208,564,370,194,448443.24,235128.49,683571.73
432120,202208,1041,588,453,713872.11,550252.07,1264124.18
432130,202208,504,360,144,437532.1,174528,612060.1
432132,202208,22,20,2,24240,2424,26664
432135,202208,79,66,13,79992,15756,95748
432140,202208,259,195,64,236342.16,77568,313910.16
432143,202208,220,134,86,162408.4,104232.85,266641.25
432145,202208,282,197,85,239976,104232,344208
432146,202208,16,14,2,16968,2424,19392
432147,202208,93,55,38,66660,46056.2,112716.2
432149,202208,16,10,6,12120,7272,19392
432150,202208,1023,622,401,755081.66,486016.7,1241098.36
432160,202208,1755,900,855,1092021.02,1036269.82,2128290.84
432162,202208,4,2,2,2424,2424,4848
432163,202208,15,10,5,12120,6060,18180
432166,202208,119,84,35,102111.1,42420.2,144531.3
432170,202208,228,116,112,140592.9,136957.21,277550.11
432180,202208,570,360,210,436320,254520.68,690840.68
432183,202208,11,10,1,12120,1212,13332
432185,202208,80,65,15,79992,18180.17,98172.17
432190,202208,514,308,206,373296.4,250884.8,624181.2
432195,202208,91,73,18,88476,21816,110292
432200,202208,418,256,162,311485.35,196344,507829.35
432210,202208,115,68,47,82416,56964,139380
432215,202208,31,29,2,35148,2424,37572
432218,202208,19,19,0,23028,,23028.0
432220,202208,643,327,316,396325.01,382995.45,779320.46
432225,202208,19,13,6,15756.2,7272,23028.2
432230,202208,123,82,41,100596,49692,150288
432232,202208,26,23,3,27876,3636,31512
432234,202208,4,2,2,2424,2424,4848
432235,202208,1,1,0,1212,,1212.0
432237,202208,23,15,8,18180,9696,27876
432240,202208,4568,2575,1993,3123374.02,2419171.69,5542545.71
432250,202208,1136,745,391,902942.39,473893.58,1376835.97
432252,202208,47,46,1,55752,1212,56964
432253,202208,68,54,14,65448.9,16968,82416.9
432254,202208,30,14,16,16968,19392,36360
432255,202208,12,10,2,12120,2424,14544
432260,202208,857,685,172,830223.99,208464.2,1038688.19
432270,202208,216,159,57,193923.3,69085.25,263008.55
432280,202208,164,122,42,147866.33,50904,198770.33
432285,202208,1,1,0,1212,,1212.0
432290,202208,55,47,8,56964,9696,66660
432300,202208,5072,2712,2360,3290525.79,2865189.62,6155715.41
432310,202208,131,108,23,130896,27876,158772
432320,202208,20,15,5,18180,6060,24240
432330,202208,16,10,6,12120,7272,19392
432335,202208,9,7,2,8484,2424,10908
432340,202208,35,28,7,33936,8484,42420
432345,202208,117,77,40,93324.3,48480,141804.3
432350,202208,23,22,1,26664,1212,27876
432360,202208,5,4,1,4848,1212,6060
432370,202208,25,25,0,30300.48,,30300.48
432375,202208,27,25,2,30300,2424,32724
432377,202208,7,7,0,8484,,8484.0
432380,202208,200,89,111,107868.8,135745.7,243614.5
500020,202208,283,149,134,180589.75,162408.39,342998.14
500025,202208,142,69,73,83628.08,88477.08,172105.16
500060,202208,1505,951,554,1152631.7,671456.1,1824087.8
500070,202208,751,358,393,433906.55,476322.18,910228.73
500080,202208,135,107,28,132111.27,33936,166047.27
500085,202208,130,98,32,118777.3,38784,157561.3
500090,202208,390,179,211,216950.61,255733.18,472683.79
500100,202208,699,356,343,432692.88,419357.12,852050.00
500110,202208,2339,1102,1237,1338069.25,1499262.82,2837332.07
500124,202208,264,143,121,174528.08,147865.25,322393.33
500150,202208,323,132,191,159986.29,231492.99,391479.28
500190,202208,572,381,191,461781.76,231493.08,693274.84
500200,202208,204,169,35,206042.74,42420,248462.74
500210,202208,1720,557,1163,676304.02,1409568.71,2085872.73
500215,202208,198,114,84,138170.16,103020.6,241190.76
500220,202208,725,459,266,557534.77,322394.47,879929.24
500230,202208,234,138,96,167258.38,116394,283652.38
500240,202208,661,426,235,517531.78,284823.74,802355.52
500260,202208,611,244,367,295730.04,444805.05,740535.09
500270,202208,31254,13532,17722,16411341.11,21501192.08,37912533.19
500280,202208,202,68,134,82416.43,162408,244824.43
500290,202208,1202,751,451,910227.11,546613.52,1456840.63
500295,202208,470,306,164,370879.32,198768.19,569647.51
500310,202208,114,39,75,47268.1,90900.64,138168.74
500315,202208,858,470,388,569642.17,470256.4,1039898.57
500320,202208,3760,1787,1973,2165887.75,2391288.13,4557175.88
500325,202208,945,523,422,633901.51,511469.48,1145370.99
500330,202208,1534,733,801,888343.84,972037.28,1860381.12
500345,202208,310,224,86,271491.76,104232.21,375723.97
500348,202208,242,148,94,179378.48,115140,294518.48
500350,202208,115,56,59,67873.7,71508,139381.7
500370,202208,5934,2694,3240,3268855.59,3932970.16,7201825.75
500375,202208,367,246,121,298152.8,146652,444804.8
500380,202208,645,361,284,437539.73,344211.14,781750.87
500390,202208,72,32,40,38784.39,48480.8,87265.19
500400,202208,218,140,78,169682.33,94536.2,264218.53
500410,202208,493,210,283,255737.64,344211.79,599949.43
500430,202208,566,380,186,460565.95,225433.92,685999.87
500440,202208,215,119,96,144228.7,116352.2,260580.9
500450,202208,433,192,241,232705.74,293304.8,526010.54
500460,202208,283,150,133,181802.89,161196,342998.89
500470,202208,435,320,115,387845.2,139380.9,527226.1
500480,202208,107,60,47,72720,56964.39,129684.39
500490,202208,101,42,59,50904.35,71511.05,122415.40
500500,202208,1501,553,948,670245.59,1150195.28,1820440.87
500510,202208,41,32,9,38784.2,10908,49692.2
500515,202208,112,76,36,92112.6,43632.2,135744.8
500520,202208,297,151,146,183017.36,176952,359969.36
500525,202208,95,49,46,59388,55752,115140
500540,202208,915,402,513,488445.1,621762.25,1110207.35
500560,202208,895,495,400,603584.72,486016.54,1089601.26
500568,202208,1061,530,531,643584.97,644786.9,1288371.87
500570,202208,1223,697,526,845987.01,637515.09,1483502.10
500580,202208,312,164,148,198772.71,179377.17,378149.88
500600,202208,380,184,196,223010.75,237553.9,460564.65
500620,202208,974,663,311,804780.05,376933.73,1181713.78
500625,202208,81,65,16,79992.8,19392,99384.8
500627,202208,40,17,23,20604.15,27876,48480.15
500630,202208,1598,914,684,1107276.74,829013.23,1936289.97
500635,202208,509,303,206,367236,249672,616908
500640,202208,369,200,169,242405.71,204830.5,447236.21
500660,202208,5972,2141,3831,2594915.9,4643194.89,7238110.79
500690,202208,627,225,402,272701.74,488436.04,761137.78
500710,202208,414,206,208,249677.33,252096.6,501773.93
500720,202208,964,519,445,629036.01,539340.55,1168376.56
500730,202208,154,93,61,112720.99,73932,186652.99
500740,202208,984,419,565,507837.37,685997.65,1193835.02
500750,202208,185,66,119,79992.6,144229.92,224222.52
500755,202208,114,88,26,106659.85,31512.93,138172.78
500769,202208,750,413,337,500565.35,409659.39,910224.74
500770,202208,419,225,194,272700.4,235128,507828.4
500780,202208,132,91,41,110294.75,49692,159986.75
500790,202208,1090,528,562,639945.38,682361.13,1322306.51
500793,202208,294,153,141,185436.43,170895.66,356332.09
500795,202208,191,128,63,155137.48,76356.79,231494.27
500797,202208,49,33,16,39996,19392,59388
500800,202208,437,189,248,229070.69,300576,529646.69
500830,202208,2355,1252,1103,1517449.3,1339267.64,2856716.94
500840,202208,117,87,30,105447.5,36360,141807.5
510010,202208,177,92,85,111504,103020,214524
510020,202208,550,250,300,303004.47,363603.74,666608.21
510025,202208,1747,980,767,1188990.45,932036.4,2121026.85
510030,202208,663,350,313,425424.96,379360.08,804785.04
510035,202208,132,68,64,82416.22,78780,161196.22
510040,202208,411,195,216,236340.86,261793.28,498134.14
510050,202208,385,206,179,249677.08,216950.49,466627.57
510060,202208,128,59,69,71509.45,83628,155137.45
510080,202208,260,102,158,123624.93,191496.6,315121.53
510100,202208,66,25,41,30300.2,49692.1,79992.3
510120,202208,33,19,14,23028,16968.4,39996.4
510125,202208,396,251,145,304213.29,175740,479953.29
510130,202208,548,322,226,391483.11,275125.02,666608.13
510140,202208,455,145,310,175740.2,375721.88,551462.08
510160,202208,111,41,70,49692,84841.16,134533.16
510170,202208,764,455,309,551464.19,374511.74,925975.93
510180,202208,3016,1380,1636,1673796.47,1985278.81,3659075.28
510185,202208,26,13,13,15756,15756,31512
510190,202208,242,81,161,98172.83,195132.8,293305.63
510250,202208,2738,1682,1056,2039819.92,1279878.28,3319698.20
510260,202208,170,123,47,149077.57,58176.79,207254.36
510263,202208,498,278,220,336939.26,267854.56,604793.82
510267,202208,621,340,281,412086.1,340573.47,752659.57
510268,202208,69,34,35,41208.9,42420,83628.9
510269,202208,76,35,41,42420,49692.8,92112.8
510270,202208,381,183,198,221797.28,239976,461773.28
510279,202208,208,155,53,189072.6,64236,253308.6
510285,202208,182,72,110,87264.05,133320.5,220584.55
510300,202208,526,268,258,324817.99,312696.56,637514.55
510305,202208,194,88,106,106656.75,128472,235128.75
510310,202208,105,54,51,65448,61812.1,127260.1
510320,202208,826,510,316,618124.94,382992.3,1001117.24
510325,202208,449,192,257,232705.68,312697.45,545403.13
510330,202208,442,242,200,293307.24,242401.33,535708.57
510335,202208,678,398,280,482384.55,339361.33,821745.88
510336,202208,53,34,19,41208.53,23028.79,64237.32
510337,202208,101,44,57,53328,69084,122412
510340,202208,18496,7978,10518,9671975.3,12752829.44,22424804.74
510343,202208,60,47,13,56964.52,15756,72720.52
510345,202208,154,96,58,116352.37,70296.6,186648.97
510350,202208,663,350,313,424206.41,379358.38,803564.79
510360,202208,230,143,87,173317.09,105444,278761.09
510370,202208,168,74,94,89688,113928,203616
510380,202208,82,61,21,73932.52,25452,99384.52
510385,202208,64,30,34,36360.4,41208,77568.4
510390,202208,100,47,53,56964.1,64236.37,121200.47
510395,202208,57,39,18,47268,21816,69084
510410,202208,803,498,305,604802.37,372085.16,976887.53
510420,202208,554,269,285,326029.33,345420,671449.33
510450,202208,54,29,25,35148,30300,65448
510452,202208,58,28,30,33936,36360,70296
510454,202208,54,25,29,30300.2,35148.08,65448.28
510455,202208,120,69,51,83628,63024,146652
510460,202208,195,84,111,101810,135744.3,237554.3
510480,202208,744,438,306,530864.13,370873.59,901737.72
510490,202208,344,166,178,201192.3,215736,416928.3
510500,202208,234,171,63,207252.38,76356,283608.38
510510,202208,856,499,357,606007.42,432726.63,1038734.05
510515,202208,1288,663,625,803564.07,757504.79,1561068.86
510517,202208,282,123,159,149078.3,192708.9,341787.2
510520,202208,223,142,81,172104.99,98172.37,270277.36
510523,202208,118,91,27,110292.65,32724,143016.65
510525,202208,902,553,349,671460.01,422991.12,1094451.13
510530,202208,24,15,9,18180,10908,29088
510550,202208,247,113,134,136956.69,162409.25,299365.94
510558,202208,318,159,159,192709.4,192708,385417.4
510560,202208,385,217,168,263047.34,204831.19,467878.53
510562,202208,672,476,196,576919.47,237553.35,814472.82
510590,202208,715,350,365,424204.43,442381.06,866585.49
510600,202208,228,116,112,140595.58,135744.99,276340.57
510610,202208,239,109,130,132109.05,157560.6,289669.65
510615,202208,225,105,120,127260.38,145440.8,272701.18
510617,202208,26,11,15,13332,18180,31512
510618,202208,128,57,71,69084,86053.19,155137.19
510619,202208,83,58,25,70296,30300,100596
510620,202208,164,89,75,107868,90900,198768
510621,202208,179,112,67,135744.17,81204.43,216948.60
510622,202208,501,268,233,324826.35,282399.28,607225.63
510623,202208,281,189,92,230283.23,112716,342999.23
510624,202208,94,46,48,55752.95,58176.53,113929.48
510625,202208,536,335,201,406027.7,243614.73,649642.43
510626,202208,121,74,47,89690.29,56964.1,146654.39
510627,202208,92,64,28,77569.1,33936.2,111505.3
510628,202208,166,100,66,121200.25,79992,201192.25
510629,202208,281,167,114,202404.4,139401.81,341806.21
510630,202208,444,224,220,272701.74,267852.3,540554.04
510631,202208,21,9,12,10908,14544,25452
510637,202208,356,209,147,253309.86,179376,432685.86
510642,202208,1154,608,546,738121.06,661757.56,1399878.62
510645,202208,9,1,8,1212,9696,10908
510650,202208,1306,845,461,1025378.88,558735.76,1584114.64
510665,202208,87,40,47,48480,56964,105444
510670,202208,59,34,25,41208.6,30300,71508.6
510675,202208,1101,708,393,858106.14,477533.01,1335639.15
510677,202208,351,182,169,220586.4,204829.11,425415.51
510680,202208,86,54,32,65449,38784,104233
510682,202208,191,96,95,116352.52,116352,232704.52
510685,202208,55,40,15,48480,18180,66660
510700,202208,586,332,254,402389.14,307848.47,710237.61
510704,202208,1223,613,610,745393.82,739330.95,1484724.77
510706,202208,160,84,76,101809.49,92112.91,193922.40
510710,202208,435,300,135,363605.94,164832.6,528438.54
510715,202208,58,40,18,48480.2,21816.41,70296.61
510718,202208,239,107,132,129684.73,159987.08,289671.81
510719,202208,47,18,29,21816,35148,56964
510720,202208,186,131,55,158773.78,66660,225433.78
510724,202208,82,29,53,35148,64236,99384
510726,202208,68,31,37,37573.09,44844,82417.09
510729,202208,14,5,9,6060,10908.1,16968.1
510730,202208,449,244,205,295729.31,249672,545401.31
510735,202208,114,47,67,56964,81204.52,138168.52
510740,202208,22,12,10,14544.5,12120.2,26664.7
510757,202208,31,26,5,31513.24,6060.16,37573.40
510760,202208,7652,3848,3804,4666271.98,4614120.29,9280392.27
510770,202208,720,333,387,403599.25,470256.9,873856.15
510774,202208,18,7,11,8484,13332,21816
510775,202208,116,87,29,105444,35148,140592
510776,202208,39,11,28,13332.1,33936.2,47268.3
510777,202208,193,82,111,99384,134532,233916
510779,202208,37,22,15,26664,18180,44844
510780,202208,269,141,128,170895.64,155136,326031.64
510785,202208,351,190,161,230283,195132.2,425415.2
510787,202208,199,95,104,115140.4,126048.85,241189.25
510788,202208,7,2,5,2424.15,6060,8484.15
510790,202208,2698,1387,1311,1682816.17,1590150.49,3272966.66
510792,202208,1125,620,505,751700.02,613278.43,1364978.45
510794,202208,112,62,50,75144,60600,135744
510795,202208,2342,1335,1007,1618044.27,1220490.23,2838534.50
510800,202208,191,111,80,134532.95,96960.14,231493.09
510805,202208,203,132,71,161196.2,86052.2,247248.4
510810,202208,108,45,63,54541.42,76356.42,130897.84
510820,202208,239,121,118,146654.09,143017.2,289671.29
510830,202208,76,39,37,47268.47,44844,92112.47
510835,202208,21,14,7,16968,8484,25452
510840,202208,9439,4329,5110,5249291.18,6195804.95,11445096.13
510850,202208,206,84,122,101808.99,147864.71,249673.70
510860,202208,411,199,212,241189.46,256944.62,498134.08
510880,202208,71,51,20,61812,24240,86052
510885,202208,71,41,30,49692.02,36360,86052.02
510890,202208,74,39,35,47268.04,42420,89688.04
510895,202208,176,102,74,123625.23,89688,213313.23
520005,202208,163,61,102,73933.14,124837.9,198771.04
520010,202208,301,129,172,156349.2,208466.83,364816.03
520013,202208,744,504,240,611906.33,290882.39,902788.72
520015,202208,42,28,14,33936,16968,50904
520017,202208,86,53,33,64236,39996,104232
520020,202208,13,5,8,6060,9696,15756
520025,202208,2835,1486,1349,1801076.38,1637445.21,3438521.59
520030,202208,834,439,395,533590.18,481164.68,1014754.86
520050,202208,63,46,17,55752,20604.51,76356.51
520055,202208,77,49,28,59388,33936,93324
520060,202208,177,115,62,139384.23,75145.1,214529.33
520080,202208,571,406,165,492073.62,199980.2,692053.82
520082,202208,16,11,5,13332,6060,19392
520085,202208,102,77,25,93325.22,30300,123625.22
520090,202208,83,60,23,72720,27876,100596
520110,202208,9336,3919,5417,4753530.23,6567880.06,11321410.29
520120,202208,11,4,7,4848,8484,13332
520130,202208,827,573,254,694483.06,307851.07,1002334.13
520140,202208,12157,6601,5556,8006625.34,6737559.38,14744184.72
520145,202208,53,31,22,37572.2,26664,64236.2
520150,202208,143,112,31,135746.16,37572,173318.16
520160,202208,42,26,16,31512,19392,50904
520170,202208,218,123,95,149080.9,115144.67,264225.57
520180,202208,197,90,107,109080.8,129684.2,238765.0
520215,202208,199,137,62,166044.97,75144,241188.97
520235,202208,84,62,22,76356,26664.11,103020.11
520250,202208,141,75,66,90900.6,79992,170892.6
520260,202208,118,72,46,87265.91,55753.1,143019.01
520280,202208,48,33,15,39996,18180,58176
520310,202208,46,28,18,33936.9,21816.2,55753.1
520320,202208,178,107,71,129685.88,86052.97,215738.85
520330,202208,841,464,377,562373.28,458139.03,1020512.31
520340,202208,376,212,164,256948.3,199980.99,456929.29
520350,202208,487,247,240,299367.53,292092.91,591460.44
520355,202208,99,57,42,69084.8,50904,119988.8
520357,202208,33,26,7,31512,8484,39996
520360,202208,6,2,4,2424,6060,8484
520380,202208,140,77,63,93324,76356,169680
520390,202208,238,107,131,129687.61,158772,288459.61
520393,202208,16,12,4,14544,4848,19392
520396,202208,77,55,22,66660,26664,93324
520400,202208,200,120,80,145443.26,96961.24,242404.50
520410,202208,197,97,100,117565.21,121200.2,238765.41
520420,202208,20,13,7,15756,8484,24240
520425,202208,250,124,126,150289,152712.81,303001.81
520430,202208,525,251,274,304214.82,332088.5,636303.32
520440,202208,644,455,189,551469.21,229068.64,780537.85
520450,202208,2174,909,1265,1102937.02,1534402.76,2637339.78
520455,202208,61,34,27,41209.07,32724.2,73933.27
520460,202208,45,28,17,33936.2,20604.75,54540.95
520465,202208,36,30,6,36360,7272,43632
520470,202208,445,275,170,333300.49,206040,539340.49
520480,202208,76,46,30,55752.8,36360,92112.8
520485,202208,110,43,67,52117.62,81204.1,133321.72
520490,202208,468,338,130,409661.5,157561.06,567222.56
520495,202208,160,94,66,113928.1,79992,193920.1
520500,202208,187,147,40,178165.25,48480.85,226646.10
520505,202208,196,113,83,136956,101808,238764
520510,202208,1991,931,1060,1128382.3,1287152.05,2415534.35
520520,202208,56,37,19,44844,23028,67872
520530,202208,201,160,41,193921.5,49692,243613.5
520540,202208,725,487,238,590247.89,288456.97,878704.86
520545,202208,142,77,65,93325.58,78780,172105.58
520547,202208,63,33,30,39996.35,36360.54,76356.89
520549,202208,1474,694,780,841144.71,945370.37,1786515.08
520551,202208,335,173,162,209677.83,197556.6,407234.43
520552,202208,40,29,11,35148.68,13332,48480.68
520570,202208,13,9,4,10908,4848,15756
520580,202208,274,169,105,204829.18,127260.53,332089.71
520590,202208,141,80,61,96960.38,75144,172104.38
520620,202208,1200,549,651,665393.8,789016.15,1454409.95
520630,202208,44,24,20,29088,24240,53328
520640,202208,378,223,155,271489.01,187860.39,459349.40
520650,202208,66,32,34,38784,41208,79992
520660,202208,40,21,19,25452.9,23028.38,48481.28
520670,202208,44,34,10,41208.6,12120,53328.6
520680,202208,30,17,13,20604,15756,36360
520690,202208,39,11,28,13332,33936.1,47268.1
520710,202208,33,28,5,33936,6060,39996
520725,202208,197,147,50,178167.09,60600,238767.09
520735,202208,59,39,20,47268.2,24240.2,71508.4
520740,202208,483,228,255,276339.22,309060.1,585399.32
520750,202208,36,25,11,30300,13332,43632
520753,202208,78,56,22,67872,26664,94536
520760,202208,99,65,34,78780.2,41208.1,119988.3
520780,202208,266,203,63,246038.8,76356.13,322394.93
520790,202208,150,92,58,111504,70296,181800
520800,202208,3434,1905,1529,2308906.14,1853166.88,4162073.02
520810,202208,140,108,32,130898.08,38784,169682.08
520815,202208,6,4,2,4848,2424,7272
520830,202208,138,93,45,112717.97,54540.9,167258.87
520840,202208,390,250,140,303001.17,170892.1,473893.27
520850,202208,107,60,47,72721,56964,129685
520860,202208,1813,1145,668,1387759.08,810831.54,2198590.62
520870,202208,32914,14900,18014,18062704.09,21851326.18,39914030.27
520880,202208,1262,669,593,810845.97,718726.91,1529572.88
520890,202208,837,521,316,631462.04,382993.15,1014455.19
520910,202208,1009,533,476,646007.74,576912.88,1222920.62
520915,202208,90,70,20,84843.3,24240,109083.3
520920,202208,471,217,254,263009.43,309064.55,572073.98
520929,202208,14,12,2,14544.8,2424,16968.8
520940,202208,61,45,16,54540.5,19392.1,73932.6
520945,202208,13,8,5,9696,6060,15756
520960,202208,41,25,16,30300,19392,49692
520970,202208,410,236,174,286034.09,210889.43,496923.52
520980,202208,90,67,23,81204,27876,109080
520990,202208,442,312,130,378145.56,157560.2,535705.76
520993,202208,127,65,62,78783.16,75144.3,153927.46
520995,202208,265,143,122,173316.82,147864,321180.82
521000,202208,1602,897,705,1088389.64,854466.14,1942855.78
521010,202208,631,329,302,399966.19,366027.91,765994.10
521015,202208,13,7,6,8484,7272,15756
521020,202208,1419,984,435,1193836.12,527226.38,1721062.50
521030,202208,59,41,18,49692.8,21816,71508.8
521040,202208,969,631,338,764781.39,409658.71,1174440.10
521056,202208,56,36,20,43632,24240,67872
521060,202208,121,78,43,94536.2,52116,146652.2
521080,202208,331,257,74,311500.12,89688.7,401188.82
521090,202208,571,379,192,459350.81,232704.69,692055.50
521100,202208,259,186,73,225432.4,88476.2,313908.6
521120,202208,1058,739,319,895682.26,386630.48,1282312.74
521130,202208,326,235,91,284822.77,110292.6,395115.37
521140,202208,196,109,87,132108.11,105444.69,237552.80
521150,202208,2580,1115,1465,1353821.66,1776809.08,3130630.74
521160,202208,24,10,14,12120,16968,29088
521170,202208,224,120,104,145440.71,126048.2,271488.91
521180,202208,1190,754,436,913859.95,529652.83,1443512.78
521190,202208,2596,1084,1512,1313827.93,1833764.72,3147592.65
521200,202208,57,39,18,47268,21816,69084
521205,202208,12,9,3,10908,3636,14544
521210,202208,120,76,44,92113.25,53328,145441.25
521220,202208,745,513,232,621757.63,281186.18,902943.81
521225,202208,22,15,7,18180.4,8484.2,26664.6
521230,202208,103,64,39,77568,47269.39,124837.39
521250,202208,6426,3530,2896,4278453.25,3512424.3,7790877.55
521260,202208,33,16,17,19392,20604,39996
521270,202208,130,98,32,118776,38784,157560
521280,202208,417,261,156,316332.81,189072,505404.81
521290,202208,27,16,11,19392.4,13332,32724.4
521295,202208,102,68,34,82416.26,41208,123624.26
521300,202208,229,125,104,151501.16,126048,277549.16
521305,202208,41,30,11,37573,13332,50905
521308,202208,1019,780,239,945377.82,289670.95,1235048.77
521310,202208,1363,762,601,923562.23,729634.39,1653196.62
521340,202208,21,16,5,19392,6060,25452
521350,202208,116,86,30,104232,36360,140592
521370,202208,159,110,49,133320,59388,192708
521375,202208,197,94,103,113930.52,124836.61,238767.13
521377,202208,51,39,12,47268,14544,61812
521380,202208,1075,640,435,775697.95,528437.87,1304135.82
521385,202208,13,6,7,7272,8484,15756
521390,202208,107,84,23,101808.1,27876,129684.1
521400,202208,370,262,108,317548.9,130896.8,448445.7
521405,202208,154,91,63,110293.04,76356.66,186649.70
521410,202208,81,59,22,71508.1,26664,98172.1
521440,202208,213,146,67,176954,81204.15,258158.15
521450,202208,783,431,352,522380.31,426625.04,949005.35
521460,202208,1113,748,365,907802.63,442381.14,1350183.77
521470,202208,14,10,4,12120,4848,16968
521480,202208,39,27,12,32724.17,14544.6,47268.77
521483,202208,330,208,122,253309.5,147864,401173.5
521486,202208,295,191,104,231492.93,126048.84,357541.77
521487,202208,23,11,12,13332,14544,27876
521490,202208,23,14,9,16968,10908,27876
521500,202208,138,60,78,72720.21,94536.89,167257.10
521520,202208,43,32,11,38784,13332,52116
521523,202208,1006,564,442,683574.94,535704.5,1219279.44
521525,202208,52,36,16,43632,19392,63024
521530,202208,245,139,106,168468,128472.4,296940.4
521540,202208,41,21,20,25452,24240,49692
521550,202208,110,50,60,60600.2,72720.99,133321.19
521560,202208,890,583,307,706606.38,372086.23,1078692.61
521565,202208,67,48,19,58177.21,23028,81205.21
521570,202208,551,352,199,426630.07,241188.7,667818.77
521580,202208,53,33,20,39996,24240,64236
521590,202208,33,15,18,18180,21816,39996
521600,202208,27,12,15,14544,18180,32724
521630,202208,229,117,112,141808.69,135750.55,277559.24
521640,202208,295,153,142,186650.27,172104.1,358754.37
521645,202208,40,21,19,25452,23028,48480
521680,202208,253,152,101,184224.2,122412.4,306636.6
521690,202208,14,12,2,14544,2424,16968
521710,202208,1158,540,618,655698.99,750229.53,1405928.52
521720,202208,521,359,162,435111.04,197557.64,632668.68
521730,202208,687,322,365,390267.65,442381.34,832648.99
521740,202208,907,412,495,499347.94,599942.85,1099290.79
521760,202208,2331,1205,1126,1461781.43,1367156.6,2828938.03
521770,202208,827,508,319,615702.23,386630.59,1002332.82
521800,202208,1985,1313,672,1591372.34,815676.93,2407049.27
521805,202208,38,21,17,25452,20604,46056
521810,202208,95,53,42,64236.8,50904.4,115141.2
521830,202208,999,718,281,870232.44,341791.04,1212023.48
521839,202208,74,42,32,50904,38784,89688
521850,202208,1158,575,583,696911.75,706602.46,1403514.21
521860,202208,335,210,125,254522.29,152712,407234.29
521870,202208,80,50,30,60600,36360,96960
521878,202208,36,14,22,16968,26664.74,43632.74
521880,202208,4957,2145,2812,2599777.1,3411807.8,6011584.9
521890,202208,597,405,192,490865.36,232704.31,723569.67
521900,202208,276,219,57,265429.2,69084,334513.2
521910,202208,183,123,60,149078.44,72720.6,221799.04
521920,202208,39,23,16,27876,19392,47268
521925,202208,49,29,20,35148,24240,59388
521930,202208,1209,673,536,815687.8,650847.31,1466535.11
521935,202208,30,21,9,25452.91,10908,36360.91
521940,202208,236,106,130,128472.64,157560.2,286032.84
521945,202208,18,13,5,15756,6060,21816
521950,202208,19,14,5,16968,6060,23028
521960,202208,69,53,16,64236,19392,83628
521970,202208,411,262,149,317547.38,180589.78,498137.16
521971,202208,115,58,57,70296,69084,139380
521973,202208,42,21,21,25452.2,25452,50904.2
521975,202208,1618,830,788,1005979.98,955069.08,1961049.06
521980,202208,237,157,80,190284.2,96960,287244.2
521990,202208,76,54,22,65448.92,26664,92112.92
522000,202208,289,191,98,232284.06,118776,351060.06
522005,202208,18,11,7,13332,8484,21816
522010,202208,1137,634,503,768421.49,609641.64,1378063.13
522015,202208,59,38,21,46056,25452,71508
522020,202208,908,536,372,649636.89,452078.04,1101714.93
522026,202208,23,16,7,19392,8484,27876
522028,202208,22,19,3,23028,3636,26664
522040,202208,812,342,470,414514.13,569645.47,984159.60
522045,202208,2702,1575,1127,1910147.54,1368359.41,3278506.95
522050,202208,166,78,88,94539.37,106656.72,201196.09
522060,202208,539,340,199,412081.2,241188.4,653269.6
522068,202208,109,80,29,96960,35148,132108
522070,202208,17,15,2,18180,2424,20604
522100,202208,39,25,14,30300,16968,47268
522108,202208,44,33,11,39996.93,13332.2,53329.13
522119,202208,59,33,26,39996,31512,71508
522130,202208,70,23,47,27876.29,56964.4,84840.69
522140,202208,4214,2197,2017,2664021.23,2445825.24,5109846.47
522145,202208,46,33,13,39996,15756,55752
522150,202208,101,69,32,83628.08,38784,122412.08
522155,202208,52,37,15,44844.2,18180,63024.2
522157,202208,16,9,7,10908.19,8484,19392.19
522160,202208,1680,1000,680,1213232.8,825376.39,2038609.19
522170,202208,406,276,130,335725.19,158772.9,494498.09
522180,202208,34,13,21,15756,25452,41208
522185,202208,2478,1066,1412,1292013.42,1711371.16,3003384.58
522190,202208,72,40,32,48480.2,38784,87264.2
522200,202208,314,182,132,220584.3,159984.46,380568.76
522205,202208,148,100,48,121201.49,58176.1,179377.59
522220,202208,139,106,33,128472.06,39996,168468.06
522230,202208,34,30,4,36360,4848,41208
530010,202208,55442,28063,27379,34027881.09,33206811.01,67234692.10
110001,202209,528,430,98,522375.68,118776,641151.68
110002,202209,2910,1851,1059,2243436.88,1284730.61,3528167.49
110003,202209,83,65,18,78780.3,21816,100596.3
110004,202209,2106,1423,683,1727120.64,827800.44,2554921.08
110005,202209,440,342,98,414507.24,118776.2,533283.44
110006,202209,441,326,115,395115.62,139380.8,534496.42
110007,202209,76,61,15,73932.16,18180,92112.16
110008,202209,254,144,110,174528.97,133320.2,307849.17
110009,202209,951,725,226,878703.02,275124.4,1153827.42
110010,202209,1697,975,722,1181711.46,875066.27,2056777.73
110011,202209,1723,1329,394,1610771.99,478747.77,2089519.76
110012,202209,4160,2395,1765,2905188.75,2141614.76,5046803.51
110013,202209,730,573,157,694486.92,191496.94,885983.86
110014,202209,370,329,41,398749.89,49692,448441.89
110015,202209,1363,1052,311,1275034.45,376935.92,1651970.37
110018,202209,1058,655,403,793870.18,488438.29,1282308.47
110020,202209,16551,9241,7310,11203971.85,8863460.63,20067432.48
110025,202209,660,482,178,585400.17,215737.32,801137.49
110026,202209,37,24,13,29089.18,15756,44845.18
110028,202209,1632,1157,475,1402310.31,575708.61,1978018.92
110029,202209,122,110,12,133320.88,14544,147864.88
110030,202209,2432,1594,838,1932973.14,1016874.14,2949847.28
110032,202209,330,251,79,304221.07,95750.4,399971.47
110033,202209,665,475,190,576925.46,230285.16,807210.62
110034,202209,320,232,88,281184.43,106656.97,387841.40
110037,202209,89,80,9,96960.4,10908,107868.4
110040,202209,405,279,126,338148.6,152712,490860.6
110045,202209,950,682,268,826599.39,326029.62,1152629.01
110050,202209,89,77,12,93324.57,14544.33,107868.90
110060,202209,61,39,22,47269.25,26664,73933.25
110070,202209,106,70,36,84840.29,43632,128472.29
110080,202209,542,309,233,374511.21,282396.7,656907.91
110090,202209,27,22,5,26664,6060,32724
110092,202209,115,60,55,72721.62,66660,139381.62
110094,202209,203,138,65,167258.77,78780,246038.77
110100,202209,52,37,15,44844.01,18180.54,63024.55
110110,202209,119,70,49,84841.67,59388,144229.67
110120,202209,65,58,7,70296.94,8484.65,78781.59
110130,202209,268,213,55,258159.82,66660.3,324820.12
110140,202209,255,181,74,219373.36,89688.1,309061.46
110143,202209,56,44,12,53328,14544,67872
110145,202209,40,30,10,36360.39,12120,48480.39
110146,202209,27,12,15,14544,18180,32724
110147,202209,41,28,13,33936.73,15756,49692.73
110148,202209,34,27,7,32724.84,8484,41208.84
110149,202209,301,211,90,255732.4,109080,364812.4
110150,202209,140,107,33,129684.2,39996,169680.2
110155,202209,11,9,2,10908,2424,13332
110160,202209,68,51,17,61813.31,20604.6,82417.91
110170,202209,219,163,56,197556.49,67872,265428.49
110175,202209,68,52,16,63025.12,19392,82417.12
110180,202209,88,69,19,83628.82,23028,106656.82
120001,202209,216,158,58,191502.15,70296.71,261798.86
120005,202209,217,127,90,153925.49,109080.1,263005.59
120010,202209,1181,718,463,870223.04,562370.05,1432593.09
120013,202209,168,113,55,136957.25,66660.1,203617.35
120017,202209,125,73,52,88476.8,63024,151500.8
120020,202209,3446,2777,669,3368234.19,812052.05,4180286.24
120025,202209,580,318,262,385435.32,317550.27,702985.59
120030,202209,1154,990,164,1199939.32,198776.26,1398715.58
120032,202209,48,42,6,50906.4,7272,58178.4
120033,202209,230,197,33,238772.74,39996.55,278769.29
120034,202209,182,134,48,162410.67,58176,220586.67
120035,202209,50,43,7,52116.45,8484,60600.45
120038,202209,406,260,146,315127.57,176952.96,492080.53
120039,202209,31,29,2,35149.65,2424,37573.65
120040,202209,14754,9929,4825,12040128.31,5854296.35,17894424.66
120042,202209,48,44,4,53329.95,4848.55,58178.50
120043,202209,17,4,13,4848,15756,20604
120045,202209,539,344,195,416938.98,236342.91,653281.89
120050,202209,1295,995,300,1206000.98,363611.87,1569612.85
120060,202209,1506,1262,244,1530812.93,295734.64,1826547.57
120070,202209,417,299,118,362395.5,143016.09,505411.59
120080,202209,199,128,71,155137.96,87264.65,242402.61
130002,202209,163,116,47,140592,56964,197556
130006,202209,105,69,36,83628,43632,127260
130008,202209,130,75,55,90900,66660,157560
130010,202209,176,115,61,139382.5,73932.09,213314.59
130014,202209,295,209,86,253611.78,104232.2,357843.98
130020,202209,120,78,42,94536.2,50904,145440.2
130030,202209,977,550,427,666604.43,517525.8,1184130.23
130040,202209,395,188,207,227856.4,250884,478740.4
130050,202209,548,292,256,353906.02,311489.91,665395.93
130060,202209,861,580,281,702961.63,340572,1043533.63
130063,202209,616,380,236,460560,286032,746592
130068,202209,239,152,87,184228.93,105446.39,289675.32
130070,202209,1358,900,458,1090817.41,555099.51,1645916.92
130080,202209,667,443,224,536920.08,271489.66,808409.74
130083,202209,88,57,31,69084.4,37572,106656.4
130090,202209,321,180,141,218160.3,170892,389052.3
130100,202209,1321,664,657,804776.78,797499.3,1602276.08
130110,202209,789,353,436,427836.3,528433.65,956269.95
130115,202209,152,78,74,94536.1,89688,184224.1
130120,202209,1689,1051,638,1275035.71,774469.08,2049504.79
130130,202209,625,420,205,509040,248460,757500
130140,202209,1558,1198,360,1451982.33,436320,1888302.33
130150,202209,394,345,49,418140.8,59388,477528.8
130160,202209,450,275,175,333300.9,212100,545400.9
130165,202209,100,85,15,103021.83,18180,121201.83
130170,202209,1054,733,321,889551.35,390270.88,1279822.23
130180,202209,256,190,66,230280.66,79992.2,310272.86
130185,202209,2274,1095,1179,1327162.8,1430176.14,2757338.94
130190,202209,3343,2078,1265,2518571.38,1534406.29,4052977.67
130195,202209,298,239,59,289668,71508,361176
130200,202209,187,99,88,119988,106656,226644
130210,202209,96,46,50,55752,60600,116352
130220,202209,218,157,61,190285.15,73932,264217.15
130230,202209,364,244,120,295728,145440,441168
130240,202209,1368,880,488,1066565.22,592668.58,1659233.80
130250,202209,4830,3109,1721,3768158.38,2088300.25,5856458.63
130255,202209,426,218,208,264216.52,253308.4,517524.92
130260,202209,63613,29336,34277,35574022.57,41584622.75,77158645.32
130270,202209,1545,1060,485,1284832.95,589033.43,1873866.38
130280,202209,143,82,61,99384.2,73932,173316.2
130290,202209,2065,1339,726,1624104.18,879922.78,2504026.96
130300,202209,430,292,138,353907.01,167258.06,521165.07
130310,202209,905,476,429,576912.69,522372.9,1099285.59
130320,202209,553,299,254,362388.13,307848.06,670236.19
130330,202209,755,480,275,581764.93,333301,915065.93
130340,202209,3559,1951,1608,2367076.87,1952554.89,4319631.76
130350,202209,468,323,145,391476,175740,567216
130353,202209,951,434,517,526018.53,627821.99,1153840.52
130356,202209,820,374,446,453290.75,540554.55,993845.30
130360,202209,111,88,23,106656.8,27876,134532.8
130370,202209,683,533,150,645996.38,181800,827796.38
130380,202209,674,535,139,648422.54,169680,818102.54
130390,202209,457,370,87,448440.2,105444,553884.2
130395,202209,170,58,112,70296,135744.13,206040.13
130400,202209,99,79,20,95752.98,24240,119992.98
130406,202209,2188,1265,923,1533187.46,1118678.29,2651865.75
130410,202209,441,226,215,273912,260580,534492
130420,202209,2800,2270,530,2751306.74,642362.06,3393668.80
130423,202209,232,156,76,189080.09,92112,281192.09
130426,202209,189,103,86,124836,104232,229068
130430,202209,406,230,176,278760,213312,492072
130440,202209,199,69,130,83628.93,157561.7,241190.63
140002,202209,42,9,33,10908.2,39996.95,50905.15
140005,202209,233,135,98,163622.6,118777.19,282399.79
140010,202209,12125,7189,4936,8721812.18,5983764.28,14705576.46
140015,202209,170,72,98,87264.93,118776.47,206041.40
140017,202209,150,82,68,100602.48,82417.32,183019.80
140020,202209,448,296,152,358762.32,184226.66,542988.98
140023,202209,68,40,28,48480.8,33936,82416.8
140028,202209,26,14,12,16968.42,14544.7,31513.12
140030,202209,410,260,150,315123.38,181800.4,496923.78
140040,202209,72,49,23,59388,27876,87264
140045,202209,317,108,209,130896.8,253309.69,384206.49
140047,202209,562,361,201,438751.19,243613.19,682364.38
140050,202209,144,92,52,111507.36,63024,174531.36
140060,202209,85,57,28,69084.3,35148.2,104232.5
140070,202209,26,23,3,27876.2,3636,31512.2
150010,202209,5181,3101,2080,3758470.27,2520982.77,6279453.04
150013,202209,170,116,54,140592.2,65449.59,206041.79
150020,202209,1135,624,511,756294.64,619333.83,1375628.47
150030,202209,715,317,398,384212.61,482378.41,866591.02
150034,202209,216,127,89,153925.8,107868.5,261794.3
150040,202209,1687,963,724,1167184.03,877504.45,2044688.48
150050,202209,735,424,311,513891.59,376933,890824.59
150060,202209,5035,3131,1904,3795944.62,2309384.99,6105329.61
150070,202209,480,253,227,306638.35,275125.09,581763.44
150080,202209,17933,8315,9618,10079241.68,11662080.33,21741322.01
150085,202209,449,281,168,340578.54,203618.54,544197.08
150090,202209,711,571,140,692057.7,169680.3,861738.0
150095,202209,63,44,19,53329.84,23028.89,76358.73
150100,202209,74,45,29,54540,35148.6,89688.6
150110,202209,218,125,93,151500.68,112717.28,264217.96
150120,202209,409,291,118,352696.15,143016.4,495712.55
150125,202209,48,18,30,21816,36360,58176
150130,202209,2341,1154,1187,1398668.23,1438665.03,2837333.26
150140,202209,61990,26664,35326,32326044.34,42831651.53,75157695.87
150145,202209,264,141,123,170893.55,149076.3,319969.85
150150,202209,3616,1581,2035,1916214.43,2467674.35,4383888.78
150157,202209,377,273,104,330883.2,126048.08,456931.28
150160,202209,147,109,38,132108.69,46056,178164.69
150170,202209,3996,2878,1118,3488177.89,1357452.4,4845630.29
150172,202209,373,261,112,316333.77,135746.01,452079.78
150175,202209,91,51,40,61812.3,48480,110292.3
150178,202209,793,543,250,658131.86,303004.04,961135.90
150180,202209,3386,1674,1712,2028929.51,2076164.09,4105093.60
150190,202209,393,261,132,316334.85,159984.9,476319.75
150195,202209,127,71,56,86052.29,67872.42,153924.71
150200,202209,191,91,100,110292,121200.3,231492.3
150210,202209,3334,2582,752,3129440.56,911436.29,4040876.85
150215,202209,672,399,273,483597,330883.59,814480.59
150220,202209,3606,2386,1220,2891879.53,1478657.12,4370536.65
150230,202209,1396,1121,275,1358671.76,333302.02,1691973.78
150240,202209,7378,4054,3324,4915986.75,4032392.32,8948379.07
150250,202209,82,46,36,55752.1,43632,99384.1
150260,202209,127,88,39,106658.64,48480.8,155139.44
150270,202209,2173,1409,764,1708939.66,925975.69,2634915.35
150275,202209,550,353,197,427842.67,238765.75,666608.42
150276,202209,114,39,75,47268,90900.5,138168.5
150277,202209,882,394,488,477536.19,593890.07,1071426.26
150280,202209,346,239,107,289669.21,129684.2,419353.41
150285,202209,159,81,78,98172.37,94342.08,192514.45
150290,202209,1291,723,568,876294.35,688426.38,1564720.73
150293,202209,822,387,435,469053.89,527224.44,996278.33
150295,202209,591,282,309,341791.02,375722.18,717513.20
150300,202209,95,44,51,53328.1,61812.6,115140.7
150304,202209,197,116,81,141804.2,98172.75,239976.95
150307,202209,459,378,81,458142.87,98172.5,556315.37
150309,202209,611,428,183,518748.69,221800.78,740549.47
150310,202209,281,185,96,224221.7,116352,340573.7
150320,202209,1919,1317,602,1596219.83,729632.62,2325852.45
150330,202209,2132,1221,911,1479863.79,1104136.33,2584000.12
150340,202209,199,127,72,153925.2,87264,241189.2
150345,202209,655,358,297,433900.62,359964.02,793864.64
150350,202209,415,328,87,397553.34,105446.03,502999.37
150360,202209,5031,2933,2098,3554861.34,2545229.04,6100090.38
150370,202209,840,571,269,692065.3,327244.94,1019310.24
150375,202209,190,81,109,98172,132108.18,230280.18
150380,202209,1554,1024,530,1241110.89,642365.09,1883475.98
150390,202209,912,519,393,629043.19,476319.94,1105363.13
150400,202209,114,95,19,115140.2,23028,138168.2
150405,202209,1676,1065,611,1290793.26,741746.24,2032539.50
150410,202209,105,65,40,78780,48480.2,127260.2
150420,202209,7989,4230,3759,5127098.7,4562075.79,9689174.49
150430,202209,674,416,258,504214.98,312699.51,816914.49
150440,202209,460,279,181,338154.84,219373.94,557528.78
150442,202209,2494,1310,1184,1587755.41,1436235.55,3023990.96
150445,202209,563,364,199,441173.2,241188.4,682361.6
150450,202209,231,134,97,162408,117564,279972
150460,202209,706,530,176,642373.49,213312.57,855686.06
150470,202209,1314,785,529,951437.24,641150.81,1592588.05
150475,202209,251,190,61,230283.9,73932.98,304216.88
150480,202209,1459,1018,441,1233846,535710.38,1769556.38
150490,202209,608,362,246,438746.73,298152,736898.73
150495,202209,343,256,87,311484.23,105444,416928.23
150497,202209,289,190,99,230282.17,119988,350270.17
150500,202209,277,162,115,196346.3,139380.7,335727.0
150503,202209,1387,693,694,839937.67,841134.47,1681072.14
150506,202209,920,633,287,767206.56,347845.12,1115051.68
150510,202209,1365,744,621,901744.24,752656.07,1654400.31
150520,202209,332,226,106,273913.27,128472,402385.27
150530,202209,2000,1122,878,1359912.25,1065401.56,2425313.81
150540,202209,223,165,58,199980.9,70296.56,270277.46
150543,202209,920,472,448,572079.2,544196.03,1116275.23
150548,202209,461,333,128,403597.28,156349.36,559946.64
150549,202209,88,55,33,66660.4,39996,106656.4
150550,202209,3264,1633,1631,1979220.9,1979210.87,3958431.77
150553,202209,3783,2093,1690,2536776.76,2051952.55,4588729.31
150555,202209,147,79,68,95748.2,82416,178164.2
150560,202209,67,33,34,39996,41208,81204
150563,202209,128,65,63,78782.82,76356.59,155139.41
150565,202209,223,136,87,164832.4,105444,270276.4
150570,202209,419,277,142,335724.1,172104.1,507828.2
150580,202209,1757,860,897,1042327.02,1088377.46,2130704.48
150590,202209,871,569,302,689638.26,366027.47,1055665.73
150600,202209,526,319,207,386636.8,252101.49,638738.29
150610,202209,175,138,37,167256,44844,212100
150611,202209,142,92,50,111504,60600,172104
150613,202209,3521,1962,1559,2378003.3,1890812.75,4268816.05
150616,202209,591,327,264,396330.57,319970.42,716300.99
150618,202209,1435,737,698,894461.18,847190.37,1741651.55
150619,202209,408,309,99,374509.93,119991,494500.93
150620,202209,1292,741,551,898106.38,667814.88,1565921.26
150630,202209,170,110,60,133325.5,72721.45,206046.95
150635,202209,488,220,268,266645.49,324819.7,591465.19
150640,202209,47,22,25,26664.73,30300,56964.73
150650,202209,2548,1447,1101,1753804.04,1334440.55,3088244.59
150655,202209,276,202,74,244824.2,90900,335724.2
150658,202209,77,44,33,53328.2,39996,93324.2
150660,202209,600,384,216,465415.72,261793.21,727208.93
150670,202209,1181,426,755,516317.33,915068.81,1431386.14
150680,202209,11487,6006,5481,7285562.96,6652801.36,13938364.32
150690,202209,39,19,20,23028.76,24240,47268.76
150700,202209,559,368,191,446030.18,231495.63,677525.81
150710,202209,295,169,126,207254.05,152713.41,359967.46
150715,202209,853,533,320,646007.54,387842.35,1033849.89
150720,202209,433,329,104,398752.54,126048.73,524801.27
150730,202209,1160,545,615,660555.47,745386.59,1405942.06
150740,202209,255,161,94,195132.2,113928,309060.2
150745,202209,812,446,366,540562.54,444806.64,985369.18
150746,202209,72,36,36,43632,43632,87264
150747,202209,264,185,79,224223.74,95748.47,319972.21
150750,202209,133,74,59,89689.74,71509.67,161199.41
150760,202209,1894,1231,663,1491990.6,803562.27,2295552.87
150770,202209,410,236,174,286034.23,210888.2,496922.43
150775,202209,102,51,51,61812.4,61812.34,123624.74
150780,202209,214,123,91,149076.8,110292,259368.8
150790,202209,702,404,298,489656.16,361179.33,850835.49
150795,202209,1740,1067,673,1294430.49,815684.56,2110115.05
150796,202209,328,189,139,229068.06,168468.2,397536.26
150797,202209,403,186,217,225435.79,263004.67,488440.46
150800,202209,1680,930,750,1127170.35,909000.1,2036170.45
150803,202209,525,406,119,492077.27,144228.3,636305.57
150805,202209,209,124,85,150288.47,103021.4,253309.87
150808,202209,1114,563,551,682358.8,667815.58,1350174.38
150810,202209,3226,2172,1054,2633713.66,1278665.33,3912378.99
150812,202209,546,282,264,342998.4,321182.06,664180.46
150815,202209,1231,763,468,924760.97,568430.65,1493191.62
150820,202209,1666,982,684,1190218.99,830236.9,2020455.89
150830,202209,583,434,149,526019.42,180589.91,706609.33
150835,202209,255,151,104,183013.58,126048.74,309062.32
150840,202209,1501,868,633,1052032.81,767207.23,1819240.04
160005,202209,70,47,23,56964.04,29088.12,86052.16
160010,202209,207,130,77,157563.07,94536.47,252099.54
160015,202209,187,128,59,155145.22,71508.16,226653.38
160020,202209,143,74,69,89689.92,83628,173317.92
160021,202209,71,33,38,39998.65,46056.44,86055.09
160023,202209,74,41,33,49693.14,39996.23,89689.37
160025,202209,29,14,15,16969.12,18180.12,35149.24
160027,202209,1529,850,679,1030235.07,822954.72,1853189.79
160030,202209,17579,8984,8595,10893733.4,10418508.86,21312242.26
160040,202209,334,207,127,250887.8,153924.46,404812.26
160050,202209,765,360,405,436331.05,490867.4,927198.45
160053,202209,309,183,126,221802.3,152714.68,374516.98
160055,202209,25,16,9,19393.39,10909.54,30302.93
160060,202209,6956,3732,3224,4523295.03,3907547.92,8430842.95
160070,202209,194,112,82,135745.02,99385.14,235130.16
160080,202209,142,70,72,84840.32,87264.02,172104.34
170025,202209,28,15,13,18180,15756.52,33936.52
170030,202209,174,139,35,168471.71,42420,210891.71
170035,202209,204,98,106,118780.1,128474.17,247254.27
170040,202209,175,130,45,157560,54540,212100
170070,202209,330,206,124,249675.92,151501.6,401177.52
170100,202209,351,254,97,309068.92,117564.19,426633.11
170105,202209,39,34,5,41208.7,6060,47268.7
170110,202209,113,69,44,83628.79,53328.1,136956.89
170130,202209,79,38,41,46056,49692,95748
170190,202209,100,58,42,70296.98,50904,121200.98
170200,202209,342,233,109,282396.8,132108.96,414505.76
170210,202209,6812,3703,3109,4490225.71,3771774.97,8262000.68
170215,202209,172,97,75,117564.98,92113.63,209678.61
170220,202209,1344,967,377,1172018.86,458140.62,1630159.48
170230,202209,147,97,50,117565.51,60600.89,178166.40
170240,202209,510,348,162,421785.65,197558.22,619343.87
170255,202209,1014,802,212,972033.62,256944.4,1228978.02
170270,202209,44,31,13,37572.8,15756,53328.8
170290,202209,135,83,52,100597,63024,163621
170300,202209,113,74,39,89688.2,47268,136956.2
170305,202209,52,42,10,50904,12120,63024
170307,202209,58,43,15,52116.8,18180.9,70297.7
170310,202209,126,74,52,89688.26,63024,152712.26
170320,202209,34,21,13,25452.2,15756,41208.2
170330,202209,32,24,8,29088,9696.1,38784.1
170360,202209,33,19,14,23028.8,16968.34,39997.14
170370,202209,78,41,37,49694.05,44844,94538.05
170380,202209,83,61,22,73932,26664,100596
170382,202209,37,32,5,38784,6060,44844
170384,202209,143,110,33,133320.94,39996.2,173317.14
170386,202209,70,30,40,36360,48480,84840
170388,202209,46,20,26,24240,31512.96,55752.96
170389,202209,26,21,5,25452.4,6060,31512.4
170390,202209,76,44,32,53328,38784,92112
170410,202209,25,23,2,27877.16,2424,30301.16
170460,202209,14,8,6,9696.2,7272.23,16968.43
170510,202209,34,26,8,31512.3,9696,41208.3
170550,202209,1600,930,670,1128390.65,812049.44,1940440.09
170555,202209,109,80,29,96963.67,35148,132111.67
170560,202209,103,75,28,90900,33936.7,124836.7
170600,202209,42,14,28,16968.73,33936,50904.73
170610,202209,183,99,84,119990.83,101808.2,221799.03
170625,202209,33,20,13,24240,15756,39996
170650,202209,96,66,30,79992,36360.2,116352.2
170700,202209,591,435,156,527224.37,189072,716296.37
170710,202209,148,90,58,109083.49,70297.74,179381.23
170720,202209,111,83,28,100596.2,33936,134532.2
170730,202209,101,60,41,72720,49692,122412
170740,202209,81,57,24,69084,29088,98172
170755,202209,50,28,22,33937.25,26664.2,60601.45
170765,202209,132,78,54,94537.69,65448,159985.69
170770,202209,195,127,68,153925.09,82416.2,236341.29
170820,202209,604,395,209,478744.75,253310.29,732055.04
170825,202209,48,29,19,35148,23028,58176
170830,202209,90,70,20,84840,24240,109080
170900,202209,170,130,40,157561.55,48480,206041.55
170930,202209,993,551,442,667821.56,535710.42,1203531.98
170950,202209,3273,1544,1729,1872566.66,2100411.54,3972978.20
170980,202209,17,10,7,12120.8,8484,20604.8
171050,202209,144,109,35,132108,42420,174528
171070,202209,60,50,10,60600.57,12120.46,72721.03
171090,202209,48,36,12,43632,14544,58176
171110,202209,23,17,6,20605,7272,27877
171150,202209,41,27,14,32724,18180,50904
171180,202209,25,11,14,13332.2,18180.2,31512.4
171190,202209,185,104,81,126049.59,98172,224221.59
171195,202209,60,49,11,59388.56,13332,72720.56
171200,202209,35,16,19,19392,23028,42420
171215,202209,10,8,2,9696,2424,12120
171240,202209,64,47,17,56964,20604,77568
171245,202209,55,48,7,58177.18,8484,66661.18
171250,202209,82,47,35,56965.11,42420,99385.11
171270,202209,11,7,4,8484.6,4848.22,13332.82
171280,202209,44,36,8,43634.46,9696.1,53330.56
171320,202209,1057,612,445,741749.04,539341.33,1281090.37
171330,202209,435,220,215,266640.78,260580.1,527220.88
171360,202209,103,72,31,87264,37572,124836
171370,202209,41,22,19,26664.2,23028.1,49692.3
171380,202209,140,121,19,146653.69,23028,169681.69
171395,202209,42,25,17,30300,20604,50904
171420,202209,264,174,90,210889.74,109080.2,319969.94
171430,202209,73,60,13,72720.72,15756.05,88476.77
171488,202209,211,116,95,140592.14,115140,255732.14
171500,202209,63,36,27,43632,32724,76356
171510,202209,75,48,27,58176,32724,90900
171515,202209,39,32,7,38785.22,8484,47269.22
171525,202209,25,22,3,26664.89,3636,30300.89
171550,202209,15,9,6,10908.2,7272,18180.2
171570,202209,58,29,29,35148,35148.1,70296.1
171575,202209,269,181,88,219372.85,106656,326028.85
171610,202209,1911,985,926,1193837.33,1125964.01,2319801.34
171620,202209,143,99,44,119989,53328,173317
171630,202209,49,28,21,33936,26664,60600
171650,202209,341,233,108,283615.31,130897.56,414512.87
171660,202209,262,151,111,183016.1,134532.6,317548.7
171665,202209,92,57,35,69084.69,42420,111504.69
171670,202209,431,267,164,324819.5,199981.37,524800.87
171700,202209,65,56,9,67872,10908,78780
171720,202209,27,10,17,12120,20604.2,32724.2
171750,202209,100,47,53,58176.26,64236.2,122412.46
171780,202209,78,61,17,73932,20604,94536
171790,202209,89,71,18,86052,21816,107868
171800,202209,35,27,8,32724,9696,42420
171820,202209,2125,1231,894,1491989.92,1083533.35,2575523.27
171830,202209,32,24,8,29088.2,9696,38784.2
171840,202209,55,37,18,44844.76,21816,66660.76
171845,202209,31,19,12,23028.17,14544,37572.17
171850,202209,44,36,8,43632.53,9696,53328.53
171855,202209,72,52,20,63024,25452,88476
171865,202209,6,4,2,4848,2424,7272
171870,202209,34,22,12,26664,14544.45,41208.45
171875,202209,86,61,25,73932,30300,104232
171880,202209,46,28,18,33936.6,21816.3,55752.9
171884,202209,55,29,26,35148,31512,66660
171886,202209,138,60,78,72720.2,94536.2,167256.4
171888,202209,27,21,6,25452.57,7272,32724.57
171889,202209,12,6,6,7272,7272,14544
171890,202209,55,45,10,54541.03,12120,66661.03
171900,202209,28,19,9,23028.9,10908,33936.9
172000,202209,34,30,4,36360,4848,41208
172010,202209,52,41,11,49692,13332.86,63024.86
172015,202209,21,16,5,19392,6060,25452
172020,202209,137,84,53,101808.13,64236.1,166044.23
172025,202209,39,26,13,31512,15756,47268
172030,202209,52,31,21,37573,25452,63025
172049,202209,82,52,30,63024.24,36360.2,99384.44
172065,202209,110,72,38,87265.72,46056.46,133322.18
172080,202209,120,74,46,89688.24,55752.59,145440.83
172085,202209,32,17,15,20604,18180,38784
172090,202209,451,330,121,399967,146652.8,546619.8
172093,202209,17,15,2,18180,2424,20604
172097,202209,17,9,8,10908,9696,20604
172100,202209,5929,3398,2531,4118449.78,3070036.76,7188486.54
172110,202209,81,53,28,64236.2,33936,98172.2
172120,202209,1746,1454,292,1762299.74,353907.1,2116206.84
172125,202209,13,10,3,12120,3636,15756
172130,202209,30,20,10,24240,12120.7,36360.7
172208,202209,204,131,73,158772,89688.88,248460.88
172210,202209,359,185,174,224223.1,210889.2,435112.3
210005,202209,3059,1923,1136,2331953.18,1376856.51,3708809.69
210010,202209,145,95,50,115141.24,60600,175741.24
210015,202209,43,30,13,36360.19,15756,52116.19
210020,202209,376,218,158,264217.37,191496.82,455714.19
210030,202209,312,215,97,260587.61,118778.58,379366.19
210040,202209,127,103,24,124836.1,29088,153924.1
210043,202209,271,220,51,266644.88,61812,328456.88
210047,202209,486,303,183,367238.44,221796,589034.44
210050,202209,268,195,73,237552,88476.2,326028.2
210055,202209,53,44,9,53328.6,10908,64236.6
210060,202209,529,428,101,518745.89,122414,641159.89
210070,202209,454,346,108,419352,132108.2,551460.2
210080,202209,145,133,12,161198.13,14544,175742.13
210083,202209,290,146,144,176952.2,174528,351480.2
210087,202209,6,5,1,6060,1212,7272
210090,202209,440,317,123,384211.35,149077.81,533289.16
210095,202209,426,331,95,401173.35,115142.17,516315.52
210100,202209,697,554,143,671453.3,173316.2,844769.5
210110,202209,115,79,36,95750.03,43632,139382.03
210120,202209,4868,3901,967,4731790.82,1172015.24,5903806.06
210125,202209,180,113,67,138169.95,82416.89,220586.84
210130,202209,445,266,179,322396.41,216949.13,539345.54
210135,202209,28,21,7,25452.39,8484,33936.39
210140,202209,4478,3440,1038,4170573.98,1258067.68,5428641.66
210150,202209,370,233,137,282404.07,166047.6,448451.67
210160,202209,3229,2753,476,3336690.38,576917.21,3913607.59
210170,202209,1228,992,236,1204757.23,287245.11,1492002.34
210173,202209,127,115,12,139383.46,14544,153927.46
210177,202209,298,170,128,206041.59,155136,361177.59
210180,202209,31,16,15,19392.2,18180,37572.2
210190,202209,438,300,138,363600.82,167256.9,530857.72
210193,202209,6,4,2,4848,2424,7272
210197,202209,68,50,18,60600,21816.2,82416.2
210200,202209,599,511,88,619343.29,106656.1,725999.39
210203,202209,223,161,62,195134.24,75144.92,270279.16
210207,202209,341,283,58,343000.56,70296,413296.56
210210,202209,693,646,47,782961.57,56964.6,839926.17
210215,202209,77,70,7,84842.11,8484,93326.11
210220,202209,349,299,50,362395.59,60601.59,422997.18
210230,202209,307,250,57,303002.2,69084.51,372086.71
210232,202209,1222,883,339,1070209.08,410868.94,1481078.02
210235,202209,187,141,46,170893.32,55752.6,226645.92
210237,202209,44,21,23,25454.05,27876,53330.05
210240,202209,75,65,10,78780.21,12120,90900.21
210250,202209,180,157,23,190284.29,27876,218160.29
210255,202209,383,285,98,345425.58,118778.38,464203.96
210260,202209,382,266,116,322393.5,140592,462985.5
210270,202209,610,426,184,516314.78,223008.29,739323.07
210275,202209,92,71,21,87265.06,25452,112717.06
210280,202209,1069,702,367,852044.17,444804.8,1296848.97
210290,202209,526,354,172,429054.51,208465.6,637520.11
210300,202209,4858,3150,1708,3819057.72,2070101.72,5889159.44
210310,202209,120,79,41,95748.2,49692,145440.2
210312,202209,119,85,34,103020.58,41208.8,144229.38
210315,202209,120,102,18,123625.09,21816,145441.09
210317,202209,139,107,32,129684,38784,168468
210320,202209,2405,2061,344,2501609.18,416929,2918538.18
210325,202209,150,92,58,111505.15,70296.2,181801.35
210330,202209,4183,2461,1722,2985196.05,2088278.89,5073474.94
210340,202209,1207,932,275,1129603.44,333301.6,1462905.04
210350,202209,674,560,114,679934.46,139380,819314.46
210355,202209,145,123,22,149077.16,26664,175741.16
210360,202209,2022,1458,564,1767124.65,684782.64,2451907.29
210370,202209,1223,640,583,776898.69,706599.09,1483497.78
210375,202209,190,95,95,115146.8,115141.29,230288.09
210380,202209,723,566,157,685995.52,190286.26,876281.78
210390,202209,193,161,32,195133.47,38784,233917.47
210400,202209,397,347,50,420570.35,60600,481170.35
210405,202209,1081,774,307,938097.74,372085.61,1310183.35
210407,202209,70,58,12,70296,14544,84840
210408,202209,49,42,7,50904.64,8484,59388.64
210409,202209,333,292,41,353905.31,49692.2,403597.51
210410,202209,440,352,88,426625.1,107868,534493.1
210420,202209,199,163,36,197556.5,43632.76,241189.26
210430,202209,56,41,15,49692.5,18180,67872.5
210440,202209,375,255,120,309065.88,145440.4,454506.28
210450,202209,109,95,14,115142.6,16968,132110.6
210455,202209,244,128,116,155139.14,140593.73,295732.87
210460,202209,313,214,99,259370.99,119988.05,379359.04
210462,202209,69,59,10,71508.38,12120.62,83629.00
210465,202209,129,103,26,124836.51,31512,156348.51
210467,202209,540,410,130,496926.85,157560.92,654487.77
210470,202209,43,37,6,44844,7272,52116
210480,202209,1333,967,366,1172016.42,446019.5,1618035.92
210490,202209,182,130,52,157561.23,63024,220585.23
210500,202209,494,312,182,378152.44,221797.19,599949.63
210510,202209,518,428,90,518738.2,109081.8,627820.0
210515,202209,338,217,121,263004.78,146652.2,409656.98
210520,202209,395,359,36,435109.99,43632,478741.99
210530,202209,9705,4981,4724,6044392.04,5736528.4,11780920.44
210535,202209,122,93,29,112716.6,35148,147864.6
210540,202209,1515,1022,493,1238687.04,597519.01,1836206.05
210542,202209,1106,562,544,682369.72,660550.88,1342920.60
210545,202209,22,19,3,23028.2,3636,26664.2
210547,202209,127,111,16,134533.74,19392.31,153926.05
210550,202209,586,414,172,501780.9,208465.61,710246.51
210560,202209,162,141,21,170893.39,25452.2,196345.59
210565,202209,21,14,7,16968,8484.08,25452.08
210570,202209,1294,1087,207,1317459.79,250884.97,1568344.76
210580,202209,124,108,16,130896,19392,150288
210590,202209,698,582,116,705387.61,140592,845979.61
210592,202209,44,41,3,49692,3636,53328
210594,202209,115,100,15,121200.2,18180,139380.2
210596,202209,118,103,15,124836,18180,143016
210598,202209,139,107,32,129684,38784.6,168468.6
210600,202209,301,260,41,315126.19,49692.2,364818.39
210610,202209,242,225,17,272703.82,20604.13,293307.95
210620,202209,44,29,15,35148,18180,53328
210630,202209,78,73,5,88476,6060,94536
210632,202209,956,689,267,835069.45,324816.2,1159885.65
210635,202209,25,22,3,26664,3636,30300
210637,202209,122,88,34,106656.4,41208,147864.4
210640,202209,566,503,63,609637.22,76356,685993.22
210650,202209,398,337,61,408448.47,73932,482380.47
210660,202209,360,286,74,347853.75,89688.4,437542.15
210663,202209,62,48,14,58176,16968,75144
210667,202209,89,40,49,48480.56,59389,107869.56
210670,202209,254,227,27,275125.62,32724.6,307850.22
210675,202209,487,284,203,344214.9,246038.2,590253.1
210680,202209,231,148,83,179378.15,100596,279974.15
210690,202209,82,76,6,92113.33,7272,99385.33
210700,202209,157,118,39,143016.4,47268.2,190284.6
210710,202209,237,154,83,186650.24,100596.6,287246.84
210720,202209,127,115,12,139381,14544,153925
210725,202209,58,49,9,59390.71,10908,70298.71
210730,202209,23,17,6,20604,7272,27876
210735,202209,283,205,78,248460.43,94536,342996.43
210740,202209,516,448,68,542989.75,82416,625405.75
210745,202209,159,119,40,144229.15,48480.2,192709.35
210750,202209,2607,1390,1217,1684712.95,1475015.81,3159728.76
210760,202209,251,198,53,239976.93,64236.19,304213.12
210770,202209,244,201,43,243620.02,52117.39,295737.41
210780,202209,405,310,95,375728.77,115140.4,490869.17
210790,202209,187,161,26,195133.32,31512,226645.32
210800,202209,178,134,44,163626,53328.55,216954.55
210805,202209,60,53,7,64236,8484,72720
210810,202209,437,357,80,432691.67,96960,529651.67
210820,202209,1963,1651,312,2001050.33,378145.05,2379195.38
210825,202209,149,88,61,106657.1,73932.2,180589.3
210830,202209,694,489,205,592673.13,248460.6,841133.73
210840,202209,203,146,57,176952.85,69084,246036.85
210845,202209,225,174,51,210889.42,61812,272701.42
210850,202209,709,503,206,609649.13,249675.42,859324.55
210860,202209,3371,2011,1360,2438582.02,1648324.86,4086906.88
210870,202209,401,324,77,392698.51,93324.2,486022.71
210880,202209,80,62,18,75145.57,21816.2,96961.77
210890,202209,313,274,39,332092.47,47268,379360.47
210900,202209,683,440,243,533291.4,294518.58,827809.98
210905,202209,70,38,32,46056.8,38784,84840.8
210910,202209,2106,1585,521,1923468.25,633882.47,2557350.72
210920,202209,141,62,79,75145.63,95748,170893.63
210923,202209,79,65,14,78780.63,18180,96960.63
210927,202209,407,211,196,255733.29,237552.78,493286.07
210930,202209,72,60,12,72720,14544,87264
210940,202209,76,61,15,73934.27,18180,92114.27
210945,202209,204,122,82,147866.7,99384,247250.7
210950,202209,509,376,133,456925.42,161196.65,618122.07
210955,202209,90,56,34,67872,41208.2,109080.2
210960,202209,2335,1204,1131,1459256.82,1370774.19,2830031.01
210970,202209,109,93,16,112716.26,19392.9,132109.16
210975,202209,80,76,4,92112.2,4848.95,96961.15
210980,202209,1038,524,514,635096.41,622969.51,1258065.92
210990,202209,4371,3081,1290,3734238.15,1564708.95,5298947.10
211000,202209,1265,1039,226,1259285.77,273913.52,1533199.29
211003,202209,953,699,254,847193.51,307848.76,1155042.27
211010,202209,481,435,46,527223.34,55753.01,582976.35
211020,202209,1352,612,740,741754.11,896888.94,1638643.05
211023,202209,43,38,5,46056,6060,52116
211027,202209,78,59,19,71508.2,23028,94536.2
211030,202209,360,259,101,313909.91,122412,436321.91
211040,202209,277,233,44,283609.46,53328,336937.46
211050,202209,1107,764,343,925985.21,415718.49,1341703.70
211060,202209,610,541,69,655709.83,83628.4,739338.23
211065,202209,26,20,6,24241.6,7272.11,31513.71
211070,202209,833,702,131,850845.49,158772.6,1009618.09
211080,202209,84,81,3,98172.21,3636,101808.21
211085,202209,64,35,29,43632.98,35148,78780.98
211090,202209,76,65,11,78781.06,13332,92113.06
211100,202209,459,389,70,471478.01,84840.4,556318.41
211102,202209,226,165,61,199980.4,73932,273912.4
211105,202209,216,155,61,187861.78,73932.26,261794.04
211107,202209,129,81,48,98172.69,58176,156348.69
211110,202209,955,646,309,784176.97,374512.91,1158689.88
211120,202209,5059,2669,2390,3237357.33,2897928.15,6135285.48
211125,202209,21,13,8,15756,9696,25452
211130,202209,40983,19657,21326,23832142.86,25857071.45,49689214.31
211140,202209,380,336,44,407240.16,53328.47,460568.63
211150,202209,1175,834,341,1010825.89,414506.32,1425332.21
211153,202209,161,97,64,117564,77568.2,195132.2
211157,202209,70,58,12,70296,14544,84840
211160,202209,672,573,99,695694.39,119988.4,815682.79
211163,202209,4,4,0,4849.19,,4849.19
211167,202209,13,12,1,14544,1212,15756
211170,202209,410,307,103,372084,124836.38,496920.38
211172,202209,110,78,32,94536.4,38784,133320.4
211174,202209,22,18,4,21816,4848.6,26664.6
211176,202209,455,329,126,398753.06,152713.36,551466.42
211178,202209,90,63,27,76356.2,32724,109080.2
211180,202209,216,173,43,209676.99,52116.04,261793.03
211190,202209,72,65,7,78780.2,8484,87264.2
211195,202209,36,24,12,29088.78,14544,43632.78
211200,202209,149,127,22,153924,26664.6,180588.6
211210,202209,396,302,94,366028.68,113928.38,479957.06
211220,202209,4314,2585,1729,3133107.44,2096804.14,5229911.58
211223,202209,119,111,8,134533.29,9696,144229.29
211227,202209,57,47,10,56964.2,12120,69084.2
211230,202209,703,581,122,704189.03,147865.66,852054.69
211240,202209,369,308,61,373298.05,73932,447230.05
211245,202209,177,95,82,115141.05,99384,214525.05
211250,202209,1462,1261,201,1529589.28,243613.44,1773202.72
211260,202209,781,671,110,813257.46,133320,946577.46
211270,202209,1838,1531,307,1855606.76,372084.74,2227691.50
211280,202209,1745,1195,550,1448355.23,666600.7,2114955.93
211285,202209,216,141,75,170892,90900,261792
211290,202209,762,531,231,643575.17,279972.92,923548.09
211300,202209,759,609,150,738118.24,181801.32,919919.56
211400,202209,1532,1002,530,1214443.68,642361.16,1856804.84
220005,202209,18,17,1,20604,1212,21816
220010,202209,79,68,11,82416.62,13332,95748.62
220020,202209,720,591,129,716298.27,156348.6,872646.87
220025,202209,105,101,4,122413.44,4848,127261.44
220027,202209,54,44,10,53328,12120,65448
220030,202209,120,102,18,123625.68,21816,145441.68
220040,202209,1272,978,294,1185347.47,356330.92,1541678.39
220045,202209,31,21,10,25452.76,12120.4,37573.16
220050,202209,686,571,115,692059.11,139380.59,831439.70
220060,202209,179,155,24,187862.83,29088.35,216951.18
220070,202209,109,94,15,113930.31,18180.2,132110.51
220080,202209,13,11,2,13332,2424,15756
220090,202209,41,30,11,36360.8,13332,49692.8
220095,202209,2,2,0,2424,,2424.0
220100,202209,21,17,4,20604.55,4848,25452.55
220105,202209,31,28,3,33936.6,3636,37572.6
220110,202209,239,219,20,267852.1,24240,292092.1
220115,202209,44,38,6,46056,7272,53328
220117,202209,22,20,2,24240,2424,26664
220120,202209,1489,1152,337,1397448.59,408444.2,1805892.79
220130,202209,26,26,0,31512.13,,31512.13
220140,202209,89,73,16,88476.2,19393,107869.2
220150,202209,486,366,120,443602.12,145442.01,589044.13
220155,202209,20,19,1,23028,1212,24240
220157,202209,20,17,3,20604.2,3636,24240.2
220160,202209,105,92,13,111505.35,15756,127261.35
220170,202209,40,34,6,41208,7272,48480
220173,202209,12,10,2,12120,2424,14544
220177,202209,16,16,0,19392,,19392.0
220180,202209,63,61,2,73932.59,2424,76356.59
220190,202209,1122,971,151,1176863.23,183013.86,1359877.09
220191,202209,39,34,5,41209.05,6060,47269.05
220192,202209,93,86,7,104232,8484,112716
220194,202209,63,54,9,65448.01,10908,76356.01
220196,202209,81,67,14,81205.77,16968.2,98173.97
220198,202209,1,1,0,1212,,1212.0
220200,202209,409,346,63,419361.44,76358.01,495719.45
220202,202209,34,30,4,36360.88,4848,41208.88
220205,202209,63,54,9,65448,10908,76356
220207,202209,14,14,0,16968,,16968.0
220208,202209,75,46,29,55752.4,35148.2,90900.6
220209,202209,32,27,5,32724,6060,38784
220210,202209,20,16,4,19392,4848,24240
220211,202209,31,29,2,35149.57,2424,37573.57
220213,202209,31,28,3,33936.84,3636,37572.84
220217,202209,43,35,8,42420.3,9696.2,52116.5
220220,202209,2336,1550,786,1879829.98,952639.18,2832469.16
220225,202209,7,2,5,2424.8,6060,8484.8
220230,202209,985,746,239,904163.26,289672.68,1193835.94
220240,202209,162,142,20,172104.78,24240.32,196345.10
220245,202209,40,37,3,44845.05,3636,48481.05
220250,202209,137,117,20,141808.05,24240,166048.05
220253,202209,50,45,5,54540,6060,60600
220255,202209,46,39,7,47268,8484,55752
220260,202209,706,540,166,654485.51,201193.11,855678.62
220265,202209,8,7,1,8484,1212,9696
220270,202209,836,752,84,911430.94,101808,1013238.94
220271,202209,39,30,9,36360.3,10908,47268.3
220272,202209,14,14,0,16968.59,,16968.59
220273,202209,15,14,1,16968.2,1212,18180.2
220275,202209,63,53,10,64236,12120,76356
220277,202209,26,19,7,23028,8484.7,31512.7
220280,202209,19,12,7,14544,8484,23028
220285,202209,42,40,2,48480.2,2424,50904.2
220290,202209,1532,1310,222,1587744.22,269067.51,1856811.73
220300,202209,40,40,0,48480.6,,48480.6
220310,202209,336,283,53,343006.79,64237.81,407244.60
220320,202209,444,407,37,493298.46,44845,538143.46
220323,202209,3,1,2,1212.8,2424.2,3637.0
220325,202209,7,6,1,7272,1212,8484
220327,202209,13,13,0,15756,,15756.0
220330,202209,219,156,63,189073.69,76356,265429.69
220335,202209,135,115,20,139381.82,24240,163621.82
220340,202209,47,35,12,42420,14544,56964
220342,202209,55,47,8,56966.22,9696,66662.22
220345,202209,82,70,12,84840,14544.3,99384.3
220350,202209,455,397,58,481167.11,70296.35,551463.46
220360,202209,47,33,14,39996,16968,56964
220370,202209,1334,1118,216,1358670.33,263004.74,1621675.07
220375,202209,18,17,1,20604.6,1212,21816.6
220380,202209,27,19,8,23028.8,9696.55,32725.35
220385,202209,16,14,2,16968,2424.66,19392.66
220390,202209,2391,1322,1069,1602288.41,1295646.97,2897935.38
220400,202209,35,30,5,36360,6060,42420
220410,202209,23,22,1,26664.2,1212,27876.2
220415,202209,13,12,1,14544.36,1212,15756.36
220420,202209,124,104,20,126049,24240,150289
220430,202209,138,121,17,146652.27,20604,167256.27
220435,202209,22,17,5,20604.5,6060,26664.5
220440,202209,269,231,38,279980.55,46056,326036.55
220450,202209,357,178,179,215739.92,216951.98,432691.90
220455,202209,51,50,1,60600.26,1212,61812.26
220460,202209,19,17,2,20604.4,2424.19,23028.59
220465,202209,65,42,23,50904.59,27876.28,78780.87
220470,202209,232,203,29,246038.54,35148.01,281186.55
220480,202209,69,64,5,77568,6060,83628
220490,202209,86,73,13,88476,15756,104232
220500,202209,116,97,19,117564.36,23028,140592.36
220510,202209,363,283,80,343002.42,96960.88,439963.30
220515,202209,24,22,2,26664.34,2424,29088.34
220520,202209,372,328,44,397540.29,53328.95,450869.24
220525,202209,8,3,5,3636.29,6060,9696.29
220527,202209,14,12,2,15756,2424,18180
220530,202209,47,24,23,29088,27876.86,56964.86
220535,202209,7,5,2,6060.2,2424,8484.2
220540,202209,96,83,13,100597,15756,116353
220545,202209,24,16,8,19392.32,9696.1,29088.42
220550,202209,721,570,151,690850.92,183012.75,873863.67
220551,202209,12,10,2,12120,2424,14544
220552,202209,13,13,0,15756,,15756.0
220553,202209,52,48,4,58176.67,4848,63024.67
220554,202209,10,7,3,8484.2,3636,12120.2
220555,202209,42,35,7,42420.68,8484,50904.68
220556,202209,40,38,2,46056,2424,48480
220557,202209,60,52,8,63024.65,9696.74,72721.39
220558,202209,10,5,5,6060,6060,12120
220559,202209,5,5,0,6060.74,,6060.74
220560,202209,77,51,26,61812,31512,93324
220570,202209,720,447,273,541767.95,330878.71,872646.66
220580,202209,537,492,45,597538.27,54541,652079.27
220585,202209,14,12,2,14544.2,2424.2,16968.4
220590,202209,13,12,1,14544,1212,15756
220595,202209,78,58,20,70296.85,24240.1,94536.95
220600,202209,22,15,7,18180,8484,26664
220605,202209,29,25,4,30300,4848,35148
220610,202209,93,76,17,92112,20604,112716
220620,202209,550,468,82,567223.04,99384.84,666607.88
220630,202209,6,3,3,3636,3636,7272
220635,202209,32,29,3,35148.46,3636,38784.46
220640,202209,109,88,21,106656,25452,132108
220650,202209,115,109,6,132108,7272,139380
220660,202209,70,52,18,63025.1,21816.8,84841.9
220665,202209,8,8,0,9696,,9696.0
220667,202209,21,19,2,23028.19,2424,25452.19
220669,202209,35,30,5,36360.2,6060,42420.2
220670,202209,70,55,15,66660,18180,84840
220672,202209,80,57,23,69085.39,27876.8,96962.19
220675,202209,28,21,7,25452.67,8484,33936.67
220680,202209,58,50,8,60600,9696,70296
220690,202209,50,48,2,58176.79,2424,60600.79
220695,202209,28,16,12,19392.74,14544,33936.74
220700,202209,1834,1412,422,1711355.5,511466.23,2222821.73
220710,202209,8,6,2,7272.22,2424.5,9696.72
220720,202209,109,92,17,111504,20604,132108
220730,202209,23,22,1,26664,1212,27876
220735,202209,6,3,3,3636,3636,7272
220740,202209,52,45,7,54540,8484.91,63024.91
220750,202209,121,102,19,123625.86,23028.21,146654.07
220755,202209,16,16,0,19393.57,,19393.57
220760,202209,69,61,8,73932.6,9696,83628.6
220770,202209,5961,3400,2561,4123313.76,3108835.19,7232148.95
220775,202209,12,9,3,10908,3636.8,14544.8
220777,202209,20,19,1,23028,1212,24240
220779,202209,5,1,4,1212,4848,6060
220780,202209,925,785,140,951423.82,169680.88,1121104.70
220785,202209,4,1,3,1212,3636,4848
220790,202209,1204,968,236,1173230.92,286038.13,1459269.05
220793,202209,8,5,3,6060,3636,9696
220795,202209,20,19,1,23028.06,1212,24240.06
220800,202209,4091,3126,965,3788973.95,1169585.2,4958559.15
220810,202209,72,62,10,75144.99,12120,87264.99
220820,202209,249,226,23,273917.36,29089.8,303007.16
220830,202209,1287,1128,159,1367145.79,192709.07,1559854.86
220840,202209,2563,1801,762,2182844.29,924769.39,3107613.68
220850,202209,76,66,10,79992,12120,92112
220855,202209,9,5,4,6060,4848,10908
220860,202209,12,11,1,13333.08,1212,14545.08
220865,202209,29,26,3,31512,3636,35148
220870,202209,87,77,10,93324.4,12120,105444.4
220880,202209,330,272,58,329668.38,71509.54,401177.92
220885,202209,27,26,1,31513.1,1212,32725.1
220887,202209,6,5,1,6060.2,1212,7272.2
220890,202209,88,75,13,90900.99,15756,106656.99
220900,202209,25,13,12,15756,14544,30300
220910,202209,50,39,11,47268.85,13332,60600.85
220915,202209,9,8,1,9696,1212,10908
220920,202209,45,40,5,48481.06,6060,54541.06
220930,202209,52,50,2,60600.56,2424,63024.56
220935,202209,12,12,0,14544,,14544.0
220937,202209,35,30,5,36360.6,6060,42420.6
220940,202209,57,51,6,61812,7272,69084
220945,202209,3,3,0,3636,,3636.0
220950,202209,33,26,7,31512.2,8484,39996.2
220955,202209,13,13,0,15756.72,,15756.72
220960,202209,36,32,4,38784.41,4848,43632.41
220965,202209,46,42,4,50904,4848,55752
220970,202209,65,55,10,66660,12120,78780
220975,202209,11,10,1,12120.6,1212,13332.6
220980,202209,30,27,3,32724,3636,36360
220985,202209,53,46,7,55752,8484,64236
220987,202209,30,29,1,35149.77,1212.8,36362.57
220990,202209,23,23,0,27876,,27876.0
220995,202209,12,9,3,10908,3636,14544
220997,202209,65,56,9,67872.4,10908,78780.4
221000,202209,1255,1112,143,1347758.63,173317.02,1521075.65
221005,202209,44,41,3,49692.7,3636.79,53329.49
221010,202209,26,18,8,21816,9696,31512
221020,202209,39,34,5,41208.76,6060,47268.76
221030,202209,42,34,8,41112.45,9696,50808.45
221035,202209,23,22,1,26664.4,1212,27876.4
221037,202209,14,10,4,12120,4848,16968
221038,202209,26,23,3,27876,3636,31512
221039,202209,24,23,1,27876.24,1212.2,29088.44
221040,202209,265,228,37,276337.12,44844,321181.12
221050,202209,229,193,36,233921.18,43632.2,277553.38
221060,202209,1987,1703,284,2064065.85,344211.15,2408277.00
221062,202209,27,27,0,32724.85,,32724.85
221063,202209,19,14,5,16968,6060,23028
221065,202209,70,57,13,69085.41,15756,84841.41
221070,202209,152,133,19,161198.57,23028,184226.57
221080,202209,391,330,61,399964.97,73932,473896.97
221090,202209,23,17,6,20605.05,7272,27877.05
221093,202209,44,30,14,36360.2,16968,53328.2
221095,202209,4,4,0,4848,,4848.0
221097,202209,12,10,2,12120,2424,14544
221100,202209,27074,16157,10917,19590028.43,13243701.35,32833729.78
221110,202209,1150,879,271,1065362.96,328454.52,1393817.48
221120,202209,561,407,154,493289.69,186648,679937.69
221130,202209,1007,816,191,989003.55,231493.74,1220497.29
221135,202209,33,29,4,35148,4848,39996
221140,202209,49,42,7,50904.2,8484,59388.2
221150,202209,10,7,3,8484.18,3636,12120.18
221160,202209,13,13,0,15756.9,,15756.9
221170,202209,20,19,1,23028,1212,24240
230010,202209,163,142,21,172104.36,25452,197556.36
230015,202209,161,134,27,162408,32724,195132
230020,202209,1784,1447,337,1753780.54,409664.98,2163445.52
230030,202209,1685,1214,471,1471392.91,570856.95,2042249.86
230040,202209,228,181,47,219372.9,56964,276336.9
230050,202209,247,172,75,208464,90900.2,299364.2
230060,202209,173,138,35,167256.51,42421.3,209677.81
230070,202209,301,256,45,311486.09,54540,366026.09
230075,202209,922,764,158,925977.91,191497.83,1117475.74
230080,202209,223,183,40,221796,48480,270276
230090,202209,170,124,46,150288,55752,206040
230100,202209,2693,1505,1188,1824094.14,1441079.86,3265174.00
230110,202209,3077,1929,1148,2337988.18,1391389.21,3729377.39
230120,202209,1171,894,277,1084756.25,335725.07,1420481.32
230125,202209,169,133,36,161196.2,43632,204828.2
230130,202209,512,447,65,541768.28,78780.7,620548.98
230140,202209,220,178,42,215737.62,50904,266641.62
230150,202209,155,119,36,144229,44844.4,189073.4
230160,202209,1008,819,189,992631.76,230281.56,1222913.32
230170,202209,662,581,81,704188.41,98175.33,802363.74
230180,202209,70,63,7,76356,8484,84840
230185,202209,424,359,65,435112.04,78780.26,513892.30
230190,202209,2561,1940,621,2353740.95,752656.51,3106397.46
230195,202209,530,450,80,545410.1,96960,642370.1
230200,202209,454,349,105,422992.78,127260.2,550252.98
230205,202209,423,281,142,340573,172104.2,512677.2
230210,202209,1448,1105,343,1340485.74,415717.08,1756202.82
230220,202209,1661,1102,559,1336855.04,677515.26,2014370.30
230230,202209,1029,838,191,1016875.84,232705.69,1249581.53
230240,202209,2027,1755,272,2127382.16,329667.43,2457049.59
230250,202209,1861,1503,358,1821671.18,433903.15,2255574.33
230260,202209,3396,2075,1321,2517342.44,1601056.73,4118399.17
230270,202209,1413,1101,312,1334422.16,378147.06,1712569.22
230280,202209,2904,2206,698,2673709.46,845983.32,3519692.78
230290,202209,360,312,48,378150.2,58177.76,436327.96
230300,202209,525,384,141,465410.74,170892.1,636302.84
230310,202209,448,344,104,416929.57,126048.63,542978.20
230320,202209,968,815,153,987790.78,185436.8,1173227.58
230330,202209,326,261,65,316334.14,79992.4,396326.54
230340,202209,457,368,89,446021.39,107868.4,553889.79
230350,202209,3475,2121,1354,2573122.91,1641060.45,4214183.36
230360,202209,281,228,53,276337.12,65448.93,341786.05
230365,202209,131,103,28,124836.73,33936,158772.73
230370,202209,11720,5768,5952,6994624.83,7218816.06,14213440.89
230380,202209,511,436,75,528435.28,90901.55,619336.83
230390,202209,544,310,234,375723.23,283608.6,659331.83
230393,202209,232,188,44,229068.31,53328.5,282396.81
230395,202209,372,295,77,357547.8,93326.82,450874.62
230400,202209,658,519,139,630245.72,168468.4,798714.12
230410,202209,2851,1771,1080,2146487.14,1308975.98,3455463.12
230420,202209,6787,4480,2307,5434740.92,2796137.81,8230878.73
230423,202209,347,301,46,364814.27,55752.1,420566.37
230425,202209,502,396,106,482380.07,128473.13,610853.20
230426,202209,122,92,30,111504,36360,147864
230427,202209,74,67,7,81204.8,8484,89688.8
230428,202209,1770,871,899,1055664.78,1089592.4,2145257.18
230430,202209,476,382,94,462989.21,113930.16,576919.37
230435,202209,993,715,278,867796.73,336937.61,1204734.34
230440,202209,100727,45698,55029,55411123.47,66750638.41,122161761.88
230445,202209,337,228,109,276341.28,132108,408449.28
230450,202209,601,472,129,572065.39,156348,728413.39
230460,202209,103,75,28,92114.39,35148,127262.39
230465,202209,326,264,62,319970.86,75144,395114.86
230470,202209,2083,1620,463,1963453.91,561157.85,2524611.76
230480,202209,152,137,15,166044,18180.56,184224.56
230490,202209,344,270,74,327241.75,89688,416929.75
230495,202209,505,349,156,422996.04,189074.67,612070.71
230500,202209,1129,836,293,1013240.95,355117.19,1368358.14
230510,202209,69,45,24,54540,29088,83628
230520,202209,424,322,102,390264.86,123624.77,513889.63
230523,202209,2667,1629,1038,1975589.85,1258071.17,3233661.02
230526,202209,255,215,40,260581.81,48480,309061.81
230530,202209,705,512,193,620550.66,233918.37,854469.03
230533,202209,224,202,22,244826.7,26664.2,271490.9
230535,202209,419,317,102,384207.79,123624.35,507832.14
230540,202209,1841,1637,204,1984066.01,247249.77,2231315.78
230550,202209,4259,2695,1564,3266420.68,1895603.44,5162024.12
230560,202209,607,456,151,552678.65,183012.52,735691.17
230565,202209,226,166,60,201192,72720.2,273912.2
230570,202209,317,267,50,323604.87,60600.6,384205.47
230580,202209,1254,875,379,1060505.68,459353.19,1519858.87
230590,202209,1061,807,254,977997.51,307849.84,1285847.35
230600,202209,279,250,29,303003.37,35148,338151.37
230610,202209,472,349,123,422989.96,149076.2,572066.16
230620,202209,177,146,31,176953.94,37572,214525.94
230625,202209,869,582,287,705394.1,347844.5,1053238.6
230630,202209,1477,1105,372,1339274.37,450866.79,1790141.16
230640,202209,4122,3374,748,4091783.96,906594.36,4998378.32
230650,202209,503,428,75,518737.71,90900.64,609638.35
230655,202209,757,611,146,742967.76,176954.24,919922.00
230660,202209,352,292,60,353906.46,73933.14,427839.60
230670,202209,484,388,96,470267.94,116352.92,586620.86
230680,202209,223,196,27,237555.1,32724,270279.1
230690,202209,1005,841,164,1019305.68,198769.16,1218074.84
230700,202209,1020,845,175,1024153.01,213312.92,1237465.93
230710,202209,688,634,54,768422.57,65448.3,833870.87
230720,202209,151,128,23,155136,27876.2,183012.2
230725,202209,283,212,71,256945.93,86052.46,342998.39
230730,202209,13365,7042,6323,8536200.56,7670843.69,16207044.25
230740,202209,724,575,149,696916.71,180588.6,877505.31
230750,202209,852,703,149,852045.55,180588.46,1032634.01
230760,202209,1647,1395,252,1693200.62,305425.67,1998626.29
230763,202209,349,283,66,342998.39,79992.99,422991.38
230765,202209,8770,4062,4708,4923272.83,5708652.31,10631925.14
230770,202209,5295,2661,2634,3225202.05,3193645.43,6418847.48
230780,202209,809,700,109,848404.32,132109.18,980513.50
230790,202209,323,263,60,318756,72720.2,391476.2
230800,202209,1221,865,356,1050528.42,431473.31,1482001.73
230810,202209,1476,1279,197,1550178.71,239978.84,1790157.55
230820,202209,394,257,137,311485.86,166044.53,477530.39
230830,202209,998,837,161,1014455.11,195132.8,1209587.91
230835,202209,291,237,54,287246.07,65448.68,352694.75
230837,202209,190,150,40,181800.85,48480.1,230280.95
230840,202209,979,748,231,906579.88,279974.15,1186554.03
230850,202209,1435,1213,222,1470184.43,269068.75,1739253.18
230860,202209,332,253,79,306636.16,95754.06,402390.22
230870,202209,1927,1629,298,1974371.25,361176.61,2335547.86
230880,202209,83,66,17,79992.44,20604,100596.44
230890,202209,574,503,71,609641.57,86052.4,695693.97
230900,202209,315,235,80,284820.68,96960.88,381781.56
230910,202209,228,178,50,215737.23,60600,276337.23
230920,202209,516,400,116,486015.04,140592,626607.04
230930,202209,1120,776,344,940528.21,416931.16,1357459.37
230940,202209,860,658,202,797504.03,244825.35,1042329.38
230945,202209,579,461,118,558744.77,144232.05,702976.82
230950,202209,443,380,63,460569.98,76356.9,536926.88
230960,202209,2938,1941,997,2353759.31,1209603.08,3563362.39
230970,202209,1870,1006,864,1221727.65,1047179.65,2268907.30
230980,202209,216,166,50,201193.2,60600,261793.2
230990,202209,144,114,30,138168.25,36360,174528.25
231000,202209,217,198,19,239976.73,23028,263004.73
231010,202209,183,125,58,151501.79,70297.28,221799.07
231020,202209,1513,1011,502,1225359.71,608436.92,1833796.63
231025,202209,1176,811,365,984170.02,442391.67,1426561.69
231030,202209,1089,879,210,1065356.66,255733.67,1321090.33
231040,202209,178,121,57,146653.45,69084,215737.45
231050,202209,974,840,134,1019309.07,162413.8,1181722.87
231060,202209,170,137,33,166045.36,39997.24,206042.60
231070,202209,1556,1062,494,1287160.42,599944.74,1887105.16
231080,202209,274,242,32,293308.07,38784,332092.07
231085,202209,718,432,286,523592.64,346633.09,870225.73
231090,202209,273,219,54,265430.55,65449.64,330880.19
231095,202209,163,126,37,152712,44844.77,197556.77
231100,202209,184,147,37,178164.24,44844,223008.24
231110,202209,383,320,63,389056.72,76356.91,465413.63
231120,202209,264,221,43,267852.8,52116.12,319968.92
231123,202209,158,148,10,179377.15,12120,191497.15
231126,202209,340,259,81,313908.46,99384,413292.46
231130,202209,5111,3950,1161,4787490.57,1407152.61,6194643.18
231135,202209,221,195,26,236341.19,31512,267853.19
231140,202209,3148,2245,903,2720979.39,1094446.23,3815425.62
231150,202209,395,369,26,447231,31512,478743
231160,202209,1287,1043,244,1265341.22,295728.46,1561069.68
231170,202209,549,379,170,459349.13,207252,666601.13
231180,202209,1960,1695,265,2054373.5,321183.68,2375557.18
231190,202209,223,181,42,219372.1,50904,270276.1
231195,202209,243,197,46,238764.51,55752.6,294517.11
231200,202209,872,699,173,847200.31,209679.52,1056879.83
231210,202209,535,447,88,541771.06,106657.39,648428.45
231220,202209,1104,783,321,949010.44,389052.86,1338063.30
231230,202209,1582,1172,410,1420477.7,498133.09,1918610.79
231240,202209,1666,1126,540,1364727.73,656911.09,2021638.82
231250,202209,97,91,6,110292.87,7272,117564.87
231260,202209,263,172,91,208465.1,110292.96,318758.06
231270,202209,1020,782,238,949014.94,289669.41,1238684.35
231280,202209,80,62,18,75144,21816,96960
231290,202209,8337,4617,3720,5597112.99,4509915.2,10107028.19
231300,202209,610,556,54,673879.85,66660,740539.85
231310,202209,841,766,75,928400.87,90901.2,1019302.07
231320,202209,611,452,159,547825.56,192709.16,740534.72
231325,202209,105,89,16,107868,19392,127260
231330,202209,2018,1523,495,1847113.31,601159.32,2448272.63
231335,202209,263,228,35,276337.36,42420.6,318757.96
231340,202209,1955,1342,613,1626527.27,742964.35,2369491.62
231350,202209,1438,1132,306,1372016.58,370883.26,1742899.84
231355,202209,422,344,78,416930.2,94536,511466.2
231360,202209,576,395,181,478744.64,219372,698116.64
231370,202209,102,85,17,103020,20604,123624
231375,202209,304,226,78,273912.9,94536.1,368449.0
231380,202209,533,420,113,509041.47,136956,645997.47
231390,202209,205,157,48,190284.59,58176,248460.59
231395,202209,801,483,318,585397.36,386628.3,972025.66
231400,202209,1227,1011,216,1225343.62,261797.76,1487141.38
231410,202209,1426,1157,269,1403512.39,326031.24,1729543.63
240010,202209,386,167,219,202409.66,265435.58,467845.24
240020,202209,2379,1939,440,2350121.36,534499.41,2884620.77
240030,202209,122,97,25,117566.49,30300,147866.49
240040,202209,31,30,1,36360,1212,37572
240050,202209,537,463,74,561175.72,89688.1,650863.82
240060,202209,79,72,7,87264.3,8484,95748.3
240070,202209,278,211,67,255732.78,81204.38,336937.16
240080,202209,604,408,196,494506.97,237555.82,732062.79
240090,202209,103,90,13,109080.7,15756,124836.7
240100,202209,1570,1473,97,1785306.42,117566.51,1902872.93
240110,202209,1076,716,360,869033.29,436338.38,1305371.67
240120,202209,155,114,41,138168.36,49692.74,187861.10
240130,202209,278,253,25,306642.65,30300.6,336943.25
240140,202209,93,59,34,71509.89,41208.64,112718.53
240145,202209,747,655,92,793873.14,111504.1,905377.24
240150,202209,28,21,7,25452,8484,33936
240160,202209,40,32,8,38784,9696,48480
240165,202209,42,34,8,41210.35,9696,50906.35
240170,202209,154,107,47,129685.1,56964,186649.1
240180,202209,115,85,30,103022.27,36360,139382.27
240185,202209,53,47,6,56965.19,7272,64237.19
240190,202209,15,13,2,15756.43,2424,18180.43
240200,202209,3205,1722,1483,2088303.98,1797409.93,3885713.91
240210,202209,166,126,40,152712,48480,201192
240220,202209,1167,800,367,969634.22,444807.81,1414442.03
240230,202209,844,765,79,927204.83,95750.22,1022955.05
240240,202209,82,54,28,65448,33936.8,99384.8
240250,202209,103,88,15,106658.44,18180,124838.44
240260,202209,1931,1355,576,1643498.8,699329.3,2342828.1
240270,202209,173,149,24,180589.9,29088,209677.9
240280,202209,66,53,13,65448.2,15756,81204.2
240290,202209,43,41,2,49692,2424,52116
240300,202209,169,91,78,110292.4,94536,204828.4
240310,202209,2589,1380,1209,1672602.26,1465326.73,3137928.99
240320,202209,179,164,15,198768.07,18180,216948.07
240325,202209,5028,2855,2173,3465202.25,2639788.14,6104990.39
240330,202209,78,74,4,89688,4848,94536
240340,202209,99,67,32,81204.6,38784.15,119988.75
240350,202209,95,76,19,92112.2,23028,115140.2
240360,202209,702,437,265,529656.19,321188.12,850844.31
240370,202209,64,55,9,66660.65,10908,77568.65
240375,202209,52,33,19,39996.99,23028.4,63025.39
240380,202209,221,180,41,218166.25,49692.7,267858.95
240390,202209,15,13,2,15756,2424,18180
240400,202209,87,77,10,93324.1,12120.2,105444.3
240410,202209,12,8,4,9696,4848,14544
240420,202209,1149,817,332,990224.39,402391.13,1392615.52
240430,202209,262,241,21,292097.82,25452.82,317550.64
240440,202209,150,79,71,95750.24,86052.93,181803.17
240450,202209,260,157,103,191501.7,124838.5,316340.2
240460,202209,83,64,19,77568,23028,100596
240470,202209,221,199,22,241194.6,26664,267858.6
240480,202209,15,13,2,15756,2424,18180
240485,202209,84,66,18,79992.8,21816,101808.8
240490,202209,64,57,7,69084,8484,77568
240500,202209,102,76,26,92112,31512,123624
240510,202209,41,31,10,37572.6,12120,49692.6
240520,202209,101,95,6,115140.5,7272.04,122412.54
240530,202209,63,52,11,63025.51,13332,76357.51
240540,202209,99,86,13,104232.1,15756.15,119988.25
240550,202209,13,10,3,12120,3636,15756
240560,202209,409,283,126,343000.9,152712,495712.9
240570,202209,442,273,169,330879.18,204829.12,535708.30
240580,202209,1378,1029,349,1248379.37,422989.3,1671368.67
240590,202209,30,29,1,35148.28,1212,36360.28
240600,202209,99,92,7,111504.96,8484,119988.96
240610,202209,511,420,91,509049.46,110294.3,619343.76
240615,202209,11,10,1,12120,1212,13332
240620,202209,85,81,4,98172.92,4848,103020.92
240630,202209,39,32,7,39996.42,8484.66,48481.08
240640,202209,35,26,9,31512,10908,42420
240650,202209,239,191,48,231493.83,58176.36,289670.19
240660,202209,112,95,17,115140.3,20604.2,135744.5
240670,202209,308,167,141,202410.8,170897.99,373308.79
240680,202209,56,43,13,52116,15756.1,67872.1
240690,202209,50,48,2,58177,2424,60601
240700,202209,179,147,32,178164,38784.2,216948.2
240710,202209,2294,1373,921,1664110.82,1116266.6,2780377.42
240720,202209,1089,769,320,932046.56,387843.84,1319890.40
240725,202209,73,66,7,79992.42,8484,88476.42
240730,202209,150,126,24,152712.91,29088,181800.91
240740,202209,229,194,35,235133.55,42420.62,277554.17
240750,202209,52,30,22,36360,26664,63024
240760,202209,58,46,12,55752,14544.1,70296.1
240770,202209,151,118,33,143016.68,39996.19,183012.87
240780,202209,739,608,131,736910.33,158772.32,895682.65
240790,202209,40,38,2,46056.72,2424,48480.72
240800,202209,9989,6723,3266,8152142.05,3959727.71,12111869.76
240810,202209,22306,11769,10537,14274191.49,12785639.7,27059831.19
240820,202209,267,154,113,186650.76,136958,323608.76
240830,202209,1624,1335,289,1618055.2,350271.22,1968326.42
240840,202209,75,63,12,76356.8,14544,90900.8
240850,202209,88,77,11,93324,13332,106656
240860,202209,109,104,5,126049.38,6060,132109.38
240870,202209,57,46,11,55753,13332,69085
240880,202209,31,28,3,33936.26,3636,37572.26
240890,202209,1205,668,537,810845.87,650850.35,1461696.22
240895,202209,64,51,13,61813.12,15756,77569.12
240910,202209,175,146,29,176952.43,35148,212100.43
240920,202209,14,12,2,14545.47,2424,16969.47
240930,202209,429,379,50,459363.82,60601.29,519965.11
240933,202209,60,38,22,46056.95,26664,72720.95
240940,202209,2353,2060,293,2496755.05,356333,2853088.05
240950,202209,42,37,5,44844,6060,50904
240960,202209,25,20,5,24240,6060.2,30300.2
240970,202209,106,76,30,92112,36360,128472
240980,202209,213,166,47,201192.17,56964.76,258156.93
240990,202209,144,89,55,107868.2,66660,174528.2
241000,202209,61,55,6,66660.35,7272,73932.35
241010,202209,89,68,21,82416.3,25452,107868.3
241020,202209,109,99,10,119988.6,12120.76,132109.36
241025,202209,20,12,8,14544.95,9696.5,24241.45
241030,202209,106,85,21,103020,25452,128472
241040,202209,44,35,9,42420.1,10908,53328.1
241050,202209,74,68,6,82416,7272,89688
241060,202209,26,22,4,26664,4848,31512
241070,202209,23,23,0,27876.79,,27876.79
241080,202209,60,53,7,64236.2,8484,72720.2
241090,202209,53,39,14,47270.06,16968,64238.06
241100,202209,77,66,11,79992,13332.27,93324.27
241105,202209,25,13,12,15756.5,14544.2,30300.7
241110,202209,51,41,10,49692.15,12120,61812.15
241120,202209,1698,1282,416,1553807.63,504197.06,2058004.69
241140,202209,206,170,36,207253.4,43632,250885.4
241142,202209,49,36,13,43632,15756.45,59388.45
241150,202209,1214,1047,167,1268998.1,202405.33,1471403.43
241160,202209,24,18,6,21816,7272,29088
241170,202209,49,42,7,50904,8484,59388
241180,202209,44,32,12,38784,14544,53328
241190,202209,41,37,4,44844.89,4848,49692.89
241200,202209,4699,2457,2242,2977966.45,2717370.5,5695336.95
241210,202209,72,61,11,73932.3,13332,87264.3
241220,202209,1558,988,570,1197486.47,692064.62,1889551.09
241230,202209,246,199,47,241188.85,56964,298152.85
241240,202209,51,37,14,44844,16968,61812
241250,202209,1169,1065,104,1290798.38,126048.91,1416847.29
241255,202209,63,51,12,61813.94,14544,76357.94
241260,202209,733,559,174,677516.78,212101.67,889618.45
241270,202209,77,53,24,64236,29088,93324
241280,202209,95,84,11,101808.2,13332,115140.2
241290,202209,145,105,40,127264.65,48480.96,175745.61
241300,202209,82,56,26,67872,31512.98,99384.98
241310,202209,48,33,15,39996,18180,58176
241320,202209,37,18,19,21816.52,23028,44844.52
241330,202209,58,50,8,60601.6,9696,70297.6
241335,202209,92,81,11,98173.72,13332,111505.72
241340,202209,186,135,51,163620,61812,225432
241350,202209,63,52,11,63024.66,13332,76356.66
241355,202209,53,44,9,53328.72,10908,64236.72
241360,202209,54,51,3,61812.85,3636,65448.85
241370,202209,63,51,12,61812,14544,76356
241380,202209,38,34,4,41208.4,4848,46056.4
241390,202209,85,65,20,78780,24240,103020
241400,202209,221,166,55,202070.7,66660,268730.7
241410,202209,181,162,19,196344.1,23028.09,219372.19
241415,202209,102,81,21,98172,25452.8,123624.8
241420,202209,133,92,41,112716.73,50904,163620.73
241430,202209,19,17,2,20604,2424,23028
241440,202209,536,447,89,542987.56,107869.65,650857.21
241445,202209,42,36,6,43632,7272.1,50904.1
241450,202209,266,220,46,266644.43,55753.24,322397.67
241460,202209,169,153,16,185438.11,19392,204830.11
241470,202209,33,27,6,32724.4,7272.4,39996.8
241475,202209,48,44,4,53328,4848,58176
241480,202209,135,98,37,118777.54,44844.2,163621.74
241490,202209,15,12,3,14544,3636.1,18180.1
241500,202209,48,37,11,44844.91,13332.02,58176.93
250010,202209,102,85,17,103020.6,20604,123624.6
250020,202209,32,27,5,32724,6060,38784
250030,202209,909,664,245,804782.49,296943.26,1101725.75
250040,202209,400,321,79,389054.88,95748.78,484803.66
250050,202209,286,232,54,281184.3,65448,346632.3
250053,202209,62,48,14,58176.2,16968,75144.2
250057,202209,3,2,1,2424.2,1212,3636.2
250060,202209,629,451,178,546622.23,215738.05,762360.28
250070,202209,683,545,138,660553.51,167256.84,827810.35
250073,202209,9,8,1,9696.16,1212.01,10908.17
250077,202209,183,135,48,163621.77,58176.8,221798.57
250080,202209,421,331,90,401177.07,109081.7,510258.77
250090,202209,225,142,83,172104.07,100596,272700.07
250100,202209,586,470,116,569643.47,140593.8,710237.27
250110,202209,682,493,189,597520.59,230281.62,827802.21
250115,202209,14,4,10,4848,12120.26,16968.26
250120,202209,124,86,38,104232.8,46056.35,150289.15
250130,202209,572,467,105,566013.05,128474.33,694487.38
250135,202209,31,14,17,16968,20604,37572
250140,202209,87,74,13,89688.12,15756,105444.12
250150,202209,638,446,192,540557.55,233916.91,774474.46
250153,202209,14,12,2,14544,2424,16968
250157,202209,34,27,7,32724,8484,41208
250160,202209,244,184,60,223009.59,72720,295729.59
250170,202209,88,59,29,72720,35148,107868
250180,202209,4858,3315,1543,4019112.89,1875013.45,5894126.34
250190,202209,818,545,273,660548.44,330878.36,991426.80
250200,202209,69,53,16,64236,19392,83628
250205,202209,25,20,5,24240,6060,30300
250210,202209,89,74,15,89688.35,18180,107868.35
250215,202209,81,56,25,67872,30300,98172
250220,202209,29,20,9,24240.1,10908,35148.1
250230,202209,77,70,7,84840.6,8484,93324.6
250240,202209,246,187,59,226647.34,71508,298155.34
250250,202209,389,335,54,406026.13,65448,471474.13
250260,202209,48,38,10,46056,12120,58176
250270,202209,80,55,25,66660,30300,96960
250280,202209,390,320,70,387842.03,84840.2,472682.23
250290,202209,104,92,12,111504,14544.84,126048.84
250300,202209,531,358,173,433901.36,209676.37,643577.73
250310,202209,47,44,3,53328,3636,56964
250320,202209,2065,1362,703,1652003.75,853266.41,2505270.16
250330,202209,117,99,18,119989.17,21816.1,141805.27
250340,202209,34,27,7,32724.63,8484,41208.63
250350,202209,203,132,71,159984.4,86052.88,246037.28
250355,202209,36,28,8,33936,9696,43632
250360,202209,187,153,34,185439.83,41209.4,226649.23
250370,202209,2414,1540,874,1867727.55,1060515.67,2928243.22
250375,202209,17,11,6,13332,7272.85,20604.85
250380,202209,55,47,8,56964.12,9696.46,66660.58
250390,202209,46,36,10,43632.16,12120.4,55752.56
250400,202209,17349,8702,8647,10551859.33,10483971.11,21035830.44
250403,202209,311,240,71,290883.01,86052,376935.01
250407,202209,69,56,13,67872,15756.85,83628.85
250410,202209,33,26,7,31512.31,8484.8,39997.11
250415,202209,46,27,19,32724,23028,55752
250420,202209,40,35,5,42420,6060,48480
250430,202209,1491,1292,199,1566219.32,241188.95,1807408.27
250435,202209,32,25,7,30300.55,8484,38784.55
250440,202209,677,558,119,676300.69,144228.2,820528.89
250450,202209,83,63,20,76358.03,24240,100598.03
250460,202209,475,305,170,369662.92,206042.04,575704.96
250470,202209,103,70,33,84840,39996.6,124836.6
250480,202209,331,259,72,313914.36,87264,401178.36
250485,202209,6,6,0,7272,,7272.0
250490,202209,244,196,48,237555.93,58176.37,295732.30
250500,202209,98,77,21,93325.32,25452,118777.32
250510,202209,825,650,175,787806.13,212100.82,999906.95
250520,202209,171,114,57,138168,69084,207252
250523,202209,124,100,24,121200,29088,150288
250527,202209,119,87,32,105444.53,38784,144228.53
250530,202209,8,4,4,4848,4848,9696
250535,202209,31,24,7,29088,8484,37572
250540,202209,147,115,32,139380.24,38784,178164.24
250550,202209,72,70,2,84840.2,2424,87264.2
250560,202209,68,41,27,49692.4,32724,82416.4
250570,202209,163,132,31,159984.8,37572.2,197557.0
250580,202209,96,74,22,89766,26664,116430
250590,202209,24,13,11,15756,13332.6,29088.6
250600,202209,1600,1045,555,1267767.28,672663.49,1940430.77
250610,202209,160,128,32,155142.97,38784.5,193927.47
250620,202209,21,17,4,20604.1,4848,25452.1
250625,202209,73,58,15,70296.63,18180,88476.63
250630,202209,3168,1967,1201,2385494.31,1456845.11,3842339.42
250640,202209,202,159,43,192711.81,52117.32,244829.13
250650,202209,29,18,11,21816,13332.45,35148.45
250660,202209,63,47,16,56964,19392,76356
250670,202209,77,60,17,72720,20604.94,93324.94
250680,202209,428,340,88,412086.36,107868.37,519954.73
250690,202209,2210,1487,723,1802275.13,876286.81,2678561.94
250700,202209,928,787,141,955062.82,170892.4,1125955.22
250710,202209,486,376,110,455726.71,133322.52,589049.23
250720,202209,121,88,33,106656.1,39996,146652.1
250730,202209,418,343,75,415718.74,90901.1,506619.84
250740,202209,67,61,6,73932.67,7272,81204.67
250750,202209,24751,14477,10274,17559816.13,12469330.73,30029146.86
250760,202209,118,93,25,112716.4,30300.14,143016.54
250770,202209,374,246,128,298156.47,155136.7,453293.17
250780,202209,72,49,23,59388,27876,87264
250790,202209,470,285,185,345427.53,224222.67,569650.20
250800,202209,150,135,15,163620,18180,181800
250810,202209,73,60,13,72720,15756,88476
250820,202209,156,129,27,156348.93,32724,189072.93
250830,202209,490,318,172,385423.32,208465.4,593888.72
250840,202209,58,49,9,59388.54,10908.2,70296.74
250850,202209,64,54,10,65448,12120,77568
250855,202209,17,15,2,18180.25,2424,20604.25
250860,202209,250,159,91,192709.18,110292.8,303001.98
250870,202209,29,26,3,31512,3636,35148
250880,202209,93,70,23,84840,27876,112716
250890,202209,3223,2357,866,2857941.85,1052025.84,3909967.69
250900,202209,66,55,11,66660.71,13332,79992.71
250905,202209,128,95,33,115140.9,39996,155136.9
250910,202209,1009,727,282,881137.38,341785.79,1222923.17
250915,202209,116,78,38,94536.13,46057.2,140593.33
250920,202209,144,106,38,128472,47269.74,175741.74
250930,202209,198,111,87,134532.4,105444.2,239976.6
250933,202209,8,5,3,6060,3636,9696
250937,202209,18,17,1,20604,1212,21816
250939,202209,42,33,9,39996.2,10908,50904.2
250940,202209,131,95,36,115141.74,44844.34,159986.08
250950,202209,87,62,25,75146.3,30300,105446.3
250960,202209,88,50,38,60601.36,46056.3,106657.66
250970,202209,1293,908,385,1100509.11,467836.88,1568345.99
250980,202209,102,70,32,84841.01,38784,123625.01
250990,202209,175,131,44,158772,53328,212100
251000,202209,79,67,12,81204,14544,95748
251010,202209,133,93,40,112716,48480,161196
251020,202209,84,69,15,83628.68,18180,101808.68
251030,202209,48,33,15,39996,18180,58176
251040,202209,64,42,22,50904,26664,77568
251050,202209,27,22,5,26664,6060,32724
251060,202209,51,40,11,48480.2,13332,61812.2
251065,202209,6,3,3,3636,3636,7272
251070,202209,20,16,4,19392,4848,24240
251080,202209,5568,2567,3001,3111304.04,3638479.53,6749783.57
251090,202209,193,161,32,195133.72,38784.68,233918.40
251100,202209,22,21,1,25452.2,1212,26664.2
251110,202209,66,43,23,52116,27876,79992
251120,202209,1985,1216,769,1473840.99,932043.54,2405884.53
251130,202209,445,364,81,441171.27,98172.05,539343.32
251140,202209,616,398,218,482379.43,264217.47,746596.90
251150,202209,343,282,61,341789.02,73932.9,415721.92
251160,202209,97,78,19,94536.1,23028,117564.1
251170,202209,88,73,15,88476.32,18180,106656.32
251180,202209,292,166,126,201194.24,152713.48,353907.72
251190,202209,197,127,70,153925.28,84840.28,238765.56
251200,202209,298,229,69,277553.31,83628.1,361181.41
251203,202209,34,31,3,37572,3636,41208
251207,202209,84,70,14,84840,16968,101808
251210,202209,1573,1142,431,1384119.53,522375.19,1906494.72
251220,202209,48,37,11,44844.2,13332,58176.2
251230,202209,589,493,96,597521.81,116353.6,713875.41
251240,202209,120,82,38,99384,46056,145440
251250,202209,1560,1111,449,1346452.79,546619.09,1893071.88
251260,202209,12,8,4,9696,4848,14544
251270,202209,314,243,71,294521.07,86052.52,380573.59
251272,202209,63,55,8,66660.2,9696.1,76356.3
251274,202209,28,21,7,25453.1,8484,33937.1
251275,202209,36,20,16,24240,19392,43632
251276,202209,31,24,7,29088.01,8484,37572.01
251278,202209,14,12,2,14544,2424,16968
251280,202209,107,102,5,123624,6060,129684
251290,202209,1086,762,324,924792.04,392696.45,1317488.49
251300,202209,20,15,5,18180,6060,24240
251310,202209,314,223,91,270277.4,110292.28,380569.68
251315,202209,42,37,5,44844,6060.1,50904.1
251320,202209,76,63,13,76356.2,15756.1,92112.3
251330,202209,84,74,10,89688,12120,101808
251335,202209,23,13,10,15756,12120,27876
251340,202209,821,461,360,558740.99,436322.24,995063.23
251350,202209,38,35,3,42420,3636,46056
251360,202209,86,74,12,89688.1,14544,104232.1
251365,202209,7,7,0,8484.1,,8484.1
251370,202209,5969,4019,1950,4872341.2,2364642.75,7236983.95
251380,202209,48,37,11,44844,13332,58176
251385,202209,3,3,0,3636,,3636.0
251390,202209,996,730,266,884774.94,322398.79,1207173.73
251392,202209,33,22,11,26664,13332,39996
251394,202209,14,11,3,13332,3636,16968
251396,202209,12,7,5,8484,6060.2,14544.2
251398,202209,22,17,5,20604,6060,26664
251400,202209,50,39,11,47268,13332,60600
251410,202209,45,38,7,46056.2,8484,54540.2
251420,202209,112,81,31,98172.15,37572.01,135744.16
251430,202209,43,38,5,46056.7,6060,52116.7
251440,202209,53,27,26,32724,31512,64236
251445,202209,68,58,10,70296.78,12120,82416.78
251450,202209,385,331,54,401179.69,65448.8,466628.49
251455,202209,5,4,1,4848,1212,6060
251460,202209,24,18,6,21816,7272,29088
251465,202209,9,5,4,6060,4848,10908
251470,202209,53,39,14,47268,16968,64236
251480,202209,29,24,5,29088,6060,35148
251490,202209,115,66,49,79992.25,59389.1,139381.35
251500,202209,119,97,22,117565.6,26664,144229.6
251510,202209,89,53,36,64236.73,43632,107868.73
251520,202209,41,33,8,39996,9696,49692
251530,202209,4358,3045,1313,3691790.38,1591366.29,5283156.67
251540,202209,92,75,17,90900,20604.48,111504.48
251550,202209,425,320,105,387845.71,127261.01,515106.72
251560,202209,24,17,7,20604.1,8484,29088.1
251570,202209,16,15,1,18180,1212,19392
251580,202209,132,103,29,124836,35148,159984
251590,202209,105,73,32,88476,38784.6,127260.6
251593,202209,28,15,13,18180,15756,33936
251597,202209,111,85,26,103020.88,31512.04,134532.92
251600,202209,1109,764,345,926274.83,418143.12,1344417.95
251610,202209,256,185,71,224220.6,86052,310272.6
251615,202209,17,14,3,16968,3636,20604
251620,202209,4238,2683,1555,3251843.68,1885898.3,5137741.98
251630,202209,481,352,129,426632.55,156349.86,582982.41
251640,202209,119,88,31,106658.1,37572,144230.1
251650,202209,294,216,78,261793.34,94536.2,356329.54
251660,202209,205,179,26,216949.24,31512.8,248462.04
251670,202209,412,314,98,380570.69,118776.21,499346.90
251675,202209,14,8,6,9696,7272,16968
251680,202209,107,92,15,111504.2,18180,129684.2
251690,202209,316,260,56,315123.94,67873.11,382997.05
251700,202209,283,240,43,290881.32,52116,342997.32
251710,202209,24,14,10,16968,12120,29088
251720,202209,29,22,7,26664,8484,35148
251740,202209,13,10,3,12120,3636,15756
260005,202209,3735,1954,1781,2367788.29,2162240.72,4530029.01
260010,202209,1756,1310,446,1587736.12,541768.08,2129504.20
260020,202209,419,364,55,442382.13,66660.2,509042.33
260030,202209,628,420,208,510256.53,253308.62,763565.15
260040,202209,816,503,313,610857.02,380571.63,991428.65
260050,202209,1178,847,331,1026579.94,402389.52,1428969.46
260060,202209,377,346,31,419361.46,37572,456933.46
260070,202209,1350,824,526,999930.06,641165.56,1641095.62
260080,202209,738,558,180,676301.43,218160,894461.43
260090,202209,475,305,170,369661.58,206040,575701.58
260100,202209,213,143,70,173316.56,84840,258156.56
260105,202209,271,155,116,187861.47,140592,328453.47
260110,202209,3052,2197,855,2662786.24,1037480.82,3700267.06
260120,202209,2824,1490,1334,1806229.28,1619248.42,3425477.70
260130,202209,210,147,63,179376.79,76356,255732.79
260140,202209,2300,1475,825,1788935.45,999911.61,2788847.06
260150,202209,192,127,65,153924.9,78781.4,232706.3
260160,202209,360,282,78,341791.85,94536.14,436327.99
260170,202209,3493,2061,1432,2499184.04,1736820.67,4236004.71
260180,202209,192,160,32,193922.03,38784.64,232706.67
260190,202209,2463,1601,862,1940434.23,1044751.43,2985185.66
260200,202209,1023,796,227,964763.18,275125.93,1239889.11
260210,202209,1401,994,407,1207165.79,494500.18,1701665.97
260220,202209,647,576,71,699334.42,86053.89,785388.31
260230,202209,1305,958,347,1161113.25,421778.9,1582892.15
260240,202209,211,160,51,193923.45,61813.63,255737.08
260250,202209,103,76,27,92112.26,32724,124836.26
260260,202209,1105,773,332,938093.09,402385.39,1340478.48
260270,202209,261,186,75,225435.27,90900,316335.27
260280,202209,1165,927,238,1123539.41,288458.47,1411997.88
260290,202209,7168,3833,3335,4646881.66,4043253.19,8690134.85
260300,202209,1052,889,163,1077497.84,197556.87,1275054.71
260310,202209,522,412,110,499347.01,133320,632667.01
260320,202209,833,595,238,721142.49,288456.94,1009599.43
260330,202209,84,64,20,77569.2,24240.2,101809.4
260340,202209,88,65,23,78780.2,27876,106656.2
260345,202209,5970,3060,2910,3708784.2,3526965.95,7235750.15
260350,202209,494,351,143,425417.87,173316.7,598734.57
260360,202209,252,141,111,170892.73,134533.1,305425.83
260370,202209,749,482,267,585399.64,324817,910216.64
260380,202209,558,393,165,476320.88,199981.05,676301.93
260390,202209,297,253,44,306638.92,53328,359966.92
260392,202209,118,101,17,122412.4,20604.26,143016.66
260400,202209,4548,2579,1969,3126981.41,2387654.29,5514635.70
260410,202209,15759,8110,7649,9840371.33,9286403.39,19126774.72
260415,202209,151,126,25,152713.24,30300,183013.24
260420,202209,1779,1104,675,1339278.24,820525.54,2159803.78
260430,202209,174,156,18,189074.97,21816.8,210891.77
260440,202209,204,137,67,166047.4,81204.74,247252.14
260450,202209,426,314,112,380575.08,135744.01,516319.09
260460,202209,877,450,427,545408.69,517528.23,1062936.92
260470,202209,342,207,135,250888.61,164833.28,415721.89
260480,202209,253,158,95,191496,115140,306636
260490,202209,234,182,52,220584,63024,283608
260500,202209,1171,776,395,942950.85,478743.88,1421694.73
260510,202209,852,676,176,819318.37,213312.43,1032630.80
260515,202209,238,218,20,264217.51,24240.91,288458.42
260520,202209,3271,1990,1281,2411837.93,1553799.38,3965637.31
260530,202209,863,688,175,833872.27,212100.1,1045972.37
260540,202209,548,428,120,518738.95,145441.04,664179.99
260545,202209,25,14,11,16968.91,13332,30300.91
260550,202209,352,227,125,275125.6,151500.2,426625.8
260560,202209,515,391,124,473900.09,150290.84,624190.93
260570,202209,1041,831,210,1007189.17,254520.87,1261710.04
260580,202209,351,283,68,342996.2,82416.83,425413.03
260590,202209,633,365,268,442380.71,326028.4,768409.11
260600,202209,8123,4718,3405,5718280.59,4129315.2,9847595.79
260610,202209,506,341,165,413295.87,199982.41,613278.28
260620,202209,3936,2010,1926,2436161.73,2334349.7,4770511.43
260630,202209,80,73,7,88476,8484,96960
260640,202209,3471,2067,1404,2505225.99,1704079.15,4209305.14
260650,202209,323,234,89,283611.06,107869.2,391480.26
260660,202209,607,393,214,476326.34,260582.27,736908.61
260670,202209,105,76,29,92112,35148.12,127260.12
260680,202209,4151,2229,1922,2702835.31,2330717.42,5033552.73
260690,202209,131,96,35,116352.74,42420,158772.74
260700,202209,322,217,105,264218.77,127260,391478.77
260710,202209,49,42,7,50904,8484,59388
260720,202209,2777,1616,1161,1958604.52,1411985.71,3370590.23
260730,202209,760,558,202,676303.65,244824.97,921128.62
260740,202209,79,64,15,77568,18180,95748
260750,202209,572,424,148,513895.82,179377.02,693272.84
260760,202209,760,375,385,454512.33,466630.91,921143.24
260765,202209,1033,527,506,642371.59,613280.7,1255652.29
260770,202209,218,159,59,192690.13,71509.6,264199.73
260775,202209,840,439,401,532079.28,487232.24,1019311.52
260780,202209,236,147,89,178165.6,107869.2,286034.8
260790,202209,16238,7876,8362,9548328.68,10138455.77,19686784.45
260795,202209,159,104,55,126048.62,66660,192708.62
260800,202209,310,253,57,306637.1,69084.96,375722.06
260805,202209,173,115,58,139381.25,70296.7,209677.95
260810,202209,851,684,167,829011.15,204828.8,1033839.95
260820,202209,313,202,111,244826.19,134532,379358.19
260825,202209,221,148,73,179376.85,88476,267852.85
260830,202209,303,194,109,235128,132108,367236
260840,202209,277,197,80,238764.58,96960.21,335724.79
260845,202209,198,121,77,146652.92,93324.1,239977.02
260850,202209,428,317,111,384206.91,134532,518738.91
260860,202209,240,183,57,221798.73,70296,292094.73
260870,202209,350,273,77,330880.08,93324,424204.08
260875,202209,765,551,214,667835.23,259369.75,927204.98
260880,202209,1616,1079,537,1307761.61,650844.97,1958606.58
260890,202209,2496,1708,788,2071333.43,956276.16,3027609.59
260900,202209,1021,743,278,900525.28,336937.4,1237462.68
260910,202209,257,201,56,243614.06,67872,311486.06
260915,202209,284,212,72,256944.2,87264,344208.2
260920,202209,218,115,103,139380,124836.6,264216.6
260930,202209,353,298,55,361179.72,66660.86,427840.58
260940,202209,2652,1418,1234,1718651.73,1495625.14,3214276.87
260950,202209,2048,1162,886,1410791.95,1073850.61,2484642.56
260960,202209,14440,6930,7510,8401834.16,9110736.7,17512570.86
260970,202209,436,348,88,422990.16,106656,529646.16
260980,202209,211,191,20,231494.55,24240.1,255734.65
260990,202209,2725,2162,563,2620410.45,682363.5,3302773.95
261000,202209,4325,2651,1674,3214260.15,2032538.33,5246798.48
261010,202209,135,98,37,118776.92,44844,163620.92
261020,202209,600,442,158,535710.17,191496.1,727206.27
261030,202209,257,190,67,230280,81204,311484
261040,202209,379,317,62,384209.12,75144,459353.12
261050,202209,538,443,95,536920.66,115141.6,652062.26
261060,202209,1575,963,612,1168379,742959.01,1911338.01
261070,202209,10093,4732,5361,5739015.26,6503739.22,12242754.48
261080,202209,367,280,87,339365.94,105444,444809.94
261090,202209,2136,1633,503,1979239.21,609639,2588878.21
261100,202209,1265,872,393,1059304.15,477532.21,1536836.36
261110,202209,9651,5988,3663,7258829.37,4439619.1,11698448.47
261120,202209,232,197,35,238764.38,42420,281184.38
261130,202209,577,335,242,406026.81,293309.72,699336.53
261140,202209,218,136,82,164832.75,99384,264216.75
261150,202209,679,435,244,527223.5,296940,824163.5
261153,202209,73,69,4,83628.2,4848,88476.2
261160,202209,79010,38355,40655,46522728.91,49320618.24,95843347.15
261170,202209,493,370,123,448441.93,150289,598730.93
261180,202209,1819,1139,680,1381984.85,825379.6,2207364.45
261190,202209,592,404,188,492076.95,227856.73,719933.68
261200,202209,218,176,42,213315.52,50904,264219.52
261210,202209,46,34,12,41208.1,14544,55752.1
261220,202209,2886,2002,884,2427675.33,1072631.03,3500306.36
261230,202209,378,278,100,336938.01,121200.97,458138.98
261240,202209,441,377,64,456931.51,77568.96,534500.47
261245,202209,252,214,38,259368.35,46056,305424.35
261247,202209,172,130,42,157562.03,50904,208466.03
261250,202209,3851,1829,2022,2217980.82,2451885,4669865.82
261255,202209,256,226,30,273912.52,36360,310272.52
261260,202209,868,747,121,905393.21,146655.33,1052048.54
261270,202209,210,148,62,179376.13,75144,254520.13
261280,202209,201,159,42,192709.28,50904,243613.28
261290,202209,105,75,30,90900.24,36360.2,127260.44
261300,202209,1428,1058,370,1282314.25,448444.96,1730759.21
261310,202209,826,547,279,662972.97,338150.38,1001123.35
261320,202209,530,364,166,441173.31,201193.29,642366.60
261330,202209,927,725,202,878728.93,244832.07,1123561.00
261340,202209,330,184,146,223008.9,176952.94,399961.84
261350,202209,925,634,291,768423.6,352698.21,1121121.81
261360,202209,1429,902,527,1093230.68,638727.11,1731957.79
261370,202209,5113,2972,2141,3603327.91,2598561.16,6201889.07
261380,202209,577,449,128,544192.51,155136,699328.51
261390,202209,3872,2613,1259,3168237.25,1527149.85,4695387.10
261400,202209,272,245,27,296942.56,32725.06,329667.62
261410,202209,1164,760,404,921133.31,489649.57,1410782.88
261420,202209,983,600,383,727208.53,464197.26,1191405.79
261430,202209,320,286,34,346634.58,41208,387842.58
261440,202209,103,98,5,118776.44,6060,124836.44
261450,202209,2630,2047,583,2480985.81,707814.77,3188800.58
261460,202209,795,615,180,745393.77,218162.6,963556.37
261470,202209,232,185,47,224221.5,56964.79,281186.29
261480,202209,482,359,123,435114.76,149023.46,584138.22
261485,202209,398,234,164,283611.33,198768.2,482379.53
261500,202209,639,410,229,496924.61,277549.72,774474.33
261510,202209,53,35,18,42421.28,21816.1,64237.38
261520,202209,96,81,15,98172.78,18180.2,116352.98
261530,202209,4266,2724,1542,3301535.82,1874979.2,5176515.02
261540,202209,1527,874,653,1059298.77,792655.53,1851954.30
261550,202209,266,129,137,156349.1,166044,322393.1
261560,202209,973,641,332,776903.3,402387.15,1179290.45
261570,202209,390,312,78,378149.08,94536.95,472686.03
261580,202209,405,325,80,393904.14,96960,490864.14
261590,202209,192,158,34,191498.56,41208.8,232707.36
261600,202209,315,246,69,298157.01,83629.13,381786.14
261610,202209,89,74,15,89688,18180,107868
261618,202209,82,58,24,70296,29088,99384
261620,202209,205,131,74,158772.25,89688.8,248461.05
261630,202209,686,535,151,648422.45,183012,831434.45
261640,202209,6847,3586,3261,4347506.97,3956012.17,8303519.14
261650,202209,477,306,171,372085.15,207252.1,579337.25
270010,202209,521,460,61,557528.24,73932.5,631460.74
270020,202209,253,208,45,252098.11,54540.2,306638.31
270030,202209,9350,6004,3346,7280606.68,4060181.78,11340788.46
270040,202209,2102,1377,725,1668940.97,878705.99,2547646.96
270050,202209,233,179,54,216949.5,65448.67,282398.17
270060,202209,74,49,25,59391.53,30300.96,89692.49
270070,202209,800,587,213,711447.06,258157.1,969604.16
270080,202209,44,36,8,43632,9696,53328
270090,202209,21,16,5,19392,6060,25452
270100,202209,1331,903,428,1094446.33,518738.54,1613184.87
270110,202209,66,55,11,66660,13332,79992
270120,202209,254,205,49,248465.64,59388.6,307854.24
270130,202209,338,252,86,305426.51,104232,409658.51
270135,202209,123,86,37,104233.3,44844,149077.3
270140,202209,1431,946,485,1147785.64,587827.74,1735613.38
270150,202209,245,188,57,227857.63,69084.1,296941.73
270160,202209,490,384,106,465413.45,128472,593885.45
270170,202209,821,541,280,655696.76,339360.19,995056.95
270180,202209,54,44,10,53328.19,12120.76,65448.95
270190,202209,110,95,15,115142.45,18180,133322.45
270200,202209,122,106,16,128472.3,19392,147864.3
270210,202209,554,338,216,409658.65,261792.92,671451.57
270220,202209,196,141,55,172104.35,66660.83,238765.18
270230,202209,2194,1380,814,1675004.78,988993.98,2663998.76
270235,202209,503,390,113,472690.84,136956.1,609646.94
270240,202209,3358,2663,695,3230013.5,842344.04,4072357.54
270250,202209,122,92,30,111505.42,36360,147865.42
270255,202209,212,175,37,212101.99,44844,256945.99
270260,202209,423,337,86,409663.38,104232.37,513895.75
270270,202209,95,50,45,60600,55752,116352
270280,202209,203,127,76,153924,92112,246036
270290,202209,1119,874,245,1059298.34,296944.51,1356242.85
270300,202209,379,277,102,335724.92,124836.2,460561.12
270310,202209,813,682,131,829022.98,158773.43,987796.41
270320,202209,770,667,103,808414.26,126048,934462.26
270330,202209,316,273,43,330876.27,52116,382992.27
270340,202209,61,52,9,63024,10908,73932
270350,202209,86,51,35,61813.11,42420,104233.11
270360,202209,79,41,38,49692,46056,95748
270370,202209,65,51,14,61812,16968,78780
270375,202209,82,53,29,64236,35148,99384
270380,202209,1069,726,343,879914.76,415716,1295630.76
270390,202209,138,82,56,99384,67872.1,167256.1
270400,202209,747,574,173,695695.94,209676.92,905372.86
270410,202209,219,166,53,201197.38,64236.01,265433.39
270420,202209,409,286,123,346634.88,149076.3,495711.18
270430,202209,35292,25167,10125,30527754.29,12292350.24,42820104.53
270440,202209,473,375,98,454506.98,118777.04,573284.02
270450,202209,869,518,351,627819.96,426625.91,1054445.87
270460,202209,180,142,38,172106.76,46056,218162.76
270470,202209,1656,1159,497,1405942.06,602364.66,2008306.72
270480,202209,570,459,111,556316.7,134532,690848.7
270490,202209,22,16,6,19392,7272,26664
270500,202209,470,390,80,472685.57,96960,569645.57
270510,202209,916,605,311,733207.85,376933.5,1110141.35
270520,202209,266,179,87,216948.78,105444,322392.78
270530,202209,64,54,10,65448.2,12120,77568.2
270540,202209,92,66,26,79992.2,31512,111504.2
270550,202209,1669,1289,380,1562287.43,460562.67,2022850.10
270560,202209,252,155,97,187861.49,117564.5,305425.99
270570,202209,586,417,169,507832.8,204828,712660.8
270580,202209,22,16,6,19392,7272,26664
270590,202209,56,44,12,53328.3,14544,67872.3
270600,202209,155,132,23,159986.62,27876.1,187862.72
270610,202209,244,197,47,238765.57,56964.1,295729.67
270620,202209,17,17,0,20604,,20604.0
270630,202209,3667,2763,904,3350033.98,1099291.46,4449325.44
270640,202209,884,653,231,792655.98,279974.36,1072630.34
270642,202209,213,179,34,216949.82,41208,258157.82
270644,202209,311,178,133,215737.03,162410.34,378147.37
270650,202209,350,212,138,256946.51,167258.25,424204.76
270660,202209,191,171,20,207258.85,25452,232710.85
270670,202209,2972,2260,712,2747636.51,865370.41,3613006.92
270680,202209,394,255,139,309064.28,168468.46,477532.74
270690,202209,1250,848,402,1027789.86,488440.4,1516230.26
270700,202209,24,19,5,23028.42,6060,29088.42
270710,202209,551,430,121,521164.48,146652.65,667817.13
270720,202209,226,182,44,220587.11,53328.5,273915.61
270730,202209,1928,1202,726,1458047.13,881127.48,2339174.61
270740,202209,35,24,11,29088,13332,42420
270750,202209,625,479,146,580552.99,176952,757504.99
270760,202209,302,220,82,266644.85,99384.76,366029.61
270770,202209,2890,1982,908,2405861.06,1101713.82,3507574.88
270780,202209,67,39,28,47268,33937.46,81205.46
270790,202209,215,136,79,164833.02,95748,260581.02
270800,202209,2057,1646,411,1994983.15,500556.57,2495539.72
270810,202209,220,180,40,218161.36,48480,266641.36
270820,202209,122,85,37,103024.12,44844,147868.12
270830,202209,845,647,198,784185.84,239977.5,1024163.34
270840,202209,1328,1032,296,1250792.25,359966.46,1610758.71
270850,202209,1539,1000,539,1213220.21,653270.56,1866490.77
270860,202209,2607,1769,838,2146483.1,1019302.56,3165785.66
270870,202209,131,76,55,92112.8,66660.2,158773.0
270880,202209,851,672,179,814474.48,216949.07,1031423.55
270890,202209,259,198,61,239976.97,73932.8,313909.77
270895,202209,68,65,3,78780,3636,82416
270900,202209,66,54,12,65448.93,14544,79992.93
270910,202209,304,251,53,304218.42,64236.6,368455.02
270915,202209,1966,1309,657,1586529.25,796287.25,2382816.50
270920,202209,419,347,72,420567.53,87264.36,507831.89
270930,202209,5645,4344,1301,5265010.7,1579243.54,6844254.24
270940,202209,2213,1758,455,2130725.35,553886.46,2684611.81
280010,202209,36,30,6,36361.29,7272,43633.29
280020,202209,506,427,79,517526.18,95748.97,613275.15
280030,202209,22304,14379,7925,17436426.17,9611366.74,27047792.91
280040,202209,334,206,128,250884.73,155136.2,406020.93
280050,202209,439,337,102,409659.93,123624.6,533284.53
280060,202209,399,255,144,309063.22,174529.02,483592.24
280067,202209,1153,825,328,999909.77,397536.31,1397446.08
280070,202209,121,103,18,124837.57,21816,146653.57
280100,202209,678,526,152,637518.17,184224.68,821742.85
280110,202209,84,75,9,90901.32,10908,101809.32
280120,202209,691,574,117,695693.6,141805.88,837499.48
280130,202209,1786,1171,615,1419260.12,747806.2,2167066.32
280140,202209,518,433,85,524800.81,103020,627820.81
280150,202209,424,297,127,359969.76,153924,513893.76
280160,202209,147,111,36,134532,43632,178164
280170,202209,435,306,129,372091.49,156350.41,528441.90
280190,202209,31,24,7,29088,8484,37572
280200,202209,44,34,10,41211.28,12120.3,53331.58
280210,202209,3069,2212,857,2682109.34,1039905.48,3722014.82
280220,202209,56,45,11,54540.91,13332,67872.91
280230,202209,340,274,66,333308.16,79993.57,413301.73
280240,202209,129,119,10,144230.58,12120,156350.58
280250,202209,19,11,8,13332,9697.05,23029.05
280260,202209,80,73,7,88476.1,8484,96960.1
280270,202209,141,108,33,130896,39996.7,170892.7
280280,202209,189,124,65,150289.19,78780,229069.19
280290,202209,3782,2743,1039,3324468.56,1259278.56,4583747.12
280300,202209,1672,1340,332,1625312.53,402386.2,2027698.73
280310,202209,100,94,6,113929.2,7272,121201.2
280320,202209,679,469,210,569647.18,254522.95,824170.13
280330,202209,322,237,85,287248,103020.2,390268.2
280340,202209,430,358,72,433898.85,87265.17,521164.02
280350,202209,3832,2942,890,3565756.32,1079909.55,4645665.87
280360,202209,490,332,158,402389.46,191496.4,593885.86
280370,202209,97,83,14,100596.13,16968,117564.13
280380,202209,49,38,11,46056,13332,59388
280390,202209,177,150,27,181801.25,32724,214525.25
280400,202209,408,272,136,329671.85,164833.95,494505.80
280410,202209,299,250,49,303001.94,59388,362389.94
280420,202209,143,124,19,150293.04,23028.95,173321.99
280430,202209,97,77,20,93325.42,24240,117565.42
280440,202209,726,596,130,722361.67,158773.38,881135.05
280445,202209,124,116,8,140594.06,9696,150290.06
280450,202209,1322,1131,191,1370783.08,231496.92,1602280.00
280460,202209,687,501,186,607217.98,225432.19,832650.17
280470,202209,101,91,10,110292.26,12120,122412.26
280480,202209,3211,2157,1054,2615575.17,1277479.23,3893054.40
280490,202209,200,190,10,230283.56,12120,242403.56
280500,202209,40,36,4,43632.04,4848.17,48480.21
280510,202209,138,112,26,135744.76,31513.3,167258.06
280520,202209,51,37,14,44844.67,16968,61812.67
280530,202209,75,51,24,61812.97,29088,90900.97
280540,202209,564,489,75,593885.55,90900,684785.55
280550,202209,751,692,59,838716.09,71508,910224.09
280560,202209,489,441,48,534496.45,58177.19,592673.64
280570,202209,2387,1888,499,2289488.18,604789.15,2894277.33
280580,202209,593,466,127,564795.75,153924.76,718720.51
280590,202209,226,143,83,173322.83,100598.1,273920.93
280600,202209,411,337,74,408503.77,89688.2,498191.97
280610,202209,116,84,32,101811.43,38785.92,140597.35
280620,202209,560,455,105,551465.57,127260.73,678726.30
280630,202209,156,126,30,152713.68,36360,189073.68
280640,202209,183,147,36,178164.1,43632,221796.1
280650,202209,85,50,35,60600.2,42420.52,103020.72
280660,202209,126,96,30,116355.03,36360.31,152715.34
280670,202209,2094,1335,759,1618113.13,921139.83,2539252.96
280680,202209,241,206,35,249673.04,42420,292093.04
280690,202209,78,68,10,82416,12120,94536
280700,202209,21,21,0,25452,,25452.0
280710,202209,1539,1195,344,1448359.82,416929.68,1865289.50
280720,202209,126,86,40,104233.71,48480,152713.71
280730,202209,31,27,4,32724.97,4848,37572.97
280740,202209,2608,1954,654,2369477.18,792650.67,3162127.85
280750,202209,224,196,28,237556.01,33936.34,271492.35
280760,202209,941,636,305,770851.74,369662.33,1140514.07
290010,202209,198,139,59,168468.86,71508,239976.86
290020,202209,182,162,20,196344.8,24240,220584.8
290030,202209,627,402,225,488439.04,273912.88,762351.92
290035,202209,136,111,25,134533.17,30300.93,164834.10
290040,202209,254,175,79,212104.12,95748,307852.12
290050,202209,88,70,18,84840,21816,106656
290060,202209,256,114,142,138169.15,172104.2,310273.35
290070,202209,6072,2850,3222,3459103.13,3907532.99,7366636.12
290080,202209,463,197,266,238766.39,322392.09,561158.48
290090,202209,345,159,186,192708.3,225433.39,418141.69
290100,202209,1723,1082,641,1313826.65,778106.92,2091933.57
290110,202209,897,507,390,614495.33,472685.43,1087180.76
290115,202209,184,167,17,202405.36,20604,223009.36
290120,202209,809,541,268,655699.27,324816.61,980515.88
290130,202209,468,284,184,344209.26,223008.16,567217.42
290135,202209,296,222,74,270277.03,89688.13,359965.16
290140,202209,320,268,52,324821.74,63024.2,387845.94
290150,202209,141,95,46,115140,55752,170892
290160,202209,246,188,58,227860.82,70297.23,298158.05
290170,202209,107,76,31,92112,37572,129684
290180,202209,198,143,55,173317.85,67872.2,241190.05
290190,202209,369,292,77,353911.47,93324.9,447236.37
290195,202209,300,194,106,235128.4,128472,363600.4
290200,202209,265,213,52,258156.31,63024.1,321180.41
290205,202209,150,93,57,112716,69084,181800
290210,202209,1270,927,343,1123542.72,415718.14,1539260.86
290220,202209,173,102,71,123626.61,86052.2,209678.81
290225,202209,296,114,182,138170,221797.86,359967.86
290230,202209,90,55,35,66661.97,42420,109081.97
290240,202209,369,129,240,156349,290881.3,447230.3
290250,202209,243,225,18,272704.34,21816,294520.34
290260,202209,350,275,75,333308.39,90902.34,424210.73
290265,202209,192,167,25,202405.84,30300.49,232706.33
290270,202209,1405,1160,245,1405944.08,296942.38,1702886.46
290280,202209,481,336,145,410869.58,178164.4,589033.98
290290,202209,1427,851,576,1032636.14,699326.78,1731962.92
290300,202209,392,335,57,406027.86,69084.99,475112.85
290310,202209,284,134,150,162409.86,181800,344209.86
290320,202209,4350,2608,1742,3162181.36,2117380.77,5279562.13
290323,202209,209,182,27,221797.76,32724.2,254521.96
290327,202209,167,128,39,155138.55,47268,202406.55
290330,202209,125,57,68,69084.73,82416,151500.73
290340,202209,791,325,466,393906.09,564792.92,958699.01
290350,202209,683,410,273,496923.31,330878.59,827801.90
290360,202209,334,256,78,310276.61,94536.63,404813.24
290370,202209,901,404,497,489649.56,602365.51,1092015.07
290380,202209,342,215,127,260583.36,153925.45,414508.81
290390,202209,2450,1522,928,1845903.36,1127167.14,2973070.50
290395,202209,233,136,97,164832,117564,282396
290400,202209,294,213,81,259368.79,98172,357540.79
290405,202209,246,208,38,252096.15,46056,298152.15
290410,202209,640,536,104,649634.49,126048,775682.49
290420,202209,280,223,57,270277.8,69084,339361.8
290430,202209,489,312,177,378146.25,214524,592670.25
290440,202209,89,76,13,92112.22,15756,107868.22
290450,202209,194,143,51,173316.46,61812,235128.46
290460,202209,2003,1191,812,1443504.04,985359.19,2428863.23
290470,202209,1385,609,776,738118.27,940521.36,1678639.63
290475,202209,566,530,36,642370.66,43632,686002.66
290480,202209,209,120,89,145441,107868.33,253309.33
290485,202209,240,215,25,260581.68,30300,290881.68
290490,202209,1313,907,406,1100503.78,492074.79,1592578.57
290500,202209,793,421,372,510256.95,450866.98,961123.93
290510,202209,190,154,36,186652.68,44844.34,231497.02
290515,202209,179,108,71,130896.69,86052,216948.69
290520,202209,1427,933,494,1130802.06,599940.96,1730743.02
290530,202209,279,251,28,304218.7,33936.2,338154.9
290540,202209,118,58,60,70296,72720,143016
290550,202209,168,139,29,168469.17,35148,203617.17
290560,202209,3253,1452,1801,1759854.27,2185247.04,3945101.31
290570,202209,6926,3258,3668,3949998.19,4446904.13,8396902.32
290580,202209,1302,778,524,942943.06,635089.65,1578032.71
290590,202209,583,466,117,564807.64,143019.95,707827.59
290600,202209,1794,1223,571,1484726.24,693275.89,2178002.13
290610,202209,182,166,16,201197.64,19392,220589.64
290620,202209,387,346,41,419353.46,49692.4,469045.86
290630,202209,2029,861,1168,1043549.36,1415622.72,2459172.08
290640,202209,129,101,28,122413.67,33936.05,156349.72
290650,202209,1981,917,1064,1111422.84,1290785.96,2402208.80
290660,202209,259,211,48,255732,58176,313908
290670,202209,1058,521,537,631461.57,650851.32,1282312.89
290680,202209,1265,1014,251,1228979.68,304214.57,1533194.25
290682,202209,340,252,88,305426.39,106656.38,412082.77
290685,202209,261,156,105,189073.46,127260.2,316333.66
290687,202209,1189,785,404,951630.53,489649.68,1441280.21
290689,202209,147,76,71,92112,88476,180588
290690,202209,580,260,320,315122.38,387841.74,702964.12
290700,202209,253,129,124,156350.04,150289.49,306639.53
290710,202209,781,537,244,650851.35,295734.15,946585.50
290720,202209,1073,860,213,1042339.37,258158.01,1300497.38
290730,202209,1266,743,523,900528.41,635094.73,1535623.14
290740,202209,27,23,4,27876,4848,32724
290750,202209,1506,649,857,786600.85,1038698.96,1825299.81
290755,202209,76,66,10,79992,12120,92112
290760,202209,264,230,34,278767.67,41208.2,319975.87
290770,202209,191,183,8,221797.15,9696,231493.15
290780,202209,1130,895,235,1084750.59,284825.09,1369575.68
290790,202209,394,266,128,323609.09,155140.54,478749.63
290800,202209,2457,992,1465,1203529.12,1775586.22,2979115.34
290810,202209,498,342,156,414507.01,189073.02,603580.03
290820,202209,419,246,173,298158.68,209678.57,507837.25
290830,202209,479,339,140,410869.74,169680.43,580550.17
290840,202209,1892,1183,709,1433814.44,860525.07,2294339.51
290850,202209,1028,522,506,632668.57,614488.37,1247156.94
290860,202209,677,318,359,385418.7,435109.34,820528.04
290870,202209,630,437,193,529651.67,233917.76,763569.43
290880,202209,120,67,53,81204,64236,145440
290890,202209,489,292,197,353907.94,238765.3,592673.24
290900,202209,162,123,39,149076,47268,196344
290910,202209,395,304,91,368449.15,110292,478741.15
290920,202209,203,180,23,218162.92,27876.6,246039.52
290930,202209,538,411,127,498136.99,153926.21,652063.20
290940,202209,225,191,34,231492.3,41208,272700.3
290950,202209,159,90,69,109080,83628,192708
290960,202209,501,353,148,427839.05,179377.86,607216.91
290970,202209,234,206,28,249672.5,33936.2,283608.7
290980,202209,1936,1332,604,1614404.97,733267.16,2347672.13
290990,202209,425,358,67,433905.75,81205.98,515111.73
291000,202209,926,287,639,347844.94,774468,1122312.94
291005,202209,2654,1129,1525,1368376.73,1850750.02,3219126.75
291010,202209,118,103,15,124836,18180,143016
291020,202209,91,72,19,87264,23028.8,110292.8
291030,202209,101,74,27,89688,32724,122412
291040,202209,653,381,272,462984.78,329664.2,792648.98
291050,202209,1548,805,743,976883.85,900520.73,1877404.58
291060,202209,1702,936,766,1136872.03,928397.61,2065269.64
291070,202209,1987,1484,503,1798630.52,609642.77,2408273.29
291072,202209,7450,2819,4631,3419130.8,5620075.1,9039205.9
291075,202209,241,200,41,242400.1,49692.2,292092.3
291077,202209,60,42,18,50904,21816,72720
291080,202209,21786,9248,12538,11220923.74,15213225.34,26434149.08
291085,202209,282,230,52,278761.19,63024.75,341785.94
291090,202209,263,104,159,126049.29,192708,318757.29
291100,202209,992,339,653,410868.15,791436,1202304.15
291110,202209,449,344,105,416930.56,127260.2,544190.76
291120,202209,2480,1302,1178,1578034.35,1427742.04,3005776.39
291125,202209,69,35,34,42420,41208,83628
291130,202209,188,164,24,198770.16,29088,227858.16
291140,202209,129,101,28,122412,33936.7,156348.7
291150,202209,364,133,231,161196,279972,441168
291160,202209,413,314,99,380576.96,119988.8,500565.76
291165,202209,50,38,12,46056,14544,60600
291170,202209,3398,1667,1731,2020434.71,2097976.85,4118411.56
291180,202209,1250,516,734,625400.74,890821.41,1516222.15
291185,202209,111,102,9,124836.78,10908,135744.78
291190,202209,1399,672,727,814473.54,881132.99,1695606.53
291200,202209,174,128,46,155136.2,55752,210888.2
291210,202209,2487,1001,1486,1214438.68,1802252.19,3016690.87
291220,202209,312,236,76,286033.19,92112,378145.19
291230,202209,974,347,627,420566.7,759927.1,1180493.8
291240,202209,409,379,30,459350.26,36360,495710.26
291250,202209,415,337,78,408444,94536,502980
291260,202209,63,54,9,65448,10908,76356
291270,202209,1037,455,582,551480.04,705396.86,1256876.90
291280,202209,368,172,196,208465.66,237552.8,446018.46
291290,202209,1645,863,782,1045983.67,947795.99,1993779.66
291300,202209,240,185,55,224220.28,66660,290880.28
291310,202209,230,202,28,244827.9,33936,278763.9
291320,202209,1315,914,401,1107788.73,486015.23,1593803.96
291330,202209,144,122,22,147865.2,26664,174529.2
291340,202209,225,132,93,159985.4,112717.21,272702.61
291345,202209,123,86,37,104232.53,44844,149076.53
291350,202209,1802,682,1120,826586.5,1357441,2184027.5
291360,202209,8662,4109,4553,4985073.05,5526800.6,10511873.65
291370,202209,1148,692,456,838722.43,552677.89,1391400.32
291380,202209,262,205,57,248460.91,69084,317544.91
291390,202209,4126,1815,2311,2202231.6,2800941.29,5003172.89
291400,202209,2111,1471,640,1784095.77,775694.52,2559790.29
291410,202209,211,182,29,220585.87,35148,255733.87
291420,202209,120,92,28,111505.16,33936,145441.16
291430,202209,176,106,70,129684.61,84840,214524.61
291440,202209,542,438,104,532074.73,126048.2,658122.93
291450,202209,1012,677,335,820532.13,406023.92,1226556.05
291460,202209,2038,1596,442,1934390.96,535713.03,2470103.99
291465,202209,2324,1106,1218,1340490.72,1476220.74,2816711.46
291470,202209,2956,1472,1484,1785303.28,1798619.77,3583923.05
291480,202209,12347,5335,7012,6467319.47,8508291.29,14975610.76
291490,202209,680,269,411,326030,498132.4,824162.4
291500,202209,359,216,143,261793.32,173316.47,435109.79
291510,202209,1194,465,729,563582.49,883549.19,1447131.68
291520,202209,938,422,516,511471.32,625393.55,1136864.87
291530,202209,940,274,666,332090.72,807192.89,1139283.61
291535,202209,129,105,24,127260,29089.2,156349.2
291540,202209,350,118,232,143018.07,281185.02,424203.09
291550,202209,1288,610,678,739327.27,824161.69,1563488.96
291560,202209,5221,2624,2597,3181522.51,3149993.83,6331516.34
291570,202209,230,115,115,139381.06,139381.7,278762.76
291580,202209,1221,759,462,919920.52,559946.08,1479866.60
291590,202209,105,50,55,60600.22,66660,127260.22
291600,202209,1157,583,574,706603,695689.42,1402292.42
291610,202209,1454,703,751,852074.31,913868.65,1765942.96
291620,202209,571,270,301,327246.19,364813.6,692059.79
291630,202209,484,151,333,183012.4,403596.85,586609.25
291640,202209,4154,2032,2122,2465244.96,2573097.02,5038341.98
291650,202209,448,306,142,370882.54,172105.34,542987.88
291660,202209,376,156,220,189072.85,266641.8,455714.65
291670,202209,174,108,66,130897.69,79992,210889.69
291680,202209,630,387,243,469063.38,294519.85,763583.23
291685,202209,602,348,254,421781.53,307850.63,729632.16
291690,202209,485,314,171,380568.22,207253.43,587821.65
291700,202209,1061,814,247,987789.12,299365.72,1287154.84
291710,202209,1612,789,823,956280.27,998693.9,1954974.17
291720,202209,442,304,138,368448.02,167256,535704.02
291730,202209,957,552,405,669032.68,492074.1,1161106.78
291733,202209,309,210,99,254522.02,119988.2,374510.22
291735,202209,86,65,21,79992,25452,105444
291740,202209,345,259,86,313909.34,104232,418141.34
291750,202209,2450,1550,900,1879861.59,1090825.5,2970687.09
291760,202209,3121,1711,1410,2074951.39,1708922.01,3783873.40
291770,202209,749,503,246,609654.23,299373.24,909027.47
291780,202209,98,62,36,75144.62,43632.8,118777.42
291790,202209,160,82,78,99384.39,94536.63,193921.02
291800,202209,10600,4486,6114,5439540.74,7416276.99,12855817.73
291810,202209,1074,806,268,976883.05,326030.73,1302913.78
291820,202209,292,210,82,254520.9,99384,353904.9
291830,202209,1023,422,601,511475.69,728415.51,1239891.20
291835,202209,564,524,40,635092.07,48480.2,683572.27
291840,202209,5340,2681,2659,3254309.65,3225177.85,6479487.50
291845,202209,288,94,194,113928,235128,349056
291850,202209,318,278,40,336942.21,48480.4,385422.61
291855,202209,273,116,157,140592.48,190284.78,330877.26
291860,202209,164,107,57,129684,69084.92,198768.92
291870,202209,80,35,45,42420,54540,96960
291875,202209,164,153,11,185438.73,13332,198770.73
291880,202209,435,356,79,431477,95749.14,527226.14
291890,202209,251,87,164,105444.1,198768.6,304212.7
291900,202209,54,32,22,38784,26664,65448
291905,202209,125,96,29,116352.71,35148,151500.71
291910,202209,160,128,32,155136,38784.1,193920.1
291915,202209,442,388,54,471474.14,65449.07,536923.21
291920,202209,5970,2863,3107,3470044.38,3766951.11,7236995.49
291930,202209,171,103,68,124837.61,82416,207253.61
291940,202209,390,227,163,275125.36,197556,472681.36
291950,202209,1215,945,270,1146557.39,327240.2,1473797.59
291955,202209,1451,870,581,1056871.94,704176.33,1761048.27
291960,202209,197,147,50,178164.49,60600,238764.49
291970,202209,779,572,207,693276.69,252097.1,945373.79
291980,202209,1438,1251,187,1516225.73,226646.12,1742871.85
291990,202209,142,131,11,158772.68,13332,172104.68
291992,202209,200,98,102,118779.99,123627.82,242407.81
291995,202209,184,115,69,139381.36,83628.2,223009.56
292000,202209,428,306,122,370875.16,149076.6,519951.76
292010,202209,342,233,109,282396.2,132108.63,414504.83
292020,202209,300,220,80,267853.42,96960.28,364813.70
292030,202209,155,118,37,143016.8,44844,187860.8
292040,202209,585,305,280,369660,339360,709020
292045,202209,122,105,17,127260,20604.67,147864.67
292050,202209,944,679,265,822952.14,321182.08,1144134.22
292060,202209,932,752,180,911445.33,218163.86,1129609.19
292070,202209,68,30,38,36360.2,46056,82416.2
292080,202209,160,111,49,134532.2,59388,193920.2
292090,202209,566,197,369,238765.02,447228,685993.02
292100,202209,1584,685,899,832665.51,1090823.46,1923488.97
292105,202209,175,157,18,190284,21816,212100
292110,202209,2337,869,1468,1053240.43,1779220.46,2832460.89
292120,202209,722,549,173,665399.59,209678.95,875078.54
292130,202209,480,266,214,322396.15,259368.2,581764.35
292140,202209,212,172,40,208468.78,48481.68,256950.46
292145,202209,167,89,78,107868,94536,202404
292150,202209,1531,1271,260,1540464.13,315120.84,1855584.97
292160,202209,172,134,38,162408.4,46056.9,208465.3
292170,202209,1184,1011,173,1225352.64,210890.85,1436243.49
292180,202209,237,165,72,199980,88476,288456
292190,202209,151,97,54,117564,65448.96,183012.96
292200,202209,1466,532,934,644791.51,1132011.44,1776802.95
292205,202209,117,98,19,119988,23028,143016
292210,202209,398,265,133,321183.78,162408.48,483592.26
292220,202209,35,23,12,27876.75,14544,42420.75
292225,202209,51,42,9,50904.51,10908.6,61813.11
292230,202209,1035,780,255,945380.22,309061.79,1254442.01
292240,202209,648,472,176,572072.42,213312.4,785384.82
292250,202209,1675,1086,589,1316254.87,715085.36,2031340.23
292260,202209,420,248,172,301788.94,208465.63,510254.57
292265,202209,255,193,62,233918.75,75144.76,309063.51
292270,202209,738,357,381,432686.61,461772.4,894459.01
292273,202209,220,129,91,156348,110292.8,266640.8
292275,202209,177,89,88,107868,106656,214524
292280,202209,153,103,50,124836,60600,185436
292285,202209,90,70,20,84840,24240.99,109080.99
292290,202209,617,413,204,500562.35,247249.01,747811.36
292300,202209,1883,727,1156,881133.39,1402293.86,2283427.25
292303,202209,134,90,44,109080.59,53328.82,162409.41
292305,202209,119,85,34,103020.57,41208,144228.57
292310,202209,999,656,343,795085.74,415719.68,1210805.42
292320,202209,592,437,155,529647.94,187861.21,717509.15
292330,202209,172,107,65,129684.46,78780,208464.46
292335,202209,309,246,63,298152.96,76356,374508.96
292340,202209,553,387,166,469045.42,201192.2,670237.62
292350,202209,278,147,131,178165.25,158772,336937.25
292360,202209,748,555,193,673873.93,233917.04,907790.97
292370,202209,734,557,177,675090.11,214524.5,889614.61
292380,202209,623,513,110,621759.64,133320.29,755079.93
292390,202209,402,160,242,193920.21,293305.54,487225.75
292400,202209,3721,2265,1456,2746438.92,1765897.67,4512336.59
292405,202209,277,186,91,226644.65,110292.34,336936.99
292410,202209,109,67,42,81204.02,50904,132108.02
292420,202209,281,241,40,292092.82,48480,340572.82
292430,202209,540,390,150,472681.51,181800.31,654481.82
292440,202209,645,537,108,650852.19,130896.94,781749.13
292450,202209,232,175,57,212103.03,69084.07,281187.10
292460,202209,521,398,123,482380.86,149076.92,631457.78
292465,202209,212,180,32,218160.6,38784.75,256945.35
292467,202209,168,111,57,134532.32,69084,203616.32
292470,202209,319,216,103,261793.11,124836,386629.11
292480,202209,413,277,136,335730.85,164835.14,500565.99
292490,202209,241,177,64,214524.3,77568.64,292092.94
292500,202209,936,442,494,535713.59,598735.73,1134449.32
292510,202209,3681,1772,1909,2150105.75,2317353.17,4467458.92
292520,202209,1197,561,636,681156.82,772050.96,1453207.78
292525,202209,446,325,121,393905.81,146654.5,540560.31
292530,202209,5046,2043,3003,2477360.36,3642081.85,6119442.21
292540,202209,500,291,209,352693.13,253308.51,606001.64
292550,202209,1152,630,522,763568.58,632667.21,1396235.79
292560,202209,334,305,29,369665.01,35148.16,404813.17
292570,202209,333,258,75,312697.27,90900,403597.27
292575,202209,581,417,164,505417.39,198770.5,704187.89
292580,202209,1054,707,347,856887.5,421778.62,1278666.12
292590,202209,578,512,66,621761.78,79992.8,701754.58
292593,202209,146,114,32,138168.58,38784,176952.58
292595,202209,199,158,41,191497.17,49692,241189.17
292600,202209,1290,918,372,1112633.64,450869.47,1563503.11
292610,202209,117,95,22,115141.32,26665.34,141806.66
292620,202209,535,446,89,541781.97,107868.7,649650.67
292630,202209,1579,870,709,1054451.91,860524.53,1914976.44
292640,202209,889,611,278,740540.7,338150.82,1078691.52
292650,202209,188,145,43,175744.98,52116,227860.98
292660,202209,1982,1389,593,1683500.81,718725.71,2402226.52
292665,202209,139,97,42,117564.6,50904,168468.6
292670,202209,400,307,93,372085.98,112716.58,484802.56
292680,202209,267,197,70,238764.76,84840.98,323605.74
292690,202209,209,144,65,174528.91,78780.2,253309.11
292700,202209,1020,662,358,802357.74,433902.23,1236259.97
292710,202209,115,99,16,119988,19392.31,139380.31
292720,202209,1017,587,430,711451.52,522373.58,1233825.10
292730,202209,215,101,114,122413.46,138168.4,260581.86
292740,202209,77671,36871,40800,44715488.19,49497621.72,94213109.91
292750,202209,396,286,110,346637.41,133322.06,479959.47
292760,202209,337,282,55,341786.79,66660.2,408446.99
292770,202209,886,370,516,448442.72,625396.85,1073839.57
292780,202209,33,14,19,16968,23028,39996
292790,202209,796,422,374,511466.36,453288.2,964754.56
292800,202209,1285,766,519,928401.74,629033.39,1557435.13
292805,202209,406,147,259,178164.4,313909.3,492073.7
292810,202209,1867,1110,757,1345336.49,922336.25,2267672.74
292820,202209,700,589,111,713885.26,134534.92,848420.18
292830,202209,134,102,32,123624.81,38784.8,162409.61
292840,202209,714,577,137,700545.3,166046.2,866591.5
292850,202209,139,94,45,113929.82,54542.18,168472.00
292860,202209,2159,1222,937,1482310.89,1135663.14,2617974.03
292870,202209,3769,2456,1313,2977924.12,1591364.19,4569288.31
292880,202209,1458,958,500,1161105.87,606005.44,1767111.31
292890,202209,552,457,95,553889.29,115143.53,669032.82
292895,202209,148,100,48,121200.2,58176,179376.2
292900,202209,335,241,94,293311.07,115141.62,408452.69
292905,202209,510,249,261,301792.54,316333.84,618126.38
292910,202209,518,385,133,466622.96,161196.11,627819.07
292920,202209,566,243,323,294516.8,391480.25,685997.05
292925,202209,474,435,39,527222.61,47269.22,574491.83
292930,202209,715,427,288,517528.37,350269.48,867797.85
292935,202209,283,125,158,151501.72,191496.7,342998.42
292937,202209,219,151,68,183012.78,82416,265428.78
292940,202209,195,148,47,180588.33,56964,237552.33
292950,202209,1361,648,713,786605.67,865376.55,1651982.22
292960,202209,510,360,150,436329.24,181802.13,618131.37
292970,202209,238,170,68,206042.07,82417.04,288459.11
292975,202209,91,50,41,60602.84,49693.56,110296.40
292980,202209,346,241,105,292093.29,127261.68,419354.97
292990,202209,1351,1010,341,1224125.12,414505.32,1638630.44
293000,202209,114,80,34,96960.2,41208.1,138168.3
293010,202209,3055,1796,1259,2176824.46,1525932.41,3702756.87
293015,202209,622,513,109,621761.55,132108,753869.55
293020,202209,340,271,69,328460.88,83629.61,412090.49
293030,202209,583,517,66,626609.67,81204,707813.67
293040,202209,386,306,80,370873.4,96960,467833.4
293050,202209,3070,1798,1272,2180423.59,1541677.75,3722101.34
293060,202209,237,190,47,230286.18,56964.5,287250.68
293070,202209,3867,1939,1928,2350111.62,2336764.23,4686875.85
293075,202209,97,69,28,83628.71,33936,117564.71
293076,202209,80,58,22,70296,26664,96960
293077,202209,600,339,261,410876.82,316335.89,727212.71
293080,202209,435,384,51,465414.57,61812.66,527227.23
293090,202209,138,123,15,149076,18180,167256
293100,202209,536,362,174,438749.95,210888.17,649638.12
293105,202209,352,256,96,310272.98,116352,426624.98
293110,202209,129,84,45,101811.33,54543.92,156355.25
293120,202209,304,214,90,259373.97,109082.57,368456.54
293130,202209,249,167,82,202408.02,99384,301792.02
293135,202209,8592,3417,5175,4143890.46,6273335.55,10417226.01
293140,202209,200,120,80,145441.4,96961.05,242402.45
293150,202209,314,273,41,332095.11,49692.2,381787.31
293160,202209,429,264,165,319969.52,199980.47,519949.99
293170,202209,249,158,91,192711.32,110293.74,303005.06
293180,202209,597,398,199,482377.76,241188,723565.76
293190,202209,1409,973,436,1179303.41,528442.05,1707745.46
293200,202209,569,503,66,609643.29,79992.34,689635.63
293210,202209,415,315,100,381783.73,121200.87,502984.60
293220,202209,2410,1056,1354,1281094.07,1642265.86,2923359.93
293230,202209,1843,687,1156,833868.67,1403497.35,2237366.02
293240,202209,239,214,25,259370.47,30300.79,289671.26
293245,202209,135,109,26,132111.04,31512,163623.04
293250,202209,812,334,478,404816.49,579344.83,984161.32
293260,202209,317,251,66,304212.8,79992,384204.8
293270,202209,1209,544,665,659329.44,807192,1466521.44
293280,202209,317,203,114,246036.72,138170.98,384207.70
293290,202209,3075,1983,1092,2405850.73,1324724.22,3730574.95
293300,202209,885,609,276,738112.15,334512.69,1072624.84
293305,202209,193,148,45,179376.11,54540.65,233916.76
293310,202209,177,133,44,161197.59,53328.2,214525.79
293315,202209,168,127,41,153927.05,49692.4,203619.45
293317,202209,98,72,26,87266.81,31512,118778.81
293320,202209,1221,631,590,764804.03,715094.98,1479899.01
293325,202209,214,85,129,103020.6,156348,259368.6
293330,202209,14914,6770,8144,8211424.09,9881518.88,18092942.97
293340,202209,289,204,85,247248.66,103020,350268.66
293345,202209,265,218,47,264219.63,56964,321183.63
293350,202209,595,373,222,452084.42,269064.45,721148.87
293360,202209,1519,1072,447,1299280.23,541766.93,1841047.16
310010,202209,148,78,70,94536,84840,179376
310020,202209,1001,544,457,659339.02,553887.86,1213226.88
310030,202209,314,252,62,305425.3,75146.44,380571.74
310040,202209,46,31,15,37572,18180,55752
310050,202209,161,99,62,119988.89,75144,195132.89
310060,202209,273,189,84,229070.06,101808.67,330878.73
310070,202209,18,10,8,12120,9696.2,21816.2
310080,202209,50,33,17,39996,20604,60600
310090,202209,1104,620,484,751450.03,586612.22,1338062.25
310100,202209,360,255,105,309063.26,127261.5,436324.76
310110,202209,698,370,328,448443.87,397537.7,845981.57
310120,202209,386,221,165,267852,199980.7,467832.7
310130,202209,29,18,11,21816,13332,35148
310140,202209,26,10,16,12120,19392.76,31512.76
310150,202209,1201,789,412,957495.61,499350.56,1456846.17
310160,202209,2117,1059,1058,1283520.04,1284725.69,2568245.73
310163,202209,101,56,45,67872,54540,122412
310170,202209,2611,1220,1391,1478653.16,1685902.01,3164555.17
310180,202209,189,84,105,101811.24,127260,229071.24
310190,202209,484,324,160,392688.7,193921.18,586609.88
310200,202209,443,280,163,339361,197556.2,536917.2
310205,202209,77,51,26,61812,31512,93324
310210,202209,275,225,50,272701.33,60600,333301.33
310220,202209,64,40,24,48480.83,29088,77568.83
310230,202209,279,199,80,241189.36,96960,338149.36
310240,202209,125,99,26,119988,31512,151500
310250,202209,98,79,19,95749.83,24240.64,119990.47
310260,202209,768,408,360,494505.96,436324.11,930830.07
310270,202209,287,183,104,221798.4,126048.34,347846.74
310280,202209,392,279,113,339362.06,136956,476318.06
310285,202209,203,157,46,190285.2,55752.99,246038.19
310290,202209,234,127,107,153924,129684,283608
310300,202209,172,140,32,169681.39,38784.66,208466.05
310310,202209,13,10,3,12120,3636,15756
310320,202209,30,11,19,13332.17,23028,36360.17
310330,202209,41,30,11,36360.86,13332,49692.86
310340,202209,1872,1322,550,1603492.61,666603.39,2270096.00
310350,202209,2830,1471,1359,1785311.65,1648328.58,3433640.23
310360,202209,51,40,11,49692,13332.3,63024.3
310370,202209,127,107,20,129684,24240,153924
310375,202209,110,43,67,52116,81205.05,133321.05
310380,202209,51,31,20,37572,24240,61812
310390,202209,108,67,41,81204,49692,130896
310400,202209,2543,1654,889,2007115.33,1079900.53,3087015.86
310410,202209,116,69,47,83629.37,56964.32,140593.69
310420,202209,687,353,334,427840.02,404812.64,832652.66
310430,202209,287,185,102,224222.32,123624,347846.32
310440,202209,76,47,29,58176,35148,93324
310445,202209,81,68,13,82416.67,15756,98172.67
310450,202209,654,430,224,521169.23,271488.95,792658.18
310460,202209,254,173,81,209677.29,98172,307849.29
310470,202209,537,350,187,424203.23,226646.02,650849.25
310480,202209,103,66,37,79992,44844,124836
310490,202209,570,266,304,322394.69,368449.22,690843.91
310500,202209,127,54,73,65449.54,88476,153925.54
310510,202209,608,431,177,522376.16,214524.99,736901.15
310520,202209,148,105,43,127260.15,52116,179376.15
310530,202209,115,48,67,58176.8,81204,139380.8
310540,202209,500,280,220,339362.66,266641.88,606004.54
310550,202209,69,46,23,55753.6,27876,83629.6
310560,202209,3222,2210,1012,2678548.5,1226545.05,3905093.55
310570,202209,105,64,41,77568,49692,127260
310590,202209,391,237,154,288458.94,186648.1,475107.04
310600,202209,139,68,71,82416.8,86052,168468.8
310610,202209,50,21,29,25452,35148,60600
310620,202209,50896,24104,26792,29236157.09,32507194.89,61743351.98
310630,202209,752,447,305,541767.59,370872.68,912640.27
310640,202209,148,103,45,124836,54540.2,179376.2
310650,202209,160,141,19,170892.62,23028,193920.62
310660,202209,112,77,35,93324,42420,135744
310665,202209,66,47,19,56964,23028,79992
310670,202209,7489,3237,4252,3923301.85,5157079.17,9080381.02
310680,202209,67,42,25,50904,30300,81204
310690,202209,622,438,184,532072.07,223010.1,755082.17
310700,202209,60,37,23,44844,27876,72720
310710,202209,1318,884,434,1070550.24,526010.26,1596560.50
310720,202209,154,43,111,52116,134532,186648
310730,202209,1567,1057,510,1281110.87,618132.14,1899243.01
310740,202209,1016,557,459,675093.4,557525.11,1232618.51
310750,202209,256,157,99,190285.64,119988.37,310274.01
310760,202209,65,52,13,63025.43,15756,78781.43
310770,202209,86,41,45,49692,54540,104232
310780,202209,364,293,71,355118.57,86053.55,441172.12
310790,202209,117,92,25,111504.2,30300.59,141804.79
310800,202209,486,232,254,281184.35,307848,589032.35
310810,202209,173,116,57,140592.69,69084.59,209677.28
310820,202209,312,254,58,309062.72,70296.04,379358.76
310825,202209,218,181,37,219373.18,44844,264217.18
310830,202209,462,213,249,258156.67,301788.33,559945.00
310840,202209,368,219,149,265428.61,180588.47,446017.08
310850,202209,77,62,15,75144,18180,93324
310855,202209,419,330,89,399964.98,107868,507832.98
310860,202209,1646,1215,431,1472603.52,523590.77,1996194.29
310870,202209,56,48,8,58176.19,9696,67872.19
310880,202209,90,71,19,86052,23028,109080
310890,202209,293,166,127,201192.26,155136,356328.26
310900,202209,634,286,348,346636.65,421777.99,768414.64
310910,202209,240,164,76,198770,92112,290882
310920,202209,430,246,184,298160.54,223011.22,521171.76
310925,202209,39,31,8,37572,9696,47268
310930,202209,1349,890,459,1078694.79,556311.52,1635006.31
310940,202209,701,343,358,415722.18,433900.92,849623.10
310945,202209,138,87,51,105444.3,61812,167256.3
310950,202209,215,172,43,208464.86,52116,260580.86
310960,202209,74,25,49,30300.72,59388,89688.72
310970,202209,178,102,76,123625.24,92112.6,215737.84
310980,202209,52,35,17,42425.34,20604,63029.34
310990,202209,163,82,81,99384.3,98172.8,197557.1
311000,202209,879,441,438,534499.22,530860.04,1065359.26
311010,202209,50,39,11,47268.2,13332,60600.2
311020,202209,37,24,13,29088.78,15756,44844.78
311030,202209,400,226,174,273912.62,210888,484800.62
311040,202209,42,33,9,39996,10908,50904
311050,202209,511,196,315,238765,382992,621757
311060,202209,830,457,373,553887.72,452077.28,1005965.00
311070,202209,339,149,190,180588.39,231492,412080.39
311080,202209,118,65,53,79992.47,64236.76,144229.23
311090,202209,348,168,180,203619.9,219373.08,422992.98
311100,202209,569,350,219,424201.85,265428.85,689630.70
311110,202209,726,514,212,622976.17,258159.65,881135.82
311115,202209,86,60,26,72720.88,31512,104232.88
311120,202209,1120,609,511,738122.85,619335.68,1357458.53
311130,202209,294,171,123,207255.06,149076,356331.06
311140,202209,169,94,75,113929.12,90901.57,204830.69
311150,202209,339,215,124,260583.48,150288.6,410872.08
311160,202209,777,552,225,669029.86,272702.17,941732.03
311170,202209,92,77,15,93324,18180,111504
311180,202209,321,216,105,261797.54,127260.68,389058.22
311190,202209,37,17,20,20604,24240,44844
311200,202209,348,234,114,283608.44,138168.9,421777.34
311205,202209,32,24,8,29088,9696,38784
311210,202209,34,30,4,36360.6,4848,41208.6
311220,202209,29,25,4,30300,4848,35148
311230,202209,1697,1118,579,1356255.84,701755.24,2058011.08
311240,202209,114,71,43,87265.18,53328.5,140593.68
311250,202209,67,28,39,33936,47268,81204
311260,202209,550,338,212,410871.81,256944,667815.81
311265,202209,134,90,44,109080,53328,162408
311270,202209,288,195,93,236342.68,112718.66,349061.34
311280,202209,202,89,113,107868.26,136956,244824.26
311290,202209,107,90,17,109080,20604.2,129684.2
311300,202209,596,380,216,460564.78,261793.59,722358.37
311310,202209,19,16,3,19392,3636,23028
311320,202209,636,473,163,573280.45,197556.64,770837.09
311330,202209,1202,880,322,1066572.1,390269.28,1456841.38
311340,202209,2682,1895,787,2296762.99,959906.86,3256669.85
311350,202209,270,206,64,249673.64,77568,327241.64
311360,202209,174,106,68,128472,82416,210888
311370,202209,1255,523,732,633893.88,887189.69,1521083.57
311380,202209,7,6,1,7272,1212,8484
311390,202209,249,144,105,174528.79,127260.2,301788.99
311400,202209,137,85,52,103020.39,63024,166044.39
311410,202209,127,61,66,73932,79992,153924
311420,202209,318,162,156,196345.97,189072.97,385418.94
311430,202209,855,561,294,679939,356329.08,1036268.08
311440,202209,457,307,150,372092.71,181802.3,553895.01
311450,202209,314,184,130,223008.02,158772.92,381780.94
311455,202209,275,190,85,231496.55,103022.54,334519.09
311460,202209,130,58,72,70296,87264,157560
311470,202209,31,14,17,16968,20604.01,37572.01
311480,202209,55,30,25,36360,30300,66660
311490,202209,11,6,5,7272,6060,13332
311500,202209,30,14,16,18180.8,19392,37572.8
311510,202209,764,520,244,630251.58,295729.33,925980.91
311520,202209,43,34,9,41208,10908,52116
311530,202209,1833,1320,513,1601073.16,622968.95,2224042.11
311535,202209,64,42,22,50904.58,26664.52,77569.10
311540,202209,34,30,4,36360,4848,41208
311545,202209,174,124,50,150289.01,60600,210889.01
311547,202209,51,38,13,46056,15756.2,61812.2
311550,202209,683,314,369,380572.24,448441.56,829013.80
311560,202209,43,27,16,32724,20604,53328
311570,202209,295,194,101,235130.48,123624.84,358755.32
311580,202209,428,269,159,326029.32,192708.39,518737.71
311590,202209,27,23,4,27876.2,4848,32724.2
311600,202209,96,79,17,95749.55,20605.2,116354.75
311610,202209,259,224,35,271488.58,42420,313908.58
311615,202209,149,127,22,153924,26664.52,180588.52
311620,202209,33,21,12,25452,14544,39996
311630,202209,105,90,15,109080,18180,127260
311640,202209,133,65,68,78781.2,82419.56,161200.76
311650,202209,131,91,40,110292,48480.24,158772.24
311660,202209,439,203,236,246036,286032.94,532068.94
311670,202209,151,102,49,123625.47,59388.43,183013.90
311680,202209,224,170,54,206041.78,65448.26,271490.04
311690,202209,12,12,0,14544.5,,14544.5
311700,202209,194,143,51,173317.06,61813.32,235130.38
311710,202209,187,128,59,155137.4,71508,226645.4
311720,202209,40,30,10,36360.6,12120,48480.6
311730,202209,583,412,171,499352.78,207252.75,706605.53
311740,202209,27,20,7,24240,8484,32724
311750,202209,741,501,240,607215.38,290880.51,898095.89
311760,202209,84,36,48,43632.55,58176.64,101809.19
311770,202209,379,184,195,223009.28,237552,460561.28
311780,202209,200,101,99,122412,119988.2,242400.2
311783,202209,90,82,8,99384.84,9696,109080.84
311787,202209,46,19,27,23028,32724.45,55752.45
311790,202209,264,116,148,140592.8,179377.27,319970.07
311800,202209,743,459,284,557525.69,346634.18,904159.87
311810,202209,51,39,12,47268.7,14544,61812.7
311820,202209,122,94,28,113928.01,33937.14,147865.15
311830,202209,1978,1179,799,1428961.27,969600.2,2398561.47
311840,202209,1113,632,481,767205.61,582976.36,1350181.97
311850,202209,17,10,7,12120,8484,20604
311860,202209,10441,4463,5978,5409232.66,7249026.14,12658258.80
311870,202209,109,63,46,76358.84,55752.26,132111.10
311880,202209,987,710,277,860529.16,336945.34,1197474.50
311890,202209,200,91,109,110192.47,132109.79,242302.26
311900,202209,66,27,39,32724,47268.05,79992.05
311910,202209,1441,896,545,1085963.08,661757.61,1747720.69
311920,202209,234,152,82,184224.78,99384,283608.78
311930,202209,915,508,407,616915.43,493286.03,1110201.46
311940,202209,2741,1477,1264,1792570.11,1533181.88,3325751.99
311950,202209,162,99,63,119989.44,76357.4,196346.84
311960,202209,65,47,18,56964.32,21816,78780.32
311970,202209,23,12,11,14544,13332,27876
311980,202209,42,31,11,37572,13332,50904
311990,202209,37,26,11,31512,13332.64,44844.64
311995,202209,50,29,21,35148,25452.22,60600.22
312000,202209,23,15,8,18180,9696,27876
312010,202209,75,59,16,71508.79,19392.1,90900.89
312015,202209,81,61,20,73932.69,24240,98172.69
312020,202209,134,95,39,115140.05,47268,162408.05
312030,202209,72,52,20,63024,24240,87264
312040,202209,83,51,32,61812,38784,100596
312050,202209,200,110,90,133320.6,109080,242400.6
312060,202209,21,14,7,16968,8484,25452
312070,202209,79,51,28,61812.14,33936.2,95748.34
312080,202209,574,270,304,327240.2,368448.3,695688.5
312083,202209,77,49,28,60600.2,33936,94536.2
312087,202209,100,75,25,90900.2,30300,121200.2
312090,202209,3452,2103,1349,2550108.53,1638636.06,4188744.59
312100,202209,148,105,43,126981.63,52116.48,179098.11
312110,202209,123,74,49,89688,59388,149076
312120,202209,129,93,36,112717.62,43632,156349.62
312125,202209,90,59,31,71508.38,37572,109080.38
312130,202209,132,87,45,105444.1,54540,159984.1
312140,202209,140,111,29,134533.16,35148,169681.16
312150,202209,38,30,8,36360,9696,46056
312160,202209,1512,1011,501,1226665.15,608426.42,1835091.57
312170,202209,10,8,2,9696,2424,12120
312180,202209,94,64,30,77568.48,36360,113928.48
312190,202209,45,39,6,47268,7272,54540
312200,202209,753,644,109,780540.28,132108.84,912649.12
312210,202209,121,65,56,78780.1,69085.15,147865.25
312220,202209,140,103,37,124837,44844,169681
312230,202209,3949,1778,2171,2156171.94,2634897.5,4791069.44
312235,202209,163,108,55,130896,66660,197556
312240,202209,82,60,22,72721.16,26664,99385.16
312245,202209,227,163,64,197558.36,77568.3,275126.66
312247,202209,88,62,26,75144,31512.38,106656.38
312250,202209,176,91,85,110293.27,103020,213313.27
312260,202209,107,68,39,82416,47268,129684
312270,202209,137,79,58,95749,70296,166045
312280,202209,33,18,15,21816,18180,39996
312290,202209,145,98,47,118778.35,56966.81,175745.16
312300,202209,205,134,71,162410.48,86052.93,248463.41
312310,202209,64,57,7,69084,8484,77568
312320,202209,412,254,158,307849.77,193920,501769.77
312330,202209,98,83,15,100596,18180.7,118776.7
312340,202209,35,18,17,21816,20604,42420
312350,202209,13,7,6,8484,7272,15756
312352,202209,97,70,27,84840.6,32724,117564.6
312360,202209,587,251,336,304213.5,407232.2,711445.7
312370,202209,370,199,171,241188.96,208466.3,449655.26
312380,202209,144,95,49,115145.62,59389.14,174534.76
312385,202209,163,135,28,163620.88,33936.45,197557.33
312390,202209,290,185,105,224220.2,128472,352692.2
312400,202209,385,287,98,347845.25,118778.26,466623.51
312410,202209,1249,458,791,556319.28,959913.06,1516232.34
312420,202209,688,521,167,631457.97,202405.94,833863.91
312430,202209,882,640,242,776896.18,293305.46,1070201.64
312440,202209,44,35,9,42420,10908,53328
312450,202209,200,126,74,152712,90900,243612
312460,202209,31,15,16,18180,19392,37572
312470,202209,46,31,15,37572,18180,55752
312480,202209,169,102,67,123625.21,81204.99,204830.20
312490,202209,322,218,104,264217.46,126048.7,390266.16
312500,202209,32,21,11,25452.2,13332,38784.2
312510,202209,657,251,406,304216.52,492077.86,796294.38
312520,202209,29,8,21,9696,25452.2,35148.2
312530,202209,39,26,13,31512.6,15756.1,47268.7
312540,202209,88,77,11,93324,13332,106656
312550,202209,34,27,7,32724,8484,41208
312560,202209,206,159,47,192708.96,56964,249672.96
312570,202209,476,281,195,340580.1,236342.06,576922.16
312580,202209,90,52,38,63024,46056,109080
312590,202209,218,172,46,208465.12,55752,264217.12
312595,202209,148,122,26,147864.05,31512,179376.05
312600,202209,77,34,43,41208.4,52116,93324.4
312610,202209,1590,820,770,993854.08,933240.1,1927094.18
312620,202209,231,168,63,203617.4,76356,279973.4
312630,202209,71,57,14,69084,18180,87264
312640,202209,40,10,30,12120,37572,49692
312650,202209,158,133,25,161606.69,30300.1,191906.79
312660,202209,114,84,30,101813.95,36361.2,138175.15
312670,202209,947,609,338,738119.01,409660.04,1147779.05
312675,202209,47,35,12,42420,14544,56964
312680,202209,75,48,27,58176,32724,90900
312690,202209,259,133,126,161197.91,152712.85,313910.76
312695,202209,31,27,4,32724,4848,37572
312700,202209,256,147,109,178168.48,132108.6,310277.08
312705,202209,82,65,17,78780,20604,99384
312707,202209,130,93,37,112716.64,44844,157560.64
312710,202209,1927,1079,848,1307777.96,1031417.32,2339195.28
312720,202209,46,22,24,26664,29088.69,55752.69
312730,202209,270,158,112,191498.4,135746.72,327245.12
312733,202209,50,40,10,48480,12120,60600
312735,202209,22,16,6,19392,7272.6,26664.6
312737,202209,73,41,32,49692.16,38784,88476.16
312738,202209,69,43,26,52116.85,31512,83628.85
312740,202209,79,53,26,64236,31512,95748
312750,202209,110,71,39,87264,47268,134532
312760,202209,280,194,86,235130.48,104232.41,339362.89
312770,202209,9078,4313,4765,5231052.57,5780043.28,11011095.85
312780,202209,453,345,108,418143.39,130897.49,549040.88
312790,202209,20,14,6,16968,7272,24240
312800,202209,1673,1161,512,1407144.56,621759,2028903.56
312810,202209,351,241,110,292092.9,133320,425412.9
312820,202209,194,147,47,178164.24,56964,235128.24
312825,202209,45,34,11,41208,13332,54540
312830,202209,197,107,90,130896,109080.2,239976.2
312840,202209,191,134,57,162408.04,69084,231492.04
312850,202209,39,36,3,43632,3636,47268
312860,202209,147,100,47,121200,56964,178164
312870,202209,1175,614,561,745387.97,679932,1425319.97
312880,202209,121,88,33,106656.05,39996,146652.05
312890,202209,169,123,46,149077.96,55752,204829.96
312900,202209,168,126,42,152712.42,50904,203616.42
312910,202209,180,102,78,123626.84,94536.38,218163.22
312920,202209,106,59,47,71508.2,56964,128472.2
312930,202209,327,222,105,269066.11,127261.54,396327.65
312940,202209,146,99,47,119988,56964,176952
312950,202209,757,529,228,641158.92,277550.43,918709.35
312960,202209,148,105,43,127262.48,52117.03,179379.51
312965,202209,114,92,22,111504.1,26664,138168.1
312970,202209,289,234,55,283614.04,66660.2,350274.24
312980,202209,2712,1397,1315,1693185.85,1593784.39,3286970.24
312990,202209,46,19,27,23028.92,32724,55752.92
313000,202209,56,31,25,37572,30300,67872
313005,202209,187,144,43,174529,52116.5,226645.5
313010,202209,995,424,571,515104.04,692056.74,1207160.78
313020,202209,194,100,94,121200,113928,235128
313030,202209,211,136,75,164832.76,90900,255732.76
313040,202209,93,29,64,35148.82,77568,112716.82
313050,202209,205,146,59,176952,71508,248460
313055,202209,41,31,10,37572,12120,49692
313060,202209,146,98,48,118777.2,58176.65,176953.85
313065,202209,60,44,16,53328,19392.6,72720.6
313070,202209,132,71,61,86054,73932,159986
313080,202209,42,23,19,27876.6,23028,50904.6
313090,202209,695,447,248,541770.4,300576.55,842346.95
313100,202209,212,77,135,93324.25,163620,256944.25
313110,202209,155,88,67,106656.1,81205.32,187861.42
313115,202209,242,129,113,156349.15,136956,293305.15
313120,202209,857,490,367,593886.4,444805.95,1038692.35
313130,202209,6161,3391,2770,4109943.52,3362108.98,7472052.50
313140,202209,134,76,58,92113.18,70296.66,162409.84
313150,202209,296,233,63,282398.03,76356,358754.03
313160,202209,189,143,46,173319.94,55752,229071.94
313170,202209,1435,914,521,1107778.65,631452.56,1739231.21
313180,202209,332,206,126,249676.04,152713.98,402390.02
313190,202209,761,442,319,535708.49,386629.13,922337.62
313200,202209,33,26,7,31512,8484.2,39996.2
313210,202209,1027,877,150,1062952.43,181803.74,1244756.17
313220,202209,305,182,123,220585.1,149076,369661.1
313230,202209,277,211,66,255732.2,79992.54,335724.74
313240,202209,2343,1189,1154,1441078.45,1401072.43,2842150.88
313250,202209,1266,951,315,1152630.96,382995.95,1535626.91
313260,202209,97,46,51,55752,61812,117564
313270,202209,1054,617,437,749992.28,529647.84,1279640.12
313280,202209,45,37,8,44844,9696,54540
313290,202209,231,186,45,225434.36,55752,281186.36
313300,202209,337,165,172,201192.5,208464,409656.5
313310,202209,249,107,142,129684.2,172104.8,301789.0
313320,202209,393,285,108,345421.91,130896.67,476318.58
313330,202209,1486,911,575,1104151.11,696904.66,1801055.77
313340,202209,342,249,93,301790.26,112716.7,414506.96
313350,202209,462,290,172,351480.96,209676,561156.96
313360,202209,194,93,101,112716.2,122412,235128.2
313370,202209,244,86,158,104232.47,191496.25,295728.72
313375,202209,317,190,127,230282.16,153925.03,384207.19
313380,202209,1342,715,627,869015.32,761137.88,1630153.20
313390,202209,56,50,6,60600.6,7272,67872.6
313400,202209,415,290,125,352702.53,151502.55,504205.08
313410,202209,98,61,37,73932.8,44844,118776.8
313420,202209,4748,2651,2097,3214281.36,2543997.78,5758279.14
313430,202209,122,61,61,73932,73932.5,147864.5
313440,202209,1402,991,411,1201119.13,499349.93,1700469.06
313450,202209,66,31,35,37572,42420,79992
313460,202209,397,174,223,210889.79,271488.88,482378.67
313470,202209,522,246,276,298160.03,334515.46,632675.49
313480,202209,170,127,43,153925.92,52116,206041.92
313490,202209,557,252,305,305427.41,370877.73,676305.14
313500,202209,30,16,14,19392,16968,36360
313505,202209,1112,856,256,1037485.66,311487.28,1348972.94
313507,202209,104,68,36,82417.02,43632,126049.02
313510,202209,2945,1824,1121,2212059.6,1358668.06,3570727.66
313520,202209,3514,2725,789,3302771.38,956276.77,4259048.15
313530,202209,37,22,15,26664,18180,44844
313535,202209,86,71,15,86053.94,18180,104233.94
313540,202209,67,47,20,56964,24240,81204
313545,202209,119,100,19,121201.64,23028,144229.64
313550,202209,224,191,33,232705.55,39997.49,272703.04
313560,202209,356,169,187,204831.04,226647.69,431478.73
313570,202209,77,28,49,33936,59388.59,93324.59
313580,202209,1375,804,571,974456,693266.42,1667722.42
313590,202209,65,39,26,47268,31512.18,78780.18
313600,202209,689,416,273,504196.73,330877.84,835074.57
313610,202209,54,42,12,50905.93,14544,65449.93
313620,202209,1494,732,762,887194.05,924759.96,1811954.01
313630,202209,1681,1273,408,1544111.48,495709.9,2039821.38
313640,202209,121,72,49,87265.08,59388,146653.08
313650,202209,231,121,110,146652.8,134533.17,281185.97
313652,202209,32,31,1,37572.6,1212,38784.6
313655,202209,89,58,31,70296.76,37572.1,107868.86
313657,202209,53,48,5,58177.82,6060,64237.82
313660,202209,134,89,45,107870.13,54541.83,162411.96
313665,202209,721,330,391,401179.6,475110.81,876290.41
313670,202209,10937,7488,3449,9085309.02,4187490.86,13272799.88
313680,202209,42,32,10,38784.2,12120,50904.2
313690,202209,137,98,39,118776.1,47268,166044.1
313695,202209,88,68,20,82416.53,24240,106656.53
313700,202209,345,266,79,322396.35,95748.2,418144.55
313710,202209,128,90,38,109082.21,46056.2,155138.41
313720,202209,1198,549,649,665401.07,786595.08,1451996.15
313730,202209,72,41,31,49692,37572,87264
313740,202209,147,113,34,138168.2,41208,179376.2
313750,202209,410,289,121,350269.59,146652,496921.59
313753,202209,238,177,61,214525.12,73932.1,288457.22
313760,202209,1402,549,853,666605.63,1035053.86,1701659.49
313770,202209,423,290,133,351487.79,161198.18,512685.97
313780,202209,864,466,398,564796.95,482379.73,1047176.68
313790,202209,35,35,0,42420,,42420.0
313800,202209,167,103,64,124837.61,77571.15,202408.76
313810,202209,86,50,36,60600,43632,104232
313820,202209,1418,689,729,835076.86,884761.85,1719838.71
313830,202209,56,38,18,46056.49,21816,67872.49
313835,202209,63,53,10,64236.2,12120,76356.2
313840,202209,1732,1031,701,1252010.88,849615.22,2101626.10
313850,202209,217,92,125,111505.54,152712,264217.54
313860,202209,484,365,119,442385.71,144228.84,586614.55
313862,202209,181,124,57,150290.31,69084.2,219374.51
313865,202209,190,131,59,158774.16,71508.3,230282.46
313867,202209,59,48,11,58176,13332,71508
313868,202209,47,31,16,37572,19392,56964
313870,202209,83,45,38,54540,46056,100596
313880,202209,387,240,147,290882.08,178165.15,469047.23
313890,202209,338,185,153,225436.63,185436,410872.63
313900,202209,836,452,384,547830.36,465413.1,1013243.46
313910,202209,151,103,48,124836,58176,183012
313920,202209,659,450,209,545402.83,254521.1,799923.93
313925,202209,36,30,6,36360,7272,43632
313930,202209,923,709,214,859322.28,260582.83,1119905.11
313940,202209,1983,1191,792,1444721.9,959909.9,2404631.8
313950,202209,875,533,342,646002.59,414505.05,1060507.64
313960,202209,1507,859,648,1041119.37,786592.81,1827712.18
313970,202209,185,105,80,127260.1,96960,224220.1
313980,202209,234,152,82,184226.37,99384.69,283611.06
313990,202209,262,162,100,197556.6,121200,318756.6
314000,202209,895,583,312,707813.06,378145.91,1085958.97
314010,202209,92,57,35,69084,42420,111504
314015,202209,91,25,66,30300.66,79992.8,110293.46
314020,202209,55,39,16,47268.03,19392,66660.03
314030,202209,71,37,34,44844.7,41208,86052.7
314040,202209,46,25,21,30300,25452,55752
314050,202209,294,167,127,202406.48,155136,357542.48
314053,202209,98,60,38,72720.7,46056,118776.7
314055,202209,306,190,116,230282.17,140592.6,370874.77
314060,202209,122,105,17,127260.3,20604,147864.3
314070,202209,1109,559,550,678728.02,666607.45,1345335.47
314080,202209,216,137,79,166045.64,95748.84,261794.48
314085,202209,181,127,54,153924,65448,219372
314090,202209,409,291,118,352695.24,143016,495711.24
314100,202209,537,423,114,512684.17,138170.11,650854.28
314110,202209,781,348,433,421784.81,526010.72,947795.53
314120,202209,68,40,28,48480,33936,82416
314130,202209,25,17,8,20604,9696,30300
314140,202209,1184,750,434,909018.77,526011.8,1435030.57
314150,202209,190,122,68,147865.26,82416.9,230282.16
314160,202209,314,236,78,286034.31,94536,380570.31
314170,202209,83,65,18,78780.37,21816,100596.37
314180,202209,776,685,91,830237.86,111506.87,941744.73
314190,202209,83,52,31,63024,37572,100596
314200,202209,514,350,164,424211.7,198773.48,622985.18
314210,202209,257,197,60,238765.27,72721.2,311486.47
314220,202209,302,213,89,258160.39,107868.93,366029.32
314225,202209,51,33,18,39997,21816,61813
314230,202209,120,54,66,65448,79992,145440
314240,202209,175,127,48,153924.2,58176.47,212100.67
314250,202209,58,35,23,42420.82,27876,70296.82
314260,202209,216,105,111,128472.26,134532,263004.26
314270,202209,419,330,89,401181.32,109080.7,510262.02
314280,202209,755,411,344,498080.75,418142.41,916223.16
314290,202209,546,424,122,513891.51,147865.6,661757.11
314300,202209,346,258,88,313912.73,106656,420568.73
314310,202209,1357,939,418,1139601.25,506616.47,1646217.72
314315,202209,45,35,10,43632,12120,55752
314320,202209,595,406,189,493287.09,229070.51,722357.60
314330,202209,12064,5866,6198,7116963.22,7518067.57,14635030.79
314340,202209,649,290,359,352693.27,435113.61,787806.88
314345,202209,58,42,16,50904,19392,70296
314350,202209,186,115,71,139380,86052.66,225432.66
314360,202209,53,30,23,36364.34,27877.44,64241.78
314370,202209,71,51,20,61812,24240,86052
314380,202209,130,71,59,86052.5,71508,157560.5
314390,202209,3513,2269,1244,2751274.47,1510154.55,4261429.02
314400,202209,708,491,217,596311.64,263006.64,859318.28
314410,202209,543,358,185,433898.32,224220.59,658118.91
314420,202209,19,12,7,14544.6,8484,23028.6
314430,202209,2501,935,1566,1133233.9,1898015.27,3031249.17
314435,202209,154,89,65,107869.89,78780,186649.89
314437,202209,50,38,12,47268.6,14544,61812.6
314440,202209,93,60,33,72720.44,39996.1,112716.54
314450,202209,170,119,51,144228,61812.84,206040.84
314460,202209,655,320,335,387843.56,406024,793867.56
314465,202209,123,80,43,96960.77,52116,149076.77
314467,202209,75,60,15,72720.1,18180,90900.1
314470,202209,420,209,211,253309.47,255734.68,509044.15
314480,202209,1095,496,599,604795.64,725990.16,1330785.80
314490,202209,38,21,17,25452.74,20604,46056.74
314500,202209,280,194,86,235129.65,104232.45,339362.10
314505,202209,120,77,43,93325,52116.6,145441.6
314510,202209,254,205,49,248462.44,59388,307850.44
314520,202209,1463,766,697,928404.77,845986.54,1774391.31
314530,202209,779,617,162,747826.41,196347.72,944174.13
314535,202209,170,105,65,127260,78780,206040
314537,202209,68,42,26,50904.13,31512.1,82416.23
314540,202209,17,10,7,12120,8484,20604
314545,202209,65,45,20,54540,24240,78780
314550,202209,72,38,34,46056.67,41209.02,87265.69
314560,202209,889,471,418,570857.93,506620.38,1077478.31
314570,202209,17,14,3,16968.3,3636,20604.3
314580,202209,13,7,6,8484.37,7272,15756.37
314585,202209,27,20,7,24240,8484,32724
314587,202209,85,74,11,89688,13332,103020
314590,202209,597,410,187,499347.77,226644.24,725992.01
314600,202209,987,642,345,778122.14,420571.08,1198693.22
314610,202209,988,507,481,614485.92,582976.38,1197462.30
314620,202209,151,115,36,140592.2,43632,184224.2
314625,202209,100,76,24,92112.19,29088,121200.19
314630,202209,1159,635,524,769634.1,636305.39,1405939.49
314640,202209,88,54,34,65451.18,41208.6,106659.78
314650,202209,156,88,68,106657.69,82416.79,189074.48
314655,202209,63,46,17,55752,20604,76356
314660,202209,19,14,5,16968,6060,23028
314670,202209,229,180,49,218166.25,59389.59,277555.84
314675,202209,214,127,87,153925.21,105444,259369.21
314690,202209,587,314,273,381782.08,330877.09,712659.17
314700,202209,2222,1183,1039,1436244.66,1261695.42,2697940.08
314710,202209,1872,1049,823,1271395.47,999901.17,2271296.64
314720,202209,397,224,173,272702.34,209676.8,482379.14
314730,202209,528,286,242,346632.56,293304,639936.56
314740,202209,793,364,429,441172.61,522374.39,963547.00
314750,202209,23,18,5,21816,6060,27876
314760,202209,365,147,218,178164,264216.8,442380.8
314770,202209,105,69,36,83628,43632,127260
314780,202209,21,9,12,10908,14544,25452
314790,202209,2533,1607,926,1950135.96,1123524.7,3073660.66
314795,202209,69,61,8,73932.1,9696,83628.1
314800,202209,3000,1751,1249,2127080.57,1515004.71,3642085.28
314810,202209,1523,870,653,1055659.04,791437.4,1847096.44
314820,202209,115,67,48,81205.87,58176.1,139381.97
314830,202209,220,184,36,223009.99,43632,266641.99
314840,202209,92,52,40,63024,48480,111504
314850,202209,426,203,223,246159.94,270276.6,516436.54
314860,202209,653,494,159,598732.34,192708.18,791440.52
314870,202209,1655,874,781,1059305.24,946584.3,2005889.54
314875,202209,63,59,4,71508,4848,76356
314880,202209,41,29,12,35148,14544,49692
314890,202209,50,27,23,32724,27876,60600
314900,202209,27,20,7,24240,8484.92,32724.92
314910,202209,236,157,79,190284.44,96960,287244.44
314915,202209,141,125,16,151500.99,19392.18,170893.17
314920,202209,80,53,27,64236.85,32724,96960.85
314930,202209,1041,491,550,595098,666602.75,1261700.75
314940,202209,39,30,9,36360,10908.1,47268.1
314950,202209,25,22,3,26664,3636,30300
314960,202209,27,20,7,24240,8484,32724
314970,202209,174,85,89,103020.43,107868.4,210888.83
314980,202209,315,198,117,239977.68,141804.75,381782.43
314990,202209,463,252,211,305426.78,255733.26,561160.04
314995,202209,156,68,88,82416.6,106656,189072.6
315000,202209,98,75,23,90900.49,27876.9,118777.39
315010,202209,35,22,13,26664,15756,42420
315015,202209,159,126,33,152712.2,39996,192708.2
315020,202209,68,58,10,70296,12120,82416
315030,202209,106,80,26,96960,31512,128472
315040,202209,87,52,35,63024,42420,105444
315050,202209,212,130,82,157560.56,99384.68,256945.24
315053,202209,60,41,19,49692,23028,72720
315057,202209,123,95,28,116352.05,35148,151500.05
315060,202209,67,55,12,66661.48,14544,81205.48
315070,202209,109,64,45,77568.26,54540,132108.26
315080,202209,394,309,85,374511.5,103020.9,477532.4
315090,202209,100,58,42,70296.29,50904,121200.29
315100,202209,86,42,44,50904.37,53328.38,104232.75
315110,202209,282,140,142,169682.38,172104,341786.38
315120,202209,1878,897,981,1087186.54,1190210.39,2277396.93
315130,202209,344,246,98,298153.56,118776.08,416929.64
315140,202209,554,299,255,362390.27,309062.85,671453.12
315150,202209,998,476,522,576916.48,632667.85,1209584.33
315160,202209,196,103,93,124840.75,112717.52,237558.27
315170,202209,297,195,102,236342.77,123624.6,359967.37
315180,202209,3311,1416,1895,1722271.8,2302807.53,4025079.33
315190,202209,294,182,112,220586.41,135744.15,356330.56
315200,202209,1217,722,495,876291.07,599943.97,1476235.04
315210,202209,1771,1044,727,1265341.34,882338.02,2147679.36
315213,202209,27,16,11,19392.75,13332,32724.75
315217,202209,211,169,42,204828.4,50904,255732.4
315220,202209,1643,1215,428,1473813.08,519955.08,1993768.16
315230,202209,182,141,41,170892.65,49692,220584.65
315240,202209,373,241,132,292099.28,159987.83,452087.11
315250,202209,2754,1309,1445,1590155.04,1751344.37,3341499.41
315260,202209,141,79,62,95748,75144.1,170892.1
315270,202209,143,102,41,123624,49692,173316
315280,202209,611,400,211,484813.7,255740.62,740554.32
315290,202209,189,116,73,140593,88476.09,229069.09
315300,202209,103,79,24,95748.25,29088,124836.25
315310,202209,82,74,8,89688,9696,99384
315320,202209,145,90,55,109082.9,66660,175742.9
315330,202209,62,48,14,58176,16968,75144
315340,202209,396,286,110,346634.5,133321.2,479955.7
315350,202209,168,106,62,128472.88,75144,203616.88
315360,202209,103,47,56,56964,69084.2,126048.2
315370,202209,57,36,21,43633.41,25452,69085.41
315380,202209,5,5,0,6060,,6060.0
315390,202209,66,25,41,30300,49693.5,79993.5
315400,202209,817,614,203,744179.99,246036.56,990216.55
315410,202209,308,184,124,223015.89,151503.22,374519.11
315415,202209,62,46,16,55752,19392,75144
315420,202209,198,147,51,178165.37,61812,239977.37
315430,202209,628,347,281,420566.6,340572.2,761138.8
315440,202209,95,63,32,76356.6,38784.6,115141.2
315445,202209,233,192,41,232709.12,49692.37,282401.49
315450,202209,180,130,50,157560,60600,218160
315460,202209,4801,2226,2575,2700387.24,3123350.83,5823738.07
315470,202209,46,20,26,24240,31512,55752
315480,202209,74,23,51,27877.1,61812.3,89689.4
315490,202209,731,462,269,559949.21,327240.48,887189.69
315500,202209,18,17,1,20604,1212,21816
315510,202209,151,106,45,128472,54540,183012
315520,202209,80,69,11,83628,13332,96960
315530,202209,45,25,20,30300,24240.2,54540.2
315540,202209,276,190,86,230283.42,104232.36,334515.78
315550,202209,190,152,38,184225.55,46056,230281.55
315560,202209,721,565,156,684790.16,190286.56,875076.72
315570,202209,314,157,157,190289.03,190285.71,380574.74
315580,202209,774,524,250,635090.21,303000.8,938091.01
315590,202209,193,99,94,119990.06,113928.51,233918.57
315600,202209,341,261,80,316334.33,96960.78,413295.11
315610,202209,103,47,56,56964,67872,124836
315620,202209,36,29,7,35148.87,8484,43632.87
315630,202209,130,95,35,115140,42420,157560
315640,202209,65,37,28,44844.98,33936.8,78781.78
315645,202209,50,33,17,39996,20604,60600
315650,202209,172,126,46,152712.74,55752,208464.74
315660,202209,441,202,239,244831.43,289672.01,534503.44
315670,202209,2496,1146,1350,1388976.68,1639852.28,3028828.96
315680,202209,783,559,224,678723.95,271488.5,950212.45
315690,202209,692,453,239,549042.95,290881.59,839924.54
315700,202209,2057,1076,981,1304140.36,1188995.71,2493136.07
315710,202209,368,123,245,149077.52,298152.94,447230.46
315720,202209,520,313,207,379359.26,252097.26,631456.52
315725,202209,200,158,42,191496.87,50904,242400.87
315727,202209,78,44,34,53328.96,41208,94536.96
315730,202209,54,47,7,56964,8484,65448
315733,202209,84,51,33,61812,39996,101808
315737,202209,49,37,12,44844.4,14544,59388.4
315740,202209,31,23,8,27876,9696,37572
315750,202209,164,118,46,143016,56964.17,199980.17
315760,202209,46,33,13,39996,15756,55752
315765,202209,135,79,56,95749.69,67873.87,163623.56
315770,202209,235,155,80,187860.83,96960,284820.83
315780,202209,4007,1975,2032,2396151.46,2464002.37,4860153.83
315790,202209,246,189,57,229069.82,69084.38,298154.20
315800,202209,317,211,106,255733.25,128472,384205.25
315810,202209,65,39,26,47269.44,31512,78781.44
315820,202209,767,566,201,686008.61,244828.01,930836.62
315830,202209,122,79,43,95748.91,52116.7,147865.61
315840,202209,80,53,27,64236,32724,96960
315850,202209,276,183,93,221800.84,112717.81,334518.65
315860,202209,19,7,12,8484,14544,23028
315870,202209,40,31,9,37572,10908,48480
315880,202209,96,65,31,78780,37572,116352
315890,202209,108,75,33,90900.7,39996.54,130897.24
315895,202209,407,267,140,323612.73,169681.93,493294.66
315900,202209,89,39,50,47268,60600.08,107868.08
315910,202209,47,28,19,33936,23028,56964
315920,202209,157,105,52,127260.2,63024,190284.2
315930,202209,52,17,35,20604.8,42421.6,63026.4
315935,202209,129,101,28,122414.39,33936,156350.39
315940,202209,101,74,27,89688,32724,122412
315950,202209,34,25,9,30300,10908.65,41208.65
315960,202209,587,276,311,334515.23,378148.39,712663.62
315970,202209,31,26,5,31512,6060,37572
315980,202209,676,342,334,414515.03,404810.76,819325.79
315990,202209,261,148,113,179376.97,136956.48,316333.45
316000,202209,51,31,20,37572.8,24240,61812.8
316010,202209,94,77,17,93325.02,20604,113929.02
316020,202209,107,91,16,110292.49,19392,129684.49
316030,202209,383,221,162,267853.65,196344.95,464198.60
316040,202209,564,231,333,279974.72,403596.2,683570.92
316045,202209,52,46,6,55752,7272,63024
316050,202209,22,16,6,19392,7272,26664
316060,202209,106,73,33,88476.68,39996,128472.68
316070,202209,1212,816,396,989001.3,479954.79,1468956.09
316080,202209,92,62,30,75251.1,36360,111611.1
316090,202209,36,18,18,21816,21816.95,43632.95
316095,202209,83,71,12,86053.84,14544.58,100598.42
316100,202209,347,191,156,231496.02,189072,420568.02
316105,202209,48,31,17,37573.38,20604,58177.38
316110,202209,1896,1475,421,1790145.92,511473.4,2301619.32
316120,202209,77,52,25,63024,30300,93324
316130,202209,117,87,30,105446.33,36360,141806.33
316140,202209,35,24,11,29088,13332,42420
316150,202209,218,155,63,187860.2,76356.33,264216.53
316160,202209,86,54,32,65448,38784.28,104232.28
316165,202209,76,50,26,60600.17,31512,92112.17
316170,202209,188,123,65,149076.1,78780,227856.1
316180,202209,219,85,134,103020.2,162408.8,265429.0
316190,202209,149,108,41,130896,49692,180588
316200,202209,682,374,308,453295.26,375721.28,829016.54
316210,202209,773,524,249,635303.89,303002.96,938306.85
316220,202209,121,77,44,93324.1,53328,146652.1
316225,202209,40,26,14,31513.67,16968,48481.67
316230,202209,44,25,19,30300,23028,53328
316240,202209,671,536,135,649640.31,163623.5,813263.81
316245,202209,172,151,21,183012.93,25452,208464.93
316250,202209,1688,1126,562,1364723.88,681147.7,2045871.58
316255,202209,139,113,26,136956,31512,168468
316257,202209,182,92,90,112716.2,109080,221796.2
316260,202209,202,138,64,167256.4,77568.2,244824.6
316265,202209,36,24,12,29088.1,14544.21,43632.31
316270,202209,683,483,200,587826.41,242402.67,830229.08
316280,202209,569,358,211,433902.1,255734.9,689637.0
316290,202209,861,588,273,712668.81,330880.27,1043549.08
316292,202209,628,254,374,307850.63,453290.17,761140.80
316294,202209,108,69,39,83629.94,47268,130897.94
316295,202209,387,185,202,224224.46,244826.69,469051.15
316300,202209,15,11,4,13332.6,4848,18180.6
316310,202209,26,14,12,16968,14544,31512
316320,202209,68,32,36,38785.86,43632,82417.86
316330,202209,178,123,55,149076.2,66660,215736.2
316340,202209,141,91,50,110292,60600,170892
316350,202209,195,134,61,162408.75,73932,236340.75
316360,202209,25,15,10,18180,12120,30300
316370,202209,1262,611,651,740544.57,789016.27,1529560.84
316380,202209,120,90,30,109080.5,36360,145440.5
316390,202209,99,73,26,88476,31512,119988
316400,202209,151,114,37,138170.15,44844,183014.15
316410,202209,301,215,86,260580.34,104232.2,364812.54
316420,202209,227,151,76,183014.12,92113.85,275127.97
316430,202209,161,89,72,107868.26,88476,196344.26
316440,202209,69,39,30,47270.09,36360.97,83631.06
316443,202209,49,40,9,48480.87,10908,59388.87
316447,202209,43,35,8,42421.09,9696,52117.09
316450,202209,236,177,59,214524.88,71508,286032.88
316460,202209,52,18,34,21816.7,41208.2,63024.9
316470,202209,1786,1306,480,1584091.44,582972,2167063.44
316480,202209,10,8,2,9696,2424,12120
316490,202209,20,7,13,8484,15756,24240
316500,202209,162,103,59,124836.6,71508.19,196344.79
316510,202209,139,110,29,133320,35148,168468
316520,202209,188,106,82,129684.85,99385.61,229070.46
316530,202209,173,108,65,130896.2,78780,209676.2
316540,202209,161,82,79,99384.31,95748.73,195133.04
316550,202209,162,101,61,122412.72,73932,196344.72
316553,202209,428,209,219,253312.2,267854.44,521166.64
316555,202209,58,53,5,64236.84,6060,70296.84
316556,202209,16,12,4,14544.41,4848,19392.41
316557,202209,32,28,4,33936,4848,38784
316560,202209,74,51,23,61812,27876,89688
316570,202209,208,191,17,231493.72,20604,252097.72
316580,202209,21,15,6,18180,7272,25452
316590,202209,89,75,14,90900.62,16968.6,107869.22
316600,202209,177,147,30,178164,36360,214524
316610,202209,69,48,21,58176.82,25452,83628.82
316620,202209,145,100,45,121200,54540.86,175740.86
316630,202209,50,39,11,47268,13332,60600
316640,202209,25,15,10,18180,12120,30300
316650,202209,100,81,19,98172,23028,121200
316660,202209,6,2,4,2424,4848,7272
316670,202209,445,153,292,185439.08,353905.17,539344.25
316680,202209,164,124,40,150289.89,48480.4,198770.29
316690,202209,174,107,67,129684.9,81204,210888.9
316695,202209,57,49,8,59388,9696,69084
316700,202209,26,18,8,21816,9696,31512
316710,202209,813,618,195,749023.09,236341.31,985364.40
316720,202209,5204,2442,2762,2959738.28,3349972.36,6309710.64
316730,202209,15,14,1,16968,1212,18180
316740,202209,158,98,60,119988,72720,192708
316750,202209,22,12,10,14544.36,12120,26664.36
316760,202209,329,264,65,319968.93,78780.49,398749.42
316770,202209,180,92,88,111504,106656,218160
316780,202209,69,39,30,47268.6,36360,83628.6
316790,202209,65,44,21,53328,25452.1,78780.1
316800,202209,1817,1112,705,1348974.71,854474.71,2203449.42
316805,202209,33,23,10,27876,12120,39996
316810,202209,59,35,24,42420.21,29088.7,71508.91
316820,202209,38,21,17,25452,20604,46056
316830,202209,103,47,56,56964.54,67872.32,124836.86
316840,202209,514,306,208,370875.28,252098.98,622974.26
316850,202209,310,210,100,254523.23,121200.4,375723.63
316860,202209,6411,2866,3545,3474856.71,4300192.51,7775049.22
316870,202209,1726,1101,625,1335648.86,757505.21,2093154.07
316880,202209,162,82,80,99384.39,96961.55,196345.94
316890,202209,232,154,78,186649.05,94536.69,281185.74
316900,202209,423,294,129,356330.56,156348,512678.56
316905,202209,25,11,14,13332,16968,30300
316910,202209,81,37,44,44844,53328,98172
316920,202209,146,112,34,135746.13,41208,176954.13
316930,202209,2002,1025,977,1242314.97,1185337.39,2427652.36
316935,202209,974,575,399,696908.75,483594.94,1180503.69
316940,202209,1136,666,470,807200.59,570852.8,1378053.39
316950,202209,186,89,97,107868.64,117564,225432.64
316960,202209,1108,617,491,747821.96,596307.84,1344129.80
316970,202209,656,522,134,632671.56,162409.57,795081.13
316980,202209,81,42,39,50904,47268,98172
316990,202209,2292,1552,740,1882261.8,898095.66,2780357.46
317000,202209,342,266,76,322397.98,92114.72,414512.70
317005,202209,221,152,69,184227.11,83628.9,267856.01
317010,202209,6904,3922,2982,4759629.69,3616644.57,8376274.26
317020,202209,16107,7030,9077,8530221.78,11009873.05,19540094.83
317030,202209,97,42,55,50904.19,66660,117564.19
317040,202209,3184,2062,1122,2501612.71,1361083.2,3862695.91
317043,202209,77,60,17,72725.73,20604.8,93330.53
317047,202209,38,22,16,26664,19392,46056
317050,202209,149,118,31,143017.7,37572,180589.7
317052,202209,154,125,29,151501.96,35148,186649.96
317057,202209,189,138,51,167258.08,61812,229070.08
317060,202209,65,40,25,48480,30300.2,78780.2
317065,202209,52,39,13,47268,15756,63024
317070,202209,1977,924,1053,1121110.97,1279875.46,2400986.43
317075,202209,97,54,43,65448.53,52116,117564.53
317080,202209,967,492,475,597534.44,575700.8,1173235.24
317090,202209,715,558,157,677512.61,191499.48,869012.09
317100,202209,438,327,111,396325.42,134532,530857.42
317103,202209,131,101,30,122412.75,36360,158772.75
317107,202209,51,42,9,50904,10908,61812
317110,202209,80,42,38,50904.4,46056.29,96960.69
317115,202209,45,41,4,49748.96,4848,54596.96
317120,202209,2178,1072,1106,1299291.29,1340482.01,2639773.30
317130,202209,2134,1431,703,1734381.19,852036.66,2586417.85
317140,202209,14,12,2,14544.1,2424,16968.1
317150,202209,282,169,113,204828.96,139380.71,344209.67
317160,202209,357,265,92,322393.95,111504.98,433898.93
317170,202209,243,159,84,192708.73,101808.36,294517.09
317180,202209,430,293,137,355117.74,166046.46,521164.20
317190,202209,261,186,75,225432.52,90900,316332.52
317200,202209,846,583,263,706610.39,318764.04,1025374.43
317210,202209,182,93,89,112721.93,107868,220589.93
317220,202209,24,12,12,14544,14544,29088
320010,202209,562,402,160,487227.85,195133.86,682361.71
320013,202209,127,83,44,101808.99,53328.37,155137.36
320016,202209,257,157,100,191497.33,121200,312697.33
320020,202209,750,442,308,536930.35,373304.27,910234.62
320030,202209,170,118,52,143016.54,63024.24,206040.78
320035,202209,132,94,38,113928.2,46056,159984.2
320040,202209,506,253,253,306640.74,306641.67,613282.41
320050,202209,124,84,40,101812.33,48480.91,150293.24
320060,202209,1896,880,1016,1067787.17,1232617.66,2300404.83
320070,202209,100,64,36,77568.87,43632,121200.87
320080,202209,839,478,361,579348.39,437534.95,1016883.34
320090,202209,1334,855,479,1036279.55,580558.72,1616838.27
320100,202209,347,205,142,248462.01,172106,420568.01
320110,202209,132,80,52,96966.77,63024.2,159990.97
320115,202209,110,94,16,113928,19392,133320
320120,202209,3815,1964,1851,2381617.15,2243447.41,4625064.56
320130,202209,8309,3575,4734,4335395.85,5740115.33,10075511.18
320140,202209,502,319,183,386636.58,221801.23,608437.81
320150,202209,2190,1203,987,1458060.78,1197468.34,2655529.12
320160,202209,650,282,368,341790.26,446019.07,787809.33
320170,202209,110,87,23,105445.09,27876.02,133321.11
320180,202209,60,35,25,42420.8,30300,72720.8
320190,202209,254,147,107,178166.82,129684.2,307851.02
320200,202209,63,52,11,63024.87,13332,76356.87
320210,202209,934,504,430,612074.16,522379.54,1134453.70
320220,202209,307,104,203,126048.8,246036.2,372085.0
320225,202209,78,64,14,77568.07,16968.17,94536.24
320230,202209,712,449,263,544204.65,318762.65,862967.30
320240,202209,3667,1657,2010,2009525.5,2439782.88,4449308.38
320245,202209,527,357,170,432690.5,207257.52,639948.02
320250,202209,237,110,127,133321.9,153926.36,287248.26
320255,202209,125,93,32,112717.62,38784.22,151501.84
320260,202209,275,150,125,181801.13,151501.58,333302.71
320265,202209,146,114,32,138168.25,38784.11,176952.36
320270,202209,162,124,38,150289.89,46057.15,196347.04
320280,202209,1300,724,576,877499.54,699335.34,1576834.88
320290,202209,67,51,16,61812,19392,81204
320300,202209,646,434,212,526024.42,256948.77,782973.19
320305,202209,779,418,361,506630.17,437542.75,944172.92
320310,202209,202,119,83,144230.24,100596.2,244826.44
320313,202209,359,162,197,196347.32,238764.4,435111.72
320316,202209,112,80,32,96961.54,38784,135745.54
320320,202209,3584,1578,2006,1912562.49,2431296.78,4343859.27
320330,202209,286,206,80,250884.75,96960,347844.75
320332,202209,802,475,327,576930.14,396336.78,973266.92
320334,202209,292,161,131,195133.71,158773.3,353907.01
320335,202209,147,96,51,116354.06,61813.52,178167.58
320340,202209,597,423,174,512691.53,212105.81,724797.34
320350,202209,1119,456,663,552682.47,804778.06,1357460.53
320360,202209,176,85,91,103020.08,110292,213312.08
320370,202209,234,173,61,209678.73,73932.6,283611.33
320380,202209,329,230,99,278762.3,119988.89,398751.19
320390,202209,1169,689,480,835078.12,582976.69,1418054.81
320400,202209,322,224,98,271492.29,119988.06,391480.35
320405,202209,1006,414,592,501782.3,717516.77,1219299.07
320410,202209,971,481,490,582980.22,593886.33,1176866.55
320420,202209,579,261,318,317553.54,386636.82,704190.36
320425,202209,217,112,105,136956.79,127260.8,264217.59
320430,202209,403,210,193,254525.91,233920.82,488446.73
320435,202209,173,117,56,141805.76,67874.39,209680.15
320440,202209,210,115,95,139381.5,115143.17,254524.67
320450,202209,143,75,68,90900.3,82417.06,173317.36
320455,202209,238,184,54,223008.93,65448.51,288457.44
320460,202209,308,184,124,223010.04,150288.6,373298.64
320465,202209,118,81,37,98174,44844.65,143018.65
320470,202209,757,446,311,540560,376942.47,917502.47
320480,202209,210,142,68,172106.39,83628.8,255735.19
320490,202209,3395,1599,1796,1939236.84,2179221.5,4118458.34
320495,202209,122,69,53,83628.1,64236.6,147864.7
320500,202209,10457,5041,5416,6118317.4,6569137.47,12687454.87
320501,202209,574,293,281,355122.33,340581.11,695703.44
320503,202209,316,222,94,270279.74,113929.56,384209.30
320506,202209,271,185,86,224221.64,104232.38,328454.02
320510,202209,1289,547,742,662972.04,900526.48,1563498.52
320515,202209,84,64,20,77568.87,24240,101808.87
320517,202209,228,161,67,195135.01,81204,276339.01
320520,202209,8144,3362,4782,4082089.23,5801935.7,9884024.93
320530,202209,7200,3444,3756,4177806.32,4557176.6,8734982.92
330010,202209,3616,1769,1847,2146500.75,2243436.79,4389937.54
330015,202209,204,89,115,107868.74,139380.56,247249.30
330020,202209,4161,1584,2577,1921046.72,3130624.45,5051671.17
330022,202209,275,133,142,161198.73,173316.69,334515.42
330023,202209,846,238,608,288457.93,736906.82,1025364.75
330025,202209,810,144,666,174528.2,809625.4,984153.6
330030,202209,1936,1189,747,1442309.96,906585.46,2348895.42
330040,202209,2774,1394,1380,1694403.73,1677427.93,3371831.66
330045,202209,10636,3214,7422,3899071.67,9008897.64,12907969.31
330050,202209,921,572,349,693272.4,422991.94,1116264.34
330060,202209,1214,703,511,852053.45,620552.37,1472605.82
330070,202209,4484,1500,2984,1819248.73,3617864.65,5437113.38
330080,202209,1703,732,971,887198.33,1176867.57,2064065.90
330090,202209,404,223,181,270278.63,219372.98,489651.61
330093,202209,236,97,139,117564.8,168468,286032.8
330095,202209,69,38,31,46056.96,37572,83628.96
330100,202209,11316,5552,5764,6735179.08,6995748.27,13730927.35
330110,202209,483,219,264,266643.18,319970.7,586613.88
330115,202209,542,267,275,323609.06,334513.87,658122.93
330120,202209,410,214,196,259368.86,237552.85,496921.71
330130,202209,1689,437,1252,529653.79,1519872.7,2049526.49
330140,202209,700,355,345,430263.38,418140.7,848404.08
330150,202209,543,322,221,390268.31,267853.29,658121.60
330160,202209,216,123,93,150288.43,112716,263004.43
330170,202209,28515,9816,18699,11908142.83,22687762.21,34595905.04
330180,202209,258,141,117,170893.79,141805.55,312699.34
330185,202209,1188,436,752,529648.55,913859.17,1443507.72
330187,202209,587,182,405,220586.31,490866.03,711452.34
330190,202209,6642,2461,4181,2983983.15,5078330.81,8062313.96
330200,202209,4876,1575,3301,1911359.9,4005711.84,5917071.74
330205,202209,488,275,213,334516.37,258159.99,592676.36
330210,202209,967,571,396,692069.7,479954.91,1172024.61
330220,202209,2943,1706,1237,2067706.53,1499267.23,3566973.76
330225,202209,617,326,291,395116.63,352693.63,747810.26
330227,202209,2556,794,1762,962344.52,2136780.36,3099124.88
330230,202209,260,140,120,169681.16,146652,316333.16
330240,202209,4526,2084,2442,2525854.6,2960958.18,5486812.78
330245,202209,171,80,91,96961.33,110292.46,207253.79
330250,202209,7049,3340,3709,4050581.27,4496577.59,8547158.86
330260,202209,789,213,576,258157.96,698114.04,956272.00
330270,202209,4116,1324,2792,1604711.34,3391217.47,4995928.81
330280,202209,486,289,197,350279.8,238767.53,589047.33
330285,202209,6858,2171,4687,2631318.44,5688026.13,8319344.57
330290,202209,788,267,521,326033.6,632668.3,958701.9
330300,202209,771,469,302,569180.91,366030.62,935211.53
330310,202209,495,280,215,339362.84,260582.24,599945.08
330320,202209,8228,2807,5421,3409441.08,6583672.58,9993113.66
330330,202209,10034,3633,6401,4406906.92,7765366.87,12172273.79
330340,202209,2881,1588,1293,1925884.82,1571976.03,3497860.85
330350,202209,20917,7549,13368,9153238.64,16220462.82,25373701.46
330360,202209,2114,975,1139,1182948.15,1381711.65,2564659.80
330370,202209,1033,531,502,643582.39,608430.2,1252012.59
330380,202209,1036,410,626,496923.54,758716.65,1255640.19
330385,202209,676,334,342,404814.36,415717.99,820532.35
330390,202209,6446,3287,3159,3986323.08,3833601.87,7819924.95
330395,202209,406,261,145,316338.45,175746.39,492084.84
330400,202209,747,374,373,453296.74,455715.62,909012.36
330410,202209,542,391,151,473900,183015.3,656915.3
330411,202209,378,202,176,244826.25,213312,458138.25
330412,202209,233,103,130,124837.41,157560.88,282398.29
330414,202209,5666,2197,3469,2666469.98,4210525.12,6876995.10
330415,202209,640,267,373,323612.18,452078.35,775690.53
330420,202209,2590,1344,1246,1631370.38,1513799.66,3145170.04
330430,202209,1902,808,1094,980519.92,1325939.41,2306459.33
330440,202209,393,183,210,221797.83,254520.6,476318.43
330450,202209,128,56,72,67873.35,87264,155137.35
330452,202209,2507,1015,1492,1232634.24,1808326.49,3040960.73
330455,202209,131059,44549,86510,54047865.4,105014232.96,159062098.36
330460,202209,272,123,149,149077.09,180588.4,329665.49
330470,202209,1308,687,621,832655.13,752662.97,1585318.10
330475,202209,1935,570,1365,690847.79,1654389.1,2345236.89
330480,202209,824,445,379,539348.23,459352.74,998700.97
330490,202209,17211,5206,12005,6314730.04,14564764.27,20879494.31
330500,202209,1610,684,926,829015.59,1122320.87,1951336.46
330510,202209,11659,3992,7667,4843237.74,9298576.84,14141814.58
330513,202209,103,52,51,63024,61812,124836
330515,202209,733,313,420,379358.88,509046.03,888404.91
330520,202209,2638,893,1745,1082334.51,2121027.66,3203362.17
330530,202209,193,110,83,133322.21,100596.52,233918.73
330540,202209,356,185,171,224221.95,207253.99,431475.94
330550,202209,2987,981,2006,1188986.43,2436146.43,3625132.86
330555,202209,1055,387,668,471473.21,812044.19,1283517.40
330560,202209,807,273,534,330877.59,647215.76,978093.35
330570,202209,324,223,101,270276.02,122412.43,392688.45
330575,202209,897,328,569,397543.59,689636.35,1087179.94
330580,202209,3558,1849,1709,2245857.67,2072544.36,4318402.03
330590,202209,269,139,130,168469.16,157561.12,326030.28
330600,202209,1429,842,587,1021727.64,712664.43,1734392.07
330610,202209,1720,877,843,1062935.04,1021724.6,2084659.64
330615,202209,229,182,47,221797.74,58177.73,279975.47
330620,202209,1080,421,659,511472.91,799928.31,1311401.22
330630,202209,4776,2796,1980,3394876.13,2399789.08,5794665.21
350010,202209,623,410,213,498144.62,258158.17,756302.79
350020,202209,60,21,39,25452.2,47268,72720.2
350030,202209,575,347,228,420582.16,276341.18,696923.34
350040,202209,116,48,68,58178.88,83630.06,141808.94
350050,202209,370,180,190,218162.82,230281.26,448444.08
350055,202209,131,58,73,70296,88476.2,158772.2
350060,202209,88,38,50,46056.9,60600.2,106657.1
350070,202209,824,460,364,557537.44,441180.04,998717.48
350075,202209,84,51,33,61813.5,39996.2,101809.7
350080,202209,59,26,33,31512.07,39996.8,71508.87
350090,202209,81,45,36,54542.76,43632,98174.76
350100,202209,288,180,108,218162.02,130896.38,349058.40
350110,202209,47,30,17,36362.14,20604,56966.14
350115,202209,182,92,90,111505.3,109080.7,220586.0
350120,202209,111,69,42,83630.17,50905.23,134535.40
350130,202209,424,181,243,221802.9,295733.71,517536.61
350140,202209,38,24,14,29088.44,16968.8,46057.24
350150,202209,70,50,20,60600.1,24240.8,84840.9
350160,202209,2456,965,1491,1169594.91,1809522.87,2979117.78
350170,202209,418,244,174,296945.15,212103.78,509048.93
350180,202209,165,91,74,113930.59,89688.81,203619.40
350190,202209,1031,551,480,669042.02,582972.36,1252014.38
350200,202209,58,26,32,31513.55,38784,70297.55
350210,202209,1349,720,629,872664.71,763577.42,1636242.13
350220,202209,647,523,124,633892.43,150289.5,784181.93
350230,202209,67,40,27,49692.84,32724.1,82416.94
350240,202209,61,38,23,46056,29089.22,75145.22
350250,202209,1143,518,625,627831.42,757505.68,1385337.10
350260,202209,101,73,28,88476.73,33936,122412.73
350270,202209,978,649,329,789018.82,401173.89,1190192.71
350275,202209,340,127,213,153926.13,259371.22,413297.35
350280,202209,4539,2170,2369,2632515.69,2876090.55,5508606.24
350290,202209,477,203,274,246040.06,335727.11,581767.17
350300,202209,51,26,25,31514.86,30300.9,61815.76
350310,202209,81,47,34,56964.2,41208.39,98172.59
350315,202209,74,32,42,38784,50904,89688
350320,202209,3493,1629,1864,1979242.96,2262824.81,4242067.77
350330,202209,1710,861,849,1043546.13,1028989.38,2072535.51
350335,202209,20,12,8,14544,9696,24240
350340,202209,124,49,75,59388.7,90902.81,150291.51
350350,202209,98,48,50,58176,60600.73,118776.73
350360,202209,105,68,37,82417.3,44844.18,127261.48
350370,202209,90,49,41,59390.47,49692,109082.47
350380,202209,843,353,490,427841.11,593885.23,1021726.34
350390,202209,1834,678,1156,821747.83,1402296.75,2224044.58
350395,202209,21,16,5,19392.14,6060,25452.14
350400,202209,1805,861,944,1043543.36,1145340.88,2188884.24
350410,202209,3156,1291,1865,1565032.87,2260395.31,3825428.18
350420,202209,288,169,119,204830.25,145441.09,350271.34
350430,202209,99,49,50,59389.63,60603.49,119993.12
350440,202209,146,101,45,124839.81,54540.4,179380.21
350450,202209,1800,979,821,1186573.56,996264.93,2182838.49
350460,202209,409,135,274,163622.78,332097.82,495720.60
350470,202209,18,12,6,14544,7272,21816
350480,202209,197,102,95,123629.17,115140.8,238769.97
350490,202209,249,114,135,138168.99,163620.04,301789.03
350500,202209,58,21,37,25452,44844,70296
350510,202209,151,89,62,107870.57,75144,183014.57
350520,202209,450,242,208,293312.5,252100.54,545413.04
350530,202209,455,216,239,263011.41,289676.67,552688.08
350535,202209,96,64,32,77568.59,38784.6,116353.19
350540,202209,373,195,178,236342.86,215739.57,452082.43
350550,202209,2819,1568,1251,1900459.59,1517430.32,3417889.91
350560,202209,604,408,196,494502.33,237555.21,732057.54
350570,202209,4792,1954,2838,2369488.75,3442104.23,5811592.98
350580,202209,386,186,200,225434.09,242403.7,467837.79
350590,202209,1014,551,463,667824.28,561287.9,1229112.18
350600,202209,6597,3039,3558,3688203.27,4314744.52,8002947.79
350610,202209,1562,801,761,970826.73,922336.92,1893163.65
350620,202209,26,17,9,20604,10908,31512
350630,202209,266,131,135,158773.67,163621.58,322395.25
350635,202209,1249,510,739,619343.03,895679.37,1515022.40
350640,202209,122,88,34,106658.5,41208.2,147866.7
350650,202209,1937,1271,666,1542897.09,807193.11,2350090.20
350660,202209,811,314,497,380571.83,602367.77,982939.60
350670,202209,298,147,151,178164,183012.6,361176.6
350680,202209,165,83,82,100599.49,100597.09,201196.58
350690,202209,209,92,117,112716.1,141804,254520.1
350700,202209,947,441,506,535711.13,614492,1150203.13
350710,202209,423,158,265,191499.26,321183.7,512682.96
350715,202209,56,46,10,55752.51,12120,67872.51
350720,202209,16,11,5,13332.62,6060,19392.62
350730,202209,40,26,14,31512,16968,48480
350740,202209,250,135,115,163623.14,139381.85,303004.99
350745,202209,29,13,16,15756.8,19392.2,35149.0
350750,202209,2521,1462,1059,1774408.78,1283518.44,3057927.22
350760,202209,4080,1707,2373,2068917.3,2877307.81,4946225.11
350770,202209,58,37,21,44844.2,25452,70296.2
350775,202209,53,39,14,47270.93,16968.84,64239.77
350780,202209,467,233,234,282408.02,283610.03,566018.05
350790,202209,372,155,217,187861.87,263008.04,450869.91
350800,202209,540,322,218,392692.67,264216.49,656909.16
350810,202209,523,400,123,484819.87,149076.95,633896.82
350820,202209,99,56,43,67872.18,52116,119988.18
350830,202209,75,39,36,47268.37,43632,90900.37
350840,202209,830,323,507,391481.62,614600.04,1006081.66
350850,202209,1921,994,927,1204746.61,1125951.36,2330697.97
350860,202209,684,358,326,435116.67,395119.27,830235.94
350870,202209,465,306,159,370877.85,192708.2,563586.05
350880,202209,278,156,122,189073.52,147867.38,336940.90
350890,202209,39,24,15,29088,18180.6,47268.6
350900,202209,1697,518,1179,627826.24,1430181,2058007.24
350910,202209,24,12,12,14544,14544,29088
350920,202209,807,414,393,501771.13,476317.51,978088.64
350925,202209,1204,611,593,741760.52,718725.95,1460486.47
350930,202209,122,70,52,84841.12,63024,147865.12
350940,202209,756,390,366,475122.07,444816.5,919938.57
350945,202209,116,81,35,98173.5,42421.02,140594.52
350950,202209,18340,8395,9945,10187018.21,12069171.05,22256189.26
350960,202209,1720,694,1026,841137.85,1243521.78,2084659.63
350970,202209,1124,541,583,655576.98,710245.7,1365822.68
350980,202209,97,66,31,79993.01,37572.2,117565.21
350990,202209,405,144,261,174530.36,317545.11,492075.47
350995,202209,44,19,25,23029.18,30301.47,53330.65
351000,202209,622,396,226,482389.61,273918.51,756308.12
351010,202209,53,34,19,41208.78,23028.99,64237.77
351015,202209,44,28,16,33937.34,19392,53329.34
351020,202209,1526,908,618,1100507.86,749020.97,1849528.83
351030,202209,352,205,147,248460.43,178164.51,426624.94
351040,202209,1043,564,479,683577.41,581763.47,1265340.88
351050,202209,3781,1712,2069,2077415.22,2511282.79,4588698.01
351060,202209,6272,2247,4025,2725831.6,4888014.08,7613845.68
351070,202209,421,259,162,313917.49,196348.31,510265.80
351080,202209,752,552,200,669035.12,242402.4,911437.52
351090,202209,49,25,24,30301.01,29088,59389.01
351100,202209,425,225,200,272710.06,242407.16,515117.22
351110,202209,2140,972,1168,1180510.74,1419253.58,2599764.32
351120,202209,66,30,36,36360.63,43632,79992.63
351130,202209,198,62,136,75146.1,164835.48,239981.58
351140,202209,330,197,133,238767.05,162409.46,401176.51
351150,202209,512,257,255,311487.72,309063.11,620550.83
351160,202209,316,185,131,224222.39,158772.72,382995.11
351170,202209,233,130,103,157560.82,124836,282396.82
351190,202209,92,56,36,67872.8,43632,111504.8
351200,202209,354,228,126,277550.83,152713.54,430264.37
351210,202209,129,64,65,77568,78780,156348
351220,202209,594,337,257,408451.35,311485.61,719936.96
351230,202209,303,201,102,243617.87,123624.39,367242.26
351240,202209,242,118,124,143017.09,150290.46,293307.55
351250,202209,82,55,27,66662.65,32724.1,99386.75
351260,202209,146,102,44,123624,53328,176952
351270,202209,45,20,25,24240.85,30300,54540.85
351280,202209,1065,500,565,607221.6,684786.95,1292008.55
351290,202209,253,113,140,136956.62,169680.1,306636.72
351300,202209,4129,1720,2409,2087098.53,2925799.94,5012898.47
351310,202209,745,358,387,433908.18,470267.79,904175.97
351320,202209,119,67,52,81205.1,63025.32,144230.42
351330,202209,45,27,18,32724,21816,54540
351340,202209,1455,785,670,951435.53,812043.53,1763479.06
351350,202209,2460,1422,1038,1724699.91,1260488.69,2985188.60
351360,202209,837,387,450,469048.11,545404.09,1014452.20
351370,202209,444,214,230,260584.43,279972.2,540556.63
351380,202209,9139,3930,5209,4766858.37,6318187.54,11085045.91
351385,202209,23,14,9,16968,10908,27876
351390,202209,283,205,78,248463.27,94536.2,342999.47
351400,202209,61,40,21,48480,25452,73932
351410,202209,479,287,192,347850.36,232706.32,580556.68
351420,202209,72,52,20,63024.04,24240,87264.04
351430,202209,75,38,37,46056,44844.2,90900.2
351440,202209,824,536,288,649651.96,349061.21,998713.17
351450,202209,286,138,148,168471.1,179378.91,347850.01
351460,202209,143,60,83,72722.4,101809.85,174532.25
351470,202209,147,77,70,93325.77,84840.98,178166.75
351480,202209,483,284,199,344212.68,241188.2,585400.88
351490,202209,310,119,191,145440.2,233916.55,379356.75
351492,202209,28,17,11,20604,13332,33936
351495,202209,25,17,8,20604,9696,30300
351500,202209,3577,1422,2155,1724690.19,2614299.51,4338989.70
351510,202209,2198,794,1404,962340.95,1704088.84,2666429.79
351512,202209,12,9,3,12120,3636,15756
351515,202209,215,123,92,149078.29,111504,260582.29
351518,202209,706,417,289,505419.01,350284.24,855703.25
351519,202209,88,52,36,63024,43632,106656
351520,202209,169,105,64,127262.18,77590.75,204852.93
351530,202209,23,12,11,14544,13332,27876
351535,202209,137,83,54,100599.75,65449.09,166048.84
351540,202209,483,318,165,385424.84,199983.4,585408.24
351550,202209,1587,931,656,1129604.97,796287.06,1925892.03
351560,202209,80,46,34,55752.89,41208,96960.89
351565,202209,15,8,7,9696.32,8484,18180.32
351570,202209,2889,1303,1586,1579271.58,1924673.09,3503944.67
351580,202209,36,34,2,41208.8,2424,43632.8
351590,202209,70,44,26,53329.34,31512.16,84841.50
351600,202209,181,131,50,158776.95,61812,220588.95
351610,202209,53,23,30,27876.17,36360,64236.17
351620,202209,6123,3246,2877,3937850.11,3493010.74,7430860.85
351630,202209,3425,1601,1824,1944079.02,2215556.6,4159635.62
351640,202209,2538,1092,1446,1324731.75,1754989.4,3079721.15
351650,202209,32,25,7,30300,8484,38784
351660,202209,140,89,51,107868.8,61812,169680.8
351670,202209,771,446,325,540562.04,393903.88,934465.92
351680,202209,82,61,21,73932,25452,99384
351685,202209,11,8,3,9696,3636,13332
351690,202209,304,195,109,236346.08,132110.4,368456.48
351700,202209,190,127,63,154185.4,76356.2,230541.6
351710,202209,67,43,24,52116.8,29088,81204.8
351720,202209,128,73,55,88478.3,66660,155138.3
351730,202209,117,78,39,94536.44,47268,141804.44
351740,202209,826,515,311,624204.5,376935.12,1001139.62
351750,202209,384,154,230,186649.79,278760.4,465410.19
351760,202209,717,551,166,667720.09,201192.28,868912.37
351770,202209,299,239,60,289674.36,72720.74,362395.10
351780,202209,155,93,62,112716.81,75144,187860.81
351790,202209,274,139,135,168469.7,163621.58,332091.28
351800,202209,45,28,17,33936.18,20604,54540.18
351810,202209,124,77,47,93325.37,56964.82,150290.19
351820,202209,785,556,229,673901.91,277553.11,951455.02
351830,202209,659,203,456,246037.69,552674.61,798712.30
351840,202209,2317,1033,1284,1253227.47,1557424.74,2810652.21
351850,202209,260,181,79,219374.68,96960,316334.68
351860,202209,611,403,208,488448.49,253308.86,741757.35
351870,202209,6006,2696,3310,3267607.9,4015425.52,7283033.42
351880,202209,22643,8611,14032,10442725.98,17033438.44,27476164.42
351885,202209,103,55,48,66662.22,58177.49,124839.71
351890,202209,70,47,23,56964.4,27876,84840.4
351900,202209,246,130,116,157562.55,140592.69,298155.24
351905,202209,99,45,54,54540.8,65448,119988.8
351907,202209,3829,1533,2296,1860445.03,2786408.6,4646853.63
351910,202209,157,66,91,79992.2,110292.4,190284.6
351920,202209,109,58,51,70296.3,61812,132108.3
351925,202209,89,55,34,66660.66,42420.41,109081.07
351930,202209,455,284,171,344220.24,207257.15,551477.39
351940,202209,244,99,145,119988.81,175740.92,295729.73
351950,202209,148,79,69,95748.72,83630.42,179379.14
351960,202209,986,473,513,573287.88,621770.9,1195058.78
351970,202209,2189,1034,1155,1253218.09,1399874.87,2653092.96
351980,202209,157,64,93,77571.73,112717.28,190289.01
351990,202209,256,161,95,195134.62,116353.14,311487.76
352000,202209,323,202,121,244830.38,147866.78,392697.16
352010,202209,439,282,157,343088.78,190291.49,533380.27
352020,202209,205,71,134,86052,162408,248460
352030,202209,1212,557,655,675096.54,795084.7,1470181.24
352040,202209,677,258,419,312700.41,509043.65,821744.06
352042,202209,346,84,262,101810.74,317547.41,419358.15
352044,202209,378,213,165,258161.91,199984.26,458146.17
352050,202209,3369,1215,2154,1473811.1,2615506.92,4089318.02
352060,202209,102,62,40,75144,48480.99,123624.99
352070,202209,97,68,29,82420.56,35148,117568.56
352080,202209,67,41,26,49693.64,31512.48,81206.12
352090,202209,182,114,68,138168.84,82416,220584.84
352100,202209,314,148,166,179377.57,201194.33,380571.90
352110,202209,115,35,80,42420.92,96960,139380.92
352115,202209,63,23,40,27876,48480.2,76356.2
352120,202209,70,47,23,56964,27876,84840
352130,202209,216,162,54,196350.58,65448.57,261799.15
352140,202209,190,89,101,107869.79,122412.97,230282.76
352150,202209,134,69,65,83629.34,78782.18,162411.52
352160,202209,140,88,52,106658.37,63024.04,169682.41
352170,202209,411,275,136,333302.93,164832.08,498135.01
352180,202209,709,431,278,522384.51,338154.52,860539.03
352190,202209,252,105,147,127260.19,178165.89,305426.08
352200,202209,29,11,18,13332,21816.1,35148.1
352210,202209,4665,1849,2816,2243460.61,3414223.97,5657684.58
352215,202209,77,41,36,49692,43632,93324
352220,202209,6409,2346,4063,2848245.58,4928033.11,7776278.69
352230,202209,3678,2307,1371,2796144.42,1662873.27,4459017.69
352240,202209,2826,1578,1248,1912560.1,1513796.49,3426356.59
352250,202209,3628,1603,2025,1945282.66,2455515.77,4400798.43
352260,202209,1067,556,511,673883.06,619343.76,1293226.82
352265,202209,67,39,28,47268,33936,81204
352270,202209,402,221,181,267856.75,220589.73,488446.48
352280,202209,528,308,220,373300.93,267852,641152.93
352290,202209,170,93,77,112717.29,94538.27,207255.56
352300,202209,99,63,36,76358.7,43632.6,119991.3
352310,202209,7495,3191,4304,3871193.97,5217666.3,9088860.27
352320,202209,1195,606,589,734481.71,716295.42,1450777.13
352330,202209,553,282,271,341786.05,329664.56,671450.61
352340,202209,1393,629,764,762358.46,928399.78,1690758.24
352350,202209,374,201,173,243615.78,209681.03,453296.81
352360,202209,223,99,124,119988,150288.2,270276.2
352370,202209,127,77,50,93324.91,60600.89,153925.80
352380,202209,115,82,33,99387.68,39996.16,139383.84
352390,202209,2687,1149,1538,1393818.08,1866487.96,3260306.04
352400,202209,571,248,323,300577.09,391477.7,692054.79
352410,202209,928,600,328,727221.99,397551.37,1124773.36
352420,202209,87,65,22,78780.62,26664,105444.62
352430,202209,1815,786,1029,952654.11,1247165.91,2199820.02
352440,202209,3565,1622,1943,1967104.59,2357349.93,4324454.52
352450,202209,202,156,46,189072.6,55752.32,244824.92
352460,202209,651,319,332,386630.55,404812.12,791442.67
352470,202209,695,256,439,310276.11,532072.13,842348.24
352480,202209,1675,934,741,1133243.14,898102.37,2031345.51
352490,202209,53,21,32,25452.6,38784.1,64236.7
352500,202209,1310,522,788,632671.43,956272.13,1588943.56
352510,202209,731,378,353,458147.39,427838.75,885986.14
352520,202209,878,388,490,470259.68,593897.89,1064157.57
352530,202209,1933,969,964,1178083.95,1170801.47,2348885.42
352540,202209,74,50,24,60601.58,29088,89689.58
352550,202209,217,125,92,151501.15,111504.4,263005.55
352560,202209,54,40,14,48481.03,16968.31,65449.34
352570,202209,773,366,407,444821.16,494508.1,939329.26
352580,202209,54,41,13,49693.38,15756,65449.38
352585,202209,20,5,15,6060.6,18180.95,24241.55
352590,202209,4617,2222,2395,2695529.54,2905187.46,5600717.00
352600,202209,377,261,116,316339.84,140596.65,456936.49
352610,202209,950,419,531,507837.6,643576.91,1151414.51
352620,202209,1155,431,724,523594.77,879919.1,1403513.87
352630,202209,196,74,122,89689.95,147864,237553.95
352640,202209,525,337,188,408453.98,227858.86,636312.84
352650,202209,89,65,24,78780.6,29088,107868.6
352660,202209,65,36,29,43632,35148,78780
352670,202209,1770,925,845,1123548.81,1025353.85,2148902.66
352680,202209,982,581,401,705396.98,486021.79,1191418.77
352690,202209,4806,2071,2735,2518576.95,3320898.31,5839475.26
352700,202209,87,49,38,59388.95,46056,105444.95
352710,202209,1540,784,756,952643.99,918699.37,1871343.36
352720,202209,1607,656,951,796304.41,1152633.98,1948938.39
352725,202209,27,20,7,24240,8484,32724
352730,202209,404,202,202,244827.03,244825.08,489652.11
352740,202209,408,257,151,311492.3,183015.91,494508.21
352750,202209,22,14,8,16968.21,9696.14,26664.35
352760,202209,225,143,82,173316.88,99384.57,272701.45
352770,202209,79,58,21,70297.42,25452.18,95749.60
352780,202209,74,36,38,43632,46056.78,89688.78
352790,202209,24,17,7,20606.05,8484.18,29090.23
352800,202209,243,185,58,224225.35,70296.67,294522.02
352810,202209,162,102,60,123625.5,72721.12,196346.62
352820,202209,47,35,12,42420.7,14544,56964.7
352830,202209,74,49,25,59388.57,30300.01,89688.58
352840,202209,720,316,404,383000.69,489650.28,872650.97
352850,202209,1853,546,1307,661756.4,1586513.07,2248269.47
352860,202209,119,74,45,89688.6,54540.53,144229.13
352870,202209,49,31,18,37573.73,21816.55,59390.28
352880,202209,184,107,77,129686.54,93324.86,223011.40
352885,202209,34,22,12,26664.7,14544,41208.7
352890,202209,57,35,22,42421.18,26664.6,69085.78
352900,202209,4756,2221,2535,2693099.56,3076064.93,5769164.49
352910,202209,38,31,7,37572,8484,46056
352920,202209,652,373,279,452087.02,338154.83,790241.85
352930,202209,1205,561,644,681152.38,780529.93,1461682.31
352940,202209,6456,2410,4046,2924594.11,4908653.73,7833247.84
352950,202209,121,54,67,65448.86,82417.94,147866.80
352960,202209,64,38,26,46056,31512,77568
352965,202209,16,10,6,12120,7272,19392
352970,202209,546,396,150,479965.33,181803.59,661768.92
352980,202209,161,95,66,115144.68,79992.89,195137.57
352990,202209,996,465,531,564805.66,643582.73,1208388.39
353000,202209,58,25,33,30300.8,39996.6,70297.4
353010,202209,527,315,212,381790.75,256948.02,638738.77
353020,202209,341,224,117,271497.1,143017.87,414514.97
353030,202209,1438,625,813,758729.53,987798.01,1746527.54
353040,202209,90,45,45,54540.59,54541.23,109081.82
353050,202209,1358,879,479,1066584.85,581760.27,1648345.12
353060,202209,9415,4000,5415,4848078.16,6566662.61,11414740.77
353070,202209,2031,1179,852,1430186.38,1036045.51,2466231.89
353080,202209,1334,716,618,869016.49,750229.96,1619246.45
353090,202209,65,36,29,43632.6,35148,78780.6
353100,202209,44,33,11,39998.07,13332.52,53330.59
353110,202209,2314,754,1560,916291.65,1894400.17,2810691.82
353120,202209,142,80,62,96960.2,75144,172104.2
353130,202209,870,412,458,499358.83,556314.05,1055672.88
353140,202209,588,271,317,329672.19,385420.54,715092.73
353150,202209,324,169,155,204831.97,187863.84,392695.81
353160,202209,112,84,28,101810.54,33936.44,135746.98
353170,202209,206,72,134,87264.8,162408.74,249673.54
353180,202209,1244,559,685,677518.54,832651.44,1510169.98
353190,202209,512,360,152,436334.61,184225.13,620559.74
353200,202209,270,130,140,157561.81,169680.39,327242.20
353205,202209,20,13,7,15756,8484,24240
353210,202209,70,41,29,49692.8,35148.56,84841.36
353215,202209,43,23,20,27876.2,24240,52116.2
353220,202209,83,44,39,53328,47268.6,100596.6
353230,202209,158,66,92,79992.36,111504,191496.36
353240,202209,391,170,221,206041.19,267852,473893.19
353250,202209,188,96,92,116353.88,111505.51,227859.39
353260,202209,470,306,164,370880.27,198771.6,569651.87
353270,202209,72,54,18,65449.46,21816,87265.46
353280,202209,120,51,69,61814.05,83630.23,145444.28
353282,202209,125,86,39,105445,48480.54,153925.54
353284,202209,29,19,10,24242.06,12120,36362.06
353286,202209,9,4,5,4848,6060.6,10908.6
353290,202209,83,45,38,54540,47268,101808
353300,202209,460,231,229,279980.93,277554.19,557535.12
353310,202209,39,32,7,38785.06,8484.6,47269.66
353320,202209,45,27,18,32725.02,21816.6,54541.62
353325,202209,43,24,19,29088.49,23028,52116.49
353330,202209,60,40,20,48480.8,24240.2,72721.0
353340,202209,706,245,461,296943.83,559951.52,856895.35
353350,202209,952,464,488,562376.74,592679.19,1155055.93
353360,202209,111,85,26,103020.87,31512.87,134533.74
353370,202209,109,62,47,75145.32,56964.38,132109.70
353380,202209,30,14,16,16968,19392,36360
353390,202209,1156,536,620,649647.64,751448.04,1401095.68
353400,202209,55,30,25,36360.6,30301.19,66661.79
353410,202209,119,64,55,77568.2,66662.2,144230.4
353420,202209,55,25,30,30300,36360,66660
353430,202209,583,381,202,461785.12,244832.48,706617.60
353440,202209,12916,5447,7469,6607900.61,9064581.35,15672481.96
353450,202209,53,26,27,31512.2,32724.2,64236.4
353460,202209,659,329,330,398760.96,399965.98,798726.94
353470,202209,2330,1115,1215,1352624.9,1472587.15,2825212.05
353475,202209,292,184,108,223013.23,130897.06,353910.29
353480,202209,189,148,41,179377.92,49692,229069.92
353490,202209,232,131,101,161199.07,122412.92,283611.99
353500,202209,213,118,95,145441.51,115141.73,260583.24
353510,202209,80,52,28,63024.7,33937.58,96962.28
353520,202209,246,178,68,215737.68,82416.6,298154.28
353530,202209,482,239,243,289674.22,295732.64,585406.86
353540,202209,422,259,163,313915.73,197557.86,511473.59
353550,202209,773,483,290,585412.24,352702.73,938114.97
353560,202209,558,224,334,271489.6,404809.3,676298.9
353570,202209,68,45,23,54541.51,27876,82417.51
353580,202209,353,223,130,270279.98,157560,427839.98
353590,202209,88,64,24,77568.2,29088,106656.2
353600,202209,292,166,126,201196.16,152712.2,353908.36
353610,202209,137,75,62,90902.33,75144,166046.33
353620,202209,692,343,349,415720.24,422992.58,838712.82
353625,202209,59,31,28,37574.19,33936.62,71510.81
353630,202209,223,160,63,193922.34,77568.89,271491.23
353640,202209,123,79,44,95748.74,53328.95,149077.69
353650,202209,1059,409,650,495712.08,787806.13,1283518.21
353657,202209,23,18,5,21816,6060,27876
353660,202209,297,147,150,178168.36,181801.29,359969.65
353670,202209,735,416,319,504200.38,386636.24,890836.62
353680,202209,140,90,50,109080.33,60600,169680.33
353690,202209,45,29,16,35148,19392.19,54540.19
353700,202209,292,199,93,241193.27,112716.9,353910.17
353710,202209,522,249,273,301792.65,330878.12,632670.77
353715,202209,42,25,17,30300.92,20604,50904.92
353720,202209,337,153,184,185439.51,223010.73,408450.24
353730,202209,1201,713,488,864165.88,593883.12,1458049.00
353740,202209,611,336,275,407242.48,333304.45,740546.93
353750,202209,83,45,38,54541.19,46056,100597.19
353760,202209,3416,1299,2117,1574421.77,2567049.49,4141471.26
353770,202209,78,62,16,75145.04,19392.2,94537.24
353780,202209,1404,634,770,768414.07,933246.93,1701661.00
353790,202209,505,298,207,362396.35,250887.92,613284.27
353800,202209,3802,1750,2052,2122278.31,2488242.02,4610520.33
353810,202209,243,119,124,144230.24,150289.4,294519.64
353820,202209,257,103,154,126048.85,186648.88,312697.73
353830,202209,66,55,11,66662.15,13332,79994.15
353850,202209,209,91,118,110292.8,143017.49,253310.29
353860,202209,550,244,306,295731.41,374510.02,670241.43
353870,202209,5972,3025,2947,3670012.17,3577845.78,7247857.95
353880,202209,740,473,267,573288.41,324820.27,898108.68
353890,202209,575,324,251,392693.51,304217.07,696910.58
353900,202209,135,71,64,86052.74,77569.63,163622.37
353910,202209,203,77,126,93325.07,152712.73,246037.80
353920,202209,465,241,224,292095.4,271490.91,563586.31
353930,202209,1071,626,445,758719.88,542979.09,1301698.97
353940,202209,215,102,113,123624.5,138168.59,261793.09
353950,202209,512,324,188,392695.32,227858.15,620553.47
353960,202209,78,63,15,76356.66,18180,94536.66
353970,202209,44,29,15,35149,18180.99,53329.99
353980,202209,2007,879,1128,1066576.51,1368364.04,2434940.55
353990,202209,84,49,35,59389.39,42420,101809.39
354000,202209,396,179,217,216952.51,263007.51,479960.02
354010,202209,92,53,39,64237.24,47268.69,111505.93
354020,202209,538,331,207,401182.31,250888.27,652070.58
354025,202209,36,30,6,36360.76,7272,43632.76
354030,202209,46,23,23,27877.4,27876.15,55753.55
354040,202209,101,73,28,88477.18,33936,122413.18
354050,202209,165,88,77,106657.95,93325.8,199983.75
354060,202209,827,377,450,456927.5,546613.63,1003541.13
354070,202209,952,533,419,646007.97,510257.76,1156265.73
354075,202209,187,87,100,105445.71,121201.47,226647.18
354080,202209,312,137,175,166049.26,212100.98,378150.24
354085,202209,23,14,9,16969.41,10908,27877.41
354090,202209,283,168,115,203516.61,139381.29,342897.90
354100,202209,6303,2529,3774,3068844.75,4582634.66,7651479.41
354105,202209,100,51,49,61812.8,59388,121200.8
354110,202209,39,19,20,23028,24240.43,47268.43
354120,202209,157,98,59,118776.89,71508.16,190285.05
354130,202209,780,468,312,568445.02,378148.3,946593.32
354140,202209,3439,1529,1910,1853182.85,2317360.7,4170543.55
354150,202209,669,378,291,458142.68,352697.43,810840.11
354160,202209,688,429,259,519967.37,313915.14,833882.51
354165,202209,12,8,4,9696.49,4848,14544.49
354170,202209,181,120,61,145442.11,73932.5,219374.61
354180,202209,53,30,23,36360.2,27876.85,64237.05
354190,202209,216,84,132,101809.3,159984.72,261794.02
354200,202209,118,56,62,67872.36,75145.8,143018.16
354210,202209,75,31,44,37572,53328,90900
354220,202209,618,378,240,462997.54,290885.46,753883.00
354230,202209,171,76,95,92113.65,116353.48,208467.13
354240,202209,331,203,128,246043.37,155136.91,401180.28
354250,202209,81,48,33,58176,39996,98172
354260,202209,2238,1031,1207,1252020.68,1465331.79,2717352.47
354270,202209,86,61,25,73932,30300,104232
354280,202209,59,30,29,36360,35148,71508
354290,202209,152,103,49,124837.5,59388.1,184225.6
354300,202209,338,235,103,284824.8,124836.1,409660.9
354310,202209,94,66,28,79995.38,33936,113931.38
354320,202209,229,111,118,134532.83,143016,277548.83
354323,202209,7,5,2,6060,2424,8484
354325,202209,134,72,62,87265.39,75144.6,162409.99
354330,202209,2532,845,1687,1025188.9,2047074.74,3072263.64
354340,202209,10988,4964,6024,6021098.11,7318111.83,13339209.94
354350,202209,144,97,47,117565.28,56964,174529.28
354360,202209,77,45,32,54542.7,38784.13,93326.83
354370,202209,233,120,113,145442.62,136958.65,282401.27
354380,202209,172,100,72,121202.24,87264,208466.24
354390,202209,2843,999,1844,1212015.09,2239794.2,3451809.29
354400,202209,334,180,154,218160.95,186648.94,404809.89
354410,202209,709,306,403,370885.11,488443.08,859328.19
354420,202209,284,193,91,233922.82,110293.08,344215.90
354425,202209,340,190,150,230338.61,181801.56,412140.17
354430,202209,183,96,87,117564.75,105444.6,223009.35
354440,202209,31,25,6,30302.14,7272,37574.14
354450,202209,59,38,21,46056.26,25452,71508.26
354460,202209,98,57,41,69087.66,49693.87,118781.53
354470,202209,27,14,13,16969.23,15757.11,32726.34
354480,202209,115,64,51,77568.8,61812.75,139381.55
354490,202209,129,72,57,87266.09,69084.9,156350.99
354500,202209,418,181,237,219373.33,288457.51,507830.84
354510,202209,89,61,28,73932.37,33936.9,107869.27
354515,202209,51,17,34,20604.98,41208.1,61813.08
354520,202209,1688,713,975,863994.7,1184124.64,2048119.34
354530,202209,882,425,457,515106.43,553888.47,1068994.90
354540,202209,265,129,136,156351.76,164832.2,321183.96
354550,202209,42,22,20,26664.51,24240,50904.51
354560,202209,163,90,73,109081.01,88476,197557.01
354570,202209,134,92,42,111504,50904,162408
354580,202209,1923,898,1025,1089606.09,1242306.42,2331912.51
354600,202209,291,136,155,164834.65,187860.1,352694.75
354610,202209,63,52,11,63024.99,13332,76356.99
354620,202209,76,19,57,23028,69084.33,92112.33
354625,202209,14,9,5,10908.94,6060,16968.94
354630,202209,352,231,121,279979.84,147867.15,427846.99
354640,202209,869,510,359,618353.98,437536.59,1055890.57
354650,202209,68,40,28,48480.74,33936,82416.74
354660,202209,840,607,233,735708.13,283610.92,1019319.05
354670,202209,228,89,139,107868.34,168468.2,276336.54
354680,202209,1387,481,906,584191.62,1100504.31,1684695.93
354690,202209,81,50,31,60601.98,37572.7,98174.68
354700,202209,79,55,24,66660,29088,95748
354710,202209,49,36,13,43632.16,15756,59388.16
354720,202209,18,17,1,20604.2,1212,21816.2
354730,202209,1849,743,1106,904163.78,1341698.99,2245862.77
354740,202209,75,51,24,61812.2,29088,90900.2
354750,202209,414,229,185,277550.46,224222.42,501772.88
354760,202209,534,326,208,395129,252101.33,647230.33
354765,202209,6,2,4,2424,4848,7272
354770,202209,364,231,133,279980.15,161197.81,441177.96
354780,202209,8795,3215,5580,3901469.31,6772686.66,10674155.97
354790,202209,87,50,37,60600.85,44844.11,105444.96
354800,202209,441,235,206,284774.69,249675.71,534450.40
354805,202209,74,37,37,44844.69,44845.07,89689.76
354810,202209,103,56,47,67872,56964,124836
354820,202209,219,88,131,106657.92,158774.93,265432.85
354830,202209,41,21,20,25452,24240,49692
354840,202209,59,38,21,46056.24,25452,71508.24
354850,202209,4839,2112,2727,2564633.17,3306366.84,5871000.01
354860,202209,347,157,190,190284.17,231493.8,421777.97
354870,202209,12680,5430,7250,6587313.47,8794318.33,15381631.80
354880,202209,2779,999,1780,1210801.77,2158645.1,3369446.87
354890,202209,3113,1617,1496,1961045.74,1815589.04,3776634.78
354900,202209,65,46,19,55752.19,23028.19,78780.38
354910,202209,1343,684,659,829020.29,801133.26,1630153.55
354920,202209,38,31,7,37572,8484,46056
354925,202209,24,13,11,15756,13332,29088
354930,202209,32,28,4,33936.21,4848,38784.21
354940,202209,783,542,241,656921.82,292098.55,949020.37
354950,202209,215,130,85,157563.63,103021.61,260585.24
354960,202209,132,49,83,59388.8,100596.59,159985.39
354970,202209,1188,815,373,987795.54,452077.54,1439873.08
354980,202209,9865,3517,6348,4268747.56,7698669.76,11967417.32
354990,202209,10840,4719,6121,5721923.91,7423534.03,13145457.94
354995,202209,621,205,416,248463.4,504197.38,752660.78
355000,202209,460,156,304,189073.43,368448.3,557521.73
355010,202209,660,403,257,488450.39,312703.47,801153.86
355020,202209,819,501,318,609648.3,385420.25,995068.55
355030,202209,223691,82488,141203,100063983.71,171308182.19,271372165.90
355040,202209,995,471,524,570865.16,636307.36,1207172.52
355050,202209,180,94,86,115140.2,104232,219372.2
355060,202209,1854,865,989,1050820.68,1204730.35,2255551.03
355070,202209,1682,733,949,888409.45,1152627.89,2041037.34
355080,202209,204,120,84,145441.31,101809.78,247251.09
355090,202209,321,197,124,238771.79,150290.96,389062.75
355100,202209,5705,2642,3063,3211731.44,3713592.02,6925323.46
355110,202209,229,148,81,179376.42,98172.77,277549.19
355120,202209,54,32,22,38784.83,26664,65448.83
355130,202209,50,27,23,32724.99,27876,60600.99
355140,202209,202,117,85,141806.36,103020.68,244827.04
355150,202209,725,427,298,518748.06,361179.03,879927.09
355160,202209,502,241,261,292098.58,318761.14,610859.72
355170,202209,2137,1091,1046,1323530.01,1271394.93,2594924.94
355180,202209,720,282,438,341788.77,530860.88,872649.65
355190,202209,228,154,74,186652.87,89689.5,276342.37
355200,202209,119,59,60,71508.96,72720.6,144229.56
355210,202209,737,380,357,461775.64,432801.63,894577.27
355220,202209,8089,3823,4266,4638398.54,5181341.83,9819740.37
355230,202209,96,52,44,63024.59,53330.21,116354.80
355240,202209,4812,1900,2912,2303989.13,3530567.29,5834556.42
355250,202209,7272,3183,4089,3863944.11,4961943.96,8825888.07
355255,202209,48,30,18,36360,21816,58176
355260,202209,189,106,83,128474.49,100598.17,229072.66
355270,202209,155,99,56,119989.53,67872.78,187862.31
355280,202209,7413,2727,4686,3306388.85,5689183.26,8995572.11
355290,202209,65,51,14,61812.27,16968.45,78780.72
355300,202209,231,130,101,157561.28,122412.59,279973.87
355310,202209,114,63,51,76356,61812,138168
355320,202209,96,50,46,60600,55752,116352
355330,202209,329,190,139,230285.42,168471.36,398756.78
355340,202209,1401,501,900,607234.82,1090836.69,1698071.51
355350,202209,166,78,88,94536,106656.1,201192.1
355360,202209,181,119,62,144233.13,75144.89,219378.02
355365,202209,17,12,5,14544,6060,20604
355370,202209,1053,619,434,752669.71,526009.22,1278678.93
355380,202209,859,517,342,627836.6,415721.5,1043558.1
355385,202209,97,60,37,73932.15,44844,118776.15
355390,202209,108,55,53,66660.2,64236.8,130897.0
355395,202209,201,104,97,127265.17,117566.69,244831.86
355400,202209,1859,1048,811,1270092.13,985357.26,2255449.39
355410,202209,5358,2387,2971,2894291.25,3600863.04,6495154.29
355420,202209,45,31,14,37572.8,16968,54540.8
355430,202209,440,264,176,319979.55,214529.52,534509.07
355440,202209,91,51,40,61812.2,48481.02,110293.22
355450,202209,459,230,229,278764.49,277550.05,556314.54
355460,202209,53,41,12,49693.15,14544,64237.15
355465,202209,51,29,22,35148.06,26664,61812.06
355470,202209,201,77,124,94537.65,150288.6,244826.25
355475,202209,7,4,3,4848.64,3636,8484.64
355480,202209,645,252,393,305433.61,476322.19,781755.80
355490,202209,112,79,33,95751.83,39998.67,135750.50
355495,202209,91,36,55,43632,66660.91,110292.91
355500,202209,1634,867,767,1050820.22,929610.22,1980430.44
355510,202209,281,194,87,235138.51,105446.56,340585.07
355520,202209,27,19,8,23028.18,9696,32724.18
355530,202209,22,11,11,13332,13332,26664
355535,202209,81,38,43,46056.87,52116,98172.87
355540,202209,2911,1129,1782,1368380.91,2161033.54,3529414.45
355550,202209,67,39,28,47268,33936,81204
355560,202209,254,116,138,140596.27,168471.56,309067.83
355570,202209,15,10,5,12120,6060,18180
355580,202209,239,162,77,196346.92,94537.63,290884.55
355590,202209,19,11,8,13332,9696,23028
355600,202209,285,137,148,166044.73,179378.18,345422.91
355610,202209,247,148,99,179381.49,119990.94,299372.43
355620,202209,1342,575,767,696907.36,930817.66,1627725.02
355630,202209,424,302,122,366031.39,149077.3,515108.69
355635,202209,129,53,76,64236,92112,156348
355640,202209,595,314,281,380569.92,340575.64,721145.56
355645,202209,922,327,595,396332.09,722360.42,1118692.51
355650,202209,1922,823,1099,997487.72,1333203.16,2330690.88
355660,202209,227,118,109,143017.76,132109.49,275127.25
355670,202209,670,278,392,336937.54,476317.35,813254.89
355680,202209,214,116,98,140592.93,119989.1,260582.03
355690,202209,95,48,47,58176,56964,115140
355695,202209,26,16,10,19392,12120,31512
355700,202209,1272,622,650,753870.45,790229.64,1544100.09
355710,202209,2371,1293,1078,1567148.28,1306538.03,2873686.31
355715,202209,16,14,2,16968,2424,19392
355720,202209,268,166,102,201193.73,123625.13,324818.86
355730,202209,110,64,46,77569.01,55752.15,133321.16
410010,202209,112,88,24,107872.14,29088,136960.14
410020,202209,122,88,34,106657.08,41208,147865.08
410030,202209,177,101,76,122414.24,92114.28,214528.52
410040,202209,1404,666,738,807199.03,894466.36,1701665.39
410045,202209,46,33,13,39996.59,15756,55752.59
410050,202209,541,315,226,382994.37,273912.84,656907.21
410060,202209,276,197,79,238770.15,95751.3,334521.45
410070,202209,294,245,49,298160.45,59388.44,357548.89
410080,202209,184,111,73,134532.2,88476,223008.2
410090,202209,56,46,10,55753.77,12120,67873.77
410100,202209,263,168,95,203616.4,115140,318756.4
410105,202209,50,31,19,37572,23028,60600
410110,202209,352,212,140,256948.75,169684.08,426632.83
410115,202209,46,27,19,32724.8,23028.2,55753.0
410120,202209,467,215,252,260585.01,305428.8,566013.81
410130,202209,64,37,27,44844,32724,77568
410140,202209,3291,1489,1802,1805896.96,2185254.12,3991151.08
410150,202209,2722,1080,1642,1312614.98,1990115.74,3302730.72
410160,202209,504,286,218,346635.86,264217.84,610853.70
410165,202209,54,32,22,38784,26664,65448
410170,202209,214,123,91,150288.2,110292,260580.2
410180,202209,2387,1259,1128,1525935.17,1368369.88,2894305.05
410185,202209,35,29,6,35148,7272,42420
410190,202209,499,322,177,390266.99,214524,604790.99
410200,202209,1062,746,316,904164.61,384206.28,1288370.89
410210,202209,647,329,318,398751.54,385418.14,784169.68
410220,202209,48,19,29,23028,35148,58176
410230,202209,189,84,105,101809.54,127260.4,229069.94
410240,202209,727,467,260,566016.39,316334.09,882350.48
410250,202209,381,264,117,319970.55,141806.12,461776.67
410260,202209,304,171,133,208465.98,161198.26,369664.24
410270,202209,28,19,9,23028,10908,33936
410275,202209,61,46,15,55752,18180,73932
410280,202209,324,192,132,232707.69,159984.35,392692.04
410290,202209,270,149,121,180589.5,146653.24,327242.74
410300,202209,87,53,34,64236,41208,105444
410302,202209,27,14,13,16968,15756,32724
410304,202209,44,30,14,36360,16968,53328
410305,202209,218,127,91,153925.88,110292.8,264218.68
410310,202209,187,110,77,133321.03,93324.58,226645.61
410315,202209,41,31,10,37572.2,12120,49692.2
410320,202209,141,97,44,117564.74,53328,170892.74
410322,202209,39,24,15,29088,18180,47268
410330,202209,177,113,64,136957.57,77568,214525.57
410335,202209,100,55,45,66660,54540,121200
410337,202209,48,38,10,46056,13332,59388
410340,202209,39,32,7,38785,8484,47269
410345,202209,197,118,79,143017.58,95748.8,238766.38
410347,202209,43,31,12,37572.49,14544,52116.49
410350,202209,248,143,105,173318.94,128472,301790.94
410360,202209,451,277,174,336940.79,210889.41,547830.20
410370,202209,2395,1023,1372,1241103.84,1665300.01,2906403.85
410380,202209,191,109,82,132108.7,99384.72,231493.42
410390,202209,410,262,148,318758.97,180588.64,499347.61
410395,202209,32,21,11,25452.85,13332.57,38785.42
410400,202209,923,383,540,464201.69,656911.02,1121112.71
410405,202209,81,61,20,73933.13,24240.94,98174.07
410410,202209,25,18,7,21816.51,8484,30300.51
410420,202209,1810,807,1003,979197.95,1219287.23,2198485.18
410425,202209,206,84,122,103020.81,147864.2,250885.01
410430,202209,2484,1286,1198,1559860.02,1451993.71,3011853.73
410440,202209,356,250,106,303000,129684.25,432684.25
410442,202209,360,223,137,270280.51,166045.16,436325.67
410445,202209,358,246,112,298154.18,136956.62,435110.80
410450,202209,388,185,203,224221.9,247248.47,471470.37
410460,202209,568,295,273,357543.15,332089.02,689632.17
410465,202209,274,147,127,178164.84,153925.14,332089.98
410470,202209,231,135,96,164833.37,116352.78,281186.15
410480,202209,6816,3274,3542,3969362.81,4299005.52,8268368.33
410490,202209,1446,800,646,969611.19,782964.51,1752575.70
410500,202209,277,160,117,193921.58,141804.5,335726.08
410510,202209,197,146,51,176955.55,63026.6,239982.15
410520,202209,277,193,84,233916.31,101808,335724.31
410530,202209,286,87,199,105444,241188,346632
410540,202209,348,253,95,306636.89,115140.79,421777.68
410550,202209,1735,720,1015,873860.23,1230185.95,2104046.18
410560,202209,179,115,64,140593.01,77568.59,218161.60
410570,202209,445,291,154,352696.03,187861.89,540557.92
410580,202209,3910,1620,2290,1963462.36,2776732.3,4740194.66
410590,202209,440,282,158,341767.61,192708.2,534475.81
410600,202209,98,84,14,101810,16968,118778
410610,202209,57,46,11,55752.99,13332,69084.99
410620,202209,277,176,101,214527.13,123625.2,338152.33
410630,202209,464,257,207,311488.01,250884,562372.01
410640,202209,1179,735,444,890827.73,538131.42,1428959.15
410645,202209,114,85,29,103022.73,35148,138170.73
410650,202209,382,234,148,284820.5,179378.7,464199.2
410655,202209,90,66,24,79992.95,29088.08,109081.03
410657,202209,36,14,22,16968,26664,43632
410660,202209,669,449,220,544197.81,266643.45,810841.26
410670,202209,80,64,16,77568.39,19392.6,96960.99
410680,202209,191,152,39,184224.57,47268,231492.57
410685,202209,35,24,11,29088,13332,42420
410690,202209,29790,12237,17553,14847182.3,21291438.72,36138621.02
410700,202209,332,238,94,289931.01,113928.6,403859.61
410710,202209,126,104,22,126048.23,26664.2,152712.43
410712,202209,42,30,12,36360,14544,50904
410715,202209,108,78,30,94536.32,36360,130896.32
410720,202209,651,357,294,432686.12,356329.28,789015.40
410725,202209,190,132,58,159984.47,70296,230280.47
410730,202209,106,45,61,54540.75,73932,128472.75
410740,202209,87,63,24,76357.33,29088.95,105446.28
410750,202209,288,187,101,226645.38,122412,349057.38
410752,202209,21,14,7,16968,8484,25452
410753,202209,63,23,40,27876,48480,76356
410754,202209,55,27,28,32725.28,33936,66661.28
410755,202209,76,39,37,47268.2,44844,92112.2
410760,202209,787,424,363,513888.93,439959.18,953848.11
410765,202209,1985,889,1096,1077492.73,1328377.77,2405870.50
410770,202209,122,82,40,99385.5,48482.32,147867.82
410773,202209,71,46,25,55753.02,30300,86053.02
410775,202209,183,132,51,159988.57,61812,221800.57
410780,202209,84,47,37,56964.64,44844,101808.64
410785,202209,52,43,9,52116,10908,63024
410790,202209,88,36,52,43632.8,63024,106656.8
410800,202209,299,186,113,225436.08,136957.36,362393.44
410810,202209,30,17,13,20604.16,15757.2,36361.36
410820,202209,152,107,45,129684.61,54540.9,184225.51
410830,202209,9448,3871,5577,4697420.55,6760596.57,11458017.12
410832,202209,118,74,44,89688.56,53328.36,143016.92
410840,202209,1449,777,672,941737,815679.21,1757416.21
410845,202209,58,32,26,38784.2,31512.49,70296.69
410850,202209,150,110,40,133323.41,48480,181803.41
410855,202209,78,70,8,84840.32,9696,94536.32
410860,202209,851,425,426,516318.02,517527.42,1033845.44
410865,202209,97,66,31,79993.13,37572,117565.13
410870,202209,143,116,27,140592.76,32724,173316.76
410880,202209,1204,583,621,706606.77,756291.67,1462898.44
410890,202209,111,69,42,83630.61,50904,134534.61
410895,202209,79,59,20,71508.35,24240.95,95749.30
410900,202209,30,23,7,27876.2,8484,36360.2
410910,202209,13,8,5,9696,6060,15756
410920,202209,43,27,16,32724,19392,52116
410930,202209,563,335,228,406022.77,276336.99,682359.76
410940,202209,4550,2319,2231,2811908.22,2705219.26,5517127.48
410950,202209,105,80,25,96962.42,30300.49,127262.91
410960,202209,973,371,602,449661.13,729634.54,1179295.67
410965,202209,64,43,21,52116,25452,77568
410970,202209,620,411,209,498138.11,254521.58,752659.69
410975,202209,126,78,48,94537.71,58176,152713.71
410980,202209,1663,747,916,905378.05,1110202.1,2015580.15
410990,202209,273,202,71,244824.77,86052.98,330877.75
411000,202209,62,33,29,39996.83,35149.62,75146.45
411005,202209,38,31,7,37572,8484,46056
411007,202209,253,146,107,176952.47,129684,306636.47
411010,202209,613,395,218,478747.31,264218.31,742965.62
411020,202209,286,174,112,210891.14,135745.31,346636.45
411030,202209,25,14,11,16968,13332,30300
411040,202209,63,39,24,47268,29088,76356
411050,202209,220,152,68,184224.8,82416.03,266640.83
411060,202209,544,370,174,449657.24,213313.79,662971.03
411065,202209,33,31,2,37573.14,2424,39997.14
411070,202209,1297,733,564,889615,684786.61,1574401.61
411080,202209,255,171,84,207252.03,101808.2,309060.23
411090,202209,90,66,24,79992.99,29088.96,109081.95
411095,202209,362,117,245,141804.7,296940.37,438745.07
411100,202209,111,85,26,103020.67,31512,134532.67
411110,202209,140,79,61,95748,73932.2,169680.2
411120,202209,203,131,72,158774.31,87264,246038.31
411125,202209,334,162,172,196346.59,208468.46,404815.05
411130,202209,115,98,17,118777.39,20604,139381.39
411140,202209,209,144,65,174528.19,78780,253308.19
411150,202209,1273,815,458,987786.92,556312.61,1544099.53
411155,202209,120,84,36,101808,43632,145440
411160,202209,34,13,21,15756,25452,41208
411170,202209,57,48,9,58176,10908,69084
411180,202209,1036,676,360,820540.86,437536.77,1258077.63
411190,202209,347,192,155,232704.79,187860,420564.79
411200,202209,674,366,308,443598.01,374511.97,818109.98
411210,202209,676,343,333,415718.38,404809.49,820527.87
411220,202209,167,115,52,139381.61,63025.4,202407.01
411230,202209,35,28,7,33936,8484.1,42420.1
411240,202209,111,71,40,86053.36,48480,134533.36
411250,202209,432,307,125,372085.44,151500,523585.44
411260,202209,14,10,4,12120,4848,16968
411270,202209,265,137,128,166049.94,155137.54,321187.48
411275,202209,193,163,30,197556.97,36360,233916.97
411280,202209,258,170,88,206043.25,106656,312699.25
411290,202209,67,52,15,63024.2,18180,81204.2
411295,202209,123,94,29,113929.65,35148.47,149078.12
411300,202209,83,39,44,47268,53328,100596
411310,202209,95,69,26,83628,31512,115140
411320,202209,842,518,324,629035.39,392690.79,1021726.18
411325,202209,66,46,20,55752.1,24240,79992.1
411330,202209,941,605,336,733277.09,409659.89,1142936.98
411340,202209,33,23,10,27876,12120,39996
411342,202209,60,45,15,54540,18180,72720
411345,202209,105,52,53,63024.67,64236.39,127261.06
411350,202209,526,391,135,473894.61,163622.22,637516.83
411360,202209,61,40,21,48481.06,25453.12,73934.18
411370,202209,14060,5719,8341,6938815.65,10121493.36,17060309.01
411373,202209,187,125,62,151500,75144,226644
411375,202209,82,67,15,81204.77,18180,99384.77
411380,202209,79,52,27,63024.95,32724.2,95749.15
411390,202209,148,80,68,98172,83628,181800
411400,202209,356,234,122,283615.36,147864,431479.36
411410,202209,531,246,285,298154.8,346632.53,644787.33
411420,202209,982,404,578,489653.93,701752.33,1191406.26
411430,202209,551,290,261,352700.96,316338.18,669039.14
411435,202209,29,20,9,24240,10908,35148
411440,202209,485,382,103,462986.09,124836,587822.09
411450,202209,399,325,74,393905.51,89688.09,483593.60
411460,202209,821,308,513,374512.26,621759.56,996271.82
411470,202209,108,74,34,89691.23,41208,130899.23
411480,202209,716,366,350,443601.39,424202.59,867803.98
411490,202209,283,174,109,210889.89,132108,342997.89
411500,202209,104,82,22,99384.27,26664,126048.27
411510,202209,229,175,54,213314.41,65448.35,278762.76
411520,202209,6402,2173,4229,2636122.31,5126793.89,7762916.20
411530,202209,124,81,43,98172.49,52116,150288.49
411535,202209,47,15,32,18180.1,38784,56964.1
411540,202209,389,256,133,310274.57,161198.23,471472.80
411545,202209,60,44,16,53328.39,19392,72720.39
411550,202209,89,69,20,83628,24240,107868
411560,202209,400,166,234,201194.34,283608.15,484802.49
411570,202209,1008,336,672,407236.16,814473.34,1221709.50
411573,202209,24,15,9,18180.2,10908,29088.2
411575,202209,313,191,122,232706.33,147864,380570.33
411580,202209,1292,454,838,550252.95,1015662.11,1565915.06
411585,202209,76,37,39,44844,47268,92112
411590,202209,15,9,6,10908,7272,18180
411600,202209,17,7,10,8484.2,12120.7,20604.9
411605,202209,177,69,108,83628.51,130896.58,214525.09
411610,202209,242,152,90,185438.01,109080.2,294518.21
411620,202209,397,188,209,227859.9,253314.48,481174.38
411630,202209,48,34,14,41208.8,16968.99,58177.79
411640,202209,31,21,10,26664,12120,38784
411650,202209,7,4,3,4848,3636,8484
411660,202209,43,31,12,37572,14544,52116
411670,202209,238,163,75,198770.65,90900,289670.65
411680,202209,159,125,34,153924.89,41208,195132.89
411690,202209,664,342,322,414504.61,390267.28,804771.89
411695,202209,66,45,21,54540.2,25452,79992.2
411700,202209,144,114,30,139383.24,36360,175743.24
411705,202209,100,66,34,79993.16,41208.3,121201.46
411710,202209,296,198,98,239976.84,118776.95,358753.79
411720,202209,150,98,52,118776.96,63024.2,181801.16
411721,202209,90,69,21,83628,25452,109080
411722,202209,106,51,55,61812.61,66660,128472.61
411725,202209,169,119,50,144228,60600,204828
411727,202209,100,80,20,96961.61,24240.2,121201.81
411729,202209,52,40,12,48480.01,14544,63024.01
411730,202209,576,366,210,443596.74,254521.15,698117.89
411740,202209,29,17,12,20604,14544.12,35148.12
411745,202209,67,51,16,63024,19392,82416
411750,202209,855,346,509,419355.61,618122.73,1037478.34
411760,202209,1272,903,369,1094462.48,448448.39,1542910.87
411770,202209,423,271,152,328453.88,184224.6,512678.48
411780,202209,377,243,134,294517.45,162408.21,456925.66
411790,202209,597,339,258,410872.43,312696,723568.43
411800,202209,160,116,44,140593.36,53328.38,193921.74
411810,202209,180,135,45,163620.8,54540.89,218161.69
411820,202209,2589,1021,1568,1237483.32,1904087.66,3141570.98
411830,202209,17,14,3,16968,3636,20604
411840,202209,2232,1306,926,1583495.09,1122326.56,2705821.65
411845,202209,64,21,43,25452.9,52116,77568.9
411850,202209,1274,677,597,820539.66,724782.57,1545322.23
411860,202209,59,35,24,42420.81,29088,71508.81
411870,202209,69,43,26,52116,31512,83628
411880,202209,422,247,175,299370.36,212101.26,511471.62
411885,202209,109,67,42,81204.2,50905.33,132109.53
411890,202209,332,232,100,281186.7,122413.68,403600.38
411900,202209,108,78,30,94536.18,36360,130896.18
411910,202209,213,143,70,174528.84,84841.33,259370.17
411915,202209,2469,960,1509,1164746.87,1830148.91,2994895.78
411920,202209,114,86,28,104233.27,33936.98,138170.25
411925,202209,18,11,7,13332.59,8484,21816.59
411930,202209,803,543,260,659418.92,315122.98,974541.90
411940,202209,610,383,227,464199.92,275124.6,739324.52
411950,202209,1240,558,682,677517.83,830237.72,1507755.55
411960,202209,1158,715,443,866588.62,536916.49,1403505.11
411965,202209,23,14,9,16968.5,10908,27876.5
411970,202209,91,78,13,94537.57,15756,110293.57
411980,202209,224,116,108,140592.78,130896,271488.78
411990,202209,5373,2847,2526,3451759.77,3061651.32,6513411.09
411995,202209,626,180,446,218163.65,540564.88,758728.53
412000,202209,331,216,115,261796.76,139382.44,401179.20
412010,202209,58,31,27,37572,32724,70296
412015,202209,36,29,7,35148.1,8484,43632.1
412020,202209,23,18,5,21816.89,6060,27876.89
412030,202209,37,34,3,41208,3636,44844
412033,202209,50,27,23,32724.83,27876,60600.83
412035,202209,69,44,25,53328,30300,83628
412040,202209,33,15,18,18180.6,21816,39996.6
412050,202209,219,157,62,191497.82,75144.56,266642.38
412060,202209,797,570,227,692060.94,275126.42,967187.36
412065,202209,59,31,28,37572,33936,71508
412070,202209,166,116,50,141805.7,60600,202405.7
412080,202209,343,167,176,202405.94,213314.97,415720.91
412085,202209,40,15,25,18180.59,30300,48480.59
412090,202209,868,528,340,641156.3,412082.91,1053239.21
412100,202209,260,219,41,265436.82,50904,316340.82
412110,202209,75,56,19,67873.2,23028,90901.2
412120,202209,359,190,169,230284.22,204829.1,435113.32
412125,202209,74,42,32,50904.2,38784,89688.2
412130,202209,47,29,18,35148.74,21816,56964.74
412135,202209,30,18,12,21816,14544,36360
412140,202209,451,287,164,349056.8,198769.45,547826.25
412150,202209,245,152,93,184224.87,112716.9,296941.77
412160,202209,79,51,28,61812,33936,95748
412170,202209,721,473,248,573278.51,300577.99,873856.50
412175,202209,41,26,15,31512.15,18180.08,49692.23
412180,202209,165,123,42,149076.8,50904.2,199981.0
412190,202209,333,262,71,318759.02,86052,404811.02
412200,202209,190,113,77,136956.35,93324,230280.35
412210,202209,95,72,23,87264,27876.73,115140.73
412215,202209,243,163,80,197556.52,96960.98,294517.50
412217,202209,65,50,15,60600.93,18180,78780.93
412220,202209,856,556,300,673887.49,364819.37,1038706.86
412230,202209,280,168,112,203619.38,135747.92,339367.30
412240,202209,1387,686,701,831441.32,849619.9,1681061.22
412250,202209,411,250,161,303001.01,195132,498133.01
412260,202209,129,80,49,96960.89,59388.2,156349.09
412265,202209,169,127,42,153924.83,50904,204828.83
412270,202209,93,57,36,69084.8,43632,112716.8
412280,202209,80,62,18,75144,21816,96960
412290,202209,87,54,33,65448.46,39996,105444.46
412300,202209,205,146,59,176952.37,71508,248460.37
412310,202209,55,42,13,50905.8,15756,66661.8
412320,202209,91,70,21,84842.3,25452,110294.3
412330,202209,197,152,45,184225.79,54540,238765.79
412340,202209,179,115,64,139380.98,77568,216948.98
412350,202209,679,303,376,367238.59,455713.46,822952.05
412360,202209,21,18,3,21816,3636,25452
412370,202209,142,117,25,141806.21,30300,172106.21
412380,202209,193,146,47,176953.2,56964,233917.2
412382,202209,62,32,30,38784,36360,75144
412385,202209,156,112,44,135745.69,53328,189073.69
412390,202209,323,244,79,295733.19,95750.79,391483.98
412395,202209,67,53,14,64236,16968,81204
412400,202209,101,66,35,79994.11,42420,122414.11
412402,202209,236,126,110,152712.6,133320,286032.6
412405,202209,979,318,661,385417.83,801132.4,1186550.23
412410,202209,1005,595,410,721778.57,498135.81,1219914.38
412420,202209,16,16,0,19392,,19392.0
412430,202209,25,23,2,27876.2,2424,30300.2
412440,202209,668,329,339,398753.73,410869.17,809622.90
412450,202209,66,58,8,70296.3,9696,79992.3
412460,202209,75,53,22,64236.4,26664,90900.4
412470,202209,219,174,45,210891.41,54540.11,265431.52
412480,202209,153,110,43,133321.62,52116.2,185437.82
412490,202209,173,148,25,179376.88,30300,209676.88
412500,202209,399,313,86,379361.44,104233.28,483594.72
412510,202209,171,140,31,169682.14,37572.92,207255.06
412520,202209,90,59,31,71508,37572,109080
412530,202209,104,49,55,59388.32,66660,126048.32
412535,202209,73,56,17,67873.47,20604.96,88478.43
412540,202209,46,25,21,30300,25452.77,55752.77
412545,202209,82,56,26,67873.35,31512,99385.35
412550,202209,4233,1721,2512,2087100.06,3047009.62,5134109.68
412555,202209,9,6,3,7272,3636,10908
412560,202209,684,451,233,547829.52,282396.2,830225.72
412570,202209,841,387,454,470261.43,550250.41,1020511.84
412575,202209,94,67,27,81205.39,32724,113929.39
412580,202209,175,117,58,141807.81,70297.61,212105.42
412590,202209,35,30,5,36361.85,6060,42421.85
412600,202209,196,140,56,169682.59,67872.83,237555.42
412610,202209,39,17,22,20604,26664,47268
412620,202209,125,103,22,124839.94,26664.6,151504.54
412625,202209,2148,1016,1132,1231407.39,1373202.67,2604610.06
412627,202209,65,47,18,56964,21816,78780
412630,202209,381,259,122,313915.29,147865.19,461780.48
412635,202209,78,24,54,29088,65448,94536
412640,202209,108,78,30,94536.2,36360,130896.2
412650,202209,323,209,114,253312.07,138168,391480.07
412660,202209,580,307,273,372084.6,330877.69,702962.29
412665,202209,43,39,4,47268,4848,52116
412667,202209,280,179,101,216950.95,122412,339362.95
412670,202209,76,59,17,71508.2,20604,92112.2
412680,202209,328,248,80,300582.75,96960.6,397543.35
412690,202209,127,83,44,100597,53328,153925
412700,202209,190,122,68,147864.16,82416.23,230280.39
412710,202209,1377,770,607,933253.01,739325.36,1672578.37
412720,202209,231,130,101,157560.19,122412.32,279972.51
412730,202209,210,178,32,215737.53,38784.99,254522.52
412740,202209,416,206,210,249674.55,254520,504194.55
412750,202209,412,227,185,276338.38,226644.52,502982.90
412760,202209,362,183,179,221799.23,216950.2,438749.43
412770,202209,2130,1138,992,1380484.98,1203521.34,2584006.32
412780,202209,145,104,41,126050.89,49692,175742.89
412785,202209,324,165,159,199981.8,192708.02,392689.82
412788,202209,50,30,20,36360.82,24240,60600.82
412790,202209,127,103,24,124837.57,29088,153925.57
412795,202209,143,100,43,121200.2,53328,174528.2
412796,202209,309,192,117,232704.7,141804,374508.7
412800,202209,701,403,298,488437.89,361176.66,849614.55
412810,202209,3165,1715,1450,2079833.46,1761056.13,3840889.59
412820,202209,1021,593,428,718730.75,518745.4,1237476.15
412830,202209,14,13,1,15756,1212,16968
412840,202209,279,188,91,227856,110292,338148
412850,202209,591,392,199,475107.77,241190.93,716298.70
412853,202209,171,80,91,96960,110292,207252
412855,202209,195,106,89,128473.45,107868,236341.45
412860,202209,96,65,31,78782.29,37573.18,116355.47
412862,202209,84,51,33,61812,39996,101808
412863,202209,10,7,3,8484,3636,12120
412865,202209,47,35,12,42420,14544,56964
412870,202209,111,69,42,83630.03,50904.46,134534.49
412880,202209,99,68,31,82419.71,37572,119991.71
420005,202209,44,37,7,46056.45,8484,54540.45
420010,202209,364,240,124,290882.86,150288.39,441171.25
420020,202209,99,75,24,90900.55,29088,119988.55
420030,202209,27,22,5,26664,6060,32724
420040,202209,94,72,22,87264.83,26664,113928.83
420050,202209,59,39,20,47268.16,24240,71508.16
420055,202209,16,15,1,18180.99,1212,19392.99
420060,202209,27,20,7,24240,8484.2,32724.2
420070,202209,104,88,16,106656,19392,126048
420075,202209,10,10,0,12120,,12120.0
420080,202209,41,35,6,42420,7272,49692
420090,202209,36,29,7,35148.66,8484.2,43632.86
420100,202209,155,130,25,157560.9,30300,187860.9
420110,202209,22,21,1,25452,1212.59,26664.59
420120,202209,60,42,18,50904.31,21816.2,72720.51
420125,202209,80,60,20,72720,24240,96960
420127,202209,37,32,5,38784,6060,44844
420130,202209,493,298,195,362396.47,236345.4,598741.87
420140,202209,1383,767,616,929616.78,746607.91,1676224.69
420150,202209,48,36,12,43632,14544,58176
420160,202209,32,29,3,35148.19,3636,38784.19
420165,202209,17,12,5,14544,6060.3,20604.3
420170,202209,71,43,28,52116,33936.59,86052.59
420180,202209,23,20,3,24240,3636,27876
420190,202209,25,22,3,26664,3636,30300
420195,202209,132,58,74,70297.47,89690.48,159987.95
420200,202209,1361,568,793,690847.33,962341.65,1653188.98
420205,202209,117,68,49,82417.01,59388.56,141805.57
420207,202209,139,77,62,93325.06,75144,168469.06
420208,202209,18,14,4,16968,4848,21816
420209,202209,13,11,2,13332.58,2424,15756.58
420210,202209,594,279,315,338150.04,381782.07,719932.11
420213,202209,56,40,16,48480,19392.2,67872.2
420215,202209,27,24,3,29088.59,3636,32724.59
420220,202209,60,38,22,46056.6,26664,72720.6
420230,202209,986,594,392,719942.34,475108.21,1195050.55
420240,202209,2343,1543,800,1872557.65,969607.73,2842165.38
420243,202209,43,34,9,41208.44,10908,52116.44
420245,202209,212,101,111,122413.33,134535.14,256948.47
420250,202209,61,41,20,49692.99,24240,73932.99
420253,202209,23,16,7,19393.72,8484,27877.72
420257,202209,14,9,5,10908,6060,16968
420260,202209,125,100,25,121200.79,30300.14,151500.93
420270,202209,33,24,9,29088.2,10908,39996.2
420280,202209,285,211,74,255738,89689.48,345427.48
420285,202209,23,18,5,21816,6060,27876
420287,202209,48,31,17,37572,20604,58176
420290,202209,934,638,296,774472.5,359964.83,1134437.33
420300,202209,1627,1293,334,1567147.83,404814.87,1971962.70
420310,202209,46,33,13,39996,15756,55752
420315,202209,27,22,5,26664.68,6060.5,32725.18
420320,202209,1028,483,545,585405.67,661760.52,1247166.19
420325,202209,4,2,2,2424,2424.8,4848.8
420330,202209,115,75,40,90900.34,48480,139380.34
420340,202209,192,128,64,155137,77568.3,232705.3
420350,202209,261,182,79,220589.66,95748.8,316338.46
420360,202209,695,535,160,649641.73,193921,843562.73
420370,202209,133,71,62,86052.84,75144.43,161197.27
420380,202209,1233,838,395,1016888.06,479955.75,1496843.81
420390,202209,233,163,70,197558.28,84840.4,282398.68
420395,202209,190,138,52,167258.45,63025.94,230284.39
420400,202209,226,173,53,210891.67,64236.2,275127.87
420410,202209,54,40,14,48481.32,16968,65449.32
420415,202209,32,26,6,31512.96,7272,38784.96
420417,202209,63,49,14,59388,16968,76356
420419,202209,11,10,1,13332,1212,14544
420420,202209,2913,1811,1102,2197393.79,1335633.79,3533027.58
420425,202209,68,51,17,61812.58,20604.19,82416.77
420430,202209,1051,761,290,922340.25,351480.3,1273820.55
420435,202209,13,11,2,13332,2424,15756
420440,202209,93,65,28,78780.6,33936,112716.6
420445,202209,30,27,3,32724.7,3636,36360.7
420450,202209,82,44,38,53328.8,46056,99384.8
420455,202209,184,143,41,173319.45,49692,223011.45
420460,202209,2359,1460,899,1769549.4,1089599.49,2859148.89
420470,202209,89,59,30,71508,36360,107868
420475,202209,10,9,1,10908,1212,12120
420480,202209,888,676,212,820547.44,259370.08,1079917.52
420490,202209,98,74,24,90901.6,29088.61,119990.21
420500,202209,398,234,164,283613.06,199980.2,483593.26
420510,202209,25,21,4,26664.68,4848,31512.68
420515,202209,27,15,12,18180.02,14544,32724.02
420517,202209,10,8,2,9696,2424,12120
420519,202209,0,0,0,,,0.0
420520,202209,59,44,15,54541.99,18180,72721.99
420530,202209,140,88,52,106656.4,63024.4,169680.8
420535,202209,15,13,2,15756,2424,18180
420540,202209,6551,4074,2477,4942702.8,3005788.31,7948491.11
420543,202209,31,29,2,35148.88,2424,37572.88
420545,202209,210,146,64,178167.9,77568,255735.9
420550,202209,771,641,130,776911.79,158773.72,935685.51
420555,202209,29,22,7,26664.5,8484,35148.5
420560,202209,61,47,14,56964.02,16968,73932.02
420570,202209,208,98,110,118777.95,133321.76,252099.71
420580,202209,308,150,158,181802.17,191497,373299.17
420590,202209,486,310,176,375724.68,213312.55,589037.23
420600,202209,148,81,67,98172.5,81204,179376.5
420610,202209,36,33,3,39996,3636,43632
420620,202209,80,59,21,71509.17,25452.65,96961.82
420630,202209,152,100,52,121201.58,63024,184225.58
420640,202209,68,58,10,70296,12120,82416
420650,202209,293,152,141,184225.2,170893.4,355118.6
420660,202209,41,31,10,37572,12120,49692
420665,202209,43,27,16,32724.2,19392,52116.2
420670,202209,236,180,56,218166.98,67872,286038.98
420675,202209,14,12,2,14544,2424,16968
420680,202209,33,28,5,33936,6060,39996
420690,202209,203,153,50,185436.5,60600.34,246036.84
420700,202209,717,471,246,570865.53,298155.88,869021.41
420710,202209,140,75,65,90900.2,78780.44,169680.64
420720,202209,94,75,19,90901.29,23028.1,113929.39
420730,202209,709,424,285,515107.77,345427.49,860535.26
420740,202209,57,56,1,67872,1212,69084
420750,202209,496,326,170,395114.72,206041.11,601155.83
420757,202209,19,16,3,19392,3636,23028
420760,202209,39,29,10,35148.2,12120,47268.2
420765,202209,73,51,22,61812.8,26664,88476.8
420768,202209,58,47,11,56966.05,13332,70298.05
420770,202209,69,60,9,72720.9,10908,83628.9
420775,202209,36,32,4,38785,4848,43633
420780,202209,197,153,44,185437.45,53328,238765.45
420785,202209,24,16,8,19392,9696,29088
420790,202209,137,112,25,135744.12,30300,166044.12
420800,202209,61,47,14,56964,16968,73932
420810,202209,282,217,65,263006.93,78780.8,341787.73
420820,202209,2570,1422,1148,1724701.88,1393814.51,3118516.39
420830,202209,704,373,331,452087.39,402397.24,854484.63
420840,202209,132,91,41,110292.8,49692,159984.8
420845,202209,439,187,252,226646.87,305426.87,532073.74
420850,202209,266,204,62,247249.14,75144,322393.14
420860,202209,58,49,9,59389.52,10908,70297.52
420870,202209,130,91,39,110292,47268,157560
420880,202209,188,120,68,145441.39,82416.6,227857.99
420890,202209,976,470,506,572069.16,615697.36,1187766.52
420895,202209,7,7,0,8484,,8484.0
420900,202209,422,343,79,415720.87,96960,512680.87
420910,202209,5995,3253,2742,3947546.06,3324552.84,7272098.90
420915,202209,59,53,6,64236,7272,71508
420917,202209,21,16,5,19392.23,6060,25452.23
420920,202209,22,15,7,18180,8484,26664
420930,202209,3328,2184,1144,2646989.41,1387767,4034756.41
420940,202209,587,414,173,502996.79,209680.06,712676.85
420945,202209,9,7,2,8484,2424,10908
420950,202209,46,33,13,39996,15756.74,55752.74
420960,202209,111,89,22,107872.19,26664.1,134536.29
420970,202209,282,226,56,273917.46,67872.93,341790.39
420980,202209,23,22,1,26664,1212,27876
420985,202209,52,45,7,54540,8484,63024
420990,202209,86,65,21,78780.2,25452.38,104232.58
421000,202209,59,31,28,37572,33936.4,71508.4
421003,202209,34,24,10,29088,12120,41208
421005,202209,8,6,2,7272.8,2424,9696.8
421010,202209,873,564,309,683580.36,374513.2,1058093.56
421020,202209,20,17,3,20604,3636,24240
421030,202209,118,98,20,118777.5,24240.2,143017.7
421040,202209,65,44,21,53329.16,25452.57,78781.73
421050,202209,320,224,96,271489.44,116352,387841.44
421055,202209,17,13,4,15756,4848,20604
421060,202209,104,60,44,72720.53,53328,126048.53
421070,202209,40,36,4,43633.18,4848,48481.18
421080,202209,42,35,7,42420.98,8484,50904.98
421085,202209,19,15,4,18180,4848,23028
421090,202209,37,29,8,35148.11,9696,44844.11
421100,202209,113,87,26,105444.21,31512.95,136957.16
421105,202209,191,152,39,185440.05,47268.2,232708.25
421110,202209,123,89,34,107868,41208,149076
421120,202209,178,129,49,156350.23,59388,215738.23
421125,202209,16,9,7,10908,8484.11,19392.11
421130,202209,848,514,334,624184.2,404813.27,1028997.47
421140,202209,34,24,10,29088.78,12120,41208.78
421145,202209,43,37,6,44844,7272,52116
421150,202209,83,63,20,76356.62,24240.97,100597.59
421160,202209,62,37,25,44844,30300.7,75144.7
421165,202209,13,10,3,12120,3636,15756
421170,202209,165,139,26,168615.52,31513.5,200129.02
421175,202209,188,135,53,163622.3,64236.89,227859.19
421180,202209,39,27,12,32724.56,14544,47268.56
421185,202209,16,13,3,15756,3636,19392
421187,202209,4,3,1,3636.8,1212,4848.8
421189,202209,45,32,13,38785,15756,54541
421190,202209,1974,1246,728,1511388.92,885985.21,2397374.13
421200,202209,94,65,29,78782.19,35148,113930.19
421205,202209,27,19,8,23029.64,9696,32725.64
421210,202209,175,127,48,153924.72,58176,212100.72
421220,202209,256,197,59,238766.98,71509.36,310276.34
421223,202209,48,38,10,46057.7,12120,58177.7
421225,202209,69,46,23,55752.21,27877.51,83629.72
421227,202209,65,54,11,65448.79,13332,78780.79
421230,202209,69,45,24,54540.99,29088,83628.99
421240,202209,19,16,3,19392.6,3636,23028.6
421250,202209,399,228,171,276338.73,207259.08,483597.81
421260,202209,21,16,5,19392,6060,25452
421265,202209,7,5,2,6060,2424,8484
421270,202209,53,48,5,58176,6060,64236
421280,202209,381,193,188,233919.69,227857.02,461776.71
421290,202209,321,212,109,256945.88,132108.72,389054.60
421300,202209,21,19,2,23028,2424,25452
421310,202209,47,33,14,39996.78,16968,56964.78
421315,202209,31,18,13,21816,15756.08,37572.08
421320,202209,140,93,47,112716.91,56964,169680.91
421330,202209,111,83,28,100596.13,33936,134532.13
421335,202209,46,33,13,39997.71,15756,55753.71
421340,202209,236,157,79,191498.2,95748,287246.2
421350,202209,183,106,77,128474.27,93324.25,221798.52
421360,202209,726,499,227,604793.85,275128.04,879921.89
421370,202209,193,143,50,173316.82,60600.83,233917.65
421380,202209,152,113,39,138169.15,47268,185437.15
421390,202209,15,10,5,12120,6060,18180
421400,202209,121,99,22,119988.15,26664,146652.15
421410,202209,21,18,3,21816,3636,25452
421415,202209,19,16,3,19392,3636,23028
421420,202209,101,85,16,103020.2,19392,122412.2
421430,202209,21,13,8,15756,9696,25452
421440,202209,60,52,8,63024.2,9696,72720.2
421450,202209,82,69,13,83629.46,15756,99385.46
421460,202209,56,44,12,53328,14544,67872
421470,202209,72,39,33,47268.2,39996,87264.2
421480,202209,774,580,194,702964.8,235129.3,938094.1
421490,202209,24,23,1,27876.18,1212,29088.18
421500,202209,475,280,195,339366.81,237552.54,576919.35
421505,202209,35,27,8,32724.6,9696,42420.6
421507,202209,30,24,6,29088,7272,36360
421510,202209,67,43,24,52116,29088,81204
421520,202209,52,43,9,52116.4,10908,63024.4
421530,202209,50,43,7,52116.2,8484,60600.2
421535,202209,23,22,1,26664,1212,27876
421540,202209,48,37,11,44844,13332,58176
421545,202209,80,56,24,69086.68,29088.4,98175.08
421550,202209,289,206,83,249680.07,100597.61,350277.68
421555,202209,14,12,2,14544.75,2424,16968.75
421560,202209,8,7,1,8484,1212,9696
421565,202209,126,82,44,99384.9,53328.15,152713.05
421567,202209,35,26,9,31512,10908,42420
421568,202209,42,40,2,48480,2424,50904
421569,202209,10,10,0,12120,,12120.0
421570,202209,252,161,91,195133.57,110292,305425.57
421575,202209,27,24,3,29088,3636,32724
421580,202209,728,426,302,516395.48,367238.33,883633.81
421590,202209,19,17,2,21816,2424,24240
421600,202209,172,121,51,146652.6,61812,208464.6
421605,202209,105,70,35,84840.64,42420.2,127260.84
421610,202209,173,128,45,155136.89,54540,209676.89
421620,202209,1067,611,456,741763.58,553895.5,1295659.08
421625,202209,21,19,2,23028.71,2424,25452.71
421630,202209,362,220,142,266642.28,172108.58,438750.86
421635,202209,21,9,12,10908,14544,25452
421640,202209,97,79,18,96961.77,21816,118777.77
421650,202209,314,183,131,221803.47,161199.67,383003.14
421660,202209,2606,1579,1027,1914648,1244740.17,3159388.17
421670,202209,162,118,44,143016.04,53328,196344.04
421680,202209,193,173,20,209677.46,24240,233917.46
421690,202209,350,239,111,290882.74,134532.2,425414.94
421700,202209,59,39,20,47268,24240.2,71508.2
421710,202209,20,20,0,24240,,24240.0
421715,202209,5,4,1,4848,1212,6060
421720,202209,651,436,215,529651.57,261794.28,791445.85
421725,202209,24,8,16,9696,19392.2,29088.2
421730,202209,24,18,6,21816,7272,29088
421740,202209,113,43,70,53328.94,84840,138168.94
421750,202209,191,139,52,168468.29,63024,231492.29
421755,202209,18,16,2,19392,2424,21816
421760,202209,102,70,32,84840.63,38784,123624.63
421770,202209,706,453,253,549041.74,306639.24,855680.98
421775,202209,29,19,10,23028.97,12120,35148.97
421780,202209,188,145,43,175740,52116,227856
421790,202209,153,131,22,158772.56,26664.66,185437.22
421795,202209,16,13,3,15756.13,3636,19392.13
421800,202209,552,331,221,401184.88,267856.09,669040.97
421810,202209,68,55,13,66661.21,15756,82417.21
421820,202209,301,189,112,229068.98,135744,364812.98
421825,202209,148,123,25,149078.86,30300.06,179378.92
421830,202209,155,95,60,115143.68,72721,187864.68
421835,202209,7,2,5,2424.19,6060,8484.19
421840,202209,40,33,7,39996.58,8484,48480.58
421850,202209,76,63,13,76356.5,15756,92112.5
421860,202209,36,26,10,31512.2,12120,43632.2
421870,202209,1122,809,313,980525.72,379364.93,1359890.65
421875,202209,48,38,10,46056,12120,58176
421880,202209,189,133,56,161196.47,67872.7,229069.17
421885,202209,21,16,5,19392,6060,25452
421890,202209,155,112,43,135744.47,52116.77,187861.24
421895,202209,45,39,6,47269.7,7272,54541.7
421900,202209,126,96,30,116355.47,36360,152715.47
421910,202209,63,40,23,48480,27876,76356
421915,202209,30,24,6,30300,7272,37572
421917,202209,49,38,11,46056.4,13332,59388.4
421920,202209,35,30,5,36360,6060,42420
421930,202209,623,500,123,607223.74,149076.27,756300.01
421935,202209,44,37,7,44844,8484,53328
421940,202209,52,45,7,54541.2,8484,63025.2
421950,202209,910,603,307,730842.23,372086,1102928.23
421960,202209,41,34,7,41208.76,8484,49692.76
421970,202209,322,206,116,249674.43,140593.39,390267.82
421985,202209,19,12,7,14544,8484,23028
422000,202209,9,5,4,6060.67,4848.9,10909.57
430003,202209,182,54,128,66660,155136,221796
430005,202209,31,23,8,27876.67,9696,37572.67
430010,202209,252,183,69,221798.41,83628,305426.41
430020,202209,137,96,41,116352.92,49692,166044.92
430030,202209,120,98,22,118776,26664,145440
430040,202209,2953,1760,1193,2135571.06,1448343.72,3583914.78
430045,202209,71,62,9,75144,10908,86052
430047,202209,6,5,1,6060,1212,7272
430050,202209,88,76,12,92112.42,14544,106656.42
430055,202209,13,12,1,14544,1212,15756
430057,202209,5,3,2,3636,2424,6060
430060,202209,4114,2376,1738,2882171.5,2110105.63,4992277.13
430063,202209,50,41,9,49692,10908,60600
430064,202209,167,131,36,158772,43632,202404
430066,202209,5,2,3,2424,3636,6060
430070,202209,46,34,12,41208.28,14544,55752.28
430080,202209,81,52,29,64236,35148,99384
430085,202209,30,15,15,18180.6,18180,36360.6
430087,202209,29,23,6,27876.8,7272,35148.8
430090,202209,68,57,11,69084.76,13332,82416.76
430100,202209,144,98,46,118776,55752,174528
430105,202209,162,91,71,110293.83,87264.9,197558.73
430107,202209,17,13,4,16968.53,4848,21816.53
430110,202209,492,268,224,324816.3,271488,596304.3
430120,202209,159,145,14,175740.1,16968,192708.1
430130,202209,814,485,329,587822.92,398748.06,986570.98
430140,202209,134,124,10,150288,12120,162408
430150,202209,110,68,42,82416,50904,133320
430155,202209,30,24,6,29088,7272,36360
430160,202209,3694,2095,1599,2539171.77,1941633.39,4480805.16
430163,202209,414,197,217,238766.23,264218.54,502984.77
430165,202209,32,20,12,24240.59,14544,38784.59
430170,202209,81,67,14,81204.2,16968,98172.2
430175,202209,80,62,18,75144,21816.7,96960.7
430180,202209,109,86,23,104232,27876,132108
430185,202209,27,19,8,23028,9696,32724
430187,202209,71,32,39,38784.33,47268,86052.33
430190,202209,228,115,113,140592.44,136957.59,277550.03
430192,202209,14,10,4,12120,4848,16968
430195,202209,17,13,4,15756,4848,20604
430200,202209,155,130,25,157560.8,30300,187860.8
430205,202209,21,21,0,25452,,25452.0
430210,202209,742,549,193,665393.67,233917,899310.67
430215,202209,10,9,1,10908,1212,12120
430220,202209,77,52,25,63024,30300,93324
430222,202209,14,6,8,7272,9696,16968
430223,202209,16,11,5,13332,6060,19392
430225,202209,3,2,1,2424,1212,3636
430230,202209,341,213,128,258157.8,155136,413293.8
430235,202209,55,34,21,41208,25452,66660
430237,202209,21,16,5,19392,6060,25452
430240,202209,113,77,36,93324.22,43632,136956.22
430245,202209,69,55,14,66660,16968,83628
430250,202209,189,109,80,132108,96960.84,229068.84
430258,202209,12,10,2,12120,2424,14544
430260,202209,35,30,5,36360,6060,42420
430265,202209,36,31,5,37572,6060,43632
430270,202209,525,375,150,454507.95,181800,636307.95
430280,202209,1073,623,450,755079.27,545400.5,1300479.77
430290,202209,447,227,220,275124.98,267852,542976.98
430300,202209,2168,1172,996,1421697.39,1208374.46,2630071.85
430310,202209,2161,1060,1101,1287166.03,1335643.05,2622809.08
430320,202209,58,46,12,55752,14544,70296
430330,202209,85,73,12,88476.16,14544,103020.16
430340,202209,67,52,15,63024,18180,81204
430350,202209,1675,1072,603,1300482.53,730836.07,2031318.60
430355,202209,19,17,2,20604,2424,23028
430360,202209,95,46,49,55752,59388,115140
430367,202209,48,36,12,43632,14544,58176
430370,202209,61,53,8,64236,9696,73932
430380,202209,112,82,30,99385.74,36360,135745.74
430390,202209,603,370,233,448447.32,283610,732057.32
430400,202209,255,176,79,213313.57,95748,309061.57
430410,202209,57,46,11,55752.2,13332,69084.2
430420,202209,528,334,194,404812.35,235128.89,639941.24
430430,202209,49,47,2,56156.8,2424,58580.8
430435,202209,149,112,37,135744,44844,180588
430440,202209,581,359,222,435111.7,270276.7,705388.4
430450,202209,1228,997,231,1209583.44,279973.48,1489556.92
430460,202209,5947,3042,2905,3690579.89,3525745.64,7216325.53
430461,202209,18,16,2,19392,2424,21816
430462,202209,4,2,2,3636.1,2424,6060.1
430463,202209,1207,637,570,772049.46,692056.4,1464105.86
430465,202209,28,17,11,20604,13332,33936
430466,202209,711,499,212,604801.86,256949.07,861750.93
430467,202209,125,71,54,86052.5,65448,151500.5
430468,202209,143,80,63,96960,76356.24,173316.24
430469,202209,22,16,6,19392,7272,26664
430470,202209,1195,642,553,778468.43,670237.69,1448706.12
430471,202209,75,51,24,61812,29088.57,90900.57
430480,202209,128,91,37,110292.64,44844,155136.64
430485,202209,8,8,0,9696.6,,9696.6
430490,202209,73,58,15,70296.26,18180,88476.26
430495,202209,34,24,10,29088,12120,41208
430500,202209,195,133,62,161196.77,75144,236340.77
430510,202209,3903,2544,1359,3086980.89,1649537.03,4736517.92
430511,202209,14,14,0,16968,,16968.0
430512,202209,165,113,52,136956.93,64236.46,201193.39
430513,202209,54,41,13,49692,15756,65448
430515,202209,25,24,1,29088,1212,30300
430517,202209,176,145,31,175740,37572,213312
430520,202209,344,242,102,293306.57,123624.1,416930.67
430530,202209,76,41,35,49692,42420,92112
430535,202209,464,298,166,361177.83,202405.37,563583.20
430537,202209,8,8,0,9696,,9696.0
430540,202209,82,55,27,66660,32724,99384
430543,202209,418,137,281,166044.96,340572.01,506616.97
430544,202209,51,46,5,55752.62,6060,61812.62
430545,202209,413,197,216,238770.31,261798.97,500569.28
430550,202209,44,36,8,43632.1,9696,53328.1
430558,202209,1,1,0,1212,,1212.0
430560,202209,54,31,23,37572,27876,65448
430570,202209,123,52,71,63024.2,86052,149076.2
430580,202209,122,97,25,118776,30300,149076
430583,202209,14,14,0,16968,,16968.0
430585,202209,14,11,3,13332,3636,16968
430587,202209,15,9,6,10908,7272.2,18180.2
430590,202209,177,141,36,170892.82,43632,214524.82
430593,202209,1,1,0,1212,,1212.0
430595,202209,16,13,3,15756,3636,19392
430597,202209,44,26,18,31512.1,21816,53328.1
430600,202209,222,167,55,203616,66660,270276
430605,202209,178,103,75,124836,90900,215736
430607,202209,28,22,6,26664,7272,33936
430610,202209,1782,847,935,1026567.61,1134437.8,2161005.41
430613,202209,5,5,0,6060,,6060.0
430620,202209,94,69,25,83628,31512,115140
430630,202209,45,39,6,47268.95,7272,54540.95
430632,202209,33,28,5,33936,6060,39996
430635,202209,34,28,6,33936,7272,41208
430637,202209,66,31,35,37572,42420,79992
430640,202209,172,93,79,112716.2,95748.54,208464.74
430642,202209,20,18,2,21816,2424,24240
430645,202209,32,26,6,31512,7272,38784
430650,202209,243,192,51,232704.6,61812,294516.6
430655,202209,6,4,2,4848,2424,7272
430660,202209,996,495,501,601156.55,608429.81,1209586.36
430670,202209,69,46,23,55752,27876,83628
430673,202209,87,59,28,71508,33936,105444
430675,202209,8,6,2,7272,2424,9696
430676,202209,625,376,249,455713.61,301789.69,757503.30
430680,202209,257,165,92,199980.6,111504,311484.6
430690,202209,557,339,218,412081.66,264217.95,676299.61
430692,202209,9,7,2,8484.2,2424,10908.2
430693,202209,141,89,52,107868,63024.2,170892.2
430695,202209,65,52,13,63024,15756,78780
430697,202209,62,39,23,47268,27876,75144
430700,202209,1396,947,449,1148982.6,544190.47,1693173.07
430705,202209,30,26,4,31512,4848,36360
430710,202209,267,166,101,201192,122412,323604
430720,202209,101,85,16,103020,19392,122412
430730,202209,149,127,22,153924,26664,180588
430740,202209,77,50,27,61812,32724,94536
430745,202209,31,17,14,20604,16968,37572
430750,202209,327,213,114,259368.76,139380.84,398749.60
430755,202209,83,47,36,56964,43632,100596
430760,202209,409,223,186,270277.65,225435.87,495713.52
430770,202209,1646,878,768,1065359.91,930821.58,1996181.49
430780,202209,346,219,127,265428,153924,419352
430781,202209,23,23,0,27876,,27876.0
430783,202209,61,48,13,59388,15756,75144
430786,202209,6,4,2,4848,2424,7272
430790,202209,522,334,188,404808.4,227858.29,632666.69
430800,202209,161,123,38,149076,46056,195132
430805,202209,40,33,7,39996,8484,48480
430807,202209,67,35,32,42420,38784,81204
430810,202209,83,56,27,67872,32724,100596
430820,202209,150,99,51,119988.8,61812,181800.8
430825,202209,11,9,2,10908,2424,13332
430830,202209,267,247,20,299365.52,24240,323605.52
430840,202209,128,85,43,103020,53328,156348
430843,202209,6,3,3,3636,3636,7272
430845,202209,80,49,31,59388.2,37572,96960.2
430850,202209,597,425,172,515100.9,208464,723564.9
430860,202209,165,109,56,132108.2,67873.32,199981.52
430865,202209,76,43,33,52116,39996,92112
430870,202209,72,58,14,70296.2,16968,87264.2
430880,202209,172,120,52,145440.7,63024,208464.7
430885,202209,11,10,1,12120,1212,13332
430890,202209,338,202,136,244824.2,164832,409656.2
430900,202209,538,373,165,452078.73,199980,652058.73
430905,202209,139,58,81,70297.25,98172.6,168469.85
430910,202209,291,156,135,190284,163620.8,353904.8
430912,202209,3,3,0,3636,,3636.0
430915,202209,42,39,3,47268,3636,50904
430920,202209,4769,2494,2275,3032478.64,2762188.6,5794667.24
430925,202209,6,5,1,6060,1212,7272
430930,202209,2136,1214,922,1471381.22,1121104.57,2592485.79
430940,202209,268,170,98,206041.33,118776.4,324817.73
430950,202209,151,122,29,147864.04,35148,183012.04
430955,202209,25,15,10,18180,12120,30300
430957,202209,22,19,3,23028,3636,26664
430960,202209,263,166,97,201192.98,117564.2,318757.18
430965,202209,100,64,36,77568,43632,121200
430970,202209,88,72,16,87264,19392,106656
430975,202209,50,45,5,54540.99,6060,60600.99
430980,202209,50,30,20,36360.2,24240,60600.2
430990,202209,96,73,23,88476,27876.58,116352.58
430995,202209,109,101,8,122412,9696,132108
431000,202209,294,147,147,178165.1,178164,356329.1
431010,202209,365,215,150,261795.37,184227.47,446022.84
431020,202209,1938,1121,817,1358656.43,990207.26,2348863.69
431030,202209,41,33,8,39996,9696,49692
431033,202209,475,222,253,269071.41,306647.63,575719.04
431036,202209,12,8,4,9696,4848,14544
431040,202209,144,95,49,115140.55,59388,174528.55
431041,202209,42,24,18,29088,21816,50904
431043,202209,41,24,17,29088,20604,49692
431046,202209,13,10,3,12120,3636,15756
431050,202209,202,122,80,147864.6,96960,244824.6
431053,202209,75,40,35,48480.94,42420.62,90901.56
431055,202209,64,43,21,52116,25452,77568
431057,202209,17,17,0,20604,,20604.0
431060,202209,1598,1026,572,1243518.47,693265.78,1936784.25
431065,202209,16,8,8,9696,9696,19392
431070,202209,65,57,8,69084,9696,78780
431075,202209,8,8,0,9696,,9696.0
431080,202209,128,73,55,88476,66660,155136
431085,202209,35,31,4,37572,4848,42420
431087,202209,16,13,3,15756.6,3636,19392.6
431090,202209,51,39,12,47268.2,14544,61812.2
431100,202209,1289,775,514,942948.09,624185.04,1567133.13
431110,202209,221,132,89,159985.54,107868,267853.54
431112,202209,30,22,8,26664,9696,36360
431113,202209,29,21,8,25452,9696,35148
431115,202209,157,109,48,132108,58176,190284
431120,202209,602,349,253,424202.09,306636,730838.09
431123,202209,7,6,1,7272,1212,8484
431125,202209,97,84,13,101808,15756,117564
431127,202209,5,3,2,3636,2424,6060
431130,202209,712,469,243,569642.88,295729.07,865371.95
431140,202209,810,577,233,700541.66,282396,982937.66
431142,202209,20,18,2,21816.84,2424,24240.84
431150,202209,204,150,54,181801.04,65448.6,247249.64
431160,202209,45,41,4,49692,4848,54540
431162,202209,6,6,0,7272.67,,7272.67
431164,202209,4,4,0,4848,,4848.0
431170,202209,113,81,32,98172,38784,136956
431171,202209,74,42,32,50904,38784,89688
431173,202209,7,5,2,6060,2424.8,8484.8
431175,202209,205,109,96,132108.8,116352.15,248460.95
431177,202209,97,70,27,84841.06,32724.31,117565.37
431179,202209,15,11,4,13332.19,4848,18180.19
431180,202209,405,250,155,303001.15,189073.71,492074.86
431190,202209,72,52,20,63024,24240.7,87264.7
431198,202209,74,48,26,58049.95,31512,89561.95
431200,202209,21,17,4,20604,4848,25452
431205,202209,21,19,2,23028,2424,25452
431210,202209,103,62,41,75144,49692,124836
431213,202209,34,27,7,32724,8484.56,41208.56
431215,202209,22,21,1,25452,1212,26664
431217,202209,5,4,1,4848,1212,6060
431220,202209,69,58,11,70296,13332,83628
431225,202209,166,102,64,123624.91,77568,201192.91
431230,202209,101,84,17,101808,20604,122412
431235,202209,6,5,1,6060,1212,7272
431237,202209,14,9,5,10908,6060,16968
431238,202209,13,9,4,10908,4848,15756
431240,202209,1129,693,436,841138.31,528434.06,1369572.37
431242,202209,42,41,1,49692,1212,50904
431244,202209,28,23,5,27876.07,6060,33936.07
431245,202209,52,35,17,42420,20604,63024
431247,202209,14,9,5,10908,6060.6,16968.6
431250,202209,286,140,146,169680,176952,346632
431260,202209,52,44,8,53328,9696,63024
431261,202209,20,15,5,18180,6060,24240
431262,202209,15,12,3,14544.89,3636.07,18180.96
431265,202209,151,83,68,100596.77,82416,183012.77
431267,202209,18,16,2,19392,2424,21816
431270,202209,334,259,75,313911.36,90900.96,404812.32
431275,202209,39,35,4,42420,4848,47268
431280,202209,21,15,6,18180,7272,25452
431290,202209,22,20,2,24240,2424,26664
431295,202209,3,1,2,1212,2424,3636
431300,202209,20,18,2,21816,2424,24240
431301,202209,7,7,0,8484,,8484.0
431303,202209,58,37,21,44844,25452,70296
431306,202209,245,127,118,153924.05,143016,296940.05
431308,202209,9,7,2,8484,2424,10908
431310,202209,63,48,15,58176,18180,76356
431320,202209,197,117,80,141804,96960,238764
431330,202209,209,137,72,166044,87264,253308
431333,202209,26,21,5,25452,6060,31512
431335,202209,7,5,2,6060,2424,8484
431337,202209,420,201,219,243618.37,265428.51,509046.88
431339,202209,22,16,6,19392,7272,26664
431340,202209,3196,1721,1475,2085772.76,1787709.01,3873481.77
431342,202209,33,23,10,27876,12120,39996
431344,202209,19,19,0,23028,,23028.0
431346,202209,5,4,1,4848,1212,6060
431349,202209,28,26,2,31512,2424,33936
431350,202209,1115,601,514,728422.36,624181.08,1352603.44
431360,202209,54,40,14,48480,16968,65448
431365,202209,371,158,213,191497.6,258156.4,449654.0
431370,202209,1206,686,520,831438.52,630241.4,1461679.92
431380,202209,98,87,11,105444,13332,118776
431390,202209,493,263,230,318756.75,278760.46,597517.21
431395,202209,333,145,188,175740.2,227856,403596.2
431400,202209,37,25,12,30300,14544,44844
431402,202209,99,72,27,88476,32724.8,121200.8
431403,202209,28,19,9,23028,10908,33936
431405,202209,724,416,308,504234.47,373299.1,877533.57
431406,202209,38,29,9,35148,10908,46056
431407,202209,48,37,11,44844,13332,58176
431410,202209,3542,2167,1375,2627637.63,1671358.01,4298995.64
431413,202209,15,12,3,14544,3636,18180
431415,202209,72,49,23,59388,27876,87264
431417,202209,22,11,11,13332,13332,26664
431420,202209,361,234,127,283611.79,153924,437535.79
431430,202209,66,33,33,39996.87,39996,79992.87
431440,202209,9294,6306,2988,7649085.23,3628815.21,11277900.44
431442,202209,26,13,13,15756,15756,31512
431445,202209,28,27,1,32724,1212,33936
431446,202209,3,3,0,3636,,3636.0
431447,202209,82,60,22,72720,26664,99384
431449,202209,58,46,12,55752.2,14544,70296.2
431450,202209,426,281,145,340572.13,175740,516312.13
431454,202209,11,6,5,7272,6060,13332
431455,202209,46,37,9,44844,10908,55752
431460,202209,501,339,162,410870.81,196344,607214.81
431470,202209,140,103,37,124836,44844,169680
431475,202209,12,10,2,12120,2424,14544
431477,202209,40,23,17,27876,20604,48480
431478,202209,7,7,0,8484,,8484.0
431480,202209,609,364,245,441168.79,296941.5,738110.29
431490,202209,30410,17053,13357,20679278.14,16207027.94,36886306.08
431500,202209,77,60,17,72720,20604,93324
431505,202209,26,17,9,20604,10908,31512
431507,202209,10,8,2,9696,2424,12120
431510,202209,232,165,67,199980.4,81204,281184.4
431513,202209,20,19,1,23028,1212,24240
431514,202209,6,4,2,4848,2424,7272
431515,202209,86,73,13,88476.04,15756,104232.04
431517,202209,8,5,3,6060,3636,9696
431520,202209,38,32,6,38784,7272,46056
431530,202209,1412,619,793,750230.82,961116.43,1711347.25
431531,202209,22,21,1,25452,1212,26664
431532,202209,37,28,9,33936,12120,46056
431535,202209,28,14,14,16968,16968,33936
431540,202209,140,112,28,135744.1,33936.6,169680.7
431545,202209,14,11,3,13332,3636,16968
431550,202209,350,185,165,224221.58,201192.27,425413.85
431555,202209,12,11,1,13332,1212,14544
431560,202209,4924,3262,1662,3963318.71,2016802.64,5980121.35
431570,202209,847,454,393,550252.3,478744.46,1028996.76
431575,202209,53,30,23,36360,27876.1,64236.1
431580,202209,80,56,24,67872,29088,96960
431590,202209,146,123,23,150288,27876,178164
431595,202209,17,15,2,18180,2424,20604
431600,202209,254,149,105,180592.06,127261.42,307853.48
431610,202209,115,85,30,103020.2,36360.8,139381.0
431620,202209,41,33,8,39996,9696,49692
431630,202209,126,102,24,123624.81,30300.6,153925.41
431640,202209,1308,816,492,992634.46,596304.19,1588938.65
431642,202209,32,30,2,36360,2424,38784
431643,202209,44,17,27,20604,32724,53328
431645,202209,326,188,138,227856.93,167256,395112.93
431647,202209,10,9,1,10908,1212,12120
431650,202209,36,20,16,24240,19392,43632
431660,202209,266,168,98,203616,118776,322392
431670,202209,223,98,125,118776.79,151500.99,270277.78
431673,202209,14,12,2,14544,2424,16968
431675,202209,26,20,6,24240,7272,31512
431680,202209,1168,849,319,1030213.05,387845.32,1418058.37
431690,202209,5041,2982,2059,3616664.71,2497966.83,6114631.54
431695,202209,17,11,6,13332,7272,20604
431697,202209,3,1,2,1212,2424,3636
431700,202209,187,141,46,170892.55,55752,226644.55
431710,202209,4149,1787,2362,2167076.91,2862750.63,5029827.54
431720,202209,1291,792,499,959304.57,604789,1564093.57
431725,202209,2,1,1,1212,1212,2424
431730,202209,1211,806,405,976896.24,490869.08,1467765.32
431740,202209,1360,661,699,801136.96,848403.47,1649540.43
431750,202209,1848,1209,639,1466530.26,776899.91,2243430.17
431755,202209,6,5,1,6060,1212,7272
431760,202209,987,621,366,753874.3,443596.55,1197470.85
431770,202209,413,280,133,339360.26,161196,500556.26
431775,202209,24,17,7,20604,8484,29088
431780,202209,569,343,226,416928.57,273912,690840.57
431790,202209,148,114,34,138168.42,41208,179376.42
431795,202209,13,10,3,12120,3636,15756
431800,202209,3139,1651,1488,2001026.19,1803462.84,3804489.03
431805,202209,18,15,3,18180,3636,21816
431810,202209,587,381,206,462984.64,249672.4,712657.04
431820,202209,336,196,140,238764.2,169680,408444.2
431830,202209,2356,1421,935,1723474.48,1134434.64,2857909.12
431840,202209,493,314,179,380572.17,216948.8,597520.97
431842,202209,35,29,6,35148,7272,42420
431843,202209,10,7,3,8484.1,3636,12120.1
431844,202209,17,12,5,14544,6060,20604
431845,202209,24,22,2,26664,2424,29088
431846,202209,27,23,4,27876,4848,32724
431848,202209,13,11,2,13332,2424,15756
431849,202209,6,5,1,6060,1212,7272
431850,202209,801,625,176,758724.63,213313.3,972037.93
431860,202209,121,77,44,93324.15,53328,146652.15
431861,202209,4,0,4,,4848,4848.0
431862,202209,65,47,18,56964,21816,78780
431870,202209,3838,2203,1635,2673699.8,1982842.52,4656542.32
431880,202209,1002,699,303,848402.61,369660.89,1218063.50
431890,202209,1248,723,525,877490.31,637512.45,1515002.76
431900,202209,189,129,60,156348,72720,229068
431910,202209,44,34,10,41208,12120,53328
431912,202209,48,31,17,37572,20604,58176
431915,202209,150,113,37,136956,44844,181800
431920,202209,151,108,43,130896,52116,183012
431930,202209,73,59,14,71508,16968,88476
431935,202209,4,3,1,3636,1212,4848
431936,202209,2,2,0,2424,,2424.0
431937,202209,20,15,5,18180.63,6060,24240.63
431940,202209,473,322,151,390267.41,183012.27,573279.68
431950,202209,487,313,174,379359.08,210888.3,590247.38
431960,202209,742,404,338,489649.47,409657.4,899306.87
431970,202209,64,58,6,70296,7272,77568
431971,202209,4,4,0,4848,,4848.0
431973,202209,22,19,3,23028.9,3636,26664.9
431975,202209,10,10,0,12120,,12120.0
431980,202209,200,117,83,141804.6,100596,242400.6
431990,202209,1098,583,515,707735.89,624187.99,1331923.88
432000,202209,1938,1028,910,1247170.52,1102931.55,2350102.07
432010,202209,258,168,90,203616.7,109080.2,312696.9
432020,202209,189,160,29,193921.67,35148.37,229070.04
432023,202209,14,12,2,14544,2424,16968
432026,202209,63,55,8,66660,9696,76356
432030,202209,57,26,31,31512.96,37572,69084.96
432032,202209,15,12,3,14544,3636,18180
432035,202209,63,47,16,56964.4,19392,76356.4
432040,202209,86,59,27,71508,32724,104232
432045,202209,3,3,0,3636,,3636.0
432050,202209,80,48,32,58176,38784.6,96960.6
432055,202209,132,93,39,112716,47268,159984
432057,202209,6,4,2,4848.6,2424,7272.6
432060,202209,32,28,4,33936,4848,38784
432065,202209,30,26,4,31512,4848,36360
432067,202209,85,78,7,94536.5,8484,103020.5
432070,202209,388,304,84,368448.8,101808,470256.8
432080,202209,835,588,247,712663.88,300578.1,1013241.98
432085,202209,18,15,3,18180.2,3636,21816.2
432090,202209,273,178,95,215736,115140,330876
432100,202209,174,111,63,134532,76356,210888
432110,202209,571,372,199,453291.81,241188.98,694480.79
432120,202209,1046,588,458,712659.63,555100.09,1267759.72
432130,202209,507,364,143,441168.18,175740.02,616908.20
432132,202209,22,20,2,24240,2424,26664
432135,202209,76,65,11,78780,13332,92112
432140,202209,263,198,65,239977.89,78780,318757.89
432143,202209,226,138,88,167256.4,106656.85,273913.25
432145,202209,288,201,87,243612,105444,349056
432146,202209,16,14,2,16968,2424,19392
432147,202209,96,57,39,69084,47268,116352
432149,202209,16,10,6,12120,7272,19392
432150,202209,1049,648,401,785383.31,487228.83,1272612.14
432160,202209,1792,924,868,1121110.54,1054449.25,2175559.79
432162,202209,5,2,3,2424,3636,6060
432163,202209,15,10,5,12120,6060,18180
432166,202209,125,87,38,105747.1,46056.2,151803.3
432170,202209,230,121,109,146653.53,132109.41,278762.94
432180,202209,579,369,210,447228,254520,701748
432183,202209,11,10,1,12120,1212,13332
432185,202209,82,67,15,81204,18180.17,99384.17
432190,202209,516,307,209,372084.13,253308.8,625392.93
432195,202209,91,72,19,88476,23028,111504
432200,202209,428,261,167,316333.4,202404.25,518737.65
432210,202209,116,69,47,83628,56964,140592
432215,202209,31,29,2,35148,2424,37572
432218,202209,19,19,0,23028,,23028.0
432220,202209,645,329,316,398749.09,382995.38,781744.47
432225,202209,19,13,6,15756.2,7272,23028.2
432230,202209,127,83,44,100596,53328,153924
432232,202209,25,22,3,26664,3636,30300
432234,202209,4,2,2,2424,2424,4848
432235,202209,1,1,0,1212,,1212.0
432237,202209,24,16,8,19392,9696,29088
432240,202209,4627,2613,2014,3169434.97,2442203.21,5611638.18
432250,202209,1143,760,383,923546.22,466621.58,1390167.80
432252,202209,49,49,0,59388,,59388.0
432253,202209,68,53,15,64236.91,18180,82416.91
432254,202209,31,15,16,18180,19392,37572
432255,202209,11,10,1,12120,1212,13332
432260,202209,880,705,175,854465.77,213312.74,1067778.51
432270,202209,218,160,58,193924.51,70297.18,264221.69
432280,202209,164,123,41,149079.53,49692,198771.53
432285,202209,1,1,0,1212,,1212.0
432290,202209,57,48,9,58176,10908,69084
432300,202209,5148,2766,2382,3354764.33,2891854.14,6246618.47
432310,202209,131,111,20,134532.89,24240,158772.89
432320,202209,20,15,5,18180,6060,24240
432330,202209,17,11,6,13332,7272,20604
432335,202209,9,7,2,8484,2424,10908
432340,202209,35,29,6,35148,7272,42420
432345,202209,117,77,40,93324.3,48480,141804.3
432350,202209,24,23,1,27876,1212,29088
432360,202209,5,4,1,4848,1212,6060
432370,202209,25,25,0,30300.48,,30300.48
432375,202209,28,26,2,31512,2424,33936
432377,202209,6,6,0,7272,,7272.0
432380,202209,206,93,113,112716.6,136957.75,249674.35
500020,202209,292,151,141,183013.83,170892.99,353906.82
500025,202209,146,68,78,82416.73,94536.92,176953.65
500060,202209,1525,972,553,1178083.9,670245.72,1848329.62
500070,202209,764,366,398,443600.95,484808.56,928409.51
500080,202209,138,108,30,130901.22,36360,167261.22
500085,202209,132,98,34,118777.92,41208,159985.92
500090,202209,393,181,212,219373.87,258157.23,477531.10
500100,202209,710,363,347,439965.38,420569.72,860535.10
500110,202209,2366,1114,1252,1352616.99,1517445.54,2870062.53
500124,202209,270,144,126,174528.94,152713.41,327242.35
500150,202209,319,132,187,159986.3,226645.14,386631.44
500190,202209,574,383,191,464206.41,231493.29,695699.70
500200,202209,207,172,35,208467.31,42420,250887.31
500210,202209,1748,564,1184,683576.73,1435022,2118598.73
500215,202209,201,116,85,140594.96,103020.6,243615.56
500220,202209,736,462,274,561170.87,332091.48,893262.35
500230,202209,240,137,103,167258.36,124837.82,292096.18
500240,202209,669,431,238,523594.97,288459.74,812054.71
500260,202209,617,247,370,299366.04,448440.96,747807.00
500270,202209,31609,13708,17901,16624671.84,21716963.44,38341635.28
500280,202209,207,69,138,83629.18,167256.6,250885.78
500290,202209,1218,763,455,924770.88,551462.09,1476232.97
500295,202209,481,314,167,380575.39,202404.19,582979.58
500310,202209,117,41,76,49692.1,92113.14,141805.24
500315,202209,860,471,389,572065.57,473892.4,1045957.97
500320,202209,3776,1788,1988,2174374.48,2416742.3,4591116.78
500325,202209,946,523,423,635112.18,512681.99,1147794.17
500330,202209,1556,751,805,910164.41,976886.15,1887050.56
500345,202209,317,227,90,275127.48,109080.21,384207.69
500348,202209,245,150,95,181802.05,115140.05,296942.10
500350,202209,111,56,55,67872.71,67872,135744.71
500370,202209,6006,2733,3273,3314873.03,3968124.43,7282997.46
500375,202209,372,248,124,300578.55,150288,450866.55
500380,202209,652,368,284,446023.98,344212.32,790236.30
500390,202209,74,31,43,37572.39,52116.8,89689.19
500400,202209,221,139,82,169682.71,99384.32,269067.03
500410,202209,487,207,280,252102.2,339363.99,591466.19
500430,202209,593,387,206,469052.22,250885.92,719938.14
500440,202209,215,119,96,145440.1,119988.2,265428.3
500450,202209,441,191,250,231494.35,303000.8,534495.15
500460,202209,284,151,133,183016.06,163620,346636.06
500470,202209,438,320,118,387847.35,143017.5,530864.85
500480,202209,102,58,44,70296.1,53328.5,123624.6
500490,202209,97,40,57,48480.56,70298.91,118779.47
500500,202209,1512,561,951,679943.09,1152619.39,1832562.48
500510,202209,39,32,7,38784.4,8484,47268.4
500515,202209,120,79,41,95750.42,49692.2,145442.62
500520,202209,290,148,142,179380.96,172104,351484.96
500525,202209,101,51,50,61812,60600,122412
500540,202209,923,403,520,488448.79,630247.25,1118696.04
500560,202209,904,500,404,606007.82,489651.93,1095659.75
500568,202209,1081,537,544,650856.12,659332.15,1310188.27
500570,202209,1234,709,525,860533.59,638728.73,1499262.32
500580,202209,314,167,147,202409.69,178165.17,380574.86
500600,202209,383,184,199,223011.62,241189.95,464201.57
500620,202209,993,681,312,825387.31,378145.61,1203532.92
500625,202209,81,65,16,78780.8,19392,98172.8
500627,202209,40,17,23,20604.15,27876,48480.15
500630,202209,1602,918,684,1113338.69,829014.19,1942352.88
500635,202209,511,304,207,368448.52,250884,619332.52
500640,202209,366,200,166,242406.11,201194.3,443600.41
500660,202209,6082,2183,3899,2648248.51,4728036.98,7376285.49
500690,202209,633,228,405,276338.49,490860.04,767198.53
500710,202209,416,208,208,252101.62,252099.26,504200.88
500720,202209,975,531,444,643581.95,539341.9,1182923.85
500730,202209,150,92,58,111510.41,70296,181806.41
500740,202209,989,422,567,511472.72,688421.67,1199894.39
500750,202209,190,70,120,84842.88,145441.3,230284.18
500755,202209,114,89,25,107870.26,30300.93,138171.19
500769,202209,750,411,339,499351.77,412084.8,911436.57
500770,202209,422,227,195,275124.5,236340,511464.5
500780,202209,136,94,42,113930.91,50904.85,164835.76
500790,202209,1113,537,576,650853.1,699328.81,1350181.91
500793,202209,299,155,144,187860.49,175743.66,363604.15
500795,202209,187,125,62,151501.28,75144.79,226646.07
500797,202209,51,35,16,42420,19392,61812
500800,202209,443,191,252,231494.57,305424.3,536918.87
500830,202209,2391,1272,1119,1544117.97,1359873.79,2903991.76
500840,202209,122,87,35,105448.79,42420,147868.79
510010,202209,172,92,80,112716,96960,209676
510020,202209,566,260,306,315125.8,370875.31,686001.11
510025,202209,1761,988,773,1197477.66,939310.34,2136788.00
510030,202209,666,349,317,422998.81,385419.89,808418.70
510035,202209,134,69,65,83628.22,78780,162408.22
510040,202209,419,197,222,238764.92,269065.88,507830.80
510050,202209,391,208,183,252100.76,221798.49,473899.25
510060,202209,127,58,69,70297.45,83628,153925.45
510080,202209,263,105,158,128472.93,192708.6,321181.53
510100,202209,68,27,41,32724.8,49692.46,82417.26
510120,202209,33,19,14,23028.99,16968.64,39997.63
510125,202209,401,254,147,307850.48,178164,486014.48
510130,202209,549,321,228,390270.51,276337.62,666608.13
510140,202209,458,149,309,180588.74,374509.65,555098.39
510160,202209,110,42,68,50904,82417.09,133321.09
510170,202209,773,461,312,558736.33,379360.11,938096.44
510180,202209,3036,1386,1650,1682281.71,2003456.75,3685738.46
510185,202209,29,14,15,16968,18180,35148
510190,202209,244,85,159,103022.03,192708.8,295730.83
510250,202209,2769,1695,1074,2055579.28,1302907.93,3358487.21
510260,202209,170,122,48,147865.13,58176.79,206041.92
510263,202209,501,278,223,336938.8,270278.62,607217.42
510267,202209,617,338,279,409662.09,338150.61,747812.70
510268,202209,72,35,37,42420.29,44844,87264.29
510269,202209,78,37,41,44844.81,49692.8,94537.61
510270,202209,384,182,202,220585.53,244824,465409.53
510279,202209,207,153,54,185436.54,65448,250884.54
510285,202209,188,76,112,92112.05,135744,227856.05
510300,202209,538,276,262,334514.92,317544.56,652059.48
510305,202209,196,87,109,105444.75,132108,237552.75
510310,202209,107,56,51,67872,61812.1,129684.1
510320,202209,829,513,316,621761.52,382992.72,1004754.24
510325,202209,454,195,259,236341.68,313909.45,550251.13
510330,202209,442,241,201,293307.37,244825.53,538132.90
510335,202209,679,397,282,481172.04,341785.13,822957.17
510336,202209,53,34,19,41209.38,23028.5,64237.88
510337,202209,102,44,58,53328,70296,123624
510340,202209,18824,8111,10713,9839252.44,12994042.67,22833295.11
510343,202209,61,47,14,56964,16968,73932
510345,202209,158,99,59,119988.66,71508.6,191497.26
510350,202209,658,344,314,416934.41,380570.38,797504.79
510360,202209,226,142,84,172105.99,103020,275125.99
510370,202209,174,76,98,92112,118776,210888
510380,202209,81,59,22,71508.52,26664,98172.52
510385,202209,62,30,32,36360.4,38784,75144.4
510390,202209,101,48,53,58176.82,64236.37,122413.19
510395,202209,57,40,17,48480,20604,69084
510410,202209,802,500,302,606012.88,367238.93,973251.81
510420,202209,565,275,290,333302.2,351480,684782.2
510450,202209,54,29,25,35148,30300,65448
510452,202209,57,28,29,33936,36360,70296
510454,202209,55,25,30,30300.74,36360.08,66660.82
510455,202209,123,71,52,86052,64236,150288
510460,202209,196,82,114,99386.1,138168.2,237554.3
510480,202209,761,449,312,544196.62,378146.27,922342.89
510490,202209,347,166,181,201192.9,219372.5,420565.4
510500,202209,237,175,62,212100.38,75144,287244.38
510510,202209,875,509,366,616918.03,443596.2,1060514.23
510515,202209,1307,672,635,814473.16,769624.96,1584098.12
510517,202209,276,121,155,146654.67,189072.9,335727.57
510520,202209,230,144,86,174529.11,104232.37,278761.48
510523,202209,118,91,27,110292.78,32724,143016.78
510525,202209,911,563,348,682368.37,422991.04,1105359.41
510530,202209,25,16,9,19392,10908,30300
510550,202209,247,113,134,136956.69,162409.25,299365.94
510558,202209,323,160,163,193921.4,197556,391477.4
510560,202209,392,223,169,270279.68,204831.92,475111.60
510562,202209,676,474,202,574496.13,244825.35,819321.48
510590,202209,734,355,379,430264.38,459350.48,889614.86
510600,202209,225,117,108,141807.92,132108.99,273916.91
510610,202209,229,101,128,122414.54,155136.6,277551.14
510615,202209,231,109,122,132108.43,147864.8,279973.23
510617,202209,26,11,15,13332,18180,31512
510618,202209,131,60,71,72720,86053.19,158773.19
510619,202209,85,60,25,72720.69,30300,103020.69
510620,202209,165,89,76,107868,92112,199980
510621,202209,179,111,68,134532.24,82416.43,216948.67
510622,202209,512,270,242,327249.75,293307.28,620557.03
510623,202209,287,194,93,235131.3,112716,347847.3
510624,202209,94,46,48,55753.21,58176.53,113929.74
510625,202209,538,338,200,409665.04,242403.15,652068.19
510626,202209,122,75,47,90903.02,56964,147867.02
510627,202209,92,63,29,76357.1,35148.2,111505.3
510628,202209,166,99,67,119989.05,81204,201193.05
510629,202209,283,168,115,203616.2,139401.81,343018.01
510630,202209,457,234,223,283609.88,270276.3,553886.18
510631,202209,22,9,13,10908,15756,26664
510637,202209,360,211,149,255733.81,180588,436321.81
510642,202209,1166,613,553,744182.13,671452.75,1415634.88
510645,202209,10,1,9,1212,10908,12120
510650,202209,1313,847,466,1026590.93,564796.53,1591387.46
510665,202209,92,43,49,52116,59388,111504
510670,202209,59,34,25,41208.6,30300,71508.6
510675,202209,1115,718,397,870228.5,482380.03,1352608.53
510677,202209,350,182,168,220586.02,203616.58,424202.60
510680,202209,89,56,33,67873,39996,107869
510682,202209,190,95,95,115140.52,116352,231492.52
510685,202209,55,40,15,48480,18180,66660
510700,202209,593,333,260,403602.92,315120.29,718723.21
510704,202209,1259,627,632,759941.27,765996.45,1525937.72
510706,202209,162,84,78,101809.78,94537.4,196347.18
510710,202209,437,301,136,364817.89,164832.6,529650.49
510715,202209,58,40,18,48480.01,21816.63,70296.64
510718,202209,244,108,136,130896.78,164835.05,295731.83
510719,202209,48,21,27,25452,32724,58176
510720,202209,186,131,55,158773.78,67872,226645.78
510724,202209,81,29,52,35148,63024,98172
510726,202209,68,32,36,38784.7,43632,82416.7
510729,202209,13,5,8,6060,9696.1,15756.1
510730,202209,456,249,207,301789.38,252096,553885.38
510735,202209,116,48,68,58176,82416.52,140592.52
510740,202209,24,13,11,15756.5,13332.21,29088.71
510757,202209,26,22,4,26665.26,4848.16,31513.42
510760,202209,7788,3918,3870,4751121.08,4694116.13,9445237.21
510770,202209,726,334,392,404812.56,475105.1,879917.66
510774,202209,18,7,11,8484,13332,21816
510775,202209,117,89,28,107868,33936,141804
510776,202209,36,11,25,13332,31512.2,44844.2
510777,202209,195,84,111,101808,134532,236340
510779,202209,39,24,15,29088,18180,47268
510780,202209,268,141,127,170895.41,155136,326031.41
510785,202209,352,193,159,233919.27,192709.2,426628.47
510787,202209,206,101,105,122414.08,127260.25,249674.33
510788,202209,8,3,5,3636.15,6060,9696.15
510790,202209,2718,1397,1321,1694454.81,1602271.77,3296726.58
510792,202209,1144,630,514,766000.33,622978.47,1388978.80
510794,202209,117,64,53,77568.12,64236,141804.12
510795,202209,2366,1346,1020,1631377.13,1236247.54,2867624.67
510800,202209,193,112,81,135745.21,98172.14,233917.35
510805,202209,207,134,73,162408,88476.2,250884.2
510810,202209,106,45,61,54541.22,73932.42,128473.64
510820,202209,265,132,133,159985.68,161197.85,321183.53
510830,202209,76,39,37,47268,44844,92112
510835,202209,22,14,8,16968,9696.3,26664.3
510840,202209,9591,4374,5217,5307483.7,6330347.4,11637831.1
510850,202209,209,83,126,100596.99,152712.13,253309.12
510860,202209,412,202,210,246037.46,254520.62,500558.08
510880,202209,72,51,21,61812,25452,87264
510885,202209,73,42,31,50904.02,37572,88476.02
510890,202209,73,38,35,46056.86,42420,88476.86
510895,202209,177,102,75,123625.5,90900.13,214525.63
520005,202209,155,60,95,72721.14,115141.3,187862.44
520010,202209,305,131,174,159985.4,214527.56,374512.96
520013,202209,749,508,241,615704.05,293306.79,909010.84
520015,202209,41,29,12,35148,14544,49692
520017,202209,86,53,33,64236,39996,104232
520020,202209,12,5,7,6060,8484,14544
520025,202209,2902,1529,1373,1853201.88,1666538.2,3519740.08
520030,202209,845,444,401,538438.94,487226.44,1025665.38
520050,202209,63,46,17,55752,20604.86,76356.86
520055,202209,81,53,28,64236,33936,98172
520060,202209,171,114,57,138171.49,69085.45,207256.94
520080,202209,564,400,164,484801.67,199980.2,684781.87
520082,202209,17,12,5,14544,6060,20604
520085,202209,103,78,25,94537.74,30300,124837.74
520090,202209,83,59,24,71508,29088,100596
520110,202209,9481,4001,5480,4852917.96,6646661.74,11499579.70
520120,202209,11,5,6,6060,7272,13332
520130,202209,845,584,261,707816.13,318757.83,1026573.96
520140,202209,12285,6685,5600,8106032.22,6798170.15,14904202.37
520145,202209,53,31,22,37572.2,27876,65448.2
520150,202209,145,114,31,138169.52,37572,175741.52
520160,202209,44,27,17,32724,20604,53328
520170,202209,218,124,94,150293.17,113931.94,264225.11
520180,202209,202,92,110,111504.9,133320.63,244825.53
520215,202209,195,133,62,161196.97,75144.2,236341.17
520235,202209,83,62,21,75144,25452.11,100596.11
520250,202209,145,78,67,94536.64,81204,175740.64
520260,202209,118,71,47,86053.74,56964.99,143018.73
520280,202209,47,33,14,39996,19392,59388
520310,202209,17,12,5,14544.9,6060.2,20605.1
520320,202209,184,109,75,132110.41,90900.97,223011.38
520330,202209,852,474,378,574493.56,461774.93,1036268.49
520340,202209,301,179,122,216952.26,147866.53,364818.79
520350,202209,493,248,245,301791,296941.91,598732.91
520355,202209,103,58,45,70297.43,54540,124837.43
520357,202209,34,28,6,33936,7272,41208
520360,202209,9,4,5,4848.6,6060,10908.6
520380,202209,143,79,64,95748,77568,173316
520390,202209,237,107,130,129687.41,157560,287247.41
520393,202209,16,12,4,14544,6060,20604
520396,202209,77,55,22,66660.6,26664,93324.6
520400,202209,206,125,81,151504.77,98173.71,249678.48
520410,202209,193,97,96,117566.35,116352.2,233918.55
520420,202209,20,13,7,15756,8484,24240
520425,202209,249,123,126,150288.82,153924.99,304213.81
520430,202209,527,251,276,304214.02,335724.5,639938.52
520440,202209,651,461,190,561166.28,232705.21,793871.49
520450,202209,2207,933,1274,1133237.19,1546522.1,2679759.29
520455,202209,65,39,26,47270.06,32724.2,79994.26
520460,202209,43,28,15,33936.19,20604.75,54540.94
520465,202209,36,30,6,36360,7272,43632
520470,202209,446,278,168,336937.24,203616,540553.24
520480,202209,77,46,31,55752.8,37572,93324.8
520485,202209,111,42,69,50904.72,83628.1,134532.82
520490,202209,478,345,133,418147.05,161197.06,579344.11
520495,202209,160,94,66,113928.1,79992,193920.1
520500,202209,189,149,40,180589.25,48480,229069.25
520505,202209,194,113,81,136956,98172,235128
520510,202209,2025,954,1071,1157470.58,1300486.21,2457956.79
520520,202209,59,38,21,46056,25452,71508
520530,202209,202,161,41,195134.4,49692,244826.4
520540,202209,734,491,243,596308.07,295729.2,892037.27
520545,202209,142,78,64,94538.09,77568,172106.09
520547,202209,65,34,31,41208.56,37573.04,78781.60
520549,202209,1509,716,793,869024.66,962339.9,1831364.56
520551,202209,342,174,168,210889.02,203616.6,414505.62
520552,202209,40,28,12,33936.3,14544,48480.3
520570,202209,14,9,5,10908,6060,16968
520580,202209,271,168,103,203617.18,124836.53,328453.71
520590,202209,146,81,65,98172.54,78780,176952.54
520620,202209,1221,562,659,681150.94,798712.38,1479863.32
520630,202209,47,27,20,32724,24240,56964
520640,202209,382,224,158,272701.01,191496.39,464197.40
520650,202209,68,32,36,38784,43632,82416
520660,202209,42,21,21,25452.61,25452.38,50904.99
520670,202209,47,36,11,43632.6,13332,56964.6
520680,202209,29,17,12,20604,14544,35148
520690,202209,38,11,27,13332,32724.22,46056.22
520710,202209,33,28,5,33936,6060,39996
520725,202209,197,147,50,178167.32,60600,238767.32
520735,202209,58,38,20,46056.2,24240.2,70296.4
520740,202209,483,229,254,277550.24,307848.1,585398.34
520750,202209,36,24,12,29088,14544,43632
520753,202209,80,58,22,70296,26664,96960
520760,202209,98,64,34,77568.4,41208.1,118776.5
520780,202209,266,205,61,248461.03,73933.66,322394.69
520790,202209,151,94,57,113928,69084,183012
520800,202209,3479,1936,1543,2348902.72,1871348.86,4220251.58
520810,202209,139,107,32,129686.08,38784.89,168470.97
520815,202209,6,4,2,4848,2424,7272
520830,202209,137,93,44,112718.17,53328.9,166047.07
520840,202209,396,253,143,306637.71,173316,479953.71
520850,202209,111,62,49,75145,59388,134533
520860,202209,1828,1149,679,1393820.08,822952.8,2216772.88
520870,202209,33515,15178,18337,18400878.39,22244034.84,40644913.23
520880,202209,1275,675,600,818119.15,729635.42,1547754.57
520890,202209,840,524,316,635098.1,384205.15,1019303.25
520910,202209,1013,531,482,643586.63,584185.48,1227772.11
520915,202209,89,68,21,82418.83,25452,107870.83
520920,202209,477,223,254,270281.92,309065,579346.92
520929,202209,13,11,2,13332.5,2424,15756.5
520940,202209,63,46,17,55752,20604.1,76356.1
520945,202209,14,9,5,10908,6060,16968
520960,202209,41,25,16,30300,19392,49692
520970,202209,418,241,177,292095.18,216949.63,509044.81
520980,202209,90,67,23,81204,27876,109080
520990,202209,447,315,132,381782.47,159984.2,541766.67
520993,202209,127,63,64,76358.98,77568.9,153927.88
520995,202209,265,144,121,174528.87,146652,321180.87
521000,202209,1622,902,720,1093238.23,875069.94,1968308.17
521010,202209,638,334,304,404813.77,369664.51,774478.28
521015,202209,14,8,6,9696,7272,16968
521020,202209,1425,987,438,1196260.83,530861.63,1727122.46
521030,202209,63,43,20,52116.8,24240,76356.8
521040,202209,978,639,339,775690.26,412082.55,1187772.81
521056,202209,58,38,20,46056,24240,70296
521060,202209,122,78,44,94536.2,53328.76,147864.96
521080,202209,329,256,73,310290.62,88476.5,398767.12
521090,202209,579,385,194,468279.01,235129.74,703408.75
521100,202209,259,187,72,226644.2,87264.4,313908.6
521120,202209,1075,754,321,915075.26,389053.99,1304129.25
521130,202209,328,235,93,284823.78,112716.6,397540.38
521140,202209,192,107,85,129684.82,104232.69,233917.51
521150,202209,2617,1122,1495,1359886.3,1813172.85,3173059.15
521160,202209,24,10,14,12120,16968,29088
521170,202209,224,120,104,145440.71,128472.2,273912.91
521180,202209,1203,762,441,924769.14,534499.69,1459268.83
521190,202209,2626,1096,1530,1329583.4,1854372,3183955.4
521200,202209,59,41,18,49692,21816,71508
521205,202209,12,7,5,8484,6060,14544
521210,202209,126,80,46,96961.84,55752,152713.84
521220,202209,748,514,234,623414.79,284822.56,908237.35
521225,202209,23,15,8,18181,9696.2,27877.2
521230,202209,106,66,40,79992,48481.39,128473.39
521250,202209,6514,3565,2949,4322093.32,3582723.66,7904816.98
521260,202209,33,16,17,19392,20604.6,39996.6
521270,202209,129,97,32,117564,38784,156348
521280,202209,423,266,157,322393.12,190284,512677.12
521290,202209,27,16,11,19392.47,13332,32724.47
521295,202209,103,68,35,82416.26,42420,124836.26
521300,202209,233,126,107,153925.16,129684,283609.16
521305,202209,43,31,12,37573,14544,52117
521308,202209,1018,782,236,947804.77,286034.95,1233839.72
521310,202209,1382,777,605,941742.18,734483.48,1676225.66
521340,202209,21,16,5,19392,6060,25452
521350,202209,116,86,30,104232.2,36360,140592.2
521370,202209,159,109,50,132108,60600,192708
521375,202209,199,96,103,116355.12,126048,242403.12
521377,202209,50,38,12,46056,14544,60600
521380,202209,1082,644,438,784185.41,530861.77,1315047.18
521385,202209,14,7,7,8484,8484,16968
521390,202209,107,84,23,101808.1,27876,129684.1
521400,202209,379,266,113,322397.87,136956.8,459354.67
521405,202209,155,93,62,112716.52,75144.66,187861.18
521410,202209,83,61,22,73932.1,26664,100596.1
521440,202209,210,146,64,176954.19,81204.35,258158.54
521450,202209,793,437,356,529651.6,432685.05,962336.65
521460,202209,1115,757,358,917498.26,433898.32,1351396.58
521470,202209,13,9,4,10908,4848,15756
521480,202209,41,28,13,33936.17,15756.6,49692.77
521483,202209,332,208,124,252097.23,150288,402385.23
521486,202209,296,195,101,236340.93,123624.84,359965.77
521487,202209,23,11,12,13332,14544,27876
521490,202209,24,14,10,16968,12120,29088
521500,202209,140,60,80,72720.21,96960.89,169681.10
521520,202209,43,32,11,38784,13332,52116
521523,202209,1046,580,466,702969.27,566004.38,1268973.65
521525,202209,54,37,17,44844,20604,65448
521530,202209,247,142,105,172104,127261,299365
521540,202209,40,21,19,25452,23028,48480
521550,202209,112,52,60,63024.8,72720.99,135745.79
521560,202209,907,594,313,719939.19,379359.08,1099298.27
521565,202209,67,49,18,59389.21,21816,81205.21
521570,202209,558,353,205,429054.51,248460.7,677515.21
521580,202209,52,33,19,39996,23028,63024
521590,202209,35,16,19,19392,23028,42420
521600,202209,26,12,14,14544,16968,31512
521630,202209,227,117,110,141808.34,133325.22,275133.56
521640,202209,305,159,146,192709.78,176952.1,369661.88
521645,202209,42,21,21,25452,25452,50904
521680,202209,255,152,103,184224.2,124836.4,309060.6
521690,202209,15,13,2,15756,2424,18180
521710,202209,1163,544,619,660547.13,755077.52,1415624.65
521720,202209,619,405,214,492075.81,259369.64,751445.45
521730,202209,695,327,368,396329.3,447229.5,843558.8
521740,202209,904,409,495,495711.94,599943.02,1095654.96
521760,202209,2366,1212,1154,1472692.13,1401094.95,2873787.08
521770,202209,835,516,319,625400.39,387842.39,1013242.78
521800,202209,2013,1335,678,1618036.41,822949.08,2440985.49
521805,202209,35,21,14,25452,16968,42420
521810,202209,94,53,41,64236.8,49692.4,113929.2
521830,202209,1015,735,280,892051.12,340579.39,1232630.51
521839,202209,75,43,32,52116,38784,90900
521850,202209,1171,578,593,700551.9,718726.54,1419278.44
521860,202209,337,210,127,254522.94,153924.2,408447.14
521870,202209,82,52,30,63024,36360,99384
521878,202209,36,14,22,16968,26664.98,43632.98
521880,202209,5020,2173,2847,2634932.4,3455443.1,6090375.5
521890,202209,606,413,193,500561.24,233917.29,734478.53
521900,202209,274,216,58,261793.7,70296,332089.7
521910,202209,182,122,60,147866.64,73932.6,221799.24
521920,202209,39,23,16,29088,19392,48480
521925,202209,54,31,23,37572,29088,66660
521930,202209,1233,690,543,836294.71,660546.93,1496841.64
521935,202209,34,24,10,29088.91,12120,41208.91
521940,202209,242,108,134,130897.84,162408.2,293306.04
521945,202209,18,13,5,15756,6060,21816
521950,202209,20,14,6,16968,7272,24240
521960,202209,71,55,16,66660.5,19392,86052.5
521970,202209,415,264,151,319971,183013.09,502984.09
521971,202209,115,58,57,70296,69084,139380
521973,202209,41,20,21,24240.8,25452,49692.8
521975,202209,1630,839,791,1016888.29,961131.02,1978019.31
521980,202209,238,158,80,191496.53,96960,288456.53
521990,202209,83,57,26,69084.98,31512,100596.98
522000,202209,287,191,96,231071.63,116352,347423.63
522005,202209,18,11,7,13332,8484,21816
522010,202209,1144,637,507,773272.6,614490.44,1387763.04
522015,202209,57,37,20,44844,24240,69084
522020,202209,912,539,373,653273.59,453290.51,1106564.10
522026,202209,24,16,8,19392,9696,29088
522028,202209,23,19,4,23028,4848,27876
522040,202209,832,355,477,430270.07,578129.59,1008399.66
522045,202209,2764,1619,1145,1963477.9,1390178.19,3353656.09
522050,202209,165,76,89,92115,109080.72,201195.72
522060,202209,550,341,209,413294.33,253308.4,666602.73
522068,202209,114,83,31,100596,37572,138168
522070,202209,18,15,3,18180,3636,21816
522100,202209,40,25,15,30300,18180,48480
522108,202209,48,36,12,43633.7,14544.2,58177.9
522119,202209,61,36,25,43632,30300,73932
522130,202209,72,24,48,29088.29,58176.4,87264.69
522140,202209,4270,2221,2049,2694321.57,2485824.42,5180145.99
522145,202209,46,34,12,41208,14544,55752
522150,202209,103,71,32,86052.08,39996.84,126048.92
522155,202209,52,37,15,44844.2,18180,63024.2
522157,202209,16,9,7,10908,8484,19392
522160,202209,1692,1013,679,1227777.1,822953.26,2050730.36
522170,202209,406,277,129,335725.43,156349.49,492074.92
522180,202209,34,13,21,15756,25452,41208
522185,202209,2532,1092,1440,1324742.88,1745312.33,3070055.21
522190,202209,72,41,31,49692.8,37572,87264.8
522200,202209,318,185,133,224220.3,162409.06,386629.36
522205,202209,147,100,47,121201.69,56964.1,178165.79
522220,202209,144,109,35,132108,42420,174528
522230,202209,33,29,4,35148.41,4848,39996.41
530010,202209,56543,28639,27904,34733337.34,33843292.3,68576629.64
110001,202210,538,438,100,530859.98,121200,652059.98
110002,202210,2949,1870,1079,2267683.69,1307760.34,3575444.03
110003,202210,82,64,18,78781.92,21816,100597.92
110004,202210,2142,1453,689,1761058.07,835072.89,2596130.96
110005,202210,441,345,96,418143.84,116352.2,534496.04
110006,202210,441,325,116,394912.5,140592.8,535505.3
110007,202210,78,63,15,76356.76,18180,94536.76
110008,202210,261,147,114,178164.97,138168.2,316333.17
110009,202210,964,736,228,894459.26,276336.6,1170795.86
110010,202210,1726,986,740,1195045.63,898093.03,2093138.66
110011,202210,1737,1337,400,1620471.32,484808.34,2105279.66
110012,202210,4200,2422,1778,2935494.15,2154947.92,5090442.07
110013,202210,737,583,154,707820.97,186650.71,894471.68
110014,202210,368,326,42,395113.38,50904,446017.38
110015,202210,1380,1054,326,1278671.99,395117.83,1673789.82
110018,202210,1056,653,403,796295.2,492072.77,1288367.97
110020,202210,16765,9336,7429,11323980.9,9008906.5,20332887.4
110025,202210,663,481,182,582975.41,220586.12,803561.53
110026,202210,37,25,12,30300.98,14544,44844.98
110028,202210,1640,1161,479,1407162.55,580557.94,1987720.49
110029,202210,124,111,13,134532.88,15756,150288.88
110030,202210,2445,1595,850,1932974.9,1030206.24,2963181.14
110032,202210,333,254,79,307857.89,95750.4,403608.29
110033,202210,679,482,197,584200.76,239981.71,824182.47
110034,202210,323,235,88,286032.3,106657.67,392689.97
110037,202210,91,80,11,96960.4,13332,110292.4
110040,202210,406,280,126,339360.6,153924,493284.6
110045,202210,967,697,270,844779.35,328453.62,1173232.97
110050,202210,89,78,11,94536.57,13332.33,107868.90
110060,202210,63,40,23,48481.35,27876,76357.35
110070,202210,109,71,38,87264.29,46056,133320.29
110080,202210,542,311,231,378148.79,281184.7,659333.49
110090,202210,26,21,5,26664,6060,32724
110092,202210,115,57,58,69085.42,70296,139381.42
110094,202210,207,141,66,170894.32,79992,250886.32
110100,202210,53,39,14,47268.03,16968.54,64236.57
110110,202210,122,72,50,87266.05,60600,147866.05
110120,202210,65,57,8,69085.14,9696,78781.14
110130,202210,270,215,55,260584.42,66660.3,327244.72
110140,202210,260,187,73,226645.64,88476.1,315121.74
110143,202210,52,42,10,50904,12120,63024
110145,202210,40,30,10,36360.39,12120,48480.39
110146,202210,28,12,16,14544,19392,33936
110147,202210,40,27,13,32725.29,15756.58,48481.87
110148,202210,33,27,6,32724.15,7272,39996.15
110149,202210,300,208,92,252096.4,111504,363600.4
110150,202210,141,108,33,130896.2,39996,170892.2
110155,202210,11,9,2,10908,2424,13332
110160,202210,66,49,17,59389.21,20604,79993.21
110170,202210,221,165,56,199981.28,67872,267853.28
110175,202210,67,51,16,61813.13,19392,81205.13
110180,202210,86,68,18,82417.58,21816,104233.58
120001,202210,214,157,57,191500.53,69084.88,260585.41
120005,202210,224,130,94,157561.3,113928.1,271489.4
120010,202210,1197,729,468,883554.41,568430.54,1451984.95
120013,202210,170,116,54,140593.86,65448.1,206041.96
120017,202210,130,75,55,90900.8,66660,157560.8
120020,202210,3469,2793,676,3385203.93,820537.46,4205741.39
120025,202210,586,320,266,389073.92,322399.83,711473.75
120030,202210,1175,1007,168,1222967.52,203625.6,1426593.12
120032,202210,46,40,6,48481.1,7272,55753.1
120033,202210,227,195,32,236348.76,38784.55,275133.31
120034,202210,181,133,48,161197.03,58176,219373.03
120035,202210,53,46,7,55752.1,8484,64236.1
120038,202210,410,265,145,321188.89,176952.96,498141.85
120039,202210,31,29,2,35149.65,2424,37573.65
120040,202210,14936,10044,4892,12178312.09,5934288.94,18112601.03
120042,202210,47,44,3,53330.05,3636,56966.05
120043,202210,16,4,12,4848,14544,19392
120045,202210,541,343,198,415726.19,239978.91,655705.10
120050,202210,1307,1005,302,1220545.14,367248.72,1587793.86
120060,202210,1520,1274,246,1545359.81,298158.64,1843518.45
120070,202210,424,305,119,369667.52,144228.69,513896.21
120080,202210,205,133,72,161198.28,87264.65,248462.93
130002,202210,163,116,47,140592,56964,197556
130006,202210,108,72,36,87264,43632,130896
130008,202210,133,76,57,92112,69084,161196
130010,202210,172,110,62,133321.94,75144.1,208466.04
130014,202210,297,209,88,253611.46,106656.4,360267.86
130020,202210,122,79,43,95748.2,52116,147864.2
130030,202210,1000,564,436,683572.41,529645.81,1213218.22
130040,202210,401,192,209,232704.6,254520.73,487225.33
130050,202210,556,297,259,359966.4,313913.89,673880.29
130060,202210,867,581,286,705385.43,346632,1052017.43
130063,202210,618,381,237,461772,287244,749016
130068,202210,235,151,84,183016.3,101809.15,284825.45
130070,202210,1374,912,462,1105362.11,559948.08,1665310.19
130080,202210,702,474,228,574494.98,276337.67,850832.65
130083,202210,89,58,31,70296.4,37572,107868.4
130090,202210,323,180,143,218160,173316,391476
130100,202210,1326,668,658,809628.27,797499.79,1607128.06
130110,202210,805,355,450,430261.17,545401.67,975662.84
130115,202210,150,76,74,92112,89688,181800
130120,202210,1709,1065,644,1290789.2,782953.93,2073743.13
130130,202210,645,431,214,522373.74,259368,781741.74
130140,202210,1564,1205,359,1460467.26,436320.5,1896787.76
130150,202210,439,390,49,472680,59388,532068
130160,202210,450,277,173,335724.3,210888,546612.3
130165,202210,139,124,15,150289.93,18180,168469.93
130170,202210,1093,753,340,912583.47,412089.24,1324672.71
130180,202210,280,213,67,258158.12,81204.2,339362.32
130185,202210,2315,1120,1195,1357465.24,1448359.23,2805824.47
130190,202210,3366,2100,1266,2547661.19,1534406.67,4082067.86
130195,202210,301,242,59,293304,71508,364812
130200,202210,194,105,89,127260.2,107868,235128.2
130210,202210,96,46,50,55752,60600,116352
130220,202210,219,157,62,190285.4,75144,265429.4
130230,202210,367,248,119,300576,144228,444804
130240,202210,1375,886,489,1075049.85,593880.88,1668930.73
130250,202210,4884,3151,1733,3819061.45,2105270.01,5924331.46
130255,202210,430,221,209,267852.52,253308.22,521160.74
130260,202210,64743,29894,34849,36251624.74,42271899.01,78523523.75
130270,202210,1563,1077,486,1305437.42,590245.61,1895683.03
130280,202210,145,85,60,103020.2,72720,175740.2
130290,202210,2081,1344,737,1628956.53,893252.38,2522208.91
130300,202210,431,294,137,356329.52,167258.26,523587.78
130310,202210,958,516,442,625392.7,535704.9,1161097.6
130320,202210,557,301,256,364812.8,310272.07,675084.87
130330,202210,779,502,277,608429.89,335725,944154.89
130340,202210,3582,1963,1619,2379201.36,1964676.61,4343877.97
130350,202210,470,326,144,395112,174528.25,569640.25
130353,202210,974,451,523,546623.24,633883.15,1180506.39
130356,202210,838,384,454,465410.48,550251.6,1015662.08
130360,202210,109,86,23,104232.32,27876,132108.32
130370,202210,704,552,152,669025.3,184224,853249.3
130380,202210,677,535,142,648423.06,173316,821739.06
130390,202210,468,377,91,456924.2,110292,567216.2
130395,202210,171,58,113,70296,136956.14,207252.14
130400,202210,99,79,20,95753.18,24240.1,119993.28
130406,202210,2197,1266,931,1535613.76,1128375.14,2663988.90
130410,202210,442,227,215,275124,260580,535704
130420,202210,2844,2305,539,2793728.95,653270.06,3446999.01
130423,202210,239,162,77,196349.39,93324,289673.39
130426,202210,189,102,87,123624,105444,229068
130430,202210,412,235,177,286032,214524,500556
130440,202210,202,72,130,87265.13,157561.9,244827.03
140002,202210,46,12,34,14544.2,41208.97,55753.17
140005,202210,238,138,100,167257.94,121201.59,288459.53
140010,202210,12365,7300,5065,8850303.82,6141336.26,14991640.08
140015,202210,176,74,102,89689.19,123624.92,213314.11
140017,202210,159,85,74,103027.2,89689.76,192716.96
140020,202210,452,303,149,367243.96,180590.5,547834.46
140023,202210,70,40,30,48480,36360,84840
140028,202210,27,15,12,19392.42,14544.7,33937.12
140030,202210,414,266,148,322396.15,179376.2,501772.35
140040,202210,76,51,25,61812,30300,92112
140045,202210,327,107,220,129684.8,266641.75,396326.55
140047,202210,572,367,205,444811.4,248461.43,693272.83
140050,202210,146,92,54,111507.36,65448,176955.36
140060,202210,90,61,29,73933.02,35148.2,109081.22
140070,202210,26,23,3,27876.2,3636,31512.2
150010,202210,5264,3157,2107,3827560.49,2558751.45,6386311.94
150013,202210,169,113,56,138168.96,67873.59,206042.55
150020,202210,1155,639,516,775688.84,626605.83,1402294.67
150030,202210,712,314,398,380578.18,482379.06,862957.24
150034,202210,219,129,90,156349.62,109080.5,265430.12
150040,202210,1704,974,730,1180516.59,884778.28,2065294.87
150050,202210,750,433,317,524800.44,384204.4,909004.84
150060,202210,5112,3178,1934,3852916.14,2344534.8,6197450.94
150070,202210,491,260,231,315123.92,279973,595096.92
150080,202210,18369,8562,9807,10379852.86,11892390.04,22272242.90
150085,202210,456,282,174,341789.46,210890.57,552680.03
150090,202210,725,581,144,704178.93,174529.1,878708.03
150095,202210,67,46,21,55753.94,25452.89,81206.83
150100,202210,76,46,30,55752,36360.7,92112.7
150110,202210,219,129,90,156349.48,109080.2,265429.68
150120,202210,409,290,119,351485.92,144228.4,495714.32
150125,202210,50,20,30,24240.4,36360,60600.4
150130,202210,2404,1182,1222,1432611.03,1482299.64,2914910.67
150140,202210,63010,27107,35903,32861867.02,43535032.86,76396899.88
150145,202210,263,143,120,173317.96,145440.3,318758.26
150150,202210,3703,1624,2079,1969552.27,2521007.03,4490559.30
150157,202210,376,273,103,330884.96,124836.8,455721.76
150160,202210,154,116,38,140593.47,46056,186649.47
150170,202210,4071,2925,1146,3545153.56,1388967.33,4934120.89
150172,202210,382,269,113,326030.15,136958.01,462988.16
150175,202210,91,51,40,61812.3,48480,110292.3
150178,202210,810,548,262,664190.83,317549.69,981740.52
150180,202210,3433,1716,1717,2079833.51,2081013.91,4160847.42
150190,202210,396,265,131,321184.07,158773.58,479957.65
150195,202210,132,73,59,88476.3,71508.54,159984.84
150200,202210,197,91,106,111504,128472.3,239976.3
150210,202210,3369,2609,760,3162174.42,921132.77,4083307.19
150215,202210,683,405,278,490870.69,336944.43,827815.12
150220,202210,3649,2419,1230,2931882.57,1490779.07,4422661.64
150230,202210,1417,1141,276,1382912.57,334514.03,1717426.60
150240,202210,7516,4131,3385,5008111.88,4103907.38,9112019.26
150250,202210,83,46,37,55752.3,44844,100596.3
150260,202210,129,90,39,110294.01,47268.8,157562.81
150270,202210,2221,1438,783,1742878.69,949004.77,2691883.46
150275,202210,553,356,197,431478.16,238765.63,670243.79
150276,202210,117,40,77,48480.1,93324.72,141804.82
150277,202210,892,395,497,478749.26,603586.24,1082335.50
150280,202210,346,238,108,289669.21,130896.2,420565.41
150285,202210,155,77,78,93324.57,94342.08,187666.65
150290,202210,1314,740,574,896898.27,699335.25,1596233.52
150293,202210,838,395,443,478751.71,536922.84,1015674.55
150295,202210,596,285,311,345428.79,376934.38,722363.17
150300,202210,97,45,52,54540.1,63024.6,117564.7
150304,202210,199,117,82,141804.7,99384.75,241189.45
150307,202210,462,380,82,460567.26,99384.5,559951.76
150309,202210,614,432,182,523598.95,220588.71,744187.66
150310,202210,288,190,98,230281.74,118776,349057.74
150320,202210,1948,1339,609,1622886.23,738117.22,2361003.45
150330,202210,2166,1236,930,1498045.19,1128376.44,2626421.63
150340,202210,207,132,75,159985.2,90900.2,250885.4
150345,202210,667,366,301,443597.12,364812,808409.12
150350,202210,429,341,88,413311.52,106658.18,519969.70
150360,202210,5079,2961,2118,3591229.83,2570682.38,6161912.21
150370,202210,851,573,278,695706.57,336941.28,1032647.85
150375,202210,193,81,112,98172,135744.18,233916.18
150380,202210,1573,1038,535,1258081.36,648425.36,1906506.72
150390,202210,928,529,399,641167.46,484804.2,1125971.66
150400,202210,116,97,19,117564.2,23028,140592.2
150405,202210,1695,1079,616,1308973.96,746595.07,2055569.03
150410,202210,106,66,40,79992,48480.2,128472.2
150420,202210,8114,4307,3807,5223719.24,4615406.65,9839125.89
150430,202210,680,418,262,506640.94,318761.7,825402.64
150440,202210,464,280,184,339366.63,224221.94,563588.57
150442,202210,2539,1345,1194,1630178.27,1448359.51,3078537.78
150445,202210,567,368,199,446020.8,241188.2,687209.0
150450,202210,235,136,99,164832.1,119988,284820.1
150460,202210,719,539,180,653282.53,218160.57,871443.10
150470,202210,1319,789,530,956285.79,642364.46,1598650.25
150475,202210,254,195,59,236344.88,71508.99,307853.87
150480,202210,1494,1044,450,1265360.14,545406.91,1810767.05
150490,202210,620,370,250,448442.76,303000,751442.76
150495,202210,357,265,92,321180.98,111504,432684.98
150497,202210,291,191,100,231493.98,121200,352693.98
150500,202210,276,160,116,193921.73,140592.7,334514.43
150503,202210,1408,705,703,854482.53,852045.19,1706527.72
150506,202210,930,642,288,778114.7,349058.01,1127172.71
150510,202210,1382,753,629,912652.65,762352.44,1675005.09
150520,202210,334,228,106,276337.59,128472,404809.59
150530,202210,2062,1164,898,1410824.69,1088432.13,2499256.82
150540,202210,227,168,59,203617.39,71509.16,275126.55
150543,202210,934,477,457,578139.36,553892.36,1132031.72
150548,202210,463,336,127,407233.47,153926.8,561160.27
150549,202210,89,57,32,69084.41,38784,107868.41
150550,202210,3315,1669,1646,2022853.62,1994966.85,4017820.47
150553,202210,3874,2156,1718,2614025.39,2085890.66,4699916.05
150555,202210,147,80,67,96960.2,81204.2,178164.4
150560,202210,72,35,37,42420.2,44844,87264.2
150563,202210,127,65,62,78783.4,75144.66,153928.06
150565,202210,225,133,92,161196.7,111504,272700.7
150570,202210,432,287,145,347844.3,175740.1,523584.4
150580,202210,1786,882,904,1068993.39,1096862.88,2165856.27
150590,202210,876,576,300,698123.47,363604.38,1061727.85
150600,202210,529,325,204,393911.09,247253.69,641164.78
150610,202210,180,142,38,172104.2,46056,218160.2
150611,202210,147,98,49,118776,59388,178164
150613,202210,3564,1981,1583,2403460.28,1919908.73,4323369.01
150616,202210,603,332,271,402389.46,328454.42,730843.88
150618,202210,1444,744,700,901736.09,849614.38,1751350.47
150619,202210,410,312,98,378145.85,119990.18,498136.03
150620,202210,1300,745,555,904168.09,673876.17,1578044.26
150630,202210,173,111,62,134537.72,75145.47,209683.19
150635,202210,491,224,267,271494.89,323606.88,595101.77
150640,202210,48,22,26,26665.06,31512,58177.06
150650,202210,2580,1479,1101,1792595.18,1334441.65,3127036.83
150655,202210,279,202,77,244824.2,93324,338148.2
150658,202210,77,42,35,50904.2,42420,93324.2
150660,202210,620,391,229,473900.6,278761.41,752662.01
150670,202210,1188,426,762,516318.05,923553.05,1439871.10
150680,202210,11653,6081,5572,7372764.25,6757038.68,14129802.93
150690,202210,41,21,20,25452.77,24240,49692.77
150700,202210,567,377,190,456940.34,230284.37,687224.71
150710,202210,298,169,129,204829.91,156349.76,361179.67
150715,202210,855,538,317,652067.94,384206.21,1036274.15
150720,202210,438,333,105,403599.28,127260.73,530860.01
150730,202210,1184,557,627,675099.88,759932.17,1435032.05
150740,202210,260,165,95,199980.88,115140,315120.88
150745,202210,830,461,369,558743.36,449655.06,1008398.42
150746,202210,71,36,35,43632,42420.2,86052.2
150747,202210,266,186,80,225435.25,96960.67,322395.92
150750,202210,138,78,60,94538.73,72721.67,167260.40
150760,202210,1925,1253,672,1518655.8,814471.24,2333127.04
150770,202210,414,240,174,290882.7,210888.2,501770.9
150775,202210,101,52,49,63025.13,59388.36,122413.49
150780,202210,213,122,91,147865.91,110292,258157.91
150790,202210,712,410,302,496927.91,366027.33,862955.24
150795,202210,1760,1079,681,1307764.02,826593.61,2134357.63
150796,202210,329,189,140,229068.53,169680.05,398748.58
150797,202210,414,190,224,230284.04,271489.34,501773.38
150800,202210,1708,943,765,1142926.72,927180.1,2070106.82
150803,202210,530,409,121,495715.12,146652.85,642367.97
150805,202210,212,125,87,151500.46,105445.4,256945.86
150808,202210,1131,566,565,685995.39,684783.71,1370779.10
150810,202210,3271,2202,1069,2668868.81,1295636.11,3964504.92
150812,202210,552,285,267,345423.42,323605.47,669028.89
150815,202210,1261,781,480,946577.47,581762.69,1528340.16
150820,202210,1716,1016,700,1231428.75,848418.44,2079847.19
150830,202210,590,442,148,535716.97,179378.32,715095.29
150835,202210,254,154,100,186650.95,121200.74,307851.69
150840,202210,1518,871,647,1055669.36,784175.62,1839844.98
160005,202210,73,49,24,59388.04,29088.12,88476.16
160010,202210,207,130,77,157562.84,94536.47,252099.31
160015,202210,191,129,62,156358.05,75144.16,231502.21
160020,202210,146,76,70,92114.54,84840,176954.54
160021,202210,71,33,38,39996.92,46056.75,86053.67
160023,202210,74,43,31,52117.34,37572.25,89689.59
160025,202210,28,13,15,15756.52,18180.12,33936.64
160027,202210,1541,853,688,1033874.62,835074.63,1868949.25
160030,202210,17834,9117,8717,11056165.96,10570022.31,21626188.27
160040,202210,342,212,130,256949.69,157560.46,414510.15
160050,202210,772,362,410,438758.07,496928.8,935686.87
160053,202210,310,183,127,221801.09,153926.72,375727.81
160055,202210,26,18,8,21817.71,9697.57,31515.28
160060,202210,7048,3794,3254,4600876.1,3943913.66,8544789.76
160070,202210,199,112,87,135745.03,105445.25,241190.28
160080,202210,144,72,72,87265,88476.02,175741.02
170025,202210,29,16,13,19392,15756.52,35148.52
170030,202210,172,138,34,167260.11,41208,208468.11
170035,202210,206,99,107,119991.67,129686.17,249677.84
170040,202210,180,134,46,162408,55752,218160
170070,202210,331,208,123,252950.42,149076.99,402027.41
170100,202210,354,256,98,310279.71,118776.19,429055.90
170105,202210,39,34,5,41208.7,6060,47268.7
170110,202210,115,70,45,84840.79,54540.1,139380.89
170130,202210,82,39,43,47268,52116,99384
170190,202210,101,59,42,71508.98,50904,122412.98
170200,202210,344,232,112,281185,135744.56,416929.56
170210,202210,6915,3772,3143,4575074.1,3810562.67,8385636.77
170215,202210,180,102,78,123625.48,94537.63,218163.11
170220,202210,1349,968,381,1173230.83,461776.62,1635007.45
170230,202210,149,98,51,118778.02,61812.69,180590.71
170240,202210,512,349,163,423000.58,197558.22,620558.80
170255,202210,1015,804,211,975671.2,255732.4,1231403.6
170270,202210,43,30,13,36360,15756,52116
170290,202210,140,86,54,104233.19,65448,169681.19
170300,202210,115,76,39,92112.2,47268,139380.2
170305,202210,52,42,10,50904,12120,63024
170307,202210,59,43,16,52117,19392.9,71509.9
170310,202210,129,78,51,94536,61812,156348
170320,202210,34,21,13,25452.2,15756,41208.2
170330,202210,32,24,8,29088,9696.1,38784.1
170360,202210,33,19,14,23028.2,16969.4,39997.6
170370,202210,79,42,37,50906.25,44844,95750.25
170380,202210,84,61,23,73932,27876,101808
170382,202210,37,31,6,37572,7272,44844
170384,202210,143,110,33,133320.94,39996.2,173317.14
170386,202210,69,29,40,35148,48480,83628
170388,202210,48,21,27,25452,32724.96,58176.96
170389,202210,27,21,6,25452.4,7272,32724.4
170390,202210,80,47,33,56964,39996,96960
170410,202210,25,23,2,27877.16,2424,30301.16
170460,202210,15,8,7,9696.2,8484.23,18180.43
170510,202210,33,25,8,30300.3,9696,39996.3
170550,202210,1609,933,676,1132028.13,819319.8,1951347.93
170555,202210,110,81,29,98175.78,35148,133323.78
170560,202210,102,74,28,89688,33936.1,123624.1
170600,202210,41,14,27,16968.91,32724,49692.91
170610,202210,186,99,87,119991.01,105444.2,225435.21
170625,202210,32,19,13,23028.99,15756,38784.99
170650,202210,97,67,30,81204,36360.2,117564.2
170700,202210,590,436,154,528436.56,187860,716296.56
170710,202210,150,91,59,110295.51,71509.74,181805.25
170720,202210,112,84,28,101808.2,33936,135744.2
170730,202210,108,63,45,76356,54540,130896
170740,202210,84,60,24,72720,29088,101808
170755,202210,52,28,24,33937.42,29088.2,63025.62
170765,202210,134,79,55,95749.73,66660,162409.73
170770,202210,197,129,68,156349.44,82416.73,238766.17
170820,202210,608,399,209,483594.28,254522.29,738116.57
170825,202210,48,30,18,36360,21816,58176
170830,202210,91,69,22,84840,26664,111504
170900,202210,170,131,39,158773.75,47268,206041.75
170930,202210,1004,554,450,671461.69,545406.62,1216868.31
170950,202210,3304,1559,1745,1889538.88,2114957.73,4004496.61
170980,202210,15,9,6,10908.86,7272,18180.86
171050,202210,146,111,35,134532,42420,176952
171070,202210,63,51,12,61812.57,14544.66,76357.23
171090,202210,48,36,12,43632,14544,58176
171110,202210,23,17,6,20605,7272,27877
171150,202210,42,27,15,32724,18180,50904
171180,202210,24,11,13,13332.2,16968.2,30300.4
171190,202210,185,104,81,126049.59,98172,224221.59
171195,202210,60,48,12,58177.23,14544,72721.23
171200,202210,34,17,17,20604,20604,41208
171215,202210,11,8,3,9696,3636,13332
171240,202210,65,49,16,59388,19392.37,78780.37
171245,202210,54,47,7,56965.2,8484,65449.2
171250,202210,79,45,34,54540.28,41208,95748.28
171270,202210,11,7,4,8484.6,4848.22,13332.82
171280,202210,45,36,9,43634.46,10908.1,54542.56
171320,202210,1065,617,448,747810.84,544189.33,1292000.17
171330,202210,436,223,213,270277.18,258156.1,528433.28
171360,202210,104,73,31,88476,37572,126048
171370,202210,41,22,19,26664,23028.1,49692.1
171380,202210,137,118,19,143017.6,23028,166045.6
171395,202210,40,25,15,30300,18180,48480
171420,202210,265,176,89,213314.22,107868.2,321182.42
171430,202210,73,59,14,71508,16968.05,88476.05
171488,202210,209,115,94,139380.14,113928,253308.14
171500,202210,64,36,28,43632,33936,77568
171510,202210,75,48,27,58176,32724.52,90900.52
171515,202210,39,32,7,38784.64,8484,47268.64
171525,202210,25,22,3,26665.09,3636,30301.09
171550,202210,15,9,6,10908.2,7272,18180.2
171570,202210,58,29,29,35148,35148.1,70296.1
171575,202210,271,184,87,223008.88,105444,328452.88
171610,202210,1930,1002,928,1214440.83,1125964.13,2340404.96
171620,202210,149,105,44,127261,53328,180589
171630,202210,49,28,21,33936,25452,59388
171650,202210,344,236,108,286039.09,130896.89,416935.98
171660,202210,268,152,116,184227.95,140592.6,324820.55
171665,202210,93,58,35,70296.69,42420.33,112717.02
171670,202210,444,275,169,334515.2,204829.37,539344.57
171700,202210,65,57,8,69084,9696,78780
171720,202210,28,10,18,12120,21816.2,33936.2
171750,202210,100,49,51,59388.26,61812.2,121200.46
171780,202210,78,61,17,73932,20604,94536
171790,202210,90,71,19,86052,23029.01,109081.01
171800,202210,35,28,7,33936,8484,42420
171820,202210,2149,1247,902,1512595.71,1093228.99,2605824.70
171830,202210,32,25,7,30300.2,8484,38784.2
171840,202210,55,35,20,42420.16,24240,66660.16
171845,202210,33,21,12,25452.99,14544,39996.99
171850,202210,45,36,9,43632.42,10908,54540.42
171855,202210,72,52,20,63024,24240,87264
171865,202210,6,4,2,4848,2424,7272
171870,202210,35,23,12,27876,14544.45,42420.45
171875,202210,86,62,24,75144,29088,104232
171880,202210,45,29,16,35148,19392.72,54540.72
171884,202210,55,30,25,36360,30300,66660
171886,202210,139,60,79,72720.2,95748.2,168468.4
171888,202210,28,21,7,25452.57,8484,33936.57
171889,202210,13,7,6,8484,7272,15756
171890,202210,55,45,10,54541.05,12120,66661.05
171900,202210,28,19,9,23028.9,10908,33936.9
172000,202210,34,30,4,36360.2,4848,41208.2
172010,202210,53,42,11,50904,13332.33,64236.33
172015,202210,21,16,5,19392.1,6060,25452.1
172020,202210,133,82,51,99384.14,61812.1,161196.24
172025,202210,41,27,14,32724,16968,49692
172030,202210,52,32,20,38785.08,24240,63025.08
172049,202210,80,51,29,61812.26,36360.2,98172.46
172065,202210,112,74,38,89690.06,46056.46,135746.52
172080,202210,121,73,48,88476.41,58177.12,146653.53
172085,202210,31,16,15,20604,18180,38784
172090,202210,455,332,123,402390.7,150288.8,552679.5
172093,202210,17,15,2,18180,2424,20604
172097,202210,17,9,8,10908,9696,20604
172100,202210,6025,3454,2571,4192395.69,3118520.21,7310915.90
172110,202210,83,55,28,66660.2,33936,100596.2
172120,202210,1761,1465,296,1776843.81,358755.1,2135598.91
172125,202210,15,12,3,14544,3636,18180
172130,202210,31,20,11,24240,13332.7,37572.7
172208,202210,200,129,71,156348,86052.88,242400.88
172210,202210,359,184,175,223010.58,212101.2,435111.78
210005,202210,3088,1942,1146,2356201.63,1390188.72,3746390.35
210010,202210,148,98,50,118777.21,60600,179377.21
210015,202210,43,30,13,36360.19,15756,52116.19
210020,202210,375,217,158,264217.97,191496.82,455714.79
210030,202210,317,219,98,265436.43,118779.05,384215.48
210040,202210,125,102,23,123624.1,27876,151500.1
210043,202210,272,221,51,269069.34,61812,330881.34
210047,202210,484,301,183,366025.53,221796,587821.53
210050,202210,270,197,73,238764.86,88476.2,327241.06
210055,202210,55,46,9,55752.79,10908,66660.79
210060,202210,535,431,104,522383.01,126050,648433.01
210070,202210,458,349,109,422988,132108.8,555096.8
210080,202210,148,136,12,164834.16,14544,179378.16
210083,202210,292,146,146,176952.2,176952,353904.2
210087,202210,7,6,1,7272,1212,8484
210090,202210,461,335,126,406030.38,153926.54,559956.92
210095,202210,428,335,93,406021.35,112718.27,518739.62
210100,202210,702,558,144,676302.16,174528.2,850830.36
210110,202210,118,81,37,98173.28,44844,143017.28
210120,202210,4895,3930,965,4763310.46,1169592.88,5932903.34
210125,202210,177,112,65,135744.9,78780.88,214525.78
210130,202210,446,266,180,322397.07,218161.13,540558.20
210135,202210,27,21,6,25452.39,7272,32724.39
210140,202210,4509,3462,1047,4197241.78,1268980.38,5466222.16
210150,202210,371,233,138,282404.03,167258.98,449663.01
210160,202210,3259,2776,483,3364574.25,585401.89,3949976.14
210170,202210,1238,999,239,1210822.91,289669.85,1500492.76
210173,202210,131,119,12,144231.66,14544,158775.66
210177,202210,294,169,125,204829.79,151500,356329.79
210180,202210,30,16,14,19392.2,16968,36360.2
210190,202210,449,306,143,370872.12,173316.9,544189.02
210193,202210,6,4,2,4848,2424,7272
210197,202210,69,52,17,63024,20604.4,83628.4
210200,202210,606,517,89,626618.21,107868.1,734486.31
210203,202210,224,162,62,196347.06,75145.12,271492.18
210207,202210,331,277,54,335729.18,65448,401177.18
210210,202210,698,651,47,789019.9,56964.6,845984.5
210215,202210,75,67,8,81206.11,9696,90902.11
210220,202210,349,299,50,362395.67,60601.59,422997.26
210230,202210,315,256,59,310274.48,71508.51,381782.99
210232,202210,1221,884,337,1072633.41,408444.94,1481078.35
210235,202210,186,141,45,170894.61,54540.4,225435.01
210237,202210,45,20,25,24241.16,30300,54541.16
210240,202210,76,66,10,79992.21,12120,92112.21
210250,202210,180,157,23,190284.29,27876,218160.29
210255,202210,387,289,98,350274.14,118777.71,469051.85
210260,202210,383,268,115,324817.3,139380,464197.3
210270,202210,616,431,185,522376.03,224221.29,746597.32
210275,202210,94,72,22,87265.04,26664,113929.04
210280,202210,1073,707,366,856893.34,446016.8,1302910.14
210290,202210,531,358,173,433902.04,209677.6,643579.64
210300,202210,4877,3169,1708,3842098.62,2071314.99,5913413.61
210310,202210,122,79,43,95748.2,52116,147864.2
210312,202210,120,86,34,104232.58,41208.8,145441.38
210315,202210,121,103,18,124837.09,21816,146653.09
210317,202210,141,110,31,133320,37572,170892
210320,202210,2416,2073,343,2513736.55,415716.2,2929452.75
210325,202210,149,91,58,110293.15,70296.2,180589.35
210330,202210,4212,2492,1720,3020351.07,2084643.29,5104994.36
210340,202210,1210,937,273,1135667.58,330878.18,1466545.76
210350,202210,674,561,113,681147.36,136956,818103.36
210355,202210,150,128,22,155137.16,26664,181801.16
210360,202210,2034,1472,562,1784095.9,681147.51,2465243.41
210370,202210,1238,651,587,789019.16,711447.09,1500466.25
210375,202210,191,95,96,115147.36,116353.49,231500.85
210380,202210,725,567,158,687209.23,191497.89,878707.12
210390,202210,194,161,33,195133.95,39996,235129.95
210400,202210,402,352,50,426631.06,60600.66,487231.72
210405,202210,1093,783,310,949006.16,375721.81,1324727.97
210407,202210,71,59,12,71508,14544,86052
210408,202210,43,38,5,47268.64,6060,53328.64
210409,202210,338,295,43,357541.51,52116.4,409657.91
210410,202210,441,351,90,425413.1,109080,534493.1
210420,202210,201,164,37,198768.5,44844.77,243613.27
210430,202210,57,42,15,50904.5,18180,69084.5
210440,202210,377,256,121,310278.71,146652.2,456930.91
210450,202210,110,96,14,116355.2,16968,133323.2
210455,202210,242,127,115,153927.36,139381.73,293309.09
210460,202210,314,214,100,259371.6,121201.11,380572.71
210462,202210,71,61,10,73932.64,12120.45,86053.09
210465,202210,127,102,25,123624.33,30300,153924.33
210467,202210,546,414,132,501774.6,159984.92,661759.52
210470,202210,42,36,6,44844,7272,52116
210480,202210,1341,969,372,1174447,450867.5,1625314.5
210490,202210,182,131,51,158773.03,61812.2,220585.23
210500,202210,497,316,181,382998.73,219374.51,602373.24
210510,202210,524,434,90,526010.77,109081,635091.77
210515,202210,335,216,119,261793.58,144228.2,406021.78
210520,202210,397,361,36,437535.22,43632,481167.22
210530,202210,9797,5028,4769,6095327.35,5785023.78,11880351.13
210535,202210,121,92,29,111504.6,35148,146652.6
210540,202210,1530,1036,494,1255660.83,598731.19,1854392.02
210542,202210,1106,564,542,683583,659340.24,1342923.24
210545,202210,21,19,2,23028.2,2424,25452.2
210547,202210,126,110,16,133321.86,19392.31,152714.17
210550,202210,585,413,172,500569.7,208465.41,709035.11
210560,202210,163,142,21,172105.39,25452.2,197557.59
210565,202210,23,15,8,18180.2,9696.08,27876.28
210570,202210,1295,1092,203,1323521.1,246037.34,1569558.44
210580,202210,125,109,16,132108,19392,151500
210590,202210,690,574,116,695690.47,140592,836282.47
210592,202210,48,45,3,54540,3636,58176
210594,202210,112,97,15,117564.6,18180,135744.6
210596,202210,118,103,15,124836.2,18180,143016.2
210598,202210,139,107,32,129684,38784.6,168468.6
210600,202210,300,258,42,312701.47,50904.2,363605.67
210610,202210,243,226,17,273916.22,20604.13,294520.35
210620,202210,44,29,15,35148,18180,53328
210630,202210,83,74,9,89688,10908,100596
210632,202210,964,696,268,843553.45,324816.2,1168369.65
210635,202210,25,22,3,26664,3636.2,30300.2
210637,202210,119,85,34,103020.2,41208,144228.2
210640,202210,567,504,63,612062.07,76356,688418.07
210650,202210,398,338,60,409660.74,72720,482380.74
210660,202210,373,295,78,357551.51,94537.08,452088.59
210663,202210,65,50,15,60600,18180,78780
210667,202210,87,39,48,47268.49,58177,105445.49
210670,202210,253,226,27,273914.02,32724.6,306638.62
210675,202210,487,282,205,341791.36,248462.2,590253.56
210680,202210,232,149,83,180590.16,100596,281186.16
210690,202210,88,80,8,96960.93,9696,106656.93
210700,202210,156,118,38,144229.2,46056.2,190285.4
210710,202210,237,153,84,185438.27,101808.6,287246.87
210720,202210,127,115,12,139380.2,14544,153924.2
210725,202210,59,50,9,60603,10908,71511
210730,202210,23,18,5,21816,6060,27876
210735,202210,285,207,78,250884.45,94536,345420.45
210740,202210,518,450,68,545416.14,82416,627832.14
210745,202210,157,119,38,144228.7,46056.2,190284.9
210750,202210,2664,1431,1233,1734408.19,1494409.89,3228818.08
210760,202210,254,200,54,242401.45,65448.19,307849.64
210770,202210,244,202,42,244834.27,50905.59,295739.86
210780,202210,409,313,96,379365.37,116352.4,495717.77
210790,202210,189,163,26,197557.48,31512,229069.48
210800,202210,174,132,42,159991.31,50904.55,210895.86
210805,202210,63,56,7,67872,8484,76356
210810,202210,438,357,81,432692.73,98172,530864.73
210820,202210,1973,1661,312,2013176.84,378145.47,2391322.31
210825,202210,151,91,60,110293.5,72720.2,183013.7
210830,202210,697,492,205,596308.8,248460.8,844769.6
210840,202210,204,148,56,179376.85,67872,247248.85
210845,202210,223,172,51,208465.62,61812,270277.62
210850,202210,715,508,207,615710.84,250887.3,866598.14
210860,202210,3400,2036,1364,2468881.29,1654385.06,4123266.35
210870,202210,395,318,77,385425.87,93324.2,478750.07
210880,202210,79,64,15,77569.57,18180.2,95749.77
210890,202210,315,276,39,334517.03,47268,381785.03
210900,202210,702,452,250,549047.83,303002.58,852050.41
210905,202210,70,40,30,48480.8,36360,84840.8
210910,202210,2111,1589,522,1925895.17,633882.93,2559778.10
210920,202210,144,63,81,76357.9,98172,174529.9
210923,202210,79,65,14,78780.63,16968,95748.63
210927,202210,408,212,196,256945.95,237552,494497.95
210930,202210,74,63,11,76356.2,13332,89688.2
210940,202210,75,60,15,72721.98,18180,90901.98
210945,202210,205,124,81,150290.29,98172,248462.29
210950,202210,510,377,133,456925.89,162408.65,619334.54
210955,202210,91,55,36,66660,43632.2,110292.2
210960,202210,2357,1217,1140,1476225.75,1381682.19,2857907.94
210970,202210,111,94,17,113928.86,20604.9,134533.76
210975,202210,79,75,4,90900.2,4848.95,95749.15
210980,202210,1038,528,510,639944.98,618122.11,1258067.09
210990,202210,4393,3110,1283,3769387.33,1556225.56,5325612.89
211000,202210,1275,1048,227,1272620.05,275125.52,1547745.57
211003,202210,969,712,257,864162.86,311484.76,1175647.62
211010,202210,490,443,47,536919.55,56964.2,593883.75
211020,202210,1371,627,744,759935.99,901738.27,1661674.26
211023,202210,42,37,5,44844,6060,50904
211027,202210,77,59,18,71508.4,21816,93324.4
211030,202210,359,257,102,311485.91,123624,435109.91
211040,202210,284,239,45,289669.66,54540,344209.66
211050,202210,1113,764,349,927201.27,422991.27,1350192.54
211060,202210,616,546,70,661771.12,84840.4,746611.52
211065,202210,24,18,6,21818.2,7272.11,29090.31
211070,202210,839,706,133,855693.51,161196.6,1016890.11
211080,202210,85,82,3,99384.22,3636,103020.22
211085,202210,64,35,29,42420.64,35148,77568.64
211090,202210,77,66,11,79993.26,13332,93325.26
211100,202210,462,393,69,476326.47,83628.4,559954.87
211102,202210,226,165,61,199980,73932,273912
211105,202210,218,157,61,190284.2,73932.26,264216.46
211107,202210,130,81,49,98172.2,59388,157560.2
211110,202210,965,655,310,793873.51,375725.63,1169599.14
211120,202210,5157,2749,2408,3331906.45,2919746.82,6251653.27
211125,202210,20,13,7,15756,8484,24240
211130,202210,41431,19974,21457,24217633.88,26012240.89,50229874.77
211140,202210,385,341,44,414513.14,53328.47,467841.61
211150,202210,1184,841,343,1019312.77,415718.32,1435031.09
211153,202210,163,97,66,118776,79992.2,198768.2
211157,202210,68,56,12,67872,14544,82416
211160,202210,677,578,99,700544.1,119988.6,820532.7
211163,202210,3,3,0,3636.23,,3636.23
211167,202210,12,11,1,13332,1212,14544
211170,202210,418,314,104,380568.74,126048.38,506617.12
211172,202210,105,76,29,92112.4,35148,127260.4
211174,202210,23,18,5,21816,6060.6,27876.6
211176,202210,458,331,127,401175.97,153925.38,555101.35
211178,202210,90,63,27,76356.2,32724,109080.2
211180,202210,215,173,42,209677.21,50904.04,260581.25
211190,202210,71,64,7,77568.2,8484,86052.2
211195,202210,38,26,12,31512.8,14544,46056.8
211200,202210,150,128,22,155136,26664.6,181800.6
211210,202210,395,302,93,367241.12,112716.38,479957.50
211220,202210,4370,2629,1741,3187656.25,2110140.48,5297796.73
211223,202210,122,113,9,136958.55,10908,147866.55
211227,202210,57,47,10,56964.2,12120,69084.2
211230,202210,711,588,123,712676.17,149077.64,861753.81
211240,202210,372,311,61,376934.25,75144,452078.25
211245,202210,182,98,84,118777.05,101808,220585.05
211250,202210,1474,1269,205,1538077.76,248461.44,1786539.20
211260,202210,781,671,110,813257.14,133320,946577.14
211270,202210,1840,1534,306,1860455.59,370872.74,2231328.33
211280,202210,1771,1221,550,1479871.11,666600.15,2146471.26
211285,202210,220,145,75,175740.1,90900,266640.1
211290,202210,774,544,230,659332.6,279974.64,939307.24
211300,202210,759,607,152,735694.55,184225.52,919920.07
211400,202210,1548,1014,534,1230198.82,648422.1,1878620.92
220005,202210,18,17,1,20604,1212,21816
220010,202210,79,67,12,81204.62,14544,95748.62
220020,202210,729,597,132,723571.94,159984.6,883556.54
220025,202210,106,102,4,123625.81,4848,128473.81
220027,202210,54,44,10,53328,12120,65448
220030,202210,122,104,18,126049.45,21816,147865.45
220040,202210,1281,984,297,1192622.17,359967.12,1552589.29
220045,202210,31,21,10,25452.58,12120.55,37573.13
220050,202210,682,569,113,689636.81,136956.59,826593.40
220060,202210,181,159,22,192710.47,26664.35,219374.82
220070,202210,110,95,15,116354.58,18180.2,134534.78
220080,202210,13,11,2,13332,2424,15756
220090,202210,40,29,11,35148,13332,48480
220095,202210,2,2,0,2424,,2424.0
220100,202210,21,17,4,20604.26,4848,25452.26
220105,202210,31,28,3,33936.6,3636,37572.6
220110,202210,244,224,20,271488.14,24240,295728.14
220115,202210,45,39,6,47268,7272,54540
220117,202210,22,20,2,24240,2424,26664
220120,202210,1502,1166,336,1414418.09,409656.2,1824074.29
220130,202210,27,27,0,32724.13,,32724.13
220140,202210,85,70,15,84840.4,18180.8,103021.2
220150,202210,490,367,123,444815.95,149078.98,593894.93
220155,202210,20,19,1,23028,1212,24240
220157,202210,21,18,3,21816.2,3636,25452.2
220160,202210,104,91,13,110292.8,15756,126048.8
220170,202210,39,33,6,39996,7272,47268
220173,202210,13,11,2,13332,2424,15756
220177,202210,16,15,1,18180,1212,19392
220180,202210,64,62,2,75145.08,2424,77569.08
220190,202210,1135,977,158,1184135.46,191499.2,1375634.66
220191,202210,36,30,6,36360.27,7272,43632.27
220192,202210,95,88,7,106656.2,8484,115140.2
220194,202210,64,55,9,66660.28,10908,77568.28
220196,202210,78,65,13,78782.21,15756.2,94538.41
220198,202210,1,1,0,1212,,1212.0
220200,202210,405,343,62,415727.28,75146.46,490873.74
220202,202210,34,30,4,36360.88,4848,41208.88
220205,202210,64,55,9,66660.2,10908,77568.2
220207,202210,15,15,0,18180.94,,18180.94
220208,202210,69,44,25,53328.4,30300.2,83628.6
220209,202210,31,26,5,31512,6060,37572
220210,202210,22,18,4,21816,4848,26664
220211,202210,34,33,1,39998.17,1212,41210.17
220213,202210,33,30,3,36361.04,3636,39997.04
220217,202210,41,34,7,41208.49,8484,49692.49
220220,202210,2354,1565,789,1898010.85,956275.64,2854286.49
220225,202210,7,2,5,2424.8,6060,8484.8
220230,202210,990,748,242,906589.34,293308.88,1199898.22
220240,202210,165,146,19,176952.78,23028.32,199981.10
220245,202210,42,39,3,47269.05,3636,50905.05
220250,202210,136,114,22,139382.47,26664,166046.47
220253,202210,51,46,5,55752,6060,61812
220255,202210,46,39,7,47268,8484,55752
220260,202210,708,541,167,655698.88,202405.69,858104.57
220265,202210,8,6,2,7272,2424,9696
220270,202210,847,764,83,925975.14,100596,1026571.14
220271,202210,39,30,9,36360.62,10908,47268.62
220272,202210,14,14,0,16968,,16968.0
220273,202210,14,13,1,15756.2,1212,16968.2
220275,202210,64,54,10,65448,12120,77568
220277,202210,29,22,7,26664,8485.19,35149.19
220280,202210,20,13,7,15756,8484,24240
220285,202210,42,40,2,48480.2,2424,50904.2
220290,202210,1544,1323,221,1603504.01,267856.22,1871360.23
220300,202210,39,39,0,47269.36,,47269.36
220310,202210,339,286,53,347853.15,64238.01,412091.16
220320,202210,442,407,35,494511.46,42421,536932.46
220323,202210,3,1,2,1212.8,2424.2,3637.0
220325,202210,8,7,1,8484,1212,9696
220327,202210,13,13,0,15756,,15756.0
220330,202210,216,153,63,185436.86,76356.7,261793.56
220335,202210,137,117,20,141805.84,24240,166045.84
220340,202210,45,35,10,42420,12120,54540
220342,202210,54,46,8,55754.22,9696,65450.22
220345,202210,84,72,12,87264,14544.3,101808.3
220350,202210,460,402,58,487228.08,70296.35,557524.43
220360,202210,49,33,16,39996,19392,59388
220370,202210,1348,1125,223,1364731.82,270276.54,1635008.36
220375,202210,18,17,1,20604.8,1212,21816.8
220380,202210,26,19,7,23028.8,8484.55,31513.35
220385,202210,16,14,2,16968,2424.66,19392.66
220390,202210,2405,1336,1069,1619262.65,1296860.28,2916122.93
220400,202210,36,31,5,37572,6060,43632
220410,202210,23,22,1,26664.2,1212,27876.2
220415,202210,13,12,1,14545.02,1212,15757.02
220420,202210,124,104,20,126049.93,24240,150289.93
220430,202210,141,124,17,150288.95,20604.2,170893.15
220435,202210,22,17,5,20604.5,6060,26664.5
220440,202210,271,232,39,281192.65,47268,328460.65
220450,202210,358,179,179,216952.43,216951.8,433904.23
220455,202210,53,52,1,63024.26,1212,64236.26
220460,202210,19,17,2,20604.4,2424.19,23028.59
220465,202210,65,43,22,52116.59,26664.28,78780.87
220470,202210,235,206,29,249675.48,35148.01,284823.49
220480,202210,67,62,5,75144,6060,81204
220490,202210,88,73,15,88476,18180,106656
220500,202210,118,99,19,119988.36,23028,143016.36
220510,202210,364,282,82,341791.04,99384.88,441175.92
220515,202210,26,24,2,29088.34,2424,31512.34
220520,202210,373,329,44,399964.63,53328.95,453293.58
220525,202210,7,3,4,3636.93,4848,8484.93
220527,202210,12,12,0,14544,,14544.0
220530,202210,47,24,23,29088,27876.87,56964.87
220535,202210,7,5,2,6060.2,2424,8484.2
220540,202210,100,86,14,104232.4,16968,121200.4
220545,202210,24,16,8,19392.49,9696.1,29088.59
220550,202210,730,577,153,700550.31,185437.4,885987.71
220551,202210,10,8,2,9696,2424,12120
220552,202210,12,12,0,14544,,14544.0
220553,202210,56,51,5,61812.67,6060,67872.67
220554,202210,9,6,3,7272.2,3636,10908.2
220555,202210,43,36,7,43632.68,8484,52116.68
220556,202210,40,38,2,46056,2424,48480
220557,202210,61,53,8,64236.65,9696.74,73933.39
220558,202210,11,6,5,7272,6060,13332
220559,202210,6,6,0,7272.74,,7272.74
220560,202210,78,51,27,61812,32724,94536
220570,202210,725,450,275,545404.3,333302.04,878706.34
220580,202210,541,496,45,601176.16,54541,655717.16
220585,202210,15,13,2,15756.2,2424.2,18180.4
220590,202210,13,12,1,14544,1212,15756
220595,202210,76,57,19,69084.85,24240.1,93324.95
220600,202210,24,17,7,20604,8484,29088
220605,202210,28,25,3,30300,3636,33936
220610,202210,93,77,16,93324,19392,112716
220620,202210,558,477,81,578131.19,98172.84,676304.03
220630,202210,5,2,3,2424,3636.2,6060.2
220635,202210,31,28,3,33936.46,3636,37572.46
220640,202210,110,90,20,109080,25452,134532
220650,202210,114,108,6,130896,7272,138168
220660,202210,71,54,17,65449.3,20604.8,86054.1
220665,202210,9,9,0,10908,,10908.0
220667,202210,21,19,2,23028.19,2424,25452.19
220669,202210,35,30,5,36360.2,6060,42420.2
220670,202210,72,57,15,69084,18180,87264
220672,202210,81,57,24,69085.71,29088.8,98174.51
220675,202210,28,21,7,25452.67,8484,33936.67
220680,202210,60,51,9,61812,10908,72720
220690,202210,47,45,2,54540.8,2424,56964.8
220695,202210,28,16,12,19392.74,14544,33936.74
220700,202210,1859,1436,423,1741659.22,512679.45,2254338.67
220710,202210,8,6,2,7272.22,2424.81,9697.03
220720,202210,110,93,17,112716,20604,133320
220730,202210,24,23,1,27876.15,1212,29088.15
220735,202210,5,3,2,3636,2424,6060
220740,202210,52,45,7,54540,8484.91,63024.91
220750,202210,123,104,19,127260.87,23028.21,150289.08
220755,202210,16,16,0,19393.57,,19393.57
220760,202210,69,62,7,75144.6,8484,83628.6
220770,202210,6018,3442,2576,4171810.17,3124593.5,7296403.67
220775,202210,13,10,3,12120,3636.8,15756.8
220777,202210,20,19,1,23028,1212,24240
220779,202210,5,2,3,2424,3636,6060
220780,202210,927,787,140,953849.8,169680.88,1123530.68
220785,202210,4,1,3,1212,3636,4848
220790,202210,1218,978,240,1186566.16,290885.33,1477451.49
220793,202210,7,5,2,6060,2424,8484
220795,202210,21,19,2,23028,2424,25452
220800,202210,4111,3141,970,3807160.41,1175645.85,4982806.26
220810,202210,73,63,10,76356.99,12120,88476.99
220820,202210,250,228,22,276342.55,26665.8,303008.35
220830,202210,1303,1143,160,1385327.32,193921.07,1579248.39
220840,202210,2589,1826,763,2213150.32,924771.46,3137921.78
220850,202210,74,64,10,77568,12120,89688
220855,202210,8,4,4,4848,4848,9696
220860,202210,14,11,3,13333.09,3636,16969.09
220865,202210,30,27,3,32724,3636,36360
220870,202210,90,80,10,96960.4,12120,109080.4
220880,202210,332,274,58,332094.48,70297.54,402392.02
220885,202210,26,25,1,30301.12,1212,31513.12
220887,202210,6,5,1,6060.2,1212,7272.2
220890,202210,89,76,13,92113.29,15756,107869.29
220900,202210,25,13,12,15756,14544,30300
220910,202210,49,39,10,47268.85,12120,59388.85
220915,202210,9,8,1,9696,1212,10908
220920,202210,45,41,4,49693.06,4848,54541.06
220930,202210,51,49,2,59388.56,2424,61812.56
220935,202210,14,14,0,16968,,16968.0
220937,202210,35,30,5,36360.29,6060,42420.29
220940,202210,57,51,6,61812,7272,69084
220945,202210,3,3,0,3636,,3636.0
220950,202210,34,27,7,32724.2,8484,41208.2
220955,202210,17,17,0,20604.72,,20604.72
220960,202210,34,30,4,36360,4848,41208
220965,202210,48,44,4,53328,4848,58176
220970,202210,65,55,10,66660,12120,78780
220975,202210,11,10,1,12120.4,1212,13332.4
220980,202210,30,27,3,32724.26,3636,36360.26
220985,202210,54,46,8,55752,9696,65448
220987,202210,29,28,1,33938.18,1212.8,35150.98
220990,202210,23,23,0,27876.2,,27876.2
220995,202210,12,9,3,10908,3636,14544
220997,202210,65,57,8,69084.4,9696,78780.4
221000,202210,1282,1137,145,1379275.46,175740.86,1555016.32
221005,202210,41,38,3,46056,3636.8,49692.8
221010,202210,26,18,8,21816,9696,31512
221020,202210,39,34,5,41208.96,6060,47268.96
221030,202210,41,34,7,41112.45,8484,49596.45
221035,202210,24,22,2,26664.5,2424,29088.5
221037,202210,14,10,4,12120,4848,16968
221038,202210,26,23,3,27876,3636,31512
221039,202210,23,22,1,26664.25,1212.2,27876.45
221040,202210,263,226,37,273915.84,44844.2,318760.04
221050,202210,230,194,36,235133.52,43632.2,278765.72
221060,202210,2001,1717,284,2082249.88,345424.45,2427674.33
221062,202210,27,27,0,32724.25,,32724.25
221063,202210,17,13,4,15756,4848,20604
221065,202210,71,57,14,69085.41,16968,86053.41
221070,202210,156,136,20,164834.59,24240,189074.59
221080,202210,398,337,61,408450.71,73932,482382.71
221090,202210,24,19,5,23029.05,6060,29089.05
221093,202210,46,30,16,36360.4,19392,55752.4
221095,202210,4,4,0,4848,,4848.0
221097,202210,13,11,2,13332,2424,15756
221100,202210,27351,16328,11023,19799845.69,13374623.14,33174468.83
221110,202210,1172,894,278,1083545.28,336940.65,1420485.93
221120,202210,572,413,159,500562.88,192708,693270.88
221130,202210,1011,819,192,992639.9,232706.54,1225346.44
221135,202210,34,30,4,36360,4848,41208
221140,202210,48,41,7,49692.2,8484,58176.2
221150,202210,11,8,3,9696.18,3636,13332.18
221160,202210,14,14,0,16968.9,,16968.9
221170,202210,20,19,1,23028,1212,24240
230010,202210,166,143,23,173316.46,27876,201192.46
230015,202210,164,138,26,167256.6,31512,198768.6
230020,202210,1818,1469,349,1780447.56,422998.83,2203446.39
230030,202210,1698,1227,471,1488362.16,570857.16,2059219.32
230040,202210,232,185,47,224220.3,58176.9,282397.2
230050,202210,244,171,73,208464,89688.2,298152.2
230060,202210,174,140,34,169680,41209.3,210889.3
230070,202210,307,261,46,316333.9,55752,372085.9
230075,202210,931,773,158,936888.56,191497.84,1128386.40
230080,202210,228,186,42,225432,50904,276336
230090,202210,177,129,48,156348.2,58176,214524.2
230100,202210,2745,1532,1213,1856823.12,1470168.85,3326991.97
230110,202210,3120,1959,1161,2374351.2,1409570.66,3783921.86
230120,202210,1190,910,280,1102934.62,340574.03,1443508.65
230125,202210,175,137,38,166044.2,46056,212100.2
230130,202210,518,450,68,545404.29,82416.1,627820.39
230140,202210,223,181,42,219372.95,50904,270276.95
230150,202210,157,119,38,144228.75,46056.4,190285.15
230160,202210,1018,827,191,1002329.2,231492.68,1233821.88
230170,202210,666,584,82,707825.52,99387.33,807212.85
230180,202210,68,62,6,75144.47,7272,82416.47
230185,202210,423,357,66,432688.78,79992.26,512681.04
230190,202210,2601,1962,639,2382833.83,775687.13,3158520.96
230195,202210,546,463,83,561165.21,100596,661761.21
230200,202210,463,356,107,431476.13,130896.2,562372.33
230205,202210,427,281,146,341785,178164.6,519949.6
230210,202210,1466,1115,351,1351395.29,425413.28,1776808.57
230220,202210,1681,1116,565,1352612.17,684789.27,2037401.44
230230,202210,1042,844,198,1022939.41,239977.51,1262916.92
230240,202210,2048,1775,273,2151624.99,330879.69,2482504.68
230250,202210,1875,1511,364,1831369.08,442386.17,2273755.25
230260,202210,3424,2100,1324,2546432.61,1605904.22,4152336.83
230270,202210,1416,1104,312,1338059.81,379359.23,1717419.04
230280,202210,2934,2233,701,2706439.54,849619.64,3556059.18
230290,202210,364,317,47,384210.97,56965.78,441176.75
230300,202210,530,387,143,469046.84,173316.29,642363.13
230310,202210,452,347,105,420565.05,127261.58,547826.63
230320,202210,976,817,159,990216,192708.8,1182924.8
230330,202210,327,263,64,318756.76,77568.4,396325.16
230340,202210,467,374,93,453293.16,112716.4,566009.56
230350,202210,3515,2142,1373,2596154.76,1666513.15,4262667.91
230360,202210,281,227,54,275125.52,65448.24,340573.76
230365,202210,133,105,28,127260.53,33936,161196.53
230370,202210,11956,5937,6019,7197043.89,7303661.91,14500705.80
230380,202210,512,437,75,530860.19,90901.77,621761.96
230390,202210,548,315,233,381783.83,282396.6,664180.43
230393,202210,236,192,44,232704.31,53328.5,286032.81
230395,202210,373,295,78,357548.91,94539.14,452088.05
230400,202210,662,523,139,633882.43,168468.4,802350.83
230410,202210,2908,1809,1099,2195132.42,1332005.3,3527137.72
230420,202210,6858,4525,2333,5485659.62,2830084.63,8315744.25
230423,202210,351,304,47,368451.44,56964.1,425415.54
230425,202210,510,403,107,488441.23,129685.14,618126.37
230426,202210,123,94,29,113928,35148,149076
230427,202210,75,68,7,82416.8,8484,90900.8
230428,202210,1799,879,920,1065362.99,1115044.82,2180407.81
230430,202210,482,385,97,466625.51,117566.37,584191.88
230435,202210,1002,717,285,869010.76,345421.79,1214432.55
230440,202210,102281,46687,55594,56617735.76,67420993.46,124038729.22
230445,202210,344,233,111,282401.63,134532.2,416933.83
230450,202210,606,475,131,575701.23,158772,734473.23
230460,202210,105,75,30,90902.29,36360,127262.29
230465,202210,329,268,61,324819.41,73932,398751.41
230470,202210,2098,1635,463,1982847.25,561158.28,2544005.53
230480,202210,151,136,15,164832.5,18180.56,183013.06
230490,202210,351,277,74,335725.7,89688,425413.7
230495,202210,514,356,158,431480.17,191498.67,622978.84
230500,202210,1163,863,300,1045964.6,363601.19,1409565.79
230510,202210,73,48,25,58176,30300,88476
230520,202210,425,324,101,392690.08,122412.62,515102.70
230523,202210,2712,1658,1054,2010742.24,1279888.96,3290631.20
230526,202210,257,217,40,263005.49,48480,311485.49
230530,202210,709,514,195,622976.77,236342.75,859319.52
230533,202210,222,202,20,244827.06,24240.2,269067.26
230535,202210,428,321,107,389056.68,129684.35,518741.03
230540,202210,1853,1650,203,1999824.53,247249.79,2247074.32
230550,202210,4293,2716,1577,3295517.93,1914998.22,5210516.15
230560,202210,614,461,153,558738.47,185436.57,744175.04
230565,202210,231,171,60,207252,72720.2,279972.2
230570,202210,326,275,51,333301.28,61812.6,395113.88
230580,202210,1262,878,384,1064142.04,465412.38,1529554.42
230590,202210,1081,824,257,1002239.48,311485.84,1313725.32
230600,202210,282,253,29,306639.61,35148,341787.61
230610,202210,478,353,125,427838.59,151500.2,579338.79
230620,202210,179,147,32,178166.16,38784,216950.16
230625,202210,894,601,293,730849.53,355116.5,1085966.03
230630,202210,1510,1127,383,1367153.58,464199.19,1831352.77
230640,202210,4152,3388,764,4108761.43,928414.09,5037175.52
230650,202210,508,433,75,524798.09,90900.65,615698.74
230655,202210,769,618,151,749030.24,183014.77,932045.01
230660,202210,354,294,60,356331.19,72720.2,429051.39
230670,202210,489,391,98,473905.59,118776.49,592682.08
230680,202210,223,194,29,235130.41,35148,270278.41
230690,202210,1015,849,166,1031428.3,201192.33,1232620.63
230700,202210,1045,862,183,1045970.47,221796.92,1267767.39
230710,202210,694,641,53,776908.79,64236.3,841145.09
230720,202210,149,127,22,153924,26664.2,180588.2
230725,202210,291,219,72,265430.74,87264.46,352695.20
230730,202210,13546,7145,6401,8663481.16,7766611.44,16430092.60
230740,202210,723,577,146,699342.77,178165.04,877507.81
230750,202210,857,706,151,855681.59,183012.46,1038694.05
230760,202210,1681,1422,259,1723501.17,315121.67,2038622.84
230763,202210,356,290,66,351482.79,79992.07,431474.86
230765,202210,8952,4170,4782,5056613.46,5800785.71,10857399.17
230770,202210,5366,2706,2660,3280963.05,3223954.38,6504917.43
230780,202210,826,714,112,865373.66,135744,1001117.66
230790,202210,332,270,62,327240,75144.4,402384.4
230800,202210,1237,878,359,1064143.03,435109.31,1499252.34
230810,202210,1488,1281,207,1552606.48,250887.28,1803493.76
230820,202210,392,258,134,312698.03,162409.45,475107.48
230830,202210,1012,845,167,1024152.2,202404.9,1226557.1
230835,202210,293,238,55,288457.91,66660.68,355118.59
230837,202210,189,152,37,184224.85,44844.1,229068.95
230840,202210,987,750,237,909005.37,287246.81,1196252.18
230850,202210,1447,1219,228,1478668.98,276339.84,1755008.82
230860,202210,341,262,79,317546.12,95754.25,413300.37
230870,202210,1929,1632,297,1979219.57,359964.81,2339184.38
230880,202210,83,66,17,79992.45,20604,100596.45
230890,202210,586,514,72,622972.98,87264.8,710237.78
230900,202210,324,242,82,293304.88,99384.88,392689.76
230910,202210,232,181,51,220585.23,61812,282397.23
230920,202210,516,402,114,487226.85,138168,625394.85
230930,202210,1140,788,352,955073.75,426627.16,1381700.91
230940,202210,872,667,205,808413.49,248461.35,1056874.84
230945,202210,583,464,119,562380.39,144232.06,706612.45
230950,202210,447,385,62,466631,75144.9,541775.9
230960,202210,2973,1970,1003,2388909.45,1215664.95,3604574.40
230970,202210,1889,1018,871,1233846.74,1055664.06,2289510.80
230980,202210,225,172,53,208465.93,64236,272701.93
230990,202210,146,115,31,139380.25,37572.6,176952.85
231000,202210,218,199,19,241188.14,23028,264216.14
231010,202210,191,129,62,156349.45,75145.49,231494.94
231020,202210,1532,1026,506,1244755.23,613285.58,1858040.81
231025,202210,1197,825,372,999928.87,452088.95,1452017.82
231030,202210,1094,881,213,1067781.84,258157.37,1325939.21
231040,202210,179,121,58,146653.45,71508.2,218161.65
231050,202210,991,851,140,1032639.01,169686.23,1202325.24
231060,202210,170,137,33,167257.58,39997.6,207255.18
231070,202210,1571,1072,499,1299282.62,606004.84,1905287.46
231080,202210,276,244,32,296944.92,38784,335728.92
231085,202210,733,446,287,540560.79,347844.89,888405.68
231090,202210,276,221,55,269066.75,66661.64,335728.39
231095,202210,165,125,40,151500,48480.77,199980.77
231100,202210,188,150,38,181800.24,46056,227856.24
231110,202210,389,323,66,391479.95,79992.91,471472.86
231120,202210,262,220,42,267852.8,50905.03,318757.83
231123,202210,156,147,9,178165.35,10908,189073.35
231126,202210,349,268,81,324816.46,98172.17,422988.63
231130,202210,5168,3997,1171,4849310.03,1420485.34,6269795.37
231135,202210,223,195,28,236341.95,33936.32,270278.27
231140,202210,3184,2272,912,2754922.03,1105354.75,3860276.78
231150,202210,402,375,27,454504.81,32724,487228.81
231160,202210,1304,1060,244,1284738.52,295728.46,1580466.98
231170,202210,552,381,171,461773.93,207252,669025.93
231180,202210,1986,1714,272,2078617.19,329668.73,2408285.92
231190,202210,225,180,45,218160.1,54540,272700.1
231195,202210,241,195,46,236340.8,55752.6,292093.4
231200,202210,881,706,175,855685.23,213315.59,1069000.82
231210,202210,540,453,87,550255.27,106657.39,656912.66
231220,202210,1108,780,328,945375.46,397538.04,1342913.50
231230,202210,1609,1191,418,1443506.52,506617.1,1950123.62
231240,202210,1691,1138,553,1379271.83,670243.76,2049515.59
231250,202210,98,92,6,111505.07,7272,118777.07
231260,202210,268,176,92,213313.9,111504.96,324818.86
231270,202210,1039,796,243,964773.53,294518.21,1259291.74
231280,202210,85,65,20,78780.2,24240,103020.2
231290,202210,8442,4678,3764,5679551.11,4566884.72,10246435.83
231300,202210,608,555,53,672667.08,64236,736903.08
231310,202210,855,782,73,947794.02,88477.2,1036271.22
231320,202210,619,460,159,557521.32,192709.16,750230.48
231325,202210,107,91,16,110292,19392,129684
231330,202210,2046,1541,505,1868935.15,612067.05,2481002.20
231335,202210,267,232,35,281185.58,42420.6,323606.18
231340,202210,1994,1363,631,1653191.65,765993.06,2419184.71
231350,202210,1477,1163,314,1410804.45,380581.31,1791385.76
231355,202210,431,350,81,424202.63,98172.64,522375.27
231360,202210,590,402,188,487231.08,227856.61,715087.69
231370,202210,101,84,17,101808,20604,122412
231375,202210,303,226,77,273913.64,93324.1,367237.74
231380,202210,544,432,112,523585.62,135744,659329.62
231390,202210,205,157,48,190284.79,58176,248460.79
231395,202210,812,489,323,592669.36,391476.3,984145.66
231400,202210,1240,1022,218,1239889.36,264221.49,1504110.85
231410,202210,1441,1170,271,1419274.41,329666.92,1748941.33
240010,202210,392,171,221,207257.7,267859.55,475117.25
240020,202210,2398,1956,442,2373153.97,535711.52,2908865.49
240030,202210,122,97,25,117565.07,30300,147865.07
240040,202210,31,30,1,36360,1212,37572
240050,202210,543,468,75,567234.94,90900.1,658135.04
240060,202210,80,73,7,88476.3,8484,96960.3
240070,202210,286,214,72,260580.78,87264.38,347845.16
240080,202210,610,411,199,498144.55,241192.54,739337.09
240090,202210,103,90,13,109080.7,15756,124836.7
240100,202210,1583,1485,98,1799852.34,118777.47,1918629.81
240110,202210,1095,734,361,889640.87,438764.59,1328405.46
240120,202210,162,119,43,144228.48,52116.89,196345.37
240130,202210,282,256,26,310281.07,31512.6,341793.67
240140,202210,94,61,33,73933.89,39996.64,113930.53
240145,202210,756,663,93,803572.7,112716.1,916288.8
240150,202210,27,20,7,24240,8484,32724
240160,202210,40,31,9,37572,10908,48480
240165,202210,44,35,9,42422.15,10908.2,53330.35
240170,202210,155,108,47,130897.1,56964,187861.1
240180,202210,120,90,30,109082.27,36360,145442.27
240185,202210,54,47,7,56965.19,8484,65449.19
240190,202210,16,14,2,16968.43,2424,19392.43
240200,202210,3232,1736,1496,2104063.14,1813167.78,3917230.92
240210,202210,165,126,39,152712,47268,199980
240220,202210,1180,806,374,976905.22,453291.81,1430197.03
240230,202210,851,768,83,930844.95,101810.37,1032655.32
240240,202210,84,55,29,66660,35148.2,101808.2
240250,202210,100,85,15,103021.6,18180,121201.6
240260,202210,1967,1377,590,1668951.73,715086.51,2384038.24
240270,202210,177,152,25,184225.4,30300,214525.4
240280,202210,66,53,13,64236.3,15756,79992.3
240290,202210,42,40,2,48480,2424,50904
240300,202210,172,91,81,110292.4,98172,208464.4
240310,202210,2623,1396,1227,1693206.96,1489567.99,3182774.95
240320,202210,179,164,15,198768.07,18180,216948.07
240325,202210,5117,2889,2228,3502796.97,2702819.51,6205616.48
240330,202210,82,76,6,92112,7272,99384
240340,202210,102,70,32,84840,38784,123624
240350,202210,96,77,19,93324.2,23028,116352.2
240360,202210,738,466,272,564806,329672.01,894478.01
240370,202210,66,58,8,70297.02,9696,79993.02
240375,202210,52,33,19,39997.19,23028.4,63025.59
240380,202210,222,181,41,219378.07,49692.7,269070.77
240390,202210,18,15,3,18180,3636,21816
240400,202210,88,78,10,94536.1,12120.2,106656.3
240410,202210,11,8,3,9696,3636,13332
240420,202210,1156,820,336,993863.96,408451.63,1402315.59
240430,202210,263,241,22,293310.28,26664.82,319975.10
240440,202210,151,79,72,95751.16,87264.94,183016.10
240450,202210,256,156,100,189078.96,121203.4,310282.36
240460,202210,86,67,19,81204,23028,104232
240470,202210,224,203,21,246043.8,25452.21,271496.01
240480,202210,15,13,2,15756,2424,18180
240485,202210,82,64,18,77568.8,21816,99384.8
240490,202210,64,58,6,70296,7272,77568
240500,202210,106,80,26,96960.6,31512,128472.6
240510,202210,40,30,10,36360.6,12120,48480.6
240520,202210,98,93,5,112716.5,6060.04,118776.54
240530,202210,62,50,12,60600.66,14544,75144.66
240540,202210,100,86,14,104232.1,16968.15,121200.25
240550,202210,13,10,3,12120,3636,15756
240560,202210,411,281,130,340578.77,157560.6,498139.37
240570,202210,449,276,173,334516.11,209677.18,544193.29
240580,202210,1394,1041,353,1264136.03,427837.3,1691973.33
240590,202210,30,29,1,35148.48,1212,36360.48
240600,202210,101,94,7,113928.98,8484,122412.98
240610,202210,511,419,92,509052.89,111506.3,620559.19
240615,202210,13,12,1,14544,1212,15756
240620,202210,88,84,4,101809.54,4848,106657.54
240630,202210,39,31,8,37572.52,9696.67,47269.19
240640,202210,36,25,11,30300,13332,43632
240650,202210,244,194,50,235129.25,60600.36,295729.61
240660,202210,114,97,17,117564.95,20604.2,138169.15
240670,202210,311,168,143,203623.42,173323.13,376946.55
240680,202210,56,43,13,52116,15756.1,67872.1
240690,202210,52,49,3,59389,3636,63025
240700,202210,178,147,31,178164.75,37573.02,215737.77
240710,202210,2348,1402,946,1700474.86,1147778.52,2848253.38
240720,202210,1105,779,326,945380.25,396328.6,1341708.85
240725,202210,74,66,8,79992.42,9696,89688.42
240730,202210,150,125,25,151500.09,30300,181800.09
240740,202210,235,195,40,236345.81,48480.62,284826.43
240750,202210,52,29,23,35148,27876,63024
240760,202210,59,47,12,56964,14544,71508
240770,202210,152,118,34,143016.34,41209.54,184225.88
240780,202210,752,618,134,749032.26,162408.43,911440.69
240790,202210,41,39,2,47268.88,2424,49692.88
240800,202210,10086,6782,3304,8223762.45,4008222.24,12231984.69
240810,202210,22671,11974,10697,14526344.03,12973525.71,27499869.74
240820,202210,275,162,113,196347.43,138170.11,334517.54
240830,202210,1641,1348,293,1633813.91,355121.67,1988935.58
240840,202210,76,64,12,77568.8,14544,92112.8
240850,202210,89,78,11,94536,13332,107868
240860,202210,112,107,5,129685.38,6060,135745.38
240870,202210,58,47,11,56965.44,13332,70297.44
240880,202210,32,29,3,35148,3636,38784
240890,202210,1220,677,543,820540.66,658124.86,1478665.52
240895,202210,65,49,16,59389.02,19392,78781.02
240910,202210,182,149,33,180589.23,39996,220585.23
240920,202210,14,12,2,14546.04,2424,16970.04
240930,202210,429,380,49,461788.97,59389.82,521178.79
240933,202210,61,39,22,47268.95,26664,73932.95
240940,202210,2367,2066,301,2505243.58,364817.29,2870060.87
240950,202210,43,38,5,46056,6060,52116
240960,202210,25,20,5,24240,6060.2,30300.2
240970,202210,110,78,32,95748,38784,134532
240980,202210,216,168,48,203616.18,58177.03,261793.21
240990,202210,143,91,52,110292.2,64236,174528.2
241000,202210,61,55,6,66660.35,7272,73932.35
241010,202210,90,70,20,84840.3,24240,109080.3
241020,202210,114,104,10,126048.8,12120.76,138169.56
241025,202210,20,12,8,15756.95,9696.5,25453.45
241030,202210,109,87,22,105444,26664,132108
241040,202210,43,35,8,42420.1,9696,52116.1
241050,202210,74,68,6,82416.2,7272,89688.2
241060,202210,25,21,4,25452,4848,30300
241070,202210,25,25,0,30301.75,,30301.75
241080,202210,63,55,8,66660.2,9696,76356.2
241090,202210,53,41,12,49694.06,14544,64238.06
241100,202210,75,65,10,78780,12120.29,90900.29
241105,202210,25,14,11,16968.7,13332.3,30301.0
241110,202210,54,44,10,53328.15,12120,65448.15
241120,202210,1736,1310,426,1587749.5,517529.07,2105278.57
241140,202210,205,169,36,204829.5,43632,248461.5
241142,202210,51,38,13,46056,15756.45,61812.45
241150,202210,1213,1046,167,1268998.65,202406.06,1471404.71
241160,202210,26,19,7,23028,8484,31512
241170,202210,50,43,7,52116,8484,60600
241180,202210,45,33,12,39996,14544,54540
241190,202210,42,38,4,46057.4,4848,50905.4
241200,202210,4849,2533,2316,3071301.29,2807065.14,5878366.43
241210,202210,72,62,10,75144.31,12120,87264.31
241220,202210,1591,1010,581,1225367.35,704185.52,1929552.87
241230,202210,251,204,47,247249.72,56964,304213.72
241240,202210,51,37,14,44844,16968,61812
241250,202210,1175,1072,103,1299286.49,124837.76,1424124.25
241255,202210,63,52,11,63026.54,13332,76358.54
241260,202210,740,567,173,688426.57,209677.67,898104.24
241270,202210,72,50,22,60600,26664.03,87264.03
241280,202210,96,84,12,101809.07,14544,116353.07
241290,202210,143,107,36,129686.72,43632.62,173319.34
241300,202210,81,56,25,67872,30300.98,98172.98
241310,202210,51,35,16,42420,19392,61812
241320,202210,37,18,19,21816.84,23028,44844.84
241330,202210,64,55,9,66661.75,10908,77569.75
241335,202210,95,84,11,101810.07,13332,115142.07
241340,202210,188,135,53,163620,64236,227856
241350,202210,63,52,11,63024.96,13332,76356.96
241355,202210,52,44,8,53328.72,9696,63024.72
241360,202210,56,53,3,64236,3636,67872
241370,202210,64,52,12,63024,14544,77568
241380,202210,36,32,4,38784.6,4848,43632.6
241390,202210,86,67,19,81204,23028,104232
241400,202210,228,168,60,204494.7,72720,277214.7
241410,202210,184,162,22,197557.01,26664.09,224221.10
241415,202210,104,83,21,100596,25452.8,126048.8
241420,202210,137,96,41,116353.4,49692,166045.4
241430,202210,19,17,2,20604,2424,23028
241440,202210,545,456,89,552684.58,107869.65,660554.23
241445,202210,42,37,5,44844,6060.43,50904.43
241450,202210,266,221,45,267856.17,54541.24,322397.41
241460,202210,172,156,16,190287.14,19392.4,209679.54
241470,202210,35,29,6,35148.6,7272.4,42421.0
241475,202210,48,44,4,53328,4848,58176
241480,202210,141,103,38,124837.1,46056.2,170893.3
241490,202210,14,11,3,13332.1,3636.1,16968.2
241500,202210,52,40,12,48481.11,14544.02,63025.13
250010,202210,103,85,18,103020.1,21816,124836.1
250020,202210,31,26,5,31512,6060,37572
250030,202210,913,665,248,805997.86,300580.67,1106578.53
250040,202210,410,330,80,399966.8,96961.05,496927.85
250050,202210,293,238,55,288456.32,66660,355116.32
250053,202210,63,50,13,60600.2,15756,76356.2
250057,202210,4,3,1,3636.2,1212,4848.2
250060,202210,635,459,176,557531.93,213314.61,770846.54
250070,202210,689,549,140,665401.91,169680.64,835082.55
250073,202210,9,8,1,9696.17,1212.01,10908.18
250077,202210,186,136,50,164833.78,60600.8,225434.58
250080,202210,415,329,86,398754.27,104233.7,502987.97
250090,202210,224,142,82,172104.09,99384,271488.09
250100,202210,595,476,119,576915.77,144229.8,721145.57
250110,202210,693,501,192,607219.04,232705.62,839924.66
250115,202210,14,4,10,4848,12120.26,16968.26
250120,202210,125,87,38,105444.8,46056.35,151501.15
250130,202210,576,474,102,574496.34,123626.54,698122.88
250135,202210,33,15,18,18180,21816,39996
250140,202210,87,74,13,89688.12,15756,105444.12
250150,202210,644,453,191,549041.48,231493.47,780534.95
250153,202210,14,11,3,13332,3636,16968
250157,202210,32,25,7,30300,8484,38784
250160,202210,242,182,60,220585.95,72720,293305.95
250170,202210,88,60,28,72720,33936,106656
250180,202210,4996,3436,1560,4170634.05,1895622.08,6066256.13
250190,202210,823,552,271,669033.53,329666.36,998699.89
250200,202210,69,54,15,65448,18180,83628
250205,202210,22,17,5,20604,6060,26664
250210,202210,89,74,15,89688.35,18180,107868.35
250215,202210,83,57,26,69084,31512.1,100596.1
250220,202210,29,20,9,24240.1,10908,35148.1
250230,202210,78,70,8,84841.04,9696,94537.04
250240,202210,247,187,60,226647.85,72720,299367.85
250250,202210,395,339,56,410876.14,67872,478748.14
250260,202210,48,37,11,44844.1,13332,58176.1
250270,202210,81,57,24,69084,29088,98172
250280,202210,400,328,72,397537.79,87264.2,484801.99
250290,202210,110,97,13,117564,15756.86,133320.86
250300,202210,533,358,175,436329.1,212100.47,648429.57
250310,202210,53,50,3,60600,3636,64236
250320,202210,2105,1400,705,1696854.15,854477.65,2551331.80
250330,202210,119,102,17,123626.17,20604.1,144230.27
250340,202210,32,26,6,31512.65,7272,38784.65
250350,202210,202,132,70,159986.04,86052,246038.04
250355,202210,40,31,9,37572,10908,48480
250360,202210,190,156,34,189077.12,41209.65,230286.77
250370,202210,2454,1566,888,1898031.26,1076276.16,2974307.42
250375,202210,18,12,6,14544,7272.87,21816.87
250380,202210,58,51,7,61812.12,8484.48,70296.60
250390,202210,47,38,9,46056.16,10908.4,56964.56
250400,202210,17732,8971,8761,10874291.56,10631850.94,21506142.50
250403,202210,309,237,72,287246.87,87264,374510.87
250407,202210,68,55,13,66660,15756.85,82416.85
250410,202210,32,26,6,31512.31,7272.8,38785.11
250415,202210,48,29,19,35148,23028,58176
250420,202210,40,34,6,41208,7272,48480
250430,202210,1512,1310,202,1588037.9,244824.97,1832862.87
250435,202210,35,28,7,33936.75,8484,42420.75
250440,202210,684,565,119,684784.07,144229,829013.07
250450,202210,85,65,20,78782.09,24240,103022.09
250460,202210,488,315,173,382994.43,209678.04,592672.47
250470,202210,102,70,32,84840,38784.6,123624.6
250480,202210,337,266,71,322400.71,86052.98,408453.69
250485,202210,6,6,0,7272,,7272.0
250490,202210,258,208,50,252100.6,60600.97,312701.57
250500,202210,98,77,21,93325.32,25452,118777.32
250510,202210,840,663,177,803561.55,214524.63,1018086.18
250520,202210,170,116,54,140592.1,65448,206040.1
250523,202210,127,102,25,123624,30300,153924
250527,202210,120,88,32,106656.53,38784,145440.53
250530,202210,8,4,4,4848,4848,9696
250535,202210,33,26,7,31512,8484,39996
250540,202210,147,115,32,139380.51,38784,178164.51
250550,202210,72,70,2,84840.2,2424,87264.2
250560,202210,68,41,27,49692.4,32724,82416.4
250570,202210,164,133,31,161196.8,37572.2,198769.0
250580,202210,95,74,21,89766,25452,115218
250590,202210,24,13,11,15756,13332.6,29088.6
250600,202210,1615,1055,560,1279890.66,678724.79,1958615.45
250610,202210,163,129,34,156356.43,41208.42,197564.85
250620,202210,21,17,4,20604.1,4848,25452.1
250625,202210,73,58,15,70296.63,18180,88476.63
250630,202210,3212,2000,1212,2425490.45,1468965.75,3894456.20
250640,202210,200,158,42,191498.23,50905.38,242403.61
250650,202210,31,19,12,23028,14544.69,37572.69
250660,202210,64,48,16,58176,19392,77568
250670,202210,81,63,18,76356,21816.94,98172.94
250680,202210,434,347,87,420570.12,105444.52,526014.64
250690,202210,2241,1518,723,1841059.61,876288.19,2717347.80
250700,202210,947,802,145,973242.82,175740.2,1148983.02
250710,202210,497,384,113,465424.44,136959.12,602383.56
250720,202210,121,87,34,106656.12,41208,147864.12
250730,202210,421,346,75,419355.04,90901.69,510256.73
250740,202210,71,63,8,76356.67,9696,86052.67
250750,202210,25240,14817,10423,17973161.3,12641465.49,30614626.79
250760,202210,123,95,28,115140.4,33936.08,149076.48
250770,202210,381,251,130,304216.74,157560.7,461777.44
250780,202210,73,50,23,60600,27876,88476
250790,202210,473,287,186,347850.03,225434.69,573284.72
250800,202210,153,138,15,167256,18180,185436
250810,202210,73,60,13,72720,15756,88476
250820,202210,157,130,27,157561.33,32724,190285.33
250830,202210,495,322,173,390272.67,209677.68,599950.35
250840,202210,59,51,8,61812.54,9696.2,71508.74
250850,202210,67,57,10,69084,12120,81204
250855,202210,16,14,2,16969.04,2424,19393.04
250860,202210,249,158,91,191496.38,110292,301788.38
250870,202210,29,26,3,31512,3636,35148
250880,202210,93,71,22,86052,26664,112716
250890,202210,3263,2389,874,2900366.59,1061722.95,3962089.54
250900,202210,66,55,11,66660.19,13332,79992.19
250905,202210,129,95,34,115140.9,41208,156348.9
250910,202210,1003,723,280,876292.12,339362.25,1215654.37
250915,202210,116,78,38,94536.15,46057.2,140593.35
250920,202210,150,110,40,133320,48480.96,181800.96
250930,202210,200,113,87,136956.2,105444.2,242400.4
250933,202210,10,7,3,8484,3636,12120
250937,202210,19,18,1,21816,1212,23028
250939,202210,44,34,10,41208.2,12120,53328.2
250940,202210,136,98,38,118777.74,46056.2,164833.94
250950,202210,89,65,24,78783.24,29088,107871.24
250960,202210,87,49,38,59389.37,46056.3,105445.67
250970,202210,1324,929,395,1125962.12,478743.69,1604705.81
250980,202210,99,67,32,81204.13,38784,119988.13
250990,202210,173,130,43,157560,52116,209676
251000,202210,83,70,13,84840,15756,100596
251010,202210,138,95,43,115140.45,52116,167256.45
251020,202210,87,71,16,86052.88,19392,105444.88
251030,202210,48,33,15,39996,18180,58176
251040,202210,66,45,21,54540,25452,79992
251050,202210,28,23,5,27876,6060,33936
251060,202210,52,41,11,49692.65,13332,63024.65
251065,202210,6,3,3,3636,3636,7272
251070,202210,20,16,4,19392,4848,24240
251080,202210,5621,2611,3010,3164637.73,3651822.88,6816460.61
251090,202210,199,162,37,196345.21,44844.68,241189.89
251100,202210,23,22,1,26664.2,1212,27876.2
251110,202210,63,42,21,50904,25452,76356
251120,202210,2003,1234,769,1495663.87,933254.88,2428918.75
251130,202210,448,366,82,443595.27,99384.05,542979.32
251140,202210,625,404,221,489652.46,267853.47,757505.93
251150,202210,351,288,63,349061.13,76357.84,425418.97
251160,202210,98,78,20,94536.3,25452,119988.3
251170,202210,89,74,15,89688.32,18180,107868.32
251180,202210,300,170,130,206042.44,157561.65,363604.09
251190,202210,205,132,73,159985.22,88476.53,248461.75
251200,202210,305,235,70,284824.58,84840.68,369665.26
251203,202210,34,31,3,37572,3636,41208
251207,202210,88,73,15,88476,18180,106656
251210,202210,1592,1154,438,1399878.41,530860.08,1930738.49
251220,202210,48,37,11,44844.2,13332,58176.2
251230,202210,594,496,98,601159.06,119989.6,721148.66
251240,202210,121,83,38,100596,46056,146652
251250,202210,1589,1129,460,1369485.78,558738.37,1928224.15
251260,202210,13,8,5,9696,6060.85,15756.85
251270,202210,321,251,70,306640.79,84840.52,391481.31
251272,202210,63,55,8,66660.2,9696.1,76356.3
251274,202210,28,21,7,25453,8484,33937
251275,202210,36,19,17,23028,20604,43632
251276,202210,29,22,7,26664.03,8484,35148.03
251278,202210,15,13,2,15756,2424,18180
251280,202210,111,107,4,129684,4848,134532
251290,202210,1120,789,331,956304.03,401183.76,1357487.79
251300,202210,19,14,5,18180,6060,24240
251310,202210,319,229,90,277550.42,109080.3,386630.72
251315,202210,41,36,5,43632,6060.1,49692.1
251320,202210,74,61,13,75144.2,15756.1,90900.3
251330,202210,86,76,10,92112,12120,104232
251335,202210,24,15,9,18180,10908,29088
251340,202210,830,463,367,561165.8,444806.44,1005972.24
251350,202210,37,35,2,42420,2424,44844
251360,202210,88,76,12,92112.1,14544,106656.1
251365,202210,8,8,0,9696.68,,9696.68
251370,202210,6101,4124,1977,5002040.93,2398580.9,7400621.83
251380,202210,49,38,11,46056,13332,59388
251385,202210,3,3,0,3636,,3636.0
251390,202210,1012,737,275,893259.6,333307.93,1226567.53
251392,202210,33,22,11,26664,13332,39996
251394,202210,14,11,3,13332,3636,16968
251396,202210,13,7,6,8484,7272.2,15756.2
251398,202210,20,17,3,20604,3636,24240
251400,202210,50,39,11,47268,13332,60600
251410,202210,48,40,8,48480.2,9696,58176.2
251420,202210,114,83,31,100596.26,37572.03,138168.29
251430,202210,47,41,6,49692.7,7272,56964.7
251440,202210,54,28,26,33936,31512,65448
251445,202210,69,59,10,71508.8,12120,83628.8
251450,202210,391,336,55,407239.98,67872.2,475112.18
251455,202210,5,4,1,4848,1212,6060
251460,202210,23,18,5,21816,6060.02,27876.02
251465,202210,9,5,4,6060,4848,10908
251470,202210,55,40,15,48480,18180,66660
251480,202210,29,24,5,29088,6060,35148
251490,202210,117,68,49,82416.27,59389.1,141805.37
251500,202210,116,95,21,115141.6,25452,140593.6
251510,202210,93,57,36,69084.73,43632,112716.73
251520,202210,40,32,8,39996,9696,49692
251530,202210,4413,3082,1331,3736641.47,1613182.37,5349823.84
251540,202210,93,76,17,92112,20604.8,112716.8
251550,202210,431,325,106,393909.22,128473.19,522382.41
251560,202210,26,19,7,23028.1,8484,31512.1
251570,202210,17,16,1,19392,1212,20604
251580,202210,133,104,29,126048,35148,161196
251590,202210,106,74,32,89688,38784.6,128472.6
251593,202210,29,15,14,18180.67,16968,35148.67
251597,202210,120,92,28,111506.18,33936.06,145442.24
251600,202210,1116,766,350,929912.77,424203.12,1354115.89
251610,202210,263,189,74,229069.76,89688,318757.76
251615,202210,17,14,3,16968,3636,20604
251620,202210,4268,2709,1559,3283360.04,1891959.4,5175319.44
251630,202210,490,359,131,435116.55,158773.87,593890.42
251640,202210,111,81,30,98174.54,36360,134534.54
251650,202210,297,219,78,265430.31,94536.2,359966.51
251660,202210,201,176,25,213313.92,30300.8,243614.72
251670,202210,415,316,99,382995.81,119988.21,502984.02
251675,202210,15,9,6,10908,7272,18180
251680,202210,111,96,15,116352.14,18180,134532.14
251690,202210,317,260,57,315125.41,69084.2,384209.61
251700,202210,280,239,41,289670.52,49692,339362.52
251710,202210,25,15,10,18180,12120,30300
251720,202210,30,23,7,27876,8484,36360
251740,202210,12,9,3,10908,3636,14544
260005,202210,3787,1983,1804,2402941.39,2186485.24,4589426.63
260010,202210,1771,1319,452,1598644.84,547828.14,2146472.98
260020,202210,422,367,55,444806.43,66660.2,511466.63
260030,202210,633,425,208,515105.32,252096.8,767202.12
260040,202210,828,515,313,624191.28,379359.43,1003550.71
260050,202210,1172,845,327,1025370.41,396329.15,1421699.56
260060,202210,382,350,32,424210.92,38784,462994.92
260070,202210,1364,835,529,1012056.5,641169.18,1653225.68
260080,202210,747,567,180,687213.69,218160,905373.69
260090,202210,478,308,170,373297.32,206040.6,579337.92
260100,202210,216,144,72,174528.42,87264.1,261792.52
260105,202210,274,159,115,192709.47,139380.6,332090.07
260110,202210,3090,2222,868,2695513.33,1052024.23,3747537.56
260120,202210,2855,1509,1346,1829259.99,1631370.01,3460630.00
260130,202210,213,150,63,181800.99,76356,258156.99
260140,202210,2306,1480,826,1793789.55,1001123.8,2794913.35
260150,202210,195,127,68,153924.9,82417.4,236342.3
260160,202210,362,282,80,341791.7,96960.14,438751.84
260170,202210,3535,2085,1450,2529487.32,1758638.75,4288126.07
260180,202210,193,163,30,197557.72,36360.66,233918.38
260190,202210,2497,1626,871,1970735.68,1055660.44,3026396.12
260200,202210,1027,800,227,969615.36,275125.23,1244740.59
260210,202210,1408,1001,407,1213227.49,493288.22,1706515.71
260220,202210,647,574,73,695698.95,88477.89,784176.84
260230,202210,1317,966,351,1170810.75,426629.1,1597439.85
260240,202210,212,161,51,195135.51,61813.63,256949.14
260250,202210,102,76,26,92112.26,31512,123624.26
260260,202210,1116,777,339,941728.9,412081.29,1353810.19
260270,202210,260,186,74,225435.29,89688,315123.29
260280,202210,1171,932,239,1129600.75,289670.68,1419271.43
260290,202210,7234,3874,3360,4699009.81,4073557.64,8772567.45
260300,202210,1066,903,163,1094469.08,197557.84,1292026.92
260310,202210,537,425,112,515105.2,135745.21,650850.41
260320,202210,830,593,237,718718.3,288456.94,1007175.24
260330,202210,85,64,21,77568.4,25452.2,103020.6
260340,202210,89,65,24,78780.2,29088,107868.2
260345,202210,6027,3082,2945,3739096.05,3571811.17,7310907.22
260350,202210,501,356,145,431480.35,175740.67,607221.02
260360,202210,249,141,108,170892,130897.1,301789.1
260370,202210,742,478,264,579339.64,319969.75,899309.39
260380,202210,558,393,165,477534.65,199981.34,677515.99
260390,202210,295,251,44,304214.02,53328.19,357542.21
260392,202210,115,100,15,121200.88,18180.26,139381.14
260400,202210,4604,2620,1984,3177888.18,2408257.74,5586145.92
260410,202210,15908,8189,7719,9931286.95,9365196.06,19296483.01
260415,202210,151,127,24,153925.24,29088,183013.24
260420,202210,1801,1123,678,1361096.48,821738.2,2182834.68
260430,202210,174,155,19,187862.2,23028.8,210891.0
260440,202210,207,139,68,168472.75,82416.75,250889.50
260450,202210,430,318,112,386636.09,135744.15,522380.24
260460,202210,886,455,431,551470.51,522376.35,1073846.86
260470,202210,339,204,135,247253.58,163621.48,410875.06
260480,202210,255,161,94,196344,113928,310272
260490,202210,236,181,55,219372.83,66660,286032.83
260500,202210,1189,787,402,953860.54,488439.72,1442300.26
260510,202210,860,682,178,826590.73,215737.12,1042327.85
260515,202210,245,225,20,273914.24,24240.91,298155.15
260520,202210,3287,2002,1285,2427598.18,1557438.66,3985036.84
260530,202210,865,689,176,835085.18,213312.1,1048397.28
260540,202210,551,430,121,522375.19,146653.04,669028.23
260545,202210,23,13,10,15756.93,12120,27876.93
260550,202210,356,230,126,278761.6,153924.2,432685.8
260560,202210,516,389,127,471478.44,153927.24,625405.68
260570,202210,1050,839,211,1016886.41,255732.88,1272619.29
260580,202210,355,287,68,347845,83628.2,431473.2
260590,202210,638,369,269,447228.47,326028.4,773256.87
260600,202210,8195,4767,3428,5780102.27,4157194.09,9937296.36
260610,202210,512,345,167,418144.82,202406.43,620551.25
260620,202210,3979,2050,1929,2484653.26,2339330.17,4823983.43
260630,202210,81,74,7,89688,8484,98172
260640,202210,3521,2113,1408,2560982.34,1706504.14,4267486.48
260650,202210,327,236,91,286035.45,110293.2,396328.65
260660,202210,614,398,216,482388.44,261795.07,744183.51
260670,202210,108,76,32,92112,38784.12,130896.12
260680,202210,4208,2263,1945,2746474.52,2357384.57,5103859.09
260690,202210,133,97,36,117564.74,43632,161196.74
260700,202210,324,219,105,265431.92,127260.2,392692.12
260710,202210,49,41,8,49692,9696,59388
260720,202210,2793,1620,1173,1963454.15,1425318.32,3388772.47
260730,202210,773,570,203,690848.71,246037.17,936885.88
260740,202210,82,67,15,81204,18180,99384
260750,202210,575,426,149,516322.36,180589.02,696911.38
260760,202210,773,383,390,464212.5,472691.85,936904.35
260765,202210,1044,537,507,650855.53,615705.03,1266560.56
260770,202210,222,160,62,193902.13,75145.6,269047.73
260775,202210,867,453,414,549047.3,501778.55,1050825.85
260780,202210,241,149,92,180590.8,111504.6,292095.4
260790,202210,16434,7972,8462,9667121.87,10266938.28,19934060.15
260795,202210,166,109,57,132108.62,69084,201192.62
260800,202210,311,253,58,306637.14,70296.96,376934.10
260805,202210,173,114,59,139382.12,71508.7,210890.82
260810,202210,864,693,171,839920.71,207252.8,1047173.51
260820,202210,325,210,115,254522.42,139380,393902.42
260825,202210,217,145,72,175740,87264,263004
260830,202210,304,194,110,235128,133320,368448
260840,202210,278,198,80,239976.7,96960.23,336936.93
260845,202210,205,121,84,147864.09,101808.1,249672.19
260850,202210,432,320,112,387842.81,135744,523586.81
260860,202210,235,178,57,215738.34,69084,284822.34
260870,202210,350,272,78,329667.25,94536,424203.25
260875,202210,762,551,211,670263.25,255733.76,925997.01
260880,202210,1637,1090,547,1321096.4,662965.68,1984062.08
260890,202210,2538,1734,804,2101637.49,975667.58,3077305.07
260900,202210,1038,758,280,918706.84,339361.4,1258068.24
260910,202210,261,206,55,249674.95,66660,316334.95
260915,202210,282,211,71,255732,87264,342996
260920,202210,222,119,103,144228.2,124836,269064.2
260930,202210,363,306,57,370876.21,69084.86,439961.07
260940,202210,2671,1428,1243,1731986.3,1506534.33,3238520.63
260950,202210,2069,1167,902,1416857.33,1094455.65,2511312.98
260960,202210,14581,7006,7575,8498836.93,9185902.61,17684739.54
260970,202210,436,349,87,422990.17,105444,528434.17
260980,202210,212,191,21,231495.26,25452.1,256947.36
260990,202210,2758,2190,568,2655564.34,688424.27,3343988.61
261000,202210,4353,2673,1680,3239717.43,2037389.86,5277107.29
261010,202210,134,99,35,119988.92,42420,162408.92
261020,202210,607,444,163,538136.09,197556.1,735692.19
261030,202210,259,191,68,231492.26,82416,313908.26
261040,202210,385,322,63,391480.56,76356,467836.56
261050,202210,545,449,96,544193.09,116353.91,660547.00
261060,202210,1597,981,616,1188985.27,746595.64,1935580.91
261070,202210,10267,4827,5440,5852960.35,6598290.29,12451250.64
261080,202210,371,282,89,341791.4,107868.2,449659.6
261090,202210,2132,1633,499,1980455.75,606004.07,2586459.82
261100,202210,1279,881,398,1067790.98,482382.57,1550173.55
261110,202210,9765,6081,3684,7376410.57,4471134.86,11847545.43
261120,202210,233,197,36,238764.24,43632,282396.24
261130,202210,586,339,247,410876.24,299370.35,710246.59
261140,202210,218,137,81,166044.95,99384,265428.95
261150,202210,682,436,246,528435.39,298152,826587.39
261153,202210,74,69,5,83628.2,6060,89688.2
261160,202210,79826,38828,40998,47085244.87,49715809.55,96801054.42
261170,202210,505,379,126,459350.88,152713,612063.88
261180,202210,1841,1153,688,1397741.9,835077.52,2232819.42
261190,202210,601,408,193,494502.77,233916.75,728419.52
261200,202210,221,178,43,215738.31,52116,267854.31
261210,202210,46,34,12,41208.1,14544,55752.1
261220,202210,2911,2024,887,2455552.02,1075057.19,3530609.21
261230,202210,382,280,102,339364.12,123624.97,462989.09
261240,202210,447,379,68,459357.74,82416.96,541774.70
261245,202210,253,216,37,261792.2,44844,306636.2
261247,202210,174,131,43,158774.4,52116,210890.4
261250,202210,3920,1866,2054,2262827.71,2493095.34,4755923.05
261255,202210,260,230,30,278760.72,36360,315120.72
261260,202210,877,751,126,911459.78,152715.39,1064175.17
261270,202210,209,148,61,179376.13,73932,253308.13
261280,202210,203,161,42,195133.25,50904,246037.25
261290,202210,102,73,29,88476.24,36360.2,124836.44
261300,202210,1435,1062,373,1287164.38,452079.69,1739244.07
261310,202210,830,550,280,667820.98,339362.81,1007183.79
261320,202210,529,364,165,442386.3,199981.3,642367.6
261330,202210,933,729,204,883577.31,247256.4,1130833.71
261340,202210,336,188,148,227858.27,179376.94,407235.21
261350,202210,938,642,296,778122.46,358757.38,1136879.84
261360,202210,1441,905,536,1098078.15,650847.23,1748925.38
261370,202210,5167,3010,2157,3648178.99,2614325.57,6262504.56
261380,202210,584,454,130,550253.75,157560,707813.75
261390,202210,3924,2656,1268,3220361.93,1536849.91,4757211.84
261400,202210,280,249,31,301791.25,37573.06,339364.31
261410,202210,1173,768,405,930830.62,492073.68,1422904.30
261420,202210,992,602,390,729634.61,472682.81,1202317.42
261430,202210,324,290,34,351484.92,41208,392692.92
261440,202210,102,97,5,117564.44,6060,123624.44
261450,202210,2652,2061,591,2499167.63,716298.88,3215466.51
261460,202210,798,617,181,747818.68,219374.29,967192.97
261470,202210,238,189,49,229069.5,59388.79,288458.29
261480,202210,490,364,126,441177.39,152659.46,593836.85
261485,202210,400,238,162,288460.42,196344.26,484804.68
261500,202210,646,414,232,501773.52,281185.72,782959.24
261510,202210,54,36,18,43632.98,21816.1,65449.08
261520,202210,98,83,15,100596.78,18180.2,118776.98
261530,202210,4331,2777,1554,3366987.5,1884678.36,5251665.86
261540,202210,1553,892,661,1081119.46,802352.63,1883472.09
261550,202210,272,130,142,157561.11,172104,329665.11
261560,202210,985,651,334,789023.92,404811.25,1193835.17
261570,202210,395,315,80,381784.33,96960.95,478745.28
261580,202210,406,326,80,395118.58,96960.61,492079.19
261590,202210,192,156,36,190287.44,43632.8,233920.24
261600,202210,321,248,73,300582.47,88477.13,389059.60
261610,202210,90,74,16,89688,19392,109080
261618,202210,81,57,24,69084.71,29088,98172.71
261620,202210,210,134,76,162408.25,92113,254521.25
261630,202210,696,540,156,654483.21,189072.25,843555.46
261640,202210,6938,3646,3292,4420238.39,3992379.96,8412618.35
261650,202210,473,301,172,364813.15,208464.3,573277.45
270010,202210,519,460,59,558740.96,72720.5,631461.46
270020,202210,254,209,45,253310.44,54540.2,307850.64
270030,202210,9432,6058,3374,7344853.21,4090481.44,11435334.65
270040,202210,2115,1383,732,1676213.98,887189.55,2563403.53
270050,202210,238,182,56,224222.34,69084.56,293306.90
270060,202210,74,49,25,59391.73,30300.96,89692.69
270070,202210,799,587,212,711447.7,256945.7,968393.4
270080,202210,47,38,9,46056,10908,56964
270090,202210,22,17,5,20604,6060,26664
270100,202210,1328,900,428,1093235.75,521162.54,1614398.29
270110,202210,68,55,13,66660,15756,82416
270120,202210,254,207,47,250890.56,56965.09,307855.65
270130,202210,342,256,86,310273.6,105444,415717.6
270135,202210,122,85,37,103020.7,44844,147864.7
270140,202210,1431,944,487,1144150.93,590252.96,1734403.89
270150,202210,251,193,58,233917.46,70296.63,304214.09
270160,202210,487,381,106,461778,128472,590250
270170,202210,818,542,276,656909.9,334512.19,991422.09
270180,202210,57,46,11,55752.21,13332.76,69084.97
270190,202210,111,96,15,116354.44,18180,134534.44
270200,202210,118,103,15,124836.3,18180,143016.3
270210,202210,551,336,215,407234.85,260580.63,667815.48
270220,202210,198,142,56,173316.1,67872.84,241188.94
270230,202210,2217,1402,815,1699249.97,987783.77,2687033.74
270235,202210,505,392,113,475116.36,136956.1,612072.46
270240,202210,3382,2678,704,3246987.78,853252.14,4100239.92
270250,202210,123,92,31,111506.73,37572,149078.73
270255,202210,212,176,36,213314.21,43632,256946.21
270260,202210,418,333,85,403602.3,103020.39,506622.69
270270,202210,101,55,46,66660,55752,122412
270280,202210,200,125,75,151500,90900,242400
270290,202210,1136,891,245,1079944.54,296943.84,1376888.38
270300,202210,380,275,105,333301.18,127260.2,460561.38
270310,202210,816,684,132,829023.66,159986.21,989009.87
270320,202210,772,667,105,808413.69,127260,935673.69
270330,202210,322,279,43,338148.08,52116,390264.08
270340,202210,62,53,9,64236,10908,75144
270350,202210,86,50,36,60601.43,43632,104233.43
270360,202210,75,39,36,48318.4,43632,91950.4
270370,202210,66,52,14,63024,16968,79992
270375,202210,83,53,30,64236,36360,100596
270380,202210,1069,727,342,881126.88,415716,1296842.88
270390,202210,135,80,55,96960,66660.1,163620.1
270400,202210,749,576,173,699333.16,209676.92,909010.08
270410,202210,219,165,54,199986.03,65448.01,265434.04
270420,202210,410,285,125,345422.97,151500.7,496923.67
270430,202210,35592,25385,10207,30788439.11,12380848.19,43169287.30
270440,202210,472,371,101,449659.31,122413.04,572072.35
270450,202210,874,523,351,633881.22,426626.51,1060507.73
270460,202210,182,143,39,173318.77,48480,221798.77
270470,202210,1667,1174,493,1424122.75,598729.19,2022851.94
270480,202210,572,460,112,557530.27,135744.76,693275.03
270490,202210,22,16,6,19392,7272,26664
270500,202210,474,395,79,478745.06,95748,574493.06
270510,202210,912,604,308,731996.54,374509.92,1106506.46
270520,202210,264,177,87,215736.78,105444,321180.78
270530,202210,65,55,10,66660.2,12120,78780.2
270540,202210,90,63,27,76356,32724,109080
270550,202210,1681,1296,385,1573196.03,466622.75,2039818.78
270560,202210,254,155,99,187861.69,119988.5,307850.19
270570,202210,592,421,171,510257.34,207252,717509.34
270580,202210,18,13,5,15756,6060,21816
270590,202210,56,44,12,53328.3,14544,67872.3
270600,202210,156,134,22,162410.95,26664.1,189075.05
270610,202210,251,203,48,246037.59,58176.1,304213.69
270620,202210,16,16,0,19392,,19392.0
270630,202210,3671,2767,904,3354282.99,1095656.88,4449939.87
270640,202210,894,659,235,798716.75,284822.36,1083539.11
270642,202210,211,176,35,213313.82,42420,255733.82
270644,202210,299,174,125,210889.47,151502.55,362392.02
270650,202210,352,216,136,261795.62,166045.85,427841.47
270660,202210,193,171,22,207259.96,26664,233923.96
270670,202210,2972,2265,707,2745219.32,856886.81,3602106.13
270680,202210,394,256,138,310277.46,167256,477533.46
270690,202210,1255,853,402,1035063.96,487229.07,1522293.03
270700,202210,23,19,4,23028.42,4848,27876.42
270710,202210,555,434,121,526013.97,146652.65,672666.62
270720,202210,225,182,43,220588.15,52116.5,272704.65
270730,202210,1949,1218,731,1477483.38,885977.95,2363461.33
270740,202210,35,25,10,30300,12120,42420
270750,202210,622,481,141,582978.78,170892.72,753871.50
270760,202210,305,222,83,269068.41,100596.76,369665.17
270770,202210,2887,1977,910,2397387.29,1102928.03,3500315.32
270780,202210,67,40,27,48480,33936.57,82416.57
270790,202210,211,131,80,158774.17,96960.2,255734.37
270800,202210,2063,1652,411,2005892.92,498133.55,2504026.47
270810,202210,218,177,41,214525.36,49692,264217.36
270820,202210,122,84,38,101811.39,46056,147867.39
270830,202210,848,649,199,786614.73,241189.51,1027804.24
270840,202210,1331,1037,294,1258064.1,356330.46,1614394.56
270850,202210,1541,999,542,1213260.91,658118.76,1871379.67
270860,202210,2622,1781,841,2159211.23,1020515.26,3179726.49
270870,202210,132,77,55,93325,66660.2,159985.2
270880,202210,859,681,178,825383.97,215738.35,1041122.32
270890,202210,258,197,61,238764.97,73932.9,312697.87
270895,202210,70,66,4,79992,4848,84840
270900,202210,68,55,13,66660.93,15756,82416.93
270910,202210,305,252,53,305431.81,64236.6,369668.41
270915,202210,1968,1309,659,1587744,799922.26,2387666.26
270920,202210,407,338,69,409659.04,84840.36,494499.40
270930,202210,5632,4337,1295,5256528.97,1569549.63,6826078.60
270940,202210,2223,1767,456,2142853.42,552674.47,2695527.89
280010,202210,34,28,6,33936.2,7272,41208.2
280020,202210,515,435,80,527223.93,96960.97,624184.90
280030,202210,22563,14577,7986,17671634.53,9687754.76,27359389.29
280040,202210,336,205,131,248460.83,158772.2,407233.03
280050,202210,441,339,102,410872.5,123624.6,534497.1
280060,202210,410,261,149,316336.92,180589.22,496926.14
280067,202210,1160,829,331,1005970.75,401172.16,1407142.91
280070,202210,122,102,20,124837.34,24240,149077.34
280100,202210,692,535,157,648426.02,190284.69,838710.71
280110,202210,88,78,10,94536.65,12120,106656.65
280120,202210,700,580,120,702965.87,146653.55,849619.42
280130,202210,1811,1193,618,1448350.31,749018,2197368.31
280140,202210,528,440,88,533284.57,106656,639940.57
280150,202210,431,300,131,364817.96,158772,523589.96
280160,202210,148,112,36,135744.8,43632,179376.8
280170,202210,440,308,132,373304.92,159986.21,533291.13
280190,202210,31,24,7,29088,8484,37572
280200,202210,48,36,12,43634.64,14544.3,58178.94
280210,202210,3084,2219,865,2689387.52,1049599.73,3738987.25
280220,202210,57,46,11,55752.91,13332,69084.91
280230,202210,339,272,67,329671.77,81205.07,410876.84
280240,202210,134,123,11,149079.35,13332,162411.35
280250,202210,20,12,8,14544.1,9697.87,24241.97
280260,202210,79,72,7,87264.63,8484,95748.63
280270,202210,142,109,33,132108,39996.7,172104.7
280280,202210,192,129,63,156349.19,76356,232705.19
280290,202210,3842,2798,1044,3392421.73,1266551.78,4658973.51
280300,202210,1699,1367,332,1656826.61,402386.46,2059213.07
280310,202210,101,95,6,115141.15,7272,122413.15
280320,202210,690,477,213,578132.49,258158.05,836290.54
280330,202210,327,244,83,295731.77,100596.2,396327.97
280340,202210,433,360,73,436322.65,88477.17,524799.82
280350,202210,3867,2968,899,3597274.1,1089608.44,4686882.54
280360,202210,491,339,152,410875.31,184224.4,595099.71
280370,202210,96,81,15,98172.13,18180,116352.13
280380,202210,50,39,11,47268,13332,60600
280390,202210,179,152,27,184226.53,32724,216950.53
280400,202210,411,274,137,332097.74,166047.35,498145.09
280410,202210,302,253,49,306638.85,59388,366026.85
280420,202210,146,126,20,152717.73,24240.95,176958.68
280430,202210,98,78,20,94537.62,24240,118777.62
280440,202210,729,602,127,729637.91,153925.98,883563.89
280445,202210,123,114,9,138170.1,10908,149078.1
280450,202210,1334,1139,195,1381695,236345.14,1618040.14
280460,202210,700,512,188,621762.58,227856.39,849618.97
280470,202210,99,90,9,109081.19,10908,119989.19
280480,202210,3259,2194,1065,2661636.16,1290814.07,3952450.23
280490,202210,202,192,10,232710.31,12120,244830.31
280500,202210,40,36,4,43632.04,4848.17,48480.21
280510,202210,140,112,28,135744.89,33937.3,169682.19
280520,202210,53,37,16,44844.67,19392,64236.67
280530,202210,73,49,24,59388.93,29088,88476.93
280540,202210,569,493,76,598733.05,92112,690845.05
280550,202210,755,696,59,843563.5,71508,915071.5
280560,202210,498,451,47,547830.11,56964.79,604794.90
280570,202210,2405,1904,501,2308886.18,607213.85,2916100.03
280580,202210,592,466,126,564796.13,152712.96,717509.09
280590,202210,230,148,82,179383.12,99386.3,278769.42
280600,202210,415,340,75,412139.7,90900.2,503039.9
280610,202210,115,83,32,100600.01,38786.11,139386.12
280620,202210,565,460,105,557525.31,127260.73,684786.04
280630,202210,159,129,30,156350.96,36360,192710.96
280640,202210,183,148,35,179376.1,42420,221796.1
280650,202210,85,50,35,60600.2,42420.52,103020.72
280660,202210,126,95,31,115143.7,37572.41,152716.11
280670,202210,2117,1351,766,1638718.27,929625.84,2568344.11
280680,202210,245,209,36,253310.34,43632,296942.34
280690,202210,78,68,10,82416,12120,94536
280700,202210,20,20,0,24240,,24240.0
280710,202210,1556,1204,352,1460480.16,426625.32,1887105.48
280720,202210,131,91,40,110293.72,48480,158773.72
280730,202210,31,27,4,32725.17,4848.05,37573.22
280740,202210,2631,1974,657,2392508.07,796286.42,3188794.49
280750,202210,230,201,29,243615.94,35149.14,278765.08
280760,202210,957,647,310,784183.87,375722.93,1159906.80
290010,202210,197,139,58,168468.86,70296,238764.86
290020,202210,185,164,21,198769.83,25452.9,224222.73
290030,202210,624,402,222,487228.08,269064.88,756292.96
290035,202210,138,113,25,136957.17,30300.93,167258.10
290040,202210,259,178,81,215740.12,98172,313912.12
290050,202210,88,70,18,84840,21816,106656
290060,202210,256,112,144,135744.95,174528.2,310273.15
290070,202210,6142,2891,3251,3503956.74,3941466.01,7445422.75
290080,202210,475,206,269,249674.15,327240.09,576914.24
290090,202210,337,155,182,187860.3,220586.06,408446.36
290100,202210,1757,1104,653,1338067.88,791441.07,2129508.95
290110,202210,903,509,394,618134.8,477535.34,1095670.14
290115,202210,184,167,17,202405.78,20604,223009.78
290120,202210,813,544,269,659335.56,326029.48,985365.04
290130,202210,473,287,186,347845.84,225432.16,573278.00
290135,202210,300,225,75,272701.63,90900.15,363601.78
290140,202210,320,267,53,323610.34,64236.2,387846.54
290150,202210,145,99,46,119988,55752,175740
290160,202210,249,191,58,231496.68,70297.24,301793.92
290170,202210,107,76,31,92112.6,37572,129684.6
290180,202210,199,143,56,173318.6,67872.2,241190.8
290190,202210,372,291,81,353911.44,98172.9,452084.34
290195,202210,300,195,105,236340.4,127260.1,363600.5
290200,202210,268,214,54,259368.31,65448.1,324816.41
290205,202210,155,95,60,115140.1,72720,187860.1
290210,202210,1285,941,344,1141725.31,416930.49,1558655.80
290220,202210,176,104,72,126050.47,87264.2,213314.67
290225,202210,295,116,179,140594.24,216949.87,357544.11
290230,202210,91,54,37,65449.97,44844,110293.97
290240,202210,369,131,238,158772.8,289668.8,448441.6
290250,202210,243,225,18,272704.71,21816,294520.71
290260,202210,348,271,77,328461.86,93327.03,421788.89
290265,202210,194,168,26,203618.12,31512.49,235130.61
290270,202210,1410,1164,246,1410799.12,299366.38,1710165.50
290280,202210,488,342,146,414505.68,176952.4,591458.08
290290,202210,1438,859,579,1041122.54,702962.9,1744085.44
290300,202210,392,335,57,406025.58,69084.56,475110.14
290310,202210,284,133,151,161196.4,183012,344208.4
290320,202210,4389,2629,1760,3186432.32,2134351.01,5320783.33
290323,202210,209,181,28,219375.24,33936.2,253311.44
290327,202210,168,129,39,156350.38,47268.13,203618.51
290330,202210,124,56,68,67872.73,82416,150288.73
290340,202210,791,327,464,396331.26,563582.77,959914.03
290350,202210,685,410,275,496923.51,334514.52,831438.03
290360,202210,337,260,77,315125.83,93324.79,408450.62
290370,202210,901,403,498,488437.57,603576.91,1092014.48
290380,202210,342,215,127,260582.42,153924.95,414507.37
290390,202210,2467,1538,929,1865296.98,1125955.49,2991252.47
290395,202210,235,138,97,167256,117564,284820
290400,202210,295,214,81,259368.79,98172,357540.79
290405,202210,246,208,38,252096.15,46056,298152.15
290410,202210,649,543,106,658118.36,128472,786590.36
290420,202210,279,222,57,269065.7,69084,338149.7
290430,202210,494,317,177,384206.25,214524,598730.25
290440,202210,89,76,13,92112.22,15756,107868.22
290450,202210,197,146,51,176952.19,61812,238764.19
290460,202210,2023,1207,816,1462898.54,990206.75,2453105.29
290470,202210,1387,610,777,739330.17,941732.9,1681063.07
290475,202210,573,536,37,649642.41,46056.6,695699.01
290480,202210,210,119,91,144229.71,110292.33,254522.04
290485,202210,242,217,25,263005.68,30300,293305.68
290490,202210,1327,918,409,1112625.01,496922.12,1609547.13
290500,202210,803,432,371,523590.77,449654.82,973245.59
290510,202210,188,151,37,183019.96,44844.35,227864.31
290515,202210,180,109,71,132108.69,86052,218160.69
290520,202210,1432,938,494,1139287.34,598728.76,1738016.10
290530,202210,280,252,28,305431.27,33936.2,339367.47
290540,202210,122,60,62,72720,75144,147864
290550,202210,172,142,30,172105.19,36360,208465.19
290560,202210,3274,1465,1809,1776827.04,2194943.84,3971770.88
290570,202210,7054,3341,3713,4050607.04,4500240.31,8550847.35
290580,202210,1310,788,522,955064.62,633877.68,1588942.30
290590,202210,589,469,120,568447.11,146656.16,715103.27
290600,202210,1815,1236,579,1498061.37,704182.11,2202243.48
290610,202210,182,166,16,201199,19392,220591
290620,202210,390,346,44,419354.85,53328.4,472683.25
290630,202210,2040,867,1173,1050824.17,1421683.12,2472507.29
290640,202210,129,102,27,123627.34,32724.05,156351.39
290650,202210,2033,944,1089,1144155.22,1319874.33,2464029.55
290660,202210,264,215,49,260580,59388,319968
290670,202210,1066,532,534,644795.61,648425.77,1293221.38
290680,202210,1275,1024,251,1241100.29,304215.64,1545315.93
290682,202210,347,258,89,312699.92,107868.38,420568.30
290685,202210,267,159,108,192710.28,130896.2,323606.48
290687,202210,1208,797,411,966175.09,498133.79,1464308.88
290689,202210,149,76,73,92112,88476,180588
290690,202210,581,265,316,321182.38,382993.95,704176.33
290700,202210,256,129,127,156351.31,153925.49,310276.80
290710,202210,785,542,243,656912.75,294522.04,951434.79
290720,202210,1083,870,213,1054463.11,258158.01,1312621.12
290730,202210,1283,760,523,921133.41,635093.82,1556227.23
290740,202210,27,23,4,27876,4848,32724
290750,202210,1528,664,864,804781.23,1048394.9,1853176.13
290755,202210,76,65,11,78780,13332,92112
290760,202210,263,228,35,276343.72,42420.2,318763.92
290770,202210,190,183,7,221797.93,8484,230281.93
290780,202210,1144,907,237,1099296.11,287249.13,1386545.24
290790,202210,397,269,128,326031.97,155140.07,481172.04
290800,202210,2480,1005,1475,1218074.77,1787706.58,3005781.35
290810,202210,498,341,157,413296.4,190285.02,603581.42
290820,202210,424,246,178,298161.39,215738.47,513899.86
290830,202210,489,346,143,419353.74,173316.78,592670.52
290840,202210,1906,1192,714,1444723,865372.39,2310095.39
290850,202210,1045,529,516,642367.42,626608.43,1268975.85
290860,202210,693,330,363,399962.79,439958.07,839920.86
290870,202210,628,436,192,528439.67,232705.76,761145.43
290880,202210,118,65,53,78780.2,64236,143016.2
290890,202210,497,298,199,363604.01,241189.6,604793.61
290900,202210,160,123,37,149076,44844,193920
290910,202210,400,305,95,369661.18,115140,484801.18
290920,202210,205,182,23,220586.56,27876,248462.56
290930,202210,545,414,131,501776.92,158774.2,660551.12
290940,202210,224,190,34,230280.5,41208,271488.5
290950,202210,161,92,69,111504,83628,195132
290960,202210,507,359,148,435110.56,180589.86,615700.42
290970,202210,234,206,28,249672.5,33936.2,283608.7
290980,202210,1973,1359,614,1647131.34,745386.65,2392517.99
290990,202210,428,363,65,439967.81,78782.16,518749.97
291000,202210,934,292,642,356328.94,779316,1135644.94
291005,202210,2689,1144,1545,1390198.04,1872567.82,3262765.86
291010,202210,118,103,15,124836.46,18180,143016.46
291020,202210,89,71,18,86052,23028.8,109080.8
291030,202210,104,76,28,92112.2,33936,126048.2
291040,202210,665,392,273,475104.98,332088.2,807193.18
291050,202210,1566,818,748,991428.42,906582.42,1898010.84
291060,202210,1734,956,778,1158690.2,944153.74,2102843.94
291070,202210,2010,1510,500,1830148.12,607218.67,2437366.79
291072,202210,7528,2861,4667,3468836.74,5661285.26,9130122.00
291075,202210,249,206,43,249672.1,52116.2,301788.3
291077,202210,62,44,18,53328,21816,75144
291080,202210,21986,9342,12644,11323974.56,15334434.18,26658408.74
291085,202210,289,236,53,286033.77,64236.75,350270.52
291090,202210,259,103,156,126049.29,189072,315121.29
291100,202210,990,339,651,410868.69,789012.2,1199880.89
291110,202210,448,344,104,418142.72,126048.2,544190.92
291120,202210,2480,1313,1167,1592580.15,1421683.11,3014263.26
291125,202210,69,36,33,43632,39996,83628
291130,202210,186,162,24,197558.81,29088,226646.81
291140,202210,129,99,30,119988,36360.7,156348.7
291150,202210,362,131,231,159984,281184,441168
291160,202210,413,313,100,379367.14,121200.8,500567.94
291165,202210,49,37,12,44844,14544,59388
291170,202210,3438,1689,1749,2049523.76,2119794.62,4169318.38
291180,202210,1256,521,735,631461.96,890821.43,1522283.39
291185,202210,111,101,10,122412.78,12120,134532.78
291190,202210,1405,676,729,819323.84,884769.93,1704093.77
291200,202210,170,125,45,151500.21,54540,206040.21
291210,202210,2501,1010,1491,1224135.95,1809524.19,3033660.14
291220,202210,318,240,78,290880.99,94536,385416.99
291230,202210,970,348,622,421779.64,753866.5,1175646.14
291240,202210,409,379,30,459350.78,36360,495710.78
291250,202210,416,338,78,409656,94536,504192
291260,202210,63,54,9,65448.1,10908,76356.1
291270,202210,1038,458,580,555116.91,702975.58,1258092.49
291280,202210,368,173,195,209677.64,236340.8,446018.44
291290,202210,1649,868,781,1052046.79,949010.02,2001056.81
291300,202210,244,185,59,224220.45,71508,295728.45
291310,202210,233,203,30,246041.34,36360,282401.34
291320,202210,1317,923,394,1118698.78,477530.55,1596229.33
291330,202210,142,119,23,145442.17,27876,173318.17
291340,202210,227,135,92,163621.29,111505.55,275126.84
291345,202210,122,86,36,104232,43632,147864
291350,202210,1814,689,1125,835070.01,1363501,2198571.01
291360,202210,8767,4163,4604,5050536.79,5580141.29,10630678.08
291370,202210,1163,698,465,845998.3,563586.76,1409585.06
291380,202210,267,208,59,252097.53,71508,323605.53
291390,202210,4158,1827,2331,2214356.91,2826394.11,5040751.02
291400,202210,2123,1475,648,1787735.51,785390.74,2573126.25
291410,202210,213,183,30,223010.07,37572,260582.07
291420,202210,121,93,28,112716.2,33936,146652.2
291430,202210,179,109,70,132108,84840,216948
291440,202210,545,439,106,532075.61,128472.2,660547.81
291450,202210,1020,679,341,822957.1,413296.52,1236253.62
291460,202210,2067,1620,447,1963482.84,541775.92,2505258.76
291465,202210,2348,1118,1230,1355036.27,1491978.09,2847014.36
291470,202210,2965,1475,1490,1788941.99,1808319.36,3597261.35
291480,202210,12471,5399,7072,6549756.31,8577380.89,15127137.20
291490,202210,698,278,420,336938.22,509041.34,845979.56
291500,202210,363,217,146,263005.64,176952.47,439958.11
291510,202210,1192,467,725,566006.3,879913.19,1445919.49
291520,202210,940,422,518,511472.1,627817.55,1139289.65
291530,202210,944,277,667,335725.55,808404.6,1144130.15
291535,202210,133,109,24,132109.19,29089.2,161198.39
291540,202210,349,118,231,143018.07,279973.02,422991.09
291550,202210,1295,615,680,745388.03,824162.17,1569550.20
291560,202210,5235,2640,2595,3200916.91,3145148.4,6346065.31
291570,202210,234,119,115,144229.06,139381.31,283610.37
291580,202210,1223,767,456,930828.89,553887.02,1484715.91
291590,202210,111,54,57,65448.4,69084,134532.4
291600,202210,1166,587,579,711452.69,701750.16,1413202.85
291610,202210,1483,721,762,873890.08,923565.24,1797455.32
291620,202210,566,267,299,323610.93,363601.6,687212.53
291630,202210,491,156,335,189073.58,406020.85,595094.43
291640,202210,4201,2045,2156,2478579.67,2613092.87,5091672.54
291650,202210,458,315,143,381794.77,173318.1,555112.87
291660,202210,377,155,222,189072.96,269065.32,458138.28
291670,202210,173,107,66,129685.66,79992,209677.66
291680,202210,633,388,245,471489.44,296943.85,768433.29
291685,202210,609,353,256,427842.6,311487.22,739329.82
291690,202210,500,321,179,389054.61,216949.43,606004.04
291700,202210,1071,822,249,996274.13,301789.73,1298063.86
291710,202210,1625,789,836,956280.94,1013238.82,1969519.76
291720,202210,447,308,139,373296.02,168468.9,541764.92
291730,202210,954,551,403,667823.17,489650.29,1157473.46
291733,202210,315,213,102,258158.08,123624.2,381782.28
291735,202210,84,63,21,76356,25452,101808
291740,202210,349,261,88,316333.35,106656,422989.35
291750,202210,2459,1553,906,1884715.54,1101733.04,2986448.58
291760,202210,3136,1726,1410,2094347.15,1710133.41,3804480.56
291770,202210,759,511,248,619351.08,300584.25,919935.33
291780,202210,97,61,36,73932.82,43632.8,117565.62
291790,202210,160,82,78,99384.39,94537.47,193921.86
291800,202210,10715,4576,6139,5552273.59,7445372.4,12997645.99
291810,202210,1074,801,273,974462.62,330879.66,1305342.28
291820,202210,293,210,83,254521.17,100596,355117.17
291830,202210,1030,424,606,513900.27,734476.35,1248376.62
291835,202210,573,531,42,643579.13,50904.36,694483.49
291840,202210,5439,2731,2708,3311283.52,3283358.49,6594642.01
291845,202210,290,95,195,115140,236340,351480
291850,202210,313,273,40,330883.99,48480.4,379364.39
291855,202210,277,119,158,144228.78,191496.78,335725.56
291860,202210,165,108,57,130896,70296.92,201192.92
291870,202210,81,36,45,43632,54540,98172
291875,202210,163,151,12,183016.23,14544,197560.23
291880,202210,442,359,83,435113.75,100597.68,535711.43
291890,202210,253,90,163,109080.1,197556.6,306636.7
291900,202210,56,33,23,39996,27876,67872
291905,202210,124,96,28,116352.81,33936,150288.81
291910,202210,162,129,33,156348,39996.1,196344.1
291915,202210,440,385,55,466627.52,66661.67,533289.19
291920,202210,6097,2928,3169,3550045.36,3843314.31,7393359.67
291930,202210,170,103,67,124837.67,81204.25,206041.92
291940,202210,394,229,165,278761.46,199980,478741.46
291950,202210,1214,943,271,1142920.89,332088.2,1475009.09
291955,202210,1479,884,595,1073843.2,721145.98,1794989.18
291960,202210,198,146,52,176952.2,63024,239976.2
291970,202210,782,574,208,695700.68,253309.1,949009.78
291980,202210,1444,1252,192,1517440.78,232705.78,1750146.56
291990,202210,142,131,11,158772.99,13332,172104.99
291992,202210,201,100,101,121204.38,122415.22,243619.60
291995,202210,183,115,68,139381.36,82416.2,221797.56
292000,202210,434,311,123,376936.37,149076.6,526012.97
292010,202210,351,238,113,288456.2,136956.63,425412.83
292020,202210,300,221,79,267853.42,95748,363601.42
292030,202210,157,120,37,146652.8,44844,191496.8
292040,202210,592,310,282,375720,341784,717504
292045,202210,121,105,16,127260,19392.67,146652.67
292050,202210,954,687,267,832648.44,323606.08,1156254.52
292060,202210,940,760,180,921145.73,219376.29,1140522.02
292070,202210,68,29,39,35148.2,47268,82416.2
292080,202210,165,116,49,140592.29,59388,199980.29
292090,202210,566,198,368,239977.3,446016,685993.3
292100,202210,1616,700,916,850846.32,1111428.92,1962275.24
292105,202210,175,157,18,190284,21816,212100
292110,202210,2352,878,1474,1065363.69,1790128.99,2855492.68
292120,202210,732,558,174,676311.9,210890.58,887202.48
292130,202210,489,269,220,326031.84,266640.2,592672.04
292140,202210,215,174,41,210893.3,49693.68,260586.98
292145,202210,169,92,77,111504,93324,204828
292150,202210,1541,1281,260,1553797.95,315120.84,1868918.79
292160,202210,177,138,39,167256.4,47268.91,214525.31
292170,202210,1199,1021,178,1237482.02,215739.06,1453221.08
292180,202210,237,165,72,199980,87264,287244
292190,202210,151,97,54,117564,65448.96,183012.96
292200,202210,1474,538,936,652064.9,1134437.53,1786502.43
292205,202210,118,97,21,117564.24,25452,143016.24
292210,202210,398,263,135,318760.22,163620.49,482380.71
292220,202210,35,24,11,29088.75,13332,42420.75
292225,202210,51,42,9,50904.51,10908.6,61813.11
292230,202210,1048,791,257,958715.53,311485.79,1270201.32
292240,202210,652,473,179,573285.47,216948.4,790233.87
292250,202210,1686,1091,595,1323529.78,722357.78,2045887.56
292260,202210,426,254,172,307848.8,208465.63,516314.43
292265,202210,255,193,62,233920.07,75144.76,309064.83
292270,202210,740,363,377,439958.41,458136.4,898094.81
292273,202210,219,128,91,155136,110292.8,265428.8
292275,202210,178,91,87,110292,105444,215736
292280,202210,152,103,49,126048,60600,186648
292285,202210,93,72,21,87264,25452,112716
292290,202210,634,420,214,509046.61,259369.66,768416.27
292300,202210,1909,748,1161,906585.05,1409568.4,2316153.45
292303,202210,136,92,44,111504.6,53329.15,164833.75
292305,202210,121,87,34,105445.09,41208,146653.09
292310,202210,1006,665,341,805993.34,414507.7,1220501.04
292320,202210,594,439,155,532071.95,187861.21,719933.16
292330,202210,177,110,67,133320.48,81204,214524.48
292335,202210,311,248,63,300577.16,76356.79,376933.95
292340,202210,553,385,168,466621.49,204828.2,671449.69
292350,202210,283,151,132,183013.85,159984,342997.85
292360,202210,747,552,195,669027.23,236341.09,905368.32
292370,202210,735,561,174,679938.12,210888.5,890826.62
292380,202210,627,518,109,627820.11,132108.29,759928.40
292390,202210,402,161,241,195132.23,292093.54,487225.77
292400,202210,3743,2280,1463,2763415.78,1776806.26,4540222.04
292405,202210,277,185,92,224220.25,111504,335724.25
292410,202210,113,71,42,86052.02,50904,136956.02
292420,202210,282,243,39,294517.02,47268,341785.02
292430,202210,542,394,148,477530.1,179376.31,656906.41
292440,202210,648,539,109,653277.84,132108.94,785386.78
292450,202210,233,176,57,213315.07,69084.07,282399.14
292460,202210,524,400,124,484804.69,151501.04,636305.73
292465,202210,211,179,32,216948.6,38784.75,255733.35
292467,202210,170,111,59,134532,71508,206040
292470,202210,322,217,105,263005.97,127260,390265.97
292480,202210,418,282,136,341791.06,164835.14,506626.20
292490,202210,246,180,66,218160.3,79993.29,298153.59
292500,202210,950,455,495,551472.86,599947.29,1151420.15
292510,202210,3714,1791,1923,2171925.78,2330685.99,4502611.77
292520,202210,1214,571,643,692070.55,780537.49,1472608.04
292525,202210,452,332,120,402392.88,145443.06,547835.94
292530,202210,5126,2079,3047,2522206.66,3694203.01,6216409.67
292540,202210,500,291,209,352692.54,254520.5,607213.04
292550,202210,1159,637,522,772054.29,633879.73,1405934.02
292560,202210,338,309,29,374514.67,35148.16,409662.83
292570,202210,339,262,77,317545.66,94536,412081.66
292575,202210,586,420,166,509053.93,201194.5,710248.43
292580,202210,1061,712,349,862948.33,422990.62,1285938.95
292590,202210,580,512,68,620550.55,82416.8,702967.35
292593,202210,145,114,31,138168.58,37572,175740.58
292595,202210,204,162,42,196345.37,50904,247249.37
292600,202210,1309,927,382,1123545.64,462990.18,1586535.82
292610,202210,119,97,22,117565.53,26665.34,144230.87
292620,202210,540,450,90,545422.19,109080.94,654503.13
292630,202210,1602,881,721,1067785.96,873857.69,1941643.65
292640,202210,898,617,281,747812.79,340576.1,1088388.89
292650,202210,193,147,46,178168.98,55752,233920.98
292660,202210,2015,1417,598,1717438.62,724787.1,2442225.72
292665,202210,136,96,40,117564.6,49692,167256.6
292670,202210,398,304,94,369662.18,113928.58,483590.76
292680,202210,269,199,70,241188.76,84840,326028.76
292690,202210,207,144,63,174528.85,76356.2,250885.05
292700,202210,1036,674,362,816903.75,438749.84,1255653.59
292710,202210,116,100,16,121200,19392.31,140592.31
292720,202210,1027,594,433,719934.78,524797.58,1244732.36
292730,202210,217,102,115,123625,139380.4,263005.4
292740,202210,78849,37521,41328,45503453.08,50133994.68,95637447.76
292750,202210,400,290,110,351485.63,133322.06,484807.69
292760,202210,335,281,54,340574.82,65448.1,406022.92
292770,202210,889,371,518,449655.31,627822.52,1077477.83
292780,202210,32,13,19,15756.07,23028,38784.07
292790,202210,799,423,376,512678.18,455712.2,968390.38
292800,202210,1295,767,528,930828.31,639941.07,1570769.38
292805,202210,411,152,259,184225.25,313908.93,498134.18
292810,202210,1879,1116,763,1353822.26,924759.58,2278581.84
292820,202210,701,591,110,716310.31,133323.12,849633.43
292830,202210,135,102,33,123624.87,39997.41,163622.28
292840,202210,725,588,137,712668.48,166045.5,878713.98
292850,202210,140,95,45,115141.98,54542.44,169684.42
292860,202210,2173,1236,937,1498069.13,1136872.56,2634941.69
292870,202210,3813,2486,1327,3014286.68,1608334.09,4622620.77
292880,202210,1465,968,497,1173226.53,603581.96,1776808.49
292890,202210,555,460,95,557525.86,115143.54,672669.40
292895,202210,146,100,46,121200.2,56964,178164.2
292900,202210,338,240,98,290889.01,118777.98,409666.99
292905,202210,508,247,261,299368.28,316334.6,615702.88
292910,202210,526,391,135,473897.44,163620.86,637518.30
292920,202210,575,251,324,304213.45,392692.44,696905.89
292925,202210,479,441,38,534495.22,46057.22,580552.44
292930,202210,727,435,292,527225.76,353906.27,881132.03
292935,202210,283,125,158,151501.15,191496.7,342997.85
292937,202210,223,154,69,186648.17,83628,270276.17
292940,202210,196,149,47,180589.06,56964,237553.06
292950,202210,1384,656,728,795090.26,883559.31,1678649.57
292960,202210,516,365,151,442390.07,183014.15,625404.22
292970,202210,247,178,69,215737.69,83629.43,299367.12
292975,202210,92,50,42,60602.56,50905.56,111508.12
292980,202210,350,244,106,295730.06,128473.88,424203.94
292990,202210,1346,1003,343,1215642.5,415717.32,1631359.82
293000,202210,115,81,34,98172.2,41208.1,139380.3
293010,202210,3105,1824,1281,2211982.76,1553809.84,3765792.60
293015,202210,628,520,108,630246.07,130896,761142.07
293020,202210,343,273,70,332097.43,84841.82,416939.25
293030,202210,585,519,66,629033.07,79992,709025.07
293040,202210,388,308,80,373297.4,96960,470257.4
293050,202210,3102,1818,1284,2203456.13,1559861.65,3763317.78
293060,202210,239,191,48,231497.52,58176.5,289674.02
293070,202210,3919,1962,1957,2379210.7,2371912.98,4751123.68
293075,202210,98,70,28,84840.39,33936,118776.39
293076,202210,81,59,22,71508,26664,98172
293077,202210,609,348,261,421786.32,316335.99,738122.31
293080,202210,439,387,52,469049.2,63024.66,532073.86
293090,202210,139,124,15,150288,18180,168468
293100,202210,535,361,174,438751.47,210888.17,649639.64
293105,202210,355,258,97,312696.98,117564,430260.98
293110,202210,131,84,47,101810.93,56967.93,158778.86
293120,202210,306,215,91,260585.43,110294.37,370879.80
293130,202210,247,166,81,201197.19,98172,299369.19
293135,202210,8680,3471,5209,4208137.43,6318182.9,10526320.33
293140,202210,202,121,81,146654.74,98173.06,244827.80
293150,202210,314,273,41,330880.94,49692.2,380573.14
293160,202210,427,264,163,319969.52,197556.47,517525.99
293170,202210,254,162,92,196348.32,111505.74,307854.06
293180,202210,600,402,198,487225.76,239976,727201.76
293190,202210,1424,983,441,1191424.55,534502.52,1725927.07
293200,202210,578,510,68,618129.01,82416,700545.01
293210,202210,416,315,101,381783.85,122412.87,504196.72
293220,202210,2425,1066,1359,1292003.92,1648326.81,2940330.73
293230,202210,1851,691,1160,837506.94,1407134.69,2244641.63
293240,202210,242,216,26,261794.47,31512.79,293307.26
293245,202210,135,109,26,132111.27,31512,163623.27
293250,202210,820,340,480,412089.42,581770.93,993860.35
293260,202210,320,254,66,307850.02,79992,387842.02
293270,202210,1212,544,668,660542.4,809616.1,1470158.5
293280,202210,321,207,114,250884.92,138170.98,389055.90
293290,202210,3111,2000,1111,2424031.51,1347754.24,3771785.75
293300,202210,895,615,280,745383.77,339360.86,1084744.63
293305,202210,195,150,45,181800.31,54540.65,236340.96
293310,202210,177,134,43,162409.59,52116.2,214525.79
293315,202210,169,128,41,155138.68,49692.4,204831.08
293317,202210,98,71,27,86053.46,32724,118777.46
293320,202210,1245,642,603,778141.78,730854.46,1508996.24
293325,202210,214,86,128,104232,155136,259368
293330,202210,15090,6863,8227,8319311.41,9982118.53,18301429.94
293340,202210,295,207,88,250884.98,106656,357540.98
293345,202210,263,218,45,264220.19,54540,318760.19
293350,202210,599,375,224,454509.82,272700.45,727210.27
293360,202210,1527,1077,450,1305341.53,545404.98,1850746.51
310010,202210,149,78,71,94536,86052,180588
310020,202210,1008,549,459,665397.86,557524.06,1222921.92
310030,202210,314,252,62,305426.13,75146.44,380572.57
310040,202210,47,32,15,38784,18180,56964
310050,202210,165,101,64,122412.21,77568,199980.21
310060,202210,274,192,82,232708.67,99384.68,332093.35
310070,202210,19,11,8,13332,9696.2,23028.2
310080,202210,51,34,17,41208,20604,61812
310090,202210,1119,626,493,758724.55,597520.82,1356245.37
310100,202210,365,257,108,312701.11,130897.38,443598.49
310110,202210,708,378,330,458140.36,399961.7,858102.06
310120,202210,389,224,165,271488.2,199980.7,471468.9
310130,202210,32,18,14,21816.2,16968,38784.2
310140,202210,26,10,16,12120,19393.66,31513.66
310150,202210,1219,799,420,968403.39,509047.52,1477450.91
310160,202210,2180,1087,1093,1317459.23,1325934.76,2643393.99
310163,202210,103,58,45,70296,54540,124836
310170,202210,2654,1246,1408,1513767.47,1706506.88,3220274.35
310180,202210,192,87,105,105445.84,127260,232705.84
310190,202210,490,329,161,398750.01,195133.64,593883.65
310200,202210,442,281,161,340574.39,195132.2,535706.59
310205,202210,79,53,26,64236,31512,95748
310210,202210,277,227,50,275125.29,60600,335725.29
310220,202210,64,41,23,49692.14,27876,77568.14
310230,202210,279,198,81,239977.56,98172,338149.56
310240,202210,124,99,25,119988.6,30300,150288.6
310250,202210,97,79,18,95750.02,21816.64,117566.66
310260,202210,788,423,365,513898.93,442384.6,956283.53
310270,202210,286,181,105,220586.59,127260.34,347846.93
310280,202210,399,283,116,342997.84,140592,483589.84
310285,202210,206,158,48,191497.39,58176.99,249674.38
310290,202210,241,128,113,155136.31,136956,292092.31
310300,202210,178,143,35,173317.39,42420,215737.39
310310,202210,13,10,3,12120,3636,15756
310320,202210,34,12,22,14544.17,26664,41208.17
310330,202210,44,32,12,38784.77,14544,53328.77
310340,202210,1897,1344,553,1628947.28,670239.56,2299186.84
310350,202210,2862,1477,1385,1792588.94,1681052.94,3473641.88
310360,202210,51,40,11,48480,13332.12,61812.12
310370,202210,131,111,20,134532.24,24240,158772.24
310375,202210,111,44,67,53328.2,82416.41,135744.61
310380,202210,51,31,20,37572,24240,61812
310390,202210,107,65,42,79992.3,50904,130896.3
310400,202210,2603,1696,907,2056815.25,1101718,3158533.25
310410,202210,115,68,47,82417.46,56964.32,139381.78
310420,202210,699,362,337,438748.79,408449.53,847198.32
310430,202210,292,190,102,230282.52,123624,353906.52
310440,202210,77,49,28,59388,33936,93324
310445,202210,83,70,13,84840.67,15756,100596.67
310450,202210,675,447,228,541775,276337.89,818112.89
310460,202210,257,174,83,210889.53,100596,311485.53
310470,202210,544,356,188,431476.86,227858.02,659334.88
310480,202210,100,65,35,78780,42420,121200
310490,202210,575,270,305,327242.65,369661.22,696903.87
310500,202210,127,53,74,64237.74,89688,153925.74
310510,202210,614,438,176,530861.82,213314.06,744175.88
310520,202210,147,104,43,126049.56,53328,179377.56
310530,202210,119,50,69,60600.2,83628,144228.2
310540,202210,502,283,219,342998.89,266641.88,609640.77
310550,202210,71,48,23,58177.39,27876,86053.39
310560,202210,3256,2227,1029,2701580.98,1248361.65,3949942.63
310570,202210,106,65,41,78780,49692,128472
310590,202210,396,238,158,288458.41,191496.1,479954.51
310600,202210,139,68,71,82416.8,86052,168468.8
310610,202210,48,19,29,23028,35148,58176
310620,202210,51699,24507,27192,29717992.58,32992015.87,62710008.45
310630,202210,775,464,311,562373.38,378145.41,940518.79
310640,202210,151,103,48,124836,58176.2,183012.2
310650,202210,166,147,19,178164.62,23028,201192.62
310660,202210,112,76,36,92112.2,43632,135744.2
310665,202210,68,49,19,59388,23028,82416
310670,202210,7626,3296,4330,3996029.51,5250408.66,9246438.17
310680,202210,68,45,23,54540,27876,82416
310690,202210,624,438,186,530860.99,225434.58,756295.57
310700,202210,60,37,23,44844,27876,72720
310710,202210,1322,887,435,1074188.25,528436.03,1602624.28
310720,202210,158,44,114,53328,138168,191496
310730,202210,1583,1068,515,1296870.22,626620.52,1923490.74
310740,202210,1033,567,466,687214.83,564796.87,1252011.70
310750,202210,258,159,99,192710.06,121200.37,313910.43
310760,202210,66,52,14,63025.63,16968,79993.63
310770,202210,85,41,44,49692,54540,104232
310780,202210,366,293,73,356331.33,88476.6,444807.93
310790,202210,119,95,24,115140.2,29088.59,144228.79
310800,202210,490,233,257,282396.46,311484,593880.46
310810,202210,179,119,60,144228.69,72720.59,216949.28
310820,202210,315,255,60,309062.13,72720.04,381782.17
310825,202210,219,182,37,220584.75,44844,265428.75
310830,202210,467,214,253,259368.83,306637.29,566006.12
310840,202210,372,224,148,271488.93,179377.09,450866.02
310850,202210,76,61,15,73932.1,18180,92112.1
310855,202210,427,334,93,404814.51,112716,517530.51
310860,202210,1664,1227,437,1487150.08,529651.67,2016801.75
310870,202210,57,48,9,58176.19,10908,69084.19
310880,202210,91,72,19,87264,23028,110292
310890,202210,298,172,126,208464.36,153924,362388.36
310900,202210,635,285,350,346635.17,424202.27,770837.44
310910,202210,244,164,80,198770,96960,295730
310920,202210,428,247,181,299373.1,219376.93,518750.03
310925,202210,38,29,9,35148,10908,46056
310930,202210,1373,905,468,1096875.48,569643.81,1666519.29
310940,202210,709,345,364,418146.34,441173.54,859319.88
310945,202210,139,89,50,107868.3,60600,168468.3
310950,202210,215,172,43,208465.26,52116,260581.26
310960,202210,76,26,50,31512.8,60600.03,92112.83
310970,202210,180,103,77,124837.46,93324.6,218162.06
310980,202210,53,35,18,42424.17,21816,64240.17
310990,202210,163,84,79,101808.3,95748.2,197556.5
311000,202210,892,451,441,546620.36,535709.21,1082329.57
311010,202210,51,40,11,48480.2,13332,61812.2
311020,202210,39,25,14,30300.45,16968,47268.45
311030,202210,406,228,178,276337.62,215736,492073.62
311040,202210,40,31,9,37572,10908,48480
311050,202210,520,197,323,238765,391476.76,630241.76
311060,202210,843,462,381,559948.06,462985.62,1022933.68
311070,202210,346,152,194,184224.39,236340,420564.39
311080,202210,119,66,53,79992.84,64236.76,144229.60
311090,202210,351,167,184,202407.39,223009.65,425417.04
311100,202210,575,353,222,427837.59,269065.05,696902.64
311110,202210,723,513,210,621767.37,255736.72,877504.09
311115,202210,87,60,27,73933,32724,106657
311120,202210,1135,618,517,750245.18,626607.29,1376852.47
311130,202210,298,173,125,209678.89,151500,361178.89
311140,202210,169,93,76,112717.12,92113.37,204830.49
311150,202210,340,216,124,261794.72,150288.6,412083.32
311160,202210,783,555,228,672665.93,277548.96,950214.89
311170,202210,93,78,15,94536,18180,112716
311180,202210,327,220,107,266646.8,129684.68,396331.48
311190,202210,37,17,20,20604,24240,44844
311200,202210,350,234,116,283608.44,140593.5,424201.94
311205,202210,33,25,8,30300,9696,39996
311210,202210,35,31,4,37572.6,4848,42420.6
311220,202210,29,25,4,30300,4848,35148
311230,202210,1708,1124,584,1363530.24,707815.09,2071345.33
311240,202210,84,54,30,65448.59,36360.85,101809.44
311250,202210,69,29,40,35148,48480,83628
311260,202210,552,339,213,412084.49,259368,671452.49
311265,202210,137,92,45,111504,54540,166044
311270,202210,289,196,93,237554.32,112718.01,350272.33
311280,202210,205,90,115,109080.26,139380,248460.26
311290,202210,109,92,17,111504.2,20604.2,132108.4
311300,202210,602,383,219,464200.17,265430.66,729630.83
311310,202210,20,17,3,20604,3636,24240
311320,202210,647,479,168,580552.28,203616.64,784168.92
311330,202210,1220,891,329,1079904.31,398753.49,1478657.80
311340,202210,2714,1912,802,2321007.65,973238.96,3294246.61
311350,202210,270,207,63,250886.41,76356,327242.41
311360,202210,172,104,68,126048.83,82416,208464.83
311370,202210,1268,532,736,644803.92,892039.94,1536843.86
311380,202210,7,6,1,7272,1212,8484
311390,202210,248,143,105,174528.79,127260.2,301788.99
311400,202210,140,87,53,105444.39,64236,169680.39
311410,202210,129,62,67,75144,81204,156348
311420,202210,327,168,159,203618.37,192709.67,396328.04
311430,202210,859,563,296,682362.4,358753.08,1041115.48
311440,202210,460,307,153,373305.89,185438.3,558744.19
311450,202210,314,185,129,224220.22,157560.92,381781.14
311455,202210,278,191,87,232708.95,105446.54,338155.49
311460,202210,131,58,73,70296,88476.99,158772.99
311470,202210,33,14,19,16968,23028,39996
311480,202210,57,31,26,37572,31512,69084
311490,202210,11,6,5,7272,6060,13332
311500,202210,32,15,17,18180.8,20604,38784.8
311510,202210,804,543,261,658127.9,316333.33,974461.23
311520,202210,42,35,7,42420,8484,50904
311530,202210,1855,1340,515,1625320.95,625392.95,2250713.90
311535,202210,63,42,21,50904.58,25452.52,76357.10
311540,202210,34,30,4,36360,4848,41208
311545,202210,174,122,52,147865.16,63024,210889.16
311547,202210,56,42,14,50904,16968.2,67872.2
311550,202210,695,320,375,389055.75,454502.12,843557.87
311560,202210,44,28,16,33936.63,19392,53328.63
311570,202210,298,192,106,232705.68,128472.84,361178.52
311580,202210,437,278,159,336937.54,192708.39,529645.93
311590,202210,27,23,4,27876.2,4848,32724.2
311600,202210,97,80,17,96961.57,20605.15,117566.72
311610,202210,262,226,36,275124.88,43632,318756.88
311615,202210,152,129,23,156348.07,27876.52,184224.59
311620,202210,35,22,13,26664,15756,42420
311630,202210,106,90,16,109080,19392,128472
311640,202210,131,64,67,77569.2,81207.29,158776.49
311650,202210,131,91,40,110292,48480.24,158772.24
311660,202210,449,209,240,253308,290882.03,544190.03
311670,202210,156,106,50,128473.47,60600.43,189073.90
311680,202210,226,169,57,204828.4,69084.26,273912.66
311690,202210,13,13,0,15756.5,,15756.5
311700,202210,199,148,51,179377.06,61813.32,241190.38
311710,202210,185,125,60,151500.9,72720,224220.9
311720,202210,42,31,11,37573.2,13332,50905.2
311730,202210,588,415,173,502988.91,209677.59,712666.50
311740,202210,28,20,8,24240,9696,33936
311750,202210,747,506,241,614487.58,292092.68,906580.26
311760,202210,85,37,48,44844.55,59388.81,104233.36
311770,202210,383,185,198,225433.22,239976,465409.22
311780,202210,203,104,99,126048,119988.2,246036.2
311783,202210,95,85,10,103022.84,12120,115142.84
311787,202210,47,19,28,23028,33936.47,56964.47
311790,202210,268,118,150,143017,181801.11,324818.11
311800,202210,753,462,291,559950.48,352694.43,912644.91
311810,202210,52,39,13,47268.7,15756,63024.7
311820,202210,127,97,30,117564.61,36361.34,153925.95
311830,202210,2015,1195,820,1449570.19,995052.9,2444623.09
311840,202210,1120,636,484,770838.38,586612.63,1357451.01
311850,202210,16,10,6,12120,7272.2,19392.2
311860,202210,10659,4553,6106,5521969.4,7409011.5,12930980.9
311870,202210,113,66,47,79994.86,56964.26,136959.12
311880,202210,983,711,272,862957.98,329673.39,1192631.37
311890,202210,203,91,112,110192.45,135745.41,245937.86
311900,202210,68,26,42,31512,50904.05,82416.05
311910,202210,1461,912,549,1105356.7,665393.61,1770750.31
311920,202210,243,157,86,190284.88,104232,294516.88
311930,202210,930,518,412,627823.94,499345.66,1127169.60
311940,202210,2785,1509,1276,1828936.74,1547726.72,3376663.46
311950,202210,162,98,64,118777.44,77569.4,196346.84
311960,202210,66,47,19,56964.32,23028,79992.32
311970,202210,24,13,11,15756,13332,29088
311980,202210,42,31,11,37572,13332,50904
311990,202210,38,27,11,32724,13332.64,46056.64
311995,202210,52,29,23,35148,27876.22,63024.22
312000,202210,22,15,7,18180,8484,26664
312010,202210,75,59,16,71508.83,19392.1,90900.93
312015,202210,81,61,20,73932.69,24240,98172.69
312020,202210,133,94,39,113928.25,47268,161196.25
312030,202210,74,54,20,65448,24240,89688
312040,202210,87,52,35,63024,42420,105444
312050,202210,206,114,92,138168.6,111504,249672.6
312060,202210,20,13,7,15756,8484,24240
312070,202210,80,51,29,61812.15,35148.2,96960.35
312080,202210,581,271,310,328452.2,376932.3,705384.5
312083,202210,78,52,26,63024.65,31512,94536.65
312087,202210,101,75,26,90900.2,31512,122412.2
312090,202210,3513,2139,1374,2592530.97,1666514.31,4259045.28
312100,202210,149,106,43,128193.63,52116,180309.63
312110,202210,130,78,52,94536.8,63024.07,157560.87
312120,202210,129,94,35,113929.62,42420,156349.62
312125,202210,89,57,32,69084.56,38784,107868.56
312130,202210,130,87,43,105444.1,53328,158772.1
312140,202210,142,111,31,134533.36,37572.4,172105.76
312150,202210,38,30,8,36360,9696,46056
312160,202210,1518,1012,506,1227877.41,613277.04,1841154.45
312170,202210,11,9,2,10908,2424,13332
312180,202210,92,63,29,76356.79,35148,111504.79
312190,202210,49,42,7,50904,8484,59388
312200,202210,757,642,115,778116.25,139381.6,917497.85
312210,202210,125,64,61,77568.7,73932.95,151501.65
312220,202210,146,107,39,129685.3,47268,176953.3
312230,202210,4000,1791,2209,2170723.49,2678529.76,4849253.25
312235,202210,167,111,56,134532.6,67872,202404.6
312240,202210,84,62,22,75145.17,26664,101809.17
312245,202210,230,166,64,201195.49,77568.4,278763.89
312247,202210,89,62,27,75144.37,32724.38,107868.75
312250,202210,177,92,85,111505.03,103020,214525.03
312260,202210,109,70,39,84840,47268,132108
312270,202210,141,81,60,99385,72720,172105
312280,202210,34,18,16,21816,19392,41208
312290,202210,146,99,47,119990.35,56966.46,176956.81
312300,202210,208,136,72,164834.6,87264.44,252099.04
312310,202210,65,58,7,70296,8484,78780
312320,202210,423,262,161,317546.05,196344,513890.05
312330,202210,99,84,15,101808,18180.72,119988.72
312340,202210,34,18,16,21816,19392,41208
312350,202210,14,8,6,9696,7272,16968
312352,202210,99,70,29,84840.6,35148,119988.6
312360,202210,599,254,345,307850.5,418140.2,725990.7
312370,202210,388,210,178,254520.96,215738.3,470259.26
312380,202210,147,98,49,118782.16,59389.14,178171.30
312385,202210,168,139,29,168469.08,35148.45,203617.53
312390,202210,293,187,106,226644.05,128472.93,355116.98
312400,202210,389,292,97,353905.25,117565.32,471470.57
312410,202210,1285,475,810,575714.87,984154.06,1559868.93
312420,202210,691,523,168,633881.35,204828.56,838709.91
312430,202210,888,640,248,775684.39,300577.46,1076261.85
312440,202210,46,36,10,43632,12120,55752
312450,202210,208,128,80,155136,96960,252096
312460,202210,34,16,18,19392,21816,41208
312470,202210,47,32,15,38784,18180,56964
312480,202210,168,101,67,122414.06,81204.99,203619.05
312490,202210,325,221,104,267853.87,126048.7,393902.57
312500,202210,30,20,10,24240.2,12120,36360.2
312510,202210,675,259,416,313913.75,504198.41,818112.16
312520,202210,28,8,20,9696,24240.2,33936.2
312530,202210,38,26,12,31513.5,14544.1,46057.6
312540,202210,88,77,11,93324,13332,106656
312550,202210,34,27,7,32724,8484,41208
312560,202210,206,159,47,192708.48,56964,249672.48
312570,202210,483,284,199,344216.74,241190.27,585407.01
312580,202210,91,53,38,64236,46056,110292
312590,202210,220,173,47,209677.16,56964,266641.16
312595,202210,149,121,28,146652.25,33936,180588.25
312600,202210,79,35,44,42420.7,53328,95748.7
312610,202210,1609,827,782,1003551.99,950208.3,1953760.29
312620,202210,232,169,63,204829.4,76356,281185.4
312630,202210,70,56,14,67872.2,16968,84840.2
312640,202210,41,10,31,12120,37572,49692
312650,202210,160,134,26,162818.19,31512.1,194330.29
312660,202210,113,83,30,100602.29,36361.2,136963.49
312670,202210,950,612,338,741756.59,410871.55,1152628.14
312675,202210,46,35,11,42420,13332,55752
312680,202210,78,51,27,61812,32724,94536
312690,202210,270,137,133,166045.91,161196.85,327242.76
312695,202210,33,27,6,32724,7272,39996
312700,202210,260,150,110,181804.56,133320.6,315125.16
312705,202210,81,65,16,78780,19392,98172
312707,202210,133,96,37,116352.1,44844,161196.1
312710,202210,1957,1098,859,1330804.93,1042325.87,2373130.80
312720,202210,45,21,24,25452.56,29088.69,54541.25
312730,202210,279,167,112,202407.1,135746.72,338153.82
312733,202210,50,40,10,48480,12120,60600
312735,202210,24,18,6,21816,7272.9,29088.9
312737,202210,75,42,33,50904.33,39996,90900.33
312738,202210,69,43,26,52116.77,31512,83628.77
312740,202210,79,51,28,61812.1,33936,95748.1
312750,202210,111,72,39,87264,47268,134532
312760,202210,279,190,89,231493.66,107868.41,339362.07
312770,202210,9207,4384,4823,5314692.13,5850339.87,11165032.00
312780,202210,458,348,110,421779.81,133321.51,555101.32
312790,202210,20,14,6,16968,7272.2,24240.2
312800,202210,1697,1176,521,1426535.94,631455.99,2057991.93
312810,202210,357,242,115,293305.33,139380,432685.33
312820,202210,198,150,48,181800.44,58176,239976.44
312825,202210,47,36,11,43632.68,13332,56964.68
312830,202210,198,107,91,129684.8,110292.05,239976.85
312840,202210,192,134,58,163620.04,70296,233916.04
312850,202210,41,36,5,43632.9,6060,49692.9
312860,202210,148,102,46,123624,55752,179376
312870,202210,1204,622,582,753871.81,705384,1459255.81
312880,202210,122,91,31,110292.98,37572,147864.98
312890,202210,176,127,49,153925.96,59388,213313.96
312900,202210,170,127,43,153924.98,52116,206040.98
312910,202210,179,100,79,121202.51,96960.88,218163.39
312920,202210,110,62,48,75144,58176,133320
312930,202210,332,225,107,272701.87,129685.54,402387.41
312940,202210,148,101,47,122412,56964,179376
312950,202210,759,534,225,647218.93,272701.86,919920.79
312960,202210,152,109,43,132110.62,52117.03,184227.65
312965,202210,119,96,23,116352.1,29088,145440.1
312970,202210,292,234,58,283614.74,70296.32,353911.06
312980,202210,2762,1427,1335,1729545.82,1618023.54,3347569.36
312990,202210,47,19,28,23028,33936,56964
313000,202210,56,31,25,37572,30300,67872
313005,202210,190,146,44,176953.29,53328.5,230281.79
313010,202210,1012,431,581,523588.96,704176.19,1227765.15
313020,202210,193,101,92,122412,111504,233916
313030,202210,211,137,74,167256.76,89688.01,256944.77
313040,202210,94,29,65,35148.55,78780,113928.55
313050,202210,209,148,61,179376,73932,253308
313055,202210,42,31,11,37572,13332,50904
313060,202210,146,99,47,119988.6,56964.65,176953.25
313065,202210,60,43,17,52116,20604.6,72720.6
313070,202210,133,72,61,87265.93,73932,161197.93
313080,202210,42,23,19,27876.6,23028,50904.6
313090,202210,700,453,247,549043.58,299364.39,848407.97
313100,202210,216,79,137,95748.6,166044,261792.6
313110,202210,156,88,68,106656.1,82417.4,189073.5
313115,202210,248,133,115,161197.17,139380,300577.17
313120,202210,865,497,368,602370.51,446018.82,1048389.33
313130,202210,6272,3465,2807,4202066.91,3402103.11,7604170.02
313140,202210,136,77,59,93325.81,71508.66,164834.47
313150,202210,298,234,64,283611.01,77568,361179.01
313160,202210,190,144,46,174531.81,56964,231495.81
313170,202210,1451,922,529,1118690.92,642360.79,1761051.71
313180,202210,339,211,128,256948.24,155137.09,412085.33
313190,202210,782,455,327,551468.33,396326.85,947795.18
313200,202210,34,27,7,32724,8484.2,41208.2
313210,202210,1031,879,152,1065380.31,184226.88,1249607.19
313220,202210,310,188,122,227856.95,147864,375720.95
313230,202210,285,220,65,266640.2,78780.54,345420.74
313240,202210,2371,1203,1168,1460476.79,1415616.63,2876093.42
313250,202210,1272,957,315,1161118.93,381784.13,1542903.06
313260,202210,98,46,52,55752,63024,118776
313270,202210,1073,630,443,763566.97,536921.79,1300488.76
313280,202210,47,38,9,46056,10908,56964
313290,202210,233,187,46,226646.09,55752,282398.09
313300,202210,339,164,175,198768.5,212100.58,410869.08
313310,202210,258,110,148,133320.96,180588.8,313909.76
313320,202210,395,286,109,346634.81,132108.61,478743.42
313330,202210,1505,921,584,1116270.3,707813.27,1824083.57
313340,202210,342,250,92,303243.99,111504.7,414748.69
313350,202210,467,290,177,352693.06,214524,567217.06
313360,202210,202,96,106,116352.2,128472,244824.2
313370,202210,244,87,157,105444.67,190284.25,295728.92
313375,202210,323,198,125,239977.51,151501.08,391478.59
313380,202210,1351,715,636,870230.23,773257.88,1643488.11
313390,202210,56,50,6,60600.6,7272,67872.6
313400,202210,419,292,127,353916.58,153927.1,507843.68
313410,202210,94,60,34,72720.8,42420.81,115141.61
313420,202210,4798,2690,2108,3262772.05,2557334.38,5820106.43
313430,202210,122,61,61,73932.8,73932.5,147865.3
313440,202210,1411,996,415,1207182.73,502987.39,1710170.12
313450,202210,66,31,35,37572,42420,79992
313460,202210,404,177,227,214527.92,275124.88,489652.80
313470,202210,525,246,279,299333.11,338151.76,637484.87
313480,202210,167,124,43,151501.94,52116,203617.94
313490,202210,570,258,312,313912.1,378150.11,692062.21
313500,202210,31,17,14,20604,16968,37572
313505,202210,1126,864,262,1049610.72,317547.28,1367158.00
313507,202210,111,73,38,88476.9,46056,134532.9
313510,202210,3003,1855,1148,2250847.76,1392604.51,3643452.27
313520,202210,3545,2747,798,3329440.19,967186.85,4296627.04
313530,202210,39,23,16,27876,19392,47268
313535,202210,91,73,18,88477.94,21816,110293.94
313540,202210,69,48,21,58176,25452,83628
313545,202210,123,104,19,127260.76,23028,150288.76
313550,202210,224,192,32,232705.55,38785.49,271491.04
313560,202210,357,168,189,204832.11,229071.51,433903.62
313570,202210,80,29,51,36360,63024.41,99384.41
313580,202210,1396,817,579,991428.02,701750.62,1693178.64
313590,202210,67,40,27,48480.2,32724.46,81204.66
313600,202210,698,425,273,516315.96,330877.84,847193.80
313610,202210,58,45,13,54541.93,15756,70297.93
313620,202210,1516,741,775,899319.89,940515.21,1839835.10
313630,202210,1706,1291,415,1565932.03,504194.74,2070126.77
313640,202210,122,72,50,87265.68,60600,147865.68
313650,202210,235,123,112,149077.6,135745.17,284822.77
313652,202210,30,29,1,36360,1212,37572
313655,202210,91,60,31,72720.76,37572.79,110293.55
313657,202210,53,48,5,58177.62,6060,64237.62
313660,202210,139,93,46,112718.18,55753.41,168471.59
313665,202210,727,335,392,406027.42,475110.29,881137.71
313670,202210,11126,7622,3504,9248959.59,4249310.09,13498269.68
313680,202210,44,34,10,41209,12120,53329
313690,202210,137,98,39,118776.87,47268,166044.87
313695,202210,87,67,20,81204.53,24240,105444.53
313700,202210,351,270,81,327245.48,98172.2,425417.68
313710,202210,128,91,37,110294.09,44844,155138.09
313720,202210,1216,557,659,676310.39,799927.56,1476237.95
313730,202210,74,43,31,52116,37572,89688
313740,202210,151,114,37,138168.4,44844,183012.4
313750,202210,411,289,122,350270.09,147864.6,498134.69
313753,202210,239,178,61,215737.67,73932.1,289669.77
313760,202210,1427,561,866,679940.45,1049598.24,1729538.69
313770,202210,424,288,136,349063.76,164834.08,513897.84
313780,202210,876,471,405,570857.55,490864.07,1061721.62
313790,202210,37,36,1,43632,1212,44844
313800,202210,170,104,66,126049.19,79994.2,206043.39
313810,202210,89,51,38,61812,46056,107868
313820,202210,1440,697,743,847197.99,904154.17,1751352.16
313830,202210,55,37,18,44844.89,21816,66660.89
313835,202210,64,54,10,65448.2,12120,77568.2
313840,202210,1745,1047,698,1271404.81,845979.77,2117384.58
313850,202210,222,95,127,115141.2,153924,269065.2
313860,202210,490,371,119,449659.28,145440.64,595099.92
313862,202210,181,125,56,151502.2,67872.2,219374.4
313865,202210,192,131,61,158773.18,73932.3,232705.48
313867,202210,60,49,11,59388,13332,72720
313868,202210,47,31,16,37572,19392,56964
313870,202210,84,45,39,54540,47268,101808
313880,202210,389,243,146,294517.14,176954.01,471471.15
313890,202210,343,187,156,226648.55,189072,415720.55
313900,202210,846,459,387,556315.98,470261.23,1026577.21
313910,202210,151,103,48,124836,58176,183012
313920,202210,667,456,211,552674.17,255732.9,808407.07
313925,202210,37,31,6,37572,7272,44844
313930,202210,935,717,218,870232.66,264220.88,1134453.54
313940,202210,2008,1208,800,1466542.43,973241.33,2439783.76
313950,202210,881,537,344,650851.48,416929.17,1067780.65
313960,202210,1531,877,654,1062937.24,795078.94,1858016.18
313970,202210,192,110,82,133320.1,100596,233916.1
313980,202210,238,154,84,186651.67,101808.7,288460.37
313990,202210,270,165,105,199980.6,127260,327240.6
314000,202210,904,590,314,717508.48,381783.91,1099292.39
314010,202210,97,63,34,76356,41208,117564
314015,202210,96,28,68,33937.37,82416.8,116354.17
314020,202210,57,39,18,47268.89,21816,69084.89
314030,202210,73,37,36,44844.7,43632,88476.7
314040,202210,47,25,22,30300,26664,56964
314050,202210,298,165,133,199982.97,161196,361178.97
314053,202210,102,62,40,75144.7,48480,123624.7
314055,202210,309,193,116,233918.82,140593.24,374512.06
314060,202210,123,104,19,126048.3,23028,149076.3
314070,202210,1122,564,558,683579.17,677517.72,1361096.89
314080,202210,215,136,79,164833.81,95748.84,260582.65
314085,202210,186,129,57,156348,69084,225432
314090,202210,417,297,120,361180.09,145440,506620.09
314100,202210,540,427,113,517533.12,136959.77,654492.89
314110,202210,791,354,437,429059.05,529648.45,958707.50
314120,202210,68,41,27,49692,32724,82416
314130,202210,26,19,7,23028,8484,31512
314140,202210,1203,760,443,921140.6,536919.8,1458060.4
314150,202210,192,123,69,149078.19,83628.65,232706.84
314160,202210,315,236,79,286033.92,95748,381781.92
314170,202210,84,66,18,79992.79,21816,101808.79
314180,202210,788,698,90,845994.49,109082.87,955077.36
314190,202210,85,53,32,64236,38784,103020
314200,202210,526,362,164,438756.4,198773.69,637530.09
314210,202210,259,201,58,243612.56,70296.6,313909.16
314220,202210,307,217,90,263008.11,109081.53,372089.64
314225,202210,51,33,18,39997,21816,61813
314230,202210,123,56,67,67872,81204,149076
314240,202210,177,128,49,155136.61,59388.47,214525.08
314250,202210,59,35,24,42421.71,29088,71509.71
314260,202210,218,105,113,127260.66,136956,264216.66
314270,202210,425,334,91,404817.6,110292.7,515110.3
314280,202210,761,414,347,501718.48,421778.32,923496.80
314290,202210,556,432,124,524800.76,150288.8,675089.56
314300,202210,352,262,90,317549.24,109080,426629.24
314310,202210,1373,951,422,1152934.74,512676.47,1665611.21
314315,202210,44,34,10,41208,12120,53328
314320,202210,600,412,188,500559.97,227859.42,728419.39
314330,202210,12194,5920,6274,7177587.41,7613823.47,14791410.88
314340,202210,666,297,369,359966.63,447233,807199.63
314345,202210,61,45,16,54540,19392,73932
314350,202210,187,115,72,139380,87264.66,226644.66
314360,202210,55,31,24,37576.34,29089.44,66665.78
314370,202210,72,52,20,63024,24240,87264
314380,202210,132,72,60,88476.5,72720,161196.5
314390,202210,3556,2293,1263,2781583.04,1531970.5,4313553.54
314400,202210,717,500,217,606007.67,264217.68,870225.35
314410,202210,554,370,184,448443.1,223008.46,671451.56
314420,202210,22,13,9,15756.6,10908,26664.6
314430,202210,2525,953,1572,1156269.95,1907713.23,3063983.18
314435,202210,153,88,65,106658.65,78780,185438.65
314437,202210,54,41,13,49692,15756,65448
314440,202210,96,60,36,72720.44,43632.1,116352.54
314450,202210,173,121,52,146652.2,63024.05,209676.25
314460,202210,655,324,331,392690.68,402387.4,795078.08
314465,202210,129,83,46,100596.87,55752,156348.87
314467,202210,75,60,15,72720.1,18180,90900.1
314470,202210,428,214,214,259370.37,260582.68,519953.05
314480,202210,1108,499,609,604795.74,739323.82,1344119.56
314490,202210,36,20,16,24240.74,19392,43632.74
314500,202210,284,194,90,235130.3,109080.45,344210.75
314505,202210,121,78,43,94537.19,52116,146653.19
314510,202210,255,207,48,250886.46,58176,309062.46
314520,202210,1486,777,709,941739.42,859317.34,1801056.76
314530,202210,791,626,165,758737.48,199984.58,958722.06
314535,202210,173,106,67,128472.6,81204,209676.6
314537,202210,69,42,27,50904.13,32724.1,83628.23
314540,202210,17,10,7,12120,8484,20604
314545,202210,65,44,21,53328,25452,78780
314550,202210,76,40,36,48480.8,43633.89,92114.69
314560,202210,898,476,422,576918.12,511468.27,1088386.39
314570,202210,16,14,2,16968.3,2424,19392.3
314580,202210,12,6,6,7272,7272,14544
314585,202210,27,20,7,24240,8484.44,32724.44
314587,202210,84,73,11,88476,13332,101808
314590,202210,603,414,189,501772.24,229068.24,730840.48
314600,202210,1007,653,354,793880.36,430268.48,1224148.84
314610,202210,999,513,486,622972.89,591460.29,1214433.18
314620,202210,155,117,38,141804.2,46056,187860.2
314625,202210,99,75,24,90900.29,29088,119988.29
314630,202210,1165,643,522,779333.17,632668.31,1412001.48
314640,202210,89,55,34,66662.67,41208.6,107871.27
314650,202210,158,90,68,109081.51,82416.79,191498.30
314655,202210,64,48,16,58176,19392,77568
314660,202210,19,14,5,16968,6060,23028
314670,202210,230,179,51,216955.5,61814.37,278769.87
314675,202210,216,131,85,158773.84,103020,261793.84
314690,202210,589,315,274,381781.62,332088.89,713870.51
314700,202210,2242,1193,1049,1445945.85,1271391.62,2717337.47
314710,202210,1896,1063,833,1289577.86,1012020.31,2301598.17
314720,202210,407,229,178,277551.79,215736.8,493288.59
314730,202210,535,288,247,349057.66,299365.19,648422.85
314740,202210,811,370,441,448445.04,534495.29,982940.33
314750,202210,24,18,6,21816,7272,29088
314760,202210,375,151,224,183012.41,271489.69,454502.10
314770,202210,107,70,37,84840,44844,129684
314780,202210,20,8,12,9696,14544,24240
314790,202210,2579,1638,941,1985291.98,1140492.8,3125784.78
314795,202210,72,64,8,77568.1,9696,87264.1
314800,202210,3044,1775,1269,2151321.48,1541668.71,3692990.19
314810,202210,1543,876,667,1061719.48,808405.4,1870124.88
314820,202210,116,67,49,81205.1,59388.1,140593.2
314830,202210,222,185,37,224222.21,44844,269066.21
314840,202210,88,51,37,61812,44844,106656
314850,202210,434,208,226,252220.14,275124.6,527344.74
314860,202210,661,498,163,603580.26,197556.18,801136.44
314870,202210,1681,889,792,1078697.24,959918.13,2038615.37
314875,202210,65,60,5,72720,6060,78780
314880,202210,42,30,12,36360,14544,50904
314890,202210,53,28,25,33936,30300,64236
314900,202210,27,20,7,24240,8484.92,32724.92
314910,202210,237,158,79,191496.44,95748,287244.44
314915,202210,145,127,18,153925.04,21816.18,175741.22
314920,202210,81,54,27,65448.85,32724,98172.85
314930,202210,1055,493,562,597523.04,681146.73,1278669.77
314940,202210,37,29,8,35148,9696.1,44844.1
314950,202210,24,21,3,25452.6,3636,29088.6
314960,202210,27,19,8,23028,9696,32724
314970,202210,177,85,92,104232.63,111504.71,215737.34
314980,202210,323,203,120,246037.47,145440.75,391478.22
314990,202210,469,254,215,307850.72,260582.18,568432.90
314995,202210,158,68,90,82416.8,109080,191496.8
315000,202210,100,78,22,94536.49,26664.9,121201.39
315010,202210,34,20,14,24240,16968,41208
315015,202210,161,129,32,156348.2,38784,195132.2
315020,202210,67,57,10,69084,12120,81204
315030,202210,107,80,27,96960,32724,129684
315040,202210,89,52,37,63024,44844,107868
315050,202210,213,130,83,157560.56,100596.68,258157.24
315053,202210,64,43,21,52116,25452,77568
315057,202210,128,98,30,118776.05,36360,155136.05
315060,202210,67,54,13,65449.48,15756,81205.48
315070,202210,110,65,45,78780.26,54540,133320.26
315080,202210,396,311,85,378147.73,103020.92,481168.65
315090,202210,101,59,42,71508.29,50904,122412.29
315100,202210,87,43,44,52116.03,53328.38,105444.41
315110,202210,285,142,143,172106.38,173316,345422.38
315120,202210,1900,902,998,1095674.66,1209605.48,2305280.14
315130,202210,346,245,101,298153.61,122413.31,420566.92
315140,202210,558,302,256,366026.6,310274.85,676301.45
315150,202210,1002,480,522,582979.86,632668.75,1215648.61
315160,202210,201,106,95,128478.13,115141.08,243619.21
315170,202210,302,197,105,238766.9,127260.6,366027.5
315180,202210,3362,1439,1923,1746516.99,2335533.28,4082050.27
315190,202210,295,183,112,221798.41,135744.15,357542.56
315200,202210,1246,739,507,895682.99,615699.6,1511382.59
315210,202210,1797,1070,727,1296855.9,882337.58,2179193.48
315213,202210,29,17,12,20604.77,14544,35148.77
315217,202210,219,172,47,208464.4,56964,265428.4
315220,202210,1659,1222,437,1481088.97,530863.58,2011952.55
315230,202210,182,139,43,168468.67,52116,220584.67
315240,202210,374,242,132,293308.27,161200.03,454508.30
315250,202210,2783,1317,1466,1596221,1776796.44,3373017.44
315260,202210,138,78,60,94536,72720.1,167256.1
315270,202210,150,107,43,129684,52116,181800
315280,202210,615,402,213,487237.11,258165.16,745402.27
315290,202210,193,118,75,143016.76,92112.09,235128.85
315300,202210,104,79,25,95748.2,30300,126048.2
315310,202210,84,75,9,90900.6,10908,101808.6
315320,202210,147,92,55,111506.69,66660,178166.69
315330,202210,64,50,14,60600,16968,77568
315340,202210,395,286,109,346634.99,132109.56,478744.55
315350,202210,167,105,62,127260.88,75144,202404.88
315360,202210,105,49,56,59388,67872,127260
315370,202210,58,37,21,44845.83,25452,70297.83
315380,202210,6,5,1,6060,1212,7272
315390,202210,70,28,42,33936,50905.6,84841.6
315400,202210,828,625,203,757515.67,246036.76,1003552.43
315410,202210,316,187,129,226650.92,156352.04,383002.96
315415,202210,62,46,16,55752,19392.64,75144.64
315420,202210,205,149,56,180589.38,67872,248461.38
315430,202210,637,355,282,430262.8,341785.17,772047.97
315440,202210,96,64,32,77568.6,38784,116352.6
315445,202210,230,189,41,229073.37,49692.37,278765.74
315450,202210,182,132,50,159984,60600,220584
315460,202210,4924,2256,2668,2734336.65,3237282.05,5971618.70
315470,202210,46,20,26,24240,31512,55752
315480,202210,75,23,52,27876.82,63024.3,90901.12
315490,202210,746,475,271,575705.11,328452.58,904157.69
315500,202210,22,18,4,21816,4848,26664
315510,202210,151,108,43,130896,53328,184224
315520,202210,79,68,11,83628,13332,96960
315530,202210,46,26,20,31512,24240.2,55752.2
315540,202210,282,193,89,233919.31,107869.27,341788.58
315550,202210,193,154,39,186650.37,47268,233918.37
315560,202210,727,571,156,692061.81,189073.73,881135.54
315570,202210,310,153,157,185441.68,190285.96,375727.64
315580,202210,781,530,251,643574.38,304212.8,947787.18
315590,202210,193,99,94,119990.14,113928.51,233918.65
315600,202210,344,266,78,322394.45,94536.78,416931.23
315610,202210,102,47,55,56964,66660,123624
315620,202210,37,30,7,36361.38,8484,44845.38
315630,202210,131,96,35,116352.76,42420,158772.76
315640,202210,63,37,26,44844.98,31512.8,76357.78
315645,202210,50,32,18,38784,21816,60600
315650,202210,172,126,46,152712.76,55752,208464.76
315660,202210,444,205,239,248468.08,289672.01,538140.09
315670,202210,2518,1151,1367,1396249.55,1659246.92,3055496.47
315680,202210,783,559,224,677513.04,271488.5,949001.54
315690,202210,698,460,238,559952.05,288457.38,848409.43
315700,202210,2079,1091,988,1322324.01,1197481.54,2519805.55
315710,202210,371,123,248,149077.88,300576,449653.88
315720,202210,532,321,211,389055.82,255733.26,644789.08
315725,202210,202,160,42,193920.87,50904,244824.87
315727,202210,88,51,37,61813.88,44844,106657.88
315730,202210,54,47,7,56964,8484,65448
315733,202210,86,51,35,61812,42420,104232
315737,202210,49,37,12,44844.68,14544,59388.68
315740,202210,31,24,7,29088,8484,37572
315750,202210,170,120,50,145440,60600.56,206040.56
315760,202210,46,34,12,41208,14544,55752
315765,202210,142,83,59,100597.69,71509.88,172107.57
315770,202210,241,159,82,192708.36,99384,292092.36
315780,202210,4080,2008,2072,2434949.14,2514905.11,4949854.25
315790,202210,250,192,58,232705.48,71508.38,304213.86
315800,202210,319,213,106,258158.8,128472,386630.8
315810,202210,65,39,26,47269.44,31512,78781.44
315820,202210,783,576,207,699341.21,250888.66,950229.87
315830,202210,123,79,44,95748.09,53328.5,149076.59
315840,202210,80,53,27,64236,32724,96960
315850,202210,276,184,92,223012.46,111507.23,334519.69
315860,202210,20,7,13,8484,15756,24240
315870,202210,40,31,9,37572.95,10908,48480.95
315880,202210,97,65,32,78780,38784,117564
315890,202210,111,77,34,93325.98,41208.54,134534.52
315895,202210,412,272,140,329672.47,169682.15,499354.62
315900,202210,91,40,51,48480,61812.08,110292.08
315910,202210,47,28,19,33936,23028,56964
315920,202210,159,106,53,128473.13,64236,192709.13
315930,202210,53,17,36,20605.07,43633.62,64238.69
315935,202210,127,100,27,121203.35,32724,153927.35
315940,202210,104,75,29,90900.19,35148,126048.19
315950,202210,35,26,9,31512,10908.65,42420.65
315960,202210,596,279,317,338152.3,384209.09,722361.39
315970,202210,32,27,5,32724.02,6060,38784.02
315980,202210,684,348,336,421788.68,407234.16,829022.84
315990,202210,263,150,113,181801.71,136956.48,318758.19
316000,202210,53,31,22,37572.8,26664,64236.8
316010,202210,94,79,15,95749.15,19392,115141.15
316020,202210,104,91,13,110292.49,15756,126048.49
316030,202210,387,223,164,270277.98,198768.95,469046.93
316040,202210,568,234,334,283610.72,406020.2,689630.92
316045,202210,52,46,6,55752,7272,63024
316050,202210,25,18,7,21816,8484,30300
316060,202210,106,73,33,88476.68,39996,128472.68
316070,202210,1242,833,409,1009606.46,495711.36,1505317.82
316080,202210,96,66,30,80099.1,36360,116459.1
316090,202210,37,18,19,21816,23028.59,44844.59
316095,202210,85,73,12,88477.29,14544.58,103021.87
316100,202210,350,192,158,232707.58,193920.85,426628.43
316105,202210,55,34,21,41208.61,25452,66660.61
316110,202210,1916,1490,426,1805904.19,516321.22,2322225.41
316120,202210,78,53,25,64236,30300,94536
316130,202210,119,89,30,107870.82,36360,144230.82
316140,202210,35,25,10,30300,12120,42420
316150,202210,219,154,65,186648.2,78780.33,265428.53
316160,202210,90,57,33,69084,39997.15,109081.15
316165,202210,78,50,28,60600.73,33936,94536.73
316170,202210,189,123,66,149076.19,79992,229068.19
316180,202210,220,86,134,104232.47,162409.57,266642.04
316190,202210,151,109,42,132109.05,50904,183013.05
316200,202210,681,374,307,453295.56,372085.96,825381.52
316210,202210,786,536,250,649849.08,303002.96,952852.04
316220,202210,124,78,46,94536.1,55752,150288.1
316225,202210,41,27,14,32724.88,16968,49692.88
316230,202210,45,26,19,31512,23028,54540
316240,202210,680,540,140,655701.16,169683.49,825384.65
316245,202210,174,154,20,186649.54,24240,210889.54
316250,202210,1710,1143,567,1386541.85,688418.99,2074960.84
316255,202210,141,113,28,136956,33936,170892
316257,202210,186,94,92,113928.2,111504.72,225432.92
316260,202210,203,137,66,167256.4,79992.2,247248.6
316265,202210,36,25,11,30300.2,13332.21,43632.41
316270,202210,695,493,202,597522.48,244826.69,842349.17
316280,202210,572,360,212,436326.44,256946.9,693273.34
316290,202210,878,604,274,732063.11,333303.06,1065366.17
316292,202210,642,263,379,318758.83,459350.17,778109.00
316294,202210,109,70,39,84842.34,47268,132110.34
316295,202210,390,187,203,226647.94,246038.63,472686.57
316300,202210,19,13,6,15756.6,7272,23028.6
316310,202210,26,14,12,16968,14544,31512
316320,202210,70,32,38,38784.97,46056,84840.97
316330,202210,181,125,56,151500.2,67872,219372.2
316340,202210,141,91,50,110292,60600,170892
316350,202210,195,135,60,163620.78,72720.2,236340.98
316360,202210,27,15,12,18180,14544,32724
316370,202210,1290,623,667,755089.72,808408.15,1563497.87
316380,202210,118,88,30,106656.5,36360,143016.5
316390,202210,103,75,28,90900,33936,124836
316400,202210,159,121,38,146653.75,46056,192709.75
316410,202210,310,222,88,269064.34,106656.2,375720.54
316420,202210,227,151,76,183015.36,92113.65,275129.01
316430,202210,162,89,73,107868.26,88476,196344.26
316440,202210,73,40,33,48481.44,39996.97,88478.41
316443,202210,49,41,8,49692,9696,59388
316447,202210,43,35,8,42421.33,9696,52117.33
316450,202210,242,181,61,219372.9,73932,293304.9
316460,202210,50,14,36,16968.7,43632.2,60600.9
316470,202210,1814,1324,490,1607123.37,593880.43,2201003.80
316480,202210,10,8,2,9696,2424,12120
316490,202210,21,7,14,8484,16968,25452
316500,202210,165,104,61,126049.34,73932.19,199981.53
316510,202210,137,110,27,133320,32724,166044
316520,202210,190,105,85,127260.85,103021.61,230282.46
316530,202210,175,110,65,133320.2,78780,212100.2
316540,202210,163,83,80,100596.31,99384.73,199981.04
316550,202210,162,100,62,122413.24,76356,198769.24
316553,202210,443,218,225,264219.91,272701.85,536921.76
316555,202210,58,52,6,63024.85,7272,70296.85
316556,202210,16,11,5,13332.41,6060,19392.41
316557,202210,34,28,6,33936.2,7272,41208.2
316560,202210,77,53,24,64236,29088,93324
316570,202210,213,195,18,236341.12,21816,258157.12
316580,202210,22,15,7,18180,8484,26664
316590,202210,89,75,14,90900.62,16968.8,107869.42
316600,202210,178,148,30,179376,36360,215736
316610,202210,71,50,21,60601.14,25452,86053.14
316620,202210,148,103,45,124836,54540.87,179376.87
316630,202210,55,41,14,49692,16968,66660
316640,202210,24,14,10,16968,12120,29088
316650,202210,102,81,21,99384,25452,124836
316660,202210,6,2,4,2424,4848,7272
316670,202210,441,150,291,181802.48,352692.83,534495.31
316680,202210,167,127,40,153926.09,48480.4,202406.49
316690,202210,154,93,61,112716,75144,187860
316695,202210,56,48,8,59388,9696,69084
316700,202210,26,18,8,21816,9696,31512
316710,202210,818,622,196,753872.16,237553.35,991425.51
316720,202210,5311,2472,2839,2997319.43,3442084.96,6439404.39
316730,202210,16,15,1,18180,1212,19392
316740,202210,160,101,59,122412,71508,193920
316750,202210,22,13,9,15756.35,10908,26664.35
316760,202210,334,267,67,323605.68,81204.49,404810.17
316770,202210,181,93,88,112716.6,106656,219372.6
316780,202210,70,39,31,47268.6,37572,84840.6
316790,202210,66,45,21,54540,25452.1,79992.1
316800,202210,1837,1122,715,1359884.67,867809.91,2227694.58
316805,202210,33,22,11,26664,13332,39996
316810,202210,62,37,25,44844.21,30300.7,75144.91
316820,202210,37,21,16,25452,19392,44844
316830,202210,104,48,56,58176.2,69084.32,127260.52
316840,202210,515,307,208,372086.3,252097.49,624183.79
316850,202210,309,210,99,254522.53,119988.78,374511.31
316860,202210,6516,2925,3591,3546412.42,4352307.74,7898720.16
316870,202210,1753,1129,624,1369591.95,758718.07,2128310.02
316880,202210,168,83,85,100597.15,103021.55,203618.70
316890,202210,234,155,79,187861.13,95748.69,283609.82
316900,202210,431,296,135,358755.42,163620,522375.42
316905,202210,26,11,15,13332,18180,31512
316910,202210,83,36,47,43632,56964,100596
316920,202210,149,113,36,136958.83,43632,180590.83
316930,202210,2044,1042,1002,1265345.38,1214426.44,2479771.82
316935,202210,985,584,401,707818.97,486018.93,1193837.90
316940,202210,1155,675,480,819321.46,581762.09,1401083.55
316950,202210,196,93,103,113928.54,124836,238764.54
316960,202210,1115,620,495,751458.26,602370.19,1353828.45
316970,202210,664,529,135,641157.2,164834.65,805991.85
316980,202210,85,43,42,52116,50904,103020
316990,202210,2319,1574,745,1908926.96,904156.01,2813082.97
317000,202210,351,272,79,329671.3,95749.08,425420.38
317005,202210,220,151,69,183015.12,83628.9,266644.02
317010,202210,7009,3993,3016,4845699.16,3656649.63,8502348.79
317020,202210,16229,7073,9156,8581149.3,11105622.96,19686772.26
317030,202210,97,42,55,50904.19,66660,117564.19
317040,202210,3209,2091,1118,2536769.16,1356235.04,3893004.20
317043,202210,77,60,17,72724.66,20604.8,93329.46
317047,202210,37,21,16,26664,19392,46056
317050,202210,155,124,31,150290.01,37572,187862.01
317052,202210,160,131,29,158773.55,35148,193921.55
317057,202210,190,141,49,170892.56,59388,230280.56
317060,202210,65,40,25,48480,30300.2,78780.2
317065,202210,51,38,13,46056,15756,61812
317070,202210,2007,932,1075,1132023.2,1302902.56,2434925.76
317075,202210,96,54,42,65448.53,52116,117564.53
317080,202210,987,505,482,613291.54,585397,1198688.54
317090,202210,720,563,157,682362.82,190287.48,872650.30
317100,202210,446,335,111,406021.32,134532,540553.32
317103,202210,134,105,29,127260.74,35148,162408.74
317107,202210,50,41,9,49692,10908,60600
317110,202210,81,42,39,50904.4,47269.02,98173.42
317115,202210,45,41,4,49748.96,4848,54596.96
317120,202210,2223,1091,1132,1323536.76,1371994.18,2695530.94
317130,202210,2165,1457,708,1768319.06,859308.96,2627628.02
317140,202210,15,12,3,14544,3636,18180
317150,202210,290,175,115,212100.96,139380.71,351481.67
317160,202210,361,267,94,324818.54,113928.98,438747.52
317170,202210,246,161,85,195132.73,103020.7,298153.43
317180,202210,431,292,139,353906.45,168470.46,522376.91
317190,202210,263,187,76,226644.74,92112,318756.74
317200,202210,860,597,263,723579.53,321186.12,1044765.65
317210,202210,182,92,90,111509,109080,220589
317220,202210,23,11,12,13332,14544,27876
320010,202210,571,409,162,495712.98,198770.23,694483.21
320013,202210,130,85,45,103021.22,54541.69,157562.91
320016,202210,256,156,100,189073.53,121200,310273.53
320020,202210,761,446,315,540567.4,381788.87,922356.27
320030,202210,172,120,52,145440.54,63024.24,208464.78
320035,202210,136,95,41,115140.2,49692,164832.2
320040,202210,507,252,255,306642.17,309066.88,615709.05
320050,202210,124,84,40,101812.07,49692.91,151504.98
320060,202210,1930,899,1031,1089607.09,1250799.29,2340406.38
320070,202210,100,63,37,76356.86,44844,121200.86
320080,202210,851,481,370,582988.94,448443.89,1031432.83
320090,202210,1354,870,484,1054462.06,587831.12,1642293.18
320100,202210,358,207,151,250886.68,183014,433900.68
320110,202210,136,82,54,99392,66660.2,166052.2
320115,202210,115,98,17,118776.61,20604,139380.61
320120,202210,3883,2004,1879,2428894.54,2281019.55,4709914.09
320130,202210,8440,3633,4807,4404484.53,5829815.35,10234299.88
320140,202210,509,321,188,389063.92,227861.65,616925.57
320150,202210,2222,1215,1007,1473821.21,1222919.8,2696741.01
320160,202210,660,283,377,344214.56,458138.77,802353.33
320170,202210,117,91,26,110293.07,31512.02,141805.09
320180,202210,60,35,25,42421.33,30300.12,72721.45
320190,202210,259,149,110,180591.97,133320,313911.97
320200,202210,63,52,11,63024.88,13332,76356.88
320210,202210,948,516,432,625406.7,524803.13,1150209.83
320220,202210,307,105,202,127260.8,246036.2,373297.0
320225,202210,79,65,14,78780.39,16968.74,95749.13
320230,202210,719,454,265,550266.99,322397.21,872664.20
320240,202210,3718,1677,2041,2032559.16,2477359.14,4509918.30
320245,202210,533,361,172,437540.22,209681.62,647221.84
320250,202210,241,110,131,133321.91,158774.47,292096.38
320255,202210,124,92,32,111505.44,38784.22,150289.66
320260,202210,282,153,129,185437.13,156349.35,341786.48
320265,202210,152,116,36,140592.42,43632.11,184224.53
320270,202210,162,122,40,147867.06,48481.15,196348.21
320280,202210,1340,743,597,901742.19,723577.22,1625319.41
320290,202210,66,50,16,60600,19392,79992
320300,202210,647,438,209,530872.45,254524.21,785396.66
320305,202210,793,427,366,517541.97,443604.39,961146.36
320310,202210,203,120,83,146654.54,100596.2,247250.74
320313,202210,362,163,199,197560.79,242400.4,439961.19
320316,202210,114,81,33,98173.27,39996,138169.27
320320,202210,3625,1592,2033,1930749.82,2468872.77,4399622.59
320330,202210,289,210,79,254520.15,95748,350268.15
320332,202210,801,474,327,575719.71,396336.36,972056.07
320334,202210,299,164,135,198769.31,163621.3,362390.61
320335,202210,148,97,51,117567.18,61813.53,179380.71
320340,202210,606,430,176,521176.62,213318.31,734494.93
320350,202210,1124,454,670,551471.04,814477.97,1365949.01
320360,202210,173,80,93,96960.08,113928,210888.08
320370,202210,240,175,65,212104.79,78780.6,290885.39
320380,202210,329,232,97,281187.17,117564.89,398752.06
320390,202210,1184,694,490,842351.12,596308.24,1438659.36
320400,202210,326,226,100,273916.97,121200.06,395117.03
320405,202210,1017,415,602,504207.65,729638.98,1233846.63
320410,202210,980,480,500,581769.59,607218.91,1188988.50
320420,202210,592,265,327,321189.17,396334.67,717523.84
320425,202210,215,113,102,136956.39,124836.8,261793.19
320430,202210,412,213,199,258162.98,241192.83,499355.81
320435,202210,176,119,57,144229.86,69086.39,213316.25
320440,202210,215,117,98,141806.35,118780.47,260586.82
320450,202210,142,75,67,90901.03,82417.06,173318.09
320455,202210,239,185,54,224222.02,65448.51,289670.53
320460,202210,316,189,127,229070.36,153924.1,382994.46
320465,202210,120,81,39,98174.99,47268.65,145443.64
320470,202210,775,459,316,556318.56,384215.13,940533.69
320480,202210,221,149,72,180591.02,87264.8,267855.82
320490,202210,3443,1626,1817,1970754.51,2202250.75,4173005.26
320495,202210,126,71,55,86052.1,66660.6,152712.7
320500,202210,10661,5123,5538,6210440.51,6727916.75,12938357.26
320501,202210,575,289,286,350276.1,346642.44,696918.54
320503,202210,323,227,96,276340.61,116353.26,392693.87
320506,202210,278,190,88,230281.84,106656.38,336938.22
320510,202210,1317,556,761,673882.52,925982.44,1599864.96
320515,202210,87,67,20,81204.79,24240,105444.79
320517,202210,230,162,68,196347.94,83628.19,279976.13
320520,202210,8300,3433,4867,4165725.24,5903750.69,10069475.93
320530,202210,7344,3489,3855,4237203.88,4674746.6,8911950.48
330010,202210,3695,1794,1901,2176804.85,2306464.3,4483269.15
330015,202210,210,88,122,106656.74,147864.56,254521.30
330020,202210,4254,1610,2644,1952561.62,3205767.97,5158329.59
330022,202210,278,134,144,162410.33,174529.29,336939.62
330023,202210,867,243,624,295730.13,756298.84,1052028.97
330025,202210,849,151,698,183012.48,849622.52,1032635.00
330030,202210,1972,1206,766,1464129.87,930828.01,2394957.88
330040,202210,2809,1404,1405,1705311.19,1705307.17,3410618.36
330045,202210,10891,3319,7572,4028768.56,9187074.19,13215842.75
330050,202210,934,574,360,695695.85,436325.27,1132021.12
330060,202210,1245,720,525,875084.96,637519.97,1512604.93
330070,202210,4605,1536,3069,1861675.53,3720885.73,5582561.26
330080,202210,1722,746,976,904170.05,1184141.63,2088311.68
330090,202210,408,224,184,271491.57,223009.37,494500.94
330093,202210,236,98,138,118777,167256,286033
330095,202210,70,37,33,44844.96,39996,84840.96
330100,202210,11601,5695,5906,6904882.92,7165438.04,14070320.96
330110,202210,486,221,265,269068.14,321181.85,590249.99
330115,202210,547,267,280,323608.37,339361.87,662970.24
330120,202210,415,218,197,264217.71,238765.49,502983.20
330130,202210,1712,439,1273,534503.32,1546541.04,2081044.36
330140,202210,712,357,355,432687.58,431472.7,864160.28
330150,202210,557,331,226,401177.71,273914.08,675091.79
330160,202210,215,124,91,150289.23,110292.42,260581.65
330170,202210,28964,10027,18937,12161499.96,22966561.7,35128061.66
330180,202210,261,143,118,173317.4,144230.8,317548.2
330185,202210,1246,463,783,561162.24,949009.1,1510171.34
330187,202210,599,185,414,225435.51,501774.46,727209.97
330190,202210,6747,2500,4247,3034897.83,5153477.72,8188375.55
330200,202210,4961,1605,3356,1946512.9,4069955.83,6016468.73
330205,202210,498,279,219,338153.36,265431.59,603584.95
330210,202210,970,576,394,699342.19,478742.91,1178085.10
330220,202210,2972,1722,1250,2087104.1,1515022.6,3602126.7
330225,202210,630,332,298,402389.6,361177.64,763567.24
330227,202210,2606,820,1786,993856.59,2164657.77,3158514.36
330230,202210,264,141,123,170893.26,149076.48,319969.74
330240,202210,4636,2113,2523,2562221.05,3061562.13,5623783.18
330245,202210,174,83,91,100597.88,110292.58,210890.46
330250,202210,7199,3405,3794,4129381.87,4605664.23,8735046.10
330260,202210,815,220,595,266642.41,722354.36,988996.77
330270,202210,4231,1354,2877,1642286.63,3489395.62,5131682.25
330280,202210,488,291,197,352704.49,238767.57,591472.06
330285,202210,6959,2197,4762,2665263.16,5786206.14,8451469.30
330290,202210,807,276,531,334517.96,643575.71,978093.67
330300,202210,777,471,306,571605.26,370878.36,942483.62
330310,202210,496,280,216,341788.27,261794.28,603582.55
330320,202210,8367,2837,5530,3442172.98,6710945.05,10153118.03
330330,202210,10201,3686,6515,4472358.2,7903546.88,12375905.08
330340,202210,2938,1610,1328,1952549.87,1611976.51,3564526.38
330350,202210,21378,7700,13678,9336278.86,16601050.77,25937329.63
330360,202210,2112,975,1137,1184161.69,1380501.16,2564662.85
330370,202210,1046,535,511,648431.87,619339.4,1267771.27
330380,202210,1053,414,639,501773.02,774472.34,1276245.36
330385,202210,687,338,349,409661.82,424204.53,833866.35
330390,202210,6562,3353,3209,4066326.63,3891774.67,7958101.30
330395,202210,423,271,152,328458.34,184230.15,512688.49
330400,202210,758,379,379,459357.63,459351.89,918709.52
330410,202210,548,396,152,479962.13,184227.12,664189.25
330411,202210,388,211,177,255734.29,214524.2,470258.49
330412,202210,236,105,131,127261.41,158772.88,286034.29
330414,202210,5798,2252,3546,2729500.61,4302638.64,7032139.25
330415,202210,653,273,380,332098.42,460562.55,792660.97
330420,202210,2631,1366,1265,1656830.32,1533191.55,3190021.87
330430,202210,1921,814,1107,987795.02,1344121.5,2331916.52
330440,202210,412,196,216,237553.5,261793.52,499347.02
330450,202210,127,54,73,65448.68,88476,153924.68
330452,202210,2549,1028,1521,1248389.92,1845898.52,3094288.44
330455,202210,133548,45548,88000,55263681.21,106783839.16,162047520.37
330460,202210,277,126,151,152712.39,184224.73,336937.12
330470,202210,1325,697,628,844774.97,761147.86,1605922.83
330475,202210,1963,586,1377,710241.85,1671358.32,2381600.17
330480,202210,838,451,387,547832.95,469051.06,1016884.01
330490,202210,17626,5320,12306,6450493.71,14929602.29,21380096.00
330500,202210,1654,700,954,848408.9,1157471.83,2005880.73
330510,202210,11862,4073,7789,4945058.64,9456153.66,14401212.30
330513,202210,104,53,51,64236,61812,126048
330515,202210,742,316,426,382996.4,516318.66,899315.06
330520,202210,2681,899,1782,1090820.04,2165871.98,3256692.02
330530,202210,193,110,83,133322.52,101808.89,235131.41
330540,202210,359,187,172,227857.45,208465.99,436323.44
330550,202210,3038,992,2046,1202320.38,2480994.56,3683314.94
330555,202210,1087,395,692,478744.5,838709.32,1317453.82
330560,202210,819,277,542,335726.42,656910.6,992637.02
330570,202210,330,227,103,275124.24,124836.43,399960.67
330575,202210,924,335,589,406028.67,715087.96,1121116.63
330580,202210,3606,1865,1741,2261618.09,2111328.79,4372946.88
330590,202210,267,139,128,168469.78,155137.46,323607.24
330600,202210,1458,853,605,1035061.93,734482.08,1769544.01
330610,202210,1726,878,848,1064147.33,1027783.94,2091931.27
330615,202210,232,183,49,221797.85,59389.75,281187.60
330620,202210,1091,431,660,523595.84,799929.48,1323525.32
330630,202210,4892,2872,2020,3483357.24,2451909.47,5935266.71
350010,202210,629,416,213,504206.27,258158.75,762365.02
350020,202210,60,21,39,25453,47268,72721
350030,202210,585,353,232,427855.14,282401.72,710256.86
350040,202210,116,47,69,56968.99,84841.19,141810.18
350050,202210,377,183,194,223010.97,235131.01,458141.98
350055,202210,134,58,76,70296.79,92112.2,162408.99
350060,202210,83,34,49,41208.65,59388.2,100596.85
350070,202210,828,460,368,558751.86,446027.46,1004779.32
350075,202210,80,49,31,59389.42,37572.2,96961.62
350080,202210,59,27,32,32724.09,38784.27,71508.36
350090,202210,82,45,37,54542.16,44844,99386.16
350100,202210,289,180,109,218162.02,132108.37,350270.39
350110,202210,45,29,16,35148.93,19392,54540.93
350115,202210,185,92,93,111504.8,112716.29,224221.09
350120,202210,110,69,41,83630.93,49692.8,133323.73
350130,202210,428,183,245,221802.8,296946.98,518749.78
350140,202210,37,23,14,27876.44,16968.8,44845.24
350150,202210,73,51,22,61812.11,26664.8,88476.91
350160,202210,2481,973,1508,1180506.58,1832551.79,3013058.37
350170,202210,427,248,179,300582.26,218163.53,518745.79
350180,202210,167,93,74,112720.33,89688.81,202409.14
350190,202210,1039,554,485,672679.89,589032.86,1261712.75
350200,202210,59,25,34,30301.04,41208,71509.04
350210,202210,1365,731,634,885998.69,769638.12,1655636.81
350220,202210,651,523,128,635106.02,155137.5,790243.52
350230,202210,66,40,26,48480.84,31512.1,79992.94
350240,202210,59,37,22,44844.4,26665.22,71509.62
350250,202210,1150,517,633,626620.08,768416.06,1395036.14
350260,202210,104,76,28,92113.26,33936,126049.26
350270,202210,990,660,330,799925.98,401175.34,1201101.32
350275,202210,344,127,217,153927.03,263008.74,416935.77
350280,202210,4580,2181,2399,2645859.56,2911238.76,5557098.32
350290,202210,488,208,280,252098.77,339362.25,591461.02
350300,202210,52,27,25,32727.68,30300.9,63028.58
350310,202210,79,45,34,54540.97,41208.78,95749.75
350315,202210,73,32,41,38784,49692,88476
350320,202210,3541,1644,1897,1995002.81,2299184.49,4294187.30
350330,202210,1724,856,868,1039913.51,1055654.17,2095567.68
350335,202210,20,12,8,14544,9696,24240
350340,202210,126,51,75,61812.7,90902.81,152715.51
350350,202210,99,47,52,56964,63024,119988
350360,202210,105,68,37,82418.2,44844.18,127262.38
350370,202210,88,49,39,59390.8,47268.48,106659.28
350380,202210,870,369,501,447234.25,607217.71,1054451.96
350390,202210,1851,686,1165,831446.09,1414417.38,2245863.47
350395,202210,20,16,4,19392.52,4848,24240.52
350400,202210,1827,866,961,1050816.9,1164733.48,2215550.38
350410,202210,3219,1314,1905,1593804.22,2310090.61,3903894.83
350420,202210,295,175,120,212104,145441.09,357545.09
350430,202210,100,50,50,60601.51,60602.72,121204.23
350440,202210,145,100,45,121205.35,54540.4,175745.75
350450,202210,1817,992,825,1202336.01,999900.93,2202236.94
350460,202210,420,139,281,168470.98,340583.16,509054.14
350470,202210,19,12,7,14544,8484,23028
350480,202210,200,104,96,126053.01,116352.8,242405.81
350490,202210,249,114,135,138169.21,164832.04,303001.25
350500,202210,58,21,37,25452,44844,70296
350510,202210,152,89,63,107870.99,76356.01,184227.00
350520,202210,454,243,211,294526.66,255738.66,550265.32
350530,202210,459,216,243,261800.07,294527.05,556327.12
350535,202210,98,64,34,77568.59,41208.89,118777.48
350540,202210,370,196,174,237555.28,212104.54,449659.82
350550,202210,2877,1597,1280,1935614.27,1552578.42,3488192.69
350560,202210,611,411,200,498139.16,242402.9,740542.06
350570,202210,4874,1991,2883,2414336.9,3496646.97,5910983.87
350580,202210,393,185,208,224222.66,252099.7,476322.36
350590,202210,1029,558,471,676307.8,570984.77,1247292.57
350600,202210,6685,3067,3618,3719731.27,4387468.45,8107199.72
350610,202210,1586,815,771,987796.28,934457.49,1922253.77
350620,202210,25,15,10,18180,12120,30300
350630,202210,267,132,135,161198.99,163621.58,324820.57
350635,202210,1292,531,761,644798.48,922346.85,1567145.33
350640,202210,123,89,34,107870.3,41208.2,149078.5
350650,202210,1960,1287,673,1562299.28,815677.11,2377976.39
350660,202210,823,321,502,389056.13,608428.59,997484.72
350670,202210,299,147,152,178164,184224.6,362388.6
350680,202210,167,82,85,99386.92,103021.32,202408.24
350690,202210,210,91,119,110292.1,144228,254520.1
350700,202210,967,450,517,545408.49,626615.13,1172023.62
350710,202210,428,160,268,193923.83,324820.73,518744.56
350715,202210,56,46,10,55752.51,13332,69084.51
350720,202210,16,11,5,13332.28,6060,19392.28
350730,202210,42,26,16,31512,19392,50904
350740,202210,255,140,115,169682.75,139381.85,309064.60
350745,202210,29,13,16,15756.8,19392.8,35149.6
350750,202210,2563,1484,1079,1801079.38,1308972.12,3110051.50
350760,202210,4153,1738,2415,2108917.39,2933060.32,5041977.71
350770,202210,57,36,21,43632.2,25452,69084.2
350775,202210,54,40,14,48482.75,16968.84,65451.59
350780,202210,473,236,237,286046.47,287246.03,573292.50
350790,202210,372,155,217,187861.64,263008.65,450870.29
350800,202210,550,328,222,397538.97,269064.31,666603.28
350810,202210,530,404,126,490881.31,152712.95,643594.26
350820,202210,101,57,44,69084.74,53328,122412.74
350830,202210,77,40,37,48480.77,44844,93324.77
350840,202210,843,327,516,396331.85,625508.93,1021840.78
350850,202210,1954,1009,945,1222928.17,1145345.12,2368273.29
350860,202210,696,358,338,435118.95,409665.14,844784.09
350870,202210,471,310,161,375724.61,195132.2,570856.81
350880,202210,280,156,124,189073.93,150291.38,339365.31
350890,202210,39,25,14,30300,16968.6,47268.6
350900,202210,1726,530,1196,642372.71,1453211,2095583.71
350910,202210,25,13,12,15756,14544,30300
350920,202210,820,417,403,505408.91,488437.51,993846.42
350925,202210,1213,613,600,742975.85,727210.43,1470186.28
350930,202210,123,71,52,87265.32,63024,150289.32
350940,202210,763,393,370,477547.8,448454.61,926002.41
350945,202210,118,82,36,100597.51,43633.02,144230.53
350950,202210,18628,8515,10113,10326428.42,12271584.82,22598013.24
350960,202210,1768,709,1059,861741.03,1284733.79,2146474.82
350970,202210,1137,548,589,666487.26,717519.86,1384007.12
350980,202210,96,65,31,78781.27,37572.2,116353.47
350990,202210,415,147,268,178165.58,324818.24,502983.82
350995,202210,44,19,25,23029.18,30301.48,53330.66
351000,202210,630,401,229,487239.07,277555.03,764794.10
351010,202210,51,34,17,41209.42,20604,61813.42
351015,202210,47,29,18,35149.97,21816,56965.97
351020,202210,1542,918,624,1112629.63,756295.79,1868925.42
351030,202210,356,208,148,252096.43,179376.36,431472.79
351040,202210,1064,581,483,704181.52,587824.07,1292005.59
351050,202210,3841,1736,2105,2104083.75,2552493.41,4656577.16
351060,202210,6379,2287,4092,2775529.42,4965588.31,7741117.73
351070,202210,430,263,167,318765.27,202409.13,521174.40
351080,202210,760,559,201,677523.13,244826.97,922350.10
351090,202210,49,25,24,30300.9,29088.41,59389.31
351100,202210,435,232,203,281196.09,246044.91,527241.00
351110,202210,2172,990,1182,1201115.18,1435011.37,2636126.55
351120,202210,69,32,37,38784.83,44844,83628.83
351130,202210,198,64,134,77570.34,162411.81,239982.15
351140,202210,332,198,134,239981.35,162411.56,402392.91
351150,202210,523,263,260,318760.86,315123.1,633883.96
351160,202210,322,188,134,227859.94,162408.72,390268.66
351170,202210,238,134,104,162409.02,127260,289669.02
351190,202210,93,57,36,69085,43632,112717
351200,202210,351,228,123,276339.54,150290.48,426630.02
351210,202210,131,66,65,79993.37,78780,158773.37
351220,202210,607,342,265,414511.89,321181.78,735693.67
351230,202210,312,203,109,246042.12,132108.39,378150.51
351240,202210,247,121,126,146653.54,152714.07,299367.61
351250,202210,85,56,29,67875.58,35148.1,103023.68
351260,202210,146,102,44,123624.2,53328,176952.2
351270,202210,47,22,25,26664.85,30300,56964.85
351280,202210,1081,513,568,621769.28,689634.88,1311404.16
351290,202210,255,115,140,139381.65,169680.1,309061.75
351300,202210,4211,1754,2457,2127100,2979132.25,5106232.25
351310,202210,756,364,392,441185.86,476327.29,917513.15
351320,202210,119,67,52,81205.99,63024.6,144230.59
351330,202210,44,27,17,32724,20604,53328
351340,202210,1482,792,690,959924.16,837495.57,1797419.73
351350,202210,2497,1445,1052,1753797.38,1276244.67,3030042.05
351360,202210,838,384,454,469048.93,550252.7,1019301.63
351370,202210,453,219,234,265433.74,284820.8,550254.54
351380,202210,9237,3976,5261,4822627.09,6381214.87,11203841.96
351385,202210,21,14,7,16968.28,8484,25452.28
351390,202210,289,208,81,253310.7,98172.2,351482.9
351400,202210,62,41,21,49692,25452,75144
351410,202210,486,287,199,347850.91,241190.75,589041.66
351420,202210,74,53,21,64236.04,25452,89688.04
351430,202210,77,40,37,48480.19,44844.2,93324.39
351440,202210,833,539,294,653288.68,356333.89,1009622.57
351450,202210,288,139,149,168472.64,180591.06,349063.70
351460,202210,145,61,84,75146.99,101809.85,176956.84
351470,202210,147,77,70,93326.02,84840,178166.02
351480,202210,490,283,207,344213.36,250884.2,595097.56
351490,202210,313,122,191,147864.5,231492.55,379357.05
351492,202210,28,17,11,20604,13332,33936
351495,202210,26,17,9,20604,10908,31512
351500,202210,3604,1432,2172,1739238.5,2633694.58,4372933.08
351510,202210,2232,805,1427,975677.14,1730755.18,2706432.32
351512,202210,13,9,4,10908,4848,15756
351515,202210,214,123,91,149078.59,110292,259370.59
351518,202210,705,418,287,507844.91,347858.77,855703.68
351519,202210,89,53,36,64236.41,43632,107868.41
351520,202210,171,106,65,128473.94,78802.75,207276.69
351530,202210,26,12,14,14544,16968,31512
351535,202210,135,80,55,98175.77,66661.09,164836.86
351540,202210,487,318,169,386638.97,204831.51,591470.48
351550,202210,1613,945,668,1145366.03,809620.97,1954987.00
351560,202210,80,46,34,55753.34,41208,96961.34
351565,202210,16,8,8,9696.32,9696,19392.32
351570,202210,2922,1318,1604,1598670.7,1947702.59,3546373.29
351580,202210,36,34,2,41208.8,2424,43632.8
351590,202210,70,43,27,52119.15,32724.16,84843.31
351600,202210,183,133,50,161201.77,60600,221801.77
351610,202210,53,24,29,29088.18,36360,65448.18
351620,202210,6187,3268,2919,3964523.74,3545127.91,7509651.65
351630,202210,3478,1632,1846,1980443.54,2239799.58,4220243.12
351640,202210,2577,1113,1464,1351399.8,1775594.81,3126994.61
351650,202210,34,27,7,32724,8484,41208
351660,202210,142,90,52,109080.93,64236,173316.93
351670,202210,782,446,336,540564.35,407237.5,947801.85
351680,202210,82,61,21,73932,25452,99384
351685,202210,13,9,4,10908,4848,15756
351690,202210,306,195,111,236345.96,134534.4,370880.36
351700,202210,191,128,63,156610.03,76356.2,232966.23
351710,202210,67,42,25,50904.9,30300,81204.9
351720,202210,123,69,54,83629.12,65448,149077.12
351730,202210,116,78,38,94536.44,46056,140592.44
351740,202210,832,522,310,632689.79,376935.91,1009625.70
351750,202210,389,155,234,187861.56,283608.4,471469.96
351760,202210,724,559,165,678629,199980.29,878609.29
351770,202210,301,242,59,293312.59,71508.74,364821.33
351780,202210,152,93,59,112717.12,71508,184225.12
351790,202210,278,139,139,168469.35,168469.82,336939.17
351800,202210,45,28,17,33936.18,20604,54540.18
351810,202210,124,77,47,94538.88,56965.72,151504.60
351820,202210,784,551,233,670271.42,282401.06,952672.48
351830,202210,683,217,466,263006.4,564794.61,827801.01
351840,202210,2363,1049,1314,1271409.92,1593786.27,2865196.19
351850,202210,269,187,82,226647.41,99384,326031.41
351860,202210,609,404,205,489663.08,250886.25,740549.33
351870,202210,6072,2715,3357,3290644.71,4073613.68,7364258.39
351880,202210,23098,8736,14362,10590609.32,17430989.01,28021598.33
351885,202210,101,55,46,66662.43,55753.53,122415.96
351890,202210,73,50,23,60600.4,27876,88476.4
351900,202210,250,131,119,158774.51,144228.38,303002.89
351905,202210,101,47,54,56964.8,65448,122412.8
351907,202210,3900,1563,2337,1895598.71,2834889.93,4730488.64
351910,202210,156,63,93,76356.4,112716.4,189072.8
351920,202210,117,63,54,76356.2,65448,141804.2
351925,202210,91,55,36,67873.81,43633.17,111506.98
351930,202210,464,289,175,350277.85,212105.3,562383.15
351940,202210,245,99,146,119989.87,176952.92,296942.79
351950,202210,146,78,68,94536.82,82418.42,176955.24
351960,202210,994,477,517,581773.69,630256.24,1212029.93
351970,202210,2213,1043,1170,1264127.7,1419267.33,2683395.03
351980,202210,152,62,90,75147.73,109081.75,184229.48
351990,202210,260,162,98,196346.64,118777.25,315123.89
352000,202210,325,203,122,246046.55,147866.35,393912.90
352010,202210,442,283,159,343090.55,195141.53,538232.08
352020,202210,209,71,138,86052,167256,253308
352030,202210,1220,558,662,677524.83,802359.61,1479884.44
352040,202210,693,264,429,319971.88,519953.13,839925.01
352042,202210,350,85,265,103022.94,322396.78,425419.72
352044,202210,385,218,167,264222.14,202407.28,466629.42
352050,202210,3409,1232,2177,1495631.93,2640958.18,4136590.11
352060,202210,104,62,42,75144.31,50904.99,126049.30
352070,202210,96,67,29,81209.21,35148,116357.21
352080,202210,67,41,26,49694.61,31512.48,81207.09
352090,202210,183,115,68,139381.11,82416,221797.11
352100,202210,325,157,168,191498.06,204830.33,396328.39
352110,202210,118,34,84,41209.16,101808,143017.16
352115,202210,66,25,41,30300,49692.2,79992.2
352120,202210,71,48,23,58176,27876,86052
352130,202210,219,161,58,195138.67,70296.57,265435.24
352140,202210,195,93,102,113928.9,124836.57,238765.47
352150,202210,135,71,64,86053.54,77569.96,163623.50
352160,202210,146,92,54,111506.59,65448.04,176954.63
352170,202210,422,280,142,340574.45,172104.08,512678.53
352180,202210,720,435,285,527232.19,345426.39,872658.58
352190,202210,253,107,146,129684.41,178166.07,307850.48
352200,202210,29,11,18,13332,21816.1,35148.1
352210,202210,4721,1856,2865,2251955.34,3473618.3,5725573.64
352215,202210,75,41,34,49692,42420,92112
352220,202210,6446,2360,4086,2862795.76,4953490.08,7816285.84
352230,202210,3737,2347,1390,2844636.59,1689536.74,4534173.33
352240,202210,2862,1597,1265,1936806.3,1533189.67,3469995.97
352250,202210,3717,1636,2081,1982859.19,2523388.03,4506247.22
352260,202210,1077,566,511,686005.04,619342.65,1305347.69
352265,202210,69,40,29,48480,35148,83628
352270,202210,409,224,185,271495.26,224226.22,495721.48
352280,202210,531,308,223,374514.95,271488,646002.95
352290,202210,176,94,82,113929.51,99385.67,213315.18
352300,202210,101,64,37,77571.73,44844.6,122416.33
352310,202210,7671,3288,4383,3985137.66,5317052.58,9302190.24
352320,202210,1217,623,594,758721.98,721142.31,1479864.29
352330,202210,557,284,273,344211.04,330876.09,675087.13
352340,202210,1419,644,775,782967.33,941733.25,1724700.58
352350,202210,386,207,179,250887.65,216953.03,467840.68
352360,202210,218,97,121,117564.2,146652.2,264216.4
352370,202210,128,78,50,94537.94,60600.36,155138.30
352380,202210,116,83,33,100599.71,39996.16,140595.87
352390,202210,2719,1150,1569,1397455.71,1902847.38,3300303.09
352400,202210,571,245,326,299364.1,395112.71,694476.81
352410,202210,942,613,329,742981.23,398766.66,1141747.89
352420,202210,89,66,23,79992.62,27876,107868.62
352430,202210,1828,794,1034,963565.16,1254441.21,2218006.37
352440,202210,3601,1629,1972,1975591.14,2393713.21,4369304.35
352450,202210,203,157,46,190284.9,55752.32,246037.22
352460,202210,654,321,333,389055.87,404812.24,793868.11
352470,202210,696,258,438,312699.23,532072.39,844771.62
352480,202210,1702,952,750,1155062.93,911435.78,2066498.71
352490,202210,54,21,33,25452.6,39996.1,65448.7
352500,202210,1344,538,806,652067.12,976876.54,1628943.66
352510,202210,743,386,357,467847.85,433900.42,901748.27
352520,202210,898,397,501,481167.59,607228.61,1088396.20
352530,202210,1953,973,980,1181723.81,1190193.28,2371917.09
352540,202210,73,50,23,60600.86,27876,88476.86
352550,202210,218,125,93,151501.16,112716.4,264217.56
352560,202210,54,40,14,48481.39,18180.31,66661.70
352570,202210,784,369,415,447242.16,502994.7,950236.86
352580,202210,56,42,14,50905.63,16968,67873.63
352585,202210,21,6,15,8484.6,18180.95,26665.55
352590,202210,4713,2285,2428,2769474.01,2948823.75,5718297.76
352600,202210,377,258,119,313915.82,144232.83,458148.65
352610,202210,957,420,537,509048.48,650849.46,1159897.94
352620,202210,1177,441,736,534503.71,892040.9,1426544.61
352630,202210,195,72,123,87266.12,149076.54,236342.66
352640,202210,532,338,194,412091.4,235131.94,647223.34
352650,202210,92,65,27,78781.3,32724,111505.3
352660,202210,67,38,29,46056.99,35148,81204.99
352670,202210,1795,945,850,1146579.69,1030202.67,2176782.36
352680,202210,991,586,405,711460.58,492087.14,1203547.72
352690,202210,4858,2093,2765,2540395.13,3352414.89,5892810.02
352700,202210,86,48,38,58176.2,46056,104232.2
352710,202210,1563,795,768,963556.24,930818.7,1894374.94
352720,202210,1630,665,965,808428.31,1169603.6,1978031.91
352725,202210,28,21,7,25452,8484,33936
352730,202210,412,200,212,243616.11,256945.1,500561.21
352740,202210,410,259,151,313917.75,183016.71,496934.46
352750,202210,23,14,9,16968.8,10908.14,27876.94
352760,202210,235,147,88,178165.22,106657.62,284822.84
352770,202210,77,56,21,69086.55,25452.18,94538.73
352780,202210,75,37,38,44844,46056.78,90900.78
352790,202210,25,17,8,20606.05,9696.18,30302.23
352800,202210,245,186,59,225437.65,71508.67,296946.32
352810,202210,164,102,62,123625.71,75144.5,198770.21
352820,202210,48,36,12,43632.7,14544,58176.7
352830,202210,74,49,25,59388.5,30300.01,89688.51
352840,202210,734,323,411,391486.65,499347.05,890833.70
352850,202210,1889,556,1333,675089.91,1615601.93,2290691.84
352860,202210,121,75,46,90901.2,56964.53,147865.73
352870,202210,49,31,18,37573.76,21816.1,59389.86
352880,202210,191,110,81,133323.3,98173.09,231496.39
352885,202210,36,24,12,29088.67,14544,43632.67
352890,202210,56,33,23,39997.24,27876.6,67873.84
352900,202210,4805,2238,2567,2714924.16,3113638.62,5828562.78
352910,202210,38,31,7,37572,8484,46056
352920,202210,653,374,279,453300.82,338155.77,791456.59
352930,202210,1227,570,657,690849.34,796286.65,1487135.99
352940,202210,6516,2437,4079,2954903.82,4949860.53,7904764.35
352950,202210,122,54,68,65448.88,82417.94,147866.82
352960,202210,65,40,25,48480,30300,78780
352965,202210,16,10,6,12120,7272,19392
352970,202210,558,402,156,487238.16,189076.67,676314.83
352980,202210,164,95,69,116357.1,83629.49,199986.59
352990,202210,992,461,531,558747.82,643582.73,1202330.55
353000,202210,61,28,33,33936.8,39996.82,73933.62
353010,202210,528,317,211,384215.12,255737,639952.12
353020,202210,343,223,120,270283.42,145442.04,415725.46
353030,202210,1453,635,818,770850.52,992647.99,1763498.51
353040,202210,90,46,44,55753.47,53329.16,109082.63
353050,202210,1384,893,491,1084774.35,596304.27,1681078.62
353060,202210,9573,4081,5492,4948691.27,6659993.08,11608684.35
353070,202210,2056,1193,863,1445947.24,1046954.15,2492901.39
353080,202210,1350,722,628,875079.2,762349.97,1637429.17
353090,202210,68,36,32,43632.6,38784,82416.6
353100,202210,44,33,11,39998.09,13332.52,53330.61
353110,202210,2341,771,1570,934478.91,1904102.8,2838581.71
353120,202210,143,81,62,98172.2,75144,173316.2
353130,202210,881,416,465,504205.5,563587.75,1067793.25
353140,202210,598,275,323,333308.62,392693.29,726001.91
353150,202210,325,168,157,203619.85,190287.13,393906.98
353160,202210,113,84,29,101810.43,35148.44,136958.87
353170,202210,208,75,133,90901.4,161196.74,252098.14
353180,202210,1268,570,698,690851.12,845985.68,1536836.80
353190,202210,520,364,156,441182.71,189073.53,630256.24
353200,202210,279,136,143,164833.79,173316.83,338150.62
353205,202210,20,13,7,15756,8484,24240
353210,202210,71,42,29,50904.8,35148.56,86053.36
353215,202210,43,23,20,27876.2,24240,52116.2
353220,202210,85,44,41,53328,49692.6,103020.6
353230,202210,158,68,90,82417.17,110292,192709.17
353240,202210,401,172,229,208545.99,277548,486093.99
353250,202210,191,96,95,116354.25,115141.51,231495.76
353260,202210,477,307,170,373304.44,206045.45,579349.89
353270,202210,74,56,18,67873.55,21816,89689.55
353280,202210,122,54,68,65450.77,82420.4,147871.17
353282,202210,129,88,41,106656.65,49692.5,156349.15
353284,202210,30,20,10,24241.46,12120,36361.46
353286,202210,9,4,5,4848.2,6060.6,10908.8
353290,202210,86,48,38,58176,46056,104232
353300,202210,468,234,234,283617.78,283614.73,567232.51
353310,202210,39,32,7,38785.06,8485.4,47270.46
353320,202210,42,24,18,29089.02,21816.6,50905.62
353325,202210,44,25,19,30300.69,23028,53328.69
353330,202210,63,42,21,50904.8,25452.2,76357.0
353340,202210,713,248,465,300581.14,563588.23,864169.37
353350,202210,961,469,492,568438.46,596316.23,1164754.69
353360,202210,110,86,24,104232.89,29088.89,133321.78
353370,202210,109,61,48,73933.02,58176.38,132109.40
353380,202210,29,14,15,16968,18180,35148
353390,202210,1162,539,623,655706.56,756296.64,1412003.20
353400,202210,56,31,25,37572.76,30301.06,67873.82
353410,202210,123,66,57,79992.6,69086.58,149079.18
353420,202210,56,25,31,30300,37572,67872
353430,202210,585,382,203,462997.12,247256.4,710253.52
353440,202210,13051,5507,7544,6680627.6,9155487.14,15836114.74
353450,202210,53,26,27,31512.8,32724.2,64237.0
353460,202210,674,340,334,412096.59,404816.24,816912.83
353470,202210,2343,1115,1228,1351420.81,1490767.62,2842188.43
353475,202210,298,188,110,229073.23,134533.27,363606.50
353480,202210,189,149,40,180590.52,48480,229070.52
353490,202210,231,131,100,158775.15,121200.92,279976.07
353500,202210,215,118,97,143017.77,117565.47,260583.24
353510,202210,82,55,27,66660.7,32724.92,99385.62
353520,202210,246,178,68,216949.84,82416.6,299366.44
353530,202210,496,244,252,295734.17,305428.64,601162.81
353540,202210,423,262,161,317555.09,195134.27,512689.36
353550,202210,778,489,289,592689.63,350278.68,942968.31
353560,202210,567,229,338,277549,409657.75,687206.75
353570,202210,66,45,21,54541.71,25452,79993.71
353580,202210,355,222,133,269069.58,161196,430265.58
353590,202210,92,66,26,79992.2,31512,111504.2
353600,202210,293,166,127,201196.59,153924.46,355121.05
353610,202210,136,75,61,90902.33,73932,164834.33
353620,202210,696,346,350,420570.25,425416.6,845986.85
353625,202210,60,31,29,37573.61,35148.76,72722.37
353630,202210,223,160,63,193925.26,76357.69,270282.95
353640,202210,128,81,47,98173.35,56964.95,155138.30
353650,202210,1075,417,658,505409.56,797502.73,1302912.29
353657,202210,24,18,6,21816,7272,29088
353660,202210,303,155,148,187864.66,179377.24,367241.90
353670,202210,749,421,328,511476.02,397543.14,909019.16
353680,202210,142,89,53,107868.93,64236,172104.93
353690,202210,45,30,15,36360,18180.19,54540.19
353700,202210,295,198,97,239980.52,117565.46,357545.98
353710,202210,541,261,280,316338.33,340573.64,656911.97
353715,202210,41,24,17,29088,20604,49692
353720,202210,335,150,185,184229.54,224222.42,408451.96
353730,202210,1206,712,494,865384.05,599943.12,1465327.17
353740,202210,617,339,278,412091.67,336940.57,749032.24
353750,202210,85,45,40,54541.49,48480,103021.49
353760,202210,3454,1310,2144,1588974.63,2598564.42,4187539.05
353770,202210,78,61,17,73933.24,20604.2,94537.44
353780,202210,1433,643,790,780537.27,958698.03,1739235.30
353790,202210,511,303,208,367245.51,253312.67,620558.18
353800,202210,3876,1777,2099,2153796.76,2546417.24,4700214.00
353810,202210,248,121,127,146655.77,153924.77,300580.54
353820,202210,261,107,154,129684.85,186648.81,316333.66
353830,202210,66,55,11,66662.27,13332.9,79995.17
353850,202210,218,97,121,117565.13,146653.49,264218.62
353860,202210,552,244,308,298155.31,373298.97,671454.28
353870,202210,6056,3068,2988,3719711.37,3623904.29,7343615.66
353880,202210,752,480,272,581778.46,329668.56,911447.02
353890,202210,577,322,255,390271.22,309065.27,699336.49
353900,202210,138,73,65,88476.94,78781.63,167258.57
353910,202210,212,79,133,95749.27,161196.17,256945.44
353920,202210,466,240,226,292097.45,275127.51,567224.96
353930,202210,1070,625,445,757509.36,541766.96,1299276.32
353940,202210,223,106,117,129684.65,141805.38,271490.03
353950,202210,521,332,189,402394.2,229069.88,631464.08
353960,202210,77,61,16,73932.87,19392,93324.87
353970,202210,42,28,14,33937,16969.29,50906.29
353980,202210,2035,888,1147,1077488.4,1392608.53,2470096.93
353990,202210,86,50,36,61813.59,43632.06,105445.65
354000,202210,404,183,221,221801.11,267855.89,489657.00
354010,202210,94,54,40,65449.64,48480.69,113930.33
354020,202210,542,333,209,403606.71,254524.21,658130.92
354025,202210,38,32,6,38784.68,7272,46056.68
354030,202210,48,25,23,30300.3,27876.15,58176.45
354040,202210,100,73,27,88478.04,33936,122414.04
354050,202210,167,88,79,106657.84,95748.96,202406.80
354060,202210,841,385,456,467837.27,553885.01,1021722.28
354070,202210,946,527,419,638738.42,509047.41,1147785.83
354075,202210,190,89,101,107869.88,122413.74,230283.62
354080,202210,315,141,174,170896.12,212100.98,382997.10
354085,202210,24,15,9,18181.41,10908,29089.41
354090,202210,288,170,118,205941.46,143017.29,348958.75
354100,202210,6405,2577,3828,3124603.99,4645665.88,7770269.87
354105,202210,100,50,50,60600.8,60600,121200.8
354110,202210,39,19,20,23028,24240.09,47268.09
354120,202210,158,98,60,118777.08,72720.18,191497.26
354130,202210,789,476,313,578142.65,381784.43,959927.08
354140,202210,3476,1545,1931,1873796.34,2342813.12,4216609.46
354150,202210,674,383,291,464204.37,352698.72,816903.09
354160,202210,697,435,262,527239.85,317551.7,844791.55
354165,202210,10,7,3,9696.49,3636,13332.49
354170,202210,188,123,65,149080.16,78780.8,227860.96
354180,202210,52,29,23,35148.2,27876.12,63024.32
354190,202210,215,83,132,100597.6,159984.72,260582.32
354200,202210,116,56,60,67872.36,72721.8,140594.16
354210,202210,75,30,45,36360,54540,90900
354220,202210,620,382,238,463001.45,288461.96,751463.41
354230,202210,171,75,96,90901.32,116353.49,207254.81
354240,202210,335,204,131,248468.36,158772.91,407241.27
354250,202210,79,46,33,55752.2,41208,96960.2
354260,202210,2242,1028,1214,1247175.7,1472604.94,2719780.64
354270,202210,91,64,27,77568,32724,110292
354280,202210,60,31,29,37572,35148,72720
354290,202210,153,104,49,126050.84,59388.1,185438.94
354300,202210,340,238,102,288461.1,123624.42,412085.52
354310,202210,92,64,28,77571.38,33936,111507.38
354320,202210,233,113,120,136958.7,145440,282398.7
354323,202210,7,5,2,6060,2424,8484
354325,202210,135,69,66,83629.39,79992.8,163622.19
354330,202210,2547,848,1699,1028832.72,2071315.64,3100148.36
354340,202210,11152,5033,6119,6104739.25,7425983.22,13530722.47
354350,202210,145,98,47,118777.05,56964,175741.05
354360,202210,79,46,33,55754.72,39997.67,95752.39
354370,202210,233,119,114,145441.92,139383.8,284825.72
354380,202210,173,100,73,121202.44,88476,209678.44
354390,202210,2873,1012,1861,1227774.99,2257974.19,3485749.18
354400,202210,344,188,156,227858.58,189072.79,416931.37
354410,202210,720,310,410,376947.33,496927.04,873874.37
354420,202210,286,194,92,235134.99,112717.08,347852.07
354425,202210,347,194,153,235187.31,185436.81,420624.12
354430,202210,183,96,87,116353.35,105444.49,221797.84
354440,202210,31,25,6,30301.32,7272,37573.32
354450,202210,59,37,22,44844.26,26664,71508.26
354460,202210,100,58,42,70300.35,50905.24,121205.59
354470,202210,26,13,13,15757.23,15757.11,31514.34
354480,202210,121,66,55,79993,67872.75,147865.75
354490,202210,131,73,58,88479.21,70297.52,158776.73
354500,202210,417,179,238,216949.33,288456.93,505406.26
354510,202210,87,60,27,72720.58,32724.9,105445.48
354515,202210,51,17,34,20605.42,41208.1,61813.52
354520,202210,1702,719,983,874904.58,1197456.65,2072361.23
354530,202210,890,430,460,521166.66,558736.47,1079903.13
354540,202210,267,128,139,155139.56,168468.77,323608.33
354550,202210,46,25,21,30300.71,25452,55752.71
354560,202210,168,91,77,110293.11,93324,203617.11
354570,202210,135,94,41,113928,49692,163620
354580,202210,1946,911,1035,1104150.01,1256850.28,2361000.29
354600,202210,291,134,157,162410.73,190284.73,352695.46
354610,202210,65,54,11,65448.99,13332,78780.99
354620,202210,78,21,57,25452,69084.7,94536.7
354625,202210,13,8,5,9697.14,6060,15757.14
354630,202210,359,234,125,283616.54,151503.89,435120.43
354640,202210,871,510,361,618355.41,438749.34,1057104.75
354650,202210,70,42,28,50904.74,33936,84840.74
354660,202210,847,612,235,745409.01,284823.26,1030232.27
354670,202210,231,90,141,109080.2,170892.2,279972.4
354680,202210,1397,488,909,591465.27,1101717.58,1693182.85
354690,202210,84,50,34,60601.92,41208.79,101810.71
354700,202210,79,56,23,67872,27876,95748
354710,202210,49,36,13,43632.36,15756,59388.36
354720,202210,20,18,2,21816.2,2424,24240.2
354730,202210,1896,770,1126,933253.06,1364729.17,2297982.23
354740,202210,75,51,24,61812.2,29088,90900.2
354750,202210,421,233,188,282399.75,227858.16,510257.91
354760,202210,536,328,208,397556.61,252101.03,649657.64
354765,202210,6,2,4,2424,4848,7272
354770,202210,368,234,134,283616.42,162410.21,446026.63
354780,202210,8948,3260,5688,3951167.09,6896314.46,10847481.55
354790,202210,87,50,37,60600.16,44844.11,105444.27
354800,202210,442,236,206,287199.03,249676.63,536875.66
354805,202210,76,38,38,46056.69,46057.07,92113.76
354810,202210,103,54,49,65448,59388,124836
354820,202210,225,92,133,111506.08,161199.53,272705.61
354830,202210,43,22,21,26664,25452,52116
354840,202210,60,38,22,46056.24,26664,72720.24
354850,202210,4917,2147,2770,2604637.92,3363333.12,5967971.04
354860,202210,350,157,193,190284.17,235129.8,425413.97
354870,202210,12839,5504,7335,6674592.34,8911889.76,15586482.10
354880,202210,2820,1010,1810,1226561.73,2197431.44,3423993.17
354890,202210,3153,1641,1512,1990141.53,1834981.49,3825123.02
354900,202210,65,47,18,56964.09,21816.19,78780.28
354910,202210,1355,687,668,832659.45,809617.26,1642276.71
354920,202210,39,32,7,38784,8484,47268
354925,202210,24,13,11,15756,13332,29088
354930,202210,33,28,5,33936.21,6060,39996.21
354940,202210,792,545,247,660560.61,299371.6,959932.21
354950,202210,212,130,82,157563.44,99385.28,256948.72
354960,202210,132,48,84,58177.63,101808.59,159986.22
354970,202210,1216,843,373,1022948.83,453289.54,1476238.37
354980,202210,9982,3576,6406,4336635.42,7771397.21,12108032.63
354990,202210,11012,4801,6211,5824960.73,7535043.26,13360003.99
354995,202210,628,205,423,248463.4,512684.42,761147.82
355000,202210,465,159,306,192709.9,370872.3,563582.2
355010,202210,672,412,260,499363.13,315128.31,814491.44
355020,202210,836,512,324,622982.44,392693.67,1015676.11
355030,202210,226546,83576,142970,101349033.51,173439143.28,274788176.79
355040,202210,1017,485,532,587833.75,646004.26,1233838.01
355050,202210,183,96,87,116352.2,105444,221796.2
355060,202210,1884,870,1014,1056883.24,1230183.38,2287066.62
355070,202210,1708,738,970,895681.39,1178079.03,2073760.42
355080,202210,207,124,83,150289.32,100597.78,250887.10
355090,202210,328,207,121,250892.98,147867.09,398760.07
355100,202210,5791,2674,3117,3244466.65,3785100.86,7029567.51
355110,202210,231,148,83,179376.79,100596.8,279973.59
355120,202210,54,32,22,38785.24,26664,65449.24
355130,202210,53,29,24,35148.99,29088,64236.99
355140,202210,206,118,88,144230.6,106656.68,250887.28
355150,202210,729,432,297,523597.66,359966.71,883564.37
355160,202210,506,240,266,290885.92,322396.89,613282.81
355170,202210,2173,1109,1064,1346559.78,1289577.42,2636137.20
355180,202210,727,284,443,344212.61,536921.31,881133.92
355190,202210,233,155,78,187865.24,94537.5,282402.74
355200,202210,119,58,61,70296.6,73932.6,144229.2
355210,202210,745,384,361,465411.84,437650.89,903062.73
355220,202210,8234,3887,4347,4715981.59,5273453.41,9989435.00
355230,202210,94,51,43,61812,52117.25,113929.25
355240,202210,4869,1920,2949,2327026.99,3577840.5,5904867.49
355250,202210,7371,3226,4145,3911227.28,5031031.46,8942258.74
355255,202210,48,30,18,36360,21816,58176
355260,202210,196,110,86,133323.41,104233.62,237557.03
355270,202210,160,102,58,123626.31,70296.78,193923.09
355280,202210,7538,2786,4752,3377904.38,5764334.09,9142238.47
355290,202210,65,50,15,60600.47,18180.45,78780.92
355300,202210,234,131,103,158773.69,124836.76,283610.45
355310,202210,115,64,51,77568.6,61812,139380.6
355320,202210,99,51,48,61812,58176,119988
355330,202210,337,194,143,235133.69,173318.88,408452.57
355340,202210,1399,498,901,603601.58,1093263.26,1696864.84
355350,202210,169,79,90,95748,109080.1,204828.1
355360,202210,179,117,62,141810.71,75144.89,216955.60
355365,202210,18,13,5,15756,6060,21816
355370,202210,1070,623,447,756311.14,541766.78,1298077.92
355380,202210,857,513,344,622991.8,418146.82,1041138.62
355385,202210,99,62,37,75144.35,44844,119988.35
355390,202210,108,55,53,66660.39,64236.8,130897.19
355395,202210,201,103,98,124839.91,118778.18,243618.09
355400,202210,1869,1050,819,1273733.54,992629.16,2266362.70
355410,202210,5443,2428,3015,2945209.73,3655403.4,6600613.13
355420,202210,46,32,14,38785,16968,55753
355430,202210,445,263,182,318768.92,220590.12,539359.04
355440,202210,91,51,40,61812,48480.8,110292.8
355450,202210,467,238,229,288460.89,277550.41,566011.30
355460,202210,56,42,14,50904.25,16968,67872.25
355465,202210,51,28,23,33936.31,27876,61812.31
355470,202210,200,77,123,93326.67,149077.51,242404.18
355475,202210,7,4,3,4848.04,3636,8484.04
355480,202210,656,263,393,318765.76,476324.26,795090.02
355490,202210,111,79,32,95753.14,38786.29,134539.43
355495,202210,94,39,55,47268,66660.91,113928.91
355500,202210,1647,878,769,1064153.42,934458.12,1998611.54
355510,202210,282,195,87,236351.1,105446.56,341797.66
355520,202210,27,19,8,23028.18,9696,32724.18
355530,202210,23,12,11,14544,13332,27876
355535,202210,83,41,42,49693.23,50904,100597.23
355540,202210,2962,1160,1802,1405957.04,2185276.42,3591233.46
355550,202210,69,40,29,48480,35148,83628
355560,202210,258,116,142,140596.12,172106.61,312702.73
355570,202210,16,10,6,12120,7272,19392
355580,202210,242,162,80,196346.53,96961.57,293308.10
355590,202210,17,11,6,13332,7272,20604
355600,202210,284,136,148,164833.41,179378.35,344211.76
355610,202210,246,145,101,175746.72,122413.74,298160.46
355620,202210,1369,584,785,707815.09,951421.83,1659236.92
355630,202210,429,306,123,370882.93,149077.3,519960.23
355635,202210,132,56,76,67872,93324,161196
355640,202210,610,326,284,395115.2,344212.27,739327.47
355645,202210,930,331,599,401184.23,727211.94,1128396.17
355650,202210,1938,833,1105,1010823.32,1340474.67,2351297.99
355660,202210,227,116,111,140593.38,134533.41,275126.79
355670,202210,681,284,397,344210.16,481165.75,825375.91
355680,202210,213,115,98,139383.48,118777,258160.48
355690,202210,96,47,49,56964.87,59388,116352.87
355695,202210,26,16,10,19392,12120,31512
355700,202210,1287,626,661,758722.18,801137.75,1559859.93
355710,202210,2391,1306,1085,1582908.94,1317446.38,2900355.32
355715,202210,15,13,2,15756,2424.8,18180.8
355720,202210,266,163,103,197558.14,124837.72,322395.86
355730,202210,112,65,47,78781.86,56964.15,135746.01
410010,202210,115,90,25,110295.31,30300,140595.31
410020,202210,123,86,37,104233.42,44844,149077.42
410030,202210,185,103,82,124838.24,99386.88,224225.12
410040,202210,1438,678,760,821743.79,922343.73,1744087.52
410045,202210,46,34,12,41208.59,14544,55752.59
410050,202210,540,313,227,380570.57,277549.44,658120.01
410060,202210,226,164,62,199983.44,75144,275127.44
410070,202210,297,247,50,299371.8,60600.75,359972.55
410080,202210,186,111,75,134532.85,90900,225432.85
410090,202210,55,45,10,54541.74,12120,66661.74
410100,202210,269,170,99,206040.4,119988,326028.4
410105,202210,47,30,17,37572,20604,58176
410110,202210,364,218,146,264224.28,176956.21,441180.49
410115,202210,48,28,20,33936.8,24240.2,58177.0
410120,202210,476,217,259,263009.8,313912.45,576922.25
410130,202210,68,39,29,47268,35148,82416
410140,202210,3358,1507,1851,1826503.16,2244646.3,4071149.46
410150,202210,2739,1085,1654,1317463.59,2010721.24,3328184.83
410160,202210,509,290,219,351484.54,265429.68,616914.22
410165,202210,55,34,21,41208,25452,66660
410170,202210,216,123,93,149076.2,112716,261792.2
410180,202210,2448,1274,1174,1548969.94,1424124.55,2973094.49
410185,202210,37,30,7,36360,9696,46056
410190,202210,505,324,181,392691.22,219372.9,612064.12
410200,202210,1084,757,327,917497.05,396326.28,1313823.33
410210,202210,658,339,319,410871.64,387842.14,798713.78
410220,202210,50,21,29,25452,35148,60600
410230,202210,196,87,109,105445.56,132108.4,237553.96
410240,202210,736,471,265,570864.18,322395.3,893259.48
410250,202210,393,265,128,322394.13,155138.12,477532.25
410260,202210,308,172,136,208468.6,164833.41,373302.01
410270,202210,30,20,10,24240.2,12120,36360.2
410275,202210,64,46,18,55752,21816,77568
410280,202210,328,194,134,235132.32,162408.2,397540.52
410290,202210,271,150,121,181801.53,146652.5,328454.03
410300,202210,87,53,34,64236,41208,105444
410302,202210,27,14,13,16968,15756,32724
410304,202210,44,30,14,36361.22,16968,53329.22
410305,202210,215,125,90,151502.06,109080.8,260582.86
410310,202210,186,110,76,133321.23,93325.4,226646.63
410315,202210,39,30,9,36360.2,10908,47268.2
410320,202210,142,98,44,118777.47,53328,172105.47
410322,202210,39,24,15,29088,18180,47268
410330,202210,177,111,66,134533.49,79992,214525.49
410335,202210,101,55,46,66660,55752,122412
410337,202210,47,38,9,46056,10908,56964
410340,202210,39,32,7,38785.2,8484,47269.2
410345,202210,199,119,80,144228.98,96961.61,241190.59
410347,202210,45,33,12,39997.06,14544,54541.06
410350,202210,253,147,106,178166.52,128472,306638.52
410360,202210,453,276,177,334517.83,214525.41,549043.24
410370,202210,2427,1035,1392,1255650.92,1691966.57,2947617.49
410380,202210,198,111,87,134533.33,105444.72,239978.05
410390,202210,418,266,152,322394.24,184224.78,506619.02
410395,202210,31,20,11,24240.85,13332.38,37573.23
410400,202210,939,395,544,478746.73,661759.62,1140506.35
410405,202210,78,57,21,69084.98,25452.59,94537.57
410410,202210,28,17,11,20604.71,13332.8,33937.51
410420,202210,1847,815,1032,987684.4,1250800.45,2238484.85
410425,202210,206,83,123,100597.31,149076.2,249673.51
410430,202210,2519,1296,1223,1570772.07,1482294.73,3053066.80
410440,202210,360,252,108,305424.72,130896.25,436320.97
410442,202210,364,227,137,276341.61,166045.16,442386.77
410445,202210,357,244,113,295731.3,136956.62,432687.92
410450,202210,394,186,208,225435.29,252096.67,477531.96
410460,202210,582,301,281,364815.54,340573.02,705388.56
410465,202210,280,154,126,186648.73,153924.6,340573.33
410470,202210,240,137,103,166046.99,124836.78,290883.77
410480,202210,6923,3320,3603,4025119.67,4370518.6,8395638.27
410490,202210,1465,804,661,974461.92,801144.39,1775606.31
410500,202210,283,165,118,199981.58,143016.5,342998.08
410510,202210,201,150,51,181803.72,61815.04,243618.76
410520,202210,281,195,86,236340,104232,340572
410530,202210,285,87,198,105444,239976,345420
410540,202210,362,263,99,318757.25,119988.79,438746.04
410550,202210,1757,726,1031,881134.3,1250790.47,2131924.77
410560,202210,180,115,65,139382.27,78780.59,218162.86
410570,202210,443,289,154,350272.03,186649.57,536921.60
410580,202210,3969,1636,2333,1982857.38,2828850.18,4811707.56
410590,202210,443,286,157,346616.73,191496.2,538112.93
410600,202210,101,87,14,105446.1,16968,122414.1
410610,202210,57,46,11,55753.36,13332,69085.36
410620,202210,283,176,107,214527.15,129685.2,344212.35
410630,202210,472,262,210,317548.3,254520,572068.3
410640,202210,1192,737,455,893252.89,551463.15,1444716.04
410645,202210,115,86,29,104236.08,35148,139384.08
410650,202210,384,233,151,282396.9,183013.72,465410.62
410655,202210,90,66,24,79992.35,29088.08,109080.43
410657,202210,35,14,21,16968,25452,42420
410660,202210,679,457,222,555105.54,269067.65,824173.19
410670,202210,81,65,16,78781.15,19392.6,98173.75
410680,202210,193,152,41,184225.31,49692,233917.31
410685,202210,35,24,11,29088,13332,42420
410690,202210,30277,12365,17912,15002343.15,21744748.64,36747091.79
410700,202210,336,241,95,292356.12,115141.54,407497.66
410710,202210,125,103,22,124836.25,26664.2,151500.45
410712,202210,42,30,12,36360,14544,50904
410715,202210,110,79,31,95748.33,37572,133320.33
410720,202210,655,358,297,436324.06,359965.06,796289.12
410725,202210,193,134,59,162408.47,71508,233916.47
410730,202210,107,44,63,53328.15,76356,129684.15
410740,202210,84,61,23,73933.33,27876.95,101810.28
410750,202210,293,191,102,231493.95,124836,356329.95
410752,202210,20,14,6,16968,7272,24240
410753,202210,63,22,41,26664,49692,76356
410754,202210,57,27,30,32726.3,36360,69086.3
410755,202210,79,40,39,48480.35,47268,95748.35
410760,202210,796,428,368,518738.85,446019.18,964758.03
410765,202210,2023,905,1118,1096888.41,1356252.03,2453140.44
410770,202210,123,82,41,99385.4,49695.04,149080.44
410773,202210,69,46,23,55753.65,27876,83629.65
410775,202210,190,136,54,164836.9,65448,230284.9
410780,202210,84,46,38,55752.64,46056,101808.64
410785,202210,53,44,9,53328,10908,64236
410790,202210,91,38,53,46056.8,64236,110292.8
410800,202210,299,185,114,224224.33,138169.36,362393.69
410810,202210,30,17,13,20604.16,15757.2,36361.36
410820,202210,156,111,45,134533.67,54540.9,189074.57
410830,202210,9697,3939,5758,4775366.35,6983614.79,11758981.14
410832,202210,119,75,44,90900.56,53328.36,144228.92
410840,202210,1475,792,683,959917.82,827801.35,1787719.17
410845,202210,61,33,28,39996.2,33936.49,73932.69
410850,202210,154,110,44,133324.43,53328.8,186653.23
410855,202210,80,72,8,87264.84,9696,96960.84
410860,202210,873,428,445,519954.72,539343.29,1059298.01
410865,202210,94,66,28,79993.13,33936,113929.13
410870,202210,145,117,28,141804.76,33936,175740.76
410880,202210,1218,588,630,712667.54,763566.42,1476233.96
410890,202210,112,69,43,84841.38,52116,136957.38
410895,202210,80,60,20,72720.35,24240.95,96961.30
410900,202210,30,23,7,27876,8484,36360
410910,202210,12,7,5,8484,6060,14544
410920,202210,45,28,17,33936,20604,54540
410930,202210,565,336,229,407233.99,277548.99,684782.98
410940,202210,4625,2332,2293,2827665.81,2785218.35,5612884.16
410950,202210,105,79,26,95750.41,31512.51,127262.92
410960,202210,984,373,611,453298.59,741756.07,1195054.66
410965,202210,67,45,22,54540,26664,81204
410970,202210,626,413,213,500563.26,258158.32,758721.58
410975,202210,125,77,48,93325.56,58176,151501.56
410980,202210,1676,755,921,915073.14,1117475,2032548.14
410990,202210,278,201,77,243612.77,93324.98,336937.75
411000,202210,65,34,31,41209.27,37573.73,78783.00
411005,202210,38,31,7,37572,8484,46056
411007,202210,255,148,107,179376.47,129684,309060.47
411010,202210,622,396,226,479959.84,273914.59,753874.43
411020,202210,285,174,111,210891.06,135745.31,346636.37
411030,202210,25,13,12,15756,14544,30300
411040,202210,64,40,24,48480,29088,77568
411050,202210,221,151,70,183013,84840.03,267853.03
411060,202210,554,374,180,453293.5,218161.42,671454.92
411065,202210,38,34,4,41209.14,4848,46057.14
411070,202210,1314,735,579,890828.3,702965.59,1593793.89
411080,202210,255,170,85,206040.03,103020.2,309060.23
411090,202210,88,64,24,77568.7,29088.96,106657.66
411095,202210,362,115,247,139380.7,299364.37,438745.07
411100,202210,110,84,26,101808.67,31512,133320.67
411110,202210,142,79,63,95748.2,76356.2,172104.4
411120,202210,209,134,75,162409.49,90900,253309.49
411125,202210,344,164,180,198770.61,218164.3,416934.91
411130,202210,120,102,18,123625.4,21816,145441.4
411140,202210,211,144,67,174528.19,81204,255732.19
411150,202210,1286,817,469,991465.37,569645.21,1561110.58
411155,202210,121,82,39,99384,47268,146652
411160,202210,34,13,21,15756,25452,41208
411170,202210,57,48,9,58176,10908,69084
411180,202210,1054,682,372,826603.5,450870.21,1277473.71
411190,202210,347,193,154,233917.41,187860,421777.41
411200,202210,685,368,317,446026.44,384206.74,830233.18
411210,202210,689,348,341,421778.58,413294.14,835072.72
411220,202210,167,115,52,139381.81,63024.8,202406.61
411230,202210,35,29,6,35148,8484.1,43632.1
411240,202210,111,72,39,87265.36,48480,135745.36
411250,202210,435,307,128,372085.94,155136,527221.94
411260,202210,13,9,4,10908,4848,15756
411270,202210,269,140,129,170898.73,156350.28,327249.01
411275,202210,195,163,32,197557.94,38784,236341.94
411280,202210,281,186,95,225436.09,116352,341788.09
411290,202210,68,52,16,63024.2,19392,82416.2
411295,202210,127,96,31,116353.65,37572.47,153926.12
411300,202210,83,39,44,47268.2,53328,100596.2
411310,202210,96,68,28,82416,33936,116352
411320,202210,856,521,335,631462.25,406023.76,1037486.01
411325,202210,66,46,20,55752.1,24240,79992.1
411330,202210,962,615,347,745396.68,421779.91,1167176.59
411340,202210,36,23,13,27876,15756,43632
411342,202210,62,47,15,56964,18180,75144
411345,202210,106,53,53,64236.68,64236,128472.68
411350,202210,533,398,135,482379.08,163622.22,646001.30
411360,202210,61,39,22,47269.36,26666,73935.36
411370,202210,14173,5754,8419,6980031.16,10213614.3,17193645.46
411373,202210,187,124,63,150288,76356,226644
411375,202210,82,67,15,81204.79,18180,99384.79
411380,202210,78,52,26,63025.15,31512,94537.15
411390,202210,156,84,72,101808,87264,189072
411400,202210,365,235,130,284827.45,157560,442387.45
411410,202210,536,249,287,303002.5,347845.53,650848.03
411420,202210,999,411,588,498138.01,715084.3,1213222.31
411430,202210,555,289,266,350275.56,323612.36,673887.92
411435,202210,29,20,9,24240.63,10908,35148.63
411440,202210,496,393,103,476319.56,124836,601155.56
411450,202210,404,325,79,393904.74,95748.09,489652.83
411460,202210,840,319,521,386634.73,631455.95,1018090.68
411470,202210,113,78,35,94539.43,42420,136959.43
411480,202210,740,376,364,455720.92,441170.59,896891.51
411490,202210,287,179,108,216951.04,132108,349059.04
411500,202210,104,82,22,99384.2,27876,127260.2
411510,202210,231,176,55,213315.65,66661.19,279976.84
411520,202210,6539,2194,4345,2661579.85,5267386.66,7928966.51
411530,202210,126,80,46,96960.44,55752,152712.44
411535,202210,49,15,34,18180.1,41208,59388.1
411540,202210,392,257,135,311487.6,163622.23,475109.83
411545,202210,57,42,15,50904.39,18180,69084.39
411550,202210,90,69,21,83628,25452,109080
411560,202210,400,169,231,204829.3,279972.15,484801.45
411570,202210,1045,342,703,414508.19,853258.28,1267766.47
411573,202210,29,15,14,18180.2,16968,35148.2
411575,202210,315,193,122,233918.33,149076,382994.33
411580,202210,1305,454,851,552677.35,1031418.39,1584095.74
411585,202210,76,36,40,43632,48480,92112
411590,202210,14,8,6,9696,7272,16968
411600,202210,17,7,10,8484.2,12120.7,20604.9
411605,202210,177,70,107,84840.61,130896.58,215737.19
411610,202210,244,148,96,180589.31,116352.2,296941.51
411620,202210,398,190,208,230284.77,254525.32,484810.09
411630,202210,49,35,14,42421.07,16968.99,59390.06
411640,202210,32,21,11,25452.46,13332,38784.46
411650,202210,7,4,3,4848,3636,8484
411660,202210,45,33,12,39996,14544,54540
411670,202210,237,162,75,196345.81,90900,287245.81
411680,202210,160,125,35,151500.99,42420,193920.99
411690,202210,725,380,345,460561.2,418143.38,878704.58
411695,202210,65,44,21,53328.2,25452,78780.2
411700,202210,144,114,30,138170.99,36360,174530.99
411705,202210,100,66,34,79994.6,41208.3,121202.9
411710,202210,296,199,97,241189.3,117564.95,358754.25
411720,202210,153,100,53,121200.96,64236.2,185437.16
411721,202210,89,69,20,83628,24240.2,107868.2
411722,202210,106,50,56,61812.2,67872,129684.2
411725,202210,170,119,51,144228.2,61812,206040.2
411727,202210,101,80,21,96961.97,25452.2,122414.17
411729,202210,52,40,12,48480.09,14544,63024.09
411730,202210,584,367,217,446019.68,263006.28,709025.96
411740,202210,27,15,12,18180,14544.12,32724.12
411745,202210,68,51,17,61812,20604,82416
411750,202210,876,355,521,430265.03,633878.13,1064143.16
411760,202210,1287,913,374,1106586.48,453296.31,1559882.79
411770,202210,431,274,157,332089.98,190284.6,522374.58
411780,202210,378,242,136,293304.9,164832.21,458137.11
411790,202210,610,340,270,412086.33,327240.2,739326.53
411800,202210,168,120,48,145442.4,58176.38,203618.78
411810,202210,185,139,46,168469.34,56964.89,225434.23
411820,202210,2668,1054,1614,1278693.48,1958629.86,3237323.34
411830,202210,16,13,3,15756,3636,19392
411840,202210,2278,1316,962,1596222.54,1165959.73,2762182.27
411845,202210,64,21,43,25452.9,52116,77568.9
411850,202210,1299,689,610,837505.7,739327.75,1576833.45
411860,202210,60,37,23,44844.81,27876,72720.81
411870,202210,72,44,28,53328,33936,87264
411880,202210,423,247,176,299370.79,213313.26,512684.05
411885,202210,109,68,41,82416.19,49693.33,132109.52
411890,202210,337,237,100,287246.6,121201.68,408448.28
411900,202210,113,82,31,99384.69,37572,136956.69
411910,202210,217,146,71,176952.49,86053.93,263006.42
411915,202210,2531,974,1557,1182931.88,1889539.29,3072471.17
411920,202210,115,87,28,105445.05,35148.98,140594.03
411925,202210,17,10,7,12120.59,8484,20604.59
411930,202210,812,544,268,659421.86,324818.98,984240.84
411940,202210,615,385,230,469051.89,279972.6,749024.49
411950,202210,1278,572,706,693279.45,856901.66,1550181.11
411960,202210,1181,731,450,885982.56,546612.49,1432595.05
411965,202210,23,14,9,16968.5,10908,27876.5
411970,202210,94,80,14,96961.67,16968,113929.67
411980,202210,224,114,110,138168.78,133320,271488.78
411990,202210,5483,2889,2594,3505091.71,3148922.24,6654013.95
411995,202210,639,184,455,223012.62,552688.84,775701.46
412000,202210,337,222,115,269070.33,139383.24,408453.57
412010,202210,61,31,30,37572,36360,73932
412015,202210,36,29,7,35148.1,8484,43632.1
412020,202210,24,19,5,23028.89,6060,29088.89
412030,202210,38,34,4,41208.2,4848,46056.2
412033,202210,51,29,22,35149.01,26664,61813.01
412035,202210,68,43,25,52116,30300,82416
412040,202210,32,15,17,18180.6,20604,38784.6
412050,202210,217,156,61,189073.82,73932.56,263006.38
412060,202210,811,578,233,700547.02,282398.42,982945.44
412065,202210,62,32,30,38784,36360.34,75144.34
412070,202210,148,103,45,124837.6,54540,179377.6
412080,202210,361,173,188,209678.59,227859.67,437538.26
412085,202210,39,14,25,16968.59,30300,47268.59
412090,202210,881,536,345,649641.87,418142.11,1067783.98
412100,202210,262,220,42,266648.82,50904,317552.82
412110,202210,75,56,19,67873.33,23028,90901.33
412120,202210,367,192,175,232707.97,212101.11,444809.08
412125,202210,72,41,31,49692.2,37572,87264.2
412130,202210,47,29,18,35149.03,21816,56965.03
412135,202210,29,18,11,21816,13332,35148
412140,202210,461,293,168,355117.5,204829.45,559946.95
412150,202210,253,155,98,187860.6,118776,306636.6
412160,202210,77,49,28,59388,33936,93324
412170,202210,726,469,257,568431.28,311485.94,879917.22
412175,202210,40,25,15,30300,18180.08,48480.08
412180,202210,163,122,41,147865,49692.2,197557.2
412190,202210,331,260,71,315124.09,86052,401176.09
412200,202210,191,113,78,136957.32,94536,231493.32
412210,202210,96,72,24,87264,29088.73,116352.73
412215,202210,244,164,80,198769.69,96960.98,295730.67
412217,202210,65,49,16,59388.24,19392,78780.24
412220,202210,869,565,304,684797.17,369667.47,1054464.64
412230,202210,279,168,111,203621.36,134535.4,338156.76
412240,202210,1400,692,708,838718.29,859316.22,1698034.51
412250,202210,418,254,164,307849.41,198768,506617.41
412260,202210,129,82,47,99384.83,58176.2,157561.03
412265,202210,170,128,42,155136.83,50904,206040.83
412270,202210,94,57,37,69084.41,44844,113928.41
412280,202210,82,63,19,76356,23028.6,99384.6
412290,202210,90,55,35,66660.46,42420,109080.46
412300,202210,207,147,60,179376.47,72720,252096.47
412310,202210,56,43,13,52117.8,15756,67873.8
412320,202210,89,67,22,81207.37,26664,107871.37
412330,202210,201,154,47,186649.58,56964,243613.58
412340,202210,178,115,63,139380.98,76356,215736.98
412350,202210,690,307,383,372086.28,464197.47,836283.75
412360,202210,21,17,4,20604,4848,25452
412370,202210,143,118,25,143018.21,30300,173318.21
412380,202210,192,144,48,174530.16,58176.3,232706.46
412382,202210,61,32,29,38784,35148,73932
412385,202210,161,113,48,136957.86,58176,195133.86
412390,202210,329,249,80,304218.07,96962.79,401180.86
412395,202210,68,54,14,65448,16968,82416
412400,202210,101,67,34,81205.63,41208,122413.63
412402,202210,241,131,110,158772.8,133321.18,292093.98
412405,202210,991,324,667,392689.95,808404.4,1201094.35
412410,202210,1018,599,419,726625.6,507832.21,1234457.81
412420,202210,17,16,1,19392,1212,20604
412430,202210,26,24,2,29088.2,2424,31512.2
412440,202210,680,338,342,409661.64,415717.61,825379.25
412450,202210,68,60,8,72720.74,9696,82416.74
412460,202210,75,53,22,64236.4,26664,90900.4
412470,202210,230,179,51,216951.43,61812.11,278763.54
412480,202210,154,110,44,133320.97,53328.2,186649.17
412490,202210,173,146,27,176952.68,32724,209676.68
412500,202210,403,315,88,381786.14,106656.86,488443.00
412510,202210,175,143,32,173318.71,38784.1,212102.81
412520,202210,96,63,33,76356,39996,116352
412530,202210,106,49,57,59388.32,70296,129684.32
412535,202210,71,55,16,66662.05,19392.6,86054.65
412540,202210,46,26,20,31512,24240.59,55752.59
412545,202210,85,58,27,70297.37,32724,103021.37
412550,202210,4319,1742,2577,2116193.67,3127007.37,5243201.04
412555,202210,11,7,4,8484,4848,13332
412560,202210,694,452,242,547829.91,293305.78,841135.69
412570,202210,858,386,472,467839.07,573278.49,1041117.56
412575,202210,96,68,28,82416.96,33936,116352.96
412580,202210,178,117,61,141808.36,73933.67,215742.03
412590,202210,34,29,5,35149.22,6060,41209.22
412600,202210,201,143,58,173319.44,70296.83,243616.27
412610,202210,39,17,22,20604,26664,47268
412620,202210,126,104,22,126051.11,26664.8,152715.91
412625,202210,2180,1028,1152,1248378.52,1398655.96,2647034.48
412627,202210,66,49,17,59388,20604,79992
412630,202210,382,259,123,313914.88,149077.89,462992.77
412635,202210,80,24,56,29088,67872,96960
412640,202210,110,78,32,94536.2,38784,133320.2
412650,202210,324,209,115,253311.11,139380,392691.11
412660,202210,586,310,276,375721.66,334513.69,710235.35
412665,202210,43,39,4,47268,4848,52116
412667,202210,280,176,104,213315.01,126048,339363.01
412670,202210,77,59,18,71508.2,21816,93324.2
412680,202210,334,252,82,305432.94,100596.6,406029.54
412690,202210,132,84,48,101809.01,58176,159985.01
412700,202210,194,122,72,147864.47,87264.23,235128.70
412710,202210,1403,777,626,942950.61,758717.75,1701668.36
412720,202210,236,132,104,159985.11,126048.32,286033.43
412730,202210,213,181,32,219374.55,38784.99,258159.54
412740,202210,415,204,211,247250.56,255732.31,502982.87
412750,202210,417,229,188,277550.46,227857.33,505407.79
412760,202210,373,185,188,224224.33,227858.2,452082.53
412770,202210,2165,1150,1015,1393817.43,1231397.51,2625214.94
412780,202210,146,103,43,124838.74,52116.19,176954.93
412785,202210,329,170,159,206041.4,192708.02,398749.42
412788,202210,51,30,21,36360.82,25452,61812.82
412790,202210,127,103,24,124838.26,29088,153926.26
412795,202210,145,99,46,119988.3,55752,175740.3
412796,202210,311,194,117,235129.5,141804,376933.5
412800,202210,717,407,310,493287.14,375720.66,869007.80
412810,202210,3217,1745,1472,2114982.71,1785298.38,3900281.09
412820,202210,1048,605,443,733275.36,536926.13,1270201.49
412830,202210,14,13,1,15756.2,1212,16968.2
412840,202210,281,187,94,226644.2,115140,341784.2
412850,202210,597,392,205,475110.9,249674.03,724784.93
412853,202210,173,80,93,96960,112716.8,209676.8
412855,202210,201,106,95,128474.39,115140,243614.39
412860,202210,99,66,33,79993.97,39997.19,119991.16
412862,202210,85,52,33,63024,39996,103020
412863,202210,10,7,3,8484,3636,12120
412865,202210,45,35,10,42420,12120,54540
412870,202210,114,70,44,84843,53328.46,138171.46
412880,202210,98,66,32,79994.32,38784,118778.32
420005,202210,43,36,7,44844.45,8484,53328.45
420010,202210,370,242,128,293307.24,155136.39,448443.63
420020,202210,100,74,26,89688.55,32724,122412.55
420030,202210,27,22,5,26664,6060,32724
420040,202210,94,72,22,87264.48,26664,113928.48
420050,202210,56,36,20,43632.16,24240,67872.16
420055,202210,17,15,2,18180.99,2424,20604.99
420060,202210,28,19,9,23028,10908.2,33936.2
420070,202210,104,89,15,107868,18180,126048
420075,202210,10,10,0,12120,,12120.0
420080,202210,41,35,6,42420,7272,49692
420090,202210,37,30,7,36360.66,8484.2,44844.86
420100,202210,163,138,25,167257.73,30300,197557.73
420110,202210,22,21,1,25452,1212,26664
420120,202210,62,44,18,53328.31,21816.2,75144.51
420125,202210,84,63,21,76356.2,25452,101808.2
420127,202210,37,32,5,38784,6060,44844
420130,202210,502,304,198,369344.95,241192.82,610537.77
420140,202210,1402,777,625,941742.24,757517.79,1699260.03
420150,202210,49,36,13,43632,15756,59388
420160,202210,31,28,3,33936.19,3636,37572.19
420165,202210,17,12,5,14544,6060.3,20604.3
420170,202210,73,42,31,50904,37572.59,88476.59
420180,202210,24,21,3,25452,3636,29088
420190,202210,27,23,4,27876,4848,32724
420195,202210,132,59,73,71510.97,88478.68,159989.65
420200,202210,1391,581,810,704183.09,986583.59,1690766.68
420205,202210,124,71,53,86053.21,64236.56,150289.77
420207,202210,146,81,65,98174.06,78780,176954.06
420208,202210,20,15,5,18180,6060,24240
420209,202210,13,11,2,13332.58,2424,15756.58
420210,202210,603,283,320,342999.45,387842.33,730841.78
420213,202210,58,40,18,48480,21816.2,70296.2
420215,202210,27,24,3,29088.59,3636,32724.59
420220,202210,61,38,23,46056.6,27876,73932.6
420230,202210,1017,607,410,738126.83,496925.62,1235052.45
420240,202210,2386,1569,817,1901644.24,990211.11,2891855.35
420243,202210,44,35,9,42420.3,10908,53328.3
420245,202210,220,104,116,126050.72,140595.14,266645.86
420250,202210,61,42,19,50904.99,24240,75144.99
420253,202210,26,19,7,23029.72,8484,31513.72
420257,202210,14,9,5,10908,6060,16968
420260,202210,125,100,25,121200.79,30300.14,151500.93
420270,202210,32,24,8,29088.19,9696,38784.19
420280,202210,290,214,76,259374.25,92113.48,351487.73
420285,202210,24,19,5,23028,6060,29088
420287,202210,46,29,17,35148,20604,55752
420290,202210,966,651,315,790232.6,381781.03,1172013.63
420300,202210,1647,1312,335,1590183.28,407238.85,1997422.13
420310,202210,44,31,13,37572,15756,53328
420315,202210,27,22,5,26664.68,6060.5,32725.18
420320,202210,1049,495,554,599950.12,671460.14,1271410.26
420325,202210,6,4,2,4848,2424.8,7272.8
420330,202210,117,76,41,92112.34,49692.2,141804.54
420340,202210,198,133,65,161197.8,78780.3,239978.1
420350,202210,260,183,77,221804.23,93324.8,315129.03
420360,202210,701,539,162,653280.81,196345.34,849626.15
420370,202210,141,75,66,90901.28,79992.43,170893.71
420380,202210,1249,844,405,1025374.15,492076.66,1517450.81
420390,202210,234,164,70,198769.87,84840.4,283610.27
420395,202210,193,141,52,170894.38,63025.94,233920.32
420400,202210,230,176,54,213315.07,65448.2,278763.27
420410,202210,55,41,14,49693.52,16968,66661.52
420415,202210,32,26,6,31512.96,7272,38784.96
420417,202210,55,43,12,52116,14544,66660
420419,202210,11,10,1,12120,1212,13332
420420,202210,2958,1827,1131,2216789.05,1371994.82,3588783.87
420425,202210,72,51,21,61812.58,25452.69,87265.27
420430,202210,1051,759,292,922336.85,353904.3,1276241.15
420435,202210,13,11,2,13332,2424,15756
420440,202210,93,65,28,78781.31,33936,112717.31
420445,202210,30,27,3,32724.9,3636,36360.9
420450,202210,84,46,38,55753.75,46056,101809.75
420455,202210,184,143,41,173319.55,49692,223011.55
420460,202210,2400,1482,918,1798640.23,1115050.68,2913690.91
420470,202210,88,57,31,69084.6,37572,106656.6
420475,202210,11,10,1,12120,1212,13332
420480,202210,899,683,216,832668.44,261794.48,1094462.92
420490,202210,101,76,25,92114.8,30300.61,122415.41
420500,202210,400,237,163,287249.46,197556.2,484805.66
420510,202210,25,21,4,25452.68,4848,30300.68
420515,202210,26,14,12,16968.02,14544,31512.02
420517,202210,9,7,2,8484,2424,10908
420519,202210,0,0,0,,,0.0
420520,202210,59,44,15,53329.25,18180,71509.25
420530,202210,138,88,50,106656.91,60600.2,167257.11
420535,202210,16,13,3,15756,3636,19392
420540,202210,6693,4142,2551,5027799.49,3097903.07,8125702.56
420543,202210,32,30,2,36361.08,2424,38785.08
420545,202210,218,150,68,181804.71,82416,264220.71
420550,202210,786,655,131,793882.68,158773.72,952656.40
420555,202210,29,21,8,25452.3,9696,35148.3
420560,202210,65,50,15,60600.84,18180,78780.84
420570,202210,218,101,117,122414.93,141805.78,264220.71
420580,202210,314,152,162,184225.74,196344.8,380570.54
420590,202210,490,311,179,376936.91,216948.55,593885.46
420600,202210,150,80,70,96960,84840,181800
420610,202210,35,32,3,38784.2,3636,42420.2
420620,202210,82,61,21,73933.14,25452.65,99385.79
420630,202210,157,104,53,126049.6,64236,190285.6
420640,202210,70,60,10,72720,12120,84840
420650,202210,303,156,147,189073.6,178166,367239.6
420660,202210,41,31,10,38784,12120,50904
420665,202210,45,29,16,35148.2,19392,54540.2
420670,202210,236,179,57,216954.53,69084,286038.53
420675,202210,14,12,2,14544,2424,16968
420680,202210,33,28,5,33936,6060,39996
420690,202210,204,154,50,186648.38,60600.34,247248.72
420700,202210,728,476,252,576926.37,306639.16,883565.53
420710,202210,141,76,65,92112.2,78780.44,170892.64
420720,202210,95,77,18,93325.49,21816.1,115141.59
420730,202210,720,431,289,522381.01,351488.79,873869.80
420740,202210,57,56,1,67872,1212,69084
420750,202210,499,327,172,396326.72,208465.11,604791.83
420757,202210,19,16,3,19392,3636,23028
420760,202210,39,28,11,33936.2,13332,47268.2
420765,202210,77,53,24,64237,29088,93325
420768,202210,58,47,11,56966.25,13332,70298.25
420770,202210,68,59,9,71508.9,10908,82416.9
420775,202210,34,30,4,36360.8,4848,41208.8
420780,202210,200,157,43,190285.88,52116,242401.88
420785,202210,24,16,8,19392,9696,29088
420790,202210,138,113,25,138168.12,30300.09,168468.21
420800,202210,63,48,15,58176,18180,76356
420810,202210,285,219,66,266643.27,79992,346635.27
420820,202210,2637,1441,1196,1752587.1,1453202.9,3205790.0
420830,202210,718,380,338,460571.95,409667.51,870239.46
420840,202210,131,90,41,109080.8,49692,158772.8
420845,202210,449,190,259,230285.03,313910.81,544195.84
420850,202210,274,211,63,255733,76356,332089
420860,202210,60,50,10,60601.52,12120,72721.52
420870,202210,131,91,40,110292.1,48480,158772.1
420880,202210,195,122,73,147866.33,88476.6,236342.93
420890,202210,996,481,515,584189.35,624182.35,1208371.70
420895,202210,8,8,0,9696,,9696.0
420900,202210,422,344,78,416932.46,95748,512680.46
420910,202210,6089,3295,2794,4003313.73,3390004.81,7393318.54
420915,202210,60,54,6,65448,7272,72720
420917,202210,21,16,5,19392.23,6060,25452.23
420920,202210,22,15,7,18180,8484,26664
420930,202210,3440,2267,1173,2750024.71,1424129.98,4174154.69
420940,202210,587,409,178,495726.8,215740.06,711466.86
420945,202210,9,7,2,8484,2424,10908
420950,202210,48,34,14,41208,16968,58176
420960,202210,112,91,21,110295.14,25452.1,135747.24
420970,202210,284,228,56,276342.37,67872.53,344214.90
420980,202210,24,23,1,27876,1212,29088
420985,202210,53,45,8,54540.08,9696,64236.08
420990,202210,88,66,22,79992.3,26664.98,106657.28
421000,202210,61,32,29,38784,35148.4,73932.4
421003,202210,33,23,10,27876,12120,39996
421005,202210,8,6,2,7272.8,2424,9696.8
421010,202210,882,570,312,693279.72,378149.88,1071429.60
421020,202210,20,17,3,20604,3636,24240
421030,202210,117,97,20,117565.5,24240.2,141805.7
421040,202210,66,45,21,54541.38,25453.43,79994.81
421050,202210,324,226,98,273913.26,118776,392689.26
421055,202210,17,13,4,15756,4848,20604
421060,202210,108,61,47,73932.33,56964,130896.33
421070,202210,39,35,4,42421.02,4848,47269.02
421080,202210,42,35,7,42420.8,8484,50904.8
421085,202210,19,15,4,18180,4848,23028
421090,202210,38,30,8,36360.11,9696,46056.11
421100,202210,114,87,27,105445.24,32724.95,138170.19
421105,202210,196,155,41,189076.45,49692.2,238768.65
421110,202210,126,90,36,109081.94,43632,152713.94
421120,202210,181,131,50,158773,60600,219373
421125,202210,16,9,7,10908,8484.11,19392.11
421130,202210,857,521,336,631459.49,407237.94,1038697.43
421140,202210,33,24,9,29088.78,10908,39996.78
421145,202210,42,37,5,44844,6060,50904
421150,202210,82,63,19,76356.69,23028.97,99385.66
421160,202210,59,36,23,43632,27876.5,71508.5
421165,202210,12,10,2,12120,2424,14544
421170,202210,165,139,26,168616.69,31513.13,200129.82
421175,202210,192,138,54,167258.4,65448.89,232707.29
421180,202210,39,27,12,32724.56,14544,47268.56
421185,202210,16,13,3,15756.18,3636,19392.18
421187,202210,4,3,1,3636.8,1212,4848.8
421189,202210,44,31,13,37573,15756,53329
421190,202210,2018,1268,750,1538058.07,910226.68,2448284.75
421200,202210,93,65,28,78781.48,33936,112717.48
421205,202210,27,20,7,24241.64,9696,33937.64
421210,202210,176,127,49,153925.52,59388,213313.52
421220,202210,258,198,60,239978.04,72720.9,312698.94
421223,202210,48,38,10,46057.7,12120,58177.7
421225,202210,72,47,25,56964.31,30301.51,87265.82
421227,202210,63,53,10,64236.99,12120,76356.99
421230,202210,71,46,25,55753.19,30300,86053.19
421240,202210,18,15,3,19392.6,3636,23028.6
421250,202210,414,231,183,279974.9,223015.75,502990.65
421260,202210,20,15,5,18180,6060,24240
421265,202210,8,5,3,6060,3636,9696
421270,202210,53,48,5,58176,6060,64236
421280,202210,393,198,195,241191.74,236341.22,477532.96
421290,202210,323,213,110,258158.07,133320.66,391478.73
421300,202210,21,19,2,23028,2424,25452
421310,202210,47,33,14,39996.78,16968,56964.78
421315,202210,32,19,13,23028,15756.08,38784.08
421320,202210,140,94,46,113928.91,55752,169680.91
421330,202210,112,84,28,101808.36,33936,135744.36
421335,202210,44,32,12,38785.01,14544,53329.01
421340,202210,243,162,81,196345.8,98172,294517.8
421350,202210,187,110,77,133322.64,93324.25,226646.89
421360,202210,742,505,237,612066.06,287249.74,899315.80
421370,202210,197,146,51,176953.81,61813.26,238767.07
421380,202210,151,113,38,136957.38,46056,183013.38
421390,202210,15,10,5,12120,6060,18180
421400,202210,123,100,23,121200.15,27876,149076.15
421410,202210,21,18,3,21816,3636,25452
421415,202210,20,18,2,21816,2424,24240
421420,202210,103,86,17,104232.4,20604,124836.4
421430,202210,21,13,8,15756,9696,25452
421440,202210,59,52,7,63024.93,8484,71508.93
421450,202210,78,65,13,78780.8,15756,94536.8
421460,202210,54,42,12,50904,14544,65448
421470,202210,72,38,34,46056.2,41208,87264.2
421480,202210,793,593,200,718719.76,242401.3,961121.06
421490,202210,24,23,1,27876.18,1212,29088.18
421500,202210,481,280,201,340580.13,243612.34,584192.47
421505,202210,36,28,8,33936.6,9696.2,43632.8
421507,202210,30,24,6,29088,7272,36360
421510,202210,69,45,24,54540.2,29088,83628.2
421520,202210,51,42,9,50904.4,10908,61812.4
421530,202210,50,43,7,52116.2,8484,60600.2
421535,202210,23,22,1,26664,1212,27876
421540,202210,50,39,11,47268,13332,60600
421545,202210,80,55,25,66664.43,30300.4,96964.83
421550,202210,291,207,84,250892.65,101809.2,352701.85
421555,202210,14,12,2,14544.75,2424,16968.75
421560,202210,8,7,1,8484,1212,9696
421565,202210,129,85,44,103021,53328.15,156349.15
421567,202210,36,27,9,32724,10908,43632
421568,202210,41,39,2,47268,2424,49692
421569,202210,11,11,0,13332,,13332.0
421570,202210,258,164,94,198769.57,113928,312697.57
421575,202210,28,25,3,30300,3636,33936
421580,202210,742,434,308,527305.99,373298.33,900604.32
421590,202210,20,17,3,20604,3636,24240
421600,202210,181,128,53,155136.6,64236,219372.6
421605,202210,106,70,36,84840.83,43632.2,128473.03
421610,202210,172,127,45,153924.89,54540,208464.89
421620,202210,1084,618,466,751459.82,564804.34,1316264.16
421625,202210,23,20,3,24240.71,3636,27876.71
421630,202210,371,223,148,270280.62,179380.98,449661.60
421635,202210,22,10,12,12120,14544,26664
421640,202210,100,80,20,96961.77,24240,121201.77
421650,202210,327,187,140,226651.65,169682.68,396334.33
421660,202210,2661,1601,1060,1944081.53,1285949.09,3230030.62
421670,202210,163,118,45,143016.31,54540,197556.31
421680,202210,198,180,18,218162.63,21816,239978.63
421690,202210,353,239,114,289670.45,138168.88,427839.33
421700,202210,58,39,19,47268.2,23028.2,70296.4
421710,202210,20,20,0,24240,,24240.0
421715,202210,5,4,1,4848,1212,6060
421720,202210,654,434,220,528440.81,266642.48,795083.29
421725,202210,29,10,19,12120,23028.2,35148.2
421730,202210,24,18,6,21816,7272,29088
421740,202210,114,44,70,53328.6,86052,139380.6
421750,202210,191,139,52,168468.29,63024,231492.29
421755,202210,18,16,2,19392,2424,21816
421760,202210,102,69,33,83628,39996,123624
421770,202210,714,456,258,553890.94,313911.94,867802.88
421775,202210,30,19,11,23028.97,13332,36360.97
421780,202210,190,147,43,179376.91,52116,231492.91
421790,202210,151,129,22,156349.42,26664.66,183014.08
421795,202210,16,13,3,15756.33,3636,19392.33
421800,202210,567,337,230,408457.39,278763.9,687221.29
421810,202210,68,54,14,65448.98,16968,82416.98
421820,202210,309,190,119,230281.65,144228.6,374510.25
421825,202210,155,130,25,157562.86,30300,187862.86
421830,202210,158,98,60,118779.54,72721.12,191500.66
421835,202210,7,2,5,2424.19,6060,8484.19
421840,202210,41,33,8,39996.58,9696,49692.58
421850,202210,76,63,13,76356.5,15756,92112.5
421860,202210,37,27,10,32724,12120,44844
421870,202210,1150,820,330,995075.11,399970.41,1395045.52
421875,202210,48,38,10,46056,12120,58176
421880,202210,191,133,58,161196.75,70297.5,231494.25
421885,202210,20,15,5,18180,6060,24240
421890,202210,160,115,45,139381.26,54540.77,193922.03
421895,202210,47,39,8,47269.02,9696,56965.02
421900,202210,126,95,31,115144.69,37572,152716.69
421910,202210,65,41,24,49692.58,29088,78780.58
421915,202210,29,23,6,27876,7272,35148
421917,202210,49,38,11,46056.5,13332,59388.5
421920,202210,34,29,5,35148,6060,41208
421930,202210,630,505,125,612072.25,151501,763573.25
421935,202210,42,36,6,43632,7272,50904
421940,202210,54,46,8,55752.86,9696,65448.86
421950,202210,923,612,311,742964.36,379358,1122322.36
421960,202210,41,34,7,41208.22,8484,49692.22
421970,202210,332,209,123,253312.16,149077.39,402389.55
421985,202210,19,11,8,13332,9696,23028
422000,202210,9,5,4,6060.67,4848.9,10909.57
430003,202210,186,56,130,67872,157560,225432
430005,202210,32,24,8,29088.67,9696,38784.67
430010,202210,254,182,72,220586.44,87264,307850.44
430020,202210,138,97,41,117564.92,49692,167256.92
430030,202210,122,98,24,118776,29088,147864
430040,202210,2999,1776,1223,2156664.71,1482279.88,3638944.59
430045,202210,71,62,9,75144,10908,86052
430047,202210,6,5,1,6060,1212,7272
430050,202210,88,75,13,90900,15756,106656
430055,202210,13,12,1,14544,1212,15756
430057,202210,5,3,2,3636,2424,6060
430060,202210,4217,2417,1800,2934293.06,2186463.58,5120756.64
430063,202210,51,42,9,50904,10908,61812
430064,202210,173,135,38,163620,46056,209676
430066,202210,6,3,3,3636,3636,7272
430070,202210,46,34,12,41208.45,14544,55752.45
430080,202210,82,52,30,63024,36360,99384
430085,202210,28,13,15,16968,18180,35148
430087,202210,30,24,6,29088.8,7272,36360.8
430090,202210,69,58,11,70296.76,13332,83628.76
430100,202210,146,100,46,122412,55752,178164
430105,202210,168,94,74,113929.84,89688.9,203618.74
430107,202210,17,13,4,15756.53,4848,20604.53
430110,202210,491,267,224,323604.75,272700,596304.75
430120,202210,165,151,14,183012.1,16968,199980.1
430130,202210,819,488,331,592671.14,401172.06,993843.20
430140,202210,136,125,11,151500,13332,164832
430150,202210,112,69,43,83628,52116,135744
430155,202210,30,24,6,29088,7272,36360
430160,202210,3771,2124,1647,2577960.5,1997385.63,4575346.13
430163,202210,428,200,228,242403.9,276338.52,518742.42
430165,202210,33,21,12,25452.59,14544,39996.59
430170,202210,83,69,14,83628.2,16968,100596.2
430175,202210,81,62,19,75144,23028.7,98172.7
430180,202210,108,85,23,103020,27876,130896
430185,202210,27,19,8,23028,9696,32724
430187,202210,80,34,46,41209.7,55752,96961.7
430190,202210,231,117,114,141805.54,138169.59,279975.13
430192,202210,14,10,4,12120,4848,16968
430195,202210,17,13,4,15756,4848,20604
430200,202210,159,133,26,161196.8,31512,192708.8
430205,202210,20,20,0,24240,,24240.0
430210,202210,759,562,197,681152.47,238764.99,919917.46
430215,202210,10,9,1,10908,1212,12120
430220,202210,76,51,25,61812,30300,92112
430222,202210,14,5,9,6060,10908,16968
430223,202210,15,10,5,12120,6060,18180
430225,202210,3,2,1,2424,1212,3636
430230,202210,349,214,135,259370,163620,422990
430235,202210,56,35,21,42420,25452,67872
430237,202210,22,17,5,20604.86,6060,26664.86
430240,202210,116,79,37,95748.22,44844,140592.22
430245,202210,69,55,14,66660,16968,83628
430250,202210,190,109,81,132108,98172.84,230280.84
430258,202210,14,11,3,13332,3636,16968
430260,202210,37,31,6,37572.1,7272,44844.1
430265,202210,36,31,5,37572,6060,43632
430270,202210,532,376,156,455721.07,189072,644793.07
430280,202210,1088,631,457,764776.36,555096.3,1319872.66
430290,202210,455,233,222,282398.3,269064,551462.3
430300,202210,2201,1190,1011,1445939.4,1226555.57,2672494.97
430310,202210,2212,1081,1131,1310195.96,1372005.28,2682201.24
430320,202210,58,46,12,55752,14544,70296
430330,202210,86,73,13,88476.16,15756,104232.16
430340,202210,68,53,15,64236,18180,82416
430350,202210,1693,1075,618,1302910.05,750228.24,2053138.29
430355,202210,19,17,2,20604,2424,23028
430360,202210,100,48,52,58176,63024,121200
430367,202210,51,37,14,44844,16968,61812
430370,202210,61,52,9,63024,10908,73932
430380,202210,112,81,31,98173.74,37572,135745.74
430390,202210,607,371,236,449660.37,286034.4,735694.77
430400,202210,258,177,81,214525.57,98172,312697.57
430410,202210,56,45,11,55752.2,13332,69084.2
430420,202210,538,342,196,414509.95,237552.89,652062.84
430430,202210,49,47,2,56156.8,2424,58580.8
430435,202210,153,114,39,138168,47268,185436
430440,202210,601,368,233,446019.19,282396.7,728415.89
430450,202210,1249,1011,238,1226551.73,288458.17,1515009.90
430460,202210,6090,3100,2990,3762092.05,3632401.74,7394493.79
430461,202210,19,17,2,20604,2424,23028
430462,202210,4,2,2,2424.1,2424,4848.1
430463,202210,1229,655,574,793866.02,695693.97,1489559.99
430465,202210,26,15,11,19392,13332,32724
430466,202210,741,518,223,627831.8,270280.98,898112.78
430467,202210,127,72,55,87265.06,66660,153925.06
430468,202210,148,85,63,103020,76356.41,179376.41
430469,202210,22,16,6,19392,7272,26664
430470,202210,1211,650,561,790587.81,679933.79,1470521.60
430471,202210,74,51,23,61812,27876.57,89688.57
430480,202210,130,92,38,111504.64,46056,157560.64
430485,202210,8,8,0,9696.6,,9696.6
430490,202210,74,58,16,70296,19392,89688
430495,202210,33,23,10,27876,12120,39996
430500,202210,197,133,64,161196.77,77568,238764.77
430510,202210,3965,2574,1391,3123347.5,1690747.92,4814095.42
430511,202210,14,14,0,16968,,16968.0
430512,202210,168,115,53,139381.64,64236.7,203618.34
430513,202210,54,41,13,49692,15756,65448
430515,202210,24,23,1,27876,1212,29088
430517,202210,179,148,31,179376,37572,216948
430520,202210,346,242,104,293305.93,126048.1,419354.03
430530,202210,76,41,35,49692.2,42420,92112.2
430535,202210,466,300,166,364814.45,201193.97,566008.42
430537,202210,9,9,0,10908,,10908.0
430540,202210,81,54,27,65448,32724,98172
430543,202210,425,141,284,172104.96,344208.01,516312.97
430544,202210,52,47,5,56964.79,6060,63024.79
430545,202210,428,208,220,252346.67,266647.06,518993.73
430550,202210,44,36,8,43632.1,9696,53328.1
430558,202210,1,1,0,1212,,1212.0
430560,202210,56,32,24,38784,29088,67872
430570,202210,123,51,72,61812.3,87264,149076.3
430580,202210,127,100,27,121200.2,32724,153924.2
430583,202210,14,14,0,16968,,16968.0
430585,202210,14,11,3,13332,3636,16968
430587,202210,15,9,6,10908,7272.2,18180.2
430590,202210,181,144,37,174529.78,44844,219373.78
430593,202210,1,1,0,1212,,1212.0
430595,202210,16,13,3,15756,3636,19392
430597,202210,42,24,18,29088,21816,50904
430600,202210,220,163,57,198768,69084,267852
430605,202210,178,103,75,124836,90900,215736
430607,202210,29,23,6,27876,7272,35148
430610,202210,1803,853,950,1033841.2,1151405.32,2185246.52
430613,202210,5,5,0,6060,,6060.0
430620,202210,94,68,26,82416,31512,113928
430630,202210,45,39,6,47268.2,7272,54540.2
430632,202210,32,27,5,32724,6060,38784
430635,202210,35,29,6,35148,7272,42420
430637,202210,66,31,35,37572,42420,79992
430640,202210,179,97,82,117564.75,99384.54,216949.29
430642,202210,20,18,2,21816,2424,24240
430645,202210,34,27,7,32724,8484,41208
430650,202210,244,195,49,236340.6,59388,295728.6
430655,202210,5,4,1,4848,1212,6060
430660,202210,1015,502,513,609641.78,621762.44,1231404.22
430670,202210,68,46,22,55752,26664,82416
430673,202210,90,61,29,73932,35148,109080
430675,202210,8,6,2,7272,2424,9696
430676,202210,642,388,254,471471.37,307849.69,779321.06
430680,202210,260,169,91,204828.6,110292,315120.6
430690,202210,564,343,221,415718.44,269065.95,684784.39
430692,202210,8,6,2,7272,2424,9696
430693,202210,141,89,52,107868,63024.2,170892.2
430695,202210,65,52,13,63024,15756,78780
430697,202210,66,42,24,50904,29088,79992
430700,202210,1400,950,450,1152619.65,546613.76,1699233.41
430705,202210,30,26,4,31512,4848,36360
430710,202210,277,172,105,208464,127260,335724
430720,202210,101,84,17,103020,20604,123624
430730,202210,147,125,22,151500,26664,178164
430740,202210,80,49,31,59388,37572,96960
430745,202210,32,17,15,20604,18180,38784
430750,202210,330,215,115,260580.57,140592.87,401173.44
430755,202210,84,47,37,56964,44844,101808
430760,202210,417,232,185,281185.85,225435.4,506621.25
430770,202210,1691,904,787,1095662.1,957487.29,2053149.39
430780,202210,350,222,128,269064.99,155136.19,424201.18
430781,202210,24,24,0,29088,,29088.0
430783,202210,61,48,13,58176,15756,73932
430786,202210,6,4,2,4848,2424,7272
430790,202210,542,346,196,419353.4,237554.95,656908.35
430800,202210,164,124,40,150288,48480,198768
430805,202210,40,33,7,39996,8484.71,48480.71
430807,202210,70,36,34,43632,41208,84840
430810,202210,84,56,28,67872.2,33936.33,101808.53
430820,202210,151,97,54,117564.7,65448,183012.7
430825,202210,11,9,2,10908,2424,13332
430830,202210,267,247,20,300576.8,24240,324816.8
430840,202210,135,88,47,106656,56964,163620
430843,202210,8,4,4,4848,4848,9696
430845,202210,82,49,33,59388.2,39996,99384.2
430850,202210,598,426,172,517525.05,208464,725989.05
430860,202210,170,111,59,134533.13,71508.88,206042.01
430865,202210,75,42,33,50904,39996,90900
430870,202210,70,57,13,69084.36,15756,84840.36
430880,202210,177,122,55,147864.84,66660,214524.84
430885,202210,11,10,1,12120,1212,13332
430890,202210,338,203,135,246037.36,163620,409657.36
430900,202210,542,371,171,452077.57,207252,659329.57
430905,202210,139,60,79,72721.85,95748.99,168470.84
430910,202210,294,157,137,190284.8,166044.8,356329.6
430912,202210,4,4,0,4848,,4848.0
430915,202210,43,40,3,48480,3636,52116
430920,202210,4908,2562,2346,3110054.57,2848245.45,5958300.02
430925,202210,6,5,1,6060,1212,7272
430930,202210,2188,1237,951,1499259.03,1156253.24,2655512.27
430940,202210,272,174,98,210889.35,119988.6,330877.95
430950,202210,154,123,31,149076.65,37572,186648.65
430955,202210,24,14,10,16968,12120,29088
430957,202210,23,20,3,24240,3636,27876
430960,202210,267,170,97,206041.35,117564.2,323605.55
430965,202210,101,64,37,77568,44844,122412
430970,202210,86,70,16,84840,19392,104232
430975,202210,51,45,6,54540,7272,61812
430980,202210,52,31,21,37572.8,25452,63024.8
430990,202210,98,75,23,90900.39,27876,118776.39
430995,202210,109,102,7,123624,8484,132108
431000,202210,298,147,151,178164.9,183012,361176.9
431010,202210,367,216,151,263008.79,183015.82,446024.61
431020,202210,1965,1133,832,1374414.16,1009599.03,2384013.19
431030,202210,40,32,8,38784,9696,48480
431033,202210,490,224,266,271497.25,323615.72,595112.97
431036,202210,12,8,4,9696,4848,14544
431040,202210,147,98,49,118776.55,59388,178164.55
431041,202210,42,24,18,29088,21816,50904
431043,202210,40,23,17,27876,20604,48480
431046,202210,13,10,3,12120,3636,15756
431050,202210,204,123,81,149076.97,98172,247248.97
431053,202210,77,41,36,49692.95,43632.62,93325.57
431055,202210,65,44,21,53328,25452,78780
431057,202210,18,18,0,21816,,21816.0
431060,202210,1614,1035,579,1255639.36,701749.8,1957389.16
431065,202210,15,7,8,8484,9696,18180
431070,202210,66,57,9,69084,10908,79992
431075,202210,8,8,0,9696,,9696.0
431080,202210,131,74,57,89688.19,69084,158772.19
431085,202210,35,31,4,37572,4848,42420
431087,202210,16,13,3,15756.6,3636,19392.6
431090,202210,52,40,12,48480.2,14544,63024.2
431100,202210,1302,776,526,941736.27,637516.1,1579252.37
431110,202210,226,134,92,162410.15,111504,273914.15
431112,202210,30,23,7,27876,8484,36360
431113,202210,29,21,8,25452,9696,35148
431115,202210,158,111,47,134532,58176,192708
431120,202210,603,350,253,424203.34,306636.2,730839.54
431123,202210,4,4,0,4848,,4848.0
431125,202210,98,85,13,103020,15756,118776
431127,202210,5,3,2,3636,2424,6060
431130,202210,731,475,256,575703.1,310273.92,885977.02
431140,202210,822,582,240,706601.74,290880.7,997482.44
431142,202210,20,18,2,21816.84,2424,24240.84
431150,202210,203,149,54,180590.01,65448,246038.01
431160,202210,44,40,4,48480,4848,53328
431162,202210,6,6,0,7272.67,,7272.67
431164,202210,4,4,0,4848,,4848.0
431170,202210,117,82,35,99384.2,42420,141804.2
431171,202210,76,44,32,53328.2,38784,92112.2
431173,202210,8,6,2,7272,2424.8,9696.8
431175,202210,206,109,97,132108.2,117564.15,249672.35
431177,202210,98,71,27,86052.22,32724.31,118776.53
431179,202210,15,11,4,13332.19,4848,18180.19
431180,202210,408,248,160,300820.34,193920.76,494741.10
431190,202210,72,52,20,63024,24240.7,87264.7
431198,202210,74,50,24,60473.95,29088,89561.95
431200,202210,21,17,4,20604,4848,25452
431205,202210,22,20,2,24240,2424,26664
431210,202210,103,62,41,75144,49692,124836
431213,202210,32,26,6,31512,7272.56,38784.56
431215,202210,22,21,1,25452,1212,26664
431217,202210,5,4,1,4848,1212,6060
431220,202210,68,57,11,69084.73,13332,82416.73
431225,202210,165,103,62,124836.91,75144,199980.91
431230,202210,101,84,17,101808.1,20604,122412.1
431235,202210,5,4,1,4848,1212,6060
431237,202210,15,9,6,10908,7272,18180
431238,202210,13,9,4,10908,4848.2,15756.2
431240,202210,1153,710,443,861744.95,536918.86,1398663.81
431242,202210,41,40,1,48480,1212,49692
431244,202210,30,24,6,29088.2,7272,36360.2
431245,202210,52,35,17,42420,20604,63024
431247,202210,14,10,4,12120,4848,16968
431250,202210,290,142,148,172104,179376,351480
431260,202210,54,46,8,55752,9696,65448
431261,202210,19,14,5,16968,6060,23028
431262,202210,14,11,3,13332.89,3636.07,16968.96
431265,202210,152,83,69,100596.77,83628,184224.77
431267,202210,17,15,2,18180,2424,20604
431270,202210,335,258,77,312700.55,93324.13,406024.68
431275,202210,39,35,4,42420,4848,47268
431280,202210,21,15,6,18180,7272,25452
431290,202210,24,21,3,25452,3636,29088
431295,202210,4,1,3,1212,3636,4848
431300,202210,22,19,3,23028,3636,26664
431301,202210,7,7,0,8484,,8484.0
431303,202210,58,37,21,44844,25452,70296
431306,202210,248,128,120,155136.05,145440,300576.05
431308,202210,8,6,2,7272,2424,9696
431310,202210,62,47,15,58176,18180,76356
431320,202210,202,122,80,147864,96960,244824
431330,202210,212,140,72,169680,87264,256944
431333,202210,27,22,5,26664.2,6060,32724.2
431335,202210,9,6,3,7272,3636,10908
431337,202210,431,206,225,249677.99,272700.95,522378.94
431339,202210,21,15,6,18180,7272,25452
431340,202210,3224,1727,1497,2096684.89,1816797.4,3913482.29
431342,202210,32,22,10,26664,12120,38784
431344,202210,19,19,0,23028,,23028.0
431346,202210,5,4,1,4848,1212,6060
431349,202210,27,25,2,31512,2424,33936
431350,202210,1145,617,528,747815.26,639938.04,1387753.30
431360,202210,54,40,14,48480,16968,65448
431365,202210,384,161,223,195133,270276.4,465409.4
431370,202210,1222,685,537,830347.29,652058.02,1482405.31
431380,202210,99,88,11,106656,13332,119988
431390,202210,502,270,232,327240.15,281184.8,608424.95
431395,202210,337,149,188,180588.39,227856,408444.39
431400,202210,38,25,13,30300,15756,46056
431402,202210,99,73,26,88476,31512.8,119988.8
431403,202210,28,19,9,23028,10908,33936
431405,202210,742,428,314,518738.65,380571.18,899309.83
431406,202210,37,28,9,33936,10908,44844
431407,202210,48,37,11,44844,13332,58176
431410,202210,3598,2202,1396,2672488.48,1693176.78,4365665.26
431413,202210,15,12,3,14544,4848,19392
431415,202210,73,50,23,60600.65,27876,88476.65
431417,202210,23,12,11,14544,13332,27876
431420,202210,369,239,130,290885.35,157560,448445.35
431430,202210,68,33,35,39996.89,42420,82416.89
431440,202210,9471,6389,3082,7744854.26,3742747.95,11487602.21
431442,202210,25,13,12,15756,14544,30300
431445,202210,27,26,1,31512,1212,32724
431446,202210,3,3,0,3636,,3636.0
431447,202210,84,62,22,75144,26664,101808
431449,202210,60,47,13,56964.4,15756,72720.4
431450,202210,429,282,147,341784.33,178164,519948.33
431454,202210,11,6,5,7272,6060,13332
431455,202210,47,39,8,47268.03,9696,56964.03
431460,202210,512,345,167,419356.8,202404,621760.8
431470,202210,140,102,38,123624,46056,169680
431475,202210,11,9,2,10908.1,2424,13332.1
431477,202210,40,23,17,27876,20604,48480
431478,202210,7,7,0,8484,,8484.0
431480,202210,624,374,250,453290.72,303000.7,756291.42
431490,202210,31031,17346,13685,21039291.58,16611846.82,37651138.40
431500,202210,78,61,17,73932,20604,94536
431505,202210,27,18,9,21816,10908,32724
431507,202210,10,8,2,9696,2424,12120
431510,202210,235,166,69,201192.4,83628,284820.4
431513,202210,20,19,1,23028,1212,24240
431514,202210,6,4,2,4848,2424,7272
431515,202210,86,73,13,88476.14,15756.1,104232.24
431517,202210,7,4,3,4848,3636,8484
431520,202210,39,32,7,38784,8484,47268
431530,202210,1433,622,811,753867.63,982932.43,1736800.06
431531,202210,22,21,1,25452,1212,26664
431532,202210,36,27,9,32724,10908,43632
431535,202210,30,16,14,19392,16968,36360
431540,202210,141,112,29,135744.1,35148.6,170892.7
431545,202210,14,11,3,13332,3636,16968
431550,202210,353,185,168,224221.51,203617.72,427839.23
431555,202210,14,13,1,15756,1212,16968
431560,202210,5006,3307,1699,4011809.13,2061648.61,6073457.74
431570,202210,863,460,403,557525.84,489653.68,1047179.52
431575,202210,54,31,23,38784,27876.58,66660.58
431580,202210,81,55,26,67872,31512,99384
431590,202210,144,122,22,149076,26664,175740
431595,202210,16,14,2,16968,2424,19392
431600,202210,255,148,107,179380.64,129685.21,309065.85
431610,202210,115,85,30,103020.4,36360.8,139381.2
431620,202210,41,33,8,39996,9696,49692
431630,202210,125,102,23,123624.81,27876.6,151501.41
431640,202210,1325,824,501,998695.27,607214.21,1605909.48
431642,202210,31,29,2,35148,2424,37572
431643,202210,44,17,27,20604,32724,53328
431645,202210,329,192,137,232704.94,166044,398748.94
431647,202210,10,9,1,10908,1212,12120
431650,202210,37,21,16,25452,19392,44844
431660,202210,268,169,99,206040,119988,326028
431670,202210,225,98,127,118776.79,153924.99,272701.78
431673,202210,14,12,2,14544,2424,16968
431675,202210,25,19,6,24240,7272,31512
431680,202210,1190,860,330,1042333.93,401177.27,1443511.20
431690,202210,5120,3012,2108,3655451.34,2557357.18,6212808.52
431695,202210,18,12,6,14544,7272,21816
431697,202210,4,2,2,2424,2424,4848
431700,202210,192,143,49,173316.55,59388,232704.55
431710,202210,4216,1809,2407,2194957.23,2917293.8,5112251.03
431720,202210,1299,795,504,964153.03,610849,1575002.03
431725,202210,3,1,2,1212,2424,3636
431730,202210,1232,819,413,992900.34,500565.6,1493465.94
431740,202210,1376,670,706,812045.36,856887.52,1668932.88
431750,202210,1868,1217,651,1476229.73,790230.78,2266460.51
431755,202210,5,4,1,4848,1212,6060
431760,202210,1001,630,371,764783.76,450869.51,1215653.27
431770,202210,418,282,136,341785.5,164832,506617.5
431775,202210,26,19,7,23028,8484,31512
431780,202210,572,345,227,419352.57,275124,694476.57
431790,202210,151,115,36,139380.82,43632,183012.82
431795,202210,13,10,3,12120,3636,15756
431800,202210,3158,1654,1504,2007086.22,1830127.07,3837213.29
431805,202210,18,15,3,18180,3636,21816
431810,202210,583,377,206,458136.94,250884.4,709021.34
431820,202210,349,200,149,242401.49,180588,422989.49
431830,202210,2383,1434,949,1738021.92,1151402.47,2889424.39
431840,202210,506,318,188,385422.9,229068.8,614491.7
431842,202210,35,29,6,35148,7272,42420
431843,202210,10,7,3,8484.1,3636.8,12120.9
431844,202210,18,13,5,15756,6060,21816
431845,202210,26,24,2,29088,2424,31512
431846,202210,27,23,4,27876,4848,32724
431848,202210,15,11,4,13332.71,4848,18180.71
431849,202210,6,5,1,6060,1212,7272
431850,202210,810,634,176,769632.3,213313.72,982946.02
431860,202210,122,78,44,94536.75,53328,147864.75
431861,202210,4,0,4,,4848,4848.0
431862,202210,65,47,18,56964,21816,78780
431870,202210,3946,2260,1686,2739160.09,2047083.24,4786243.33
431880,202210,1007,697,310,845978.93,375720.89,1221699.82
431890,202210,1265,727,538,881127.41,652057.08,1533184.49
431900,202210,195,130,65,157560.2,78780,236340.2
431910,202210,45,35,10,42420,12120,54540
431912,202210,50,32,18,38784,21816,60600
431915,202210,150,113,37,136956.95,44844,181800.95
431920,202210,155,111,44,134532.1,53328,187860.1
431930,202210,74,59,15,71508,18180,89688
431935,202210,3,2,1,2424,1212,3636
431936,202210,2,2,0,2424,,2424.0
431937,202210,21,16,5,19392.63,6060,25452.63
431940,202210,470,321,149,389055.66,180588.27,569643.93
431950,202210,491,313,178,381784.2,215736.37,597520.57
431960,202210,753,408,345,494499.46,418141.4,912640.86
431970,202210,64,58,6,70296,7272,77568
431971,202210,4,4,0,4848,,4848.0
431973,202210,22,19,3,23028.9,3636,26664.9
431975,202210,10,10,0,12120,,12120.0
431980,202210,207,117,90,141805.9,109080,250885.9
431990,202210,1108,586,522,711373.08,635095.09,1346468.17
432000,202210,1988,1056,932,1279895.97,1130808.45,2410704.42
432010,202210,265,170,95,206040.18,115140.2,321180.38
432020,202210,190,161,29,195134.57,35148.87,230283.44
432023,202210,15,12,3,14544,3636,18180
432026,202210,63,54,9,65448,10908,76356
432030,202210,56,24,32,29088.98,38784,67872.98
432032,202210,15,12,3,14544,3636,18180
432035,202210,65,49,16,59388.5,19392,78780.5
432040,202210,88,61,27,73932,32724,106656
432045,202210,3,3,0,3636,,3636.0
432050,202210,80,48,32,58176,38784.6,96960.6
432055,202210,129,90,39,109080,47268,156348
432057,202210,6,4,2,4848.6,2424,7272.6
432060,202210,32,28,4,33936,4848,38784
432065,202210,31,27,4,32724,4848,37572
432067,202210,85,78,7,94536.5,8484,103020.5
432070,202210,386,303,83,369661.73,100596,470257.73
432080,202210,849,596,253,722360.97,306638.45,1028999.42
432085,202210,20,15,5,18180,6060,24240
432090,202210,280,182,98,221796.6,118776,340572.6
432100,202210,172,110,62,133320,75144,208464
432110,202210,574,377,197,456925.56,241189.58,698115.14
432120,202210,1068,600,468,729630.49,567221.43,1296851.92
432130,202210,521,371,150,450864.38,181800.95,632665.33
432132,202210,22,20,2,24240,2424,26664
432135,202210,79,64,15,77568,18180,95748
432140,202210,263,198,65,239977.56,78780.71,318758.27
432143,202210,233,141,92,170892.59,111504.85,282397.44
432145,202210,296,210,86,255732,105444,361176
432146,202210,16,14,2,16968,2424,19392
432147,202210,100,60,40,73932,48480,122412
432149,202210,17,12,5,14544,6060,20604
432150,202210,1082,668,414,809625.24,504196.83,1313822.07
432160,202210,1829,943,886,1142928.28,1073841.15,2216769.43
432162,202210,5,2,3,2424,3636,6060
432163,202210,15,10,5,12120,6060,18180
432166,202210,128,88,40,106959.2,48480.4,155439.6
432170,202210,236,125,111,151501.69,134533.58,286035.27
432180,202210,587,376,211,455712,255732,711444
432183,202210,11,10,1,12120.1,1212,13332.1
432185,202210,82,67,15,81204,18180.17,99384.17
432190,202210,525,316,209,382992.37,253308.8,636301.17
432195,202210,92,73,19,88476,23028,111504
432200,202210,437,267,170,323605.42,206040.83,529646.25
432210,202210,121,72,49,87264,59388,146652
432215,202210,31,29,2,35148,2424,37572
432218,202210,19,19,0,23028,,23028.0
432220,202210,654,331,323,401173.09,392691.39,793864.48
432225,202210,19,13,6,15756.2,7272,23028.2
432230,202210,129,84,45,101808,54540,156348
432232,202210,27,24,3,29088,3636,32724
432234,202210,4,2,2,2424,2424,4848
432235,202210,1,1,0,1212,,1212.0
432237,202210,23,15,8,18180,9696,27876
432240,202210,4688,2632,2056,3191254.86,2494324.17,5685579.03
432250,202210,1167,775,392,939302.43,476317.58,1415620.01
432252,202210,50,48,2,58176,2424,60600
432253,202210,69,54,15,65449.01,18180,83629.01
432254,202210,31,15,16,18180,19392,37572
432255,202210,11,10,1,12120,1212,13332
432260,202210,890,710,180,860525.3,218160.1,1078685.4
432270,202210,218,160,58,193924.22,71508.75,265432.97
432280,202210,164,121,43,146654.33,52116,198770.33
432285,202210,1,1,0,1212,,1212.0
432290,202210,58,48,10,58176,12120,70296
432300,202210,5255,2803,2452,3398404.53,2976693.72,6375098.25
432310,202210,131,111,20,134532.89,24240,158772.89
432320,202210,20,15,5,18180,6060,24240
432330,202210,18,12,6,14544,7272,21816
432335,202210,10,8,2,9696,2424,12120
432340,202210,34,27,7,32724,8484,41208
432345,202210,122,79,43,95748.3,52116,147864.3
432350,202210,24,23,1,27876,1212,29088
432360,202210,5,4,1,4848,1212,6060
432370,202210,25,25,0,30300.48,,30300.48
432375,202210,27,25,2,30300.66,2424,32724.66
432377,202210,6,6,0,7272,,7272.0
432380,202210,212,98,114,118776.8,138169.7,256946.5
500020,202210,294,155,139,187863.5,168468.39,356331.89
500025,202210,147,68,79,82416.4,95749.12,178165.52
500060,202210,1539,981,558,1188993.54,677518.86,1866512.40
500070,202210,784,381,403,461781.93,488446.52,950228.45
500080,202210,140,111,29,134535.79,35148,169683.79
500085,202210,138,101,37,122413.07,44844,167257.07
500090,202210,401,187,214,226645.31,259369.25,486014.56
500100,202210,718,365,353,443602.02,429053.68,872655.70
500110,202210,2402,1148,1254,1392615.82,1522294.89,2914910.71
500124,202210,272,144,128,175740.94,155137.41,330878.35
500150,202210,323,134,189,162409.98,229069.14,391479.12
500190,202210,592,393,199,476326.37,241189.29,717515.66
500200,202210,208,172,36,208467.68,43632,252099.68
500210,202210,1770,567,1203,687214.96,1459263.19,2146478.15
500215,202210,205,119,86,144231.2,104233.2,248464.4
500220,202210,735,463,272,561174.03,329667.24,890841.27
500230,202210,246,141,105,170893.87,127262.42,298156.29
500240,202210,675,426,249,516321.12,301791.51,818112.63
500260,202210,627,252,375,305427.29,455712.82,761140.11
500270,202210,31993,13885,18108,16842567.84,21964228.26,38806796.10
500280,202210,204,69,135,83628.48,164833.36,248461.84
500290,202210,1219,768,451,933255.99,549038.07,1482294.06
500295,202210,485,316,169,382998.88,206041.09,589039.97
500310,202210,117,41,76,49692.1,92113.14,141805.24
500315,202210,865,472,393,572065.57,476317.01,1048382.58
500320,202210,3804,1786,2018,2165895.8,2447045.36,4612941.16
500325,202210,965,538,427,652081.03,517529.52,1169610.55
500330,202210,1573,760,813,921077.31,985370.96,1906448.27
500345,202210,319,227,92,275126.79,111504.21,386631.00
500348,202210,252,155,97,187861.8,117564.6,305426.4
500350,202210,109,53,56,64236.71,67872,132108.71
500370,202210,6051,2746,3305,3330638.25,4009336.13,7339974.38
500375,202210,370,245,125,296942.98,151500,448442.98
500380,202210,666,373,293,452087.1,355119.35,807206.45
500390,202210,73,31,42,37572.39,50904.8,88477.19
500400,202210,228,144,84,174530.87,101808.12,276338.99
500410,202210,488,207,281,252103.42,340576.63,592680.05
500430,202210,607,395,212,478748.35,256945.92,735694.27
500440,202210,217,120,97,145440.1,117564.2,263004.3
500450,202210,444,192,252,232706.55,306636.8,539343.35
500460,202210,284,153,131,185439.23,159984,345423.23
500470,202210,439,317,122,384210.97,149077.5,533288.47
500480,202210,106,58,48,70296.29,58176.5,128472.79
500490,202210,96,40,56,48480.68,67874.16,116354.84
500500,202210,1520,559,961,677519.48,1165953.07,1843472.55
500510,202210,39,32,7,38784.4,8484,47268.4
500515,202210,123,80,43,96962.42,52116.78,149079.20
500520,202210,292,150,142,181805.42,174528.16,356333.58
500525,202210,102,52,50,63024,60600,123624
500540,202210,931,402,529,487238.1,641154.38,1128392.48
500560,202210,903,502,401,609648.29,486016.62,1095664.91
500568,202210,1095,535,560,648432.11,678724.52,1327156.63
500570,202210,1247,710,537,860534.7,653272.92,1513807.62
500580,202210,321,174,147,210892.89,178166.07,389058.96
500600,202210,388,188,200,227859.19,242402.9,470262.09
500620,202210,1011,689,322,835083.66,390267.42,1225351.08
500625,202210,81,65,16,78780.4,19392,98172.4
500627,202210,40,17,23,20604.15,27876,48480.15
500630,202210,1624,929,695,1125462.5,843558.29,1969020.79
500635,202210,512,303,209,368448.44,253308,621756.44
500640,202210,376,206,170,249678.44,206042.3,455720.74
500660,202210,6160,2203,3957,2673702.53,4801970.78,7475673.31
500690,202210,640,232,408,281186.92,494496.24,775683.16
500710,202210,420,208,212,252101.94,256947.12,509049.06
500720,202210,986,533,453,646007.42,550249.91,1196257.33
500730,202210,149,91,58,110298.04,70296,180594.04
500740,202210,1004,427,577,517533.73,699330.99,1216864.72
500750,202210,198,74,124,89689.66,150288.7,239978.36
500755,202210,111,86,25,105446.96,30300.93,135747.89
500769,202210,759,415,344,502987.94,419356.58,922344.52
500770,202210,429,226,203,273912.5,246036,519948.5
500780,202210,137,94,43,113932.3,52116.63,166048.93
500790,202210,1127,545,582,660549.73,705390.38,1365940.11
500793,202210,299,155,144,187860.7,174531.66,362392.36
500795,202210,190,125,65,151501.84,78780.79,230282.63
500797,202210,49,33,16,39996,19392,59388
500800,202210,448,192,256,232706.71,311485.93,544192.64
500830,202210,2430,1292,1138,1565939.92,1380481.77,2946421.69
500840,202210,120,86,34,104237.44,41208,145445.44
510010,202210,172,94,78,113928,94536,208464
510020,202210,567,263,304,321184.73,370875.11,692059.84
510025,202210,1792,1006,786,1219298.22,953853.45,2173151.67
510030,202210,677,354,323,429062.12,393903.76,822965.88
510035,202210,135,69,66,83628.26,79992,163620.26
510040,202210,421,199,222,241189.14,269066.28,510255.42
510050,202210,391,208,183,252101.21,223010.49,475111.70
510060,202210,131,61,70,73934.25,84840,158774.25
510080,202210,261,108,153,130896.93,185436.6,316333.53
510100,202210,68,27,41,32724.8,49692.7,82417.5
510120,202210,33,19,14,23028.99,16968.8,39997.79
510125,202210,405,258,147,312698.55,178164,490862.55
510130,202210,548,322,226,393907.52,273913.6,667821.12
510140,202210,462,153,309,185436.74,374509.28,559946.02
510160,202210,108,42,66,50904,79993.09,130897.09
510170,202210,790,468,322,567221.43,390268.89,957490.32
510180,202210,3069,1397,1672,1693195.24,2027697.18,3720892.42
510185,202210,31,14,17,16968,20604,37572
510190,202210,256,91,165,110294.43,201192.8,311487.23
510250,202210,2806,1709,1097,2073761.25,1331995.97,3405757.22
510260,202210,170,121,49,146654.6,59388.79,206043.39
510263,202210,504,283,221,342998.14,267854.78,610852.92
510267,202210,622,340,282,412087.96,341787.49,753875.45
510268,202210,73,35,38,42420.17,46056,88476.17
510269,202210,79,37,42,44844,50904.8,95748.8
510270,202210,389,184,205,223009.7,248460,471469.7
510279,202210,208,154,54,186648.71,65448,252096.71
510285,202210,190,77,113,93324.05,136956,230280.05
510300,202210,537,278,259,336939.67,313908.56,650848.23
510305,202210,197,88,109,106656.75,132108,238764.75
510310,202210,108,57,51,69084.2,61812.1,130896.3
510320,202210,842,521,321,631457.98,389052.72,1020510.70
510325,202210,453,194,259,235129.13,313909.45,549038.58
510330,202210,459,252,207,305427.9,250885.53,556313.43
510335,202210,688,397,291,481174.7,353905.23,835079.93
510336,202210,55,37,18,44844.72,21816.15,66660.87
510337,202210,102,43,59,53328,71508,124836
510340,202210,19115,8203,10912,9944724,13237674.87,23182398.87
510343,202210,63,48,15,58176,18180,76356
510345,202210,156,98,58,119988.57,70297.28,190285.85
510350,202210,662,350,312,425419.51,380570.07,805989.58
510360,202210,222,139,83,168469.62,100596,269065.62
510370,202210,174,76,98,92112,118776,210888
510380,202210,82,60,22,72720.52,26664,99384.52
510385,202210,62,31,31,37572.2,37572,75144.2
510390,202210,102,48,54,58176.09,65448.37,123624.46
510395,202210,57,40,17,48480,20604,69084
510410,202210,815,514,301,622983.6,367239.88,990223.48
510420,202210,571,277,294,336939.11,356328,693267.11
510450,202210,53,28,25,33936,30300,64236
510452,202210,61,29,32,35148,38784,73932
510454,202210,55,25,30,30300.2,36360.08,66660.28
510455,202210,121,71,50,86052.2,60600,146652.2
510460,202210,201,84,117,101811.47,141804.2,243615.67
510480,202210,774,454,320,550258,387842.71,938100.71
510490,202210,349,166,183,202404.97,221796.5,424201.47
510500,202210,238,177,61,214524.38,73932,288456.38
510510,202210,888,518,370,627824.79,449656.29,1077481.08
510515,202210,1320,677,643,820534.5,779321.49,1599855.99
510517,202210,281,122,159,147866.87,192708.9,340575.77
510520,202210,233,146,87,176953.28,105444.37,282397.65
510523,202210,116,91,25,110817.98,31512,142329.98
510525,202210,917,566,351,686003.67,425415.78,1111419.45
510530,202210,27,16,11,19392,13332,32724
510550,202210,249,115,134,139381.31,162409.25,301790.56
510558,202210,324,161,163,195363.74,197556,392919.74
510560,202210,391,223,168,270278.72,203618.95,473897.67
510562,202210,683,481,202,582981.33,244826.11,827807.44
510590,202210,741,360,381,436326.92,462986.61,899313.53
510600,202210,226,117,109,141808.52,132108.99,273917.51
510610,202210,225,101,124,122415.8,151500.6,273916.4
510615,202210,232,110,122,133320.38,147864.8,281185.18
510617,202210,27,11,16,13332,19392,32724
510618,202210,131,63,68,76356,82417.19,158773.19
510619,202210,82,58,24,70296,29088,99384
510620,202210,167,90,77,109080.52,94536,203616.52
510621,202210,183,114,69,138168.25,83628.23,221796.48
510622,202210,515,272,243,329675.33,295731.37,625406.70
510623,202210,291,198,93,239979.3,112716,352695.3
510624,202210,93,46,47,55753.56,58176.53,113930.09
510625,202210,542,340,202,412089.91,244827.15,656917.06
510626,202210,123,72,51,88478.85,61812,150290.85
510627,202210,94,63,31,76357.12,37572.2,113929.32
510628,202210,168,101,67,122413.25,81204,203617.25
510629,202210,295,178,117,215736.87,141825.81,357562.68
510630,202210,464,239,225,289672.77,272701.22,562373.99
510631,202210,22,9,13,10908.13,15756,26664.13
510637,202210,366,212,154,258157.03,186648,444805.03
510642,202210,1183,628,555,762364.04,673879.69,1436243.73
510645,202210,10,1,9,1212,10908,12120
510650,202210,1326,855,471,1036291.42,570855.72,1607147.14
510665,202210,94,45,49,54540.19,59388,113928.19
510670,202210,59,34,25,41208.6,30300,71508.6
510675,202210,1126,727,399,882350.5,483592.23,1365942.73
510677,202210,344,181,163,219374.04,197556.78,416930.82
510680,202210,88,56,32,67873,38784,106657
510682,202210,190,95,95,115140.52,115140,230280.52
510685,202210,56,40,16,48480,19392,67872
510700,202210,602,337,265,408453.02,321180.72,729633.74
510704,202210,1292,646,646,782974.89,785389.96,1568364.85
510706,202210,164,83,81,100597.99,98172.83,198770.82
510710,202210,439,303,136,367241.81,166045.2,533287.01
510715,202210,59,41,18,49692.19,21816.64,71508.83
510718,202210,250,110,140,133321.5,169683.84,303005.34
510719,202210,48,20,28,24240,33936.2,58176.2
510720,202210,186,131,55,159339.12,66660,225999.12
510724,202210,83,30,53,36360,64236,100596
510726,202210,67,32,35,38784.7,42420,81204.7
510729,202210,15,6,9,7272,10908.1,18180.1
510730,202210,464,253,211,306637.48,255732,562369.48
510735,202210,114,46,68,55752.1,82416,138168.1
510740,202210,24,13,11,15756.42,13332.12,29088.54
510757,202210,31,25,6,30301.27,7272.16,37573.43
510760,202210,7888,3972,3916,4816581.67,4752294.48,9568876.15
510770,202210,741,336,405,407236.98,490861.1,898098.08
510774,202210,19,7,12,8484,14544,23028
510775,202210,120,91,29,110292,35148,145440
510776,202210,38,12,26,14544,31512.2,46056.2
510777,202210,190,84,106,101808,129684,231492
510779,202210,39,24,15,29088,18180,47268
510780,202210,270,142,128,172108.29,155136.66,327244.95
510785,202210,355,193,162,233919.24,196345.52,430264.76
510787,202210,206,98,108,118778.92,130896.9,249675.82
510788,202210,8,4,4,4848.2,4848,9696.2
510790,202210,2741,1409,1332,1710211.04,1616816.48,3327027.52
510792,202210,1158,641,517,776909.41,632676.04,1409585.45
510794,202210,116,64,52,77568.12,64236,141804.12
510795,202210,2398,1366,1032,1655618.4,1254427.74,2910046.14
510800,202210,200,113,87,136957.77,106656.14,243613.91
510805,202210,212,139,73,168468,88476.2,256944.2
510810,202210,108,44,64,53329.22,77568.42,130897.64
510820,202210,265,131,134,158773.68,162410.09,321183.77
510830,202210,79,40,39,48480,47268,95748
510835,202210,22,15,7,18180,8484,26664
510840,202210,9665,4386,5279,5320823.77,6406708.99,11727532.76
510850,202210,213,82,131,100597.39,158772,259369.39
510860,202210,415,206,209,249673.66,253308.62,502982.28
510880,202210,73,52,21,63024.2,25452,88476.2
510885,202210,73,43,30,52116.24,36360,88476.24
510890,202210,76,38,38,46056.86,46056.6,92113.46
510895,202210,177,103,74,126050.88,89688,215738.88
520005,202210,160,62,98,75145.14,118777.39,193922.53
520010,202210,313,135,178,163621.77,218164.01,381785.78
520013,202210,755,513,242,621767.58,293307.15,915074.73
520015,202210,40,27,13,32724,15756,48480
520017,202210,84,52,32,63024,38784,101808
520020,202210,12,5,7,6060,8484,14544
520025,202210,2978,1579,1399,1915020.74,1695628.03,3610648.77
520030,202210,869,452,417,548133.88,505407.75,1053541.63
520050,202210,64,48,16,58176,19392.03,77568.03
520055,202210,80,53,27,64236,32724,96960
520060,202210,174,116,58,140595.36,70297.45,210892.81
520080,202210,570,406,164,492075.91,198768,690843.91
520082,202210,17,12,5,14544,6060,20604
520085,202210,107,81,26,98173.74,31512.2,129685.94
520090,202210,84,60,24,72720,29088,101808
520110,202210,9601,4055,5546,4914739.55,6729081.18,11643820.73
520120,202210,11,5,6,6060,7272,13332
520130,202210,864,596,268,722359.67,324817.83,1047177.50
520140,202210,12465,6786,5679,8228462.48,6887866.69,15116329.17
520145,202210,53,31,22,37572.2,26664,64236.2
520150,202210,143,112,31,135746.94,37572,173318.94
520160,202210,43,26,17,31512,20604,52116
520170,202210,219,125,94,151504.82,113931.94,265436.76
520180,202210,203,95,108,115140.8,130896.63,246037.43
520215,202210,197,136,61,164832.97,73932.2,238765.17
520235,202210,84,63,21,76356,25452.11,101808.11
520250,202210,147,80,67,96960.64,81204,178164.64
520260,202210,120,73,47,88477.74,56964.99,145442.73
520280,202210,49,34,15,41208,18180,59388
520310,202210,21,13,8,15756.9,9696.2,25453.1
520320,202210,185,110,75,133322.01,93324.97,226646.98
520330,202210,865,478,387,579343.37,469048.66,1048392.03
520340,202210,304,179,125,216951.65,151503.07,368454.72
520350,202210,494,249,245,301791.7,299365.91,601157.61
520355,202210,104,59,45,71509.72,54540,126049.72
520357,202210,33,27,6,32724,7272,39996
520360,202210,14,5,9,6060,10908,16968
520380,202210,145,79,66,95748,79992,175740
520390,202210,240,108,132,130898.53,159984,290882.53
520393,202210,16,12,4,14544,4848,19392
520396,202210,75,54,21,65448,25452,90900
520400,202210,207,127,80,153928.84,96961.71,250890.55
520410,202210,192,97,95,117566.4,115140.2,232706.6
520420,202210,19,13,6,15756,7272,23028
520425,202210,253,124,129,150288.82,156348.59,306637.41
520430,202210,535,255,280,309061.73,339360.5,648422.23
520440,202210,654,467,187,567227.25,227857.51,795084.76
520450,202210,2236,940,1296,1139297.2,1571975.14,2711272.34
520455,202210,66,39,27,47269.88,33936.2,81206.08
520460,202210,47,28,19,33936.19,23028.75,56964.94
520465,202210,35,29,6,35148,7272,42420
520470,202210,455,287,168,347845.3,204828,552673.3
520480,202210,78,47,31,56965.05,37572,94537.05
520485,202210,113,43,70,52116.72,84840.1,136956.82
520490,202210,486,350,136,424207.54,164835.03,589042.57
520495,202210,163,96,67,116352.1,81204,197556.1
520500,202210,189,148,41,179377.45,50904,230281.45
520505,202210,195,113,82,136956,99384,236340
520510,202210,2050,965,1085,1169590.66,1316241.62,2485832.28
520520,202210,62,39,23,47268.69,27876,75144.69
520530,202210,207,164,43,198771.63,52116,250887.63
520540,202210,758,506,252,613277.15,306637.2,919914.35
520545,202210,150,85,65,103022.7,79992,183014.7
520547,202210,70,36,34,43633.19,41209.04,84842.23
520549,202210,1533,732,801,887208.76,970823.35,1858032.11
520551,202210,341,172,169,209678.69,206040.6,415719.29
520552,202210,43,29,14,35148.9,16968,52116.9
520570,202210,14,9,5,10908,6060,16968
520580,202210,275,171,104,207253.38,126048.36,333301.74
520590,202210,148,81,67,99386.03,81204,180590.03
520620,202210,1250,580,670,702966.87,812046.31,1515013.18
520630,202210,49,28,21,33936,25452,59388
520640,202210,384,225,159,272701.41,192708.39,465409.80
520650,202210,69,34,35,41208.07,43632,84840.07
520660,202210,42,21,21,25452.42,25452.38,50904.80
520670,202210,49,38,11,46056.58,13332,59388.58
520680,202210,27,16,11,19392,13332,32724
520690,202210,39,11,28,13332,33936,47268
520710,202210,34,29,5,35148,6060,41208
520725,202210,195,145,50,175743.34,60600,236343.34
520735,202210,58,38,20,46056.2,24240.2,70296.4
520740,202210,485,234,251,286036.23,304212,590248.23
520750,202210,35,22,13,27835.6,15756,43591.6
520753,202210,81,59,22,71508,26664,98172
520760,202210,101,66,35,79992.2,42420.1,122412.3
520780,202210,271,210,61,254522.6,73933.28,328455.88
520790,202210,155,97,58,117564,70296,187860
520800,202210,3526,1968,1558,2388901.15,1890742.73,4279643.88
520810,202210,141,109,32,133160.48,38784.89,171945.37
520815,202210,6,4,2,4848.36,2424,7272.36
520830,202210,136,92,44,111506.32,53328.9,164835.22
520840,202210,402,260,142,315122.19,173316,488438.19
520850,202210,112,63,49,76356.67,59388,135744.67
520860,202210,1847,1164,683,1410791.55,831437.6,2242229.15
520870,202210,34130,15442,18688,18723438.45,22674319.6,41397758.05
520880,202210,1293,679,614,822970.86,744179.55,1567150.41
520890,202210,853,535,318,648432.23,385417.15,1033849.38
520910,202210,1017,534,483,647223.16,585397.48,1232620.64
520915,202210,94,69,25,83630.83,30300,113930.83
520920,202210,494,233,261,283615.26,316337.14,599952.40
520929,202210,16,13,3,15756.8,3636,19392.8
520940,202210,64,46,18,55752.87,21816.1,77568.97
520945,202210,15,8,7,9696,8484,18180
520960,202210,43,26,17,31512,20604,52116
520970,202210,422,245,177,296943.8,215737.97,512681.77
520980,202210,90,68,22,82416,27876,110292
520990,202210,448,316,132,382993.27,159984.2,542977.47
520993,202210,127,64,63,77571.32,76356.98,153928.30
520995,202210,267,146,121,176952.88,146652,323604.88
521000,202210,1642,905,737,1096876.28,894462.96,1991339.24
521010,202210,645,342,303,414510.35,367240.24,781750.59
521015,202210,12,8,4,9696,4848,14544
521020,202210,1448,1007,441,1220501.67,534497.39,1754999.06
521030,202210,66,45,21,54540.8,25452,79992.8
521040,202210,992,654,338,792661.33,412081.16,1204742.49
521056,202210,61,38,23,46056,27876,73932
521060,202210,123,78,45,94536.4,54540.76,149077.16
521080,202210,330,258,72,312715.99,87264.5,399980.49
521090,202210,585,391,194,473894.09,235128.89,709022.98
521100,202210,262,189,73,229069.45,88476.4,317545.85
521120,202210,1092,771,321,936891.75,389054,1325945.75
521130,202210,328,233,95,282399.47,115140.6,397540.07
521140,202210,193,108,85,130897.07,103020.69,233917.76
521150,202210,2655,1134,1521,1374437.1,1844690.48,3219127.58
521160,202210,25,11,14,13332,16968,30300
521170,202210,234,123,111,149077.11,134532.2,283609.31
521180,202210,1214,771,443,934466.86,536924.01,1471390.87
521190,202210,2654,1105,1549,1339282.43,1878615.21,3217897.64
521200,202210,59,41,18,49692.1,21816,71508.1
521205,202210,11,8,3,9696.2,3636,13332.2
521210,202210,128,79,49,95749.15,59388,155137.15
521220,202210,761,519,242,629031.99,293306.48,922338.47
521225,202210,23,15,8,18181,9696.23,27877.23
521230,202210,105,66,39,79992.2,48481.39,128473.59
521250,202210,6610,3613,2997,4379068.55,3633627.54,8012696.09
521260,202210,40,19,21,23028,25452.6,48480.6
521270,202210,129,97,32,117564,38784,156348
521280,202210,422,265,157,321181.76,190284,511465.76
521290,202210,28,17,11,20604.64,13332,33936.64
521295,202210,104,68,36,82416.26,43632,126048.26
521300,202210,239,130,109,157560.77,132108,289668.77
521305,202210,44,31,13,37573,15756,53329
521308,202210,1030,787,243,953865.61,294518.95,1248384.56
521310,202210,1406,791,615,959923.04,746602.37,1706525.41
521340,202210,21,16,5,19392,6060,25452
521350,202210,115,85,30,103020.2,36360,139380.2
521370,202210,164,111,53,134532.2,64236.86,198769.06
521375,202210,202,97,105,117567.12,128472.56,246039.68
521377,202210,49,37,12,44844.1,14544,59388.1
521380,202210,1100,654,446,792673.64,544194.08,1336867.72
521385,202210,13,7,6,8484,7272,15756
521390,202210,108,85,23,103020.1,27876,130896.1
521400,202210,386,271,115,330397.37,139381.43,469778.80
521405,202210,160,97,63,117564.52,76356.66,193921.18
521410,202210,84,60,24,72720.87,29088,101808.87
521440,202210,216,149,67,180591.48,82416.64,263008.12
521450,202210,806,445,361,540561.09,439958.18,980519.27
521460,202210,1124,766,358,930833.1,433898.36,1364731.46
521470,202210,13,9,4,10908,4848,15756
521480,202210,42,29,13,35148.17,15756.6,50904.77
521483,202210,333,210,123,254522.4,149076.56,403598.96
521486,202210,298,195,103,236340.93,124836.84,361177.77
521487,202210,22,11,11,13332,13332,26664
521490,202210,26,15,11,18180.2,13332,31512.2
521500,202210,143,62,81,75144.21,99384.37,174528.58
521520,202210,44,33,11,39996,13332,53328
521523,202210,1106,605,501,733270.06,607215.6,1340485.66
521525,202210,57,39,18,47268,21816,69084
521530,202210,252,145,107,175740,129684.89,305424.89
521540,202210,42,21,21,25452,25452,50904
521550,202210,112,52,60,63024.8,73932.99,136957.79
521560,202210,917,603,314,730851.41,380571.78,1111423.19
521565,202210,71,51,20,61813.41,24240,86053.41
521570,202210,566,358,208,433901.78,254520.7,688422.48
521580,202210,53,33,20,39996,24240,64236
521590,202210,38,18,20,21816,24240,46056
521600,202210,25,11,14,13332,16968,30300
521630,202210,232,119,113,144233.32,136962.48,281195.80
521640,202210,316,166,150,201193.98,181800.7,382994.68
521645,202210,41,21,20,25452,24240,49692
521680,202210,254,152,102,185436.4,124836.4,310272.8
521690,202210,15,13,2,15756,2424,18180
521710,202210,1162,542,620,658124.95,753865.33,1411990.28
521720,202210,625,407,218,493288.33,264217.64,757505.97
521730,202210,714,341,373,413299.51,453289.82,866589.33
521740,202210,916,417,499,505406.96,606003.44,1111410.40
521760,202210,2419,1246,1173,1511487.15,1422912.82,2934399.97
521770,202210,842,518,324,627824.54,392690.09,1020514.63
521800,202210,2039,1354,685,1641066.51,830221.48,2471287.99
521805,202210,36,22,14,26664,16968,43632
521810,202210,94,52,42,63024.8,50904.19,113928.99
521830,202210,1026,745,281,902959.97,340578.98,1243538.95
521839,202210,74,43,31,52116,37572,89688
521850,202210,1193,596,597,722369.02,724785.89,1447154.91
521860,202210,333,208,125,252099.57,151500.2,403599.77
521870,202210,86,54,32,65448,38784,104232
521878,202210,36,14,22,16968,26664.99,43632.99
521880,202210,5128,2226,2902,2699175.21,3522103.17,6221278.38
521890,202210,625,425,200,515105.67,242401.29,757506.96
521900,202210,274,216,58,261793.9,70296,332089.9
521910,202210,181,124,57,150291.54,70296.78,220588.32
521920,202210,40,23,17,27876.6,20604,48480.6
521925,202210,56,31,25,37572,30300,67872
521930,202210,1265,704,561,855687.6,682363.61,1538051.21
521935,202210,32,23,9,27877.27,10908,38785.27
521940,202210,244,109,135,132109.84,163620.2,295730.04
521945,202210,19,14,5,16968,6060,23028
521950,202210,22,14,8,16968,9696,26664
521960,202210,70,55,15,66660,18180,84840
521970,202210,419,267,152,323607.51,184225.09,507832.60
521971,202210,115,59,56,71508,67872,139380
521973,202210,39,18,21,21816.6,25452,47268.6
521975,202210,1664,863,801,1047191.38,973251.92,2020443.30
521980,202210,239,160,79,195132.53,95748,290880.53
521990,202210,89,59,30,71509,36360,107869
522000,202210,293,196,97,237132.91,117564,354696.91
522005,202210,21,12,9,14544,10908,25452
522010,202210,1159,647,512,784184.98,620550.25,1404735.23
522015,202210,55,35,20,42420,24240,66660
522020,202210,910,538,372,653273.13,452079.7,1105352.83
522026,202210,24,16,8,19392,9696,29088
522028,202210,25,21,4,25452,4848,30300
522040,202210,852,368,484,446026.98,586613.59,1032640.57
522045,202210,2809,1644,1165,1994996.14,1413207.97,3408204.11
522050,202210,164,75,89,90902.77,107868.72,198771.49
522060,202210,553,341,212,413295.01,258157.41,671452.42
522068,202210,114,82,32,99384,38784,138168
522070,202210,18,15,3,18180,3636,21816
522100,202210,40,25,15,30300,18180,48480
522108,202210,48,35,13,42421.49,15756.2,58177.69
522119,202210,63,36,27,43632,32724,76356
522130,202210,76,25,51,30300.29,61812.4,92112.69
522140,202210,4336,2240,2096,2714937.71,2544001.94,5258939.65
522145,202210,46,34,12,41208,14544,55752
522150,202210,106,72,34,87264.08,41208.84,128472.92
522155,202210,55,40,15,48480.2,18180,66660.2
522157,202210,16,10,6,12120,7272,19392
522160,202210,1709,1020,689,1236263.11,836285.42,2072548.53
522170,202210,413,283,130,342997.54,157560.2,500557.74
522180,202210,32,13,19,15756,23028,38784
522185,202210,2611,1124,1487,1362315.91,1805919.93,3168235.84
522190,202210,71,40,31,48480.8,37572,86052.8
522200,202210,327,191,136,231493.3,164833.06,396326.36
522205,202210,149,100,49,121202.31,59388.1,180590.41
522220,202210,147,112,35,136956,42420,179376
522230,202210,33,29,4,35148.41,4848,39996.41
530010,202210,57993,29396,28597,35652906.76,34690540.97,70343447.73
110001,202211,534,435,99,527292.31,120001.2,647293.51
110002,202211,2976,1887,1089,2287282.88,1320042.87,3607325.75
110003,202211,80,62,18,75157.53,21819.12,96976.65
110004,202211,2161,1469,692,1780608.26,838812.72,2619420.98
110005,202211,443,348,95,421822.74,115145.82,536968.56
110006,202211,444,327,117,396358.3,141817.07,538175.37
110007,202211,76,62,14,75152.21,16969.39,92121.60
110008,202211,263,148,115,179394.59,139392.95,318787.54
110009,202211,964,736,228,892089.62,276365.11,1168454.73
110010,202211,1725,985,740,1195159.19,899381.71,2094540.90
110011,202211,1745,1343,402,1627930.03,487294.33,2115224.36
110012,202211,4216,2423,1793,2936909.92,2175732,5112641.92
110013,202211,734,579,155,703060.95,187883.95,890944.90
110014,202211,362,322,40,391543.29,49698.3,441241.59
110015,202211,1391,1063,328,1288516.82,397576.62,1686093.44
110018,202211,1057,658,399,797591.23,483653.35,1281244.58
110020,202211,16833,9357,7476,11346838.07,9068107.76,20414945.83
110025,202211,660,481,179,583022.15,216965.15,799987.30
110026,202211,34,24,10,29090,13332.74,42422.74
110028,202211,1657,1171,486,1420673.03,589125.96,2009798.99
110029,202211,128,114,14,138193.99,16970.52,155164.51
110030,202211,2467,1603,864,1942870.16,1047288.05,2990158.21
110032,202211,335,256,79,310316.21,95760.17,406076.38
110033,202211,683,486,197,589141.5,238794.06,827935.56
110034,202211,326,240,86,290914.25,105455.71,396369.96
110037,202211,90,80,10,96965.31,12120.79,109086.10
110040,202211,410,284,126,344237.92,152722.58,496960.50
110045,202211,973,699,274,848298.93,332141.73,1180440.66
110050,202211,91,80,11,96982.78,13333.86,110316.64
110060,202211,63,40,23,48493.54,27881.06,76374.60
110070,202211,109,71,38,86058.68,46058.93,132117.61
110080,202211,547,315,232,381790.86,281195.23,662986.09
110090,202211,26,21,5,25452,6060,31512
110092,202211,116,58,58,70298.95,70298.07,140597.02
110094,202211,206,141,65,170902.18,78783.44,249685.62
110100,202211,53,39,14,47271.31,16969.2,64240.51
110110,202211,123,72,51,87274.43,61817.35,149091.78
110120,202211,66,57,9,69095.27,10908.07,80003.34
110130,202211,272,218,54,264276.55,65457.39,329733.94
110140,202211,261,187,74,226658,89694.83,316352.83
110143,202211,54,44,10,53328.85,12120.67,65449.52
110145,202211,43,31,12,37576.39,14546.19,52122.58
110146,202211,28,12,16,14544.54,19392.96,33937.50
110147,202211,40,27,13,32728.77,15757.58,48486.35
110148,202211,33,27,6,32725.33,7272.5,39997.83
110149,202211,302,209,93,253317.47,112720.62,366038.09
110150,202211,141,109,32,132112.98,38785.39,170898.37
110155,202211,11,9,2,10908.87,2424,13332.87
110160,202211,64,48,16,58178.81,19393.76,77572.57
110170,202211,224,168,56,203651.34,67876.97,271528.31
110175,202211,68,52,16,63024.39,19392,82416.39
110180,202211,86,68,18,82419.69,21816.44,104236.13
120001,202211,215,158,57,191521.69,69094.95,260616.64
120005,202211,226,130,96,157572.45,116360.87,273933.32
120010,202211,1198,732,466,887251.36,564833.98,1452085.34
120013,202211,170,114,56,138174.3,67875.76,206050.06
120017,202211,131,75,56,90903.25,67873.27,158776.52
120020,202211,3485,2809,676,3404687.53,819350.74,4224038.27
120025,202211,591,320,271,389151.26,328542.08,717693.34
120030,202211,1176,1010,166,1224194.08,201210.71,1425404.79
120032,202211,43,38,5,46056.74,6060.17,52116.91
120033,202211,225,194,31,235140.86,37573.23,272714.09
120034,202211,181,133,48,161199.37,58177.24,219376.61
120035,202211,54,46,8,55754.14,9697.76,65451.90
120038,202211,414,268,146,324850.91,176963.83,501814.74
120039,202211,31,29,2,35149.68,2424,37573.68
120040,202211,15009,10066,4943,12207023.21,5994212.95,18201236.16
120042,202211,45,42,3,50907.43,3636,54543.43
120043,202211,17,5,12,6060.34,14544.67,20605.01
120045,202211,546,347,199,420623.73,241211.21,661834.94
120050,202211,1306,1005,301,1218156.53,367256.74,1585413.27
120060,202211,1522,1277,245,1547791.58,296951.82,1844743.40
120070,202211,425,308,117,373333.81,141818.28,515152.09
120080,202211,205,133,72,161204.86,87266.64,248471.50
130002,202211,164,117,47,141805.63,56965.3,198770.93
130006,202211,107,71,36,86052.44,43632,129684.44
130008,202211,134,77,57,93325.38,69086.84,162412.22
130010,202211,174,111,63,134534.84,76356.54,210891.38
130014,202211,299,211,88,256039.32,106660.59,362699.91
130020,202211,123,79,44,95749.22,53328,149077.22
130030,202211,1006,567,439,687212.92,532072.36,1219285.28
130040,202211,395,190,205,230289.71,248466.6,478756.31
130050,202211,568,302,266,366048.15,322422.66,688470.81
130060,202211,868,583,285,706606.06,345427.63,1052033.69
130063,202211,619,381,238,461772,288456.2,750228.2
130068,202211,235,149,86,180592.6,104233.18,284825.78
130070,202211,1375,912,463,1105429.42,561208.46,1666637.88
130080,202211,714,487,227,590257.64,275129.8,865387.44
130083,202211,90,58,32,70299.42,38785.51,109084.93
130090,202211,322,180,142,218160.44,173316.78,391477.22
130100,202211,1333,670,663,812093.09,803626.29,1615719.38
130110,202211,813,353,460,427847.2,557531.2,985378.4
130115,202211,150,76,74,92114.68,89692.94,181807.62
130120,202211,1723,1070,653,1296915.22,792674.57,2089589.79
130130,202211,644,434,210,526012.01,254521.98,780533.99
130140,202211,1568,1205,363,1461731.67,439988.8,1901720.47
130150,202211,438,389,49,471468.97,59389.2,530858.17
130160,202211,452,277,175,335738.43,212104.62,547843.05
130165,202211,139,124,15,150291.7,18180.8,168472.5
130170,202211,1108,762,346,923533.22,419379.66,1342912.88
130180,202211,279,213,66,258160.86,79993.85,338154.71
130185,202211,2327,1134,1193,1374507.3,1446090.01,2820597.31
130190,202211,3375,2111,1264,2558708.23,1534527.69,4093235.92
130195,202211,300,241,59,292092.31,71508,363600.31
130200,202211,196,104,92,126051.25,111507.56,237558.81
130210,202211,96,46,50,55752,60601.4,116353.4
130220,202211,218,156,62,189074.08,75147.55,264221.63
130230,202211,368,249,119,301788,144228,446016
130240,202211,1376,886,490,1073872.89,593906.74,1667779.63
130250,202211,4917,3183,1734,3859318.22,2104224.8,5963543.02
130255,202211,433,220,213,267853.85,258170.33,526024.18
130260,202211,65328,30161,35167,36587396.28,42663428.45,79250824.73
130270,202211,1566,1078,488,1306676.98,591485.77,1898162.75
130280,202211,146,86,60,104234.98,72720.41,176955.39
130290,202211,2078,1341,737,1627814.74,893288.29,2521103.03
130300,202211,435,295,140,357547.84,169688.4,527236.24
130310,202211,965,522,443,632668.32,536921.95,1169590.27
130320,202211,558,302,256,366027.82,310275.23,676303.05
130330,202211,790,511,279,619346.7,338153.85,957500.55
130340,202211,3595,1963,1632,2381756.2,1978083.32,4359839.52
130350,202211,469,325,144,393900,174528.5,568428.5
130353,202211,971,452,519,547872.46,629082.3,1176954.76
130356,202211,845,389,456,471483.03,553902.22,1025385.25
130360,202211,109,86,23,104234.11,27877.59,132111.70
130370,202211,711,560,151,678727.14,183012,861739.14
130380,202211,673,532,141,644801.59,170895.13,815696.72
130390,202211,481,391,90,473899.24,109080,582979.24
130395,202211,172,62,110,75144,133320.6,208464.6
130400,202211,98,78,20,94541.52,24241.26,118782.78
130406,202211,2219,1272,947,1541734.26,1147838.97,2689573.23
130410,202211,445,228,217,276336.42,263004.34,539340.76
130420,202211,2853,2314,539,2807227.86,655739.4,3462967.26
130423,202211,233,155,78,187867.39,94536.4,282403.79
130426,202211,189,103,86,124838.31,105446.2,230284.51
130430,202211,417,236,181,286034.36,219372.17,505406.53
130440,202211,210,73,137,88478.75,166053.26,254532.01
140002,202211,51,13,38,15757.82,46057.73,61815.55
140005,202211,234,136,98,164840.63,118784.73,283625.36
140010,202211,12511,7345,5166,8907075.67,6269306.38,15176382.05
140015,202211,178,74,104,89693.2,126055.21,215748.41
140017,202211,156,84,72,101826.69,87275.32,189102.01
140020,202211,461,305,156,369690.63,189093.41,558784.04
140023,202211,71,41,30,49695.03,36361.3,86056.33
140028,202211,24,14,10,16969.79,12122.54,29092.33
140030,202211,425,270,155,327279.71,187877.2,515156.91
140040,202211,76,50,26,60600,31512.27,92112.27
140045,202211,334,106,228,128480.75,276347.9,404828.65
140047,202211,581,371,210,449694.98,254535.25,704230.23
140050,202211,149,95,54,115158.73,65459.03,180617.76
140060,202211,92,64,28,77572.76,33937.14,111509.90
140070,202211,25,23,2,27879.67,2424.44,30304.11
150010,202211,5302,3185,2117,3860569.95,2566214.32,6426784.27
150013,202211,172,115,57,139383.25,69088.49,208471.74
150020,202211,1174,654,520,792702.63,630273.45,1422976.08
150030,202211,720,318,402,385454.18,487279.37,872733.55
150034,202211,216,125,91,151506.09,110296.63,261802.72
150040,202211,1721,983,738,1192756.76,895765.69,2088522.45
150050,202211,758,443,315,536933.82,381788.77,918722.59
150060,202211,5152,3194,1958,3873862.25,2373849.17,6247711.42
150070,202211,497,264,233,319986.8,282411.83,602398.63
150080,202211,18536,8643,9893,10483013.47,12003051.22,22486064.69
150085,202211,464,286,178,346666.42,215756.12,562422.54
150090,202211,744,593,151,718782.48,183023.46,901805.94
150095,202211,74,51,23,61821.29,27881.69,89702.98
150100,202211,77,47,30,56964.74,36363.49,93328.23
150110,202211,220,129,91,156350.82,110293.94,266644.76
150120,202211,412,292,120,353944.6,145448.15,499392.75
150125,202211,49,20,29,24242.67,35149.5,59392.17
150130,202211,2438,1200,1238,1454552.44,1500567.43,2955119.87
150140,202211,63359,27241,36118,33039341.15,43817600.31,76856941.46
150145,202211,263,142,121,172112.79,146656.55,318769.34
150150,202211,3744,1648,2096,1997597.01,2541864.06,4539461.07
150157,202211,376,271,105,328495.75,127276.95,455772.70
150160,202211,154,115,39,139386.18,47270.52,186656.70
150170,202211,4252,3071,1181,3722324.43,1431472.56,5153796.99
150172,202211,384,270,114,327270.47,138180.3,465450.77
150175,202211,91,51,40,61816.45,48484.59,110301.04
150178,202211,814,551,263,667881.64,318782.42,986664.06
150180,202211,3458,1724,1734,2089710.68,2104239.74,4193950.42
150190,202211,410,271,139,328486.18,168486.54,496972.72
150195,202211,133,74,59,89689.39,71508.49,161197.88
150200,202211,198,91,107,110293,129688.26,239981.26
150210,202211,3380,2611,769,3166132.15,934082.15,4100214.30
150215,202211,694,409,285,495778.26,345459.94,841238.20
150220,202211,3653,2414,1239,2926065.63,1501810.94,4427876.57
150230,202211,1432,1150,282,1393929.25,341816.93,1735746.18
150240,202211,7598,4180,3418,5070449.76,4146797.46,9217247.22
150250,202211,87,50,37,60603.48,44844.07,105447.55
150260,202211,129,89,40,107873.51,48482.76,156356.27
150270,202211,2229,1446,783,1753996.29,949093.87,2703090.16
150275,202211,556,360,196,436366.7,237573.39,673940.09
150276,202211,121,42,79,50907.65,95751.25,146658.90
150277,202211,895,395,500,478804.81,607283.87,1086088.68
150280,202211,349,241,108,292096.6,130897.42,422994.02
150285,202211,153,76,77,92114.91,94343.68,186458.59
150290,202211,1334,753,581,912720.11,704217.72,1616937.83
150293,202211,851,400,451,484855.19,546669.24,1031524.43
150295,202211,599,282,317,341825.14,384261.2,726086.34
150300,202211,99,46,53,55754.59,64238.06,119992.65
150304,202211,199,116,83,140602.44,100603.29,241205.73
150307,202211,465,383,82,466659.59,99390.49,566050.08
150309,202211,616,434,182,527305.39,220610.74,747916.13
150310,202211,288,191,97,231494.97,117564,349058.97
150320,202211,1966,1354,612,1641137.02,741790.66,2382927.68
150330,202211,2194,1246,948,1510234.81,1151467.35,2661702.16
150340,202211,209,133,76,161202.61,92113.75,253316.36
150345,202211,666,366,300,443619.66,364823.78,808443.44
150350,202211,430,341,89,413376.39,107882.73,521259.12
150360,202211,5164,3019,2145,3661918.98,2601204.02,6263123.00
150370,202211,856,576,280,698239.87,340607.8,1038847.67
150375,202211,196,81,115,98176.47,139384.42,237560.89
150380,202211,1581,1045,536,1266678.99,649708.03,1916387.02
150390,202211,937,534,403,648504.57,488484.88,1136989.45
150400,202211,118,99,19,119990.65,23028.73,143019.38
150405,202211,1700,1079,621,1308259.07,752689.95,2060949.02
150410,202211,107,67,40,81207.07,48482.45,129689.52
150420,202211,8159,4319,3840,5240506.47,4657189.2,9897695.67
150430,202211,687,425,262,515177.39,318783.03,833960.42
150440,202211,476,290,186,351526.23,225455.68,576981.91
150442,202211,2554,1356,1198,1644862.93,1455765.53,3100628.46
150445,202211,565,368,197,446077.72,238782.16,684859.88
150450,202211,236,138,98,167257.07,118776.74,286033.81
150460,202211,725,544,181,659402.18,219390.22,878792.40
150470,202211,1324,792,532,960021.58,644850.16,1604871.74
150475,202211,247,191,56,231533.24,67884.93,299418.17
150480,202211,1503,1054,449,1277596.66,550293.99,1827890.65
150490,202211,620,369,251,447236.85,304214.4,751451.25
150495,202211,362,270,92,327241.09,111505.2,438746.29
150497,202211,293,190,103,230293.65,124841.02,355134.67
150500,202211,277,161,116,195143.99,140596.7,335740.69
150503,202211,1427,709,718,860597.09,870289.96,1730887.05
150506,202211,938,645,293,781826.27,355150.7,1136976.97
150510,202211,1381,752,629,911497.49,762412.13,1673909.62
150520,202211,337,230,107,278763.93,129684.2,408448.13
150530,202211,2074,1171,903,1419515.16,1094650.28,2514165.44
150540,202211,233,171,62,207280.11,75153.9,282434.01
150543,202211,933,481,452,583049.56,550308.34,1133357.90
150548,202211,462,332,130,402400.11,157566.63,559966.74
150549,202211,89,58,31,70299.67,37572.64,107872.31
150550,202211,3342,1691,1651,2049665.2,2004792.11,4054457.31
150553,202211,3933,2191,1742,2655862.55,2112818.31,4768680.86
150555,202211,148,80,68,96966.09,82422.6,179388.69
150560,202211,76,38,38,46058.16,46057.49,92115.65
150563,202211,128,65,63,78792.03,76367.36,155159.39
150565,202211,229,136,93,164836.63,112720.09,277556.72
150570,202211,432,287,145,347850.95,175743.26,523594.21
150580,202211,1802,886,916,1073889.52,1110261.06,2184150.58
150590,202211,876,578,298,701787.09,361204.82,1062991.91
150600,202211,533,328,205,397556.22,248476.08,646032.30
150610,202211,182,143,39,173319.59,47269.68,220589.27
150611,202211,153,103,50,124838.75,60601.79,185440.54
150613,202211,3578,1990,1588,2413478.74,1925014.64,4338493.38
150616,202211,613,333,280,403631.35,340593.01,744224.36
150618,202211,1452,744,708,901786.48,858145.85,1759932.33
150619,202211,413,313,100,379385.72,121212.03,500597.75
150620,202211,1313,754,559,913909.08,677545.79,1591454.87
150630,202211,174,112,62,135766.65,75153.83,210920.48
150635,202211,493,224,269,271507,326045.37,597552.37
150640,202211,48,21,27,25455.43,32727.02,58182.45
150650,202211,2589,1487,1102,1803709.93,1338251.32,3141961.25
150655,202211,281,202,79,244836.42,95750.56,340586.98
150658,202211,75,40,35,48488.04,42426.48,90914.52
150660,202211,627,392,235,475161.98,284843.33,760005.31
150670,202211,1191,426,765,516363.59,927267.53,1443631.12
150680,202211,11714,6109,5605,7406337.01,6796537.41,14202874.42
150690,202211,42,21,21,25456.4,25452.34,50908.74
150700,202211,566,377,189,456974.14,230312.66,687286.80
150710,202211,297,169,128,204849.75,155147.08,359996.83
150715,202211,851,533,318,647267.77,385453.97,1032721.74
150720,202211,435,328,107,397563.56,129688.83,527252.39
150730,202211,1194,558,636,676389.05,770913.13,1447302.18
150740,202211,259,164,95,198782.45,115147.03,313929.48
150745,202211,838,467,371,566088.96,449716.21,1015805.17
150746,202211,71,34,37,41210.39,44846.09,86056.48
150747,202211,273,190,83,230294.96,100608.18,330903.14
150750,202211,140,77,63,93337.99,76364.38,169702.37
150760,202211,1938,1267,671,1535701.14,813294.21,2348995.35
150770,202211,415,241,174,292096.8,210890.21,502987.01
150775,202211,106,54,52,65458.17,63032.42,128490.59
150780,202211,215,122,93,147870.5,112717.36,260587.86
150790,202211,717,413,304,500581.82,368464.93,869046.75
150795,202211,1791,1092,699,1323625.55,847241.93,2170867.48
150796,202211,331,190,141,230280.94,170895.34,401176.28
150797,202211,416,192,224,232733.25,271502.64,504235.89
150800,202211,1721,951,770,1152679.69,933264.11,2085943.80
150803,202211,388,288,100,349081.4,121211.94,470293.34
150805,202211,217,127,90,153932.03,109086.91,263018.94
150808,202211,1139,566,573,687242.85,698154.06,1385396.91
150810,202211,3289,2211,1078,2679952.61,1307821.55,3987774.16
150812,202211,560,291,269,352714.94,326050.75,678765.69
150815,202211,1274,792,482,959980.13,584205.76,1544185.89
150820,202211,1730,1025,705,1242458.81,855781.4,2098240.21
150830,202211,597,448,149,543031.57,180604.85,723636.42
150835,202211,255,155,100,187864.84,121201.31,309066.15
150840,202211,1523,878,645,1064282.12,784258.64,1848540.76
160005,202211,73,49,24,59392.5,29090.71,88483.21
160010,202211,205,128,77,155155.47,93332.7,248488.17
160015,202211,190,126,64,152731.65,77571.09,230302.74
160020,202211,149,76,73,92115.29,88478.44,180593.73
160021,202211,71,32,39,38789.7,47271.56,86061.26
160023,202211,73,43,30,52121.87,36363.66,88485.53
160025,202211,28,13,15,15757.26,18181.53,33938.79
160027,202211,1550,860,690,1042458.92,836368.92,1878827.84
160030,202211,17951,9170,8781,11117874.84,10648872.38,21766747.22
160040,202211,346,211,135,255742.06,163633.26,419375.32
160050,202211,786,364,422,441210.21,511500.19,952710.40
160053,202211,310,184,126,223037.2,152728.3,375765.5
160055,202211,26,18,8,21821.68,9698.34,31520.02
160060,202211,7103,3840,3263,4654707.87,3955294.94,8610002.81
160070,202211,202,114,88,138175.73,106659.12,244834.85
160080,202211,147,73,74,88477.45,89688.8,178166.25
170025,202211,28,15,13,18181.17,15759.54,33940.71
170030,202211,171,137,34,166066.03,41209.18,207275.21
170035,202211,204,99,105,120020.4,127284.54,247304.94
170040,202211,181,134,47,162408,56964.29,219372.29
170070,202211,331,209,122,253362.43,147880.66,401243.09
170100,202211,358,260,98,315161.86,118790.96,433952.82
170105,202211,40,35,5,42425.14,6060,48485.14
170110,202211,115,70,45,84842.17,54540.87,139383.04
170130,202211,82,40,42,48480,50904,99384
170190,202211,104,60,44,72721.61,53328.64,126050.25
170200,202211,342,232,110,281214.54,133327.76,414542.30
170210,202211,6934,3781,3153,4583882.85,3823029.5,8406912.35
170215,202211,185,105,80,127267.95,96966.58,224234.53
170220,202211,1352,965,387,1170894.03,469076.95,1639970.98
170230,202211,151,99,52,120010.72,63037.25,183047.97
170240,202211,504,346,158,419426.75,191531.66,610958.41
170255,202211,1012,800,212,970878.27,256955.1,1227833.37
170270,202211,43,30,13,36360,15756.02,52116.02
170290,202211,140,85,55,103025.37,66660.2,169685.57
170300,202211,118,78,40,94537.53,48482.27,143019.80
170305,202211,52,42,10,50905.01,12120.78,63025.79
170307,202211,57,42,15,50912.91,18183.28,69096.19
170310,202211,129,77,52,93330.84,63026.86,156357.70
170320,202211,37,22,15,26667.57,18182.16,44849.73
170330,202211,32,24,8,29091.59,9696.9,38788.49
170360,202211,33,19,14,23031.06,16971.7,40002.76
170370,202211,76,40,36,48489.15,43639.67,92128.82
170380,202211,83,62,21,75148.15,25453.14,100601.29
170382,202211,39,32,7,38785,8486.32,47271.32
170384,202211,143,109,34,132109.62,41208.2,173317.82
170386,202211,69,29,40,35149.7,48483.36,83633.06
170388,202211,50,23,27,27878.54,32727.99,60606.53
170389,202211,28,22,6,26666.79,7273.29,33940.08
170390,202211,78,47,31,56969.52,38785.62,95755.14
170410,202211,25,23,2,27882.44,2425.1,30307.54
170460,202211,14,8,6,9698.03,7273.18,16971.21
170510,202211,33,25,8,30306.86,9697.64,40004.50
170550,202211,1612,934,678,1133359.59,823052.17,1956411.76
170555,202211,111,82,29,99407.03,35154.59,134561.62
170560,202211,102,74,28,89688,33936.99,123624.99
170600,202211,41,13,28,15757.51,33936.46,49693.97
170610,202211,188,101,87,122433.23,105463.52,227896.75
170625,202211,32,19,13,23030.11,15759.26,38789.37
170650,202211,99,68,31,82416.44,37572.91,119989.35
170700,202211,588,436,152,528472.23,185445.93,713918.16
170710,202211,148,88,60,106681.47,72737.21,179418.68
170720,202211,113,86,27,104234.54,32725.02,136959.56
170730,202211,110,64,46,77573.28,55756.17,133329.45
170740,202211,85,61,24,73932,29088.38,103020.38
170755,202211,50,27,23,32729.83,27886.82,60616.65
170765,202211,136,79,57,95769.65,69092.81,164862.46
170770,202211,197,128,69,155146.32,83631.75,238778.07
170820,202211,607,399,208,483643.98,252125.4,735769.38
170825,202211,49,30,19,36362.03,23030.19,59392.22
170830,202211,92,70,22,84844.69,26665.27,111509.96
170900,202211,170,130,40,158778.69,48482.17,207260.86
170930,202211,1012,558,454,676387.07,550321.78,1226708.85
170950,202211,3322,1572,1750,1905511.11,2121294.33,4026805.44
170980,202211,15,9,6,10910.57,7272.69,18183.26
171050,202211,147,112,35,135745.91,42420.21,178166.12
171070,202211,62,51,11,61812.81,13332.22,75145.03
171090,202211,49,37,12,44845.96,14545.22,59391.18
171110,202211,24,18,6,21819.18,7272.19,29091.37
171150,202211,43,27,16,32724,19392.8,52116.8
171180,202211,24,11,13,13334.59,15759.07,29093.66
171190,202211,187,102,85,123636.04,103029.23,226665.27
171195,202211,59,47,12,56971.99,14546.6,71518.59
171200,202211,35,18,17,21818.39,20604.62,42423.01
171215,202211,10,8,2,9696.07,2424.89,12120.96
171240,202211,66,50,16,60600,19393.87,79993.87
171245,202211,53,46,7,55762.31,8485.41,64247.72
171250,202211,81,46,35,55752.96,42421.93,98174.89
171270,202211,11,7,4,8485.89,4849.71,13335.60
171280,202211,45,36,9,43639.53,10909.18,54548.71
171320,202211,1066,617,449,747869.04,544218.63,1292087.67
171330,202211,438,225,213,273925.93,259385.62,533311.55
171360,202211,103,72,31,87265.78,37574.95,124840.73
171370,202211,44,24,20,29090.18,24246.25,53336.43
171380,202211,139,119,20,144232.46,24240.85,168473.31
171395,202211,41,25,16,30300.65,19392,49692.65
171420,202211,266,176,90,213320.72,109084.82,322405.54
171430,202211,76,61,15,73937.42,18181.87,92119.29
171488,202211,210,115,95,139384.79,115142.1,254526.89
171500,202211,67,38,29,46059.87,35152.09,81211.96
171510,202211,74,48,26,58176.8,31513.01,89689.81
171515,202211,39,32,7,38789.39,8485.93,47275.32
171525,202211,25,22,3,26667.69,3636,30303.69
171550,202211,16,10,6,12121.76,7273.35,19395.11
171570,202211,56,27,29,32724.73,35148.82,67873.55
171575,202211,271,185,86,224235.12,104236.67,328471.79
171610,202211,1946,1007,939,1221821.73,1138187.94,2360009.67
171620,202211,152,107,45,129692.18,54542.41,184234.59
171630,202211,50,28,22,33936.8,26664.67,60601.47
171650,202211,344,237,107,287287.89,129700.31,416988.20
171660,202211,268,150,118,181839.34,143043.44,324882.78
171665,202211,92,58,34,70301.01,42422.75,112723.76
171670,202211,450,278,172,336972.46,208479.58,545452.04
171700,202211,63,55,8,66665.86,9698.39,76364.25
171720,202211,28,10,18,12122.08,21819.79,33941.87
171750,202211,102,50,52,60603.69,63028.8,123632.49
171780,202211,78,61,17,73933.78,20604,94537.78
171790,202211,93,74,19,89690.64,23028.04,112718.68
171800,202211,35,28,7,33936,8484,42420
171820,202211,2160,1245,915,1509132.52,1109096.7,2618229.22
171830,202211,32,25,7,30301.64,8484,38785.64
171840,202211,55,35,20,42425.95,24240.44,66666.39
171845,202211,34,23,11,27878.33,13332.82,41211.15
171850,202211,45,36,9,43635.97,10909.64,54545.61
171855,202211,71,51,20,61813.43,24240.32,86053.75
171865,202211,6,4,2,4848.44,2424.34,7272.78
171870,202211,39,26,13,31515.63,15758.11,47273.74
171875,202211,87,62,25,75145.69,30300.2,105445.89
171880,202211,46,30,16,36361.38,19393.93,55755.31
171884,202211,57,31,26,37572.19,31512.8,69084.99
171886,202211,140,61,79,73933.65,95752.45,169686.10
171888,202211,28,21,7,25458.72,8485.73,33944.45
171889,202211,13,6,7,7273.62,8486.08,15759.70
171890,202211,57,46,11,55757.11,13332,69089.11
171900,202211,27,18,9,21822.63,10909.62,32732.25
172000,202211,35,30,5,36365.93,6060.8,42426.73
172010,202211,53,41,12,49692.68,14545.25,64237.93
172015,202211,19,14,5,16971.79,6061.65,23033.44
172020,202211,127,79,48,95755.04,58178.92,153933.96
172025,202211,41,27,14,32724.6,16968.25,49692.85
172030,202211,52,32,20,38786.47,24240.89,63027.36
172049,202211,80,51,29,61815.74,35150.32,96966.06
172065,202211,112,74,38,89711.51,46065.46,135776.97
172080,202211,121,73,48,88479.16,58179.74,146658.90
172085,202211,30,16,14,19392,16968.67,36360.67
172090,202211,457,330,127,400008.14,153935.86,553944.00
172093,202211,17,15,2,18180.12,2424,20604.12
172097,202211,17,9,8,10909.16,9696,20605.16
172100,202211,6077,3483,2594,4223134.06,3146765.25,7369899.31
172110,202211,83,55,28,66667.69,33937.79,100605.48
172120,202211,1768,1469,299,1780668.27,362424.34,2143092.61
172125,202211,15,12,3,14545.55,3636.17,18181.72
172130,202211,31,20,11,24240.87,13333.64,37574.51
172208,202211,202,131,71,158776.64,86054.91,244831.55
172210,202211,356,184,172,223045.75,208494.82,431540.57
210005,202211,3096,1943,1153,2356495.63,1397647.89,3754143.52
210010,202211,150,100,50,121203,60600.6,181803.6
210015,202211,43,30,13,36361.86,15756,52117.86
210020,202211,375,216,159,261812.44,192726.49,454538.93
210030,202211,317,218,99,264263.94,120006.1,384270.04
210040,202211,125,102,23,123630.5,27877.11,151507.61
210043,202211,270,220,50,266652.92,60604.81,327257.73
210047,202211,487,307,180,372085.15,218160.8,590245.95
210050,202211,271,194,77,235129.59,93325.28,328454.87
210055,202211,56,46,10,55756.52,12121.82,67878.34
210060,202211,533,429,104,520014.22,126065.66,646079.88
210070,202211,457,351,106,425415.63,128474.63,553890.26
210080,202211,148,136,12,164838.49,14544.88,179383.37
210083,202211,292,146,146,176953.73,176953.77,353907.50
210087,202211,8,6,2,7272,2424,9696
210090,202211,469,341,128,414565.57,155155.77,569721.34
210095,202211,427,337,90,408484.09,109095.03,517579.12
210100,202211,701,561,140,679994.55,169698.16,849692.71
210110,202211,118,81,37,98175.86,44845.61,143021.47
210120,202211,4890,3928,962,4762706.66,1166125,5928831.66
210125,202211,176,110,66,133327.14,79998.09,213325.23
210130,202211,449,271,178,328492.26,215760.72,544252.98
210135,202211,27,21,6,25460.27,7273.72,32733.99
210140,202211,4521,3470,1051,4207355.54,1275179.39,5482534.93
210150,202211,370,233,137,282456.27,166073.13,448529.40
210160,202211,3260,2776,484,3368536.93,586682.54,3955219.47
210170,202211,1249,1009,240,1224279.36,290899.89,1515179.25
210173,202211,133,121,12,146656.72,14545,161201.72
210177,202211,293,169,124,204839.3,151515.98,356355.28
210180,202211,30,16,14,19392.4,16968.54,36360.94
210190,202211,448,307,141,372095.96,170897.07,542993.03
210193,202211,6,4,2,4848.09,2424,7272.09
210197,202211,67,50,17,60601.46,20607.52,81208.98
210200,202211,609,521,88,631524.93,106672.68,738197.61
210203,202211,224,161,63,195148.86,76360.47,271509.33
210207,202211,324,276,48,334544.62,58186.27,392730.89
210210,202211,703,654,49,792684.64,59392.44,852077.08
210215,202211,75,67,8,81213.7,9696,90909.7
210220,202211,349,299,50,362446.47,60610.26,423056.73
210230,202211,316,259,57,313930.67,69085.71,383016.38
210232,202211,1228,887,341,1075148.06,413327.47,1488475.53
210235,202211,186,141,45,170909.19,54545.11,225454.30
210237,202211,47,22,25,26666.12,30301.35,56967.47
210240,202211,78,67,11,81205.02,13333.31,94538.33
210250,202211,181,158,23,191501.13,27876.75,219377.88
210255,202211,389,291,98,353942.17,118784.96,472727.13
210260,202211,386,272,114,329669.71,138168.58,467838.29
210270,202211,620,436,184,528456.73,223025.07,751481.80
210275,202211,94,73,21,88478.5,25454.44,113932.94
210280,202211,1084,718,366,870272.32,443612.97,1313885.29
210290,202211,534,360,174,436342.22,210897.09,647239.31
210300,202211,4893,3187,1706,3864149.1,2067852.63,5932001.73
210310,202211,124,80,44,96962.03,53330.97,150293.00
210312,202211,119,85,34,103024.49,41209.04,144233.53
210315,202211,121,104,17,126051.84,20604.88,146656.72
210317,202211,144,111,33,134534.39,39998.65,174533.04
210320,202211,2431,2087,344,2529723.61,416957.98,2946681.59
210325,202211,148,89,59,107875.29,71514.99,179390.28
210330,202211,4217,2492,1725,3020510.48,2090828.19,5111338.67
210340,202211,1213,940,273,1139415.55,330912.92,1470328.47
210350,202211,678,565,113,684841.17,136967.6,821808.77
210355,202211,149,127,22,153930.5,26668.38,180598.88
210360,202211,2040,1477,563,1790282.74,682420.18,2472702.92
210370,202211,1243,654,589,793917.51,713936.6,1507854.11
210375,202211,193,97,96,117581.9,116370.03,233951.93
210380,202211,732,574,158,695741.15,191512.16,887253.31
210390,202211,193,161,32,195136.07,38784.44,233920.51
210400,202211,408,358,50,433946.93,60608.68,494555.61
210405,202211,1095,782,313,947829.21,379371.26,1327200.47
210407,202211,72,60,12,72721.1,14544.44,87265.54
210408,202211,45,40,5,48488.06,6060.67,54548.73
210409,202211,341,298,43,361201.42,52120.24,413321.66
210410,202211,443,352,91,426631.34,110294.98,536926.32
210420,202211,203,164,39,198777.09,47268.1,246045.19
210430,202211,58,43,15,52116.95,18180.44,70297.39
210440,202211,377,255,122,309097.74,147879.35,456977.09
210450,202211,110,96,14,116367.15,16970.12,133337.27
210455,202211,247,130,117,157582.32,141819.04,299401.36
210460,202211,313,214,99,259401.42,120007.4,379408.82
210462,202211,71,60,11,72722.4,13333.59,86055.99
210465,202211,126,101,25,122418.38,30301.07,152719.45
210467,202211,544,413,131,500595.78,158781.68,659377.46
210470,202211,43,37,6,44844.52,7272,52116.52
210480,202211,1344,972,372,1178184.55,450918.23,1629102.78
210490,202211,185,133,52,161205.07,63027.64,224232.71
210500,202211,501,320,181,387885.53,219394.19,607279.72
210510,202211,525,431,94,522377.93,113930.25,636308.18
210515,202211,337,221,116,267863.13,140610.96,408474.09
210520,202211,399,362,37,438784.51,44848.22,483632.73
210530,202211,9842,5024,4818,6091362.63,5840432.57,11931795.20
210535,202211,120,91,29,110296.41,35150.8,145447.21
210540,202211,1541,1045,496,1266662.33,601194.94,1867857.27
210542,202211,1108,566,542,686069.48,656975.67,1343045.15
210545,202211,24,21,3,25454.75,3636.6,29091.35
210547,202211,127,111,16,134538.39,19393.63,153932.02
210550,202211,582,412,170,499438.92,206062.98,705501.90
210560,202211,162,141,21,170894.45,25453,196347.45
210565,202211,24,17,7,20608.72,8486.85,29095.57
210570,202211,1293,1092,201,1323640.74,243651.19,1567291.93
210580,202211,125,109,16,132110.8,19392.47,151503.27
210590,202211,691,576,115,698127.56,139381.96,837509.52
210592,202211,48,44,4,53328.89,4848,58176.89
210594,202211,110,95,15,115144.33,18181.65,133325.98
210596,202211,119,104,15,126051,18180.44,144231.44
210598,202211,140,108,32,130901.45,38788.06,169689.51
210600,202211,302,260,42,315166.66,50915.01,366081.67
210610,202211,247,228,19,276372.48,23028.93,299401.41
210620,202211,44,30,14,36361.21,16968.87,53330.08
210630,202211,88,77,11,93326.03,13332.34,106658.37
210632,202211,975,703,272,852059.11,329671.17,1181730.28
210635,202211,26,23,3,27883.33,3636.99,31520.32
210637,202211,120,86,34,104234,41208,145442
210640,202211,566,505,61,612066.68,73932,685998.68
210650,202211,404,340,64,412094.34,77572.71,489667.05
210660,202211,373,295,78,357600.9,94549.29,452150.19
210663,202211,67,52,15,63024.55,18180.44,81204.99
210667,202211,86,39,47,47271.48,56971.91,104243.39
210670,202211,255,228,27,276368.52,32727.91,309096.43
210675,202211,488,283,205,343018.95,248489.83,591508.78
210680,202211,236,152,84,184240.68,101816.58,286057.26
210690,202211,88,80,8,96961.82,9697.28,106659.10
210700,202211,158,120,38,145445.64,46057.78,191503.42
210710,202211,244,156,88,189077.95,106660.61,295738.56
210720,202211,127,115,12,139383.55,14544,153927.55
210725,202211,59,50,9,60619.15,10910.66,71529.81
210730,202211,23,18,5,21818.65,6060.6,27879.25
210735,202211,285,207,78,250887.52,94537.02,345424.54
210740,202211,516,447,69,541865.68,83643.8,625509.48
210745,202211,155,119,36,144232.21,43632.97,187865.18
210750,202211,2696,1450,1246,1758782.33,1512753.09,3271535.42
210760,202211,254,201,53,243623.95,64237.68,307861.63
210770,202211,245,203,42,246092.49,50918.39,297010.88
210780,202211,414,317,97,384254.08,117575.56,501829.64
210790,202211,188,162,26,196371.04,31516.9,227887.94
210800,202211,173,133,40,161222.62,48485.51,209708.13
210805,202211,64,57,7,69084,8484,77568
210810,202211,439,359,80,435172.64,96974.99,532147.63
210820,202211,1966,1655,311,2007409.49,376992.56,2384402.05
210825,202211,152,92,60,111519.06,72735.19,184254.25
210830,202211,699,492,207,596319.07,250893.96,847213.03
210840,202211,209,152,57,184227.7,69085.7,253313.4
210845,202211,227,175,52,212105.1,63025.13,275130.23
210850,202211,713,509,204,616984.44,247271.43,864255.87
210860,202211,3415,2047,1368,2481178.19,1658157.62,4139335.81
210870,202211,394,316,78,383070.66,94555.55,477626.21
210880,202211,83,66,17,79996.89,20604.6,100601.49
210890,202211,314,275,39,333365.12,47278.65,380643.77
210900,202211,709,459,250,556373.15,304249.28,860622.43
210905,202211,66,39,27,47270.96,32724.44,79995.40
210910,202211,2112,1593,519,1930938.89,629086.78,2560025.67
210920,202211,143,64,79,77574.28,95748.86,173323.14
210923,202211,78,64,14,77569.73,16968,94537.73
210927,202211,410,213,197,258159.11,238779.21,496938.32
210930,202211,74,63,11,76358.16,13332.34,89690.50
210940,202211,79,61,18,73934.44,21817,95751.44
210945,202211,203,121,82,146659.43,99386.57,246046.00
210950,202211,515,382,133,463015.02,161212.51,624227.53
210955,202211,94,56,38,67875.98,46057.48,113933.46
210960,202211,2373,1223,1150,1482333.83,1393863.88,2876197.71
210970,202211,111,94,17,113931.92,20604.51,134536.43
210975,202211,79,75,4,90909.07,4849.55,95758.62
210980,202211,1037,527,510,638808.18,618178.54,1256986.72
210990,202211,4400,3119,1281,3780597.01,1552724.29,5333321.30
211000,202211,1282,1057,225,1281217.52,272732.19,1553949.71
211003,202211,963,710,253,860568.84,307864.55,1168433.39
211010,202211,492,444,48,538152.29,58179.48,596331.77
211020,202211,1383,639,744,774529.51,901832.81,1676362.32
211023,202211,46,41,5,49693.82,6060,55753.82
211027,202211,79,61,18,73933.1,21816.57,95749.67
211030,202211,363,260,103,315143.73,124849.71,439993.44
211040,202211,286,242,44,293309.29,53329.24,346638.53
211050,202211,1120,771,349,934578.3,423033.39,1357611.69
211060,202211,619,548,71,664271.4,86059.55,750330.95
211065,202211,24,18,6,21821.01,7272.89,29093.90
211070,202211,841,707,134,857025.91,162431.18,1019457.09
211080,202211,87,84,3,101810.75,3636.6,105447.35
211085,202211,64,35,29,42421.82,35151.11,77572.93
211090,202211,78,68,10,82431.47,12123.23,94554.70
211100,202211,467,397,70,481230.12,84853.76,566083.88
211102,202211,227,165,62,199980,75144,275124
211105,202211,222,159,63,192718.04,76361.34,269079.38
211107,202211,130,81,49,98172,59388,157560
211110,202211,972,664,308,804868.5,373348.25,1178216.75
211120,202211,5184,2781,2403,3373567.82,2915268.73,6288836.55
211125,202211,21,14,7,16971.8,8484.7,25456.5
211130,202211,41637,20138,21499,24419533.17,26072111.8,50491644.97
211140,202211,374,335,39,406088.43,47276.25,453364.68
211150,202211,1185,845,340,1025475.98,412119.32,1437595.30
211153,202211,165,97,68,117564.47,82417.23,199981.70
211157,202211,69,56,13,67876.34,15756.43,83632.77
211160,202211,682,578,104,700588.54,126060.21,826648.75
211163,202211,3,2,1,2424,1212,3636
211167,202211,12,11,1,13332.97,1212.94,14545.91
211170,202211,415,311,104,376954.85,126062.94,503017.79
211172,202211,110,79,31,95750.46,37574.59,133325.05
211174,202211,24,19,5,23028,6060.46,29088.46
211176,202211,457,331,126,402417.66,152719.26,555136.92
211178,202211,91,64,27,77573.9,32726.19,110300.09
211180,202211,217,174,43,210900.92,52121.3,263022.22
211190,202211,71,64,7,77569.73,8484,86053.73
211195,202211,39,27,12,32731.41,14546.86,47278.27
211200,202211,149,127,22,153946.37,26668.7,180615.07
211210,202211,400,305,95,369695.4,115159.91,484855.31
211220,202211,4391,2642,1749,3204997.07,2120094.9,5325091.97
211223,202211,122,114,8,138181.89,9696,147877.89
211227,202211,57,46,11,55754.42,13333.01,69087.43
211230,202211,710,588,122,712762.22,147885.98,860648.20
211240,202211,376,315,61,381800.4,73934.32,455734.72
211245,202211,181,98,83,118782.5,100604.84,219387.34
211250,202211,1477,1271,206,1541873.56,249701.95,1791575.51
211260,202211,790,678,112,821751.96,135745,957496.96
211270,202211,1841,1533,308,1858081.73,373306.36,2231388.09
211280,202211,1773,1225,548,1484829.17,664240.17,2149069.34
211285,202211,223,146,77,176957.01,93324.2,270281.21
211290,202211,776,546,230,661776.51,278773.95,940550.46
211300,202211,769,617,152,747903.68,184245.68,932149.36
211400,202211,1561,1025,536,1242427.93,649681.27,1892109.20
220005,202211,18,17,1,20609.23,1212.5,21821.73
220010,202211,82,68,14,82417.02,16968.6,99385.62
220020,202211,737,604,133,732092.54,161210.47,893303.01
220025,202211,104,100,4,121203.04,4848,126051.04
220027,202211,55,44,11,53329.18,13332,66661.18
220030,202211,122,103,19,124841.63,24240.2,149081.83
220040,202211,1286,989,297,1199964.31,359989.72,1559954.03
220045,202211,30,21,9,25457.65,10910.04,36367.69
220050,202211,686,572,114,693326.58,138178.74,831505.32
220060,202211,181,159,22,192734.61,26668.3,219402.91
220070,202211,109,94,15,113938.7,18181.53,132120.23
220080,202211,13,11,2,13332.77,2424,15756.77
220090,202211,41,29,12,35148,14544,49692
220095,202211,2,2,0,2424.79,,2424.79
220100,202211,21,17,4,20606.09,4848.8,25454.89
220105,202211,31,28,3,33939.57,3636.1,37575.67
220110,202211,244,224,20,271492.9,24240.27,295733.17
220115,202211,45,39,6,47268.88,7272,54540.88
220117,202211,24,22,2,26665.7,2424,29089.7
220120,202211,1511,1169,342,1416926.76,414529.4,1831456.16
220130,202211,26,26,0,31513.85,,31513.85
220140,202211,85,70,15,84840.4,18181.38,103021.78
220150,202211,489,367,122,444892.7,147890.5,592783.2
220155,202211,22,21,1,25452,1212,26664
220157,202211,21,18,3,21821.48,3637.07,25458.55
220160,202211,102,89,13,107871.95,15757.22,123629.17
220170,202211,39,33,6,39997.87,7272.6,47270.47
220173,202211,13,11,2,13332.67,2424,15756.67
220177,202211,16,16,0,19392.84,,19392.84
220180,202211,63,61,2,73936.01,2424,76360.01
220190,202211,1140,979,161,1186638.66,195143.99,1381782.65
220191,202211,38,32,6,38791.84,7273.16,46065.00
220192,202211,95,88,7,106659.44,8484,115143.44
220194,202211,63,54,9,65452.21,10908,76360.21
220196,202211,78,65,13,78793.04,15758.43,94551.47
220198,202211,1,1,0,1212,,1212.0
220200,202211,401,340,61,412171.49,73943.54,486115.03
220202,202211,34,30,4,36367.29,4849.01,41216.30
220205,202211,64,55,9,66661.43,10908,77569.43
220207,202211,15,15,0,18183.7,,18183.7
220208,202211,70,44,26,53334.37,31514.21,84848.58
220209,202211,32,27,5,32727.03,6060.5,38787.53
220210,202211,23,19,4,23030.04,4848.28,27878.32
220211,202211,32,31,1,37576.28,1212.16,38788.44
220213,202211,32,29,3,35157.45,3636,38793.45
220217,202211,40,33,7,39998.05,8484,48482.05
220220,202211,2363,1572,791,1905392.75,959982.69,2865375.44
220225,202211,7,2,5,2424.25,6062.48,8486.73
220230,202211,996,752,244,911497.21,295752.52,1207249.73
220240,202211,165,146,19,176959.74,23029.7,199989.44
220245,202211,41,38,3,46058.2,3636.26,49694.46
220250,202211,141,118,23,143028.15,27877.47,170905.62
220253,202211,51,46,5,55754.32,6060.5,61814.82
220255,202211,46,39,7,47269.49,8484.4,55753.89
220260,202211,708,542,166,656963.82,201213.81,858177.63
220265,202211,8,6,2,7272,2425.05,9697.05
220270,202211,848,764,84,927251.53,101814.35,1029065.88
220271,202211,40,31,9,37575.28,10909.15,48484.43
220272,202211,15,15,0,18180.59,,18180.59
220273,202211,15,14,1,16971.25,1212,18183.25
220275,202211,64,54,10,65448.55,12120,77568.55
220277,202211,30,22,8,26666.5,9697.32,36363.82
220280,202211,19,13,6,15757.56,7272,23029.56
220285,202211,44,40,4,48486.86,4848.4,53335.26
220290,202211,1547,1325,222,1606055.62,269090.23,1875145.85
220300,202211,38,38,0,46065.47,,46065.47
220310,202211,339,286,53,346698.75,64245.93,410944.68
220320,202211,448,412,36,499414.66,43636.83,543051.49
220323,202211,2,1,1,1212.6,1212,2424.6
220325,202211,8,7,1,8484.75,1212,9696.75
220327,202211,14,14,0,16970.28,,16970.28
220330,202211,219,156,63,189077.9,76360.47,265438.37
220335,202211,136,116,20,140594.45,24240.17,164834.62
220340,202211,45,35,10,42421.59,12121.38,54542.97
220342,202211,54,46,8,55764.35,9699.13,65463.48
220345,202211,85,73,12,88479.93,14545.06,103024.99
220350,202211,463,405,58,490879.98,71512.77,562392.75
220360,202211,50,34,16,41209.24,19393.2,60602.44
220370,202211,1356,1132,224,1372124.43,271506.14,1643630.57
220375,202211,18,17,1,20605.73,1212,21817.73
220380,202211,25,19,6,23031.18,7272.65,30303.83
220385,202211,16,14,2,16970.5,2425.29,19395.79
220390,202211,2441,1348,1093,1633984.4,1324864.69,2958849.09
220400,202211,36,31,5,37572.44,6060.95,43633.39
220410,202211,23,22,1,26668.48,1212.94,27881.42
220415,202211,14,13,1,15760.43,1212.97,16973.40
220420,202211,123,103,20,124858.05,24243.17,149101.22
220430,202211,141,124,17,150309.05,20605.7,170914.75
220435,202211,23,17,6,20608.39,7274,27882.39
220440,202211,275,234,41,283656.75,49697.9,333354.65
220450,202211,358,179,179,216979.95,216981.1,433961.05
220455,202211,53,52,1,63029.86,1212,64241.86
220460,202211,19,17,2,20607.48,2424.23,23031.71
220465,202211,64,42,22,50914.64,26671.36,77586.00
220470,202211,233,205,28,248504.29,33940.59,282444.88
220480,202211,67,62,5,75144.68,6060.34,81205.02
220490,202211,88,74,14,89688,16968.2,106656.2
220500,202211,118,98,20,118781.07,24240.55,143021.62
220510,202211,363,282,81,341833.69,98180.65,440014.34
220515,202211,26,24,2,29093.4,2424.44,31517.84
220520,202211,372,329,43,398821.5,52126.51,450948.01
220525,202211,8,3,5,3637.15,6061.61,9698.76
220527,202211,13,13,0,15759.74,,15759.74
220530,202211,48,24,24,29090.2,29089.65,58179.85
220535,202211,5,4,1,4848.54,1212.67,6061.21
220540,202211,102,89,13,107870.03,16968.8,124838.83
220545,202211,25,16,9,19396.87,10909.84,30306.71
220550,202211,736,581,155,705471.19,187885.88,893357.07
220551,202211,12,10,2,12120.9,2424.58,14545.48
220552,202211,13,13,0,15757.52,,15757.52
220553,202211,57,52,5,63029.93,6060,69089.93
220554,202211,8,6,2,7272.91,2424,9696.91
220555,202211,43,36,7,43638.54,8484.94,52123.48
220556,202211,42,39,3,47272.85,3636.1,50908.95
220557,202211,58,51,7,61820.55,8484.92,70305.47
220558,202211,12,6,6,7272.78,7273.04,14545.82
220559,202211,6,6,0,7274.01,,7274.01
220560,202211,79,51,28,61814.39,33936,95750.39
220570,202211,723,447,276,541802.62,334530.25,876332.87
220580,202211,545,500,45,606139.32,54549.83,660689.15
220585,202211,14,12,2,14545.75,2424.14,16969.89
220590,202211,13,12,1,14546.75,1212,15758.75
220595,202211,75,57,18,69086.9,21817.9,90904.8
220600,202211,24,17,7,20604.48,8486.2,29090.68
220605,202211,30,27,3,32728.06,3636,36364.06
220610,202211,94,78,16,94536.8,19392.64,113929.44
220620,202211,561,479,82,580625.27,99397.31,680022.58
220630,202211,6,3,3,3636,3636.36,7272.36
220635,202211,32,29,3,35156.66,3636,38792.66
220640,202211,112,92,20,111504.4,24240,135744.4
220650,202211,115,109,6,132113.56,7272,139385.56
220660,202211,72,55,17,66663.82,20606.87,87270.69
220665,202211,10,10,0,12121.87,,12121.87
220667,202211,21,19,2,23032.84,2424,25456.84
220669,202211,35,30,5,36363.11,6060,42423.11
220670,202211,72,57,15,69090.28,18180.44,87270.72
220672,202211,79,58,21,70303.64,25454.77,95758.41
220675,202211,28,21,7,25460.42,8484.81,33945.23
220680,202211,60,50,10,60600,12120.2,72720.2
220690,202211,47,45,2,54541.23,2424,56965.23
220695,202211,28,16,12,19395.16,14547.11,33942.27
220700,202211,1881,1455,426,1763576.84,516344.42,2279921.26
220710,202211,10,8,2,9697.47,2424.89,12122.36
220720,202211,111,94,17,113930.39,20604,134534.39
220730,202211,24,23,1,27878.79,1212,29090.79
220735,202211,6,3,3,3636,3636.4,7272.4
220740,202211,54,47,7,56968.01,8484.39,65452.40
220750,202211,127,107,20,129689.3,24242.08,153931.38
220755,202211,16,16,0,19397.97,,19397.97
220760,202211,70,63,7,76358.88,8484,84842.88
220770,202211,6045,3464,2581,4198998.82,3129844.94,7328843.76
220775,202211,12,9,3,10911.77,3636.99,14548.76
220777,202211,21,20,1,24240.22,1212,25452.22
220779,202211,5,1,4,1212,4848.2,6060.2
220780,202211,931,790,141,957569.94,170903.57,1128473.51
220785,202211,5,2,3,2424.8,3636.88,6061.68
220790,202211,1223,980,243,1187908.29,294550.04,1482458.33
220793,202211,7,5,2,6061.11,2424,8485.11
220795,202211,22,20,2,24242.05,2424,26666.05
220800,202211,4108,3144,964,3811175.46,1168503.25,4979678.71
220810,202211,74,64,10,77575.65,12120.44,89696.09
220820,202211,247,226,21,273952.48,25458.8,299411.28
220830,202211,1306,1146,160,1389081.62,193940.75,1583022.37
220840,202211,2595,1832,763,2221860.53,924867.05,3146727.58
220850,202211,75,65,10,78780.6,12120,90900.6
220855,202211,8,4,4,4848.8,4849.2,9698.0
220860,202211,15,13,2,15760.57,2424.92,18185.49
220865,202211,30,27,3,32726.47,3636,36362.47
220870,202211,87,79,8,96963.97,9696.25,106660.22
220880,202211,333,275,58,333346.89,70305.12,403652.01
220885,202211,26,25,1,30303.22,1212.34,31515.56
220887,202211,6,5,1,6062.01,1212,7274.01
220890,202211,90,76,14,92131.4,16970.03,109101.43
220900,202211,24,12,12,14546.2,14546.19,29092.39
220910,202211,48,38,10,46064.26,12121.07,58185.33
220915,202211,9,8,1,9696.15,1212,10908.15
220920,202211,47,43,4,52123.08,4848.94,56972.02
220930,202211,51,49,2,59391.01,2424,61815.01
220935,202211,14,14,0,16975.22,,16975.22
220937,202211,35,30,5,36366.32,6060,42426.32
220940,202211,57,50,7,60602.12,8484,69086.12
220945,202211,3,3,0,3636.34,,3636.34
220950,202211,33,26,7,31514.83,8484.67,39999.50
220955,202211,18,18,0,21817.69,,21817.69
220960,202211,35,30,5,36360,6060,42420
220965,202211,49,45,4,54540,4848,59388
220970,202211,65,54,11,65448.32,13332,78780.32
220975,202211,10,9,1,10912.97,1212,12124.97
220980,202211,29,27,2,32724.74,2424.86,35149.60
220985,202211,54,46,8,56965.48,9696.24,66661.72
220987,202211,29,28,1,33943.52,1212.12,35155.64
220990,202211,23,23,0,27876.25,,27876.25
220995,202211,12,10,2,12121.23,2424.78,14546.01
220997,202211,67,59,8,71517.65,9697.32,81214.97
221000,202211,1300,1154,146,1398777.81,176962.83,1575740.64
221005,202211,42,39,3,47269.8,3636.88,50906.68
221010,202211,26,18,8,21817.13,9696,31513.13
221020,202211,39,34,5,41215.32,6060.78,47276.10
221030,202211,41,34,7,41117.41,8484.78,49602.19
221035,202211,24,22,2,26669.64,2424,29093.64
221037,202211,14,10,4,12121.59,4848.47,16970.06
221038,202211,27,23,4,27876,4848,32724
221039,202211,24,23,1,27876.62,1212,29088.62
221040,202211,261,223,38,270324.75,46062.18,316386.93
221050,202211,229,193,36,233953.51,43635.82,277589.33
221060,202211,2010,1728,282,2096897.64,341803.78,2438701.42
221062,202211,28,28,0,33941.13,,33941.13
221063,202211,18,14,4,16968,4848.67,21816.67
221065,202211,71,57,14,69092.19,16968.12,86060.31
221070,202211,157,137,20,166071.85,24242.37,190314.22
221080,202211,400,340,60,412135.15,73935.44,486070.59
221090,202211,23,18,5,21820.58,6060.72,27881.30
221093,202211,46,30,16,36370.12,19393.37,55763.49
221095,202211,4,4,0,4850.46,,4850.46
221097,202211,12,10,2,12122.53,2425.2,14547.73
221100,202211,27529,16423,11106,19913825.37,13467218.34,33381043.71
221110,202211,1177,904,273,1095780.63,330914.54,1426695.17
221120,202211,578,417,161,505444.2,195144.34,700588.54
221130,202211,1011,820,191,993918.41,231509.31,1225427.72
221135,202211,33,30,3,36365.53,3636,40001.53
221140,202211,48,41,7,49696.02,8484.51,58180.53
221150,202211,11,8,3,9697.47,3636,13333.47
221160,202211,15,15,0,18185.05,,18185.05
221170,202211,20,19,1,23030.64,1212,24242.64
230010,202211,167,144,23,174531.99,27876,202407.99
230015,202211,164,138,26,167256.49,31512,198768.49
230020,202211,1826,1473,353,1785415.11,427877.65,2213292.76
230030,202211,1707,1237,470,1500627.21,569697.21,2070324.42
230040,202211,235,188,47,227860.15,56964.94,284825.09
230050,202211,246,172,74,208468.88,89689.37,298158.25
230060,202211,180,144,36,174528.97,43633.51,218162.48
230070,202211,310,263,47,318761.81,56964.84,375726.65
230075,202211,944,782,162,947884.62,196354.8,1144239.42
230080,202211,233,189,44,229080.14,53329.35,282409.49
230090,202211,178,127,51,153929.55,61813.1,215742.65
230100,202211,2774,1548,1226,1876427.34,1486097.23,3362524.57
230110,202211,3148,1974,1174,2393883.92,1422999.93,3816883.85
230120,202211,1202,915,287,1110271.6,347873.88,1458145.48
230125,202211,178,139,39,168472.14,47270.59,215742.73
230130,202211,523,453,70,549065.42,84846.05,633911.47
230140,202211,230,183,47,221803.62,56965.8,278769.42
230150,202211,158,120,38,145443.78,46060.32,191504.10
230160,202211,1020,829,191,1004785.43,231496.84,1236282.27
230170,202211,668,582,86,705472.11,104238.96,809711.07
230180,202211,67,61,6,73932.86,7272,81204.86
230185,202211,421,356,65,431518.05,78786.02,510304.07
230190,202211,2618,1977,641,2396296.01,778156.21,3174452.22
230195,202211,544,461,83,558787.45,100605.32,659392.77
230200,202211,467,362,105,438783.78,127264.7,566048.48
230205,202211,427,281,146,340575.13,176954.45,517529.58
230210,202211,1475,1119,356,1356311.79,431493.46,1787805.25
230220,202211,1696,1123,573,1361223.87,694543.65,2055767.52
230230,202211,1048,849,199,1029074.33,241199.42,1270273.75
230240,202211,2068,1787,281,2166305.98,341808.7,2508114.68
230250,202211,1878,1515,363,1837552.19,439994.26,2277546.45
230260,202211,3456,2121,1335,2570736.15,1619286.11,4190022.26
230270,202211,1426,1111,315,1346640.82,381806.74,1728447.56
230280,202211,2940,2240,700,2715075.13,848452.89,3563528.02
230290,202211,366,317,49,384261.4,59392.8,443654.2
230300,202211,527,387,140,469051.93,170897.2,639949.13
230310,202211,451,346,105,419374.16,127262.63,546636.79
230320,202211,978,820,158,993913.37,191504.77,1185418.14
230330,202211,329,266,63,322409.38,76362.45,398771.83
230340,202211,466,374,92,453347.58,111513.21,564860.79
230350,202211,3542,2159,1383,2618155.87,1676326.61,4294482.48
230360,202211,279,226,53,273938.01,64241.01,338179.02
230365,202211,135,107,28,129687,33936,163623
230370,202211,12101,6025,6076,7308111.57,7370085.02,14678196.59
230380,202211,518,440,78,533328.81,94540.55,627869.36
230390,202211,550,316,234,383012.64,283618.38,666631.02
230393,202211,236,191,45,231493.84,54541.3,286035.14
230395,202211,378,298,80,361241.81,96975.21,458217.02
230400,202211,667,528,139,639978.37,168479.4,808457.77
230410,202211,2937,1839,1098,2229081.22,1330933.4,3560014.62
230420,202211,6890,4531,2359,5493419.08,2859477.39,8352896.47
230423,202211,353,305,48,369684.59,58180.05,427864.64
230425,202211,518,410,108,496957.6,130904.62,627862.22
230426,202211,123,94,29,113928.79,35148.6,149077.39
230427,202211,77,69,8,83635.66,9696.4,93332.06
230428,202211,1824,885,939,1072740.78,1138155.16,2210895.94
230430,202211,484,387,97,469085.37,117576.2,586661.57
230435,202211,1006,721,285,873902.42,345437.46,1219339.88
230440,202211,103240,47162,56078,57185244.12,68023022.17,125208266.29
230445,202211,349,233,116,282425.25,140602.26,423027.51
230450,202211,606,476,130,578146.56,157562.31,735708.87
230460,202211,106,76,30,92117.82,36361.72,128479.54
230465,202211,327,268,59,324835.46,71516.08,396351.54
230470,202211,2119,1650,469,1999905.62,568457.72,2568363.34
230480,202211,153,137,16,166048.17,19393.92,185442.09
230490,202211,349,275,74,333309.89,89688.95,422998.84
230495,202211,510,354,156,430301.75,189088.56,619390.31
230500,202211,1171,866,305,1049640.02,370891.15,1420531.17
230510,202211,75,50,25,60600.98,30300,90900.98
230520,202211,426,324,102,392713.15,123630.26,516343.41
230523,202211,2730,1661,1069,2013284.75,1296929.61,3310214.36
230526,202211,261,221,40,267854.06,48480.2,316334.26
230530,202211,713,515,198,624247.19,240003.44,864250.63
230533,202211,222,202,20,244834.39,24241.34,269075.73
230535,202211,432,322,110,390306.54,133325.62,523632.16
230540,202211,1862,1660,202,2014528.16,244846.04,2259374.20
230550,202211,4334,2739,1595,3320078.89,1934607.64,5254686.53
230560,202211,612,460,152,557573.59,185451.42,743025.01
230565,202211,233,172,61,208469.1,73936.63,282405.73
230570,202211,326,275,51,333311.23,61815.7,395126.93
230580,202211,1273,877,396,1062982.36,481193.3,1544175.66
230590,202211,1098,841,257,1019249.9,311506.93,1330756.83
230600,202211,287,255,32,309094.95,38787.64,347882.59
230610,202211,483,357,126,432718.29,152721.19,585439.48
230620,202211,181,149,32,180600.1,38786.61,219386.71
230625,202211,918,617,301,749071.05,364830.97,1113902.02
230630,202211,1532,1144,388,1389055.34,470291.92,1859347.26
230640,202211,4194,3417,777,4142996.92,943040.17,5086037.09
230650,202211,507,432,75,523611.29,90907.77,614519.06
230655,202211,771,617,154,749084.84,186658.63,935743.47
230660,202211,365,301,64,364825.18,77573.82,442399.00
230670,202211,492,394,98,477585.66,118779.93,596365.59
230680,202211,226,196,30,237576.74,36362.59,273939.33
230690,202211,1016,847,169,1026639.02,204838.34,1231477.36
230700,202211,1056,869,187,1053293.99,226654.85,1279948.84
230710,202211,699,645,54,781824,65452.65,847276.65
230720,202211,150,127,23,153927.17,27877.85,181805.02
230725,202211,300,224,76,271509.66,92116.98,363626.64
230730,202211,13646,7183,6463,8708122.45,7837764.97,16545887.42
230740,202211,733,587,146,711528.61,178174.56,889703.17
230750,202211,861,710,151,860585.97,183026.7,1043612.67
230760,202211,1696,1435,261,1740621.71,316351.33,2056973.04
230763,202211,361,295,66,357559.04,79996.38,437555.42
230765,202211,9083,4249,4834,5151754.56,5863364.91,11015119.47
230770,202211,5418,2739,2679,3321217.86,3248447.81,6569665.67
230780,202211,832,720,112,872697.21,135749.17,1008446.38
230790,202211,330,269,61,326029.82,75144.6,401174.42
230800,202211,1247,882,365,1069049.03,442395.92,1511444.95
230810,202211,1492,1283,209,1555178.65,253339.39,1808518.04
230820,202211,396,258,138,312715.11,167266.56,479981.67
230830,202211,1019,849,170,1030278.53,206056.06,1236334.59
230835,202211,294,239,55,289701.48,66665.88,356367.36
230837,202211,197,158,39,191507.72,47270.66,238778.38
230840,202211,989,751,238,910269.03,288472.73,1198741.76
230850,202211,1450,1219,231,1477591.12,279997.33,1757588.45
230860,202211,343,265,78,321199.96,94547.29,415747.25
230870,202211,1940,1642,298,1990280.7,361207.34,2351488.04
230880,202211,83,66,17,79994.85,20604.44,100599.29
230890,202211,589,517,72,626648.49,87267.98,713916.47
230900,202211,327,242,85,295748.63,103025.38,398774.01
230910,202211,235,182,53,220598.06,64238.52,284836.58
230920,202211,520,406,114,492098.25,138175.05,630273.30
230930,202211,1157,803,354,974522.82,429081.82,1403604.64
230940,202211,884,675,209,818172.08,253322.36,1071494.44
230945,202211,592,471,121,570920.85,146672.96,717593.81
230950,202211,451,388,63,470319.91,76366.05,546685.96
230960,202211,2999,1984,1015,2404868.72,1231554.78,3636423.50
230970,202211,1904,1030,874,1249691.75,1059396.58,2309088.33
230980,202211,231,175,56,212118.28,67876.45,279994.73
230990,202211,148,116,32,140599.95,38785.97,179385.92
231000,202211,217,198,19,241199.44,23028.34,264227.78
231010,202211,193,130,63,158774.74,76359.03,235133.77
231020,202211,1544,1024,520,1241234.34,630315.42,1871549.76
231025,202211,1201,825,376,1000017.67,455754.14,1455771.81
231030,202211,1099,885,214,1072707.47,259388.1,1332095.57
231040,202211,184,124,60,150294.65,72721.42,223016.07
231050,202211,994,852,142,1033958.05,172128.32,1206086.37
231060,202211,169,136,33,164839.73,40001.26,204840.99
231070,202211,1582,1082,500,1311536.41,607253.33,1918789.74
231080,202211,277,245,32,296981.33,38786.76,335768.09
231085,202211,742,452,290,547865.21,351499.61,899364.82
231090,202211,279,223,56,270286.33,67875.44,338161.77
231095,202211,167,126,41,152714.02,49692.9,202406.92
231100,202211,193,153,40,186649.29,48481.61,235130.90
231110,202211,389,322,67,390305.39,81211.53,471516.92
231120,202211,262,220,42,266656.08,50907.57,317563.65
231123,202211,156,148,8,179379.33,9696,189075.33
231126,202211,348,268,80,324824.15,96966.45,421790.60
231130,202211,5197,4009,1188,4861699.25,1440007.51,6301706.76
231135,202211,225,196,29,237562.98,35151.76,272714.74
231140,202211,3202,2284,918,2768463.97,1112692.87,3881156.84
231150,202211,407,379,28,459384.78,33939.9,493324.68
231160,202211,1317,1068,249,1294516.25,301805.72,1596321.97
231170,202211,548,378,170,458171.29,206053.32,664224.61
231180,202211,2015,1745,270,2115129.98,327265.9,2442395.88
231190,202211,227,182,45,220586,54541.1,275127.1
231195,202211,249,201,48,243615.7,58177.08,301792.78
231200,202211,890,717,173,869092.41,209696.96,1078789.37
231210,202211,538,455,83,551487.88,100599.26,652087.14
231220,202211,1109,778,331,943037.4,401205.39,1344242.79
231230,202211,1624,1201,423,1455703.66,515119.07,1970822.73
231240,202211,1704,1147,557,1390266.17,676342.63,2066608.80
231250,202211,97,91,6,110304.47,7272,117576.47
231260,202211,270,179,91,216956.78,110297.71,327254.49
231270,202211,1046,802,244,972112.16,295741.21,1267853.37
231280,202211,85,64,21,77569.38,25453.26,103022.64
231290,202211,8497,4709,3788,5710247.55,4596391.14,10306638.69
231300,202211,613,559,54,677568,65449.98,743017.98
231310,202211,865,790,75,957539.36,90908.32,1048447.68
231320,202211,632,468,164,569672.48,198780.26,768452.74
231325,202211,108,92,16,111510.74,19392,130902.74
231330,202211,2072,1564,508,1895783.31,616966.55,2512749.86
231335,202211,264,231,33,279980.53,41208.68,321189.21
231340,202211,2027,1383,644,1676338.05,781796.93,2458134.98
231350,202211,1494,1169,325,1416973.12,393939.34,1810912.46
231355,202211,436,355,81,430291.15,98174.97,528466.12
231360,202211,596,402,194,487294.01,235147.2,722441.21
231370,202211,103,86,17,104234.11,20604.26,124838.37
231375,202211,307,230,77,278784.41,93332.19,372116.60
231380,202211,551,437,114,529667.62,138173.34,667840.96
231390,202211,202,154,48,186658.56,59390.22,246048.78
231395,202211,822,488,334,592692.27,404824.29,997516.56
231400,202211,1253,1034,219,1253305.83,266657.26,1519963.09
231410,202211,1454,1179,275,1429072.02,333331.43,1762403.45
240010,202211,393,175,218,212130.89,265476.15,477607.04
240020,202211,2413,1971,442,2390323.97,535756.2,2926080.17
240030,202211,121,97,24,117566.72,29088.55,146655.27
240040,202211,31,30,1,36360.67,1212.67,37573.34
240050,202211,545,470,75,569713.44,92123.27,661836.71
240060,202211,82,75,7,90903.96,8484.44,99388.40
240070,202211,289,217,72,263012.32,87266.73,350279.05
240080,202211,613,410,203,496966.14,246058.43,743024.57
240090,202211,105,92,13,111505.28,15756.21,127261.49
240100,202211,1596,1498,98,1815755.22,118786.52,1934541.74
240110,202211,1097,734,363,890955.59,440037.16,1330992.75
240120,202211,161,119,42,144233.31,50906.43,195139.74
240130,202211,282,257,25,311530.37,30303.22,341833.59
240140,202211,93,61,32,73939.34,38786.71,112726.05
240145,202211,756,663,93,803606.34,112718.53,916324.87
240150,202211,26,19,7,23028.9,8484.2,31513.1
240160,202211,41,31,10,37572.51,12121.49,49694.00
240165,202211,44,36,8,43636.92,9697.61,53334.53
240170,202211,155,108,47,130900.76,56964.63,187865.39
240180,202211,120,89,31,107871.1,37572.27,145443.37
240185,202211,54,46,8,55753.42,9696.54,65449.96
240190,202211,17,15,2,18182.01,2424.34,20606.35
240200,202211,3246,1743,1503,2113955.2,1823054.29,3937009.49
240210,202211,165,126,39,152713.78,47268.74,199982.52
240220,202211,1197,817,380,990297.07,460594.16,1450891.23
240230,202211,874,780,94,945489.83,113936.55,1059426.38
240240,202211,85,56,29,67872,35148.48,103020.48
240250,202211,101,85,16,103027.73,19393.22,122420.95
240260,202211,1984,1386,598,1680002.29,724836.93,2404839.22
240270,202211,177,152,25,184229.52,30300,214529.52
240280,202211,68,55,13,66660.8,15756,82416.8
240290,202211,43,41,2,49693.32,2424,52117.32
240300,202211,172,93,79,112719.45,95750.76,208470.21
240310,202211,2639,1408,1231,1706651.56,1494528.76,3201180.32
240320,202211,184,169,15,204829.23,18180.5,223009.73
240325,202211,5183,2919,2264,3538280.99,2745533.93,6283814.92
240330,202211,83,77,6,93324.98,7272,100596.98
240340,202211,106,73,33,88478.71,39997.86,128476.57
240350,202211,98,79,19,95749.26,23028.2,118777.46
240360,202211,758,477,281,578186.49,341812.48,919998.97
240370,202211,64,56,8,67873.65,9696.6,77570.25
240375,202211,54,34,20,41213.59,24243.27,65456.86
240380,202211,223,182,41,220611.42,49695.91,270307.33
240390,202211,17,14,3,16969.08,3636.34,20605.42
240400,202211,88,78,10,94537.98,12123.06,106661.04
240410,202211,12,9,3,10908,3636,14544
240420,202211,1176,837,339,1014525.41,410894.25,1425419.66
240430,202211,266,243,23,294563.49,27877.78,322441.27
240440,202211,154,83,71,100601.13,86055.53,186656.66
240450,202211,260,158,102,191514.13,123632.72,315146.85
240460,202211,89,69,20,83629.27,24240,107869.27
240470,202211,227,204,23,247284.87,27879.94,275164.81
240480,202211,15,13,2,15756.17,2424.84,18181.01
240485,202211,83,66,17,79994.22,20605.38,100599.60
240490,202211,63,57,6,69086.09,7272.95,76359.04
240500,202211,108,83,25,100597.04,30300,130897.04
240510,202211,40,30,10,36360,12120,48480
240520,202211,98,93,5,112731.16,6060.47,118791.63
240530,202211,63,51,12,61813.37,14544.54,76357.91
240540,202211,101,87,14,105444.6,16968.26,122412.86
240550,202211,14,11,3,13332.44,3636.2,16968.64
240560,202211,415,280,135,339385.63,163624.69,503010.32
240570,202211,449,277,172,335771.27,208500.45,544271.72
240580,202211,1396,1045,351,1266651.49,425435.52,1692087.01
240590,202211,30,29,1,35149.27,1212,36361.27
240600,202211,101,94,7,113929.01,8484.5,122413.51
240610,202211,512,420,92,509126.37,111521.83,620648.20
240615,202211,13,12,1,14546.87,1212.5,15759.37
240620,202211,88,84,4,101812.46,4848,106660.46
240630,202211,42,34,8,41214.48,9697.05,50911.53
240640,202211,39,26,13,31513.31,15757.6,47270.91
240650,202211,246,194,52,235137.73,63025.93,298163.66
240660,202211,115,98,17,118777.93,20604,139381.93
240670,202211,311,169,142,204856.7,172131.46,376988.16
240680,202211,57,44,13,53330.6,15756.37,69086.97
240690,202211,52,49,3,59396.26,3637.61,63033.87
240700,202211,178,147,31,178164.95,37573.51,215738.46
240710,202211,2376,1420,956,1721188.06,1158754.55,2879942.61
240720,202211,1114,785,329,951490.48,398773.28,1350263.76
240725,202211,75,67,8,81206.2,9696.28,90902.48
240730,202211,149,124,25,150292.11,30300,180592.11
240740,202211,237,195,42,236372.46,50912.37,287284.83
240750,202211,52,29,23,35148,27878.27,63026.27
240760,202211,57,45,12,54540.98,14544,69084.98
240770,202211,150,116,34,140596.73,41211.35,181808.08
240780,202211,758,623,135,755132.72,163636.05,918768.77
240790,202211,41,39,2,47274.95,2424.88,49699.83
240800,202211,10141,6813,3328,8263322.59,4035392.41,12298715.00
240810,202211,22833,12057,10776,14621212.09,13074417.62,27695629.71
240820,202211,278,164,114,198783.21,138184.36,336967.57
240830,202211,1645,1350,295,1637542.62,357572.77,1995115.39
240840,202211,76,64,12,77574.92,14545.81,92120.73
240850,202211,91,80,11,96961.88,13332.78,110294.66
240860,202211,112,107,5,129687.02,6060,135747.02
240870,202211,59,48,11,58182.91,13333.44,71516.35
240880,202211,31,28,3,33936.44,3636,37572.44
240890,202211,1233,687,546,832742.71,661819.57,1494562.28
240895,202211,65,49,16,59389.81,19392.59,78782.40
240910,202211,185,152,33,184228.28,39996.51,224224.79
240920,202211,14,12,2,14547.57,2424.6,16972.17
240930,202211,433,384,49,465476.35,59396.91,524873.26
240933,202211,64,40,24,48483.04,29090.18,77573.22
240940,202211,2374,2074,300,2513878.66,363641.09,2877519.75
240950,202211,43,38,5,46059.92,6060,52119.92
240960,202211,25,20,5,24243.46,6061.64,30305.10
240970,202211,110,77,33,93324.59,39997.33,133321.92
240980,202211,213,166,47,201196.12,56967.15,258163.27
240990,202211,145,93,52,112719.73,63024.74,175744.47
241000,202211,61,55,6,66666.67,7272.34,73939.01
241010,202211,90,70,20,84842.2,24240,109082.2
241020,202211,114,104,10,126054.52,12122.3,138176.82
241025,202211,22,14,8,16968.95,9698.41,26667.36
241030,202211,114,91,23,110292.88,27876,138168.88
241040,202211,50,37,13,44844.6,15757.2,60601.8
241050,202211,74,68,6,82417.32,7272,89689.32
241060,202211,26,22,4,26665.74,4848.84,31514.58
241070,202211,25,25,0,30303.96,,30303.96
241080,202211,62,54,8,65450.76,9696.98,75147.74
241090,202211,57,45,12,54544.43,14544.1,69088.53
241100,202211,74,63,11,76363.16,13333.06,89696.22
241105,202211,28,17,11,20605.23,13332.8,33938.03
241110,202211,53,43,10,52117.42,12120.5,64237.92
241120,202211,1755,1325,430,1605991.76,521192.03,2127183.79
241140,202211,206,169,37,204847.48,44846.96,249694.44
241142,202211,53,39,14,47270.91,16970.53,64241.44
241150,202211,1216,1046,170,1267875.38,206058.98,1473934.36
241160,202211,26,19,7,23028,8484,31512
241170,202211,51,44,7,53328,9696,63024
241180,202211,45,32,13,38791.04,15758.94,54549.98
241190,202211,42,38,4,46061.62,4848.34,50909.96
241200,202211,4912,2551,2361,3092245.8,2863147.65,5955393.45
241210,202211,73,62,11,75146.93,13332,88478.93
241220,202211,1603,1019,584,1235161.52,709095.93,1944257.45
241230,202211,258,209,49,253324.93,59394.01,312718.94
241240,202211,50,36,14,43634.64,16969.18,60603.82
241250,202211,1180,1078,102,1307887.64,123638.66,1431526.30
241255,202211,65,53,12,64239.53,14544.5,78784.03
241260,202211,752,573,179,695733.41,216963.67,912697.08
241270,202211,72,51,21,61814.01,25452.76,87266.77
241280,202211,99,86,13,104238.2,15757.91,119996.11
241290,202211,142,104,38,126060.89,46058.63,172119.52
241300,202211,84,58,26,70296.66,31513.82,101810.48
241310,202211,50,34,16,41208.37,19392,60600.37
241320,202211,39,20,19,24244.38,23031.46,47275.84
241330,202211,65,56,9,67876.36,10908,78784.36
241335,202211,97,86,11,104235.25,13332,117567.25
241340,202211,187,135,52,163625.65,63025.97,226651.62
241350,202211,65,54,11,65449.72,13332,78781.72
241355,202211,55,45,10,54545.73,12122.53,66668.26
241360,202211,56,53,3,64237.2,3636,67873.2
241370,202211,64,52,12,63024,14544,77568
241380,202211,37,32,5,38787.09,6060,44847.09
241390,202211,86,67,19,81204,23028,104232
241400,202211,228,169,59,205707.7,71508.4,277216.1
241410,202211,184,162,22,196348.99,26664.43,223013.42
241415,202211,106,84,22,101809.07,26664.11,128473.18
241420,202211,137,95,42,115145,50908.67,166053.67
241430,202211,20,18,2,21818.19,2424,24242.19
241440,202211,547,460,87,557598.78,106673.06,664271.84
241445,202211,44,37,7,44845.5,8484.55,53330.05
241450,202211,265,221,44,267877.16,53335.34,321212.50
241460,202211,172,157,15,190292.18,18181.87,208474.05
241470,202211,33,27,6,32727.47,7273.13,40000.60
241475,202211,48,44,4,53329.84,4848,58177.84
241480,202211,143,104,39,126052.52,47270.66,173323.18
241490,202211,14,11,3,13333.15,3636.97,16970.12
241500,202211,50,39,11,47271.76,13333.19,60604.95
250010,202211,104,86,18,104235.61,21816.46,126052.07
250020,202211,31,26,5,31512.91,6060.4,37573.31
250030,202211,915,667,248,808477.04,300606.4,1109083.44
250040,202211,411,331,80,401233,96968.79,498201.79
250050,202211,292,238,54,288463.24,65450.95,353914.19
250053,202211,64,52,12,63029.72,14544.78,77574.50
250057,202211,2,1,1,1212,1212,2424
250060,202211,646,463,183,561216.23,221822.23,783038.46
250070,202211,689,547,142,663058.99,172129.43,835188.42
250073,202211,9,8,1,9697.63,1212.84,10910.47
250077,202211,184,134,50,162416.43,60602.91,223019.34
250080,202211,416,329,87,398795.44,105456.07,504251.51
250090,202211,225,143,82,173317.95,99384.54,272702.49
250100,202211,599,478,121,579398.75,146662.1,726060.85
250110,202211,701,507,194,614525.83,235136.72,849662.55
250115,202211,14,4,10,4849.65,12125.17,16974.82
250120,202211,127,89,38,107869.73,47270.28,155140.01
250130,202211,575,473,102,574577.69,124856.36,699434.05
250135,202211,33,15,18,18180,21816.38,39996.38
250140,202211,88,74,14,89695.2,16969.6,106664.8
250150,202211,649,454,195,550285.54,236352.14,786637.68
250153,202211,15,12,3,14544.98,3636.8,18181.78
250157,202211,33,26,7,31513.26,8484,39997.26
250160,202211,248,187,61,226668.16,73936.73,300604.89
250170,202211,87,58,29,70298.6,35148.73,105447.33
250180,202211,5065,3490,1575,4231546.08,1909145.68,6140691.76
250190,202211,824,556,268,673906.94,324836.15,998743.09
250200,202211,71,54,17,65450.6,20605.57,86056.17
250205,202211,22,17,5,20605.24,6060.94,26666.18
250210,202211,89,74,15,89688.89,18180.2,107869.09
250215,202211,87,60,27,72725.51,32725.39,105450.90
250220,202211,30,20,10,24241.78,12120.94,36362.72
250230,202211,78,70,8,84846.9,9697.33,94544.23
250240,202211,248,188,60,227876.14,72727.41,300603.55
250250,202211,404,346,58,419421.63,70301.56,489723.19
250260,202211,49,38,11,46056.2,13332,59388.2
250270,202211,81,58,23,70297.35,27876,98173.35
250280,202211,399,329,70,398762.22,84843.46,483605.68
250290,202211,111,98,13,118779.65,15757.26,134536.91
250300,202211,534,360,174,436363.97,210903.7,647267.67
250310,202211,56,52,4,63028.37,4849.14,67877.51
250320,202211,2123,1404,719,1701849.3,871529.51,2573378.81
250330,202211,120,103,17,124843.85,20605.31,145449.16
250340,202211,32,26,6,31514.48,7272.27,38786.75
250350,202211,208,137,71,166052.7,86054.12,252106.82
250355,202211,43,34,9,41208.67,10909.86,52118.53
250360,202211,192,158,34,191512.49,41214.4,232726.89
250370,202211,2480,1580,900,1915183.29,1092152.07,3007335.36
250375,202211,17,11,6,13333.77,7272.89,20606.66
250380,202211,57,49,8,59391.13,9696.47,69087.60
250390,202211,46,37,9,44846.89,10909.04,55755.93
250400,202211,17978,9127,8851,11072980.83,10736157.96,21809138.79
250403,202211,306,233,73,282405.74,88478.96,370884.70
250407,202211,68,55,13,66660,15757.44,82417.44
250410,202211,31,26,5,31518.12,6060.67,37578.79
250415,202211,50,30,20,36360.65,24240,60600.65
250420,202211,41,35,6,42421.16,7272.44,49693.60
250430,202211,1523,1320,203,1600271.68,246059.05,1846330.73
250435,202211,35,27,8,32726.67,9696,42422.67
250440,202211,688,566,122,686047.28,147874.66,833921.94
250450,202211,87,65,22,78785.75,26665.1,105450.85
250460,202211,495,322,173,390278.12,209685.95,599964.07
250470,202211,104,70,34,84840.04,41208.14,126048.18
250480,202211,337,266,71,322442.93,86070.25,408513.18
250485,202211,6,6,0,7272,,7272.0
250490,202211,257,206,51,249677.6,61814.2,311491.8
250500,202211,98,76,22,92113.06,26664,118777.06
250510,202211,858,677,181,820580.25,220594.89,1041175.14
250520,202211,170,116,54,140595.43,65450.57,206046.00
250523,202211,127,104,23,126049.84,27876.85,153926.69
250527,202211,123,90,33,109083.7,39996,149079.7
250530,202211,10,6,4,7272,4848.34,12120.34
250535,202211,33,26,7,31513.62,8485.11,39998.73
250540,202211,147,116,31,140596.77,37573.04,178169.81
250550,202211,73,71,2,86054.76,2424,88478.76
250560,202211,68,41,27,49692.8,32724,82416.8
250570,202211,167,135,32,163623.07,38785.41,202408.48
250580,202211,97,76,21,92191.48,25452,117643.48
250590,202211,24,13,11,15756.44,13335.13,29091.57
250600,202211,1640,1072,568,1299378.64,688461.34,1987839.98
250610,202211,162,128,34,155166.75,41213.46,196380.21
250620,202211,21,17,4,20604.7,4848.44,25453.14
250625,202211,72,56,16,67891.25,19400.49,87291.74
250630,202211,3223,2012,1211,2438972.5,1469114.66,3908087.16
250640,202211,202,160,42,193944.12,50911.34,244855.46
250650,202211,32,20,12,24240.86,14544.7,38785.56
250660,202211,63,47,16,56964,19392.77,76356.77
250670,202211,81,63,18,76357.37,21817.29,98174.66
250680,202211,433,346,87,419407.74,105454.67,524862.41
250690,202211,2260,1528,732,1852051.67,887256.26,2739307.93
250700,202211,946,806,140,976939.56,170901.37,1147840.93
250710,202211,500,386,114,467893.31,138189.03,606082.34
250720,202211,121,87,34,105446.9,41208.8,146655.7
250730,202211,423,348,75,421812.94,90911.88,512724.82
250740,202211,72,64,8,77570.12,9696.43,87266.55
250750,202211,25507,14976,10531,18155278.28,12768848.8,30924127.08
250760,202211,124,98,26,118778.75,31514.4,150293.15
250770,202211,381,252,129,306663.9,156357.18,463021.08
250780,202211,74,51,23,61812.6,27876.06,89688.66
250790,202211,475,288,187,349077.83,226659.41,575737.24
250800,202211,153,138,15,167256.61,18180,185436.61
250810,202211,74,60,14,72720.94,16968.44,89689.38
250820,202211,159,131,28,158784.99,33938.2,192723.19
250830,202211,497,323,174,392751.39,212119.58,604870.97
250840,202211,59,50,9,60605.91,10909.47,71515.38
250850,202211,67,57,10,69085.4,12120,81205.4
250855,202211,16,14,2,16972.21,2425.14,19397.35
250860,202211,249,158,91,191498.45,110294.26,301792.71
250870,202211,29,26,3,31513.41,3636,35149.41
250880,202211,95,72,23,87264.88,27876,115140.88
250890,202211,3285,2415,870,2928379.61,1054512.94,3982892.55
250900,202211,67,56,11,67874.17,13332,81206.17
250905,202211,128,94,34,113928.85,41208.67,155137.52
250910,202211,1007,723,284,876357.65,344239.82,1220597.47
250915,202211,117,78,39,94543,47270.98,141813.98
250920,202211,153,113,40,136957.23,48481.03,185438.26
250930,202211,201,115,86,139381.24,104233.58,243614.82
250933,202211,12,9,3,10908,3636.88,14544.88
250937,202211,18,17,1,20604.5,1212.34,21816.84
250939,202211,43,32,11,38786.92,13332.4,52119.32
250940,202211,135,97,38,117569.39,46058.37,163627.76
250950,202211,91,67,24,81208.19,29089.72,110297.91
250960,202211,87,49,38,59390.56,46056.8,105447.36
250970,202211,1330,932,398,1129683.99,482404.15,1612088.14
250980,202211,99,66,33,79996.57,39996,119992.57
250990,202211,172,130,42,157560,50904,208464
251000,202211,87,74,13,89688.44,15756.87,105445.31
251010,202211,138,95,43,115142.36,52118.52,167260.88
251020,202211,88,72,16,87264.2,19392,106656.2
251030,202211,49,34,15,41210.55,18180.49,59391.04
251040,202211,68,47,21,56964.13,25452,82416.13
251050,202211,30,24,6,29088,7272,36360
251060,202211,53,42,11,50908.79,13333.18,64241.97
251065,202211,6,3,3,3636,3637.34,7273.34
251070,202211,19,16,3,19393.44,3636.95,23030.39
251080,202211,5648,2623,3025,3179420.37,3667920.83,6847341.20
251090,202211,198,163,35,197562.52,42424.79,239987.31
251100,202211,23,22,1,26666.5,1212,27878.5
251110,202211,65,43,22,52116,26664.64,78780.64
251120,202211,2006,1235,771,1497023.5,934570.47,2431593.97
251130,202211,450,368,82,446054.4,99389.42,545443.82
251140,202211,637,416,221,504224.97,267863.29,772088.26
251150,202211,348,285,63,345466.99,76361.34,421828.33
251160,202211,100,79,21,95749.14,25452,121201.14
251170,202211,88,73,15,88480.61,18180,106660.61
251180,202211,302,171,131,207273.05,158788.12,366061.17
251190,202211,213,135,78,163627.51,94543.36,258170.87
251200,202211,310,239,71,289701.93,86058.61,375760.54
251203,202211,34,31,3,37575.38,3636,41211.38
251207,202211,88,73,15,88477.65,18180,106657.65
251210,202211,1602,1160,442,1406025.94,535765.46,1941791.40
251220,202211,50,39,11,47270.87,13333.55,60604.42
251230,202211,596,500,96,607275.24,117577.27,724852.51
251240,202211,123,85,38,103020.81,46056.98,149077.79
251250,202211,1606,1151,455,1395049.69,551508.01,1946557.70
251260,202211,12,8,4,9699.25,4849.26,14548.51
251270,202211,322,252,70,305465.06,84848.27,390313.33
251272,202211,61,53,8,64236.62,9696.6,73933.22
251274,202211,27,20,7,24243.34,8486.38,32729.72
251275,202211,36,19,17,23032.13,20604.52,43636.65
251276,202211,29,22,7,26664.3,8484.15,35148.45
251278,202211,14,11,3,13333.96,3636.98,16970.94
251280,202211,113,109,4,132110.87,4848,136958.87
251290,202211,1145,804,341,974551.73,413336.81,1387888.54
251300,202211,19,14,5,16968.88,6061.04,23029.92
251310,202211,325,233,92,283633.21,111512.99,395146.20
251315,202211,41,36,5,43632,6060.5,49692.5
251320,202211,73,59,14,71512.5,16970.73,88483.23
251330,202211,85,76,9,92114.83,10909.14,103023.97
251335,202211,24,15,9,18180,10909.27,29089.27
251340,202211,839,466,373,564835.3,452108.87,1016944.17
251350,202211,37,35,2,42420.39,2424,44844.39
251360,202211,87,74,13,89688.74,15756.6,105445.34
251365,202211,8,8,0,9698.93,,9698.93
251370,202211,6163,4173,1990,5060433.85,2413251.34,7473685.19
251380,202211,47,37,10,44848.82,12121.12,56969.94
251385,202211,3,3,0,3636.5,,3636.5
251390,202211,1018,744,274,901842.5,332125.77,1233968.27
251392,202211,33,22,11,26664.66,13332.94,39997.60
251394,202211,15,12,3,14545.22,3636.2,18181.42
251396,202211,13,7,6,8484.41,7273.66,15758.07
251398,202211,22,18,4,21816.81,4848.6,26665.41
251400,202211,53,41,12,49694.96,14544.6,64239.56
251410,202211,47,40,7,48480.84,8485,56965.84
251420,202211,114,82,32,99389.08,38787.7,138176.78
251430,202211,47,41,6,49692.2,7272.44,56964.64
251440,202211,56,29,27,35148,32724.67,67872.67
251445,202211,69,59,10,71513.32,12121.78,83635.10
251450,202211,394,336,58,407303.88,70305.55,477609.43
251455,202211,5,4,1,4848,1212.5,6060.5
251460,202211,25,18,7,21816.72,8485.24,30301.96
251465,202211,11,5,6,6060.44,7273.51,13333.95
251470,202211,55,41,14,49692.5,16968.67,66661.17
251480,202211,28,24,4,29088.5,4848.96,33937.46
251490,202211,117,69,48,83647.75,58188.64,141836.39
251500,202211,115,94,21,113933.1,25452.26,139385.36
251510,202211,95,59,36,71511.17,43633.34,115144.51
251520,202211,41,33,8,39997.04,9696,49693.04
251530,202211,4437,3100,1337,3759828.05,1621780.6,5381608.65
251540,202211,94,75,19,90900.72,23029.77,113930.49
251550,202211,435,329,106,398802.79,128492.63,527295.42
251560,202211,28,21,7,25454.64,8485.58,33940.22
251570,202211,18,17,1,20604,1212,21816
251580,202211,134,105,29,127261.61,35148,162409.61
251590,202211,106,74,32,89688,38784.07,128472.07
251593,202211,29,15,14,18181.26,16968.85,35150.11
251597,202211,125,96,29,116354.86,35150.78,151505.64
251600,202211,1116,768,348,931200.57,421799.38,1352999.95
251610,202211,267,192,75,232721.97,90903.85,323625.82
251615,202211,19,16,3,19392.4,3636,23028.4
251620,202211,4272,2710,1562,3284823.53,1893313.67,5178137.20
251630,202211,494,364,130,441227.79,157579.78,598807.57
251640,202211,111,81,30,98187.3,36368.19,134555.49
251650,202211,303,224,79,271517.85,95757.15,367275.00
251660,202211,203,178,25,215767.75,30304.23,246071.98
251670,202211,415,316,99,383042.19,120002.61,503044.80
251675,202211,15,9,6,10908,7272.37,18180.37
251680,202211,113,99,14,119990.79,18180.89,138171.68
251690,202211,322,266,56,322739.43,67878.97,390618.40
251700,202211,281,240,41,290921.74,49699.82,340621.56
251710,202211,23,14,9,16969.14,10909.83,27878.97
251720,202211,32,25,7,30303.69,8485.93,38789.62
251740,202211,13,10,3,12122.32,3636,15758.32
260005,202211,3803,1983,1820,2410424.09,2213350.05,4623774.14
260010,202211,1780,1326,454,1608405.36,550275.47,2158680.83
260020,202211,426,367,59,444860.44,71513.34,516373.78
260030,202211,638,427,211,517591.53,256968.5,774560.03
260040,202211,827,513,314,621854.09,380603.53,1002457.62
260050,202211,1177,848,329,1027863.27,398774.96,1426638.23
260060,202211,378,349,29,423030.43,35152.96,458183.39
260070,202211,1374,837,537,1014623.47,650965.57,1665589.04
260080,202211,756,569,187,689739.86,226668.29,916408.15
260090,202211,492,311,181,376965.07,219397.56,596362.63
260100,202211,220,149,71,180591.82,86054.08,266645.90
260105,202211,275,159,116,192712.61,140593.47,333306.08
260110,202211,3100,2230,870,2703060.87,1054522.02,3757582.89
260120,202211,2858,1511,1347,1833011.27,1633916.83,3466928.10
260130,202211,217,152,65,184229.9,78782.6,263012.5
260140,202211,2313,1487,826,1804836.79,1001201.19,2806037.98
260150,202211,197,128,69,155160.18,83638.53,238798.71
260160,202211,366,285,81,346668.44,98180.48,444848.92
260170,202211,3562,2105,1457,2551553.99,1766065.79,4317619.78
260180,202211,193,163,30,197565.99,36363,233928.99
260190,202211,2513,1637,876,1984229.09,1063022.9,3047251.99
260200,202211,1032,802,230,972116.25,278772.67,1250888.92
260210,202211,1410,1002,408,1215762.85,494548.38,1710311.23
260220,202211,652,576,76,698195.39,92121.91,790317.30
260230,202211,1327,974,353,1183006.02,427874.12,1610880.14
260240,202211,216,163,53,197583.57,64242.5,261826.07
260250,202211,102,76,26,92119.93,31514.16,123634.09
260260,202211,1126,781,345,946654.8,418177.12,1364831.92
260270,202211,260,187,73,226660.76,88481.27,315142.03
260280,202211,1176,935,241,1133325.83,292115.18,1425441.01
260290,202211,7315,3910,3405,4739402.15,4129741.82,8869143.97
260300,202211,1078,912,166,1105458.59,201204.49,1306663.08
260310,202211,540,427,113,517581.16,138182.43,655763.59
260320,202211,831,592,239,717522.1,289677.21,1007199.31
260330,202211,87,65,22,78782.11,26665.56,105447.67
260340,202211,88,64,24,77574.41,29089.51,106663.92
260345,202211,6107,3116,2991,3778278.46,3626768.04,7405046.50
260350,202211,503,357,146,432738.11,176967.56,609705.67
260360,202211,251,144,107,174531.13,129685.75,304216.88
260370,202211,743,476,267,576975.38,323644.29,900619.67
260380,202211,557,394,163,477587.96,198788.25,676376.21
260390,202211,296,252,44,305458.21,53334.71,358792.92
260392,202211,115,100,15,121205.06,18180.9,139385.96
260400,202211,4633,2640,1993,3201043.23,2415656.67,5616699.90
260410,202211,16005,8235,7770,9984237.16,9425373.88,19409611.04
260415,202211,156,129,27,156355.43,32724.2,189079.63
260420,202211,1815,1133,682,1375708.08,826639.21,2202347.29
260430,202211,174,155,19,187894.47,23030,210924.47
260440,202211,206,139,67,168480.11,81216.06,249696.17
260450,202211,430,321,109,389097.01,132127.28,521224.29
260460,202211,887,456,431,552731.64,522422.94,1075154.58
260470,202211,341,206,135,249708.71,163637.18,413345.89
260480,202211,259,164,95,198771.29,115142.42,313913.71
260490,202211,236,182,54,220602.98,65449.87,286052.85
260500,202211,1192,790,402,957604.25,487284.75,1444889.00
260510,202211,865,684,181,829055.6,219384.67,1048440.27
260515,202211,247,227,20,275131.16,24242.03,299373.19
260520,202211,3309,2013,1296,2439902.21,1570905.97,4010808.18
260530,202211,868,692,176,838811.34,213331.84,1052143.18
260540,202211,556,433,123,524852.29,149091.08,673943.37
260545,202211,26,13,13,15757.78,15756.57,31514.35
260550,202211,359,233,126,282403.85,152715.26,435119.11
260560,202211,517,392,125,475171.58,151516.95,626688.53
260570,202211,1061,848,213,1027906.48,258170.74,1286077.22
260580,202211,356,286,70,346651.33,84842.12,431493.45
260590,202211,646,374,272,453297.12,329675.25,782972.37
260600,202211,8213,4769,3444,5781637.23,4174456.42,9956093.65
260610,202211,511,346,165,419406.89,200004.22,619411.11
260620,202211,4001,2068,1933,2507832.9,2344341.38,4852174.28
260630,202211,83,74,9,89688,10908,100596
260640,202211,3527,2121,1406,2570846.11,1705445.05,4276291.16
260650,202211,332,240,92,290916.45,111517.36,402433.81
260660,202211,621,402,219,487275.89,265442.56,752718.45
260670,202211,111,76,35,92112,42421.1,134533.1
260680,202211,4245,2282,1963,2766151.12,2381966.36,5148117.48
260690,202211,136,100,36,121205.73,43634.92,164840.65
260700,202211,325,220,105,266676.11,127281.57,393957.68
260710,202211,49,42,7,50904,8484.85,59388.85
260720,202211,2805,1634,1171,1980567.23,1420547.02,3401114.25
260730,202211,781,576,205,698147.91,248471.23,946619.14
260740,202211,82,67,15,81206.32,18180,99386.32
260750,202211,578,429,149,520025.92,180611.95,700637.87
260760,202211,782,388,394,470311.34,477578.52,947889.86
260765,202211,1058,551,507,667854.82,614542.63,1282397.45
260770,202211,224,161,63,195135.27,76363.81,271499.08
260775,202211,876,452,424,547879.95,515158.04,1063037.99
260780,202211,243,153,90,185438.01,109082.14,294520.15
260790,202211,16595,8060,8535,9774764.12,10352754.66,20127518.78
260795,202211,166,109,57,132110.12,70296.11,202406.23
260800,202211,310,252,58,305451.74,70300.07,375751.81
260805,202211,42,30,12,36365.69,14549.42,50915.11
260810,202211,867,696,171,843630.68,208471.54,1052102.22
260820,202211,325,210,115,255740.51,139386.2,395126.71
260825,202211,216,145,71,175742.63,86052.93,261795.56
260830,202211,304,194,110,235130.18,133321.38,368451.56
260840,202211,278,196,82,237574.86,99389.38,336964.24
260845,202211,209,123,86,149078.21,104234.47,253312.68
260850,202211,438,326,112,395149.69,135753.04,530902.73
260860,202211,237,180,57,218166.64,69087.25,287253.89
260870,202211,348,273,75,330921.25,90910.75,421832.00
260875,202211,768,551,217,667898.41,263026.24,930924.65
260880,202211,1650,1094,556,1325997.65,675105.69,2001103.34
260890,202211,2564,1751,813,2127243.24,985433.53,3112676.77
260900,202211,1046,765,281,927249.47,340617.66,1267867.13
260910,202211,260,206,54,249693.75,66664.11,316357.86
260915,202211,283,212,71,256944.46,86052,342996.46
260920,202211,228,122,106,147864.44,128473.3,276337.74
260930,202211,365,310,55,375768.02,66665.39,442433.41
260940,202211,2686,1432,1254,1738226.97,1520057.35,3258284.32
260950,202211,2083,1172,911,1420596.18,1104260.78,2524856.96
260960,202211,14710,7055,7655,8555608.37,9281607.02,17837215.39
260970,202211,441,353,88,427892.91,106663.84,534556.75
260980,202211,215,195,20,236356.75,24241.04,260597.79
260990,202211,2777,2203,574,2670304.6,695742.94,3366047.54
261000,202211,4378,2685,1693,3255623.28,2052058.91,5307682.19
261010,202211,135,100,35,121202.03,42424.83,163626.86
261020,202211,607,441,166,535778.65,201211.87,736990.52
261030,202211,261,193,68,233918.65,82419.76,316338.41
261040,202211,383,321,62,389103.67,75148.57,464252.24
261050,202211,548,454,94,550313.77,113936.67,664250.44
261060,202211,1621,993,628,1203613.12,761190.67,1964803.79
261070,202211,10370,4871,5499,5905668.02,6668181.47,12573849.49
261080,202211,369,282,87,341834.06,105452.17,447286.23
261090,202211,2142,1640,502,1987888.9,610898.93,2598787.83
261100,202211,1282,883,399,1071515.68,483624.15,1555139.83
261110,202211,9850,6135,3715,7440081.67,4506662.34,11946744.01
261120,202211,234,199,35,241191.1,42422.47,283613.57
261130,202211,590,344,246,417005.45,298198.55,715204.00
261140,202211,219,138,81,167257.72,99384.64,266642.36
261150,202211,683,439,244,532109.66,295742.43,827852.09
261153,202211,75,70,5,84844.39,6060,90904.39
261160,202211,80346,39106,41240,47428679.93,50031944.44,97460624.37
261170,202211,511,381,130,461780.43,157567.19,619347.62
261180,202211,1857,1162,695,1408758.97,842414.49,2251173.46
261190,202211,605,410,195,496974.53,236351.76,733326.29
261200,202211,221,178,43,215764.27,52120.83,267885.10
261210,202211,46,34,12,41209.42,14544,55753.42
261220,202211,2937,2042,895,2475086.33,1084836.16,3559922.49
261230,202211,384,281,103,340597.48,124841.39,465438.87
261240,202211,452,383,69,464225.1,83632.26,547857.36
261245,202211,255,217,38,263005.48,46056.61,309062.09
261247,202211,173,131,42,158786.06,50907.28,209693.34
261250,202211,3965,1885,2080,2286063.14,2523647.2,4809710.34
261255,202211,261,231,30,279976.62,36360,316336.62
261260,202211,884,757,127,917628.22,153942.23,1071570.45
261270,202211,208,147,61,179384.23,73932.88,253317.11
261280,202211,203,161,42,196368.31,50905.2,247273.51
261290,202211,102,74,28,89688.12,33937.03,123625.15
261300,202211,1453,1079,374,1307848.59,454532.93,1762381.52
261310,202211,840,554,286,671526.31,346663.81,1018190.12
261320,202211,531,365,166,443637.51,201212.57,644850.08
261330,202211,932,727,205,882487.06,248506.5,1130993.56
261340,202211,340,189,151,229085.21,183022.77,412107.98
261350,202211,948,652,296,790334.38,358798.02,1149132.40
261360,202211,1446,911,535,1104178.21,648454.27,1752632.48
261370,202211,5194,3034,2160,3678721.01,2621764.8,6300485.81
261380,202211,586,457,129,553914.5,156370.17,710284.67
261390,202211,3941,2665,1276,3231604.89,1547942.12,4779547.01
261400,202211,281,249,32,301822.07,38786.39,340608.46
261410,202211,1177,770,407,933329.81,493312.31,1426642.12
261420,202211,994,605,389,733329.4,471496.17,1204825.57
261430,202211,326,292,34,353938.35,41210.98,395149.33
261440,202211,103,97,6,117571.23,7272,124843.23
261450,202211,2668,2071,597,2510270.39,723618.07,3233888.46
261460,202211,802,619,183,750326.48,221813.77,972140.25
261470,202211,239,190,49,230287.08,59390.15,289677.23
261480,202211,497,368,129,446060.84,156306.4,602367.24
261485,202211,406,245,161,296965.87,195145.44,492111.31
261500,202211,654,420,234,509123.23,283645.32,792768.55
261510,202211,54,36,18,43634.38,21817.48,65451.86
261520,202211,99,84,15,101816.53,18182.13,119998.66
261530,202211,4372,2797,1575,3392605.18,1909043.4,5301648.58
261540,202211,1565,901,664,1092086.71,804824.77,1896911.48
261550,202211,271,128,143,155139.14,173322.07,328461.21
261560,202211,997,655,342,793950.74,414544.83,1208495.57
261570,202211,395,315,80,381835.02,96978.08,478813.10
261580,202211,407,326,81,395168.44,98180.54,493348.98
261590,202211,194,157,37,190306.76,44846.93,235153.69
261600,202211,322,249,73,301827.07,88479.82,390306.89
261610,202211,92,76,16,92115.65,19393.54,111509.19
261618,202211,84,57,27,69087.48,32725.11,101812.59
261620,202211,212,135,77,163629.53,93328.47,256958.00
261630,202211,701,543,158,658169.35,191516.68,849686.03
261640,202211,6988,3677,3311,4461914.41,4020745.44,8482659.85
261650,202211,466,297,169,361188.31,206048.2,567236.51
270010,202211,521,462,59,560025.56,71522.2,631547.76
270020,202211,257,211,46,255766.29,55759.34,311525.63
270030,202211,9470,6078,3392,7369544.09,4112615.38,11482159.47
270040,202211,2129,1393,736,1692046.94,893319.97,2585366.91
270050,202211,241,187,54,226656.39,65450.83,292107.22
270060,202211,75,50,25,60613.67,30306.92,90920.59
270070,202211,796,583,213,707862.75,258174.57,966037.32
270080,202211,55,42,13,50906.76,15757.09,66663.85
270090,202211,21,16,5,19392,6060.2,25452.2
270100,202211,1337,906,431,1098139.69,523632.81,1621772.50
270110,202211,68,55,13,66664.07,15757.38,82421.45
270120,202211,259,212,47,256971.74,56970.46,313942.20
270130,202211,343,259,84,313926.6,103028.07,416954.67
270135,202211,121,84,37,101811.41,44844.2,146655.61
270140,202211,1435,945,490,1145418.2,593965.08,1739383.28
270150,202211,249,191,58,231522.09,70302.38,301824.47
270160,202211,484,380,104,460607.39,126065.7,586673.09
270170,202211,816,544,272,659348.42,330886.15,990234.57
270180,202211,57,46,11,55753.37,13332.31,69085.68
270190,202211,110,96,14,116360.3,16968,133328.3
270200,202211,115,102,13,123628.34,15756.44,139384.78
270210,202211,555,341,214,413316.91,259386.31,672703.22
270220,202211,202,143,59,173323.27,71514.31,244837.58
270230,202211,2229,1408,821,1706600.14,995112.32,2701712.46
270235,202211,506,389,117,472742.11,141819.86,614561.97
270240,202211,3384,2680,704,3248358.95,854529.04,4102887.99
270250,202211,126,95,31,115160.39,37582.22,152742.61
270255,202211,214,177,37,214527.44,44844.44,259371.88
270260,202211,420,335,85,406071.55,103031.53,509103.08
270270,202211,101,56,45,67873.96,54543.43,122417.39
270280,202211,201,127,74,153924,89688.83,243612.83
270290,202211,1144,899,245,1089673.35,296972.05,1386645.40
270300,202211,381,276,105,334515.84,127263.46,461779.30
270310,202211,824,690,134,836359.11,162420.64,998779.75
270320,202211,769,663,106,803644.56,128484.31,932128.87
270330,202211,329,284,45,344210.77,54540.32,398751.09
270340,202211,62,53,9,64238.06,10908.04,75146.10
270350,202211,84,48,36,58180.63,43637.23,101817.86
270360,202211,76,39,37,47271.93,44844.78,92116.71
270370,202211,67,52,15,63024,18180,81204
270375,202211,83,52,31,63027.88,37574.26,100602.14
270380,202211,1071,732,339,888403.92,410873.41,1299277.33
270390,202211,136,81,55,98173.35,66660.39,164833.74
270400,202211,758,584,174,709078.93,210904.34,919983.27
270410,202211,220,167,53,202439.72,64247.4,266687.12
270420,202211,410,285,125,345443.96,151518.57,496962.53
270430,202211,35805,25505,10300,30933000.26,12495037.03,43428037.29
270440,202211,471,370,101,448487.25,122425.14,570912.39
270450,202211,884,533,351,646047.03,426659.79,1072706.82
270460,202211,182,144,38,174551.78,46066.56,220618.34
270470,202211,1679,1180,499,1432699.24,606054.17,2038753.41
270480,202211,578,465,113,563616.99,136967.05,700584.04
270490,202211,25,19,6,23028.44,7272.44,30300.88
270500,202211,477,397,80,481226.2,96968.57,578194.77
270510,202211,915,607,308,735697.44,373331.87,1109029.31
270520,202211,265,178,87,215737.76,105447.7,321185.46
270530,202211,65,55,10,66661.43,12120,78781.43
270540,202211,90,63,27,76357.21,32724.44,109081.65
270550,202211,1680,1292,388,1566007.32,470295.91,2036303.23
270560,202211,252,154,98,186673.81,118798.23,305472.04
270570,202211,597,425,172,515124.71,208479.58,723604.29
270580,202211,18,14,4,16968,4848.67,21816.67
270590,202211,58,46,12,55758.07,14546.26,70304.33
270600,202211,158,135,23,163651.65,27879.66,191531.31
270610,202211,250,203,47,246046.82,56967.21,303014.03
270620,202211,17,17,0,20604.88,,20604.88
270630,202211,3680,2768,912,3357293.71,1105444.54,4462738.25
270640,202211,894,659,235,798781.03,284850.9,1083631.93
270642,202211,214,176,38,213323.76,46061.13,259384.89
270644,202211,287,177,110,214532.49,133338.26,347870.75
270650,202211,352,217,135,263018.49,163626.2,426644.69
270660,202211,194,172,22,208491.46,26668.91,235160.37
270670,202211,2985,2279,706,2762344.24,856948.11,3619292.35
270680,202211,396,258,138,312733.85,167274.98,480008.83
270690,202211,1259,853,406,1035124.31,492108.96,1527233.27
270700,202211,23,19,4,23028.98,4848,27876.98
270710,202211,557,434,123,526077.29,149099.83,675177.12
270720,202211,227,184,43,223029.5,52124.01,275153.51
270730,202211,1959,1219,740,1477544.73,896957.75,2374502.48
270740,202211,36,25,11,30300.39,13333.3,43633.69
270750,202211,621,479,142,580567.85,172112.58,752680.43
270760,202211,302,221,81,267881.71,98178.9,366060.61
270770,202211,2903,1987,916,2411544.74,1110308.6,3521853.34
270780,202211,68,42,26,50904.73,31513.11,82417.84
270790,202211,211,132,79,160001.92,95760.65,255762.57
270800,202211,2059,1647,412,1997541.29,499383.07,2496924.36
270810,202211,216,174,42,210895.19,50907.67,261802.86
270820,202211,122,85,37,103026.67,44850.91,147877.58
270830,202211,850,650,200,787911.69,242442.14,1030353.83
270840,202211,1335,1040,295,1260559.73,357564.01,1618123.74
270850,202211,1549,1008,541,1221757.89,655737.86,1877495.75
270860,202211,2639,1792,847,2172029.24,1026661.7,3198690.94
270870,202211,131,78,53,94539.85,64239.86,158779.71
270880,202211,860,683,177,827875.67,214546.24,1042421.91
270890,202211,264,201,63,243621.27,76358.63,319979.90
270895,202211,72,67,5,81205.41,6060,87265.41
270900,202211,68,56,12,67879.84,14545.28,82425.12
270910,202211,306,254,52,307902.76,63028.67,370931.43
270915,202211,1978,1321,657,1603575.84,796359.75,2399935.59
270920,202211,405,336,69,407263.2,83637.67,490900.87
270930,202211,5635,4338,1297,5262923.91,1572157.49,6835081.40
270940,202211,2226,1776,450,2153879.78,545444.87,2699324.65
280010,202211,34,28,6,33938.1,7272.11,41210.21
280020,202211,516,435,81,528469.23,98176.69,626645.92
280030,202211,22730,14682,8048,17802117.37,9755607.1,27557724.47
280040,202211,338,207,131,250902.18,158788.29,409690.47
280050,202211,445,345,100,418173.21,121209.97,539383.18
280060,202211,417,265,152,321204.06,184236.57,505440.63
280067,202211,1164,835,329,1012076.25,398776.48,1410852.73
280070,202211,123,104,19,126052.74,23028.88,149081.62
280100,202211,699,540,159,654533.61,192728.46,847262.07
280110,202211,86,76,10,92119.68,12120.62,104240.30
280120,202211,706,586,120,710270.78,145449.14,855719.92
280130,202211,1828,1203,625,1458105.86,758746.75,2216852.61
280140,202211,529,441,88,534528.55,106659.66,641188.21
280150,202211,432,302,130,366054.08,157566.73,523620.81
280160,202211,147,111,36,134538.96,43632.5,178171.46
280170,202211,439,309,130,374539.46,157568.97,532108.43
280190,202211,33,25,8,30301.5,9697.87,39999.37
280200,202211,48,38,10,46065.07,12122.28,58187.35
280210,202211,3099,2227,872,2701673.67,1056931.52,3758605.19
280220,202211,58,47,11,56970.02,13333.27,70303.29
280230,202211,344,276,68,334552.43,82425.81,416978.24
280240,202211,136,125,11,151520.61,13333.38,164853.99
280250,202211,20,11,9,13333.48,10908.86,24242.34
280260,202211,80,72,8,87273.08,9696.63,96969.71
280270,202211,143,110,33,133323.6,39999.78,173323.38
280280,202211,193,131,62,158783.73,75148.64,233932.37
280290,202211,3883,2824,1059,3426637.35,1283638.32,4710275.67
280300,202211,1707,1372,335,1664213.5,406062.15,2070275.65
280310,202211,101,95,6,115149.36,7272,122421.36
280320,202211,694,479,215,580632.61,260609.93,841242.54
280330,202211,327,243,84,294559.39,101818.17,396377.56
280340,202211,438,365,73,442417.88,88482,530899.88
280350,202211,3874,2967,907,3597650.12,1100622.68,4698272.80
280360,202211,496,342,154,414544.17,186668.43,601212.60
280370,202211,99,83,16,100607.23,19395.56,120002.79
280380,202211,51,39,12,47268,14546.52,61814.52
280390,202211,177,151,26,183020.15,31513.11,214533.26
280400,202211,413,274,139,332115.46,168476.05,500591.51
280410,202211,301,252,49,305464.26,59397.7,364861.96
280420,202211,148,128,20,155157.78,24242.59,179400.37
280430,202211,100,79,21,95754.16,25455.17,121209.33
280440,202211,726,600,126,727263.24,152725.52,879988.76
280445,202211,122,114,8,138179.93,9696.85,147876.78
280450,202211,1340,1144,196,1386653.61,237577.3,1624230.91
280460,202211,695,508,187,616978.49,226678.05,843656.54
280470,202211,98,89,9,107893.39,10910.84,118804.23
280480,202211,3300,2221,1079,2693440.33,1309124.78,4002565.11
280490,202211,205,195,10,236395.53,12121.49,248517.02
280500,202211,38,34,4,41214.98,4850.18,46065.16
280510,202211,137,108,29,130905.33,35152.8,166058.13
280520,202211,52,37,15,44846.19,18181.33,63027.52
280530,202211,73,48,25,58181.19,30304.46,88485.65
280540,202211,570,494,76,599969.97,92115.04,692085.01
280550,202211,759,700,59,848486.14,71513.88,920000.02
280560,202211,496,449,47,544247.57,56969.48,601217.05
280570,202211,2434,1927,507,2335638.51,614515.14,2950153.65
280580,202211,600,475,125,575769.94,151519.64,727289.58
280590,202211,231,149,82,180607.45,99396.92,280004.37
280600,202211,419,343,76,415813.19,92116.59,507929.78
280610,202211,117,83,34,100618.02,41212.53,141830.55
280620,202211,565,458,107,555125.4,129687.25,684812.65
280630,202211,158,128,30,155148.48,36360.34,191508.82
280640,202211,180,145,35,175747.39,42420.84,218168.23
280650,202211,87,51,36,61816.51,43634.89,105451.40
280660,202211,131,96,35,116366.21,42427.77,158793.98
280670,202211,2127,1363,764,1652200.74,927287.92,2579488.66
280680,202211,243,207,36,250893.48,43632.32,294525.80
280690,202211,77,67,10,81205.76,12120.11,93325.87
280700,202211,22,22,0,26665.13,,26665.13
280710,202211,1568,1211,357,1467861.47,432730.08,1900591.55
280720,202211,132,92,40,111516.27,48483.87,160000.14
280730,202211,31,27,4,32725.98,4848.44,37574.42
280740,202211,2642,1989,653,2412086.6,792695.8,3204782.4
280750,202211,233,204,29,248515.67,35153.54,283669.21
280760,202211,969,654,315,793935.43,381808.96,1175744.39
290010,202211,197,139,58,168485.56,70301.33,238786.89
290020,202211,188,165,23,199997.18,27878.58,227875.76
290030,202211,629,408,221,494541.7,267871.17,762412.87
290035,202211,142,116,26,140601.87,31514.28,172116.15
290040,202211,258,179,79,216969.09,95753.77,312722.86
290050,202211,92,74,18,89689.32,21816,111505.32
290060,202211,258,113,145,136959.06,175742.06,312701.12
290070,202211,6210,2924,3286,3545594.23,3986819.65,7532413.88
290080,202211,484,214,270,259387.87,327261.32,586649.19
290090,202211,336,154,182,186651.04,220587.78,407238.82
290100,202211,1761,1111,650,1346683.85,789093.28,2135777.13
290110,202211,906,511,395,619420.73,480003.69,1099424.42
290115,202211,185,168,17,203636.22,20604.99,224241.21
290120,202211,823,549,274,665482.4,332111.21,997593.61
290130,202211,477,289,188,350305.8,227871.81,578177.61
290135,202211,300,225,75,272726.81,90909.77,363636.58
290140,202211,326,272,54,329715.46,65458.01,395173.47
290150,202211,147,99,48,119989.28,58177.2,178166.48
290160,202211,250,191,59,231527.9,71516.93,303044.83
290170,202211,106,76,30,92122.96,36364.01,128486.97
290180,202211,197,142,55,172118.07,66661.35,238779.42
290190,202211,372,290,82,351549.28,99395.14,450944.42
290195,202211,304,199,105,241198.12,127261.44,368459.56
290200,202211,265,213,52,258163.73,63025.8,321189.53
290205,202211,156,94,62,113938.65,75149.7,189088.35
290210,202211,1289,944,345,1144276.82,418183.19,1562460.01
290220,202211,177,106,71,128502.45,86068.33,214570.78
290225,202211,298,116,182,140596.07,220590.19,361186.26
290230,202211,92,55,37,66663.58,44847.4,111510.98
290240,202211,371,132,239,159991.45,289674.3,449665.75
290250,202211,242,224,18,271535.22,21817.02,293352.24
290260,202211,355,276,79,334579.05,95766.24,430345.29
290265,202211,196,169,27,204851.89,32727.7,237579.59
290270,202211,1413,1164,249,1410993.92,301825.39,1712819.31
290280,202211,492,345,147,418207.16,178190.77,596397.93
290290,202211,1440,859,581,1041176.36,705420.67,1746597.03
290300,202211,395,337,58,408519.87,70308.27,478828.14
290310,202211,289,135,154,163624.92,186655.6,350280.52
290320,202211,4413,2640,1773,3201332.19,2149098.33,5350430.52
290323,202211,211,183,28,221835.12,33941.27,255776.39
290327,202211,168,129,39,156372.57,47271.96,203644.53
290330,202211,126,58,68,70297.78,82418.6,152716.38
290340,202211,798,332,466,402450.38,564868.56,967318.94
290350,202211,687,411,276,498185.01,334538.36,832723.37
290360,202211,334,258,76,312738.14,92121.83,404859.97
290370,202211,903,405,498,490876.53,603591.91,1094468.44
290380,202211,342,216,126,261824,153943.52,415767.52
290390,202211,2477,1541,936,1867939.52,1134567.11,3002506.63
290395,202211,236,139,97,168479.35,117571.78,286051.13
290400,202211,293,212,81,256984.78,98183.24,355168.02
290405,202211,245,207,38,250895.7,46056.8,296952.5
290410,202211,644,539,105,653330.85,127266.89,780597.74
290420,202211,281,224,57,271508.92,69089.23,340598.15
290430,202211,496,319,177,386643.95,214533.19,601177.14
290440,202211,91,76,15,92113.54,18180.6,110294.14
290450,202211,199,147,52,178179.96,63032.82,241212.78
290460,202211,2032,1212,820,1470354.49,993926.06,2464280.55
290470,202211,1397,616,781,747891.92,946682.73,1694574.65
290475,202211,572,537,35,650887.01,42422.04,693309.05
290480,202211,207,116,91,140601.36,110298.76,250900.12
290485,202211,241,216,25,261801.15,30300,292101.15
290490,202211,1330,924,406,1119964.39,492110.25,1612074.64
290500,202211,809,432,377,523646.94,456969.48,980616.42
290510,202211,189,153,36,185474.24,43639.95,229114.19
290515,202211,176,108,68,130905.51,82419.76,213325.27
290520,202211,1440,943,497,1144267.4,602412.98,1746680.38
290530,202211,280,251,29,304264.47,35154.47,339418.94
290540,202211,128,61,67,73938.73,81211.57,155150.30
290550,202211,173,143,30,173320.6,36360.94,209681.54
290560,202211,3285,1470,1815,1783004.14,2199942.71,3982946.85
290570,202211,7123,3372,3751,4087509.55,4546851.18,8634360.73
290580,202211,1318,795,523,964842.6,635143.13,1599985.73
290590,202211,591,469,122,568507.88,147889.12,716397.00
290600,202211,1827,1241,586,1505533.8,710312.17,2215845.97
290610,202211,184,168,16,203658.26,19397.61,223055.87
290620,202211,393,348,45,421827.02,54543.75,476370.77
290630,202211,2046,865,1181,1049701.37,1431483.75,2481185.12
290640,202211,131,104,27,126074.77,32730.47,158805.24
290650,202211,2050,953,1097,1155196.15,1332154.31,2487350.46
290660,202211,270,219,51,265471.45,61818.2,327289.65
290670,202211,1072,532,540,646102.18,654571.58,1300673.76
290680,202211,1281,1032,249,1250887.14,301812.71,1552699.85
290682,202211,346,256,90,310290.17,109092.42,419382.59
290685,202211,268,159,109,192726.88,132113.46,324840.34
290687,202211,1225,806,419,977184.86,507884.46,1485069.32
290689,202211,146,75,71,90907.32,86054.96,176962.28
290690,202211,583,264,319,320016.38,386695.17,706711.55
290700,202211,259,130,129,157589.5,156378.59,313968.09
290710,202211,794,549,245,665461.11,296969.87,962430.98
290720,202211,1092,877,215,1063045.48,260603.41,1323648.89
290730,202211,1280,754,526,913925.18,637557.97,1551483.15
290740,202211,27,23,4,27877.38,4848,32725.38
290750,202211,1538,670,868,813397.17,1052187.53,1865584.70
290755,202211,77,66,11,79999.85,13332,93331.85
290760,202211,267,230,37,278819.98,44851.89,323671.87
290770,202211,189,181,8,219392.46,9696,229088.46
290780,202211,1148,914,234,1107883.87,283642.67,1391526.54
290790,202211,402,270,132,327272.46,160005.86,487278.32
290800,202211,2494,1010,1484,1224225.09,1798778.9,3023003.99
290810,202211,497,341,156,414565.59,189089.87,603655.46
290820,202211,425,246,179,298202.91,216974.39,515177.30
290830,202211,490,348,142,421802.85,172111.26,593914.11
290840,202211,1916,1199,717,1453359.12,869080.83,2322439.95
290850,202211,1058,536,522,649708.09,633943.88,1283651.97
290860,202211,704,339,365,412127.19,443646.11,855773.30
290870,202211,638,439,199,532124.68,241202.2,773326.88
290880,202211,119,65,54,78783.09,65449.58,144232.67
290890,202211,501,299,202,362404.59,244837.82,607242.41
290900,202211,161,124,37,150292.29,46057.55,196349.84
290910,202211,400,307,93,372095.9,112718.81,484814.71
290920,202211,207,184,23,224250.96,27879,252129.96
290930,202211,546,415,131,503056.38,158794.39,661850.77
290940,202211,229,194,35,235135.19,42422.19,277557.38
290950,202211,161,91,70,110294.72,84840.2,195134.92
290960,202211,511,363,148,440000.29,179395.55,619395.84
290970,202211,233,205,28,248473.59,33938.21,282411.80
290980,202211,1988,1370,618,1660576.01,750286.07,2410862.08
290990,202211,431,365,66,442458.39,80004.82,522463.21
291000,202211,944,298,646,361184.6,782961.22,1144145.82
291005,202211,2712,1160,1552,1406103.84,1881231.33,3287335.17
291010,202211,119,104,15,126071.65,18182.13,144253.78
291020,202211,90,71,19,86052.28,23028.96,109081.24
291030,202211,102,76,26,92113.78,31514.98,123628.76
291040,202211,666,394,272,477537.24,329665.64,807202.88
291050,202211,1581,819,762,992734.63,923616.33,1916350.96
291060,202211,1735,956,779,1158778.14,944227.43,2103005.57
291070,202211,2008,1511,497,1832752.47,602433.1,2435185.57
291072,202211,7574,2883,4691,3495850.49,5686176.43,9182026.92
291075,202211,252,208,44,252105.03,53329.49,305434.52
291077,202211,61,43,18,52118.79,21816.89,73935.68
291080,202211,22149,9427,12722,11429674.45,15432192.95,26861867.40
291085,202211,289,233,56,282422.11,67878.68,350300.79
291090,202211,260,104,156,126053.36,189081.74,315135.10
291100,202211,988,338,650,409656.2,787801.88,1197458.08
291110,202211,453,346,107,420627.88,129695.01,550322.89
291120,202211,2484,1318,1166,1597595.99,1415746.36,3013342.35
291125,202211,70,34,36,41211,43636.54,84847.54
291130,202211,186,162,24,196382.92,29094.59,225477.51
291140,202211,129,98,31,120000.87,37575.13,157576.00
291150,202211,362,131,231,158774.31,281187.86,439962.17
291160,202211,414,316,98,383053.76,118785.17,501838.93
291165,202211,49,36,13,43632.78,15756.36,59389.14
291170,202211,3470,1709,1761,2072715.81,2136927.85,4209643.66
291180,202211,1258,524,734,635177.37,889739.13,1524916.50
291185,202211,114,104,10,126052.74,12121.1,138173.84
291190,202211,1411,678,733,821845.91,888522.21,1710368.12
291200,202211,174,128,46,155155.76,55758.38,210914.14
291210,202211,2501,1015,1486,1231501.57,1801159.2,3032660.77
291220,202211,318,240,78,290894.24,94539.52,385433.76
291230,202211,964,343,621,415784.88,752753.85,1168538.73
291240,202211,407,377,30,456954.33,36361.26,493315.59
291250,202211,414,336,78,408467.99,94539.87,503007.86
291260,202211,63,53,10,64237.23,12120,76357.23
291270,202211,1039,458,581,555212.27,704323.91,1259536.18
291280,202211,369,172,197,208493.01,238781.39,447274.40
291290,202211,1659,875,784,1060692.75,952798.64,2013491.39
291300,202211,243,183,60,223049.11,72730.53,295779.64
291310,202211,232,201,31,243632.98,37572.4,281205.38
291320,202211,1327,926,401,1122493.36,486078.96,1608572.32
291330,202211,142,117,25,141821.5,30302.35,172123.85
291340,202211,228,136,92,166061.36,111521.08,277582.44
291345,202211,121,86,35,104239.54,42420.78,146660.32
291350,202211,1826,696,1130,843574.98,1369615.72,2213190.70
291360,202211,8850,4199,4651,5092349.47,5641367.99,10733717.46
291370,202211,1169,701,468,850949.8,568514.08,1419463.88
291380,202211,271,211,60,255740.34,72722.41,328462.75
291390,202211,4185,1832,2353,2220655.34,2852178.25,5072833.59
291400,202211,2133,1478,655,1792905.66,793977.52,2586883.18
291410,202211,217,185,32,224244.52,38785.22,263029.74
291420,202211,124,96,28,116352.94,33936,150288.94
291430,202211,183,113,70,136963.37,84845.29,221808.66
291440,202211,548,441,107,534554.88,129697.85,664252.73
291450,202211,1028,679,349,823050.66,423035.02,1246085.68
291460,202211,2070,1621,449,1969765.15,544267.55,2514032.70
291465,202211,2367,1126,1241,1364859.43,1504225.6,2869085.03
291470,202211,2991,1495,1496,1812165.15,1815791.73,3627956.88
291480,202211,12519,5425,7094,6575852.28,8604814.87,15180667.15
291490,202211,698,278,420,336962.67,509066.31,846028.98
291500,202211,365,218,147,264238.38,178200.63,442439.01
291510,202211,1199,474,725,574497.38,878712,1453209.38
291520,202211,943,426,517,516381.02,626680.05,1143061.07
291530,202211,936,276,660,335735.7,802360.15,1138095.85
291535,202211,134,109,25,132109.87,30300.64,162410.51
291540,202211,348,119,229,144240.2,277566.94,421807.14
291550,202211,1304,619,685,750295.68,830282.39,1580578.07
291560,202211,5243,2648,2595,3209662.33,3150252.54,6359914.87
291570,202211,235,121,114,146656.83,138173.06,284829.89
291580,202211,1215,763,452,924860.5,547881.94,1472742.44
291590,202211,113,54,59,65450.61,71513.57,136964.18
291600,202211,1169,588,581,712786.91,704291.79,1417078.70
291610,202211,1489,724,765,877635.98,927320.32,1804956.30
291620,202211,564,266,298,322449.08,361233.16,683682.24
291630,202211,489,153,336,185442.06,408451.24,593893.30
291640,202211,4224,2048,2176,2483663.66,2637578.22,5121241.88
291650,202211,460,318,142,385486.91,172132.87,557619.78
291660,202211,374,152,222,184245.42,269099.49,453344.91
291670,202211,173,106,67,128487.53,81210.59,209698.12
291680,202211,632,387,245,469129.23,298198.87,767328.10
291685,202211,611,354,257,429093.53,311523.56,740617.09
291690,202211,509,323,186,391499.43,225459.75,616959.18
291700,202211,1075,825,250,1000030.19,303021.79,1303051.98
291710,202211,1627,790,837,957583.42,1014561.56,1972144.98
291720,202211,456,311,145,376945.87,175745.9,552691.77
291730,202211,959,553,406,670332.06,492130.28,1162462.34
291733,202211,318,216,102,261818.97,123633.67,385452.64
291735,202211,84,63,21,76358.45,25453.95,101812.40
291740,202211,349,263,86,318807.58,104246.3,423053.88
291750,202211,2482,1565,917,1897074.59,1112756.32,3009830.91
291760,202211,3146,1732,1414,2100488.02,1713842.62,3814330.64
291770,202211,766,513,253,621879.28,306683.52,928562.80
291780,202211,101,64,37,77573.14,44848.93,122422.07
291790,202211,160,82,78,99385.35,94538.17,193923.52
291800,202211,10757,4611,6146,5593924.66,7455805.53,13049730.19
291810,202211,1072,797,275,966093.94,334556.28,1300650.22
291820,202211,292,210,82,254537.26,99385.72,353922.98
291830,202211,1033,426,607,516389.08,735785.07,1252174.15
291835,202211,571,530,41,642405.95,49695.68,692101.63
291840,202211,5485,2756,2729,3341962.28,3307926.48,6649888.76
291845,202211,294,96,198,116353.76,239978.83,356332.59
291850,202211,311,273,38,330922.16,46060.62,376982.78
291855,202211,275,115,160,139383.22,193923.72,333306.94
291860,202211,164,108,56,130899.18,67873.32,198772.50
291870,202211,79,36,43,43632.44,52116.32,95748.76
291875,202211,164,151,13,183046.51,15759.86,198806.37
291880,202211,437,355,82,430335.94,99403.08,529739.02
291890,202211,253,91,162,110292.3,196347.51,306639.81
291900,202211,56,33,23,39996,27876.66,67872.66
291905,202211,123,95,28,115154.19,33943.89,149098.08
291910,202211,162,128,34,155140.51,41210.88,196351.39
291915,202211,445,387,58,470327.34,70302.27,540629.61
291920,202211,6178,2968,3210,3597802.95,3891087.79,7488890.74
291930,202211,169,103,66,124855.14,79999.5,204854.64
291940,202211,397,231,166,280003.5,201211.14,481214.64
291950,202211,1220,946,274,1146644.2,332100.54,1478744.74
291955,202211,1498,894,604,1084857.56,732126.34,1816983.90
291960,202211,203,148,55,179391.56,66664.48,246056.04
291970,202211,784,574,210,695774.39,254535.87,950310.26
291980,202211,1447,1253,194,1518959.71,235155.29,1754115.00
291990,202211,144,133,11,161206.92,13332.21,174539.13
291992,202211,208,102,106,123642.6,128491.22,252133.82
291995,202211,184,117,67,141810.51,81205.63,223016.14
292000,202211,435,311,124,376957.52,150296.06,527253.58
292010,202211,352,239,113,289680.91,136963.76,426644.67
292020,202211,301,222,79,269092.57,95755.95,364848.52
292030,202211,157,121,36,146663.36,43633.44,190296.80
292040,202211,595,311,284,376932.6,344212.6,721145.2
292045,202211,124,108,16,130898.96,19393.12,150292.08
292050,202211,960,690,270,836368.59,327280.76,1163649.35
292060,202211,956,770,186,933358.74,225456.47,1158815.21
292070,202211,68,29,39,35150.72,47268.54,82419.26
292080,202211,163,113,50,136957.88,61813.11,198770.99
292090,202211,571,202,369,244833.02,449671.7,694504.72
292100,202211,1636,711,925,861883.01,1121323.69,1983206.70
292105,202211,176,158,18,191497.38,21816.14,213313.52
292110,202211,2359,879,1480,1065467.5,1796352.3,2861819.8
292120,202211,737,561,176,680058.62,213330.68,893389.30
292130,202211,495,270,225,327272.74,272728.3,600001.04
292140,202211,213,173,40,210930.86,48484.1,259414.96
292145,202211,172,94,78,113932.32,94540.17,208472.49
292150,202211,1552,1290,262,1563692.29,317585.88,1881278.17
292160,202211,178,138,40,167266.27,48482.1,215748.37
292170,202211,1201,1022,179,1238844.69,216970.89,1455815.58
292180,202211,238,166,72,201216.72,87272.87,288489.59
292190,202211,152,98,54,118795.29,65456.75,184252.04
292200,202211,1482,540,942,655739.1,1142998.39,1798737.49
292205,202211,118,97,21,117567.97,25452.68,143020.65
292210,202211,400,265,135,321208,163629.92,484837.92
292220,202211,33,22,11,26667.56,13332,39999.56
292225,202211,52,43,9,52120.62,10908.4,63029.02
292230,202211,1059,799,260,968497.41,315141.07,1283638.48
292240,202211,656,476,180,577004.79,218190.11,795194.90
292250,202211,1689,1089,600,1321241.46,727267.34,2048508.80
292260,202211,428,258,170,312724.65,206054.22,518778.87
292265,202211,257,194,63,235157.92,76366.93,311524.85
292270,202211,740,365,375,442420.51,454547.42,896967.93
292273,202211,217,128,89,155143.33,107873.08,263016.41
292275,202211,184,92,92,111505.49,111509.45,223014.94
292280,202211,155,106,49,128472.94,59388.75,187861.69
292285,202211,96,75,21,90900.15,25452,116352.15
292290,202211,642,425,217,515157.18,263024.76,778181.94
292300,202211,1922,754,1168,913937.76,1418161.7,2332099.46
292303,202211,139,95,44,115142.73,53329.9,168472.63
292305,202211,122,88,34,106664.22,41210.39,147874.61
292310,202211,1011,666,345,807297.01,418176.03,1225473.04
292320,202211,604,447,157,541844.54,190302.4,732146.94
292330,202211,179,110,69,133326.47,83629.7,216956.17
292335,202211,319,253,66,306645.86,79995.67,386641.53
292340,202211,558,387,171,469069.2,207264.57,676333.77
292350,202211,288,153,135,185444.47,163629.67,349074.14
292360,202211,751,555,196,672760.02,237580.37,910340.39
292370,202211,738,562,176,681225.88,213328.48,894554.36
292380,202211,626,517,109,626698.3,132132.72,758831.02
292390,202211,402,161,241,195154.01,293333.87,488487.88
292400,202211,3901,2372,1529,2875218.48,1853356.51,4728574.99
292405,202211,277,184,93,224223.21,112717.92,336941.13
292410,202211,112,70,42,84844,50905.68,135749.68
292420,202211,283,244,39,295754.88,47271.37,343026.25
292430,202211,542,394,148,477551.47,179384.62,656936.09
292440,202211,649,541,108,655749.86,132118.68,787868.54
292450,202211,234,176,58,213331.72,70299.81,283631.53
292460,202211,528,402,126,487259.51,152722.21,639981.72
292465,202211,211,179,32,216954.89,38785.05,255739.94
292467,202211,178,118,60,143018.88,72720.33,215739.21
292470,202211,319,215,104,260586.81,126051.58,386638.39
292480,202211,422,284,138,344257.3,167276.52,511533.82
292490,202211,250,182,68,220595.45,82423.33,303018.78
292500,202211,960,461,499,558822.91,604891.6,1163714.51
292510,202211,3745,1812,1933,2196365.73,2343005.51,4539371.24
292520,202211,1222,577,645,699429.5,781846.54,1481276.04
292525,202211,461,339,122,410909.49,147874.36,558783.85
292530,202211,5166,2102,3064,2549114.08,3715175.44,6264289.52
292540,202211,498,289,209,350275.19,253313.26,603588.45
292550,202211,1164,640,524,775748.52,635132,1410880.52
292560,202211,340,310,30,375798.77,36365.18,412163.95
292570,202211,339,262,77,317574.12,93328.45,410902.57
292575,202211,592,424,168,513956.85,203639.03,717595.88
292580,202211,1057,709,348,859373.01,421806.06,1281179.07
292590,202211,577,509,68,616947.17,82419.32,699366.49
292593,202211,145,114,31,138174.46,37572.9,175747.36
292595,202211,206,165,41,200007.88,49698.3,249706.18
292600,202211,1312,932,380,1130977.76,460604.32,1591582.08
292610,202211,119,97,22,117584.7,26672.51,144257.21
292620,202211,541,449,92,544289.47,111520.44,655809.91
292630,202211,1619,885,734,1072747.05,889674.53,1962421.58
292640,202211,900,618,282,750316.93,341817,1092133.93
292650,202211,192,147,45,178196.6,54544.2,232740.8
292660,202211,2030,1430,600,1733392.74,727305.03,2460697.77
292665,202211,137,96,41,116352.63,49693,166045.63
292670,202211,399,305,94,369729,113934.55,483663.55
292680,202211,266,198,68,240005.93,82429.31,322435.24
292690,202211,209,145,64,175749.79,77569.41,253319.20
292700,202211,1037,675,362,818208.94,438800.71,1257009.65
292710,202211,115,99,16,119994.53,19393.4,139387.93
292720,202211,1040,598,442,724846.78,535738.61,1260585.39
292730,202211,219,103,116,124849.98,140604.62,265454.60
292740,202211,79540,37867,41673,45925873.97,50554288,96480161.97
292750,202211,404,294,110,356378,133339.36,489717.36
292760,202211,334,280,54,340590.9,65451.57,406042.47
292770,202211,904,376,528,455772.05,640009.25,1095781.30
292780,202211,37,13,24,15757.42,29090.79,44848.21
292790,202211,797,421,376,510269.37,455721.2,965990.57
292800,202211,1315,782,533,947874.1,646040.55,1593914.65
292805,202211,411,156,255,189077.97,310282.21,499360.18
292810,202211,1880,1116,764,1352720.15,928455.94,2281176.09
292820,202211,701,592,109,717601.01,132124.4,849725.41
292830,202211,144,107,37,129702.88,44851.09,174553.97
292840,202211,724,585,139,709121.92,168478.93,877600.85
292850,202211,142,98,44,118794.28,53337.71,172131.99
292860,202211,2186,1242,944,1506774.09,1145498.15,2652272.24
292870,202211,3838,2504,1334,3035156.41,1616969.19,4652125.60
292880,202211,1472,969,503,1175768.94,610915.43,1786684.37
292890,202211,557,460,97,557604.26,117574.82,675179.08
292895,202211,146,100,46,121209.85,55754.83,176964.68
292900,202211,340,241,99,292144.58,120007.26,412151.84
292905,202211,511,249,262,301831.08,317584.99,619416.07
292910,202211,528,394,134,477563.8,162420.58,639984.38
292920,202211,589,258,331,312733.94,401216.82,713950.76
292925,202211,483,445,38,539349.66,46057.59,585407.25
292930,202211,739,443,296,536958.01,358783.08,895741.09
292935,202211,281,124,157,150293.58,190291.74,340585.32
292937,202211,221,152,69,184234.27,83632.95,267867.22
292940,202211,197,150,47,181833.64,56972.05,238805.69
292950,202211,1395,663,732,803690.58,887299.56,1690990.14
292960,202211,514,366,148,443658.28,179404.59,623062.87
292970,202211,254,184,70,223035.99,84855.5,307891.49
292975,202211,93,50,43,60609.85,52123.48,112733.33
292980,202211,349,243,106,294533.39,128480.31,423013.70
292990,202211,1350,1006,344,1220610.82,416961.43,1637572.25
293000,202211,117,82,35,99391.63,42426,141817.63
293010,202211,3131,1842,1289,2235245.07,1562426.98,3797672.05
293015,202211,631,519,112,629105.87,135756.12,764861.99
293020,202211,346,274,72,332141.59,87275.84,419417.43
293030,202211,585,519,66,629094.8,80000.57,709095.37
293040,202211,389,309,80,374527.05,96964.22,471491.27
293050,202211,3135,1834,1301,2223023.13,1576959.5,3799982.63
293060,202211,240,191,49,231539.33,59396.14,290935.47
293070,202211,3952,1984,1968,2406153.13,2387956.1,4794109.23
293075,202211,98,70,28,84844.31,33937.38,118781.69
293076,202211,81,60,21,72724.5,25452.67,98177.17
293077,202211,606,346,260,419405.27,316366.55,735771.82
293080,202211,440,388,52,470281.18,63027.14,533308.32
293090,202211,138,123,15,149086.51,18180.66,167267.17
293100,202211,538,362,176,438818.37,213330.09,652148.46
293105,202211,355,258,97,312707.34,117572.77,430280.11
293110,202211,131,84,47,101832.57,56970.49,158803.06
293120,202211,307,215,92,260619.93,111524.02,372143.95
293130,202211,249,167,82,202420.79,99394.39,301815.18
293135,202211,8725,3497,5228,4238873.06,6339333.84,10578206.90
293140,202211,201,120,81,145470.41,98186.85,243657.26
293150,202211,320,277,43,335754.6,52118.77,387873.37
293160,202211,428,265,163,321198.9,197562.71,518761.61
293170,202211,256,162,94,196369.38,113938.27,310307.65
293180,202211,612,410,202,496959.04,244836.87,741795.91
293190,202211,1435,990,445,1200059.26,539428.73,1739487.99
293200,202211,583,515,68,624269.79,82426.98,706696.77
293210,202211,417,316,101,384242.17,122417.83,506660.00
293220,202211,2424,1067,1357,1294583.83,1647296.21,2941880.04
293230,202211,1860,690,1170,836349.59,1418139.04,2254488.63
293240,202211,241,214,27,260634.95,32728.61,293363.56
293245,202211,134,109,25,132116.29,31513.11,163629.40
293250,202211,828,347,481,420627.06,584287.07,1004914.13
293260,202211,322,256,66,310322.15,79999.63,390321.78
293270,202211,1216,544,672,660599.74,814521.08,1475120.82
293280,202211,320,209,111,254531.13,135757.21,390288.34
293290,202211,3140,2010,1130,2436368.73,1369686.7,3806055.43
293300,202211,902,623,279,755143.35,338162.99,1093306.34
293305,202211,198,150,48,181807.92,58178.18,239986.10
293310,202211,178,134,44,162421.14,53333.67,215754.81
293315,202211,168,127,41,153951.86,49699.38,203651.24
293317,202211,95,69,26,83631.1,31512.74,115143.84
293320,202211,1249,647,602,784309.06,729745.42,1514054.48
293325,202211,216,87,129,105446.66,156350.4,261797.06
293330,202211,15182,6910,8272,8379697.71,10034063.75,18413761.46
293340,202211,296,208,88,252100.21,106657.88,358758.09
293345,202211,265,220,45,266685.45,54544.04,321229.49
293350,202211,601,374,227,454575.62,275160.25,729735.87
293360,202211,1535,1076,459,1304277.05,556379.56,1860656.61
310010,202211,149,78,71,94545.61,86055.82,180601.43
310020,202211,1009,549,460,666674.54,559979.59,1226654.13
310030,202211,315,252,63,305483.08,76368.8,381851.88
310040,202211,49,33,16,39996.47,19392,59388.47
310050,202211,167,102,65,123628.09,78788.23,202416.32
310060,202211,277,196,81,237580.34,98182.12,335762.46
310070,202211,19,10,9,12121.01,10909,23030.01
310080,202211,52,35,17,42422.01,20606.4,63028.41
310090,202211,1127,631,496,766043.57,602419.03,1368462.60
310100,202211,371,257,114,311529.51,138187.15,449716.66
310110,202211,714,382,332,463038.96,402427.17,865466.13
310120,202211,389,226,163,275137.65,197572.35,472710.00
310130,202211,33,19,14,23034.59,16971.76,40006.35
310140,202211,27,10,17,12121.22,20608.38,32729.60
310150,202211,1224,799,425,968516.25,515172.95,1483689.20
310160,202211,2186,1095,1091,1327274.01,1322352.25,2649626.26
310163,202211,104,59,45,71509.3,54540.45,126049.75
310170,202211,2675,1267,1408,1536936.8,1707852.11,3244788.91
310180,202211,195,90,105,109084.09,127266.26,236350.35
310190,202211,493,330,163,400007.98,197578.12,597586.10
310200,202211,441,281,160,340619.05,193943.76,534562.81
310205,202211,78,53,25,64237.97,30300.06,94538.03
310210,202211,278,226,52,273947.4,63036.34,336983.74
310220,202211,63,40,23,48486.8,27878.67,76365.47
310230,202211,284,201,83,243643.84,100604.27,344248.11
310240,202211,127,101,26,122414.7,31512.71,153927.41
310250,202211,96,77,19,93335.8,23031,116366.8
310260,202211,788,422,366,511523.42,443639.84,955163.26
310270,202211,286,180,106,219405.35,128488.85,347894.20
310280,202211,400,284,116,344248.19,140600.33,484848.52
310285,202211,206,158,48,191507.08,58180.39,249687.47
310290,202211,241,128,113,155153.15,136961.26,292114.41
310300,202211,179,144,35,174548.84,42423.76,216972.60
310310,202211,14,11,3,13332,3636.97,16968.97
310320,202211,34,12,22,14544.23,26664,41208.23
310330,202211,46,33,13,39999.23,15757.81,55757.04
310340,202211,1914,1359,555,1647246.04,672728.29,2319974.33
310350,202211,2883,1486,1397,1801245.79,1693287.83,3494533.62
310360,202211,52,40,12,48480.16,14544.44,63024.60
310370,202211,133,112,21,135747.09,25452.44,161199.53
310375,202211,110,44,66,53329.48,79996.63,133326.11
310380,202211,53,33,20,40000.02,24244.19,64244.21
310390,202211,108,66,42,80003.44,52120.91,132124.35
310400,202211,2634,1721,913,2088564.96,1106710.59,3195275.55
310410,202211,115,69,46,83642.42,55760.11,139402.53
310420,202211,705,364,341,441213.95,413334.6,854548.55
310430,202211,292,189,103,229080.71,124836.87,353917.58
310440,202211,76,48,28,58176.14,33936.48,92112.62
310445,202211,83,70,13,84843.57,15757.21,100600.78
310450,202211,681,451,230,547681.31,278799.74,826481.05
310460,202211,257,174,83,210911.92,100601.81,311513.73
310470,202211,553,361,192,437569.56,232725.14,670294.70
310480,202211,100,65,35,78784.28,42422.04,121206.32
310490,202211,577,275,302,333353.06,366040.36,699393.42
310500,202211,127,53,74,65450.19,90902,156352.19
310510,202211,622,444,178,538183.08,215764.06,753947.14
310520,202211,148,103,45,124857.19,54544.35,179401.54
310530,202211,120,50,70,60602.84,84841.82,145444.66
310540,202211,505,282,223,341819.67,270304.04,612123.71
310550,202211,72,49,23,59394.32,27879.51,87273.83
310560,202211,3283,2242,1041,2722468.1,1262971.18,3985439.28
310570,202211,109,68,41,82418.78,49693.82,132112.60
310590,202211,400,239,161,289707.22,195151.16,484858.38
310600,202211,141,68,73,82423.95,88482.83,170906.78
310610,202211,47,17,30,20605.89,36365.32,56971.21
310620,202211,52162,24696,27466,29954585.04,33310524.22,63265109.26
310630,202211,780,464,316,562410.91,383015.29,945426.20
310640,202211,155,104,51,126052.89,61815.21,187868.10
310650,202211,168,149,19,180625.41,23031.2,203656.61
310660,202211,114,77,37,93326.41,44846.16,138172.57
310665,202211,70,50,20,60600.14,24241.82,84841.96
310670,202211,7684,3327,4357,4035240.66,5284711.38,9319952.04
310680,202211,68,45,23,54541.96,27877.91,82419.87
310690,202211,624,439,185,533314.01,224231.56,757545.57
310700,202211,60,36,24,43636.38,29089.98,72726.36
310710,202211,1328,895,433,1083974.2,526051.4,1610025.6
310720,202211,159,45,114,54543.45,138179.44,192722.89
310730,202211,1589,1072,517,1299441.24,629115.26,1928556.50
310740,202211,1045,570,475,690944.56,575775.37,1266719.93
310750,202211,253,158,95,191518.62,115149.49,306668.11
310760,202211,67,53,14,64250.89,16969.79,81220.68
310770,202211,85,40,45,48480.44,54543.83,103024.27
310780,202211,367,294,73,356377.68,88487.89,444865.57
310790,202211,123,98,25,118792.88,30301.18,149094.06
310800,202211,495,235,260,284852.81,315146.76,599999.57
310810,202211,180,119,61,144248.84,73943.29,218192.13
310820,202211,322,261,61,316386.99,73944.52,390331.51
310825,202211,221,184,37,223027.15,44846.74,267873.89
310830,202211,473,216,257,261820.28,311496.46,573316.74
310840,202211,373,224,149,271506.59,181822.07,453328.66
310850,202211,75,61,14,73936.18,16968,90904.18
310855,202211,436,343,93,415769.65,112724.55,528494.20
310860,202211,1670,1235,435,1498283.11,528519.25,2026802.36
310870,202211,57,48,9,58180.49,10909.64,69090.13
310880,202211,93,73,20,88476.82,24240.51,112717.33
310890,202211,298,171,127,207279.23,153928.79,361208.02
310900,202211,643,294,349,356365.74,423041.11,779406.85
310910,202211,248,167,81,202435.43,99395.36,301830.79
310920,202211,432,250,182,303057.37,220629.74,523687.11
310925,202211,38,29,9,36363.69,10908,47271.69
310930,202211,1382,912,470,1105461.88,570925.21,1676387.09
310940,202211,716,347,369,420623.73,447286.91,867910.64
310945,202211,143,92,51,111507.24,61815.25,173322.49
310950,202211,215,171,44,207284.58,53331.53,260616.11
310960,202211,76,27,49,32727.95,59398.54,92126.49
310970,202211,182,103,79,124858.82,95756.57,220615.39
310980,202211,54,36,18,43637.04,21817.77,65454.81
310990,202211,166,85,81,103027.34,98176.44,201203.78
311000,202211,900,453,447,549108.97,541831.7,1090940.67
311010,202211,52,40,12,48484.43,14545.94,63030.37
311020,202211,39,25,14,30304.48,16969.65,47274.13
311030,202211,409,231,178,281210.58,215748.02,496958.60
311040,202211,40,31,9,37572.11,10908,48480.11
311050,202211,518,194,324,235145.29,392702.21,627847.50
311060,202211,847,461,386,558789.49,469083.71,1027873.20
311070,202211,348,152,196,185446.53,237556.1,423002.63
311080,202211,121,69,52,83637.62,63037.52,146675.14
311090,202211,352,169,183,204860.11,221815.76,426675.87
311100,202211,576,353,223,427888.67,270300.26,698188.93
311110,202211,727,516,211,625451.53,255766.36,881217.89
311115,202211,83,57,26,69086.99,31516.84,100603.83
311120,202211,1135,623,512,755170.46,620606.25,1375776.71
311130,202211,299,174,125,210932.45,151519.45,362451.90
311140,202211,170,95,75,115151.11,90911.88,206062.99
311150,202211,344,218,126,264247.6,152734.24,416981.84
311160,202211,786,560,226,678802.85,273940.78,952743.63
311170,202211,93,78,15,94537.09,18180.34,112717.43
311180,202211,326,220,106,266665.51,128481.53,395147.04
311190,202211,37,18,19,21816.78,23028.94,44845.72
311200,202211,352,237,115,287275.87,139392.72,426668.59
311205,202211,33,25,8,30301.66,9696,39997.66
311210,202211,35,31,4,37574.71,4848.94,42423.65
311220,202211,30,26,4,31512,4848,36360
311230,202211,1712,1129,583,1368586.25,706696.74,2075282.99
311240,202211,83,53,30,64238.2,36363.61,100601.81
311250,202211,70,29,41,35150.28,50906.17,86056.45
311260,202211,552,337,215,408477.1,260602.53,669079.63
311265,202211,137,91,46,110300.45,55756.53,166056.98
311270,202211,293,200,93,242430.51,112727.99,355158.50
311280,202211,204,89,115,107872.2,139387.52,247259.72
311290,202211,108,93,15,112726.53,18180.75,130907.28
311300,202211,609,389,220,471535.47,266665,738200.47
311310,202211,20,16,4,19392.78,4849.56,24242.34
311320,202211,656,487,169,590311.71,204844.83,795156.54
311330,202211,1233,902,331,1094556.41,401214.62,1495771.03
311340,202211,2739,1935,804,2345481.74,974485.63,3319967.37
311350,202211,269,206,63,249706.75,76363.63,326070.38
311360,202211,170,103,67,124848.82,81206.41,206055.23
311370,202211,1277,538,739,652135.12,895768.76,1547903.88
311380,202211,7,6,1,7273.06,1212,8485.06
311390,202211,246,143,103,173332.66,124851.54,298184.20
311400,202211,139,86,53,104239.33,64238.01,168477.34
311410,202211,126,61,65,73938.13,78784.07,152722.20
311420,202211,330,167,163,203637.56,197566.78,401204.34
311430,202211,861,567,294,688500.21,357585.64,1046085.85
311440,202211,468,313,155,379416.16,187884.51,567300.67
311450,202211,311,183,128,221839.93,156365.61,378205.54
311455,202211,277,190,87,230306.48,105457.36,335763.84
311460,202211,132,58,74,70304.06,89697.59,160001.65
311470,202211,32,14,18,16968,21816.71,38784.71
311480,202211,56,31,25,37573.73,30300.87,67874.60
311490,202211,11,6,5,7272.51,6060.87,13333.38
311500,202211,32,15,17,18180.5,20605.28,38785.78
311510,202211,809,546,263,661811.6,318776.63,980588.23
311520,202211,42,35,7,42420,8484,50904
311530,202211,1866,1345,521,1631569.28,632688.31,2264257.59
311535,202211,64,43,21,52127.1,25457.81,77584.91
311540,202211,35,31,4,37575.96,4848,42423.96
311545,202211,172,124,48,150291.53,58176.6,208468.13
311547,202211,57,43,14,52116.9,16969.87,69086.77
311550,202211,704,321,383,389089.28,465448.26,854537.54
311560,202211,44,28,16,33938.77,19392.34,53331.11
311570,202211,298,194,104,235162.41,126064.95,361227.36
311580,202211,441,283,158,343015.87,191505.48,534521.35
311590,202211,29,25,4,30304.37,4849.41,35153.78
311600,202211,97,79,18,95771.02,21818.51,117589.53
311610,202211,262,226,36,273943.41,43637.66,317581.07
311615,202211,162,138,24,167256.94,29089.79,196346.73
311620,202211,35,22,13,26664.67,15756.91,42421.58
311630,202211,107,91,16,110294.52,19392,129686.52
311640,202211,130,64,66,77577.25,80007.16,157584.41
311650,202211,131,90,41,109081.32,49695.76,158777.08
311660,202211,454,207,247,250907.06,299382.3,550289.36
311670,202211,153,103,50,126062.61,60606.27,186668.88
311680,202211,223,168,55,203637.18,66667.86,270305.04
311690,202211,15,14,1,16970.25,1212,18182.25
311700,202211,198,146,52,176975.54,63033.22,240008.76
311710,202211,183,123,60,150316.76,72729.67,223046.43
311720,202211,43,32,11,38788.26,13332,52120.26
311730,202211,584,411,173,498187.22,210907.31,709094.53
311740,202211,28,20,8,24240.88,9696,33936.88
311750,202211,746,507,239,614533.42,290907.77,905441.19
311760,202211,85,37,48,44849.04,58184.13,103033.17
311770,202211,382,184,198,223024.23,239988.9,463013.13
311780,202211,203,103,100,124849.03,121208.11,246057.14
311783,202211,94,85,9,103027.06,10908.67,113935.73
311787,202211,47,19,28,23028.5,33937.24,56965.74
311790,202211,273,119,154,144243.31,186666.18,330909.49
311800,202211,762,469,293,568507.25,355132.61,923639.86
311810,202211,52,39,13,47269.44,15756,63025.44
311820,202211,129,99,30,119997.14,36367.09,156364.23
311830,202211,2024,1200,824,1455765.3,998716.69,2454481.99
311840,202211,1140,650,490,789085.06,593945.18,1383030.24
311850,202211,18,12,6,14545.53,7273.27,21818.80
311860,202211,10775,4624,6151,5607529.89,7459337.28,13066867.17
311870,202211,114,66,48,80002.74,59395.14,139397.88
311880,202211,985,711,274,861888.38,332140.42,1194028.80
311890,202211,204,93,111,112634.56,134558.97,247193.53
311900,202211,69,27,42,32729.4,50910.54,83639.94
311910,202211,1456,908,548,1100595.13,664224.44,1764819.57
311920,202211,247,160,87,193944.87,105453.61,299398.48
311930,202211,940,527,413,638797.82,500608.79,1139406.61
311940,202211,2796,1515,1281,1837618.96,1552688.1,3390307.06
311950,202211,163,97,66,117584.67,79998.8,197583.47
311960,202211,66,47,19,56972.73,23029.28,80002.01
311970,202211,24,13,11,15756,13332.67,29088.67
311980,202211,40,30,10,36362.11,12121.44,48483.55
311990,202211,39,27,12,32730.41,14546.14,47276.55
311995,202211,55,31,24,37578.04,29092.73,66670.77
312000,202211,23,16,7,19393.54,8484,27877.54
312010,202211,74,58,16,70307.19,19393.59,89700.78
312015,202211,82,60,22,72720.62,26664.2,99384.82
312020,202211,133,94,39,113942.44,47276.88,161219.32
312030,202211,75,56,19,67872.87,23028,90900.87
312040,202211,89,52,37,63025.99,44844.64,107870.63
312050,202211,204,114,90,138185.61,109086.62,247272.23
312060,202211,20,13,7,15757.22,8484.78,24242.00
312070,202211,81,52,29,63033.16,35151.8,98184.96
312080,202211,575,270,305,327259.26,372106.62,699365.88
312083,202211,78,52,26,63027.36,31513.58,94540.94
312087,202211,103,77,26,93331.63,31514.19,124845.82
312090,202211,3548,2167,1381,2626725.97,1673904.02,4300629.99
312100,202211,149,106,43,128213.27,52124.07,180337.34
312110,202211,130,78,52,94553.47,63032.8,157586.27
312120,202211,130,94,36,113940,43639.46,157579.46
312125,202211,89,56,33,67876.35,40002.31,107878.66
312130,202211,133,88,45,106669.89,54546.14,161216.03
312140,202211,146,115,31,139398.75,37573.59,176972.34
312150,202211,36,29,7,35149.14,8484,43633.14
312160,202211,1519,1007,512,1221942.55,621842.76,1843785.31
312170,202211,11,9,2,10908.26,2424,13332.26
312180,202211,92,62,30,75149.15,36362.45,111511.60
312190,202211,49,42,7,50906.33,8484.44,59390.77
312200,202211,762,646,116,784296.61,141822.38,926118.99
312210,202211,127,66,61,79998.04,73941.06,153939.10
312220,202211,149,109,40,132115.24,48482.01,180597.25
312230,202211,4025,1799,2226,2180720.54,2701695.61,4882416.15
312235,202211,175,117,58,141806.67,70301.83,212108.50
312240,202211,85,62,23,75157.13,27879.79,103036.92
312245,202211,236,171,65,207277.75,78791.89,286069.64
312247,202211,87,62,25,75148.88,30304.11,105452.99
312250,202211,175,92,83,111515.7,100604.56,212120.26
312260,202211,108,70,38,84840.99,46056.55,130897.54
312270,202211,143,82,61,99399.54,73942.39,173341.93
312280,202211,34,17,17,20604.71,20606.42,41211.13
312290,202211,147,98,49,118785.93,59392.49,178178.42
312300,202211,212,137,75,166055.33,90906.24,256961.57
312310,202211,63,56,7,67873.89,8484,76357.89
312320,202211,424,262,162,317563.69,196358.37,513922.06
312330,202211,99,85,14,103020.84,16968.45,119989.29
312340,202211,34,18,16,21818.55,19392.88,41211.43
312350,202211,15,9,6,10908.34,7272,18180.34
312352,202211,97,68,29,82419.04,35148.89,117567.93
312360,202211,600,256,344,311522.91,416960.39,728483.30
312370,202211,390,209,181,253311.61,219376.07,472687.68
312380,202211,147,98,49,118793.91,59399.62,178193.53
312385,202211,169,138,31,167278.44,37576.25,204854.69
312390,202211,295,187,108,226667.31,130914.55,357581.86
312400,202211,389,292,97,353959.04,117582.03,471541.07
312410,202211,1293,477,816,578188.82,989107.39,1567296.21
312420,202211,701,531,170,643646.13,206055.34,849701.47
312430,202211,893,645,248,783068.29,300619.48,1083687.77
312440,202211,48,36,12,43632,14544,58176
312450,202211,213,131,82,158794.42,99396.75,258191.17
312460,202211,34,16,18,19393.12,21816.74,41209.86
312470,202211,47,33,14,39998.56,16968,56966.56
312480,202211,169,103,66,124860.95,80012.2,204873.15
312490,202211,327,223,104,270316.07,126063.22,396379.29
312500,202211,31,21,10,25454.83,12123.56,37578.39
312510,202211,686,261,425,317586.68,515170.55,832757.23
312520,202211,27,8,19,9697.41,23032.66,32730.07
312530,202211,39,27,12,32730.04,14545.1,47275.14
312540,202211,89,77,12,93329.1,14544.2,107873.3
312550,202211,34,27,7,32729.13,8484.07,41213.20
312560,202211,206,159,47,192723.2,56969.37,249692.57
312570,202211,492,290,202,351534.24,244852.97,596387.21
312580,202211,89,53,36,64240.44,43635.98,107876.42
312590,202211,223,176,47,213344.66,56972.41,270317.07
312595,202211,159,130,29,157574.29,35150.37,192724.66
312600,202211,80,36,44,43635.11,53330.56,96965.67
312610,202211,1628,839,789,1018231.83,956351.6,1974583.43
312620,202211,234,172,62,208479.32,76362.07,284841.39
312630,202211,71,56,15,67874.67,18180,86054.67
312640,202211,42,11,31,13332,37573.15,50905.15
312650,202211,160,135,25,164067.83,30305.95,194373.78
312660,202211,114,84,30,101820.79,36364.16,138184.95
312670,202211,955,612,343,741807.6,415750.71,1157558.31
312675,202211,47,36,11,43633.98,13332.78,56966.76
312680,202211,78,50,28,60600.47,33936,94536.47
312690,202211,276,140,136,169697.7,164841.05,334538.75
312695,202211,34,27,7,32727.26,8484.78,41212.04
312700,202211,257,150,107,181815.99,130906.64,312722.63
312705,202211,81,65,16,78780.17,19394.49,98174.66
312707,202211,133,95,38,115142.44,46057.01,161199.45
312710,202211,1967,1101,866,1335755.57,1049705.66,2385461.23
312720,202211,44,21,23,25456.99,27880.94,53337.93
312730,202211,280,167,113,202431.83,136976.45,339408.28
312733,202211,52,42,10,50904.67,12121.5,63026.17
312735,202211,23,17,6,20607.53,7273.66,27881.19
312737,202211,78,45,33,54543.2,39997.39,94540.59
312738,202211,71,45,26,54542.88,31513.29,86056.17
312740,202211,76,50,26,60608.98,31516.01,92124.99
312750,202211,112,73,39,88477.26,47268.8,135746.06
312760,202211,279,191,88,231520.36,106671.08,338191.44
312770,202211,9274,4417,4857,5353981.51,5891813.86,11245795.37
312780,202211,458,347,111,420639.33,134552.1,555191.43
312790,202211,21,14,7,16968.44,8484.61,25453.05
312800,202211,1710,1180,530,1430296.36,642427.46,2072723.82
312810,202211,357,243,114,294519.15,139384.27,433903.42
312820,202211,196,149,47,180601.53,56970.41,237571.94
312825,202211,51,39,12,47271.64,14545.46,61817.10
312830,202211,200,108,92,130926.07,111520.73,242446.80
312840,202211,194,136,58,164841.46,70299.94,235141.40
312850,202211,40,34,6,41211.64,7272.44,48484.08
312860,202211,147,100,47,121207.16,56966.22,178173.38
312870,202211,1219,631,588,764844.45,712676.6,1477521.05
312880,202211,124,92,32,111518.23,38787.58,150305.81
312890,202211,175,126,49,152741.7,59397.81,212139.51
312900,202211,169,126,43,152746.58,52127.93,204874.51
312910,202211,177,100,77,121221.25,93347.96,214569.21
312920,202211,110,62,48,75155.38,58182.11,133337.49
312930,202211,333,227,106,275177.86,129705.02,404882.88
312940,202211,152,104,48,126050.35,58177.77,184228.12
312950,202211,761,536,225,650916.31,273952.66,924868.97
312960,202211,153,109,44,132131.8,53336.63,185468.43
312965,202211,121,97,24,117569.66,29088,146657.66
312970,202211,297,236,61,286071.33,73940.56,360011.89
312980,202211,2779,1446,1333,1753984.38,1620582.93,3374567.31
312990,202211,47,19,28,23031.09,33936.59,56967.68
313000,202211,55,30,25,37575.17,30300.84,67876.01
313005,202211,187,143,44,173325.84,53332.64,226658.48
313010,202211,1019,434,585,526055.55,709083.05,1235138.60
313020,202211,196,102,94,123624.55,113928,237552.55
313030,202211,212,138,74,167271.74,89693.13,256964.87
313040,202211,91,28,63,35150.11,76356.91,111507.02
313050,202211,211,150,61,181805.57,73937.19,255742.76
313055,202211,41,30,11,36360,13332,49692
313060,202211,145,97,48,117567.75,58178.24,175745.99
313065,202211,59,43,16,52117.55,19395.11,71512.66
313070,202211,133,71,62,86066.46,75155.98,161222.44
313080,202211,43,24,19,29090.74,23028.84,52119.58
313090,202211,704,454,250,550318.25,303033.35,853351.60
313100,202211,217,78,139,94539.81,168474.44,263014.25
313110,202211,156,87,69,105450.01,83636.62,189086.63
313115,202211,250,129,121,156372.55,146666.18,303038.73
313120,202211,869,495,374,601228.87,453325.06,1054553.93
313130,202211,6308,3489,2819,4232812.49,3420541.47,7653353.96
313140,202211,135,77,58,93330.02,70301.8,163631.82
313150,202211,300,235,65,284867.46,78787.91,363655.37
313160,202211,189,143,46,173352.72,55764.79,229117.51
313170,202211,1463,929,534,1126107.01,647235.47,1773342.48
313180,202211,342,213,129,258202.11,156376.8,414578.91
313190,202211,791,457,334,556395.78,404862.01,961257.79
313200,202211,34,27,7,32727.51,8484.47,41211.98
313210,202211,1026,875,151,1060668.56,184254.18,1244922.74
313220,202211,313,189,124,229096.53,150293.98,379390.51
313230,202211,285,220,65,266659.81,78784.58,345444.39
313240,202211,2384,1203,1181,1461811.18,1433844.89,2895656.07
313250,202211,1275,959,316,1163737.66,383054.21,1546791.87
313260,202211,100,48,52,58179.26,63025.21,121204.47
313270,202211,1078,635,443,770913.78,536973.7,1307887.48
313280,202211,48,37,11,44844.84,13332.87,58177.71
313290,202211,234,188,46,227875.12,55755.02,283630.14
313300,202211,334,163,171,197578.18,207262.28,404840.46
313310,202211,259,112,147,135755.18,178171.8,313926.98
313320,202211,399,289,110,350332.89,133339.8,483672.69
313330,202211,1513,925,588,1121215.14,712721.71,1833936.85
313340,202211,346,252,94,305462.83,113947.04,419409.87
313350,202211,467,291,176,352721.41,213329.69,566051.10
313360,202211,205,96,109,116357.54,132116.19,248473.73
313370,202211,245,88,157,106662.73,191502.69,298165.42
313375,202211,327,200,127,243629.52,153935.36,397564.88
313380,202211,1351,712,639,863059.37,774498.58,1637557.95
313390,202211,55,49,6,59389.61,7272,66661.61
313400,202211,414,287,127,349898.75,153956.06,503854.81
313410,202211,95,61,34,73941.57,41211.07,115152.64
313420,202211,4810,2701,2109,3273951.47,2557500.99,5831452.46
313430,202211,122,61,61,73943.6,73940.55,147884.15
313440,202211,1421,1006,415,1220660.47,503053.66,1723714.13
313450,202211,67,32,35,38784.34,42420,81204.34
313460,202211,410,181,229,219414.78,277584.89,496999.67
313470,202211,525,247,278,299422.45,337007.21,636429.66
313480,202211,166,122,44,149093.55,53333.54,202427.09
313490,202211,572,258,314,312736.98,380620.36,693357.34
313500,202211,32,18,14,21816.31,16969.01,38785.32
313505,202211,1125,861,264,1044884.81,320006.56,1364891.37
313507,202211,111,75,36,90907.58,43635.38,134542.96
313510,202211,3034,1869,1165,2265638.64,1414591.24,3680229.88
313520,202211,3554,2747,807,3332268.33,978185.35,4310453.68
313530,202211,40,24,16,29092.47,19392.78,48485.25
313535,202211,90,75,15,90906.56,18183.44,109090.00
313540,202211,69,48,21,58180.73,25453.79,83634.52
313545,202211,122,103,19,124856.6,23029.27,147885.87
313550,202211,226,194,32,235172.22,38788.72,273960.94
313560,202211,360,169,191,204869.69,231549.3,436418.99
313570,202211,79,28,51,33938.03,61814.08,95752.11
313580,202211,1405,823,582,998767.25,705448.35,1704215.60
313590,202211,68,39,29,47275.43,35154.03,82429.46
313600,202211,706,430,276,521205.66,334537.61,855743.27
313610,202211,57,45,12,54544.67,14545.41,69090.08
313620,202211,1536,750,786,910321.75,952672.92,1862994.67
313630,202211,1721,1299,422,1574618.66,511503.72,2086122.38
313640,202211,122,72,50,87268.97,60604.29,147873.26
313650,202211,241,128,113,155150.43,136976.03,292126.46
313652,202211,31,29,2,35148.67,2424.6,37573.27
313655,202211,92,61,31,73937.7,37575.38,111513.08
313657,202211,53,48,5,58188.6,6060.94,64249.54
313660,202211,143,95,48,115160.57,58182.25,173342.82
313665,202211,737,341,396,413352.07,481236.75,894588.82
313670,202211,11247,7700,3547,9338396.41,4301773.13,13640169.54
313680,202211,44,35,9,42424.15,10908.94,53333.09
313690,202211,136,98,38,118793.91,46058.66,164852.57
313695,202211,86,66,20,79997.47,24241.22,104238.69
313700,202211,352,271,81,328506.43,98179.75,426686.18
313710,202211,129,92,37,111524.96,44849.84,156374.80
313720,202211,1225,566,659,687298.56,801229.23,1488527.79
313730,202211,75,43,32,52120.93,38788.78,90909.71
313740,202211,153,115,38,139396.27,46058.8,185455.07
313750,202211,414,290,124,351530.29,150299.91,501830.20
313753,202211,241,180,61,218179.34,73944.04,292123.38
313760,202211,1438,563,875,682441.39,1060655.23,1743096.62
313770,202211,428,290,138,351524.06,167275.52,518799.58
313780,202211,880,474,406,574530.86,492097.86,1066628.72
313790,202211,38,37,1,44845.5,1212,46057.5
313800,202211,172,105,67,127276.21,81218.14,208494.35
313810,202211,93,52,41,63026.85,49692.86,112719.71
313820,202211,1445,702,743,850925.84,902973.27,1753899.11
313830,202211,57,38,19,46060.39,23030.99,69091.38
313835,202211,65,56,9,67872.4,12120.8,79993.2
313840,202211,1765,1054,711,1278779.94,861786.95,2140566.89
313850,202211,225,96,129,116359.63,156369.18,272728.81
313860,202211,489,371,118,450923.77,144240.51,595164.28
313862,202211,182,125,57,151521.12,69095,220616.12
313865,202211,191,130,61,157560.92,73933.64,231494.56
313867,202211,61,50,11,60602.24,13332,73934.24
313868,202211,49,32,17,38786.45,20604,59390.45
313870,202211,82,43,39,53340.01,48489.87,101829.88
313880,202211,395,247,148,299392.17,179393.69,478785.86
313890,202211,348,188,160,227879.81,193935.73,421815.54
313900,202211,858,465,393,563640.98,476354.1,1039995.08
313910,202211,152,104,48,126057.35,58177.82,184235.17
313920,202211,670,457,213,553949.09,258191.08,812140.17
313925,202211,35,30,5,36361.15,6060.03,42421.18
313930,202211,939,720,219,872782.36,265463.97,1138246.33
313940,202211,2026,1213,813,1470336.59,985440.06,2455776.65
313950,202211,882,534,348,647273.54,421804.64,1069078.18
313960,202211,1537,878,659,1065449,798784.36,1864233.36
313970,202211,194,110,84,133321.98,101809.2,235131.18
313980,202211,242,157,85,190297.35,103031.8,293329.15
313990,202211,275,171,104,207272.39,127265.67,334538.06
314000,202211,905,591,314,716391.62,380617.97,1097009.59
314010,202211,99,63,36,76361.57,43635.48,119997.05
314015,202211,95,27,68,32727.03,82432.6,115159.63
314020,202211,57,39,18,47273.99,21817.85,69091.84
314030,202211,78,40,38,48483.71,46056.8,94540.51
314040,202211,46,24,22,29093.16,26664.11,55757.27
314050,202211,296,164,132,198790.01,159992.14,358782.15
314053,202211,101,63,38,76364.92,46058.21,122423.13
314055,202211,311,194,117,235147.99,141822.39,376970.38
314060,202211,125,105,20,127268.05,24240.5,151508.55
314070,202211,1131,569,562,689708.55,683656.04,1373364.59
314080,202211,215,135,80,163647.28,96969.44,260616.72
314085,202211,192,134,58,163622.74,70296,233918.74
314090,202211,419,299,120,362423.94,145456.13,507880.07
314100,202211,541,428,113,518795.74,136969.25,655764.99
314110,202211,796,351,445,425464.23,539400.86,964865.09
314120,202211,69,42,27,50904.82,32724.83,83629.65
314130,202211,27,20,7,24240.46,8484,32724.46
314140,202211,1212,769,443,932126.64,536966.76,1469093.40
314150,202211,194,123,71,149090.26,86065.92,235156.18
314160,202211,313,233,80,282431.46,96971.26,379402.72
314170,202211,84,65,19,78794.87,23030.4,101825.27
314180,202211,791,702,89,850990.1,107887.06,958877.16
314190,202211,86,53,33,64249.08,40000.41,104249.49
314200,202211,534,365,169,442449.5,204863.91,647313.41
314210,202211,255,197,58,238791.64,70307.12,309098.76
314220,202211,310,221,89,267887.43,107878.53,375765.96
314225,202211,52,34,18,41215.97,21820.74,63036.71
314230,202211,123,57,66,69091.71,79995.91,149087.62
314240,202211,178,128,50,155155.96,60607.13,215763.09
314250,202211,60,36,24,43634.5,29090.58,72725.08
314260,202211,216,103,113,124842.88,136959.97,261802.85
314270,202211,423,332,91,402456.13,110305.67,512761.80
314280,202211,761,415,346,502972.24,419394.84,922367.08
314290,202211,562,434,128,526097.49,155154.32,681251.81
314300,202211,353,262,91,317599.48,110307.71,427907.19
314310,202211,1376,955,421,1157928.56,510278.6,1668207.16
314315,202211,45,34,11,41208.2,13332.6,54540.8
314320,202211,601,414,187,501829.1,226669.85,728498.95
314330,202211,12267,5956,6311,7222136.97,7651941.56,14874078.53
314340,202211,670,302,368,366064.77,446053.06,812117.83
314345,202211,64,48,16,58180.12,19392,77572.12
314350,202211,187,114,73,138184.21,88480.45,226664.66
314360,202211,56,30,26,36367.77,31516.77,67884.54
314370,202211,72,52,20,63024.5,24240.34,87264.84
314380,202211,134,72,62,87265.75,75145.42,162411.17
314390,202211,3594,2319,1275,2810941.4,1545375.33,4356316.73
314400,202211,720,500,220,606101.97,266690.01,872791.98
314410,202211,556,372,184,450900.98,223023.11,673924.09
314420,202211,22,13,9,15756.84,10908.67,26665.51
314430,202211,2541,960,1581,1166077.92,1917626.4,3083704.32
314435,202211,152,87,65,106664.13,78781.4,185445.53
314437,202211,54,42,12,50904.82,14544.43,65449.25
314440,202211,97,62,35,75150,42422.76,117572.76
314450,202211,171,121,50,146670.15,60607.42,207277.57
314460,202211,653,324,329,392733.51,399999.16,792732.67
314465,202211,129,83,46,100600.44,55754.21,156354.65
314467,202211,75,60,15,72720.54,18182.62,90903.16
314470,202211,432,215,217,260614.86,264250.98,524865.84
314480,202211,1119,503,616,609720.43,746649.16,1356369.59
314490,202211,36,20,16,24241.72,19394.57,43636.29
314500,202211,283,195,88,236369.71,106670.25,343039.96
314505,202211,122,78,44,94544.87,53329.32,147874.19
314510,202211,259,210,49,254571.47,59391.49,313962.96
314520,202211,1499,781,718,946697.32,870335.34,1817032.66
314530,202211,796,630,166,764923.99,201231.24,966155.23
314535,202211,177,108,69,130897.8,83628,214525.8
314537,202211,70,42,28,50911.93,33940.15,84852.08
314540,202211,17,9,8,12120,9697.15,21817.15
314545,202211,66,43,23,52117.65,27878.08,79995.73
314550,202211,78,41,37,49699.26,44851.28,94550.54
314560,202211,910,482,428,584237.57,518791.28,1103028.85
314570,202211,15,13,2,15760.19,2424,18184.19
314580,202211,12,6,6,7272,7272.5,14544.5
314585,202211,31,21,10,25455.87,12120.97,37576.84
314587,202211,83,72,11,87271.42,13332,100603.42
314590,202211,615,421,194,510307.86,235153.2,745461.06
314600,202211,1011,654,357,792746.65,432731.98,1225478.63
314610,202211,1013,516,497,625465.9,603657.16,1229123.06
314620,202211,153,116,37,140594.17,44845.11,185439.28
314625,202211,99,75,24,90905.98,29089.68,119995.66
314630,202211,1169,649,520,786729.68,630336.62,1417066.30
314640,202211,93,58,35,70305.35,42424.28,112729.63
314650,202211,159,91,68,110307.71,82429.32,192737.03
314655,202211,64,47,17,56965.76,20605.41,77571.17
314660,202211,19,14,5,16969.66,6061.72,23031.38
314670,202211,230,181,49,219408.73,59398.51,278807.24
314675,202211,217,131,86,159885.68,104245.49,264131.17
314690,202211,592,315,277,381802.72,335750.05,717552.77
314700,202211,2258,1197,1061,1451016.92,1287333.04,2738349.96
314710,202211,1908,1073,835,1301820.57,1012048.94,2313869.51
314720,202211,410,230,180,278794.26,218176.64,496970.90
314730,202211,537,291,246,352720.23,298173.39,650893.62
314740,202211,820,371,449,449698.99,544244.33,993943.32
314750,202211,25,19,6,23028.83,7272,30300.83
314760,202211,374,151,223,183032.39,270295.04,453327.43
314770,202211,109,71,38,86069.7,46062.56,132132.26
314780,202211,19,8,11,9697.23,13334.88,23032.11
314790,202211,2609,1657,952,2012140.78,1155060.44,3167201.22
314795,202211,70,63,7,76356.28,8484.67,84840.95
314800,202211,3064,1791,1273,2172173.98,1542973.88,3715147.86
314810,202211,1550,879,671,1065483.35,813305.78,1878789.13
314820,202211,117,68,49,82422.15,59390.68,141812.83
314830,202211,222,186,36,225465.84,44851.76,270317.60
314840,202211,88,52,36,63026.84,43635.94,106662.78
314850,202211,443,213,230,258285,278765,537050
314860,202211,663,500,163,606078.7,197574.47,803653.17
314870,202211,1706,907,799,1099404.01,969733.33,2069137.34
314875,202211,69,63,6,76357.5,7272.58,83630.08
314880,202211,42,30,12,36362.54,14545.52,50908.06
314890,202211,53,28,25,33939.89,30304.41,64244.30
314900,202211,28,21,7,25453.84,8486.11,33939.95
314910,202211,241,160,81,193945.65,98177.52,292123.17
314915,202211,145,126,19,153931.13,23028.93,176960.06
314920,202211,81,54,27,65458.57,32729.17,98187.74
314930,202211,1057,492,565,596400.21,684829.08,1281229.29
314940,202211,37,29,8,35150.52,9697.04,44847.56
314950,202211,23,20,3,24243.62,3636.41,27880.03
314960,202211,28,20,8,24244.25,9697.11,33941.36
314970,202211,180,85,95,103035.93,116370.79,219406.72
314980,202211,321,203,118,246062.93,143032.64,389095.57
314990,202211,471,256,215,310305.54,260601.98,570907.52
314995,202211,157,68,89,82418.73,107869.65,190288.38
315000,202211,99,77,22,93339.85,26666.85,120006.70
315010,202211,33,20,13,24241.54,15758.44,39999.98
315015,202211,164,130,34,157564.05,41209.38,198773.43
315020,202211,69,59,10,71508.07,12120.56,83628.63
315030,202211,109,82,27,99391.88,32725.01,132116.89
315040,202211,91,53,38,64237.66,46056.27,110293.93
315050,202211,212,129,83,156355.82,100601.46,256957.28
315053,202211,65,44,21,53329.31,25452,78781.31
315057,202211,129,98,31,118777.55,37572.2,156349.75
315060,202211,67,54,13,65463.16,15758.1,81221.26
315070,202211,116,70,46,84843.58,55754.8,140598.38
315080,202211,399,314,85,380652.06,103033.13,483685.19
315090,202211,101,59,42,71515.34,50905.35,122420.69
315100,202211,89,44,45,53332.7,54544.45,107877.15
315110,202211,286,144,142,174545.55,172114.47,346660.02
315120,202211,1913,908,1005,1101856.54,1219433.55,2321290.09
315130,202211,352,252,100,305455.06,121214.88,426669.94
315140,202211,562,307,255,372120.34,309093.07,681213.41
315150,202211,1005,478,527,579403.88,638793.15,1218197.03
315160,202211,198,106,92,128496.5,111525.04,240021.54
315170,202211,303,198,105,240005.15,127280.34,367285.49
315180,202211,3376,1434,1942,1740635.16,2353842.42,4094477.58
315190,202211,299,184,115,223052.49,139402.42,362454.91
315200,202211,1256,749,507,907873.83,614556.9,1522430.73
315210,202211,1829,1090,739,1321219.61,896936.08,2218155.69
315213,202211,26,15,11,18182.89,13336.74,31519.63
315217,202211,220,172,48,208470.11,58178.43,266648.54
315220,202211,1668,1227,441,1487348.99,534566.44,2021915.43
315230,202211,185,141,44,170904.93,53331.83,224236.76
315240,202211,372,241,131,292156.52,160022.34,452178.86
315250,202211,2813,1331,1482,1614554.54,1796266.43,3410820.97
315260,202211,140,81,59,98177.72,71509.47,169687.19
315270,202211,151,108,43,130903.84,52116.78,183020.62
315280,202211,613,399,214,483679.91,259426.95,743106.86
315290,202211,194,119,75,144231.44,90900.81,235132.25
315300,202211,103,78,25,94539.05,30302.68,124841.73
315310,202211,85,76,9,92112.52,10908.67,103021.19
315320,202211,147,93,54,112742.93,65459,178201.93
315330,202211,64,50,14,60600.71,16968.11,77568.82
315340,202211,395,286,109,346676.1,132122.29,478798.39
315350,202211,165,105,60,127270.07,72728.88,199998.95
315360,202211,104,49,55,59391.03,66663.04,126054.07
315370,202211,58,37,21,44848.95,25453.32,70302.27
315380,202211,7,5,2,6060,2424,8484
315390,202211,71,28,43,33938.05,52124.57,86062.62
315400,202211,840,634,206,768482.69,250905.07,1019387.76
315410,202211,319,189,130,229109.35,157589.82,386699.17
315415,202211,58,46,12,55760.79,14545.84,70306.63
315420,202211,210,152,58,184249.82,70300,254549.82
315430,202211,645,360,285,436375.64,345456.25,781831.89
315440,202211,97,64,33,77571.54,39996.6,117568.14
315445,202211,232,190,42,230332.15,50912.85,281245.00
315450,202211,182,132,50,159984,60601.66,220585.66
315460,202211,4967,2279,2688,2763774.59,3261852.64,6025627.23
315470,202211,46,20,26,24241.82,31513.57,55755.39
315480,202211,76,22,54,26667.41,65458.24,92125.65
315490,202211,747,474,273,574516.57,330897.47,905414.04
315500,202211,21,18,3,21818.16,3636,25454.16
315510,202211,153,110,43,133330.49,52121.02,185451.51
315520,202211,79,67,12,81206.31,14544,95750.31
315530,202211,47,27,20,32724.76,24240.67,56965.43
315540,202211,282,193,89,233937.25,107872.5,341809.75
315550,202211,196,155,41,187882.08,49696.52,237578.60
315560,202211,737,577,160,699459.11,193958.26,893417.37
315570,202211,312,152,160,184258.71,193948.87,378207.58
315580,202211,787,536,251,649679.84,304238.78,953918.62
315590,202211,193,98,95,118804.36,115164.17,233968.53
315600,202211,350,269,81,326069.37,98188.03,424257.40
315610,202211,102,47,55,56964.32,66660.56,123624.88
315620,202211,36,29,7,35154.57,8486.27,43640.84
315630,202211,132,97,35,117576.9,42421.23,159998.13
315640,202211,63,37,26,44845.86,31513.94,76359.80
315645,202211,50,32,18,38788.29,21817.56,60605.85
315650,202211,171,127,44,153940.81,53336.5,207277.31
315660,202211,443,205,238,248504.15,288496.72,537000.87
315670,202211,2527,1154,1373,1400120.05,1665536.01,3065656.06
315680,202211,784,559,225,677569.17,272723.47,950292.64
315690,202211,713,469,244,568498.07,295762.61,864260.68
315700,202211,2096,1098,998,1330992.14,1211011.18,2542003.32
315710,202211,373,124,249,150292.97,301798.76,452091.73
315720,202211,534,322,212,390305.8,256965.55,647271.35
315725,202211,207,164,43,198785.29,52119.25,250904.54
315727,202211,93,54,39,65456.58,47276.34,112732.92
315730,202211,56,49,7,59390.71,8484.4,67875.11
315733,202211,87,52,35,63029.74,42421.28,105451.02
315737,202211,49,37,12,44853.64,14545.29,59398.93
315740,202211,32,25,7,30300.98,8484,38784.98
315750,202211,174,123,51,149102,61819.05,210921.05
315760,202211,46,34,12,41208.08,14544,55752.08
315765,202211,143,83,60,101824.84,72730.56,174555.40
315770,202211,244,163,81,197572.77,98179.22,295751.99
315780,202211,4113,2024,2089,2457031.01,2536876.87,4993907.88
315790,202211,248,191,57,232732.68,69088.33,301821.01
315800,202211,323,214,109,259401.19,132123.75,391524.94
315810,202211,66,40,26,48481.34,31513.4,79994.74
315820,202211,787,578,209,700664.62,253349.08,954013.70
315830,202211,123,79,44,95758.13,53336.78,149094.91
315840,202211,81,54,27,65448.72,32725.04,98173.76
315850,202211,278,186,92,225477.02,112738.98,338216.00
315860,202211,19,6,13,7272.88,15756,23028.88
315870,202211,39,30,9,36365.48,10909.51,47274.99
315880,202211,98,66,32,80000.85,38788.54,118789.39
315890,202211,109,75,34,92118.41,41211.38,133329.79
315895,202211,412,272,140,329722.44,169707.11,499429.55
315900,202211,92,41,51,49695.24,61815.02,111510.26
315910,202211,47,28,19,33936,23028,56964
315920,202211,159,107,52,129705.64,64241.68,193947.32
315930,202211,53,17,36,20606.52,43637.77,64244.29
315935,202211,128,101,27,122427.73,32725.76,155153.49
315940,202211,105,75,30,90906.33,36362.4,127268.73
315950,202211,36,27,9,32727.24,10909.43,43636.67
315960,202211,602,281,321,340603.13,389090.2,729693.33
315970,202211,32,27,5,32725.4,6060,38785.4
315980,202211,693,352,341,426674.66,413338.26,840012.92
315990,202211,267,153,114,185462.87,138188.73,323651.60
316000,202211,54,33,21,40000.33,25453.14,65453.47
316010,202211,95,80,15,96974.02,18184.01,115158.03
316020,202211,105,92,13,111505.93,15756.8,127262.73
316030,202211,392,229,163,277598.41,197585.26,475183.67
316040,202211,570,236,334,286059.8,404840.3,690900.1
316045,202211,54,48,6,58177.27,7272.8,65450.07
316050,202211,24,17,7,20604,8484,29088
316060,202211,108,75,33,90906.37,39998.84,130905.21
316070,202211,1248,838,410,1015741.14,498168.59,1513909.73
316080,202211,96,66,30,80100.98,36360.47,116461.45
316090,202211,36,18,18,21816.11,21818.59,43634.70
316095,202211,86,74,12,89695.78,14545.15,104240.93
316100,202211,351,193,158,236361.64,191505.64,427867.28
316105,202211,56,35,21,42425.44,25454.39,67879.83
316110,202211,1920,1492,428,1808557.03,520013.33,2328570.36
316120,202211,79,53,26,64242.64,31512.94,95755.58
316130,202211,118,89,29,107885.13,35153.5,143038.63
316140,202211,34,25,9,31512.2,12120,43632.2
316150,202211,223,155,68,187875.64,82424.88,270300.52
316160,202211,89,57,32,69095.05,38792.36,107887.41
316165,202211,78,51,27,61816.53,32727.24,94543.77
316170,202211,194,125,69,151520.64,83639.3,235159.94
316180,202211,221,86,135,104247.59,163636.72,267884.31
316190,202211,150,108,42,130905.89,50905.46,181811.35
316200,202211,688,381,307,461822.04,372113.25,833935.29
316210,202211,788,538,250,653564.83,303046.17,956611.00
316220,202211,125,77,48,93325.89,58176.89,151502.78
316225,202211,43,27,16,32727.87,19393.48,52121.35
316230,202211,47,27,20,32726,24240,56966
316240,202211,682,538,144,652158.72,174552.18,826710.90
316245,202211,174,154,20,186666.79,24241.93,210908.72
316250,202211,1718,1152,566,1396385.34,686018.73,2082404.07
316255,202211,137,109,28,132122.08,33937.58,166059.66
316257,202211,188,96,92,116363.37,111525.6,227888.97
316260,202211,200,135,65,163646.14,78791.04,242437.18
316265,202211,37,26,11,31515.91,13334.68,44850.59
316270,202211,702,493,209,597628.4,253353.06,850981.46
316280,202211,574,361,213,438815.27,260618.12,699433.39
316290,202211,882,606,276,735742.97,334540.77,1070283.74
316292,202211,647,268,379,324852.85,459406.11,784258.96
316294,202211,109,68,41,82426.41,49698.22,132124.63
316295,202211,393,189,204,229089.63,247276.87,476366.50
316300,202211,20,13,7,15757.72,8484,24241.72
316310,202211,27,15,12,18180.34,14544.11,32724.45
316320,202211,75,35,40,42421.77,48481.29,90903.06
316330,202211,182,127,55,153941.79,66667.7,220609.49
316340,202211,146,93,53,112718.23,64239.36,176957.59
316350,202211,196,136,60,164852.21,72727.21,237579.42
316360,202211,26,16,10,19393.51,14544.4,33937.91
316370,202211,1315,637,678,772122.02,821795.19,1593917.21
316380,202211,117,88,29,106665.83,35153.6,141819.43
316390,202211,105,76,29,92126.16,35152.27,127278.43
316400,202211,163,124,39,150313.85,47275.62,197589.47
316410,202211,310,221,89,267865.16,107871.63,375736.79
316420,202211,229,152,77,184245.02,93336.87,277581.89
316430,202211,163,89,74,107874.43,89689.69,197564.12
316440,202211,72,41,31,49701.94,37578.47,87280.41
316443,202211,50,42,8,50910.46,9696,60606.46
316447,202211,44,36,8,43634.58,9696.32,53330.90
316450,202211,247,183,64,221814.97,77574.9,299389.87
316460,202211,50,15,35,18183.26,42424.64,60607.90
316470,202211,1820,1327,493,1609702.6,597537.75,2207240.35
316480,202211,10,8,2,9696.4,2424,12120.4
316490,202211,21,7,14,8484.2,16968.44,25452.64
316500,202211,166,105,61,127278.78,73938.04,201216.82
316510,202211,137,110,27,133333.59,32725.43,166059.02
316520,202211,188,104,84,126057.72,101817.47,227875.19
316530,202211,176,110,66,134557.84,80003.95,214561.79
316540,202211,165,86,79,104250.73,96966.49,201217.22
316550,202211,162,100,62,121212.4,75147.04,196359.44
316553,202211,442,218,224,265439.84,271507.33,536947.17
316555,202211,60,52,8,63026.57,9696,72722.57
316556,202211,17,12,5,14545.08,6060.44,20605.52
316557,202211,33,28,5,33937.43,6060,39997.43
316560,202211,77,53,24,64237.03,29089.46,93326.49
316570,202211,212,194,18,235166.88,21820.82,256987.70
316580,202211,25,16,9,19393.81,10909.24,30303.05
316590,202211,90,76,14,92123.07,16971.52,109094.59
316600,202211,180,150,30,181812.03,36361.55,218173.58
316610,202211,70,50,20,60602.68,24240,84842.68
316620,202211,150,105,45,127268.18,54542.16,181810.34
316630,202211,59,45,14,54542.95,16968.11,71511.06
316640,202211,24,14,10,16968,12120.6,29088.6
316650,202211,105,83,22,100596,26664,127260
316660,202211,7,2,5,2424,6060.8,8484.8
316670,202211,442,152,290,184242.93,351522.02,535764.95
316680,202211,166,128,38,155150.02,46062.65,201212.67
316690,202211,155,95,60,115147.01,72721.68,187868.69
316695,202211,56,48,8,58176.5,9696,67872.5
316700,202211,26,18,8,21816.57,9696.11,31512.68
316710,202211,821,626,195,758806.28,236372.39,995178.67
316720,202211,5340,2483,2857,3009745.13,3465270.25,6475015.38
316730,202211,16,15,1,18183.74,1212.6,19396.34
316740,202211,160,102,58,123630.18,70298.95,193929.13
316750,202211,22,13,9,15758.37,10910.09,26668.46
316760,202211,337,269,68,326086.37,82427.96,408514.33
316770,202211,185,96,89,116354.88,107871.85,224226.73
316780,202211,72,41,31,49696.03,37574.93,87270.96
316790,202211,67,46,21,55752.77,25452.32,81205.09
316800,202211,1849,1128,721,1367320.94,875206.05,2242526.99
316805,202211,33,22,11,26665.89,13332.67,39998.56
316810,202211,61,37,24,44854.58,29092.56,73947.14
316820,202211,37,21,16,25452.78,19392.78,44845.56
316830,202211,104,49,55,59397.5,66672.35,126069.85
316840,202211,520,313,207,379404.45,250913.43,630317.88
316850,202211,310,211,99,255765.95,120003.25,375769.20
316860,202211,6579,2955,3624,3581913.95,4392612.32,7974526.27
316870,202211,1773,1147,626,1390358.72,759967.53,2150326.25
316880,202211,168,83,85,100605.96,103028.01,203633.97
316890,202211,236,157,79,190310.76,95765.53,286076.29
316900,202211,433,300,133,363627.08,161206.86,524833.94
316905,202211,26,12,14,14545.2,16968.5,31513.7
316910,202211,84,36,48,43634.61,58178.12,101812.73
316920,202211,153,117,36,141819.41,43635.36,185454.77
316930,202211,2058,1053,1005,1277546.57,1218128.22,2495674.79
316935,202211,994,590,404,715151.41,490911.04,1206062.45
316940,202211,1157,677,480,820598.99,581814.92,1402413.91
316950,202211,198,93,105,112727.99,127277.39,240005.38
316960,202211,1130,628,502,761237.25,608503.65,1369740.90
316970,202211,669,533,136,646095.68,164863.89,810959.57
316980,202211,86,43,43,52118.54,52118.87,104237.41
316990,202211,2341,1590,751,1929681.56,910290.85,2839972.41
317000,202211,352,273,79,330931,95759.84,426690.84
317005,202211,223,153,70,185464.78,84848.07,270312.85
317010,202211,7109,4052,3057,4914065.42,3706669.54,8620734.96
317020,202211,16300,7110,9190,8624537.43,11145262.23,19769799.66
317030,202211,96,42,54,50907.15,65449.78,116356.93
317040,202211,3221,2105,1116,2551569.06,1355212.22,3906781.28
317043,202211,77,60,17,72735.55,20609.61,93345.16
317047,202211,37,21,16,25452.06,19392.55,44844.61
317050,202211,158,127,31,153942.33,37577.49,191519.82
317052,202211,161,131,30,158781.44,36361.19,195142.63
317057,202211,195,145,50,175747.32,60602.15,236349.47
317060,202211,65,40,25,48481.19,30302.78,78783.97
317065,202211,51,38,13,46058.57,15756,61814.57
317070,202211,2012,937,1075,1135793.98,1302964.6,2438758.58
317075,202211,95,53,42,64242.05,50908.25,115150.30
317080,202211,994,507,487,614571.34,590279.83,1204851.17
317090,202211,730,570,160,690948.1,193943.1,884891.2
317100,202211,451,340,111,412117.16,134546.5,546663.66
317103,202211,134,105,29,127265.74,35148.6,162414.34
317107,202211,49,40,9,48480,10908,59388
317110,202211,82,42,40,50912.07,48490.21,99402.28
317115,202211,44,40,4,48538.38,4848.34,53386.72
317120,202211,2241,1106,1135,1340671.84,1378228,2718899.84
317130,202211,2188,1471,717,1784218.99,869044.87,2653263.86
317140,202211,16,11,5,13332.44,6060,19392.44
317150,202211,289,174,115,210901.43,139385.24,350286.67
317160,202211,366,268,98,324862.83,120004.51,444867.34
317170,202211,244,160,84,195155.52,101813.1,296968.62
317180,202211,434,294,140,356373.84,169695.07,526068.91
317190,202211,266,189,77,229083.52,93329.72,322413.24
317200,202211,861,600,261,728499.45,316374.38,1044873.83
317210,202211,182,92,90,111520.23,109086.95,220607.18
317220,202211,23,11,12,13333.33,14545.01,27878.34
320010,202211,577,409,168,495819.49,203655.04,699474.53
320013,202211,136,89,47,107885.03,56975.58,164860.61
320016,202211,258,157,101,190324.12,122430.88,312755.00
320020,202211,767,453,314,549123.61,380635.46,929759.07
320030,202211,174,121,53,146677.06,64242.05,210919.11
320035,202211,139,96,43,116364.6,52122.16,168486.76
320040,202211,510,251,259,305475.34,313963.37,619438.71
320050,202211,131,89,42,107892.06,50914.94,158807.00
320060,202211,1960,920,1040,1115225.2,1261915.33,2377140.53
320070,202211,101,64,37,77581.07,44847.64,122428.71
320080,202211,858,484,374,586728.89,453365.24,1040094.13
320090,202211,1367,879,488,1065511.63,591544.65,1657056.28
320100,202211,365,210,155,254569.2,187898.94,442468.14
320110,202211,136,81,55,98197.27,66674.69,164871.96
320115,202211,118,100,18,121220.24,21817.68,143037.92
320120,202211,3941,2049,1892,2483715.17,2293401.58,4777116.75
320130,202211,8533,3668,4865,4448807.28,5902225.54,10351032.82
320140,202211,523,329,194,398806.32,235160.89,633967.21
320150,202211,2270,1244,1026,1507960.76,1243708.25,2751669.01
320160,202211,665,285,380,345470.54,460610.92,806081.46
320170,202211,115,89,26,107885.01,31517.73,139402.74
320180,202211,60,34,26,41213.14,31518.57,72731.71
320190,202211,260,152,108,184267.45,130917.08,315184.53
320200,202211,64,53,11,64246.51,13334.12,77580.63
320210,202211,952,516,436,626718.95,528525.69,1155244.64
320220,202211,310,107,203,129695.99,247262.12,376958.11
320225,202211,82,68,14,82432.34,16971.76,99404.10
320230,202211,737,465,272,563699.4,330925.11,894624.51
320240,202211,3759,1696,2063,2057025.93,2501892,4558917.93
320245,202211,538,366,172,443665.43,208498.64,652164.07
320250,202211,249,116,133,140621.57,161224.43,301846.00
320255,202211,126,93,33,112738.28,40003.67,152741.95
320260,202211,285,153,132,185460.86,159994.78,345455.64
320265,202211,153,118,35,143038.47,42424.84,185463.31
320270,202211,164,122,42,147895.59,50912.64,198808.23
320280,202211,1368,759,609,921244.82,738194.63,1659439.45
320290,202211,69,51,18,61826.06,21818.41,83644.47
320300,202211,650,440,210,533359.21,254552.69,787911.90
320305,202211,798,431,367,522468.47,444877.71,967346.18
320310,202211,204,120,84,145464.88,101820.69,247285.57
320313,202211,367,165,202,200013.62,244866.85,444880.47
320316,202211,113,80,33,96982.2,40002.84,136985.04
320320,202211,3665,1615,2050,1957691.83,2486203.22,4443895.05
320330,202211,293,213,80,258166.79,96965.81,355132.60
320332,202211,816,482,334,584317.9,407316.55,991634.45
320334,202211,301,167,134,202433.68,164851.78,367285.46
320335,202211,149,98,51,118802.57,61826.18,180628.75
320340,202211,618,439,179,532163.87,216986.42,749150.29
320350,202211,1146,464,682,562450.97,826699.81,1389150.78
320360,202211,173,80,93,96970.55,112722.18,209692.73
320370,202211,243,179,64,216983.34,77577.36,294560.70
320380,202211,334,236,98,286068.17,118782.82,404850.99
320390,202211,1197,699,498,847350.58,603680.88,1451031.46
320400,202211,326,227,99,275184.84,120008.13,395192.97
320405,202211,1018,413,605,500646.02,737000.48,1237646.50
320410,202211,987,487,500,590354.78,606086.97,1196441.75
320420,202211,604,268,336,324872.06,407290.77,732162.83
320425,202211,221,115,106,139394.46,128477.87,267872.33
320430,202211,421,219,202,265482.03,244870.69,510352.72
320435,202211,183,124,59,150313.54,71520.1,221833.64
320440,202211,218,119,99,144260.52,120012.74,264273.26
320450,202211,139,73,66,88496.37,80004.58,168500.95
320455,202211,239,186,53,225484.5,64247.92,289732.42
320460,202211,320,189,131,230311.84,158788.67,389100.51
320465,202211,119,81,38,98187.81,46064.65,144252.46
320470,202211,782,462,320,560030.26,387914.86,947945.12
320480,202211,225,153,72,185459.97,87275.43,272735.40
320490,202211,3499,1657,1842,2009818.92,2232895.26,4242714.18
320495,202211,127,72,55,87276.86,66673.39,153950.25
320500,202211,10838,5221,5617,6330217.32,6815146.37,13145363.69
320501,202211,588,298,290,361244.02,351548.58,712792.60
320503,202211,331,233,98,282447.05,118792.56,401239.61
320506,202211,284,194,90,235156.7,109089.69,344246.39
320510,202211,1332,562,770,681261.64,933393.74,1614655.38
320515,202211,87,68,19,82431.53,23033.56,105465.09
320517,202211,236,168,68,203664.21,82430.57,286094.78
320520,202211,8464,3512,4952,4260788.83,6008765.77,10269554.60
320530,202211,7455,3548,3907,4303114.67,4741988.87,9045103.54
330010,202211,3739,1824,1915,2210982.04,2323663.71,4534645.75
330015,202211,212,88,124,106664.36,150298.18,256962.54
330020,202211,4272,1623,2649,1967368.17,3213417.23,5180785.40
330022,202211,280,137,143,166065.27,173333.85,339399.12
330023,202211,881,251,630,305452.34,763626.81,1069079.15
330025,202211,869,155,714,187871.39,866689.34,1054560.73
330030,202211,1979,1224,755,1484898.55,915179.51,2400078.06
330040,202211,2843,1425,1418,1728525.09,1721272.68,3449797.77
330045,202211,11048,3418,7630,4143082.55,9255958.48,13399041.03
330050,202211,931,571,360,693359.1,437588.3,1130947.4
330060,202211,1266,736,530,893354.44,642417.9,1535772.34
330070,202211,4658,1560,3098,1893370.59,3757654.96,5651025.55
330080,202211,1732,752,980,912763.55,1189107.42,2101870.97
330090,202211,414,227,187,275171.14,226676.43,501847.57
330093,202211,237,97,140,118791.79,169694.21,288486.00
330095,202211,72,39,33,47275.59,39997.85,87273.44
330100,202211,11783,5814,5969,7051084.84,7241357.69,14292442.53
330110,202211,487,221,266,269089.96,322434.08,591524.04
330115,202211,549,270,279,327277.23,338182.35,665459.58
330120,202211,417,217,200,263042.87,242435.74,505478.61
330130,202211,1726,449,1277,544257.33,1549227.45,2093484.78
330140,202211,720,363,357,439998.61,432718.39,872717.00
330150,202211,559,334,225,404847.64,272729.04,677576.68
330160,202211,215,124,91,150305.49,110303.22,260608.71
330170,202211,29248,10191,19057,12359363.5,23121046.97,35480410.47
330180,202211,260,144,116,174542.63,140606.79,315149.42
330185,202211,1271,480,791,581809.28,958847.29,1540656.57
330187,202211,603,188,415,229088.22,504241.19,733329.41
330190,202211,6810,2540,4270,3082527.55,5180735.12,8263262.67
330200,202211,4993,1625,3368,1972230.63,4086311.47,6058542.10
330205,202211,511,286,225,346673.24,272735.71,619408.95
330210,202211,975,583,392,706687.97,475179.61,1181867.58
330220,202211,2987,1734,1253,2103149.33,1520059.52,3623208.85
330225,202211,634,334,300,406056.87,363644.55,769701.42
330227,202211,2637,847,1790,1026684.63,2172207.72,3198892.35
330230,202211,261,139,122,169695.14,147877.81,317572.95
330240,202211,4696,2147,2549,2604965.01,3094636.03,5699601.04
330245,202211,172,82,90,99390.97,109091.17,208482.14
330250,202211,7277,3446,3831,4178476.54,4647380.7,8825857.24
330260,202211,828,224,604,272722.12,732108.55,1004830.67
330270,202211,4270,1375,2895,1667967.75,3514113.14,5182080.89
330280,202211,495,296,199,358809.87,241214.68,600024.55
330285,202211,6963,2209,4754,2679059.23,5768921.29,8447980.52
330290,202211,811,280,531,340604.37,646057.74,986662.11
330300,202211,781,477,304,578945.64,368505.55,947451.19
330310,202211,500,285,215,345466.85,260614.45,606081.30
330320,202211,8398,2861,5537,3473024.24,6715396.62,10188420.86
330330,202211,10265,3736,6529,4529863.86,7920154.85,12450018.71
330340,202211,2967,1638,1329,1985518.65,1613338.38,3598857.03
330350,202211,21610,7836,13774,9503485.87,16707147.66,26210633.53
330360,202211,2115,979,1136,1186768.23,1377080.54,2563848.77
330370,202211,1050,539,511,653353.03,620646.9,1273999.93
330380,202211,1074,426,648,516370.87,785460.71,1301831.58
330385,202211,696,343,353,415759.67,427876.39,843636.06
330390,202211,6659,3418,3241,4144335.72,3935837.19,8080172.91
330395,202211,422,270,152,328158.15,185453.22,513611.37
330400,202211,766,388,378,471530.04,459396.48,930926.52
330410,202211,549,396,153,480023.88,185465.45,665489.33
330411,202211,396,215,181,260593.53,219387.83,479981.36
330412,202211,237,107,130,129696.64,157576.96,287273.60
330414,202211,5868,2302,3566,2790512.88,4324999.79,7115512.67
330415,202211,662,277,385,335776.71,466681.54,802458.25
330420,202211,2648,1379,1269,1671497.87,1539396.46,3210894.33
330430,202211,1935,818,1117,991583.52,1353954.54,2345538.06
330440,202211,412,195,217,236355.87,263024.57,499380.44
330450,202211,127,54,73,65454.14,88487.01,153941.15
330452,202211,2584,1055,1529,1278808.66,1854531.83,3133340.49
330455,202211,134690,46430,88260,56319751.58,107048652.2,163368403.78
330460,202211,280,126,154,152730.37,187887.63,340618.00
330470,202211,1339,708,631,858193.86,764852.37,1623046.23
330475,202211,1978,596,1382,722429.94,1677602.89,2400032.83
330480,202211,846,463,383,561218.65,464266.59,1025485.24
330490,202211,17846,5423,12423,6577206.22,15066727.9,21643934.12
330500,202211,1673,716,957,867919.43,1161253.61,2029173.04
330510,202211,11971,4143,7828,5024482.92,9492374.69,14516857.61
330513,202211,106,54,52,65450.61,63026.89,128477.50
330515,202211,749,320,429,389114.69,520056.4,909171.09
330520,202211,2696,911,1785,1105510.53,2167373.52,3272884.05
330530,202211,191,108,83,130913.74,100609.26,231523.00
330540,202211,360,188,172,227886.55,208494.47,436381.02
330550,202211,3060,1002,2058,1215828.25,2494638.13,3710466.38
330555,202211,1096,399,697,483631.12,846057.73,1329688.85
330560,202211,830,285,545,345476.09,661852.19,1007328.28
330570,202211,336,231,105,280004.78,127269.59,407274.37
330575,202211,934,347,587,420627.43,711551.4,1132178.83
330580,202211,3659,1900,1759,2304309.71,2134574.23,4438883.94
330590,202211,269,140,129,169702.69,156370.47,326073.16
330600,202211,1491,873,618,1059403.3,750293.74,1809697.04
330610,202211,1744,889,855,1078801.01,1036360.55,2115161.56
330615,202211,234,185,49,224249.12,59395.38,283644.50
330620,202211,1096,435,661,527305.13,801272.44,1328577.57
330630,202211,4949,2923,2026,3545442.07,2456937.82,6002379.89
350010,202211,628,416,212,504262.22,256970.83,761233.05
350020,202211,63,22,41,26666.85,49697.41,76364.26
350030,202211,587,351,236,425485.06,286067.41,711552.47
350040,202211,116,48,68,58185.77,82425.28,140611.05
350050,202211,380,183,197,221820.49,238781.95,460602.44
350055,202211,134,57,77,69091.45,93327.26,162418.71
350060,202211,84,34,50,41214.37,60602.56,101816.93
350070,202211,827,459,368,556402.55,446100.26,1002502.81
350075,202211,81,50,31,60605,37572.86,98177.86
350080,202211,60,28,32,33943.4,38789.24,72732.64
350090,202211,81,45,36,54548.07,43634.79,98182.86
350100,202211,298,185,113,224237.19,136966.98,361204.17
350110,202211,44,28,16,33944.07,19393.69,53337.76
350115,202211,187,92,95,111515.5,115148.08,226663.58
350120,202211,110,70,40,84852.43,48487.82,133340.25
350130,202211,430,186,244,225471.48,295773.54,521245.02
350140,202211,37,23,14,27877.97,16970.72,44848.69
350150,202211,72,50,22,60605.9,26665.87,87271.77
350160,202211,2510,988,1522,1198820.7,1847215.32,3046036.02
350170,202211,423,244,179,295764.2,216972.05,512736.25
350180,202211,166,91,75,110301.05,90906.23,201207.28
350190,202211,1044,559,485,677617.79,587852.19,1265469.98
350200,202211,60,25,35,30300.74,42421.57,72722.31
350210,202211,1374,737,637,893374.15,772141.96,1665516.11
350220,202211,651,523,128,635165,155150.29,790315.29
350230,202211,67,40,27,48483.85,32726.05,81209.90
350240,202211,61,37,24,44850.46,29094.14,73944.60
350250,202211,1157,520,637,630350.54,772161.28,1402511.82
350260,202211,105,77,28,93334.41,33936.9,127271.31
350270,202211,995,660,335,799999.89,406063.34,1206063.23
350275,202211,345,128,217,155155.9,264252.02,419407.92
350280,202211,4605,2188,2417,2654618.06,2930809.84,5585427.90
350290,202211,493,212,281,256980.21,340616.18,597596.39
350300,202211,50,25,25,31518.03,30303.63,61821.66
350310,202211,79,44,35,53334.61,42422.57,95757.18
350315,202211,74,31,43,37573.03,52117,89690.03
350320,202211,3549,1647,1902,1997639.67,2306626.75,4304266.42
350330,202211,1726,855,871,1037592.38,1056926.71,2094519.09
350335,202211,21,13,8,15756.67,9697.45,25454.12
350340,202211,128,52,76,63037.45,92127.9,155165.35
350350,202211,99,47,52,56971.64,63028.78,120000.42
350360,202211,108,71,37,86067.84,44850.03,130917.87
350370,202211,89,49,40,59400.23,48485.15,107885.38
350380,202211,880,375,505,455766.25,612120.13,1067886.38
350390,202211,1874,692,1182,838815.54,1432756.69,2271572.23
350395,202211,18,14,4,16973,4848.2,21821.2
350400,202211,1820,860,960,1044864.11,1163565.84,2208429.95
350410,202211,3240,1323,1917,1606116.92,2323603.26,3929720.18
350420,202211,291,173,118,209695.45,143027.61,352723.06
350430,202211,103,52,51,63032.72,61823.35,124856.07
350440,202211,144,100,44,121219.23,53333,174552.23
350450,202211,1819,999,820,1212158.04,993880.44,2206038.48
350460,202211,422,141,281,170923.73,340629.73,511553.46
350470,202211,19,12,7,14544,8484.6,23028.6
350480,202211,201,104,97,126068.35,117577.29,243645.64
350490,202211,253,115,138,139406.84,167282.07,306688.91
350500,202211,56,20,36,24240.34,43633.4,67873.74
350510,202211,154,90,64,109095.05,77572.16,186667.21
350520,202211,460,247,213,299419.36,259401.69,558821.05
350530,202211,458,216,242,263040.36,294560.61,557600.97
350535,202211,99,64,35,77580.27,42427.09,120007.36
350540,202211,372,195,177,238799.08,214556.97,453356.05
350550,202211,2901,1614,1287,1957660.36,1559940.11,3517600.47
350560,202211,613,412,201,501827.92,243638.83,745466.75
350570,202211,4911,2004,2907,2431607.45,3523656.17,5955263.62
350580,202211,397,188,209,227884.23,253335.55,481219.78
350590,202211,1036,558,478,676355.86,579522.82,1255878.68
350600,202211,6707,3071,3636,3724973.95,4411960.17,8136934.12
350610,202211,1601,825,776,1000009.3,942997.47,1943006.77
350620,202211,25,15,10,18180.44,12120.6,30301.04
350630,202211,268,132,136,160000.51,164847.48,324847.99
350635,202211,1308,542,766,656984.42,928504.66,1585489.08
350640,202211,123,88,35,106664.57,42421.98,149086.55
350650,202211,1978,1296,682,1572153.49,827847.93,2400001.42
350660,202211,839,331,508,401226.25,615774.01,1017000.26
350670,202211,303,149,154,180593.78,186651.15,367244.93
350680,202211,167,85,82,103036.31,100607.97,203644.28
350690,202211,210,93,117,112729.93,141811.8,254541.73
350700,202211,976,453,523,549097.19,635149.65,1184246.84
350710,202211,430,160,270,193942.91,328491.57,522434.48
350715,202211,58,46,12,55755.88,14546.2,70302.08
350720,202211,16,11,5,13333.78,6062.45,19396.23
350730,202211,41,26,15,31513.74,18180.11,49693.85
350740,202211,255,141,114,170909.39,138178.88,309088.27
350745,202211,31,14,17,16970.99,20607.22,37578.21
350750,202211,2584,1497,1087,1814590.86,1318750.31,3133341.17
350760,202211,4183,1758,2425,2131038.29,2941780.24,5072818.53
350770,202211,58,36,22,43634.43,27877.42,71511.85
350775,202211,54,39,15,47277.86,18182.39,65460.25
350780,202211,473,237,236,287276.99,286068.28,573345.27
350790,202211,374,155,219,187884.54,265461.08,453345.62
350800,202211,548,327,221,396365.07,267874.3,664239.37
350810,202211,526,400,126,484868.96,153940.33,638809.29
350820,202211,101,57,44,69085.33,53329.85,122415.18
350830,202211,78,40,38,48485.51,46059.52,94545.03
350840,202211,851,334,517,404864.26,626792.79,1031657.05
350850,202211,1964,1011,953,1225487.8,1155134.41,2380622.21
350860,202211,709,364,345,441238.29,418208.13,859446.42
350870,202211,470,311,159,379392.72,192725.15,572117.87
350880,202211,281,154,127,186680.32,153951.49,340631.81
350890,202211,38,24,14,29091.18,16972.33,46063.51
350900,202211,1732,536,1196,649716.5,1449746.41,2099462.91
350910,202211,25,13,12,15757.84,14545.73,30303.57
350920,202211,822,419,403,507875.08,488475.68,996350.76
350925,202211,1234,616,618,746705.3,749127.03,1495832.33
350930,202211,125,72,53,87276.16,64240.23,151516.39
350940,202211,767,396,371,481243.18,449717.04,930960.22
350945,202211,118,82,36,99395.63,44851.13,144246.76
350950,202211,18775,8611,10164,10446226.77,12326972.28,22773199.05
350960,202211,1784,709,1075,861829.87,1304238.87,2166068.74
350970,202211,1145,553,592,670215.57,717629.81,1387845.38
350980,202211,98,67,31,81214.02,37575.67,118789.69
350990,202211,417,146,271,176966.91,328478.03,505444.94
350995,202211,44,18,26,21818.17,31516.44,53334.61
351000,202211,633,401,232,486078.88,281222.06,767300.94
351010,202211,52,35,17,42423.26,20605.78,63029.04
351015,202211,47,29,18,35152.31,21816.44,56968.75
351020,202211,1551,923,628,1119999.75,761215.88,1881215.63
351030,202211,357,209,148,253325.63,179380,432705.63
351040,202211,1065,581,484,704235.37,586668.61,1290903.98
351050,202211,3861,1734,2127,2101917.91,2578149.11,4680067.02
351060,202211,6440,2305,4135,2795309.25,5011942.5,7807251.75
351070,202211,428,264,164,320019.64,198799.15,518818.79
351080,202211,783,577,206,699395.71,249696.34,949092.05
351090,202211,49,25,24,30303.26,29092.4,59395.66
351100,202211,437,232,205,281237.98,248501.38,529739.36
351110,202211,2182,992,1190,1204874.5,1444785.64,2649660.14
351120,202211,67,31,36,37576.05,43633.86,81209.91
351130,202211,199,66,133,80001.34,161215.58,241216.92
351140,202211,333,199,134,241220.31,162422.98,403643.29
351150,202211,523,261,262,318789.31,317563.33,636352.64
351160,202211,325,190,135,230306.36,164840.29,395146.65
351170,202211,241,137,104,166050.91,126056.28,292107.19
351190,202211,94,58,36,70302.03,43633.34,113935.37
351200,202211,355,230,125,278788.55,151522.17,430310.72
351210,202211,132,64,68,77577.52,83635.29,161212.81
351220,202211,610,343,267,415764.44,324842.27,740606.71
351230,202211,316,205,111,248485.83,134539.49,383025.32
351240,202211,247,121,126,146665.73,152730.54,299396.27
351250,202211,86,56,30,67882.64,36366.14,104248.78
351260,202211,148,103,45,124838.11,54541.81,179379.92
351270,202211,48,23,25,27877.87,30302.34,58180.21
351280,202211,1079,516,563,625453.97,683643.87,1309097.84
351290,202211,258,121,137,146661.68,166053.36,312715.04
351300,202211,4237,1768,2469,2144368.62,2992835.09,5137203.71
351310,202211,758,365,393,442443.7,476403.71,918847.41
351320,202211,119,67,52,81215.22,63033.19,144248.41
351330,202211,44,26,18,31514.04,21817.24,53331.28
351340,202211,1496,803,693,973354.62,842390.08,1815744.70
351350,202211,2525,1467,1058,1780726.23,1283610.23,3064336.46
351360,202211,843,385,458,466695.86,555180.04,1021875.90
351370,202211,460,223,237,270308.29,287263.15,557571.44
351380,202211,9283,3997,5286,4846322.23,6413263.32,11259585.55
351385,202211,23,16,7,19396.2,8486.17,27882.37
351390,202211,292,212,80,256977.24,98179.65,355156.89
351400,202211,62,41,21,49693.36,25454.49,75147.85
351410,202211,488,287,201,347894.7,244844.99,592739.69
351420,202211,75,54,21,65451.22,25452,90903.22
351430,202211,74,38,36,46061.5,43635.35,89696.85
351440,202211,840,545,295,661832.92,357576.59,1019409.51
351450,202211,290,140,150,169703.38,181822.91,351526.29
351460,202211,144,61,83,73944.43,100605.69,174550.12
351470,202211,145,75,70,90910.7,84847.95,175758.65
351480,202211,488,284,204,344234.93,248474.56,592709.49
351490,202211,316,126,190,152717.17,231505.88,384223.05
351492,202211,28,17,11,20607.43,13332,33939.43
351495,202211,26,17,9,20606.77,10908.99,31515.76
351500,202211,3622,1439,2183,1744299.61,2648515.62,4392815.23
351510,202211,2248,811,1437,983048.12,1744235.54,2727283.66
351512,202211,13,9,4,10908.44,4848,15756.44
351515,202211,210,121,89,146671.07,107879.64,254550.71
351518,202211,705,417,288,505527.15,349120.41,854647.56
351519,202211,89,53,36,64242.38,43635.14,107877.52
351520,202211,172,107,65,129696.21,78806.21,208502.42
351530,202211,26,12,14,14544.4,16968,31512.4
351535,202211,139,82,57,99400.19,69095.82,168496.01
351540,202211,489,315,174,381835.99,210910.78,592746.77
351550,202211,1636,959,677,1162431.9,820570.69,1983002.59
351560,202211,83,48,35,58180.75,42421.97,100602.72
351565,202211,17,8,9,9697.2,10909.24,20606.44
351570,202211,2935,1329,1606,1611044.17,1946777,3557821.17
351580,202211,35,33,2,39999.59,2424,42423.59
351590,202211,70,42,28,50913.54,33939.65,84853.19
351600,202211,183,133,50,161218.26,60607.65,221825.91
351610,202211,55,24,31,29090.59,37576.94,66667.53
351620,202211,6223,3280,2943,3978300.72,3570827.18,7549127.90
351630,202211,3516,1652,1864,2003718.81,2261861.21,4265580.02
351640,202211,2603,1127,1476,1366076.55,1792721.34,3158797.89
351650,202211,35,28,7,33940.57,8484.74,42425.31
351660,202211,145,92,53,111514.8,64238.98,175753.78
351670,202211,784,448,336,544257.83,408484.74,952742.57
351680,202211,84,63,21,76357.29,25452,101809.29
351685,202211,13,9,4,10908.6,4848.2,15756.8
351690,202211,307,194,113,235167.42,136971.84,372139.26
351700,202211,192,129,63,156623.69,76358.37,232982.06
351710,202211,67,42,25,50911.45,30304.59,81216.04
351720,202211,122,69,53,83630.67,64238.13,147868.80
351730,202211,117,79,38,95749.36,46056,141805.36
351740,202211,829,522,307,632737.72,372133.57,1004871.29
351750,202211,393,157,236,190311.5,286072.81,476384.31
351760,202211,721,558,163,677505.12,197572,875077.12
351770,202211,298,240,58,290912.79,70307.25,361220.04
351780,202211,150,92,58,111513.93,70298.11,181812.04
351790,202211,280,140,140,169699.45,169697.25,339396.70
351800,202211,47,30,17,36362.56,20604.44,56967.00
351810,202211,123,77,46,93339.29,55759.41,149098.70
351820,202211,782,549,233,665487.94,282432.05,947919.99
351830,202211,685,219,466,265457.79,564857.39,830315.18
351840,202211,2374,1056,1318,1280022.9,1597493.48,2877516.38
351850,202211,273,189,84,229103.24,101813.45,330916.69
351860,202211,616,410,206,497000.57,249702.96,746703.53
351870,202211,6114,2729,3385,3310460.61,4104392.88,7414853.49
351880,202211,23251,8810,14441,10682604.61,17515904.67,28198509.28
351885,202211,107,57,50,69093.37,60605.01,129698.38
351890,202211,74,50,24,60603.91,29088,89691.91
351900,202211,253,132,121,160006.08,146664.58,306670.66
351905,202211,100,46,54,55754.74,65453.01,121207.75
351907,202211,3929,1581,2348,1917624.6,2849636.65,4767261.25
351910,202211,156,63,93,76374.37,112738.52,189112.89
351920,202211,116,63,53,76359.88,64240.07,140599.95
351925,202211,92,57,35,69095.99,42426.64,111522.63
351930,202211,470,292,178,353958.7,215765.17,569723.87
351940,202211,246,101,145,122424.36,175757.92,298182.28
351950,202211,146,79,67,95757.62,81215.08,176972.70
351960,202211,1000,480,520,583048.77,630326.84,1213375.61
351970,202211,2217,1042,1175,1263054.12,1424270.85,2687324.97
351980,202211,153,64,89,77579.68,107884.18,185463.86
351990,202211,262,163,99,197573.71,120003.89,317577.60
352000,202211,321,200,121,242437.92,146675.59,389113.51
352010,202211,445,285,160,345542.12,193956.77,539498.89
352020,202211,210,71,139,86056.76,169684.61,255741.37
352030,202211,1236,566,670,686076.91,812120.55,1498197.46
352040,202211,704,270,434,327279.4,526072.34,853351.74
352042,202211,358,84,274,101817.85,332126.13,433943.98
352044,202211,383,216,167,261845.35,202436.34,464281.69
352050,202211,3418,1235,2183,1497028,2647217.11,4144245.11
352060,202211,104,62,42,75147.54,50906.91,126054.45
352070,202211,99,67,32,81217.98,38786.36,120004.34
352080,202211,69,41,28,49697.95,33943.28,83641.23
352090,202211,187,115,72,139393.5,87267.1,226660.6
352100,202211,328,159,169,192731.17,204845.07,397576.24
352110,202211,114,30,84,36363.92,101814.67,138178.59
352115,202211,67,26,41,31514.38,49696.52,81210.90
352120,202211,72,48,24,58178.11,29092.73,87270.84
352130,202211,222,163,59,197582.4,71512.54,269094.94
352140,202211,196,94,102,113932.52,123637.88,237570.40
352150,202211,135,70,65,84854.74,78794.05,163648.79
352160,202211,147,94,53,113938.26,64240.25,178178.51
352170,202211,430,287,143,347873.88,173326.75,521200.63
352180,202211,719,434,285,528508.5,345470.93,873979.43
352190,202211,252,106,146,128490.39,176968.52,305458.91
352200,202211,30,12,18,14546.35,21819.2,36365.55
352210,202211,4743,1868,2875,2264315.15,3488411.17,5752726.32
352215,202211,75,41,34,49694.35,41208.8,90903.15
352220,202211,6451,2367,4084,2869326.27,4951920.56,7821246.83
352230,202211,3756,2350,1406,2852234.74,1704157.77,4556392.51
352240,202211,2871,1598,1273,1938205.84,1543041.24,3481247.08
352250,202211,3767,1655,2112,2008548.42,2563527.74,4572076.16
352260,202211,1083,566,517,686090.11,626703.75,1312793.86
352265,202211,68,39,29,47270.34,35149.93,82420.27
352270,202211,418,227,191,275168.7,231526.09,506694.79
352280,202211,532,306,226,370906.93,273922.69,644829.62
352290,202211,179,97,82,117584.92,99395.33,216980.25
352300,202211,101,64,37,77579.35,44851.25,122430.60
352310,202211,7788,3350,4438,4060826.1,5382737.16,9443563.26
352320,202211,1224,628,596,761221.28,723626.04,1484847.32
352330,202211,559,287,272,347856.96,330883.77,678740.73
352340,202211,1428,648,780,785488.04,945475.01,1730963.05
352350,202211,389,206,183,249711.8,221828.57,471540.37
352360,202211,219,97,122,117572.4,147871.63,265444.03
352370,202211,126,77,49,93337.54,59394.12,152731.66
352380,202211,119,85,34,103034.52,41214.03,144248.55
352390,202211,2724,1151,1573,1396422.35,1906613.65,3303036.00
352400,202211,580,252,328,305446.9,397571.24,703018.14
352410,202211,940,612,328,741834.09,398804.75,1140638.84
352420,202211,87,65,22,78785.59,26667.02,105452.61
352430,202211,1829,792,1037,960013.16,1256976.56,2216989.72
352440,202211,3629,1634,1995,1980643.49,2418095.67,4398739.16
352450,202211,204,157,47,190296.73,56973.35,247270.08
352460,202211,659,323,336,391523.28,407281.55,798804.83
352470,202211,704,264,440,321212.8,533330.14,854542.94
352480,202211,1712,961,751,1167276.05,912742.7,2080018.75
352490,202211,56,22,34,26668.44,41213.63,67882.07
352500,202211,1345,534,811,647294.11,985454.98,1632749.09
352510,202211,744,387,357,469111.36,432744.29,901855.65
352520,202211,904,401,503,486077.6,609724.67,1095802.27
352530,202211,1963,978,985,1186720.82,1193898.33,2380619.15
352540,202211,73,50,23,60607.96,27880.36,88488.32
352550,202211,218,124,94,150302.91,113934.71,264237.62
352560,202211,54,40,14,48486.57,16968.9,65455.47
352570,202211,784,373,411,452134.43,498189.65,950324.08
352580,202211,59,45,14,54546.71,16970.21,71516.92
352585,202211,21,6,15,7273.12,18183.75,25456.87
352590,202211,4730,2301,2429,2791651.74,2944253.31,5735905.05
352600,202211,379,259,120,315165.06,146671.56,461836.62
352610,202211,952,416,536,504252.29,649710.66,1153962.95
352620,202211,1172,439,733,532150.48,889724.51,1421874.99
352630,202211,197,73,124,88485,150304.75,238789.75
352640,202211,534,338,196,409718.76,237587.59,647306.35
352650,202211,93,65,28,78786.92,33937.91,112724.83
352660,202211,69,38,31,46061.78,37572.57,83634.35
352670,202211,1808,948,860,1149121.76,1042364.36,2191486.12
352680,202211,1001,591,410,716399.46,497012.05,1213411.51
352690,202211,4882,2099,2783,2545551.16,3374475.47,5920026.63
352700,202211,90,50,40,60611.81,48485.34,109097.15
352710,202211,1572,794,778,962429.56,942963.55,1905393.11
352720,202211,1643,671,972,814585.28,1178219.66,1992804.94
352725,202211,28,21,7,25455.48,8484.5,33939.98
352730,202211,416,204,212,247278.19,256975.75,504253.94
352740,202211,409,259,150,313958.35,181828.45,495786.80
352750,202211,23,14,9,16972.03,10908.77,27880.80
352760,202211,237,150,87,181813.84,105451.68,287265.52
352770,202211,77,56,21,67882.4,25453.94,93336.34
352780,202211,75,37,38,44846.04,46058.58,90904.62
352790,202211,25,17,8,20606.46,9696.74,30303.20
352800,202211,249,187,62,226668.77,75153.65,301822.42
352810,202211,162,102,60,123649.95,72731.27,196381.22
352820,202211,48,36,12,43634.32,14546.13,58180.45
352830,202211,75,50,25,60612.44,30304.14,90916.58
352840,202211,743,328,415,398820.8,503050.73,901871.53
352850,202211,1903,562,1341,682416.61,1627848.4,2310265.01
352860,202211,120,74,46,89704.24,55759.3,145463.54
352870,202211,51,32,19,38790.44,23033.12,61823.56
352880,202211,191,110,81,134549.63,98186.07,232735.70
352885,202211,34,22,12,26668.63,14544.75,41213.38
352890,202211,58,35,23,42426.54,27879.75,70306.29
352900,202211,4797,2227,2570,2701879.17,3116276.69,5818155.86
352910,202211,38,31,7,37574.26,8484.44,46058.70
352920,202211,656,373,283,452142.82,343041.8,795184.62
352930,202211,1233,571,662,693341.93,802412.77,1495754.70
352940,202211,6554,2453,4101,2974621.48,4974596.98,7949218.46
352950,202211,124,55,69,66663.85,83635.29,150299.14
352960,202211,64,39,25,47270.8,30301.45,77572.25
352965,202211,16,10,6,12121.87,7272.5,19394.37
352970,202211,554,398,156,483660.35,189101.11,672761.46
352980,202211,166,97,69,117586.49,83638.35,201224.84
352990,202211,996,463,533,561235.28,646111.07,1207346.35
353000,202211,61,27,34,32726.73,41212.61,73939.34
353010,202211,531,320,211,387905.7,255765.75,643671.45
353020,202211,348,226,122,273943.98,147883.04,421827.02
353030,202211,1456,638,818,773345.25,992735.23,1766080.48
353040,202211,91,47,44,56971.85,53332.06,110303.91
353050,202211,1388,894,494,1084876.87,598769.21,1683646.08
353060,202211,9628,4114,5514,4986948.86,6688307.14,11675256.00
353070,202211,2063,1194,869,1447300.46,1053056.89,2500357.35
353080,202211,1356,720,636,872741.54,770876.08,1643617.62
353090,202211,69,36,33,43632.91,39997.15,83630.06
353100,202211,44,33,11,40001.09,13333.28,53334.37
353110,202211,2364,780,1584,946693.63,1921355.69,2868049.32
353120,202211,143,81,62,98178.46,75146.15,173324.61
353130,202211,881,415,466,503040.16,564848.3,1067888.46
353140,202211,600,279,321,338181.61,389102.74,727284.35
353150,202211,321,166,155,201214.29,187881.99,389096.28
353160,202211,112,84,28,101822.15,33941.92,135764.07
353170,202211,212,76,136,92124.29,164854.87,256979.16
353180,202211,1278,578,700,700602.83,849702.75,1550305.58
353190,202211,522,366,156,444869.38,189089.4,633958.78
353200,202211,281,137,144,166057.69,174538.35,340596.04
353205,202211,19,12,7,14544.44,8484,23028.44
353210,202211,70,42,28,50909.61,35151.2,86060.81
353215,202211,44,24,20,29090.33,24241.22,53331.55
353220,202211,84,44,40,53333.9,48483.13,101817.03
353230,202211,161,69,92,83634.14,111515.47,195149.61
353240,202211,407,174,233,210901.61,282409.12,493310.73
353250,202211,190,94,96,113941.24,116373.21,230314.45
353260,202211,480,306,174,370951.43,210917.21,581868.64
353270,202211,75,57,18,69094.77,21816.78,90911.55
353280,202211,122,56,66,67880.32,81218.1,149098.42
353282,202211,130,88,42,106663.02,50906.97,157569.99
353284,202211,32,22,10,26666,12121.25,38787.25
353286,202211,9,4,5,4848.4,6060.7,10909.1
353290,202211,87,50,37,60605.62,44846.83,105452.45
353300,202211,463,232,231,281220.62,281226.69,562447.31
353310,202211,40,33,7,40000.28,8484.3,48484.58
353320,202211,42,24,18,29092.84,21817.68,50910.52
353325,202211,45,25,20,30303.81,24243.36,54547.17
353330,202211,62,42,20,50908.82,24240,75148.82
353340,202211,719,250,469,303035.32,568501.32,871536.64
353350,202211,958,466,492,564864.32,597597.63,1162461.95
353360,202211,107,84,23,101816.66,27879.84,129696.50
353370,202211,110,60,50,72730.44,60610.12,133340.56
353380,202211,28,13,15,15757.11,18180.11,33937.22
353390,202211,1169,541,628,655779.38,761227.45,1417006.83
353400,202211,56,30,26,36365.67,31515.43,67881.10
353410,202211,121,64,57,77574.13,69089.65,146663.78
353420,202211,59,26,33,31512.44,39996.71,71509.15
353430,202211,586,382,204,464248.06,248492.41,712740.47
353440,202211,13147,5557,7590,6737114.39,9206990.48,15944104.87
353450,202211,53,26,27,31517.83,32730.75,64248.58
353460,202211,677,342,335,414548.66,406056.16,820604.82
353470,202211,2355,1118,1237,1355200.79,1500533.37,2855734.16
353475,202211,300,191,109,232721.44,132125.28,364846.72
353480,202211,189,150,39,181811.94,47270.25,229082.19
353490,202211,231,133,98,161212.76,118789.5,280002.26
353500,202211,220,121,99,146669.37,120002.18,266671.55
353510,202211,82,54,28,65454.87,33938.06,99392.93
353520,202211,248,181,67,219388.98,81208.67,300597.65
353530,202211,502,246,256,299416.38,310322.32,609738.70
353540,202211,425,263,162,318795.79,196374.05,515169.84
353550,202211,787,494,293,600021.12,355167.24,955188.36
353560,202211,568,230,338,278799.95,412135.97,690935.92
353570,202211,69,48,21,58182.54,25458.09,83640.63
353580,202211,356,223,133,270306.91,161205.12,431512.03
353590,202211,90,65,25,78786.05,30300.99,109087.04
353600,202211,295,166,129,201210.7,156358.77,357569.47
353610,202211,135,76,59,92119.93,71515.73,163635.66
353620,202211,704,351,353,425459.7,427885.95,853345.65
353625,202211,59,30,29,36364.81,35150.52,71515.33
353630,202211,222,158,64,192731.08,77571.34,270302.42
353640,202211,127,81,46,98180.7,55756.1,153936.8
353650,202211,1081,419,662,507871.69,802408,1310279.69
353657,202211,24,18,6,21817.6,7273.98,29091.58
353660,202211,306,159,147,192726.8,178180.62,370907.42
353670,202211,747,419,328,507896.04,397590.95,905486.99
353680,202211,145,90,55,109087.09,67874.18,176961.27
353690,202211,43,29,14,35153.02,16970.49,52123.51
353700,202211,295,198,97,240007.05,117574.46,357581.51
353710,202211,548,267,281,324855.03,340613.33,665468.36
353715,202211,40,23,17,27881.1,20607.31,48488.41
353720,202211,332,149,183,180620.3,221832.54,402452.84
353730,202211,1216,717,499,869096.99,604836.46,1473933.45
353740,202211,619,341,278,413341.12,336973.89,750315.01
353750,202211,88,47,41,56971.57,49695.99,106667.56
353760,202211,3468,1326,2142,1609759.78,2598825.02,4208584.80
353770,202211,79,62,17,75152.51,20604.82,95757.33
353780,202211,1442,648,794,785452.66,963632.86,1749085.52
353790,202211,510,304,206,368508.86,249707.74,618216.60
353800,202211,3909,1796,2113,2177037.09,2562283.92,4739321.01
353810,202211,248,123,125,149100.24,151517.61,300617.85
353820,202211,266,108,158,130902.58,191501.81,322404.39
353830,202211,67,56,11,67877.62,13333.01,81210.63
353850,202211,221,98,123,118787.33,149094.52,267881.85
353860,202211,553,245,308,296974.06,373324.67,670298.73
353870,202211,6097,3090,3007,3746703.59,3648368.2,7395071.79
353880,202211,751,479,272,580621.76,329690.91,910312.67
353890,202211,581,324,257,392763.17,311527.01,704290.18
353900,202211,143,75,68,90912.47,82424.36,173336.83
353910,202211,217,80,137,96974.08,166060.33,263034.41
353920,202211,476,244,232,295757.98,281209.16,576967.14
353930,202211,1072,626,446,758804.19,540586.76,1299390.95
353940,202211,223,106,117,128482.48,141816.22,270298.70
353950,202211,527,339,188,410909.39,227877.81,638787.20
353960,202211,78,62,16,75149.86,19394.3,94544.16
353970,202211,43,28,15,33943.99,18184.24,52128.23
353980,202211,2064,897,1167,1087309.86,1414588.73,2501898.59
353990,202211,85,50,35,60608.67,42423.73,103032.40
354000,202211,402,182,220,220604.55,266666.14,487270.69
354010,202211,95,54,41,65462.49,49700.1,115162.59
354020,202211,545,338,207,410921.51,252131.19,663052.70
354025,202211,39,33,6,40002,7272.84,47274.84
354030,202211,50,26,24,31517.03,29091.5,60608.53
354040,202211,101,74,27,89698.54,32725.72,122424.26
354050,202211,166,87,79,105454.08,95754.98,201209.06
354060,202211,849,391,458,473943.92,555155.84,1029099.76
354070,202211,946,529,417,642430.86,506668.09,1149098.95
354075,202211,190,90,100,109092.58,121216.45,230309.03
354080,202211,314,139,175,168489.37,212127.52,380616.89
354085,202211,23,14,9,16971.66,10908.84,27880.50
354090,202211,289,169,120,204757.8,145453,350210.8
354100,202211,6461,2605,3856,3158869.88,4676405.11,7835274.99
354105,202211,101,51,50,61816.8,60602.95,122419.75
354110,202211,41,20,21,24243.28,25460,49703.28
354120,202211,159,99,60,120003.06,72724.57,192727.63
354130,202211,797,478,319,579415.04,386679.44,966094.48
354140,202211,3493,1550,1943,1878837.05,2355076.31,4233913.36
354150,202211,672,381,291,461837.08,352726.49,814563.57
354160,202211,700,437,263,529714.4,318792.19,848506.59
354165,202211,11,7,4,8486.22,4848,13334.22
354170,202211,188,123,65,149093.33,78786.61,227879.94
354180,202211,52,29,23,35152.78,27879.43,63032.21
354190,202211,216,82,134,99393.28,162422.48,261815.76
354200,202211,118,56,62,67882.08,75161.8,143043.88
354210,202211,75,30,45,36365.27,54541.03,90906.30
354220,202211,627,385,242,466695.67,293339.96,760035.63
354230,202211,169,74,95,89699.92,115159.38,204859.30
354240,202211,336,207,129,250911.76,156361.56,407273.32
354250,202211,78,46,32,55761.26,38786.61,94547.87
354260,202211,2251,1034,1217,1253383.76,1476405.35,2729789.11
354270,202211,89,64,25,77571.19,31512.44,109083.63
354280,202211,58,32,26,38786.19,31515.23,70301.42
354290,202211,151,103,48,124851.83,58183.19,183035.02
354300,202211,344,241,103,292148.79,124854.76,417003.55
354310,202211,93,65,28,78793.85,33940.53,112734.38
354320,202211,233,111,122,134546.53,149085.91,283632.44
354323,202211,7,5,2,6060.55,2424,8484.55
354325,202211,133,69,64,83632.44,77569.99,161202.43
354330,202211,2560,854,1706,1035052.26,2070261.14,3105313.40
354340,202211,11239,5069,6170,6146640.35,7482309.78,13628950.13
354350,202211,150,102,48,123626.95,58178.59,181805.54
354360,202211,79,46,33,55758.57,39999.88,95758.45
354370,202211,235,121,114,146671.88,138184.2,284856.08
354380,202211,174,100,74,121218.48,89699.03,210917.51
354390,202211,2891,1018,1873,1235164.41,2271488.41,3506652.82
354400,202211,348,188,160,227874.68,193936.5,421811.18
354410,202211,723,311,412,378200.5,499409.1,877609.6
354420,202211,289,194,95,235162.87,115155.13,350318.00
354425,202211,345,192,153,232787.12,186668.58,419455.70
354430,202211,185,96,89,116367.18,107876.31,224243.49
354440,202211,28,22,6,26668.22,7272,33940.22
354450,202211,59,38,21,46058.06,25453.56,71511.62
354460,202211,104,59,45,71522.93,54546.52,126069.45
354470,202211,25,13,12,15760,14549.83,30309.83
354480,202211,121,66,55,79999.63,67874.37,147874.00
354490,202211,131,73,58,88486.67,70301.9,158788.57
354500,202211,417,181,236,219387.5,286046.71,505434.21
354510,202211,88,61,27,73939.91,32727.58,106667.49
354515,202211,51,17,34,20605.68,41213.26,61818.94
354520,202211,1712,719,993,873798.96,1204799.21,2078598.17
354530,202211,893,436,457,529698.31,553928.6,1083626.91
354540,202211,266,129,137,156374.57,166062.99,322437.56
354550,202211,46,25,21,30301.72,25452.84,55754.56
354560,202211,166,90,76,109086.94,92114.29,201201.23
354570,202211,134,94,40,113935.56,48482.48,162418.04
354580,202211,1971,931,1040,1130215.94,1261806.51,2392022.45
354600,202211,295,136,159,164863.62,192723.89,357587.51
354610,202211,64,53,11,64246.9,13334.77,77581.67
354620,202211,77,21,56,25454.24,67875.18,93329.42
354625,202211,13,8,5,9697.5,6061.81,15759.31
354630,202211,357,234,123,283646.66,149095.7,432742.36
354640,202211,871,511,360,620826.26,436367.21,1057193.47
354650,202211,71,42,29,50907.89,35150.04,86057.93
354660,202211,849,616,233,746711.3,282434.29,1029145.59
354670,202211,230,89,141,107880.46,170908.43,278788.89
354680,202211,1401,494,907,598803.14,1100600.95,1699404.09
354690,202211,82,50,32,60607.05,38786.44,99393.49
354700,202211,80,55,25,66664.29,30300.76,96965.05
354710,202211,49,36,13,43634.8,15757.58,59392.38
354720,202211,22,20,2,24241.17,2424,26665.17
354730,202211,1906,778,1128,943088.11,1368571.36,2311659.47
354740,202211,73,50,23,60602.88,27876.71,88479.59
354750,202211,424,235,189,284839.88,229087.13,513927.01
354760,202211,549,338,211,409725.26,255765.22,665490.48
354765,202211,6,2,4,2424.78,4850.26,7275.04
354770,202211,370,239,131,289702.01,158789.95,448491.96
354780,202211,8982,3267,5715,3960106.2,6936792.81,10896899.01
354790,202211,90,52,38,63028.42,46057.94,109086.36
354800,202211,439,231,208,279958.25,252138.91,532097.16
354805,202211,76,38,38,46059.62,46067.46,92127.08
354810,202211,102,55,47,66665.01,56966.9,123631.91
354820,202211,224,91,133,110313.04,161225.86,271538.90
354830,202211,43,22,21,26664.4,25455.04,52119.44
354840,202211,61,38,23,46059.08,27876.44,73935.52
354850,202211,4961,2174,2787,2636434.85,3378137.04,6014571.89
354860,202211,351,157,194,190300.98,235155.33,425456.31
354870,202211,12914,5547,7367,6727497.43,8935563.28,15663060.71
354880,202211,2812,1008,1804,1221893.11,2186771.88,3408664.99
354890,202211,3171,1655,1516,2006113.73,1838734.99,3844848.72
354900,202211,65,47,18,56970.3,21818.76,78789.06
354910,202211,1359,685,674,830329.62,818125.57,1648455.19
354920,202211,39,32,7,38786.76,8484.61,47271.37
354925,202211,24,13,11,15756,13332.44,29088.44
354930,202211,32,27,5,32730.71,6060.44,38791.15
354940,202211,796,547,249,663055.69,301831.56,964887.25
354950,202211,212,130,82,157575.44,99395.22,256970.66
354960,202211,129,46,83,55764.21,100616.37,156380.58
354970,202211,1216,846,370,1026654.98,449667.91,1476322.89
354980,202211,10024,3600,6424,4368535.98,7796165.63,12164701.61
354990,202211,11100,4845,6255,5874038.22,7586460.47,13460498.69
354995,202211,628,205,423,248494.86,512756.13,761250.99
355000,202211,470,164,306,198792.08,370931.7,569723.78
355010,202211,680,418,262,506694.95,317598.41,824293.36
355020,202211,837,511,326,619419.14,395158.72,1014577.86
355030,202211,227829,84066,143763,101953332.15,174366488.33,276319820.48
355040,202211,1031,493,538,598780.51,652105.31,1250885.82
355050,202211,185,99,86,119996.38,104237.88,224234.26
355060,202211,1912,886,1026,1073980.44,1243575.36,2317555.80
355070,202211,1718,745,973,903044.85,1181844.7,2084889.55
355080,202211,213,128,85,155155.91,103030.77,258186.68
355090,202211,329,205,124,249704.31,151515.14,401219.45
355100,202211,5846,2690,3156,3263010.78,3826574.14,7089584.92
355110,202211,226,146,80,176972.92,98179.72,275152.64
355120,202211,54,32,22,38788.21,26666.41,65454.62
355130,202211,53,29,24,35156.17,29092.65,64248.82
355140,202211,207,118,89,143024.81,107873.07,250897.88
355150,202211,738,438,300,530938.05,363649.22,894587.27
355160,202211,515,244,271,296978.42,328491.33,625469.75
355170,202211,2195,1116,1079,1353976.49,1307856.74,2661833.23
355180,202211,735,284,451,344255.83,546681.05,890936.88
355190,202211,232,153,79,185456.74,95759.28,281216.02
355200,202211,119,58,61,70298.59,73934.75,144233.34
355210,202211,747,383,364,464261.27,441329.33,905590.60
355220,202211,8291,3905,4386,4733532.65,5319870.57,10053403.22
355230,202211,95,51,44,61818.77,53331.78,115150.55
355240,202211,4899,1927,2972,2339419.78,3607147.43,5946567.21
355250,202211,7447,3257,4190,3950438.98,5084616.25,9035055.23
355255,202211,49,30,19,36362.86,23029,59391.86
355260,202211,197,110,87,133335.89,105455.86,238791.75
355270,202211,160,104,56,126063.57,69091.93,195155.50
355280,202211,7593,2807,4786,3403824.49,5803930.4,9207754.89
355290,202211,65,50,15,60603.63,18184.29,78787.92
355300,202211,235,133,102,161215.18,123630.93,284846.11
355310,202211,116,64,52,77573.44,63029.71,140603.15
355320,202211,102,52,50,63029.09,60604.06,123633.15
355330,202211,340,195,145,236366.56,175759.11,412125.67
355340,202211,1392,498,894,603667.7,1083801.15,1687468.85
355350,202211,170,79,91,95751.97,110296.62,206048.59
355360,202211,181,118,63,143037.48,76369.5,219406.98
355365,202211,18,12,6,14546.48,7273.28,21819.76
355370,202211,1068,623,445,755168.35,539369.67,1294538.02
355380,202211,857,514,343,623069.8,415778.48,1038848.28
355385,202211,99,62,37,75148.78,44845.09,119993.87
355390,202211,108,55,53,66667.3,64245.01,130912.31
355395,202211,204,102,102,124854.25,123640.37,248494.62
355400,202211,1889,1061,828,1286002.34,1003574.36,2289576.70
355410,202211,5488,2451,3037,2970970.93,3682246.95,6653217.88
355420,202211,47,33,14,39999.86,16970.81,56970.67
355430,202211,447,264,183,320007.89,221826.81,541834.70
355440,202211,91,51,40,61816.2,48483.82,110300.02
355450,202211,469,239,230,289694.59,279997.81,569692.40
355460,202211,58,43,15,52122.38,18181.01,70303.39
355465,202211,52,29,23,35150.62,27876.16,63026.78
355470,202211,198,76,122,92122.49,147876.41,239998.90
355475,202211,7,4,3,4848.57,3636,8484.57
355480,202211,663,266,397,322436.28,481212.22,803648.50
355490,202211,111,79,32,95766.89,38792.89,134559.78
355495,202211,99,40,59,48480.85,71510.26,119991.11
355500,202211,1652,881,771,1070297.68,936948.23,2007245.91
355510,202211,279,194,85,235166.56,103031.7,338198.26
355520,202211,27,19,8,23031.38,9696.32,32727.70
355530,202211,24,13,11,15756.09,13332,29088.09
355535,202211,82,39,43,47275.48,52123.31,99398.79
355540,202211,2995,1175,1820,1425044.63,2208620.68,3633665.31
355550,202211,68,39,29,47270.39,35153.08,82423.47
355560,202211,262,119,143,144246.93,173337.9,317584.83
355570,202211,17,11,6,13334.17,7272,20606.17
355580,202211,242,161,81,196377.95,98183.38,294561.33
355590,202211,17,11,6,13334.17,7273.21,20607.38
355600,202211,285,137,148,166075.56,179392.26,345467.82
355610,202211,248,148,100,179404.03,121216.58,300620.61
355620,202211,1372,582,790,705477.45,957539.34,1663016.79
355630,202211,432,306,126,370917.82,152728.29,523646.11
355635,202211,131,54,77,65454.24,93331.18,158785.42
355640,202211,614,328,286,397574.17,346669,744243.17
355645,202211,930,334,596,404867.78,722435.26,1127303.04
355650,202211,1939,838,1101,1015828.8,1340549.79,2356378.59
355660,202211,228,116,112,140604.58,135762.59,276367.17
355670,202211,694,295,399,357561.66,483620.55,841182.21
355680,202211,216,116,100,140615.84,121215.16,261831.00
355690,202211,97,48,49,58184.45,59398.84,117583.29
355695,202211,26,16,10,19392.72,12120,31512.72
355700,202211,1293,623,670,755170.13,812079.55,1567249.68
355710,202211,2408,1323,1085,1606085.51,1315093.49,2921179.00
355715,202211,17,13,4,15757.97,4849.4,20607.37
355720,202211,266,162,104,196364.92,126060.17,322425.09
355730,202211,113,67,46,81212.42,55760.52,136972.94
410010,202211,113,89,24,107888.9,29091.39,136980.29
410020,202211,123,85,38,103049.22,46061.94,149111.16
410030,202211,189,104,85,126066.51,103034.9,229101.41
410040,202211,1448,688,760,833920.7,924828.79,1758749.49
410045,202211,46,33,13,40000.75,15756.93,55757.68
410050,202211,542,315,227,381811.4,275148.82,656960.22
410060,202211,223,162,61,196366.49,73936.44,270302.93
410070,202211,299,248,51,300606.89,61817.3,362424.19
410080,202211,187,113,74,136968.73,89692.85,226661.58
410090,202211,56,46,10,55757.93,12122.32,67880.25
410100,202211,267,169,98,204839.88,118780.54,323620.42
410105,202211,46,28,18,33936.99,21816.87,55753.86
410110,202211,367,220,147,266662.99,178183.87,444846.86
410115,202211,49,29,20,35148.65,24241.27,59389.92
410120,202211,481,222,259,269093.73,313935.96,583029.69
410130,202211,68,39,29,47275.33,35150.05,82425.38
410140,202211,3378,1518,1860,1839985.64,2256962.48,4096948.12
410150,202211,2756,1103,1653,1336953.35,2006044.51,3342997.86
410160,202211,513,291,222,352727.02,269081.33,621808.35
410165,202211,55,34,21,41209.33,25453.78,66663.11
410170,202211,220,127,93,153932.42,112721.38,266653.80
410180,202211,2462,1290,1172,1563684.59,1423031.81,2986716.40
410185,202211,38,31,7,37575.63,8484,46059.63
410190,202211,505,325,180,395137.03,218174.44,613311.47
410200,202211,1085,761,324,923986.37,392714,1316700.37
410210,202211,665,344,321,416964.37,389087.4,806051.77
410220,202211,49,21,28,25453.18,33936,59389.18
410230,202211,201,89,112,107877.07,135751.16,243628.23
410240,202211,739,474,265,574576.05,321212.76,895788.81
410250,202211,394,265,129,321215.11,156360.53,477575.64
410260,202211,308,173,135,209713.81,163649.19,373363.00
410270,202211,29,20,9,24240.99,10908,35148.99
410275,202211,64,46,18,55756.34,21816.6,77572.94
410280,202211,331,196,135,237572.69,163633.99,401206.68
410290,202211,271,150,121,181811.98,147874.03,329686.01
410300,202211,87,53,34,64245.3,41210.97,105456.27
410302,202211,28,15,13,18180.51,15756,33936.51
410304,202211,45,31,14,37575.92,16968.8,54544.72
410305,202211,214,126,88,152720.16,106658.67,259378.83
410310,202211,187,109,78,132120.89,94542.82,226663.71
410315,202211,41,32,9,38787.94,10908.94,49696.88
410320,202211,144,99,45,119993.58,54543.04,174536.62
410322,202211,39,24,15,29089.64,18180.26,47269.90
410330,202211,177,112,65,135772.01,78791.49,214563.50
410335,202211,102,55,47,66660.74,56964.54,123625.28
410337,202211,47,38,9,46057.32,10908.2,56965.52
410340,202211,39,32,7,38786.65,8484.46,47271.11
410345,202211,201,122,79,147878.14,96965.66,244843.80
410347,202211,44,32,12,38789.48,14544.85,53334.33
410350,202211,256,149,107,180603.62,129688.46,310292.08
410360,202211,462,282,180,341822.71,219387.25,561209.96
410370,202211,2431,1042,1389,1264249.69,1686088.85,2950338.54
410380,202211,201,113,88,136976.56,106668.79,243645.35
410390,202211,417,264,153,321208.4,185441.27,506649.67
410395,202211,33,20,13,24244.7,15761.71,40006.41
410400,202211,964,399,565,483643.69,684869.5,1168513.19
410405,202211,77,56,21,67883.93,25456.39,93340.32
410410,202211,27,16,11,19396.01,13334.33,32730.34
410420,202211,1873,829,1044,1005964.87,1265462.37,2271427.24
410425,202211,204,83,121,100613.21,147883.39,248496.60
410430,202211,2523,1296,1227,1573327.55,1488474.95,3061802.50
410440,202211,364,254,110,307885.13,133333.81,441218.94
410442,202211,364,227,137,275152.64,166055.19,441207.83
410445,202211,359,248,111,300602.96,134540.45,435143.41
410450,202211,396,185,211,224239.02,255748.19,479987.21
410460,202211,587,310,277,375740.07,336955.53,712695.60
410465,202211,281,154,127,186659.21,153935.57,340594.78
410470,202211,244,139,105,168490.94,127265.28,295756.22
410480,202211,6970,3342,3628,4050929.6,4401297.79,8452227.39
410490,202211,1473,810,663,981863.4,807289.74,1789153.14
410500,202211,282,164,118,198785.44,143023.58,341809.02
410510,202211,201,150,51,183028.6,61822.61,244851.21
410520,202211,283,198,85,240001.39,103029.88,343031.27
410530,202211,287,88,199,106661.81,241194.5,347856.31
410540,202211,370,268,102,324834.54,123630.68,448465.22
410550,202211,1763,730,1033,884847.58,1253332.68,2138180.26
410560,202211,184,119,65,144241.25,78782.48,223023.73
410570,202211,445,289,156,350287.1,189081.87,539368.97
410580,202211,4008,1654,2354,2004901.3,2857035.72,4861937.02
410590,202211,445,288,157,349064.56,190297.41,539361.97
410600,202211,102,88,14,106664.08,16969.12,123633.20
410610,202211,59,47,12,56966.54,14544,71510.54
410620,202211,290,182,108,220612.72,130906.59,351519.31
410630,202211,472,262,210,317557.56,254534.98,572092.54
410640,202211,1187,733,454,888460.48,551492.83,1439953.31
410645,202211,117,87,30,105460.48,36366.09,141826.57
410650,202211,385,235,150,284845.55,183024.32,467869.87
410655,202211,90,66,24,79995.15,29089.82,109084.97
410657,202211,36,14,22,16969.49,26664.74,43634.23
410660,202211,688,469,219,568471.85,265443.93,833915.78
410670,202211,80,65,15,78793.44,18181.87,96975.31
410680,202211,196,154,42,186674.34,50911.08,237585.42
410685,202211,35,24,11,29090,13332.41,42422.41
410690,202211,30445,12431,18014,15078548.52,21859638.33,36938186.85
410700,202211,339,241,98,292389.93,118786.4,411176.33
410710,202211,126,105,21,127269.11,26666.86,153935.97
410712,202211,42,30,12,36361.33,14544.97,50906.30
410715,202211,110,79,31,95755.99,37574.07,133330.06
410720,202211,667,365,302,442412.74,366041.83,808454.57
410725,202211,199,137,62,166057.76,75145.65,241203.41
410730,202211,107,44,63,53332.37,76362.12,129694.49
410740,202211,86,64,22,77571.61,26666.12,104237.73
410750,202211,297,191,106,231510.01,128480.02,359990.03
410752,202211,20,14,6,16970.41,7272,24242.41
410753,202211,63,22,41,26667.69,49696.38,76364.07
410754,202211,57,28,29,33941.33,35148.31,69089.64
410755,202211,79,40,39,48484.02,47269.27,95753.29
410760,202211,798,430,368,521208.47,448674.63,969883.10
410765,202211,2039,919,1120,1113982.86,1357648.48,2471631.34
410770,202211,122,82,40,99392.31,48484.91,147877.22
410773,202211,69,46,23,55755.54,27876.94,83632.48
410775,202211,195,140,55,169705.14,66666.69,236371.83
410780,202211,83,45,38,54543.77,47269.63,101813.40
410785,202211,55,46,9,55754.54,10909.07,66663.61
410790,202211,88,37,51,44847.44,61814.69,106662.13
410800,202211,298,186,112,225464.07,136970.94,362435.01
410810,202211,29,17,12,20604.71,14544.62,35149.33
410820,202211,154,109,45,132124.96,54548.4,186673.36
410830,202211,9778,3958,5820,4798872.14,7058356.37,11857228.51
410832,202211,116,73,43,89694.88,52121.73,141816.61
410840,202211,1484,798,686,967261.72,832702.9,1799964.62
410845,202211,58,30,28,36362.02,33938.25,70300.27
410850,202211,155,110,45,133345.3,54545.5,187890.8
410855,202211,81,73,8,88486.77,9697.34,98184.11
410860,202211,882,432,450,523617.46,545422.51,1069039.97
410865,202211,95,67,28,81219.74,33939.1,115158.84
410870,202211,147,119,28,144250.77,33939.5,178190.27
410880,202211,1227,591,636,716367.56,770922.38,1487289.94
410890,202211,112,69,43,83631.25,52116.14,135747.39
410895,202211,80,60,20,72727.98,24244.21,96972.19
410900,202211,30,24,6,29091.14,7272,36363.14
410910,202211,12,7,5,8485.35,6060.17,14545.52
410920,202211,46,28,18,33940.41,21818.01,55758.42
410930,202211,573,343,230,415747.26,278775.06,694522.32
410940,202211,4647,2345,2302,2844958.54,2792743.47,5637702.01
410950,202211,105,78,27,94549.84,32731.43,127281.27
410960,202211,996,377,619,456981.73,750307.33,1207289.06
410965,202211,67,45,22,54543.66,26666.91,81210.57
410970,202211,619,408,211,494555.75,258181.63,752737.38
410975,202211,126,78,48,94542.16,58182.1,152724.26
410980,202211,1673,754,919,913931.39,1115161.57,2029092.96
410990,202211,283,204,79,247264.21,95757.5,343021.71
411000,202211,63,34,29,41211.79,35153.54,76365.33
411005,202211,38,31,7,37573.63,8484.44,46058.07
411007,202211,256,148,108,179381.12,130898.39,310279.51
411010,202211,622,392,230,475156.96,278779.48,753936.44
411020,202211,286,175,111,212127,134547.22,346674.22
411030,202211,25,13,12,15757.97,14544.74,30302.71
411040,202211,65,41,24,49693.93,29090.09,78784.02
411050,202211,222,152,70,184255.75,84849.85,269105.60
411060,202211,556,376,180,455749.76,218177.07,673926.83
411065,202211,37,33,4,39997.68,4848.6,44846.28
411070,202211,1319,739,580,895751.37,703012.99,1598764.36
411080,202211,259,171,88,207268.8,107871,315139.8
411090,202211,88,64,24,77579.38,29089.3,106668.68
411095,202211,361,116,245,140605.16,298181.14,438786.30
411100,202211,116,87,29,105456.76,35148.59,140605.35
411110,202211,145,80,65,96968.63,78784.89,175753.52
411120,202211,214,136,78,164846.77,94541.89,259388.66
411125,202211,351,169,182,204841.36,220612.39,425453.75
411130,202211,121,102,19,123631.86,23028,146659.86
411140,202211,210,143,67,173320.5,81204.57,254525.07
411150,202211,1289,819,470,993911.78,569665.5,1563577.28
411155,202211,123,84,39,101809.4,47268.88,149078.28
411160,202211,35,14,21,16968.05,25452.34,42420.39
411170,202211,58,49,9,59390.18,10908.93,70299.11
411180,202211,1065,690,375,836365.96,454538.94,1290904.90
411190,202211,352,196,156,237572.57,189084.91,426657.48
411200,202211,693,375,318,454564.2,385443.05,840007.25
411210,202211,695,351,344,425439.95,416950.82,842390.77
411220,202211,169,116,53,140612.91,64243.15,204856.06
411230,202211,35,29,6,35149.53,7272.68,42422.21
411240,202211,111,71,40,86064.32,48486.41,134550.73
411250,202211,437,308,129,373315.3,156355.34,529670.64
411260,202211,13,9,4,10909.29,4849.24,15758.53
411270,202211,270,141,129,170919.08,156371.2,327290.28
411275,202211,195,164,31,198790.52,37574.23,236364.75
411280,202211,276,182,94,220602.83,115145.29,335748.12
411290,202211,67,52,15,63026.78,18181.6,81208.38
411295,202211,128,97,31,117585.2,37575.86,155161.06
411300,202211,84,40,44,48481.84,53330,101811.84
411310,202211,95,67,28,81210.88,33936.8,115147.68
411320,202211,866,525,341,636366.81,413319.15,1049685.96
411325,202211,65,45,20,54543.46,24240.84,78784.30
411330,202211,968,614,354,744234.51,429074.58,1173309.09
411340,202211,35,22,13,26666.08,15756.5,42422.58
411342,202211,63,48,15,58181.9,18182.86,76364.76
411345,202211,104,52,52,63032.71,63030.98,126063.69
411350,202211,536,399,137,484850.09,167271.42,652121.51
411360,202211,61,39,22,47277.32,26668.67,73945.99
411370,202211,14193,5765,8428,6991571.5,10225523.84,17217095.34
411373,202211,188,126,62,152724.32,75150.79,227875.11
411375,202211,80,65,15,78789.06,18180.55,96969.61
411380,202211,79,53,26,64250.74,31518.8,95769.54
411390,202211,156,83,73,100605.96,88480.58,189086.54
411400,202211,366,237,129,287280.11,156355.03,443635.14
411410,202211,541,252,289,305452.2,350291.17,655743.37
411420,202211,1003,411,592,499391.19,717584.05,1216975.24
411430,202211,559,292,267,353972.09,323652.98,677625.07
411435,202211,29,20,9,24242.9,10909.86,35152.76
411440,202211,497,393,104,476346.19,126056.3,602402.49
411450,202211,403,326,77,395140.72,93328.26,488468.98
411460,202211,851,324,527,393939.86,638787.62,1032727.48
411470,202211,116,80,36,96967.55,43632.91,140600.46
411480,202211,746,378,368,458192.58,446053.71,904246.29
411490,202211,290,180,110,218185.72,133337.17,351522.89
411500,202211,107,84,23,101816.41,27876.84,129693.25
411510,202211,231,176,55,213323.3,66663.07,279986.37
411520,202211,6569,2197,4372,2664236.06,5302992.04,7967228.10
411530,202211,127,81,46,98175.5,55752.46,153927.96
411535,202211,48,14,34,16971.48,41213.22,58184.70
411540,202211,390,256,134,310286.07,163623.99,473910.06
411545,202211,57,42,15,50905.11,18180,69085.11
411550,202211,89,69,20,83630.85,24242.26,107873.11
411560,202211,399,168,231,203628.3,281193.12,484821.42
411570,202211,1061,351,710,425461.9,860597.67,1286059.57
411573,202211,28,15,13,18183.61,15758.2,33941.81
411575,202211,321,197,124,238780.36,150292.06,389072.42
411580,202211,1305,454,851,550299.2,1031501.03,1581800.23
411585,202211,74,35,39,42425.37,47271.71,89697.08
411590,202211,15,8,7,9696.61,8485.99,18182.60
411600,202211,17,7,10,8486.75,12123.58,20610.33
411605,202211,177,70,107,84852.06,129703.21,214555.27
411610,202211,242,146,96,176973.13,116363.1,293336.23
411620,202211,395,188,207,227884.81,252107.56,479992.37
411630,202211,52,36,16,43633.96,19392.46,63026.42
411640,202211,31,20,11,24240.92,13332,37572.92
411650,202211,7,4,3,4848.67,3636.96,8485.63
411660,202211,45,33,12,39996.22,14544.93,54541.15
411670,202211,241,164,77,198787.91,93335.65,292123.56
411680,202211,160,126,34,152725.76,41209.22,193934.98
411690,202211,723,379,344,460594.33,416948.67,877543.00
411695,202211,64,43,21,52119.73,25452.17,77571.90
411700,202211,147,116,31,140607.91,37576.94,178184.85
411705,202211,99,65,34,78791.63,41214.61,120006.24
411710,202211,295,198,97,239989.56,117572.45,357562.01
411720,202211,155,102,53,123631.62,64240.07,187871.69
411721,202211,90,69,21,83631.6,25452.53,109084.13
411722,202211,104,49,55,59392.16,66669.16,126061.32
411725,202211,167,117,50,141810.14,60601.19,202411.33
411727,202211,104,81,23,98177.55,27877.61,126055.16
411729,202211,52,40,12,48482.73,14545.18,63027.91
411730,202211,584,368,216,446059.9,261813.63,707873.53
411740,202211,27,15,12,18181.2,14544.72,32725.92
411745,202211,71,52,19,63024.86,23029.6,86054.46
411750,202211,881,353,528,427878.63,641205.07,1069083.70
411760,202211,1306,930,376,1128481.71,455759.11,1584240.82
411770,202211,435,277,158,335768.01,191524.97,527292.98
411780,202211,377,243,134,294538.69,162419.9,456958.59
411790,202211,612,340,272,412114.87,329691.03,741805.90
411800,202211,169,121,48,146676.38,58179.95,204856.33
411810,202211,186,140,46,169694.39,55757.48,225451.87
411820,202211,2694,1066,1628,1292167.04,1974546.82,3266713.86
411830,202211,16,13,3,15756.34,3636,19392.34
411840,202211,2292,1328,964,1613308.04,1169679.61,2782987.65
411845,202211,67,21,46,25453.24,55754.72,81207.96
411850,202211,1302,688,614,836355.42,744250.62,1580606.04
411860,202211,60,37,23,44849.8,27878.17,72727.97
411870,202211,73,44,29,53330.06,35148.54,88478.60
411880,202211,423,248,175,300604.01,212111.87,512715.88
411885,202211,109,68,41,82420.37,49697.54,132117.91
411890,202211,344,242,102,293327.49,123635.62,416963.11
411900,202211,114,82,32,99395.82,38786.42,138182.24
411910,202211,221,147,74,178188.49,89692.43,267880.92
411915,202211,2542,978,1564,1185466.93,1897006.07,3082473.00
411920,202211,116,86,30,104250.44,36363.95,140614.39
411925,202211,17,10,7,12121.24,8484.8,20606.04
411930,202211,820,548,272,664362.57,329709.62,994072.19
411940,202211,615,386,229,467900.45,278777.12,746677.57
411950,202211,1283,575,708,699415.88,859425.73,1558841.61
411960,202211,1184,729,455,883598.56,551479.31,1435077.87
411965,202211,24,14,10,16970.61,12120.67,29091.28
411970,202211,94,80,14,96968.01,16968.44,113936.45
411980,202211,230,118,112,143034.32,135752.57,278786.89
411990,202211,5535,2922,2613,3542688.94,3169829.3,6712518.24
411995,202211,656,192,464,232733.87,562420.32,795154.19
412000,202211,338,224,114,271514.01,138184.48,409698.49
412010,202211,66,33,33,40001.03,40001.67,80002.70
412015,202211,37,30,7,36366.99,8485.04,44852.03
412020,202211,25,20,5,24245.67,6061.47,30307.14
412030,202211,39,34,5,42427.96,6060,48487.96
412033,202211,51,29,22,35150.69,26665.17,61815.86
412035,202211,69,44,25,53331.52,30301.41,83632.93
412040,202211,32,15,17,18180.7,20605.18,38785.88
412050,202211,217,157,60,190303.28,72722.67,263025.95
412060,202211,813,581,232,704284.39,281208.61,985493.00
412065,202211,58,29,29,36362.3,35150.56,71512.86
412070,202211,147,103,44,124846.85,53334.77,178181.62
412080,202211,367,178,189,215752.11,229091.21,444843.32
412085,202211,39,14,25,16968.97,30301.8,47270.77
412090,202211,885,536,349,649680.12,423017.37,1072697.49
412100,202211,264,220,44,266674.08,53333.49,320007.57
412110,202211,77,57,20,69087.84,24242.5,93330.34
412120,202211,370,195,175,236369.38,212116.06,448485.44
412125,202211,73,41,32,49692.45,38785.68,88478.13
412130,202211,51,32,19,38788.28,23028,61816.28
412135,202211,29,18,11,21817.97,13333.46,35151.43
412140,202211,455,290,165,351495.75,199987.74,551483.49
412150,202211,255,155,100,187882.07,121208.15,309090.22
412160,202211,77,49,28,59393.95,33936.78,93330.73
412170,202211,727,468,259,567291.69,313929.55,881221.24
412175,202211,41,26,15,31515.14,18181.59,49696.73
412180,202211,163,122,41,147872.98,49695.76,197568.74
412190,202211,334,262,72,317589.32,87269.29,404858.61
412200,202211,192,113,79,136962.7,95751.68,232714.38
412210,202211,96,72,24,87269.3,29090.54,116359.84
412215,202211,244,165,79,199999.51,95756.43,295755.94
412217,202211,64,48,16,58178.51,19393.58,77572.09
412220,202211,874,566,308,686111.01,373342.52,1059453.53
412230,202211,284,170,114,206065.12,138194.45,344259.57
412240,202211,1423,703,720,852131.35,872749.63,1724880.98
412250,202211,418,253,165,306668.64,199998.44,506667.08
412260,202211,130,85,45,103030,54541.85,157571.85
412265,202211,167,127,40,153932.51,48481.11,202413.62
412270,202211,95,58,37,70304.86,44846.81,115151.67
412280,202211,82,63,19,76356.9,23028.34,99385.24
412290,202211,91,56,35,67879.18,42421.28,110300.46
412300,202211,209,148,61,179387.24,73936.15,253323.39
412310,202211,57,44,13,53335.73,15756.28,69092.01
412320,202211,90,67,23,81222.26,27879.23,109101.49
412330,202211,203,156,47,189090.84,56966.72,246057.56
412340,202211,179,117,62,141813.59,75147,216960.59
412350,202211,694,312,382,378164.58,463011.49,841176.07
412360,202211,22,17,5,20605.01,6060,26665.01
412370,202211,143,118,25,143035.06,30300.81,173335.87
412380,202211,192,143,49,173341.58,59394.3,232735.88
412382,202211,60,32,28,38785.68,33938.41,72724.09
412385,202211,164,115,49,139390.51,59392.86,198783.37
412390,202211,330,250,80,303026.6,96967.78,399994.38
412395,202211,67,55,12,66661.71,14544.68,81206.39
412400,202211,103,70,33,84847.61,39997.44,124845.05
412402,202211,243,131,112,158780.3,135759.02,294539.32
412405,202211,998,327,671,396344.01,814496.52,1210840.53
412410,202211,1033,605,428,732772.31,518780.01,1251552.32
412420,202211,16,15,1,18180.42,1212,19392.42
412430,202211,27,25,2,30304.6,2424.88,32729.48
412440,202211,688,343,345,415748.53,418158.88,833907.41
412450,202211,67,59,8,71514.81,9696.8,81211.61
412460,202211,77,54,23,65454.72,27877.67,93332.39
412470,202211,232,180,52,218183.96,63029.2,281213.16
412480,202211,158,114,44,138178.51,53331.29,191509.80
412490,202211,171,144,27,175749.09,32724.88,208473.97
412500,202211,407,316,91,383043.68,110298.61,493342.29
412510,202211,173,144,29,174561,36367.79,210928.79
412520,202211,93,62,31,75152.93,37574.48,112727.41
412530,202211,105,49,56,59392.91,69085.43,128478.34
412535,202211,68,53,15,64243.39,18181.48,82424.87
412540,202211,47,26,21,31513.84,25454.57,56968.41
412545,202211,86,58,28,70306.22,33937.37,104243.59
412550,202211,4358,1760,2598,2134591.51,3152826.39,5287417.90
412555,202211,11,7,4,8484.4,4848,13332.4
412560,202211,707,460,247,557580.27,299383.34,856963.61
412570,202211,865,388,477,470301.57,578157.93,1048459.50
412575,202211,97,69,28,83637.67,33939.43,117577.10
412580,202211,180,119,61,144256.6,73941.72,218198.32
412590,202211,34,30,4,36364.33,4848.37,41212.70
412600,202211,206,145,61,175750.92,73936.68,249687.60
412610,202211,40,18,22,23028.36,26664.57,49692.93
412620,202211,127,105,22,127280.56,26668.85,153949.41
412625,202211,2205,1048,1157,1271532.54,1406042.64,2677575.18
412627,202211,66,49,17,59395.52,20605.89,80001.41
412630,202211,381,258,123,312757.47,149099.07,461856.54
412635,202211,81,24,57,29089.62,69085.12,98174.74
412640,202211,110,78,32,94547.16,38787.02,133334.18
412650,202211,325,211,114,255760.13,138176.71,393936.84
412660,202211,591,315,276,381813.81,334533.32,716347.13
412665,202211,43,39,4,47270.15,4848,52118.15
412667,202211,280,176,104,213340.49,126057.57,339398.06
412670,202211,80,60,20,72724.23,24240.5,96964.73
412680,202211,338,255,83,309098.95,100607.38,409706.33
412690,202211,133,84,49,101817.16,59391.12,161208.28
412700,202211,194,122,72,147869.81,87266.04,235135.85
412710,202211,1400,774,626,938215.14,758779.98,1696995.12
412720,202211,237,132,105,160000.83,127271.39,287272.22
412730,202211,212,180,32,218739.61,38786.07,257525.68
412740,202211,418,203,215,247276.05,261819.34,509095.39
412750,202211,422,233,189,283649.4,229084.43,512733.83
412760,202211,373,188,185,227885.35,225458.82,453344.17
412770,202211,2181,1161,1020,1407263.96,1238774.34,2646038.30
412780,202211,147,103,44,124855.98,53334.01,178189.99
412785,202211,327,168,159,203628.93,192718.25,396347.18
412788,202211,51,29,22,35153.86,26666.82,61820.68
412790,202211,126,102,24,123642.21,29092.26,152734.47
412795,202211,148,99,49,120002.58,59399.95,179402.53
412796,202211,307,193,114,233924.18,138171.11,372095.29
412800,202211,722,409,313,495745.34,379376.76,875122.10
412810,202211,3228,1756,1472,2130885.54,1784217.51,3915103.05
412820,202211,1055,608,447,736993.95,541822.78,1278816.73
412830,202211,14,13,1,15757.29,1212,16969.29
412840,202211,284,189,95,229083.38,115144.22,344227.60
412850,202211,597,393,204,476375.14,247265.97,723641.11
412853,202211,174,79,95,95755.3,115144.05,210899.35
412855,202211,204,108,96,130911.91,116363.32,247275.23
412860,202211,100,67,33,81221.68,40000.02,121221.70
412862,202211,84,53,31,64239.73,38784.78,103024.51
412863,202211,8,5,3,6060.63,3636.96,9697.59
412865,202211,46,35,11,42423.74,13333.15,55756.89
412870,202211,117,73,44,88483.3,53333.77,141817.07
412880,202211,97,65,32,78791.16,38786.4,117577.56
420005,202211,42,35,7,42422.77,8484,50906.77
420010,202211,378,245,133,296959.84,161203.21,458163.05
420020,202211,100,74,26,89695.06,31512.67,121207.73
420030,202211,28,23,5,27879.87,6060,33939.87
420040,202211,96,74,22,89701.73,26667.91,116369.64
420050,202211,54,34,20,41212.25,24242.47,65454.72
420055,202211,17,15,2,18184.8,2424,20608.8
420060,202211,28,20,8,24246.28,9698.32,33944.60
420070,202211,104,89,15,107881.33,18182.08,126063.41
420075,202211,10,10,0,12120,,12120.0
420080,202211,40,34,6,41213.84,7272.54,48486.38
420090,202211,39,31,8,37575.91,9697.28,47273.19
420100,202211,164,140,24,169705.46,29091.02,198796.48
420110,202211,22,21,1,25454.72,1212,26666.72
420120,202211,62,44,18,53335.86,21819.38,75155.24
420125,202211,87,65,22,78785.35,26664.94,105450.29
420127,202211,37,32,5,38784.78,6060,44844.78
420130,202211,504,306,198,370905.08,239996.99,610902.07
420140,202211,1411,786,625,952741.91,757604.8,1710346.71
420150,202211,49,36,13,43636.82,15756.74,59393.56
420160,202211,32,28,4,33940.5,4848.84,38789.34
420165,202211,17,12,5,14546.01,6060.42,20606.43
420170,202211,72,43,29,52120.26,35148.55,87268.81
420180,202211,24,21,3,25453.04,3636.8,29089.84
420190,202211,27,23,4,27882.08,4848.47,32730.55
420195,202211,135,60,75,72736.41,90916.66,163653.07
420200,202211,1414,587,827,711528.55,1003653.16,1715181.71
420205,202211,124,73,51,88486.27,61816.87,150303.14
420207,202211,149,84,65,101822.84,78791.82,180614.66
420208,202211,19,15,4,18180.72,4848.4,23029.12
420209,202211,13,11,2,13333.3,2424.07,15757.37
420210,202211,613,291,322,352718.22,390289.64,743007.86
420213,202211,59,41,18,49695.48,21816.8,71512.28
420215,202211,27,23,4,27879.65,4848.69,32728.34
420220,202211,62,41,21,49698.58,27879.8,77578.38
420230,202211,1029,613,416,743461.88,504266.29,1247728.17
420240,202211,2390,1572,818,1906617.4,992689.6,2899307.0
420243,202211,46,36,10,43635.76,12121.48,55757.24
420245,202211,223,109,114,132119.48,138182.74,270302.22
420250,202211,60,42,18,50912.28,21820.25,72732.53
420253,202211,25,18,7,21818.87,8485.44,30304.31
420257,202211,14,9,5,10908.87,6060.4,16969.27
420260,202211,126,101,25,122421.78,30303.61,152725.39
420270,202211,33,25,8,30302.36,9696.5,39998.86
420280,202211,295,220,75,266687.6,90912.39,357599.99
420285,202211,24,19,5,23030.13,6060.87,29091.00
420287,202211,45,29,16,35153.11,19394.64,54547.75
420290,202211,977,661,316,801183.6,383016.88,1184200.48
420300,202211,1665,1328,337,1609718.17,408483.23,2018201.40
420310,202211,43,31,12,37574.51,14544.61,52119.12
420315,202211,28,23,5,27882.17,6061.62,33943.79
420320,202211,1063,505,558,612139.62,677580,1289719.62
420325,202211,8,6,2,7272,2424.2,9696.2
420330,202211,119,79,40,95764.46,48486.98,144251.44
420340,202211,199,136,63,164851.88,76361.41,241213.29
420350,202211,266,189,77,229094.94,93331.47,322426.41
420360,202211,707,544,163,659415.75,197577.9,856993.65
420370,202211,145,78,67,94544.63,81210.6,175755.23
420380,202211,1248,844,404,1024258.5,489708.46,1513966.96
420390,202211,234,164,70,198788.44,84846.17,283634.61
420395,202211,190,138,52,167278.57,63034.24,230312.81
420400,202211,233,178,55,215753.08,66664.43,282417.51
420410,202211,53,39,14,47276.15,16968.88,64245.03
420415,202211,35,29,6,35149.17,7272.86,42422.03
420417,202211,55,43,12,52122.4,14546.65,66669.05
420419,202211,11,10,1,12121.77,1212,13333.77
420420,202211,2980,1839,1141,2230301.08,1384231.25,3614532.33
420425,202211,72,51,21,61820.05,25454.39,87274.44
420430,202211,1050,756,294,916329.41,357554.27,1273883.68
420435,202211,14,11,3,13336.11,3636.11,16972.22
420440,202211,92,64,28,77577.73,33939.23,111516.96
420445,202211,29,27,2,32728.37,2424,35152.37
420450,202211,84,47,37,56967.49,44847.37,101814.86
420455,202211,186,145,41,175761.25,49697.71,225458.96
420460,202211,2427,1500,927,1818189.33,1127275.87,2945465.20
420470,202211,87,56,31,67880.4,37574.33,105454.73
420475,202211,10,9,1,10908,1212,12120
420480,202211,900,687,213,832711.26,258175.83,1090887.09
420490,202211,103,78,25,94549.53,30301.99,124851.52
420500,202211,400,236,164,287275.62,198785.78,486061.40
420510,202211,25,21,4,25454.24,4848,30302.24
420515,202211,26,14,12,16970.22,14544.54,31514.76
420517,202211,9,7,2,8485.69,2424,10909.69
420519,202211,1,1,0,1212.6,,1212.6
420520,202211,57,43,14,52128.6,16973.02,69101.62
420530,202211,138,88,50,106660.42,60602.04,167262.46
420535,202211,16,13,3,15756.41,3636,19392.41
420540,202211,6768,4196,2572,5092493.76,3118821.37,8211315.13
420543,202211,32,30,2,36364.1,2424.99,38789.09
420545,202211,218,150,68,183033.88,82421.44,265455.32
420550,202211,792,662,130,802428.57,157577.5,960006.07
420555,202211,31,23,8,27880.48,9697.4,37577.88
420560,202211,65,50,15,60605.8,18181.46,78787.26
420570,202211,227,103,124,124857.32,150302.84,275160.16
420580,202211,317,156,161,189092.91,195159.69,384252.60
420590,202211,494,313,181,380589.12,219381.01,599970.13
420600,202211,155,83,72,100604.31,87270.45,187874.76
420610,202211,35,32,3,38789.35,3636.05,42425.40
420620,202211,83,62,21,75154.53,25455.52,100610.05
420630,202211,156,103,53,124848.22,64242.21,189090.43
420640,202211,70,60,10,72723.76,12120.61,84844.37
420650,202211,314,161,153,195148.14,185458.42,380606.56
420660,202211,40,30,10,36361.86,12122.1,48483.96
420665,202211,45,29,16,35150.84,19392.99,54543.83
420670,202211,239,182,57,220621.4,69093.78,289715.18
420675,202211,14,12,2,14544,2424,16968
420680,202211,33,28,5,33938.93,6061.31,40000.24
420690,202211,204,154,50,186663.87,60604.1,247267.97
420700,202211,733,474,259,574557.16,313942.76,888499.92
420710,202211,143,78,65,94544.86,78788.19,173333.05
420720,202211,95,77,18,93336.33,21817.28,115153.61
420730,202211,729,434,295,526076.54,357584.12,883660.66
420740,202211,57,56,1,67876.7,1212,69088.7
420750,202211,510,336,174,407262.14,210902.17,618164.31
420757,202211,20,17,3,20604,3636,24240
420760,202211,40,29,11,35152.84,13332.88,48485.72
420765,202211,77,53,24,64239.96,29088.78,93328.74
420768,202211,58,48,10,58183.51,12120.47,70303.98
420770,202211,69,59,10,71515.32,12120.11,83635.43
420775,202211,34,30,4,36361.39,4848,41209.39
420780,202211,199,157,42,190311.82,50908.65,241220.47
420785,202211,24,16,8,19393.95,9696.44,29090.39
420790,202211,139,114,25,138183.7,30304.54,168488.24
420800,202211,64,49,15,59393.35,18180.34,77573.69
420810,202211,285,218,67,264255.28,81209,345464.28
420820,202211,2673,1466,1207,1778160.53,1463025.04,3241185.57
420830,202211,732,390,342,473952.56,416977.1,890929.66
420840,202211,129,89,40,109088.02,48481.26,157569.28
420845,202211,448,193,255,233941.2,309093.66,543034.86
420850,202211,273,211,62,255746.65,75147.99,330894.64
420860,202211,58,49,9,59396.81,10908.14,70304.95
420870,202211,131,91,40,110301.46,48484.42,158785.88
420880,202211,196,124,72,150306.92,87269.61,237576.53
420890,202211,1007,485,522,587874.76,632700.82,1220575.58
420895,202211,8,8,0,9697.3,,9697.3
420900,202211,424,344,80,416972.09,98176.97,515149.06
420910,202211,6119,3312,2807,4018211.35,3407245.35,7425456.70
420915,202211,58,52,6,63035.47,7272,70307.47
420917,202211,21,16,5,19394.02,6060.78,25454.80
420920,202211,22,15,7,18182.58,8484.61,26667.19
420930,202211,3483,2307,1176,2796290.48,1426709.83,4223000.31
420940,202211,590,409,181,495802.45,219413.77,715216.22
420945,202211,10,8,2,9697.06,2424,12121.06
420950,202211,47,32,15,38787.37,18181.32,56968.69
420960,202211,113,92,21,111515.32,25455.89,136971.21
420970,202211,284,229,55,277601.54,66671.01,344272.55
420980,202211,24,23,1,27878.5,1212,29090.5
420985,202211,53,45,8,54544.98,9696.32,64241.30
420990,202211,88,66,22,80000.13,26669.28,106669.41
421000,202211,62,32,30,38785.45,36361.38,75146.83
421003,202211,36,26,10,31519.49,12122.12,43641.61
421005,202211,8,6,2,7273.28,2424.67,9697.95
421010,202211,890,574,316,695774.71,384248.35,1080023.06
421020,202211,20,17,3,20608.9,3636.69,24245.59
421030,202211,116,96,20,116375.16,24243.26,140618.42
421040,202211,67,46,21,55760.38,25457.57,81217.95
421050,202211,328,229,99,277558.19,119992.15,397550.34
421055,202211,17,13,4,15757.97,4848.44,20606.41
421060,202211,107,62,45,75148.8,54541.61,129690.41
421070,202211,39,34,5,41213.36,6060.78,47274.14
421080,202211,43,36,7,43638.32,8484.69,52123.01
421085,202211,19,15,4,18183.73,4849.14,23032.87
421090,202211,38,30,8,36364.82,9697.01,46061.83
421100,202211,112,86,26,105459.9,31514.67,136974.57
421105,202211,194,154,40,186667.35,48485.56,235152.91
421110,202211,131,94,37,113942.76,44846.54,158789.30
421120,202211,179,129,50,156359.74,60605.64,216965.38
421125,202211,16,9,7,10909.18,8484.96,19394.14
421130,202211,866,531,335,643630.52,406055.76,1049686.28
421140,202211,31,22,9,26666.27,10910.11,37576.38
421145,202211,41,36,5,43634.79,6060,49694.79
421150,202211,82,63,19,76372.42,23032.05,99404.47
421160,202211,59,36,23,43635.46,27877.7,71513.16
421165,202211,12,10,2,12120,2424,14544
421170,202211,166,140,26,169854.56,31518.09,201372.65
421175,202211,191,136,55,166059.52,66668.08,232727.60
421180,202211,40,28,12,33941.92,14546.39,48488.31
421185,202211,16,13,3,15759.27,3636,19395.27
421187,202211,4,3,1,3637.4,1212,4849.4
421189,202211,47,33,14,39999.14,16969.14,56968.28
421190,202211,2050,1282,768,1556416.24,932151.1,2488567.34
421200,202211,94,66,28,80001.02,33938.93,113939.95
421205,202211,27,18,9,21822.64,10908.85,32731.49
421210,202211,174,126,48,152727.32,58184.3,210911.62
421220,202211,256,197,59,238787.75,71512.84,310300.59
421223,202211,50,39,11,47274.9,13332.74,60607.64
421225,202211,75,49,26,59396.4,31518.43,90914.83
421227,202211,63,53,10,64239.66,12120,76359.66
421230,202211,71,46,25,55758.79,30304.23,86063.02
421240,202211,18,15,3,18183.52,3636,21819.52
421250,202211,413,228,185,276367.76,224247.08,500614.84
421260,202211,20,15,5,18181.38,6060.49,24241.87
421265,202211,10,7,3,8484.67,3636,12120.67
421270,202211,53,48,5,58181.65,6060.11,64241.76
421280,202211,402,206,196,249699.35,237579.23,487278.58
421290,202211,321,208,113,252110.23,136963.78,389074.01
421300,202211,21,19,2,23030.76,2424,25454.76
421310,202211,47,33,14,40000.13,16970.91,56971.04
421315,202211,32,19,13,23030.8,15757.28,38788.08
421320,202211,141,95,46,115148.28,55757.11,170905.39
421330,202211,108,81,27,98179.63,32726.14,130905.77
421335,202211,45,32,13,38788.06,15756.74,54544.80
421340,202211,241,161,80,195152.47,96968.9,292121.37
421350,202211,188,112,76,135769.59,92124.18,227893.77
421360,202211,757,519,238,629099.78,288484.89,917584.67
421370,202211,198,147,51,178184.69,61816.93,240001.62
421380,202211,151,113,38,136980.95,46062.01,183042.96
421390,202211,15,10,5,12120,6060,18180
421400,202211,118,96,22,116358.17,26664.18,143022.35
421410,202211,20,17,3,20605.95,3636,24241.95
421415,202211,20,18,2,21819.17,2424,24243.17
421420,202211,101,86,15,104237.9,19393.08,123630.98
421430,202211,21,13,8,15760.53,9696,25456.53
421440,202211,60,52,8,63032.88,9697.24,72730.12
421450,202211,79,66,13,80002.14,15758.2,95760.34
421460,202211,55,43,12,52123.29,14546.22,66669.51
421470,202211,74,40,34,48489.66,41213.42,89703.08
421480,202211,804,600,204,727241.15,247258.32,974499.47
421490,202211,24,23,1,27879.72,1212,29091.72
421500,202211,487,286,201,347887.73,243629.95,591517.68
421505,202211,35,28,7,33939.47,8484.84,42424.31
421507,202211,30,24,6,29091.5,7272,36363.5
421510,202211,71,47,24,56976.15,29090.99,86067.14
421520,202211,51,42,9,50911.97,10910.22,61822.19
421530,202211,50,43,7,52122.68,8484.39,60607.07
421535,202211,23,22,1,26670.82,1212,27882.82
421540,202211,50,40,10,48485.61,12120.07,60605.68
421545,202211,81,55,26,66672.19,31515.09,98187.28
421550,202211,293,210,83,254562.05,100611.7,355173.75
421555,202211,14,12,2,14549.16,2424.87,16974.03
421560,202211,8,7,1,8485.07,1212.4,9697.47
421565,202211,129,85,44,103034.98,53336.18,156371.16
421567,202211,36,27,9,32728.05,10908,43636.05
421568,202211,41,39,2,47268.84,2424.67,49693.51
421569,202211,11,11,0,13333.59,,13333.59
421570,202211,262,167,95,202428.93,115148.89,317577.82
421575,202211,28,25,3,30300.99,3636.44,33937.43
421580,202211,747,439,308,532197.39,373327.47,905524.86
421590,202211,21,18,3,21818.58,3636,25454.58
421600,202211,187,132,55,159990.01,66661.61,226651.62
421605,202211,106,71,35,86057.02,42423.5,128480.52
421610,202211,172,127,45,153936.46,54543.57,208480.03
421620,202211,1105,632,473,766078.39,573349.16,1339427.55
421625,202211,23,20,3,24242.6,3636.23,27878.83
421630,202211,372,223,149,270308.91,180606.68,450915.59
421635,202211,25,12,13,14545.51,15757.25,30302.76
421640,202211,101,79,22,95767.19,26668.22,122435.41
421650,202211,328,188,140,227887.64,169707.6,397595.24
421660,202211,2692,1616,1076,1958805.89,1304286.12,3263092.01
421670,202211,163,118,45,145447.01,54540.71,199987.72
421680,202211,200,182,18,220606.73,21818.25,242424.98
421690,202211,349,235,114,284850.43,138182.33,423032.76
421700,202211,58,39,19,47271.36,23029.68,70301.04
421710,202211,21,20,1,24241.42,1212,25453.42
421715,202211,5,4,1,4848.44,1212,6060.44
421720,202211,658,436,222,528469.29,269077.08,797546.37
421725,202211,31,12,19,14545.29,23030.43,37575.72
421730,202211,25,18,7,21818.26,8484.67,30302.93
421740,202211,115,45,70,54545.62,84842.71,139388.33
421750,202211,192,140,52,169690.64,63028.84,232719.48
421755,202211,18,16,2,19393.89,2424.44,21818.33
421760,202211,102,69,33,83637.23,40001.84,123639.07
421770,202211,716,455,261,551532.01,316372.5,867904.51
421775,202211,30,19,11,23031.48,13335.22,36366.70
421780,202211,189,146,43,176965.17,52117.59,229082.76
421790,202211,152,129,23,156362.79,27878.74,184241.53
421795,202211,16,13,3,15759.81,3636,19395.81
421800,202211,570,339,231,410940.84,280005.9,690946.74
421810,202211,66,54,12,65458.16,14545.5,80003.66
421820,202211,319,197,122,238791.38,147872.45,386663.83
421825,202211,158,133,25,161218.28,30303.86,191522.14
421830,202211,161,101,60,122429.04,72726.53,195155.57
421835,202211,7,2,5,2424.33,6060,8484.33
421840,202211,40,33,7,40002.79,8485.52,48488.31
421850,202211,77,64,13,77577.73,15758.72,93336.45
421860,202211,37,27,10,32727.28,12120.31,44847.59
421870,202211,1156,825,331,1000037.67,401218.11,1401255.78
421875,202211,47,37,10,44850.44,12120,56970.44
421880,202211,189,132,57,159994.8,69087.15,229081.95
421885,202211,20,15,5,18180.54,6060,24240.54
421890,202211,164,119,45,144246.68,54549.22,198795.90
421895,202211,48,40,8,48486.35,9697.41,58183.76
421900,202211,126,96,30,116379.17,36365.31,152744.48
421910,202211,66,42,24,50908.73,29091.55,80000.28
421915,202211,29,23,6,27879.06,7272.8,35151.86
421917,202211,50,39,11,47271.18,13332.44,60603.62
421920,202211,34,29,5,35154.59,6060,41214.59
421930,202211,633,506,127,613337.54,153944.58,767282.12
421935,202211,43,37,6,44847.38,7273.2,52120.58
421940,202211,53,45,8,54543.11,9696.44,64239.55
421950,202211,930,616,314,746636,380601.78,1127237.78
421960,202211,41,34,7,41212.19,8484,49696.19
421970,202211,332,209,123,254544.04,149084.88,403628.92
421985,202211,19,11,8,13334.48,9699.28,23033.76
422000,202211,11,6,5,7273.3,6061.86,13335.16
430003,202211,186,56,130,67872.44,157560,225432.44
430005,202211,32,24,8,29090.36,9696,38786.36
430010,202211,254,183,71,221806.52,86054.67,307861.19
430020,202211,136,95,41,115153.28,49696.08,164849.36
430030,202211,124,98,26,118785.03,31512.2,150297.23
430040,202211,3009,1786,1223,2164745.06,1483562.93,3648307.99
430045,202211,70,61,9,73932,10908,84840
430047,202211,8,5,3,6060,3637.2,9697.2
430050,202211,87,74,13,89691.14,15756,105447.14
430055,202211,14,12,2,14544,2424,16968
430057,202211,5,3,2,3636,2424,6060
430060,202211,4272,2447,1825,2968478.55,2212104.3,5180582.85
430063,202211,52,43,9,52117.3,10908.34,63025.64
430064,202211,174,137,37,166046.95,44844,210890.95
430066,202211,7,4,3,4848.4,3636.6,8485.0
430070,202211,46,34,12,41208.76,14544.8,55753.56
430080,202211,84,54,30,65451.72,36361.09,101812.81
430085,202211,28,14,14,16969.4,16969.56,33938.96
430087,202211,30,24,6,29092.59,7274.56,36367.15
430090,202211,69,58,11,70298.32,13332,83630.32
430100,202211,147,102,45,123631.77,54542.79,178174.56
430105,202211,172,96,76,116366.76,92120.84,208487.60
430107,202211,19,14,5,16972.01,6061.29,23033.30
430110,202211,493,267,226,323617.46,273919.08,597536.54
430120,202211,164,151,13,183017.55,15756,198773.55
430130,202211,824,491,333,595125.22,403608.52,998733.74
430140,202211,138,127,11,153933.33,13332.74,167266.07
430150,202211,113,70,43,84845.9,52116.6,136962.5
430155,202211,30,24,6,29091.15,7272,36363.15
430160,202211,3820,2151,1669,2607207.21,2024154.77,4631361.98
430163,202211,437,205,232,248475.38,281200.43,529675.81
430165,202211,32,20,12,24240.86,14544,38784.86
430170,202211,82,68,14,82417.88,16968,99385.88
430175,202211,83,62,21,75144.79,25453.75,100598.54
430180,202211,109,85,24,103023.85,29088,132111.85
430185,202211,27,19,8,23028,9696,32724
430187,202211,85,35,50,42422.16,60602.28,103024.44
430190,202211,232,120,112,145448.32,135751.09,281199.41
430192,202211,14,10,4,12120.95,4848.31,16969.26
430195,202211,17,13,4,15756.36,4848,20604.36
430200,202211,158,131,27,158786.55,32726.84,191513.39
430205,202211,21,21,0,25452.6,,25452.6
430210,202211,779,576,203,698139.63,247256.39,945396.02
430215,202211,10,9,1,10908,1212,12120
430220,202211,77,52,25,63026.12,30300,93326.12
430222,202211,15,6,9,7272,10908.67,18180.67
430223,202211,15,10,5,12120,6060,18180
430225,202211,4,2,2,2424,2424,4848
430230,202211,348,214,134,259383.93,163624.79,423008.72
430235,202211,54,34,20,41208.66,24240,65448.66
430237,202211,21,16,5,19393.24,6060,25453.24
430240,202211,116,79,37,95751.02,44844.06,140595.08
430245,202211,67,53,14,64238.45,16968.8,81207.25
430250,202211,192,111,81,134538.4,98172.03,232710.43
430258,202211,14,10,4,12122.08,4848,16970.08
430260,202211,39,33,6,39998.33,7272,47270.33
430265,202211,36,32,4,38785.91,4848,43633.91
430270,202211,533,376,157,455751.15,190293.69,646044.84
430280,202211,1097,636,461,770862.82,558746.88,1329609.70
430290,202211,459,239,220,289681.18,269073.4,558754.58
430300,202211,2210,1195,1015,1448465.78,1231485.23,2679951.01
430310,202211,2229,1093,1136,1324840.63,1376964.43,2701805.06
430320,202211,59,47,12,56964.2,14544,71508.2
430330,202211,85,72,13,87269.45,15756,103025.45
430340,202211,69,54,15,65452.21,18180.34,83632.55
430350,202211,1705,1079,626,1309030.64,758740.78,2067771.42
430355,202211,19,17,2,20605.04,2424,23029.04
430360,202211,99,48,51,58176.8,61812,119988.8
430367,202211,51,36,15,43633.38,18180.84,61814.22
430370,202211,61,53,8,64237.03,9696.8,73933.83
430380,202211,108,78,30,94541.63,36360,130901.63
430390,202211,612,374,238,453332.29,288484.76,741817.05
430400,202211,264,180,84,219376.28,103021.65,322397.93
430410,202211,56,45,11,54540.47,13332.44,67872.91
430420,202211,543,347,196,420590.74,237560.17,658150.91
430430,202211,49,47,2,56162.1,2424,58586.1
430435,202211,150,111,39,135748.19,47269.96,183018.15
430440,202211,600,366,234,444834.77,283618.16,728452.93
430450,202211,1257,1017,240,1232691.43,290899.13,1523590.56
430460,202211,6157,3142,3015,3808389.49,3655630.82,7464020.31
430461,202211,19,17,2,20604,2424,23028
430462,202211,4,2,2,2425.19,2424.99,4850.18
430463,202211,1243,667,576,808468.45,699379.17,1507847.62
430465,202211,27,16,11,19393.43,13332.08,32725.51
430466,202211,749,524,225,636352.47,272717.47,909069.94
430467,202211,125,71,54,86054.69,65449.48,151504.17
430468,202211,152,88,64,106659.69,77570.76,184230.45
430469,202211,21,15,6,18184.68,7273.01,25457.69
430470,202211,1212,647,565,784562.77,684810.86,1469373.63
430471,202211,77,51,26,61817.3,31513.55,93330.85
430480,202211,135,96,39,116353.43,47268,163621.43
430485,202211,8,8,0,9697.07,,9697.07
430490,202211,73,58,15,71510.17,18180.34,89690.51
430495,202211,33,24,9,29089.27,10908,39997.27
430500,202211,198,132,66,159989.34,79994.42,239983.76
430510,202211,3994,2591,1403,3141658.77,1701708.76,4843367.53
430511,202211,14,14,0,16969.38,,16969.38
430512,202211,173,118,55,143024.84,66666.31,209691.15
430513,202211,54,41,13,49694.15,15756,65450.15
430515,202211,26,24,2,29088.34,2424,31512.34
430517,202211,180,150,30,181806.06,36361.17,218167.23
430520,202211,347,242,105,294532.04,127265.57,421797.61
430530,202211,77,41,36,49693.72,43634.73,93328.45
430535,202211,474,305,169,369682.45,204840.4,574522.85
430537,202211,9,9,0,10908.67,,10908.67
430540,202211,80,53,27,64236,32724,96960
430543,202211,429,144,285,174531.82,345442.05,519973.87
430544,202211,52,47,5,56974.11,6061.07,63035.18
430545,202211,436,214,222,259394.56,269092.69,528487.25
430550,202211,44,36,8,43634.59,9697.31,53331.90
430558,202211,1,1,0,1212,,1212.0
430560,202211,55,31,24,37572,29088,66660
430570,202211,122,51,71,61817.48,86052.2,147869.68
430580,202211,124,97,27,117566.93,32724,150290.93
430583,202211,14,14,0,16968.62,,16968.62
430585,202211,14,11,3,13332,3636,16968
430587,202211,16,10,6,12120,7272.21,19392.21
430590,202211,185,148,37,179381.81,44845.81,224227.62
430593,202211,1,1,0,1212,,1212.0
430595,202211,16,13,3,15756,3636,19392
430597,202211,41,23,18,27877.63,21818.75,49696.38
430600,202211,224,166,58,201198.9,70296,271494.9
430605,202211,180,105,75,127262.14,90900.67,218162.81
430607,202211,28,23,5,27878.26,6060.5,33938.76
430610,202211,1806,854,952,1035092.43,1153854.82,2188947.25
430613,202211,5,5,0,6060.67,,6060.67
430620,202211,96,69,27,83628.44,32724.44,116352.88
430630,202211,46,40,6,48483.58,7272,55755.58
430632,202211,33,28,5,33936,6060,39996
430635,202211,35,29,6,35148.68,7272,42420.68
430637,202211,65,31,34,37572.74,42420,79992.74
430640,202211,181,98,83,118782.27,100602.96,219385.23
430642,202211,18,16,2,19392.17,2424,21816.17
430645,202211,34,27,7,32724,8484,41208
430650,202211,244,194,50,235158.6,60603.4,295762.0
430655,202211,7,5,2,6060.26,2424.34,8484.60
430660,202211,1023,505,518,612099.86,629071.75,1241171.61
430670,202211,68,46,22,55752.78,26664,82416.78
430673,202211,73,49,24,59390.61,29088.27,88478.88
430675,202211,8,6,2,7272,2424,9696
430676,202211,647,393,254,476341.46,307869.42,784210.88
430680,202211,256,166,90,201202.57,109084.81,310287.38
430690,202211,566,344,222,416961.75,269079.91,686041.66
430692,202211,8,6,2,7273.18,2424.54,9697.72
430693,202211,142,91,51,110296.12,61814.34,172110.46
430695,202211,65,52,13,63024.12,15756,78780.12
430697,202211,66,42,24,50904.58,29088.44,79993.02
430700,202211,1411,958,453,1166012.76,549067.15,1715079.91
430705,202211,30,26,4,31512.11,4848,36360.11
430710,202211,276,172,104,208468.82,126048,334516.82
430720,202211,102,85,17,103021.66,20604,123625.66
430730,202211,149,127,22,155140.03,26664,181804.03
430740,202211,80,48,32,58179.14,38784.12,96963.26
430745,202211,32,17,15,20604.93,18180.8,38785.73
430750,202211,330,214,116,259374.05,140593.41,399967.46
430755,202211,82,46,36,55754.99,43633.26,99388.25
430760,202211,423,236,187,286058.35,227876.91,513935.26
430770,202211,1705,913,792,1106655.89,962397.71,2069053.60
430780,202211,353,222,131,269067.11,158773.01,427840.12
430781,202211,24,24,0,29092.22,,29092.22
430783,202211,62,48,14,58176,16968,75144
430786,202211,6,4,2,4848,2424,7272
430790,202211,547,344,203,419372.26,246046.31,665418.57
430800,202211,165,125,40,152717.22,48480.67,201197.89
430805,202211,39,32,7,38786.89,8484.85,47271.74
430807,202211,72,38,34,46056.34,41208,87264.34
430810,202211,85,57,28,69085.74,33936.67,103022.41
430820,202211,155,100,55,121204.99,66660,187864.99
430825,202211,11,9,2,10908,2424,13332
430830,202211,268,249,19,301800.17,23028,324828.17
430840,202211,136,89,47,107874.12,56964.93,164839.05
430843,202211,8,4,4,4848,4848,9696
430845,202211,81,48,33,58177.65,39996,98173.65
430850,202211,599,426,173,516329.71,209680.42,726010.13
430860,202211,172,112,60,136961.01,72723.28,209684.29
430865,202211,75,42,33,50904.55,39996.64,90901.19
430870,202211,72,59,13,71515.21,15756.45,87271.66
430880,202211,179,124,55,150294.92,67875.5,218170.42
430885,202211,13,11,2,13332.45,2424,15756.45
430890,202211,339,203,136,246040.43,164833.78,410874.21
430900,202211,544,371,173,449667.59,209677.06,659344.65
430905,202211,138,59,79,71510.24,95751.06,167261.30
430910,202211,294,156,138,189084.25,167265.9,356350.15
430912,202211,4,4,0,4848,,4848.0
430915,202211,43,40,3,48480.34,3636,52116.34
430920,202211,4962,2591,2371,3140613.59,2873914.59,6014528.18
430925,202211,6,5,1,6060,1212,7272
430930,202211,2207,1239,968,1503008.67,1173291.88,2676300.55
430940,202211,272,174,98,210897.83,118782.7,329680.53
430950,202211,154,124,30,151505.08,36360.55,187865.63
430955,202211,24,14,10,16968.9,12120,29088.9
430957,202211,23,20,3,24241.57,3636,27877.57
430960,202211,278,179,99,216953.47,119988.89,336942.36
430965,202211,103,67,36,81204.89,43632.34,124837.23
430970,202211,89,71,18,86052.85,21816.8,107869.65
430975,202211,51,45,6,54541.55,7272,61813.55
430980,202211,52,31,21,37574.1,25452.44,63026.54
430990,202211,98,75,23,90901.75,27876,118777.75
430995,202211,111,104,7,126050.68,8484.4,134535.08
431000,202211,297,146,151,176961.88,184227.67,361189.55
431010,202211,371,219,152,265449.76,184244.2,449693.96
431020,202211,1978,1141,837,1384177.01,1014485.15,2398662.16
431030,202211,40,31,9,37572.65,10908,48480.65
431033,202211,498,226,272,273947.12,330911.28,604858.40
431036,202211,12,8,4,9696.73,4848,14544.73
431040,202211,147,98,49,118782.14,59390.38,178172.52
431041,202211,43,24,19,29088,23028.53,52116.53
431043,202211,40,23,17,27878.1,20604.32,48482.42
431046,202211,13,10,3,12120.78,3636.44,15757.22
431050,202211,207,126,81,152719.02,98172.44,250891.46
431053,202211,75,41,34,49695.93,41212.1,90908.03
431055,202211,65,44,21,53328.84,25452.08,78780.92
431057,202211,18,18,0,21816,,21816.0
431060,202211,1627,1040,587,1260518.72,711462.82,1971981.54
431065,202211,17,7,10,8484,12120,20604
431070,202211,66,57,9,69085.1,10908.67,79993.77
431075,202211,8,8,0,9698.75,,9698.75
431080,202211,133,75,58,90907.2,70298.21,161205.41
431085,202211,35,31,4,37573.5,4848,42421.5
431087,202211,16,13,3,15756.67,3636,19392.67
431090,202211,55,43,12,52116.23,14544,66660.23
431100,202211,1308,782,526,947835.42,637551.84,1585387.26
431110,202211,228,136,92,164843.91,111507.5,276351.41
431112,202211,29,22,7,26666.64,8485.22,35151.86
431113,202211,28,20,8,24241.41,9696,33937.41
431115,202211,157,110,47,133326.94,56964,190290.94
431120,202211,607,353,254,427854.22,307859.06,735713.28
431123,202211,4,4,0,4848.74,,4848.74
431125,202211,96,83,13,100596.54,15756,116352.54
431127,202211,5,3,2,3636,2424,6060
431130,202211,735,474,261,574508.63,316343.62,890852.25
431140,202211,835,586,249,710264.48,301797.14,1012061.62
431142,202211,20,18,2,21819.27,2424,24243.27
431150,202211,206,151,55,183023.95,66661.51,249685.46
431160,202211,44,40,4,48481.94,4848,53329.94
431162,202211,6,6,0,7273.11,,7273.11
431164,202211,5,4,1,4848,1212,6060
431170,202211,118,83,35,100600.89,42420.2,143021.09
431171,202211,76,44,32,53328.4,38784,92112.4
431173,202211,7,5,2,6060.93,2424.2,8485.13
431175,202211,206,108,98,130899.85,118779.92,249679.77
431177,202211,101,73,28,88486.69,33938.98,122425.67
431179,202211,14,10,4,12120.11,4848,16968.11
431180,202211,409,251,158,304219.93,191498.59,495718.52
431190,202211,71,51,20,61815.48,24240.8,86056.28
431198,202211,76,51,25,61688.21,30300.67,91988.88
431200,202211,22,18,4,21816,4848,26664
431205,202211,22,20,2,24240.67,2424,26664.67
431210,202211,103,62,41,75147.43,49695.16,124842.59
431213,202211,32,26,6,31515.41,7274.2,38789.61
431215,202211,24,23,1,27876,1212,29088
431217,202211,5,4,1,4848.95,1212,6060.95
431220,202211,66,55,11,66660.97,13332.34,79993.31
431225,202211,165,103,62,126049.39,75144,201193.39
431230,202211,101,84,17,101810.63,20604,122414.63
431235,202211,5,4,1,4848,1212,6060
431237,202211,16,10,6,12121.02,7272.2,19393.22
431238,202211,14,10,4,12120.44,4848.74,16969.18
431240,202211,1153,713,440,865441.07,534529.9,1399970.97
431242,202211,42,41,1,49694.87,1212,50906.87
431244,202211,32,26,6,31515.74,7272.27,38788.01
431245,202211,53,36,17,43634.03,20604.67,64238.70
431247,202211,15,11,4,13332,4848.5,18180.5
431250,202211,298,147,151,178178.68,183023.32,361202.00
431260,202211,53,46,7,55752.46,9696,65448.46
431261,202211,20,15,5,18180.23,6060.34,24240.57
431262,202211,15,12,3,14544.74,3636.21,18180.95
431265,202211,152,85,67,103022.3,81204.44,184226.74
431267,202211,17,15,2,18181.55,2424.5,20606.05
431270,202211,337,261,76,316347.85,92117.15,408465.00
431275,202211,39,35,4,42422.19,4848,47270.19
431280,202211,21,15,6,18180,7272,25452
431290,202211,24,21,3,25453.58,3636,29089.58
431295,202211,3,1,2,1212,2424,3636
431300,202211,22,19,3,23028.2,3636,26664.2
431301,202211,7,7,0,8484.34,,8484.34
431303,202211,57,35,22,42421.84,26664,69085.84
431306,202211,248,127,121,153930.83,146655.48,300586.31
431308,202211,9,7,2,8484,2424,10908
431310,202211,62,47,15,56966.64,18180,75146.64
431320,202211,204,126,78,152716.38,94536.23,247252.61
431330,202211,215,142,73,172109.56,88477.86,260587.42
431333,202211,26,21,5,25453.01,6060.33,31513.34
431335,202211,10,7,3,8484,3636.44,12120.44
431337,202211,435,212,223,256959.06,271500.21,528459.27
431339,202211,21,15,6,18181.04,7272,25453.04
431340,202211,3247,1738,1509,2106512.53,1831434.95,3937947.48
431342,202211,34,23,11,27878.13,13332.26,41210.39
431344,202211,19,19,0,23028.89,,23028.89
431346,202211,5,4,1,4848,1212,6060
431349,202211,27,25,2,30300,2424,32724
431350,202211,1164,625,539,757573.13,653320.48,1410893.61
431360,202211,55,41,14,49692,16968.67,66660.67
431365,202211,390,164,226,198783.71,273919.52,472703.23
431370,202211,1226,686,540,835104.86,658134.12,1493238.98
431380,202211,97,86,11,104237.87,13332,117569.87
431390,202211,508,273,235,330889.46,284825.63,615715.09
431395,202211,335,148,187,179388.38,226656.92,406045.30
431400,202211,37,24,13,29089.35,15756,44845.35
431402,202211,98,72,26,87267.91,31512.6,118780.51
431403,202211,28,19,9,23028,10908.84,33936.84
431405,202211,752,435,317,527253.66,384229.43,911483.09
431406,202211,36,27,9,32728.21,10908,43636.21
431407,202211,48,37,11,44844.55,13332.44,58176.99
431410,202211,3622,2215,1407,2684773.9,1706604.43,4391378.33
431413,202211,15,12,3,14545.78,3636.36,18182.14
431415,202211,72,51,21,61819.27,25454.19,87273.46
431417,202211,24,13,11,15756,13332,29088
431420,202211,372,244,128,295749.93,156355.22,452105.15
431430,202211,69,33,36,39997.59,43632.44,83630.03
431440,202211,9562,6467,3095,7842316.78,3755104.17,11597420.95
431442,202211,26,14,12,16968,14544.43,31512.43
431445,202211,25,24,1,29088,1212,30300
431446,202211,4,4,0,4848.15,,4848.15
431447,202211,84,62,22,75146.82,26664,101810.82
431449,202211,61,48,13,58176.57,15756,73932.57
431450,202211,430,282,148,341793.8,179376.9,521170.7
431454,202211,11,6,5,7272,6061.43,13333.43
431455,202211,48,39,9,47274.18,10909.55,58183.73
431460,202211,514,347,167,420603.9,202414.94,623018.84
431470,202211,141,104,37,126052.51,44845.12,170897.63
431475,202211,11,9,2,10908.67,2424.35,13333.02
431477,202211,40,22,18,26664.14,21816,48480.14
431478,202211,7,7,0,8484.96,,8484.96
431480,202211,636,382,254,464226.08,309075.85,773301.93
431490,202211,31302,17497,13805,21223465.91,16747645.79,37971111.70
431500,202211,77,60,17,72723.89,20605.08,93328.97
431505,202211,27,18,9,21816.54,10908.77,32725.31
431507,202211,10,8,2,9698.53,2424,12122.53
431510,202211,235,166,69,201198.94,83628.99,284827.93
431513,202211,20,19,1,23030.5,1212,24242.5
431514,202211,6,4,2,4848,2424,7272
431515,202211,85,72,13,87266.9,15756.6,103023.5
431517,202211,7,4,3,4848.84,3636,8484.84
431520,202211,40,33,7,39997.38,8484,48481.38
431530,202211,1437,623,814,755102.92,986596.92,1741699.84
431531,202211,24,22,2,26664.87,2424,29088.87
431532,202211,36,27,9,32724.55,10908,43632.55
431535,202211,30,16,14,19395.1,16968.4,36363.5
431540,202211,142,111,31,134535.06,37573.55,172108.61
431545,202211,14,11,3,13334.07,3636,16970.07
431550,202211,352,186,166,225452.81,201203.59,426656.40
431555,202211,14,13,1,15756,1212,16968
431560,202211,5047,3336,1711,4050860.6,2076324.15,6127184.75
431570,202211,873,465,408,563617.05,494526.64,1058143.69
431575,202211,54,32,22,38785.41,26665.74,65451.15
431580,202211,81,56,25,67872.44,30300.14,98172.58
431590,202211,144,122,22,147865.27,26664.5,174529.77
431595,202211,15,13,2,15758.58,2424,18182.58
431600,202211,255,148,107,179390.54,129692.64,309083.18
431610,202211,119,88,31,106663.88,37572.47,144236.35
431620,202211,39,32,7,38785.88,8484,47269.88
431630,202211,125,102,23,123627.42,27876,151503.42
431640,202211,1333,825,508,1001157.77,615718.07,1616875.84
431642,202211,32,30,2,36360,2424,38784
431643,202211,44,17,27,20604.71,32727.99,53332.70
431645,202211,332,195,137,236345.01,167257.9,403602.91
431647,202211,11,10,1,12120.34,1212,13332.34
431650,202211,37,21,16,25452.44,19392.82,44845.26
431660,202211,268,169,99,204832.6,119988.88,324821.48
431670,202211,227,99,128,119992.26,155138.8,275131.06
431673,202211,15,12,3,14544.95,3636.8,18181.75
431675,202211,26,20,6,24240.94,7272,31512.94
431680,202211,1205,869,336,1053306.38,407260.39,1460566.77
431690,202211,5163,3040,2123,3685990.93,2579324.72,6265315.65
431695,202211,17,11,6,13333.01,7272,20605.01
431697,202211,4,2,2,2424,2424.44,4848.44
431700,202211,193,144,49,174531.64,59388.58,233920.22
431710,202211,4247,1823,2424,2209641.31,2941736.44,5151377.75
431720,202211,1305,799,506,967819.21,613298.79,1581118.00
431725,202211,3,1,2,1212,2424,3636
431730,202211,1236,820,416,993940.26,504234.99,1498175.25
431740,202211,1371,666,705,808448.77,854503.61,1662952.38
431750,202211,1873,1218,655,1477528.66,793899.28,2271427.94
431755,202211,5,4,1,4848.2,1212.49,6060.69
431760,202211,1006,635,371,770914.64,450917.91,1221832.55
431770,202211,417,281,136,340580.98,164832.51,505413.49
431775,202211,27,20,7,24243.33,8484.34,32727.67
431780,202211,587,356,231,431475.02,279973.86,711448.88
431790,202211,148,112,36,135749.68,43633.23,179382.91
431795,202211,12,10,2,12120,3636,15756
431800,202211,3168,1660,1508,2012048.35,1830259.31,3842307.66
431805,202211,19,15,4,18180,4848,23028
431810,202211,580,376,204,455742.72,249677.47,705420.19
431820,202211,353,201,152,243621.95,184225.12,427847.07
431830,202211,2393,1435,958,1740499.99,1162359.25,2902859.24
431840,202211,508,315,193,381810.33,233928.18,615738.51
431842,202211,35,29,6,35148,7272,42420
431843,202211,9,6,3,7272,3636.6,10908.6
431844,202211,18,13,5,15756,6060.67,21816.67
431845,202211,24,22,2,27876,2424.44,30300.44
431846,202211,27,23,4,27877.7,4848,32725.7
431848,202211,15,11,4,13332.99,4848,18180.99
431849,202211,6,5,1,6060.8,1212,7272.8
431850,202211,825,646,179,784027.91,216965.14,1000993.05
431860,202211,121,78,43,94539.47,52116.44,146655.91
431861,202211,4,0,4,,4848.78,4848.78
431862,202211,65,47,18,56965.07,21816.86,78781.93
431870,202211,3992,2289,1703,2774539.19,2067858.33,4842397.52
431880,202211,1009,698,311,848433.75,376939.62,1225373.37
431890,202211,1262,725,537,879945.98,652067.12,1532013.10
431900,202211,196,130,66,157564.12,79992,237556.12
431910,202211,45,35,10,42420.8,12120.88,54541.68
431912,202211,50,32,18,38785.39,21818.07,60603.46
431915,202211,151,114,37,138169.63,44844.8,183014.43
431920,202211,155,111,44,134538.69,53329.04,187867.73
431930,202211,75,60,15,72722.64,18180,90902.64
431935,202211,3,2,1,2424,1212,3636
431936,202211,2,2,0,2424.5,,2424.5
431937,202211,22,17,5,20605.18,6060.17,26665.35
431940,202211,473,324,149,392710.91,180593.81,573304.72
431950,202211,490,311,179,378185.23,216969.65,595154.88
431960,202211,760,412,348,499379.78,421785.13,921164.91
431970,202211,64,58,6,70300.7,7272.44,77573.14
431971,202211,4,4,0,4848,,4848.0
431973,202211,20,17,3,20605.04,3636,24241.04
431975,202211,10,10,0,12120,,12120.0
431980,202211,209,118,91,143024.7,110294.99,253319.69
431990,202211,1114,592,522,717501.59,633951.44,1351453.03
432000,202211,2005,1069,936,1295758.56,1134546.07,2430304.63
432010,202211,268,173,95,209679.57,115142.69,324822.26
432020,202211,191,162,29,196352.86,35148.48,231501.34
432023,202211,15,13,2,15756,2424,18180
432026,202211,62,54,8,65450.03,9696,75146.03
432030,202211,56,24,32,29088.28,38784,67872.28
432032,202211,14,11,3,13332.81,3636.67,16969.48
432035,202211,68,51,17,61814.89,20604.4,82419.29
432040,202211,86,60,26,72723.9,31512.78,104236.68
432045,202211,3,3,0,3636.34,,3636.34
432050,202211,81,49,32,59392.82,38784,98176.82
432055,202211,132,91,41,110297.95,49693.43,159991.38
432057,202211,6,4,2,4848.6,2424,7272.6
432060,202211,32,28,4,33937.36,4848,38785.36
432065,202211,31,27,4,32724,4848,37572
432067,202211,85,78,7,94539.37,8484,103023.37
432070,202211,388,305,83,369679,100600.8,470279.8
432080,202211,869,615,254,746661.82,307868.28,1054530.10
432085,202211,22,17,5,20604.21,6060,26664.21
432090,202211,284,184,100,223016.7,121200.8,344217.5
432100,202211,171,108,63,130899.01,76357.93,207256.94
432110,202211,574,377,197,456947.86,238771.39,695719.25
432120,202211,1074,602,472,729662.96,574515.2,1304178.16
432130,202211,526,375,151,454523.52,183017.98,637541.50
432132,202211,22,20,2,24240.17,2424,26664.17
432135,202211,83,66,17,79995.76,20605.27,100601.03
432140,202211,267,202,65,244832.45,78781.64,323614.09
432143,202211,232,141,91,170901.93,110299.28,281201.21
432145,202211,303,212,91,256957.03,110292.5,367249.53
432146,202211,16,14,2,16969.55,2424,19393.55
432147,202211,99,59,40,71508,48480,119988
432149,202211,15,10,5,12120.86,6060,18180.86
432150,202211,1095,681,414,825446.87,503021.24,1328468.11
432160,202211,1855,957,898,1159964.22,1089660.01,2249624.23
432162,202211,5,3,2,3636,2424,6060
432163,202211,15,10,5,12120,6060,18180
432166,202211,129,89,40,108188.37,48486.88,156675.25
432170,202211,237,127,110,153935.98,133326.96,287262.94
432180,202211,592,377,215,456929.68,260583.46,717513.14
432183,202211,10,9,1,10910.33,1212.34,12122.67
432185,202211,79,64,15,78783.17,18181.23,96964.40
432190,202211,533,318,215,385420.48,260584.06,646004.54
432195,202211,92,73,19,88476.67,23029.04,111505.71
432200,202211,439,267,172,323619.49,208473.23,532092.72
432210,202211,123,72,51,87267.72,61812.44,149080.16
432215,202211,30,28,2,35149.83,2424,37573.83
432218,202211,20,20,0,24241.51,,24241.51
432220,202211,653,327,326,397560.19,395124.61,792684.80
432225,202211,19,13,6,15758.41,7272,23030.41
432230,202211,128,84,44,101814.13,53329.15,155143.28
432232,202211,29,26,3,31512,3636,35148
432234,202211,4,2,2,2424,2424.8,4848.8
432235,202211,1,1,0,1212,,1212.0
432237,202211,23,15,8,18182.42,9696,27878.42
432240,202211,4715,2643,2072,3204762.92,2511435.98,5716198.90
432250,202211,1178,789,389,956294.91,473897.46,1430192.37
432252,202211,50,48,2,58176,2424,60600
432253,202211,70,54,16,65452.15,19393.49,84845.64
432254,202211,31,15,16,18180,19392,37572
432255,202211,11,10,1,12120,1212,13332
432260,202211,900,720,180,872672.05,218165.64,1090837.69
432270,202211,219,161,58,195160.22,70306.78,265467.00
432280,202211,164,121,43,147874.41,52118.84,199993.25
432285,202211,1,1,0,1212,,1212.0
432290,202211,58,48,10,58177.66,12120,70297.66
432300,202211,5303,2835,2468,3439884.71,2993864.67,6433749.38
432310,202211,132,112,20,135748.83,24240.44,159989.27
432320,202211,20,15,5,18180,6060,24240
432330,202211,18,12,6,14544,7272,21816
432335,202211,11,9,2,10908.67,2424,13332.67
432340,202211,34,27,7,32725.04,8484,41209.04
432345,202211,121,79,42,95750.81,50904.34,146655.15
432350,202211,24,23,1,27876,1212,29088
432360,202211,5,4,1,4849.04,1212,6061.04
432370,202211,26,26,0,31514.85,,31514.85
432375,202211,26,24,2,29088.87,2424,31512.87
432377,202211,6,6,0,7272.02,,7272.02
432380,202211,219,102,117,123631.68,141811.74,265443.42
500020,202211,297,156,141,189088.42,170902.04,359990.46
500025,202211,147,69,78,83634.31,94541.25,178175.56
500060,202211,1542,983,559,1191521.22,677586.66,1869107.88
500070,202211,784,380,404,460608.08,492121.01,952729.09
500080,202211,140,112,28,135760.16,33939.99,169700.15
500085,202211,137,102,35,123634.02,42421.41,166055.43
500090,202211,406,189,217,229085.13,263020.32,492105.45
500100,202211,716,366,350,443643,424236.04,867879.04
500110,202211,2397,1143,1254,1385445.44,1522453.29,2907898.73
500124,202211,269,143,126,173331.75,152724.29,326056.04
500150,202211,326,135,191,163639.15,231528.68,395167.83
500190,202211,601,397,204,481220.35,247276.9,728497.25
500200,202211,211,174,37,210914.47,44846.79,255761.26
500210,202211,1780,568,1212,688482.82,1469075.6,2157558.42
500215,202211,205,118,87,143038.81,105461.77,248500.58
500220,202211,735,464,271,562437.65,328492.62,890930.27
500230,202211,249,142,107,172131.43,129697.74,301829.17
500240,202211,675,425,250,515152.59,303029.16,818181.75
500260,202211,624,253,371,306665.38,449692.19,756357.57
500270,202211,32180,13976,18204,16948625.97,22085282.1,39033908.07
500280,202211,206,71,135,86056.83,163622.81,249679.64
500290,202211,1233,775,458,939400.48,555150.82,1494551.30
500295,202211,488,317,171,384244.15,207273.16,591517.31
500310,202211,119,42,77,50906.12,93329.58,144235.70
500315,202211,876,479,397,581765.27,481172.67,1062937.94
500320,202211,3844,1800,2044,2181862.84,2479977.66,4661840.50
500325,202211,973,543,430,658207.88,521236.88,1179444.76
500330,202211,1577,767,810,929645.47,984260.12,1913905.59
500345,202211,315,223,92,270308.02,111513.76,381821.78
500348,202211,254,156,98,189089.89,119998.31,309088.20
500350,202211,108,53,55,64243.81,67882.19,132126.00
500370,202211,6064,2742,3322,3324908.41,4035204.3,7360112.71
500375,202211,376,246,130,298185.51,157577.14,455762.65
500380,202211,669,376,293,455766.76,356354.04,812120.80
500390,202211,73,31,42,37573.73,50907.85,88481.58
500400,202211,230,144,86,174545.66,104237.56,278783.22
500410,202211,482,206,276,249704.59,335775.82,585480.41
500430,202211,604,392,212,475139.78,258176.48,733316.26
500440,202211,216,120,96,145449.77,116358.02,261807.79
500450,202211,448,192,256,232721.34,310290.81,543012.15
500460,202211,281,153,128,185460.35,156365.23,341825.58
500470,202211,438,316,122,384237.48,147871.76,532109.24
500480,202211,104,57,47,69090.34,56970.87,126061.21
500490,202211,95,39,56,47271.65,67875.81,115147.46
500500,202211,1527,563,964,682419.69,1168484.5,1850904.19
500510,202211,39,32,7,38792.48,8485.89,47278.37
500515,202211,122,79,43,95759.87,52123.73,147883.60
500520,202211,293,150,143,181822.33,173332.1,355154.43
500525,202211,102,52,50,63030.6,60603.42,123634.02
500540,202211,945,407,538,493350.7,652143.07,1145493.77
500560,202211,909,507,402,615757.81,487270.31,1103028.12
500568,202211,1114,537,577,650922.54,699388.15,1350310.69
500570,202211,1253,714,539,866653.35,653324.69,1519978.04
500580,202211,320,175,145,212134.38,175762.38,387896.76
500600,202211,393,191,202,231526.08,244848.03,476374.11
500620,202211,1028,704,324,854545.86,393934.43,1248480.29
500625,202211,83,65,18,78781.8,21817.39,100599.19
500627,202211,41,17,24,20605.81,29091.33,49697.14
500630,202211,1635,932,703,1129226.6,852145.08,1981371.68
500635,202211,515,303,212,367242.24,256946.13,624188.37
500640,202211,377,208,169,252132.96,206074.82,458207.78
500660,202211,6205,2212,3993,2682434.56,4840062.76,7522497.32
500690,202211,650,232,418,281210.95,506649.89,787860.84
500710,202211,423,206,217,249696.78,263035.93,512732.71
500720,202211,986,531,455,643627.23,552701.79,1196329.02
500730,202211,147,89,58,107896.86,70311.75,178208.61
500740,202211,1011,429,582,521216.59,705459.97,1226676.56
500750,202211,197,72,125,87268.83,151507.57,238776.40
500755,202211,112,85,27,103042.35,32728.49,135770.84
500769,202211,763,417,346,505449.34,419385.97,924835.31
500770,202211,426,223,203,270302.61,246057.51,516360.12
500780,202211,138,95,43,115166.62,52124.76,167291.38
500790,202211,1140,547,593,663048.76,718770.6,1381819.36
500793,202211,299,156,143,189095.59,174553.5,363649.09
500795,202211,196,124,72,150298.22,87272.14,237570.36
500797,202211,49,33,16,39997.14,19392.05,59389.19
500800,202211,445,196,249,237574.89,303018.92,540593.81
500830,202211,2440,1295,1145,1570929.32,1387871.75,2958801.07
500840,202211,118,84,34,101830.39,41213.93,143044.32
510010,202211,175,96,79,116353.19,95749.53,212102.72
510020,202211,568,267,301,323643.79,364847.28,688491.07
510025,202211,1804,1014,790,1229110.87,957595.72,2186706.59
510030,202211,673,351,322,425489.63,390330.43,815820.06
510035,202211,135,68,67,82418.58,81209.4,163627.98
510040,202211,423,199,224,241210.22,271509.36,512719.58
510050,202211,387,206,181,249713.51,219402.21,469115.72
510060,202211,131,60,71,72726.03,86056.49,158782.52
510080,202211,261,108,153,132113.91,185440.76,317554.67
510100,202211,68,27,41,32726.45,49697,82423.45
510120,202211,33,19,14,23034.4,16969.36,40003.76
510125,202211,407,259,148,313935.44,179389.83,493325.27
510130,202211,550,324,226,392719.34,273933.92,666653.26
510140,202211,465,154,311,186670.93,376962.74,563633.67
510160,202211,105,40,65,48484.27,78792.88,127277.15
510170,202211,802,472,330,572119.31,400009.38,972128.69
510180,202211,3095,1404,1691,1701837.35,2049652.47,3751489.82
510185,202211,32,14,18,16970.35,21817.31,38787.66
510190,202211,257,91,166,110300.14,201204.25,311504.39
510250,202211,2813,1711,1102,2075101.83,1338140.04,3413241.87
510260,202211,171,122,49,147897.37,59398.63,207296.00
510263,202211,500,282,218,343035.49,264243.71,607279.20
510267,202211,621,344,277,416987.46,335767.55,752755.01
510268,202211,73,35,38,42423.09,46060.62,88483.71
510269,202211,78,36,42,43634.33,50906.23,94540.56
510270,202211,392,188,204,227878.14,247261.14,475139.28
510279,202211,210,156,54,189085.4,66663.85,255749.25
510285,202211,191,76,115,92117.71,139389.55,231507.26
510300,202211,532,275,257,333350.74,312743.06,646093.80
510305,202211,195,87,108,105448.23,130899.5,236347.73
510310,202211,105,56,49,67874.82,59390.13,127264.95
510320,202211,845,526,319,637609.77,386685.99,1024295.76
510325,202211,457,195,262,236353.09,317560.22,553913.31
510330,202211,465,255,210,309099.07,254539.23,563638.30
510335,202211,687,397,290,481222.61,351519.09,832741.70
510336,202211,55,37,18,44846.88,21817.5,66664.38
510337,202211,103,44,59,53329.79,71511.64,124841.43
510340,202211,19253,8233,11020,9982330.69,13366501.31,23348832.00
510343,202211,58,45,13,54540.05,15756,70296.05
510345,202211,151,92,59,111514.77,72727.95,184242.72
510350,202211,665,351,314,425459.03,380598.43,806057.46
510360,202211,224,140,84,169699.07,101822.14,271521.21
510370,202211,174,75,99,90900,119989.59,210889.59
510380,202211,83,61,22,73932.12,26664.6,100596.72
510385,202211,60,30,30,36361.12,36360.33,72721.45
510390,202211,102,48,54,58178.36,65451.72,123630.08
510395,202211,58,41,17,49693.53,20604.2,70297.73
510410,202211,821,518,303,627900.83,367279.55,995180.38
510420,202211,578,276,302,334536.09,366043.46,700579.55
510450,202211,53,28,25,33936.44,30300.44,64236.88
510452,202211,61,29,32,35149.68,38786.94,73936.62
510454,202211,55,25,30,30301.11,36361.7,66662.81
510455,202211,120,70,50,86060.08,60603.62,146663.70
510460,202211,203,88,115,106670.67,139390.64,246061.31
510480,202211,777,451,326,546686.87,395164.04,941850.91
510490,202211,347,164,183,198781.94,221807.22,420589.16
510500,202211,242,181,61,219381.6,73934.78,293316.38
510510,202211,888,518,370,629108.62,450910.46,1080019.08
510515,202211,1328,676,652,819382.8,790294.7,1609677.5
510517,202211,284,124,160,150298.65,193931.98,344230.63
510520,202211,235,146,89,176973.74,107881.1,284854.84
510523,202211,116,91,25,110293.83,30300,140593.83
510525,202211,927,573,354,694538.99,429094.98,1123633.97
510530,202211,27,16,11,19392,13332.84,32724.84
510550,202211,253,117,136,141825.97,164855.65,306681.62
510558,202211,327,163,164,197793.7,198771.28,396564.98
510560,202211,399,228,171,277583.47,207272.93,484856.40
510562,202211,688,488,200,591552.43,243637.44,835189.87
510590,202211,745,361,384,437573.81,465454.24,903028.05
510600,202211,228,117,111,141822.81,134544.88,276367.69
510610,202211,226,101,125,123631.24,151509.73,275140.97
510615,202211,230,109,121,132118.13,146660.65,278778.78
510617,202211,26,11,15,13332.27,18182.28,31514.55
510618,202211,131,63,68,76358.97,82421.13,158780.10
510619,202211,81,59,22,71515.23,26665.34,98180.57
510620,202211,169,89,80,107871.28,96962.44,204833.72
510621,202211,184,116,68,140602.58,82418.87,223021.45
510622,202211,517,273,244,330928.42,296969.98,627898.40
510623,202211,290,197,93,238786.53,112723.29,351509.82
510624,202211,92,45,47,54544.71,56968.81,111513.52
510625,202211,541,339,202,410946.13,244862.1,655808.23
510626,202211,118,70,48,84847.83,58179,143026.83
510627,202211,95,63,32,76359.58,38786.11,115145.69
510628,202211,170,102,68,123630.97,82416,206046.97
510629,202211,299,181,118,219375.96,143041.1,362417.06
510630,202211,464,239,225,289699.99,272723.87,562423.86
510631,202211,21,8,13,9696.3,15757.16,25453.46
510637,202211,367,212,155,256969.59,187880.43,444850.02
510642,202211,1194,634,560,768484.2,681198.35,1449682.55
510645,202211,11,1,10,1212,12121.34,13333.34
510650,202211,1325,854,471,1035265.79,570925.27,1606191.06
510665,202211,94,45,49,54549.92,59394.69,113944.61
510670,202211,59,34,25,41211.83,30300.55,71512.38
510675,202211,1132,730,402,884891,487283.08,1372174.08
510677,202211,346,180,166,218186.96,201210.29,419397.25
510680,202211,89,56,33,67885.71,40002.21,107887.92
510682,202211,191,96,95,116354.8,115142.93,231497.73
510685,202211,56,41,15,49695.94,18181.66,67877.60
510700,202211,603,339,264,410954.81,320026.13,730980.94
510704,202211,1306,660,646,800049.58,784268.22,1584317.80
510706,202211,166,83,83,100603.48,100605.13,201208.61
510710,202211,444,307,137,372118.58,166053.77,538172.35
510715,202211,58,40,18,48482.06,21816.52,70298.58
510718,202211,251,111,140,134546.57,169696.6,304243.17
510719,202211,52,20,32,24241.27,38788.03,63029.30
510720,202211,188,132,56,160002.49,67881.09,227883.58
510724,202211,83,29,54,35148.61,65448.95,100597.56
510726,202211,66,32,34,38786.42,41212.99,79999.41
510729,202211,18,7,11,8485.95,13334.04,21819.99
510730,202211,465,252,213,305444.86,258175.35,563620.21
510735,202211,115,46,69,55754.42,83632.1,139386.52
510740,202211,24,13,11,15759.09,13333.86,29092.95
510757,202211,30,24,6,29090.42,7272.98,36363.40
510760,202211,7940,3995,3945,4848555.56,4785484.19,9634039.75
510770,202211,746,339,407,412125.48,493336.15,905461.63
510774,202211,19,7,12,8484.73,14545.74,23030.47
510775,202211,120,91,29,110293.95,35148,145441.95
510776,202211,37,12,25,14544.62,30301.63,44846.25
510777,202211,190,84,106,101808,128472,230280
510779,202211,43,25,18,30303.69,21819.19,52122.88
510780,202211,270,141,129,170926.4,156368.54,327294.94
510785,202211,351,191,160,231521,193932.97,425453.97
510787,202211,207,99,108,120004.87,130910.5,250915.37
510788,202211,8,4,4,4848.2,4848,9696.2
510790,202211,2775,1424,1351,1726125.44,1638753.11,3364878.55
510792,202211,1169,651,518,789117.75,627889.11,1417006.86
510794,202211,118,65,53,78788.58,64241.5,143030.08
510795,202211,2401,1368,1033,1658116.47,1252072.41,2910188.88
510800,202211,200,114,86,138178.85,105449.78,243628.63
510805,202211,216,140,76,169688.36,92118.5,261806.86
510810,202211,107,44,63,53332.54,76360.08,129692.62
510820,202211,264,132,132,160015.06,160010.29,320025.35
510830,202211,81,40,41,48480.78,49692,98172.78
510835,202211,23,16,7,19392,8484,27876
510840,202211,9728,4389,5339,5321543.89,6476535.8,11798079.69
510850,202211,215,83,132,100602.42,159991.22,260593.64
510860,202211,413,206,207,249681.44,252105.92,501787.36
510880,202211,76,53,23,64238.42,27876.4,92114.82
510885,202211,73,43,30,52118.62,36361.8,88480.42
510890,202211,77,38,39,46057.97,47270.39,93328.36
510895,202211,174,102,72,123637.32,87267.09,210904.41
520005,202211,160,64,96,77573.23,116362.09,193935.32
520010,202211,315,136,179,164855,216988.55,381843.55
520013,202211,755,510,245,620603.86,296970.28,917574.14
520015,202211,40,27,13,32724.92,15757,48481.92
520017,202211,84,52,32,63031.64,38789.47,101821.11
520020,202211,12,5,7,6061.08,8485.33,14546.41
520025,202211,3020,1600,1420,1940691.21,1722547.92,3663239.13
520030,202211,890,460,430,557897.26,521217.22,1079114.48
520050,202211,65,49,16,59389.69,19393.01,78782.70
520055,202211,79,52,27,63024.7,32724.8,95749.5
520060,202211,175,117,58,141829.74,70308.01,212137.75
520080,202211,576,410,166,496938.79,201198.34,698137.13
520082,202211,17,12,5,14545.47,6061.22,20606.69
520085,202211,109,84,25,101809.59,30301.41,132111.00
520090,202211,85,61,24,73934.63,29089.93,103024.56
520110,202211,9686,4100,5586,4970129.23,6777200.17,11747329.40
520120,202211,12,6,6,7272,7272.68,14544.68
520130,202211,872,606,266,734526.54,322421.36,1056947.90
520140,202211,12604,6844,5760,8299963.26,6985795.43,15285758.69
520145,202211,54,31,23,37574.14,27877.93,65452.07
520150,202211,138,109,29,133341.63,35155.41,168497.04
520160,202211,42,25,17,30301.24,20604,50905.24
520170,202211,219,126,93,152744.64,112740.5,265485.14
520180,202211,202,94,108,113932.41,130904.46,244836.87
520215,202211,196,136,60,164840.67,73936.85,238777.52
520235,202211,85,64,21,77570.29,25452.6,103022.89
520250,202211,149,80,69,98180.33,83631.95,181812.28
520260,202211,117,71,46,86065.68,56974.83,143040.51
520280,202211,49,34,15,41209.19,18182.44,59391.63
520310,202211,21,12,9,14545.84,10908.8,25454.64
520320,202211,184,111,73,134547.33,88481.75,223029.08
520330,202211,879,486,393,589103.28,476398.08,1065501.36
520340,202211,308,179,129,216986.47,156370.33,373356.80
520350,202211,495,251,244,305453.4,296976.21,602429.61
520355,202211,107,61,46,73939.01,55757.14,129696.15
520357,202211,35,28,7,33936.43,8484,42420.43
520360,202211,15,5,10,6060.49,12120.68,18181.17
520380,202211,146,80,66,96962.77,79993.88,176956.65
520390,202211,240,107,133,129713.26,161224.9,290938.16
520393,202211,17,13,4,15757.36,4848.67,20606.03
520396,202211,75,54,21,65448.56,25452.34,90900.90
520400,202211,213,131,82,158795.3,99399.69,258194.99
520410,202211,194,96,98,116367.31,118785.08,235152.39
520420,202211,19,13,6,15756.2,7272.64,23028.84
520425,202211,255,124,131,150309.53,158794.56,309104.09
520430,202211,541,258,283,312718.16,343008.72,655726.88
520440,202211,658,469,189,568498.55,229098.24,797596.79
520450,202211,2254,949,1305,1150316.58,1584240.53,2734557.11
520455,202211,66,39,27,47272.86,32731.66,80004.52
520460,202211,49,30,19,36364.89,23030.27,59395.16
520465,202211,36,29,7,35149.31,8484,43633.31
520470,202211,454,285,169,345453.06,204841.98,550295.04
520480,202211,77,46,31,55761.28,37581.51,93342.79
520485,202211,113,43,70,52124.17,84850.3,136974.47
520490,202211,498,359,139,435163.46,168490.84,603654.30
520495,202211,164,97,67,117567.93,81204.88,198772.81
520500,202211,191,149,42,180602.79,50907.82,231510.61
520505,202211,196,115,81,139384.84,98173.32,237558.16
520510,202211,2074,970,1104,1175781.73,1339396.05,2515177.78
520520,202211,63,41,22,49694.99,27876.44,77571.43
520530,202211,207,166,41,201240.19,49701.29,250941.48
520540,202211,763,513,250,621799,304233.37,926032.37
520545,202211,149,84,65,101823.79,78793.28,180617.07
520547,202211,71,37,34,44850.08,41214.46,86064.54
520549,202211,1541,738,803,894563.1,978204.21,1872767.31
520551,202211,346,173,173,209694.98,210906.58,420601.56
520552,202211,45,30,15,36362.81,18182.03,54544.84
520570,202211,14,9,5,10908,6060,16968
520580,202211,281,173,108,209706.81,130914.01,340620.82
520590,202211,148,83,65,100605.62,78786.86,179392.48
520620,202211,1273,590,683,715164.4,827889.23,1543053.63
520630,202211,48,27,21,32724,25452.2,58176.2
520640,202211,386,226,160,273946.22,193936.71,467882.93
520650,202211,69,34,35,41209.85,42422.15,83632.00
520660,202211,43,22,21,26666.19,25453.52,52119.71
520670,202211,49,38,11,46058.45,13332,59390.45
520680,202211,26,16,10,19396.29,12121.17,31517.46
520690,202211,40,11,29,13334.17,35149.86,48484.03
520710,202211,34,29,5,35148.03,6060,41208.03
520725,202211,197,146,51,176978.65,61822.2,238800.85
520735,202211,58,38,20,46056.77,24241.95,70298.72
520740,202211,488,237,251,287273.11,304241.27,591514.38
520750,202211,35,22,13,26664,15756,42420
520753,202211,79,58,21,70298.56,25452.5,95751.06
520760,202211,101,68,33,82423.96,40001.3,122425.26
520780,202211,269,210,59,254556.68,71518.33,326075.01
520790,202211,155,96,59,116353.6,71509.78,187863.38
520800,202211,3546,1983,1563,2403737.77,1895834.17,4299571.94
520810,202211,140,108,32,130908.65,38788.34,169696.99
520815,202211,6,4,2,4849.7,2424,7273.7
520830,202211,136,92,44,111521.73,53338.7,164860.43
520840,202211,407,263,144,318761.78,174529.79,493291.57
520850,202211,114,63,51,76368.81,61818.9,138187.71
520860,202211,1875,1183,692,1433945.5,839991.96,2273937.46
520870,202211,34489,15601,18888,18918519.51,22905945.85,41824465.36
520880,202211,1311,686,625,831536.02,758805.58,1590341.60
520890,202211,861,539,322,653325.24,390307.71,1043632.95
520910,202211,1028,537,491,650940.49,595183.35,1246123.84
520915,202211,92,67,25,81222,30304.22,111526.22
520920,202211,497,235,262,284854.13,317585.31,602439.44
520929,202211,15,13,2,15756.04,2424.44,18180.48
520940,202211,66,47,19,56966.87,23030.56,79997.43
520945,202211,16,9,7,10908,8485.44,19393.44
520960,202211,44,27,17,32725.65,20604.4,53330.05
520970,202211,431,248,183,300604.63,221821.83,522426.46
520980,202211,91,67,24,81204,29088,110292
520990,202211,445,313,132,379379.68,159992.65,539372.33
520993,202211,127,64,63,77581.78,76374.27,153956.05
520995,202211,267,145,122,175764.1,149094.87,324858.97
521000,202211,1651,907,744,1099410.01,903029.01,2002439.02
521010,202211,646,345,301,418182.18,364867.98,783050.16
521015,202211,11,7,4,8484,4848.11,13332.11
521020,202211,1471,1032,439,1250937.13,533353.73,1784290.86
521030,202211,70,48,22,58178.43,26664.44,84842.87
521040,202211,1003,662,341,802408.05,413341.19,1215749.24
521056,202211,60,38,22,46058.69,26665.59,72724.28
521060,202211,124,80,44,96969.64,53333.8,150303.44
521080,202211,332,260,72,315177.94,87284.22,402462.16
521090,202211,585,394,191,477560.87,231518.28,709079.15
521100,202211,262,189,73,229091.99,88485.55,317577.54
521120,202211,1100,776,324,940594.29,392718.52,1333312.81
521130,202211,331,235,96,284857.93,116371.76,401229.69
521140,202211,195,109,86,132124.89,104241.86,236366.75
521150,202211,2664,1138,1526,1379440.85,1849754.4,3229195.25
521160,202211,26,11,15,13332.99,18183.66,31516.65
521170,202211,238,127,111,153932.1,134542.34,288474.44
521180,202211,1225,774,451,938192.15,546682.98,1484875.13
521190,202211,2660,1104,1556,1338227.58,1887320.2,3225547.78
521200,202211,60,42,18,50905.18,21816,72721.18
521205,202211,12,8,4,9696.4,4848,14544.4
521210,202211,128,78,50,94554.86,60613.27,155168.13
521220,202211,772,528,244,640041.29,295750.21,935791.50
521225,202211,22,15,7,18187.52,8485.73,26673.25
521230,202211,106,68,38,82433.86,46061.69,128495.55
521250,202211,6650,3630,3020,4404024.84,3662049.3,8066074.14
521260,202211,42,19,23,23028.2,27877.9,50906.1
521270,202211,128,97,31,117565.34,37572.89,155138.23
521280,202211,429,269,160,326057.83,193944.66,520002.49
521290,202211,28,17,11,20605.68,13333.05,33938.73
521295,202211,107,70,37,84851.8,44848.41,129700.21
521300,202211,243,134,109,162425.7,132119.97,294545.67
521305,202211,45,32,13,38789.17,15757.62,54546.79
521308,202211,1033,791,242,958817.59,294554.09,1253371.68
521310,202211,1425,800,625,969790.33,758823.66,1728613.99
521340,202211,21,16,5,19393.32,6060.44,25453.76
521350,202211,114,84,30,101821.21,36365.43,138186.64
521370,202211,169,112,57,135753.09,69087.58,204840.67
521375,202211,202,99,103,120005.85,124850.76,244856.61
521377,202211,49,37,12,44850.29,14545.43,59395.72
521380,202211,1112,655,457,793973.91,553947.19,1347921.10
521385,202211,12,7,5,8484,6060,14544
521390,202211,108,85,23,103028.67,27879.32,130907.99
521400,202211,393,277,116,335747.72,140601.91,476349.63
521405,202211,161,98,63,119995.91,76361.02,196356.93
521410,202211,83,60,23,72724.23,27877.75,100601.98
521440,202211,217,150,67,181829.13,81218.55,263047.68
521450,202211,809,446,363,540600.29,441217.34,981817.63
521460,202211,1125,768,357,932153.45,433964.63,1366118.08
521470,202211,12,8,4,9697.38,4848.44,14545.82
521480,202211,42,29,13,35154.96,15758.65,50913.61
521483,202211,336,214,122,259391.27,147880.51,407271.78
521486,202211,303,199,104,242404.97,126052.48,368457.45
521487,202211,22,11,11,13333.32,13332.44,26665.76
521490,202211,25,15,10,18180.44,12120.11,30300.55
521500,202211,144,62,82,75154.57,99394.56,174549.13
521520,202211,44,33,11,39996,13332,53328
521523,202211,1115,608,507,736943.94,615723.24,1352667.18
521525,202211,60,42,18,50904,21816.89,72720.89
521530,202211,248,142,106,172123.77,128485.47,300609.24
521540,202211,44,22,22,26664.28,26665.18,53329.46
521550,202211,116,53,63,64243.23,76362.98,140606.21
521560,202211,929,610,319,739426.54,386671.47,1126098.01
521565,202211,71,51,20,61813.81,24240.2,86054.01
521570,202211,573,362,211,438799.09,255759.53,694558.62
521580,202211,52,33,19,40000.05,23028.74,63028.79
521590,202211,38,17,21,20604.03,25453.18,46057.21
521600,202211,27,13,14,15756,16968.78,32724.78
521630,202211,229,117,112,141829.05,135769.05,277598.10
521640,202211,320,168,152,203629.92,184238.38,387868.30
521645,202211,41,21,20,25454.83,24241.65,49696.48
521680,202211,259,157,102,190304.17,123637.24,313941.41
521690,202211,15,13,2,15756,2424,18180
521710,202211,1170,546,624,661813.59,756364.87,1418178.46
521720,202211,625,408,217,494543.26,263025.16,757568.42
521730,202211,717,341,376,413333.32,455757.2,869090.52
521740,202211,918,418,500,506658.05,608489.36,1115147.41
521760,202211,2441,1252,1189,1517706.44,1442495.4,2960201.84
521770,202211,847,520,327,631506.76,396361,1027867.76
521800,202211,2053,1370,683,1660588.35,830307.77,2490896.12
521805,202211,37,22,15,26665.45,18181.67,44847.12
521810,202211,94,52,42,63038.02,50912.47,113950.49
521830,202211,1028,746,282,904259.53,341833.62,1246093.15
521839,202211,75,42,33,50906.44,39996.88,90903.32
521850,202211,1199,597,602,723681.84,729726.45,1453408.29
521860,202211,336,208,128,252118.5,155150.18,407268.68
521870,202211,86,54,32,65448,38784,104232
521878,202211,36,14,22,16968.44,26666.47,43634.91
521880,202211,5186,2256,2930,2739506.46,3555273.88,6294780.34
521890,202211,630,430,200,522417.97,243628.97,766046.94
521900,202211,275,217,58,263022.1,70300.71,333322.81
521910,202211,181,125,56,151531.01,67886.43,219417.44
521920,202211,40,23,17,27876.75,20608.13,48484.88
521925,202211,55,30,25,36360.37,30300,66660.37
521930,202211,1281,708,573,858210.24,694561.45,1552771.69
521935,202211,32,23,9,27879.25,10908.11,38787.36
521940,202211,242,109,133,133336.51,161209.36,294545.87
521945,202211,21,13,8,15757.88,9696.5,25454.38
521950,202211,21,14,7,16968.2,8484,25452.2
521960,202211,71,55,16,66660,19392.44,86052.44
521970,202211,418,269,149,326049.45,180598.03,506647.48
521971,202211,115,59,56,71509.98,67877.16,139387.14
521973,202211,41,18,23,21817.4,27877.99,49695.39
521975,202211,1674,871,803,1055795.31,973382.98,2029178.29
521980,202211,244,164,80,198792.2,96969.61,295761.81
521990,202211,89,61,28,73940.36,33939.69,107880.05
522000,202211,294,196,98,238372.62,118794.7,357167.32
522005,202211,22,12,10,14544.48,12121.01,26665.49
522010,202211,1167,655,512,795176.01,620624.95,1415800.96
522015,202211,57,35,22,42421.65,26664.89,69086.54
522020,202211,911,543,368,658166.04,446047.34,1104213.38
522026,202211,23,16,7,19392.84,8484.44,27877.28
522028,202211,23,19,4,23028.84,4848,27876.84
522040,202211,850,369,481,447289.8,583059.96,1030349.76
522045,202211,2833,1656,1177,2008559.67,1427921.01,3436480.68
522050,202211,163,73,90,88494.42,109091.78,197586.20
522060,202211,556,346,210,419389.45,254543.13,673932.58
522068,202211,112,80,32,96960.47,38784.6,135745.07
522070,202211,17,14,3,16968,3636,20604
522100,202211,39,25,14,30300.44,16968,47268.44
522108,202211,46,34,12,41215.07,14545.29,55760.36
522119,202211,63,36,27,43633.03,32724,76357.03
522130,202211,77,26,51,31519.77,61824.33,93344.10
522140,202211,4388,2274,2114,2756431.55,2562430.6,5318862.15
522145,202211,47,34,13,41209.65,15759.5,56969.15
522150,202211,107,72,35,87268.42,42421.53,129689.95
522155,202211,53,37,16,46057.26,19393.62,65450.88
522157,202211,15,9,6,10908,7272,18180
522160,202211,1716,1028,688,1246082.36,833956.26,2080038.62
522170,202211,417,287,130,347876.98,157580.74,505457.72
522180,202211,31,13,18,15757.76,21817.72,37575.48
522185,202211,2634,1136,1498,1378216.38,1818315.05,3196531.43
522190,202211,71,40,31,48484.5,37575.11,86059.61
522200,202211,331,194,137,235148.28,167266.33,402414.61
522205,202211,148,100,48,121218.09,58186.23,179404.32
522220,202211,145,111,34,134538.22,41209.3,175747.52
522230,202211,32,28,4,33940.61,4848.67,38789.28
530010,202211,58492,29636,28856,35941690.45,35009902.74,70951593.19
110001,202212,535,436,99,528437.45,119988,648425.45
110002,202212,2994,1896,1098,2297997.39,1330786.63,3628784.02
110003,202212,78,60,18,72721.09,21816,94537.09
110004,202212,2165,1469,696,1781667.11,844769.31,2626436.42
110005,202212,448,351,97,425415.45,117564.2,542979.65
110006,202212,445,328,117,397539.42,141804,539343.42
110007,202212,77,63,14,76356.6,16968,93324.6
110008,202212,267,151,116,183013.32,141804.2,324817.52
110009,202212,965,738,227,894462.35,276336.91,1170799.26
110010,202212,1727,981,746,1190200.72,907791.32,2097992.04
110011,202212,1749,1345,404,1630175.83,490867.37,2121043.20
110012,202212,4240,2433,1807,2951261.32,2193733.49,5144994.81
110013,202212,730,576,154,699340.82,186651.76,885992.58
110014,202212,363,322,41,390267.62,49692,439959.62
110015,202212,1397,1063,334,1288374.68,406024.87,1694399.55
110018,202212,1051,649,402,789031.08,488437.2,1277468.28
110020,202212,16901,9345,7556,11332659.96,9166482.81,20499142.77
110025,202212,664,487,177,590248.23,214525.41,804773.64
110026,202212,35,24,11,29088.98,13332,42420.98
110028,202212,1658,1175,483,1425348.92,586618.71,2011967.63
110029,202212,126,113,13,137442.31,15756,153198.31
110030,202212,2475,1602,873,1942674.54,1058081.77,3000756.31
110032,202212,337,258,79,312706.01,95751.73,408457.74
110033,202212,682,485,197,587840.56,238770.11,826610.67
110034,202212,325,240,85,290880.87,103021.07,393901.94
110037,202212,89,79,10,95748.4,12120,107868.4
110040,202212,408,284,124,344208.6,150288,494496.6
110045,202212,984,709,275,859326.53,333301.79,1192628.32
110050,202212,91,80,11,96961.34,13332.33,110293.67
110060,202212,61,39,22,47269.48,26664,73933.48
110070,202212,109,72,37,87264.59,44844,132108.59
110080,202212,551,316,235,382996.98,284820.7,667817.68
110090,202212,27,21,6,25452,7272,32724
110092,202212,117,58,59,70297.42,71508,141805.42
110094,202212,207,140,67,169682.78,81204,250886.78
110100,202212,53,38,15,46056.29,18180.06,64236.35
110110,202212,122,72,50,87267.28,60600,147867.28
110120,202212,65,56,9,67873.36,10908,78781.36
110130,202212,267,216,51,261798.33,63024.4,324822.73
110140,202212,259,187,72,226645.64,87264.1,313909.74
110143,202212,53,44,9,53328,10908,64236
110145,202212,44,32,12,38784.39,14544,53328.39
110146,202212,29,12,17,14544.2,20604,35148.2
110147,202212,40,26,14,31512.76,16968.58,48481.34
110148,202212,32,26,6,31512.72,7272,38784.72
110149,202212,305,209,96,253308.4,116352,369660.4
110150,202212,141,109,32,132108.2,38784,170892.2
110155,202212,10,9,1,10908,1212,12120
110160,202212,66,50,16,60601.21,19392,79993.21
110170,202212,224,168,56,203618.73,67872,271490.73
110175,202212,67,52,15,63024.8,18180,81204.8
110180,202212,84,66,18,79993.58,21816,101809.58
120001,202212,219,161,58,195137.88,70296.25,265434.13
120005,202212,228,132,96,159986.26,116352.1,276338.36
120010,202212,1200,734,466,890828.36,564793.35,1455621.71
120013,202212,171,115,56,139381.02,67872.3,207253.32
120017,202212,135,79,56,95749,69084,164833
120020,202212,3508,2829,679,3431255.99,824172.29,4255428.28
120025,202212,597,325,272,393929.08,329673.53,723602.61
120030,202212,1190,1024,166,1242360.27,201201.99,1443562.26
120032,202212,43,38,5,46056.55,6060,52116.55
120033,202212,223,193,30,233924.13,36360.55,270284.68
120034,202212,180,133,47,161198.27,56964,218162.27
120035,202212,55,48,7,58176.1,8484,66660.1
120038,202212,412,265,147,321190.81,178166.27,499357.08
120039,202212,33,30,3,36361.1,3636,39997.1
120040,202212,15058,10080,4978,12220788.13,6039737.71,18260525.84
120042,202212,46,42,4,50906.05,4848,55754.05
120043,202212,17,5,12,6060,14544,20604
120045,202212,545,346,199,419366.75,241191.29,660558.04
120050,202212,1310,1004,306,1216911.2,370885.81,1587797.01
120060,202212,1520,1269,251,1539301.33,305430.64,1844731.97
120070,202212,423,305,118,369670.14,143016.69,512686.83
120080,202212,202,133,69,161197.97,83628.65,244826.62
130002,202212,164,117,47,141804,56964,198768
130006,202212,106,70,36,84840,43632,128472
130008,202212,131,77,54,93324,65448,158772
130010,202212,173,109,64,133320.45,77568.18,210888.63
130014,202212,305,215,90,260884.13,109080.4,369964.53
130020,202212,146,99,47,119988.8,56964,176952.8
130030,202212,1013,569,444,689634.39,538129.7,1227764.09
130040,202212,390,189,201,229068.8,244824,473892.8
130050,202212,573,303,270,367242.13,327247.55,694489.68
130060,202212,886,596,290,722354.92,351480.7,1073835.62
130063,202212,619,381,238,461772,288456,750228
130068,202212,236,148,88,179377.27,106657.32,286034.59
130070,202212,1382,913,469,1106576.16,568432.9,1675009.06
130080,202212,734,506,228,613279.4,276337.85,889617.25
130083,202212,89,58,31,70296.4,37572,107868.4
130090,202212,320,182,138,220584.2,168468,389052.2
130100,202212,1338,672,666,815687.59,807199.75,1622887.34
130110,202212,828,361,467,438746.83,566005.72,1004752.55
130115,202212,149,75,74,90900,89688,180588
130120,202212,1723,1076,647,1305336.91,784165.29,2089502.20
130130,202212,649,437,212,529644.2,256944,786588.2
130140,202212,1572,1209,363,1465314.84,439956.5,1905271.34
130150,202212,437,389,48,471468.39,58176,529644.39
130160,202212,454,279,175,339360.6,212100,551460.6
130165,202212,140,125,15,151501.63,18180,169681.63
130170,202212,1136,778,358,942886.72,433906.83,1376793.55
130180,202212,277,210,67,254522.19,81204.2,335726.39
130185,202212,2334,1137,1197,1379287.22,1451997.3,2831284.52
130190,202212,3390,2113,1277,2561010.98,1548952.21,4109963.19
130195,202212,297,238,59,288456,71508,359964
130200,202212,217,124,93,150289.11,112716,263005.11
130210,202212,94,45,49,54540,59388,113928
130220,202212,214,156,58,189073.7,70296,259369.7
130230,202212,368,249,119,301788,144228,446016
130240,202212,1378,886,492,1073838.08,596305.88,1670143.96
130250,202212,4951,3200,1751,3878465.83,2122239.06,6000704.89
130255,202212,435,220,215,266640.52,260580.74,527221.26
130260,202212,65981,30470,35511,36944105.91,43074364.68,80018470.59
130270,202212,1564,1074,490,1303016.74,593882.4,1896899.14
130280,202212,147,86,61,104232.2,73932,178164.2
130290,202212,2089,1342,747,1626536.21,905371.86,2531908.07
130300,202212,431,295,136,357541.45,164834.98,522376.43
130310,202212,971,535,436,649633.18,528432.9,1178066.08
130320,202212,559,302,257,366025.2,311484,677509.2
130330,202212,809,534,275,647213.59,333301,980514.59
130340,202212,3621,1971,1650,2388912.83,2001031.95,4389944.78
130350,202212,471,326,145,395112,175740,570852
130353,202212,979,455,524,551472.34,635095.43,1186567.77
130356,202212,843,387,456,469050.29,552675.68,1021725.97
130360,202212,105,83,22,100596.39,26664.1,127260.49
130370,202212,710,560,150,678722.14,181800,860522.14
130380,202212,676,533,143,645999.99,173316.8,819316.79
130390,202212,499,406,93,492072.2,112716,604788.2
130395,202212,178,67,111,81204.3,134532,215736.3
130400,202212,100,79,21,95750.11,25452,121202.11
130406,202212,2247,1295,952,1570763.01,1153826.17,2724589.18
130410,202212,444,232,212,281184,258156,539340
130420,202212,2862,2321,541,2814339.27,656906.09,3471245.36
130423,202212,232,154,78,186653.12,95748,282401.12
130426,202212,191,105,86,127260.2,104232,231492.2
130430,202212,449,264,185,319968.8,224220,544188.8
130440,202212,206,72,134,87266.42,162409.3,249675.72
140002,202212,55,16,39,19392.2,47269.03,66661.23
140005,202212,234,135,99,163622.85,119990,283612.85
140010,202212,12662,7380,5282,8950970.3,6412844.18,15363814.48
140015,202212,180,74,106,89691.19,128472.92,218164.11
140017,202212,150,81,69,98180.08,83630.53,181810.61
140020,202212,456,297,159,361186.55,192712.03,553898.58
140023,202212,72,43,29,52116.65,35148,87264.65
140028,202212,25,15,10,18180.22,12121.43,30301.65
140030,202212,425,272,153,329670.84,185436.7,515107.54
140040,202212,77,51,26,61812,31512,93324
140045,202212,343,107,236,129684.72,286034.96,415719.68
140047,202212,584,373,211,452082.3,255733.84,707816.14
140050,202212,147,92,55,112719.31,66660.2,179379.51
140060,202212,91,63,28,76357.68,33936.2,110293.88
140070,202212,25,22,3,26664.2,3636,30300.2
150010,202212,5312,3194,2118,3871211.31,2567045.16,6438256.47
150013,202212,174,116,58,140592.48,70296.99,210889.47
150020,202212,1182,658,524,798719.26,635089.93,1433809.19
150030,202212,716,314,402,380577.46,487226.79,867804.25
150034,202212,215,122,93,147865.7,112716.5,260582.2
150040,202212,1733,985,748,1193856.78,907810.61,2101667.39
150050,202212,763,446,317,540556.9,384205.16,924762.06
150060,202212,5178,3210,1968,3894141.34,2389385.54,6283526.88
150070,202212,507,272,235,329667.24,284821.75,614488.99
150080,202212,18718,8707,10011,10558184.66,12142100.07,22700284.73
150085,202212,469,287,182,347852.36,220586.62,568438.98
150090,202212,756,605,151,733275.43,183013.6,916289.03
150095,202212,73,51,22,61814.05,26665.15,88479.20
150100,202212,76,45,31,54540,37572.7,92112.7
150110,202212,216,126,90,152713.78,109080.7,261794.48
150120,202212,415,296,119,358758.85,144229.61,502988.46
150125,202212,48,19,29,23028,35148,58176
150130,202212,2472,1206,1266,1461717.98,1535830,2997547.98
150140,202212,63817,27373,36444,33213647.29,44245082.71,77458730.00
150145,202212,265,143,122,173318.65,147864.1,321182.75
150150,202212,3800,1667,2133,2020464.41,2585239.82,4605704.23
150157,202212,375,271,104,328463.59,126048.46,454512.05
150160,202212,159,117,42,141805.55,50904,192709.55
150170,202212,4297,3104,1193,3762116.15,1448356.41,5210472.56
150172,202212,388,268,120,324819.44,145441.7,470261.14
150175,202212,95,55,40,66660.3,48480,115140.3
150178,202212,810,547,263,664196.44,318760.62,982957.06
150180,202212,3469,1737,1732,2105293.85,2100407.28,4205701.13
150190,202212,406,273,133,332093.74,161197.01,493290.75
150195,202212,136,75,61,90900.8,73932.51,164833.31
150200,202212,193,90,103,109080,124836.3,233916.3
150210,202212,3389,2618,771,3173102.11,935678.72,4108780.83
150215,202212,707,419,288,509053.64,349064.66,858118.30
150220,202212,3665,2424,1241,2939165.63,1506540.82,4445706.45
150230,202212,1456,1167,289,1414431.64,350272.67,1764704.31
150240,202212,7690,4223,3467,5122079.18,4203313.52,9325392.70
150250,202212,84,48,36,58177.45,43632,101809.45
150260,202212,127,87,40,105447.56,48480.8,153928.36
150270,202212,2227,1445,782,1751370.81,947793.37,2699164.18
150275,202212,564,367,197,444811.79,238764.99,683576.78
150276,202212,120,39,81,47268.2,98172.82,145441.02
150277,202212,897,398,499,483600.1,604801.1,1088401.2
150280,202212,345,237,108,287247.37,130896,418143.37
150285,202212,155,76,79,92114.35,95554.08,187668.43
150290,202212,1353,766,587,928410.23,711455.18,1639865.41
150293,202212,868,410,458,496937.93,555104.01,1052041.94
150295,202212,608,287,321,347856.72,389054.58,736911.30
150300,202212,100,46,54,55752.1,65448.6,121200.7
150304,202212,203,117,86,143017.82,104233.25,247251.07
150307,202212,462,381,81,461779.58,98172.5,559952.08
150309,202212,618,432,186,523606.5,225437.08,749043.58
150310,202212,292,195,97,236341.65,117564,353905.65
150320,202212,1994,1374,620,1666523.91,751450.72,2417974.63
150330,202212,2219,1263,956,1530769.66,1158676.74,2689446.40
150340,202212,205,133,72,161196.59,87264.32,248460.91
150345,202212,681,378,303,458141.76,367236,825377.76
150350,202212,433,343,90,415737.65,109082.4,524820.05
150360,202212,5198,3024,2174,3667611.29,2636134.53,6303745.82
150370,202212,864,581,283,704192.73,343001.13,1047193.86
150375,202212,197,83,114,100596.19,138168.18,238764.37
150380,202212,1588,1051,537,1273837.7,653272.5,1927110.2
150390,202212,934,532,402,644808.26,488440.88,1133249.14
150400,202212,121,100,21,121200.4,25452,146652.4
150405,202212,1716,1088,628,1318675.61,762351.48,2081027.09
150410,202212,104,66,38,79992,46056.2,126048.2
150420,202212,8229,4362,3867,5289578,4691775.47,9981353.47
150430,202212,689,428,261,518773.77,316337.47,835111.24
150440,202212,478,291,187,352702.86,226646.47,579349.33
150442,202212,2581,1369,1212,1660487.57,1468965.2,3129452.77
150445,202212,562,368,194,446022.38,235128.2,681150.58
150450,202212,241,141,100,170892.84,121200,292092.84
150460,202212,732,554,178,671468.14,215737.52,887205.66
150470,202212,1335,799,536,968416.2,649637.62,1618053.82
150475,202212,245,189,56,229074.52,67873.19,296947.71
150480,202212,1534,1084,450,1313851.08,547831.87,1861682.95
150490,202212,609,366,243,443596.3,294516,738112.3
150495,202212,362,271,91,328452.78,110292,438744.78
150497,202212,293,190,103,230281.04,124836,355117.04
150500,202212,278,162,116,196345.12,140592.1,336937.22
150503,202212,1438,717,721,869029.74,873862.22,1742891.96
150506,202212,940,646,294,784175.57,356329.32,1140504.89
150510,202212,1388,755,633,915081.48,767202.31,1682283.79
150520,202212,339,231,108,279974.45,130896.8,410871.25
150530,202212,2098,1183,915,1433883.92,1110252.98,2544136.90
150540,202212,234,173,61,210889.59,73932.56,284822.15
150543,202212,933,483,450,585413.98,547833.5,1133247.48
150548,202212,464,335,129,406024.22,156349.7,562373.92
150549,202212,83,53,30,64236.93,36360,100596.93
150550,202212,3366,1708,1658,2073773.22,2010726.45,4084499.67
150553,202212,3951,2201,1750,2670127.49,2122255.7,4792383.19
150555,202212,144,79,65,96960.2,78780.2,175740.4
150560,202212,76,36,40,43632.51,48480,92112.51
150563,202212,130,64,66,77572.49,79993.33,157565.82
150565,202212,227,135,92,163621.1,111504.68,275125.78
150570,202212,433,287,146,347844.86,176952.1,524796.96
150580,202212,1814,895,919,1085962.55,1115041.91,2201004.46
150590,202212,881,586,295,710246.53,357541.61,1067788.14
150600,202212,526,326,200,395125.56,242404.96,637530.52
150610,202212,183,143,40,173317.52,48480,221797.52
150611,202212,154,105,49,127260,59388,186648
150613,202212,3614,2003,1611,2428930.16,1952635.74,4381565.90
150616,202212,623,335,288,406026.62,349059.12,755085.74
150618,202212,1456,747,709,905371.26,859308.85,1764680.11
150619,202212,412,312,100,378146.73,121203.31,499350.04
150620,202212,1325,755,570,916293.34,692056.13,1608349.47
150630,202212,178,114,64,139389.02,77569.57,216958.59
150635,202212,486,218,268,264222.77,326029.97,590252.74
150640,202212,47,22,25,26666.19,30300,56966.19
150650,202212,2590,1481,1109,1796246.36,1344137.77,3140384.13
150655,202212,281,203,78,246037,94536,340573
150658,202212,72,40,32,48480.2,38784,87264.2
150660,202212,639,397,242,481170.96,293305.61,774476.57
150670,202212,1194,431,763,522378.41,924764.73,1447143.14
150680,202212,11783,6145,5638,7451628.78,6835836.86,14287465.64
150690,202212,43,20,23,24240.84,27876,52116.84
150700,202212,575,384,191,465426.77,231495.87,696922.64
150710,202212,298,169,129,204831.86,156349.94,361181.80
150715,202212,851,534,317,647223.32,385419.21,1032642.53
150720,202212,443,336,107,407237.25,129684.73,536921.98
150730,202212,1204,560,644,678732.89,780536,1459268.89
150740,202212,262,168,94,203617.45,113928,317545.45
150745,202212,845,470,375,569654.74,454504.23,1024158.97
150746,202212,72,34,38,41208,46056.2,87264.2
150747,202212,269,187,82,226648.37,99384.67,326033.04
150750,202212,144,78,66,94539.5,79994.6,174534.1
150760,202212,1945,1272,673,1544110.46,816895.59,2361006.05
150770,202212,417,242,175,293305.52,212100.2,505405.72
150775,202212,106,56,50,67873.41,60600.64,128474.05
150780,202212,211,122,89,147866.38,107868,255734.38
150790,202212,723,417,306,505413.49,370875.33,876288.82
150795,202212,1802,1099,703,1333222.11,852044.44,2185266.55
150796,202212,329,189,140,229068.38,169680.81,398749.19
150797,202212,418,192,226,233921.58,276336.54,510258.12
150800,202212,1739,964,775,1169595.17,941726.15,2111321.32
150803,202212,375,275,100,334522.47,121201.72,455724.19
150805,202212,219,129,90,156348.85,109080.7,265429.55
150808,202212,1158,576,582,698116.34,705387.59,1403503.93
150810,202212,3289,2211,1078,2679797.41,1308967.27,3988764.68
150812,202212,560,290,270,352696.86,327241.47,679938.33
150815,202212,1297,801,496,970821.04,602367.29,1573188.33
150820,202212,1767,1055,712,1278705.4,864174.79,2142880.19
150830,202212,596,449,147,545414.3,178165.87,723580.17
150835,202212,252,154,98,186650.13,118776,305426.13
150840,202212,1539,884,655,1071430.6,793873.67,1865304.27
160005,202212,70,47,23,56964.76,27876.12,84840.88
160010,202212,210,131,79,158776.88,95749.06,254525.94
160015,202212,187,123,64,149086.11,77569.62,226655.73
160020,202212,151,75,76,92113.21,92112.92,184226.13
160021,202212,69,30,39,36361.45,47268.39,83629.84
160023,202212,76,45,31,54541.69,37572.34,92114.03
160025,202212,27,13,14,15756.72,16968.22,32724.94
160027,202212,1557,861,696,1043577.23,843562.83,1887140.06
160030,202212,18120,9261,8859,11229601.67,10745788.6,21975390.27
160040,202212,345,212,133,258160.33,161197.3,419357.63
160050,202212,797,365,432,442393.65,523593.08,965986.73
160053,202212,308,180,128,218167.62,155138.62,373306.24
160055,202212,26,18,8,21817.49,9697.72,31515.21
160060,202212,7159,3877,3282,4700321.1,3977858.48,8678179.58
160070,202212,193,110,83,133321.43,100598.36,233919.79
160080,202212,151,76,75,93324.81,90900.74,184225.55
170025,202212,26,14,12,16968,14544.62,31512.62
170030,202212,172,138,34,167262.16,41208,208470.16
170035,202212,205,100,105,121204.61,127261.26,248465.87
170040,202212,183,136,47,164832,56964,221796
170070,202212,333,210,123,254525.75,149077.27,403603.02
170100,202212,360,260,100,315129.92,121200.19,436330.11
170105,202212,39,34,5,41208.51,6060,47268.51
170110,202212,115,70,45,84840.79,54540.1,139380.89
170130,202212,83,40,43,48480,52116,100596
170190,202212,104,60,44,72720.98,53328,126048.98
170200,202212,347,234,113,283610.33,136956,420566.33
170210,202212,6986,3821,3165,4630860.97,3837230.62,8468091.59
170215,202212,171,97,74,117565.25,89689.35,207254.60
170220,202212,1361,971,390,1176870.56,473897.14,1650767.70
170230,202212,147,98,49,118778.04,59388.3,178166.34
170240,202212,505,348,157,421792.63,190286.22,612078.85
170255,202212,1017,800,217,970826.57,264216.8,1235043.37
170270,202212,43,30,13,36360,15756,52116
170290,202212,143,89,54,107870.32,65448,173318.32
170300,202212,119,78,41,94536.2,49692.71,144228.91
170305,202212,54,43,11,52116,13332,65448
170307,202212,58,42,16,50905.86,19392.9,70298.76
170310,202212,127,78,49,94537.7,59388,153925.7
170320,202212,40,25,15,30300.2,18180,48480.2
170330,202212,33,23,10,27876.53,12120.1,39996.63
170360,202212,33,19,14,23028.2,16969.26,39997.46
170370,202212,76,41,35,49693.92,42420,92113.92
170380,202212,83,62,21,75144.3,25452,100596.3
170382,202212,38,31,7,37572,8484,46056
170384,202212,145,111,34,134533.59,41208.2,175741.79
170386,202212,70,30,40,36360.22,48480,84840.22
170388,202212,47,21,26,25452,31512,56964
170389,202212,26,20,6,24240.4,7272.2,31512.6
170390,202212,82,49,33,59388.84,39996,99384.84
170410,202212,24,22,2,26665.16,2424,29089.16
170460,202212,14,8,6,9696.63,7272,16968.63
170510,202212,32,24,8,30301.1,9696,39997.1
170550,202212,1619,933,686,1132032.96,832652.4,1964685.36
170555,202212,109,81,28,98176.18,33936,132112.18
170560,202212,103,75,28,90900.2,33936,124836.2
170600,202212,42,15,27,18180.98,33936,52116.98
170610,202212,189,102,87,123626.89,105444.2,229071.09
170625,202212,32,19,13,23028.99,15756,38784.99
170650,202212,97,67,30,81204,36360.2,117564.2
170700,202212,583,431,152,523589.13,184224,707813.13
170710,202212,146,86,60,104234.86,72722.5,176957.36
170720,202212,112,85,27,103020.81,32724,135744.81
170730,202212,112,66,46,79992.2,55752,135744.2
170740,202212,85,62,23,75144,27876,103020
170755,202212,51,28,23,33937.51,27876.2,61813.71
170765,202212,137,79,58,95749.85,70296,166045.85
170770,202212,197,127,70,153925.59,84840.73,238766.32
170820,202212,607,399,208,483594.51,252098.29,735692.80
170825,202212,48,29,19,35148.12,23028,58176.12
170830,202212,92,70,22,84840.2,26664,111504.2
170900,202212,168,128,40,155137.36,48480.6,203617.96
170930,202212,1010,554,456,671467.94,552678.18,1224146.12
170950,202212,3352,1586,1766,1924701.48,2141624.52,4066326.00
170980,202212,15,9,6,10908.11,7272,18180.11
171050,202212,148,114,34,138168,41208,179376
171070,202212,63,51,12,61812.77,14544.38,76357.15
171090,202212,49,37,12,44844,14544,59388
171110,202212,24,18,6,21817.05,7272,29089.05
171150,202212,43,28,15,33936,18180,52116
171180,202212,24,11,13,13332.2,15757,29089.2
171190,202212,189,105,84,127261.2,101808,229069.2
171195,202212,58,47,11,56964.77,13332,70296.77
171200,202212,32,15,17,18180,20604,38784
171215,202212,10,8,2,9696,2424,12120
171240,202212,67,50,17,60600,20604.6,81204.6
171245,202212,54,47,7,56965.7,8484,65449.7
171250,202212,78,43,35,52116.2,42420,94536.2
171270,202212,11,7,4,8484.6,4848.22,13332.82
171280,202212,46,37,9,44845.96,10908.1,55754.06
171320,202212,1067,620,447,752661.57,544188.63,1296850.20
171330,202212,439,226,213,273913.6,258156.1,532069.7
171360,202212,103,73,30,88476,36360,124836
171370,202212,39,21,18,25452,21816.2,47268.2
171380,202212,136,115,21,139382.27,25452,164834.27
171395,202212,41,25,16,30300,19392,49692
171420,202212,265,175,90,212101.56,109080.2,321181.76
171430,202212,75,59,16,71508,19392.05,90900.05
171488,202212,214,119,95,144228.58,115140,259368.58
171500,202212,66,37,29,44844,35148,79992
171510,202212,74,48,26,58176,31512.52,89688.52
171515,202212,39,32,7,38785.71,8484,47269.71
171525,202212,25,22,3,26665.28,3636,30301.28
171550,202212,16,10,6,12120.4,7272,19392.4
171570,202212,56,27,29,32724,35148.1,67872.1
171575,202212,269,183,86,221797.88,104232,326029.88
171610,202212,1975,1017,958,1233839.08,1162325.86,2396164.94
171620,202212,155,110,45,133321.2,54540,187861.2
171630,202212,50,28,22,33936,26664,60600
171650,202212,353,243,110,294526.59,133320.93,427847.52
171660,202212,265,151,114,183018.11,138168.6,321186.71
171665,202212,90,56,34,69085.08,41208.33,110293.41
171670,202212,453,282,171,341788.84,207253.74,549042.58
171700,202212,63,54,9,65448.26,10908,76356.26
171720,202212,29,10,19,12120.4,23028.2,35148.6
171750,202212,102,50,52,60600,63024.2,123624.2
171780,202212,78,61,17,73932.4,20604,94536.4
171790,202212,94,75,19,90900,23028,113928
171800,202212,34,27,7,32724,8484,41208
171820,202212,2168,1247,921,1511393.69,1118681.15,2630074.84
171830,202212,32,25,7,30300.2,8484,38784.2
171840,202212,55,35,20,42420.76,24240,66660.76
171845,202212,32,21,11,25452.98,13332,38784.98
171850,202212,46,37,9,44846.02,10908.2,55754.22
171855,202212,73,52,21,63024.1,25452,88476.1
171865,202212,6,4,2,4848,2424,7272
171870,202212,37,25,12,30300.1,14544.45,44844.55
171875,202212,88,63,25,76356,30300,106656
171880,202212,47,30,17,36360,20604.72,56964.72
171884,202212,57,31,26,37572.93,31512,69084.93
171886,202212,135,60,75,73932.97,90900,164832.97
171888,202212,28,21,7,25452.16,8484.1,33936.26
171889,202212,15,7,8,8484,9696,18180
171890,202212,58,47,11,56964.13,13332,70296.13
171900,202212,29,20,9,24240.91,10908,35148.91
172000,202212,35,30,5,36360.2,6060,42420.2
172010,202212,54,41,13,49692,15756,65448
172015,202212,19,14,5,16968.32,6060,23028.32
172020,202212,126,79,47,96960.21,56964,153924.21
172025,202212,41,27,14,32724.46,16968,49692.46
172030,202212,53,33,20,39997.74,24240,64237.74
172049,202212,80,51,29,61812.54,35148.2,96960.74
172065,202212,110,73,37,88478.06,44844.46,133322.52
172080,202212,126,76,50,92112.72,60600.65,152713.37
172085,202212,31,16,15,19392,18180,37572
172090,202212,458,332,126,402390.72,152712,555102.72
172093,202212,17,15,2,18180,2424,20604
172097,202212,17,9,8,10908,9696,20604
172100,202212,6166,3539,2627,4290594.39,3185182.77,7475777.16
172110,202212,85,57,28,69084.5,33936,103020.5
172120,202212,1771,1469,302,1780487.75,366028,2146515.75
172125,202212,15,12,3,14544,3636,18180
172130,202212,31,20,11,24240,13332.3,37572.3
172208,202212,202,129,73,156348.2,88476.88,244825.08
172210,202212,352,182,170,220586.68,207253.1,427839.78
210005,202212,3129,1968,1161,2385305.51,1407158.79,3792464.30
210010,202212,150,100,50,121201.12,60600,181801.12
210015,202212,43,31,12,37572.39,14544,52116.39
210020,202212,382,223,159,270278.54,192708.82,462987.36
210030,202212,318,219,99,266655.36,119991.49,386646.85
210040,202212,122,100,22,121200.1,26664,147864.1
210043,202212,272,222,50,269068.62,60600,329668.62
210047,202212,495,312,183,378145.15,221796,599941.15
210050,202212,273,194,79,235128,95748.2,330876.2
210055,202212,58,48,10,58176.79,12120,70296.79
210060,202212,544,439,105,532086.05,128474,660560.05
210070,202212,458,353,105,429048,128472.8,557520.8
210080,202212,148,137,11,166046.14,13332,179378.14
210083,202212,295,149,146,180588.99,176952.19,357541.18
210087,202212,9,6,3,7272,3636,10908
210090,202212,484,353,131,427852.42,158775.48,586627.90
210095,202212,426,338,88,409660.06,106657.31,516317.37
210100,202212,705,566,139,686000.02,168468.2,854468.22
210110,202212,114,81,33,98173.35,39996,138169.35
210120,202212,4882,3924,958,4758513.76,1163535.54,5922049.30
210125,202212,172,107,65,129684.8,78780.99,208465.79
210130,202212,454,275,179,333306.99,216949.13,550256.12
210135,202212,26,21,5,25453.48,6060,31513.48
210140,202212,4573,3498,1075,4242109.75,1305341.24,5547450.99
210150,202212,369,234,135,283618.76,163623.95,447242.71
210160,202212,3257,2775,482,3364589.99,585402.13,3949992.12
210170,202212,1262,1025,237,1242344.56,288458.23,1530802.79
210173,202212,131,119,12,144229.56,14544,158773.56
210177,202212,293,169,124,204829.46,150288,355117.46
210180,202212,31,17,14,20604.2,16968,37572.2
210190,202212,450,309,141,374508.43,170892.7,545401.13
210193,202212,6,4,2,4848.09,2424,7272.09
210197,202212,66,49,17,59388.2,20604.2,79992.4
210200,202212,614,526,88,637528.9,106656.1,744185.0
210203,202212,226,163,63,197559.68,76357.12,273916.80
210207,202212,315,273,42,330881.53,50904,381785.53
210210,202212,705,657,48,796291.8,58176.6,854468.4
210215,202212,77,69,8,83629.98,9696,93325.98
210220,202212,352,302,50,366035.07,60601.59,426636.66
210230,202212,318,261,57,316335.49,69084,385419.49
210232,202212,1230,889,341,1078699.95,413293.45,1491993.40
210235,202212,188,141,47,170895.95,56964.4,227860.35
210237,202212,48,25,23,30301.16,27876,58177.16
210240,202212,75,65,10,78780.21,12120.21,90900.42
210250,202212,184,161,23,195132.26,27876.2,223008.46
210255,202212,397,295,102,357549.22,123625.85,481175.07
210260,202212,390,277,113,335727.17,136956,472683.17
210270,202212,627,442,185,535711.38,224220.59,759931.97
210275,202212,101,79,22,95749.11,26664,122413.11
210280,202212,1094,722,372,876288.73,450864.98,1327153.71
210290,202212,542,364,178,441174.6,215737.6,656912.2
210300,202212,4904,3194,1710,3871196.91,2072526.96,5943723.87
210310,202212,126,80,46,96960.2,55752,152712.2
210312,202212,119,86,33,104232.78,39996.8,144229.58
210315,202212,122,105,17,127260.89,20604,147864.89
210317,202212,145,112,33,135744,39996,175740
210320,202212,2433,2090,343,2533146.47,415716.54,2948863.01
210325,202212,152,91,61,110294.58,73932.49,184227.07
210330,202212,4223,2494,1729,3022785.69,2096765.4,5119551.09
210340,202212,1210,936,274,1135679.02,332090.24,1467769.26
210350,202212,683,571,112,692061.41,136956,829017.41
210355,202212,148,126,22,152713.16,26664,179377.16
210360,202212,2050,1487,563,1802285.77,683572.31,2485858.08
210370,202212,1249,659,590,798717.77,715083.23,1513801.00
210375,202212,191,95,96,115147.45,116353.29,231500.74
210380,202212,735,575,160,696905.9,193922.12,890828.02
210390,202212,196,164,32,198770.39,38784,237554.39
210400,202212,413,362,51,438754.6,61812,500566.6
210405,202212,1109,788,321,955071.03,389054.25,1344125.28
210407,202212,73,61,12,73932.2,14544,88476.2
210408,202212,47,42,5,50906.04,6060,56966.04
210409,202212,342,298,44,362391.34,53328.4,415719.74
210410,202212,442,351,91,426625.33,110292,536917.33
210420,202212,202,163,39,197557.56,47268.84,244826.40
210430,202212,56,41,15,49692.5,18180,67872.5
210440,202212,374,253,121,306645.03,146652.2,453297.23
210450,202212,110,96,14,116355.69,16968,133323.69
210455,202212,244,129,115,156352.77,139381.87,295734.64
210460,202212,314,213,101,258160.8,122412.25,380573.05
210462,202212,76,63,13,76356.64,15756.9,92113.54
210465,202212,127,102,25,123625.36,30300,153925.36
210467,202212,557,420,137,509050.97,166045.86,675096.83
210470,202212,43,37,6,44844,7272,52116
210480,202212,1352,981,371,1188998.73,449655.8,1638654.53
210490,202212,186,134,52,162410.12,63025,225435.12
210500,202212,503,325,178,393912.33,215738.28,609650.61
210510,202212,526,433,93,524798.9,112717.92,637516.82
210515,202212,335,221,114,267853.3,138168.2,406021.5
210520,202212,401,364,37,441174.1,44844,486018.1
210530,202212,9904,5055,4849,6129318.78,5879571.86,12008890.64
210535,202212,121,92,29,111504.97,35148,146652.97
210540,202212,1551,1054,497,1278698.26,602367.39,1881065.65
210542,202212,1094,560,534,678739.65,648431.97,1327171.62
210545,202212,23,21,2,25452.71,2424,27876.71
210547,202212,125,110,15,133321.93,18180.31,151502.24
210550,202212,587,415,172,504210.36,208466.01,712676.37
210560,202212,161,140,21,169681.55,25452.2,195133.75
210565,202212,24,17,7,20604.69,8484.95,29089.64
210570,202212,1304,1103,201,1336858.21,243613.34,1580471.55
210580,202212,128,111,17,134532,20604.16,155136.16
210590,202212,683,571,112,693266.9,138168,831434.9
210592,202212,47,43,4,52116,4848,56964
210594,202212,108,94,14,113928.6,16968,130896.6
210596,202212,117,102,15,123624.4,18180,141804.4
210598,202212,138,106,32,128472,38784.58,167256.58
210600,202212,299,257,42,311491.37,50904.96,362396.33
210610,202212,244,225,19,272705.83,23029.11,295734.94
210620,202212,43,30,13,36360.22,15756,52116.22
210630,202212,89,79,10,95748.2,12120.2,107868.4
210632,202212,976,703,273,853251.4,330876.2,1184127.6
210635,202212,25,22,3,26664.2,3636.2,30300.4
210637,202212,121,88,33,106656.2,39996,146652.2
210640,202212,568,507,61,614486.24,73932,688418.24
210650,202212,406,342,64,414511.14,77568,492079.14
210660,202212,374,300,74,363615.26,89689.18,453304.44
210663,202212,67,54,13,65448,15756,81204
210667,202212,81,39,42,47268.91,50904.37,98173.28
210670,202212,255,228,27,276338.85,32724.6,309063.45
210675,202212,486,282,204,341791.51,247249.41,589040.92
210680,202212,235,154,81,186650.42,98172,284822.42
210690,202212,93,85,8,103021.13,9696,112717.13
210700,202212,154,117,37,141805.15,44844.2,186649.35
210710,202212,249,158,91,191497.43,110292.6,301790.03
210720,202212,128,116,12,140592.6,14544,155136.6
210725,202212,60,51,9,61815.68,10908,72723.68
210730,202212,22,16,6,19392,7272,26664
210735,202212,285,207,78,250884.72,94536,345420.72
210740,202212,516,447,69,541783.01,83628,625411.01
210745,202212,155,120,35,145440.7,42420,187860.7
210750,202212,2714,1469,1245,1781678.44,1510166.3,3291844.74
210760,202212,257,203,54,246037.03,65448.19,311485.22
210770,202212,246,203,43,246048.7,52118.24,298166.94
210780,202212,415,315,100,381791.58,122413.2,504204.78
210790,202212,192,164,28,198770.18,33936,232706.18
210800,202212,183,137,46,166051.96,55753.17,221805.13
210805,202212,66,59,7,71508,8484,79992
210810,202212,439,360,79,436331.55,95748,532079.55
210820,202212,1967,1660,307,2011982.16,372088.29,2384070.45
210825,202212,150,92,58,111505.2,71508.2,183013.4
210830,202212,697,496,201,601157.37,243613.44,844770.81
210840,202212,208,153,55,185437.05,66660,252097.05
210845,202212,227,175,52,212101.82,63024,275125.82
210850,202212,718,513,205,621775.64,248463.37,870239.01
210860,202212,3426,2066,1360,2504038.5,1648327.07,4152365.57
210870,202212,389,312,77,378157.52,93324.2,471481.72
210880,202212,81,65,16,78783.04,19392.2,98175.24
210890,202212,318,279,39,338157.46,47268,385425.46
210900,202212,707,455,252,551475.02,305426.95,856901.97
210905,202212,69,41,28,49692.6,33936,83628.6
210910,202212,2114,1598,516,1936811.26,627822.5,2564633.76
210920,202212,142,64,78,77569.82,94536,172105.82
210923,202212,78,64,14,77568.93,16968,94536.93
210927,202212,412,215,197,260581.77,238764.2,499345.97
210930,202212,75,64,11,77568.4,13332,90900.4
210940,202212,74,58,16,70297.49,19392,89689.49
210945,202212,202,122,80,147866.6,96960,244826.6
210950,202212,519,387,132,469045.97,159984.65,629030.62
210955,202212,92,54,38,65448.2,46056.2,111504.4
210960,202212,2410,1245,1165,1508954.66,1411982.39,2920937.05
210970,202212,108,92,16,111504.86,19392.9,130897.76
210975,202212,78,74,4,89688.2,4848.95,94537.15
210980,202212,1043,531,512,643586.46,620547.9,1264134.36
210990,202212,4400,3127,1273,3790009.79,1544106.05,5334115.84
211000,202212,1290,1064,226,1289597.96,273915.6,1563513.56
211003,202212,965,714,251,866593.05,304212.56,1170805.61
211010,202212,491,446,45,540557.3,54540.4,595097.7
211020,202212,1364,625,739,757513.05,896892.79,1654405.84
211023,202212,45,39,6,47268.4,7272,54540.4
211027,202212,78,60,18,72720.4,21816,94536.4
211030,202212,362,259,103,315122.31,124836,439958.31
211040,202212,293,248,45,300577.66,54540,355117.66
211050,202212,1123,778,345,942961.04,418142.33,1361103.37
211060,202212,620,548,72,664202.19,87264.4,751466.59
211065,202212,26,20,6,24241.69,7272.88,31514.57
211070,202212,840,705,135,854491.64,163620.8,1018112.44
211080,202212,88,85,3,103020.56,3636,106656.56
211085,202212,63,34,29,41208,35148,76356
211090,202212,81,71,10,86053.02,12120,98173.02
211100,202212,466,399,67,483600.83,81204.4,564805.23
211102,202212,225,165,60,199980.4,72720,272700.4
211105,202212,223,160,63,193920.6,76356.65,270277.25
211107,202212,129,81,48,98172.2,58176,156348.2
211110,202212,981,670,311,812058.09,376937.54,1188995.63
211120,202212,5194,2792,2402,3384059.16,2911265.86,6295325.02
211125,202212,20,13,7,15756,8484,24240
211130,202212,41795,20300,21495,24610579.42,26075311.3,50685890.72
211140,202212,341,305,36,369673.49,43632.47,413305.96
211150,202212,1184,851,333,1031438.53,403598.52,1435037.05
211153,202212,168,98,70,118776,84840,203616
211157,202212,69,56,13,67872,15756,83628
211160,202212,688,581,107,704181.11,129684.85,833865.96
211163,202212,3,2,1,2424,1212,3636
211167,202212,10,10,0,12120,,12120.0
211170,202212,420,314,106,380568.93,128473.35,509042.28
211172,202212,108,79,29,95748.76,35148,130896.76
211174,202212,24,19,5,23028.2,6060.31,29088.51
211176,202212,462,337,125,408450.91,151501.45,559952.36
211178,202212,92,65,27,78780.93,32724,111504.93
211180,202212,213,173,40,209677.59,48480.74,258158.33
211190,202212,71,64,7,77568.2,8484,86052.2
211195,202212,42,28,14,33938.22,16968,50906.22
211200,202212,149,126,23,152712.2,27876.6,180588.8
211210,202212,399,307,92,372090.37,111504.88,483595.25
211220,202212,4400,2642,1758,3203454.84,2130752.57,5334207.41
211223,202212,131,121,10,146655.78,12120,158775.78
211227,202212,57,46,11,55752.2,13332,69084.2
211230,202212,710,588,122,712680.94,147865.01,860545.95
211240,202212,373,313,60,379359.74,72720,452079.74
211245,202212,182,98,84,118777.36,101808,220585.36
211250,202212,1476,1268,208,1536881.14,252099.33,1788980.47
211260,202212,796,684,112,829015.3,135744,964759.3
211270,202212,1846,1536,310,1861667.11,375720.74,2237387.85
211280,202212,1782,1233,549,1496847.29,666600.75,2163448.04
211285,202212,228,150,78,181800.9,94536.6,276337.5
211290,202212,791,556,235,673875.37,284822.84,958698.21
211300,202212,769,619,150,750242.34,183013.04,933255.38
211400,202212,1565,1029,536,1247174.38,649634.5,1896808.88
220005,202212,18,17,1,20604,1212,21816
220010,202212,76,64,12,77568.26,14544,92112.26
220020,202212,743,609,134,738116.76,162409.48,900526.24
220025,202212,104,100,4,121201.94,4848,126049.94
220027,202212,57,46,11,55752.2,13332,69084.2
220030,202212,121,101,20,122413.56,24240.6,146654.16
220040,202212,1295,999,296,1210808.24,361178.92,1571987.16
220045,202212,30,21,9,25452.87,10908.55,36361.42
220050,202212,686,572,114,693278.14,138169.55,831447.69
220060,202212,184,162,22,196347.16,26664.35,223011.51
220070,202212,111,96,15,116355.76,18180.2,134535.96
220080,202212,13,11,2,13332,2424,15756
220090,202212,40,29,11,35148,13332,48480
220095,202212,3,2,1,2424,1212,3636
220100,202212,22,18,4,21816.71,4848,26664.71
220105,202212,31,28,3,33936.94,3636,37572.94
220110,202212,248,228,20,276336.8,24240,300576.8
220115,202212,46,40,6,48480,7272,55752
220117,202212,24,22,2,26664,2424,29088
220120,202212,1518,1171,347,1419272.7,421776.2,1841048.9
220130,202212,23,23,0,27876,,27876.0
220140,202212,85,70,15,84840.4,18180.64,103021.04
220150,202212,488,367,121,444819.26,146654.42,591473.68
220155,202212,22,21,1,25452,1212,26664
220157,202212,22,19,3,23028.4,3636,26664.4
220160,202212,105,92,13,111505.2,15756,127261.2
220170,202212,40,33,7,39996,8484,48480
220173,202212,14,12,2,14544,2424,16968
220177,202212,15,15,0,18180,,18180.0
220180,202212,63,61,2,73933.19,2424,76357.19
220190,202212,1159,993,166,1203531.17,201196.55,1404727.72
220191,202212,38,32,6,38785.07,7272,46057.07
220192,202212,93,86,7,105444.16,8484,113928.16
220194,202212,61,53,8,64236.28,9696,73932.28
220196,202212,78,65,13,78782.83,15756.4,94539.23
220198,202212,2,2,0,2424,,2424.0
220200,202212,402,342,60,415731.24,72722.01,488453.25
220202,202212,34,30,4,36360.88,4848,41208.88
220205,202212,64,55,9,66660.2,10908,77568.2
220207,202212,16,16,0,19392.94,,19392.94
220208,202212,70,44,26,53328.7,31512.2,84840.9
220209,202212,33,27,6,32724,7272,39996
220210,202212,24,20,4,24240,4848,29088
220211,202212,33,32,1,38786.77,1212,39998.77
220213,202212,34,31,3,37573.04,3636,41209.04
220217,202212,41,33,8,39996.3,9696,49692.3
220220,202212,2370,1581,789,1918616.39,959913.7,2878530.09
220225,202212,7,2,5,2424.22,6060,8484.22
220230,202212,996,752,244,911437.85,295733.32,1207171.17
220240,202212,164,146,18,176953.14,21816.32,198769.46
220245,202212,41,38,3,46057.8,3636,49693.8
220250,202212,142,118,24,143018.77,29088,172106.77
220253,202212,49,44,5,53328.25,6060,59388.25
220255,202212,46,39,7,47268.2,8484,55752.2
220260,202212,714,547,167,662972.85,202404.48,865377.33
220265,202212,12,10,2,12120,2424,14544
220270,202212,856,772,84,936884.03,101808,1038692.03
220271,202212,37,28,9,33936.86,10908,44844.86
220272,202212,18,17,1,20604,1212,21816
220273,202212,15,14,1,16968.2,1212,18180.2
220275,202212,66,56,10,67872,12120,79992
220277,202212,29,21,8,25452.85,9696.94,35149.79
220280,202212,19,13,6,15756,7272,23028
220285,202212,43,39,4,47268.28,4848,52116.28
220290,202212,1565,1338,227,1622903.47,275129.18,1898032.65
220300,202212,39,39,0,47270.42,,47270.42
220310,202212,339,287,52,347856.66,63026.01,410882.67
220320,202212,451,414,37,504212.04,44845.68,549057.72
220323,202212,2,1,1,1212.8,1212,2424.8
220325,202212,8,7,1,8484,1212,9696
220327,202212,16,16,0,19392.19,,19392.19
220330,202212,216,154,62,186649.06,75144.7,261793.76
220335,202212,134,114,20,138169.5,24240,162409.5
220340,202212,46,36,10,43632,12120,55752
220342,202212,55,47,8,56966.54,9696,66662.54
220345,202212,88,76,12,92112,14544.3,106656.3
220350,202212,463,405,58,490864.16,70296.35,561160.51
220360,202212,51,34,17,42420,20604,63024
220370,202212,1364,1139,225,1380493.41,273912.54,1654405.95
220375,202212,19,18,1,21817.41,1212,23029.41
220380,202212,25,19,6,23028.9,7272.55,30301.45
220385,202212,15,13,2,15756,2424.66,18180.66
220390,202212,2461,1362,1099,1650784.03,1332008.9,2982792.93
220400,202212,37,31,6,37572,7272,44844
220410,202212,21,20,1,24240.2,1212,25452.2
220415,202212,14,13,1,15756.37,1212,16968.37
220420,202212,124,104,20,126049.95,24240,150289.95
220430,202212,141,124,17,150289.28,20604.2,170893.48
220435,202212,24,18,6,21816.5,7272,29088.5
220440,202212,278,237,41,287254.38,49692,336946.38
220450,202212,359,181,178,219376.57,216954.28,436330.85
220455,202212,53,52,1,63024.4,1212,64236.4
220460,202212,18,17,1,20605.31,1212.21,21817.52
220465,202212,63,41,22,49692.74,26664.41,76357.15
220470,202212,234,206,28,249676.51,33936,283612.51
220480,202212,68,63,5,76356.68,6060,82416.68
220490,202212,86,73,13,88476,15756,104232
220500,202212,122,102,20,123624.36,24240,147864.36
220510,202212,362,283,79,344217.54,95748.88,439966.42
220515,202212,27,25,2,30300.54,2424,32724.54
220520,202212,376,333,43,403603.82,52116.45,455720.27
220525,202212,7,3,4,3636.93,4848.06,8484.99
220527,202212,12,12,0,14544.65,,14544.65
220530,202212,47,23,24,27876,29088.87,56964.87
220535,202212,6,5,1,6060.2,1212,7272.2
220540,202212,103,90,13,109080.8,15756.2,124837.0
220545,202212,25,16,9,19392.33,10908.7,30301.03
220550,202212,740,584,156,707826.22,191497.9,899324.12
220551,202212,12,10,2,12120,2424,14544
220552,202212,13,13,0,15756,,15756.0
220553,202212,58,53,5,64236.87,6060,70296.87
220554,202212,6,4,2,4848.2,2424,7272.2
220555,202212,45,37,8,44844.88,9696,54540.88
220556,202212,42,39,3,47269.24,3636,50905.24
220557,202212,59,53,6,64237.99,8484.74,72722.73
220558,202212,12,6,6,7272,7272,14544
220559,202212,5,5,0,6060,,6060.0
220560,202212,79,51,28,61812.69,33936,95748.69
220570,202212,728,448,280,542981.64,339362.54,882344.18
220580,202212,550,504,46,610875.56,55754.03,666629.59
220585,202212,14,12,2,14544.2,2424.02,16968.22
220590,202212,14,13,1,15756.2,1212,16968.2
220595,202212,75,58,17,70297.06,20604,90901.06
220600,202212,22,16,6,19392,7272,26664
220605,202212,30,27,3,32724.2,3636,36360.2
220610,202212,97,80,17,96960,20604,117564
220620,202212,559,477,82,578136.36,99386.03,677522.39
220630,202212,4,2,2,2424,2424.96,4848.96
220635,202212,33,30,3,36360.83,3636,39996.83
220640,202212,113,93,20,112716,24240,136956
220650,202212,115,109,6,132108.2,7272,139380.2
220660,202212,75,58,17,70298.36,20604.8,90903.16
220665,202212,10,10,0,12120,,12120.0
220667,202212,21,19,2,23028.19,2424,25452.19
220669,202212,35,30,5,36360.2,6060,42420.2
220670,202212,72,56,16,67872.23,19392,87264.23
220672,202212,75,55,20,66662.8,25453.21,92116.01
220675,202212,28,21,7,25453.02,8484,33937.02
220680,202212,59,50,9,60600,10908,71508
220690,202212,46,44,2,53328.67,2424,55752.67
220695,202212,27,16,11,19392.74,13332,32724.74
220700,202212,1897,1466,431,1776812.39,522375.46,2299187.85
220710,202212,7,5,2,6060.42,2424.81,8485.23
220720,202212,112,95,17,115140,20604,135744
220730,202212,26,25,1,30300.68,1212,31512.68
220735,202212,6,3,3,3636,3636,7272
220740,202212,55,47,8,56964.38,9696.91,66661.29
220750,202212,129,109,20,132110.41,24240.21,156350.62
220755,202212,17,17,0,20605.17,,20605.17
220760,202212,68,61,7,73932.99,8484,82416.99
220770,202212,6092,3500,2592,4242151.77,3145208.8,7387360.57
220775,202212,12,8,4,9696.1,4848.13,14544.23
220777,202212,22,21,1,25452,1212,26664
220779,202212,5,1,4,1212,4848,6060
220780,202212,938,794,144,962337.33,174528.88,1136866.21
220785,202212,5,2,3,2424,3636,6060
220790,202212,1229,983,246,1192632.73,298160.48,1490793.21
220793,202212,7,5,2,6060,2424,8484
220795,202212,21,20,1,24240,1212,25452
220800,202212,4126,3154,972,3826564.54,1178073.92,5004638.46
220810,202212,76,65,11,78780.69,13332,92112.69
220820,202212,249,228,21,276342.03,25453.8,301795.83
220830,202212,1321,1161,160,1407148.12,193920.97,1601069.09
220840,202212,2605,1840,765,2231342.66,928409.94,3159752.60
220850,202212,76,66,10,79992,12120,92112
220855,202212,8,4,4,4848,4848,9696
220860,202212,14,12,2,14545.85,2424,16969.85
220865,202212,31,28,3,33936.1,3636,37572.1
220870,202212,91,83,8,100596.91,9696,110292.91
220880,202212,332,275,57,333309.61,69085.4,402395.01
220885,202212,28,27,1,32725.86,1212,33937.86
220887,202212,6,5,1,6060.2,1212,7272.2
220890,202212,90,76,14,92113.4,16968,109081.4
220900,202212,24,12,12,14544,14544,29088
220910,202212,48,38,10,46058.03,12120,58178.03
220915,202212,9,8,1,9696.19,1212,10908.19
220920,202212,51,45,6,54540.82,7272,61812.82
220930,202212,53,51,2,61812.26,2424,64236.26
220935,202212,14,14,0,16968.27,,16968.27
220937,202212,36,31,5,37572.29,6060,43632.29
220940,202212,58,50,8,60600,9696,70296
220945,202212,4,4,0,4848,,4848.0
220950,202212,33,26,7,31512.2,8484,39996.2
220955,202212,17,17,0,20604.72,,20604.72
220960,202212,39,34,5,41208,6060,47268
220965,202212,49,45,4,54540,4848,59388
220970,202212,65,54,11,65448,13332,78780
220975,202212,10,9,1,10908.4,1212,12120.4
220980,202212,27,25,2,30300.26,2424,32724.26
220985,202212,53,45,8,54540,9696,64236
220987,202212,31,30,1,36362.16,1212.63,37574.79
220990,202212,23,23,0,27876,,27876.0
220995,202212,14,12,2,14544,2424,16968
220997,202212,67,59,8,71509.08,9696,81205.08
221000,202212,1308,1162,146,1408370.61,176953.55,1585324.16
221005,202212,44,41,3,49692,3636.87,53328.87
221010,202212,26,18,8,21816,9696,31512
221020,202212,41,36,5,43632.76,6060,49692.76
221030,202212,42,35,7,42324.96,8484,50808.96
221035,202212,22,20,2,24241.33,2424,26665.33
221037,202212,14,10,4,12120,4848,16968
221038,202212,26,23,3,27876,3636,31512
221039,202212,24,23,1,27876.33,1212.2,29088.53
221040,202212,260,221,39,267856.26,47268.2,315124.46
221050,202212,230,194,36,235134.63,43632.2,278766.83
221060,202212,2027,1741,286,2111343.45,349060.81,2460404.26
221062,202212,26,26,0,31512.95,,31512.95
221063,202212,17,13,4,15756,4848,20604
221065,202212,71,57,14,69085.71,16968.41,86054.12
221070,202212,159,138,21,167259.57,25452,192711.57
221080,202212,406,345,61,418147.45,73932,492079.45
221090,202212,24,19,5,23029.05,6060,29089.05
221093,202212,45,30,15,36360.4,18180,54540.4
221095,202212,4,4,0,4848,,4848.0
221097,202212,12,10,2,12120,2424,14544
221100,202212,27692,16516,11176,20027564.49,13556464.41,33584028.90
221110,202212,1178,906,272,1099309.92,330880.78,1430190.70
221120,202212,580,419,161,507836.83,195132.63,702969.46
221130,202212,1025,831,194,1007187.58,235130.86,1242318.44
221135,202212,34,30,4,36360.2,4848,41208.2
221140,202212,48,41,7,49692.2,8484,58176.2
221150,202212,13,9,4,10908.18,4848,15756.18
221160,202212,16,16,0,19393.19,,19393.19
221170,202212,20,19,1,23028,1212,24240
230010,202212,166,143,23,173318.4,27876,201194.4
230015,202212,163,137,26,166044,31512,197556
230020,202212,1861,1497,364,1814394.91,442392.96,2256787.87
230030,202212,1713,1244,469,1507763.41,568432.94,2076196.35
230040,202212,241,192,49,232705.2,59388,292093.2
230050,202212,246,172,74,208464.2,89688.2,298152.4
230060,202212,177,142,35,173316.3,42421.54,215737.84
230070,202212,317,268,49,326030.69,59388,385418.69
230075,202212,951,789,162,956285.77,197558.77,1153844.54
230080,202212,235,190,45,230280.1,54540,284820.1
230090,202212,183,129,54,156349.33,65448,221797.33
230100,202212,2796,1565,1231,1896837.87,1493200.5,3390038.37
230110,202212,3166,1982,1184,2404660.79,1436237.37,3840898.16
230120,202212,1218,928,290,1124756.94,351482.46,1476239.40
230125,202212,180,140,40,169680.2,48480,218160.2
230130,202212,521,453,68,549043.65,82416.95,631460.60
230140,202212,228,183,45,221798.71,54540,276338.71
230150,202212,155,118,37,143017.38,44844.4,187861.78
230160,202212,1020,830,190,1005965.87,230280.68,1236246.55
230170,202212,670,583,87,706612.25,105447.73,812059.98
230180,202212,68,62,6,75144.39,7272,82416.39
230185,202212,425,359,66,435116.43,79993.14,515109.57
230190,202212,2636,1989,647,2413149.64,785383.21,3198532.85
230195,202212,542,459,83,556322.19,100596,656918.19
230200,202212,469,362,107,438749.63,129684.2,568433.83
230205,202212,428,280,148,339360.2,179376.6,518736.8
230210,202212,1477,1120,357,1357459.68,432685.08,1790144.76
230220,202212,1714,1133,581,1373226.99,704183.97,2077410.96
230230,202212,1054,853,201,1033851.16,243614.04,1277465.20
230240,202212,2084,1804,280,2186783.46,339363.4,2526146.86
230250,202212,1903,1539,364,1865313.97,441176.59,2306490.56
230260,202212,3473,2128,1345,2580372.23,1631355.29,4211727.52
230270,202212,1432,1112,320,1347756.48,387842.96,1735599.44
230280,202212,2961,2256,705,2734331.33,854465.14,3588796.47
230290,202212,365,317,48,384212.88,58177.85,442390.73
230300,202212,529,385,144,466622.4,174528.29,641150.69
230310,202212,445,343,102,415716.29,123624.51,539340.80
230320,202212,988,829,159,1004769.43,192709.78,1197479.21
230330,202212,331,268,63,324819.44,76356.4,401175.84
230340,202212,465,373,92,453294.65,112716.4,566011.05
230350,202212,3571,2174,1397,2637371.36,1693179.75,4330551.11
230360,202212,281,229,52,277549.99,63024.75,340574.74
230365,202212,136,109,27,132108.53,32724,164832.53
230370,202212,12228,6113,6115,7414085.49,7413990.91,14828076.40
230380,202212,530,452,78,547832.36,94537.74,642370.10
230390,202212,556,318,238,385420.22,288456.6,673876.82
230393,202212,236,190,46,230280.89,55752.5,286033.39
230395,202212,377,299,78,362402.27,94539.46,456941.73
230400,202212,675,534,141,647215.47,170892.4,818107.87
230410,202212,2956,1852,1104,2247096.67,1339280.56,3586377.23
230420,202212,6882,4515,2367,5476016.47,2873725.91,8349742.38
230423,202212,352,303,49,367239.65,59388.1,426627.75
230425,202212,523,416,107,504199.9,129685.28,633885.18
230426,202212,126,97,29,117564,35148,152712
230427,202212,78,69,9,83628.4,10908,94536.4
230428,202212,1839,890,949,1081125.59,1150194.54,2231320.13
230430,202212,484,387,97,470261.72,117565.9,587827.62
230435,202212,996,712,284,862959.62,345422.39,1208382.01
230440,202212,104051,47643,56408,57781384.94,68412620.07,126194005.01
230445,202212,349,235,114,284826.39,138168.2,422994.59
230450,202212,609,478,131,579337.57,158772.2,738109.77
230460,202212,106,76,30,92113.93,36360,128473.93
230465,202212,331,269,62,326031.41,75144,401175.41
230470,202212,2128,1661,467,2014361.21,567217.22,2581578.43
230480,202212,158,143,15,173316.5,18180.56,191497.06
230490,202212,351,275,76,333301.99,92112.07,425414.06
230495,202212,519,364,155,441178.2,187862.72,629040.92
230500,202212,1187,881,306,1067781.22,370873.13,1438654.35
230510,202212,79,52,27,63024,32724,95748
230520,202212,430,326,104,395114.39,126048.62,521163.01
230523,202212,2748,1671,1077,2025304.88,1306554.46,3331859.34
230526,202212,259,219,40,265429.49,48480,313909.49
230530,202212,716,515,201,624188.4,243615.4,867803.8
230533,202212,220,201,19,243614.93,23028.2,266643.13
230535,202212,435,325,110,393909.87,133320.35,527230.22
230540,202212,1866,1663,203,2015593.74,246038.11,2261631.85
230550,202212,4379,2768,1611,3354947.27,1953784.99,5308732.26
230560,202212,616,465,151,563591.05,183012.57,746603.62
230565,202212,233,172,61,208464,73932.2,282396.2
230570,202212,326,274,52,332090.65,63024.6,395115.25
230580,202212,1276,881,395,1068995.58,481169.73,1550165.31
230590,202212,1109,850,259,1030116.37,313909.14,1344025.51
230600,202212,291,258,33,312701.59,39996,352697.59
230610,202212,489,360,129,436326.95,156348.2,592675.15
230620,202212,182,150,32,181801.55,38784,220585.55
230625,202212,918,617,301,750241.68,366024.3,1116265.98
230630,202212,1548,1161,387,1407159.53,469047.23,1876206.76
230640,202212,4225,3441,784,4171816.75,950236.01,5122052.76
230650,202212,510,436,74,528434.9,89688.19,618123.09
230655,202212,774,615,159,746613.11,192710,939323.11
230660,202212,376,309,67,374513.26,81204.2,455717.46
230670,202212,498,396,102,479968.07,123624.02,603592.09
230680,202212,230,199,31,241191.46,37572,278763.46
230690,202212,1012,846,166,1025373.27,201194,1226567.27
230700,202212,1070,881,189,1070214.83,229068.97,1299283.80
230710,202212,703,644,59,780545.05,71508.56,852053.61
230720,202212,153,130,23,157560,27876.2,185436.2
230725,202212,303,228,75,276338.86,92112.66,368451.52
230730,202212,13745,7249,6496,8789911.11,7879341.93,16669253.04
230740,202212,738,588,150,712676.07,181801.84,894477.91
230750,202212,866,713,153,864167.06,185437.75,1049604.81
230760,202212,1722,1450,272,1759876.78,329667.17,2089543.95
230763,202212,368,302,66,366028.06,81204.93,447232.99
230765,202212,9184,4331,4853,5250621.46,5884447.72,11135069.18
230770,202212,5467,2768,2699,3357340.58,3271224.21,6628564.79
230780,202212,840,726,114,879918.25,138168.1,1018086.35
230790,202212,335,274,61,332088,73932.2,406020.2
230800,202212,1265,892,373,1081116.61,453289.41,1534406.02
230810,202212,1497,1289,208,1562313.3,252098.64,1814411.94
230820,202212,395,259,136,313910.7,164834.49,478745.19
230830,202212,1027,857,170,1038701.09,206040.9,1244741.99
230835,202212,295,239,56,289671.35,67873.36,357544.71
230837,202212,199,160,39,193921.18,47268.67,241189.85
230840,202212,997,758,239,918703.71,289670.19,1208373.90
230850,202212,1466,1233,233,1494432.72,282399.53,1776832.25
230860,202212,347,269,78,326029.25,94542.25,420571.50
230870,202212,1945,1649,296,1999830.18,359964.47,2359794.65
230880,202212,83,66,17,79992,20604,100596
230890,202212,594,522,72,632671.11,87264.88,719935.99
230900,202212,322,239,83,290882.1,100596.88,391478.98
230910,202212,238,185,53,224222.21,64236,288458.21
230920,202212,525,407,118,493289.13,143016,636305.13
230930,202212,1170,808,362,979316.16,438747.59,1418063.75
230940,202212,884,677,207,820540.52,250885.35,1071425.87
230945,202212,598,476,122,576925.94,147868.82,724794.76
230950,202212,463,396,67,479966.55,81204.37,561170.92
230960,202212,3014,1994,1020,2416826.34,1236272.24,3653098.58
230970,202212,1918,1039,879,1259303.99,1066572.9,2325876.89
230980,202212,232,174,58,212101.84,70296,282397.84
230990,202212,148,116,32,140592.25,38784.6,179376.85
231000,202212,219,200,19,243612.68,23028,266640.68
231010,202212,190,130,60,157562.32,72720.02,230282.34
231020,202212,1562,1030,532,1248400.6,646010.83,1894411.43
231025,202212,1203,823,380,997512.11,460571.38,1458083.49
231030,202212,1105,891,214,1079906.11,259369.05,1339275.16
231040,202212,188,127,61,153925.23,73932,227857.23
231050,202212,1001,857,144,1038703.13,174535.07,1213238.20
231060,202212,170,137,33,166047.69,39997.2,206044.89
231070,202212,1603,1096,507,1328375.67,614488.4,1942864.07
231080,202212,279,246,33,298158.68,39996,338154.68
231085,202212,741,454,287,550261.7,347845.11,898106.81
231090,202212,282,223,59,270280.11,71509.64,341789.75
231095,202212,168,125,43,151500,52116.99,203616.99
231100,202212,193,155,38,187860.24,46056,233916.24
231110,202212,391,323,68,391482.02,82417.72,473899.74
231120,202212,264,221,43,267853.2,52117.62,319970.82
231123,202212,152,144,8,174530.21,9696,184226.21
231126,202212,348,270,78,327240.46,94536,421776.46
231130,202212,5222,4021,1201,4876032.11,1456850.92,6332883.03
231135,202212,227,196,31,237554.58,37573.41,275127.99
231140,202212,3233,2303,930,2793725.36,1127172.26,3920897.62
231150,202212,410,380,30,460565.16,36360,496925.16
231160,202212,1327,1078,249,1306554.58,303000.66,1609555.24
231170,202212,550,379,171,459351.37,207252,666603.37
231180,202212,2030,1758,272,2130748.39,329670.02,2460418.41
231190,202212,226,183,43,221796.1,52116,273912.1
231195,202212,249,202,47,244824.6,56964.55,301789.15
231200,202212,892,716,176,867812.72,213315.59,1081128.31
231210,202212,540,453,87,549770.49,105445.39,655215.88
231220,202212,1125,788,337,955075.76,409659.94,1364735.70
231230,202212,1650,1217,433,1478659.4,524797.07,2003456.47
231240,202212,1720,1162,558,1409581.94,676303.72,2085885.66
231250,202212,98,91,7,110294,8484,118778
231260,202212,269,177,92,214525.9,111504.96,326030.86
231270,202212,1060,817,243,990230.77,294517.46,1284748.23
231280,202212,83,63,20,76356.6,24240,100596.6
231290,202212,8587,4764,3823,5780212.16,4637191.88,10417404.04
231300,202212,614,557,57,675090.55,69084,744174.55
231310,202212,873,798,75,968400.33,90900.89,1059301.22
231320,202212,635,472,163,572067.21,197557.62,769624.83
231325,202212,107,90,17,109080,20604.54,129684.54
231330,202212,2076,1568,508,1901668.71,615703.36,2517372.07
231335,202212,262,230,32,278763.24,38784,317547.24
231340,202212,2045,1391,654,1685926.72,792656.58,2478583.30
231350,202212,1510,1181,329,1432626.04,398762.14,1831388.18
231355,202212,439,356,83,431476.58,100596.64,532073.22
231360,202212,602,403,199,489658.06,241189.34,730847.40
231370,202212,101,85,16,103020,19392.12,122412.12
231375,202212,306,229,77,277552.13,93324.56,370876.69
231380,202212,555,439,116,532070.67,140592.2,672662.87
231390,202212,200,153,47,186648.79,56964,243612.79
231395,202212,831,491,340,595093.5,412080.3,1007173.8
231400,202212,1275,1049,226,1271405.44,273916.6,1545322.04
231410,202212,1466,1188,278,1441094.32,336938.12,1778032.44
240010,202212,401,179,222,216954.93,270283.39,487238.32
240020,202212,2411,1972,439,2390144.96,532076.21,2922221.17
240030,202212,120,96,24,116354.08,29088,145442.08
240040,202212,32,31,1,37572,1212,38784
240050,202212,543,467,76,566032.76,92112.1,658144.86
240060,202212,86,77,9,93324.81,10908,104232.81
240070,202212,293,221,72,267853.23,87264.32,355117.55
240080,202212,612,410,202,496936.77,246042.53,742979.30
240090,202212,105,92,13,111504.98,15756,127260.98
240100,202212,1613,1510,103,1830167.15,124838.58,1955005.73
240110,202212,1113,747,366,905410.95,443612.35,1349023.30
240120,202212,153,114,39,138168.99,47268.97,185437.96
240130,202212,279,254,25,309070.65,30300.7,339371.35
240140,202212,90,60,30,72721.89,36360.64,109082.53
240145,202212,766,674,92,816917.54,111504.28,928421.82
240150,202212,29,20,9,24240,10908,35148
240160,202212,41,30,11,36360,13332,49692
240165,202212,43,35,8,43635.38,9696.2,53331.58
240170,202212,153,106,47,128473.09,56964,185437.09
240180,202212,125,92,33,111506.2,39996,151502.2
240185,202212,54,46,8,55753.09,9696,65449.09
240190,202212,16,14,2,16968.43,2424,19392.43
240200,202212,3262,1754,1508,2125894.8,1828928.48,3954823.28
240210,202212,164,125,39,151500.73,47268,198768.73
240220,202212,1198,816,382,991458.83,465411.36,1456870.19
240230,202212,878,784,94,951451.14,113929.38,1065380.52
240240,202212,84,55,29,66660.2,35148.5,101808.7
240250,202212,103,87,16,105445.2,19392,124837.2
240260,202212,2013,1404,609,1701691.82,738115.29,2439807.11
240270,202212,178,152,26,184225.23,31512,215737.23
240280,202212,70,56,14,67873.19,16968,84841.19
240290,202212,42,40,2,48480,2424,50904
240300,202212,174,93,81,112716.8,98172,210888.8
240310,202212,2655,1419,1236,1719875.73,1499264.71,3219140.44
240320,202212,185,171,14,207252.07,16968,224220.07
240325,202212,5232,2927,2305,3547680.89,2793739.16,6341420.05
240330,202212,84,79,5,95748,6060,101808
240340,202212,109,75,34,90900,41208.66,132108.66
240350,202212,99,80,19,96960.2,23028,119988.2
240360,202212,759,482,277,584205,336944.79,921149.79
240370,202212,66,57,9,70297.09,10908.2,81205.29
240375,202212,52,33,19,39997.05,23028.4,63025.45
240380,202212,221,180,41,219380.31,49692.7,269073.01
240390,202212,16,14,2,16968,2424,19392
240400,202212,85,76,9,92112.85,10908,103020.85
240410,202212,12,9,3,10908,3636,14544
240420,202212,1185,838,347,1015684.93,420571.03,1436255.96
240430,202212,271,247,24,299373.22,29088.54,328461.76
240440,202212,156,83,73,100601.64,88476.01,189077.65
240450,202212,258,157,101,190292.03,123627.16,313919.19
240460,202212,92,70,22,84840.1,26664,111504.1
240470,202212,226,203,23,246046.36,27876,273922.36
240480,202212,15,13,2,15756,2424,18180
240485,202212,85,66,19,79992.97,23028,103020.97
240490,202212,66,60,6,72720.2,7272,79992.2
240500,202212,109,83,26,100596.6,31512,132108.6
240510,202212,39,29,10,35148.96,12120,47268.96
240520,202212,98,93,5,112718.05,6060.04,118778.09
240530,202212,64,52,12,63024.74,14544,77568.74
240540,202212,103,89,14,107868.1,16968.45,124836.55
240550,202212,13,11,2,13332,2424,15756
240560,202212,418,282,136,341793.5,164832.99,506626.49
240570,202212,456,281,175,340578.46,212101.18,552679.64
240580,202212,1415,1052,363,1275056.95,439956.89,1715013.84
240590,202212,30,29,1,35148.48,1212,36360.48
240600,202212,103,96,7,116353.29,8484,124837.29
240610,202212,513,421,92,510268.01,111507.52,621775.53
240615,202212,13,12,1,14544.4,1212,15756.4
240620,202212,89,85,4,103021.74,4848,107869.74
240630,202212,42,35,7,42420.79,8484.74,50905.53
240640,202212,39,26,13,31512,15756,47268
240650,202212,247,195,52,236342.92,63024.26,299367.18
240660,202212,116,99,17,121200.52,20604,141804.52
240670,202212,316,173,143,209687.4,173325.03,383012.43
240680,202212,57,44,13,53328.47,15756.1,69084.57
240690,202212,49,47,2,56965.01,2424,59389.01
240700,202212,180,149,31,180588.1,37573.02,218161.12
240710,202212,2406,1436,970,1740479.14,1178081.33,2918560.47
240720,202212,1124,789,335,957507.27,406024.91,1363532.18
240725,202212,78,70,8,84840.25,9696.88,94537.13
240730,202212,149,123,26,149076.16,31512,180588.16
240740,202212,236,193,43,233923.95,52116.62,286040.57
240750,202212,53,31,22,37572,26664,64236
240760,202212,58,46,12,55752,14544,70296
240770,202212,150,116,34,140592.69,41208.6,181801.29
240780,202212,767,630,137,763580.22,166045.17,929625.39
240790,202212,40,38,2,46057.9,2424,48481.9
240800,202212,10211,6855,3356,8313586.36,4067630.8,12381217.16
240810,202212,22945,12094,10851,14665891.36,13158999.28,27824890.64
240820,202212,276,164,112,198773.45,135746.66,334520.11
240830,202212,1651,1359,292,1647152.59,353910.16,2001062.75
240840,202212,76,64,12,77569.59,14544,92113.59
240850,202212,91,80,11,96960,13332,110292
240860,202212,111,107,4,129685.38,4848,134533.38
240870,202212,59,48,11,58179.6,13332,71511.6
240880,202212,31,28,3,33936,3636,37572
240890,202212,1243,695,548,844789.25,664186.09,1508975.34
240895,202212,67,50,17,60600.28,20604.23,81204.51
240910,202212,180,149,31,180589.16,37572,218161.16
240920,202212,13,12,1,14545.36,1212,15757.36
240930,202212,436,386,50,467854.65,60601.82,528456.47
240933,202212,62,39,23,47269.55,27876,75145.55
240940,202212,2378,2078,300,2518587.39,363604.85,2882192.24
240950,202212,43,38,5,46056.61,6060,52116.61
240960,202212,27,20,7,24240.2,8484.3,32724.5
240970,202212,110,77,33,93324,39996,133320
240980,202212,212,166,46,201193.15,55753.74,256946.89
240990,202212,147,94,53,113928.2,64236,178164.2
241000,202212,61,55,6,66660.55,7272,73932.55
241010,202212,88,73,15,88476.98,18180,106656.98
241020,202212,113,104,9,127261.16,10908.46,138169.62
241025,202212,19,11,8,13333.85,9696.5,23030.35
241030,202212,115,91,24,110292,29088,139380
241040,202212,46,37,9,44844.1,10908,55752.1
241050,202212,75,69,6,83628.2,7272,90900.2
241060,202212,27,23,4,27876,4848,32724
241070,202212,25,25,0,30301.81,,30301.81
241080,202212,61,54,7,65448.2,8484,73932.2
241090,202212,57,45,12,54543.62,14544,69087.62
241100,202212,72,61,11,73932.2,13332.35,87264.55
241105,202212,29,18,11,21818.86,13332.1,35150.96
241110,202212,53,43,10,52116.15,12120,64236.15
241120,202212,1759,1331,428,1613205.19,519952.64,2133157.83
241140,202212,209,171,38,207253.98,46056,253309.98
241142,202212,52,41,11,49692,13332,63024
241150,202212,1213,1046,167,1267787.61,202406.4,1470194.01
241160,202212,26,19,7,23028,8484,31512
241170,202212,52,44,8,53328,9696,63024
241180,202212,46,33,13,39996,15756,55752
241190,202212,40,36,4,43634.17,4848,48482.17
241200,202212,5008,2608,2400,3162258.78,2912530.55,6074789.33
241210,202212,72,61,11,73932.14,13332,87264.14
241220,202212,1632,1033,599,1254470.67,726004.55,1980475.22
241230,202212,259,209,50,253312.2,60600,313912.2
241240,202212,50,36,14,43632.54,16968,60600.54
241250,202212,1186,1081,105,1310199.01,127262.15,1437461.16
241255,202212,67,52,15,63024.68,18180,81204.68
241260,202212,761,578,183,700551.2,221797.67,922348.87
241270,202212,67,48,19,58177.47,23028,81205.47
241280,202212,98,86,12,104235.17,14544,118779.17
241290,202212,146,108,38,130898.2,46056,176954.2
241300,202212,85,59,26,71508,31512.98,103020.98
241310,202212,53,37,16,44844.1,19392,64236.1
241320,202212,34,17,17,20605.06,20604,41209.06
241330,202212,65,55,10,66660.55,12120,78780.55
241335,202212,101,90,11,109082.91,13332,122414.91
241340,202212,186,134,52,162408,63024,225432
241350,202212,65,54,11,65448.96,13332,78780.96
241355,202212,56,46,10,55752.92,12120,67872.92
241360,202212,56,53,3,64236.2,3636,67872.2
241370,202212,64,52,12,63024,14544,77568
241380,202212,36,32,4,38784.6,4848,43632.6
241390,202212,85,66,19,79992,23028,103020
241400,202212,229,169,60,205706.7,72720.1,278426.8
241410,202212,186,164,22,198769.57,26664.09,225433.66
241415,202212,110,87,23,105444.1,27876.8,133320.9
241420,202212,137,95,42,115141.12,50904,166045.12
241430,202212,20,18,2,21816,2424,24240
241440,202212,552,463,89,561177.75,107870,669047.75
241445,202212,44,38,6,46056.2,7272.63,53328.83
241450,202212,265,222,43,269070.54,52116.44,321186.98
241460,202212,174,159,15,192711.49,18181.09,210892.58
241470,202212,33,27,6,32724.8,7272.2,39997.0
241475,202212,48,44,4,53328,4848,58176
241480,202212,142,102,40,123625,48480.2,172105.2
241490,202212,15,12,3,14544.79,3636.37,18181.16
241500,202212,51,40,11,48481.34,13332.02,61813.36
250010,202212,104,85,19,103020.12,23028,126048.12
250020,202212,31,26,5,31512,6060,37572
250030,202212,912,670,242,812062.26,293309.05,1105371.31
250040,202212,408,329,79,398760.35,95749.05,494509.40
250050,202212,294,241,53,292094.3,64236,356330.3
250053,202212,66,53,13,64236.3,15756,79992.3
250057,202212,2,1,1,1212,1212,2424
250060,202212,646,463,183,561168.09,221799.53,782967.62
250070,202212,703,557,146,675100.21,176952.64,852052.85
250073,202212,9,8,1,9696.64,1212.01,10908.65
250077,202212,185,135,50,163622.01,60600.8,224222.81
250080,202212,418,329,89,398755.47,107869.7,506625.17
250090,202212,226,144,82,174528.4,99384,273912.4
250100,202212,611,486,125,589037.58,151501.8,740539.38
250110,202212,703,510,193,618128.82,235129.03,853257.85
250115,202212,14,4,10,4848,12120.26,16968.26
250120,202212,125,88,37,107868.76,44845.58,152714.34
250130,202212,581,476,105,576924.29,127262.8,704187.09
250135,202212,33,15,18,18180.16,21816,39996.16
250140,202212,88,75,13,90900.37,15756,106656.37
250150,202212,653,452,201,547831.46,243612.88,791444.34
250153,202212,16,14,2,16968.48,2424,19392.48
250157,202212,36,29,7,35148,8484,43632
250160,202212,250,188,62,227858.87,75144,303002.87
250170,202212,91,61,30,73932.2,36360,110292.2
250180,202212,5109,3525,1584,4273717.49,1919866.94,6193584.43
250190,202212,826,557,269,675091.07,326030.09,1001121.16
250200,202212,72,57,15,69084.78,18180,87264.78
250205,202212,22,17,5,20604.61,6060,26664.61
250210,202212,92,77,15,93324.8,18180,111504.8
250215,202212,88,59,29,71508.5,35148.94,106657.44
250220,202212,30,20,10,24240.24,12120,36360.24
250230,202212,79,70,9,84840.61,10908.2,95748.81
250240,202212,251,189,62,229072.94,75144.2,304217.14
250250,202212,410,351,59,425423.57,71508,496931.57
250260,202212,51,40,11,48480.1,13332,61812.1
250270,202212,82,58,24,70296.8,29088,99384.8
250280,202212,402,332,70,402386.53,84840.2,487226.73
250290,202212,114,101,13,122412,15756.93,138168.93
250300,202212,529,357,172,432694.75,208464.72,641159.47
250310,202212,57,52,5,64236.12,6060,70296.12
250320,202212,2130,1412,718,1711410.34,870237.98,2581648.32
250330,202212,121,105,16,127261.59,19392.1,146653.69
250340,202212,33,27,6,32724.8,7272,39996.8
250350,202212,210,138,72,167258.11,87264,254522.11
250355,202212,41,32,9,38784,10908.24,49692.24
250360,202212,194,160,34,193923.53,41209.68,235133.21
250370,202212,2478,1581,897,1916228.77,1087189.35,3003418.12
250375,202212,17,11,6,13332.36,7272.51,20604.87
250380,202212,55,49,6,59388.84,7272.15,66660.99
250390,202212,46,37,9,44845.59,10908,55753.59
250400,202212,18133,9225,8908,11182277.05,10801565.84,21983842.89
250403,202212,306,235,71,284821.91,87264,372085.91
250407,202212,68,55,13,66660.1,15756.85,82416.95
250410,202212,32,27,5,32724.31,6060.8,38785.11
250415,202212,48,29,19,35148.13,23028,58176.13
250420,202212,41,35,6,42420.2,7272,49692.2
250430,202212,1531,1325,206,1606231.57,249673.33,1855904.90
250435,202212,37,28,9,33937.82,10908,44845.82
250440,202212,693,568,125,688423.75,151501,839924.75
250450,202212,88,67,21,81205.59,25452,106657.59
250460,202212,495,325,170,393904.6,206042.04,599946.64
250470,202212,106,73,33,88476,39996.6,128472.6
250480,202212,342,269,73,326037.06,88476.98,414514.04
250485,202212,6,6,0,7272,,7272.0
250490,202212,257,206,51,249675.85,61813.14,311488.99
250500,202212,100,79,21,95749.92,25452,121201.92
250510,202212,864,685,179,830227.05,216948.83,1047175.88
250520,202212,170,116,54,140592.1,65448.12,206040.22
250523,202212,127,104,23,127260,27876.12,155136.12
250527,202212,124,91,33,110293.4,39996,150289.4
250530,202212,10,6,4,7272,4848,12120
250535,202212,31,24,7,29088,8484,37572
250540,202212,143,113,30,136956.08,36360,173316.08
250550,202212,73,71,2,86052.2,2424,88476.2
250560,202212,68,42,26,50904.2,31512,82416.2
250570,202212,169,138,31,167256.8,37572.2,204829.0
250580,202212,96,75,21,90978,25452,116430
250590,202212,24,14,10,16968,12120.54,29088.54
250600,202212,1663,1088,575,1319893.35,696903.56,2016796.91
250610,202212,160,127,33,153933.53,39997.01,193930.54
250620,202212,22,17,5,20604.71,6060,26664.71
250625,202212,68,53,15,64238.19,18180.59,82418.78
250630,202212,3227,2013,1214,2441259.83,1472605.09,3913864.92
250640,202212,200,158,42,191499.39,50904.78,242404.17
250650,202212,34,22,12,26664,14544.22,41208.22
250660,202212,62,46,16,55752,19392,75144
250670,202212,82,64,18,77568.27,21816.94,99385.21
250680,202212,429,344,85,418149.52,103020.52,521170.04
250690,202212,2280,1537,743,1864092.7,901742.7,2765835.4
250700,202212,960,819,141,995061.77,170892.2,1165953.97
250710,202212,501,387,114,469067.5,138171.04,607238.54
250720,202212,123,89,34,107868.65,41208,149076.65
250730,202212,421,347,74,421779.71,89689.9,511469.61
250740,202212,73,65,8,78780.08,9696.43,88476.51
250750,202212,25711,15097,10614,18309079.97,12870566.44,31179646.41
250760,202212,125,99,26,119988.5,31512.56,151501.06
250770,202212,382,253,129,306641.73,156348.7,462990.43
250780,202212,74,51,23,61812,27876,89688
250790,202212,477,289,188,350276.64,227858.77,578135.41
250800,202212,154,139,15,168468,18180,186648
250810,202212,75,59,16,71508,19392,90900
250820,202212,164,135,29,163621.53,35148,198769.53
250830,202212,496,320,176,387850.38,213313.68,601164.06
250840,202212,60,50,10,60600.54,12120.2,72720.74
250850,202212,69,58,11,70296,13332,83628
250855,202212,15,13,2,15756.2,2424,18180.2
250860,202212,250,162,88,196344.66,106656,303000.66
250870,202212,30,27,3,32724,3636,36360
250880,202212,93,71,22,86052.33,26664,112716.33
250890,202212,3309,2438,871,2956139.35,1055666.25,4011805.60
250900,202212,68,57,11,69086.04,13332,82418.04
250905,202212,127,92,35,111505.3,42420,153925.3
250910,202212,1012,730,282,884777.77,342999.28,1227777.05
250915,202212,117,78,39,94536.48,47270.11,141806.59
250920,202212,154,116,38,140592,46056.96,186648.96
250930,202212,205,118,87,143016.2,105444.2,248460.4
250933,202212,13,10,3,12120,3636,15756
250937,202212,18,17,1,20604,1212,21816
250939,202212,42,32,10,38784.2,12120,50904.2
250940,202212,135,95,40,115141.2,48480.6,163621.8
250950,202212,87,63,24,76358.39,29088,105446.39
250960,202212,89,50,39,60602.2,47268.3,107870.5
250970,202212,1331,940,391,1140510.23,473896.44,1614406.67
250980,202212,98,66,32,79992.57,38784,118776.57
250990,202212,172,132,40,159984,48480,208464
251000,202212,87,73,14,88476,16968,105444
251010,202212,142,99,43,119988.12,52116,172104.12
251020,202212,88,72,16,87264.27,19392,106656.27
251030,202212,49,34,15,41208,18180,59388
251040,202212,68,47,21,56964,25452,82416
251050,202212,29,23,6,27876,7272,35148
251060,202212,52,41,11,49692.56,13332,63024.56
251065,202212,6,3,3,3636,3636,7272
251070,202212,20,17,3,20604.2,3636,24240.2
251080,202212,5711,2657,3054,3220407.61,3701527.74,6921935.35
251090,202212,200,165,35,199981.88,42420.68,242402.56
251100,202212,22,21,1,25452.85,1212,26664.85
251110,202212,64,43,21,52116,25452,77568
251120,202212,2023,1247,776,1511432.43,940529.91,2451962.34
251130,202212,454,372,82,450867.27,99384.05,550251.32
251140,202212,637,415,222,505408.89,269065.45,774474.34
251150,202212,351,290,61,351484.69,73933.54,425418.23
251160,202212,99,80,19,96960.7,23028,119988.7
251170,202212,88,73,15,88477.27,18180,106657.27
251180,202212,305,175,130,212102.84,157562.18,369665.02
251190,202212,207,131,76,158775.26,92113.08,250888.34
251200,202212,317,244,73,295737.4,88476.34,384213.74
251203,202212,32,29,3,35148.3,3636,38784.3
251207,202212,87,72,15,87264,18180,105444
251210,202212,1610,1161,449,1408364.02,544193.35,1952557.37
251220,202212,49,38,11,46056.2,13332,59388.2
251230,202212,598,501,97,607219.35,117565.6,724784.95
251240,202212,121,84,37,101808,44844,146652
251250,202212,1628,1169,459,1416762.87,556314.53,1973077.40
251260,202212,13,9,4,10908,4848.65,15756.65
251270,202212,324,254,70,307854.82,84840.89,392695.71
251272,202212,61,53,8,64236.2,9696.1,73932.3
251274,202212,29,21,8,25453,9696.25,35149.25
251275,202212,37,20,17,24240.29,20604,44844.29
251276,202212,28,22,6,26664.5,8484,35148.5
251278,202212,14,11,3,13332.62,3636,16968.62
251280,202212,115,110,5,133320.2,6060,139380.2
251290,202212,1150,807,343,978131.72,415732.52,1393864.24
251300,202212,19,13,6,15756,7272,23028
251310,202212,323,232,91,281186.48,110293,391479.48
251315,202212,43,38,5,46056,6060.1,52116.1
251320,202212,73,59,14,71508.2,16968.1,88476.3
251330,202212,84,74,10,89688,12120,101808
251335,202212,23,14,9,16968,10908,27876
251340,202212,845,471,374,572077.61,453291.21,1025368.82
251350,202212,35,34,1,42420,1212,43632
251360,202212,89,76,13,92112.1,15756,107868.1
251365,202212,8,8,0,9698.31,,9698.31
251370,202212,6202,4193,2009,5084489.45,2436152.04,7520641.49
251380,202212,45,35,10,42420.75,12120,54540.75
251385,202212,3,3,0,3636,,3636.0
251390,202212,1033,754,279,913866.79,338154.94,1252021.73
251392,202212,34,23,11,27876,13332.39,41208.39
251394,202212,15,12,3,14544.1,3636,18180.1
251396,202212,11,7,4,8484,4848.2,13332.2
251398,202212,21,17,4,20604.2,4848,25452.2
251400,202212,55,43,12,52116,14544,66660
251410,202212,47,40,7,48480.07,8484,56964.07
251420,202212,112,80,32,96961.38,38784.06,135745.44
251430,202212,47,41,6,49692.7,7272,56964.7
251440,202212,57,30,27,36360,32724,69084
251445,202212,69,58,11,70297.79,13332,83629.79
251450,202212,396,337,59,408455.21,71508.2,479963.41
251455,202212,5,4,1,4848,1212,6060
251460,202212,23,19,4,23028,6060.02,29088.02
251465,202212,11,6,5,7272,6060,13332
251470,202212,52,38,14,46056,16968,63024
251480,202212,27,23,4,27876.62,4848.38,32725.00
251490,202212,115,68,47,82416.92,56965.55,139382.47
251500,202212,112,91,21,110293.11,25452,135745.11
251510,202212,94,58,36,70296.72,43632,113928.72
251520,202212,41,33,8,39996,9696,49692
251530,202212,4452,3112,1340,3774235.73,1627725.69,5401961.42
251540,202212,95,75,20,90900.49,24241.19,115141.68
251550,202212,437,331,106,401183.26,128474.83,529658.09
251560,202212,25,19,6,23028.1,7272,30300.1
251570,202212,17,16,1,19392,1212,20604
251580,202212,133,104,29,126048.77,35148,161196.77
251590,202212,105,73,32,88476.2,38784.6,127260.8
251593,202212,30,16,14,19392.27,16968,36360.27
251597,202212,123,96,27,116353.49,32724.12,149077.61
251600,202212,1124,770,354,933255.53,429051.12,1362306.65
251610,202212,270,192,78,232707.26,94536.4,327243.66
251615,202212,20,17,3,20604,3636,24240
251620,202212,4280,2714,1566,3291856.54,1899233.94,5191090.48
251630,202212,498,365,133,442392.94,161197.58,603590.52
251640,202212,109,79,30,95750.84,36360.2,132111.04
251650,202212,306,224,82,271489.41,99384.2,370873.61
251660,202212,205,180,25,218162.23,30300.8,248463.03
251670,202212,421,319,102,386633.62,123625.06,510258.68
251675,202212,15,10,5,12120,6060,18180
251680,202212,110,96,14,116352.84,16968,133320.84
251690,202212,322,267,55,323916.57,66660.2,390576.77
251700,202212,281,240,41,292095.18,49692,341787.18
251710,202212,23,14,9,16968.19,10908,27876.19
251720,202212,32,25,7,30300,8484,38784
251740,202212,13,10,3,12120,3636,15756
260005,202212,3844,2006,1838,2434476.16,2230119.26,4664595.42
260010,202212,1798,1342,456,1626527.37,552677.38,2179204.75
260020,202212,432,372,60,450868.44,72720.2,523588.64
260030,202212,641,429,212,519957.71,258157.03,778114.74
260040,202212,820,511,309,619345.64,374512.21,993857.85
260050,202212,1181,850,331,1031431.47,401176.33,1432607.80
260060,202212,378,347,31,420574.64,37572,458146.64
260070,202212,1368,835,533,1012064.37,646018.93,1658083.30
260080,202212,757,569,188,689640.81,227856,917496.81
260090,202212,490,308,182,373296.88,220584,593880.88
260100,202212,220,149,71,180588.82,86052,266640.82
260105,202212,276,158,118,191497.47,143016,334513.47
260110,202212,3121,2246,875,2723403.21,1060508.54,3783911.75
260120,202212,2877,1523,1354,1848663.98,1643489.5,3492153.48
260130,202212,219,154,65,186650.01,78780,265430.01
260140,202212,2352,1511,841,1831372.07,1020516.6,2851888.67
260150,202212,194,128,66,155138.12,79993.4,235131.52
260160,202212,360,282,78,341794.49,94536.46,436330.95
260170,202212,3568,2113,1455,2562228.8,1764701.69,4326930.49
260180,202212,189,161,28,195133.05,33936.5,229069.55
260190,202212,2537,1653,884,2003468.41,1071416.85,3074885.26
260200,202212,1035,802,233,972040.87,282396.8,1254437.67
260210,202212,1417,1012,405,1230202.9,490864.68,1721067.58
260220,202212,647,572,75,693275.65,90901.89,784177.54
260230,202212,1342,985,357,1195056.28,432689.92,1627746.20
260240,202212,216,163,53,197560.67,64238.48,261799.15
260250,202212,103,77,26,93324.43,31512,124836.43
260260,202212,1123,777,346,941733.34,419354.32,1361087.66
260270,202212,262,186,76,225436.81,92112,317548.81
260280,202212,1180,938,242,1136877.1,293307.17,1430184.27
260290,202212,7379,3945,3434,4783882.47,4165678.08,8949560.55
260300,202212,1094,923,171,1118716.3,207253.13,1325969.43
260310,202212,546,432,114,523592.77,138168.6,661761.37
260320,202212,825,588,237,712658.45,287244.94,999903.39
260330,202212,88,65,23,78780.5,27876.8,106657.3
260340,202212,88,64,24,77568.45,29088,106656.45
260345,202212,6142,3137,3005,3803367.81,3642113.33,7445481.14
260350,202212,498,353,145,429058.04,175741.38,604799.42
260360,202212,251,144,107,175740.6,129685.1,305425.7
260370,202212,743,477,266,578134.41,322393.95,900528.36
260380,202212,559,398,161,482384.77,195134.25,677519.02
260390,202212,297,253,44,306638.29,53328,359966.29
260392,202212,122,107,15,129684.86,18180.67,147865.53
260400,202212,4682,2671,2011,3237289.61,2444622.37,5681911.98
260410,202212,16092,8269,7823,10028325.4,9486403.58,19514728.98
260415,202212,154,127,27,153925.24,32724,186649.24
260420,202212,1831,1148,683,1391399.22,830223.19,2221622.41
260430,202212,175,156,19,189077.29,23028.8,212106.09
260440,202212,206,139,67,168472.86,81205.48,249678.34
260450,202212,436,325,111,393908.66,134532.85,528441.51
260460,202212,890,460,430,557534.61,522377.15,1079911.76
260470,202212,340,207,133,250888.68,161197.84,412086.52
260480,202212,258,162,96,196344,116352.2,312696.2
260490,202212,238,184,54,223009.03,65448,288457.03
260500,202212,1194,791,403,958709.84,488441.42,1447151.26
260510,202212,871,691,180,837503.92,220585.07,1058088.99
260515,202212,245,226,19,273913.97,23028.91,296942.88
260520,202212,3322,2020,1302,2450637.49,1579257.09,4029894.58
260530,202212,872,696,176,843575.82,213312.1,1056887.92
260540,202212,562,438,124,530862.36,150289.36,681151.72
260545,202212,24,13,11,15756.65,13332,29088.65
260550,202212,357,230,127,278761.86,153924.19,432686.05
260560,202212,517,394,123,477537.7,149079.05,626616.75
260570,202212,1066,853,213,1033864.68,258157.52,1292022.20
260580,202212,358,287,71,347847.02,86052,433899.02
260590,202212,648,374,274,453291.93,332088.4,785380.33
260600,202212,8251,4785,3466,5803168.93,4204462.67,10007631.60
260610,202212,517,352,165,426632.55,199983.82,626616.37
260620,202212,4027,2089,1938,2531941.99,2349028.93,4880970.92
260630,202212,81,72,9,87264.2,10908,98172.2
260640,202212,3525,2124,1401,2576747.32,1699234.4,4275981.72
260650,202212,334,240,94,290884.89,113929.2,404814.09
260660,202212,620,403,217,488451.18,263008.31,751459.49
260670,202212,112,78,34,94536,41208.12,135744.12
260680,202212,4260,2292,1968,2779216.85,2387686.95,5166903.80
260690,202212,138,103,35,124836.74,42420,167256.74
260700,202212,325,222,103,269067.07,126048.2,395115.27
260710,202212,50,43,7,52116,8484,60600
260720,202212,2816,1638,1178,1985276.88,1427742.44,3413019.32
260730,202212,795,589,206,713877.69,249673.17,963550.86
260740,202212,82,67,15,81204.2,18180,99384.2
260750,202212,576,428,148,518746.15,179376.82,698122.97
260760,202212,783,387,396,470281.17,481173.69,951454.86
260765,202212,1063,552,511,669036.56,620551.85,1289588.41
260770,202212,225,162,63,196327.44,76358.01,272685.45
260775,202212,894,465,429,563595.55,521169.32,1084764.87
260780,202212,241,150,91,181801.95,110292,292093.95
260790,202212,16743,8120,8623,9845372.62,10457230.55,20302603.17
260795,202212,160,105,55,127260.62,66660,193920.62
260800,202212,311,255,56,309063.03,69084.96,378147.99
260805,202212,40,27,13,32725.81,15756.7,48482.51
260810,202212,875,700,175,848408.13,213312.67,1061720.80
260820,202212,325,211,114,255735.53,138168,393903.53
260825,202212,219,148,71,179376.92,86052,265428.92
260830,202212,305,196,109,238764,133320,372084
260840,202212,278,198,80,239978.25,96960.3,336938.55
260845,202212,208,125,83,151501.28,100596.93,252098.21
260850,202212,435,326,109,396329.49,132108,528437.49
260860,202212,239,181,58,219374.04,70296,289670.04
260870,202212,346,270,76,327242.7,92112,419354.7
260875,202212,772,553,219,670265.75,265430.02,935695.77
260880,202212,1666,1099,567,1333219.31,688416.84,2021636.15
260890,202212,2602,1771,831,2146488.16,1007179.74,3153667.90
260900,202212,1048,768,280,930829.28,339361.4,1270190.68
260910,202212,255,202,53,244827.81,64236.6,309064.41
260915,202212,286,214,72,259368,87264,346632
260920,202212,228,124,104,150288.2,126048,276336.2
260930,202212,362,308,54,373304.49,65448.86,438753.35
260940,202212,2691,1431,1260,1736851.59,1528352.03,3265203.62
260950,202212,2084,1172,912,1421711.46,1107790.43,2529501.89
260960,202212,14751,7053,7698,8551044.64,9339848.98,17890893.62
260970,202212,445,358,87,433899.87,105444,539343.87
260980,202212,210,193,17,233919.5,20604.1,254523.6
260990,202212,2799,2220,579,2693136.57,701755.08,3394891.65
261000,202212,4396,2701,1695,3273661.09,2055572.22,5329233.31
261010,202212,135,99,36,119989.26,43632,163621.26
261020,202212,614,445,169,540560.86,204828.1,745388.96
261030,202212,262,192,70,232705.02,84840,317545.02
261040,202212,381,321,60,389059.69,72720,461779.69
261050,202212,546,451,95,546618.68,115142.6,661761.28
261060,202212,1637,1014,623,1228982.56,755080.27,1984062.83
261070,202212,10426,4885,5541,5924528.59,6719519.11,12644047.70
261080,202212,372,287,85,347850.64,104232,452082.64
261090,202212,2165,1655,510,2010769.57,618124.65,2628894.22
261100,202212,1285,882,403,1070220.93,488442.81,1558663.74
261110,202212,9915,6185,3730,7496534.28,4525685.95,12022220.23
261120,202212,238,202,36,244824.24,43632,288456.24
261130,202212,584,344,240,416940.34,290886.15,707826.49
261140,202212,217,135,82,164832.75,99384,264216.75
261150,202212,678,439,239,533284,289668.85,822952.85
261153,202212,73,68,5,82416.2,6060,88476.2
261160,202212,80853,39317,41536,47673871.4,50386171.2,98060042.6
261170,202212,511,381,130,462984.48,157560.68,620545.16
261180,202212,1863,1164,699,1413501.46,847196.86,2260698.32
261190,202212,607,410,197,496928.25,238764.87,735693.12
261200,202212,222,178,44,215739.41,53328,269067.41
261210,202212,44,33,11,39996.1,13332,53328.1
261220,202212,2962,2063,899,2501625.49,1089601.93,3591227.42
261230,202212,384,281,103,341789.99,124836.97,466626.96
261240,202212,445,380,65,460571.7,78780.96,539352.66
261245,202212,253,217,36,263004.51,43632,306636.51
261247,202212,176,133,43,161198.51,52116,213314.51
261250,202212,3996,1902,2094,2305257.9,2539154.45,4844412.35
261255,202212,260,230,30,278760.72,36360,315120.72
261260,202212,881,755,126,915098.93,153928.29,1069027.22
261270,202212,208,147,61,178164.13,73932,252096.13
261280,202212,206,164,42,198769.79,50904.04,249673.83
261290,202212,100,73,27,88476.24,32724.2,121200.44
261300,202212,1458,1084,374,1313837.55,454504.94,1768342.49
261310,202212,847,561,286,679946.5,346634.21,1026580.71
261320,202212,524,361,163,437542.68,197557.93,635100.61
261330,202212,922,720,202,873892.85,244832.6,1118725.45
261340,202212,343,193,150,233918.76,181800.47,415719.23
261350,202212,949,653,296,793887.13,358758.09,1152645.22
261360,202212,1447,909,538,1104140.46,653272.48,1757412.94
261370,202212,5225,3040,2185,3686985.41,2648261.39,6335246.80
261380,202212,585,456,129,553889.99,156348,710237.99
261390,202212,3966,2682,1284,3253276.76,1558669.03,4811945.79
261400,202212,287,255,32,309064.71,38785.06,347849.77
261410,202212,1184,776,408,940536.11,494498.22,1435034.33
261420,202212,1002,612,390,742969.95,472683.64,1215653.59
261430,202212,326,291,35,352697.33,42420,395117.33
261440,202212,101,96,5,116352.24,6060,122412.24
261450,202212,2684,2083,601,2525842.65,730844,3256686.65
261460,202212,805,618,187,749035.5,226645.63,975681.13
261470,202212,237,189,48,229069.7,58176.5,287246.2
261480,202212,501,373,128,452085.63,155083.46,607169.09
261485,202212,411,247,164,299370.56,198768.78,498139.34
261500,202212,656,420,236,509049.1,287244.93,796294.03
261510,202212,55,37,18,44844.98,21816.1,66661.08
261520,202212,103,87,16,105444.93,19392.2,124837.13
261530,202212,4410,2829,1581,3428813.62,1918615.6,5347429.22
261540,202212,1583,912,671,1106574.37,813259.98,1919834.35
261550,202212,272,128,144,155137.38,174528,329665.38
261560,202212,999,659,340,798727.02,412084.45,1210811.47
261570,202212,396,316,80,382997.37,96960.95,479958.32
261580,202212,405,327,78,396330.86,95748.62,492079.48
261590,202212,199,161,38,195136.39,46056.8,241193.19
261600,202212,324,252,72,305432.8,87264.4,392697.2
261610,202212,91,75,16,90901.04,19392.2,110293.24
261618,202212,83,59,24,71508.71,29088,100596.71
261620,202212,211,135,76,163620.32,92113.15,255733.47
261630,202212,704,546,158,661757.36,191497.05,853254.41
261640,202212,7062,3726,3336,4519648.69,4046934.75,8566583.44
261650,202212,464,296,168,358752.85,203616.3,562369.15
270010,202212,520,460,60,557531.3,72720.5,630251.8
270020,202212,257,210,47,254522.9,56965.17,311488.07
270030,202212,9509,6095,3414,7391828.84,4140187.36,11532016.20
270040,202212,2125,1394,731,1689557.44,887191.87,2576749.31
270050,202212,240,188,52,227857.43,63024.13,290881.56
270060,202212,71,48,23,58180.27,27876.96,86057.23
270070,202212,800,589,211,713877.14,255733.7,969610.84
270080,202212,53,40,13,48480.82,15756,64236.82
270090,202212,22,17,5,20604,6060,26664
270100,202212,1353,919,434,1116272.55,526010.73,1642283.28
270110,202212,66,54,12,65448,14544,79992
270120,202212,259,210,49,254527.37,59388.34,313915.71
270130,202212,334,254,80,309063.59,96960,406023.59
270135,202212,120,84,36,101808.8,43632,145440.8
270140,202212,1436,949,487,1151425.82,590252.49,1741678.31
270150,202212,246,189,57,229070.67,69084.63,298155.30
270160,202212,484,381,103,461781.82,124836.06,586617.88
270170,202212,814,542,272,656910.6,329664.79,986575.39
270180,202212,57,46,11,55752,13332.76,69084.76
270190,202212,111,97,14,117567.07,16968,134535.07
270200,202212,116,103,13,124836.16,15756,140592.16
270210,202212,555,340,215,412083.13,263004.6,675087.73
270220,202212,198,139,59,168468.29,71508.89,239977.18
270230,202212,2237,1419,818,1721065.19,991420.15,2712485.34
270235,202212,505,392,113,475120.9,136956.3,612077.2
270240,202212,3385,2681,704,3253297.37,853252.5,4106549.87
270250,202212,124,94,30,115142.25,36360,151502.25
270255,202212,214,176,38,213314.61,46056.44,259371.05
270260,202212,419,332,87,402394.23,106656.2,509050.43
270270,202212,99,54,45,65448.2,54540,119988.2
270280,202212,200,125,75,151500,90900,242400
270290,202212,1158,907,251,1100510.26,304216.49,1404726.75
270300,202212,380,277,103,335725.49,126048.2,461773.69
270310,202212,825,689,136,836296.9,164834.11,1001131.01
270320,202212,768,664,104,804779.96,126048,930827.96
270330,202212,330,284,46,344208.6,55752,399960.6
270340,202212,66,55,11,66660,13332,79992
270350,202212,84,49,35,59391.05,42420.06,101811.11
270360,202212,76,39,37,47268,44844.81,92112.81
270370,202212,65,51,14,63024,16968,79992
270375,202212,85,54,31,65448,37572,103020
270380,202212,1070,734,336,889609.49,407232,1296841.49
270390,202212,134,80,54,96960.2,65448.1,162408.3
270400,202212,768,593,175,718727.12,212100.92,930828.04
270410,202212,221,167,54,202409.59,65448.01,267857.60
270420,202212,410,286,124,346635.14,150288.7,496923.84
270430,202212,35955,25587,10368,31039692.26,12577234.42,43616926.68
270440,202212,472,373,99,453296.07,119989.04,573285.11
270450,202212,889,535,354,652951.22,429050.11,1082001.33
270460,202212,184,145,39,175743.72,47268,223011.72
270470,202212,1700,1189,511,1443522.24,619333.42,2062855.66
270480,202212,574,465,109,563592.22,133320.86,696913.08
270490,202212,26,20,6,24240,7272,31512
270500,202212,477,395,82,478745.54,99384,578129.54
270510,202212,914,606,308,735634.65,373297.92,1108932.57
270520,202212,262,177,85,214524.99,103020,317544.99
270530,202212,65,55,10,66660.2,12120,78780.2
270540,202212,88,62,26,75144,31512,106656
270550,202212,1667,1280,387,1552594.62,470258.25,2022852.87
270560,202212,251,154,97,186649.82,117564.5,304214.32
270570,202212,599,428,171,518741.3,207252,725993.3
270580,202212,20,14,6,16968,7272,24240
270590,202212,57,45,12,54540.3,14544,69084.3
270600,202212,159,137,22,166050.17,26664.1,192714.27
270610,202212,250,203,47,246038.52,58176.1,304214.62
270620,202212,19,18,1,21816,1212,23028
270630,202212,3680,2759,921,3345773.85,1116262.63,4462036.48
270640,202212,890,660,230,799933.89,278762.26,1078696.15
270642,202212,211,174,37,210889.25,46056,256945.25
270644,202212,276,171,105,207254.79,127262.21,334517.00
270650,202212,351,219,132,265431.45,159985.75,425417.20
270660,202212,196,173,23,209685.37,27876,237561.37
270670,202212,3009,2297,712,2785224.9,862946.25,3648171.15
270680,202212,397,259,138,313913.98,167256,481169.98
270690,202212,1254,847,407,1026588.76,493288.61,1519877.37
270700,202212,23,19,4,23028.42,4848,27876.42
270710,202212,561,437,124,530861.81,150288.24,681150.05
270720,202212,229,185,44,224225.08,53328.5,277553.58
270730,202212,1947,1220,727,1478777.6,882341.48,2361119.08
270740,202212,34,24,10,29088,12120,41208
270750,202212,624,483,141,585404.57,170892.72,756297.29
270760,202212,300,220,80,267857.34,96960.76,364818.10
270770,202212,2919,2003,916,2428915.64,1112623.63,3541539.27
270780,202212,66,40,26,49692,31512.65,81204.65
270790,202212,200,125,75,151501.6,90900,242401.6
270800,202212,2069,1658,411,2011391.94,498132.77,2509524.71
270810,202212,212,171,41,207253.44,49692,256945.44
270820,202212,119,82,37,99387.15,44844,144231.15
270830,202212,856,657,199,797522.69,241189.64,1038712.33
270840,202212,1331,1036,295,1256856.62,358753.66,1615610.28
270850,202212,1559,1019,540,1235037.63,654483.62,1889521.25
270860,202212,2662,1807,855,2190119.45,1037483.97,3227603.42
270870,202212,131,78,53,94536.3,64236.2,158772.5
270880,202212,855,681,174,826598.49,210890.25,1037488.74
270890,202212,261,200,61,242401.12,73932.9,316334.02
270895,202212,71,67,4,81204,4848,86052
270900,202212,67,56,11,67872.85,13332,81204.85
270910,202212,308,255,53,309068.69,64237.54,373306.23
270915,202212,1981,1325,656,1605929.22,795074.09,2401003.31
270920,202212,401,335,66,406024.06,79992,486016.06
270930,202212,5635,4342,1293,5266241.42,1569550.16,6835791.58
270940,202212,2233,1777,456,2153762.88,552673.8,2706436.68
280010,202212,34,28,6,33936.2,7272,41208.2
280020,202212,515,434,81,526015.4,98173.17,624188.57
280030,202212,22747,14686,8061,17808767.01,9775051.68,27583818.69
280040,202212,341,208,133,252098.1,161196.2,413294.3
280050,202212,449,348,101,421781.46,122412,544193.46
280060,202212,419,267,152,323610.22,184225.29,507835.51
280067,202212,1171,842,329,1020518.7,398748.36,1419267.06
280070,202212,124,105,19,127260.1,23028,150288.1
280100,202212,700,540,160,654487.97,193920.76,848408.73
280110,202212,89,78,11,94536.88,13332,107868.88
280120,202212,702,583,119,706604.37,144229.64,850834.01
280130,202212,1839,1206,633,1461689.57,768409.8,2230099.37
280140,202212,529,440,89,534498.52,107868.2,642366.72
280150,202212,432,307,125,372093.25,151500,523593.25
280160,202212,148,113,35,136956.99,42420,179376.99
280170,202212,434,305,129,370885.38,157562.21,528447.59
280190,202212,32,25,7,30300,8484,38784
280200,202212,51,41,10,49695.85,12120.3,61816.15
280210,202212,3113,2234,879,2711223.88,1067780.24,3779004.12
280220,202212,64,53,11,64237.36,13332,77569.36
280230,202212,342,276,66,334522.88,79994.42,414517.30
280240,202212,135,125,10,151503.07,12120,163623.07
280250,202212,20,11,9,13332.1,10909.87,24241.97
280260,202212,80,72,8,87265.97,9696,96961.97
280270,202212,142,110,32,133320.58,38784.79,172105.37
280280,202212,192,130,62,157562.11,75144,232706.11
280290,202212,3931,2867,1064,3476062.61,1292004.53,4768067.14
280300,202212,1714,1373,341,1666526.63,413295.99,2079822.62
280310,202212,104,98,6,118778.61,7272,126050.61
280320,202212,694,478,216,579349.89,263007.44,842357.33
280330,202212,324,240,84,290886.73,101808.2,392694.93
280340,202212,439,366,73,443599.17,88477.17,532076.34
280350,202212,3901,2984,917,3616691.97,1111423.79,4728115.76
280360,202212,503,346,157,419361.62,191497.39,610859.01
280370,202212,96,81,15,98172.66,18180,116352.66
280380,202212,50,39,11,47268,13332,60600
280390,202212,178,152,26,184226.33,31512,215738.33
280400,202212,417,274,143,332097.47,173318.15,505415.62
280410,202212,303,255,48,309064.81,58176,367240.81
280420,202212,148,127,21,153933.2,25452.95,179386.15
280430,202212,103,82,21,99384.74,25452,124836.74
280440,202212,730,601,129,729639.31,156350.21,885989.52
280445,202212,124,116,8,140594.44,9696,150290.44
280450,202212,1360,1157,203,1404731.24,246040.53,1650771.77
280460,202212,696,511,185,620555.4,224220.52,844775.92
280470,202212,99,91,8,110294.26,9696,119990.26
280480,202212,3327,2235,1092,2711421.6,1324752.07,4036173.67
280490,202212,204,194,10,235138.11,12120,247258.11
280500,202212,38,34,4,41208.24,4848.77,46057.01
280510,202212,135,108,27,130896.89,32725.3,163622.19
280520,202212,52,37,15,44844.27,18180,63024.27
280530,202212,77,50,27,60602.49,32724.38,93326.87
280540,202212,573,496,77,601158.94,93324,694482.94
280550,202212,764,703,61,852051.44,73932,925983.44
280560,202212,494,447,47,541772.89,56964.74,598737.63
280570,202212,2456,1946,510,2358586.03,618122.42,2976708.45
280580,202212,604,478,126,579341.91,152713.44,732055.35
280590,202212,230,148,82,180596.56,99389.41,279985.97
280600,202212,422,344,78,416989.79,94536.2,511525.99
280610,202212,116,82,34,100599.78,41210.11,141809.89
280620,202212,567,459,108,556313.82,130896.73,687210.55
280630,202212,155,126,29,152713.58,35148,187861.58
280640,202212,181,146,35,176952.3,42420,219372.3
280650,202212,86,52,34,63024.34,41208.52,104232.86
280660,202212,127,94,33,113933.58,39996.31,153929.89
280670,202212,2119,1358,761,1648433.19,923568.27,2572001.46
280680,202212,245,208,37,252099.44,44844,296943.44
280690,202212,76,66,10,79992,12120,92112
280700,202212,22,22,0,26664,,26664.0
280710,202212,1582,1218,364,1476239.89,441170.2,1917410.09
280720,202212,135,95,40,115143.02,48480,163623.02
280730,202212,32,28,4,33937.17,4848.05,38785.22
280740,202212,2661,2005,656,2430086.04,797499.51,3227585.55
280750,202212,234,205,29,248467.9,36361.14,284829.04
280760,202212,972,656,316,795094.16,382995.1,1178089.26
290010,202212,200,142,58,172104.46,70296,242400.46
290020,202212,191,169,22,204829.93,26664.9,231494.83
290030,202212,634,409,225,496926.72,272700.88,769627.60
290035,202212,141,113,28,138168.87,33936.93,172105.80
290040,202212,256,178,78,216953.01,94536,311489.01
290050,202212,92,74,18,89688,21816,111504
290060,202212,255,111,144,134532.95,174529.19,309062.14
290070,202212,6238,2944,3294,3570632.93,3994798.76,7565431.69
290080,202212,486,214,272,259370.25,329664.09,589034.34
290090,202212,332,152,180,184224.3,218162.57,402386.87
290100,202212,1776,1119,657,1356256.2,796287.93,2152544.13
290110,202212,913,510,403,618140.87,488444.94,1106585.81
290115,202212,184,167,17,202406.05,20604,223010.05
290120,202212,833,556,277,675093.56,335724.3,1010817.86
290130,202212,479,291,188,352694.24,227856.26,580550.50
290135,202212,301,225,76,272703.15,92112.1,364815.25
290140,202212,326,273,53,330882.76,64236.2,395118.96
290150,202212,153,103,50,124836,60600.01,185436.01
290160,202212,250,190,60,230285.56,72720.64,303006.20
290170,202212,106,76,30,92113.04,36360,128473.04
290180,202212,198,142,56,172106.4,67872.2,239978.6
290190,202212,371,289,82,350278.13,99385.63,449663.76
290195,202212,312,208,104,252097.72,126048.1,378145.82
290200,202212,264,212,52,256944.31,63024.1,319968.41
290205,202212,158,96,62,116352.3,75144,191496.3
290210,202212,1293,949,344,1150213.12,418144.01,1568357.13
290220,202212,172,103,69,124840.38,83628.2,208468.58
290225,202212,293,113,180,138171.53,218160.5,356332.03
290230,202212,92,55,37,66661.5,44844.79,111506.29
290240,202212,369,128,241,157562.19,292092.8,449654.99
290250,202212,241,223,18,270281.74,21816,292097.74
290260,202212,355,277,78,335736.09,94538.92,430275.01
290265,202212,195,169,26,204830.07,31512.49,236342.56
290270,202212,1416,1167,249,1414445.87,301790.38,1716236.25
290280,202212,500,351,149,425415.76,180588.4,606004.16
290290,202212,1460,876,584,1061729.09,710234.29,1771963.38
290300,202212,392,333,59,404815.68,71509.3,476324.98
290310,202212,291,137,154,166044.4,186648,352692.4
290320,202212,4439,2652,1787,3216750.35,2165866.85,5382617.20
290323,202212,213,185,28,224224.5,33936.2,258160.7
290327,202212,168,129,39,156351.44,47268.13,203619.57
290330,202212,124,55,69,66660.13,83628,150288.13
290340,202212,798,333,465,404822.43,563584.6,968407.03
290350,202212,686,409,277,495711.84,335726.42,831438.26
290360,202212,335,262,73,317549.27,88476.39,406025.66
290370,202212,907,409,498,495711.64,603576.91,1099288.55
290380,202212,347,220,127,266642.4,153924.87,420567.27
290390,202212,2494,1555,939,1884694.56,1142924.8,3027619.36
290395,202212,238,141,97,170892.2,117564,288456.2
290400,202212,294,214,80,259369.25,96960,356329.25
290405,202212,242,207,35,250884.58,42420,293304.58
290410,202212,658,550,108,667814.53,130896,798710.53
290420,202212,283,227,56,275125.7,67872,342997.7
290430,202212,506,325,181,393902.12,219372,613274.12
290440,202212,89,74,15,89688.22,18180,107868.22
290450,202212,198,145,53,175740.86,64236,239976.86
290460,202212,2050,1225,825,1484723.21,1001114.46,2485837.67
290470,202212,1406,621,785,752670.09,951431.3,1704101.39
290475,202212,575,538,37,652068.97,44844.6,696913.57
290480,202212,203,112,91,136957.02,110292.93,247249.95
290485,202212,241,217,24,263005.27,29088,292093.27
290490,202212,1335,932,403,1132018.51,488439.34,1620457.85
290500,202212,822,440,382,534497.26,464198.82,998696.08
290510,202212,188,152,36,184232.84,43632.35,227865.19
290515,202212,179,111,68,134533.25,82416,216949.25
290520,202212,1453,956,497,1158678.36,602365.59,1761043.95
290530,202212,280,251,29,304221,35148.2,339369.2
290540,202212,126,61,65,73932,78780,152712
290550,202212,175,144,31,174529.77,37572,212101.77
290560,202212,3288,1482,1806,1797436.42,2191306.18,3988742.60
290570,202212,7193,3409,3784,4134272.93,4589933.25,8724206.18
290580,202212,1320,796,524,964762.78,635089.22,1599852.00
290590,202212,591,472,119,572090.36,144231.73,716322.09
290600,202212,1835,1244,591,1508986.64,716301.22,2225287.86
290610,202212,185,169,16,204836.04,19392,224228.04
290620,202212,390,345,45,419354.47,54540.4,473894.87
290630,202212,2063,878,1185,1064161.45,1436227.35,2500388.80
290640,202212,134,107,27,129689.51,32724.05,162413.56
290650,202212,2085,967,1118,1173249.43,1355024.6,2528274.03
290660,202212,273,223,50,270276.14,60600,330876.14
290670,202212,1085,544,541,660552.23,655697.5,1316249.73
290680,202212,1294,1041,253,1261708.85,306638.71,1568347.56
290682,202212,349,255,94,309065.27,115140.38,424205.65
290685,202212,267,160,107,193922.82,129684.2,323607.02
290687,202212,1238,816,422,989208.33,511465.23,1500673.56
290689,202212,146,76,70,93324,84840,178164
290690,202212,576,261,315,317547.1,381782.15,699329.25
290700,202212,259,130,129,157564.55,156349.69,313914.24
290710,202212,807,564,243,683579.3,295733.59,979312.89
290720,202212,1100,883,217,1070229.77,263006.01,1333235.78
290730,202212,1285,762,523,923562.76,633882,1557444.76
290740,202212,27,23,4,27876,4848,32724
290750,202212,1547,676,871,819329.09,1055669.3,1874998.39
290755,202212,81,69,12,83628,14544,98172
290760,202212,266,230,36,278771.14,43632.52,322403.66
290770,202212,191,182,9,220587.24,10908,231495.24
290780,202212,1160,925,235,1121119.03,284824.21,1405943.24
290790,202212,407,273,134,330881.41,162412.42,493293.83
290800,202212,2499,1012,1487,1226563.26,1802252.52,3028815.78
290810,202212,498,342,156,415721.88,189072.99,604794.87
290820,202212,433,252,181,306645.4,219376.15,526021.55
290830,202212,498,352,146,426628.19,176952.18,603580.37
290840,202212,1933,1216,717,1473821.46,869009.46,2342830.92
290850,202212,1072,546,526,661759.81,637517.91,1299277.72
290860,202212,709,340,369,412084.97,447230.22,859315.19
290870,202212,640,442,198,535713.03,239977.76,775690.79
290880,202212,124,67,57,81204.4,69084,150288.4
290890,202212,507,302,205,366028.52,248462.03,614490.55
290900,202212,162,125,37,151500.94,44844,196344.94
290910,202212,406,310,96,375720.6,116352,492072.6
290920,202212,210,187,23,226647.36,27876,254523.36
290930,202212,550,417,133,505412.94,161198.11,666611.05
290940,202212,229,195,34,236340.3,41208,277548.3
290950,202212,161,92,69,111504,84840,196344
290960,202212,512,364,148,441171.87,179377.86,620549.73
290970,202212,237,209,28,253309.02,33936.2,287245.22
290980,202212,1992,1387,605,1682289.65,733268.13,2415557.78
290990,202212,424,361,63,437547.63,76358.07,513905.70
291000,202212,942,303,639,367236.42,774468,1141704.42
291005,202212,2723,1166,1557,1413243.09,1888327.62,3301570.71
291010,202212,119,104,15,126048,18180,144228
291020,202212,90,73,17,88476,20604,109080
291030,202212,104,78,26,94536.76,31512,126048.76
291040,202212,665,395,270,478741.17,327240.95,805982.12
291050,202212,1587,822,765,996278.45,928399.57,1924678.02
291060,202212,1733,954,779,1156269.86,945366.68,2101636.54
291070,202212,2016,1514,502,1839849.6,608431.66,2448281.26
291072,202212,7589,2895,4694,3511283.98,5690374.78,9201658.76
291075,202212,254,210,44,254520.4,53328.2,307848.6
291077,202212,63,43,20,52116,24240,76356
291080,202212,22308,9519,12789,11547059.91,15512624.27,27059684.18
291085,202212,287,232,55,281187.44,66660.75,347848.19
291090,202212,256,102,154,123625.89,186648,310273.89
291100,202212,985,340,645,413292.23,781740,1195032.23
291110,202212,453,344,109,418146.84,132108.4,550255.24
291120,202212,2489,1328,1161,1610766.41,1413197.76,3023964.17
291125,202212,69,35,34,42420,41208,83628
291130,202212,182,158,24,191500.69,29088,220588.69
291140,202212,131,101,30,122412.56,36360.7,158773.26
291150,202212,358,131,227,158772.2,275124,433896.2
291160,202212,411,316,95,383005.13,115141.09,498146.22
291165,202212,50,37,13,44844,15756.62,60600.62
291170,202212,3510,1737,1773,2107703.14,2148882.87,4256586.01
291180,202212,1267,529,738,641160.63,896881.5,1538042.13
291185,202212,116,105,11,127260.98,13332,140592.98
291190,202212,1421,687,734,833872.4,889618.25,1723490.65
291200,202212,173,128,45,155136.41,54540,209676.41
291210,202212,2519,1025,1494,1242319.46,1811949.5,3054268.96
291220,202212,330,252,78,305424.99,94536,399960.99
291230,202212,968,347,621,420570.66,752655.62,1173226.28
291240,202212,403,373,30,452079.02,36360,488439.02
291250,202212,410,335,75,406020.02,90900,496920.02
291260,202212,64,54,10,65448.1,12120,77568.1
291270,202212,1039,459,580,556335.45,705402.76,1261738.21
291280,202212,369,172,197,208467.24,238764.8,447232.04
291290,202212,1678,888,790,1076291.54,957496.33,2033787.87
291300,202212,247,185,62,224220.84,75144,299364.84
291310,202212,233,201,32,244828.53,38784.63,283613.16
291320,202212,1329,927,402,1124767.08,487226.71,1611993.79
291330,202212,142,118,24,143018.17,29088,172106.17
291340,202212,235,144,91,174530.38,110293.13,284823.51
291345,202212,122,88,34,106656.2,41208,147864.2
291350,202212,1841,703,1138,852040.29,1380469,2232509.29
291360,202212,8921,4238,4683,5143911.66,5688019.52,10831931.18
291370,202212,1175,706,469,855698.72,573283.51,1428982.23
291380,202212,266,208,58,253309.14,70296,323605.14
291390,202212,4209,1852,2357,2244664.01,2859121.98,5103785.99
291400,202212,2152,1494,658,1810770.03,798722.08,2609492.11
291410,202212,224,189,35,229070.67,42420,271490.67
291420,202212,121,93,28,112716.2,33936,146652.2
291430,202212,186,116,70,140592,84840,225432
291440,202212,548,444,104,538140.01,126048.2,664188.21
291450,202212,1031,679,352,824173.18,426628.54,1250801.72
291460,202212,2091,1636,455,1984101.37,551469.98,2535571.35
291465,202212,2363,1133,1230,1373219.66,1491980.11,2865199.77
291470,202212,3019,1519,1500,1841068.6,1819228.91,3660297.51
291480,202212,12553,5437,7116,6595868.33,8631923.26,15227791.59
291490,202212,712,285,427,345423.62,517524.4,862948.02
291500,202212,371,224,147,271490.26,178164.47,449654.73
291510,202212,1194,473,721,573279.19,873853.19,1447132.38
291520,202212,947,427,520,517533.74,630241.55,1147775.29
291530,202212,939,275,664,334513.55,804768.64,1139282.19
291535,202212,134,109,25,133320,30301,163621
291540,202212,346,120,226,145441.45,273912.89,419354.34
291550,202212,1300,616,684,746602.76,829009.97,1575612.73
291560,202212,5264,2666,2598,3231228.71,3153632.4,6384861.11
291570,202212,236,123,113,149076.79,138169.33,287246.12
291580,202212,1223,774,449,938101.75,544191.02,1482292.77
291590,202212,113,53,60,64236.77,72720,136956.77
291600,202212,1168,590,578,715092.07,700539.87,1415631.94
291610,202212,1503,729,774,884807,940533.8,1825340.8
291620,202212,566,268,298,324825.28,361179.49,686004.77
291630,202212,487,153,334,185437.65,404808.36,590246.01
291640,202212,4241,2064,2177,2502835.26,2639759.37,5142594.63
291650,202212,463,320,143,387855.41,173318.55,561173.96
291660,202212,371,151,220,183013.34,266641.41,449654.75
291670,202212,171,107,64,129686.3,77568,207254.3
291680,202212,626,383,243,464220.13,294519.85,758739.98
291685,202212,620,361,259,437539.21,313912.52,751451.73
291690,202212,509,325,184,393902.77,223009.43,616912.20
291700,202212,1078,827,251,1003555.14,304214.94,1307770.08
291710,202212,1636,792,844,959923.44,1022934.93,1982858.37
291720,202212,459,314,145,380568.62,175740.9,556309.52
291730,202212,963,554,409,671462.86,495711.42,1167174.28
291733,202212,319,218,101,264219.16,123624.19,387843.35
291735,202212,87,66,21,79992,25452,105444
291740,202212,350,265,85,322393.89,103020,425413.89
291750,202212,2491,1572,919,1907760.59,1113853.99,3021614.58
291760,202212,3181,1760,1421,2133132.83,1723465.31,3856598.14
291770,202212,769,516,253,625419.79,306645.71,932065.50
291780,202212,102,64,38,77568.62,46056.8,123625.42
291790,202212,160,83,77,100596,93325.47,193921.47
291800,202212,10847,4676,6171,5669874.15,7480538.34,13150412.49
291810,202212,1078,801,277,970829.2,335727.86,1306557.06
291820,202212,296,212,84,256946.29,101808,358754.29
291830,202212,1038,437,601,529658.62,729629.12,1259287.74
291835,202212,577,535,42,648428.03,52116.36,700544.39
291840,202212,5574,2810,2764,3407075.59,3350028.09,6757103.68
291845,202212,294,98,196,118776,237552,356328
291850,202212,311,273,38,330885.63,46056.4,376942.03
291855,202212,272,114,158,138168.41,191496.78,329665.19
291860,202212,157,102,55,123624.52,66661.48,190286.00
291870,202212,81,37,44,44844,53328,98172
291875,202212,165,152,13,184228.47,15756.84,199985.31
291880,202212,444,364,80,443602.96,98175.98,541778.94
291890,202212,255,91,164,110292.1,198768.6,309060.7
291900,202212,59,36,23,43632,27876,71508
291905,202212,124,95,29,115141.01,35148.22,150289.23
291910,202212,159,127,32,153924.26,38784.1,192708.36
291915,202212,450,391,59,473903.52,71509.07,545412.59
291920,202212,6274,3000,3274,3638567.7,3968158.99,7606726.69
291930,202212,171,106,65,128473.77,78780.25,207254.02
291940,202212,409,239,170,289669.15,206040,495709.15
291950,202212,1231,959,272,1163526.54,329664.98,1493191.52
291955,202212,1512,906,606,1098097.46,736901.16,1834998.62
291960,202212,202,149,53,180589.08,64236,244825.08
291970,202212,786,577,209,699338.47,253309.2,952647.67
291980,202212,1446,1252,194,1517445.33,235130.94,1752576.27
291990,202212,145,134,11,162409.34,13332,175741.34
291992,202212,207,100,107,121204.88,129688.23,250893.11
291995,202212,186,119,67,144229.56,81204.2,225433.76
292000,202212,438,312,126,378150.32,152712.24,530862.56
292010,202212,357,241,116,292092.2,140592.6,432684.8
292020,202212,305,227,78,275125.42,94536,369661.42
292030,202212,160,123,37,149078.85,44844,193922.85
292040,202212,602,322,280,390264,339360,729624
292045,202212,126,110,16,133320,19392.43,152712.43
292050,202212,970,701,269,849618.49,326030.28,1175648.77
292060,202212,962,780,182,945387.68,220588.92,1165976.60
292070,202212,69,28,41,33936.2,49692,83628.2
292080,202212,169,119,50,144228.29,60600,204828.29
292090,202212,571,203,368,246037.22,446016.75,692053.97
292100,202212,1659,720,939,872676.46,1138093.19,2010769.65
292105,202212,183,164,19,198768,23028,221796
292110,202212,2365,888,1477,1076272.94,1792556.2,2868829.14
292120,202212,739,563,176,682380.36,213313.69,895694.05
292130,202212,498,272,226,329668.68,273912.2,603580.88
292140,202212,216,176,40,213316.4,48481.94,261798.34
292145,202212,171,94,77,115140,93324,208464
292150,202212,1550,1291,259,1565922.86,315122.27,1881045.13
292160,202212,179,140,39,169680.4,47268.78,216949.18
292170,202212,1207,1022,185,1238699.12,224222.89,1462922.01
292180,202212,245,172,73,208464,88476,296940
292190,202212,155,100,55,121200,66660.96,187860.96
292200,202212,1481,544,937,659342.45,1135649.58,1794992.03
292205,202212,119,98,21,118776.97,25452,144228.97
292210,202212,403,266,137,322398.12,166044.2,488442.32
292220,202212,33,22,11,26664.93,13332,39996.93
292225,202212,56,47,9,56965.11,10908.6,67873.71
292230,202212,1038,797,241,967202.26,292093.39,1259295.65
292240,202212,660,479,181,580563.98,219372.5,799936.48
292250,202212,1686,1083,603,1315057.18,732053.94,2047111.12
292260,202212,428,255,173,309062.38,209677.63,518740.01
292265,202212,252,191,61,231498.17,73932.76,305430.93
292270,202212,736,368,368,446021.22,446016,892037.22
292273,202212,217,127,90,153924.2,109080.8,263005.0
292275,202212,187,96,91,116352,110292,226644
292280,202212,154,105,49,127260,59388,186648
292285,202212,100,78,22,94536,26664,121200
292290,202212,655,438,217,530863.13,263005.48,793868.61
292300,202212,1944,766,1178,929619.06,1427751.03,2357370.09
292303,202212,139,95,44,115140.66,53328.39,168469.05
292305,202212,122,88,34,106656.45,41208,147864.45
292310,202212,1021,675,346,818116.97,419355.95,1237472.92
292320,202212,611,455,156,551463.5,189073.52,740537.02
292330,202212,174,109,65,132108.51,78780,210888.51
292335,202212,320,253,67,306637.56,81204,387841.56
292340,202212,564,390,174,473895.39,210888.86,684784.25
292350,202212,292,152,140,184226.14,169680,353906.14
292360,202212,759,559,200,677511.47,244825.51,922336.98
292370,202212,736,563,173,682362.85,209676.5,892039.35
292380,202212,630,520,110,631459.02,133320.29,764779.31
292390,202212,402,162,240,196344.52,290882.6,487227.12
292400,202212,3924,2380,1544,2885854.21,1874975.89,4760830.10
292405,202212,276,183,93,224220.8,112716,336936.8
292410,202212,111,69,42,83628,50904,134532
292420,202212,281,242,39,294517.02,47268,341785.02
292430,202212,546,396,150,479954.84,181800.31,661755.15
292440,202212,654,542,112,659337,135745.31,795082.31
292450,202212,236,177,59,214526.52,71508.8,286035.32
292460,202212,528,403,125,488441.68,151500.5,639942.18
292465,202212,211,179,32,218160.59,38784.1,256944.69
292467,202212,181,120,61,145440,73932,219372
292470,202212,324,220,104,266641.17,126048,392689.17
292480,202212,422,282,140,341794.18,169682.7,511476.88
292490,202212,245,181,64,219373.55,77569.26,296942.81
292500,202212,975,473,502,573291.86,612067.08,1185358.94
292510,202212,3763,1830,1933,2217991.07,2344020.31,4562011.38
292520,202212,1232,585,647,709038.02,784174.15,1493212.17
292525,202212,462,338,124,410875.52,150291.61,561167.13
292530,202212,5200,2117,3083,2567065.08,3739051.77,6306116.85
292540,202212,497,289,208,351481.75,252096.33,603578.08
292550,202212,1172,649,523,786599.68,635093.11,1421692.79
292560,202212,343,311,32,376939.82,38784.16,415723.98
292570,202212,344,266,78,322392.78,94536,416928.78
292575,202212,589,425,164,515118.59,198770.96,713889.55
292580,202212,1067,716,351,869008.6,426626.62,1295635.22
292590,202212,581,513,68,621762.2,82416.2,704178.4
292593,202212,146,116,30,140592.58,36360,176952.58
292595,202212,212,168,44,203617.37,53328,256945.37
292600,202212,1330,944,386,1144158.75,467839.08,1611997.83
292610,202212,117,96,21,116355.77,25453.34,141809.11
292620,202212,538,447,91,541790.42,110293.13,652083.55
292630,202212,1628,888,740,1077487.85,899309.32,1976797.17
292640,202212,909,628,281,761148.71,340576.1,1101724.81
292650,202212,189,143,46,174536.87,55752,230288.87
292660,202212,2045,1447,598,1753810.16,724789.54,2478599.70
292665,202212,137,96,41,117564.36,49692,167256.36
292670,202212,399,304,95,368450.18,115140.58,483590.76
292680,202212,264,198,66,239976.76,79992,319968.76
292690,202212,215,147,68,178164.92,82416.2,260581.12
292700,202212,1046,682,364,826599.78,443599.41,1270199.19
292710,202212,117,101,16,122412,19392.31,141804.31
292720,202212,1045,597,448,724784.36,542976.78,1267761.14
292730,202212,218,102,116,123625.64,140592.4,264218.04
292740,202212,80145,38163,41982,46283228.98,50923148.04,97206377.02
292750,202212,405,295,110,357548.09,134534.26,492082.35
292760,202212,343,290,53,351483.66,65448.1,416931.76
292770,202212,912,381,531,461778.63,643579.14,1105357.77
292780,202212,39,15,24,18180.34,29088.82,47269.16
292790,202212,803,428,375,518738.5,454500.2,973238.7
292800,202212,1320,787,533,953859.72,646002.77,1599862.49
292805,202212,415,156,259,190285.99,313909.01,504195.00
292810,202212,1890,1121,769,1358675.05,934455.38,2293130.43
292820,202212,702,594,108,719956.53,130899.12,850855.65
292830,202212,146,110,36,133322.21,43633.41,176955.62
292840,202212,729,587,142,711460.37,172106.13,883566.50
292850,202212,141,98,43,118778.04,52117.54,170895.58
292860,202212,2196,1251,945,1516260.91,1145355.14,2661616.05
292870,202212,3858,2509,1349,3044602.94,1636211.55,4680814.49
292880,202212,1488,980,508,1187776.92,618125.79,1805902.71
292890,202212,558,462,96,559954.29,116355.92,676310.21
292895,202212,144,99,45,119988.2,54540,174528.2
292900,202212,339,242,97,293315.67,117565.94,410881.61
292905,202212,513,249,264,301792.74,322395.32,624188.06
292910,202212,536,401,135,486017.4,163620.47,649637.87
292920,202212,591,260,331,315125.43,401177.83,716303.26
292925,202212,486,445,41,539382.47,49693.22,589075.69
292930,202212,746,447,299,541771.25,363602.64,905373.89
292935,202212,279,120,159,145440.18,192708.9,338149.08
292937,202212,217,148,69,179378.06,84840,264218.06
292940,202212,195,149,46,180588.51,55752.2,236340.71
292950,202212,1409,670,739,812065.2,898103.09,1710168.29
292960,202212,518,372,146,450878.1,176954.05,627832.15
292970,202212,254,185,69,224221.22,83630.22,307851.44
292975,202212,94,51,43,61815.46,52117.53,113932.99
292980,202212,350,243,107,294518.62,130898.48,425417.10
292990,202212,1366,1022,344,1238671.23,416929.32,1655600.55
293000,202212,120,84,36,101808.2,43632.1,145440.3
293010,202212,3164,1869,1295,2266552.93,1571992.4,3838545.33
293015,202212,640,527,113,638732.98,136956,775688.98
293020,202212,351,274,77,333309.64,93325.75,426635.39
293030,202212,590,524,66,635095.7,81204,716299.7
293040,202212,390,311,79,376934.21,95748,472682.21
293050,202212,3167,1856,1311,2249519.34,1590166.72,3839686.06
293060,202212,242,191,51,231498.84,61812.5,293311.34
293070,202212,3976,1996,1980,2419228.19,2402214.87,4821443.06
293075,202212,97,69,28,83628.98,33936,117564.98
293076,202212,79,58,21,70296.89,25452,95748.89
293077,202212,619,353,266,427851.61,322396.28,750247.89
293080,202212,441,390,51,472684.94,61812.66,534497.60
293090,202212,137,122,15,147864,18180,166044
293100,202212,546,369,177,447235.52,214524.47,661759.99
293105,202212,360,262,98,317544.98,118776,436320.98
293110,202212,130,84,46,101812.47,55754.73,157567.20
293120,202212,307,217,90,263010.73,109082.28,372093.01
293130,202212,255,174,81,210895.47,98172,309067.47
293135,202212,8746,3519,5227,4272391.69,6341211.1,10613602.79
293140,202212,202,121,81,146654.21,98173.14,244827.35
293150,202212,325,280,45,339366.98,54540.4,393907.38
293160,202212,431,268,163,324819.31,197556.47,522375.78
293170,202212,257,163,94,197561.05,113929.74,311490.79
293180,202212,618,416,202,504194.2,244824,749018.2
293190,202212,1446,996,450,1207185.63,545409.55,1752595.18
293200,202212,596,523,73,635098.09,89688,724786.09
293210,202212,428,323,105,391482.51,127261.01,518743.52
293220,202212,2422,1071,1351,1298065.25,1641057.06,2939122.31
293230,202212,1866,692,1174,838720.53,1422890.87,2261611.40
293240,202212,241,214,27,259372.53,32724.79,292097.32
293245,202212,133,108,25,130899.2,30300,161199.2
293250,202212,834,348,486,421785.22,589045.7,1010830.92
293260,202212,329,262,67,317545.98,81204,398749.98
293270,202212,1229,551,678,669026.91,821736.3,1490763.21
293280,202212,320,214,106,259369.28,128472.93,387842.21
293290,202212,3146,2012,1134,2439799.04,1379265.81,3819064.85
293300,202212,914,632,282,767203.09,345420.88,1112623.97
293305,202212,197,150,47,181800.2,56964.65,238764.85
293310,202212,176,133,43,161197.08,52116.2,213313.28
293315,202212,172,130,42,157562.24,50905.19,208467.43
293317,202212,94,69,25,83628.88,30300,113928.88
293320,202212,1259,652,607,790270.23,735702.78,1525973.01
293325,202212,218,89,129,107868,156348,264216
293330,202212,15330,7013,8317,8502375.94,10085146.45,18587522.39
293340,202212,295,206,89,249672,107868,357540
293345,202212,264,219,45,265433.66,54540,319973.66
293350,202212,599,375,224,454513.09,271489.29,726002.38
293360,202212,1537,1080,457,1308984.06,553890.16,1862874.22
310010,202212,149,77,72,93324.46,87264,180588.46
310020,202212,1009,549,460,665399,558738.58,1224137.58
310030,202212,316,252,64,305427.56,77570.44,382998.00
310040,202212,47,33,14,39996,16968,56964
310050,202212,171,106,65,128472.21,78780,207252.21
310060,202212,277,196,81,237557.24,98172.75,335729.99
310070,202212,19,10,9,12120.95,10908.2,23029.15
310080,202212,53,36,17,43632,20604.83,64236.83
310090,202212,1129,629,500,762363.59,606007.26,1368370.85
310100,202212,383,266,117,322399.64,141805.73,464205.37
310110,202212,718,381,337,461776.62,408446.43,870223.05
310120,202212,392,228,164,276336.4,198768.7,475105.1
310130,202212,33,18,15,21816.2,19392,41208.2
310140,202212,27,10,17,12120,20605.66,32725.66
310150,202212,1232,803,429,973262.47,519955.43,1493217.90
310160,202212,2205,1104,1101,1338074.24,1335631.97,2673706.21
310163,202212,106,61,45,73932,54540,128472
310170,202212,2699,1281,1418,1552597.1,1719840.2,3272437.3
310180,202212,200,95,105,115141.44,127260,242401.44
310190,202212,496,332,164,403600.04,198769.32,602369.36
310200,202212,443,282,161,341788.05,195132.2,536920.25
310205,202212,81,56,25,67872,30300,98172
310210,202212,280,229,51,277549.49,61812,339361.49
310220,202212,62,39,23,47268.36,27876,75144.36
310230,202212,289,206,83,249673.84,100596,350269.84
310240,202212,128,103,25,124836,30300,155136
310250,202212,96,78,18,94537.81,21816.64,116354.45
310260,202212,787,423,364,513903.62,444808.31,958711.93
310270,202212,285,180,105,218163.27,127260.34,345423.61
310280,202212,408,287,121,347847.45,146652,494499.45
310285,202212,211,161,50,195133.97,60600,255733.97
310290,202212,239,129,110,156349.2,133320,289669.2
310300,202212,182,146,36,176952.63,43632,220584.63
310310,202212,14,12,2,14544,2424,16968
310320,202212,33,11,22,13332.18,26664,39996.18
310330,202212,45,32,13,38784.19,15756,54540.19
310340,202212,1930,1374,556,1665314.53,675087.05,2340401.58
310350,202212,2882,1491,1391,1808363.29,1687115.2,3495478.49
310360,202212,50,38,12,46056.16,14544.12,60600.28
310370,202212,135,113,22,136956,26664,163620
310375,202212,112,45,67,54540.51,81205.12,135745.63
310380,202212,54,34,20,41208,24240,65448
310390,202212,109,65,44,78780.29,53328,132108.29
310400,202212,2660,1741,919,2110169.43,1113835.02,3224004.45
310410,202212,115,68,47,82418.09,58176.32,140594.41
310420,202212,705,365,340,442387.25,412085.94,854473.19
310430,202212,291,189,102,229069.21,123624,352693.21
310440,202212,79,50,29,60600,35148,95748
310445,202212,84,71,13,86053.89,15756,101809.89
310450,202212,686,454,232,550261.22,281185.3,831446.52
310460,202212,259,174,85,210889.6,103020,313909.6
310470,202212,554,360,194,436327.21,236342.02,672669.23
310480,202212,100,64,36,77568,43632,121200
310490,202212,587,283,304,343000.24,368450.22,711450.46
310500,202212,130,54,76,65449.74,92112.8,157562.54
310510,202212,626,445,181,540565.15,219374.58,759939.73
310520,202212,148,103,45,124837.15,54540,179377.15
310530,202212,122,53,69,64236.03,83628,147864.03
310540,202212,507,284,223,344216.39,270277.88,614494.27
310550,202212,74,49,25,59390,30300,89690
310560,202212,3329,2267,1062,2750086.69,1288360.02,4038446.71
310570,202212,110,69,41,83628,50904,134532
310590,202212,406,239,167,289671.72,202404.19,492075.91
310600,202212,143,69,74,83629.1,89688,173317.1
310610,202212,46,17,29,20604,35148,55752
310620,202212,52593,24915,27678,30219409.99,33578673.56,63798083.55
310630,202212,788,471,317,570861.56,384205.41,955066.97
310640,202212,156,105,51,127260,61812.2,189072.2
310650,202212,172,153,19,185436.7,23028,208464.7
310660,202212,115,77,38,93324.2,46056,139380.2
310665,202212,71,50,21,60600,25452,86052
310670,202212,7730,3356,4374,4068806.5,5306161.95,9374968.45
310680,202212,69,45,24,54540,29088,83628
310690,202212,628,445,183,539348.76,221798.58,761147.34
310700,202212,62,37,25,44844.2,30300.97,75145.17
310710,202212,1328,895,433,1085098.04,524800.63,1609898.67
310720,202212,160,45,115,54540,139380,193920
310730,202212,1613,1089,524,1321121.91,635106.53,1956228.44
310740,202212,1054,576,478,698129.98,579341.31,1277471.29
310750,202212,254,159,95,192710,115140.37,307850.37
310760,202212,70,55,15,66661.74,18180,84841.74
310770,202212,86,41,45,49692.1,54540,104232.1
310780,202212,369,297,72,359968.11,87265.56,447233.67
310790,202212,121,96,25,116352.4,30300.59,146652.99
310800,202212,495,235,260,284821.24,315120,599941.24
310810,202212,186,121,65,146652.69,78780.59,225433.28
310820,202212,321,257,64,311492.62,77568.04,389060.66
310825,202212,217,180,37,218161.74,44844,263005.74
310830,202212,477,217,260,263004.58,315121.38,578125.96
310840,202212,373,226,147,275125.81,178164.83,453290.64
310850,202212,75,61,14,73932.95,16968,90900.95
310855,202212,440,347,93,420572.46,113928,534500.46
310860,202212,1675,1238,437,1500491.05,529652.75,2030143.80
310870,202212,58,49,9,59388.19,10908,70296.19
310880,202212,92,73,19,88476,23028,111504
310890,202212,299,173,126,209676.46,152712,362388.46
310900,202212,641,297,344,359967.37,419356.86,779324.23
310910,202212,250,167,83,202406,100596,303002
310920,202212,440,255,185,309070.27,224225.29,533295.56
310925,202212,36,28,8,33936.2,9696,43632.2
310930,202212,1396,929,467,1127176.55,569644.24,1696820.79
310940,202212,717,348,369,421785.9,447233.12,869019.02
310945,202212,147,94,53,113928.3,64236,178164.3
310950,202212,217,171,46,207253.82,55752,263005.82
310960,202212,77,27,50,32725.08,60600.03,93325.11
310970,202212,184,105,79,127260.89,95748.6,223009.49
310980,202212,55,37,18,44848.1,21816,66664.1
310990,202212,165,85,80,103020.71,96961.11,199981.82
311000,202212,894,454,440,550258.35,534497.48,1084755.83
311010,202212,52,40,12,48481.44,14544,63025.44
311020,202212,40,26,14,31512.45,16968,48480.45
311030,202212,409,231,178,281185.31,215736.2,496921.51
311040,202212,40,31,9,37572,10908,48480
311050,202212,524,197,327,238766.35,397536.76,636303.11
311060,202212,854,462,392,559949.87,475105.85,1035055.72
311070,202212,350,156,194,189073.16,235128,424201.16
311080,202212,123,69,54,83629.86,65448.96,149078.82
311090,202212,351,172,179,208467.9,218161.86,426629.76
311100,202212,580,353,227,427838.99,275124.25,702963.24
311110,202212,724,516,208,625404.02,253310.9,878714.92
311115,202212,84,58,26,71508.66,31512,103020.66
311120,202212,1148,629,519,763579.88,629032.7,1392612.58
311130,202212,301,175,126,212104.74,152712,364816.74
311140,202212,172,96,76,116353.81,92113.87,208467.68
311150,202212,345,219,126,265431.97,152712.6,418144.57
311160,202212,788,562,226,681153.98,275125.91,956279.89
311170,202212,94,78,16,94536,19392,113928
311180,202212,327,221,106,267860.42,128472.68,396333.10
311190,202212,37,18,19,21816,23028,44844
311200,202212,354,239,115,289668.94,139380.9,429049.84
311205,202212,34,26,8,31512,9696,41208
311210,202212,39,35,4,42420.6,4848,47268.6
311220,202212,30,26,4,31512,4848,36360
311230,202212,1729,1147,582,1390204.94,705390.72,2095595.66
311240,202212,81,53,28,64236.96,33936.85,98173.81
311250,202212,66,26,40,31512,48480,79992
311260,202212,552,335,217,409659.67,263004,672663.67
311265,202212,139,91,48,110292.3,58176,168468.3
311270,202212,296,201,95,243615.19,115142.58,358757.77
311280,202212,209,92,117,111504.2,141804,253308.2
311290,202212,107,92,15,112716.2,18180.2,130896.4
311300,202212,610,391,219,473897.61,265429.95,739327.56
311310,202212,19,15,4,18180,4848,23028
311320,202212,662,493,169,597521.15,204829.03,802350.18
311330,202212,1245,911,334,1105364.39,404811.54,1510175.93
311340,202212,2762,1946,816,2361021.8,992632.1,3353653.9
311350,202212,269,204,65,247250.28,78780,326030.28
311360,202212,171,103,68,124837.84,82416,207253.84
311370,202212,1276,542,734,658139.49,890829.35,1548968.84
311380,202212,7,6,1,7272,1212,8484
311390,202212,247,144,103,174530.3,124836.2,299366.5
311400,202212,141,88,53,106656.2,64236,170892.2
311410,202212,124,59,65,71508.2,78780,150288.2
311420,202212,329,166,163,202407.44,197558.4,399965.84
311430,202212,862,567,295,687211.13,358753.08,1045964.21
311440,202212,469,316,153,383002.41,186650.5,569652.91
311450,202212,314,184,130,223009.49,157560.92,380570.41
311455,202212,280,192,88,232709.73,106658.54,339368.27
311460,202212,133,59,74,71508.26,89688.9,161197.16
311470,202212,32,14,18,16968,21816,38784
311480,202212,56,31,25,37572,31512,69084
311490,202212,11,6,5,7272,6060,13332
311500,202212,31,15,16,18180.6,19392,37572.6
311510,202212,819,557,262,676309.76,317545.26,993855.02
311520,202212,42,35,7,42420,8484,50904
311530,202212,1890,1352,538,1641089.66,653269.9,2294359.56
311535,202212,63,42,21,50904.78,25452.52,76357.30
311540,202212,35,31,4,37572.2,4848,42420.2
311545,202212,172,123,49,149077.37,59388,208465.37
311547,202212,58,43,15,52116,18180.2,70296.2
311550,202212,708,323,385,392694.19,466622.8,859316.99
311560,202212,44,28,16,33936.83,19392,53328.83
311570,202212,298,195,103,236342.64,124838.64,361181.28
311580,202212,444,284,160,344211.18,193920.4,538131.58
311590,202212,28,24,4,29088.04,4848,33936.04
311600,202212,97,78,19,94537.85,23029.81,117567.66
311610,202212,264,228,36,276336.88,43632,319968.88
311615,202212,168,143,25,173316.43,30300.52,203616.95
311620,202212,34,23,11,27876,13332,41208
311630,202212,109,93,16,112716,19392,132108
311640,202212,128,62,66,75145.2,79995.44,155140.64
311650,202212,132,91,41,110292,49692.2,159984.2
311660,202212,455,207,248,250884.57,300577.09,551461.66
311670,202212,157,107,50,129685.02,60600.43,190285.45
311680,202212,226,171,55,207254.07,66660,273914.07
311690,202212,13,13,0,15756.5,1212,16968.5
311700,202212,198,147,51,178732.2,61813.32,240545.52
311710,202212,183,123,60,149077.67,72720,221797.67
311720,202212,43,32,11,38785.2,13332,52117.2
311730,202212,590,416,174,505415.74,212100.75,717516.49
311740,202212,30,21,9,25452.2,10908,36360.2
311750,202212,753,515,238,625396.39,288456.68,913853.07
311760,202212,84,36,48,43632.55,58176.89,101809.44
311770,202212,383,188,195,227858.45,237552,465410.45
311780,202212,210,106,104,128472,126048.2,254520.2
311783,202212,96,86,10,104233.94,12120,116353.94
311787,202212,47,19,28,23028,33936.68,56964.68
311790,202212,275,121,154,146653.76,186649.62,333303.38
311800,202212,778,479,299,580557.9,362390.18,942948.08
311810,202212,54,40,14,48480.7,16968,65448.7
311820,202212,129,100,29,121202.21,35149.34,156351.55
311830,202212,2050,1212,838,1468969.32,1016868.8,2485838.12
311840,202212,1148,653,495,791445.62,599944.63,1391390.25
311850,202212,19,13,6,15756,7272.2,23028.2
311860,202212,10867,4656,6211,5650500.83,7536284.11,13186784.94
311870,202212,113,65,48,78783.1,59388.31,138171.41
311880,202212,992,713,279,864176.11,338158.43,1202334.54
311890,202212,205,94,111,113830.06,134533.21,248363.27
311900,202212,72,30,42,36360,50904.15,87264.15
311910,202212,1464,917,547,1111422.39,662968.42,1774390.81
311920,202212,246,160,86,193921.91,104232.2,298154.11
311930,202212,950,531,419,643580.1,507830.72,1151410.82
311940,202212,2827,1541,1286,1868944.03,1558635.42,3427579.45
311950,202212,164,97,67,117566.31,81205.15,198771.46
311960,202212,65,47,18,56964.08,21816,78780.08
311970,202212,25,14,11,16968,13332,30300
311980,202212,39,30,9,36360,10908,47268
311990,202212,38,26,12,31512,14544.64,46056.64
311995,202212,55,31,24,37572,29088.22,66660.22
312000,202212,23,16,7,19392,8484,27876
312010,202212,74,58,16,70296.65,19392.1,89688.75
312015,202212,80,59,21,71508.69,25452,96960.69
312020,202212,136,96,40,116352.25,48480,164832.25
312030,202212,75,56,19,67872,23028,90900
312040,202212,89,51,38,61812,46056,107868
312050,202212,203,115,88,141804.6,106656,248460.6
312060,202212,21,14,7,16968,8484,25452
312070,202212,82,53,29,64236.93,35148.2,99385.13
312080,202212,574,270,304,327241.51,369660.4,696901.91
312083,202212,78,52,26,63024.2,31512,94536.2
312087,202212,104,78,26,94536.97,31512,126048.97
312090,202212,3589,2202,1387,2673762.22,1683484.88,4357247.10
312100,202212,150,107,43,129407.5,52116.7,181524.2
312110,202212,132,80,52,96960.92,63024.07,159984.99
312120,202212,132,95,37,115141.63,44844,159985.63
312125,202212,89,56,33,67872.38,39996,107868.38
312130,202212,133,88,45,106656.56,54540,161196.56
312140,202212,149,116,33,141805.94,39996.4,181802.34
312150,202212,38,30,8,36360,9696,46056
312160,202212,1521,1008,513,1224246.81,621761.13,1846007.94
312170,202212,13,10,3,12120,3636,15756
312180,202212,88,62,26,75144,31512,106656
312190,202212,50,43,7,52116,8484,60600
312200,202212,770,653,117,791448.69,141805.53,933254.22
312210,202212,130,67,63,81205.03,76356.58,157561.61
312220,202212,150,111,39,135745.3,47268,183013.3
312230,202212,4053,1811,2242,2198625.96,2722163.32,4920789.28
312235,202212,178,120,58,145440.14,70296,215736.14
312240,202212,86,63,23,76358.55,27876,104234.55
312245,202212,237,172,65,208468.56,78780.39,287248.95
312247,202212,87,63,24,76356.37,29088.38,105444.75
312250,202212,181,94,87,113929.21,105444,219373.21
312260,202212,109,72,37,87264,44844,132108
312270,202212,144,84,60,101809.94,72720,174529.94
312280,202212,32,17,15,20604,18180,38784
312290,202212,147,98,49,118777.1,59389.91,178167.01
312300,202212,213,138,75,167258.66,90901.05,258159.71
312310,202212,64,57,7,69084,8484,77568
312320,202212,431,262,169,318757.84,204828,523585.84
312330,202212,100,86,14,104232,16968.79,121200.79
312340,202212,33,18,15,21816,18180,39996
312350,202212,14,8,6,9696,7272,16968
312352,202212,96,67,29,81204.61,35148,116352.61
312360,202212,605,260,345,315124.51,418140.8,733265.31
312370,202212,393,213,180,258157.16,219373.49,477530.65
312380,202212,147,98,49,118780.21,59389.09,178169.30
312385,202212,167,137,30,166045.64,37572.93,203618.57
312390,202212,298,189,109,229069.14,132108,361177.14
312400,202212,392,294,98,356329.8,118777.54,475107.34
312410,202212,1303,482,821,584202.89,995066.46,1579269.35
312420,202212,699,530,169,642364.3,206040.7,848405.0
312430,202212,894,645,249,781748.11,301789.35,1083537.46
312440,202212,50,37,13,44844,15756,60600
312450,202212,218,132,86,159984,104232,264216
312460,202212,34,16,18,19392,21816,41208
312470,202212,47,33,14,39996,16968,56964
312480,202212,173,105,68,127263.75,82417.85,209681.60
312490,202212,333,227,106,276342.02,128473.11,404815.13
312500,202212,32,22,10,26665.11,12120,38785.11
312510,202212,700,267,433,323611.85,524805.84,848417.69
312520,202212,28,9,19,10908,23028.2,33936.2
312530,202212,40,28,12,33937.06,14544.1,48481.16
312540,202212,90,77,13,93324.7,15756,109080.7
312550,202212,33,26,7,31512,8484,39996
312560,202212,210,163,47,197558.68,56964,254522.68
312570,202212,494,295,199,357549.57,241190.37,598739.94
312580,202212,90,54,36,65448,43632,109080
312590,202212,222,175,47,212102.01,56964,269066.01
312595,202212,161,132,29,159984.25,36360,196344.25
312600,202212,79,36,43,43632.7,52116,95748.7
312610,202212,1643,849,794,1029009.86,962330.16,1991340.02
312620,202212,237,175,62,212101.8,75144,287245.8
312630,202212,70,55,15,66660.2,18180,84840.2
312640,202212,44,11,33,13332,39996.6,53328.6
312650,202212,159,136,23,165242.01,27876.1,193118.11
312660,202212,114,84,30,101814.69,36360.4,138175.09
312670,202212,962,615,347,745397.93,420568.38,1165966.31
312675,202212,48,37,11,44844,13332,58176
312680,202212,78,51,27,61812,32724,94536
312690,202212,276,143,133,173318.79,162408.45,335727.24
312695,202212,33,26,7,31512,8484,39996
312700,202212,260,152,108,184226.48,130896.64,315123.12
312705,202212,82,66,16,79992.31,19392,99384.31
312707,202212,132,93,39,112716.61,47268,159984.61
312710,202212,1979,1110,869,1347782.45,1055659.92,2403442.37
312720,202212,45,22,23,26664.56,27876.69,54541.25
312730,202212,281,167,114,202407.56,138170.72,340578.28
312733,202212,51,41,10,49692.2,12120,61812.2
312735,202212,21,16,5,19392.71,6060.8,25453.51
312737,202212,79,46,33,55752,39996,95748
312738,202212,70,44,26,53329.5,31512,84841.5
312740,202212,76,49,27,60601.09,32724,93325.09
312750,202212,115,77,38,93324.6,46056,139380.6
312760,202212,281,191,90,231494.95,109080.41,340575.36
312770,202212,9356,4467,4889,5418974.85,5931544.56,11350519.41
312780,202212,460,348,112,422992.93,135745.51,558738.44
312790,202212,21,14,7,16968,8484.4,25452.4
312800,202212,1713,1185,528,1436235.95,639940.61,2076176.56
312810,202212,359,245,114,296941.26,138168,435109.26
312820,202212,197,151,46,183012.64,55752,238764.64
312825,202212,48,36,12,43633.26,14544,58177.26
312830,202212,197,106,91,129684.94,110292.81,239977.75
312840,202212,195,137,58,166044.8,70296,236340.8
312850,202212,37,32,5,38784.9,6060,44844.9
312860,202212,148,99,49,119988.2,59388,179376.2
312870,202212,1226,636,590,772057.88,715080,1487137.88
312880,202212,121,90,31,109081.21,37572,146653.21
312890,202212,178,128,50,155139.58,60600,215739.58
312900,202212,165,123,42,149078.56,52116,201194.56
312910,202212,179,101,78,122417.65,94536.87,216954.52
312920,202212,110,61,49,73932.18,59388,133320.18
312930,202212,333,227,106,275127,128473.54,403600.54
312940,202212,151,103,48,124836,58176,183012
312950,202212,770,538,232,652071.88,281187.02,933258.90
312960,202212,148,107,41,130901.76,49693.03,180594.79
312965,202212,121,97,24,117564.1,29088,146652.1
312970,202212,301,240,61,290887.24,73933.21,364820.45
312980,202212,2782,1442,1340,1748951.3,1625298.58,3374249.88
312990,202212,44,17,27,20604.91,32724,53328.91
313000,202212,56,31,25,37572,30300,67872
313005,202212,186,143,43,173317.38,52116.5,225433.88
313010,202212,1033,446,587,541773.55,711448.66,1253222.21
313020,202212,199,105,94,127260.6,113928,241188.6
313030,202212,213,139,74,168468.42,89688,258156.42
313040,202212,91,28,63,33936.65,76356,110292.65
313050,202212,214,153,61,185436.61,75144,260580.61
313055,202212,42,30,12,36360,14544,50904
313060,202212,152,103,49,124836.6,59388.65,184225.25
313065,202212,56,41,15,49692,18180.6,67872.6
313070,202212,134,71,63,86053.59,76356,162409.59
313080,202212,44,24,20,29088.6,24240,53328.6
313090,202212,697,451,246,546619.99,299364.18,845984.17
313100,202212,218,79,139,95748.39,168468,264216.39
313110,202212,160,88,72,106656.3,87265.55,193921.85
313115,202212,254,135,119,163623.3,144228.22,307851.52
313120,202212,870,499,371,606009.43,449654.21,1055663.64
313130,202212,6357,3524,2833,4273611.55,3439681.85,7713293.40
313140,202212,135,77,58,93326.8,70296.66,163623.46
313150,202212,303,238,65,288460.51,78780,367240.51
313160,202212,186,140,46,169684.41,55752,225436.41
313170,202212,1468,931,537,1128395.08,650845.02,1779240.10
313180,202212,348,218,130,264220,157561.97,421781.97
313190,202212,789,456,333,552680.85,403599.09,956279.94
313200,202212,36,28,8,33936,9696.2,43632.2
313210,202212,1040,888,152,1077505.53,184227.54,1261733.07
313220,202212,321,194,127,235129.8,153924,389053.8
313230,202212,294,226,68,273912.49,82416,356328.49
313240,202212,2395,1200,1195,1456853.21,1449552.63,2906405.84
313250,202212,1274,957,317,1159913.29,384208.95,1544122.24
313260,202212,98,46,52,56964.4,63024,119988.4
313270,202212,1086,642,444,778110.71,538133.7,1316244.41
313280,202212,48,37,11,44844,13332,58176
313290,202212,239,191,48,231496.36,58176,289672.36
313300,202212,335,164,171,198770.22,207252.58,406022.80
313310,202212,259,113,146,136957.47,176952.8,313910.27
313320,202212,403,294,109,356331.46,132108.54,488440.00
313330,202212,1507,923,584,1119910.77,707815.14,1827725.91
313340,202212,348,251,97,304216.61,117564.7,421781.31
313350,202212,461,283,178,344209.5,216948,561157.5
313360,202212,205,96,109,116352.2,132108,248460.2
313370,202212,244,87,157,106656.8,190284,296940.8
313375,202212,331,208,123,252100.74,149076.9,401177.64
313380,202212,1362,716,646,867813.99,784166.12,1651980.11
313390,202212,55,49,6,59388.6,7272,66660.6
313400,202212,417,289,128,350282.7,155137.84,505420.54
313410,202212,95,62,33,75144.8,39996.81,115141.61
313420,202212,4829,2720,2109,3299159.21,2556122.26,5855281.47
313430,202212,121,60,61,72720.8,73932.33,146653.13
313440,202212,1430,1014,416,1229011.25,504199.2,1733210.45
313450,202212,70,32,38,38784,46056,84840
313460,202212,415,185,230,224222.52,278761.09,502983.61
313470,202212,527,252,275,305434.26,333305.38,638739.64
313480,202212,166,123,43,149077.42,52116,201193.42
313490,202212,569,256,313,310282.29,379362.43,689644.72
313500,202212,31,17,14,20604,16968,37572
313505,202212,1136,870,266,1055677.79,323607.8,1379285.59
313507,202212,111,75,36,90901.18,43632,134533.18
313510,202212,3044,1876,1168,2277523.36,1419270.55,3696793.91
313520,202212,3544,2738,806,3318557.4,976882.13,4295439.53
313530,202212,41,25,16,30300,19392,49692
313535,202212,89,73,16,89690.31,19392,109082.31
313540,202212,68,48,20,58176,24240,82416
313545,202212,123,105,18,127260.51,21816,149076.51
313550,202212,219,187,32,226646.06,38785.85,265431.91
313560,202212,363,170,193,206044.86,233920.04,439964.90
313570,202212,78,28,50,33936,60600.13,94536.13
313580,202212,1416,829,587,1005974.44,711447.02,1717421.46
313590,202212,68,42,26,50904.59,31512.54,82417.13
313600,202212,708,432,276,523591.86,335726.01,859317.87
313610,202212,57,45,12,54541.33,14544.35,69085.68
313620,202212,1562,760,802,921142.84,972026.51,1893169.35
313630,202212,1733,1307,426,1585327.85,516314.51,2101642.36
313640,202212,124,73,51,88477.68,61812,150289.68
313650,202212,237,124,113,151500.76,136957.56,288458.32
313652,202212,31,29,2,35148,2424,37572
313655,202212,93,62,31,75144.76,37572.79,112717.55
313657,202212,53,48,5,58177.88,6060,64237.88
313660,202212,142,96,46,116352.93,55752.99,172105.92
313665,202212,742,342,400,414514.79,484807.82,899322.61
313670,202212,11356,7768,3588,9423639.06,4351121.73,13774760.79
313680,202212,43,34,9,41208.73,10908,52116.73
313690,202212,140,99,41,119988.27,49692,169680.27
313695,202212,89,68,21,82417.52,25452,107869.52
313700,202212,357,271,86,328456.67,104232.4,432689.07
313710,202212,131,93,38,112718.6,46056,158774.6
313720,202212,1220,566,654,688434.69,795081.68,1483516.37
313730,202212,75,43,32,52116.86,38784,90900.86
313740,202212,157,118,39,143017.25,47268,190285.25
313750,202212,413,288,125,350270.21,151501.39,501771.60
313753,202212,242,183,59,221798.2,71508.1,293306.3
313760,202212,1441,567,874,687217.21,1060508.24,1747725.45
313770,202212,431,291,140,352701.12,169683.09,522384.21
313780,202212,894,485,409,587825.14,495712.29,1083537.43
313790,202212,38,38,0,46056,,46056.0
313800,202212,169,105,64,127263.32,78781.4,206044.72
313810,202212,93,53,40,64236.21,48480,112716.21
313820,202212,1456,707,749,858113.48,907790.55,1765904.03
313830,202212,56,37,19,44845.29,23028,67873.29
313835,202212,68,59,9,71508.2,10908,82416.2
313840,202212,1795,1076,719,1305354.46,872644.69,2177999.15
313850,202212,229,99,130,119990.03,157560,277550.03
313860,202212,501,381,120,461782.73,145440.64,607223.37
313862,202212,180,124,56,151505.06,69084.2,220589.26
313865,202212,191,130,61,157560.83,73932.3,231493.13
313867,202212,64,53,11,64236,13332,77568
313868,202212,50,31,19,37572,23028,60600
313870,202212,83,44,39,53328,47268,100596
313880,202212,392,247,145,299367.21,175740.35,475107.56
313890,202212,349,188,161,227861.1,195132,422993.1
313900,202212,868,471,397,570862.53,481171.96,1052034.49
313910,202212,152,104,48,126048.32,58176,184224.32
313920,202212,672,456,216,553887.75,261792.9,815680.65
313925,202212,35,30,5,36360,6060,42420
313930,202212,939,716,223,867814.81,271492.93,1139307.74
313940,202212,2045,1217,828,1475028.05,1003541.65,2478569.70
313950,202212,887,534,353,647219.44,427836.65,1075056.09
313960,202212,1540,877,663,1062939.58,804775.84,1867715.42
313970,202212,191,108,83,130896.1,100596,231492.1
313980,202212,250,159,91,192713.49,110293.56,303007.05
313990,202212,276,171,105,207252.01,127260,334512.01
314000,202212,912,596,316,722358.16,384209.4,1106567.56
314010,202212,101,64,37,77568.49,44844,122412.49
314015,202212,96,27,69,32725.35,83629.7,116355.05
314020,202212,58,39,19,47268.8,23028,70296.8
314030,202212,78,40,38,48481.73,46056,94537.73
314040,202212,46,24,22,29088,26664,55752
314050,202212,296,165,131,199984.68,158772,358756.68
314053,202212,96,60,36,72720.7,43632,116352.7
314055,202212,309,194,115,235132.12,139381.64,374513.76
314060,202212,125,105,20,127260.9,24240,151500.9
314070,202212,1127,567,560,688436.36,678728.96,1367165.32
314080,202212,221,136,85,164835.26,103020.84,267856.10
314085,202212,189,133,56,161196.16,67872,229068.16
314090,202212,424,303,121,367240.24,146652,513892.24
314100,202212,542,428,114,518750.45,138170.93,656921.38
314110,202212,800,354,446,431486.39,540556.12,972042.51
314120,202212,71,43,28,52116,33936,86052
314130,202212,25,18,7,21816,8484,30300
314140,202212,1223,775,448,939320.96,542979.76,1482300.72
314150,202212,195,125,70,151502.74,84840.66,236343.40
314160,202212,320,238,82,288458.6,99384.56,387843.16
314170,202212,86,64,22,77568.79,26664,104232.79
314180,202212,799,707,92,858119.76,111505.27,969625.03
314190,202212,87,54,33,65448,39996,105444
314200,202212,541,371,170,449664.22,206045.69,655709.91
314210,202212,252,193,59,233918.77,71508.6,305427.37
314220,202212,316,227,89,275128.86,107868.93,382997.79
314225,202212,50,32,18,38785.2,21816,60601.2
314230,202212,125,57,68,69084.95,82416,151500.95
314240,202212,180,129,51,156349.01,61812.47,218161.48
314250,202212,59,35,24,42421.82,29088,71509.82
314260,202212,217,105,112,127260.96,135744,263004.96
314270,202212,430,338,92,409668.96,111504.7,521173.66
314280,202212,759,416,343,504144.16,416930.51,921074.67
314290,202212,560,436,124,528437.33,150288.72,678726.05
314300,202212,351,260,91,315125.17,110292,425417.17
314310,202212,1379,956,423,1159000.52,512676.47,1671676.99
314315,202212,45,34,11,41208.2,13332,54540.2
314320,202212,603,415,188,504200,227858.74,732058.74
314330,202212,12343,5993,6350,7268564.71,7697460.43,14966025.14
314340,202212,673,304,369,368456.12,447233.77,815689.89
314345,202212,62,46,16,55752,19392,75144
314350,202212,188,115,73,139380.2,88476.66,227856.86
314360,202212,54,28,26,33938.16,31512.64,65450.80
314370,202212,72,51,21,61812,25452,87264
314380,202212,136,75,61,90900,73932,164832
314390,202212,3648,2353,1295,2853119.34,1569544.69,4422664.03
314400,202212,719,498,221,604797.17,267854.86,872652.03
314410,202212,553,370,183,449659.44,221798.38,671457.82
314420,202212,25,15,10,18180,12120,30300
314430,202212,2548,967,1581,1173244.03,1918623.37,3091867.40
314435,202212,149,88,61,106657.92,73932,180589.92
314437,202212,55,43,12,52116,14544,66660
314440,202212,94,61,33,73932.79,39996.1,113928.89
314450,202212,168,118,50,143016.36,60600.65,203617.01
314460,202212,659,325,334,393907.61,404811.6,798719.21
314465,202212,131,84,47,101808.55,56964,158772.55
314467,202212,74,60,14,72720.1,18180,90900.1
314470,202212,433,216,217,261794.63,264217.9,526012.53
314480,202212,1126,503,623,610856.39,755080.24,1365936.63
314490,202212,35,19,16,23028,19392,42420
314500,202212,283,195,88,236342.33,106656.45,342998.78
314505,202212,122,78,44,94537.93,53328,147865.93
314510,202212,263,215,48,260581.05,58176,318757.05
314520,202212,1508,784,724,950229.88,877498.5,1827728.38
314530,202212,790,628,162,762375.2,196348.59,958723.79
314535,202212,175,108,67,130896,81204,212100
314537,202212,70,42,28,50904.13,33936.1,84840.23
314540,202212,18,10,8,12120,9696,21816
314545,202212,67,44,23,53328,27876,81204
314550,202212,76,41,35,49693.55,42421.65,92115.20
314560,202212,911,486,425,590254.35,515105.12,1105359.47
314570,202212,15,13,2,15756.3,2424,18180.3
314580,202212,12,6,6,7272,7272,14544
314585,202212,31,22,9,26664,10908.55,37572.55
314587,202212,83,72,11,87264,13332,100596
314590,202212,615,423,192,512680.61,233917,746597.61
314600,202212,1006,654,352,792672.77,426631.95,1219304.72
314610,202212,1026,519,507,631458.79,616911.67,1248370.46
314620,202212,152,115,37,140592.39,44844,185436.39
314625,202212,99,75,24,90900.39,30300,121200.39
314630,202212,1170,652,518,791455.14,629034.6,1420489.74
314640,202212,94,59,35,71510.63,42420.6,113931.23
314650,202212,161,92,69,111505.59,83629.53,195135.12
314655,202212,65,48,17,58176.2,20604,78780.2
314660,202212,20,15,5,18180,6060,24240
314670,202212,233,184,49,224230.3,59390.67,283620.97
314675,202212,218,131,87,158773.84,105444.23,264218.07
314690,202212,587,314,273,381783.34,330877.76,712661.10
314700,202212,2262,1205,1057,1460503.02,1284724.39,2745227.41
314710,202212,1915,1070,845,1296854.98,1025352.26,2322207.24
314720,202212,412,229,183,277551.67,221797.22,499348.89
314730,202212,533,290,243,351483.55,295728.77,647212.32
314740,202212,831,372,459,450868.86,556311.52,1007180.38
314750,202212,27,20,7,24240,8484,32724
314760,202212,373,151,222,183013.09,269065.09,452078.18
314770,202212,106,68,38,82416,46056,128472
314780,202212,18,7,11,8484,13332,21816
314790,202212,2660,1700,960,2064088.85,1167156.49,3231245.34
314795,202212,73,64,9,77568,10908,88476
314800,202212,3088,1808,1280,2197391.73,1553789.12,3751180.85
314810,202212,1556,884,672,1071421.51,815677.58,1887099.09
314820,202212,118,69,49,83629.54,59388.1,143017.64
314830,202212,223,187,36,226646.18,43632,270278.18
314840,202212,87,52,35,63024,42420,105444
314850,202212,457,219,238,265552.14,288456,554008.14
314860,202212,664,500,164,607217.08,198768.08,805985.16
314870,202212,1710,913,797,1106577.09,968401.64,2074978.73
314875,202212,68,62,6,75144,7272,82416
314880,202212,41,29,12,35148,14544,49692
314890,202212,56,30,26,36360,31512,67872
314900,202212,28,21,7,25452.72,8484.92,33937.64
314910,202212,242,161,81,196345.69,98172,294517.69
314915,202212,145,125,20,151501.83,24240.18,175742.01
314920,202212,81,54,27,65448.85,32724,98172.85
314930,202212,1065,492,573,596320.17,694478.55,1290798.72
314940,202212,37,29,8,35148,9696.1,44844.1
314950,202212,23,20,3,24240.2,3636,27876.2
314960,202212,26,18,8,21816,9696,31512
314970,202212,180,82,98,99384.8,118776.92,218161.72
314980,202212,320,203,117,246038.79,141804.75,387843.54
314990,202212,473,254,219,309063.02,265430.33,574493.35
314995,202212,157,68,89,82416.01,107868,190284.01
315000,202212,97,76,21,92112.49,25452.1,117564.59
315010,202212,33,20,13,24240,15756,39996
315015,202212,164,129,35,156348.4,42420,198768.4
315020,202212,68,58,10,70296,12120,82416
315030,202212,110,82,28,99384,33936,133320
315040,202212,90,53,37,65448,44844,110292
315050,202212,213,129,84,156348.37,101808.68,258157.05
315053,202212,68,47,21,56964.8,25452,82416.8
315057,202212,128,98,30,118776.05,36360,155136.05
315060,202212,66,54,12,65449.48,14544,79993.48
315070,202212,117,71,46,86052.26,55752,141804.26
315080,202212,402,318,84,385419.94,101809.27,487229.21
315090,202212,101,59,42,71508.89,50904,122412.89
315100,202212,94,45,49,54540.4,59388.38,113928.78
315110,202212,286,143,143,173318.38,173316,346634.38
315120,202212,1932,918,1014,1113862.57,1230209.32,2344071.89
315130,202212,364,259,105,313911.04,127260.88,441171.92
315140,202212,570,311,259,376937.09,313912.39,690849.48
315150,202212,1010,481,529,582985.44,641154.2,1224139.64
315160,202212,198,106,92,128476.7,111506.32,239983.02
315170,202212,305,201,104,243614.56,126048.64,369663.20
315180,202212,3398,1444,1954,1751379.31,2368257.34,4119636.65
315190,202212,299,184,115,223011.49,139380.15,362391.64
315200,202212,1266,755,511,915079.8,619334.76,1534414.56
315210,202212,1860,1110,750,1345345.55,910214.58,2255560.13
315213,202212,26,15,11,18180.79,13332,31512.79
315217,202212,219,171,48,207253.31,58176,265429.31
315220,202212,1670,1229,441,1489582.51,534500.34,2024082.85
315230,202212,184,141,43,170893.24,52116,223009.24
315240,202212,369,241,128,292100.04,156351.93,448451.97
315250,202212,2854,1368,1486,1659262.48,1805883.4,3465145.88
315260,202212,141,81,60,98172,72720.1,170892.1
315270,202212,152,107,45,129684,54540,184224
315280,202212,617,400,217,484816.6,264225.52,749042.12
315290,202212,199,123,76,149077.94,92112.56,241190.50
315300,202212,98,74,24,89688,29088,118776
315310,202212,82,74,8,89688,9696,99384
315320,202212,145,93,52,112718.19,63024,175742.19
315330,202212,65,51,14,61812,16968,78780
315340,202212,390,283,107,342999.47,129685.56,472685.03
315350,202212,167,106,61,128472.88,73932,202404.88
315360,202212,104,49,55,59388.15,66660,126048.15
315370,202212,56,36,20,43633.66,24240,67873.66
315380,202212,6,5,1,6060,1212,7272
315390,202212,70,28,42,33936,50905.88,84841.88
315400,202212,844,636,208,770848.42,252096.7,1022945.12
315410,202212,321,191,130,231502.44,157565.36,389067.80
315415,202212,57,45,12,54540.28,14544,69084.28
315420,202212,212,151,61,183014.41,73932,256946.41
315430,202212,649,361,288,437535.04,349057.17,786592.21
315440,202212,98,65,33,78780,41208,119988
315445,202212,231,190,41,230286.26,50904.37,281190.63
315450,202212,182,132,50,159984.66,60600,220584.66
315460,202212,5027,2316,2711,2808297.62,3290617.16,6098914.78
315470,202212,47,20,27,24240,32724,56964
315480,202212,77,22,55,26665.48,66660.3,93325.78
315490,202212,765,490,275,593885.12,333300.48,927185.60
315500,202212,20,17,3,20604,3636,24240
315510,202212,155,111,44,134532.32,53328.35,187860.67
315520,202212,79,67,12,81204.2,14544,95748.2
315530,202212,47,27,20,32724,24240.2,56964.2
315540,202212,280,193,87,233919.79,105444.67,339364.46
315550,202212,195,155,40,187861.1,49692,237553.1
315560,202212,740,578,162,700549.69,196345.79,896895.48
315570,202212,311,155,156,189078.09,189073.62,378151.71
315580,202212,787,535,252,648424.22,305425.4,953849.62
315590,202212,192,98,94,118779.04,113928.63,232707.67
315600,202212,352,271,81,328455.75,98172.78,426628.53
315610,202212,102,48,54,58176,65448,123624
315620,202212,36,29,7,35149.69,8484,43633.69
315630,202212,132,97,35,117564.33,42420,159984.33
315640,202212,64,38,26,46056.98,31512,77568.98
315645,202212,52,34,18,41208,21816,63024
315650,202212,172,127,45,153924.23,54540,208464.23
315660,202212,444,205,239,248470.63,289672.41,538143.04
315670,202212,2538,1151,1387,1396261.33,1684701.14,3080962.47
315680,202212,786,563,223,682364.57,270276.5,952641.07
315690,202212,713,469,244,569654.1,295730.61,865384.71
315700,202212,2108,1102,1006,1336873.72,1220515.88,2557389.60
315710,202212,379,128,251,155137.23,304212,459349.23
315720,202212,540,327,213,396332.35,258156.42,654488.77
315725,202212,210,164,46,198768.87,55752.6,254521.47
315727,202212,89,53,36,64239.98,43632.33,107872.31
315730,202212,56,49,7,59388,8484,67872
315733,202212,88,52,36,63024.2,43632,106656.2
315737,202212,49,37,12,44844.68,14544,59388.68
315740,202212,29,22,7,27876,8484,36360
315750,202212,174,123,51,149076,61812.56,210888.56
315760,202212,45,34,11,41208,13332,54540
315765,202212,144,83,61,100597.61,73934.27,174531.88
315770,202212,240,161,79,195133.79,95748,290881.79
315780,202212,4156,2051,2105,2490730.68,2552480.56,5043211.24
315790,202212,248,191,57,232708.73,69085.13,301793.86
315800,202212,326,216,110,263007.52,133320,396327.52
315810,202212,65,40,25,48481.78,30300,78781.78
315820,202212,795,584,211,709045.6,255738.59,964784.19
315830,202212,123,80,43,96960.75,52116.5,149077.25
315840,202212,83,57,26,69084,31512,100596
315850,202212,277,187,90,226648.73,109082.16,335730.89
315860,202212,19,7,12,8484,14544,23028
315870,202212,39,30,9,36360.41,10908,47268.41
315880,202212,99,66,33,79992,39996,119988
315890,202212,107,74,33,89689.49,39996.54,129686.03
315895,202212,412,272,140,329676.07,169681.79,499357.86
315900,202212,89,38,51,47268,61812.08,109080.08
315910,202212,48,29,19,35148,23028,58176
315920,202212,159,109,50,132109.88,61812,193921.88
315930,202212,54,18,36,21817.69,43633.7,65451.39
315935,202212,129,101,28,122415.79,33936,156351.79
315940,202212,104,75,29,90900.52,35148,126048.52
315950,202212,37,28,9,33936,10908.65,44844.65
315960,202212,603,284,319,344213.88,386634.1,730847.98
315970,202212,32,27,5,32725.08,6060,38785.08
315980,202212,695,353,342,427847.53,415718.11,843565.64
315990,202212,268,154,114,186650.53,138168.58,324819.11
316000,202212,53,33,20,39996.8,24240,64236.8
316010,202212,95,80,15,96961.15,18180,115141.15
316020,202212,99,89,10,110292.49,12120,122412.49
316030,202212,389,227,162,275129.6,196344.95,471474.55
316040,202212,574,240,334,290881.99,407232.2,698114.19
316045,202212,53,47,6,56964,7272,64236
316050,202212,24,17,7,20604,8484,29088
316060,202212,108,75,33,90900.68,39996,130896.68
316070,202212,1254,842,412,1020522.78,500561.54,1521084.32
316080,202212,95,65,30,78886.7,36360,115246.7
316090,202212,36,18,18,21816,21816.44,43632.44
316095,202212,87,75,12,90901.78,14544.58,105446.36
316100,202212,354,195,159,236344.2,192708.85,429053.05
316105,202212,56,34,22,41209.28,26664,67873.28
316110,202212,1928,1495,433,1811972.31,524805.34,2336777.65
316120,202212,79,54,25,66660,30300.6,96960.6
316130,202212,118,90,28,109082.46,35148,144230.46
316140,202212,34,23,11,27876,13332,41208
316150,202212,225,157,68,190285.44,82416.33,272701.77
316160,202212,89,56,33,69084.76,39996.28,109081.04
316165,202212,80,53,27,64236.29,32724,96960.29
316170,202212,190,122,68,147864.56,82416,230280.56
316180,202212,219,85,134,103022.6,162410.14,265432.74
316190,202212,149,107,42,129684.58,50904,180588.58
316200,202212,693,385,308,466629.96,373297.82,839927.78
316210,202212,786,537,249,651065.53,301791.35,952856.88
316220,202212,126,81,45,98173.14,54540,152713.14
316225,202212,43,27,16,32725.84,19392,52117.84
316230,202212,48,27,21,32724.2,25452,58176.2
316240,202212,688,542,146,656915.64,176955.76,833871.40
316245,202212,176,155,21,187863.41,25452,213315.41
316250,202212,1736,1162,574,1409581.53,696903.82,2106485.35
316255,202212,135,107,28,129684,33936.1,163620.1
316257,202212,183,94,89,113928.68,107868.72,221797.40
316260,202212,201,137,64,166044.8,77568.2,243613.0
316265,202212,38,26,12,31512.2,14544.21,46056.41
316270,202212,703,495,208,599947.7,252099.06,852046.76
316280,202212,579,365,214,442388.69,259370.43,701759.12
316290,202212,883,607,276,736911.79,334515.99,1071427.78
316292,202212,650,269,381,326032.81,461774.78,787807.59
316294,202212,110,69,41,83630.16,49692,133322.16
316295,202212,400,194,206,236343.61,249677.71,486021.32
316300,202212,24,17,7,20604.6,8484,29088.6
316310,202212,28,16,12,19392,14544,33936
316320,202212,73,34,39,41208.85,47268,88476.85
316330,202212,179,126,53,152713.36,64236.91,216950.27
316340,202212,144,92,52,112716,63024,175740
316350,202212,198,137,61,166044.98,73932.2,239977.18
316360,202212,26,16,10,19392,12120,31512
316370,202212,1328,648,680,786602.4,825376.77,1611979.17
316380,202212,117,88,29,106656.56,35148,141804.56
316390,202212,103,77,26,94536,31512,126048
316400,202212,165,127,38,153926.05,46056,199982.05
316410,202212,313,224,89,271488.31,109080.2,380568.51
316420,202212,229,151,78,183017.08,94537.79,277554.87
316430,202212,165,91,74,110292.46,89688,199980.46
316440,202212,73,41,32,49693.22,38784.62,88477.84
316443,202212,49,41,8,49692,9696,59388
316447,202212,45,37,8,44845.23,9696,54541.23
316450,202212,248,184,64,224220.5,77568,301788.5
316460,202212,46,14,32,16968.7,38784.54,55753.24
316470,202212,1830,1335,495,1622898.98,601153.03,2224052.01
316480,202212,9,7,2,8484,2424,10908
316490,202212,20,6,14,8484,16968,25452
316500,202212,165,104,61,127260.77,73932.85,201193.62
316510,202212,138,111,27,135744.1,32724,168468.1
316520,202212,189,103,86,124836.91,104234.2,229071.11
316530,202212,180,113,67,136956.3,81204,218160.3
316540,202212,165,86,79,104234.08,95748.73,199982.81
316550,202212,164,101,63,122413.13,76356,198769.13
316553,202212,458,229,229,277553.67,277548.45,555102.12
316555,202212,63,53,10,64236.84,12120,76356.84
316556,202212,16,11,5,13332.41,6060,19392.41
316557,202212,33,28,5,33936.46,6060,39996.46
316560,202212,77,53,24,64236.2,29088,93324.2
316570,202212,216,197,19,238765.31,23028,261793.31
316580,202212,25,16,9,19392,10908,30300
316590,202212,90,76,14,92112.62,16968.8,109081.42
316600,202212,182,152,30,184226.06,36360,220586.06
316610,202212,72,51,21,61813.26,25452,87265.26
316620,202212,151,105,46,127260,55752.94,183012.94
316630,202212,61,47,14,56964.6,16968,73932.6
316640,202212,23,14,9,16968,10908,27876
316650,202212,109,87,22,105444,26664,132108
316660,202212,6,2,4,2424,4848,7272
316670,202212,437,151,286,183015.47,346632.93,529648.40
316680,202212,169,130,39,157562,47268.4,204830.4
316690,202212,154,94,60,113928,72720,186648
316695,202212,56,48,8,58176.87,9696,67872.87
316700,202212,26,18,8,21816,9696,31512
316710,202212,826,629,197,763570.42,239978.14,1003548.56
316720,202212,5401,2508,2893,3040977.92,3508746.58,6549724.50
316730,202212,16,14,2,16968,2424,19392
316740,202212,159,101,58,122412.99,70296,192708.99
316750,202212,22,13,9,15756.71,10908.8,26665.51
316760,202212,341,272,69,329667.42,83628.49,413295.91
316770,202212,187,97,90,117564,109080,226644
316780,202212,73,41,32,49692.6,38784,88476.6
316790,202212,68,47,21,56964.16,25452.1,82416.26
316800,202212,1860,1131,729,1372013.22,883568.27,2255581.49
316805,202212,34,23,11,27876.08,13332,41208.08
316810,202212,61,36,25,43632,30300.7,73932.7
316820,202212,37,21,16,25452,19392,44844
316830,202212,103,49,54,59389.19,65448.2,124837.39
316840,202212,517,312,205,378147.14,248461.6,626608.74
316850,202212,311,215,96,260583.09,116352.2,376935.29
316860,202212,6614,2975,3639,3606987.44,4410486.92,8017474.36
316870,202212,1789,1154,635,1401129.52,769626.48,2170756.00
316880,202212,166,85,81,103021.51,98173.46,201194.97
316890,202212,235,157,78,190285.34,94536.69,284822.03
316900,202212,436,304,132,368454.65,159984,528438.65
316905,202212,24,10,14,12120,16968,29088
316910,202212,82,34,48,41208,58176,99384
316920,202212,154,118,36,143017.7,43632,186649.7
316930,202212,2076,1064,1012,1290803.47,1230182.25,2520985.72
316935,202212,1005,594,411,719940.69,498140.03,1218080.72
316940,202212,1155,680,475,824172.62,576913.94,1401086.56
316950,202212,199,94,105,113929.38,127260,241189.38
316960,202212,1133,631,502,764794.48,608432.58,1373227.06
316970,202212,676,541,135,656913.83,163623.23,820537.06
316980,202212,86,45,41,54540,49692,104232
316990,202212,2367,1601,766,1940451.9,928396.05,2868847.95
317000,202212,351,272,79,330883.32,95749.61,426632.93
317005,202212,225,153,72,185439.26,87264.9,272704.16
317010,202212,7147,4076,3071,4946350.23,3728157.24,8674507.47
317020,202212,16333,7122,9211,8639417.88,11175936.65,19815354.53
317030,202212,93,42,51,50904,61812,112716
317040,202212,3234,2115,1119,2563436.52,1357449.7,3920886.22
317043,202212,78,62,16,75151.82,19393.27,94545.09
317047,202212,39,24,15,29088,18180.81,47268.81
317050,202212,158,126,32,153925.3,38784,192709.3
317052,202212,161,131,30,158773.14,36360,195133.14
317057,202212,191,142,49,172105.41,59388,231493.41
317060,202212,66,40,26,48480,31512.8,79992.8
317065,202212,52,39,13,47268,15756,63024
317070,202212,2027,939,1088,1138097.55,1319869.81,2457967.36
317075,202212,95,53,42,64236.75,50904,115140.75
317080,202212,1001,507,494,615722.53,599940.6,1215663.13
317090,202212,735,571,164,692064.21,198771.9,890836.11
317100,202212,453,341,112,413296.39,135744.95,549041.34
317103,202212,135,107,28,129684.75,33936,163620.75
317107,202212,51,40,11,48480,13332,61812
317110,202212,80,41,39,49692.4,47269.57,96961.97
317115,202212,44,40,4,48536.96,4848,53384.96
317120,202212,2249,1110,1139,1346580.59,1384118.67,2730699.26
317130,202212,2194,1480,714,1793777.94,866582.25,2660360.19
317140,202212,14,10,4,12120,4848,16968
317150,202212,296,179,117,216949.51,141804.49,358754.00
317160,202212,361,267,94,326031.65,116352.98,442384.63
317170,202212,243,159,84,192709.48,101808.6,294518.08
317180,202212,434,293,141,355119.75,170894.46,526014.21
317190,202212,267,190,77,230281.57,93324,323605.57
317200,202212,877,616,261,746614.84,316337.98,1062952.82
317210,202212,186,96,90,116357.66,109080.21,225437.87
317220,202212,23,11,12,13332,14544,27876
320010,202212,585,416,169,504199.23,204832.82,709032.05
320013,202212,141,93,48,112718.39,58178.21,170896.60
320016,202212,259,158,101,191501.77,122412,313913.77
320020,202212,773,457,316,555113.21,384212.01,939325.22
320030,202212,174,121,53,146653.97,64237.28,210891.25
320035,202212,137,94,43,113928.2,52116.24,166044.44
320040,202212,513,252,261,305429.76,316338.03,621767.79
320050,202212,126,88,38,106662.21,46056.26,152718.47
320060,202212,1977,927,1050,1124763.1,1272617.03,2397380.13
320070,202212,102,65,37,78780.87,44844,123624.87
320080,202212,862,485,377,590267.66,456927.51,1047195.17
320090,202212,1359,875,484,1060526.53,586622.14,1647148.67
320100,202212,363,208,155,253314.86,187862.28,441177.14
320110,202212,137,83,54,100602.56,65448.5,166051.06
320115,202212,119,100,19,121200.18,23028,144228.18
320120,202212,3958,2063,1895,2504064.76,2302841.67,4806906.43
320130,202212,8590,3706,4884,4494232.41,5929218.18,10423450.59
320140,202212,530,337,193,408459.2,233923.18,642382.38
320150,202212,2290,1254,1036,1521106.08,1258070.34,2779176.42
320160,202212,676,293,383,355122.49,464198.61,819321.10
320170,202212,117,91,26,110292.98,31512.02,141805.00
320180,202212,62,34,28,41209.38,33936.12,75145.50
320190,202212,260,154,106,186653.78,128472.1,315125.88
320200,202212,64,53,11,64238.7,13332,77570.7
320210,202212,949,514,435,622988.68,527228.06,1150216.74
320220,202212,307,106,201,128472.8,244824.2,373297.0
320225,202212,81,67,14,81204.39,16968.49,98172.88
320230,202212,747,475,272,575725.76,332095.96,907821.72
320240,202212,3788,1714,2074,2077419.05,2517357.32,4594776.37
320245,202212,542,371,171,449660.05,208470.88,658130.93
320250,202212,255,118,137,143020.4,166046.53,309066.93
320255,202212,124,91,33,110294.15,39996.22,150290.37
320260,202212,300,159,141,193921.73,170893.67,364815.40
320265,202212,151,117,34,141805.18,41208.64,183013.82
320270,202212,166,124,42,150291.67,50905.15,201196.82
320280,202212,1402,780,622,945384.64,753879.86,1699264.50
320290,202212,69,52,17,63024.4,20604,83628.4
320300,202212,650,441,209,535718.77,253310.71,789029.48
320305,202212,800,433,367,526027.99,444818.9,970846.89
320310,202212,211,123,88,150292.53,106656.2,256948.73
320313,202212,369,168,201,203623.94,243613.35,447237.29
320316,202212,114,81,33,98172.98,39996,138168.98
320320,202212,3665,1614,2051,1957430.62,2490693.13,4448123.75
320330,202212,296,215,81,260580.35,98172,358752.35
320332,202212,813,482,331,585430.72,401186.93,986617.65
320334,202212,303,167,136,202405.85,164833.3,367239.15
320335,202212,150,99,51,119993.79,61814.5,181808.29
320340,202212,621,439,182,532086.86,220590.48,752677.34
320350,202212,1153,470,683,569654,827808.84,1397462.84
320360,202212,179,83,96,100596.08,116352,216948.08
320370,202212,244,178,66,215740.55,79992.6,295733.15
320380,202212,333,238,95,288462.62,115140.89,403603.51
320390,202212,1198,699,499,847206.4,606005.82,1453212.22
320400,202212,328,231,97,279981.48,117564.06,397545.54
320405,202212,1022,412,610,499364.56,739336.28,1238700.84
320410,202212,990,490,500,593893.11,606007.78,1199900.89
320420,202212,611,273,338,330888.55,410880.32,741768.87
320425,202212,221,114,107,138170.03,129684.8,267854.83
320430,202212,421,220,201,266650.22,243616.83,510267.05
320435,202212,185,126,59,152714.65,71510.44,224225.09
320440,202212,217,118,99,143019.52,119993,263012.52
320450,202212,143,74,69,89689.03,83629.06,173318.09
320455,202212,239,185,54,224224.35,65448.66,289673.01
320460,202212,323,192,131,232705.68,158772.21,391477.89
320465,202212,121,83,38,100599.67,46056.65,146656.32
320470,202212,777,461,316,558744.88,383003.82,941748.70
320480,202212,236,157,79,190288.52,95748.82,286037.34
320490,202212,3514,1666,1848,2021679.98,2242251.76,4263931.74
320495,202212,133,75,58,90900.4,70296.6,161197.0
320500,202212,10927,5273,5654,6394743.12,6863681.53,13258424.65
320501,202212,586,298,288,361191.28,349065.6,710256.88
320503,202212,333,234,99,283614.11,119988.37,403602.48
320506,202212,284,193,91,233918.09,110292.38,344210.47
320510,202212,1345,573,772,694490.5,935681.89,1630172.39
320515,202212,87,67,20,81205.78,24240,105445.78
320517,202212,240,171,69,208469.02,83628,292097.02
320520,202212,8537,3536,5001,4286962.27,6064957.75,10351920.02
320530,202212,7566,3600,3966,4369357.18,4810499.16,9179856.34
330010,202212,3796,1855,1941,2253176.51,2356157.02,4609333.53
330015,202212,217,93,124,112717.55,150288.56,263006.11
330020,202212,4322,1639,2683,1991368.4,3251830.4,5243198.8
330022,202212,278,141,137,170895.67,166044.95,336940.62
330023,202212,899,256,643,311488.16,779326.7,1090814.86
330025,202212,946,159,787,192711.76,953853.32,1146565.08
330030,202212,2010,1236,774,1499305.76,939313.26,2438619.02
330040,202212,2862,1449,1413,1758659.31,1717430.23,3476089.54
330045,202212,11182,3487,7695,4227568.21,9339803.37,13567371.58
330050,202212,935,573,362,694490.58,439959.69,1134450.27
330060,202212,1289,751,538,910244.73,652064.67,1562309.40
330070,202212,4710,1579,3131,1915023.82,3799674.47,5714698.29
330080,202212,1747,764,983,925995.88,1193840.23,2119836.11
330090,202212,415,227,188,275128.29,227858.24,502986.53
330093,202212,237,98,139,118777.1,168468.99,287246.09
330095,202212,71,37,34,44845.16,41208,86053.16
330100,202212,11906,5873,6033,7121933.19,7325442.11,14447375.30
330110,202212,497,225,272,272703.45,329668.74,602372.19
330115,202212,548,267,281,323610.7,340575.09,664185.79
330120,202212,423,220,203,266643.42,246038.38,512681.80
330130,202212,1739,457,1282,553899.96,1553818.15,2107718.11
330140,202212,730,367,363,444808.44,439956.7,884765.14
330150,202212,560,337,223,408449.66,270277.8,678727.46
330160,202212,214,124,90,150290.71,109081.7,259372.41
330170,202212,29422,10327,19095,12525224.55,23171435.59,35696660.14
330180,202212,259,142,117,172105.76,141807.15,313912.91
330185,202212,1303,500,803,606012.45,973254.17,1579266.62
330187,202212,621,195,426,236346.58,517530.63,753877.21
330190,202212,6856,2561,4295,3104009.64,5212870.96,8316880.60
330200,202212,5008,1654,3354,2004708.19,4073607.45,6078315.64
330205,202212,518,289,229,350275.74,277550.74,627826.48
330210,202212,977,584,393,707829.6,476320.9,1184150.5
330220,202212,3002,1744,1258,2113792.67,1524721.41,3638514.08
330225,202212,637,336,301,407237.95,364813.72,772051.67
330227,202212,2652,861,1791,1045979.18,2173146.24,3219125.42
330230,202212,262,139,123,168468.96,150288.58,318757.54
330240,202212,4772,2179,2593,2641024.61,3142776.25,5783800.86
330245,202212,175,83,92,100597.56,111504.85,212102.41
330250,202212,7335,3475,3860,4211842.09,4682030.54,8893872.63
330260,202212,837,227,610,275128.47,740536.78,1015665.25
330270,202212,4337,1402,2935,1699270.53,3559705.77,5258976.30
330280,202212,496,298,198,361195.09,239979.71,601174.80
330285,202212,7009,2244,4765,2721044.81,5783787.95,8504832.76
330290,202212,816,282,534,341793.97,647212.64,989006.61
330300,202212,789,480,309,582519.07,374517.47,957036.54
330310,202212,503,288,215,349065.33,260582.79,609648.12
330320,202212,8489,2884,5605,3497966.04,6797014.78,10294980.82
330330,202212,10350,3778,6572,4580259.1,7972648.7,12552907.8
330340,202212,2970,1637,1333,1985288.51,1616826.74,3602115.25
330350,202212,21840,7938,13902,9626041.21,16867725.6,26493766.81
330360,202212,2104,977,1127,1185387.68,1369593.45,2554981.13
330370,202212,1065,554,511,672676.49,619344.82,1292021.31
330380,202212,1085,438,647,530860.53,785384.44,1316244.97
330385,202212,705,348,357,421783.87,432687.01,854470.88
330390,202212,6763,3473,3290,4210600.52,3989959.43,8200559.95
330395,202212,424,272,152,329673.35,184231.43,513904.78
330400,202212,766,388,378,470270.48,458139.59,928410.07
330410,202212,554,396,158,481173.93,191499.16,672673.09
330411,202212,400,217,183,263005.41,223008.2,486013.61
330412,202212,233,105,128,127263.52,155136.88,282400.40
330414,202212,5914,2317,3597,2809521.35,4366887.45,7176408.80
330415,202212,670,285,385,345434.91,470261.82,815696.73
330420,202212,2678,1401,1277,1700471.83,1548946.77,3249418.60
330430,202212,1945,819,1126,993858.03,1364729.19,2358587.22
330440,202212,412,197,215,238768.16,260582.15,499350.31
330450,202212,127,55,72,66660.41,87264.56,153924.97
330452,202212,2624,1071,1553,1299302.81,1883475.34,3182778.15
330455,202212,136394,47255,89139,57317476.78,108164585.51,165482062.29
330460,202212,280,128,152,155138.69,184225.3,339363.99
330470,202212,1346,714,632,865382.99,767208.46,1632591.45
330475,202212,1991,602,1389,729635.83,1685903.56,2415539.39
330480,202212,847,467,380,566013.05,460567.09,1026580.14
330490,202212,18014,5500,12514,6671143.06,15188997.69,21860140.75
330500,202212,1681,721,960,873869.4,1163532.91,2037402.31
330510,202212,12065,4209,7856,5105110.72,9532520.47,14637631.19
330513,202212,107,55,52,66660,64236,130896
330515,202212,746,319,427,387845.49,518746,906591.49
330520,202212,2734,924,1810,1119921.35,2196176.61,3316097.96
330530,202212,187,106,81,128475.34,98172.1,226647.44
330540,202212,367,192,175,232705.95,213314.76,446020.71
330550,202212,3072,1009,2063,1224141.92,2501600.13,3725742.05
330555,202212,1127,414,713,501775.07,864162.77,1365937.84
330560,202212,843,294,549,356335.84,666609.54,1022945.38
330570,202212,343,235,108,284820.56,132108.43,416928.99
330575,202212,947,351,596,426635.61,722362.3,1148997.91
330580,202212,3700,1935,1765,2345276.47,2141627.9,4486904.37
330590,202212,276,145,131,175742.34,158773.48,334515.82
330600,202212,1513,884,629,1073859.5,762360.05,1836219.55
330610,202212,1750,890,860,1079908.86,1044753.24,2124662.10
330615,202212,235,187,48,226646.94,58178.61,284825.55
330620,202212,1111,441,670,534509.26,812052.07,1346561.33
330630,202212,5004,2957,2047,3586408.59,2482215.21,6068623.80
350010,202212,627,413,214,501786.94,259369.99,761156.93
350020,202212,56,18,38,23029.43,46056,69085.43
350030,202212,595,352,243,426647.53,294524.12,721171.65
350040,202212,115,49,66,59392.1,81205.19,140597.29
350050,202212,379,182,197,221801.74,241191.47,462993.21
350055,202212,131,56,75,67873.1,90900.2,158773.3
350060,202212,85,35,50,42422.81,60600.2,103023.01
350070,202212,824,458,366,555119.58,444815.59,999935.17
350075,202212,82,50,32,60601.83,38784.2,99386.03
350080,202212,59,27,32,32724.87,38784.27,71509.14
350090,202212,82,45,37,54543.86,44844,99387.86
350100,202212,304,188,116,227857.94,140592.38,368450.32
350110,202212,46,29,17,35149.19,20604,55753.19
350115,202212,186,88,98,106657.01,119988.1,226645.11
350120,202212,109,68,41,82419.25,49692.97,132112.22
350130,202212,432,185,247,224232.48,299371.99,523604.47
350140,202212,35,22,13,26664.44,15756,42420.44
350150,202212,72,50,22,60600.74,26664.16,87264.90
350160,202212,2521,989,1532,1198694.89,1859216.85,3057911.74
350170,202212,426,245,181,296950.68,219377.04,516327.72
350180,202212,166,90,76,109083.78,92112.81,201196.59
350190,202212,1034,551,483,667841.03,587821.36,1255662.39
350200,202212,60,25,35,30301.02,42420,72721.02
350210,202212,1379,739,640,895703.92,775704.65,1671408.57
350220,202212,653,524,129,635103.75,156350.47,791454.22
350230,202212,69,41,28,49692.84,33936.1,83628.94
350240,202212,60,37,23,44844.65,27876.44,72721.09
350250,202212,1163,523,640,633897.28,775691.17,1409588.45
350260,202212,111,82,29,99386.45,35148.87,134535.32
350270,202212,1001,660,341,801137.87,413295.7,1214433.57
350275,202212,346,126,220,152713.99,266643.84,419357.83
350280,202212,4622,2198,2424,2666505.49,2937903.77,5604409.26
350290,202212,494,212,282,256949.06,341787.85,598736.91
350300,202212,49,24,25,29091.37,30300.9,59392.27
350310,202212,81,44,37,53329.27,44844.38,98173.65
350315,202212,75,31,44,37572,53328,90900
350320,202212,3552,1644,1908,1995035.73,2313730.19,4308765.92
350330,202212,1727,852,875,1032654.4,1060504.48,2093158.88
350335,202212,21,13,8,15756,9696,25452
350340,202212,127,51,76,61812.38,93327.52,155139.90
350350,202212,97,46,51,55752.2,61812.9,117565.1
350360,202212,106,68,38,82417.91,46056.24,128474.15
350370,202212,88,48,40,58179.74,48480.48,106660.22
350380,202212,877,375,502,454509.75,608430.64,1062940.39
350390,202212,1897,701,1196,849632.43,1451991.62,2301624.05
350395,202212,18,14,4,16968,4848,21816
350400,202212,1835,868,967,1052037.74,1172004.88,2224042.62
350410,202212,3260,1319,1941,1598667.22,2353725.16,3952392.38
350420,202212,288,172,116,208468.42,140592.83,349061.25
350430,202212,102,52,50,64239.14,60602.03,124841.17
350440,202212,144,100,44,121207.35,53328.35,174535.70
350450,202212,1822,998,824,1209619.72,1001114.52,2210734.24
350460,202212,421,142,279,172107.81,340581.14,512688.95
350470,202212,21,12,9,14544,10908,25452
350480,202212,203,105,98,127267.61,118776.22,246043.83
350490,202212,259,116,143,140593.31,173317.79,313911.10
350500,202212,57,20,37,24240,44844,69084
350510,202212,153,88,65,106659.7,78780.01,185439.71
350520,202212,460,248,212,301800.85,256950.67,558751.52
350530,202212,459,218,241,264225.54,292104.59,556330.13
350535,202212,96,62,34,75144.79,41208.61,116353.40
350540,202212,370,193,177,233920.32,215740.09,449660.41
350550,202212,2909,1619,1290,1964725.59,1565911.22,3530636.81
350560,202212,621,418,203,506632.03,247252.13,753884.16
350570,202212,4932,2004,2928,2433751.63,3552402.58,5986154.21
350580,202212,396,185,211,224226.44,255734.31,479960.75
350590,202212,1043,560,483,679948.31,585530.81,1265479.12
350600,202212,6727,3068,3659,3719783.14,4437168.07,8156951.21
350610,202212,1601,825,776,1002348.97,941729.9,1944078.87
350620,202212,25,15,10,18180,12120,30300
350630,202212,271,132,139,159987.35,168469.15,328456.50
350635,202212,1326,555,771,672676.66,936892.47,1609569.13
350640,202212,125,89,36,107870,43632.2,151502.2
350650,202212,1989,1305,684,1582927.36,830221,2413148.36
350660,202212,841,329,512,398753.85,620549.29,1019303.14
350670,202212,304,150,154,181800.2,186648.7,368448.9
350680,202212,164,82,82,99386.93,99385.5,198772.43
350690,202212,213,94,119,113929.88,144228,258157.88
350700,202212,984,463,521,562385.7,632673.69,1195059.39
350710,202212,429,157,272,190288.65,329668.46,519957.11
350715,202212,57,46,11,55752.71,13332,69084.71
350720,202212,16,11,5,13332.32,6060,19392.32
350730,202212,43,26,17,31512,20604,52116
350740,202212,259,143,116,173318.85,141805.56,315124.41
350745,202212,31,14,17,16969.4,20604.06,37573.46
350750,202212,2617,1513,1104,1837461.93,1340486.56,3177948.49
350760,202212,4214,1770,2444,2146511.98,2965786.98,5112298.96
350770,202212,57,35,22,42420.2,26664,69084.2
350775,202212,54,39,15,47273.79,18181.36,65455.15
350780,202212,478,240,238,290892.01,288458.45,579350.46
350790,202212,377,154,223,186651.12,271491.83,458142.95
350800,202212,551,330,221,399967.54,267852.32,667819.86
350810,202212,528,402,126,487248.24,152712.2,639960.44
350820,202212,99,56,43,67872.52,52116,119988.52
350830,202212,81,41,40,49692.49,48480,98172.49
350840,202212,861,341,520,413303.73,630356.89,1043660.62
350850,202212,1966,1011,955,1225357.87,1158677.47,2384035.34
350860,202212,720,371,349,450878.48,422997.46,873875.94
350870,202212,470,311,159,378150.21,192708.26,570858.47
350880,202212,284,153,131,186651.19,158775.45,345426.64
350890,202212,38,24,14,29088,16968.22,46056.22
350900,202212,1733,544,1189,660556.7,1442308.67,2102865.37
350910,202212,24,12,12,14544,14544.42,29088.42
350920,202212,827,422,405,511471.93,492072.95,1003544.88
350925,202212,1239,615,624,745410.19,756299.6,1501709.79
350930,202212,126,72,54,87266.02,65448,152714.02
350940,202212,767,396,371,479972.28,449669.56,929641.84
350945,202212,120,83,37,100599.12,44844.89,145444.01
350950,202212,18903,8683,10220,10537399.14,12403701.67,22941100.81
350960,202212,1804,718,1086,872838.49,1316247.2,2189085.69
350970,202212,1158,558,600,676191.21,727213.51,1403404.72
350980,202212,98,64,34,78781.46,41208.03,119989.49
350990,202212,425,151,274,183012.99,332090.78,515103.77
350995,202212,44,18,26,21817.29,31513.07,53330.36
351000,202212,635,401,234,486030.62,284831.46,770862.08
351010,202212,52,35,17,42421.94,20604,63025.94
351015,202212,49,30,19,36361.21,23028,59389.21
351020,202212,1553,925,628,1122337.6,762356.07,1884693.67
351030,202212,356,205,151,248461.02,183012.37,431473.39
351040,202212,1073,582,491,706611.69,596307.62,1302919.31
351050,202212,3888,1754,2134,2127144.93,2590069.55,4717214.48
351060,202212,6516,2332,4184,2828887.64,5073460.89,7902348.53
351070,202212,431,267,164,323615.34,198772.66,522388.00
351080,202212,793,581,212,704189.5,256947.04,961136.54
351090,202212,48,25,23,30300.9,27876.41,58177.31
351100,202212,436,230,206,278772.91,249680.84,528453.75
351110,202212,2209,1008,1201,1222938.12,1456828.15,2679766.27
351120,202212,65,30,35,36360.83,43632,79992.83
351130,202212,196,64,132,77570.65,159987.25,237557.90
351140,202212,335,198,137,241192.86,166047.52,407240.38
351150,202212,527,263,264,318762.55,319970.48,638733.03
351160,202212,328,190,138,230285.52,167256.72,397542.24
351170,202212,242,139,103,168469.55,124836.95,293306.50
351190,202212,95,58,37,70296.82,44844.52,115141.34
351200,202212,360,232,128,281191.2,155137.11,436328.31
351210,202212,133,65,68,78781.27,82416,161197.27
351220,202212,616,346,270,419366.08,327241.07,746607.15
351230,202212,321,207,114,250891.36,138168.3,389059.66
351240,202212,250,124,126,150291.21,153927.14,304218.35
351250,202212,86,59,27,71512.72,33936.1,105448.82
351260,202212,146,101,45,122412.57,54540,176952.57
351270,202212,44,20,24,24240.85,29088,53328.85
351280,202212,1079,518,561,629039.74,679938.9,1308978.64
351290,202212,256,119,137,144230.27,166044,310274.27
351300,202212,4278,1778,2500,2157420.03,3032464.47,5189884.50
351310,202212,757,364,393,441188.95,476327.85,917516.80
351320,202212,121,67,54,81205.56,65448,146653.56
351330,202212,42,25,17,30300,20604,50904
351340,202212,1514,809,705,980535.73,854463.86,1834999.59
351350,202212,2548,1487,1061,1803523.39,1287151.73,3090675.12
351360,202212,847,387,460,469050.85,557525.08,1026575.93
351370,202212,464,226,238,273917.95,288456.4,562374.35
351380,202212,9318,4017,5301,4871147.96,6426061.93,11297209.89
351385,202212,22,16,6,19392.28,7272,26664.28
351390,202212,289,210,79,254523.45,95748.55,350272.00
351400,202212,64,41,23,49692.73,27876,77568.73
351410,202212,487,283,204,344215.77,247251.62,591467.39
351420,202212,75,54,21,65448.04,25452,90900.04
351430,202212,71,36,35,43632.34,42420.2,86052.54
351440,202212,852,552,300,669051.26,363605.17,1032656.43
351450,202212,296,144,152,174532.01,184229.44,358761.45
351460,202212,142,59,83,71509.82,100598.03,172107.85
351470,202212,147,77,70,93326.57,84840.89,178167.46
351480,202212,484,283,201,343001.16,243612.2,586613.36
351490,202212,321,130,191,157561,232704.55,390265.55
351492,202212,28,17,11,20604.79,13332,33936.79
351495,202212,25,17,8,20604,9696,30300
351500,202212,3644,1444,2200,1750156.36,2666420.58,4416576.94
351510,202212,2260,820,1440,995077.95,1747724.53,2742802.48
351512,202212,13,9,4,10908,4848,15756
351515,202212,214,123,91,149079.78,110292,259371.78
351518,202212,708,417,291,506640.71,353923.71,860564.42
351519,202212,89,54,35,65449.18,42420,107869.18
351520,202212,173,107,66,129687.74,80014.83,209702.57
351530,202212,26,12,14,14544,16968,31512
351535,202212,140,85,55,103024.57,66661.39,169685.96
351540,202212,493,316,177,383003.98,215739.79,598743.77
351550,202212,1658,969,689,1174463.62,836285.11,2010748.73
351560,202212,86,48,38,58177.41,46056,104233.41
351565,202212,15,7,8,8484.32,9696,18180.32
351570,202212,2947,1332,1615,1616866.45,1961033.95,3577900.40
351580,202212,36,33,3,39996,3636,43632
351590,202212,70,42,28,50906.65,33936.63,84843.28
351600,202212,183,133,50,162414.31,60600.07,223014.38
351610,202212,53,24,29,29088.92,35148,64236.92
351620,202212,6249,3278,2971,3979130.39,3600883.1,7580013.49
351630,202212,3553,1677,1876,2034998.61,2273737.31,4308735.92
351640,202212,2629,1139,1490,1380621.65,1805893.2,3186514.85
351650,202212,33,27,6,32724.79,7272,39996.79
351660,202212,145,94,51,113928.93,61812,175740.93
351670,202212,786,447,339,541781.78,410874.53,952656.31
351680,202212,86,64,22,77568,26664,104232
351685,202212,13,9,4,10908,4848,15756
351690,202212,306,194,112,235135.51,135745.02,370880.53
351700,202212,195,131,64,159035.87,77568.2,236604.07
351710,202212,67,42,25,50905.56,30300.46,81206.02
351720,202212,126,71,55,86053.64,66660,152713.64
351730,202212,118,80,38,96960.44,46056,143016.44
351740,202212,826,520,306,631480.15,370876.6,1002356.75
351750,202212,391,156,235,189074.92,284820.67,473895.59
351760,202212,722,559,163,677416.97,197556,874972.97
351770,202212,300,242,58,293319.53,70296.56,363616.09
351780,202212,147,90,57,110293.97,69084,179377.97
351790,202212,281,141,140,170895.64,169682.4,340578.04
351800,202212,46,29,17,35148.18,20604,55752.18
351810,202212,124,78,46,94539.21,55754.58,150293.79
351820,202212,779,547,232,663005.06,282401.73,945406.79
351830,202212,687,220,467,266646.43,566008.72,832655.15
351840,202212,2401,1073,1328,1301722.23,1610755.5,2912477.73
351850,202212,279,191,88,231497.19,106656,338153.19
351860,202212,617,410,207,498148.89,250885.7,749034.59
351870,202212,6162,2756,3406,3344005.51,4130584.69,7474590.20
351880,202212,23426,8899,14527,10799168.28,17635840.7,28435008.98
351885,202212,107,57,50,69087.01,60601.63,129688.64
351890,202212,75,52,23,63024.8,27876,90900.8
351900,202212,251,128,123,155138.58,149076.19,304214.77
351905,202212,100,47,53,56966.07,64236,121202.07
351907,202212,3951,1590,2361,1929556.3,2863981.6,4793537.9
351910,202212,159,66,93,79994.47,112717.38,192711.85
351920,202212,116,63,53,76356,64236,140592
351925,202212,92,58,34,70298.8,42421.17,112719.97
351930,202212,473,295,178,357560.03,215743.6,573303.63
351940,202212,247,101,146,123626.91,176953.54,300580.45
351950,202212,148,79,69,95749.48,83630.58,179380.06
351960,202212,1006,484,522,586628.86,632680.46,1219309.32
351970,202212,2235,1043,1192,1265347.23,1444723.92,2710071.15
351980,202212,157,65,92,78782.25,111505.48,190287.73
351990,202212,262,163,99,197558.43,119989.27,317547.70
352000,202212,325,204,121,247261.88,146655.92,393917.80
352010,202212,451,289,162,350364.84,196353.42,546718.26
352020,202212,210,69,141,83628,170892,254520
352030,202212,1242,576,666,699343.45,809631.91,1508975.36
352040,202212,710,273,437,330881.28,529648.48,860529.76
352042,202212,353,81,272,98174.21,330877.88,429052.09
352044,202212,386,216,170,261804.19,206044.78,467848.97
352050,202212,3423,1242,2181,1507759.55,2651867.94,4159627.49
352060,202212,105,62,43,75144.28,52116.99,127261.27
352070,202212,103,70,33,84845.43,39996,124841.43
352080,202212,67,41,26,49694.6,31512.48,81207.08
352090,202212,191,119,72,144231.64,87264.45,231496.09
352100,202212,331,162,169,196347.61,204830.33,401177.94
352110,202212,111,28,83,33936.85,100596,134532.85
352115,202212,67,26,41,31512,49692.2,81204.2
352120,202212,71,48,23,58176,27876,86052
352130,202212,219,161,58,195141.29,70296.17,265437.46
352140,202212,198,94,104,113929.42,126048.81,239978.23
352150,202212,132,69,63,83629.85,76357.82,159987.67
352160,202212,146,94,52,113931.64,63024.04,176955.68
352170,202212,436,289,147,350272.48,178164.08,528436.56
352180,202212,722,437,285,529661.57,345428.59,875090.16
352190,202212,252,104,148,127262.63,179377.37,306640.00
352200,202212,30,13,17,15756.6,21816.1,37572.7
352210,202212,4785,1877,2908,2277437.36,3524526.53,5801963.89
352215,202212,77,42,35,50904.2,42420,93324.2
352220,202212,6457,2375,4082,2878575.41,4957135.82,7835711.23
352230,202212,3784,2367,1417,2871330.66,1721049.76,4592380.42
352240,202212,2898,1611,1287,1952581.45,1563495.74,3516077.19
352250,202212,3824,1699,2125,2059234.49,2577932.32,4637166.81
352260,202212,1086,570,516,690854.32,625404.12,1316258.44
352265,202212,67,39,28,47268,33936,81204
352270,202212,417,225,192,272712.23,232711.23,505423.46
352280,202212,532,309,223,374517.22,270276,644793.22
352290,202212,181,97,84,117567.8,101812.21,219380.01
352300,202212,103,64,39,77570.72,47268.6,124839.32
352310,202212,7891,3393,4498,4114877.39,5460071.79,9574949.18
352320,202212,1220,626,594,761151.54,719934.13,1481085.67
352330,202212,555,284,271,344212.35,329664.96,673877.31
352340,202212,1429,648,781,786612.06,947792.73,1734404.79
352350,202212,389,207,182,250889.6,220587.99,471477.59
352360,202212,220,96,124,116353,150288.2,266641.2
352370,202212,126,77,49,94540.14,59388.34,153928.48
352380,202212,117,83,34,100599.61,41209.13,141808.74
352390,202212,2749,1166,1583,1414437.78,1921029.01,3335466.79
352400,202212,578,250,328,303000.46,398749.8,701750.26
352410,202212,943,615,328,747833.03,398767.99,1146601.02
352420,202212,88,66,22,79993.04,26664,106657.04
352430,202212,1833,796,1037,964789.06,1256871.82,2221660.88
352440,202212,3651,1640,2011,1987728.93,2439767.57,4427496.50
352450,202212,204,156,48,189073.99,58177.2,247251.19
352460,202212,665,323,342,391480.63,414508.88,805989.51
352470,202212,710,268,442,326038.98,536920.27,862959.25
352480,202212,1722,967,755,1174456.99,915070.13,2089527.12
352490,202212,57,25,32,30300.6,38784.09,69084.69
352500,202212,1367,546,821,661764.91,995058.89,1656823.80
352510,202212,758,392,366,475123.85,443596.67,918720.52
352520,202212,911,403,508,488444.28,616923.73,1105368.01
352530,202212,1966,982,984,1190228.49,1198674.67,2388903.16
352540,202212,72,49,23,59391.08,27876,87267.08
352550,202212,223,126,97,152713.34,117564.4,270277.74
352560,202212,54,39,15,47270.15,18180.96,65451.11
352570,202212,790,378,412,458155.76,500567.22,958722.98
352580,202212,59,43,16,52118.71,19392,71510.71
352585,202212,18,7,11,8484.64,14544.95,23029.59
352590,202212,4742,2308,2434,2797384.99,2951249.34,5748634.33
352600,202212,379,259,120,313917.17,145445.57,459362.74
352610,202212,961,417,544,505414.84,660546.79,1165961.63
352620,202212,1182,442,740,536926.9,896889.86,1433816.76
352630,202212,194,70,124,84841.55,150288.62,235130.17
352640,202212,539,342,197,414522.32,238768.92,653291.24
352650,202212,93,64,29,77569.01,35148,112717.01
352660,202212,70,39,31,47269.01,37572,84841.01
352670,202212,1809,950,859,1151452.07,1041110.03,2192562.10
352680,202212,998,588,410,713889.94,498150.59,1212040.53
352690,202212,4910,2124,2786,2575571.79,3382715.45,5958287.24
352700,202212,90,50,40,60600.58,48480.88,109081.46
352710,202212,1577,797,780,965995.54,947786.1,1913781.64
352720,202212,1639,670,969,813282.59,1175665.06,1988947.65
352725,202212,29,22,7,26664,8484,35148
352730,202212,415,203,212,246040.21,256947.46,502987.67
352740,202212,411,260,151,315134.24,183015.45,498149.69
352750,202212,23,14,9,16968.6,10908.14,27876.74
352760,202212,235,148,87,179378.67,105445.74,284824.41
352770,202212,79,57,22,69086.93,26664.18,95751.11
352780,202212,75,38,37,46056,46056.78,92112.78
352790,202212,25,17,8,20606.07,9696.18,30302.25
352800,202212,248,185,63,224227.17,76356.88,300584.05
352810,202212,162,101,61,122413.81,73933.63,196347.44
352820,202212,48,36,12,43632.7,14544,58176.7
352830,202212,75,50,25,60601.14,30300.01,90901.15
352840,202212,751,331,420,402395.53,509046.08,911441.61
352850,202212,1921,562,1359,681155.42,1649540.87,2330696.29
352860,202212,120,74,46,89690.48,55752.82,145443.30
352870,202212,51,32,19,38787,23028.1,61815.1
352880,202212,192,109,83,132112.49,100598.09,232710.58
352885,202212,34,22,12,26664.37,14544,41208.37
352890,202212,58,35,23,42421.47,27876.6,70298.07
352900,202212,4804,2235,2569,2712532.41,3116065.14,5828597.55
352910,202212,39,32,7,38784.2,8484,47268.2
352920,202212,654,375,279,454520.22,338155.18,792675.40
352930,202212,1234,570,664,692072.31,804772.2,1496844.51
352940,202212,6582,2468,4114,2993704.09,4988659.33,7982363.42
352950,202212,126,57,69,69085.55,83629.95,152715.50
352960,202212,63,39,24,47268.93,29088,76356.93
352965,202212,16,10,6,12120.18,7272,19392.18
352970,202212,551,394,157,478759.24,190288.94,669048.18
352980,202212,163,94,69,113934.33,83629.78,197564.11
352990,202212,1002,467,535,566022.91,648431.05,1214453.96
353000,202212,58,25,33,30300,39996.51,70296.51
353010,202212,536,324,212,392701.15,258160.08,650861.23
353020,202212,346,223,123,270284.38,149078.68,419363.06
353030,202212,1457,640,817,775702.95,990222.75,1765925.70
353040,202212,90,47,43,56966.48,52117.15,109083.63
353050,202212,1382,895,487,1084788,591457.62,1676245.62
353060,202212,9668,4130,5538,5009359.66,6714537.85,11723897.51
353070,202212,2063,1194,869,1447179.9,1053014.02,2500193.92
353080,202212,1371,729,642,884788.33,780530.63,1665318.96
353090,202212,67,36,31,43632.8,37572,81204.8
353100,202212,45,34,11,41209.86,13333.09,54542.95
353110,202212,2366,781,1585,947824.39,1923506.47,2871330.86
353120,202212,141,77,64,93324.2,77568,170892.2
353130,202212,880,415,465,504211.33,563588.48,1067799.81
353140,202212,603,281,322,340583.05,390269.48,730852.53
353150,202212,321,163,158,198771.83,191500.01,390271.84
353160,202212,110,82,28,100599.82,33936,134535.82
353170,202212,208,74,134,90902.08,162408,253310.08
353180,202212,1294,589,705,715095.5,855681.86,1570777.36
353190,202212,517,363,154,439972.75,186650.62,626623.37
353200,202212,277,134,143,163622.77,173316.95,336939.72
353205,202212,20,13,7,15756,8484,24240
353210,202212,72,43,29,52116.8,35148.56,87265.36
353215,202212,44,24,20,29088.2,24240,53328.2
353220,202212,83,44,39,53330.03,47268.6,100598.63
353230,202212,160,67,93,81205.64,112716,193921.64
353240,202212,415,175,240,212101.39,290880.6,502981.99
353250,202212,188,93,95,112719.41,115141.87,227861.28
353260,202212,481,306,175,370882.47,212105.87,582988.34
353270,202212,74,57,17,69085.74,20604,89689.74
353280,202212,121,56,65,67873.25,78783.9,146657.15
353282,202212,130,87,43,105445.25,52117.28,157562.53
353284,202212,32,22,10,26665.47,12120,38785.47
353286,202212,9,4,5,4848.2,6060.3,10908.5
353290,202212,88,51,37,61813.33,44844,106657.33
353300,202212,465,230,235,278770.89,284826.57,563597.46
353310,202212,38,31,7,37572.96,8485.4,46058.36
353320,202212,42,24,18,29089.02,21816.39,50905.41
353325,202212,47,25,22,30301.88,26664,56965.88
353330,202212,62,41,21,49692.9,25452.2,75145.1
353340,202212,727,255,472,309067.02,573283.72,882350.74
353350,202212,954,465,489,563594.62,593893.23,1157487.85
353360,202212,110,86,24,104233.34,29088.57,133321.91
353370,202212,111,60,51,72722.7,61812.38,134535.08
353380,202212,28,13,15,15756,18180,33936
353390,202212,1172,543,629,658134.27,763573.77,1421708.04
353400,202212,58,32,26,38785.61,31513.41,70299.02
353410,202212,119,64,55,77571.41,66662.88,144234.29
353420,202212,60,26,34,31512,41208,72720
353430,202212,587,381,206,461792.95,249681.82,711474.77
353440,202212,13824,6159,7665,7469688.44,9299723.25,16769411.69
353450,202212,53,26,27,31513,32724.2,64237.2
353460,202212,683,346,337,419372.32,409664.1,829036.42
353470,202212,2376,1134,1242,1376887.17,1508948.18,2885835.35
353475,202212,299,190,109,230287.03,132109.39,362396.42
353480,202212,186,148,38,179379.15,46056,225435.15
353490,202212,228,132,96,159989.02,117564.92,277553.94
353500,202212,221,123,98,149078.96,118777.05,267856.01
353510,202212,82,55,27,66660.72,32724.3,99385.02
353520,202212,250,182,68,220588.16,82416.6,303004.76
353530,202212,508,248,260,300588.19,316336.1,616924.29
353540,202212,424,262,162,317555.4,196348.3,513903.7
353550,202212,789,494,295,598761.72,358765.15,957526.87
353560,202212,570,231,339,279973.8,410869.21,690843.01
353570,202212,70,49,21,59389.88,25452,84841.88
353580,202212,361,223,138,270280.48,167256,437536.48
353590,202212,91,66,25,79993.16,30300,110293.16
353600,202212,292,166,126,202410.5,153924.46,356334.96
353610,202212,142,80,62,96962.81,75144,172106.81
353620,202212,704,350,354,424210.05,430267.82,854477.87
353625,202212,60,31,29,37573.26,35148.15,72721.41
353630,202212,223,159,64,192716.73,77569.69,270286.42
353640,202212,129,82,47,99387.07,56964.95,156352.02
353650,202212,1094,425,669,515108.08,810834.37,1325942.45
353657,202212,24,19,5,23028,6060,29088
353660,202212,307,159,148,193924.11,179378.33,373302.44
353670,202212,749,419,330,507844.67,401181.06,909025.73
353680,202212,148,92,56,111504.93,67872,179376.93
353690,202212,43,29,14,35148,16968.19,52116.19
353700,202212,302,203,99,246043.18,119989.1,366032.28
353710,202212,559,275,284,333310.49,344209.78,677520.27
353715,202212,41,24,17,29088,20604,49692
353720,202212,333,149,184,180593.46,223010.36,403603.82
353730,202212,1221,721,500,873883.87,606002.52,1479886.39
353740,202212,617,337,280,408460.55,339366.1,747826.65
353750,202212,88,47,41,56965.09,49692,106657.09
353760,202212,3493,1333,2160,1615651.86,2617962.08,4233613.94
353770,202212,80,63,17,76357.24,20604.2,96961.44
353780,202212,1447,656,791,795084.83,959913.49,1754998.32
353790,202212,516,306,210,372097.52,254526.79,626624.31
353800,202212,3942,1812,2130,2197448.94,2582782.35,4780231.29
353810,202212,248,122,126,147870.12,152712.64,300582.76
353820,202212,272,111,161,134532.85,195132.81,329665.66
353830,202212,68,56,12,69085.82,14544.9,83630.72
353850,202212,222,98,124,118778.78,150289.73,269068.51
353860,202212,557,249,308,301792.51,373300.17,675092.68
353870,202212,6124,3090,3034,3748821.2,3679661.9,7428483.1
353880,202212,752,480,272,581779.56,330881.84,912661.40
353890,202212,582,324,258,392697.38,312703.22,705400.60
353900,202212,145,76,69,92114.08,83629.63,175743.71
353910,202212,215,81,134,98173.87,162409.18,260583.05
353920,202212,479,245,234,296947.18,283610.98,580558.16
353930,202212,1081,626,455,758737.77,551463.4,1310201.17
353940,202212,222,104,118,126049.58,143018.81,269068.39
353950,202212,528,341,187,415731.09,226647.04,642378.13
353960,202212,79,62,17,75146.52,20604,95750.52
353970,202212,41,26,15,31512.63,18181.29,49693.92
353980,202212,2082,904,1178,1096891.39,1428967.78,2525859.17
353990,202212,83,48,35,58177.26,42420.61,100597.87
354000,202212,400,181,219,219376.84,265430.96,484807.80
354010,202212,94,53,41,64237.86,49692.69,113930.55
354020,202212,548,339,209,410881.31,255737.02,666618.33
354025,202212,39,33,6,39996.56,7272,47268.56
354030,202212,48,26,22,31513.16,26664.15,58177.31
354040,202212,101,75,26,90902.57,31512,122414.57
354050,202212,167,87,80,105444.96,96960.96,202405.92
354060,202212,855,394,461,478749.44,559945.25,1038694.69
354070,202212,954,534,420,648436.96,509049.49,1157486.45
354075,202212,191,91,100,110294.72,121201.09,231495.81
354080,202212,309,138,171,167260.29,208464.98,375725.27
354085,202212,23,14,9,16968.83,10908,27876.83
354090,202212,292,169,123,204730.46,149076.99,353807.45
354100,202212,6499,2623,3876,3181612.91,4703851.58,7885464.49
354105,202212,104,53,51,64237.02,61812,126049.02
354110,202212,44,22,22,26664.61,26664.47,53329.08
354120,202212,160,100,60,121201.28,72720.28,193921.56
354130,202212,810,486,324,589054.1,392691.8,981745.9
354140,202212,3510,1561,1949,1894421.11,2371899.59,4266320.70
354150,202212,675,384,291,465427.62,352699.2,818126.82
354160,202212,703,437,266,532097.19,323612.91,855710.10
354165,202212,11,7,4,8484.49,4848,13332.49
354170,202212,189,124,65,150293.42,78780.3,229073.72
354180,202212,52,31,21,37572.2,25452.64,63024.84
354190,202212,220,84,136,101810.22,164833.25,266643.47
354200,202212,117,56,61,67872.76,73933.72,141806.48
354210,202212,75,31,44,37572,53328,90900
354220,202212,630,383,247,464214.81,299370.06,763584.87
354230,202212,173,76,97,92112.68,117564.96,209677.64
354240,202212,339,205,134,249684.11,162409.14,412093.25
354250,202212,78,45,33,54540.4,39996,94536.4
354260,202212,2251,1033,1218,1253240.02,1482302.29,2735542.31
354270,202212,89,64,25,77569.8,30300,107869.8
354280,202212,57,32,25,38784,31512,70296
354290,202212,147,100,47,121202.2,56964.5,178166.7
354300,202212,338,238,100,288461.75,121200.31,409662.06
354310,202212,93,64,29,77571.96,35148,112719.96
354320,202212,238,111,127,134533.91,153924.91,288458.82
354323,202212,7,5,2,6060,2424,8484
354325,202212,133,70,63,84841.39,76356.27,161197.66
354330,202212,2569,859,1710,1042170.8,2074953.16,3117123.96
354340,202212,11307,5099,6208,6183568.03,7532641.87,13716209.90
354350,202212,150,102,48,123624.37,59388,183012.37
354360,202212,77,44,33,53330.74,39997.41,93328.15
354370,202212,244,123,121,149077.62,146653.72,295731.34
354380,202212,178,102,76,123627.04,92112,215739.04
354390,202212,2890,1020,1870,1237485.68,2270096.42,3507582.10
354400,202212,359,191,168,231495.35,203616.79,435112.14
354410,202212,731,316,415,383008.71,504201.26,887209.97
354420,202212,294,196,98,237559.71,118777.08,356336.79
354425,202212,348,195,153,236403.74,185439.16,421842.90
354430,202212,181,97,84,117567.93,104232.48,221800.41
354440,202212,27,22,5,26665.76,6060,32725.76
354450,202212,58,38,20,46056.26,24240,70296.26
354460,202212,104,59,45,71515.48,54542.63,126058.11
354470,202212,25,13,12,15757.23,14544.76,30301.99
354480,202212,120,65,55,78781.7,66660.75,145442.45
354490,202212,131,73,58,88478.96,70299.59,158778.55
354500,202212,416,177,239,214525.2,289668.8,504194.0
354510,202212,88,61,27,73934.43,32724.65,106659.08
354515,202212,52,18,34,21816.99,41208.1,63025.09
354520,202212,1724,721,1003,874909.07,1219273.73,2094182.80
354530,202212,900,439,461,532077.69,561160.82,1093238.51
354540,202212,273,135,138,163624.97,167257.1,330882.07
354550,202212,46,25,21,30300.6,25452,55752.6
354560,202212,166,92,74,111505.01,89688,201193.01
354570,202212,133,93,40,112717,48480,161197
354580,202212,1970,920,1050,1117494.09,1273819.87,2391313.96
354600,202212,295,136,159,164837.06,192708.5,357545.56
354610,202212,65,53,12,65448.99,14544,79992.99
354620,202212,77,21,56,25452,67872.7,93324.7
354625,202212,14,9,5,10909.76,6060.72,16970.48
354630,202212,357,233,124,282402.5,151505.41,433907.91
354640,202212,878,515,363,624419.27,439961.42,1064380.69
354650,202212,69,41,28,49693.18,33936,83629.18
354660,202212,850,615,235,747838.7,284822.92,1032661.62
354670,202212,228,88,140,106656.8,169680.2,276337.0
354680,202212,1420,503,917,609651.49,1112625.38,1722276.87
354690,202212,81,49,32,59391.34,38784.19,98175.53
354700,202212,79,54,25,65448.2,30300,95748.2
354710,202212,45,33,12,39996.45,14544,54540.45
354720,202212,23,20,3,24240.2,3636,27876.2
354730,202212,1937,787,1150,953863.33,1395030.87,2348894.20
354740,202212,75,53,22,64236.95,26664,90900.95
354750,202212,419,232,187,281189.61,226646.38,507835.99
354760,202212,550,340,210,412103.9,256952.62,669056.52
354765,202212,7,3,4,3636,4848,8484
354770,202212,367,236,131,287250.39,158775.24,446025.63
354780,202212,9050,3286,5764,3985134.76,6996914.8,10982049.56
354790,202212,88,50,38,60600.39,46056.11,106656.50
354800,202212,446,235,211,284778.65,255736.33,540514.98
354805,202212,76,38,38,46056.69,46057.07,92113.76
354810,202212,101,55,46,66660.98,55752,122412.98
354820,202212,224,91,133,110294.08,161200.05,271494.13
354830,202212,43,22,21,26664,25452,52116
354840,202212,60,37,23,44844.49,27876,72720.49
354850,202212,4999,2202,2797,2668911.02,3397279.03,6066190.05
354860,202212,358,158,200,192708.99,242401.5,435110.49
354870,202212,13005,5605,7400,6800698.35,8977345.91,15778044.26
354880,202212,2834,1021,1813,1238693.52,2197433.73,3436127.25
354890,202212,3189,1671,1518,2025327.7,1842254.02,3867581.72
354900,202212,66,47,19,56964.5,23028.19,79992.69
354910,202212,1377,694,683,844790.71,836281.37,1681072.08
354920,202212,40,33,7,39996,8484,48480
354925,202212,24,13,11,15756,13332,29088
354930,202212,34,28,6,33938,7272,41210
354940,202212,801,548,253,664202.48,306642.99,970845.47
354950,202212,213,130,83,157563.8,101810.06,259373.86
354960,202212,131,47,84,56965.78,101809.42,158775.20
354970,202212,1231,856,375,1039931.73,455713.13,1495644.86
354980,202212,10106,3634,6472,4415450.78,7851400.65,12266851.43
354990,202212,11183,4898,6285,5943781.65,7624737.24,13568518.89
354995,202212,626,208,418,252098.81,506624.66,758723.47
355000,202212,470,163,307,197557.8,372084.5,569642.3
355010,202212,691,428,263,519977.68,321188.87,841166.55
355020,202212,844,515,329,624197.23,399967.42,1024164.65
355030,202212,229224,84659,144565,102682098.62,175390707.09,278072805.71
355040,202212,1044,502,542,609657.25,656912.06,1266569.31
355050,202212,186,99,87,119988.97,105444,225432.97
355060,202212,1929,890,1039,1078718.33,1259273.75,2337992.08
355070,202212,1735,748,987,906595.4,1197473.13,2104068.53
355080,202212,212,127,85,155137.6,103021.58,258159.18
355090,202212,328,206,122,249683,147866.77,397549.77
355100,202212,5880,2700,3180,3276036.95,3862678.94,7138715.89
355110,202212,222,144,78,174528.49,94536.89,269065.38
355120,202212,53,33,20,39996.92,24240,64236.92
355130,202212,53,29,24,35149.22,29088,64237.22
355140,202212,211,120,91,145442.78,110292.43,255735.21
355150,202212,752,444,308,539360.67,373298.6,912659.27
355160,202212,515,243,272,294527.65,329670.64,624198.29
355170,202212,2192,1111,1081,1347796.01,1312609.35,2660405.36
355180,202212,730,283,447,343000.97,541770,884770.97
355190,202212,231,153,78,185444.46,94537.6,279982.06
355200,202212,119,59,60,71509.42,72720.6,144230.02
355210,202212,741,381,360,462989.74,437650.91,900640.65
355220,202212,8351,3927,4424,4762086.73,5369207.93,10131294.66
355230,202212,95,50,45,60600.7,54541.87,115142.57
355240,202212,4925,1936,2989,2348870.88,3623901.66,5972772.54
355250,202212,7532,3301,4231,4002173.3,5130417.25,9132590.55
355255,202212,49,30,19,36360,23028,59388
355260,202212,200,110,90,133323.59,109081.64,242405.23
355270,202212,161,103,58,124839.87,70296.98,195136.85
355280,202212,7647,2832,4815,3434893.58,5838289.14,9273182.72
355290,202212,67,50,17,60600.2,20604.45,81204.65
355300,202212,235,133,102,162411.35,124836.39,287247.74
355310,202212,114,63,51,76356.6,61812,138168.6
355320,202212,106,53,53,64236.2,64236.96,128473.16
355330,202212,337,192,145,235134.85,175742.88,410877.73
355340,202212,1388,500,888,607244.96,1077512.2,1684757.16
355350,202212,168,77,91,94536,110292.1,204828.1
355360,202212,187,123,64,149082.26,77569.81,226652.07
355365,202212,19,14,5,16968,6060,23028
355370,202212,1078,626,452,761168.17,547828.95,1308997.12
355380,202212,860,515,345,624208.66,418148.6,1042357.26
355385,202212,98,63,35,76356.15,42420,118776.15
355390,202212,105,54,51,65449.13,61812.8,127261.93
355395,202212,204,101,103,122416.28,124839.63,247255.91
355400,202212,1901,1068,833,1294351.37,1013234.07,2307585.44
355410,202212,5523,2462,3061,2984031.68,3714795.38,6698827.06
355420,202212,46,32,14,38784.8,16968,55752.8
355430,202212,450,266,184,322406.97,223016.42,545423.39
355440,202212,93,51,42,61812.65,50905.43,112718.08
355450,202212,477,243,234,294522.96,283610.85,578133.81
355460,202212,57,42,15,50904.4,18180.8,69085.2
355465,202212,51,28,23,33936.74,27876,61812.74
355470,202212,197,76,121,92115.61,146652.4,238768.01
355475,202212,7,4,3,4848.13,3636,8484.13
355480,202212,666,267,399,323615.39,483594.64,807210.03
355490,202212,110,79,31,95753.43,37573.5,133326.93
355495,202212,103,41,62,49692.1,75144.91,124837.01
355500,202212,1658,886,772,1073861.09,939305.66,2013166.75
355510,202212,283,196,87,237566.75,105446.2,343012.95
355520,202212,27,19,8,23028.18,9696,32724.18
355530,202212,25,13,12,15756,14544,30300
355535,202212,81,38,43,46058.74,52116,98174.74
355540,202212,3011,1185,1826,1437475.83,2215585.26,3653061.09
355550,202212,69,39,30,47268,36360,83628
355560,202212,268,119,149,144232.1,180590.61,324822.71
355570,202212,16,12,4,14545,4848,19393
355580,202212,244,163,81,197561.02,98173.61,295734.63
355590,202212,17,11,6,13332.2,7272,20604.2
355600,202212,285,135,150,163624.31,183014.26,346638.57
355610,202212,252,150,102,181807.19,123627.08,305434.27
355620,202212,1360,572,788,695708.8,955057.97,1650766.77
355630,202212,436,308,128,374521.73,155137.31,529659.04
355635,202212,134,54,80,65448,96960,162408
355640,202212,616,332,284,402389.17,345425.21,747814.38
355645,202212,927,335,592,406032.96,717513.15,1123546.11
355650,202212,1954,843,1111,1021748.25,1346534.62,2368282.87
355660,202212,229,117,112,141805.53,135745.41,277550.94
355670,202212,702,299,403,362390.52,488437.89,850828.41
355680,202212,215,115,100,139387.77,121201.7,260589.47
355690,202212,98,47,51,56964.18,61812,118776.18
355695,202212,25,15,10,18180,12120,30300
355700,202212,1302,629,673,763581.63,815682.82,1579264.45
355710,202212,2401,1316,1085,1596266.39,1316235.94,2912502.33
355715,202212,16,13,3,15756,3636.1,19392.1
355720,202212,269,162,107,196347.86,129685.68,326033.54
355730,202212,108,62,46,76356.03,55752.15,132108.18
410010,202212,110,87,23,106659.62,27876,134535.62
410020,202212,123,86,37,104233.52,44844,149077.52
410030,202212,194,106,88,128475.81,106658.88,235134.69
410040,202212,1462,697,765,847199.94,927194.78,1774394.72
410045,202212,46,33,13,39996.55,15756,55752.55
410050,202212,544,316,228,384206.65,276337.44,660544.09
410060,202212,221,160,61,193925.05,75144,269069.05
410070,202212,299,248,51,300585.71,61812.99,362398.70
410080,202212,187,115,72,139381.11,89688,229069.11
410090,202212,56,47,9,56966.53,10908,67874.53
410100,202212,266,168,98,203617.39,118776,322393.39
410105,202212,46,28,18,33936,21816,55752
410110,202212,370,224,146,271498.96,176957.5,448456.46
410115,202212,48,28,20,33936,24240.2,58176.2
410120,202212,488,225,263,272706.44,319971.06,592677.50
410130,202212,65,37,28,44844,33936,78780
410140,202212,3381,1516,1865,1837423.34,2262827.34,4100250.68
410150,202212,2771,1104,1667,1338074.71,2024055.56,3362130.27
410160,202212,509,290,219,351485.63,265431.34,616916.97
410165,202212,57,36,21,43632.41,25452,69084.41
410170,202212,219,126,93,152713.93,112716.31,265430.24
410180,202212,2494,1306,1188,1582916.06,1441096.12,3024012.18
410185,202212,35,29,6,35148,7272,42420
410190,202212,506,325,181,395117.15,219372.9,614490.05
410200,202212,1089,759,330,923559.76,399963.41,1323523.17
410210,202212,667,343,324,416934.92,392689.53,809624.45
410220,202212,48,20,28,24240.7,33936,58176.7
410230,202212,205,88,117,106656.58,141807.06,248463.64
410240,202212,741,474,267,575719.96,323607.43,899327.39
410250,202212,393,267,126,323606.4,152714.22,476320.62
410260,202212,311,173,138,209682.91,167258.14,376941.05
410270,202212,29,20,9,24240.45,10908,35148.45
410275,202212,63,44,19,53328.25,23028,76356.25
410280,202212,337,200,137,242408.25,166044.2,408452.45
410290,202212,273,152,121,184226.04,146653.31,330879.35
410300,202212,90,56,34,67872,41208,109080
410302,202212,27,14,13,16968.6,15756,32724.6
410304,202212,45,31,14,37573.67,16968,54541.67
410305,202212,216,129,87,156351.72,105445,261796.72
410310,202212,190,111,79,134533.72,95749.89,230283.61
410315,202212,39,31,8,37572.2,9696,47268.2
410320,202212,144,100,44,121201.47,54540,175741.47
410322,202212,38,23,15,27876.63,18180,46056.63
410330,202212,181,114,67,138171.09,81204,219375.09
410335,202212,105,57,48,69084,58176,127260
410337,202212,47,37,10,44844,12120,56964
410340,202212,38,31,7,37573.86,8484,46057.86
410345,202212,202,123,79,149076.98,95749.01,244825.99
410347,202212,43,31,12,37573.47,14544.5,52117.97
410350,202212,254,147,107,178168.72,129684,307852.72
410360,202212,458,278,180,336946.73,218162.17,555108.90
410370,202212,2440,1045,1395,1266569.63,1691969,2958538.63
410380,202212,203,114,89,138170,107868.52,246038.52
410390,202212,423,267,156,323605.98,189072.78,512678.76
410395,202212,32,20,12,24241,14544.38,38785.38
410400,202212,978,404,574,489660.43,695694.45,1185354.88
410405,202212,78,57,21,69085.68,25453.68,94539.36
410410,202212,26,16,10,19393.34,12120,31513.34
410420,202212,1899,835,1064,1011933.69,1289587.21,2301520.90
410425,202212,208,83,125,101809.13,151500.2,253309.33
410430,202212,2541,1309,1232,1587745.89,1493203.82,3080949.71
410440,202212,364,254,110,307849.05,133322.19,441171.24
410442,202212,363,229,134,278767.01,162409.76,441176.77
410445,202212,364,249,115,303007.72,140592.94,443600.66
410450,202212,400,188,212,227859.46,258156.47,486015.93
410460,202212,592,315,277,381782.9,335725.81,717508.71
410465,202212,282,155,127,187861.34,153925.21,341786.55
410470,202212,244,140,104,169682.93,126048.59,295731.52
410480,202212,6987,3347,3640,4062715.19,4419004.97,8481720.16
410490,202212,1489,814,675,987802.96,819323.06,1807126.02
410500,202212,278,162,116,196347.25,140592.5,336939.75
410510,202212,205,152,53,184229.94,64237.76,248467.70
410520,202212,281,198,83,239976,100596,340572
410530,202212,285,86,199,104232,241188,345420
410540,202212,376,271,105,328455.19,127260.79,455715.98
410550,202212,1772,736,1036,892046.72,1255642.73,2147689.45
410560,202212,185,120,65,146654.63,78780.83,225435.46
410570,202212,451,295,156,357543.6,190285.51,547829.11
410580,202212,4017,1660,2357,2011958.81,2859155.75,4871114.56
410590,202212,448,287,161,347830.71,196344.81,544175.52
410600,202212,102,87,15,105444.67,18180,123624.67
410610,202212,60,48,12,58177.23,14544,72721.23
410620,202212,292,183,109,221800.79,132108.98,353909.77
410630,202212,474,261,213,317547.19,258156.38,575703.57
410640,202212,1188,729,459,884771.57,557522.25,1442293.82
410645,202212,115,85,30,103023.11,36360,139383.11
410650,202212,388,237,151,287245.4,183014.43,470259.83
410655,202212,90,66,24,79992.35,29088.08,109080.43
410657,202212,35,13,22,15756,26664,42420
410660,202212,693,471,222,570866.36,269067.29,839933.65
410670,202212,78,63,15,76356.63,18180.13,94536.76
410680,202212,194,153,41,185439.79,49692,235131.79
410685,202212,35,24,11,29088,13332,42420
410690,202212,30708,12499,18209,15158779.64,22097454.25,37256233.89
410700,202212,337,242,95,294780.68,115140.97,409921.65
410710,202212,126,105,21,127261.02,25452.2,152713.22
410712,202212,42,29,13,35148.2,15756,50904.2
410715,202212,108,78,30,94537.22,36360,130897.22
410720,202212,675,373,302,452083.31,366024.65,818107.96
410725,202212,201,137,64,166045.83,77568,243613.83
410730,202212,106,43,63,52116.66,76356,128472.66
410740,202212,83,62,21,76357.32,25452.15,101809.47
410750,202212,301,193,108,233918.92,130896,364814.92
410752,202212,21,15,6,18180,7272,25452
410753,202212,61,20,41,24240,49692,73932
410754,202212,57,27,30,32726.32,36360,69086.32
410755,202212,81,40,41,48480.2,49692,98172.2
410760,202212,802,432,370,523589.36,448443.21,972032.57
410765,202212,2064,921,1143,1116285.98,1386557.36,2502843.34
410770,202212,122,83,39,100597,47270.68,147867.68
410773,202212,69,45,24,54541.05,29088,83629.05
410775,202212,203,144,59,174532.08,71508,246040.08
410780,202212,83,46,37,55753.17,44844,100597.17
410785,202212,57,48,9,58176.72,10908,69084.72
410790,202212,88,37,51,44844.8,61812,106656.8
410800,202212,298,184,114,223014.71,138169.36,361184.07
410810,202212,28,17,11,20604.69,13332.9,33937.59
410820,202212,153,109,44,132110.51,53328.9,185439.41
410830,202212,9867,3981,5886,4827516.46,7139973.56,11967490.02
410832,202212,114,72,42,88476.56,50904.36,139380.92
410840,202212,1494,797,697,965983.42,844768.59,1810752.01
410845,202212,60,31,29,37572.47,35148.49,72720.96
410850,202212,154,110,44,133325.04,53328,186653.04
410855,202212,80,73,7,88477.04,8484,96961.04
410860,202212,893,437,456,530862.55,553887.84,1084750.39
410865,202212,95,66,29,79993.65,35148,115141.65
410870,202212,147,119,28,144229.46,33936.57,178166.03
410880,202212,1236,598,638,726001.71,773262.49,1499264.20
410890,202212,114,71,43,86052.8,52116,138168.8
410895,202212,80,61,19,73933.08,23028.95,96962.03
410900,202212,29,24,5,29088.67,6060,35148.67
410910,202212,12,7,5,8484.95,6060,14544.95
410920,202212,47,29,18,35148,21816,56964
410930,202212,572,341,231,413293.75,279973.19,693266.94
410940,202212,4673,2355,2318,2856772.23,2815519.36,5672291.59
410950,202212,103,75,28,90901.8,33936.2,124838.0
410960,202212,1007,382,625,462993.79,758724.55,1221718.34
410965,202212,67,46,21,55752,25452,81204
410970,202212,629,413,216,500563.56,261793.45,762357.01
410975,202212,124,75,49,90901.65,59388,150289.65
410980,202212,1667,750,917,909020.02,1113839.55,2022859.57
410990,202212,286,204,82,248461.19,99384.98,347846.17
411000,202212,65,35,30,42420.65,36361.44,78782.09
411005,202212,39,31,8,37572,9696,47268
411007,202212,256,147,109,178164.47,132108,310272.47
411010,202212,630,396,234,479964.06,286034.67,765998.73
411020,202212,289,179,110,216952.28,134533.51,351485.79
411030,202212,26,14,12,16968,14544,31512
411040,202212,63,40,23,48480,27876,76356
411050,202212,221,149,72,180589.15,87264.03,267853.18
411060,202212,556,376,180,455718.04,218162.78,673880.82
411065,202212,39,35,4,42420.84,4848,47268.84
411070,202212,1321,742,579,899317.24,702964.5,1602281.74
411080,202212,261,171,90,207252.03,109080.2,316332.23
411090,202212,88,63,25,76356.9,30300.96,106657.86
411095,202212,365,118,247,143016.87,300576.37,443593.24
411100,202212,111,86,25,104233.66,30300,134533.66
411110,202212,152,83,69,100596.4,83628.2,184224.6
411120,202212,215,139,76,168472.04,92112,260584.04
411125,202212,359,172,187,208470,227861.29,436331.29
411130,202212,124,104,20,126050.57,24240,150290.57
411140,202212,214,144,70,174528.19,84840,259368.19
411150,202212,1288,820,468,996278.19,567222.15,1563500.34
411155,202212,121,82,39,99384,47268,146652
411160,202212,34,14,20,16968,24240,41208
411170,202212,57,48,9,58176,10908,69084
411180,202212,1065,691,374,838730.06,453293.79,1292023.85
411190,202212,364,207,157,250886.09,191496,442382.09
411200,202212,697,376,321,455723.93,389055.59,844779.52
411210,202212,701,353,348,427839.56,421777.47,849617.03
411220,202212,167,115,52,139383.13,63024.8,202407.93
411230,202212,36,29,7,35148.04,8484.1,43632.14
411240,202212,110,72,38,87265.35,47268,134533.35
411250,202212,440,310,130,375721.98,158772.27,534494.25
411260,202212,13,9,4,10908.8,4848,15756.8
411270,202212,270,140,130,169684.9,157562.04,327246.94
411275,202212,196,165,31,199982.24,37572,237554.24
411280,202212,285,189,96,229070.98,116352,345422.98
411290,202212,67,52,15,63024.37,18180,81204.37
411295,202212,131,99,32,119989.59,38784.47,158774.06
411300,202212,85,40,45,48480.36,54540,103020.36
411310,202212,95,67,28,81204.2,33936,115140.2
411320,202212,873,528,345,639945.66,419354.19,1059299.85
411325,202212,64,44,20,53328.1,24240,77568.1
411330,202212,979,620,359,751458.62,435110.51,1186569.13
411340,202212,35,23,12,27876,14544,42420
411342,202212,62,47,15,56964,18180,75144
411345,202212,106,53,53,64238.25,65448,129686.25
411350,202212,541,399,142,484807.35,172106.42,656913.77
411360,202212,61,39,22,47269.75,26666,73935.75
411370,202212,14226,5781,8445,7015214.62,10247567.1,17262781.72
411373,202212,188,126,62,152712,75144.17,227856.17
411375,202212,84,68,16,82417.36,19392,101809.36
411380,202212,79,53,26,64237.98,31512,95749.98
411390,202212,157,84,73,101808,88476,190284
411400,202212,369,235,134,284827.27,162408,447235.27
411410,202212,547,256,291,311488.62,352694.23,664182.85
411420,202212,1008,417,591,505412.65,719931.71,1225344.36
411430,202212,565,295,270,357554.96,327246.8,684801.76
411435,202212,28,20,8,24240.63,9696,33936.63
411440,202212,498,394,104,477533.39,126048,603581.39
411450,202212,403,325,78,393908.67,94536.09,488444.76
411460,202212,853,320,533,387848.07,646001.11,1033849.18
411470,202212,113,79,34,95752.43,41208,136960.43
411480,202212,753,376,377,456936.37,456926.18,913862.55
411490,202212,290,179,111,216950.18,134532,351482.18
411500,202212,109,85,24,103020.06,29088,132108.06
411510,202212,231,176,55,213315.84,66661.19,279977.03
411520,202212,6623,2214,4409,2684623.82,5347383.52,8032007.34
411530,202212,127,82,45,99385.11,54540,153925.11
411535,202212,48,14,34,16968.1,41208,58176.1
411540,202212,397,260,137,315124.88,166047.48,481172.36
411545,202212,59,43,16,52116.39,19392,71508.39
411550,202212,88,68,20,82416.46,24240,106656.46
411560,202212,403,167,236,202406.31,286032.15,488438.46
411570,202212,1076,353,723,427844.46,876285.53,1304129.99
411573,202212,27,15,12,18180.2,14544,32724.2
411575,202212,324,197,127,238767.28,153924,392691.28
411580,202212,1315,458,857,555101.54,1039904.7,1595006.24
411585,202212,73,35,38,42420,46056,88476
411590,202212,13,7,6,8484,7272,15756
411600,202212,15,7,8,8484.2,10908.7,19392.9
411605,202212,175,69,106,83629.09,128472,212101.09
411610,202212,243,146,97,176954.79,117564.2,294518.99
411620,202212,394,189,205,229076.27,248466.95,477543.22
411630,202212,53,35,18,42420.07,21816.99,64237.06
411640,202212,31,21,10,25452.46,12120,37572.46
411650,202212,6,4,2,4848,2424,7272
411660,202212,47,35,12,42420,14544,56964
411670,202212,241,163,78,197557.95,94536.2,292094.15
411680,202212,162,126,36,152712.69,43632,196344.69
411690,202212,730,379,351,459350.97,425415.13,884766.10
411695,202212,65,43,22,52116.2,26664,78780.2
411700,202212,145,114,31,139382.77,37572,176954.77
411705,202212,99,67,32,81204.95,38784.3,119989.25
411710,202212,295,198,97,239979.57,117565.07,357544.64
411720,202212,155,101,54,122412.96,65448.2,187861.16
411721,202212,94,70,24,84840,29088.2,113928.2
411722,202212,103,50,53,60600.2,65448,126048.2
411725,202212,166,115,51,139380.2,61812,201192.2
411727,202212,106,83,23,100598.88,27876.33,128475.21
411729,202212,53,40,13,48480.67,15756,64236.67
411730,202212,581,365,216,443595.54,263007,706602.54
411740,202212,27,15,12,18180.53,14544.12,32724.65
411745,202212,73,52,21,63024,25452,88476
411750,202212,878,354,524,429055.71,636305.71,1065361.42
411760,202212,1315,940,375,1139316.5,455721.38,1595037.88
411770,202212,433,277,156,335726.96,190286.16,526013.12
411780,202212,378,244,134,295729.02,162408.21,458137.23
411790,202212,613,338,275,409662.71,333300,742962.71
411800,202212,170,120,50,145443.23,60600.38,206043.61
411810,202212,189,143,46,173317.11,55752.79,229069.90
411820,202212,2713,1075,1638,1305376.94,1987726.69,3293103.63
411830,202212,19,14,5,16968,6060,23028
411840,202212,2305,1337,968,1621684.06,1174445.33,2796129.39
411845,202212,66,21,45,25452.9,54540,79992.9
411850,202212,1325,702,623,850843.12,756296.42,1607139.54
411860,202212,62,38,24,46056.54,29088,75144.54
411870,202212,76,47,29,56964,35148,92112
411880,202212,425,252,173,305432.69,209676.56,515109.25
411885,202212,113,72,41,87265.37,49693.57,136958.94
411890,202212,348,245,103,296944.39,124837.68,421782.07
411900,202212,112,81,31,99384.29,38784,138168.29
411910,202212,220,143,77,175743.51,93326.04,269069.55
411915,202212,2574,989,1585,1199910.32,1921050.13,3120960.45
411920,202212,116,86,30,104233.25,36360.98,140594.23
411925,202212,19,12,7,14544.59,8484,23028.59
411930,202212,829,554,275,671545.14,333302.98,1004848.12
411940,202212,611,381,230,461781.1,279974.1,741755.2
411950,202212,1295,580,715,704194.61,867811.25,1572005.86
411960,202212,1198,734,464,889619.27,562368.75,1451988.02
411965,202212,23,14,9,16968.97,10908,27876.97
411970,202212,92,79,13,95749.37,15756,111505.37
411980,202212,233,119,114,144228,138168,282396
411990,202212,5583,2937,2646,3559911.13,3208312.7,6768223.83
411995,202212,663,195,468,236345.99,568444.06,804790.05
412000,202212,344,229,115,277557.67,139383.68,416941.35
412010,202212,67,34,33,41208.9,39996.71,81205.61
412015,202212,36,27,9,32724.1,10908,43632.1
412020,202212,25,19,6,23029.74,7272,30301.74
412030,202212,39,34,5,41208.73,6060,47268.73
412033,202212,44,23,21,27877.15,25452,53329.15
412035,202212,69,44,25,53328,30300,83628
412040,202212,31,14,17,16968.6,20604,37572.6
412050,202212,215,155,60,187866.25,72720.56,260586.81
412060,202212,820,584,236,709035.12,286035.51,995070.63
412065,202212,57,29,28,35148.71,33936,69084.71
412070,202212,145,102,43,123625.31,52116.63,175741.94
412080,202212,359,174,185,212103.61,224223.35,436326.96
412085,202212,39,14,25,16968.2,30300,47268.2
412090,202212,888,538,350,652070.98,425414.01,1077484.99
412100,202212,266,220,46,266650.05,55752,322402.05
412110,202212,77,57,20,69085,24240,93325
412120,202212,374,195,179,236343.29,216952.05,453295.34
412125,202212,72,40,32,48480.2,38784,87264.2
412130,202212,49,30,19,36361.17,23028,59389.17
412135,202212,29,17,12,20604.2,14544,35148.2
412140,202212,462,297,165,359967.26,199981.45,559948.71
412150,202212,258,156,102,189073.72,123624,312697.72
412160,202212,73,48,25,58176.81,30300,88476.81
412170,202212,730,469,261,569644.4,316333.94,885978.34
412175,202212,40,26,14,31512,16968.08,48480.08
412180,202212,161,120,41,145441.82,49692.2,195134.02
412190,202212,338,264,74,319974.64,89688,409662.64
412200,202212,195,114,81,138169.42,98172,236341.42
412210,202212,98,73,25,88476,30301.64,118777.64
412215,202212,241,162,79,196346.36,95748.98,292095.34
412217,202212,64,48,16,58176.97,19392,77568.97
412220,202212,891,573,318,694498.7,385423.16,1079921.86
412230,202212,287,172,115,208468.69,139384.29,347852.98
412240,202212,1423,698,725,845998.24,879922.85,1725921.09
412250,202212,424,254,170,307850.28,206040,513890.28
412260,202212,130,84,46,101809.43,55752.2,157561.63
412265,202212,167,129,38,156348.83,46056,202404.83
412270,202212,97,58,39,70296.94,47268,117564.94
412280,202212,83,63,20,76356.2,24240,100596.2
412290,202212,91,58,33,70296.66,39996,110292.66
412300,202212,212,150,62,181800.6,76356,258156.6
412310,202212,58,45,13,54540.57,15756,70296.57
412320,202212,93,69,24,83632.17,29088,112720.17
412330,202212,206,157,49,190285.21,59388,249673.21
412340,202212,178,117,61,141805.05,73932,215737.05
412350,202212,707,317,390,385419.71,473894.15,859313.86
412360,202212,23,18,5,21816,6060,27876
412370,202212,144,118,26,144230.46,31512,175742.46
412380,202212,193,143,50,173318.06,60600.3,233918.36
412382,202212,58,32,26,38784,31512,70296
412385,202212,161,115,46,139382.34,55752,195134.34
412390,202212,334,251,83,305432.36,101809.81,407242.17
412395,202212,67,55,12,66660.4,14544,81204.4
412400,202212,100,67,33,81205.75,39996,121201.75
412402,202212,241,131,110,158774,133320,292094
412405,202212,999,328,671,397538.1,814466.73,1212004.83
412410,202212,1030,603,427,731483.88,518742.28,1250226.16
412420,202212,17,16,1,19392,1212,20604
412430,202212,27,25,2,30300.8,2424.2,32725.0
412440,202212,697,351,346,425418.08,420565.77,845983.85
412450,202212,67,59,8,71509.39,9696,81205.39
412460,202212,80,56,24,67872.67,29088,96960.67
412470,202212,227,178,49,216951.05,59388,276339.05
412480,202212,160,116,44,140594.24,54540.2,195134.44
412490,202212,174,147,27,178166.17,32724,210890.17
412500,202212,413,319,94,386636.96,113928.86,500565.82
412510,202212,170,141,29,172106.73,35148,207254.73
412520,202212,90,59,31,71508,37572,109080
412530,202212,110,49,61,59388.32,73932,133320.32
412535,202212,67,52,15,63026.27,18180,81206.27
412540,202212,49,28,21,33936.96,25452.13,59389.09
412545,202212,87,59,28,71508.95,33936,105444.95
412550,202212,4394,1766,2628,2144087.77,3188827.84,5332915.61
412555,202212,12,7,5,8484,6060,14544
412560,202212,718,464,254,562375.84,307849.87,870225.71
412570,202212,870,386,484,467839.09,586611.17,1054450.26
412575,202212,102,72,30,87265.54,36360,123625.54
412580,202212,181,120,61,145445.81,73933.67,219379.48
412590,202212,32,28,4,33936.77,4848,38784.77
412600,202212,210,147,63,178167.78,76356.83,254524.61
412610,202212,42,19,23,23028.2,27876,50904.2
412620,202212,126,103,23,124839.47,27876.46,152715.93
412625,202212,2224,1055,1169,1278684.59,1419261.16,2697945.75
412627,202212,66,49,17,59388.42,20604,79992.42
412630,202212,384,259,125,313916,151500.28,465416.28
412635,202212,79,25,54,30300,65448,95748
412640,202212,111,79,32,95748.2,38784,134532.2
412650,202212,323,211,112,255735.52,135744,391479.52
412660,202212,587,313,274,379359.21,332088.55,711447.76
412665,202212,40,36,4,44844,4848,49692
412667,202212,277,172,105,208467.6,127260,335727.6
412670,202212,83,63,20,76356.2,24240,100596.2
412680,202212,340,255,85,309069.18,103020.08,412089.26
412690,202212,135,85,50,103021.33,60600,163621.33
412700,202212,192,120,72,145440.02,87264.23,232704.25
412710,202212,1408,774,634,938104.89,769628.74,1707733.63
412720,202212,241,134,107,162410.13,129684.69,292094.82
412730,202212,218,185,33,224224.36,39996.99,264221.35
412740,202212,417,203,214,246039.48,259368.41,505407.89
412750,202212,418,231,187,279976.28,227856.56,507832.84
412760,202212,380,192,188,232709.85,227860.45,460570.30
412770,202212,2202,1174,1028,1422915.12,1245941.32,2668856.44
412780,202212,149,103,46,124838.52,55752.19,180590.71
412785,202212,326,167,159,202405.5,193920.02,396325.52
412788,202212,52,29,23,35149.27,27876,63025.27
412790,202212,128,103,25,124839.43,30300,155139.43
412795,202212,149,99,50,119989.31,60600,180589.31
412796,202212,309,195,114,236341.49,138168,374509.49
412800,202212,733,409,324,495710.3,393900.66,889610.96
412810,202212,3224,1755,1469,2129546.37,1786513.36,3916059.73
412820,202212,1058,609,449,738128.72,544201.35,1282330.07
412830,202212,14,13,1,15756.2,1212,16968.2
412840,202212,291,196,95,237553.21,115140,352693.21
412850,202212,597,393,204,476324.72,249674.22,725998.94
412853,202212,174,78,96,94536.18,116352.8,210888.98
412855,202212,206,110,96,133322.8,116352,249674.8
412860,202212,98,68,30,82419.21,37573.27,119992.48
412862,202212,81,51,30,61812,36360,98172
412863,202212,8,5,3,6060,3636,9696
412865,202212,46,36,10,43632,12120,55752
412870,202212,117,74,43,89690.97,52116.55,141807.52
412880,202212,97,65,32,78782.98,38784,117566.98
420005,202212,41,35,6,42420.7,7272,49692.7
420010,202212,371,241,130,292097.48,157560.39,449657.87
420020,202212,101,76,25,92112.13,30300,122412.13
420030,202212,29,23,6,27876.2,7272,35148.2
420040,202212,95,73,22,88477.8,26664,115141.8
420050,202212,53,33,20,39996.91,24240,64236.91
420055,202212,17,15,2,18180.29,2424,20604.29
420060,202212,27,19,8,23028,9696.2,32724.2
420070,202212,105,90,15,109080.1,18180,127260.1
420075,202212,10,10,0,12120,,12120.0
420080,202212,40,34,6,41209.06,7272,48481.06
420090,202212,40,31,9,37572.66,10908.79,48481.45
420100,202212,165,141,24,170895.01,29088,199983.01
420110,202212,24,23,1,27876,1212,29088
420120,202212,61,44,17,53328.31,20604,73932.31
420125,202212,84,62,22,76356.6,26664,103020.6
420127,202212,37,32,5,38784,6060,44844
420130,202212,509,309,200,374519.11,242404.46,616923.57
420140,202212,1419,789,630,956294.02,766004.73,1722298.75
420150,202212,52,38,14,46056,16968,63024
420160,202212,32,28,4,33936.3,4848,38784.3
420165,202212,19,14,5,16968.87,6060,23028.87
420170,202212,72,42,30,52116.52,36360,88476.52
420180,202212,23,20,3,24240,3636,27876
420190,202212,27,23,4,27876.18,4848,32724.18
420195,202212,133,60,73,72723.6,88480.12,161203.72
420200,202212,1435,595,840,721159.02,1019310.72,1740469.74
420205,202212,124,74,50,89690.85,60600.4,150291.25
420207,202212,150,85,65,103022.91,78780,181802.91
420208,202212,19,15,4,18180,4848,23028
420209,202212,13,11,2,13332.58,2424,15756.58
420210,202212,616,290,326,352701.14,395114.4,747815.54
420213,202212,58,40,18,48480.69,21816.2,70296.89
420215,202212,28,23,5,27876.45,6060,33936.45
420220,202212,61,38,23,46056.6,27876,73932.6
420230,202212,1049,619,430,750257.79,521167.57,1271425.36
420240,202212,2414,1586,828,1923470.85,1003545.23,2927016.08
420243,202212,46,37,9,44844.69,10908,55752.69
420245,202212,228,110,118,133323.56,143019.66,276343.22
420250,202212,61,43,18,52116.69,21816,73932.69
420253,202212,26,19,7,23029.72,8484,31513.72
420257,202212,15,10,5,12120,6060,18180
420260,202212,125,100,25,121201.59,30300.14,151501.73
420270,202212,35,25,10,30300.19,12120,42420.19
420280,202212,296,221,75,267865.3,92113.48,359978.78
420285,202212,24,19,5,23028,6060,29088
420287,202212,46,29,17,35149.37,20604,55753.37
420290,202212,977,659,318,799932.14,385417.02,1185349.16
420300,202212,1666,1326,340,1607164.17,412086.28,2019250.45
420310,202212,42,30,12,36360.2,14544,50904.2
420315,202212,26,21,5,25452.78,6060.5,31513.28
420320,202212,1076,511,565,621771.57,687215.88,1308987.45
420325,202212,6,4,2,4848,2424.8,7272.8
420330,202212,120,80,40,96960.34,48480.36,145440.70
420340,202212,197,133,64,161197.54,77568,238765.54
420350,202212,265,188,77,227863.18,93325.19,321188.37
420360,202212,703,540,163,654498.03,197559.63,852057.66
420370,202212,142,77,65,94538.3,79992.43,174530.73
420380,202212,1267,853,414,1035077.51,501772.69,1536850.20
420390,202212,230,163,67,197559.04,81204.4,278763.44
420395,202212,191,139,52,168474.59,63026.18,231500.77
420400,202212,229,175,54,212103.76,66660.2,278763.96
420410,202212,54,40,14,48481.67,16968,65449.67
420415,202212,32,26,6,31513.56,7272,38785.56
420417,202212,57,44,13,53328.01,15756,69084.01
420419,202212,11,10,1,12120,1212,13332
420420,202212,3014,1862,1152,2260435.97,1396238.72,3656674.69
420425,202212,71,50,21,60602.71,25452,86054.71
420430,202212,1051,757,294,917532.54,356328.3,1273860.84
420435,202212,14,11,3,13332,3636,16968
420440,202212,91,65,26,78782.26,31512,110294.26
420445,202212,30,27,3,32724.9,3636,36360.9
420450,202212,82,46,36,55754.04,43632,99386.04
420455,202212,180,138,42,167257.74,50904,218161.74
420460,202212,2460,1519,941,1841089.57,1140501.89,2981591.46
420470,202212,86,55,31,66660.2,37572.69,104232.89
420475,202212,10,9,1,10908,1212,12120
420480,202212,908,688,220,833888.06,266641.21,1100529.27
420490,202212,102,76,26,92114.83,31512,123626.83
420500,202212,402,238,164,288463.86,198769.06,487232.92
420510,202212,26,22,4,26664.84,4848,31512.84
420515,202212,27,14,13,16968.02,15756,32724.02
420517,202212,11,8,3,9696.91,3636,13332.91
420519,202212,2,2,0,2424,,2424.0
420520,202212,61,45,16,54541.45,19392.2,73933.65
420530,202212,143,91,52,110293.48,63024.2,173317.68
420535,202212,16,13,3,15756.91,3636,19392.91
420540,202212,6846,4245,2601,5150237.36,3152453.41,8302690.77
420543,202212,31,29,2,35149.17,2424,37573.17
420545,202212,218,150,68,181804.15,82416,264220.15
420550,202212,797,668,129,810855.09,156350.99,967206.08
420555,202212,33,24,9,29088.3,10908,39996.3
420560,202212,65,50,15,60601.34,18180,78781.34
420570,202212,226,104,122,126051.48,147866.2,273917.68
420580,202212,323,159,164,193923.66,198769.53,392693.19
420590,202212,499,314,185,380572.85,224220.62,604793.47
420600,202212,156,86,70,104232.6,84840,189072.6
420610,202212,37,34,3,41208.6,3636,44844.6
420620,202212,81,59,22,71509.74,26664,98173.74
420630,202212,158,106,52,128476.28,63024,191500.28
420640,202212,71,61,10,73932,12120,86052
420650,202212,320,165,155,199982.9,187862,387844.9
420660,202212,39,29,10,36360.45,12120,48480.45
420665,202212,46,29,17,35148.2,20604,55752.2
420670,202212,237,182,55,220591.15,66660.78,287251.93
420675,202212,14,12,2,14544,2424,16968
420680,202212,34,29,5,35148,6060,41208
420690,202212,199,151,48,183013.76,58176.34,241190.10
420700,202212,735,478,257,579352.63,312700.47,892053.10
420710,202212,144,78,66,94537.76,79993.53,174531.29
420720,202212,95,77,18,94538.49,21816.97,116355.46
420730,202212,738,437,301,529656.36,364819.63,894475.99
420740,202212,58,57,1,69084.66,1212,70296.66
420750,202212,503,327,176,396326.86,213313.64,609640.50
420757,202212,19,16,3,19392,3636,23028
420760,202212,40,28,12,33936.36,14544,48480.36
420765,202212,76,53,23,64236.7,27876,92112.7
420768,202212,59,47,12,56966.31,14544,71510.31
420770,202212,68,58,10,70298.19,12120,82418.19
420775,202212,34,30,4,36361.49,4848,41209.49
420780,202212,200,156,44,189073.98,53328,242401.98
420785,202212,25,17,8,20604,9696,30300
420790,202212,137,112,25,135744.86,30300.09,166044.95
420800,202212,62,47,15,56964,18180,75144
420810,202212,284,217,67,264223.91,81204,345427.91
420820,202212,2718,1496,1222,1814412.86,1483506.55,3297919.41
420830,202212,736,390,346,473907.97,419364.55,893272.52
420840,202212,131,90,41,109080.11,49692,158772.11
420845,202212,453,195,258,236345.33,312698.86,549044.19
420850,202212,276,214,62,259370.99,75144,334514.99
420860,202212,59,50,9,60601.49,10908,71509.49
420870,202212,131,91,40,110292.3,48480,158772.3
420880,202212,195,122,73,149078.93,88476.92,237555.85
420890,202212,1020,494,526,598737.19,638726.01,1237463.20
420895,202212,9,8,1,9696,1212,10908
420900,202212,420,338,82,409662.44,99384.78,509047.22
420910,202212,6169,3346,2823,4060316.3,3425157.57,7485473.87
420915,202212,57,52,5,63024.2,6060,69084.2
420917,202212,21,16,5,19392.23,6060,25452.23
420920,202212,21,15,6,18180,7272,25452
420930,202212,3540,2355,1185,2857920.38,1437462.45,4295382.83
420940,202212,590,409,181,495729.98,220589.26,716319.24
420945,202212,10,8,2,9696,2424,12120
420950,202212,47,32,15,38784,18180,56964
420960,202212,114,93,21,112721.28,25452.1,138173.38
420970,202212,286,231,55,279980.71,66660.53,346641.24
420980,202212,23,22,1,26664,1212,27876
420985,202212,52,44,8,53329.75,9696,63025.75
420990,202212,90,67,23,81205.3,27876.8,109082.1
421000,202212,63,33,30,39996,36360,76356
421003,202212,33,23,10,27876.8,12120,39996.8
421005,202212,8,6,2,7272.8,2424,9696.8
421010,202212,898,578,320,700561.54,387846.68,1088408.22
421020,202212,20,17,3,20604,3636,24240
421030,202212,117,96,21,116353.85,25452.2,141806.05
421040,202212,68,47,21,56967.28,25454,82421.28
421050,202212,332,232,100,281186.95,122412,403598.95
421055,202212,15,12,3,14544.2,3636,18180.2
421060,202212,109,62,47,75144.53,56964,132108.53
421070,202212,37,33,4,39997.52,4848,44845.52
421080,202212,44,37,7,44844.08,8484,53328.08
421085,202212,20,16,4,19392,4848,24240
421090,202212,38,29,9,35148.11,10908.6,46056.71
421100,202212,112,86,26,104234.26,31512.95,135747.21
421105,202212,199,158,41,191500.46,49692.2,241192.66
421110,202212,131,93,38,112719.93,46056,158775.93
421120,202212,187,134,53,162412.64,64236,226648.64
421125,202212,16,9,7,10908,8484.71,19392.71
421130,202212,871,533,338,647224.18,409661.45,1056885.63
421140,202212,32,23,9,27876.58,10908,38784.58
421145,202212,41,36,5,43632,6060,49692
421150,202212,82,64,18,77570.1,21816.97,99387.07
421160,202212,60,38,22,46056.03,26664.5,72720.53
421165,202212,14,12,2,14544,2424,16968
421170,202212,165,138,27,167408.65,32725.13,200133.78
421175,202212,191,137,54,166045.78,65449.69,231495.47
421180,202212,40,28,12,33936.76,14544,48480.76
421185,202212,16,13,3,15756.18,3636,19392.18
421187,202212,3,2,1,2424.2,1212,3636.2
421189,202212,45,32,13,38785,15756,54541
421190,202212,2091,1309,782,1586561.99,947801.11,2534363.10
421200,202212,94,65,29,78781.98,35148,113929.98
421205,202212,27,19,8,23029.11,9696,32725.11
421210,202212,174,127,47,153925.72,56964,210889.72
421220,202212,254,196,58,237554.57,70297.45,307852.02
421223,202212,50,39,11,47269.17,13332,60601.17
421225,202212,75,51,24,61813.33,29089.73,90903.06
421227,202212,63,54,9,65449.19,10908,76357.19
421230,202212,71,46,25,55753.91,30300.18,86054.09
421240,202212,18,15,3,18180.98,3636,21816.98
421250,202212,422,230,192,278764.08,232710.35,511474.43
421260,202212,21,16,5,19392.59,6060,25452.59
421265,202212,10,7,3,8484.11,3636,12120.11
421270,202212,54,49,5,59388,6060,65448
421280,202212,404,203,201,246040.44,243613.22,489653.66
421290,202212,318,208,110,252098.47,134532.85,386631.32
421300,202212,21,19,2,23028,2424,25452
421310,202212,47,33,14,39996.78,16968,56964.78
421315,202212,33,20,13,24240,15756.08,39996.08
421320,202212,140,95,45,115140.91,54540,169680.91
421330,202212,109,82,27,99385.34,32724,132109.34
421335,202212,43,31,12,37573.65,14544,52117.65
421340,202212,238,159,79,192711.35,95748,288459.35
421350,202212,189,111,78,134535.69,94536.25,229071.94
421360,202212,757,522,235,632673.74,286038.19,918711.93
421370,202212,200,150,50,181801.42,61812.53,243613.95
421380,202212,151,112,39,135745.65,47268,183013.65
421390,202212,15,10,5,12120,6060,18180
421400,202212,118,95,23,115140.15,27876,143016.15
421410,202212,20,17,3,20604,3636,24240
421415,202212,20,18,2,21816,2424,24240
421420,202212,101,86,15,104233.12,18180,122413.12
421430,202212,21,13,8,15756,9696,25452
421440,202212,60,52,8,63026.51,9696.98,72723.49
421450,202212,79,66,13,79992.55,15756,95748.55
421460,202212,55,43,12,52116,14544,66660
421470,202212,76,41,35,49692.26,42420,92112.26
421480,202212,806,597,209,723571.44,253308.79,976880.23
421490,202212,24,23,1,27876.18,1212,29088.18
421500,202212,488,286,202,346642.78,246036.54,592679.32
421505,202212,37,30,7,36360.1,8484.2,44844.3
421507,202212,30,24,6,29088.1,7272,36360.1
421510,202212,68,42,26,50904.82,31512.61,82417.43
421520,202212,50,41,9,49692.4,12120,61812.4
421530,202212,50,43,7,52116.4,8484,60600.4
421535,202212,24,22,2,26664,2424,29088
421540,202212,49,40,9,48480.2,12120,60600.2
421545,202212,79,53,26,64240.64,31512.82,95753.46
421550,202212,294,211,83,255744.52,101809.57,357554.09
421555,202212,15,13,2,15756.41,2424,18180.41
421560,202212,8,7,1,8484,1212,9696
421565,202212,131,86,45,104234.58,54540.15,158774.73
421567,202212,36,27,9,32724,10908,43632
421568,202212,40,38,2,46056,2424,48480
421569,202212,11,11,0,13332.91,,13332.91
421570,202212,264,171,93,207253.65,112716.97,319970.62
421575,202212,27,24,3,29088.31,3636,32724.31
421580,202212,754,442,312,535793.85,379358.96,915152.81
421590,202212,22,19,3,23028.2,3636,26664.2
421600,202212,188,134,54,162409.27,65448,227857.27
421605,202212,105,70,35,84841.21,42420.2,127261.41
421610,202212,173,126,47,152712.89,56964,209676.89
421620,202212,1105,634,471,769649.27,572075.24,1341724.51
421625,202212,23,20,3,24240.71,3636,27876.71
421630,202212,370,222,148,269070.01,179381.84,448451.85
421635,202212,26,13,13,15756,15756,31512
421640,202212,104,82,22,99387.33,26664,126051.33
421650,202212,333,191,142,231499.25,172107.06,403606.31
421660,202212,2724,1636,1088,1985312.22,1318676,3303988.22
421670,202212,162,117,45,141805.48,54540,196345.48
421680,202212,198,179,19,216950.46,23028,239978.46
421690,202212,353,237,116,287248.52,140592.92,427841.44
421700,202212,61,41,20,49692.2,24240.2,73932.4
421710,202212,20,20,0,24240.1,,24240.1
421715,202212,5,4,1,4848,1212,6060
421720,202212,655,438,217,530868.19,264218.18,795086.37
421725,202212,31,12,19,14544,23028.2,37572.2
421730,202212,23,17,6,20604,8484,29088
421740,202212,115,46,69,55752.35,83628,139380.35
421750,202212,194,141,53,172104.34,64236,236340.34
421755,202212,18,16,2,19392,2424,21816
421760,202212,99,66,33,79993.83,39996.19,119990.02
421770,202212,726,460,266,557535.06,322395.57,879930.63
421775,202212,30,19,11,23028.97,13332,36360.97
421780,202212,191,147,44,178164.4,54540,232704.4
421790,202212,150,127,23,153925.09,27876.66,181801.75
421795,202212,16,13,3,15756.33,3636,19392.33
421800,202212,582,348,234,421794.58,286036.98,707831.56
421810,202212,67,55,12,66661.58,14544,81205.58
421820,202212,311,190,121,230283.38,146652,376935.38
421825,202212,159,133,26,161201,31512,192713
421830,202212,157,97,60,117569.41,72721,190290.41
421835,202212,6,2,4,2424.19,4848,7272.19
421840,202212,42,35,7,42421.53,8484,50905.53
421850,202212,77,64,13,77568.5,15756,93324.5
421860,202212,36,26,10,31512,12120,43632
421870,202212,1176,839,337,1019324.18,408455.74,1427779.92
421875,202212,48,38,10,46056,12120,58176
421880,202212,193,135,58,163620.44,70296.7,233917.14
421885,202212,20,15,5,18180,6060.84,24240.84
421890,202212,168,123,45,149078.91,54540.85,203619.76
421895,202212,49,41,8,49693.6,9696,59389.6
421900,202212,129,99,30,119993.72,36360,156353.72
421910,202212,65,41,24,49692.58,29088,78780.58
421915,202212,29,23,6,27876,7272,35148
421917,202212,50,39,11,47269.2,13332,60601.2
421920,202212,33,29,4,35148,6060,41208
421930,202212,641,512,129,621769.59,156349.27,778118.86
421935,202212,43,38,5,46056,6060,52116
421940,202212,52,44,8,53328.4,9696,63024.4
421950,202212,945,625,320,757510.32,387843.11,1145353.43
421960,202212,41,34,7,41208.22,8484,49692.22
421970,202212,331,205,126,249677.07,152713.39,402390.46
421985,202212,19,11,8,13332,9696,23028
422000,202212,7,3,4,3636.7,4848.26,8484.96
430003,202212,189,57,132,69084,159984,229068
430005,202212,32,24,8,29088.78,9696,38784.78
430010,202212,256,185,71,224222.06,86052,310274.06
430020,202212,136,95,41,115141.23,49692,164833.23
430030,202212,126,100,26,121200.06,31512,152712.06
430040,202212,3014,1784,1230,2167093.12,1494399.15,3661492.27
430045,202212,70,61,9,73932,10908,84840
430047,202212,9,6,3,7272,3636,10908
430050,202212,87,74,13,89688,15756,105444
430055,202212,14,12,2,14544,2424,16968
430057,202212,5,3,2,3636,2424,6060
430060,202212,4288,2453,1835,2976752.98,2224036.99,5200789.97
430063,202212,54,43,11,52116,13332,65448
430064,202212,175,139,36,168468.14,43632,212100.14
430066,202212,7,4,3,4848,3636,8484
430070,202212,45,33,12,39996,14544,54540
430080,202212,85,55,30,66661.07,36360.2,103021.27
430085,202212,25,11,14,13332,16968,30300
430087,202212,30,24,6,29089.75,7272,36361.75
430090,202212,69,58,11,70296.76,13332,83628.76
430100,202212,151,103,48,124837.04,58176,183013.04
430105,202212,173,96,77,116355.45,93324.3,209679.75
430107,202212,19,14,5,16968.13,6060,23028.13
430110,202212,493,266,227,322392.87,275124,597516.87
430120,202212,164,151,13,183012.1,15756,198768.1
430130,202212,824,491,333,595095.84,403596.68,998692.52
430140,202212,140,129,11,156348.6,13332,169680.6
430150,202212,114,72,42,87264.96,50904,138168.96
430155,202212,30,24,6,29088,7272,36360
430160,202212,3847,2158,1689,2616752.14,2048291.05,4665043.19
430163,202212,442,209,233,253313.57,282401.09,535714.66
430165,202212,30,19,11,24240.59,14544,38784.59
430170,202212,83,69,14,83628,16968,100596
430175,202212,82,63,19,76356,23028.7,99384.7
430180,202212,109,84,25,101808.2,30300,132108.2
430185,202212,26,17,9,20604,10908,31512
430187,202212,89,35,54,42421.7,65448,107869.7
430190,202212,235,118,117,144230.51,141805.59,286036.10
430192,202212,14,10,4,12120,4848,16968
430195,202212,17,13,4,15756.36,4848,20604.36
430200,202212,156,130,26,158773,31512,190285
430205,202212,20,20,0,24240,,24240.0
430210,202212,780,577,203,699335.37,246036.99,945372.36
430215,202212,10,9,1,10908,1212,12120
430220,202212,78,53,25,64236,30300,94536
430222,202212,15,5,10,6060,12120,18180
430223,202212,16,11,5,13332,6060,19392
430225,202212,5,3,2,3636,2424,6060
430230,202212,355,218,137,264217,166044,430261
430235,202212,54,34,20,41208,24240,65448
430237,202212,21,16,5,19392.41,6060,25452.41
430240,202212,117,79,38,95748.4,46056,141804.4
430245,202212,67,53,14,64236,16968,81204
430250,202212,192,112,80,135744.51,96960.84,232705.35
430258,202212,14,10,4,12120.71,4848.2,16968.91
430260,202212,37,32,5,38784.1,6060,44844.1
430265,202212,36,32,4,38784,4848,43632
430270,202212,533,376,157,455724.24,190284,646008.24
430280,202212,1095,636,459,772048.99,557520.3,1329569.29
430290,202212,462,241,221,292094.48,267852,559946.48
430300,202212,2225,1211,1014,1467762.21,1232619.26,2700381.47
430310,202212,2256,1099,1157,1333236.61,1402311.4,2735548.01
430320,202212,59,47,12,56964,14544,71508
430330,202212,86,73,13,88476.16,15756,104232.16
430340,202212,73,57,16,69084,19392.07,88476.07
430350,202212,1725,1086,639,1317453.12,774469.05,2091922.17
430355,202212,18,16,2,19392,2424,21816
430360,202212,99,47,52,56964,63024,119988
430367,202212,51,37,14,44844,18180,63024
430370,202212,60,53,7,64236,8484,72720
430380,202212,109,79,30,95749.16,36360,132109.16
430390,202212,730,435,295,528364.78,357542.8,885907.58
430400,202212,259,177,82,214525.27,99384,313909.27
430410,202212,55,45,10,54540.2,12120,66660.2
430420,202212,541,348,193,422994.56,235128.89,658123.45
430430,202212,48,46,2,54944.8,2424,57368.8
430435,202212,151,112,39,135744,47268,183012
430440,202212,607,372,235,450869.38,284820.8,735690.18
430450,202212,1262,1021,241,1238676.35,293305.55,1531981.90
430460,202212,6226,3162,3064,3833633.26,3719674.79,7553308.05
430461,202212,18,16,2,19392,2424,21816
430462,202212,4,2,2,2424.1,2424,4848.1
430463,202212,1267,682,585,826597.15,709025.92,1535623.07
430465,202212,27,16,11,19392,13332,32724
430466,202212,756,525,231,637533.61,279976.83,917510.44
430467,202212,127,72,55,87265.06,66660,153925.06
430468,202212,152,89,63,107869.02,77568.48,185437.50
430469,202212,20,14,6,16968,7272,24240
430470,202212,1219,648,571,785745.94,692056.31,1477802.25
430471,202212,77,52,25,63024.86,30300.57,93325.43
430480,202212,139,97,42,117564.95,50904,168468.95
430485,202212,8,8,0,9696.6,,9696.6
430490,202212,72,57,15,69084.64,18180,87264.64
430495,202212,34,25,9,30300.2,10908,41208.2
430500,202212,198,133,65,161197,78780,239977
430510,202212,4016,2597,1419,3148813.31,1722259.5,4871072.81
430511,202212,14,14,0,16968,,16968.0
430512,202212,176,120,56,145441.72,67872.9,213314.62
430513,202212,54,41,13,49692,15756,65448
430515,202212,25,23,2,27876,2424,30300
430517,202212,181,151,30,183012,36360,219372
430520,202212,343,239,104,289672.95,126048.1,415721.05
430530,202212,79,42,37,50904.2,44844,95748.2
430535,202212,477,306,171,370875.12,207254.51,578129.63
430537,202212,9,9,0,10908.6,,10908.6
430540,202212,81,53,28,64236,33936,98172
430543,202212,434,142,292,172105.47,353904.01,526009.48
430544,202212,54,50,4,60600.81,4848,65448.81
430545,202212,441,214,227,259380.94,275131.9,534512.84
430550,202212,44,36,8,43632.1,9696,53328.1
430558,202212,1,1,0,1212,,1212.0
430560,202212,53,29,24,35148,29088,64236
430570,202212,120,49,71,59388.4,86052,145440.4
430580,202212,126,99,27,119988.2,32724,152712.2
430583,202212,14,14,0,16968,,16968.0
430585,202212,15,11,4,13332,4848,18180
430587,202212,16,10,6,12120,7272.94,19392.94
430590,202212,189,152,37,184225.85,44844,229069.85
430593,202212,1,1,0,1212,,1212.0
430595,202212,18,15,3,18180,3636,21816
430597,202212,41,23,18,27876,21816,49692
430600,202212,228,168,60,203616.3,72720,276336.3
430605,202212,181,106,75,128472,90900,219372
430607,202212,30,24,6,29088,7272,36360
430610,202212,1819,860,959,1042329.19,1163525.2,2205854.39
430613,202212,5,5,0,6060,,6060.0
430620,202212,95,69,26,83628.47,31512,115140.47
430630,202212,46,39,7,47269.57,8484,55753.57
430632,202212,32,27,5,32724,6060,38784
430635,202212,35,29,6,35148,7272,42420
430637,202212,65,30,35,36360,42420,78780
430640,202212,181,99,82,119989.31,99384.74,219374.05
430642,202212,19,17,2,20604,2424,23028
430645,202212,34,27,7,32724,8484,41208
430650,202212,246,195,51,236341.2,61812.2,298153.4
430655,202212,7,6,1,7272,1212,8484
430660,202212,1039,509,530,619342.24,642368.96,1261711.20
430670,202212,69,46,23,55752,27876,83628
430673,202212,78,53,25,64236,30300,94536
430675,202212,8,6,2,7272,2424,9696
430676,202212,658,401,257,487233.95,311486.42,798720.37
430680,202212,257,168,89,203617.14,107868,311485.14
430690,202212,564,343,221,415720.32,269065.07,684785.39
430692,202212,8,6,2,7272,2424,9696
430693,202212,143,93,50,112716.64,60600.2,173316.84
430695,202212,68,55,13,66660,15756,82416
430697,202212,66,42,24,50904,29088,79992
430700,202212,1417,958,459,1162321.9,556309.38,1718631.28
430705,202212,30,26,4,31512,4848,36360
430710,202212,277,172,105,208464,127260,335724
430720,202212,102,85,17,103020,20604,123624
430730,202212,148,126,22,152712,26664,179376
430740,202212,81,49,32,59388,38784,98172
430745,202212,29,17,12,20604,14544,35148
430750,202212,332,215,117,260581.11,141805.03,402386.14
430755,202212,84,47,37,56964.24,44844,101808.24
430760,202212,434,241,193,293310.74,233919.88,527230.62
430770,202212,1726,930,796,1128393.82,965971.32,2094365.14
430780,202212,355,219,136,265428.2,164832,430260.2
430781,202212,25,25,0,30300,,30300.0
430783,202212,62,48,14,58176,16968,75144
430786,202212,6,4,2,4848,2424,7272
430790,202212,552,345,207,419354.19,250886.59,670240.78
430800,202212,166,124,42,150288.1,50904,201192.1
430805,202212,38,31,7,37572,8484.32,46056.32
430807,202212,74,40,34,48480,41208,89688
430810,202212,84,56,28,69084.7,33936.62,103021.32
430820,202212,155,100,55,121200.2,66660,187860.2
430825,202212,11,9,2,10908,2424,13332
430830,202212,268,248,20,300577.43,24240,324817.43
430840,202212,139,91,48,110292,58176,168468
430843,202212,8,4,4,4848,4848,9696
430845,202212,84,50,34,60600,41208,101808
430850,202212,599,424,175,515101.39,212100,727201.39
430860,202212,173,115,58,139381.01,70296.88,209677.89
430865,202212,76,42,34,50904,41208,92112
430870,202212,71,58,13,70296.21,15756,86052.21
430880,202212,181,124,57,150289.14,69084.2,219373.34
430885,202212,11,9,2,10908,2424,13332
430890,202212,340,204,136,248460.56,164832,413292.56
430900,202212,548,375,173,455717.24,210888,666605.24
430905,202212,138,59,79,71508.6,95749.25,167257.85
430910,202212,296,159,137,192708.52,166044.8,358753.32
430912,202212,4,4,0,4848.84,,4848.84
430915,202212,44,41,3,49692,3636,53328
430920,202212,5019,2611,2408,3167050.27,2920965.25,6088015.52
430925,202212,6,5,1,6060,1212,7272
430930,202212,2236,1255,981,1522296.23,1190189.77,2712486.00
430940,202212,269,172,97,208465.11,117564.92,326030.03
430950,202212,157,125,32,151500.77,38784,190284.77
430955,202212,25,15,10,18180,12120,30300
430957,202212,23,20,3,24240,3636,27876
430960,202212,273,175,98,212101.93,118776.38,330878.31
430965,202212,104,67,37,81204,44844,126048
430970,202212,91,73,18,88476,21816,110292
430975,202212,53,46,7,55752,8484,64236
430980,202212,52,31,21,37572.6,25452,63024.6
430990,202212,98,76,22,92112,26664,118776
430995,202212,110,103,7,124836,8484,133320
431000,202212,300,147,153,178165.1,185436,363601.1
431010,202212,371,217,154,263010.61,186650.89,449661.50
431020,202212,1978,1138,840,1380484.05,1019294.41,2399778.46
431030,202212,40,31,9,37572,10908,48480
431033,202212,505,229,276,277561.39,334523.58,612084.97
431036,202212,12,8,4,9696,4848,14544
431040,202212,148,98,50,118777.36,60600,179377.36
431041,202212,45,27,18,32724.37,21816,54540.37
431043,202212,41,23,18,27876,21816,49692
431046,202212,13,10,3,12120,3636,15756
431050,202212,209,127,82,153925.01,99384,253309.01
431053,202212,77,43,34,52116.02,41208.99,93325.01
431055,202212,66,44,22,53328,26664,79992
431057,202212,18,18,0,21816,,21816.0
431060,202212,1630,1039,591,1259281.2,716294.02,1975575.22
431065,202212,17,7,10,8484,12120,20604
431070,202212,66,57,9,69084.1,10908,79992.1
431075,202212,8,8,0,9696,,9696.0
431080,202212,130,73,57,89688.19,69084,158772.19
431085,202212,36,32,4,38784.1,4848,43632.1
431087,202212,16,13,3,15756.17,3636,19392.17
431090,202212,52,40,12,49692.59,14544,64236.59
431100,202212,1318,785,533,952647.94,645999.53,1598647.47
431110,202212,229,136,93,164833.72,112716,277549.72
431112,202212,28,21,7,25452,8484,33936
431113,202212,28,20,8,24240,9696,33936
431115,202212,156,109,47,132108.2,56964,189072.2
431120,202212,607,353,254,427841.75,309060,736901.75
431123,202212,5,5,0,6060,,6060.0
431125,202212,97,84,13,101808,15756,117564
431127,202212,5,3,2,3636,2424,6060
431130,202212,737,471,266,570857.15,323606.01,894463.16
431140,202212,840,587,253,711449.86,306636.8,1018086.66
431142,202212,19,17,2,20605.04,2424,23029.04
431150,202212,206,150,56,181801.47,67872,249673.47
431160,202212,44,40,4,48480,4848,53328
431162,202212,6,6,0,7272.67,,7272.67
431164,202212,5,4,1,4848,1212,6060
431170,202212,116,82,34,99384.2,41208,140592.2
431171,202212,78,44,34,53328,41208,94536
431173,202212,6,5,1,6060,1212.8,7272.8
431175,202212,207,108,99,130896.72,119988.15,250884.87
431177,202212,102,72,30,87264.64,36360.31,123624.95
431179,202212,15,10,5,12120,6060,18180
431180,202212,412,254,158,309062.3,191496.77,500559.07
431190,202212,72,52,20,63024,24240.7,87264.7
431198,202212,75,51,24,61686.21,30300,91986.21
431200,202212,22,18,4,21816,4848,26664
431205,202212,22,20,2,24240,2424,26664
431210,202212,104,62,42,75144.2,50904,126048.2
431213,202212,33,26,7,31512,8484.56,39996.56
431215,202212,23,22,1,26664,1212,27876
431217,202212,6,5,1,6060,1212,7272
431220,202212,66,55,11,66660.38,13332,79992.38
431225,202212,168,103,65,124838.05,78780,203618.05
431230,202212,100,82,18,99386.16,21816,121202.16
431235,202212,5,4,1,4848,1212,6060
431237,202212,18,12,6,14544,7272,21816
431238,202212,16,11,5,13332,6060.2,19392.2
431240,202212,1006,625,381,758730.21,461774.4,1220504.61
431242,202212,42,41,1,49692,1212,50904
431244,202212,35,28,7,33936.2,8484,42420.2
431245,202212,51,36,15,43632,19392,63024
431247,202212,13,10,3,12120,3636,15756
431250,202212,305,150,155,181801.6,187860,369661.6
431260,202212,53,46,7,55752,8484,64236
431261,202212,22,16,6,19392.23,7272,26664.23
431262,202212,15,12,3,14544.89,3636.07,18180.96
431265,202212,152,86,66,104232.77,79992,184224.77
431267,202212,18,15,3,18180,3636,21816
431270,202212,339,264,75,319971.69,90900.42,410872.11
431275,202212,39,35,4,42420,4848,47268
431280,202212,21,15,6,18180,7272,25452
431290,202212,25,22,3,26664.4,3636,30300.4
431295,202212,3,1,2,1212,2424,3636
431300,202212,24,21,3,25452,3636,29088
431301,202212,7,7,0,8484,,8484.0
431303,202212,57,36,21,43632,25452,69084
431306,202212,250,127,123,153924.88,149076,303000.88
431308,202212,8,7,1,8484,2424,10908
431310,202212,65,50,15,61812,18180,79992
431320,202212,215,131,84,158773.6,101808,260581.6
431330,202212,219,145,74,175740.4,89688,265428.4
431333,202212,25,20,5,24240,6060,30300
431335,202212,8,6,2,7272,2424,9696
431337,202212,443,217,226,263011.74,273913.93,536925.67
431339,202212,23,17,6,20604,7272,27876
431340,202212,3264,1742,1522,2113668.11,1845885.06,3959553.17
431342,202212,34,23,11,27876,13332,41208
431344,202212,20,20,0,24240,,24240.0
431346,202212,5,4,1,4848,1212,6060
431349,202212,28,26,2,31512,2424,33936
431350,202212,941,521,420,631473.37,509042.99,1140516.36
431360,202212,57,41,16,49692,19392,69084
431365,202212,389,162,227,196347.51,276337.24,472684.75
431370,202212,1239,689,550,835079.05,666601.83,1501680.88
431380,202212,99,86,13,104232,15756,119988
431390,202212,507,277,230,335724.59,278760.8,614485.39
431395,202212,335,147,188,179377.27,229068,408445.27
431400,202212,37,23,14,27876,16968,44844
431402,202212,99,73,26,88476.2,31512.8,119989.0
431403,202212,28,19,9,23028.09,10908,33936.09
431405,202212,757,436,321,529651.6,389054.3,918705.9
431406,202212,37,28,9,33936.86,10908,44844.86
431407,202212,48,36,12,43632,14544,58176
431410,202212,3656,2234,1422,2707655.09,1724689.45,4432344.54
431413,202212,16,13,3,15756,3636,19392
431415,202212,74,52,22,63025.41,26664,89689.41
431417,202212,23,12,11,14544,13332,27876
431420,202212,379,250,129,303004.36,156348.2,459352.56
431430,202212,69,33,36,39998.4,43632,83630.4
431440,202212,9618,6476,3142,7852776.58,3809408.25,11662184.83
431442,202212,27,14,13,16968,15756,32724
431445,202212,27,25,2,30300,2424,32724
431446,202212,5,5,0,6060,,6060.0
431447,202212,86,64,22,77568,26664,104232
431449,202212,61,48,13,58176.3,15756,73932.3
431450,202212,429,280,149,340572.33,181800,522372.33
431454,202212,11,6,5,7272,6060,13332
431455,202212,49,40,9,48480.65,10908,59388.65
431460,202212,520,351,169,425416.68,204828,630244.68
431470,202212,140,103,37,124836.25,44844,169680.25
431475,202212,10,8,2,9696,2424,12120
431477,202212,41,23,18,27876,21816,49692
431478,202212,7,7,0,8484,,8484.0
431480,202212,785,477,308,578133.66,373296.1,951429.76
431490,202212,31619,17730,13889,21504610.95,16860323.87,38364934.82
431500,202212,75,59,16,71508,19392,90900
431505,202212,28,20,8,24240.35,9696,33936.35
431507,202212,11,8,3,9696,3636,13332
431510,202212,234,164,70,198768.6,84840,283608.6
431513,202212,20,19,1,23028,1212,24240
431514,202212,5,3,2,4848,2424,7272
431515,202212,84,71,13,86052.04,15756.1,101808.14
431517,202212,7,4,3,4848,3636,8484
431520,202212,40,33,7,39996.2,8484,48480.2
431530,202212,1431,622,809,753868.89,984144.43,1738013.32
431531,202212,23,22,1,26664,1212,27876
431532,202212,36,27,9,32724,10908,43632
431535,202212,29,16,13,19392,15756,35148
431540,202212,144,113,31,136957.32,37572.6,174529.92
431545,202212,14,11,3,13332,3636,16968
431550,202212,354,185,169,224223.01,204829.16,429052.17
431555,202212,14,13,1,15756,1212,16968
431560,202212,5088,3349,1739,4062759.66,2108923.15,6171682.81
431570,202212,890,470,420,569649.6,509044.85,1078694.45
431575,202212,56,34,22,41208,26664.58,67872.58
431580,202212,83,58,25,70296,30300,100596
431590,202212,145,121,24,146652,29088,175740
431595,202212,17,15,2,18180,2424,20604
431600,202212,253,146,107,176956.98,129684.6,306641.58
431610,202212,121,89,32,107870.2,38784.8,146655.0
431620,202212,39,32,7,38784,8484,47268
431630,202212,124,100,24,121200.13,29088,150288.13
431640,202212,1334,826,508,1002334.67,616909.52,1619244.19
431642,202212,32,30,2,36360,2424,38784
431643,202212,44,17,27,20604,32724,53328
431645,202212,333,193,140,233916.02,170892,404808.02
431647,202212,11,10,1,12120,1212,13332
431650,202212,37,21,16,25452,19392,44844
431660,202212,267,170,97,206040.73,117564,323604.73
431670,202212,231,101,130,122412.79,157560.11,279972.90
431673,202212,14,11,3,13332,3636,16968
431675,202212,27,21,6,25452,7272,32724
431680,202212,1214,872,342,1058100.67,414509.87,1472610.54
431690,202212,5199,3053,2146,3708810.6,2604635.38,6313445.98
431695,202212,20,12,8,14544,9696,24240
431697,202212,4,2,2,2424,2424,4848
431700,202212,193,144,49,175740.55,59388,235128.55
431710,202212,4281,1831,2450,2220415.69,2971833.9,5192249.59
431720,202212,1307,809,498,981121.7,603577.15,1584698.85
431725,202212,3,1,2,1212,2424,3636
431730,202212,1238,817,421,990246.15,511473.86,1501720.01
431740,202212,1372,666,706,808416.19,856887.2,1665303.39
431750,202212,1879,1226,653,1487141.1,791441.52,2278582.62
431755,202212,5,4,1,4848,1212,6060
431760,202212,1015,639,376,774484.32,455718.44,1230202.76
431770,202212,420,282,138,341784.89,167256,509040.89
431775,202212,27,20,7,24240,8484,32724
431780,202212,591,356,235,431474.04,284820,716294.04
431790,202212,147,111,36,134532.52,43632.1,178164.62
431795,202212,13,11,2,13332,2424,15756
431800,202212,3188,1670,1518,2025276.05,1841034.28,3866310.33
431805,202212,19,15,4,18180,4848,23028
431810,202212,581,377,204,456927.31,247248.4,704175.71
431820,202212,357,204,153,247249.29,185436,432685.29
431830,202212,2420,1452,968,1760995.54,1173218.48,2934214.02
431840,202212,514,322,192,390272.17,232704.8,622976.97
431842,202212,35,29,6,35148,7272,42420
431843,202212,9,6,3,7272.1,3636.8,10908.9
431844,202212,17,13,4,15756,4848,20604
431845,202212,24,22,2,26664,2424,29088
431846,202212,27,23,4,27876.52,4848,32724.52
431848,202212,15,11,4,13332.6,4848,18180.6
431849,202212,7,6,1,7272,1212,8484
431850,202212,834,653,181,792660.78,219373.8,1012034.58
431860,202212,121,78,43,94536.31,52116,146652.31
431861,202212,3,0,3,,3636,3636.0
431862,202212,67,49,18,59388.32,21816,81204.32
431870,202212,4010,2304,1706,2796158.32,2071329.72,4867488.04
431880,202212,1016,704,312,853252.89,378145.53,1231398.42
431890,202212,1267,730,537,885980.15,652057.08,1538037.23
431900,202212,198,129,69,156348.2,83628,239976.2
431910,202212,45,35,10,42420,12120,54540
431912,202212,51,33,18,39996.96,21816,61812.96
431915,202212,154,116,38,140592.95,46056,186648.95
431920,202212,155,110,45,133320.55,54540,187860.55
431930,202212,74,59,15,71508,18180,89688
431935,202212,3,2,1,2424,1212,3636
431936,202212,2,2,0,2424,,2424.0
431937,202212,21,16,5,19392.63,6060,25452.63
431940,202212,477,326,151,395117.29,183012.27,578129.56
431950,202212,498,316,182,383001.67,220585,603586.67
431960,202212,766,413,353,500561.55,427836.26,928397.81
431970,202212,63,57,6,69084,7272,76356
431971,202212,3,3,0,3636,,3636.0
431973,202212,20,17,3,20604.83,3636,24240.83
431975,202212,10,10,0,12120,,12120.0
431980,202212,207,115,92,139382.26,111504,250886.26
431990,202212,1002,533,469,646009.91,568437.45,1214447.36
432000,202212,2018,1068,950,1295670.71,1153839.11,2449509.82
432010,202212,266,170,96,206040.38,116352.2,322392.58
432020,202212,191,162,29,196346.68,35148.87,231495.55
432023,202212,15,12,3,14544,3636,18180
432026,202212,62,54,8,65448.2,9696,75144.2
432030,202212,54,23,31,27876.06,37572,65448.06
432032,202212,15,11,4,13332,4848,18180
432035,202212,71,51,20,61812.4,24240,86052.4
432040,202212,86,60,26,72721.66,31512,104233.66
432045,202212,3,3,0,3636,,3636.0
432050,202212,83,51,32,61812.71,38784,100596.71
432055,202212,136,92,44,112718.27,53328,166046.27
432057,202212,6,4,2,4848.6,2424,7272.6
432060,202212,32,27,5,32724,6060,38784
432065,202212,31,27,4,32724,4848,37572
432067,202212,85,78,7,94536.6,8484,103020.6
432070,202212,390,306,84,370874.65,101808,472682.65
432080,202212,868,612,256,741764.55,310274.6,1052039.15
432085,202212,20,16,4,19392,4848,24240
432090,202212,288,187,101,226644.2,122412.33,349056.53
432100,202212,172,109,63,132108.21,76356,208464.21
432110,202212,581,382,199,462988.71,241188.92,704177.63
432120,202212,1085,609,476,738118.21,576915.86,1315034.07
432130,202212,534,380,154,460562.05,186648,647210.05
432132,202212,22,20,2,24240,2424,26664
432135,202212,83,66,17,79992,20604,100596
432140,202212,270,203,67,247250.3,81204,328454.3
432143,202212,232,141,91,170893.05,110292.1,281185.15
432145,202212,307,218,89,264218.38,109080,373298.38
432146,202212,17,14,3,16968,3636,20604
432147,202212,100,61,39,73932,47268,121200
432149,202212,14,10,4,12120,4848,16968
432150,202212,1110,693,417,839929.86,507832.5,1347762.36
432160,202212,2117,1079,1038,1309993.39,1258070.57,2568063.96
432162,202212,4,2,2,2424,2424,4848
432163,202212,15,10,5,12120,6060,18180
432166,202212,132,90,42,109384.06,50904.95,160289.01
432170,202212,244,132,112,159986.62,135745.2,295731.82
432180,202212,588,376,212,456924.2,258156.6,715080.8
432183,202212,11,10,1,12120.1,1212,13332.1
432185,202212,79,64,15,77568.2,18180.39,95748.59
432190,202212,542,322,220,390264.57,266640.8,656905.37
432195,202212,91,72,19,87264.2,23028,110292.2
432200,202212,448,269,179,326030.36,216949.64,542980.00
432210,202212,124,73,51,89688,61812,151500
432215,202212,30,28,2,33936,2424,36360
432218,202212,20,20,0,24240,,24240.0
432220,202212,662,330,332,399966.59,403597.63,803564.22
432225,202212,20,14,6,16968.2,7272,24240.2
432230,202212,128,82,46,99384,55752.71,155136.71
432232,202212,27,24,3,29088,3636,32724
432234,202212,4,2,2,2424,2424,4848
432235,202212,1,1,0,1212,,1212.0
432237,202212,23,15,8,18180,9696,27876
432240,202212,4734,2640,2094,3202177.62,2540379.43,5742557.05
432250,202212,1188,795,393,963542.93,476317.58,1439860.51
432252,202212,50,48,2,58176,2424,60600
432253,202212,71,55,16,66662.39,19392,86054.39
432254,202212,30,15,15,18180,18180,36360
432255,202212,11,10,1,12120,1212,13332
432260,202212,902,723,179,876286.21,216948.1,1093234.31
432270,202212,220,161,59,195141.23,71508.2,266649.43
432280,202212,165,123,42,149079.83,50904,199983.83
432285,202212,1,1,0,1212,,1212.0
432290,202212,59,49,10,59388,12120,71508
432300,202212,5344,2846,2498,3450551.62,3030023.87,6480575.49
432310,202212,131,111,20,134532.65,24240,158772.65
432320,202212,20,15,5,18180,6060,24240
432330,202212,19,13,6,15756,7272,23028
432335,202212,11,9,2,10908,2424,13332
432340,202212,35,28,7,33936,8484,42420
432345,202212,124,80,44,96961.37,53328,150289.37
432350,202212,25,24,1,29088,1212,30300
432360,202212,5,4,1,4848,1212,6060
432370,202212,27,27,0,32724.26,,32724.26
432375,202212,26,24,2,29088,2424,31512
432377,202212,6,6,0,7272.48,,7272.48
432380,202212,224,103,121,124837.68,146654.19,271491.87
500020,202212,299,156,143,189074.86,173316.39,362391.25
500025,202212,147,69,78,83629.7,94537.12,178166.82
500060,202212,1546,983,563,1192639.79,682365.89,1875005.68
500070,202212,784,377,407,456938.53,493292.6,950231.13
500080,202212,142,113,29,136958.68,35148,172106.68
500085,202212,139,103,36,124837.26,43632,168469.26
500090,202212,409,188,221,227859.55,267853.2,495712.75
500100,202212,713,369,344,447240.11,416932.57,864172.68
500110,202212,2406,1156,1250,1403532.78,1516238.62,2919771.40
500124,202212,269,144,125,174528.26,151501.16,326029.42
500150,202212,330,137,193,166047.91,233917.14,399965.05
500190,202212,596,397,199,482389.15,241189.66,723578.81
500200,202212,212,175,37,212104.08,44844,256948.08
500210,202212,1788,568,1220,688426.03,1478657.51,2167083.54
500215,202212,204,117,87,141807.9,105445.13,247253.03
500220,202212,735,461,274,561176.7,332091.82,893268.52
500230,202212,251,143,108,174530.83,130896.58,305427.41
500240,202212,676,426,250,516323.81,303003.2,819327.01
500260,202212,626,253,373,306640.72,453289.05,759929.77
500270,202212,32402,14076,18326,17078144.36,22228468.79,39306613.15
500280,202212,205,71,134,86052.24,162409.55,248461.79
500290,202212,1231,771,460,934475.09,557524.16,1491999.25
500295,202212,495,325,170,393908.92,206041.09,599950.01
500310,202212,117,40,77,48480.1,93324.87,141804.97
500315,202212,876,476,400,578125.67,484801.83,1062927.50
500320,202212,3867,1804,2063,2191370.86,2504008.21,4695379.07
500325,202212,979,551,428,667837.59,519955.23,1187792.82
500330,202212,1585,777,808,942900.76,979311.21,1922211.97
500345,202212,318,225,93,272704.19,112716.21,385420.40
500348,202212,254,155,99,189074.26,119988,309062.26
500350,202212,106,51,55,63024.71,66660,129684.71
500370,202212,6090,2746,3344,3329466.03,4056603.3,7386069.33
500375,202212,385,252,133,305426.72,161196.77,466623.49
500380,202212,673,378,295,458148.35,357542.83,815691.18
500390,202212,74,31,43,37572.1,52116.8,89688.9
500400,202212,230,142,88,172107.16,106656.97,278764.13
500410,202212,477,207,270,250890.2,328456.33,579346.53
500430,202212,610,387,223,470266.59,270278.74,740545.33
500440,202212,216,123,93,149077.09,113928.2,263005.29
500450,202212,447,189,258,230283.77,313908.8,544192.57
500460,202212,282,153,129,185440.96,156348.96,341789.92
500470,202212,448,320,128,389057.17,155137.07,544194.24
500480,202212,102,56,46,67872.53,55752.23,123624.76
500490,202212,94,39,55,47268.68,66662.61,113931.29
500500,202212,1529,560,969,678730.48,1176857.92,1855588.40
500510,202212,39,32,7,38784.51,8484,47268.51
500515,202212,123,79,44,95750.5,53328.78,149079.28
500520,202212,292,149,143,180593.03,173316.16,353909.19
500525,202212,99,50,49,60600,59388,119988
500540,202212,947,405,542,490873.45,656912.37,1147785.82
500560,202212,908,504,404,612070.09,489653.23,1101723.32
500568,202212,1124,539,585,653279.96,710238.41,1363518.37
500570,202212,1255,716,539,869022.08,654486.67,1523508.75
500580,202212,318,173,145,210893.57,175741.87,386635.44
500600,202212,403,193,210,233919.44,255733.4,489652.84
500620,202212,1036,708,328,860537.62,397541.92,1258079.54
500625,202212,86,66,20,79992.4,24240,104232.4
500627,202212,39,17,22,20604.15,26664,47268.15
500630,202212,1640,934,706,1131530.29,855678.96,1987209.25
500635,202212,519,306,213,370872.71,258156,629028.71
500640,202212,373,206,167,249681.09,202406.3,452087.39
500660,202212,6250,2224,4026,2695539.52,4881969.52,7577509.04
500690,202212,656,235,421,284824.05,510252.04,795076.09
500710,202212,426,207,219,250890.56,266643.83,517534.39
500720,202212,983,533,450,646013.52,545403.94,1191417.46
500730,202212,148,90,58,109088.24,70296,179384.24
500740,202212,1017,431,586,522383.67,710239.35,1232623.02
500750,202212,199,74,125,89690.4,151502.38,241192.78
500755,202212,111,84,27,101811.26,32724.93,134536.19
500769,202212,778,422,356,512685.54,431476.78,944162.32
500770,202212,437,231,206,279972.52,249672,529644.52
500780,202212,137,94,43,116357.63,52116.63,168474.26
500790,202212,1135,549,586,666621.94,710235.41,1376857.35
500793,202212,301,155,146,187862.3,176955.26,364817.56
500795,202212,198,127,71,153925.94,86052.79,239978.73
500797,202212,48,33,15,39996.52,18180,58176.52
500800,202212,443,197,246,239979.79,300577.91,540557.70
500830,202212,2456,1294,1162,1569592.77,1408352.52,2977945.29
500840,202212,117,83,34,100600.96,41208,141808.96
510010,202212,172,93,79,112716,95748,208464
510020,202212,570,268,302,324824.12,367238.81,692062.93
510025,202212,1807,1017,790,1233847.06,957489.25,2191336.31
510030,202212,672,352,320,426639.36,387844.42,814483.78
510035,202212,135,68,67,82416.26,81204,163620.26
510040,202212,423,198,225,239978.2,273914.08,513892.28
510050,202212,382,203,179,246042.42,216950.65,462993.07
510060,202212,134,60,74,72721.05,89688,162409.05
510080,202212,258,108,150,130896.93,183012,313908.93
510100,202212,66,27,39,32724.55,47268.03,79992.58
510120,202212,32,19,13,23028.99,15756.85,38785.84
510125,202212,409,260,149,317545.8,180588,498133.8
510130,202212,553,324,229,392697.53,277549.3,670246.83
510140,202212,464,154,310,186648.64,376933.38,563582.02
510160,202212,109,41,68,49693.95,82417.51,132111.46
510170,202212,803,470,333,570858.67,404812.49,975671.16
510180,202212,3101,1397,1704,1693203.04,2066484.71,3759687.75
510185,202212,34,15,19,18180,23028,41208
510190,202212,259,91,168,110293.96,203617.59,313911.55
510250,202212,2812,1706,1106,2071341.11,1342904.34,3414245.45
510260,202212,171,122,49,147866.55,59389.31,207255.86
510263,202212,504,285,219,346636.96,267855.43,614492.39
510267,202212,625,351,274,425425.34,332090.87,757516.21
510268,202212,73,35,38,42420.95,46056,88476.95
510269,202212,79,36,43,43632.29,52116.4,95748.69
510270,202212,395,188,207,229070.32,250884,479954.32
510279,202212,209,154,55,186648.83,66660,253308.83
510285,202212,190,75,115,90901.36,139380.55,230281.91
510300,202212,539,276,263,334515.3,318756.56,653271.86
510305,202212,193,86,107,104232.2,132108,236340.2
510310,202212,107,56,51,67872.69,61812.1,129684.79
510320,202212,838,521,317,632671.92,385417.4,1018089.32
510325,202212,466,197,269,238765.43,326029.45,564794.88
510330,202212,469,258,211,312700.09,255734.29,568434.38
510335,202212,691,403,288,488449.03,349057.54,837506.57
510336,202212,54,36,18,43633.04,21816.5,65449.54
510337,202212,103,44,59,53328,71508,124836
510340,202212,19347,8256,11091,10015102.39,13453437.68,23468540.07
510343,202212,58,45,13,54540,15756,70296
510345,202212,153,92,61,111505.53,73933.28,185438.81
510350,202212,671,352,319,426632.6,386630.97,813263.57
510360,202212,227,144,83,174530.67,100596.8,275127.47
510370,202212,178,75,103,90900,124836,215736
510380,202212,84,62,22,75144.52,26664,101808.52
510385,202212,61,31,30,37572.2,36360,73932.2
510390,202212,101,47,54,56964.8,65448.1,122412.9
510395,202212,58,42,16,50904.5,19392,70296.5
510410,202212,824,516,308,626624.51,374511.93,1001136.44
510420,202212,578,277,301,335728.06,364812,700540.06
510450,202212,52,28,24,33936,29088,63024
510452,202212,61,29,32,35148,38784,73932
510454,202212,55,25,30,31512.2,36360.03,67872.23
510455,202212,122,70,52,84840,63024.97,147864.97
510460,202212,196,83,113,100598.86,136956,237554.86
510480,202212,774,455,319,551471.5,389058.24,940529.74
510490,202212,348,164,184,198770.44,224220.5,422990.94
510500,202212,243,181,62,219373.13,75144,294517.13
510510,202212,889,520,369,631463.85,448445.6,1079909.45
510515,202212,1324,673,651,815688.13,789018.58,1604706.71
510517,202212,286,128,158,155138.69,191496.9,346635.59
510520,202212,235,145,90,175743.01,109080.37,284823.38
510523,202212,119,93,26,112716,31512,144228
510525,202212,922,567,355,689643.37,430264.32,1119907.69
510530,202212,26,15,11,18180,13332,31512
510550,202212,248,115,133,139382.44,161196.99,300579.43
510558,202212,331,164,167,200211.92,202404,402615.92
510560,202212,406,234,172,283611.88,208466.35,492078.23
510562,202212,690,489,201,592679.56,243613.35,836292.91
510590,202212,739,359,380,435116.86,461774.11,896890.97
510600,202212,223,117,106,141807.15,129684.21,271491.36
510610,202212,224,99,125,121202.47,151501.09,272703.56
510615,202212,230,110,120,133321.21,146652.56,279973.77
510617,202212,26,11,15,13332,18180,31512
510618,202212,130,64,66,77568,79994.02,157562.02
510619,202212,82,60,22,72720.23,26664,99384.23
510620,202212,167,88,79,106656,95748,202404
510621,202212,185,117,68,141804.5,82416.23,224220.73
510622,202212,522,276,246,334525.57,298155.92,632681.49
510623,202212,288,196,92,237555.12,111504.2,349059.32
510624,202212,93,46,47,55753.91,56964.53,112718.44
510625,202212,542,339,203,412090.51,246039.89,658130.40
510626,202212,114,67,47,81206.65,56964,138170.65
510627,202212,95,63,32,76357.83,38784.2,115142.03
510628,202212,175,104,71,126049.95,86052,212101.95
510629,202212,301,181,120,219373.37,145461.81,364835.18
510630,202212,468,240,228,290886.59,276336.5,567223.09
510631,202212,22,9,13,10908.13,15756,26664.13
510637,202212,370,217,153,263006.72,185436,448442.72
510642,202212,1213,648,565,785393.6,685999.93,1471393.53
510645,202212,12,2,10,2424,12120,14544
510650,202212,1315,849,466,1029028.54,564796.71,1593825.25
510665,202212,100,47,53,58176.39,64236.08,122412.47
510670,202212,59,34,25,41208.46,30300,71508.46
510675,202212,1132,722,410,875085.49,496924.23,1372009.72
510677,202212,346,182,164,220587.24,198769.54,419356.78
510680,202212,88,56,32,67874,38784,106658
510682,202212,193,94,99,113928.52,119988,233916.52
510685,202212,56,41,15,49692.2,18180,67872.2
510700,202212,605,340,265,413303.66,321180.72,734484.38
510704,202212,1306,659,647,799948.77,786600.01,1586548.78
510706,202212,163,83,80,100598.26,98173.7,198771.96
510710,202212,447,314,133,380573.83,161196.6,541770.43
510715,202212,57,39,18,47268,21816.12,69084.12
510718,202212,251,111,140,134533.95,169683.8,304217.75
510719,202212,49,21,28,25452,33936,59388
510720,202212,188,131,57,158772.59,69084,227856.59
510724,202212,83,30,53,36360,64236,100596
510726,202212,67,32,35,38784.7,42420,81204.7
510729,202212,17,7,10,8484,12120.1,20604.1
510730,202212,466,254,212,307849.77,256944,564793.77
510735,202212,119,46,73,55752.92,88476,144228.92
510740,202212,25,14,11,16970.38,13332.31,30302.69
510757,202212,28,23,5,27876.74,6060.16,33936.90
510760,202212,8006,4018,3988,4873566.37,4834711.87,9708278.24
510770,202212,750,340,410,412086.9,496922.64,909009.54
510774,202212,18,7,11,8484,13332,21816
510775,202212,121,92,29,111504,35148,146652
510776,202212,35,12,23,14544,29088.2,43632.2
510777,202212,188,83,105,100596,127260,227856
510779,202212,43,25,18,30300,21816,52116
510780,202212,272,140,132,169688.25,161196.2,330884.45
510785,202212,348,190,158,230283.88,191496.06,421779.94
510787,202212,210,102,108,124839.38,130896.94,255736.32
510788,202212,8,4,4,4848.2,4848,9696.2
510790,202212,2780,1438,1342,1742946.65,1626513.13,3369459.78
510792,202212,1165,647,518,784184.79,627829.28,1412014.07
510794,202212,117,64,53,77568.12,64236,141804.12
510795,202212,2407,1366,1041,1656834.54,1261700.79,2918535.33
510800,202212,198,112,86,135745.33,104232.14,239977.47
510805,202212,214,140,74,169680.4,89688,259368.4
510810,202212,109,44,65,53329.42,78780.42,132109.84
510820,202212,263,131,132,158774.27,159985.85,318760.12
510830,202212,83,41,42,49692,50904,100596
510835,202212,24,17,7,20604.2,8484,29088.2
510840,202212,9799,4412,5387,5351170.92,6533969.02,11885139.94
510850,202212,214,84,130,101809.61,157560,259369.61
510860,202212,418,207,211,250885.71,255732.42,506618.13
510880,202212,78,54,24,66660.2,29088,95748.2
510885,202212,72,42,30,50904.54,36360,87264.54
510890,202212,76,37,39,44844.86,47268.45,92113.31
510895,202212,180,105,75,127262.06,90900,218162.06
520005,202212,156,62,94,75146.63,113930.46,189077.09
520010,202212,319,138,181,167258.24,219377.59,386635.83
520013,202212,764,515,249,624192.27,301791.82,925984.09
520015,202212,41,27,14,32724,16968,49692
520017,202212,84,52,32,63024.15,38784,101808.15
520020,202212,12,5,7,6060,8484,14544
520025,202212,3041,1611,1430,1952613.11,1735638.96,3688252.07
520030,202212,898,462,436,562378.11,528435.89,1090814.00
520050,202212,64,48,16,58176,19392.1,77568.1
520055,202212,80,52,28,63024,33936.2,96960.2
520060,202212,177,115,62,139385.19,75145.65,214530.84
520080,202212,575,413,162,501769.76,198768,700537.76
520082,202212,17,12,5,14544,6060,20604
520085,202212,109,84,25,101809.38,30300.2,132109.58
520090,202212,85,61,24,73932.84,29088,103020.84
520110,202212,9738,4127,5611,5002035.92,6812713.85,11814749.77
520120,202212,14,8,6,9696,7272,16968
520130,202212,873,605,268,733272.95,324817.77,1058090.72
520140,202212,12679,6869,5810,8335180.8,7046652.27,15381833.07
520145,202212,57,31,26,37572.2,31512,69084.2
520150,202212,138,108,30,130900.47,36360,167260.47
520160,202212,41,25,16,30300,19392,49692
520170,202212,220,126,94,152719.62,113931.95,266651.57
520180,202212,203,93,110,112716.8,133320.63,246037.43
520215,202212,193,133,60,161197.05,72720.2,233917.25
520235,202212,85,64,21,77568.8,25452,103020.8
520250,202212,153,80,73,96962.03,88476,185438.03
520260,202212,118,72,46,87265.84,55752.99,143018.83
520280,202212,48,35,13,42420,15756,58176
520310,202212,23,12,11,14544.9,13332.2,27877.1
520320,202212,185,112,73,135745.92,88476.97,224222.89
520330,202212,881,486,395,589044.41,478743.95,1067788.36
520340,202212,307,180,127,218166.8,153926.41,372093.21
520350,202212,496,253,243,306641.02,294517.85,601158.87
520355,202212,105,61,44,73933.55,53328,127261.55
520357,202212,35,28,7,33936,8484,42420
520360,202212,16,5,11,6060.2,13332.28,19392.48
520380,202212,145,79,66,95748,79992,175740
520390,202212,241,108,133,130899.98,161196,292095.98
520393,202212,17,13,4,15756.1,4848,20604.1
520396,202212,78,56,22,67872,26664,94536
520400,202212,209,128,81,155141.75,98175.22,253316.97
520410,202212,193,97,96,118777.63,116352.2,235129.83
520420,202212,20,15,5,18180.46,6060,24240.46
520425,202212,255,125,130,151501.25,158772.89,310274.14
520430,202212,551,261,290,316333.68,351480.5,667814.18
520440,202212,664,473,191,573291.42,231492.93,804784.35
520450,202212,2278,954,1324,1156277.27,1607126.73,2763404.00
520455,202212,63,37,26,44846.44,31512.2,76358.64
520460,202212,46,29,17,35148.19,20604.75,55752.94
520465,202212,37,30,7,36360,8484,44844
520470,202212,464,289,175,350269.95,212100.2,562370.15
520480,202212,78,47,31,56965.34,37572,94537.34
520485,202212,113,43,70,52117.17,84840.1,136957.27
520490,202212,504,362,142,438752.38,173318.18,612070.56
520495,202212,166,98,68,118776.1,82416,201192.1
520500,202212,190,148,42,179378.15,50904,230282.15
520505,202212,199,117,82,141804.59,100596,242400.59
520510,202212,2092,978,1114,1185357.08,1350179.46,2535536.54
520520,202212,65,41,24,50904.69,29088,79992.69
520530,202212,209,166,43,201197.25,52116,253313.25
520540,202212,769,521,248,632672.15,300576.9,933249.05
520545,202212,149,83,66,100598.17,79992,180590.17
520547,202212,74,39,35,47269.81,42420.51,89690.32
520549,202212,1551,738,813,896912.99,986581.59,1883494.58
520551,202212,347,177,170,214528.01,207252.6,421780.61
520552,202212,43,30,13,36360.9,15756,52116.9
520570,202212,15,9,6,10908,7272,18180
520580,202212,281,173,108,209679.33,130896.16,340575.49
520590,202212,148,83,65,100598.68,78780,179378.68
520620,202212,1273,589,684,713880.96,830227.57,1544108.53
520630,202212,49,28,21,33936,25452,59388
520640,202212,391,228,163,276339.24,197556.39,473895.63
520650,202212,66,32,34,38784,41208,79992
520660,202212,42,22,20,26665.26,24240.38,50905.64
520670,202212,49,37,12,46056.74,14544,60600.74
520680,202212,26,16,10,19392,12120,31512
520690,202212,40,11,29,13332,35148,48480
520710,202212,37,30,7,36360,8484,44844
520725,202212,195,144,51,174531.23,61812,236343.23
520735,202212,57,37,20,44844.2,24240.2,69084.4
520740,202212,488,238,250,288460.75,303000,591460.75
520750,202212,39,25,14,30300,16968,47268
520753,202212,78,58,20,70296.2,24240,94536.2
520760,202212,103,69,34,83628.2,41208.1,124836.3
520780,202212,270,212,58,256948.16,70296.46,327244.62
520790,202212,150,92,58,111504.3,71508,183012.3
520800,202212,3555,1985,1570,2408310.79,1904080.79,4312391.58
520810,202212,139,107,32,129686.28,38784.89,168471.17
520815,202212,6,4,2,4848.96,2424,7272.96
520830,202212,136,92,44,111507.44,53328.05,164835.49
520840,202212,410,267,143,323605.03,173316,496921.03
520850,202212,113,63,50,76356.67,60600,136956.67
520860,202212,1881,1185,696,1438677.27,843558.52,2282235.79
520870,202212,34828,15721,19107,19067778.27,23172487.56,42240265.83
520880,202212,1325,694,631,841158.81,766001.27,1607160.08
520890,202212,864,543,321,658132.42,389053.15,1047185.57
520910,202212,1027,532,495,644805.3,599941.28,1244746.58
520915,202212,96,69,27,83630.83,32724,116354.83
520920,202212,503,236,267,286042.11,324823.61,610865.72
520929,202212,14,12,2,14544.34,2424,16968.34
520940,202212,66,47,19,56965.19,23028.1,79993.29
520945,202212,17,10,7,12120,8484,20604
520960,202212,46,27,19,32724,23028,55752
520970,202212,432,248,184,300579.53,224221.19,524800.72
520980,202212,90,65,25,78780,30300,109080
520990,202212,439,311,128,376934.62,155136.2,532070.82
520993,202212,126,62,64,76359.55,77568.3,153927.85
520995,202212,266,144,122,174529.71,147864,322393.71
521000,202212,1659,906,753,1098091.91,913856.26,2011948.17
521010,202212,652,347,305,421781.85,369662.69,791444.54
521015,202212,12,7,5,8484,6060,14544
521020,202212,1459,1028,431,1245959.37,523591.76,1769551.13
521030,202212,71,48,23,59388.53,27876,87264.53
521040,202212,1014,673,341,815697.39,414505.16,1230202.55
521056,202212,58,38,20,46056,24240,70296
521060,202212,124,80,44,96960.4,53328.76,150289.16
521080,202212,331,260,71,315134.03,86052.5,401186.53
521090,202212,593,398,195,482380.46,236340.89,718721.35
521100,202212,266,191,75,231494.89,90900.4,322395.29
521120,202212,1103,776,327,944175.92,397538.67,1341714.59
521130,202212,330,234,96,283614.64,117564.6,401179.24
521140,202212,196,109,87,132110.99,105444.69,237555.68
521150,202212,2666,1138,1528,1380510.66,1851965.24,3232475.90
521160,202212,26,10,16,12120,19392,31512
521170,202212,236,127,109,153925.01,132108.2,286033.21
521180,202212,1231,775,456,939320.77,557528.09,1496848.86
521190,202212,2675,1107,1568,1342929.46,1901644.45,3244573.91
521200,202212,60,42,18,50904.2,21816,72720.2
521205,202212,13,10,3,12120.2,3636,15756.2
521210,202212,131,78,53,94537.88,64236,158773.88
521220,202212,770,527,243,638731.45,294519.55,933251.00
521225,202212,23,16,7,19393.56,8484.93,27878.49
521230,202212,105,67,38,81204.57,46057.39,127261.96
521250,202212,6673,3635,3038,4410623.48,3685749.94,8096373.42
521260,202212,43,19,24,23028,29088.6,52116.6
521270,202212,126,95,31,116352,37572,153924
521280,202212,432,270,162,327242.43,196344,523586.43
521290,202212,28,17,11,20604.72,13332,33936.72
521295,202212,105,71,34,86053.05,41208,127261.05
521300,202212,244,134,110,162409.19,133320.11,295729.30
521305,202212,44,31,13,37572.59,15756,53328.59
521308,202212,1039,793,246,962351.74,298154.95,1260506.69
521310,202212,1437,795,642,965991.88,779327.69,1745319.57
521340,202212,19,15,4,18180,4848,23028
521350,202212,112,83,29,100596.6,35148,135744.6
521370,202212,169,111,58,134532.2,70296,204828.2
521375,202212,202,97,105,117566.55,127260.88,244827.43
521377,202212,49,37,12,44844.1,14544.1,59388.2
521380,202212,1120,662,458,803587.01,556314.04,1359901.05
521385,202212,12,7,5,8484,6060,14544
521390,202212,107,84,23,101808.9,27876,129684.9
521400,202212,401,284,117,344218.8,141805,486023.8
521405,202212,159,96,63,116353.31,76356.66,192709.97
521410,202212,82,60,22,72720.87,26664,99384.87
521440,202212,222,149,73,180592.61,88476.8,269069.41
521450,202212,808,444,364,538137.39,441169.86,979307.25
521460,202212,1124,769,355,934485.2,431475.9,1365961.1
521470,202212,13,9,4,10908,4848,15756
521480,202212,41,28,13,33936.37,15756.6,49692.97
521483,202212,331,213,118,258159.06,143016.56,401175.62
521486,202212,304,201,103,243613.03,124836.84,368449.87
521487,202212,22,11,11,13332,13332,26664
521490,202212,25,15,10,18180,12120,30300
521500,202212,149,63,86,76356.95,104232.29,180589.24
521520,202212,44,33,11,39996,13332,53328
521523,202212,1134,613,521,742967.73,631455,1374422.73
521525,202212,60,42,18,50904,21816,72720
521530,202212,249,143,106,173316.39,128472.89,301789.28
521540,202212,47,22,25,26664,30300,56964
521550,202212,115,52,63,63024.33,76357.89,139382.22
521560,202212,930,610,320,739337.49,390268.1,1129605.59
521565,202212,73,51,22,61813.16,26664,88477.16
521570,202212,581,368,213,446022.46,258157.47,704179.93
521580,202212,51,32,19,38784,23028,61812
521590,202212,38,18,20,21816,24240,46056
521600,202212,27,12,15,14544,18180,32724
521630,202212,226,115,111,139386.52,134537.55,273924.07
521640,202212,322,170,152,206042.76,184224.7,390267.46
521645,202212,40,21,19,25452,23028,48480
521680,202212,257,156,101,189073,123624.4,312697.4
521690,202212,16,14,2,16968,2424,19392
521710,202212,1165,546,619,662973.71,751442.82,1414416.53
521720,202212,627,408,219,494500.12,265429.97,759930.09
521730,202212,719,338,381,409664.3,462986.85,872651.15
521740,202212,930,423,507,512680.48,614487.64,1127168.12
521760,202212,2467,1263,1204,1532109.53,1461704.44,2993813.97
521770,202212,855,521,334,632671.84,404809.89,1037481.73
521800,202212,2054,1377,677,1670161.21,821738.12,2491899.33
521805,202212,36,22,14,26664,16968,43632
521810,202212,94,53,41,64236.8,49692.2,113929.0
521830,202212,1033,748,285,907814.3,345427.56,1253241.86
521839,202212,72,41,31,49692,37572,87264
521850,202212,1201,596,605,722371.72,735694.8,1458066.52
521860,202212,338,209,129,253312.92,156348,409660.92
521870,202212,87,55,32,66660,38784,105444
521878,202212,35,14,21,16968,25452.98,42420.98
521880,202212,5235,2279,2956,2763441.56,3587554.69,6350996.25
521890,202212,643,439,204,533287.29,247250.1,780537.39
521900,202212,278,218,60,264217.5,72720.2,336937.7
521910,202212,182,127,55,153931.33,66660.98,220592.31
521920,202212,38,22,16,26664,19392,46056
521925,202212,55,30,25,36360,30300,66660
521930,202212,1285,706,579,856904.22,701757.09,1558661.31
521935,202212,34,24,10,29089.27,12120,41209.27
521940,202212,245,108,137,130897.78,166045.25,296943.03
521945,202212,21,13,8,15756,9696,25452
521950,202212,21,14,7,16968,8484,25452
521960,202212,70,55,15,66660,18180,84840
521970,202212,421,272,149,329667.09,180588.89,510255.98
521971,202212,112,57,55,69084.72,66660,135744.72
521973,202212,39,16,23,19392.6,27876,47268.6
521975,202212,1684,872,812,1056895.37,984161.68,2041057.05
521980,202212,242,164,78,198769.35,94536,293305.35
521990,202212,86,59,27,71508.91,32724,104232.91
522000,202212,296,196,100,237133.6,121200.79,358334.39
522005,202212,20,11,9,13332.2,10908,24240.2
522010,202212,1180,660,520,799948.2,630247.19,1430195.39
522015,202212,56,34,22,41208,26664,67872
522020,202212,916,545,371,661760.04,450867.96,1112628.00
522026,202212,25,16,9,19392,10908,30300
522028,202212,22,19,3,23028,3636,26664
522040,202212,855,373,482,454513.69,584190.09,1038703.78
522045,202212,2862,1672,1190,2026525.23,1443507.45,3470032.68
522050,202212,163,72,91,87268.21,110292.72,197560.93
522060,202212,559,349,210,422993.46,255733.34,678726.80
522068,202212,112,80,32,96960.17,38784,135744.17
522070,202212,18,15,3,18180,3636,21816
522100,202212,40,26,14,31512,16968,48480
522108,202212,44,34,10,41209.02,12120,53329.02
522119,202212,63,36,27,43632.98,32724,76356.98
522130,202212,79,29,50,35149.09,60600.59,95749.68
522140,202212,4439,2320,2119,2814350.54,2570669.46,5385020.00
522145,202212,51,35,16,42420,19392,61812
522150,202212,106,72,34,87264.16,41208.84,128473.00
522155,202212,55,36,19,43632.2,23028,66660.2
522157,202212,15,8,7,9696,8484,18180
522160,202212,1727,1030,697,1248389.86,844770.74,2093160.60
522170,202212,425,294,131,356330.85,158773.34,515104.19
522180,202212,32,13,19,15756,23028,38784
522185,202212,2668,1140,1528,1382943.78,1851980.84,3234924.62
522190,202212,76,44,32,53328.67,38784,92112.67
522200,202212,334,196,138,237553.89,167257.93,404811.82
522205,202212,147,100,47,121202.5,56964.1,178166.6
522220,202212,144,111,33,134532,41208,175740
522230,202212,29,26,3,31512.41,3636,35148.41
530010,202212,58845,29781,29064,36125057.14,35254183.05,71379240.19
