ibge,anomes,bpc_ben,bpc_pcd_ben,bpc_idoso_ben,bpc_pcd_val,bpc_idoso_val,bpc_val
110001,202101,504,402,102,442200,112200,554400
110002,202101,2828,1762,1066,1941756.66,1173700,3115456.66
110003,202101,81,68,13,74800,14300,89100
110004,202101,2026,1332,694,1466300,765600,2231900
110005,202101,437,349,88,383900,96800,480700
110006,202101,441,335,106,370700,116600,487300
110007,202101,70,58,12,63800,13200,77000
110008,202101,241,133,108,146300,121000,267300
110009,202101,902,660,242,726000,266200,992200
110010,202101,1688,1028,660,1130800,726000,1856800
110011,202101,1749,1357,392,1492700,431200,1923900
110012,202101,4092,2370,1722,2607000,1896400,4503400
110013,202101,767,610,157,671000,172700,843700
110014,202101,371,323,48,356216.66,52800,409016.66
110015,202101,1380,1108,272,1219900,299200,1519100
110018,202101,1087,676,411,743600,452100,1195700
110020,202101,15534,8876,6658,9766900.75,7326000,17092900.75
110025,202101,652,477,175,524700,192500,717200
110026,202101,37,27,10,29700,11000,40700
110028,202101,1625,1167,458,1288100,504203.33,1792303.33
110029,202101,136,122,14,134200,15400,149600
110030,202101,2404,1606,798,1767524.18,878900.85,2646425.03
110032,202101,319,249,70,273900,77000,350900
110033,202101,663,481,182,529100,201300,730400
110034,202101,333,245,88,269500.5,96800,366300.5
110037,202101,99,86,13,94600,14300,108900
110040,202101,371,250,121,275000,133100,408100
110045,202101,933,640,293,706163.33,323400,1029563.33
110050,202101,91,79,12,86900,13200,100100
110060,202101,66,39,27,42900,29700,72600
110070,202101,105,69,36,75900,39600,115500
110080,202101,487,273,214,300300,235400,535700
110090,202101,26,22,4,24200,4400,28600
110092,202101,103,56,47,61600,51700,113300
110094,202101,196,141,55,155100,60500,215600
110100,202101,39,27,12,29700,13200,42900
110110,202101,96,53,43,58300,47300,105600
110120,202101,68,59,9,64900,9900,74800
110130,202101,284,232,52,256300,57200,313500
110140,202101,239,168,71,184800,78100,262900
110143,202101,47,38,9,41800,9900,51700
110145,202101,29,21,8,23100,8800,31900
110146,202101,22,12,10,13200,11000,24200
110147,202101,38,26,12,28600,13200,41800
110148,202101,34,24,10,26400,11000,37400
110149,202101,312,221,91,243100,100100,343200
110150,202101,131,101,30,111100,33000,144100
110155,202101,9,9,0,9900,0,9900
110160,202101,67,54,13,59400,14300,73700
110170,202101,218,166,52,182600,57200,239800
110175,202101,66,50,16,55000,17600,72600
110180,202101,86,72,14,79200,15400,94600
120001,202101,190,140,50,154000,55000,209000
120005,202101,196,114,82,125400.41,90200,215600.41
120010,202101,1098,681,417,749100,459800,1208900
120013,202101,140,95,45,104500.88,49500,154000.88
120017,202101,109,60,49,66000,53900,119900
120020,202101,3524,2845,679,3129501.2,746900,3876401.2
120025,202101,536,303,233,333300.4,256300,589600.4
120030,202101,1056,910,146,1001000.7,160600,1161600.7
120032,202101,35,31,4,34100,4400,38500
120033,202101,212,188,24,206800,26400,233200
120034,202101,168,123,45,135300,49500,184800
120035,202101,38,31,7,34100,7700,41800
120038,202101,415,274,141,301400,155100,456500
120039,202101,29,28,1,30800,1100,31900
120040,202101,13906,9492,4414,10443765.73,4857600,15301365.73
120042,202101,44,38,6,41800,6600,48400
120043,202101,11,3,8,3300,8800,12100
120045,202101,532,340,192,374000,211200,585200
120050,202101,1275,973,302,1070301,332200,1402501
120060,202101,1462,1200,262,1322200,288200,1610400
120070,202101,419,304,115,334400.6,126500,460900.6
120080,202101,175,109,66,119900,72600,192500
130002,202101,162,116,46,127600,50600,178200
130006,202101,101,63,38,69300,41800,111100
130008,202101,131,71,60,78100,66000,144100
130010,202101,150,83,67,91300,73700,165000
130014,202101,274,197,77,216700,84700,301400
130020,202101,98,59,39,64900,42900,107800
130030,202101,979,573,406,630300,446600,1076900
130040,202101,337,166,171,182600,188100,370700
130050,202101,566,293,273,322300,300300,622600
130060,202101,843,574,269,631400,295900,927300
130063,202101,594,337,257,370700,282700,653400
130068,202101,183,113,70,124300,77000,201300
130070,202101,1299,884,415,972400.6,456500,1428900.6
130080,202101,723,480,243,528000,267300,795300
130083,202101,71,38,33,41800,36300,78100
130090,202101,322,166,156,182600,172700,355300
130100,202101,1105,467,638,513700,701800,1215500
130110,202101,737,312,425,343200,467500,810700
130115,202101,160,70,90,77000,99000,176000
130120,202101,1622,1018,604,1119800,667700,1787500
130130,202101,612,418,194,459800,213400,673200
130140,202101,1566,1230,336,1353000,369600,1722600
130150,202101,413,365,48,401500,52800,454300
130160,202101,449,256,193,281600,212300,493900
130165,202101,39,30,9,33000,9900,42900
130170,202101,1012,705,307,775429.6,337700.9,1113130.5
130180,202101,233,174,59,191400,64900,256300
130185,202101,2283,1050,1233,1156100,1358500,2514600
130190,202101,3399,2132,1267,2347400,1395900,3743300
130195,202101,275,218,57,239800,62700,302500
130200,202101,176,80,96,89100,105600,194700
130210,202101,74,36,38,39600,41800,81400
130220,202101,173,117,56,128700,61600,190300
130230,202101,382,248,134,272800,147400,420200
130240,202101,1300,826,474,908600,522500,1431100
130250,202101,4705,3001,1704,3302200,1875500,5177700
130255,202101,428,206,222,226600,245300,471900
130260,202101,57186,26898,30288,29616311.41,33392931.72,63009243.13
130270,202101,1558,1056,502,1161699,552200,1713899
130280,202101,118,65,53,71500,58300,129800
130290,202101,2087,1430,657,1573000,722700,2295700
130300,202101,428,299,129,328900,141900,470800
130310,202101,937,497,440,546700,484000,1030700
130320,202101,522,275,247,302500,271700,574200
130330,202101,779,487,292,535700,321200,856900
130340,202101,3471,1974,1497,2171400,1647800,3819200
130350,202101,479,320,159,352000,174900,526900
130353,202101,934,403,531,443300,584100,1027400
130356,202101,814,363,451,399300,498300,897600
130360,202101,89,66,23,72600,25300,97900
130370,202101,701,537,164,590700,180400,771100
130380,202101,673,516,157,568700,172700,741400
130390,202101,476,383,93,421300,102300,523600
130395,202101,159,38,121,41800,133100,174900
130400,202101,67,45,22,49500,24200,73700
130406,202101,2066,1231,835,1356300,918500,2274800
130410,202101,434,208,226,228800,248600,477400
130420,202101,2914,2360,554,2596000,609400,3205400
130423,202101,156,79,77,86900,84700,171600
130426,202101,154,76,78,83600,85800,169400
130430,202101,421,257,164,282700,180400,463100
130440,202101,196,58,138,63800,152900,216700
140002,202101,15,4,11,4400,12100,16500
140005,202101,196,118,78,129800,85800,215600
140010,202101,10867,6819,4048,7508602.67,4453900,11962502.67
140015,202101,132,60,72,66000,79200,145200
140017,202101,122,74,48,81400,53900,135300
140020,202101,465,301,164,331100,181500,512600
140023,202101,34,18,16,19800,17600,37400
140028,202101,23,12,11,13200,12100,25300
140030,202101,350,242,108,266200,118800,385000
140040,202101,62,43,19,47300,20900,68200
140045,202101,271,104,167,114400,183700,298100
140047,202101,399,269,130,297000,143000,440000
140050,202101,139,84,55,92400,60500,152900
140060,202101,56,38,18,41800,19800,61600
140070,202101,31,28,3,30800,3300,34100
150010,202101,4702,2845,1857,3129500,2042700,5172200
150013,202101,160,112,48,123200,52800,176000
150020,202101,1091,585,506,644600,556600,1201200
150030,202101,702,311,391,342100,430100,772200
150034,202101,204,125,79,137500,86900,224400
150040,202101,1478,838,640,922900,707300,1630200
150050,202101,685,384,301,423500,331100,754600
150060,202101,4887,3088,1799,3400007.29,1980455.4,5380462.69
150070,202101,399,198,201,218900,221100,440000
150080,202101,15337,7234,8103,7960700,8913300.05,16874000.05
150085,202101,431,268,163,294800,179300,474100
150090,202101,708,595,113,654500,124300,778800
150095,202101,365,229,136,253000,149600,402600
150100,202101,61,38,23,41800,25300,67100
150110,202101,201,105,96,115500,105600,221100
150120,202101,403,290,113,319000,124300,443300
150125,202101,49,17,32,18700,35200,53900
150130,202101,2042,1065,977,1171500,1074700,2246200
150140,202101,55352,24787,30565,27277800.67,33638000.7,60915801.37
150145,202101,214,115,99,127600,110000,237600
150150,202101,2986,1289,1697,1417900,1866700,3284600
150157,202101,380,266,114,292600,125400,418000
150160,202101,127,98,29,107800,31900,139700
150170,202101,3629,2692,937,2963400,1030700,3994100
150172,202101,337,235,102,258500,112200,370700
150175,202101,79,48,31,52800,34100,86900
150178,202101,758,499,259,548900,284900,833800
150180,202101,3174,1540,1634,1694000,1797400,3491400
150190,202101,345,215,130,236500,143000,379500
150195,202101,111,57,54,62700,59400,122100
150200,202101,196,92,104,101200,114400,215600
150210,202101,3143,2517,626,2768700,689700,3458400
150215,202101,564,356,208,391600,228800,620400
150220,202101,3602,2392,1210,2632300.82,1332100,3964400.82
150230,202101,1190,950,240,1046100.5,264000,1310100.5
150240,202101,6394,3606,2788,3967700.6,3067900,7035600.6
150250,202101,58,30,28,33000,30800,63800
150260,202101,91,60,31,66000,34100,100100
150270,202101,2203,1422,781,1564200,859100,2423300
150275,202101,526,331,195,364100,214500,578600
150276,202101,111,42,69,46200,75900,122100
150277,202101,784,341,443,375100,487300,862400
150280,202101,365,241,124,265100.42,136400,401500.42
150285,202101,107,54,53,59400,58124,117524
150290,202101,1141,668,473,734800,520300,1255100
150293,202101,700,326,374,358600,411400,770000
150295,202101,510,232,278,255200,305800,561000
150300,202101,82,38,44,41800,48400,90200
150304,202101,174,102,72,112200,79200,191400
150307,202101,398,329,69,361900,75900,437800
150309,202101,566,404,162,445500,178200,623700
150310,202101,243,157,86,172700,94600,267300
150320,202101,1889,1313,576,1445400,633600,2079000
150330,202101,2026,1159,867,1274900,953700,2228600
150340,202101,197,130,67,143000,74800,217800
150345,202101,622,342,280,376200,308000,684200
150350,202101,407,316,91,347600,100100,447700
150360,202101,4651,2857,1794,3143800,1973400,5117200
150370,202101,827,564,263,620400,289300,909700
150375,202101,199,89,110,97900,121000,218900
150380,202101,1496,987,509,1086800,561000,1647800
150390,202101,802,466,336,512600,369600,882200
150400,202101,108,89,19,97900,20900,118800
150405,202101,1222,774,448,852500,492800,1345300
150410,202101,119,75,44,82500,48400,130900
150420,202101,7374,3966,3408,4370480,3748800,8119280
150430,202101,610,386,224,424600,246400,671000
150440,202101,435,276,159,303600,174900,478500
150442,202101,2329,1238,1091,1362900,1202300,2565200
150445,202101,545,353,192,388300,211200,599500
150450,202101,221,116,105,127600,115500,243100
150460,202101,735,544,191,598400,210100,808500
150470,202101,1293,771,522,848100,574200,1422300
150475,202101,231,175,56,193600,61600,255200
150480,202101,1301,904,397,994400,436700,1431100
150490,202101,665,394,271,433400,298100,731500
150495,202101,332,245,87,269500,95700,365200
150497,202101,270,187,83,205700,91300,297000
150500,202101,224,135,89,148500,97900,246400
150503,202101,1049,520,529,572000,581900,1153900
150506,202101,923,612,311,673200,342100,1015300
150510,202101,1262,687,575,755700.46,632500,1388200.46
150520,202101,292,193,99,212300,108900,321200
150530,202101,1719,934,785,1027400,863500,1890900
150540,202101,227,164,63,180400,69300,249700
150543,202101,830,422,408,464200,448800,913000
150548,202101,462,326,136,358600,149600,508200
150549,202101,59,42,17,46200,18700,64900
150550,202101,2925,1460,1465,1606000,1613700,3219700
150553,202101,3345,1879,1466,2070200,1614800,3685000
150555,202101,148,79,69,86900,75900,162800
150560,202101,35,14,21,15400,23100,38500
150563,202101,118,52,66,57200,72600,129800
150565,202101,191,117,74,128700,81400,210100
150570,202101,424,279,145,306900,159500,466400
150580,202101,1680,806,874,886600,961400,1848000
150590,202101,809,536,273,589600,300300,889900
150600,202101,479,284,195,312400,214500,526900
150610,202101,147,119,28,132000,30800,162800
150611,202101,123,80,43,88000,47300,135300
150613,202101,3223,1898,1325,2087800,1457500,3545300
150616,202101,535,300,235,330000,258500,588500
150618,202101,1345,704,641,774400,705100,1479500
150619,202101,395,298,97,327800,106700,434500
150620,202101,1259,727,532,799700,586300,1386000
150630,202101,322,209,113,229900,124300,354200
150635,202101,454,185,269,203500,297000,500500
150640,202101,47,24,23,26400,25300,51700
150650,202101,2389,1381,1008,1521300,1111000,2632300
150655,202101,237,175,62,192500,68200,260700
150658,202101,86,50,36,55000,39600,94600
150660,202101,543,353,190,388300,209000,597300
150670,202101,1080,373,707,410300,777700,1188000
150680,202101,10182,5298,4884,5833300.57,5376800,11210100.57
150690,202101,20,10,10,11000,11000,22000
150700,202101,480,314,166,345400,183700,529100
150710,202101,287,156,131,171600,144100,315700
150715,202101,826,513,313,564300,345400,909700
150720,202101,417,318,99,349800,110000,459800
150730,202101,1033,513,520,564300,573100,1137400
150740,202101,229,149,80,163900,88000,251900
150745,202101,746,412,334,453200,368500,821700
150746,202101,64,36,28,39600,30800,70400
150747,202101,224,170,54,187000,59400,246400
150750,202101,137,76,61,83600,67100,150700
150760,202101,1814,1174,640,1291400.5,704000,1995400.5
150770,202101,386,212,174,233200,191400,424600
150775,202101,105,49,56,53900,61600,115500
150780,202101,199,111,88,122100,97900,220000
150790,202101,873,491,382,540100,420200,960300
150795,202101,1540,915,625,1006500,687500,1694000
150796,202101,353,199,154,218900,169400,388300
150797,202101,338,161,177,177100,194700,371800
150800,202101,1502,849,653,933900,718300,1652200
150803,202101,531,428,103,470800,113300,584100
150805,202101,206,120,86,132000,94600,226600
150808,202101,993,531,462,584100,508200,1092300
150810,202101,3241,2194,1047,2413400.5,1151700,3565100.5
150812,202101,449,223,226,245300,249700,495000
150815,202101,1065,660,405,726000,445500,1171500
150820,202101,1541,915,626,1006500,689700,1696200
150830,202101,729,527,202,579700,222200,801900
150835,202101,209,123,86,135300,94600,229900
150840,202101,1367,829,538,911900,591800,1503700
160005,202101,64,45,19,49500,20900,70400
160010,202101,189,120,69,132000,77000,209000
160015,202101,132,82,50,90200,55000,145200
160020,202101,133,73,60,80300,66000,146300
160021,202101,60,26,34,28600,37400,66000
160023,202101,67,43,24,47300,26400,73700
160025,202101,23,10,13,11000,14300,25300
160027,202101,1476,834,642,918500,706200,1624700
160030,202101,15957,8160,7797,8978200.61,8584400,17562600.61
160040,202101,298,170,128,187000,140800,327800
160050,202101,721,361,360,397100,396000,793100
160053,202101,283,170,113,187000,124300,311300
160055,202101,24,15,9,16500,9900,26400
160060,202101,6532,3436,3096,3780700.23,3406700,7187400.23
160070,202101,178,100,78,110000,85800,195800
160080,202101,114,56,58,62700,63800,126500
170025,202101,28,15,13,16500,14300,30800
170030,202101,196,160,36,176000.03,39600,215600.03
170035,202101,219,102,117,113300,128700,242000
170040,202101,176,132,44,145200,48400,193600
170070,202101,323,197,126,217800,139700,357500
170100,202101,349,254,95,279400,105600,385000
170105,202101,56,45,11,49500,12100,61600
170110,202101,112,66,46,72600,50600,123200
170130,202101,71,34,37,37400,40700,78100
170190,202101,98,58,40,63800,44000,107800
170200,202101,369,253,116,278300,127600,405900
170210,202101,6136,3207,2929,3527434.25,3226300,6753734.25
170215,202101,115,49,66,53900,72600,126500
170220,202101,1377,1005,372,1105500,409200,1514700
170230,202101,146,96,50,105600,55000,160600
170240,202101,512,342,170,376200,187000,563200
170255,202101,1074,871,203,958100,223300,1181400
170270,202101,44,31,13,34100,14300,48400
170290,202101,113,75,38,82500,41800,124300
170300,202101,98,61,37,67100,40700,107800
170305,202101,47,36,11,39600,12100,51700
170307,202101,61,47,14,51700,15400,67100
170310,202101,114,63,51,69300,56100,125400
170320,202101,26,16,10,17600,11000,28600
170330,202101,25,22,3,24200,3300,27500
170360,202101,32,18,14,19800,15400,35200
170370,202101,102,51,51,56100,56100,112200
170380,202101,70,53,17,58300,18700,77000
170382,202101,43,36,7,39600,7700,47300
170384,202101,141,110,31,121000,34100,155100
170386,202101,64,22,42,24200,46200,70400
170388,202101,48,19,29,20900,31900,52800
170389,202101,26,21,5,23100,5500,28600
170390,202101,73,40,33,44000,36300,80300
170410,202101,26,22,4,24200,4400,28600
170460,202101,17,11,6,12100,6600,18700
170510,202101,37,29,8,31900,8800,40700
170550,202101,1541,896,645,985600,710600,1696200
170555,202101,111,81,30,89100,33000,122100
170560,202101,104,73,31,80300,34100,114400
170600,202101,42,16,26,17600,28600,46200
170610,202101,195,99,96,108900,105600,214500
170625,202101,37,21,16,23100,17600,40700
170650,202101,80,58,22,63800,24200,88000
170700,202101,583,432,151,475200,166100,641300
170710,202101,154,94,60,103400,66000,169400
170720,202101,88,70,18,77000,19800,96800
170730,202101,84,50,34,55000,37400,92400
170740,202101,83,57,26,62700,28600,91300
170755,202101,59,32,27,35200,29700,64900
170765,202101,142,75,67,82500,73700,156200
170770,202101,204,127,77,140800,84700,225500
170820,202101,612,403,209,444106.66,229900,674006.66
170825,202101,36,18,18,19800,19800,39600
170830,202101,85,67,18,73700,19800,93500
170900,202101,176,134,42,147400,46200,193600
170930,202101,913,484,429,533500,471900,1005400
170950,202101,3129,1427,1702,1569700,1873300.4,3443000.4
170980,202101,16,10,6,11000,6600,17600
171050,202101,147,114,33,125400,36300,161700
171070,202101,42,34,8,37400,8800,46200
171090,202101,48,35,13,38500,14300,52800
171110,202101,22,16,6,17600,6600,24200
171150,202101,40,21,19,23100,20900,44000
171180,202101,28,14,14,15400,15400,30800
171190,202101,155,90,65,99000,71500,170500
171195,202101,62,52,10,57200,11000,68200
171200,202101,50,24,26,26400,28600,55000
171215,202101,4,3,1,3300,1100,4400
171240,202101,61,42,19,46200,20900,67100
171245,202101,58,49,9,53900,9900,63800
171250,202101,76,43,33,47300,36300,83600
171270,202101,14,10,4,11000,4400,15400
171280,202101,37,32,5,35200,5500,40700
171320,202101,999,572,427,629200,470800,1100000
171330,202101,430,213,217,234300,238700,473000
171360,202101,89,62,27,68200,29700,97900
171370,202101,33,16,17,17600,18700,36300
171380,202101,128,110,18,121000,19800,140800
171395,202101,50,32,18,35200,19800,55000
171420,202101,272,176,96,193600,105600,299200
171430,202101,72,57,15,62700,16500,79200
171488,202101,181,98,83,107800,91300,199100
171500,202101,59,34,25,37400,27500,64900
171510,202101,70,45,25,49500,27500,77000
171515,202101,42,33,9,36300,9900,46200
171525,202101,29,27,2,29700,2200,31900
171550,202101,15,9,6,9900,6600,16500
171570,202101,51,26,25,28600,27500,56100
171575,202101,303,198,105,217800,115500,333300
171610,202101,1743,886,857,975700,943800,1919500
171620,202101,138,94,44,103400,48400,151800
171630,202101,54,29,25,31900,29700,61600
171650,202101,313,219,94,240900,103400,344300
171660,202101,268,151,117,166100,128700,294800
171665,202101,64,42,22,46200,24200,70400
171670,202101,428,259,169,284900,185900,470800
171700,202101,63,56,7,61600,7700,69300
171720,202101,28,10,18,11000,19800,30800
171750,202101,103,53,50,58300,55000,113300
171780,202101,71,56,15,61600,16500,78100
171790,202101,82,68,14,74800,15400,90200
171800,202101,32,23,9,25300,9900,35200
171820,202101,2096,1190,906,1310100.7,997700,2307800.7
171830,202101,34,27,7,29700,7700,37400
171840,202101,65,42,23,46200,25300,71500
171845,202101,29,18,11,19800,12100,31900
171850,202101,39,31,8,34100,8800,42900
171855,202101,76,58,18,63800,19800,83600
171865,202101,7,6,1,6600,1100,7700
171870,202101,33,22,11,24200,12100,36300
171875,202101,79,56,23,61600,25300,86900
171880,202101,36,23,13,25300,14300,39600
171884,202101,50,27,23,29700,25300,55000
171886,202101,133,55,78,60500,85800,146300
171888,202101,29,23,6,25300,6600,31900
171889,202101,13,8,5,8800,5500,14300
171890,202101,54,46,8,50600,8800,59400
171900,202101,35,25,10,27500,11000,38500
172000,202101,39,30,9,33000,9900,42900
172010,202101,52,43,9,47300,9900,57200
172015,202101,24,16,8,17600,8800,26400
172020,202101,141,88,53,96800,58300,155100
172025,202101,39,26,13,28600,14300,42900
172030,202101,42,23,19,25300,20900,46200
172049,202101,83,54,29,59400,31900,91300
172065,202101,133,87,46,95700,50600,146300
172080,202101,103,67,36,73700,39600,113300
172085,202101,29,14,15,15400,16500,31900
172090,202101,426,323,103,355300.56,113300,468600.56
172093,202101,15,13,2,14300,2200,16500
172097,202101,18,11,7,12100,7700,19800
172100,202101,5119,2881,2238,3170200,2464000,5634200
172110,202101,76,48,28,52800,30800,83600
172120,202101,1638,1374,264,1511400,290400,1801800
172125,202101,10,9,1,9900,1100,11000
172130,202101,24,14,10,15400,11000,26400
172208,202101,203,121,82,133100,90200,223300
172210,202101,373,179,194,196900,214500,411400
210005,202101,2969,1861,1108,2047100.32,1221000,3268100.32
210010,202101,155,88,67,96800,73700,170500
210015,202101,40,29,11,31900,12100,44000
210020,202101,366,205,161,225500,177100,402600
210030,202101,329,216,113,237600,124300,361900
210040,202101,139,110,29,121000,31900,152900
210043,202101,251,188,63,206800,69300,276100
210047,202101,529,321,208,353100,228800,581900
210050,202101,285,210,75,231000,82500,313500
210055,202101,49,39,10,42900,11000,53900
210060,202101,530,421,109,463100,119900,583000
210070,202101,417,319,98,350900,107800,458700
210080,202101,128,115,13,126500,14300,140800
210083,202101,291,141,150,155100,165000,320100
210087,202101,2,1,1,1100,1100,2200
210090,202101,443,318,125,349800,137500,487300
210095,202101,428,326,102,358600,112200,470800
210100,202101,706,550,156,605000,171600,776600
210110,202101,122,78,44,85800,48400,134200
210120,202101,4981,3903,1078,4293300,1185800.5,5479100.5
210125,202101,187,116,71,127600,78100,205700
210130,202101,469,271,198,298100,217800,515900
210135,202101,25,18,7,19800,7700,27500
210140,202101,4379,3404,975,3746600.12,1072500,4819100.12
210150,202101,377,237,140,260700,154000,414700
210160,202101,3273,2780,493,3059100.54,542300,3601400.54
210170,202101,1152,920,232,1012000,256300,1268300
210173,202101,124,108,16,118800,17600,136400
210177,202101,355,200,155,220000,170500,390500
210180,202101,30,16,14,17600,15400,33000
210190,202101,435,286,149,314600,163900,478500
210193,202101,3,2,1,2200,1100,3300
210197,202101,74,54,20,59400,22000,81400
210200,202101,610,512,98,563200,107800,671000
210203,202101,221,150,71,165000,78100,243100
210207,202101,362,298,64,327800,70400,398200
210210,202101,743,687,56,755700,61600,817300
210215,202101,73,66,7,72600,7700,80300
210220,202101,385,325,60,357500,66000,423500
210230,202101,315,251,64,276100,70400,346500
210232,202101,1379,938,441,1031800,485100,1516900
210235,202101,174,131,43,144100,47300,191400
210237,202101,36,21,15,23100,16500,39600
210240,202101,96,76,20,83600,22000,105600
210250,202101,181,153,28,168300,30800,199100
210255,202101,352,264,88,291500,96800,388300
210260,202101,397,272,125,299200,137500,436700
210270,202101,649,434,215,477400,236500,713900
210275,202101,76,59,17,64900,18700,83600
210280,202101,1049,694,355,763400,390500,1153900
210290,202101,537,359,178,394900.18,195800,590700.18
210300,202101,5286,3336,1950,3670701.54,2145000,5815701.54
210310,202101,109,76,33,83600,36300,119900
210312,202101,115,81,34,89100,37400,126500
210315,202101,107,88,19,96800,20900,117700
210317,202101,135,100,35,110000,38500,148500
210320,202101,2306,1967,339,2163700,372900,2536600
210325,202101,138,86,52,94600,57200,151800
210330,202101,4573,2630,1943,2893000,2139500,5032500
210340,202101,1234,925,309,1017500,339900,1357400
210350,202101,638,533,105,586300,115500,701800
210355,202101,146,122,24,134200,26400,160600
210360,202101,2225,1528,697,1680800,766700,2447500
210370,202101,1231,605,626,665500,688600,1354100
210375,202101,189,95,94,104500,104500,209000
210380,202101,719,551,168,606100,184800,790900
210390,202101,192,164,28,180400,30800,211200
210400,202101,388,338,50,371800,55000,426800
210405,202101,983,688,295,756800,325600,1082400
210407,202101,53,42,11,46200,12100,58300
210408,202101,59,52,7,57200,7700,64900
210409,202101,323,282,41,311300,45100,356400
210410,202101,445,348,97,382800,106700,489500
210420,202101,204,167,37,183700,40700,224400
210430,202101,51,35,16,38500,17600,56100
210440,202101,342,230,112,253000,123200,376200
210450,202101,139,111,28,122100,30800,152900
210455,202101,231,120,111,132000,122100,254100
210460,202101,304,204,100,224400,110000,334400
210462,202101,69,57,12,62700,13200,75900
210465,202101,140,109,31,119900,34100,154000
210467,202101,508,373,135,410300,148500,558800
210470,202101,50,43,7,47300,7700,55000
210480,202101,1267,907,360,998800,396000.5,1394800.5
210490,202101,203,136,67,149600,73700,223300
210500,202101,509,309,200,339900,220000,559900
210510,202101,546,437,109,480700,119900,600600
210515,202101,358,225,133,247500,146300,393800
210520,202101,399,360,39,396000,42900,438900
210530,202101,9378,4906,4472,5401000.48,4924700.83,10325701.31
210535,202101,130,98,32,107800,35200,143000
210540,202101,1509,1001,508,1101100,558800,1659900
210542,202101,1155,586,569,645700,625900,1271600
210545,202101,22,20,2,22000,2200,24200
210547,202101,128,113,15,124300,16500,140800
210550,202101,674,488,186,536800,204600,741400
210560,202101,156,137,19,150700,20900,171600
210565,202101,20,15,5,16500,5500,22000
210570,202101,1271,1030,241,1133000.59,265100,1398100.59
210580,202101,118,100,18,110000,19800,129800
210590,202101,727,602,125,662200,137500,799700
210592,202101,39,37,2,40700,2200,42900
210594,202101,111,93,18,102300,19800,122100
210596,202101,103,88,15,96800,16500,113300
210598,202101,137,102,35,112200,38500,150700
210600,202101,310,268,42,294800,46200,341000
210610,202101,258,243,15,267300,16500,283800
210620,202101,43,27,16,29700,17600,47300
210630,202101,73,70,3,77000,3300,80300
210632,202101,1026,726,300,799700,330000,1129700
210635,202101,22,19,3,20900,3300,24200
210637,202101,122,87,35,95700,38500,134200
210640,202101,584,509,75,559900,83600,643500
210650,202101,397,331,66,364100,72600,436700
210660,202101,374,295,79,324500,86900,411400
210663,202101,36,26,10,28600,11000,39600
210667,202101,102,41,61,45100,67100,112200
210670,202101,242,215,27,236500,29700,266200
210675,202101,546,289,257,317900,282700,600600
210680,202101,221,144,77,158400,84700,243100
210690,202101,620,511,109,562100,119900,682000
210700,202101,157,119,38,130900,41800,172700
210710,202101,242,154,88,169400,96800,266200
210720,202101,129,115,14,126500,15400,141900
210725,202101,64,56,8,61600,8800,70400
210730,202101,24,18,6,19800,6600,26400
210735,202101,292,210,82,231000,90200,321200
210740,202101,521,448,73,492800,80300,573100
210745,202101,153,114,39,125400,42900,168300
210750,202101,2430,1228,1202,1350800,1322200,2673000
210760,202101,257,194,63,213400,69300,282700
210770,202101,245,196,49,215600,53900,269500
210780,202101,431,321,110,353100,121000,474100
210790,202101,184,151,33,166100,36300,202400
210800,202101,171,128,43,140800,47300,188100
210805,202101,53,48,5,52800,5500,58300
210810,202101,461,374,87,411400,95700,507100
210820,202101,2121,1752,369,1927200,405900,2333100
210825,202101,153,87,66,95700,72600,168300
210830,202101,726,484,242,532400,266200,798600
210840,202101,195,137,58,150700,63800,214500
210845,202101,232,162,70,178200,77000,255200
210850,202101,753,514,239,565400,262900,828300
210860,202101,3555,2038,1517,2241800,1668700,3910500
210870,202101,426,338,88,371800,96800,468600
210880,202101,75,58,17,63800,18700,82500
210890,202101,318,276,42,303600,46200,349800
210900,202101,629,410,219,451000,240900,691900
210905,202101,62,34,28,37400,30800,68200
210910,202101,1952,1475,477,1622500.7,524700,2147200.7
210920,202101,168,63,105,69300,115500,184800
210923,202101,84,67,17,73700,18700,92400
210927,202101,419,198,221,217800,243100,460900
210930,202101,67,53,14,58300,15400,73700
210940,202101,85,66,19,72600,20900,93500
210945,202101,195,105,90,115500,99000,214500
210950,202101,527,384,143,422400,157300,579700
210955,202101,81,49,32,53900,35200,89100
210960,202101,2196,1096,1100,1205600,1210000,2415600
210970,202101,118,104,14,114400,15400,129800
210975,202101,83,77,6,84700,6600,91300
210980,202101,1088,532,556,585200,611600,1196800
210990,202101,3998,2653,1345,2918300,1479500,4397800
211000,202101,1314,1061,253,1167100,278300,1445400
211003,202101,981,706,275,776600,302500,1079100
211010,202101,484,430,54,473000,60500,533500
211020,202101,1423,612,811,673200,892100,1565300
211023,202101,36,31,5,34100,5500,39600
211027,202101,73,53,20,58300,22000,80300
211030,202101,367,261,106,287100,116600,403700
211040,202101,296,245,51,269500,56100,325600
211050,202101,1155,763,392,839300,431200,1270500
211060,202101,628,548,80,602800,88000.49,690800.49
211065,202101,20,17,3,18700,3300,22000
211070,202101,882,733,149,806300,165000,971300
211080,202101,83,80,3,88000,3300,91300
211085,202101,54,28,26,30800,28600,59400
211090,202101,75,64,11,70400,12100,82500
211100,202101,479,396,83,435600,91300,526900
211102,202101,241,169,72,185900,79200,265100
211105,202101,220,156,64,171600,70400,242000
211107,202101,125,77,48,84700,52800,137500
211110,202101,936,627,309,689700,341000,1030700
211120,202101,5248,2616,2632,2878700,2895200,5773900
211125,202101,32,23,9,25300,9900,35200
211130,202101,41408,19000,22408,20911000,24654300,45565300
211140,202101,394,345,49,379500,53900,433400
211150,202101,1186,799,387,878900,425700,1304600
211153,202101,170,105,65,115500,71500,187000
211157,202101,65,51,14,56100,15400,71500
211160,202101,692,594,98,653400,108900,762300
211163,202101,2,2,0,2200,0,2200
211167,202101,11,10,1,11000,1100,12100
211170,202101,416,310,106,341000,116600,457600
211172,202101,115,79,36,86900,39600,126500
211174,202101,256,159,97,174900,106700,281600
211176,202101,474,352,122,388300,134200,522500
211178,202101,92,61,31,67100,34100,101200
211180,202101,212,169,43,185900,47300,233200
211190,202101,72,65,7,71500,7700,79200
211195,202101,34,23,11,25300,12100,37400
211200,202101,151,132,19,145200,20900,166100
211210,202101,428,317,111,348700,122100,470800
211220,202101,4111,2420,1691,2662000.51,1860100,4522100.51
211223,202101,88,85,3,93500,3300,96800
211227,202101,66,52,14,57200,15400,72600
211230,202101,736,606,130,666600,143000,809600
211240,202101,400,314,86,345400,94600,440000
211245,202101,186,91,95,101200,104500,205700
211250,202101,1528,1322,206,1454200,226600,1680800
211260,202101,802,662,140,728200,154000,882200
211270,202101,1947,1591,356,1750100,391600,2141700
211280,202101,1742,1117,625,1228700,687500,1916200
211285,202101,205,126,79,138600,86900,225500
211290,202101,717,506,211,556600,232100,788700
211300,202101,748,594,154,653400,169400,822800
211400,202101,1519,936,583,1029600,641300,1670900
220005,202101,15,14,1,15400,1100,16500
220010,202101,89,69,20,75900,22000,97900
220020,202101,693,551,142,606100,156200,762300
220025,202101,107,105,2,115500,2200,117700
220027,202101,45,36,9,39600,9900,49500
220030,202101,114,91,23,100100,25300,125400
220040,202101,1248,946,302,1040600,333300,1373900
220045,202101,32,21,11,23100,12100,35200
220050,202101,689,573,116,630300.8,127600,757900.8
220060,202101,172,150,22,165000,24200,189200
220070,202101,113,102,11,112200,12100,124300
220080,202101,17,15,2,16500,2200,18700
220090,202101,32,26,6,28600,6600,35200
220095,202101,2,1,1,1100,1100,2200
220100,202101,18,15,3,16500,3300,19800
220105,202101,26,24,2,26400,2200,28600
220110,202101,229,209,20,229900,22000,251900
220115,202101,37,36,1,39600,1100,40700
220117,202101,21,20,1,22000,1100,23100
220120,202101,1463,1121,342,1234200,376200,1610400
220130,202101,31,30,1,33000,1100,34100
220140,202101,106,85,21,93500,23100,116600
220150,202101,500,370,130,407000,143000,550000
220155,202101,6,6,0,6600,0,6600
220157,202101,20,16,4,17600,4400,22000
220160,202101,90,80,10,88000,11000,99000
220170,202101,34,31,3,34100,3300,37400
220173,202101,10,10,0,11000,0,11000
220177,202101,8,7,1,7700,1100,8800
220180,202101,65,63,2,69300,2200,71500
220190,202101,1081,951,130,1046100,143000,1189100
220191,202101,44,35,9,38500,9900,48400
220192,202101,86,82,4,90200,4400,94600
220194,202101,58,53,5,58300,5500,63800
220196,202101,98,82,16,90200,17600,107800
220198,202101,3,2,1,2200,1100,3300
220200,202101,413,342,71,376200,78100,454300
220202,202101,37,32,5,35200,5500,40700
220205,202101,55,48,7,52800,7700,60500
220207,202101,12,12,0,13200,0,13200
220208,202101,74,41,33,45100,36300,81400
220209,202101,33,28,5,30800,5500,36300
220210,202101,20,14,6,15400,6600,22000
220211,202101,26,24,2,26400,2200,28600
220213,202101,40,35,5,38500,5500,44000
220217,202101,39,29,10,31900,11000,42900
220220,202101,2192,1450,742,1598300,818400,2416700
220225,202101,8,3,5,3300,5500,8800
220230,202101,963,742,221,816200,243100,1059300
220240,202101,157,139,18,152900,19800,172700
220245,202101,33,30,3,33000.18,3300,36300.18
220250,202101,123,108,15,118800,16500,135300
220253,202101,47,40,7,44000,7700,51700
220255,202101,33,29,4,31900,4400,36300
220260,202101,707,530,177,583000,194700,777700
220265,202101,5,3,2,3300,2200,5500
220270,202101,762,687,75,756800,82500,839300
220271,202101,43,35,8,38500,8800,47300
220272,202101,23,22,1,24200,1100,25300
220273,202101,17,15,2,16500,2200,18700
220275,202101,57,46,11,50600,12100,62700
220277,202101,17,12,5,13200,5500,18700
220280,202101,17,12,5,13200,5500,18700
220285,202101,40,38,2,41800,2200,44000
220290,202101,1471,1266,205,1392600,225500,1618100
220300,202101,35,33,2,36300,2200,38500
220310,202101,326,277,49,304700,53900,358600
220320,202101,438,406,32,446600,35200,481800
220323,202101,1,0,1,0,1100,1100
220325,202101,11,10,1,11000,1100,12100
220327,202101,10,10,0,11000,0,11000
220330,202101,228,167,61,183700,67100,250800
220335,202101,142,124,18,136400,19800,156200
220340,202101,39,27,12,29700,13200,42900
220342,202101,56,48,8,52800,8800,61600
220345,202101,81,73,8,80300,8800,89100
220350,202101,443,382,61,420200,67100,487300
220360,202101,43,31,12,34100,13200,47300
220370,202101,1232,1021,211,1124200,232100,1356300
220375,202101,19,17,2,18700,2200,20900
220380,202101,23,17,6,18700,6600,25300
220385,202101,14,13,1,14300,1100,15400
220390,202101,2327,1319,1008,1450900,1108800,2559700
220400,202101,33,29,4,31900,4400,36300
220410,202101,20,18,2,19800,2200,22000
220415,202101,13,11,2,12100,2200,14300
220420,202101,124,104,20,115500,22000,137500
220430,202101,128,114,14,125400,15400,140800
220435,202101,24,17,7,18700,7700,26400
220440,202101,281,238,43,261800,47300,309100
220450,202101,338,170,168,187000,184800,371800
220455,202101,51,50,1,55000,1100,56100
220460,202101,20,18,2,19800,2200,22000
220465,202101,91,60,31,66000,34100,100100
220470,202101,244,211,33,232100,36300,268400
220480,202101,72,65,7,71500,7700,79200
220490,202101,87,74,13,81400,14300,95700
220500,202101,107,91,16,100100,17600,117700
220510,202101,415,321,94,353100,103400,456500
220515,202101,21,19,2,20900,2200,23100
220520,202101,367,328,39,360800,42900,403700
220525,202101,10,7,3,7700,3300,11000
220527,202101,18,14,4,15400,4400,19800
220530,202101,33,12,21,13200,23100,36300
220535,202101,5,4,1,4400,1100,5500
220540,202101,67,55,12,60500,13200,73700
220545,202101,39,26,13,28600,14300,42900
220550,202101,710,561,149,619300,163900,783200
220551,202101,16,12,4,13200,4400,17600
220552,202101,16,16,0,17600,0,17600
220553,202101,54,48,6,52800,6600,59400
220554,202101,11,8,3,8800,3300,12100
220555,202101,36,31,5,34100,5500,39600
220556,202101,40,38,2,41800,2200,44000
220557,202101,57,54,3,59400,3300,62700
220558,202101,7,3,4,3300,4400,7700
220559,202101,3,3,0,3300,0,3300
220560,202101,70,46,24,50600,26400,77000
220570,202101,731,450,281,495000,309100,804100
220580,202101,544,497,47,546700,51700,598400
220585,202101,9,8,1,8800,1100,9900
220590,202101,14,14,0,15400,0,15400
220595,202101,64,48,16,52800,17600,70400
220600,202101,19,11,8,12100,8800,20900
220605,202101,25,22,3,24200,3300,27500
220610,202101,78,66,12,72600,13200,85800
220620,202101,555,460,95,506000,104500,610500
220630,202101,5,4,1,4400,1100,5500
220635,202101,35,30,5,33000,5500,38500
220640,202101,104,87,17,95700,18700,114400
220650,202101,111,105,6,115500,6600,122100
220660,202101,57,46,11,50600,12100,62700
220665,202101,5,5,0,5500,0,5500
220667,202101,19,17,2,18700,2200,20900
220669,202101,27,23,4,25300,4400,29700
220670,202101,65,52,13,57200,14300,71500
220672,202101,79,56,23,61600,25300,86900
220675,202101,36,28,8,30800,8800,39600
220680,202101,43,37,6,40700,6600,47300
220690,202101,47,44,3,48400,3300,51700
220695,202101,33,16,17,17600,18700,36300
220700,202101,1700,1311,389,1443200,427900,1871100
220710,202101,6,4,2,4400,2200,6600
220720,202101,110,93,17,102300,18700,121000
220730,202101,15,15,0,16500,0,16500
220735,202101,5,1,4,1100,4400,5500
220740,202101,47,43,4,47300,4400,51700
220750,202101,112,95,17,104500,18700,123200
220755,202101,14,13,1,14300,1100,15400
220760,202101,64,58,6,63800,6600,70400
220770,202101,5711,3110,2601,3421000.7,2862200,6283200.7
220775,202101,18,11,7,12100,7700,19800
220777,202101,19,18,1,19800,1100,20900
220779,202101,1,0,1,0,1100,1100
220780,202101,893,760,133,836000,146300,982300
220785,202101,5,1,4,1100,4400,5500
220790,202101,1098,863,235,949300,258500,1207800
220793,202101,6,6,0,6600,0,6600
220795,202101,12,11,1,12100,1100,13200
220800,202101,4003,3078,925,3385800,1019700,4405500
220810,202101,65,56,9,61600,9900,71500
220820,202101,237,216,21,237600,23100,260700
220830,202101,1250,1080,170,1189100,187000,1376100
220840,202101,2405,1673,732,1841400.63,807400,2648800.63
220850,202101,62,53,9,58300,9900,68200
220855,202101,8,5,3,5500,3300,8800
220860,202101,13,10,3,11000,3300,14300
220865,202101,29,27,2,29700,2200,31900
220870,202101,77,69,8,75900,8800,84700
220880,202101,320,255,65,280500,71500,352000
220885,202101,31,27,4,29700,4400,34100
220887,202101,13,12,1,13200,1100,14300
220890,202101,92,80,12,88000,13200,101200
220900,202101,25,15,10,16500,11000,27500
220910,202101,51,42,9,46200,9900,56100
220915,202101,10,9,1,9900,1100,11000
220920,202101,46,41,5,45100,5500,50600
220930,202101,43,42,1,46200,1100,47300
220935,202101,15,15,0,16500,0,16500
220937,202101,33,32,1,35200,1100,36300
220940,202101,55,50,5,55000,5500,60500
220945,202101,2,2,0,2200,0,2200
220950,202101,41,32,9,35200,9900,45100
220955,202101,22,20,2,22000,2200,24200
220960,202101,16,16,0,17600,0,17600
220965,202101,37,33,4,36300,4400,40700
220970,202101,61,52,9,57200,9900,67100
220975,202101,15,13,2,14300,2200,16500
220980,202101,32,30,2,33000,2200,35200
220985,202101,61,54,7,59400,7700,67100
220987,202101,31,30,1,33000,1100,34100
220990,202101,27,26,1,28600,1100,29700
220995,202101,18,15,3,16500,3300,19800
220997,202101,67,56,11,61600,12100,73700
221000,202101,1188,1069,119,1175900,130900,1306800
221005,202101,45,41,4,45100,4400,49500
221010,202101,16,12,4,13200,4400,17600
221020,202101,36,35,1,38500,1100,39600
221030,202101,39,31,8,34100,8800,42900
221035,202101,21,21,0,23100,0,23100
221037,202101,12,8,4,8800,4400,13200
221038,202101,26,23,3,25300,3300,28600
221039,202101,22,22,0,24200,0,24200
221040,202101,259,219,40,240900,44000,284900
221050,202101,234,195,39,214500,42900,257400
221060,202101,1864,1625,239,1787500,264000,2051500
221062,202101,34,34,0,37400,0,37400
221063,202101,11,7,4,7700,4400,12100
221065,202101,60,48,12,52800,13200,66000
221070,202101,135,118,17,129800,18700,148500
221080,202101,375,318,57,349800,62700,412500
221090,202101,23,19,4,20900,4400,25300
221093,202101,45,33,12,36300,13200,49500
221095,202101,6,6,0,6600,0,6600
221097,202101,13,11,2,12100,2200,14300
221100,202101,25510,15121,10389,16637500.63,11444400,28081900.63
221110,202101,1095,831,264,915200,290400,1205600
221120,202101,542,397,145,437800,159500,597300
221130,202101,966,776,190,853600,209000,1062600
221135,202101,36,31,5,34100,5500,39600
221140,202101,45,39,6,42900,6600,49500
221150,202101,11,9,2,9900,2200,12100
221160,202101,13,13,0,14300,0,14300
221170,202101,15,15,0,16500,0,16500
230010,202101,150,138,12,151800,13200,165000
230015,202101,129,105,24,115500,26400,141900
230020,202101,1621,1360,261,1496000,287100,1783100
230030,202101,1678,1205,473,1325500,520300,1845800
230040,202101,220,184,36,202400,39600,242000
230050,202101,226,164,62,180400,68200,248600
230060,202101,159,126,33,138600,36300,174900
230070,202101,304,261,43,287100,47300,334400
230075,202101,841,723,118,795300,129800,925100
230080,202101,197,168,29,184800,31900,216700
230090,202101,129,93,36,102300,39600,141900
230100,202101,2183,1242,941,1366200,1035100,2401300
230110,202101,2868,1840,1028,2024000,1131900,3155900
230120,202101,1021,801,220,881100,242000,1123100
230125,202101,152,123,29,135300,31900,167200
230130,202101,473,420,53,462000,58300,520300
230140,202101,222,185,37,203500,40700,244200
230150,202101,150,115,35,126500,38500,165000
230160,202101,941,796,145,875600,159500,1035100
230170,202101,608,546,62,600600,68200,668800
230180,202101,73,67,6,73700,6600,80300
230185,202101,402,345,57,379500,62700,442200
230190,202101,2379,1860,519,2046000.32,570900,2616900.32
230195,202101,492,426,66,468600,72600,541200
230200,202101,416,336,80,369600,88000,457600
230205,202101,390,257,133,282700,146300,429000
230210,202101,1359,1052,307,1158300.46,337700,1496000.46
230220,202101,1577,1063,514,1169300,565400,1734700
230230,202101,962,808,154,888800,169400,1058200
230240,202101,1754,1509,245,1661275,269500,1930775
230250,202101,1772,1452,320,1597200,353100,1950300
230260,202101,3241,2010,1231,2214300,1354100,3568400
230270,202101,1373,1094,279,1203400.05,306900,1510300.05
230280,202101,2734,2045,689,2250600,757900,3008500
230290,202101,399,357,42,393800.5,46200,440000.5
230300,202101,526,378,148,415800,162800,578600
230310,202101,416,316,100,347600,110000,457600
230320,202101,924,783,141,861300,156200,1017500
230330,202101,309,246,63,270600,69300,339900
230340,202101,447,360,87,396000,95700,491700
230350,202101,3185,2004,1181,2206600,1299100,3505700
230360,202101,278,222,56,244200,61600,305800
230365,202101,132,109,23,119900,25300,145200
230370,202101,10207,4952,5255,5450500.92,5783800,11234300.92
230380,202101,493,419,74,462000,81400,543400
230390,202101,550,304,246,334400,270600,605000
230393,202101,250,205,45,225500,49500,275000
230395,202101,354,283,71,311300.6,78100,389400.6
230400,202101,616,490,126,539000,138600,677600
230410,202101,2656,1654,1002,1820500.5,1103300,2923800.5
230420,202101,6306,4154,2152,4572701.75,2367200,6939901.75
230423,202101,337,294,43,323400,47300,370700
230425,202101,419,341,78,375100,85800,460900
230426,202101,118,96,22,105600,24200,129800
230427,202101,73,69,4,75900,4400,80300
230428,202101,1542,761,781,837100,859100,1696200
230430,202101,460,374,86,411400,94600,506000
230435,202101,878,630,248,693000,272800.24,965800.24
230440,202101,89831,39761,50070,43763391.3,55110000.92,98873392.22
230445,202101,310,212,98,233200,107800,341000
230450,202101,561,443,118,487300,129800,617100
230460,202101,70,52,18,57200,19800,77000
230465,202101,304,245,59,269500,64900,334400
230470,202101,2012,1584,428,1742400,470800,2213200
230480,202101,152,143,9,157300,9900,167200
230490,202101,303,242,61,266200,67100,333300
230495,202101,459,337,122,370700,134200,504900
230500,202101,1022,751,271,826100,298100,1124200
230510,202101,57,44,13,48400,14300,62700
230520,202101,383,302,81,332200.56,90200,422400.56
230523,202101,2398,1490,908,1640100,998800,2638900
230526,202101,273,234,39,257400,42900,300300
230530,202101,681,505,176,556600,193600,750200
230533,202101,207,191,16,210100,17600,227700
230535,202101,370,274,96,302500,105600,408100
230540,202101,1795,1591,204,1750100,224400,1974500
230550,202101,3838,2454,1384,2700500,1522400,4222900
230560,202101,574,431,143,475200,157300,632500
230565,202101,222,163,59,179300,64900,244200
230570,202101,290,254,36,279400,39600,319000
230580,202101,1169,842,327,926200,359700,1285900
230590,202101,996,773,223,850300,245300,1095600
230600,202101,239,218,21,239800,23100,262900
230610,202101,377,286,91,314600,100100,414700
230620,202101,206,175,31,192500,34100,226600
230625,202101,776,535,241,588500,265100,853600
230630,202101,1338,1034,304,1137400,334400,1471800
230640,202101,3815,3211,604,3532100,665500,4197600
230650,202101,457,390,67,429000,73700,502700
230655,202101,693,583,110,641300,121000,762300
230660,202101,361,296,65,325600,71500,397100
230670,202101,449,380,69,418000,75900,493900
230680,202101,203,183,20,201300,22000,223300
230690,202101,910,767,143,843700,157300,1001000
230700,202101,850,713,137,784300,150700,935000
230710,202101,691,653,38,718300,41800,760100
230720,202101,150,128,22,140800,24200,165000
230725,202101,213,164,49,180400,53900,234300
230730,202101,12310,6604,5706,7267631.32,6281000.82,13548632.14
230740,202101,673,538,135,591800,148500,740300
230750,202101,827,696,131,765600,144100,909700
230760,202101,1454,1245,209,1370600,229900,1600500
230763,202101,329,270,59,297000,64900,361900
230765,202101,7627,3481,4146,3831300.6,4566100,8397400.6
230770,202101,5025,2540,2485,2797300,2733500,5530800
230780,202101,722,632,90,695200,100100,795300
230790,202101,292,244,48,268400,52800,321200
230800,202101,1144,817,327,898700,359700,1258400
230810,202101,1355,1193,162,1312300,178200,1490500
230820,202101,365,249,116,273900,127600,401500
230830,202101,961,818,143,899800,157300,1057100
230835,202101,276,236,40,259600,44000,303600
230837,202101,170,143,27,158400,29700,188100
230840,202101,927,721,206,793100,226600,1019700
230850,202101,1482,1274,208,1401400,228800,1630200
230860,202101,301,227,74,249700,81400,331100
230870,202101,1818,1538,280,1694183.33,308000,2002183.33
230880,202101,67,51,16,57200,17600,74800
230890,202101,532,484,48,532400.83,52800,585200.83
230900,202101,278,202,76,222200,83600.7,305800.7
230910,202101,221,171,50,188100,55000,243100
230920,202101,425,338,87,371800,95700,467500
230930,202101,985,684,301,753500,331100,1084600
230940,202101,852,659,193,724900,212300,937200
230945,202101,527,424,103,467500,114400,581900
230950,202101,415,359,56,394900,61600,456500
230960,202101,2674,1785,889,1964600,977900,2942500
230970,202101,1697,935,762,1029600,839300,1868900
230980,202101,203,166,37,182600,40700,223300
230990,202101,138,112,26,123200,28600,151800
231000,202101,189,174,15,191400,16500,207900
231010,202101,152,110,42,121000,46200,167200
231020,202101,1356,936,420,1029600,464200,1493800
231025,202101,1064,781,283,859100,311300,1170400
231030,202101,1092,910,182,1001000,200200,1201200
231040,202101,144,95,49,104500,53900,158400
231050,202101,935,823,112,905300,123200,1028500
231060,202101,158,132,26,145200,28600,173800
231070,202101,1490,1032,458,1135200,503800,1639000
231080,202101,264,240,24,264000,26400,290400
231085,202101,625,374,251,411400,277200,688600
231090,202101,250,199,51,218900,56100,275000
231095,202101,168,134,34,147400,37400,184800
231100,202101,151,126,25,138600,27500,166100
231110,202101,371,314,57,345400,62700,408100
231120,202101,269,230,39,253000,42900,295900
231123,202101,153,144,9,159500,9900,169400
231126,202101,333,256,77,281600,84700,366300
231130,202101,4769,3724,1045,4096400,1149500,5245900
231135,202101,210,182,28,200200,30800,231000
231140,202101,3072,2241,831,2469500,914100,3383600
231150,202101,368,347,21,381700,23100,404800
231160,202101,1196,947,249,1041700,273900,1315600
231170,202101,513,354,159,389400,174900,564300
231180,202101,1704,1461,243,1607100,268400,1875500
231190,202101,206,173,33,190300,36300,226600
231195,202101,217,180,37,198000,40700,238700
231200,202101,793,649,144,713900,158400,872300
231210,202101,579,485,94,533500,103400,636900
231220,202101,1044,759,285,834900.85,313500,1148400.85
231230,202101,1472,1154,318,1272700,350900,1623600
231240,202101,1468,1040,428,1144000,473000,1617000
231250,202101,105,97,8,106700,8800,115500
231260,202101,272,178,94,195800,103400,299200
231270,202101,1000,806,194,886600,213400,1100000
231280,202101,76,58,18,63800,19800,83600
231290,202101,7699,4301,3398,4734400,3737800.57,8472200.57
231300,202101,601,555,46,610500,50600,661100
231310,202101,735,674,61,741400.81,67100,808500.81
231320,202101,593,444,149,488400,163900,652300
231325,202101,102,88,14,96800,15400,112200
231330,202101,1971,1524,447,1676675.74,491700,2168375.74
231335,202101,252,221,31,243100,34100,277200
231340,202101,1725,1252,473,1377200,521400,1898600
231350,202101,1299,1043,256,1149500,281600,1431100
231355,202101,432,366,66,402600,72600,475200
231360,202101,512,369,143,405900.65,157300,563200.65
231370,202101,87,76,11,83600,12100,95700
231375,202101,290,209,81,229900,89100,319000
231380,202101,493,392,101,433400,111100,544500
231390,202101,209,160,49,176000,53900,229900
231395,202101,741,464,277,510400,304700,815100
231400,202101,1128,932,196,1025200,215600,1240800
231410,202101,1336,1090,246,1199000,271700,1470700
240010,202101,395,170,225,187000.97,247500,434500.97
240020,202101,2247,1822,425,2005300,467500,2472800
240030,202101,120,100,20,110000,22000,132000
240040,202101,33,33,0,36300,0,36300
240050,202101,524,445,79,489500,86900,576400
240060,202101,67,63,4,69300,4400,73700
240070,202101,224,175,49,192500,53900,246400
240080,202101,530,360,170,396000,188100.7,584100.7
240090,202101,96,85,11,93500,12100,105600
240100,202101,1496,1407,89,1547700.5,97900,1645600.5
240110,202101,1039,679,360,746900,396000,1142900
240120,202101,142,111,31,122100,34100,156200
240130,202101,279,258,21,283800,23100,306900
240140,202101,81,58,23,63800,25300,89100
240145,202101,738,652,86,717200,94600,811800
240150,202101,22,17,5,18700,5500,24200
240160,202101,42,34,8,37400,8800,46200
240165,202101,36,28,8,30800,8800,39600
240170,202101,114,79,35,86900,38500,125400
240180,202101,93,71,22,78100,24200,102300
240185,202101,44,40,4,44000,4400,48400
240190,202101,14,12,2,13200,2200,15400
240200,202101,3084,1722,1362,1894200,1498200,3392400
240210,202101,172,132,40,145200,44000,189200
240220,202101,1103,797,306,876700,336600,1213300
240230,202101,845,776,69,856900,75900,932800
240240,202101,74,53,21,58300,23100,81400
240250,202101,91,79,12,86900,13200,100100
240260,202101,1808,1329,479,1463000,526900,1989900
240270,202101,183,161,22,177100,24200,201300
240280,202101,46,35,11,38500,12100,50600
240290,202101,46,44,2,48400,2200,50600
240300,202101,182,99,83,108900,91300,200200
240310,202101,2363,1291,1072,1421200.19,1179200,2600400.19
240320,202101,189,176,13,193600,14300,207900
240325,202101,4571,2691,1880,2960101.05,2069100,5029201.05
240330,202101,74,68,6,74800,6600,81400
240340,202101,72,46,26,50600,28600,79200
240350,202101,93,81,12,89100,13200,102300
240360,202101,555,337,218,370700,239800,610500
240370,202101,53,49,4,53900,4400,58300
240375,202101,63,38,25,41800,27500,69300
240380,202101,230,188,42,206800,46200,253000
240390,202101,12,11,1,12100,1100,13200
240400,202101,79,71,8,78100,8800,86900
240410,202101,14,8,6,8800,6600,15400
240420,202101,1013,735,278,808500,305800,1114300
240430,202101,262,245,17,270600,18700,289300
240440,202101,127,71,56,78100,61600,139700
240450,202101,229,153,76,168300,83600,251900
240460,202101,71,55,16,60500,17600,78100
240470,202101,233,208,25,228800,27500,256300
240480,202101,17,15,2,16500,2200,18700
240485,202101,80,66,14,72600,15400,88000
240490,202101,45,43,2,47300,2200,49500
240500,202101,86,64,22,70400,24200,94600
240510,202101,42,31,11,34100,12100,46200
240520,202101,113,108,5,118800,5500,124300
240530,202101,55,48,7,52800,7700,60500
240540,202101,78,66,12,72600,13200,85800
240550,202101,13,12,1,13200,1100,14300
240560,202101,379,275,104,302500,114400,416900
240570,202101,439,279,160,308000,176000.38,484000.38
240580,202101,1293,1015,278,1117600,305800,1423400
240590,202101,30,28,2,30800,2200,33000
240600,202101,102,97,5,107800,5500,113300
240610,202101,515,432,83,475200,91300,566500
240615,202101,17,16,1,17600,1100,18700
240620,202101,88,85,3,93500,3300,96800
240630,202101,40,34,6,37400,6600,44000
240640,202101,26,21,5,23100,5500,28600
240650,202101,244,201,43,221100,47300,268400
240660,202101,114,97,17,106700,18700,125400
240670,202101,309,173,136,190300,149600,339900
240680,202101,50,37,13,40700,14300,55000
240690,202101,48,45,3,49500,3300,52800
240700,202101,182,149,33,163900,36300,200200
240710,202101,2029,1248,781,1372800.41,859100,2231900.41
240720,202101,1065,781,284,860200,312400,1172600
240725,202101,68,63,5,69300,5500,74800
240730,202101,150,126,24,138600,26400,165000
240740,202101,230,195,35,214500,38500,253000
240750,202101,52,29,23,31900,25300,57200
240760,202101,46,41,5,45100,5500,50600
240770,202101,145,114,31,125400,34100,159500
240780,202101,683,567,116,623700,128700,752400
240790,202101,42,40,2,44000,2200,46200
240800,202101,9314,6322,2992,6954200.85,3292300,10246500.85
240810,202101,20598,11037,9561,12151700,10525900,22677600
240820,202101,239,143,96,157300.2,105600,262900.2
240830,202101,1612,1322,290,1454200,319000,1773200
240840,202101,77,67,10,73700,11000,84700
240850,202101,86,77,9,84700,9900,94600
240860,202101,102,98,4,107800,4400,112200
240870,202101,58,50,8,55000,8800,63800
240880,202101,31,28,3,30800,3300,34100
240890,202101,1127,635,492,698500,541200,1239700
240895,202101,59,40,19,44000,20900,64900
240910,202101,158,139,19,152900,20900,173800
240920,202101,14,10,4,11000,4400,15400
240930,202101,407,365,42,401500,46200,447700
240933,202101,52,33,19,36300,20900,57200
240940,202101,2359,2087,272,2296800,299200,2596000
240950,202101,49,44,5,48400,5500,53900
240960,202101,25,21,4,23100,4400,27500
240970,202101,117,85,32,93500,35200,128700
240980,202101,197,157,40,172700,44000,216700
240990,202101,131,87,44,95700,48400,144100
241000,202101,61,57,4,62700,4400,67100
241010,202101,75,55,20,60500,22000,82500
241020,202101,113,104,9,114400,9900,124300
241025,202101,13,6,7,6600,7700,14300
241030,202101,114,89,25,97900,27500,125400
241040,202101,43,31,12,34100,13200,47300
241050,202101,81,73,8,80300,8800,89100
241060,202101,29,24,5,26400,5500,31900
241070,202101,15,15,0,16500,0,16500
241080,202101,62,55,7,60500,7700,68200
241090,202101,57,46,11,50600,12100,62700
241100,202101,72,61,11,67100,12100,79200
241105,202101,8,3,5,3300,5500,8800
241110,202101,50,46,4,50600,4400,55000
241120,202101,1480,1118,362,1230900,398200,1629100
241140,202101,222,184,38,202400,41800,244200
241142,202101,38,32,6,35200,6600,41800
241150,202101,1189,1041,148,1145100,163900,1309000
241160,202101,18,17,1,18700,1100,19800
241170,202101,46,39,7,42900,7700,50600
241180,202101,44,37,7,40700,7700,48400
241190,202101,36,35,1,38500,1100,39600
241200,202101,3992,2063,1929,2270400,2125200,4395600
241210,202101,67,58,9,63800,9900,73700
241220,202101,1429,951,478,1047200.43,525800,1573000.43
241230,202101,247,204,43,224400,47300,271700
241240,202101,54,42,12,46200,13200,59400
241250,202101,1106,1012,94,1113200,103400,1216600
241255,202101,52,40,12,44000,13200,57200
241260,202101,684,527,157,579700.46,172700,752400.46
241270,202101,64,44,20,48400,22000,70400
241280,202101,96,83,13,91300,14300,105600
241290,202101,125,85,40,93500,44000,137500
241300,202101,82,56,26,61600,28600,90200
241310,202101,52,37,15,40700,16500,57200
241320,202101,31,18,13,19800,14300,34100
241330,202101,63,55,8,60500,8800,69300
241335,202101,75,67,8,73700,8800,82500
241340,202101,184,135,49,148500,53900,202400
241350,202101,61,52,9,57200,9900,67100
241355,202101,49,42,7,46200,7700,53900
241360,202101,48,47,1,51700,1100,52800
241370,202101,56,44,12,48400,13200,61600
241380,202101,36,32,4,35200,4400,39600
241390,202101,83,63,20,69300,22000,91300
241400,202101,218,174,44,191400,48400,239800
241410,202101,181,163,18,179300,19800,199100
241415,202101,101,83,18,91300,19800,111100
241420,202101,99,76,23,83600,25300,108900
241430,202101,26,24,2,26400,2200,28600
241440,202101,535,435,100,478500,110000,588500
241445,202101,40,35,5,38500,5500,44000
241450,202101,268,220,48,242000,52800,294800
241460,202101,142,129,13,141900,14300,156200
241470,202101,35,30,5,33000,5500,38500
241475,202101,52,49,3,53900,3300,57200
241480,202101,99,69,30,75900,33000,108900
241490,202101,11,10,1,11000,1100,12100
241500,202101,46,35,11,38500,12100,50600
250010,202101,100,85,15,93500,16500,110000
250020,202101,29,26,3,28600,3300,31900
250030,202101,894,666,228,733700,251900,985600
250040,202101,372,305,67,335500,73700,409200
250050,202101,254,208,46,228800,50600,279400
250053,202101,56,42,14,46200,15400,61600
250057,202101,1,1,0,1100,0,1100
250060,202101,586,416,170,457600,187000,644600
250070,202101,704,565,139,622600.22,152900,775500.22
250073,202101,8,8,0,8800,0,8800
250077,202101,176,131,45,144100,49500,193600
250080,202101,432,341,91,375100,100100.71,475200.71
250090,202101,223,144,79,160600,88000,248600
250100,202101,519,428,91,470800,100100,570900
250110,202101,634,480,154,528000,169400,697400
250115,202101,19,6,13,6600,14300,20900
250120,202101,121,86,35,94600,38500,133100
250130,202101,571,459,112,504900,123200,628100
250135,202101,18,11,7,12100,7700,19800
250140,202101,86,76,10,83600,11000,94600
250150,202101,596,426,170,468600,187000,655600
250153,202101,11,8,3,8800,3300,12100
250157,202101,31,25,6,27500,6600,34100
250160,202101,234,185,49,203500,53900,257400
250170,202101,65,42,23,46200,25300,71500
250180,202101,4357,2936,1421,3232900,1563100,4796000
250190,202101,836,546,290,600600,320100,920700
250200,202101,48,39,9,42900,9900,52800
250205,202101,23,20,3,22000,3300,25300
250210,202101,86,75,11,82500,12100,94600
250215,202101,67,53,14,58300,15400,73700
250220,202101,25,18,7,19800,7700,27500
250230,202101,76,68,8,74800,8800,83600
250240,202101,233,186,47,204600,51700,256300
250250,202101,392,333,59,366300,64900,431200
250260,202101,43,36,7,39600,7700,47300
250270,202101,76,54,22,59400,24200,83600
250280,202101,378,309,69,339900,75900,415800
250290,202101,91,83,8,91300,8800,100100
250300,202101,547,369,178,405900,195800,601700
250310,202101,49,41,8,45100,8800,53900
250320,202101,1951,1302,649,1434400,713900,2148300
250330,202101,100,84,16,92400,17600,110000
250340,202101,26,24,2,26400,2200,28600
250350,202101,177,113,64,124300,70400,194700
250355,202101,31,24,7,26400,7700,34100
250360,202101,197,162,35,178200,38500,216700
250370,202101,2402,1560,842,1716000,926200,2642200
250375,202101,12,7,5,7700,5500,13200
250380,202101,53,42,11,46200,12100,58300
250390,202101,46,35,11,38500,12100,50600
250400,202101,16456,8270,8186,9105781.02,9020000,18125781.02
250403,202101,331,266,65,292600,71500,364100
250407,202101,63,51,12,56100,13200,69300
250410,202101,30,26,4,28600,4400,33000
250415,202101,42,29,13,31900,14300,46200
250420,202101,43,37,6,40700,6600,47300
250430,202101,1444,1243,201,1367575,221100,1588675
250435,202101,19,14,5,15400,5500,20900
250440,202101,680,564,116,620400,127600,748000
250450,202101,84,65,19,71500,20900,92400
250460,202101,466,302,164,332200,181500,513700
250470,202101,92,63,29,69300,31900,101200
250480,202101,330,263,67,289300,73700,363000
250485,202101,2,2,0,2200,0,2200
250490,202101,228,182,46,200200,51700,251900
250500,202101,97,71,26,78100,28600,106700
250510,202101,775,612,163,673200,179300,852500
250520,202101,178,120,58,132000,64900,196900
250523,202101,121,96,25,105600,27500,133100
250527,202101,104,80,24,88000,26400,114400
250530,202101,10,6,4,6600,4400,11000
250535,202101,33,24,9,26400,9900,36300
250540,202101,132,102,30,112200,33000,145200
250550,202101,72,69,3,75900,3300,79200
250560,202101,49,36,13,39600,14300,53900
250570,202101,163,135,28,148500,30800,179300
250580,202101,106,82,24,90271,26400,116671
250590,202101,24,14,10,15400,11000,26400
250600,202101,1427,930,497,1023000.7,547800,1570800.7
250610,202101,162,133,29,146300,31900,178200
250620,202101,20,16,4,17600,4400,22000
250625,202101,71,53,18,58300,19800,78100
250630,202101,3074,1962,1112,2160400.62,1228700,3389100.62
250640,202101,222,176,46,193600,50600,244200
250650,202101,30,20,10,22000,11000,33000
250660,202101,51,39,12,42900,13200,56100
250670,202101,63,46,17,50600,18700,69300
250680,202101,409,328,81,360800,89100,449900
250690,202101,2077,1431,646,1576300.7,711700,2288000.7
250700,202101,930,799,131,880000,144100,1024100
250710,202101,434,336,98,370700,107800,478500
250720,202101,114,82,32,90200,35200,125400
250730,202101,387,322,65,354200,71500,425700
250740,202101,52,48,4,52800,4400,57200
250750,202101,22461,13405,9056,14754181.41,9971500.64,24725682.05
250760,202101,106,82,24,90200,26400,116600
250770,202101,366,239,127,262900,139700,402600
250780,202101,68,44,24,48400,26400,74800
250790,202101,464,303,161,333300,177100,510400
250800,202101,154,139,15,152900,16500,169400
250810,202101,75,60,15,66000,16500,82500
250820,202101,149,124,25,136400,27500,163900
250830,202101,437,290,147,319000,162800,481800
250840,202101,55,49,6,53900,6600,60500
250850,202101,56,46,10,50600,11000,61600
250855,202101,14,12,2,13200,2200,15400
250860,202101,223,151,72,166100,79200,245300
250870,202101,28,23,5,25300,5500,30800
250880,202101,86,62,24,68200,26400,94600
250890,202101,2847,2114,733,2325400,806300,3131700
250900,202101,51,42,9,46200,9900,56100
250905,202101,117,88,29,96800,31900,128700
250910,202101,1109,807,302,887700,333300,1221000
250915,202101,103,74,29,81400,31900,113300
250920,202101,139,100,39,111100,44000,155100
250930,202101,178,103,75,113300,83600,196900
250933,202101,6,4,2,4400,2200,6600
250937,202101,10,10,0,11000,0,11000
250939,202101,30,22,8,24200,8800,33000
250940,202101,104,75,29,82500,31900,114400
250950,202101,72,49,23,53900,25300,79200
250960,202101,92,51,41,56100,45100,101200
250970,202101,1207,853,354,938300,390500,1328800
250980,202101,102,67,35,73700,38500,112200
250990,202101,166,129,37,141900,40700,182600
251000,202101,74,67,7,73700,7700,81400
251010,202101,112,83,29,91300,31900,123200
251020,202101,76,62,14,68200,15400,83600
251030,202101,47,35,12,38500,13200,51700
251040,202101,56,38,18,41800,19800,61600
251050,202101,24,21,3,23100,3300,26400
251060,202101,50,40,10,44000,11000,55000
251065,202101,4,3,1,3300,1100,4400
251070,202101,20,16,4,17600,4400,22000
251080,202101,5078,2402,2676,2643300,2944700.1,5588000.1
251090,202101,178,151,27,166100,29700,195800
251100,202101,19,18,1,19800,1100,20900
251110,202101,47,37,10,40700,11000,51700
251120,202101,1858,1131,727,1244100,799700,2043800
251130,202101,409,334,75,367400,83600,451000
251140,202101,561,360,201,396000,221100,617100
251150,202101,342,287,55,315700,60500,376200
251160,202101,91,75,16,82500,17600,100100
251170,202101,101,81,20,89100,22000,111100
251180,202101,285,173,112,190300,123200,313500
251190,202101,202,131,71,144100,78100,222200
251200,202101,267,215,52,237600,57200,294800
251203,202101,33,31,2,34100,2200,36300
251207,202101,86,70,16,77000,17600,94600
251210,202101,1459,1063,396,1169300,435600,1604900
251220,202101,50,38,12,41800,13200,55000
251230,202101,593,494,99,544500,108900,653400
251240,202101,99,69,30,75900,33000,108900
251250,202101,1417,1017,400,1118700,440000,1558700
251260,202101,12,7,5,7700,5500,13200
251270,202101,319,246,73,270600,80300,350900
251272,202101,61,55,6,60500,6600,67100
251274,202101,29,22,7,24200,7700,31900
251275,202101,35,20,15,22000,16500,38500
251276,202101,17,13,4,14300,4400,18700
251278,202101,9,7,2,7700,2200,9900
251280,202101,105,98,7,107800,7700,115500
251290,202101,836,588,248,646800,272800,919600
251300,202101,15,12,3,13200,3300,16500
251310,202101,296,214,82,235400,90200,325600
251315,202101,33,29,4,31900,4400,36300
251320,202101,63,48,15,52800,16500,69300
251330,202101,77,68,9,74800,9900,84700
251335,202101,15,10,5,11000,5500,16500
251340,202101,744,437,307,480700,337700,818400
251350,202101,34,33,1,36300,1100,37400
251360,202101,83,72,11,79200,12100,91300
251365,202101,11,11,0,12100,0,12100
251370,202101,5548,3708,1840,4082100.32,2025100,6107200.32
251380,202101,45,35,10,38500,11000,49500
251385,202101,1,1,0,1100,0,1100
251390,202101,822,613,209,674300,229900,904200
251392,202101,18,10,8,11000,8800,19800
251394,202101,9,9,0,9900,0,9900
251396,202101,11,7,4,7700,4400,12100
251398,202101,17,15,2,16500,2200,18700
251400,202101,42,34,8,37400,8800,46200
251410,202101,38,32,6,35200,6600,41800
251420,202101,102,73,29,80300,31900,112200
251430,202101,45,41,4,45100,4400,49500
251440,202101,44,25,19,27500,20900,48400
251445,202101,51,45,6,49500,6600,56100
251450,202101,406,352,54,387200,59400,446600
251455,202101,3,2,1,2200,1100,3300
251460,202101,16,14,2,15400,2200,17600
251465,202101,7,4,3,4400,3300,7700
251470,202101,50,39,11,42900,12100,55000
251480,202101,26,21,5,23100,5500,28600
251490,202101,123,79,44,86900,48400,135300
251500,202101,128,104,24,115500,26400,141900
251510,202101,61,38,23,41800,25300,67100
251520,202101,30,29,1,31900,1100,33000
251530,202101,4487,3162,1325,3479300,1459700,4939000
251540,202101,77,65,12,71500,13200,84700
251550,202101,411,309,102,339900,113300,453200
251560,202101,24,16,8,17600,8800,26400
251570,202101,20,17,3,18700,3300,22000
251580,202101,134,105,29,115500,31900,147400
251590,202101,114,82,32,90407.9,35200,125607.9
251593,202101,24,14,10,15400,11000,26400
251597,202101,102,81,21,89100,23100,112200
251600,202101,1106,776,330,853600,364100,1217700
251610,202101,240,179,61,196900,67100,264000
251615,202101,11,10,1,11000,1100,12100
251620,202101,4245,2757,1488,3032700,1636800,4669500
251630,202101,467,344,123,378400,135300,513700
251640,202101,141,101,40,111100,44000,155100
251650,202101,279,200,79,220000,86900,306900
251660,202101,184,164,20,180400,22000,202400
251670,202101,372,289,83,317900,91300,409200
251675,202101,8,6,2,6600,2200,8800
251680,202101,98,86,12,94600,13200,107800
251690,202101,320,263,57,289300,62700,352000
251700,202101,288,247,41,271700,45100,316800
251710,202101,22,14,8,15400,8800,24200
251720,202101,22,15,7,16500,7700,24200
251740,202101,12,9,3,9900,3300,13200
260005,202101,3325,1790,1535,1968532.93,1688500,3657032.93
260010,202101,1634,1178,456,1296900.14,501600,1798500.14
260020,202101,412,356,56,391600,61600,453200
260030,202101,595,410,185,452100,203500,655600
260040,202101,813,504,309,554400,339900,894300
260050,202101,1155,821,334,903100,367400,1270500
260060,202101,377,342,35,376200,38500,414700
260070,202101,1342,827,515,909700,566500,1476200
260080,202101,722,556,166,611600,182600,794200
260090,202101,495,326,169,358600,185900,544500
260100,202101,218,153,65,168300,72600,240900
260105,202101,242,133,109,146300,119900,266200
260110,202101,2858,2086,772,2294600,850300,3144900
260120,202101,2869,1450,1419,1595293,1564200,3159493
260130,202101,173,117,56,128700,61600,190300
260140,202101,2113,1364,749,1500400.48,823900,2324300.48
260150,202101,206,131,75,144100,82500,226600
260160,202101,313,259,54,284900,59400,344300
260170,202101,3353,1989,1364,2187900,1500400,3688300
260180,202101,158,125,33,138526.66,36300,174826.66
260190,202101,2334,1566,768,1722600,845900,2568500
260200,202101,962,769,193,845900.63,212300,1058200.63
260210,202101,1410,993,417,1092300.01,458700,1551000.01
260220,202101,679,612,67,673200,73700,746900
260230,202101,1220,912,308,1004300,338800,1343100
260240,202101,212,159,53,174900,58300,233200
260250,202101,89,64,25,70400,27500,97900
260260,202101,1039,726,313,799700,344300,1144000
260270,202101,406,319,87,350900,95700,446600
260280,202101,1218,903,315,994400,346500,1340900
260290,202101,6551,3516,3035,3873100,3344000.59,7217100.59
260300,202101,949,811,138,894300,151800,1046100
260310,202101,514,410,104,451000,114400,565400
260320,202101,856,624,232,686400,255200,941600
260330,202101,66,45,21,49500,23100,72600
260340,202101,76,56,20,61600,22000,83600
260345,202101,5490,2959,2531,3254900.4,2788500,6043400.4
260350,202101,481,341,140,375100,154000,529100
260360,202101,240,133,107,146300,117700,264000
260370,202101,764,481,283,529100,311300,840400
260380,202101,584,429,155,471900,170500.6,642400.6
260390,202101,288,240,48,264000,52800,316800
260392,202101,107,92,15,101200,16500,117700
260400,202101,4219,2392,1827,2632300.5,2010800,4643100.5
260410,202101,14735,7686,7049,8454601.63,7763800.5,16218402.13
260415,202101,141,123,18,135300,19800,155100
260420,202101,1724,1049,675,1153900.5,743600,1897500.5
260430,202101,182,168,14,184800.48,15400,200200.48
260440,202101,194,138,56,152900,61600,214500
260450,202101,430,316,114,347601.13,125400,473001.13
260460,202101,813,424,389,466400,427900,894300
260470,202101,342,210,132,231000,145200,376200
260480,202101,242,155,87,170500,95700,266200
260490,202101,209,174,35,191400,38500,229900
260500,202101,1119,759,360,834900,396000,1230900
260510,202101,773,614,159,675400,174900,850300
260515,202101,232,210,22,231000,24200,255200
260520,202101,3266,2014,1252,2216500,1377200,3593700
260530,202101,793,648,145,712800,159500,872300
260540,202101,546,429,117,471900,128700,600600
260545,202101,15,11,4,12100,4400,16500
260550,202101,324,201,123,221100,135300,356400
260560,202101,510,383,127,421300,139700,561000
260570,202101,969,779,190,856900,209000,1065900
260580,202101,248,215,33,236500,36300,272800
260590,202101,636,365,271,401500,298100,699600
260600,202101,8079,4345,3734,4782801.78,4111800,8894601.78
260610,202101,490,325,165,357500,182600,540100
260620,202101,3666,1889,1777,2079000,1954700.19,4033700.19
260630,202101,79,74,5,81400,5500,86900
260640,202101,3472,1924,1548,2116400,1706100,3822500
260650,202101,325,234,91,257400,100100,357500
260660,202101,559,355,204,390500,224400,614900
260670,202101,103,74,29,81400,31900,113300
260680,202101,3773,2064,1709,2271500.5,1881000,4152500.5
260690,202101,123,88,35,96800,38500,135300
260700,202101,307,206,101,226600,111100,337700
260710,202101,44,35,9,38500,9900,48400
260720,202101,2477,1447,1030,1595000,1133000,2728000
260730,202101,704,525,179,577500,198000,775500
260740,202101,65,58,7,63800,7700,71500
260750,202101,591,418,173,459800,190300,650100
260760,202101,669,337,332,370700.3,365200,735900.3
260765,202101,984,510,474,561000,521400,1082400
260770,202101,220,161,59,177081,64900,241981
260775,202101,771,430,341,473000,375100,848100
260780,202101,244,151,93,166100,102300,268400
260790,202101,14304,7227,7077,7953000,7792400,15745400
260795,202101,168,109,59,119900,64900,184800
260800,202101,290,237,53,261800,58300,320100
260805,202101,177,117,60,128700,66000,194700
260810,202101,765,651,114,716100,125400,841500
260820,202101,286,180,106,198000,116600,314600
260825,202101,216,143,73,157300,80300,237600
260830,202101,311,182,129,200200,141900,342100
260840,202101,239,174,65,191400,71500,262900
260845,202101,167,114,53,125400,58300,183700
260850,202101,437,320,117,353100,128700,481800
260860,202101,252,191,61,210100,67100,277200
260870,202101,366,275,91,302500.2,100100,402600.2
260875,202101,728,515,213,566500,234300,800800
260880,202101,1598,1010,588,1112100,646800,1758900
260890,202101,2352,1658,694,1823800,763400,2587200
260900,202101,986,696,290,766700,319000,1085700
260910,202101,254,201,53,222200,58300,280500
260915,202101,290,214,76,236500,84700,321200
260920,202101,186,98,88,107800,96800,204600
260930,202101,390,330,60,363000,66000,429000
260940,202101,2679,1444,1235,1589500,1359600,2949100
260950,202101,2013,1147,866,1262800,954800,2217600
260960,202101,13708,6859,6849,7550401.08,7548200.5,15098601.58
260970,202101,416,346,70,380600,77000,457600
260980,202101,192,171,21,188100,23100,211200
260990,202101,2623,2114,509,2326500,559900,2886400
261000,202101,4214,2532,1682,2786300,1851300,4637600
261010,202101,225,117,108,128700,118800,247500
261020,202101,599,446,153,490600.47,168300,658900.47
261030,202101,265,178,87,195800,95700,291500
261040,202101,367,319,48,350900,52800,403700
261050,202101,508,437,71,480700,78100,558800
261060,202101,1387,874,513,962500,564300,1526800
261070,202101,8877,4289,4588,4720100,5050100.5,9770200.5
261080,202101,371,283,88,311300,96800,408100
261090,202101,2163,1648,515,1817202.03,572000.3,2389202.33
261100,202101,1162,811,351,892100,386100,1278200
261110,202101,8737,5318,3419,5854200.03,3764200,9618400.03
261120,202101,259,221,38,243100,41800,284900
261130,202101,570,343,227,377300,249700,627000
261140,202101,204,126,78,138600,85800,224400
261150,202101,688,426,262,468600.56,288200,756800.56
261153,202101,70,64,6,70400,6600,77000
261160,202101,74734,36765,37969,40467991.94,41806601.92,82274593.86
261170,202101,466,345,121,379500,133100,512600
261180,202101,1783,1109,674,1221000,741400,1962400
261190,202101,619,435,184,478500,202400,680900
261200,202101,218,182,36,201300,39600,240900
261210,202101,32,28,4,30800,4400,35200
261220,202101,2731,1915,816,2107600.66,897600,3005200.66
261230,202101,335,247,88,271700,96800,368500
261240,202101,449,392,57,431200,62700,493900
261245,202101,239,197,42,216700,46200,262900
261247,202101,170,132,38,145200,41800,187000
261250,202101,3204,1555,1649,1711600,1816100,3527700
261255,202101,243,219,24,240900,27500,268400
261260,202101,842,729,113,803000.12,125400,928400.12
261270,202101,203,145,58,159500,63800,223300
261280,202101,173,140,33,154000,36300,190300
261290,202101,113,82,31,90200,34100,124300
261300,202101,1286,942,344,1036200,378400,1414600
261310,202101,802,536,266,589600,292600,882200
261320,202101,575,370,205,407000,225500,632500
261330,202101,951,731,220,804100,242000.63,1046100.63
261340,202101,300,167,133,183700,146300,330000
261350,202101,846,595,251,654500,276100,930600
261360,202101,1278,827,451,910800,497200,1408000
261370,202101,4834,2866,1968,3155900,2170300,5326200
261380,202101,550,419,131,460900.78,144100,605000.78
261390,202101,3594,2411,1183,2652100,1302400,3954500
261400,202101,294,265,29,291500,31900,323400
261410,202101,1102,722,380,795300,418000,1213300
261420,202101,893,550,343,605000.32,377300,982300.32
261430,202101,324,293,31,322300,34100,356400
261440,202101,116,107,9,117700,9900,127600
261450,202101,2528,2013,515,2216500,566500,2783000
261460,202101,719,566,153,622600,168300,790900
261470,202101,239,190,49,209000,53900,262900
261480,202101,449,348,101,382800,113250.5,496050.5
261485,202101,358,214,144,235400,158400,393800
261500,202101,611,412,199,453200.59,220000,673200.59
261510,202101,52,33,19,36300,20900,57200
261520,202101,93,81,12,89100,13200,102300
261530,202101,4115,2608,1507,2871000.09,1659900,4530900.09
261540,202101,1352,793,559,872300,616000,1488300
261550,202101,249,117,132,128700,145200,273900
261560,202101,853,558,295,613800,324500,938300
261570,202101,397,311,86,342100,95700,437800
261580,202101,375,292,83,321200,91300,412500
261590,202101,187,150,37,165000,40700,205700
261600,202101,288,230,58,254100,63800,317900
261610,202101,86,73,13,80300,14300,94600
261618,202101,74,59,15,64900,16500,81400
261620,202101,198,123,75,135300,82500,217800
261630,202101,543,425,118,467500,129800,597300
261640,202101,6431,3355,3076,3693801.05,3386900,7080701.05
261650,202101,487,308,179,338800,196900,535700
270010,202101,513,453,60,499400,66000,565400
270020,202101,281,229,52,251900,57200,309100
270030,202101,8795,5656,3139,6223838.22,3455100,9678938.22
270040,202101,2031,1285,746,1413500,820600,2234100
270050,202101,161,125,36,138600,39600,178200
270060,202101,109,60,49,66000,53900,119900
270070,202101,859,628,231,691900,254100,946000
270080,202101,37,31,6,34100,6600,40700
270090,202101,23,17,6,18700,6600,25300
270100,202101,1247,841,406,925430,446600,1372030
270110,202101,102,84,18,92400,19800,112200
270120,202101,223,181,42,199100,46200,245300
270130,202101,290,206,84,226600,92400,319000
270135,202101,113,71,42,78100,47300,125400
270140,202101,1365,869,496,956780,546700,1503480
270150,202101,251,197,54,216700,59400,276100
270160,202101,497,393,104,433400,114400,547800
270170,202101,806,520,286,572000,314600,886600
270180,202101,55,42,13,46200,14300,60500
270190,202101,89,77,12,84700,13200,97900
270200,202101,109,94,15,103400,16500,119900
270210,202101,525,300,225,330000,247500,577500
270220,202101,179,140,39,154000,42900,196900
270230,202101,2120,1289,831,1420100,915200,2335300
270235,202101,682,532,150,586300,165000,751300
270240,202101,2977,2355,622,2591600.93,684200,3275800.93
270250,202101,157,115,42,126500,46200,172700
270255,202101,217,188,29,206836.66,31900,238736.66
270260,202101,367,299,68,328900,74800,403700
270270,202101,101,46,55,50600,60500,111100
270280,202101,238,136,102,149600,112200,261800
270290,202101,1155,888,267,976800,293700,1270500
270300,202101,322,227,95,249700,104500,354200
270310,202101,847,701,146,771100,160600,931700
270320,202101,826,704,122,774400.63,134200,908600.63
270330,202101,297,248,49,272800,53900,326700
270340,202101,56,43,13,47300,14300,61600
270350,202101,90,52,38,57200,41800,99000
270360,202101,70,40,30,44000,33000,77000
270370,202101,57,46,11,50600,12100,62700
270375,202101,72,43,29,47300,31900,79200
270380,202101,1013,649,364,713900.6,400400,1114300.6
270390,202101,186,113,73,124300,80300,204600
270400,202101,713,533,180,586300.2,198000,784300.2
270410,202101,657,481,176,529100,193600,722700
270420,202101,396,270,126,297000,138600,435600
270430,202101,32980,23656,9324,26033664.96,10270201.18,36303866.14
270440,202101,478,377,101,414736.66,111100,525836.66
270450,202101,800,455,345,500536.66,379500,880036.66
270460,202101,183,146,37,160600,40700,201300
270470,202101,1478,1021,457,1123136.66,504900,1628036.66
270480,202101,537,441,96,485100,105600,590700
270490,202101,22,17,5,18700,5500,24200
270500,202101,494,414,80,455400,88000,543400
270510,202101,813,507,306,557700,337700,895400
270520,202101,290,186,104,204600,114400,319000
270530,202101,66,59,7,64900,7700,72600
270540,202101,100,77,23,84700,25300,110000
270550,202101,1728,1324,404,1457500,444400,1901900
270560,202101,268,149,119,163900,132000,295900
270570,202101,525,368,157,404800,172700,577500
270580,202101,88,69,19,75900,20900,96800
270590,202101,65,52,13,57200,14300,71500
270600,202101,175,146,29,160600,31900,192500
270610,202101,263,175,88,192500,96800,289300
270620,202101,17,17,0,18700,0,18700
270630,202101,3730,2831,899,3115200,990000,4105200
270640,202101,868,643,225,707300,247500,954800
270642,202101,210,178,32,195800,36300,232100
270644,202101,257,165,92,181500,101200,282700
270650,202101,326,194,132,213400,145200,358600
270660,202101,237,200,37,220000,40700,260700
270670,202101,3042,2304,738,2534401.01,812900,3347301.01
270680,202101,424,252,172,277200,189200,466400
270690,202101,1174,772,402,849200,443300,1292500
270700,202101,27,22,5,24200,5500,29700
270710,202101,866,682,184,750200,202400,952600
270720,202101,238,186,52,204600,57200,261800
270730,202101,1854,1119,735,1232000,808500,2040500
270740,202101,45,32,13,35200,14300,49500
270750,202101,644,484,160,532400,176000,708400
270760,202101,290,208,82,228800,90200,319000
270770,202101,2737,1812,925,1994300,1017500,3011800
270780,202101,73,47,26,51700,28600,80300
270790,202101,267,172,95,189200,104500,293700
270800,202101,2055,1617,438,1779800,481800,2261600
270810,202101,228,187,41,205700,45100,250800
270820,202101,141,97,44,106700,48400,155100
270830,202101,785,587,198,645700,217800,863500
270840,202101,1362,1034,328,1138830.4,360800,1499630.4
270850,202101,1486,927,559,1021350,616000,1637350
270860,202101,2566,1703,863,1873337.36,951500,2824837.36
270870,202101,117,64,53,70400,58300,128700
270880,202101,889,698,191,767800,210100,977900
270890,202101,289,214,75,235400,82500,317900
270895,202101,49,45,4,49500,4400,53900
270900,202101,87,67,20,73700,22000,95700
270910,202101,306,249,57,273900,62700,336600
270915,202101,1891,1214,677,1335656.66,744700,2080356.66
270920,202101,464,387,77,425700,84700,510400
270930,202101,5925,4437,1488,4880700,1639000.14,6519700.14
270940,202101,2253,1765,488,1941500,536800,2478300
280010,202101,38,32,6,35200,6600,41800
280020,202101,487,415,72,456500,79200,535700
280030,202101,20661,13343,7318,14685331.98,8053101.25,22738433.23
280040,202101,331,216,115,238700,127600,366300
280050,202101,408,313,95,344300,104500,448800
280060,202101,346,221,125,243100,137500,380600
280067,202101,1072,775,297,853600,327800.5,1181400.5
280070,202101,123,99,24,110000,26400,136400
280100,202101,641,493,148,542300,162800,705100
280110,202101,72,67,5,73700,5500,79200
280120,202101,657,538,119,591800,130900,722700
280130,202101,1748,1146,602,1260600,662200,1922800
280140,202101,481,395,86,434500,94600,529100
280150,202101,402,282,120,310200,132000,442200
280160,202101,118,98,20,108900,22000,130900
280170,202101,402,279,123,306900,135300,442200
280190,202101,25,22,3,24200,3300,27500
280200,202101,29,25,4,27500,4400,31900
280210,202101,2933,2108,825,2318669.6,907500,3226169.6
280220,202101,38,31,7,34100,7700,41800
280230,202101,326,266,60,292600,66000,358600
280240,202101,124,118,6,129800,6600,136400
280250,202101,18,10,8,11000,8800,19800
280260,202101,77,70,7,77000,7700,84700
280270,202101,151,117,34,128700,37400,166100
280280,202101,199,128,71,140800.5,78100,218900.5
280290,202101,3360,2426,934,2668529.87,1027400,3695929.87
280300,202101,1600,1251,349,1376100,383900,1760000
280310,202101,100,95,5,104500,5500,110000
280320,202101,644,452,192,497200,211200,708400
280330,202101,322,235,87,258500,95700,354200
280340,202101,406,329,77,361900,84700,446600
280350,202101,3682,2853,829,3138300.66,911900.08,4050200.74
280360,202101,480,326,154,358600,169400,528000
280370,202101,95,83,12,91300,13200,104500
280380,202101,52,40,12,44000,13200,57200
280390,202101,174,149,25,163900,27500,191400
280400,202101,355,245,110,269500,121000,390500
280410,202101,286,236,50,259600,55000,314600
280420,202101,168,142,26,157300,28600,185900
280430,202101,52,40,12,44000,13200,57200
280440,202101,694,544,150,598400,165000,763400
280445,202101,119,108,11,118800,12100,130900
280450,202101,1196,1035,161,1140700,177100,1317800
280460,202101,622,455,167,500500.93,183700,684200.93
280470,202101,181,170,11,187000,12100,199100
280480,202101,2711,1885,826,2075701.67,908600.5,2984302.17
280490,202101,257,241,16,265100.96,17600,282700.96
280500,202101,44,40,4,44000,4400,48400
280510,202101,139,112,27,123200,29700,152900
280520,202101,52,38,14,41800,15400,57200
280530,202101,80,50,30,55000,33000,88000
280540,202101,533,448,85,493900,94600,588500
280550,202101,733,676,57,743600.65,62700,806300.65
280560,202101,492,436,56,479600,61600,541200
280570,202101,2205,1721,484,1893100,532400,2425500
280580,202101,587,454,133,499400,146300,645700
280590,202101,212,135,77,148500,84700,233200
280600,202101,383,321,62,354200,68200,422400
280610,202101,110,82,28,90200,30800,121000
280620,202101,550,447,103,491700,113300,605000
280630,202101,154,125,29,137500,31900,169400
280640,202101,192,151,41,167200,45100,212300
280650,202101,93,58,35,63800,38500,102300
280660,202101,142,104,38,114400,41800,156200
280670,202101,1868,1165,703,1281500.85,773300.48,2054801.33
280680,202101,199,174,25,191400,27500,218900
280690,202101,81,72,9,79200,9900,89100
280700,202101,23,23,0,26400,0,26400
280710,202101,1474,1134,340,1247400,374000,1621400
280720,202101,113,73,40,80300,44000,124300
280730,202101,27,22,5,24200,5500,29700
280740,202101,2529,1882,647,2070200,712800,2783000
280750,202101,236,206,30,226600,33000,259600
280760,202101,788,545,243,599500,267300,866800
290010,202101,201,140,61,154000,67100,221100
290020,202101,187,168,19,184800,20900,205700
290030,202101,613,396,217,435600,238700,674300
290035,202101,132,107,25,117700,27500,145200
290040,202101,299,202,97,222200,107800,330000
290050,202101,83,65,18,71500,19800,91300
290060,202101,264,118,146,129800,160600,290400
290070,202101,5704,2737,2967,3011800.69,3268100,6279900.69
290080,202101,451,203,248,223300,272800,496100
290090,202101,377,167,210,183700,232100,415800
290100,202101,1636,1060,576,1167100,633600,1800700
290110,202101,829,481,348,529100.85,382800,911900.85
290115,202101,195,182,13,200200,14300,214500
290120,202101,776,512,264,563200,290400,853600
290130,202101,425,263,162,289300,178200,467500
290135,202101,303,232,71,255200,78100,333300
290140,202101,315,260,55,286000,60500,346500
290150,202101,138,97,41,107800,45100,152900
290160,202101,244,186,58,204600,63800,268400
290170,202101,91,65,26,71500,28600,100100
290180,202101,178,128,50,140800,55000,195800
290190,202101,434,354,80,389400,89100,478500
290195,202101,315,203,112,223300,123200,346500
290200,202101,270,220,50,242000,55000,297000
290205,202101,151,92,59,101200,64900,166100
290210,202101,1163,857,306,942700,336600,1279300
290220,202101,218,119,99,130900,110000,240900
290225,202101,289,119,170,130900,187000,317900
290230,202101,78,49,29,53900,31900,85800
290240,202101,364,130,234,143000,257400,400400
290250,202101,253,233,20,256300,22000,278300
290260,202101,323,267,56,293700,61600,355300
290265,202101,191,164,27,180400,29700,210100
290270,202101,1416,1179,237,1298000,261800,1559800
290280,202101,474,334,140,368500,154000,522500
290290,202101,1332,796,536,876700.94,589600,1466300.94
290300,202101,429,365,64,401500,70400,471900
290310,202101,296,138,158,151800,173800,325600
290320,202101,4026,2483,1543,2731300.11,1700600,4431900.11
290323,202101,189,164,25,181500,27500,209000
290327,202101,169,133,36,147400,39600,187000
290330,202101,112,57,55,62700,60500,123200
290340,202101,819,335,484,368500,532400,900900
290350,202101,634,377,257,414700.67,282700,697400.67
290360,202101,348,268,80,294800.99,88000,382800.99
290370,202101,913,386,527,424600,579700,1004300
290380,202101,323,204,119,224400,130900,355300
290390,202101,2433,1517,916,1668700,1007600,2676300
290395,202101,243,137,106,150700,116600,267300
290400,202101,275,202,73,222200,80300,302500
290405,202101,245,210,35,231000,38500,269500
290410,202101,621,518,103,572000.3,113300,685300.3
290420,202101,252,203,49,224400,53900,278300
290430,202101,474,307,167,337700,183700,521400
290440,202101,76,67,9,73700,9900,83600
290450,202101,197,149,48,163900,52800,216700
290460,202101,1941,1159,782,1274900,860200,2135100
290470,202101,1377,604,773,664400,850300,1514700
290475,202101,551,517,34,569800.08,37400,607200.08
290480,202101,293,166,127,182600,139700,322300
290485,202101,238,217,21,238700,23100,261800
290490,202101,1227,874,353,963600,388300,1351900
290500,202101,741,380,361,419100,397100,816200
290510,202101,228,179,49,196900,53900,250800
290515,202101,158,95,63,104500,69300,173800
290520,202101,1398,914,484,1006500,532400.2,1538900.2
290530,202101,298,275,23,302500,25300,327800
290540,202101,105,55,50,60500,55000,115500
290550,202101,160,135,25,148500,27500,176000
290560,202101,3153,1369,1784,1505900,1964600,3470500
290570,202101,6247,3001,3246,3303300,3570600,6873900
290580,202101,1265,749,516,823900,569800,1393700
290590,202101,570,469,101,517000,111100,628100
290600,202101,1751,1199,552,1321100.67,610500,1931600.67
290610,202101,202,181,21,199100,23100,222200
290620,202101,356,322,34,354200,37400,391600
290630,202101,1999,847,1152,931700,1267200,2198900
290640,202101,145,116,29,127600,31900,159500
290650,202101,1782,830,952,914100.92,1049400,1963500.92
290660,202101,278,226,52,248600,57200,305800
290670,202101,930,481,449,529100,495000,1024100
290680,202101,1228,989,239,1087900,262900,1350800
290682,202101,306,228,78,250800.48,85800,336600.48
290685,202101,240,158,82,173800,90200,264000
290687,202101,1053,676,377,744879,414700,1159579
290689,202101,143,75,68,82500,74800,157300
290690,202101,610,259,351,284900,386100,671000
290700,202101,243,120,123,132000,135300,267300
290710,202101,758,518,240,569800,264000,833800
290720,202101,1025,828,197,910800,217800,1128600
290730,202101,1171,672,499,740300,548900,1289200
290740,202101,18,15,3,16500,3300,19800
290750,202101,1404,622,782,686400,860200,1546600
290755,202101,72,65,7,71500,7700,79200
290760,202101,291,251,40,276100,44000,320100
290770,202101,184,172,12,189200,13200,202400
290780,202101,1112,854,258,939400,283800,1223200
290790,202101,368,256,112,281600,123200,404800
290800,202101,2459,995,1464,1094500,1611500,2706000
290810,202101,466,321,145,353100,159500,512600
290820,202101,401,233,168,256300,184800,441100
290830,202101,424,302,122,332200,134200,466400
290840,202101,1768,1094,674,1203400,742500,1945900
290850,202101,844,435,409,478500,449900,928400
290860,202101,643,288,355,317900,390500,708400
290870,202101,620,442,178,487300,195800,683100
290880,202101,119,64,55,70400,60500,130900
290890,202101,407,266,141,292600,155100,447700
290900,202101,167,126,41,138600,45100,183700
290910,202101,379,285,94,313500,103400,416900
290920,202101,207,180,27,198000,29700,227700
290930,202101,815,618,197,680900,216700,897600
290940,202101,244,205,39,225500,42900,268400
290950,202101,158,95,63,104500,69300,173800
290960,202101,474,333,141,366300,155100,521400
290970,202101,247,216,31,237600,34100,271700
290980,202101,1631,1140,491,1254000,540100,1794100
290990,202101,397,335,62,368500,68200,436700
291000,202101,863,261,602,288200,663300,951500
291005,202101,2321,1006,1315,1106600,1448700.42,2555300.42
291010,202101,164,148,16,162800,17600,180400
291020,202101,101,81,20,89100,22000,111100
291030,202101,98,70,28,77000,30800,107800
291040,202101,614,344,270,378400,297000,675400
291050,202101,1442,788,654,866800,719400,1586200
291060,202101,1555,848,707,932800,777700,1710500
291070,202101,1976,1472,504,1619200.82,554401.3,2173602.12
291072,202101,7162,2646,4516,2913900,4970900,7884800
291075,202101,240,195,45,214500,49500,264000
291077,202101,59,40,19,44000,20900,64900
291080,202101,20295,8778,11517,9658000.75,12678600.55,22336601.30
291085,202101,294,241,53,265100,58300,323400
291090,202101,298,125,173,137500,191400,328900
291100,202101,649,198,451,217800,497200,715000
291110,202101,421,321,100,354200,110000,464200
291120,202101,2378,1189,1189,1307900,1307900,2615800
291125,202101,65,31,34,34100,37400,71500
291130,202101,197,175,22,192500,24200,216700
291140,202101,126,101,25,112200,27500,139700
291150,202101,394,146,248,160600,272800,433400
291160,202101,386,313,73,344300,80300,424600
291165,202101,46,37,9,40700,9900,50600
291170,202101,3133,1546,1587,1700600.5,1746800,3447400.5
291180,202101,1257,506,751,556600,826100,1382700
291185,202101,93,88,5,96800,5500,102300
291190,202101,1389,640,749,704000,823900,1527900
291200,202101,170,124,46,136400,50600,187000
291210,202101,2313,911,1402,1002100,1542200,2544300
291220,202101,277,208,69,228800,75900,304700
291230,202101,973,335,638,368500,701800,1070300
291240,202101,428,397,31,436700,34100,470800
291250,202101,434,351,83,386100,91300,477400
291260,202101,57,48,9,52800,9900,62700
291270,202101,1151,477,674,524700,742500,1267200
291280,202101,351,165,186,181500,204600,386100
291290,202101,1715,885,830,973500,913000,1886500
291300,202101,226,179,47,196900,51700,248600
291310,202101,226,203,23,223300,25300,248600
291320,202101,1359,960,399,1056000,441100,1497100
291330,202101,129,111,18,122100,19800,141900
291340,202101,215,128,87,140800,95700,236500
291345,202101,131,91,40,100100,44000,144100
291350,202101,1649,580,1069,638000,1175900,1813900
291360,202101,8334,4015,4319,4420900,4754200,9175100
291370,202101,1123,649,474,713900,521400,1235300
291380,202101,264,210,54,231000,60500,291500
291390,202101,3915,1712,2203,1883200,2423300,4306500
291400,202101,2077,1482,595,1630200,654500.42,2284700.42
291410,202101,193,168,25,184800,27500,212300
291420,202101,120,88,32,96800,35200,132000
291430,202101,167,90,77,99000,84700.5,183700.5
291440,202101,513,419,94,460900,103400,564300
291450,202101,937,596,341,655600,375100,1030700
291460,202101,1856,1502,354,1654400,389400,2043800
291465,202101,2196,1034,1162,1137400,1278200,2415600
291470,202101,2851,1433,1418,1577400.56,1559800,3137200.56
291480,202101,11798,5193,6605,5715601.62,7269900,12985501.62
291490,202101,610,245,365,269500,401500,671000
291500,202101,377,221,156,243100,171600,414700
291510,202101,1214,466,748,512600,823900,1336500
291520,202101,944,423,521,465300,574200,1039500
291530,202101,933,248,685,273900,753500,1027400
291535,202101,123,100,23,110000,25300,135300
291540,202101,354,110,244,121000,269500,390500
291550,202101,1243,585,658,643500,723800,1367300
291560,202101,5229,2621,2608,2885300,2869900,5755200
291570,202101,206,104,102,114400,112200,226600
291580,202101,1194,739,455,812900,500500,1313400
291590,202101,91,38,53,41800,58300,100100
291600,202101,1137,558,579,613800,636900,1250700
291610,202101,1453,698,755,767800,831600,1599400
291620,202101,566,262,304,289300,334400,623700
291630,202101,479,149,330,163900,363000,526900
291640,202101,3946,1988,1958,2187900,2154900,4342800
291650,202101,428,289,139,317900.5,152900,470800.5
291660,202101,382,155,227,170500,249700,420200
291670,202101,222,133,89,146300,97900,244200
291680,202101,643,386,257,424600,282700,707300
291685,202101,578,322,256,354200,281600,635800
291690,202101,518,312,206,344300,226600.92,570900.92
291700,202101,964,747,217,822800,238700,1061500
291710,202101,1615,778,837,856900,920700,1777600
291720,202101,431,291,140,320100,155100,475200
291730,202101,923,536,387,589600,425700,1015300
291733,202101,290,196,94,215600,103400,319000
291735,202101,72,56,16,61600,17600,79200
291740,202101,356,270,86,298100,94600,392700
291750,202101,2173,1406,767,1547701.11,844800,2392501.11
291760,202101,2937,1632,1305,1795200,1439900,3235100
291770,202101,766,517,249,568700,273900,842600
291780,202101,57,35,22,38500,24200,62700
291790,202101,156,80,76,88000,83600,171600
291800,202101,10045,4160,5885,4582601.02,6483400,11066001.02
291810,202101,1099,820,279,902000,306900,1208900
291820,202101,275,198,77,217800,85800,303600
291830,202101,1051,424,627,466400.59,689700,1156100.59
291835,202101,560,520,40,572000,44000,616000
291840,202101,4902,2470,2432,2717000,2676300,5393300
291845,202101,273,88,185,96800,203500,300300
291850,202101,325,288,37,316800,40700,357500
291855,202101,257,102,155,112200,170500,282700
291860,202101,169,105,64,116600,70400,187000
291870,202101,83,35,48,38500,52800,91300
291875,202101,178,164,14,180400,15400,195800
291880,202101,451,359,92,394900,101200,496100
291890,202101,248,80,168,88000,184800,272800
291900,202101,59,33,26,36300,28600,64900
291905,202101,126,92,34,101200,37400,138600
291910,202101,155,126,29,138600,31900,170500
291915,202101,430,380,50,419100,55000,474100
291920,202101,5124,2527,2597,2784100,2857800,5641900
291930,202101,169,100,69,110000.27,75900,185900.27
291940,202101,355,204,151,224400,166100,390500
291950,202101,1137,913,224,1005400,247500,1252900
291955,202101,1261,756,505,832700,555500,1388200
291960,202101,190,137,53,150700,58300,209000
291970,202101,753,570,183,627000,201300,828300
291980,202101,1499,1321,178,1453100.73,195800,1648900.73
291990,202101,138,128,10,140800,11000,151800
291992,202101,169,87,82,95700,90200,185900
291995,202101,187,122,65,134200,71500,205700
292000,202101,395,302,93,332200,102300,434500
292010,202101,314,216,98,237600,107800,345400
292020,202101,300,220,80,242000,88000,330000
292030,202101,145,111,34,122100,37400,159500
292040,202101,626,319,307,350900,337700,688600
292045,202101,108,97,11,106700,12100,118800
292050,202101,942,684,258,752400,284900,1037300
292060,202101,902,742,160,817300,178200,995500
292070,202101,63,18,45,19800,49500,69300
292080,202101,137,92,45,101200,49500,150700
292090,202101,543,188,355,206800,390500,597300
292100,202101,1479,627,852,689700,937200,1626900
292105,202101,187,166,21,182600,23100,205700
292110,202101,2267,821,1446,903100,1592800,2495900
292120,202101,688,541,147,595100,161700,756800
292130,202101,445,248,197,272800,216700,489500
292140,202101,207,168,39,184800,42900,227700
292145,202101,162,87,75,95700,82500,178200
292150,202101,1482,1210,272,1331000,299200,1630200
292160,202101,166,134,32,147400,35200,182600
292170,202101,1185,1027,158,1129700,173800,1303500
292180,202101,222,164,58,180400,63800,244200
292190,202101,160,104,56,114400,61600,176000
292200,202101,1352,488,864,536800,951500,1488300
292205,202101,125,108,17,118800,18700,137500
292210,202101,363,252,111,277200,122100,399300
292220,202101,31,22,9,24200,9900,34100
292225,202101,38,31,7,34100,7700,41800
292230,202101,955,753,202,828300,222200,1050500
292240,202101,607,441,166,485100,182600,667700
292250,202101,1704,1113,591,1224300,650100,1874400
292260,202101,403,239,164,262900,180400,443300
292265,202101,246,177,69,194700,75900,270600
292270,202101,732,338,394,371800,433400,805200
292273,202101,206,114,92,125400,101200,226600
292275,202101,170,84,86,92400,94600,187000
292280,202101,143,100,43,110000,47300,157300
292285,202101,75,61,14,67100,15400,82500
292290,202101,572,382,190,420200,209000,629200
292300,202101,1698,630,1068,693000,1175900,1868900
292303,202101,115,73,42,80300,46200,126500
292305,202101,114,84,30,92400,33000,125400
292310,202101,929,599,330,660000,364100,1024100
292320,202101,591,446,145,490600,159500,650100
292330,202101,177,102,75,112200,82500,194700
292335,202101,275,216,59,239800,64900,304700
292340,202101,578,401,177,441100,194700,635800
292350,202101,268,145,123,159500,135300,294800
292360,202101,702,535,167,588500,183700,772200
292370,202101,734,560,174,616000,191400,807400
292380,202101,631,510,121,561000,133100,694100
292390,202101,462,182,280,200200,308000,508200
292400,202101,3589,2225,1364,2450506.66,1502600,3953106.66
292405,202101,265,176,89,194700,97900,292600
292410,202101,132,80,52,88000,57200,145200
292420,202101,297,258,39,283800,42900,326700
292430,202101,543,407,136,447700,149600,597300
292440,202101,601,511,90,562100.56,99000,661100.56
292450,202101,239,186,53,204600,58300,262900
292460,202101,543,405,138,445500,152900,598400
292465,202101,208,175,33,192500,36300,228800
292467,202101,139,85,54,93500,59400,152900
292470,202101,289,195,94,215600,103400,319000
292480,202101,362,247,115,271700,127600,399300
292490,202101,241,170,71,187000,78100,265100
292500,202101,858,379,479,416900.32,528000,944900.32
292510,202101,3434,1585,1849,1743500,2035000,3778500
292520,202101,1090,505,585,555500,644600,1200100
292525,202101,401,285,116,313500,127600,441100
292530,202101,4420,1749,2671,1925000.65,2943600,4868600.65
292540,202101,481,269,212,295900,233200,529100
292550,202101,1100,579,521,638000,573100,1211100
292560,202101,329,306,23,336600,25300,361900
292570,202101,307,239,68,262900,74800,337700
292575,202101,483,321,162,353100,178200,531300
292580,202101,989,651,338,717200,372900,1090100
292590,202101,564,493,71,542300,78100,620400
292593,202101,136,108,28,118800,30800,149600
292595,202101,204,159,45,174900,49500,224400
292600,202101,1248,908,340,998800.63,374000,1372800.63
292610,202101,128,98,30,107800,33000,140800
292620,202101,530,448,82,492800,90200,583000
292630,202101,1438,796,642,875600,706200,1581800
292640,202101,846,586,260,644600,286000,930600
292650,202101,192,160,32,176000,35200,211200
292660,202101,2027,1450,577,1595000,636900.92,2231900.92
292665,202101,145,102,43,112200,47300,159500
292670,202101,387,310,77,341000,84700,425700
292680,202101,259,192,67,211200,73700,284900
292690,202101,193,141,52,155100,57200,212300
292700,202101,975,643,332,707300.9,365200,1072500.9
292710,202101,115,100,15,110000,16500,126500
292720,202101,928,526,402,578600,442200,1020800
292730,202101,198,90,108,99000,118800,217800
292740,202101,69296,33596,35700,36991903.24,39319500.88,76311404.12
292750,202101,392,278,114,305800,125400,431200
292760,202101,337,280,57,308000,62700,370700
292770,202101,822,346,476,380600,524700,905300
292780,202101,412,158,254,173800,279400,453200
292790,202101,776,399,377,438900,414700,853600
292800,202101,1253,744,509,819500,559900,1379400
292805,202101,396,124,272,136400,299200,435600
292810,202101,1503,853,650,938300,715000,1653300
292820,202101,713,602,111,662200,122100,784300
292830,202101,111,90,21,99000,23100,122100
292840,202101,689,562,127,618200,139700,757900
292850,202101,144,95,49,104500,53900,158400
292860,202101,2140,1238,902,1366200,992200,2358400
292870,202101,3505,2320,1185,2553100,1304600,3857700
292880,202101,1491,980,511,1079100,563200,1642300
292890,202101,517,437,80,480700,88000,568700
292895,202101,142,94,48,103400,52800,156200
292900,202101,376,269,107,295900,117700,413600
292905,202101,484,238,246,261800,270600,532400
292910,202101,461,346,115,382800,126500,509300
292920,202101,523,229,294,251900,323400,575300
292925,202101,498,455,43,500500,47300,547800
292930,202101,628,375,253,413600,278300,691900
292935,202101,288,123,165,135300,181500,316800
292937,202101,222,151,71,167200,78100,245300
292940,202101,193,148,45,162800,49500,212300
292950,202101,1171,580,591,638000,650100.6,1288100.6
292960,202101,578,408,170,448800,187000,635800
292970,202101,239,168,71,184800.48,78100,262900.48
292975,202101,109,64,45,70400,49500,119900
292980,202101,290,198,92,217800.61,101200,319000.61
292990,202101,1316,972,344,1070300,378400,1448700
293000,202101,115,80,35,88000,38500,126500
293010,202101,2798,1649,1149,1816100,1266100.5,3082200.5
293015,202101,630,514,116,565400,127600,693000
293020,202101,330,270,60,297000,66000,363000
293030,202101,607,528,79,580800,86900,667700
293040,202101,361,285,76,313500,83600,397100
293050,202101,2871,1686,1185,1855700,1303500,3159200
293060,202101,258,206,52,226600.48,57200,283800.48
293070,202101,3506,1758,1748,1933800.18,1922800,3856600.18
293075,202101,90,59,31,64900,34100,99000
293076,202101,75,55,20,60500,22000,82500
293077,202101,529,302,227,332200,250800,583000
293080,202101,434,388,46,426800,50600,477400
293090,202101,129,116,13,127600,14300,141900
293100,202101,518,360,158,396000,173800,569800
293105,202101,339,248,91,272800,101200,374000
293110,202101,167,114,53,125400,58300,183700
293120,202101,302,204,98,224400,107800,332200
293130,202101,248,169,79,185900,86900,272800
293135,202101,8058,3130,4928,3444100.18,5424100,8868200.18
293140,202101,217,131,86,144100,94600,238700
293150,202101,316,275,41,304700,45100,349800
293160,202101,430,258,172,283800,189200,473000
293170,202101,182,120,62,132000,68200,200200
293180,202101,539,378,161,416900,177100,594000
293190,202101,1351,925,426,1017500.7,469700,1487200.7
293200,202101,556,487,69,535700,75900,611600
293210,202101,399,301,98,331100,107800,438900
293220,202101,2472,1054,1418,1159400,1562000,2721400
293230,202101,1753,650,1103,715000.1,1213300,1928300.1
293240,202101,233,214,19,235400,20900,256300
293245,202101,126,106,20,116600,22000,138600
293250,202101,731,266,465,292600.22,511500,804100.22
293260,202101,305,253,52,278300,57200,335500
293270,202101,1183,543,640,597300,704000,1301300
293280,202101,280,153,127,168300,139700,308000
293290,202101,3049,1977,1072,2174700,1181400,3356100
293300,202101,744,525,219,577500,240900,818400
293305,202101,194,151,43,166100,47300,213400
293310,202101,153,114,39,125400,42900,168300
293315,202101,165,129,36,141900,39600,181500
293317,202101,85,61,24,67100,26400,93500
293320,202101,1062,577,485,635800.5,534600,1170400.5
293325,202101,187,69,118,75900,129800,205700
293330,202101,13733,6345,7388,6987200.38,8136700,15123900.38
293340,202101,277,193,84,212300,92400,304700
293345,202101,249,202,47,222200,51700,273900
293350,202101,606,351,255,386100,280500,666600
293360,202101,1515,1083,432,1191300,475200,1666500
310010,202101,140,76,64,83600,70400,154000
310020,202101,1032,565,467,621500,513700,1135200
310030,202101,327,261,66,287100,72600,359700
310040,202101,42,28,14,31900,15400,47300
310050,202101,174,107,67,117700,73700,191400
310060,202101,254,176,78,193600,85800,279400
310070,202101,14,9,5,11000,5500,16500
310080,202101,40,24,16,26400,17600,44000
310090,202101,1013,530,483,583000,532400,1115400
310100,202101,306,222,84,244200,92400,336600
310110,202101,708,386,322,424600,356400,781000
310120,202101,382,216,166,237600,182600,420200
310130,202101,31,17,14,18700,15400,34100
310140,202101,23,10,13,11000,14300,25300
310150,202101,1179,795,384,877506.66,425700,1303206.66
310160,202101,2041,994,1047,1095600.22,1152800,2248400.22
310163,202101,87,49,38,53900,41800,95700
310170,202101,2531,1102,1429,1213300,1575200,2788500
310180,202101,152,56,96,62700,105600,168300
310190,202101,492,335,157,368500,172700,541200
310200,202101,486,310,176,341000,193600,534600
310205,202101,59,39,20,42900,22000,64900
310210,202101,287,230,57,253000,62700,315700
310220,202101,61,34,27,37400,29700,67100
310230,202101,279,193,86,212300,95700,308000
310240,202101,108,94,14,103400,15400,118800
310250,202101,98,81,17,89100,18700,107800
310260,202101,756,397,359,436700.92,396000,832700.92
310270,202101,269,171,98,188100,107800,295900
310280,202101,370,271,99,298100,108900,407000
310285,202101,205,150,55,165000,60500,225500
310290,202101,241,134,107,147400,117700,265100
310300,202101,159,130,29,143000,31900,174900
310310,202101,8,7,1,7700,1100,8800
310320,202101,28,10,18,11000,19800,30800
310330,202101,40,27,13,29700,14300,44000
310340,202101,1735,1142,593,1256200,652300,1908500
310350,202101,2798,1479,1319,1626900,1450900,3077800
310360,202101,41,34,7,37400,7700,45100
310370,202101,118,97,21,106700,23100,129800
310375,202101,103,36,67,39600,73700,113300
310380,202101,48,28,20,30800,22000,52800
310390,202101,101,67,34,73700,37400,111100
310400,202101,2348,1507,841,1657700,927300,2585000
310410,202101,127,69,58,75900,63800,139700
310420,202101,654,340,314,375100,346500,721600
310430,202101,291,179,112,196900,123200,320100
310440,202101,73,42,31,46200,34100,80300
310445,202101,80,64,16,70400,17600,88000
310450,202101,622,387,235,425700,258500,684200
310460,202101,256,180,76,198000,83600,281600
310470,202101,511,323,188,356400,206800,563200
310480,202101,83,54,29,59400,31900,91300
310490,202101,533,245,288,269500,317900,587400
310500,202101,137,55,82,60500,90200,150700
310510,202101,605,420,185,462000,203500,665500
310520,202101,137,95,42,104500,46200,150700
310530,202101,106,43,63,47300,69300,116600
310540,202101,468,266,202,292600,222200,514800
310550,202101,73,47,26,51700,28600,80300
310560,202101,2968,2042,926,2249500,1020800,3270300
310570,202101,92,58,34,63800,37400,101200
310590,202101,372,235,137,258500,150700,409200
310600,202101,148,81,67,89100,73700,162800
310610,202101,56,21,35,23100,38500,61600
310620,202101,46979,22241,24738,24503517.5,27253600,51757117.5
310630,202101,658,400,258,440000,283800,723800
310640,202101,123,96,27,105600,29700,135300
310650,202101,155,138,17,151800,18700,170500
310660,202101,99,67,32,73700,35200,108900
310665,202101,60,45,15,49500,16500,66000
310670,202101,6724,2849,3875,3135000,4270200,7405200
310680,202101,59,36,23,39600,25300,64900
310690,202101,604,421,183,463100,201300,664400
310700,202101,61,39,22,42900,24200,67100
310710,202101,1311,884,427,972400,470800,1443200
310720,202101,138,35,103,38500,113300,151800
310730,202101,1471,1007,464,1109900,511500,1621400
310740,202101,981,541,440,595100,484000,1079100
310750,202101,238,143,95,157300,104500,261800
310760,202101,62,47,15,51700,16500,68200
310770,202101,89,44,45,48400,49500,97900
310780,202101,358,289,69,317900,75900,393800
310790,202101,104,85,19,93500,20900,114400
310800,202101,448,206,242,226600,266200,492800
310810,202101,170,120,50,132000.72,56100,188100.72
310820,202101,336,264,72,290400,79200,369600
310825,202101,194,164,30,180400,33000,213400
310830,202101,475,225,250,247500,277200,524700
310840,202101,359,211,148,232100,162800,394900
310850,202101,79,64,15,70400,16500,86900
310855,202101,400,311,89,342100.29,97900,440000.29
310860,202101,1577,1163,414,1280400,455400,1735800
310870,202101,57,47,10,51700,11000,62700
310880,202101,83,65,18,71500,19800,91300
310890,202101,306,176,130,193600,143000,336600
310900,202101,653,293,360,322308.64,396011.52,718320.16
310910,202101,238,161,77,177100,84700,261800
310920,202101,452,261,191,287100,210100,497200
310925,202101,34,28,6,30800,6600,37400
310930,202101,1295,825,470,907500,519200,1426700
310940,202101,693,342,351,376200,387200,763400
310945,202101,122,78,44,85800,48400,134200
310950,202101,225,181,44,199100,48400,247500
310960,202101,78,24,54,26400,60500,86900
310970,202101,167,103,64,113300,71500,184800
310980,202101,49,31,18,34100,19800,53900
310990,202101,164,84,80,92400,88000,180400
311000,202101,806,391,415,430100.1,456500,886600.1
311010,202101,48,42,6,46200,6600,52800
311020,202101,45,26,19,28600,20900,49500
311030,202101,382,220,162,242000,178200,420200
311040,202101,44,33,11,36300,12100,48400
311050,202101,472,180,292,198000,321200,519200
311060,202101,777,426,351,469700,386100,855800
311070,202101,343,150,193,165000,212300,377300
311080,202101,106,58,48,63800,52800,116600
311090,202101,335,154,181,169400,199100,368500
311100,202101,571,340,231,374000,254100,628100
311110,202101,692,486,206,534600,226600,761200
311115,202101,72,51,21,56100,23100,79200
311120,202101,1059,561,498,618200,547800,1166000
311130,202101,330,195,135,214500,148500,363000
311140,202101,168,89,79,97900,86900,184800
311150,202101,338,218,120,240900,132000,372900
311160,202101,707,504,203,554400,223300,777700
311170,202101,85,68,17,74800,19800,94600
311180,202101,312,204,108,224400,118800,343200
311190,202101,40,18,22,19800,24200,44000
311200,202101,333,232,101,255200,111100,366300
311205,202101,33,24,9,26400,9900,36300
311210,202101,42,37,5,40700,5500,46200
311220,202101,29,24,5,26400,5500,31900
311230,202101,1638,1077,561,1185800,617100,1802900
311240,202101,195,124,71,136400,78100,214500
311250,202101,55,21,34,23100,37400,60500
311260,202101,557,351,206,387200,226600,613800
311265,202101,125,85,40,93500,44000,137500
311270,202101,287,196,91,215600,101200,316800
311280,202101,204,96,108,105600,118800,224400
311290,202101,103,84,19,92400,20900,113300
311300,202101,574,359,215,394900,236500,631400
311310,202101,21,16,5,17600,5500,23100
311320,202101,650,482,168,531300,184800,716100
311330,202101,1078,787,291,866800,321200,1188000
311340,202101,2644,1865,779,2051500,859100,2910600
311350,202101,273,210,63,231000,69300,300300
311360,202101,178,104,74,114400,81400,195800
311370,202101,1223,497,726,546700,798600,1345300
311380,202101,6,5,1,5500,1100,6600
311390,202101,248,136,112,149600,123200,272800
311400,202101,133,81,52,89100,57200,146300
311410,202101,114,59,55,64900,60500,125400
311420,202101,302,165,137,181500,150700,332200
311430,202101,842,559,283,616000,311300,927300
311440,202101,459,321,138,353100,151800,504900
311450,202101,304,184,120,202400,132000,334400
311455,202101,279,192,87,211200,95700,306900
311460,202101,136,60,76,66000,84700,150700
311470,202101,26,13,13,14300,14300,28600
311480,202101,49,23,26,25300,28600,53900
311490,202101,13,9,4,9900,4400,14300
311500,202101,25,12,13,13200,14300,27500
311510,202101,642,440,202,485100,222200,707300
311520,202101,39,31,8,34100,8800,42900
311530,202101,1804,1313,491,1445400,541200,1986600
311535,202101,65,44,21,48400,23100,71500
311540,202101,33,29,4,31900,4400,36300
311545,202101,166,121,45,133100,49500,182600
311547,202101,38,31,7,34100,7700,41800
311550,202101,684,308,376,338800,414700,753500
311560,202101,44,28,16,30800,17600,48400
311570,202101,285,191,94,210100,103400,313500
311580,202101,358,212,146,233200,160600,393800
311590,202101,32,29,3,31900,3300,35200
311600,202101,104,83,21,91300,23100,114400
311610,202101,249,212,37,233200,40700,273900
311615,202101,93,74,19,81400,20900,102300
311620,202101,24,14,10,15400,11000,26400
311630,202101,88,74,14,81400,15400,96800
311640,202101,132,63,69,69300,75900,145200
311650,202101,121,82,39,90200,42900,133100
311660,202101,402,194,208,213400,231000,444400
311670,202101,144,94,50,103400,55000,158400
311680,202101,206,154,52,169400,57200,226600
311690,202101,16,12,4,13200,4400,17600
311700,202101,194,138,56,151800,61600,213400
311710,202101,192,131,61,144100,67100,211200
311720,202101,42,31,11,34100,12100,46200
311730,202101,565,386,179,424600,196900,621500
311740,202101,26,19,7,20900,7700,28600
311750,202101,720,479,241,528000.7,265100,793100.7
311760,202101,70,31,39,34100,42900,77000
311770,202101,383,191,192,210100,211200,421300
311780,202101,175,87,88,95700,96800,192500
311783,202101,90,81,9,89100,9900,99000
311787,202101,35,12,23,13200,25300,38500
311790,202101,258,111,147,122100,161700,283800
311800,202101,680,444,236,488400,259600,748000
311810,202101,47,37,10,40700,11000,51700
311820,202101,122,99,23,108900,25300,134200
311830,202101,1878,1144,734,1259500,808500,2068000
311840,202101,1004,554,450,609400,496100,1105500
311850,202101,12,8,4,8800,4400,13200
311860,202101,9595,4115,5480,4529800,6035700,10565500
311870,202101,123,68,55,74800,60500,135300
311880,202101,924,667,257,733700,282700,1016400
311890,202101,197,95,102,104409,112200,216609
311900,202101,71,27,44,29700,48400,78100
311910,202101,1382,861,521,947100,573100,1520200
311920,202101,223,145,78,159500,85800,245300
311930,202101,893,501,392,552200,431200,983400
311940,202101,2511,1301,1210,1431100,1331000,2762100
311950,202101,55,38,17,41800,18700,60500
311960,202101,60,44,16,48400,17600,66000
311970,202101,25,15,10,16500,11000,27500
311980,202101,41,33,8,36300,8800,45100
311990,202101,37,28,9,30800,9900,40700
311995,202101,56,36,20,40700,22000,62700
312000,202101,25,16,9,17600,9900,27500
312010,202101,76,59,17,64900,18700,83600
312015,202101,72,54,18,59400,20900,80300
312020,202101,126,84,42,92400,46200,138600
312030,202101,60,44,16,48400,17600,66000
312040,202101,78,51,27,56100,29700,85800
312050,202101,201,111,90,122100,99000,221100
312060,202101,20,12,8,13200,8800,22000
312070,202101,76,48,28,52800,30800,83600
312080,202101,529,237,292,260700,321200,581900
312083,202101,56,37,19,40700,20900,61600
312087,202101,97,74,23,81400,25300,106700
312090,202101,3208,1915,1293,2107600,1422300,3529900
312100,202101,149,105,44,115247,48400,163647
312110,202101,114,63,51,70400,56100,126500
312120,202101,136,101,35,111100.63,38500,149600.63
312125,202101,88,51,37,56100,40700,96800
312130,202101,126,82,44,90200,48400,138600
312140,202101,134,104,30,114400,33000,147400
312150,202101,42,32,10,35200,11000,46200
312160,202101,1553,1014,539,1116599.75,594000,1710599.75
312170,202101,10,8,2,8800,2200,11000
312180,202101,108,65,43,71500,47300,118800
312190,202101,35,31,4,34100,4400,38500
312200,202101,751,640,111,704000,122100,826100
312210,202101,114,61,53,67100,58300,125400
312220,202101,130,99,31,108900,34100,143000
312230,202101,3650,1673,1977,1841400,2176900,4018300
312235,202101,153,102,51,112200,56100,168300
312240,202101,93,66,27,72600,29700,102300
312245,202101,191,129,62,141900,68200,210100
312247,202101,75,53,22,59400,24200,83600
312250,202101,173,82,91,90200,101200,191400
312260,202101,102,67,35,73700,38500,112200
312270,202101,131,77,54,84700,59400,144100
312280,202101,28,15,13,16500,14300,30800
312290,202101,145,102,43,112200,47300,159500
312300,202101,206,135,71,148500,78100,226600
312310,202101,62,55,7,60500,7700,68200
312320,202101,421,263,158,289300,173800,463100
312330,202101,88,77,11,84700,12100,96800
312340,202101,35,16,19,17600,20900,38500
312350,202101,16,9,7,9900,7700,17600
312352,202101,88,67,21,73700,23100,96800
312360,202101,573,242,331,266200,365200,631400
312370,202101,315,171,144,188100,158400,346500
312380,202101,133,87,46,95700,50600,146300
312385,202101,160,129,31,141900,34100,176000
312390,202101,296,186,110,204600,121000,325600
312400,202101,378,278,100,305800,110000,415800
312410,202101,1028,324,704,356400,774400,1130800
312420,202101,617,469,148,515900,162800,678700
312430,202101,871,636,235,699601.13,258500,958101.13
312440,202101,40,30,10,33000,11000,44000
312450,202101,201,130,71,143000,78100,221100
312460,202101,31,16,15,17600,16500,34100
312470,202101,44,30,14,33000,15400,48400
312480,202101,186,114,72,126500,79200,205700
312490,202101,266,183,83,201300,91300,292600
312500,202101,34,20,14,22000,15400,37400
312510,202101,521,194,327,214500,359700,574200
312520,202101,33,10,23,11000,25300,36300
312530,202101,45,31,14,34100,15400,49500
312540,202101,90,78,12,86900,13200,100100
312550,202101,37,29,8,31900,8800,40700
312560,202101,205,154,51,170500,56100,226600
312570,202101,430,255,175,280500,192500,473000
312580,202101,89,47,42,51700,46200,97900
312590,202101,244,196,48,215600,52800,268400
312595,202101,124,108,16,118800,17600,136400
312600,202101,67,36,31,39600,34100,73700
312610,202101,1596,817,779,898700,856900,1755600
312620,202101,216,155,61,170500,67100,237600
312630,202101,72,58,14,63800,15400,79200
312640,202101,42,11,31,12100,34100,46200
312650,202101,146,120,26,132000,28600,160600
312660,202101,90,63,27,69300.01,29700,99000.01
312670,202101,923,591,332,650100,365200,1015300
312675,202101,29,24,5,26400,5500,31900
312680,202101,73,44,29,48400,31900,80300
312690,202101,243,123,120,135300,132000,267300
312695,202101,27,23,4,25300,4400,29700
312700,202101,226,129,97,141900,106700,248600
312705,202101,82,63,19,69300,20900,90200
312707,202101,131,93,38,102300,41800,144100
312710,202101,1862,997,865,1097800.59,951500,2049300.59
312720,202101,55,28,27,30800,29700,60500
312730,202101,285,163,122,179300,134200,313500
312733,202101,46,37,9,40700,9900,50600
312735,202101,21,13,8,14300,8800,23100
312737,202101,63,33,30,36300,33000,69300
312738,202101,58,39,19,42900,20900,63800
312740,202101,82,53,29,58300,31900,90200
312750,202101,89,61,28,67100,30800,97900
312760,202101,290,208,82,228800,90200,319000
312770,202101,8175,3721,4454,4095300.81,4902700,8998000.81
312780,202101,440,336,104,369600,114400,484000
312790,202101,21,15,6,16500,6600,23100
312800,202101,1593,1111,482,1223200,530200,1753400
312810,202101,366,237,129,260700,143000,403700
312820,202101,184,141,43,155100,47300,202400
312825,202101,27,18,9,19800,9900,29700
312830,202101,221,127,94,139700,103400,243100
312840,202101,155,103,52,113300,57200,170500
312850,202101,45,39,6,42900,6600,49500
312860,202101,152,95,57,104500,62700,167200
312870,202101,1061,551,510,607200,562100,1169300
312880,202101,124,88,36,96800,39600,136400
312890,202101,156,109,47,119900,51700,171600
312900,202101,193,144,49,158400,53900,212300
312910,202101,169,88,81,96800,90200,187000
312920,202101,149,85,64,93500,70400,163900
312930,202101,321,224,97,246400,107800,354200
312940,202101,122,83,39,91300,42900,134200
312950,202101,687,468,219,515900,240900,756800
312960,202101,159,119,40,130900,44000,174900
312965,202101,83,66,17,72600,18700,91300
312970,202101,272,224,48,246400,52800,299200
312980,202101,2462,1222,1240,1346400,1367300,2713700
312990,202101,47,25,22,27500,24200,51700
313000,202101,55,29,26,31900,28600,60500
313005,202101,172,133,39,146300,42900,189200
313010,202101,906,353,553,388300,608300,996600
313020,202101,200,101,99,111100,108900,220000
313030,202101,197,131,66,144100,72600,216700
313040,202101,77,25,52,27500,57200,84700
313050,202101,181,132,49,145200,53900,199100
313055,202101,39,29,10,31900,11000,42900
313060,202101,130,87,43,95700,47300,143000
313065,202101,64,45,19,49500,20900,70400
313070,202101,133,69,64,75900,70400,146300
313080,202101,39,17,22,18700,24200,42900
313090,202101,665,433,232,476300,255200,731500
313100,202101,190,64,126,70400,138600,209000
313110,202101,139,69,70,75900,77000,152900
313115,202101,213,116,97,128700,106700,235400
313120,202101,826,469,357,517000,392700,909700
313130,202101,5779,3120,2659,3433100,2926000,6359100
313140,202101,139,75,64,82500,70400,152900
313150,202101,304,240,64,264000,70400,334400
313160,202101,188,139,49,152900,53900,206800
313170,202101,1394,924,470,1017500,517000,1534500
313180,202101,299,173,126,191400,138600,330000
313190,202101,736,433,303,478500,333300,811800
313200,202101,25,20,5,22000,5500,27500
313210,202101,995,845,150,929500,165000,1094500
313220,202101,287,175,112,192500,123200,315700
313230,202101,256,194,62,214500.5,68200,282700.5
313240,202101,2153,1100,1053,1210000,1160500,2370500
313250,202101,1257,957,300,1052700,330000,1382700
313260,202101,93,48,45,52800,49500,102300
313270,202101,989,571,418,629200,459800,1089000
313280,202101,51,43,8,47300,8800,56100
313290,202101,214,173,41,190300,45100,235400
313300,202101,341,178,163,195800,179300,375100
313310,202101,262,121,141,133100,155100,288200
313320,202101,383,282,101,310200,112200,422400
313330,202101,1396,849,547,933900,601700,1535600
313340,202101,324,229,95,251900,104500,356400
313350,202101,483,321,162,354200,178200,532400
313360,202101,147,69,78,75900,86900,162800
313370,202101,220,68,152,74800,167200,242000
313375,202101,290,173,117,190300,129800,320100
313380,202101,1349,699,650,768900,716100,1485000
313390,202101,49,45,4,49500,4400,53900
313400,202101,392,263,129,289300,144100,433400
313410,202101,24,13,11,14300,12100,26400
313420,202101,4556,2427,2129,2670800,2343000,5013800
313430,202101,140,67,73,73700,80300,154000
313440,202101,1406,968,438,1064801.13,484000,1548801.13
313450,202101,68,29,39,31900,42900,74800
313460,202101,379,166,213,182600,235400,418000
313470,202101,527,246,281,270600,309100,579700
313480,202101,145,107,38,117700,41800,159500
313490,202101,514,234,280,257400,309100,566500
313500,202101,27,15,12,16500,13200,29700
313505,202101,1029,803,226,883300,248600,1131900
313507,202101,101,61,40,67100,44000,111100
313510,202101,2828,1771,1057,1950397.1,1162700,3113097.1
313520,202101,3446,2688,758,2960101.5,834900,3795001.5
313530,202101,33,21,12,23100,13200,36300
313535,202101,64,50,14,55000,15400,70400
313540,202101,69,51,18,56100,19800,75900
313545,202101,111,93,18,102300,19800,122100
313550,202101,227,192,35,211200,38500,249700
313560,202101,341,163,178,179300,195800,375100
313570,202101,63,21,42,23100,46200,69300
313580,202101,1313,730,583,803000,641300,1444300
313590,202101,69,38,31,41800,34100,75900
313600,202101,668,402,266,442200,292600,734800
313610,202101,62,48,14,52800,15400,68200
313620,202101,1398,692,706,762300,776600.6,1538900.6
313630,202101,1608,1217,391,1339800,430100,1769900
313640,202101,121,73,48,80300,52800,133100
313650,202101,233,108,125,118800,137500,256300
313652,202101,20,20,0,22000,0,22000
313655,202101,69,45,24,49500,26400,75900
313657,202101,44,41,3,45100,3300,48400
313660,202101,133,89,44,97900,48419.8,146319.8
313665,202101,639,289,350,317900,385000,702900
313670,202101,10222,6918,3304,7616400.8,3641000,11257400.8
313680,202101,43,33,10,36300,11000,47300
313690,202101,140,105,35,115500,38500,154000
313695,202101,65,48,17,52800,18700,71500
313700,202101,310,247,63,271700,69300,341000
313710,202101,137,99,38,108900,41800,150700
313720,202101,1114,514,600,567600,660000,1227600
313730,202101,74,42,32,46200,35200,81400
313740,202101,148,119,29,130900,31900,162800
313750,202101,421,301,120,331100,132000,463100
313753,202101,231,172,59,189200,64900,254100
313760,202101,1311,469,842,515900,928400,1444300
313770,202101,380,270,110,297000,121000,418000
313780,202101,786,412,374,453200,411400,864600
313790,202101,28,27,1,29700,1100,30800
313800,202101,139,83,56,91300,61600,152900
313810,202101,77,44,33,48400,36300,84700
313820,202101,1307,610,697,672100.18,767800,1439900.18
313830,202101,57,41,16,45100,17600,62700
313835,202101,58,48,10,52800,11000,63800
313840,202101,1651,980,671,1079100,738100,1817200
313850,202101,205,75,130,82500,143000,225500
313860,202101,469,358,111,393800,122100,515900
313862,202101,159,105,54,115500,59400,174900
313865,202101,124,92,32,101200,35200,136400
313867,202101,50,40,10,44000,11000,55000
313868,202101,36,21,15,23100,16500,39600
313870,202101,113,60,53,66000,58300,124300
313880,202101,375,229,146,251900,161700,413600
313890,202101,327,170,157,188100,172700,360800
313900,202101,865,468,397,514800.66,436700,951500.66
313910,202101,148,102,46,112200,50600,162800
313920,202101,626,437,189,481800,207900.94,689700.94
313925,202101,33,28,5,30800,5500,36300
313930,202101,858,665,193,731500,213400,944900
313940,202101,1860,1141,719,1256200,793100,2049300
313950,202101,862,540,322,594000,354200,948200
313960,202101,1404,803,601,884400,663300,1547700
313970,202101,173,110,63,121000,69300,190300
313980,202101,200,128,72,140800,79200,220000
313990,202101,232,153,79,168300,86900,255200
314000,202101,888,584,304,642400,335500,977900
314010,202101,79,44,35,48400,38500,86900
314015,202101,63,16,47,17600,51700,69300
314020,202101,55,33,22,36300,24200,60500
314030,202101,73,33,40,36300,44000,80300
314040,202101,47,27,20,29700,22000,51700
314050,202101,283,170,113,187000,124300,311300
314053,202101,100,65,35,71500,38500,110000
314055,202101,295,184,111,202400,122100,324500
314060,202101,133,117,16,128700.04,17600,146300.04
314070,202101,1027,516,511,567600,562100,1129700
314080,202101,205,130,75,143000,83600,226600
314085,202101,153,100,53,110000,58300,168300
314090,202101,381,270,111,298100,122100,420200
314100,202101,508,410,98,452100,108900,561000
314110,202101,792,388,404,427900,444400,872300
314120,202101,75,45,30,49500,33000,82500
314130,202101,23,13,10,14300,11000,25300
314140,202101,1105,677,428,744700,470800,1215500
314150,202101,186,120,66,132000,73700,205700
314160,202101,331,247,84,272800,92400,365200
314170,202101,85,65,20,71500,22000,93500
314180,202101,728,640,88,704000,96800,800800
314190,202101,98,58,40,63800,44000,107800
314200,202101,502,340,162,374000,178200.89,552200.89
314210,202101,246,187,59,205700,64900,270600
314220,202101,297,218,79,239800,86900,326700
314225,202101,60,43,17,47300,18700,66000
314230,202101,116,51,65,56100,71500,127600
314240,202101,149,109,40,119900,44000,163900
314250,202101,52,29,23,31900,25300,57200
314260,202101,209,102,107,113300,117700,231000
314270,202101,385,296,89,325600,97900,423500
314280,202101,716,383,333,422350.5,366300,788650.5
314290,202101,545,436,109,479600,119900,599500
314300,202101,350,255,95,280500,105600,386100
314310,202101,1362,928,434,1021075.77,478500,1499575.77
314315,202101,35,26,9,28600,9900,38500
314320,202101,584,392,192,431200,212300,643500
314330,202101,11159,5411,5748,5957600,6328300,12285900
314340,202101,596,264,332,291500,365200,656700
314345,202101,51,34,17,37400,18700,56100
314350,202101,180,113,67,124300,73700,198000
314360,202101,59,34,25,37400,27500,64900
314370,202101,66,44,22,48400,24200,72600
314380,202101,97,60,37,66000,40700,106700
314390,202101,3326,2120,1206,2333100,1326600,3659700
314400,202101,689,485,204,533500,225500,759000
314410,202101,486,317,169,348700,187000,535700
314420,202101,14,8,6,8800,6600,15400
314430,202101,2417,884,1533,972401.51,1689600,2662001.51
314435,202101,181,105,76,115500,83600,199100
314437,202101,28,21,7,23100,7700,30800
314440,202101,96,66,30,72600,33000,105600
314450,202101,163,114,49,125400,53900,179300
314460,202101,634,299,335,330000,368500,698500
314465,202101,95,60,35,66000,38500,104500
314467,202101,69,55,14,60500,15400,75900
314470,202101,406,199,207,218900,228800,447700
314480,202101,1030,483,547,531300,603900,1135200
314490,202101,46,30,16,33000,17600,50600
314500,202101,281,197,84,216700.96,92400,309100.96
314505,202101,109,68,41,74800,45100,119900
314510,202101,246,202,44,222200,48400,270600
314520,202101,1300,692,608,762300,668800,1431100
314530,202101,726,582,144,640200.7,158400,798600.7
314535,202101,164,97,67,106700,73700,180400
314537,202101,62,36,26,39600,28600,68200
314540,202101,15,9,6,9900,6600,16500
314545,202101,50,33,17,36300,18700,55000
314550,202101,79,41,38,45100,41800,86900
314560,202101,846,457,389,502700,427900,930600
314570,202101,21,16,5,17600,5500,23100
314580,202101,14,5,9,5500,9900,15400
314585,202101,27,18,9,19800,9900,29700
314587,202101,82,68,14,74800,15400,90200
314590,202101,554,391,163,430100,181500,611600
314600,202101,936,597,339,656700.84,372900.63,1029601.47
314610,202101,936,481,455,530200,500500,1030700
314620,202101,134,100,34,110000,37400,147400
314625,202101,98,71,27,78100,29700,107800
314630,202101,1163,614,549,675400,603900,1279300
314640,202101,82,53,29,58300,31900,90200
314650,202101,177,100,77,110000,84700,194700
314655,202101,61,45,16,49500,17600,67100
314660,202101,16,13,3,14300,3300,17600
314670,202101,199,152,47,167200,51700,218900
314675,202101,209,123,86,135300,94600,229900
314690,202101,589,310,279,341000,308000,649000
314700,202101,2258,1208,1050,1328800,1155000,2483800
314710,202101,1725,979,746,1079100,822800,1901900
314720,202101,390,226,164,248600,180400,429000
314730,202101,517,270,247,297000,272800,569800
314740,202101,724,340,384,374000,422400,796400
314750,202101,17,14,3,15400,3300,18700
314760,202101,347,154,193,169400,212300,381700
314770,202101,106,72,34,79200,37400,116600
314780,202101,22,8,14,8800,15400,24200
314790,202101,2418,1527,891,1681900,981200,2663100
314795,202101,48,38,10,41800,11000,52800
314800,202101,2921,1688,1233,1857900.76,1357400,3215300.76
314810,202101,1485,838,647,921800,711700,1633500
314820,202101,104,58,46,63800,50600,114400
314830,202101,211,170,41,187000,45100,232100
314840,202101,86,52,34,57200,37400,94600
314850,202101,394,190,204,210100,224400,434500
314860,202101,656,503,153,553300,168300,721600
314870,202101,1525,793,732,872300,805200,1677500
314875,202101,52,47,5,51700,5500,57200
314880,202101,45,31,14,34100,15400,49500
314890,202101,50,28,22,30800,24200,55000
314900,202101,28,22,6,24200,6600,30800
314910,202101,242,157,85,172700,93500,266200
314915,202101,136,123,13,135300,14300,149600
314920,202101,101,62,39,68200,42900,111100
314930,202101,1037,504,533,555500,589600,1145100
314940,202101,46,37,9,40700,9900,50600
314950,202101,31,21,10,23100,11000,34100
314960,202101,30,22,8,24200,8800,33000
314970,202101,149,72,77,79200,84700,163900
314980,202101,312,201,111,221100,122100,343200
314990,202101,435,234,201,257400,221100,478500
314995,202101,158,62,96,68200,105600,173800
315000,202101,78,59,19,64900,20900,85800
315010,202101,43,28,15,30800,16500,47300
315015,202101,166,130,36,143000,39600,182600
315020,202101,68,57,11,62700,12100,74800
315030,202101,106,81,25,89100,27500,116600
315040,202101,72,48,24,52800,26400,79200
315050,202101,184,107,77,117700,84700,202400
315053,202101,42,33,9,36300,9900,46200
315057,202101,101,78,23,85800,25300,111100
315060,202101,75,63,12,69300,14300,83600
315070,202101,105,59,46,64900,50600,115500
315080,202101,368,288,80,316800,88000,404800
315090,202101,93,54,39,59400,42900,102300
315100,202101,77,39,38,42900,41800,84700
315110,202101,268,144,124,158400,136400,294800
315120,202101,1733,837,896,920700,985600,1906300
315130,202101,338,244,94,268400,103400,371800
315140,202101,533,296,237,325600,260700,586300
315150,202101,978,462,516,508200,567600,1075800
315160,202101,215,105,110,115500,121000,236500
315170,202101,310,205,105,225500,115500,341000
315180,202101,3226,1329,1897,1461900,2088900,3550800
315190,202101,312,185,127,203500,139700,343200
315200,202101,1214,716,498,787600,548900,1336500
315210,202101,1636,931,705,1025200,776600,1801800
315213,202101,30,18,12,19800,13200,33000
315217,202101,200,157,43,172700,47300,220000
315220,202101,1576,1186,390,1304600,429000,1733600
315230,202101,167,120,47,132000,51700,183700
315240,202101,417,266,151,292600,166100,458700
315250,202101,2570,1233,1337,1357400,1474000,2831400
315260,202101,144,81,63,89100,69300,158400
315270,202101,133,90,43,99000,47300,146300
315280,202101,642,414,228,455400,250800,706200
315290,202101,189,118,71,129800,78100,207900
315300,202101,80,58,22,63800,24200,88000
315310,202101,75,67,8,73700,8800,82500
315320,202101,153,90,63,99000,69300,168300
315330,202101,54,44,10,48400,11000,59400
315340,202101,386,281,105,309100,115500,424600
315350,202101,152,92,60,101200,66000,167200
315360,202101,88,41,47,45100,51700,96800
315370,202101,55,35,20,38500,22000,60500
315380,202101,6,6,0,6600,0,6600
315390,202101,61,15,46,16500,50600,67100
315400,202101,826,615,211,676500,232100,908600
315410,202101,322,188,134,206800,147400,354200
315415,202101,56,42,14,46200,15400,61600
315420,202101,199,144,55,158400,60500,218900
315430,202101,658,378,280,415800,308000,723800
315440,202101,96,65,31,71500,34100,105600
315445,202101,232,193,39,212300,42900,255200
315450,202101,179,134,45,147400,49500,196900
315460,202101,4090,1941,2149,2136200.41,2366100,4502300.41
315470,202101,41,17,24,18700,26400,45100
315480,202101,71,20,51,22000,56100,78100
315490,202101,692,424,268,466400,295900,762300
315500,202101,17,13,4,14300,4400,18700
315510,202101,149,100,49,110000,53900,163900
315520,202101,73,63,10,69300,11000,80300
315530,202101,40,22,18,24200,19800,44000
315540,202101,246,168,78,185900,85800,271700
315550,202101,177,144,33,158400,36300,194700
315560,202101,738,587,151,645700,166100,811800
315570,202101,306,151,155,166100.63,170500,336600.63
315580,202101,711,478,233,525800,256300,782100
315590,202101,196,99,97,108900,106700,215600
315600,202101,303,231,72,255200,79200,334400
315610,202101,103,53,50,58300,55000,113300
315620,202101,37,29,8,31900,8800,40700
315630,202101,124,81,43,89100,47300,136400
315640,202101,74,44,30,48400,34100,82500
315645,202101,46,31,15,34100,16500,50600
315650,202101,174,125,49,137500,53900,191400
315660,202101,455,199,256,218900,281600,500500
315670,202101,2373,1113,1260,1226500,1387100,2613600
315680,202101,817,577,240,634700,264000,898700
315690,202101,671,463,208,509300.5,228800,738100.5
315700,202101,1916,1004,912,1104400.92,1006500,2110900.92
315710,202101,351,102,249,112200,273900,386100
315720,202101,456,280,176,309100,193600,502700
315725,202101,186,151,35,166100,38500,204600
315727,202101,50,23,27,25300,29700,55000
315730,202101,46,43,3,47300,3300,50600
315733,202101,88,59,29,64900,31900,96800
315737,202101,49,36,13,39600,14300,53900
315740,202101,32,25,7,27500,7700,35200
315750,202101,154,115,39,126500,42900,169400
315760,202101,38,27,11,29700,12100,41800
315765,202101,116,66,50,72600,56100,128700
315770,202101,214,132,82,145200,90200,235400
315780,202101,3524,1731,1793,1905200,1978900,3884100
315790,202101,233,181,52,199100,57200,256300
315800,202101,295,203,92,223300,101200,324500
315810,202101,93,56,37,61600,40700,102300
315820,202101,744,543,201,597300,221100,818400
315830,202101,121,78,43,85800,47300,133100
315840,202101,85,55,30,60500,33000,93500
315850,202101,259,184,75,202400,82500,284900
315860,202101,14,5,9,5500,9900,15400
315870,202101,40,30,10,33000,11000,44000
315880,202101,103,65,38,71500,41800,113300
315890,202101,91,67,24,73700,26400,100100
315895,202101,417,272,145,299200,159500,458700
315900,202101,67,32,35,35200,38500,73700
315910,202101,38,22,16,24200,17600,41800
315920,202101,157,105,52,115500,57200,172700
315930,202101,52,19,33,20900,36300,57200
315935,202101,131,103,28,113300,30800,144100
315940,202101,101,74,27,81400,29700,111100
315950,202101,36,29,7,31900,7700,39600
315960,202101,533,254,279,280500,306900,587400
315970,202101,33,26,7,28600,7700,36300
315980,202101,673,333,340,367400,374000,741400
315990,202101,257,149,108,163900,118800,282700
316000,202101,49,30,19,33000,20900,53900
316010,202101,78,64,14,70400,15400,85800
316020,202101,118,101,17,111100,18700,129800
316030,202101,379,208,171,228800,188100,416900
316040,202101,526,218,308,239800,338800,578600
316045,202101,50,44,6,48400,6600,55000
316050,202101,16,12,4,13200,4400,17600
316060,202101,91,60,31,66000,34100,100100
316070,202101,1079,693,386,764500,424600,1189100
316080,202101,96,64,32,70496.8,35200,105696.8
316090,202101,42,21,21,23100,23100,46200
316095,202101,94,76,18,83600,19800,103400
316100,202101,316,178,138,195800,151800,347600
316105,202101,37,23,14,25300,15400,40700
316110,202101,1873,1478,395,1626900.5,434500,2061400.5
316120,202101,77,54,23,59400,25300,84700
316130,202101,122,91,31,100100,34100,134200
316140,202101,30,19,11,20900,12100,33000
316150,202101,207,143,64,157300,70400,227700
316160,202101,80,46,34,50600,37400,88000
316165,202101,63,44,19,49500,20900,70400
316170,202101,182,120,62,132000,68200,200200
316180,202101,200,85,115,93500,127600,221100
316190,202101,131,93,38,102300,41800,144100
316200,202101,666,357,309,393800,339900,733700
316210,202101,775,512,263,563389.2,289300,852689.2
316220,202101,121,80,41,88000,45100,133100
316225,202101,30,17,13,18700,14300,33000
316230,202101,35,19,16,20900,17600,38500
316240,202101,647,517,130,568700,143000,711700
316245,202101,134,116,18,127600,19800,147400
316250,202101,1537,1039,498,1142900,547800,1690700
316255,202101,129,102,27,112200,29700,141900
316257,202101,177,92,85,101200,93500,194700
316260,202101,191,135,56,148500,61600,210100
316265,202101,28,19,9,20900,9900,30800
316270,202101,682,478,204,525800,224400,750200
316280,202101,550,340,210,374000.63,231000,605000.63
316290,202101,748,490,258,539000,284900,823900
316292,202101,520,207,313,227700,344300,572000
316294,202101,104,64,40,70400,44000,114400
316295,202101,309,130,179,143000,196900,339900
316300,202101,108,70,38,77000,41800,118800
316310,202101,27,14,13,15400,14300,29700
316320,202101,51,27,24,29700,26400,56100
316330,202101,164,112,52,123200,57200,180400
316340,202101,133,88,45,96800,49500,146300
316350,202101,189,132,57,145200,62700,207900
316360,202101,23,15,8,16500,8800,25300
316370,202101,1126,567,559,623700,614900,1238600
316380,202101,114,85,29,93500,31900,125400
316390,202101,110,77,33,84700,36300,121000
316400,202101,132,102,30,112200,33000,145200
316410,202101,304,220,84,242000,92400,334400
316420,202101,204,135,69,148500,75900,224400
316430,202101,150,78,72,85800,79200,165000
316440,202101,88,42,46,46200,50600,96800
316443,202101,38,36,2,39600,2200,41800
316447,202101,48,36,12,39600,13200,52800
316450,202101,221,169,52,185900,57200,243100
316460,202101,80,29,51,31900,56100,88000
316470,202101,1671,1215,456,1336489.65,502700,1839189.65
316480,202101,11,8,3,8800,3300,12100
316490,202101,20,6,14,6600,15400,22000
316500,202101,156,105,51,115500,56100,171600
316510,202101,152,115,37,126500,40700,167200
316520,202101,193,114,79,125400,86900,212300
316530,202101,165,106,59,116600,64900,181500
316540,202101,145,74,71,81400,78100,159500
316550,202101,143,91,52,100100,57200,157300
316553,202101,299,134,165,147400,181500.72,328900.72
316555,202101,46,38,8,41800,8800,50600
316556,202101,13,9,4,9900,4400,14300
316557,202101,22,18,4,19800,4400,24200
316560,202101,65,44,21,48400,23100,71500
316570,202101,216,196,20,215600,22000,237600
316580,202101,21,14,7,15400,7700,23100
316590,202101,101,84,17,92400,18700,111100
316600,202101,171,140,31,154000,34100,188100
316610,202101,63,47,16,51700,17600,69300
316620,202101,137,99,38,108900,41800,150700
316630,202101,40,31,9,34100,9900,44000
316640,202101,22,14,8,15400,8800,24200
316650,202101,73,58,15,63800,16500,80300
316660,202101,8,3,5,3300,5500,8800
316670,202101,441,150,291,165000,320100,485100
316680,202101,155,109,46,119900,50600,170500
316690,202101,182,114,68,125400,74800,200200
316695,202101,61,51,10,56100,11000,67100
316700,202101,17,11,6,12100,6600,18700
316710,202101,769,576,193,633600,213400,847000
316720,202101,5021,2428,2593,2671900,2857800,5529700
316730,202101,16,16,0,17600,0,17600
316740,202101,140,90,50,99000,55000,154000
316750,202101,17,10,7,11000,7700,18700
316760,202101,317,254,63,280500,69300,349800
316770,202101,157,85,72,93500,79200,172700
316780,202101,66,41,25,45100,27500,72600
316790,202101,55,39,16,42900,17600,60500
316800,202101,1765,1092,673,1201200,741400,1942600
316805,202101,23,17,6,18700,6600,25300
316810,202101,66,40,26,44000,29700,73700
316820,202101,40,21,19,23100,20900,44000
316830,202101,97,44,53,48400,58300,106700
316840,202101,521,302,219,332200,240900,573100
316850,202101,323,214,109,237600,119900,357500
316860,202101,5910,2606,3304,2868800.18,3636600,6505400.18
316870,202101,1551,994,557,1093400,612700,1706100
316880,202101,127,60,67,66000,73700,139700
316890,202101,239,164,75,180400,82500,262900
316900,202101,417,290,127,319000,139700,458700
316905,202101,21,11,10,12100,11000,23100
316910,202101,67,28,39,30800,42900,73700
316920,202101,140,109,31,119900,34100,154000
316930,202101,1894,960,934,1057100,1027400,2084500
316935,202101,909,539,370,592900,407000,999900
316940,202101,1090,614,476,675400,523600,1199000
316950,202101,179,88,91,96800,100100,196900
316960,202101,1095,608,487,668800,535700,1204500
316970,202101,648,510,138,561000,152900,713900
316980,202101,73,40,33,44000,36300,80300
316990,202101,2146,1422,724,1566400,796400.84,2362800.84
317000,202101,333,256,77,281600,84700,366300
317005,202101,232,161,71,177100,78100,255200
317010,202101,6397,3533,2864,3887400.4,3154800,7042200.4
317020,202101,15945,6970,8975,7673600,9881300,17554900
317030,202101,78,29,49,31900,53900,85800
317040,202101,3039,1899,1140,2092200,1255100,3347300
317043,202101,70,51,19,56100,20900,77000
317047,202101,36,19,17,20900,18700,39600
317050,202101,157,118,39,129800,42900,172700
317052,202101,140,108,32,118800,35200,154000
317057,202101,168,129,39,141900,42900,184800
317060,202101,61,38,23,41800,25300,67100
317065,202101,48,37,11,40700,12100,52800
317070,202101,1940,891,1049,981200,1155000,2136200
317075,202101,99,53,46,58300,50600,108900
317080,202101,913,462,451,509300,496100,1005400
317090,202101,674,530,144,583000,158400,741400
317100,202101,417,312,105,344300,115500,459800
317103,202101,106,83,23,91300,25300,116600
317107,202101,44,38,6,41800,6600,48400
317110,202101,114,50,64,55000,70400,125400
317115,202101,40,36,4,39600,4400,44000
317120,202101,1923,915,1008,1006500,1112100,2118600
317130,202101,1961,1299,662,1434400,730400,2164800
317140,202101,10,8,2,8800,2200,11000
317150,202101,264,156,108,171600,118800,290400
317160,202101,315,234,81,258500.63,89100,347600.63
317170,202101,222,150,72,165000,79200,244200
317180,202101,441,300,141,330000,155100,485100
317190,202101,262,185,77,203500,84700,288200
317200,202101,826,573,253,630300,278300,908600
317210,202101,182,99,83,108900,91300,200200
317220,202101,24,13,11,14300,12100,26400
320010,202101,594,425,169,468600,185900,654500
320013,202101,119,83,36,91300,39600,130900
320016,202101,264,168,96,184800,107800,292600
320020,202101,716,416,300,457601.23,331100,788701.23
320030,202101,151,107,44,117700.06,48400.08,166100.14
320035,202101,138,99,39,108900,42900,151800
320040,202101,501,254,247,279400,271700,551100
320050,202101,106,76,30,83600,33000,116600
320060,202101,1693,800,893,882200,983400,1865600
320070,202101,95,60,35,66000,38500,104500
320080,202101,798,458,340,503800,375100,878900
320090,202101,1251,828,423,911900,466400,1378300
320100,202101,323,188,135,206800,148500,355300
320110,202101,120,76,44,84700,49500,134200
320115,202101,110,91,19,100100,22000,122100
320120,202101,3552,1871,1681,2061400,1850200.74,3911600.74
320130,202101,7490,3375,4115,3714700.81,4532000,8246700.81
320140,202101,432,282,150,311300,165000.81,476300.81
320150,202101,2043,1139,904,1256200,994400,2250600
320160,202101,655,293,362,322300,399300,721600
320170,202101,108,85,23,93500.1,25300.02,118800.12
320180,202101,56,32,24,36300,26400,62700
320190,202101,236,151,85,166100,93500,259600
320200,202101,57,42,15,46200,16500,62700
320210,202101,899,488,411,539000,452100,991100
320220,202101,295,103,192,113300,212300,325600
320225,202101,85,66,19,72600,20900,93500
320230,202101,622,389,233,427900,257400,685300
320240,202101,3345,1603,1742,1765500,1919500,3685000
320245,202101,478,323,155,355300,170500,525800
320250,202101,225,114,111,125400,122100,247500
320255,202101,131,102,29,112200,31900,144100
320260,202101,219,137,82,150700.2,90200.12,240900.32
320265,202101,148,112,36,123200,39600,162800
320270,202101,149,115,34,126500,37400,163900
320280,202101,1127,639,488,704000.5,539000.02,1243000.52
320290,202101,55,47,8,51700,8800,60500
320300,202101,591,403,188,443300.02,206800,650100.02
320305,202101,675,350,325,385000,357500,742500
320310,202101,198,113,85,124300,93500,217800
320313,202101,340,161,179,177100,196900,374000
320316,202101,112,85,27,93500,29700,123200
320320,202101,3395,1498,1897,1647800,2092200,3740000
320330,202101,257,191,66,210100,72600,282700
320332,202101,763,461,302,507100,332200,839300
320334,202101,247,141,106,155100.02,116600,271700.02
320335,202101,147,98,49,107800,53900,161700
320340,202101,559,387,172,425700,189200,614900
320350,202101,1017,425,592,467500.5,652300,1119800.5
320360,202101,166,90,76,99000,83600,182600
320370,202101,241,179,62,196900,68200,265100
320380,202101,288,198,90,217800,99000,316800
320390,202101,1146,681,465,750200,512600,1262800
320400,202101,313,226,87,248600,95700,344300
320405,202101,955,386,569,424600,627000,1051600
320410,202101,954,482,472,530200,519200,1049400
320420,202101,513,245,268,269500,294800,564300
320425,202101,189,101,88,111100,96800,207900
320430,202101,400,215,185,237600,203500,441100
320435,202101,157,105,52,115500,57200,172700
320440,202101,199,114,85,125400.28,93500.2,218900.48
320450,202101,130,72,58,79200,63800,143000
320455,202101,251,201,50,222200,55000,277200
320460,202101,281,166,115,182600,126500,309100
320465,202101,114,76,38,83600,41800,125400
320470,202101,698,420,278,462000,305800,767800
320480,202101,195,126,69,138600,75900,214500
320490,202101,3062,1494,1568,1644501.23,1727001.3,3371502.53
320495,202101,110,66,44,72600,48400,121000
320500,202101,9609,4657,4952,5128200,5454900,10583100
320501,202101,538,270,268,297000,294800,591800
320503,202101,291,204,87,224400.1,95700.02,320100.12
320506,202101,261,183,78,201300,85800,287100
320510,202101,1056,467,589,513700,650100,1163800
320515,202101,83,63,20,70400,22000,92400
320517,202101,216,154,62,169400,71500,240900
320520,202101,7038,2976,4062,3275800.29,4470400,7746200.29
320530,202101,6287,3084,3203,3394017.5,3527700,6921717.5
330010,202101,3077,1535,1542,1690700,1697300,3388000
330015,202101,168,68,100,74800,110000,184800
330020,202101,3746,1527,2219,1680800,2442000,4122800
330022,202101,250,127,123,139700,135300,275000
330023,202101,660,210,450,231000,497200,728200
330025,202101,586,112,474,123200,522500,645700
330030,202101,1880,1168,712,1287000.5,784300,2071300.5
330040,202101,2425,1212,1213,1335400,1335400,2670800
330045,202101,9151,2732,6419,3008500.5,7074100,10082600.5
330050,202101,879,558,321,613800,353100,966900
330060,202101,1018,600,418,660000,459800,1119800
330070,202101,3787,1320,2467,1453100,2715900,4169000
330080,202101,1577,682,895,750200,984500,1734700
330090,202101,391,226,165,248600,181500,430100
330093,202101,261,115,146,126500,160600,287100
330095,202101,76,45,31,49500,34100,83600
330100,202101,9924,4915,5009,5406500.5,5518700.73,10925201.23
330110,202101,468,195,273,214500,300300,514800
330115,202101,512,271,241,300300,266200,566500
330120,202101,385,191,194,210100,213400.37,423500.37
330130,202101,1563,380,1183,418000,1301300,1719300
330140,202101,608,318,290,349800,320100,669900
330150,202101,516,293,223,324500,246400,570900
330160,202101,205,121,84,134200,92400,226600
330170,202101,27137,9006,18131,9917600,19965001.38,29882601.38
330180,202101,237,140,97,154000,106700,260700
330185,202101,981,347,634,381700,699600,1081300
330187,202101,400,120,280,132000,308000,440000
330190,202101,5864,2192,3672,2415600,4043600,6459200
330200,202101,4694,1388,3306,1527900.86,3641000,5168900.86
330205,202101,439,249,190,273900,209000,482900
330210,202101,946,574,372,631400,409200,1040600
330220,202101,2681,1568,1113,1727000,1226500,2953500
330225,202101,567,285,282,314600,310200,624800
330227,202101,2426,723,1703,796400,1877700,2674100
330230,202101,254,142,112,156200,123200,279400
330240,202101,3833,1878,1955,2069100,2152700,4221800
330245,202101,149,65,84,71500,92400,163900
330250,202101,6652,3298,3354,3632200,3694901.03,7327101.03
330260,202101,609,150,459,165000,504900,669900
330270,202101,3630,1195,2435,1314500,2680700,3995200
330280,202101,445,284,161,312400,177100,489500
330285,202101,6965,2135,4830,2350700,5319600,7670300
330290,202101,658,234,424,257400,466400,723800
330300,202101,768,493,275,544075.6,303600,847675.6
330310,202101,441,240,201,264000,223300,487300
330320,202101,7994,2865,5129,3157000,5646397.9,8803397.9
330330,202101,9143,3347,5796,3685000.02,6383300,10068300.02
330340,202101,2657,1532,1125,1686300,1240800,2927100
330350,202101,18636,6912,11724,7610900,12910701.74,20521601.74
330360,202101,2198,1045,1153,1150600,1272700,2423300
330370,202101,1019,500,519,550000,570900,1120900
330380,202101,909,375,534,412500,587400.01,999900.01
330385,202101,630,319,311,350900,342100,693000
330390,202101,5638,2894,2744,3188900,3022800,6211700
330395,202101,314,184,130,202400,143000,345400
330400,202101,709,369,340,407000,375100,782100
330410,202101,500,361,139,397100,152900,550000
330411,202101,253,134,119,148500,130900,279400
330412,202101,227,90,137,99000,150700,249700
330414,202101,5328,2114,3214,2330900,3542000,5872900
330415,202101,611,265,346,291500,380600,672100
330420,202101,2219,1107,1112,1218800,1225400,2444200
330430,202101,1765,782,983,860200,1081300,1941500
330440,202101,296,134,162,147400,178200,325600
330450,202101,119,51,68,56100,74800,130900
330452,202101,2089,902,1187,992200,1309000,2301200
330455,202101,113734,38780,74954,42696595.8,82549503.37,125246099.17
330460,202101,251,109,142,119900,156200,276100
330470,202101,1212,657,555,722700,611600,1334300
330475,202101,1568,411,1157,452100,1272700,1724800
330480,202101,822,444,378,488400,416900,905300
330490,202101,14823,4644,10179,5115105,11214500.26,16329605.26
330500,202101,1411,600,811,661100,892100,1553200
330510,202101,10828,3685,7143,4056800,7867200,11924000
330513,202101,97,49,48,53900,52800,106700
330515,202101,784,322,462,354200,509300,863500
330520,202101,2509,861,1648,948200,1813900,2762100
330530,202101,201,113,88,124300,97900,222200
330540,202101,358,177,181,194700,199100,393800
330550,202101,2942,996,1946,1097800,2143900,3241700
330555,202101,800,312,488,343200,539000,882200
330560,202101,698,229,469,251900,517000,768900
330570,202101,271,193,78,212886.66,85800,298686.66
330575,202101,797,279,518,308000,569800,877800
330580,202101,3379,1859,1520,2044900.5,1673100,3718000.5
330590,202101,276,144,132,158400.5,146300,304700.5
330600,202101,1186,732,454,805200,501600,1306800
330610,202101,1571,838,733,922900,807400,1730300
330615,202101,219,169,50,185900,55000,240900
330620,202101,1096,408,688,448800,757900,1206700
330630,202101,4096,2494,1602,2746701.05,1763300,4510001.05
350010,202101,577,380,197,419100.88,216700,635800.88
350020,202101,56,22,34,24200,37400,61600
350030,202101,510,315,195,346500,214500,561000
350040,202101,126,52,74,57200,81400,138600
350050,202101,320,167,153,184800,168300,353100
350055,202101,104,51,53,56100,58300,114400
350060,202101,87,32,55,35200,60500,95700
350070,202101,776,452,324,497200.2,356400,853600.2
350075,202101,75,47,28,52800,30800,83600
350080,202101,58,27,31,29700,34100,63800
350090,202101,81,46,35,50600,38500,89100
350100,202101,280,171,109,189200,121000,310200
350110,202101,58,41,17,45100,18700,63800
350115,202101,141,85,56,93500,61600,155100
350120,202101,104,66,38,72600,41800,114400
350130,202101,370,162,208,178200.56,228800,407000.56
350140,202101,41,25,16,27500,17600,45100
350150,202101,76,57,19,62700,20900,83600
350160,202101,2417,948,1469,1043900,1622500,2666400
350170,202101,386,220,166,242000,182600,424600
350180,202101,166,93,73,102300,80300,182600
350190,202101,988,521,467,574200.63,513700,1087900.63
350200,202101,70,26,44,28600,48400,77000
350210,202101,1294,707,587,778800,646800.63,1425600.63
350220,202101,654,536,118,590700.63,129800,720500.63
350230,202101,74,48,26,52800,28600,81400
350240,202101,60,43,17,47300,18700,66000
350250,202101,1163,545,618,599500,679800,1279300
350260,202101,95,68,27,74800,29700,104500
350270,202101,888,593,295,652300,326700.97,979000.97
350275,202101,293,120,173,132000,192500,324500
350280,202101,4537,2284,2253,2515700,2480500,4996200
350290,202101,454,201,253,221100,278300,499400
350300,202101,54,28,26,30800,28600,59400
350310,202101,80,52,28,57200,30800,88000
350315,202101,60,28,32,30800,35200,66000
350320,202101,3333,1605,1728,1766600,1904100.37,3670700.37
350330,202101,1655,874,781,962501.26,863500,1826001.26
350335,202101,17,12,5,13200,5500,18700
350340,202101,125,54,71,59400,78100,137500
350350,202101,93,46,47,50600,51700,102300
350360,202101,110,72,38,79200,41800,121000
350370,202101,82,46,36,50600.63,39600,90200.63
350380,202101,778,323,455,357500,500500,858000
350390,202101,1614,593,1021,654500.5,1124200,1778700.5
350395,202101,23,19,4,20900,4400,25300
350400,202101,1685,832,853,916301.89,938300.63,1854602.52
350410,202101,2767,1163,1604,1283700,1767720.63,3051420.63
350420,202101,256,153,103,168300,113300,281600
350430,202101,73,41,32,45100,35200,80300
350440,202101,152,109,43,119900,48400,168300
350450,202101,1683,967,716,1069201.13,788700,1857901.13
350460,202101,399,133,266,146300,292600,438900
350470,202101,19,10,9,11000,9900,20900
350480,202101,179,96,83,105600,91300,196900
350490,202101,236,111,125,122100,137500,259600
350500,202101,52,21,31,23100,34100,57200
350510,202101,167,107,60,118800,66000,184800
350520,202101,444,232,212,255200,233200,488400
350530,202101,437,198,239,218900,262900,481800
350535,202101,82,62,20,68200,22000,90200
350540,202101,372,189,183,207900,201300,409200
350550,202101,2655,1529,1126,1685200.77,1239701.26,2924902.03
350560,202101,599,409,190,451000,209000,660000
350570,202101,4191,1706,2485,1879900.63,2737901.27,4617801.90
350580,202101,365,178,187,195910,206800,402710
350590,202101,927,495,432,545600,476300,1021900
350600,202101,6069,2865,3204,3152600,3528800,6681400
350610,202101,1486,766,720,844800.63,792000,1636800.63
350620,202101,28,18,10,19800,11000,30800
350630,202101,245,136,109,149600.63,119900.63,269501.26
350635,202101,976,382,594,421300,654500,1075800
350640,202101,120,92,28,101200,30800,132000
350650,202101,1865,1243,622,1369500,687500,2057000
350660,202101,748,312,436,343200,480700,823900
350670,202101,304,152,152,167200,167200,334400
350680,202101,173,88,85,97900,93500,191400
350690,202101,193,90,103,99000,113300,212300
350700,202101,805,381,424,420200,467500,887700
350710,202101,382,139,243,152900,267300,420200
350715,202101,54,43,11,47300,12100,59400
350720,202101,18,12,6,13200,6600,19800
350730,202101,45,28,17,30800,18700,49500
350740,202101,215,124,91,136400,100100,236500
350745,202101,23,8,15,8800,16500,25300
350750,202101,2219,1349,870,1485000,958100,2443100
350760,202101,3744,1563,2181,1719300.26,2402400,4121700.26
350770,202101,57,40,17,44000,18700,62700
350775,202101,42,29,13,31900,14300,46200
350780,202101,425,213,212,234300,234300,468600
350790,202101,362,149,213,165000,234300,399300
350800,202101,472,274,198,303600,217800,521400
350810,202101,518,412,106,453200,116600,569800
350820,202101,92,54,38,59400,41800,101200
350830,202101,75,39,36,42900,39600,82500
350840,202101,764,298,466,327800,513700,841500
350850,202101,1725,933,792,1029600.99,873400,1903000.99
350860,202101,608,336,272,369600,300300,669900
350870,202101,437,289,148,317900,163900,481800
350880,202101,286,158,128,173800,140800,314600
350890,202101,41,25,16,27500,17600,45100
350900,202101,1471,450,1021,495000,1129700.63,1624700.63
350910,202101,28,15,13,16500,14300,30800
350920,202101,700,360,340,397100,375100,772200
350925,202101,1183,628,555,691900,610500.63,1302400.63
350930,202101,100,59,41,64900,45100,110000
350940,202101,734,399,335,438900,368500,807400
350945,202101,112,81,31,89100,34100,123200
350950,202101,16402,7511,8891,8273100.63,9797700,18070800.63
350960,202101,1429,621,808,684200,888800,1573000
350970,202101,1086,560,526,616981.2,578600,1195581.2
350980,202101,97,65,32,71500,35200,106700
350990,202101,375,134,241,147400,265100,412500
350995,202101,37,17,20,18700,22000,40700
351000,202101,630,424,206,468600.63,226600,695200.63
351010,202101,54,33,21,36300,23100,59400
351015,202101,49,33,16,36300,17600,53900
351020,202101,1569,944,625,1040600,688600,1729200
351030,202101,331,207,124,228800,136400,365200
351040,202101,904,454,450,499400,495000.2,994400.2
351050,202101,3330,1482,1848,1632400,2033900,3666300
351060,202101,5325,2003,3322,2209900,3659700,5869600
351070,202101,396,251,145,278300.63,159500,437800.63
351080,202101,714,518,196,569800,215600,785400
351090,202101,52,24,28,26400,30800,57200
351100,202101,430,241,189,265100,207900,473000
351110,202101,2023,949,1074,1047201.13,1182500,2229701.13
351120,202101,66,34,32,37400,35200,72600
351130,202101,186,60,126,66000,138600,204600
351140,202101,323,209,114,229900,125400,355300
351150,202101,434,223,211,246400,232100,478500
351160,202101,282,182,100,200200.63,110000,310200.63
351170,202101,187,98,89,107800,97900,205700
351190,202101,88,62,26,68200,28600,96800
351200,202101,366,236,130,259600,143000,402600
351210,202101,114,53,61,58300,67100,125400
351220,202101,529,317,212,348701.18,233200,581901.18
351230,202101,265,183,82,201300,90200,291500
351240,202101,238,110,128,122100,140800,262900
351250,202101,80,55,25,60500.5,27500,88000.5
351260,202101,152,110,42,121000,46200,167200
351270,202101,45,17,28,18700,30800,49500
351280,202101,1019,462,557,508200.63,612700.63,1120901.26
351290,202101,240,104,136,114400,149600,264000
351300,202101,3732,1627,2105,1794013.6,2319900,4113913.6
351310,202101,743,365,378,402600,418000,820600
351320,202101,114,65,49,71500,53900,125400
351330,202101,37,25,12,27500,13200,40700
351340,202101,1260,732,528,805200,581900,1387100
351350,202101,2334,1332,1002,1468500.04,1103300,2571800.04
351360,202101,779,368,411,404800,453200,858000
351370,202101,377,191,186,210100,204600,414700
351380,202101,8906,3930,4976,4332900,5484600.63,9817500.63
351385,202101,26,17,9,18700,9900,28600
351390,202101,277,210,67,231000,74800,305800
351400,202101,67,40,27,44000,29700,73700
351410,202101,433,267,166,293700.55,182600,476300.55
351420,202101,72,52,20,57200,22000,79200
351430,202101,71,39,32,42900,35200,78100
351440,202101,781,538,243,591801.26,267300,859101.26
351450,202101,262,126,136,139700,149600,289300
351460,202101,129,56,73,61600,80300,141900
351470,202101,142,78,64,85800,70400,156200
351480,202101,488,283,205,311300.63,225500,536800.63
351490,202101,282,102,180,112200,198000,310200
351492,202101,24,17,7,18700,7700,26400
351495,202101,26,18,8,19800,9900,29700
351500,202101,3503,1439,2064,1588400,2274800,3863200
351510,202101,1954,735,1219,808500,1340900,2149400
351512,202101,17,13,4,14300,4400,18700
351515,202101,181,105,76,115500,83600,199100
351518,202101,712,448,264,492800,291500,784300
351519,202101,79,45,34,49500,37400,86900
351520,202101,149,89,60,97900,66019.8,163919.8
351530,202101,25,14,11,15400,12100,27500
351535,202101,132,81,51,89100,56100,145200
351540,202101,462,325,137,358600,150700,509300
351550,202101,1403,814,589,895401.26,647900,1543301.26
351560,202101,75,43,32,47300,35200,82500
351565,202101,12,8,4,8800,4400,13200
351570,202101,2682,1277,1405,1404700,1548800,2953500
351580,202101,39,34,5,37400,5500,42900
351590,202101,57,36,21,39600,23100,62700
351600,202101,189,133,56,146300,61600,207900
351610,202101,47,22,25,24200,27500,51700
351620,202101,5806,3195,2611,3522200.82,2878700,6400900.82
351630,202101,2864,1381,1483,1523500,1633500,3157000
351640,202101,2040,902,1138,992200.55,1251800.63,2244001.18
351650,202101,29,25,4,27500,4400,31900
351660,202101,134,86,48,94600,52800,147400
351670,202101,707,435,272,479600,299200,778800
351680,202101,65,54,11,59400,12100,71500
351685,202101,13,10,3,11000,3300,14300
351690,202101,295,201,94,221100.5,103400,324500.5
351700,202101,170,114,56,125400,61600,187000
351710,202101,71,45,26,49500,28600,78100
351720,202101,129,73,56,80300,61600,141900
351730,202101,106,66,40,72600,44000,116600
351740,202101,715,451,264,496100.74,290400,786500.74
351750,202101,345,139,206,152900,227700,380600
351760,202101,751,572,179,630300,196900,827200
351770,202101,308,255,53,280500.63,58300,338800.63
351780,202101,164,96,68,105600,75900,181500
351790,202101,247,128,119,141900,130900,272800
351800,202101,38,24,14,26400,15400,41800
351810,202101,119,80,39,88000,42900,130900
351820,202101,804,578,226,636900,248600,885500
351830,202101,554,188,366,206800,402600,609400
351840,202101,1946,917,1029,1010900,1131900,2142800
351850,202101,234,168,66,184800,72600,257400
351860,202101,640,445,195,489500,215600,705100
351870,202101,5519,2530,2989,2786302.12,3297751.96,6084054.08
351880,202101,19677,7803,11874,8596500.63,13081200.27,21677700.90
351885,202101,82,50,32,55000,35200,90200
351890,202101,69,55,14,60500,15400,75900
351900,202101,232,131,101,144100,111100,255200
351905,202101,82,33,49,36300,53900,90200
351907,202101,3477,1401,2076,1545500,2286900,3832400
351910,202101,176,72,104,79200,114400,193600
351920,202101,113,60,53,66000,58300,124300
351925,202101,87,56,31,61600,34100,95700
351930,202101,385,247,138,271700,154000,425700
351940,202101,234,99,135,108900,148500,257400
351950,202101,139,73,66,81400,72600,154000
351960,202101,918,455,463,500844.93,510400,1011244.93
351970,202101,1944,1001,943,1103300,1037300,2140600
351980,202101,158,69,89,77000,97900,174900
351990,202101,256,165,91,181500,100100,281600
352000,202101,329,209,120,231000,134200,365200
352010,202101,391,240,151,264071,166100,430171
352020,202101,183,71,112,78100,123200,201300
352030,202101,1095,549,546,605000,600600,1205600
352040,202101,569,236,333,259600,366300,625900
352042,202101,279,74,205,81400,227700,309100
352044,202101,352,216,136,237600,149600,387200
352050,202101,3207,1201,2006,1322200.63,2208800,3531000.63
352060,202101,103,62,41,68200,45100,113300
352070,202101,92,69,23,75901.26,25300,101201.26
352080,202101,63,40,23,44000,25300,69300
352090,202101,156,102,54,112200,59400,171600
352100,202101,284,136,148,150700,162800,313500
352110,202101,116,36,80,39600,88000,127600
352115,202101,61,21,40,23100,45100,68200
352120,202101,77,52,25,57200.63,27500,84700.63
352130,202101,219,179,40,198000,44000,242000
352140,202101,183,85,98,94600,107800,202400
352150,202101,115,61,54,67100,59400,126500
352160,202101,135,87,48,95700,52800,148500
352170,202101,380,258,122,283800,135300,419100
352180,202101,639,393,246,432300.63,270600,702900.63
352190,202101,242,97,145,106700,159500,266200
352200,202101,29,14,15,15400,16500,31900
352210,202101,4165,1668,2497,1838100.95,2747800,4585900.95
352215,202101,62,35,27,38500,29700,68200
352220,202101,6633,2447,4186,2693900,4612300.63,7306200.63
352230,202101,3310,2128,1182,2343001.13,1301300.42,3644301.55
352240,202101,2493,1422,1071,1564200.63,1180300,2744500.63
352250,202101,2812,1327,1485,1461902.19,1639000,3100902.19
352260,202101,975,512,463,564300,510400,1074700
352265,202101,56,28,28,30800,30800,61600
352270,202101,389,221,168,243100,184800,427900
352280,202101,463,274,189,301401.26,207900,509301.26
352290,202101,176,103,73,113300,80300,193600
352300,202101,96,65,31,72600,34100,106700
352310,202101,6489,2835,3654,3124000.99,4022700.61,7146701.60
352320,202101,1064,549,515,603900,567600,1171500
352330,202101,521,253,268,278300,294800,573100
352340,202101,1350,608,742,668800,816200,1485000
352350,202101,339,196,143,215600,157300,372900
352360,202101,221,98,123,107800,135300,243100
352370,202101,104,66,38,72600,41800,114400
352380,202101,109,74,35,81400,38500,119900
352390,202101,2521,1089,1432,1197900,1576300,2774200
352400,202101,499,219,280,242000,308000,550000
352410,202101,862,591,271,650100.63,299200,949300.63
352420,202101,94,67,27,73700,29700,103400
352430,202101,1752,795,957,874501.89,1056001.26,1930503.15
352440,202101,3244,1574,1670,1732500,1841400,3573900
352450,202101,200,161,39,177100,42900,220000
352460,202101,623,312,311,343200,343200,686400
352470,202101,648,220,428,242000,471900,713900
352480,202101,1420,775,645,854700,709500,1564200
352490,202101,66,22,44,24200,48400,72600
352500,202101,1231,514,717,566500,789800,1356300
352510,202101,714,379,335,416900.63,369600,786500.63
352520,202101,721,318,403,349947.4,444400,794347.4
352530,202101,1750,910,840,1002100,928400,1930500
352540,202101,72,47,25,51700,27500,79200
352550,202101,193,114,79,125400,86950.6,212350.6
352560,202101,48,38,10,41800,11000,52800
352570,202101,691,336,355,371800.63,390500,762300.63
352580,202101,57,43,14,47300,15400,62700
352585,202101,20,6,14,6600,15400,22000
352590,202101,4337,2132,2205,2349600.63,2435400,4785000.63
352600,202101,343,242,101,266200,111100,377300
352610,202101,928,420,508,462000.5,559900,1021900.5
352620,202101,1039,393,646,433400,711700,1145100
352630,202101,180,65,115,71500,126500,198000
352640,202101,512,334,178,367400,195800,563200
352650,202101,79,60,19,66000,20900,86900
352660,202101,63,37,26,40700,28600,69300
352670,202101,1683,877,806,966900.6,888800,1855700.6
352680,202101,917,565,352,622600,387200,1009800
352690,202101,4507,2003,2504,2204402.07,2757700.63,4962102.70
352700,202101,99,57,42,63800,46200,110000
352710,202101,1408,732,676,807400,744700,1552100
352720,202101,1399,632,767,695200,843700,1538900
352725,202101,23,18,5,19800,5500,25300
352730,202101,379,185,194,203500,214500,418000
352740,202101,410,264,146,290400,161700.8,452100.8
352750,202101,19,13,6,14300,6600,20900
352760,202101,188,121,67,133100,73700,206800
352770,202101,88,66,22,72600,25300,97900
352780,202101,80,43,37,47300,40700,88000
352790,202101,26,20,6,22000,6600,28600
352800,202101,233,176,57,193600,63800,257400
352810,202101,154,96,58,105600,63800,169400
352820,202101,50,39,11,42900,12100,55000
352830,202101,75,51,24,56100,26400,82500
352840,202101,661,321,340,353100,374000,727100
352850,202101,1572,502,1070,552200,1179200,1731400
352860,202101,116,74,42,81400,46200,127600
352870,202101,46,30,16,33000,17600,50600
352880,202101,182,116,66,127600,72600,200200
352885,202101,32,21,11,23100,12100,35200
352890,202101,55,36,19,39600,20900,60500
352900,202101,4675,2227,2448,2459600,2695000,5154600
352910,202101,39,31,8,34100,8800,42900
352920,202101,650,386,264,424600,290400,715000
352930,202101,1229,585,644,645700,710600,1356300
352940,202101,6093,2458,3635,2707100,4006200,6713300
352950,202101,112,37,75,40700,82500,123200
352960,202101,61,38,23,41800,25300,67100
352965,202101,17,8,9,8800,9900,18700
352970,202101,511,389,122,429000.35,134200,563200.35
352980,202101,159,85,74,93500,81400,174900
352990,202101,980,455,525,502700,577500,1080200
353000,202101,57,24,33,26400,36300,62700
353010,202101,542,332,210,365200,232100,597300
353020,202101,306,222,84,244200,92400,336600
353030,202101,1262,563,699,620400,768900,1389300
353040,202101,89,52,37,57200,40700,97900
353050,202101,1298,841,457,927300.9,502700,1430000.9
353060,202101,8429,3573,4856,3936900.71,5348200.49,9285101.20
353070,202101,1776,1066,710,1173701.91,781904.2,1955606.11
353080,202101,1264,674,590,742500.92,651200,1393700.92
353090,202101,61,32,29,35200,31900,67100
353100,202101,47,37,10,40700,11000,51700
353110,202101,2086,634,1452,698500,1601600,2300100
353120,202101,98,48,50,52800,55000,107800
353130,202101,857,417,440,458701.29,484000,942701.29
353140,202101,548,219,329,240900.63,361900,602800.63
353150,202101,326,184,142,203500.63,157300,360800.63
353160,202101,94,73,21,80300,23100,103400
353170,202101,213,68,145,74800,159500,234300
353180,202101,1093,488,605,536800,666600,1203400
353190,202101,486,355,131,392700,144100,536800
353200,202101,221,104,117,114400,129800,244200
353205,202101,20,13,7,14300,7700,22000
353210,202101,69,39,30,42900,33000,75900
353215,202101,42,23,19,25300,20900,46200
353220,202101,79,43,36,47300,39600,86900
353230,202101,158,60,98,66000,107800,173800
353240,202101,324,164,160,181500,176000,357500
353250,202101,208,100,108,110000,118800,228800
353260,202101,457,310,147,343200,162800,506000
353270,202101,73,54,19,59400,20900,80300
353280,202101,99,47,52,51700,57200,108900
353282,202101,127,90,37,99000,40700,139700
353284,202101,27,20,7,22000,7700,29700
353286,202101,2,0,2,0,2200,2200
353290,202101,79,43,36,47300,39600,86900
353300,202101,437,227,210,250801.26,231000,481801.26
353310,202101,48,40,8,44000,8800,52800
353320,202101,35,20,15,22000,16500,38500
353325,202101,49,29,20,31900,22000,53900
353330,202101,61,43,18,47300,19800,67100
353340,202101,643,230,413,254100,455400,709500
353350,202101,894,426,468,468600,514800,983400
353360,202101,99,79,20,86900,22000,108900
353370,202101,109,62,47,69300,51700,121000
353380,202101,31,17,14,19800,15400,35200
353390,202101,1103,519,584,573100,642400,1215500
353400,202101,43,22,21,24200,23100,47300
353410,202101,109,64,45,70400,49500,119900
353420,202101,59,23,36,25300,39600,64900
353430,202101,572,381,191,419101.5,210100,629201.5
353440,202101,11258,4850,6408,5340500.63,7060900,12401400.63
353450,202101,55,29,26,31900,28600,60500
353460,202101,613,327,286,359700,314600,674300
353470,202101,2169,1112,1057,1225400.6,1162700,2388100.6
353475,202101,246,165,81,181500,89100,270600
353480,202101,183,151,32,166100,35200,201300
353490,202101,236,136,100,150700,110000,260700
353500,202101,205,117,88,128700,96800,225500
353510,202101,94,64,30,70400,33000,103400
353520,202101,205,145,60,159500,67100,226600
353530,202101,464,241,223,265100,246400,511500
353540,202101,383,247,136,271700,150700,422400
353550,202101,713,462,251,508200.93,277200,785400.93
353560,202101,581,232,349,255200,385000,640200
353570,202101,64,36,28,39600,30800,70400
353580,202101,346,248,98,273900,108900,382800
353590,202101,80,59,21,64900,23100,88000
353600,202101,272,158,114,173800.63,125400,299200.63
353610,202101,128,68,60,74800,66000,140800
353620,202101,631,324,307,356400,337700,694100
353625,202101,53,26,27,28600,29700,58300
353630,202101,226,161,65,178200,72600,250800
353640,202101,125,81,44,89100,48400,137500
353650,202101,946,352,594,388300,653400,1041700
353657,202101,24,18,6,19800,6600,26400
353660,202101,270,142,128,156200,140800,297000
353670,202101,753,443,310,490600.63,342100,832700.63
353680,202101,108,78,30,85800,33000,118800
353690,202101,38,29,9,31900,9900,41800
353700,202101,271,188,83,207900,92400,300300
353710,202101,476,222,254,244200,279400,523600
353715,202101,50,32,18,35200,19800,55000
353720,202101,348,155,193,170500,212300,382800
353730,202101,1103,670,433,738100,476300,1214400
353740,202101,609,335,274,368500,301400,669900
353750,202101,75,44,31,48400,34100,82500
353760,202101,3027,1138,1889,1251800,2079000.9,3330800.9
353770,202101,84,66,18,73700,19800,93500
353780,202101,1258,586,672,646800.63,741400,1388200.63
353790,202101,495,299,196,328900,215600,544500
353800,202101,3446,1639,1807,1804020,1991074,3795094
353810,202101,232,127,105,140800,116600,257400
353820,202101,207,89,118,97900,129800,227700
353830,202101,53,46,7,50600,7700,58300
353850,202101,177,84,93,92400,102300,194700
353860,202101,513,218,295,240900,325600,566500
353870,202101,5395,2678,2717,2949100,2990900,5940000
353880,202101,684,465,219,511500,240900,752400
353890,202101,538,312,226,343200,248600.59,591800.59
353900,202101,133,70,63,77000,69300,146300
353910,202101,178,77,101,84700,111100,195800
353920,202101,415,228,187,250800,205700,456500
353930,202101,1016,589,427,650100,470800,1120900
353940,202101,192,96,96,105600.15,106700,212300.15
353950,202101,503,309,194,339900,213400,553300
353960,202101,79,64,15,70400,16500,86900
353970,202101,43,28,15,30800,16500,47300
353980,202101,1701,764,937,840400,1030700,1871100
353990,202101,70,41,29,45100,31900,77000
354000,202101,380,177,203,194700,223300,418000
354010,202101,88,51,37,56100,40700,96800
354020,202101,504,315,189,346500,209000,555500
354025,202101,36,31,5,34100,5500,39600
354030,202101,50,30,20,33000,22000,55000
354040,202101,97,72,25,80300,27500,107800
354050,202101,172,96,76,105600.63,83600,189200.63
354060,202101,752,363,389,399300,427900,827200
354070,202101,910,508,402,562100.46,442200,1004300.46
354075,202101,180,84,96,92400,106700,199100
354080,202101,311,131,180,144100,198000,342100
354085,202101,20,13,7,14300,7700,22000
354090,202101,284,165,119,181407,130900,312307
354100,202101,5548,2238,3310,2461800.4,3645400,6107200.4
354105,202101,95,44,51,48400,56100,104500
354110,202101,46,22,24,24200,26400,50600
354120,202101,145,101,44,111100,48400,159500
354130,202101,709,441,268,485100,297000,782100
354140,202101,3187,1457,1730,1604900.55,1905200,3510100.55
354150,202101,632,374,258,411400.66,284900,696300.66
354160,202101,640,403,237,443300,261800,705100
354165,202101,16,13,3,14300,3300,17600
354170,202101,169,116,53,127600,58300,185900
354180,202101,58,35,23,38500.42,25300,63800.42
354190,202101,189,77,112,84700,123200,207900
354200,202101,108,57,51,62700,56100,118800
354210,202101,62,24,38,26400,41800,68200
354220,202101,651,412,239,453200.63,262900,716100.63
354230,202101,166,70,96,77000,105600,182600
354240,202101,332,212,120,234300.82,132000,366300.82
354250,202101,82,51,31,56100,34100,90200
354260,202101,2102,991,1111,1091200.5,1223200.85,2314401.35
354270,202101,88,65,23,71500,25300,96800
354280,202101,46,23,23,25300,25300,50600
354290,202101,136,94,42,103400,46200,149600
354300,202101,368,259,109,284900.63,119900,404800.63
354310,202101,87,66,21,72600,23100,95700
354320,202101,209,103,106,113300,116600,229900
354323,202101,10,9,1,9900,1100,11000
354325,202101,119,68,51,74800.83,56100,130900.83
354330,202101,2402,803,1599,883143,1762200,2645343
354340,202101,10274,4825,5449,5314968,6000500.27,11315468.27
354350,202101,138,88,50,96800,56100,152900
354360,202101,67,36,31,39600,34100,73700
354370,202101,235,122,113,134200,124300,258500
354380,202101,183,110,73,121000,80300,201300
354390,202101,2665,959,1706,1059300,1885400,2944700
354400,202101,295,163,132,179300,145200,324500
354410,202101,618,291,327,320100,359700,679800
354420,202101,264,170,94,187000,103400,290400
354425,202101,304,176,128,193651.07,140800,334451.07
354430,202101,185,105,80,115500,88000,203500
354440,202101,33,25,8,27500,8800,36300
354450,202101,51,33,18,36300,19800,56100
354460,202101,98,55,43,60500,47300,107800
354470,202101,32,17,15,18700,16500,35200
354480,202101,115,62,53,68200,58300,126500
354490,202101,140,84,56,93500,61600,155100
354500,202101,390,180,210,198000,231000,429000
354510,202101,93,64,29,70400,31900,102300
354515,202101,36,11,25,12100,27500,39600
354520,202101,1590,672,918,743443,1009800,1753243
354530,202101,785,388,397,427900,437800,865700
354540,202101,261,137,124,150700,137500,288200
354550,202101,37,24,13,26400,14300,40700
354560,202101,148,75,73,82500,80300,162800
354570,202101,132,87,45,95700,49500,145200
354580,202101,1823,849,974,935000,1076900,2011900
354600,202101,259,136,123,149600,135300,284900
354610,202101,72,61,11,67100,12100,79200
354620,202101,61,15,46,16500,50600,67100
354625,202101,14,9,5,9900,5500,15400
354630,202101,295,189,106,207900,116600,324500
354640,202101,799,505,294,557700,324500,882200
354650,202101,67,39,28,42900,30800,73700
354660,202101,785,583,202,642400.63,222200,864600.63
354670,202101,235,89,146,97900,160600,258500
354680,202101,1273,457,816,506000,900900,1406900
354690,202101,81,55,26,60500,28600,89100
354700,202101,69,49,20,53900,22000,75900
354710,202101,47,33,14,36300,15400,51700
354720,202101,19,19,0,20900,0,20900
354730,202101,1741,719,1022,793100,1127500,1920600
354740,202101,77,51,26,56100,28600,84700
354750,202101,419,240,179,264000,196900,460900
354760,202101,463,278,185,305800,203500,509300
354765,202101,10,5,5,5500,5500,11000
354770,202101,343,224,119,246400,130900,377300
354780,202101,8151,3158,4993,3482601.13,5503300,8985901.13
354790,202101,91,51,40,56100,44000,100100
354800,202101,445,239,206,262804.05,226600,489404.05
354805,202101,88,39,49,42900,53900,96800
354810,202101,107,64,43,70400,47300,117700
354820,202101,208,82,126,90200,139700,229900
354830,202101,41,21,20,23100,22000,45100
354840,202101,55,38,17,41800,18700,60500
354850,202101,4439,1934,2505,2129600.08,2764300.06,4893900.14
354860,202101,327,156,171,172700,188100.63,360800.63
354870,202101,11887,5233,6654,5765101.26,7335900,13101001.26
354880,202101,2709,1000,1709,1102200.89,1882100,2984300.89
354890,202101,2886,1527,1359,1685201.43,1496000,3181201.43
354900,202101,62,42,20,46200,22000,68200
354910,202101,1256,639,617,702900,680900,1383800
354920,202101,40,32,8,35200,8800,44000
354925,202101,17,7,10,7700,11000,18700
354930,202101,37,33,4,36300.4,4400,40700.4
354940,202101,783,563,220,619575,242000,861575
354950,202101,200,127,73,140800,80300,221100
354960,202101,144,54,90,59400,99000,158400
354970,202101,991,657,334,722701.12,367400,1090101.12
354980,202101,8730,3091,5639,3401202.23,6206200.39,9607402.62
354990,202101,9406,4231,5175,4659600,5704600,10364200
354995,202101,540,169,371,185900,408100,594000
355000,202101,456,154,302,170500,332200,502700
355010,202101,591,358,233,393800,257400.63,651200.63
355020,202101,774,479,295,528000,324500,852500
355030,202101,207680,78451,129229,86424603.65,142358745.68,228783349.33
355040,202101,780,343,437,380600,480700,861300
355050,202101,152,89,63,99000,69300,168300
355060,202101,1624,801,823,882200,907500,1789700
355070,202101,1462,686,776,756800.08,854700.73,1611500.81
355080,202101,191,116,75,128700,82500,211200
355090,202101,284,163,121,181500,133100.57,314600.57
355100,202101,4989,2356,2633,2596990,2901800,5498790
355110,202101,238,160,78,176000,86900,262900
355120,202101,58,37,21,40700,23100,63800
355130,202101,47,26,21,28600,23100,51700
355140,202101,180,106,74,116600,81400,198000
355150,202101,672,391,281,430100,309100,739200
355160,202101,476,226,250,248600.63,275000,523600.63
355170,202101,2040,1051,989,1157200,1089000,2246200
355180,202101,682,282,400,311300,441100,752400
355190,202101,209,137,72,150700,79200,229900
355200,202101,109,61,48,67100,52800,119900
355210,202101,689,384,305,422400,336600,759000
355220,202101,7193,3615,3578,3983100,3941300,7924400
355230,202101,98,60,38,66000,41800,107800
355240,202101,4422,1796,2626,1976701.13,2895200,4871901.13
355250,202101,5865,2554,3311,2816021.06,3646500,6462521.06
355255,202101,50,28,22,30800,24200,55000
355260,202101,178,111,67,122100,73700,195800
355270,202101,168,108,60,118800,68200,187000
355280,202101,6443,2473,3970,2723600,4370300,7093900
355290,202101,74,60,14,66000,15400,81400
355300,202101,197,113,84,124300,92400,216700
355310,202101,109,57,52,62700,57200,119900
355320,202101,92,49,43,53900,47300,101200
355330,202101,275,157,118,173800,129800,303600
355340,202101,1455,504,951,556600.55,1046100,1602700.55
355350,202101,145,68,77,74800,84700,159500
355360,202101,167,109,58,119900,63800,183700
355365,202101,20,16,4,17600,4400,22000
355370,202101,1032,608,424,669900.63,466400,1136300.63
355380,202101,825,515,310,566500.26,342100,908600.26
355385,202101,75,50,25,55000,28600,83600
355390,202101,110,60,50,66000,55000,121000
355395,202101,195,106,89,116600.5,97900,214500.5
355400,202101,1716,1011,705,1113109,776600.63,1889709.63
355410,202101,4876,2254,2622,2484900,2890800,5375700
355420,202101,48,34,14,37400,15400,52800
355430,202101,389,236,153,260700,168300,429000
355440,202101,86,51,35,56100,38500,94600
355450,202101,448,219,229,242000,253000,495000
355460,202101,62,48,14,52800,15400,68200
355465,202101,45,26,19,28600,20900,49500
355470,202101,177,73,104,80300,114400,194700
355475,202101,10,6,4,6600,4400,11000
355480,202101,537,215,322,236500,354200,590700
355490,202101,117,83,34,91300,38500,129800
355495,202101,64,24,40,26400,44000,70400
355500,202101,1559,857,702,943800.48,774400,1718200.48
355510,202101,266,193,73,212300.63,80300,292600.63
355520,202101,32,24,8,26400,8800,35200
355530,202101,21,12,9,13200,9900,23100
355535,202101,73,33,40,36300,44000,80300
355540,202101,2497,969,1528,1067155.1,1681900.63,2749055.73
355550,202101,58,36,22,39600,24200,63800
355560,202101,245,115,130,126500,144100,270600
355570,202101,21,13,8,15400,8800,24200
355580,202101,244,173,71,191400,78100,269500
355590,202101,16,10,6,11000,6600,17600
355600,202101,267,134,133,148500,146300,294800
355610,202101,227,151,76,167200,83600,250800
355620,202101,1313,576,737,636900,810700,1447600
355630,202101,424,312,112,345400,124300.63,469700.63
355635,202101,112,52,60,57200,66000,123200
355640,202101,549,308,241,338800,265100,603900
355645,202101,852,332,520,366300,573100,939400
355650,202101,1941,813,1128,897600,1241900,2139500
355660,202101,238,127,111,140800,124300,265100
355670,202101,576,239,337,262900,371800,634700
355680,202101,206,115,91,126500,100100,226600
355690,202101,91,42,49,46200,53900.54,100100.54
355695,202101,21,13,8,14300,8800,23100
355700,202101,1138,583,555,642400,611600,1254000
355710,202101,2206,1190,1016,1310100,1119800,2429900
355715,202101,12,10,2,11000,2200,13200
355720,202101,229,136,93,149600,102300,251900
355730,202101,100,57,43,62700,47300,110000
410010,202101,131,107,24,117700,26400,144100
410020,202101,116,89,27,97900,29700,127600
410030,202101,167,92,75,102300,82500,184800
410040,202101,1198,589,609,649000,669900,1318900
410045,202101,38,29,9,31900,9900,41800
410050,202101,480,271,209,298100,229900,528000
410060,202101,276,202,74,223300,81400,304700
410070,202101,296,245,51,269500,56100,325600
410080,202101,173,106,67,116600,73700,190300
410090,202101,74,64,10,70400,11000,81400
410100,202101,290,202,88,222200,96800,319000
410105,202101,46,28,18,30800,19800,50600
410110,202101,328,194,134,213400,147400,360800
410115,202101,35,23,12,25300,13200,38500
410120,202101,421,205,216,225500,237600,463100
410130,202101,52,32,20,35200,22000,57200
410140,202101,3131,1466,1665,1615900.03,1832600.88,3448500.91
410150,202101,2666,1027,1639,1133000,1806200,2939200
410160,202101,504,310,194,341000,213400,554400
410165,202101,48,29,19,31900,20900,52800
410170,202101,177,112,65,123200,71500,194700
410180,202101,2232,1240,992,1365100,1094500,2459600
410185,202101,24,20,4,22000,4400,26400
410190,202101,495,307,188,337700,206800,544500
410200,202101,936,666,270,733700,297000,1030700
410210,202101,611,307,304,337700,334400,672100
410220,202101,45,21,24,23100,26400,49500
410230,202101,149,71,78,78100,85800,163900
410240,202101,737,468,269,514800.78,295900,810700.78
410250,202101,371,265,106,292600,116600,409200
410260,202101,299,165,134,181500,147400,328900
410270,202101,29,22,7,24200,7700,31900
410275,202101,55,42,13,46200,14300,60500
410280,202101,319,180,139,198000,154000,352000
410290,202101,247,147,100,161700,110000,271700
410300,202101,80,57,23,62700,25300,88000
410302,202101,24,16,8,17600,8800,26400
410304,202101,34,23,11,25300,12100,37400
410305,202101,213,109,104,119900,114400,234300
410310,202101,215,126,89,138600,97900,236500
410315,202101,48,34,14,37400,15400,52800
410320,202101,139,96,43,105600,47300,152900
410322,202101,32,21,11,23100,12100,35200
410330,202101,181,123,58,135300,63800,199100
410335,202101,104,58,46,63800,50600,114400
410337,202101,44,33,11,36300,12100,48400
410340,202101,40,33,7,36300,7700,44000
410345,202101,205,115,90,126500,99000,225500
410347,202101,46,35,11,38500,12100,50600
410350,202101,238,141,97,155100,107800,262900
410360,202101,457,284,173,313500,190300,503800
410370,202101,2304,952,1352,1048300,1489400,2537700
410380,202101,205,128,77,140800,84700,225500
410390,202101,379,257,122,282700,134200,416900
410395,202101,35,21,14,23100,15400,38500
410400,202101,830,369,461,405900.5,508200,914100.5
410405,202101,88,64,24,70400,26400,96800
410410,202101,29,21,8,23100,8800,31900
410420,202101,1697,789,908,868902.1,999900,1868802.1
410425,202101,178,71,107,78100,118800,196900
410430,202101,2305,1251,1054,1376100,1160500,2536600
410440,202101,378,275,103,302500,113300,415800
410442,202101,354,232,122,255200,134200,389400
410445,202101,426,301,125,331100,138600,469700
410450,202101,401,197,204,216700,224400,441100
410460,202101,526,263,263,289300,290400,579700
410465,202101,228,134,94,147400,103400,250800
410470,202101,243,143,100,157300,110000,267300
410480,202101,6218,2939,3279,3234000,3615700,6849700
410490,202101,1417,843,574,927300.33,632500,1559800.33
410500,202101,269,151,118,166100,129800,295900
410510,202101,169,126,43,138600,47300,185900
410520,202101,248,183,65,201300,71500,272800
410530,202101,304,102,202,112200,222200,334400
410540,202101,320,237,83,260700,91300,352000
410550,202101,1685,707,978,779900,1078000,1857900
410560,202101,151,106,45,116600,49500,166100
410570,202101,426,284,142,312400,156200,468600
410580,202101,3472,1476,1996,1629101.04,2196700,3825801.04
410590,202101,393,262,131,288181,144100,432281
410600,202101,190,163,27,179300,29700,209000
410610,202101,49,40,9,45100,9900,55000
410620,202101,246,164,82,180400.4,90200,270600.4
410630,202101,440,243,197,267300,216700,484000
410640,202101,1016,640,376,704000,414700,1118700
410645,202101,111,78,33,85800,36300,122100
410650,202101,355,225,130,247500,143000,390500
410655,202101,90,63,27,69300,30800,100100
410657,202101,29,11,18,12100,19800,31900
410660,202101,607,415,192,456500.5,212300,668800.5
410670,202101,73,61,12,67100,13200,80300
410680,202101,209,165,44,182600,48400,231000
410685,202101,20,13,7,14300,7700,22000
410690,202101,28490,11882,16608,13082300.01,18287500.74,31369800.75
410700,202101,321,237,84,260700,92400,353100
410710,202101,128,103,25,113300,27500,140800
410712,202101,38,26,12,28600,13200,41800
410715,202101,88,64,24,70400,26400,96800
410720,202101,681,380,301,419100.92,332200,751300.92
410725,202101,180,129,51,141900,56100,198000
410730,202101,95,46,49,50600,53900,104500
410740,202101,106,75,31,82500,35200,117700
410750,202101,271,180,91,198000,100100,298100
410752,202101,22,13,9,14300,9900,24200
410753,202101,57,23,34,25300,37400,62700
410754,202101,52,26,26,28600,28600,57200
410755,202101,84,50,34,55000,37400,92400
410760,202101,767,420,347,462000,381700,843700
410765,202101,1791,808,983,888800,1085700,1974500
410770,202101,111,82,29,90200,31900,122100
410773,202101,56,39,17,42900,18700,61600
410775,202101,185,139,46,152900,50600,203500
410780,202101,86,47,39,51700,42900,94600
410785,202101,53,41,12,45100,13200,58300
410790,202101,83,37,46,40700,50600,91300
410800,202101,286,177,109,195800,119900,315700
410810,202101,25,16,9,17600,9900,27500
410820,202101,171,123,48,137500,52800,190300
410830,202101,8595,3647,4948,4016100.4,5448300,9464400.4
410832,202101,104,70,34,77000,37400,114400
410840,202101,1465,782,683,860200.21,751300,1611500.21
410845,202101,47,28,19,30800,20900,51700
410850,202101,184,130,54,143000,59400,202400
410855,202101,64,53,11,58300,12100,70400
410860,202101,744,393,351,432300,386100,818400
410865,202101,105,76,29,83600,31900,115500
410870,202101,152,129,23,141900,25300,167200
410880,202101,1128,563,565,619300,621500,1240800
410890,202101,88,62,26,68200,28600,96800
410895,202101,71,54,17,59400,18700,78100
410900,202101,23,17,6,18700,6600,25300
410910,202101,19,14,5,15400,5500,20900
410920,202101,36,24,12,26400,13200,39600
410930,202101,533,328,205,360800,225500,586300
410940,202101,4391,2400,1991,2640000.6,2194500,4834500.6
410950,202101,107,76,31,83600,34100,117700
410960,202101,838,335,503,368500.6,554400,922900.6
410965,202101,64,44,20,48400,22000,70400
410970,202101,627,440,187,484000,206800,690800
410975,202101,126,78,48,85800.38,52800,138600.38
410980,202101,1623,714,909,785400,1004300,1789700
410990,202101,270,191,79,210100,86900,297000
411000,202101,65,39,26,42900,28600,71500
411005,202101,28,23,5,26400,5500,31900
411007,202101,252,145,107,159500,117700,277200
411010,202101,603,403,200,443300,220000,663300
411020,202101,282,185,97,204600,107800,312400
411030,202101,19,10,9,11000,9900,20900
411040,202101,54,36,18,39600,19800,59400
411050,202101,209,157,52,172700,57200,229900
411060,202101,515,343,172,377300,189200,566500
411065,202101,52,46,6,50600,6600,57200
411070,202101,1257,744,513,819500,564300,1383800
411080,202101,239,170,69,187000,75900,262900
411090,202101,98,76,22,83600,24200,107800
411095,202101,286,108,178,118800,195800,314600
411100,202101,118,95,23,104500,25300,129800
411110,202101,127,77,50,84700,55000,139700
411120,202101,215,143,72,157300,79200,236500
411125,202101,242,101,141,111100,155100,266200
411130,202101,128,108,20,118800,22000,140800
411140,202101,214,140,74,154000,81400,235400
411150,202101,1261,821,440,903100,485100.63,1388200.63
411155,202101,117,79,38,86900,41800,128700
411160,202101,25,10,15,11000,16500,27500
411170,202101,52,46,6,50600,6600,57200
411180,202101,962,629,333,694100,366300,1060400
411190,202101,335,190,145,209000,159500,368500
411200,202101,673,402,271,442200.63,298100,740300.63
411210,202101,682,360,322,396000,354200,750200
411220,202101,157,109,48,119900,52800,172700
411230,202101,40,33,7,36300,7700,44000
411240,202101,118,74,44,81400,48400,129800
411250,202101,428,310,118,341000,129800,470800
411260,202101,15,11,4,12100,4400,16500
411270,202101,273,144,129,158400,141900,300300
411275,202101,178,156,22,171600,24200,195800
411280,202101,207,146,61,160600.63,67100,227700.63
411290,202101,63,47,16,51700,17600,69300
411295,202101,132,104,28,114400,30800,145200
411300,202101,79,33,46,36300,50600,86900
411310,202101,90,68,22,74800,24200,99000
411320,202101,790,517,273,568700,300300,869000
411325,202101,59,40,19,44000,20900,64900
411330,202101,907,581,326,640200,359700.15,999900.15
411340,202101,29,18,11,19800,12100,31900
411342,202101,56,41,15,45100,16500,61600
411345,202101,119,58,61,63800,67100,130900
411350,202101,483,364,119,400400,130900,531300
411360,202101,55,36,19,39600,20900,60500
411370,202101,14202,5672,8530,6245801.26,9395100.4,15640901.66
411373,202101,173,119,54,130900,59400,190300
411375,202101,80,63,17,69300,18700,88000
411380,202101,84,60,24,66000,26400,92400
411390,202101,129,77,52,84700,57200,141900
411400,202101,395,281,114,309100,125400,434500
411410,202101,458,221,237,243100,260700,503800
411420,202101,990,425,565,467500,621500,1089000
411430,202101,474,265,209,291500,229900,521400
411435,202101,32,19,13,20900,14300,35200
411440,202101,463,360,103,396000,113300,509300
411450,202101,427,358,69,393800,75900,469700
411460,202101,774,286,488,314600,536800.66,851400.66
411470,202101,94,65,29,71500,31900,103400
411480,202101,670,365,305,402600,335500,738100
411490,202101,287,183,104,201300,114400,315700
411500,202101,100,82,18,90200,19800,110000
411510,202101,216,173,43,191400,47300,238700
411520,202101,5997,2201,3796,2426600,4184400.7,6611000.7
411530,202101,128,85,43,94600,47300,141900
411535,202101,53,20,33,22000,36300,58300
411540,202101,356,243,113,267300,124300,391600
411545,202101,54,38,16,41800,17600,59400
411550,202101,83,64,19,70400,20900,91300
411560,202101,394,166,228,182600,250800,433400
411570,202101,870,298,572,327800,629200,957000
411573,202101,23,14,9,15400,9900,25300
411575,202101,300,185,115,203500,126500,330000
411580,202101,1258,449,809,495000,891000,1386000
411585,202101,76,37,39,40700,42900,83600
411590,202101,21,14,7,15400,7700,23100
411600,202101,23,10,13,11000,14300,25300
411605,202101,237,94,143,103400,157300,260700
411610,202101,210,134,76,147400,83600,231000
411620,202101,379,199,180,218900,198000,416900
411630,202101,55,37,18,40700,19800,60500
411640,202101,33,23,10,25300,11000,36300
411650,202101,12,7,5,7700,5500,13200
411660,202101,38,26,12,28600,13200,41800
411670,202101,236,172,64,189200,70400,259600
411680,202101,163,132,31,145200,34100,179300
411690,202101,589,310,279,341000,306900,647900
411695,202101,62,43,19,47300,22000,69300
411700,202101,144,114,30,125400,33000,158400
411705,202101,108,70,38,77000,41800,118800
411710,202101,294,196,98,215600,107800,323400
411720,202101,131,86,45,94600,49500,144100
411721,202101,73,60,13,66000,14300,80300
411722,202101,105,44,61,48400,67100,115500
411725,202101,155,116,39,127600,42900,170500
411727,202101,80,59,21,64900,23100,88000
411729,202101,40,32,8,35200,8800,44000
411730,202101,552,345,207,379500,227700,607200
411740,202101,36,21,15,23100,16500,39600
411745,202101,71,51,20,56100,22000,78100
411750,202101,839,363,476,399300,524700,924000
411760,202101,1170,864,306,950400,336600,1287000
411770,202101,455,299,156,328900,171600,500500
411780,202101,348,223,125,245300,137500,382800
411790,202101,527,293,234,323400.18,257400,580800.18
411800,202101,152,114,38,125400.65,41800,167200.65
411810,202101,176,132,44,145200,48400,193600
411820,202101,2258,971,1287,1069200,1417900,2487100
411830,202101,10,9,1,9900,1100,11000
411840,202101,2029,1225,804,1347500,884400,2231900
411845,202101,54,19,35,20900,38500,59400
411850,202101,1203,654,549,721600,607200,1328800
411860,202101,49,31,18,34100,19800,53900
411870,202101,73,47,26,51700,28600,80300
411880,202101,423,261,162,287100,178200,465300
411885,202101,98,63,35,69300,38500,107800
411890,202101,307,197,110,216700,121000,337700
411900,202101,77,61,16,67100,18700,85800
411910,202101,184,142,42,157300,46200,203500
411915,202101,2221,880,1341,968000,1475100,2443100
411920,202101,122,97,25,106700,27500,134200
411925,202101,12,6,6,6600,6600,13200
411930,202101,796,565,231,621570.4,256300,877870.4
411940,202101,578,382,196,422400,215600,638000
411950,202101,1046,493,553,542300.24,609400,1151700.24
411960,202101,1081,715,366,786500,402600,1189100
411965,202101,21,14,7,15400,7700,23100
411970,202101,92,78,14,85800,15400,101200
411980,202101,172,106,66,116600,72600,189200
411990,202101,5121,2869,2252,3158101.42,2483872,5641973.42
411995,202101,526,168,358,184800,393800,578600
412000,202101,322,206,116,226600,127600,354200
412010,202101,43,27,16,29700,17600,47300
412015,202101,40,30,10,33000,12100,45100
412020,202101,30,24,6,26400,6600,33000
412030,202101,45,43,2,47300,2200,49500
412033,202101,55,29,26,31900,28600,60500
412035,202101,71,44,27,48400,29700,78100
412040,202101,45,25,20,27500,22000,49500
412050,202101,209,155,54,170500,59400,229900
412060,202101,777,563,214,619300,236500,855800
412065,202101,52,31,21,34100,23100,57200
412070,202101,161,110,51,121000,56100,177100
412080,202101,300,148,152,162800,168300,331100
412085,202101,41,17,24,18700,26400,45100
412090,202101,802,503,299,553300,330000,883300
412100,202101,248,208,40,228800,44000,272800
412110,202101,73,55,18,61600,19800,81400
412120,202101,324,189,135,207900,149600,357500
412125,202101,78,48,30,52800,33000,85800
412130,202101,37,24,13,26400,14300,40700
412135,202101,29,16,13,17600,14300,31900
412140,202101,354,224,130,246400,144100,390500
412150,202101,250,165,85,182600,93500,276100
412160,202101,87,48,39,52800,42900,95700
412170,202101,700,476,224,523600,247500,771100
412175,202101,34,26,8,28600,8800,37400
412180,202101,192,145,47,159500,51700,211200
412190,202101,322,256,66,281600,72600,354200
412200,202101,185,120,65,132000,71500,203500
412210,202101,74,55,19,60500,20900,81400
412215,202101,232,163,69,179623.4,77000,256623.4
412217,202101,65,53,12,58300,13200,71500
412220,202101,829,572,257,630300,282700,913000
412230,202101,314,193,121,213400,133100,346500
412240,202101,1338,646,692,711700,761200,1472900
412250,202101,409,249,160,273900,176000,449900
412260,202101,105,73,32,80300,35200,115500
412265,202101,176,134,42,147400,46200,193600
412270,202101,87,60,27,66000,29700,95700
412280,202101,89,71,18,78100,19800,97900
412290,202101,94,65,29,71500,31900,103400
412300,202101,207,138,69,151800,75900,227700
412310,202101,53,43,10,47300,11000,58300
412320,202101,96,78,18,85800,19800,105600
412330,202101,181,151,30,166100,33000,199100
412340,202101,158,112,46,123200,50600,173800
412350,202101,629,305,324,335500,356400,691900
412360,202101,25,21,4,23100,4400,27500
412370,202101,159,138,21,151800,23100,174900
412380,202101,249,189,60,209000,66000,275000
412382,202101,59,33,26,36300,28600,64900
412385,202101,148,104,44,114400,48400,162800
412390,202101,279,209,70,229900,77000,306900
412395,202101,65,53,12,58300,13200,71500
412400,202101,95,64,31,70400,34100,104500
412402,202101,236,116,120,127600,132000,259600
412405,202101,895,307,588,337700,646800,984500
412410,202101,968,584,384,643500,423500,1067000
412420,202101,14,13,1,14300,1100,15400
412430,202101,19,16,3,17600,3300,20900
412440,202101,618,327,291,359700,320100,679800
412450,202101,77,67,10,73700,11000,84700
412460,202101,93,71,22,78100,24200,102300
412470,202101,218,173,45,190300,49500,239800
412480,202101,140,101,39,112200,42900,155100
412490,202101,156,138,18,151800,19800,171600
412500,202101,428,344,84,378400.44,92400,470800.44
412510,202101,172,140,32,154000,35200,189200
412520,202101,89,59,30,64900,33000,97900
412530,202101,106,55,51,60500,56100,116600
412535,202101,93,67,26,73700,28600,102300
412540,202101,82,38,44,41800,48400,90200
412545,202101,89,60,29,66000,31900,97900
412550,202101,3849,1569,2280,1730300.5,2510200,4240500.5
412555,202101,10,6,4,6600,4400,11000
412560,202101,621,430,191,473000,210100.5,683100.5
412570,202101,760,378,382,415800,420200,836000
412575,202101,90,61,29,67100,31900,99000
412580,202101,175,117,58,128700,64900,193600
412590,202101,36,31,5,34100,5500,39600
412600,202101,177,128,49,140800,53900,194700
412610,202101,36,16,20,17600,22000,39600
412620,202101,142,119,23,130900,25300,156200
412625,202101,2127,1092,1035,1203400.63,1139600,2343000.63
412627,202101,68,50,18,55000,19800,74800
412630,202101,395,261,134,288200,147400,435600
412635,202101,66,19,47,20900,51700,72600
412640,202101,101,72,29,79200,31900,111100
412650,202101,327,213,114,234300,125400,359700
412660,202101,463,274,189,303600,207900,511500
412665,202101,45,41,4,45100,4400,49500
412667,202101,301,202,99,222200,108900,331100
412670,202101,63,51,12,56100,13200,69300
412680,202101,301,231,70,254100,77000,331100
412690,202101,113,73,40,80300,44000,124300
412700,202101,167,112,55,123200,60500,183700
412710,202101,1358,796,562,876700,619300,1496000
412720,202101,233,142,91,156200,101200,257400
412730,202101,188,159,29,174900,31900,206800
412740,202101,422,213,209,234300,229900,464200
412750,202101,421,238,183,261800,201300,463100
412760,202101,291,148,143,162800,157300,320100
412770,202101,2137,1173,964,1291400.63,1060400,2351800.63
412780,202101,139,108,31,118800,34100,152900
412785,202101,288,139,149,152900,163900,316800
412788,202101,36,22,14,24200,15400,39600
412790,202101,119,98,21,107800,23100,130900
412795,202101,153,107,46,118800,50600,169400
412796,202101,307,198,109,217800,119900,337700
412800,202101,631,372,259,410300,287100,697400
412810,202101,2955,1571,1384,1730300,1524600,3254900
412820,202101,927,568,359,624800,396000,1020800
412830,202101,14,11,3,12100,3300,15400
412840,202101,234,163,71,179300,78100,257400
412850,202101,755,480,275,528000,302500,830500
412853,202101,174,85,89,93500,97900,191400
412855,202101,189,99,90,108900.26,99000,207900.26
412860,202101,94,62,32,68200,35200,103400
412862,202101,58,35,23,38500,25300,63800
412863,202101,7,5,2,5500,2200,7700
412865,202101,46,32,14,35200,15400,50600
412870,202101,103,62,41,68200,45100,113300
412880,202101,90,65,25,71500,27500,99000
420005,202101,41,37,4,40700,4400,45100
420010,202101,361,229,132,251900,145200,397100
420020,202101,81,68,13,74800,14300,89100
420030,202101,23,20,3,22000,3300,25300
420040,202101,102,80,22,88000,24200,112200
420050,202101,56,33,23,36300,25300,61600
420055,202101,19,19,0,20900,0,20900
420060,202101,30,22,8,24200,8800,33000
420070,202101,101,84,17,93500,18700,112200
420075,202101,11,11,0,12100,0,12100
420080,202101,42,37,5,40700,5500,46200
420090,202101,35,30,5,33000,5500,38500
420100,202101,149,126,23,138600,25300,163900
420110,202101,19,19,0,20900,0,20900
420120,202101,56,40,16,44000,17600,61600
420125,202101,78,60,18,66000,19800,85800
420127,202101,31,25,6,27500,6600,34100
420130,202101,445,264,181,290400,199100,489500
420140,202101,1298,716,582,789800,640200,1430000
420150,202101,44,35,9,38500,9900,48400
420160,202101,31,29,2,31900,2200,34100
420165,202101,15,10,5,11000,5500,16500
420170,202101,71,43,28,47300,30800,78100
420180,202101,21,18,3,19800,3300,23100
420190,202101,25,22,3,24200,3300,27500
420195,202101,131,63,68,69300,74800,144100
420200,202101,1245,546,699,600600,770000,1370600
420205,202101,91,48,43,52800,47300,100100
420207,202101,119,64,55,70400,60500,130900
420208,202101,19,15,4,16500,4400,20900
420209,202101,17,14,3,15400,3300,18700
420210,202101,518,239,279,262900,306900,569800
420213,202101,42,33,9,36300,9900,46200
420215,202101,28,24,4,26400,4400,30800
420220,202101,60,38,22,42900,24200,67100
420230,202101,838,478,360,525800,397100,922900
420240,202101,2201,1426,775,1569700,852500,2422200
420243,202101,42,33,9,36300,9900,46200
420245,202101,162,83,79,91300,86900,178200
420250,202101,63,42,21,46200,23100,69300
420253,202101,28,22,6,24200,6600,30800
420257,202101,13,10,3,11000,3300,14300
420260,202101,97,79,18,86900,19800,106700
420270,202101,31,26,5,28600,5500,34100
420280,202101,286,218,68,239800,74800,314600
420285,202101,21,13,8,14300,8800,23100
420287,202101,49,32,17,35200,18700,53900
420290,202101,958,654,304,719400,336600,1056000
420300,202101,1449,1144,305,1259500,336600,1596100
420310,202101,50,33,17,36300,18700,55000
420315,202101,35,28,7,30800,7700,38500
420320,202101,959,461,498,507100,548900,1056000
420325,202101,3,0,3,0,3300,3300
420330,202101,123,79,44,86900,48400,135300
420340,202101,167,110,57,121000,62700,183700
420350,202101,254,178,76,195800,83600,279400
420360,202101,717,546,171,600601.51,188100,788701.51
420370,202101,125,74,51,82500,56100,138600
420380,202101,1182,820,362,903100,398200,1301300
420390,202101,241,170,71,187000,78100,265100
420395,202101,195,138,57,151800,62700,214500
420400,202101,247,189,58,207900.15,63800,271700.15
420410,202101,59,44,15,48400,16500,64900
420415,202101,34,28,6,30800,6600,37400
420417,202101,50,38,12,41800,13200,55000
420419,202101,12,12,0,13200,0,13200
420420,202101,2833,1735,1098,1908500.29,1211100,3119600.29
420425,202101,72,59,13,64900,14300,79200
420430,202101,1145,813,332,895400.37,365200,1260600.37
420435,202101,14,12,2,13200,2200,15400
420440,202101,104,72,32,79200,35200,114400
420445,202101,27,26,1,28600,1100,29700
420450,202101,75,37,38,40700,41800,82500
420455,202101,206,156,50,171600,55000,226600
420460,202101,2308,1472,836,1620300,920700,2541000
420470,202101,95,68,27,74800,29700,104500
420475,202101,8,8,0,8800,0,8800
420480,202101,850,637,213,700700,234300,935000
420490,202101,101,75,26,82500,28600,111100
420500,202101,448,233,215,256300.26,236500,492800.26
420510,202101,19,18,1,19800,1100,20900
420515,202101,26,16,10,17600,11000,28600
420517,202101,9,9,0,9900,0,9900
420519,202101,0,,,,,0.0
420520,202101,65,48,17,52800,18700,71500
420530,202101,158,104,54,114400,59400,173800
420535,202101,19,17,2,18700,2200,20900
420540,202101,5563,3340,2223,3680875,2448600,6129475
420543,202101,31,29,2,31900,2200,34100
420545,202101,203,146,57,160600,62700,223300
420550,202101,840,689,151,757900,166100,924000
420555,202101,28,18,10,19800,11000,30800
420560,202101,62,52,10,57200,11000,68200
420570,202101,170,98,72,107800,79200,187000
420580,202101,277,129,148,141900,162800,304700
420590,202101,498,336,162,370700,178200,548900
420600,202101,124,70,54,77000,59400,136400
420610,202101,39,36,3,39600,3300,42900
420620,202101,86,66,20,72600,22000,94600
420630,202101,145,96,49,105600,53900,159500
420640,202101,82,72,10,80300,11000,91300
420650,202101,244,124,120,136400,134200,270600
420660,202101,48,39,9,42900,9900,52800
420665,202101,35,24,11,26400,12100,38500
420670,202101,292,229,63,251900,69300,321200
420675,202101,11,10,1,11000,1100,12100
420680,202101,37,26,11,28600,12100,40700
420690,202101,177,137,40,150700,44000,194700
420700,202101,681,453,228,498300.7,250800,749100.7
420710,202101,141,75,66,82500,72600,155100
420720,202101,107,86,21,94600,23100,117700
420730,202101,618,381,237,421300,260700,682000
420740,202101,51,50,1,55000,1100,56100
420750,202101,487,329,158,363000,173800,536800
420757,202101,18,16,2,17600,2200,19800
420760,202101,38,30,8,33000,8800,41800
420765,202101,80,59,21,64900,23100,88000
420768,202101,49,43,6,47300,6600,53900
420770,202101,70,60,10,66000,11000,77000
420775,202101,39,36,3,39600,3300,42900
420780,202101,204,162,42,178200,46200,224400
420785,202101,20,13,7,14300,7700,22000
420790,202101,159,130,29,143000,31900,174900
420800,202101,65,49,16,53900,17600,71500
420810,202101,257,211,46,232100,50600,282700
420820,202101,2369,1335,1034,1470700,1139600.5,2610300.5
420830,202101,620,326,294,359700,325600,685300
420840,202101,150,105,45,115500,49500,165000
420845,202101,409,172,237,189200,260700,449900
420850,202101,256,187,69,205700,75900,281600
420860,202101,53,44,9,48400,9900,58300
420870,202101,126,86,40,94600,44000,138600
420880,202101,181,114,67,125400,73700,199100
420890,202101,941,466,475,512600,522500,1035100
420895,202101,8,8,0,8800,0,8800
420900,202101,412,326,86,358600,94600,453200
420910,202101,5776,3154,2622,3469401.3,2893000,6362401.3
420915,202101,62,57,5,62700,5500,68200
420917,202101,22,15,7,16500,7700,24200
420920,202101,22,15,7,16500,7700,24200
420930,202101,2799,1742,1057,1917229,1162700.18,3079929.18
420940,202101,585,430,155,474100,170500,644600
420945,202101,10,7,3,7700,3300,11000
420950,202101,51,44,7,48400,7700,56100
420960,202101,110,88,22,96800,24200,121000
420970,202101,278,223,55,245300,60500,305800
420980,202101,23,22,1,24200,1100,25300
420985,202101,55,49,6,53900,6600,60500
420990,202101,81,57,24,62700,26400,89100
421000,202101,44,26,18,28600,19800,48400
421003,202101,47,31,16,34100,17600,51700
421005,202101,7,4,3,4400,3300,7700
421010,202101,774,508,266,558800,292600,851400
421020,202101,24,19,5,20900,5500,26400
421030,202101,114,96,18,105600,19800,125400
421040,202101,72,54,18,59400,19800,79200
421050,202101,348,238,110,261800,121000,382800
421055,202101,21,16,5,17600,5500,23100
421060,202101,89,49,40,53900,44000,97900
421070,202101,50,42,8,46200,8800,55000
421080,202101,34,31,3,34100,3300,37400
421085,202101,21,17,4,18700,4400,23100
421090,202101,36,28,8,30800,8800,39600
421100,202101,125,91,34,100100,37400,137500
421105,202101,193,154,39,169400,42900,212300
421110,202101,110,85,25,93500,27500,121000
421120,202101,174,128,46,140800.92,50600,191400.92
421125,202101,18,12,6,13200,6600,19800
421130,202101,824,510,314,561000,345400,906400
421140,202101,28,19,9,20900,9900,30800
421145,202101,43,33,10,36300,11000,47300
421150,202101,96,69,27,75900,29700,105600
421160,202101,65,43,22,47300,24200,71500
421165,202101,16,13,3,14300,3300,17600
421170,202101,183,153,30,168432,33000,201432
421175,202101,160,109,51,119900,56100,176000
421180,202101,44,32,12,35200,13200,48400
421185,202101,16,12,4,13200,4400,17600
421187,202101,1,0,1,0,1100,1100
421189,202101,46,31,15,34100,16500,50600
421190,202101,1696,1055,641,1160500,705100,1865600
421200,202101,93,69,24,75900,26400,102300
421205,202101,27,18,9,19800,9900,29700
421210,202101,180,124,56,136400,61600,198000
421220,202101,261,199,62,220000,69300,289300
421223,202101,45,36,9,39600,9900,49500
421225,202101,71,45,26,49500,28600,78100
421227,202101,85,67,18,73700,19800,93500
421230,202101,57,43,14,47300,15400,62700
421240,202101,17,17,0,18700,0,18700
421250,202101,366,207,159,228800,174900,403700
421260,202101,22,18,4,19800,4400,24200
421265,202101,2,2,0,2200,0,2200
421270,202101,49,44,5,48400,5500,53900
421280,202101,340,184,156,202400,172700,375100
421290,202101,336,221,115,243100,126500,369600
421300,202101,23,19,4,20900,4400,25300
421310,202101,45,32,13,35200,14300,49500
421315,202101,30,18,12,19800,13200,33000
421320,202101,124,80,44,88000,48400,136400
421330,202101,109,77,32,84700,35200,119900
421335,202101,39,27,12,29700.22,13200,42900.22
421340,202101,242,159,83,174900,91300,266200
421350,202101,186,107,79,117700.39,88000,205700.39
421360,202101,653,465,188,511500,206800,718300
421370,202101,189,143,46,157300,50600,207900
421380,202101,128,99,29,108900,31900,140800
421390,202101,16,10,6,11000,6600,17600
421400,202101,114,98,16,107800,17600,125400
421410,202101,18,16,2,17600,2200,19800
421415,202101,17,16,1,17600,1100,18700
421420,202101,112,94,18,103400,19800,123200
421430,202101,17,12,5,13200,5500,18700
421440,202101,57,49,8,53900,8800,62700
421450,202101,89,73,16,80300,17600.51,97900.51
421460,202101,58,45,13,49500,14300,63800
421470,202101,69,42,27,46200,29700,75900
421480,202101,733,559,174,614900,191400,806300
421490,202101,23,22,1,24200,1100,25300
421500,202101,490,309,181,341000,199100,540100
421505,202101,22,15,7,16500,7700,24200
421507,202101,29,22,7,25300,7700,33000
421510,202101,72,47,25,51700,27500,79200
421520,202101,54,45,9,49500,9900,59400
421530,202101,48,41,7,45100,7700,52800
421535,202101,24,22,2,24200,2200,26400
421540,202101,53,43,10,47300,11000,58300
421545,202101,103,73,30,80300,34100,114400
421550,202101,278,200,78,220000,85800,305800
421555,202101,18,16,2,17600,3300,20900
421560,202101,9,8,1,8800,1100,9900
421565,202101,122,83,39,91300,42900,134200
421567,202101,31,24,7,26400,7700,34100
421568,202101,40,35,5,38500,5500,44000
421569,202101,12,12,0,13200,0,13200
421570,202101,206,138,68,151800,74800,226600
421575,202101,25,22,3,24200,3300,27500
421580,202101,713,424,289,467572,319000,786572
421590,202101,21,19,2,20900,2200,23100
421600,202101,154,100,54,110000,59400,169400
421605,202101,109,76,33,83600,36300,119900
421610,202101,179,135,44,148500,48400,196900
421620,202101,1025,596,429,656700,471900,1128600
421625,202101,20,17,3,18700,3300,22000
421630,202101,309,190,119,210100,130900,341000
421635,202101,17,8,9,8800,9900,18700
421640,202101,98,81,17,89100,18700,107800
421650,202101,292,171,121,188100,133100,321200
421660,202101,2262,1342,920,1478400.6,1013100,2491500.6
421670,202101,177,128,49,140800,53900,194700
421680,202101,178,162,16,178200,17600,195800
421690,202101,345,239,106,262900,116600,379500
421700,202101,52,35,17,38500,18700,57200
421710,202101,25,23,2,25300,2200,27500
421715,202101,5,4,1,4400,1100,5500
421720,202101,625,434,191,477400,211200,688600
421725,202101,18,7,11,7700,12100,19800
421730,202101,32,24,8,26400,8800,35200
421740,202101,94,33,61,36300,67100,103400
421750,202101,196,146,50,161700,55000,216700
421755,202101,21,19,2,20900,2200,23100
421760,202101,102,67,35,73700,38500,112200
421770,202101,663,412,251,453200,276100,729300
421775,202101,26,16,10,17600,11000,28600
421780,202101,190,146,44,161700,48400,210100
421790,202101,151,129,22,141900,24200,166100
421795,202101,17,14,3,15400,3300,18700
421800,202101,518,326,192,358600,211200,569800
421810,202101,68,54,14,59400,15400,74800
421820,202101,303,195,108,214500,118800,333300
421825,202101,146,123,23,135300,25300,160600
421830,202101,138,88,50,96800,55000,151800
421835,202101,7,3,4,3300,4400,7700
421840,202101,48,42,6,46200,6600,52800
421850,202101,80,67,13,73700,14300,88000
421860,202101,43,33,10,36300,11000,47300
421870,202101,1026,764,262,841500.44,288200,1129700.44
421875,202101,54,44,10,48400,11000,59400
421880,202101,168,120,48,132000,52800,184800
421885,202101,21,17,4,18700,4400,23100
421890,202101,130,90,40,99000,44000.5,143000.5
421895,202101,44,39,5,42900,5500,48400
421900,202101,149,116,33,127600,36300,163900
421910,202101,59,35,24,38500,26400,64900
421915,202101,29,24,5,26400,5500,31900
421917,202101,34,25,9,28600,9900,38500
421920,202101,40,36,4,39600,4400,44000
421930,202101,646,515,131,568700.74,145200,713900.74
421935,202101,52,45,7,49500,7700,57200
421940,202101,46,39,7,42900,7700,50600
421950,202101,877,583,294,641300,323400,964700
421960,202101,44,38,6,41800,6600,48400
421970,202101,335,215,120,236500,133100,369600
421985,202101,21,13,8,14300,8800,23100
422000,202101,0,,,,,0.0
430003,202101,194,54,140,59400,154000,213400
430005,202101,32,22,10,24200,11000,35200
430010,202101,268,193,75,212300,82500,294800
430020,202101,142,93,49,102300,53900,156200
430030,202101,122,99,23,108900,25300,134200
430040,202101,2900,1710,1190,1882100,1309000,3191100
430045,202101,66,55,11,60500,12100,72600
430047,202101,8,7,1,7700,1100,8800
430050,202101,78,63,15,69300,16500,85800
430055,202101,10,9,1,9900,1100,11000
430057,202101,5,4,1,4400,1100,5500
430060,202101,3698,2124,1574,2338600,1735800,4074400
430063,202101,52,47,5,52800,5500,58300
430064,202101,155,123,32,135300,35200,170500
430066,202101,5,2,3,2200,3300,5500
430070,202101,42,29,13,31900,14300,46200
430080,202101,68,44,24,48400,26400,74800
430085,202101,27,10,17,11000,18700,29700
430087,202101,25,18,7,19800,7700,27500
430090,202101,71,63,8,69300,8800,78100
430100,202101,126,85,41,93500,45100,138600
430105,202101,149,83,66,91300,72600,163900
430107,202101,18,12,6,13200,6600,19800
430110,202101,469,258,211,284900,233200,518100
430120,202101,159,147,12,161700,13200,174900
430130,202101,793,481,312,529100,343200,872300
430140,202101,122,113,9,124300,11000,135300
430150,202101,107,67,40,74800,44000,118800
430155,202101,32,27,5,29700,5500,35200
430160,202101,3581,2090,1491,2302300,1640100,3942400
430163,202101,364,156,208,172700,229900,402600
430165,202101,30,20,10,22000,11000,33000
430170,202101,86,71,15,78100,16500,94600
430175,202101,72,57,15,62700,16500,79200
430180,202101,106,86,20,94600,22000,116600
430185,202101,28,18,10,19800,11000,30800
430187,202101,53,29,24,31900,26400,58300
430190,202101,219,121,98,133100,107800,240900
430192,202101,13,11,2,12100,2200,14300
430195,202101,17,11,6,12100,6600,18700
430200,202101,160,137,23,150700,25300,176000
430205,202101,21,21,0,23100,0,23100
430210,202101,670,505,165,555500,181500,737000
430215,202101,11,10,1,11000,1100,12100
430220,202101,72,48,24,52800,26400,79200
430222,202101,13,6,7,6600,7700,14300
430223,202101,15,8,7,8800,7700,16500
430225,202101,2,1,1,1100,1100,2200
430230,202101,302,178,124,195800,136400,332200
430235,202101,50,38,12,41800,13200,55000
430237,202101,26,20,6,22000,6600,28600
430240,202101,106,74,32,81400,35200,116600
430245,202101,75,60,15,66000,16500,82500
430250,202101,180,106,74,116600,81400,198000
430258,202101,8,7,1,7700,1100,8800
430260,202101,30,26,4,28600,4400,33000
430265,202101,33,27,6,29700,6600,36300
430270,202101,506,380,126,418000,138600,556600
430280,202101,1027,611,416,673200,460900,1134100
430290,202101,406,217,189,238700,207900,446600
430300,202101,2107,1151,956,1267200,1051600,2318800
430310,202101,2001,983,1018,1084600,1120900.7,2205500.7
430320,202101,53,44,9,48400,9900,58300
430330,202101,99,86,13,94600,14300,108900
430340,202101,71,57,14,62700,15400,78100
430350,202101,1641,1096,545,1205600,599500,1805100
430355,202101,21,19,2,20900,2200,23100
430360,202101,85,41,44,45100,48400,93500
430367,202101,35,26,9,28600,9900,38500
430370,202101,53,48,5,52800,5500,58300
430380,202101,124,95,29,104500,31900,136400
430390,202101,582,360,222,399300,244200,643500
430400,202101,253,181,72,199100,79200,278300
430410,202101,54,43,11,47300,12100,59400
430420,202101,503,322,181,354200,199100,553300
430430,202101,52,51,1,56467.4,1100,57567.4
430435,202101,150,111,39,122100,42900,165000
430440,202101,497,324,173,356400,190300,546700
430450,202101,1141,937,204,1030700,224400,1255100
430460,202101,5306,2742,2564,3020600,2824800.9,5845400.9
430461,202101,16,15,1,16500,1100,17600
430462,202101,5,3,2,3300,2200,5500
430463,202101,1103,586,517,645700,570900,1216600
430465,202101,24,13,11,14300,12100,26400
430466,202101,641,447,194,491700,213400,705100
430467,202101,106,58,48,63800,52800,116600
430468,202101,120,71,49,78100,53900,132000
430469,202101,21,16,5,17600,5500,23100
430470,202101,1156,644,512,708727.5,563200,1271927.5
430471,202101,55,37,18,40700,19800,60500
430480,202101,101,64,37,70400,40700,111100
430485,202101,7,7,0,7700,0,7700
430490,202101,70,56,14,61600,15400,77000
430495,202101,34,26,8,28600,8800,37400
430500,202101,187,126,61,138600,67100,205700
430510,202101,3452,2217,1235,2439801.4,1362900,3802701.4
430511,202101,16,16,0,17600,0,17600
430512,202101,152,105,47,115500,51700,167200
430513,202101,52,42,10,46200,11000,57200
430515,202101,26,25,1,27500,1100,28600
430517,202101,173,147,26,161700,29700,191400
430520,202101,341,240,101,264000,111100,375100
430530,202101,84,47,37,51700,40700,92400
430535,202101,437,296,141,325600,156200,481800
430537,202101,11,11,0,12100,0,12100
430540,202101,82,55,27,60500,29700,90200
430543,202101,360,113,247,124300,271700,396000
430544,202101,44,40,4,44000,4400,48400
430545,202101,382,184,198,203500,217800,421300
430550,202101,41,33,8,36300,8800,45100
430558,202101,1,1,0,1100,0,1100
430560,202101,56,31,25,34100,27500,61600
430570,202101,105,40,65,44000,71500,115500
430580,202101,132,107,25,117700,27500,145200
430583,202101,14,14,0,15400,0,15400
430585,202101,10,5,5,5500,5500,11000
430587,202101,15,7,8,7700,8800,16500
430590,202101,146,120,26,132000,28600,160600
430593,202101,1,1,0,1100,0,1100
430595,202101,17,14,3,15400,3300,18700
430597,202101,44,22,22,24200,24200,48400
430600,202101,216,160,56,176000,61600,237600
430605,202101,162,100,62,110000,68200,178200
430607,202101,26,21,5,23100,5500,28600
430610,202101,1663,772,891,849200,981200,1830400
430613,202101,3,3,0,3300,0,3300
430620,202101,109,78,31,85800,35200,121000
430630,202101,46,40,6,44000,6600,50600
430632,202101,34,29,5,31900,5500,37400
430635,202101,35,31,4,34100,4400,38500
430637,202101,63,30,33,33000,36300,69300
430640,202101,175,94,81,103400,89100,192500
430642,202101,19,16,3,17600,3300,20900
430645,202101,33,27,6,29700,6600,36300
430650,202101,238,195,43,214500,47300,261800
430655,202101,2,2,0,2200,0,2200
430660,202101,971,482,489,530200,539000.97,1069200.97
430670,202101,78,53,25,59400,27500,86900
430673,202101,70,43,27,47300,29700,77000
430675,202101,10,8,2,8800,2200,11000
430676,202101,525,305,220,336600,242000,578600
430680,202101,238,164,74,180400,81400,261800
430690,202101,519,318,201,349800,221100.63,570900.63
430692,202101,9,7,2,7700,2200,9900
430693,202101,138,89,49,97900,53900,151800
430695,202101,63,52,11,57200,12100,69300
430697,202101,60,36,24,39600,26400,66000
430700,202101,1451,995,456,1094500,501600,1596100
430705,202101,26,23,3,25300,3300,28600
430710,202101,249,156,93,171600,102300,273900
430720,202101,110,94,16,103400,17600,121000
430730,202101,139,118,21,129800,23100,152900
430740,202101,74,51,23,56100,25300,81400
430745,202101,30,24,6,26400,6600,33000
430750,202101,329,221,108,243100,118800,361900
430755,202101,86,45,41,50600,45100,95700
430760,202101,382,211,171,232100,188151,420251
430770,202101,1488,766,722,843700,796400,1640100
430780,202101,297,184,113,202400,124300,326700
430781,202101,25,21,4,23100,4400,27500
430783,202101,60,49,11,53900,12100,66000
430786,202101,5,3,2,3300,2200,5500
430790,202101,509,333,176,366300,194700,561000
430800,202101,152,122,30,134200.01,33000,167200.01
430805,202101,43,34,9,37400,9900,47300
430807,202101,55,29,26,31900,28600,60500
430810,202101,75,45,30,49500,33000,82500
430820,202101,143,84,59,92400,64900,157300
430825,202101,10,8,2,8800,2200,11000
430830,202101,239,220,19,242000,20900,262900
430840,202101,129,84,45,92400,49500,141900
430843,202101,5,3,2,3300,2200,5500
430845,202101,75,40,35,44000,38500,82500
430850,202101,587,423,164,465300,180400,645700
430860,202101,152,97,55,106700,60500,167200
430865,202101,73,39,34,42900,38500,81400
430870,202101,78,64,14,70400,16500,86900
430880,202101,154,111,43,122100,47300,169400
430885,202101,11,9,2,9900,2200,12100
430890,202101,337,202,135,223300,148500,371800
430900,202101,515,354,161,390500,177100,567600
430905,202101,121,48,73,53900,80300,134200
430910,202101,278,155,123,170500,135300,305800
430912,202101,4,4,0,4400,0,4400
430915,202101,35,31,4,34100,4400,38500
430920,202101,4334,2281,2053,2510346.66,2261600,4771946.66
430925,202101,5,4,1,4400,1100,5500
430930,202101,2073,1191,882,1311200,970200,2281400
430940,202101,257,169,88,185900,96800,282700
430950,202101,152,125,27,137500,29700,167200
430955,202101,25,13,12,14300,13200,27500
430957,202101,19,16,3,17600,3300,20900
430960,202101,244,159,85,174900,93500,268400
430965,202101,112,71,41,78100,45100,123200
430970,202101,91,73,18,80300,19800,100100
430975,202101,45,39,6,42900,6600,49500
430980,202101,45,28,17,30800,18700,49500
430990,202101,98,75,23,82500,26400,108900
430995,202101,111,105,6,115500,6600,122100
431000,202101,292,141,151,155100.6,166100,321200.6
431010,202101,344,194,150,213400,165000,378400
431020,202101,1851,1067,784,1175900,863500,2039400
431030,202101,39,31,8,34100,8800,42900
431033,202101,407,189,218,207900,239800,447700
431036,202101,11,6,5,6600,5500,12100
431040,202101,142,87,55,95700,60500,156200
431041,202101,40,27,13,29700,14300,44000
431043,202101,42,25,17,27500,18700,46200
431046,202101,10,7,3,8800,3300,12100
431050,202101,199,125,74,138600,81400,220000
431053,202101,63,38,25,41800,27500,69300
431055,202101,62,43,19,47300,20900,68200
431057,202101,18,18,0,19800,0,19800
431060,202101,1590,1027,563,1131900.31,619300,1751200.31
431065,202101,16,10,6,11000,6600,17600
431070,202101,66,61,5,67100,5500,72600
431075,202101,8,8,0,8800,0,8800
431080,202101,134,78,56,85800,62700,148500
431085,202101,33,30,3,33000,3300,36300
431087,202101,12,10,2,11000,2200,13200
431090,202101,55,43,12,47300,13200,60500
431100,202101,1218,725,493,797500,542300,1339800
431110,202101,229,139,90,152900,99000,251900
431112,202101,23,15,8,16500,8800,25300
431113,202101,35,25,10,27500,11000,38500
431115,202101,163,114,49,125400,53900,179300
431120,202101,600,358,242,393800,266200,660000
431123,202101,3,2,1,2200,1100,3300
431125,202101,95,84,11,92400,12100,104500
431127,202101,11,6,5,6600,5500,12100
431130,202101,701,453,248,499400,272800,772200
431140,202101,741,512,229,563200,251900,815100
431142,202101,25,21,4,23100.55,4400,27500.55
431150,202101,189,140,49,154000,53900,207900
431160,202101,46,43,3,47300,3300,50600
431162,202101,3,3,0,3300,0,3300
431164,202101,6,6,0,6600,0,6600
431170,202101,109,85,24,93500,26400,119900
431171,202101,67,39,28,42900,30800,73700
431173,202101,1,1,0,1100,0,1100
431175,202101,200,99,101,108900,111100,220000
431177,202101,84,61,23,67100,25300,92400
431179,202101,14,11,3,12100,3300,15400
431180,202101,425,257,168,283800,185900,469700
431190,202101,77,58,19,63800,20900,84700
431198,202101,74,53,21,58300,23100,81400
431200,202101,21,17,4,18700,4400,23100
431205,202101,20,19,1,20900,1100,22000
431210,202101,97,61,36,67100,39600,106700
431213,202101,30,26,4,28600,4400,33000
431215,202101,22,19,3,20900,3300,24200
431217,202101,5,5,0,5500,0,5500
431220,202101,66,57,9,62700,9900,72600
431225,202101,158,99,59,108900,64900,173800
431230,202101,95,82,13,90200,14300,104500
431235,202101,7,7,0,7700,0,7700
431237,202101,7,6,1,7700,1100,8800
431238,202101,11,7,4,7700,4400,12100
431240,202101,1018,637,381,701800,419100,1120900
431242,202101,41,40,1,44000,1100,45100
431244,202101,14,10,4,11000,4400,15400
431245,202101,49,37,12,40700,13200,53900
431247,202101,11,6,5,6600,5500,12100
431250,202101,280,142,138,156200,151800,308000
431260,202101,59,47,12,51700,13200,64900
431261,202101,18,11,7,12100,7700,19800
431262,202101,15,14,1,15400,1100,16500
431265,202101,147,78,69,85800,75900,161700
431267,202101,18,16,2,17600,2200,19800
431270,202101,325,263,62,289300,68200,357500
431275,202101,39,36,3,39600,3300,42900
431280,202101,20,16,4,17600,4400,22000
431290,202101,20,18,2,19800,2200,22000
431295,202101,2,1,1,1100,1100,2200
431300,202101,22,20,2,22000,2200,24200
431301,202101,5,5,0,5500,0,5500
431303,202101,63,40,23,44000,25300,69300
431306,202101,244,128,116,140604.2,127600,268204.2
431308,202101,6,4,2,4400,2200,6600
431310,202101,63,51,12,57200,13200,70400
431320,202101,150,89,61,97900,67100,165000
431330,202101,182,109,73,119900,80300,200200
431333,202101,27,21,6,23100,6600,29700
431335,202101,9,5,4,5500,4400,9900
431337,202101,362,159,203,174900,223300,398200
431339,202101,21,17,4,18700,4400,23100
431340,202101,3034,1652,1382,1817164.1,1524600,3341764.1
431342,202101,37,25,12,27500,13200,40700
431344,202101,18,18,0,19800,0,19800
431346,202101,4,4,0,4400,0,4400
431349,202101,35,31,4,34100,4400,38500
431350,202101,907,512,395,564300,434500,998800
431360,202101,50,42,8,46200,8800,55000
431365,202101,338,151,187,166100,205700,371800
431370,202101,1215,694,521,763400,573100,1336500
431380,202101,99,87,12,95700,13200,108900
431390,202101,501,267,234,293700,258500,552200
431395,202101,310,132,178,145200,195800,341000
431400,202101,45,30,15,33000,16500,49500
431402,202101,106,78,28,85800,30800,116600
431403,202101,24,15,9,16500,9900,26400
431405,202101,680,375,305,412500,335500,748000
431406,202101,32,26,6,28600,6600,35200
431407,202101,54,42,12,46200,13200,59400
431410,202101,3362,2045,1317,2250600,1450900,3701500
431413,202101,16,13,3,14300,3300,17600
431415,202101,64,46,18,50600,19800,70400
431417,202101,26,12,14,13200,15400,28600
431420,202101,323,218,105,239800,115500,355300
431430,202101,56,26,30,28600,33000,61600
431440,202101,8825,6068,2757,6683600,3036051,9719651
431442,202101,28,13,15,14300,16500,30800
431445,202101,28,26,2,28600,2200,30800
431446,202101,4,3,1,3300,1100,4400
431447,202101,87,60,27,66000,29700,95700
431449,202101,51,43,8,47300,8800,56100
431450,202101,407,270,137,297000,150700,447700
431454,202101,9,3,6,3300,6600,9900
431455,202101,49,39,10,42900,11000,53900
431460,202101,501,345,156,380600,171600,552200
431470,202101,115,86,29,94600,31900,126500
431475,202101,10,8,2,8800,2200,11000
431477,202101,36,24,12,26400,13200,39600
431478,202101,9,8,1,8800,1100,9900
431480,202101,526,312,214,343200,236500,579700
431490,202101,28442,15761,12681,17360200.85,13968900,31329100.85
431500,202101,75,61,14,67100,15400,82500
431505,202101,25,15,10,16500,11000,27500
431507,202101,9,7,2,7700,2200,9900
431510,202101,251,176,75,194700,82500,277200
431513,202101,24,21,3,23100,3300,26400
431514,202101,5,4,1,4400,1100,5500
431515,202101,78,65,13,71500,14300,85800
431517,202101,5,3,2,3300,2200,5500
431520,202101,39,35,4,38500,4400,42900
431530,202101,1437,643,794,707300,873400,1580700
431531,202101,24,23,1,25300,1100,26400
431532,202101,35,26,9,28600,9900,38500
431535,202101,29,15,14,16500,15400,31900
431540,202101,144,123,21,135300,23100,158400
431545,202101,14,12,2,13200,2200,15400
431550,202101,347,189,158,209000,173800,382800
431555,202101,12,12,0,13200,0,13200
431560,202101,4512,3061,1451,3368200,1597200,4965400
431570,202101,812,424,388,466400,427900,894300
431575,202101,43,23,20,25300,22000,47300
431580,202101,94,63,31,69300,34100,103400
431590,202101,137,116,21,127600,23100,150700
431595,202101,19,16,3,17600,3300,20900
431600,202101,242,139,103,152900,113300,266200
431610,202101,113,83,30,91300,33000,124300
431620,202101,45,38,7,41800,7700,49500
431630,202101,129,106,23,116600,25300,141900
431640,202101,1323,832,491,915200,540100,1455300
431642,202101,36,33,3,36300,3300,39600
431643,202101,47,20,27,22000,29700,51700
431645,202101,312,185,127,203500,139700,343200
431647,202101,9,8,1,8800,1100,9900
431650,202101,33,22,11,25300,13200,38500
431660,202101,281,178,103,195800,113300,309100
431670,202101,225,99,126,108900,138600,247500
431673,202101,7,7,0,7700,0,7700
431675,202101,23,18,5,19800,5500,25300
431680,202101,1107,813,294,896500,325600,1222100
431690,202101,4754,2837,1917,3124000.87,2112000,5236000.87
431695,202101,22,16,6,17600,6600,24200
431697,202101,1,0,1,0,1100,1100
431700,202101,181,138,43,151800,47300,199100
431710,202101,3986,1727,2259,1900800,2487100,4387900
431720,202101,1330,811,519,891550,570900,1462450
431725,202101,1,1,0,1100,0,1100
431730,202101,1156,778,378,856900,416900,1273800
431740,202101,1340,656,684,721600,753500,1475100
431750,202101,1818,1177,641,1294700.32,705100,1999800.32
431755,202101,6,5,1,5500,1100,6600
431760,202101,1020,639,381,705100,419100,1124200
431770,202101,413,291,122,320100,134200,454300
431775,202101,26,19,7,20900,7700,28600
431780,202101,540,322,218,354200,239800,594000
431790,202101,160,123,37,135300,40700,176000
431795,202101,13,10,3,11000,3300,14300
431800,202101,3166,1650,1516,1816100,1670900,3487000
431805,202101,22,20,2,22000,2200,24200
431810,202101,600,395,205,434500,225500,660000
431820,202101,327,194,133,213400,146300,359700
431830,202101,2278,1360,918,1497100,1010900,2508000
431840,202101,479,315,164,347600,181500,529100
431842,202101,33,26,7,28600,7700,36300
431843,202101,10,7,3,7700,3300,11000
431844,202101,17,13,4,14300,4400,18700
431845,202101,26,24,2,26400,2200,28600
431846,202101,26,22,4,24200,4400,28600
431848,202101,10,8,2,8800,2200,11000
431849,202101,7,6,1,6600,1100,7700
431850,202101,773,625,148,687500,162800,850300
431860,202101,114,77,37,84700,40700,125400
431861,202101,6,2,4,2200,4400,6600
431862,202101,55,37,18,40700,19800,60500
431870,202101,3484,1977,1507,2175800,1658800,3834600
431880,202101,923,674,249,741400,275000,1016400
431890,202101,1310,776,534,854700,587400,1442100
431900,202101,180,124,56,136400,61600,198000
431910,202101,52,38,14,41800,15400,57200
431912,202101,42,26,16,28600,17600,46200
431915,202101,130,100,30,110000,33000,143000
431920,202101,158,112,46,123200,50600,173800
431930,202101,76,63,13,69300,14300,83600
431935,202101,2,2,0,2200,0,2200
431936,202101,3,3,0,3300,0,3300
431937,202101,19,14,5,15400,5500,20900
431940,202101,452,301,151,331100,166100,497200
431950,202101,490,311,179,342100,198000,540100
431960,202101,729,388,341,427900,376200,804100
431970,202101,67,61,6,67100,6600,73700
431971,202101,3,3,0,3300,0,3300
431973,202101,19,15,4,16500,4400,20900
431975,202101,9,8,1,8800,1100,9900
431980,202101,211,128,83,141900,91300,233200
431990,202101,1118,596,522,655528.5,575300,1230828.5
432000,202101,1750,906,844,998800,931700,1930500
432010,202101,268,184,84,202400,92400,294800
432020,202101,175,144,31,158400,34100,192500
432023,202101,15,13,2,14300,2200,16500
432026,202101,65,58,7,63800,7700,71500
432030,202101,65,32,33,35200,36300,71500
432032,202101,20,14,6,15400,6600,22000
432035,202101,51,41,10,45100,11000,56100
432040,202101,90,61,29,67100,31900,99000
432045,202101,2,2,0,2200,0,2200
432050,202101,79,46,33,50600,36300,86900
432055,202101,123,90,33,99000,36300,135300
432057,202101,8,6,2,6600,2200,8800
432060,202101,34,31,3,34100,3300,37400
432065,202101,31,28,3,30800,3300,34100
432067,202101,89,79,10,86900,11000,97900
432070,202101,380,296,84,325875,92400,418275
432080,202101,805,561,244,617100,268400,885500
432085,202101,8,5,3,5500,3300,8800
432090,202101,266,176,90,193600,100100,293700
432100,202101,167,107,60,117700,66000,183700
432110,202101,543,358,185,393800,203500,597300
432120,202101,957,543,414,599500,455400,1054900
432130,202101,485,342,143,376200,157300,533500
432132,202101,22,19,3,20900,3300,24200
432135,202101,80,66,14,72600,15400,88000
432140,202101,268,205,63,225500,69300,294800
432143,202101,211,131,80,144100,88000,232100
432145,202101,274,189,85,207900,93500,301400
432146,202101,13,12,1,13200,1100,14300
432147,202101,113,60,53,66000,58300,124300
432149,202101,16,10,6,11000,6600,17600
432150,202101,887,535,352,588500,387200,975700
432160,202101,1492,750,742,826100.5,817300,1643400.5
432162,202101,4,3,1,3300,1100,4400
432163,202101,19,14,5,15400,5500,20900
432166,202101,121,92,29,101475.85,31900,133375.85
432170,202101,232,119,113,130900,124300,255200
432180,202101,545,332,213,365200,234300,599500
432183,202101,8,8,0,8800,0,8800
432185,202101,76,65,11,71500,12100,83600
432190,202101,485,286,199,314600,218900,533500
432195,202101,89,72,17,79200,18700,97900
432200,202101,400,248,152,272800,167200,440000
432210,202101,114,71,43,79200,47300,126500
432215,202101,38,34,4,37400,4400,41800
432218,202101,21,20,1,22000,1100,23100
432220,202101,653,337,316,370700,347600.63,718300.63
432225,202101,14,9,5,9900,5500,15400
432230,202101,133,90,43,99000,47300,146300
432232,202101,12,11,1,12100,1100,13200
432234,202101,3,2,1,2200,1100,3300
432235,202101,3,2,1,2200,1100,3300
432237,202101,25,15,10,16500,11000,27500
432240,202101,4294,2378,1916,2621300,2112000,4733300
432250,202101,1123,723,400,796400,441100,1237500
432252,202101,46,44,2,48400,2200,50600
432253,202101,59,47,12,51700,13200,64900
432254,202101,26,11,15,12100,16500,28600
432255,202101,14,12,2,13200,2200,15400
432260,202101,816,640,176,705100,193600,898700
432270,202101,231,173,58,191400,63800,255200
432280,202101,140,104,36,114400,39600,154000
432285,202101,2,2,0,2200,0,2200
432290,202101,67,57,10,62700,11000,73700
432300,202101,4638,2497,2141,2749928.5,2357300.61,5107229.11
432310,202101,131,106,25,116600,27500,144100
432320,202101,22,17,5,18700,5500,24200
432330,202101,15,9,6,9900,6600,16500
432335,202101,9,7,2,7700,2200,9900
432340,202101,39,33,6,36300,6600,42900
432345,202101,106,70,36,77000,39600,116600
432350,202101,20,19,1,20900,1100,22000
432360,202101,4,3,1,3300,1100,4400
432370,202101,22,21,1,23100,1100,24200
432375,202101,31,28,3,30800,3300,34100
432377,202101,8,8,0,8800,0,8800
432380,202101,170,73,97,80300,106700,187000
500020,202101,241,129,112,141900,123200,265100
500025,202101,139,67,72,73700,79200,152900
500060,202101,1446,904,542,996600,596200.71,1592800.71
500070,202101,772,366,406,403700.57,446600,850300.57
500080,202101,135,107,28,117700,31900,149600
500085,202101,129,106,23,116600,25300,141900
500090,202101,355,160,195,176000,215600,391600
500100,202101,714,377,337,414700,370700,785400
500110,202101,2239,1041,1198,1147300,1321100,2468400
500124,202101,264,144,120,159500,132000,291500
500150,202101,349,137,212,150700,233200,383900
500190,202101,515,350,165,385000,181500,566500
500200,202101,192,164,28,180400,30800,211200
500210,202101,1582,528,1054,580800,1159400,1740200
500215,202101,239,132,107,145200,117700,262900
500220,202101,717,468,249,515900.92,273900,789800.92
500230,202101,233,142,91,156200,100100,256300
500240,202101,652,444,208,488400,228800,717200
500260,202101,582,224,358,246400,393800,640200
500270,202101,29828,12678,17150,13959422.82,18878200.44,32837623.26
500280,202101,199,66,133,72600,146300,218900
500290,202101,1161,707,454,777700,502700,1280400
500295,202101,439,284,155,313500,171600,485100
500310,202101,83,25,58,27500,63800,91300
500315,202101,766,437,329,481800,361900,843700
500320,202101,3571,1738,1833,1912900.84,2018500,3931400.84
500325,202101,933,507,426,559900,468600,1028500
500330,202101,1491,699,792,768900,872300,1641200
500345,202101,302,229,73,251900,80300,332200
500348,202101,250,145,105,159500,115500,275000
500350,202101,121,60,61,66000,67100,133100
500370,202101,5641,2510,3131,2763200,3447400,6210600
500375,202101,342,240,102,264000,112200,376200
500380,202101,583,327,256,359700,282700,642400
500390,202101,71,36,35,39600,38500,78100
500400,202101,219,138,81,151800,89100,240900
500410,202101,532,217,315,238700,346500,585200
500430,202101,523,367,156,403700,171600,575300
500440,202101,199,104,95,114400,104500,218900
500450,202101,405,171,234,188100,257400,445500
500460,202101,269,143,126,157300,138600,295900
500470,202101,427,331,96,364100,105600,469700
500480,202101,104,62,42,68200,46200,114400
500490,202101,104,46,58,50600,63800,114400
500500,202101,1410,510,900,562100,991100,1553200
500510,202101,42,35,7,38500,7700,46200
500515,202101,100,69,31,75900,34100,110000
500520,202101,301,161,140,177100,154000,331100
500525,202101,92,49,43,53900,47300,101200
500540,202101,873,373,500,411400,550000,961400
500560,202101,921,511,410,562100,452100,1014200
500568,202101,977,551,426,606100,469700,1075800
500570,202101,1187,695,492,764500,543400,1307900
500580,202101,325,161,164,177100,180400,357500
500600,202101,334,164,170,180400,187000,367400
500620,202101,918,648,270,713900.9,297000,1010900.9
500625,202101,78,61,17,67100,18700,85800
500627,202101,18,9,9,9900,9900,19800
500630,202101,1574,874,700,964700.63,772200,1736900.63
500635,202101,521,312,209,343200,229900,573100
500640,202101,376,201,175,221100,192500,413600
500660,202101,5558,2015,3543,2217600,3905000,6122600
500690,202101,602,204,398,224400,437800,662200
500710,202101,407,206,201,226600,221100,447700
500720,202101,921,528,393,581900.3,432300,1014200.3
500730,202101,183,110,73,121000,80300,201300
500740,202101,883,363,520,399300,573100,972400
500750,202101,146,46,100,50600,110000,160600
500755,202101,122,91,31,100100,34100,134200
500769,202101,743,401,342,441100,376200,817300
500770,202101,412,214,198,236500,218900,455400
500780,202101,151,100,51,110000,56100,166100
500790,202101,1058,533,525,586300,577500,1163800
500793,202101,271,144,127,158400,139700,298100
500795,202101,182,124,58,136400,63800,200200
500797,202101,47,33,14,36300,15400,51700
500800,202101,436,193,243,213400,267300,480700
500830,202101,2215,1226,989,1348600,1089000,2437600
500840,202101,132,98,34,107800,37400,145200
510010,202101,171,88,83,96800,91300,188100
510020,202101,509,216,293,237600,322300,559900
510025,202101,1667,950,717,1045000.37,788700,1833700.37
510030,202101,665,337,328,372900,360800,733700
510035,202101,126,62,64,68200,70400,138600
510040,202101,397,181,216,199100,237600,436700
510050,202101,385,211,174,232100,191400.3,423500.3
510060,202101,119,58,61,64900,67100,132000
510080,202101,228,90,138,99000,151800,250800
510100,202101,65,28,37,30800,40700,71500
510120,202101,33,20,13,22000,14300,36300
510125,202101,377,233,144,256300,158400,414700
510130,202101,534,315,219,346500,243100,589600
510140,202101,430,126,304,138600,334400,473000
510160,202101,111,37,74,40700,81400,122100
510170,202101,784,477,307,525800.56,337700,863500.56
510180,202101,2918,1361,1557,1497100,1712700,3209800
510185,202101,19,8,11,8800,12100,20900
510190,202101,233,83,150,91300,165000,256300
510250,202101,2574,1530,1044,1684100.6,1149500,2833600.6
510260,202101,174,127,47,139700,51700,191400
510263,202101,458,252,206,277200,227700,504900
510267,202101,654,363,291,399300,320100,719400
510268,202101,61,27,34,29700,37400,67100
510269,202101,75,32,43,35200,47300,82500
510270,202101,385,193,192,212300,211200,423500
510279,202101,217,165,52,181500,57200,238700
510285,202101,183,72,111,79200,122100,201300
510300,202101,507,263,244,289300,268400,557700
510305,202101,198,90,108,100100,118800,218900
510310,202101,107,54,53,59400,58300,117700
510320,202101,840,530,310,583000,342100,925100
510325,202101,420,174,246,191400,271700,463100
510330,202101,424,236,188,260700,206800,467500
510335,202101,629,356,273,392700,301400,694100
510336,202101,56,39,17,42900,18700,61600
510337,202101,108,45,63,49500,69300,118800
510340,202101,17166,7714,9452,8489800.63,10404900,18894700.63
510343,202101,61,43,18,47300,19800,67100
510345,202101,158,101,57,111100,62700,173800
510350,202101,649,352,297,387200,326700,713900
510360,202101,203,124,79,136400,86900,223300
510370,202101,152,70,82,77000,90200,167200
510380,202101,85,62,23,68200,25300,93500
510385,202101,62,27,35,29700,38500,68200
510390,202101,109,47,62,51700,68200,119900
510395,202101,45,32,13,35200,14300,49500
510410,202101,712,459,253,504900,278300,783200
510420,202101,557,267,290,294800,319000,613800
510450,202101,50,25,25,27500,27500,55000
510452,202101,53,25,28,27500,30800,58300
510454,202101,55,25,30,27500,33000,60500
510455,202101,137,78,59,85800,64900,150700
510460,202101,179,82,97,90200,106700,196900
510480,202101,698,412,286,455400,315700,771100
510490,202101,348,175,173,192500,190300,382800
510500,202101,241,182,59,200200,64900,265100
510510,202101,783,458,325,503800,360800,864600
510515,202101,1222,626,596,689700,658900,1348600
510517,202101,256,110,146,121000,160600,281600
510520,202101,225,146,79,160600,86900,247500
510523,202101,100,78,22,85800,24200,110000
510525,202101,809,484,325,533500,358600,892100
510530,202101,20,13,7,14300,7700,22000
510550,202101,241,111,130,123200.56,143000,266200.56
510558,202101,292,143,149,157300,163900,321200
510560,202101,413,241,172,265100,189200,454300
510562,202101,635,462,173,508200,190300,698500
510590,202101,744,384,360,422400,397100,819500
510600,202101,233,121,112,133100,123200,256300
510610,202101,208,85,123,93500,135300,228800
510615,202101,180,81,99,89100,108900,198000
510617,202101,18,9,9,9900,9900,19800
510618,202101,121,58,63,63800,69300,133100
510619,202101,92,64,28,70400,30800,101200
510620,202101,162,93,69,102300,75900,178200
510621,202101,175,112,63,123200,69300,192500
510622,202101,491,294,197,324500,216700,541200
510623,202101,319,219,100,240900,111100,352000
510624,202101,94,46,48,50600,52800,103400
510625,202101,521,326,195,358600,214500.63,573100.63
510626,202101,109,68,41,74800,45100,119900
510627,202101,78,54,24,59400,26400,85800
510628,202101,152,89,63,97900,69300,167200
510629,202101,270,158,112,173800,123219.8,297019.8
510630,202101,430,220,210,242000,231000,473000
510631,202101,14,4,10,4400,11000,15400
510637,202101,347,196,151,215600,166100,381700
510642,202101,1000,529,471,581900,518100,1100000
510645,202101,2,0,2,0,2200,2200
510650,202101,1365,892,473,981200,520300,1501500
510665,202101,83,35,48,38500,52800,91300
510670,202101,59,33,26,36300,28600,64900
510675,202101,1133,724,409,798600,449900,1248500
510677,202101,340,176,164,193600,180400,374000
510680,202101,102,59,43,64900,47300,112200
510682,202101,206,105,101,115500,111100,226600
510685,202101,53,40,13,44000,14300,58300
510700,202101,569,327,242,359700,267300,627000
510704,202101,1157,600,557,660000,613800,1273800
510706,202101,134,66,68,72600,74800,147400
510710,202101,390,278,112,305800,123200,429000
510715,202101,58,40,18,44000,19800,63800
510718,202101,216,108,108,118800,118800,237600
510719,202101,42,17,25,18700,28600,47300
510720,202101,187,130,57,143000,62700,205700
510724,202101,86,33,53,36300,58300,94600
510726,202101,53,28,25,30800,27500,58300
510729,202101,55,21,34,23100,37400,60500
510730,202101,480,264,216,290400,237600,528000
510735,202101,110,44,66,48400,73700,122100
510740,202101,18,10,8,11000,8800,19800
510757,202101,24,18,6,19800,6600,26400
510760,202101,7130,3640,3490,4009500,3839000,7848500
510770,202101,675,318,357,349800,392700,742500
510774,202101,17,5,12,5500,13200,18700
510775,202101,107,81,26,89100,29700,118800
510776,202101,27,10,17,11000,18700,29700
510777,202101,192,82,110,90200,121000,211200
510779,202101,51,25,26,27500,28600,56100
510780,202101,284,160,124,176000,136400,312400
510785,202101,385,205,180,225500,198000,423500
510787,202101,191,92,99,101200,108900,210100
510788,202101,5,1,4,1100,4400,5500
510790,202101,2496,1306,1190,1438851.6,1310100,2748951.6
510792,202101,1131,632,499,696300,550000.54,1246300.54
510794,202101,113,62,51,68200,56100,124300
510795,202101,2282,1334,948,1468500.11,1043900,2512400.11
510800,202101,174,104,70,114400,77000,191400
510805,202101,189,127,62,139700,68200,207900
510810,202101,97,43,54,47300,59400,106700
510820,202101,238,118,120,129800,132000.5,261800.5
510830,202101,73,42,31,46200,34100,80300
510835,202101,14,9,5,9900,5500,15400
510840,202101,9049,4274,4775,4704700,5256900,9961600
510850,202101,221,89,132,97900,145200,243100
510860,202101,375,168,207,184800,227700,412500
510880,202101,68,47,21,51700,23100,74800
510885,202101,69,38,31,41800,35200,77000
510890,202101,64,37,27,40700,29700,70400
510895,202101,168,99,69,108900,75900,184800
520005,202101,129,54,75,59400,82500,141900
520010,202101,285,128,157,140800,172700,313500
520013,202101,727,472,255,519200,280500,799700
520015,202101,51,37,14,40700,15400,56100
520017,202101,87,49,38,53900,42900,96800
520020,202101,17,10,7,11000,7700,18700
520025,202101,2369,1229,1140,1355200,1256200,2611400
520030,202101,809,429,380,472175,418000,890175
520050,202101,69,49,20,53900,22000,75900
520055,202101,55,34,21,37400,23100,60500
520060,202101,172,112,60,123200,66000,189200
520080,202101,583,421,162,463100,178200,641300
520082,202101,17,12,5,13200,5500,18700
520085,202101,90,66,24,72600,26400,99000
520090,202101,91,62,29,68200,31900,100100
520110,202101,9250,3941,5309,4340600,5842100,10182700
520120,202101,12,7,5,7700,5500,13200
520130,202101,807,559,248,614900,272800,887700
520140,202101,11940,6622,5318,7287500.46,5852000.4,13139500.86
520145,202101,54,32,22,35200,24200,59400
520150,202101,161,128,33,140800,36300,177100
520160,202101,40,29,11,31900,12100,44000
520170,202101,250,143,107,157300,117700,275000
520180,202101,171,81,90,89100,99000,188100
520215,202101,209,140,69,154000,75900,229900
520235,202101,80,64,16,70400,17600,88000
520250,202101,127,71,56,78100,61600,139700
520260,202101,113,72,41,79200,45100,124300
520280,202101,44,30,14,33000,15400,48400
520310,202101,39,26,13,28600,14300,42900
520320,202101,180,109,71,119900,78100,198000
520330,202101,800,425,375,468600,413600,882200
520340,202101,361,212,149,233200,163900,397100
520350,202101,508,240,268,264000,294800,558800
520355,202101,88,51,37,56100,41800,97900
520357,202101,25,18,7,19800,7700,27500
520360,202101,2,2,0,2200,0,2200
520380,202101,133,72,61,79200,67100,146300
520390,202101,256,108,148,118800,162800,281600
520393,202101,16,11,5,12100,5500,17600
520396,202101,76,49,27,53900,29700,83600
520400,202101,193,115,78,126500,85800,212300
520410,202101,196,95,101,104500,111100,215600
520420,202101,20,13,7,14300,7700,22000
520425,202101,284,142,142,156200,156200,312400
520430,202101,488,241,247,265201.2,273900,539101.2
520440,202101,700,503,197,553300,216700,770000
520450,202101,1983,843,1140,928400,1254000,2182400
520455,202101,60,33,27,36300,29700,66000
520460,202101,39,24,15,26400,16500,42900
520465,202101,32,27,5,29700,5500,35200
520470,202101,437,280,157,309100,172700,481800
520480,202101,76,45,31,49500,34100,83600
520485,202101,105,38,67,41800,73700,115500
520490,202101,412,306,106,337700,116600,454300
520495,202101,164,99,65,108900,71500,180400
520500,202101,187,148,39,162800,42900,205700
520505,202101,190,110,80,121000,88000,209000
520510,202101,1805,852,953,937200,1048300,1985500
520520,202101,44,30,14,33000,15400,48400
520530,202101,220,168,52,184800,57200,242000
520540,202101,589,396,193,435600,213400,649000
520545,202101,136,79,57,86900,62700,149600
520547,202101,62,35,27,38500,29700,68200
520549,202101,1216,560,656,616000,721600,1337600
520551,202101,310,165,145,181500,160600,342100
520552,202101,35,23,12,25300,13200,38500
520570,202101,15,9,6,9900,6600,16500
520580,202101,272,169,103,187000,113300,300300
520590,202101,141,86,55,94600,61600,156200
520620,202101,1129,528,601,581900,661100,1243000
520630,202101,40,23,17,25300,18700,44000
520640,202101,388,226,162,248600,178200,426800
520650,202101,66,36,30,39600,33000,72600
520660,202101,46,25,21,27500,23100,50600
520670,202101,35,29,6,31900,6600,38500
520680,202101,48,31,17,34100,18700,52800
520690,202101,40,11,29,12100,31900,44000
520710,202101,32,29,3,31900,3300,35200
520725,202101,203,147,56,162800,61600,224400
520735,202101,55,35,20,38500,22000,60500
520740,202101,419,203,216,223300,237600,460900
520750,202101,35,26,9,28600,9900,38500
520753,202101,66,45,21,49500,23100,72600
520760,202101,100,66,34,72600,37400,110000
520780,202101,283,208,75,228800,82500,311300
520790,202101,155,91,64,101200,70400,171600
520800,202101,3393,1829,1564,2014100,1720400,3734500
520810,202101,148,116,32,127600,35200,162800
520815,202101,5,4,1,4400,1100,5500
520830,202101,145,98,47,107800,51700,159500
520840,202101,357,234,123,257400,135300,392700
520850,202101,100,59,41,64900,45100,110000
520860,202101,1757,1133,624,1247400,686400,1933800
520870,202101,31659,14719,16940,16194200.98,18643900,34838100.98
520880,202101,1155,612,543,674300,598400,1272700
520890,202101,782,478,304,525800,334400,860200
520910,202101,972,517,455,569800.4,500500,1070300.4
520915,202101,95,73,22,80300,24200,104500
520920,202101,429,201,228,221100,250800,471900
520929,202101,18,16,2,17600,2200,19800
520940,202101,73,49,24,53900,26400,80300
520945,202101,16,11,5,12100,5500,17600
520960,202101,43,27,16,29700,17600,47300
520970,202101,347,206,141,226600,155100,381700
520980,202101,95,68,27,74800,29700,104500
520990,202101,449,309,140,341000,155100,496100
520993,202101,124,58,66,63800,72600,136400
520995,202101,245,138,107,151800,117700,269500
521000,202101,1556,897,659,987800.6,726000,1713800.6
521010,202101,678,333,345,367400,379500,746900
521015,202101,15,10,5,11000,5500,16500
521020,202101,1416,1001,415,1101100,456500,1557600
521030,202101,56,37,19,40700,20900,61600
521040,202101,939,601,338,661100,371800,1032900
521056,202101,51,34,17,37400,18700,56100
521060,202101,128,83,45,91300,49500,140800
521080,202101,405,312,93,343200,102300,445500
521090,202101,547,355,192,391600,211200,602800
521100,202101,268,200,68,220000,74800,294800
521120,202101,1055,744,311,818400,342100,1160500
521130,202101,348,248,100,272800,110000,382800
521140,202101,179,100,79,110000,86900,196900
521150,202101,2626,1135,1491,1248500,1640100,2888600
521160,202101,28,15,13,16500,14300,30800
521170,202101,220,123,97,135300,106700,242000
521180,202101,1170,749,421,823900,463100,1287000
521190,202101,2512,1064,1448,1171500,1592800,2764300
521200,202101,55,41,14,45100,15400,60500
521205,202101,11,8,3,8800,3300,12100
521210,202101,118,70,48,77000,52800,129800
521220,202101,753,527,226,580800,249700,830500
521225,202101,31,21,10,23100,11000,34100
521230,202101,108,70,38,77000,41800,118800
521250,202101,6184,3490,2694,3839001.71,2968900,6807901.71
521260,202101,29,14,15,15400,16500,31900
521270,202101,143,110,33,121000,36300,157300
521280,202101,423,259,164,286000,180400,466400
521290,202101,25,15,10,16500,11000,27500
521295,202101,97,63,34,69300,37400,106700
521300,202101,219,120,99,133100,108900.77,242000.77
521305,202101,36,25,11,27500,12100,39600
521308,202101,1045,803,242,883300,266200,1149500
521310,202101,1322,765,557,841500,613800,1455300
521340,202101,17,14,3,15400,3300,18700
521350,202101,123,93,30,102300,33000,135300
521370,202101,176,125,51,137500,56100,193600
521375,202101,180,94,86,103400,94600,198000
521377,202101,48,38,10,41800,11000,52800
521380,202101,1059,671,388,738100,429000,1167100
521385,202101,13,8,5,8800,5500,14300
521390,202101,99,81,18,90200,19800,110000
521400,202101,351,235,116,258500,127600,386100
521405,202101,146,80,66,88000,72600,160600
521410,202101,68,48,20,52800,22000,74800
521440,202101,196,141,55,155100,60500,215600
521450,202101,735,408,327,448800,359700,808500
521460,202101,1135,730,405,803000,445500,1248500
521470,202101,14,9,5,9900,5500,15400
521480,202101,43,29,14,31900,15400,47300
521483,202101,311,189,122,207900,134200,342100
521486,202101,285,185,100,203500,110000,313500
521487,202101,22,11,11,12100,12100,24200
521490,202101,22,11,11,12100,12100,24200
521500,202101,127,74,53,81400,58300,139700
521520,202101,45,31,14,34100,15400,49500
521523,202101,745,443,302,487300,332200,819500
521525,202101,47,29,18,31900,19800,51700
521530,202101,240,132,108,145200,118800,264000
521540,202101,34,17,17,18700,18700,37400
521550,202101,89,36,53,39600,58300,97900
521560,202101,817,557,260,613800,286000,899800
521565,202101,62,43,19,47300,20900,68200
521570,202101,528,355,173,391600,190300,581900
521580,202101,55,31,24,34100,26400,60500
521590,202101,37,17,20,18700,22000,40700
521600,202101,21,11,10,12100,11000,23100
521630,202101,248,135,113,148500,124300,272800
521640,202101,307,165,142,181500,156200,337700
521645,202101,34,17,17,18700,18700,37400
521680,202101,241,148,93,162800,103400,266200
521690,202101,3,3,0,3300,0,3300
521710,202101,1138,548,590,603900,650100,1254000
521720,202101,564,389,175,429000,192500,621500
521730,202101,662,317,345,348700,380600,729300
521740,202101,881,380,501,420200,551100,971300
521760,202101,1978,1016,962,1118700.95,1058200,2176900.95
521770,202101,818,515,303,567600,333300,900900
521800,202101,1977,1277,700,1404700,770000,2174700
521805,202101,33,17,16,18700,17600,36300
521810,202101,83,53,30,58300,33000,91300
521830,202101,961,685,276,753500.73,304700,1058200.73
521839,202101,86,53,33,58300,36300,94600
521850,202101,1102,572,530,629200.17,584100,1213300.17
521860,202101,333,206,127,227700,139700,367400
521870,202101,71,43,28,47300,30800,78100
521878,202101,34,16,18,17600,19800,37400
521880,202101,4737,2108,2629,2319900,2891900,5211800
521890,202101,591,414,177,455400.3,195800,651200.3
521900,202101,283,230,53,253000,58300,311300
521910,202101,160,113,47,124300,51700,176000
521920,202101,44,22,22,24200,24200,48400
521925,202101,53,31,22,34100,24200,58300
521930,202101,1148,641,507,706200,559900,1266100
521935,202101,34,24,10,26400,11000,37400
521940,202101,204,97,107,106700,117700,224400
521945,202101,17,13,4,14300,4400,18700
521950,202101,9,5,4,5500,4400,9900
521960,202101,70,52,18,57200,19800,77000
521970,202101,404,256,148,281600,162800,444400
521971,202101,104,58,46,63800,50600,114400
521973,202101,34,17,17,18700,18700,37400
521975,202101,1456,727,729,799700.75,805200.18,1604900.93
521980,202101,244,168,76,184800,83600,268400
521990,202101,75,53,22,58300,24200,82500
522000,202101,292,186,106,205316.1,116600,321916.1
522005,202101,18,10,8,11000,8800,19800
522010,202101,1132,629,503,691900,553300,1245200
522015,202101,58,34,24,37400,26400,63800
522020,202101,892,515,377,566500,414700,981200
522026,202101,23,14,9,15400,9900,25300
522028,202101,15,11,4,12100,4400,16500
522040,202101,771,314,457,345400,503800,849200
522045,202101,2340,1426,914,1570800,1007600,2578400
522050,202101,160,77,83,84700,91300,176000
522060,202101,541,334,207,367400,227700,595100
522068,202101,109,77,32,84700,35200,119900
522070,202101,10,9,1,9900,1100,11000
522100,202101,37,21,16,23100,17600,40700
522108,202101,42,31,11,34100,12100,46200
522119,202101,54,30,24,33000,26400,59400
522130,202101,75,28,47,30800,51700,82500
522140,202101,4039,2071,1968,2278100.01,2164800,4442900.01
522145,202101,49,35,14,38500,15400,53900
522150,202101,96,68,28,74800,30800,105600
522155,202101,55,40,15,44000,16500,60500
522157,202101,6,3,3,3300,3300,6600
522160,202101,1685,992,693,1093400,763400,1856800
522170,202101,401,269,132,295900,145200,441100
522180,202101,36,17,19,18700,20900,39600
522185,202101,2092,830,1262,913000,1390400,2303400
522190,202101,53,28,25,30800,27500,58300
522200,202101,300,179,121,196900,133100,330000
522205,202101,139,93,46,102300,50600,152900
522220,202101,147,107,40,117700,44000,161700
522230,202101,31,24,7,26400,8800,35200
530010,202101,53932,27211,26721,29956543.11,29414106.29,59370649.40
110001,202102,504,406,98,446600,111100,557700
110002,202102,2823,1770,1053,1948100,1159400,3107500
110003,202102,81,68,13,74800,14300,89100
110004,202102,2028,1338,690,1471800,760100,2231900
110005,202102,432,344,88,379500,96800,476300
110006,202102,444,337,107,370700,117700,488400
110007,202102,69,57,12,62700,13200,75900
110008,202102,242,133,109,146300,119900,266200
110009,202102,902,661,241,727100,266200,993300
110010,202102,1689,1029,660,1133000.36,727100,1860100.36
110011,202102,1741,1354,387,1489400,425700,1915100
110012,202102,4091,2376,1715,2616900,1888700,4505600
110013,202102,775,617,158,678700.51,173800,852500.51
110014,202102,371,323,48,355300,52800,408100
110015,202102,1377,1105,272,1217700,300300,1518000
110018,202102,1080,674,406,741400,447700,1189100
110020,202102,15479,8869,6610,9772401.32,7306200,17078601.32
110025,202102,648,476,172,523600,189200,712800
110026,202102,37,27,10,29700,11000,40700
110028,202102,1611,1156,455,1272700,500500,1773200
110029,202102,136,122,14,134200,15400,149600
110030,202102,2398,1607,791,1768624.18,871200.85,2639825.03
110032,202102,321,250,71,275000,78100,353100
110033,202102,657,475,182,524700,200200,724900
110034,202102,335,246,89,270600.5,97900,368500.5
110037,202102,98,85,13,93500,14300,107800
110040,202102,374,251,123,276100,135300,411400
110045,202102,932,640,292,705100,321200,1026300
110050,202102,92,80,12,88000,13200,101200
110060,202102,66,39,27,42900,29700,72600
110070,202102,103,67,36,73700,39600,113300
110080,202102,494,279,215,306900,236500,543400
110090,202102,25,21,4,23100,4400,27500
110092,202102,104,57,47,62700,51700,114400
110094,202102,195,141,54,155100,60500,215600
110100,202102,38,26,12,28600,13200,41800
110110,202102,96,53,43,58300,47300,105600
110120,202102,69,60,9,66000,9900,75900
110130,202102,283,231,52,254100,57200,311300
110140,202102,239,169,70,185900,78100,264000
110143,202102,48,39,9,42900,9900,52800
110145,202102,29,22,7,24200,7700,31900
110146,202102,22,12,10,13200,11000,24200
110147,202102,38,26,12,28600,13200,41800
110148,202102,34,24,10,26400,11000,37400
110149,202102,311,221,90,243100,100100,343200
110150,202102,131,101,30,111100,33000,144100
110155,202102,10,10,0,11000,0,11000
110160,202102,65,52,13,57200,14300,71500
110170,202102,218,166,52,182600,57200,239800
110175,202102,66,50,16,55000,17600,72600
110180,202102,88,74,14,81400,15400,96800
120001,202102,193,142,51,156200,56100,212300
120005,202102,197,115,82,126500.41,90200,216700.41
120010,202102,1099,680,419,748000,460900,1208900
120013,202102,144,97,47,106700.33,51700,158400.33
120017,202102,108,60,48,66000,52800,118800
120020,202102,3517,2843,674,3127301.2,743600,3870901.2
120025,202102,534,302,232,332200.4,255200,587400.4
120030,202102,1056,912,144,1003200.7,158400,1161600.7
120032,202102,34,30,4,33000,4400,37400
120033,202102,213,190,23,209000,25300,234300
120034,202102,170,125,45,137500,49500,187000
120035,202102,37,31,6,34100,6600,40700
120038,202102,412,273,139,300300,152900,453200
120039,202102,29,28,1,30800,1100,31900
120040,202102,13886,9479,4407,10429465.13,4849900,15279365.13
120042,202102,44,38,6,41800,6600,48400
120043,202102,11,3,8,3300,8800,12100
120045,202102,530,338,192,371800,211200,583000
120050,202102,1279,977,302,1074701,332200,1406901
120060,202102,1467,1204,263,1324400,289300,1613700
120070,202102,418,303,115,333300.6,126500,459800.6
120080,202102,176,109,67,119900,73700,193600
130002,202102,161,115,46,126500,50600,177100
130006,202102,102,64,38,70400,41800,112200
130008,202102,130,71,59,78100,64900,143000
130010,202102,152,85,67,93500,73700,167200
130014,202102,274,198,76,217800,83600,301400
130020,202102,98,59,39,64900,42900,107800
130030,202102,975,570,405,627000,446600,1073600
130040,202102,334,165,169,181500,185900,367400
130050,202102,564,293,271,322300,298100,620400
130060,202102,838,571,267,628100,293700,921800
130063,202102,591,336,255,369600,280500,650100
130068,202102,183,113,70,124300,77000,201300
130070,202102,1297,881,416,969100,457600,1426700
130080,202102,720,481,239,529100,262900,792000
130083,202102,71,38,33,41800,36300,78100
130090,202102,321,165,156,181500,171600,353100
130100,202102,1112,471,641,518100,705100,1223200
130110,202102,743,315,428,346500,470800,817300
130115,202102,160,70,90,77000,99000,176000
130120,202102,1623,1019,604,1120900,664400,1785300
130130,202102,618,421,197,464200,216700,680900
130140,202102,1566,1230,336,1353000,369600,1722600
130150,202102,412,364,48,400400,52800,453200
130160,202102,452,260,192,286000,211200,497200
130165,202102,39,30,9,33000,9900,42900
130170,202102,1016,710,306,780929.6,337700.9,1118630.5
130180,202102,233,174,59,191400,64900,256300
130185,202102,2260,1045,1215,1150600,1340900,2491500
130190,202102,3385,2128,1257,2340800,1383800,3724600
130195,202102,275,219,56,240900,61600,302500
130200,202102,174,80,94,88000,103400,191400
130210,202102,74,36,38,39600,41800,81400
130220,202102,176,120,56,132000,61600,193600
130230,202102,383,249,134,273900,147400,421300
130240,202102,1293,822,471,905300,518100,1423400
130250,202102,4698,3011,1687,3314300,1856800,5171100
130255,202102,426,206,220,226600,242000,468600
130260,202102,56814,26827,29987,29549210.95,33056331.75,62605542.70
130270,202102,1549,1052,497,1157299,546700,1703999
130280,202102,117,65,52,71500,58300,129800
130290,202102,2082,1425,657,1567500,723800,2291300
130300,202102,428,297,131,326700,144100,470800
130310,202102,925,494,431,543400,474100,1017500
130320,202102,519,275,244,302500,269500,572000
130330,202102,783,490,293,539000,322300,861300
130340,202102,3451,1964,1487,2160400,1636800,3797200
130350,202102,479,320,159,352000,174900,526900
130353,202102,935,409,526,449900,578600,1028500
130356,202102,811,362,449,398200,493900,892100
130360,202102,89,66,23,72600,25300,97900
130370,202102,700,538,162,591800,178200,770000
130380,202102,664,510,154,561000,169400,730400
130390,202102,478,385,93,423500,102300,525800
130395,202102,159,37,122,41800,134200,176000
130400,202102,67,45,22,49500,24200,73700
130406,202102,2056,1224,832,1346400,919600,2266000
130410,202102,434,208,226,228800,248600,477400
130420,202102,2903,2350,553,2585000,608300,3193300
130423,202102,155,79,76,86900,83600,170500
130426,202102,156,78,78,85800,85800,171600
130430,202102,417,256,161,281600,179300,460900
130440,202102,195,58,137,63800,150700,214500
140002,202102,15,4,11,4400,12100,16500
140005,202102,198,120,78,132000,85800,217800
140010,202102,10908,6851,4057,7540502.67,4462700,12003202.67
140015,202102,137,63,74,69300,81400,150700
140017,202102,123,74,49,81400,53900,135300
140020,202102,459,297,162,326700,178200,504900
140023,202102,33,17,16,18700,17600,36300
140028,202102,23,12,11,13200,12100,25300
140030,202102,355,243,112,267300,123200,390500
140040,202102,63,44,19,48400,20900,69300
140045,202102,268,103,165,113300,181500,294800
140047,202102,405,275,130,302500,144100,446600
140050,202102,139,84,55,92400,60500,152900
140060,202102,56,37,19,40700,20900,61600
140070,202102,31,28,3,30800,3300,34100
150010,202102,4732,2865,1867,3151500,2053700,5205200
150013,202102,161,114,47,125400,52800,178200
150020,202102,1096,590,506,649000,556600,1205600
150030,202102,700,310,390,341000,429000,770000
150034,202102,203,125,78,137500,85800,223300
150040,202102,1486,846,640,930600,705100,1635700
150050,202102,692,386,306,424600,336600,761200
150060,202102,4885,3086,1799,3394507,1979355.4,5373862.4
150070,202102,398,199,199,218900,218900,437800
150080,202102,15353,7275,8078,8002500,8889100,16891600
150085,202102,432,269,163,295900,179300,475200
150090,202102,700,589,111,649000,122100,771100
150095,202102,364,228,136,250800,149600,400400
150100,202102,59,38,21,41800,23100,64900
150110,202102,200,106,94,116600,103400,220000
150120,202102,403,291,112,320100,124300,444400
150125,202102,50,17,33,18700,36300,55000
150130,202102,2055,1076,979,1183600,1076900,2260500
150140,202102,55405,24854,30551,27351500.67,33632500.7,60984001.37
150145,202102,220,118,102,129800,112200,242000
150150,202102,3005,1295,1710,1424500,1882100,3306600
150157,202102,385,268,117,294800,128700,423500
150160,202102,126,98,28,107800,30800,138600
150170,202102,3654,2713,941,2984300,1035100,4019400
150172,202102,341,238,103,261800,113300,375100
150175,202102,80,48,32,52800,35200,88000
150178,202102,755,499,256,548900,281600,830500
150180,202102,3180,1547,1633,1701700,1796300,3498000
150190,202102,348,217,131,238700,144100,382800
150195,202102,110,57,53,62700,58300,121000
150200,202102,194,92,102,101200,112200,213400
150210,202102,3149,2521,628,2773100,690800,3463900
150215,202102,565,355,210,390500,231000,621500
150220,202102,3591,2385,1206,2624600.82,1327700,3952300.82
150230,202102,1197,960,237,1056000.5,260700,1316700.5
150240,202102,6415,3623,2792,3985300.6,3073400,7058700.6
150250,202102,61,33,28,36300,30800,67100
150260,202102,93,61,32,67100,35200,102300
150270,202102,2205,1421,784,1563100,862400,2425500
150275,202102,525,332,193,365200,213400,578600
150276,202102,110,42,68,46200,74800,121000
150277,202102,792,346,446,380600,490600,871200
150280,202102,365,242,123,266200,135300,401500
150285,202102,107,54,53,59400,58124,117524
150290,202102,1145,671,474,738100,521400,1259500
150293,202102,706,328,378,360800,415800,776600
150295,202102,509,234,275,257400,302500,559900
150300,202102,82,38,44,41800,48400,90200
150304,202102,176,104,72,114400,79200,193600
150307,202102,399,330,69,363000,75900,438900
150309,202102,574,407,167,447700,183700,631400
150310,202102,244,158,86,173800,94600,268400
150320,202102,1891,1319,572,1450900,629200,2080100
150330,202102,2028,1164,864,1280400,950400,2230800
150340,202102,195,129,66,141900,72600,214500
150345,202102,623,342,281,376200,309100,685300
150350,202102,405,316,89,347600,99000,446600
150360,202102,4651,2866,1785,3153700,1967900,5121600
150370,202102,826,568,258,624800,283800,908600
150375,202102,199,90,109,99000,119900,218900
150380,202102,1501,993,508,1092300,558800,1651100
150390,202102,803,467,336,513700,370700,884400
150400,202102,108,89,19,97900,20900,118800
150405,202102,1232,781,451,859100,496100,1355200
150410,202102,119,75,44,82500,48400,130900
150420,202102,7403,3996,3407,4396880,3748800,8145680
150430,202102,615,389,226,427900,248600,676500
150440,202102,440,277,163,304700,179300,484000
150442,202102,2329,1236,1093,1360700,1203400,2564100
150445,202102,544,352,192,387200,211200,598400
150450,202102,222,118,104,129800,114400,244200
150460,202102,736,544,192,598400,211200,809600
150470,202102,1288,769,519,845900,570900,1416800
150475,202102,234,177,57,194700,62700,257400
150480,202102,1302,904,398,995500,437800,1433300
150490,202102,659,390,269,429000,295900,724900
150495,202102,334,245,89,269500,97900,367400
150497,202102,273,189,84,207900,92400,300300
150500,202102,224,135,89,148500,97900,246400
150503,202102,1063,533,530,587400,583000,1170400
150506,202102,924,614,310,675400,341000,1016400
150510,202102,1262,692,570,761200,628100,1389300
150520,202102,292,193,99,212300,108900,321200
150530,202102,1726,939,787,1034000,865700,1899700
150540,202102,226,163,63,179300,69300,248600
150543,202102,824,422,402,464200,442200,906400
150548,202102,463,328,135,360800,148500,509300
150549,202102,60,42,18,46200,19800,66000
150550,202102,2942,1476,1466,1623600,1612600,3236200
150553,202102,3353,1889,1464,2079000,1611500,3690500
150555,202102,146,80,66,88000,72600,160600
150560,202102,35,14,21,15400,23100,38500
150563,202102,119,53,66,58300,72600,130900
150565,202102,190,116,74,127600,81400,209000
150570,202102,427,282,145,310200,159500,469700
150580,202102,1680,806,874,886600,961400,1848000
150590,202102,809,536,273,589600,300300,889900
150600,202102,480,286,194,314600,213400,528000
150610,202102,146,118,28,129800,30800,160600
150611,202102,122,80,42,88000,46200,134200
150613,202102,3239,1900,1339,2091100,1472900,3564000
150616,202102,540,302,238,332200,261800,594000
150618,202102,1345,700,645,770000,709500,1479500
150619,202102,394,297,97,326700,106700,433400
150620,202102,1259,725,534,798600,587400,1386000
150630,202102,323,209,114,229900,125400,355300
150635,202102,456,186,270,204600,297000,501600
150640,202102,47,24,23,26400,25300,51700
150650,202102,2400,1395,1005,1534500,1105500,2640000
150655,202102,238,177,61,194700,67100,261800
150658,202102,86,51,35,56100,38500,94600
150660,202102,546,355,191,390500,210100,600600
150670,202102,1083,378,705,415800,775500,1191300
150680,202102,10197,5322,4875,5855300.57,5366900,11222200.57
150690,202102,19,10,9,11000,9900,20900
150700,202102,483,318,165,349800,181500,531300
150710,202102,286,157,129,172700,141900,314600
150715,202102,835,520,315,572000,346500,918500
150720,202102,414,316,98,347600,107800,455400
150730,202102,1030,513,517,564300,570900,1135200
150740,202102,227,149,78,163900,85800,249700
150745,202102,750,415,335,456500,369600,826100
150746,202102,63,34,29,37400,31900,69300
150747,202102,225,170,55,187000,60500,247500
150750,202102,137,76,61,83600,67100,150700
150760,202102,1824,1181,643,1299100.5,707593.33,2006693.83
150770,202102,386,212,174,233200,191400,424600
150775,202102,105,49,56,53900,61600,115500
150780,202102,197,109,88,119900,96800,216700
150790,202102,883,503,380,553300,419100,972400
150795,202102,1546,919,627,1012000,689700,1701700
150796,202102,351,200,151,220000,166100,386100
150797,202102,337,163,174,179300,191400,370700
150800,202102,1510,854,656,939400,721600,1661000
150803,202102,525,422,103,464200,113300,577500
150805,202102,208,122,86,134200,94600,228800
150808,202102,998,532,466,585200,512600,1097800
150810,202102,3238,2193,1045,2412300.5,1150600,3562900.5
150812,202102,448,223,225,245300,247500,492800
150815,202102,1074,667,407,733700,447700,1181400
150820,202102,1553,926,627,1018600,689700,1708300
150830,202102,728,527,201,579700,221100,800800
150835,202102,210,124,86,136400,94600,231000
150840,202102,1363,829,534,913000,587400,1500400
160005,202102,64,45,19,49500,20900,70400
160010,202102,190,120,70,132000,77000,209000
160015,202102,132,81,51,89100,56100,145200
160020,202102,134,73,61,80300,67100,147400
160021,202102,61,26,35,28600,38500,67100
160023,202102,67,43,24,47300,26400,73700
160025,202102,25,12,13,13200,14300,27500
160027,202102,1477,838,639,921800,702900,1624700
160030,202102,16016,8205,7811,9027700,8594300,17622000
160040,202102,302,172,130,189200,143000,332200
160050,202102,722,361,361,397100,397100,794200
160053,202102,283,171,112,188100,123200,311300
160055,202102,24,15,9,16500,9900,26400
160060,202102,6553,3466,3087,3812600.23,3396800,7209400.23
160070,202102,177,100,77,110000,84700,194700
160080,202102,114,56,58,61600,63800,125400
170025,202102,28,15,13,16500,14300,30800
170030,202102,198,162,36,178200.03,39600,217800.03
170035,202102,219,102,117,112200,128700,240900
170040,202102,177,132,45,145200,49500,194700
170070,202102,320,197,123,216700,135300,352000
170100,202102,346,254,92,279400,101200,380600
170105,202102,56,45,11,49500,12100,61600
170110,202102,112,66,46,72600,50600,123200
170130,202102,70,34,36,37400,39600,77000
170190,202102,98,58,40,63800,44000,107800
170200,202102,367,254,113,279400,124300,403700
170210,202102,6144,3223,2921,3547234.25,3214200,6761434.25
170215,202102,115,50,65,55000,71500,126500
170220,202102,1373,1008,365,1108800,401500,1510300
170230,202102,147,97,50,106700,55000,161700
170240,202102,514,344,170,378400,187000,565400
170255,202102,1077,876,201,963600,221100,1184700
170270,202102,44,31,13,34100,14300,48400
170290,202102,114,75,39,82500,42900,125400
170300,202102,99,61,38,67100,41800,108900
170305,202102,48,37,11,40700,12100,52800
170307,202102,64,48,16,52800,17600,70400
170310,202102,114,63,51,69300,56100,125400
170320,202102,26,16,10,17600,11000,28600
170330,202102,24,21,3,23100,3300,26400
170360,202102,31,18,13,19800,14300,34100
170370,202102,101,50,51,55000,56100,111100
170380,202102,70,53,17,58300,18700,77000
170382,202102,43,36,7,39600,7700,47300
170384,202102,141,110,31,121000,34100,155100
170386,202102,66,25,41,27500,46200,73700
170388,202102,48,19,29,20900,31900,52800
170389,202102,26,21,5,23100,5500,28600
170390,202102,73,40,33,44000,36300,80300
170410,202102,26,22,4,24200,4400,28600
170460,202102,16,10,6,11000,6600,17600
170510,202102,38,30,8,33000,8800,41800
170550,202102,1540,895,645,984500,709646.66,1694146.66
170555,202102,111,81,30,89100,33000,122100
170560,202102,104,73,31,80300,34100,114400
170600,202102,41,15,26,16500,28600,45100
170610,202102,195,100,95,110000,104500,214500
170625,202102,37,22,15,24200,16500,40700
170650,202102,80,58,22,63800,24200,88000
170700,202102,585,434,151,477400,166100,643500
170710,202102,158,97,61,106700,67100,173800
170720,202102,88,70,18,77000,19800,96800
170730,202102,85,50,35,55000,38500,93500
170740,202102,85,58,27,63800,29700,93500
170755,202102,59,32,27,35200,29700,64900
170765,202102,142,75,67,82500,73700,156200
170770,202102,202,127,75,139700,82500,222200
170820,202102,611,404,207,444400,227700,672100
170825,202102,37,18,19,19800,20900,40700
170830,202102,85,67,18,73700,19800,93500
170900,202102,176,134,42,147400,46200,193600
170930,202102,923,493,430,542300,473000.91,1015300.91
170950,202102,3128,1428,1700,1573000,1870000.4,3443000.4
170980,202102,17,10,7,11000,7700,18700
171050,202102,147,113,34,124300,37400,161700
171070,202102,44,36,8,39600,8800,48400
171090,202102,48,35,13,38500,14300,52800
171110,202102,22,16,6,17600,6600,24200
171150,202102,41,21,20,23100,22000,45100
171180,202102,28,14,14,15400,15400,30800
171190,202102,157,91,66,100100,72600,172700
171195,202102,62,51,11,56100,12100,68200
171200,202102,49,23,26,26400,28600,55000
171215,202102,4,3,1,3300,1100,4400
171240,202102,60,42,18,46200,19800,66000
171245,202102,56,48,8,52800,8800,61600
171250,202102,78,44,34,48400,37400,85800
171270,202102,14,10,4,11000,4400,15400
171280,202102,39,34,5,37400,5500,42900
171320,202102,1000,572,428,629200,470800,1100000
171330,202102,429,215,214,237600,235400,473000
171360,202102,89,62,27,68200,29700,97900
171370,202102,33,16,17,17600,18700,36300
171380,202102,128,110,18,121000,19800,140800
171395,202102,50,32,18,35200,19800,55000
171420,202102,270,175,95,192500,104500,297000
171430,202102,72,57,15,62700,16500,79200
171488,202102,182,100,82,110000,90200,200200
171500,202102,60,34,26,37400,28600,66000
171510,202102,70,45,25,49500,27500,77000
171515,202102,42,33,9,36300,9900,46200
171525,202102,29,27,2,29700,2200,31900
171550,202102,15,9,6,9900,6600,16500
171570,202102,50,25,25,27500,27500,55000
171575,202102,301,197,104,217800,114400,332200
171610,202102,1737,882,855,970200,940500,1910700
171620,202102,139,94,45,103400,49500,152900
171630,202102,53,28,25,30800,27500,58300
171650,202102,312,218,94,240900,103400,344300
171660,202102,267,150,117,165000,128700,293700
171665,202102,64,42,22,46200,24200,70400
171670,202102,429,258,171,283800,188100,471900
171700,202102,64,57,7,62700,7700,70400
171720,202102,29,11,18,12100,19800,31900
171750,202102,104,54,50,59400,55000,114400
171780,202102,72,56,16,61600,17600,79200
171790,202102,82,68,14,74800,15400,90200
171800,202102,31,23,8,25300,8800,34100
171820,202102,2101,1197,904,1316700.7,994400,2311100.7
171830,202102,34,27,7,29700,7700,37400
171840,202102,65,42,23,46200,25300,71500
171845,202102,28,18,10,19800,11000,30800
171850,202102,39,31,8,34100,8800,42900
171855,202102,78,60,18,66000,19800,85800
171865,202102,7,6,1,6600,1100,7700
171870,202102,33,22,11,24200,12100,36300
171875,202102,79,56,23,61600,25300,86900
171880,202102,36,23,13,25300,14300,39600
171884,202102,50,27,23,29700,25300,55000
171886,202102,133,55,78,60500,85800,146300
171888,202102,28,22,6,24200,6600,30800
171889,202102,13,8,5,8800,5500,14300
171890,202102,53,45,8,49500,8800,58300
171900,202102,35,25,10,27500,11000,38500
172000,202102,38,31,7,34100,7700,41800
172010,202102,52,43,9,47300,9900,57200
172015,202102,25,17,8,18700,8800,27500
172020,202102,141,88,53,96800,58300,155100
172025,202102,39,26,13,28600,14300,42900
172030,202102,42,23,19,25300,20900,46200
172049,202102,83,53,30,58300,33000,91300
172065,202102,132,86,46,94600,50600,145200
172080,202102,104,67,37,73700,40700,114400
172085,202102,29,14,15,15400,16500,31900
172090,202102,428,325,103,357500.56,113300,470800.56
172093,202102,15,13,2,14300,2200,16500
172097,202102,18,11,7,12100,7700,19800
172100,202102,5154,2912,2242,3204300,2466200,5670500
172110,202102,77,49,28,53900,30800,84700
172120,202102,1649,1388,261,1526800,288200,1815000
172125,202102,10,9,1,9900,1100,11000
172130,202102,24,14,10,15400,11000,26400
172208,202102,204,123,81,135300,89100,224400
172210,202102,372,181,191,199100,210100,409200
210005,202102,2970,1865,1105,2051500.32,1215500,3267000.32
210010,202102,155,88,67,96800,73700,170500
210015,202102,40,29,11,31900,12100,44000
210020,202102,367,206,161,226600,177100,403700
210030,202102,328,216,112,237600,123200,360800
210040,202102,139,110,29,121000,31900,152900
210043,202102,249,187,62,205700,68200,273900
210047,202102,530,322,208,354200,228800,583000
210050,202102,284,210,74,231000,81400,312400
210055,202102,50,40,10,44000,11000,55000
210060,202102,532,423,109,465300,119900,585200
210070,202102,420,321,99,353100,108900,462000
210080,202102,128,115,13,126500,14300,140800
210083,202102,293,142,151,156200,166100,322300
210087,202102,2,1,1,1100,1100,2200
210090,202102,444,319,125,350900,137500,488400
210095,202102,428,326,102,358600,112200,470800
210100,202102,705,550,155,605000,170500,775500
210110,202102,124,79,45,86900,49500,136400
210120,202102,4989,3910,1079,4301000,1186900.5,5487900.5
210125,202102,188,116,72,127600,79200,206800
210130,202102,467,270,197,297000,216700,513700
210135,202102,25,18,7,19800,7700,27500
210140,202102,4378,3409,969,3749900.1,1065900,4815800.1
210150,202102,374,237,137,260700,150700,411400
210160,202102,3262,2776,486,3053600.54,534600,3588200.54
210170,202102,1155,926,229,1018600,251900,1270500
210173,202102,124,108,16,118800,17600,136400
210177,202102,355,200,155,220000,170500,390500
210180,202102,30,16,14,17600,15400,33000
210190,202102,434,287,147,315700,161700,477400
210193,202102,3,2,1,2200,1100,3300
210197,202102,74,54,20,59400,22000,81400
210200,202102,614,515,99,566500,108900,675400
210203,202102,221,150,71,165000,78100,243100
210207,202102,361,298,63,327800,69300,397100
210210,202102,739,683,56,752400,61600,814000
210215,202102,77,66,11,72600,12100,84700
210220,202102,384,324,60,356400,66000,422400
210230,202102,316,252,64,277200,70400,347600
210232,202102,1369,934,435,1028500,478500,1507000
210235,202102,175,132,43,145200,47300,192500
210237,202102,36,21,15,23100,16500,39600
210240,202102,98,76,22,83600,24200,107800
210250,202102,180,153,27,168300,29700,198000
210255,202102,353,266,87,292600,96800,389400
210260,202102,396,271,125,298100,137500,435600
210270,202102,646,434,212,477400,233200,710600
210275,202102,78,60,18,66000,19800,85800
210280,202102,1044,691,353,760100,388300,1148400
210290,202102,540,361,179,397100,196900,594000
210300,202102,5287,3342,1945,3677301.67,2140600,5817901.67
210310,202102,109,76,33,83600,36300,119900
210312,202102,116,81,35,89100,38500,127600
210315,202102,107,88,19,96800,20900,117700
210317,202102,134,100,34,110000,37400,147400
210320,202102,2314,1972,342,2169200,376200,2545400
210325,202102,139,87,52,95700,57200,152900
210330,202102,4581,2631,1950,2894100,2145000,5039100
210340,202102,1237,927,310,1019700,341000,1360700
210350,202102,641,536,105,589600,115500,705100
210355,202102,147,124,23,136400,26400,162800
210360,202102,2213,1529,684,1681900,752400,2434300
210370,202102,1238,610,628,671000,690800,1361800
210375,202102,191,97,94,106700,103400,210100
210380,202102,717,552,165,607200,181500,788700
210390,202102,194,166,28,182600,30800,213400
210400,202102,389,339,50,372900,55000,427900
210405,202102,980,688,292,756800,321200,1078000
210407,202102,55,44,11,48400,12100,60500
210408,202102,59,52,7,57200,7700,64900
210409,202102,327,286,41,314600,45100,359700
210410,202102,445,348,97,382800,106700,489500
210420,202102,202,166,36,182600,39600,222200
210430,202102,51,35,16,38500,17600,56100
210440,202102,341,229,112,251900,123200,375100
210450,202102,138,110,28,121000,30800,151800
210455,202102,235,122,113,134200,124300,258500
210460,202102,303,205,98,225500,107800,333300
210462,202102,68,57,11,62700,12100,74800
210465,202102,140,109,31,119900,34100,154000
210467,202102,511,376,135,413600,148500,562100
210470,202102,50,43,7,47300,7700,55000
210480,202102,1277,916,361,1007600,397100.5,1404700.5
210490,202102,197,131,66,144100,72600,216700
210500,202102,514,309,205,339900,225500,565400
210510,202102,548,439,109,482900,119900,602800
210515,202102,356,224,132,246400,145200,391600
210520,202102,399,360,39,396000,42900,438900
210530,202102,9374,4903,4471,5398800.48,4920300.83,10319101.31
210535,202102,132,99,33,108900,36300,145200
210540,202102,1513,1004,509,1104400,559900,1664300
210542,202102,1156,591,565,650100,622600,1272700
210545,202102,22,20,2,22000,2200,24200
210547,202102,127,113,14,124300,15400,139700
210550,202102,668,484,184,532400,202400,734800
210560,202102,158,138,20,151800,22000,173800
210565,202102,20,15,5,16500,5500,22000
210570,202102,1280,1039,241,1142900.59,265100,1408000.59
210580,202102,118,100,18,110000,19800,129800
210590,202102,727,602,125,662200,137500,799700
210592,202102,39,37,2,40700,2200,42900
210594,202102,111,94,17,103400,18700,122100
210596,202102,105,90,15,99000,16500,115500
210598,202102,138,103,35,113300,38500,151800
210600,202102,309,268,41,294800,45100,339900
210610,202102,260,245,15,269500,16500,286000
210620,202102,43,27,16,29700,17600,47300
210630,202102,73,70,3,77000,3300,80300
210632,202102,1029,729,300,801900,330000,1131900
210635,202102,22,19,3,20900,3300,24200
210637,202102,123,88,35,96800,38500,135300
210640,202102,582,509,73,559900,80300,640200
210650,202102,398,332,66,365200,72600,437800
210660,202102,373,294,79,323400,86900,410300
210663,202102,39,28,11,30800,12100,42900
210667,202102,102,41,61,45100,67100,112200
210670,202102,243,216,27,237600,29700,267300
210675,202102,541,291,250,320100,275000,595100
210680,202102,220,144,76,158400,83600,242000
210690,202102,620,511,109,562100,119900,682000
210700,202102,156,119,37,130900,40700,171600
210710,202102,241,151,90,166100,99000,265100
210720,202102,130,116,14,127600,15400,143000
210725,202102,63,55,8,60500,8800,69300
210730,202102,24,18,6,19800,6600,26400
210735,202102,294,212,82,233200,90200,323400
210740,202102,521,449,72,493900,79200,573100
210745,202102,153,114,39,125400,42900,168300
210750,202102,2429,1235,1194,1358500,1313400,2671900
210760,202102,255,195,60,214500,66000,280500
210770,202102,245,196,49,215600,53900,269500
210780,202102,432,324,108,356400,118800,475200
210790,202102,184,151,33,166100,36300,202400
210800,202102,174,131,43,144100,47300,191400
210805,202102,53,48,5,52800,5500,58300
210810,202102,465,378,87,415800,95700,511500
210820,202102,2116,1752,364,1928300,400400,2328700
210825,202102,155,88,67,96800,73700,170500
210830,202102,728,484,244,532400,268400,800800
210840,202102,194,136,58,149600,63800,213400
210845,202102,233,163,70,179300,77000,256300
210850,202102,754,515,239,567600,262900,830500
210860,202102,3553,2035,1518,2239600,1669800,3909400
210870,202102,425,338,87,371800,95700,467500
210880,202102,76,59,17,64900,18700,83600
210890,202102,317,276,41,303600,45100,348700
210900,202102,631,412,219,453200,240900,694100
210905,202102,62,34,28,37400,30800,68200
210910,202102,1952,1481,471,1629100.7,518100,2147200.7
210920,202102,164,62,102,68200,112200,180400
210923,202102,83,66,17,72600,18700,91300
210927,202102,423,200,223,220000,245300,465300
210930,202102,67,53,14,58300,15400,73700
210940,202102,85,65,20,71500,22000,93500
210945,202102,194,104,90,114400,99000,213400
210950,202102,525,382,143,420200,157300,577500
210955,202102,80,50,30,55000,33000,88000
210960,202102,2211,1103,1108,1213300,1218800,2432100
210970,202102,118,104,14,114400,15400,129800
210975,202102,83,77,6,84700,6600,91300
210980,202102,1083,530,553,583000,608300,1191300
210990,202102,4006,2658,1348,2923800,1482800,4406600
211000,202102,1313,1061,252,1167100,277200,1444300
211003,202102,977,705,272,775500,299200,1074700
211010,202102,487,434,53,477400,58300,535700
211020,202102,1420,612,808,673200,888800,1562000
211023,202102,37,32,5,35200,5500,40700
211027,202102,74,53,21,58300,23100,81400
211030,202102,369,263,106,289300,116600,405900
211040,202102,299,248,51,272800,56100,328900
211050,202102,1160,769,391,845900,430100,1276000
211060,202102,623,543,80,597300,88000.49,685300.49
211065,202102,21,18,3,19800,3300,23100
211070,202102,883,735,148,808500,163900,972400
211080,202102,84,81,3,89100,3300,92400
211085,202102,52,27,25,29700,27500,57200
211090,202102,74,63,11,69300,12100,81400
211100,202102,478,396,82,435600,90200,525800
211102,202102,241,171,70,188100,77000,265100
211105,202102,220,156,64,171600,70400,242000
211107,202102,125,77,48,84700,52800,137500
211110,202102,932,625,307,687500,338800,1026300
211120,202102,5264,2616,2648,2877600,2913900,5791500
211125,202102,32,23,9,25300,9900,35200
211130,202102,41351,19012,22339,20915400,24579500,45494900
211140,202102,394,345,49,379500,53900,433400
211150,202102,1186,802,384,882200,422400,1304600
211153,202102,170,105,65,115500,71500,187000
211157,202102,65,51,14,56100,15400,71500
211160,202102,694,596,98,655600,107800,763400
211163,202102,2,2,0,2200,0,2200
211167,202102,11,10,1,11000,1100,12100
211170,202102,414,308,106,338800,116600,455400
211172,202102,114,78,36,85800,39600,125400
211174,202102,256,159,97,174900,106700,281600
211176,202102,475,354,121,389400,133100,522500
211178,202102,92,61,31,67100,34100,101200
211180,202102,214,171,43,188100,47300,235400
211190,202102,72,65,7,71500,7700,79200
211195,202102,34,23,11,25300,12100,37400
211200,202102,152,133,19,146300,20900,167200
211210,202102,429,318,111,349800,122100,471900
211220,202102,4118,2429,1689,2671900.5,1860100,4532000.5
211223,202102,91,87,4,95700,4400,100100
211227,202102,66,52,14,57200,15400,72600
211230,202102,735,606,129,666600,141900,808500
211240,202102,398,315,83,346500,91300,437800
211245,202102,185,92,93,101200,102300,203500
211250,202102,1531,1325,206,1457500,226600,1684100
211260,202102,797,660,137,726000,150700,876700
211270,202102,1946,1592,354,1751200,389400,2140600
211280,202102,1741,1120,621,1232000,683100,1915100
211285,202102,204,126,78,138600,85800,224400
211290,202102,715,506,209,556600,229900,786500
211300,202102,747,592,155,651200,170500,821700
211400,202102,1524,936,588,1029600,646800,1676400
220005,202102,15,14,1,15400,1100,16500
220010,202102,90,69,21,75900,23100,99000
220020,202102,695,551,144,606100,158400,764500
220025,202102,108,105,3,115500,3300,118800
220027,202102,46,37,9,40700,9900,50600
220030,202102,113,90,23,99000,25300,124300
220040,202102,1253,952,301,1047200,331100,1378300
220045,202102,33,22,11,24200,12100,36300
220050,202102,689,573,116,630300.8,127600,757900.8
220060,202102,173,150,23,165000,25300,190300
220070,202102,113,102,11,112200,12100,124300
220080,202102,17,15,2,16500,2200,18700
220090,202102,33,27,6,29700,6600,36300
220095,202102,2,1,1,1100,1100,2200
220100,202102,18,15,3,16500,3300,19800
220105,202102,26,24,2,26400,2200,28600
220110,202102,228,209,19,229900,20900,250800
220115,202102,36,35,1,38500,1100,39600
220117,202102,22,21,1,23100,1100,24200
220120,202102,1468,1125,343,1237500,377300,1614800
220130,202102,31,30,1,33000,1100,34100
220140,202102,105,84,21,92400,23100,115500
220150,202102,499,371,128,408100,140800,548900
220155,202102,7,6,1,6600,1100,7700
220157,202102,19,15,4,16500,4400,20900
220160,202102,90,80,10,88000,11000,99000
220170,202102,34,31,3,34100,3300,37400
220173,202102,9,9,0,9900,0,9900
220177,202102,10,9,1,9900,1100,11000
220180,202102,66,64,2,70400,2200,72600
220190,202102,1080,949,131,1043900,144100,1188000
220191,202102,44,37,7,40700,7700,48400
220192,202102,85,81,4,89100,4400,93500
220194,202102,60,55,5,60500,5500,66000
220196,202102,97,82,15,90200,16500,106700
220198,202102,3,2,1,2200,1100,3300
220200,202102,413,343,70,377300,77000,454300
220202,202102,37,32,5,35200,5500,40700
220205,202102,55,48,7,52800,7700,60500
220207,202102,12,12,0,13200,0,13200
220208,202102,74,41,33,45100,36300,81400
220209,202102,33,28,5,30800,5500,36300
220210,202102,20,14,6,15400,6600,22000
220211,202102,28,26,2,28600,2200,30800
220213,202102,40,35,5,38500,5500,44000
220217,202102,38,28,10,31900,11000,42900
220220,202102,2193,1450,743,1595000,817300,2412300
220225,202102,8,3,5,3300,5500,8800
220230,202102,970,747,223,821700,245300,1067000
220240,202102,157,139,18,152900,19800,172700
220245,202102,33,30,3,33000.18,3300,36300.18
220250,202102,126,110,16,121000,17600,138600
220253,202102,46,39,7,42900,7700,50600
220255,202102,34,30,4,33000,4400,37400
220260,202102,708,531,177,584100,194700,778800
220265,202102,5,3,2,3300,2200,5500
220270,202102,766,690,76,759000,83600,842600
220271,202102,42,34,8,37400,8800,46200
220272,202102,22,22,0,24200,0,24200
220273,202102,17,15,2,16500,2200,18700
220275,202102,57,46,11,50600,12100,62700
220277,202102,17,12,5,13200,5500,18700
220280,202102,17,11,6,12100,6600,18700
220285,202102,40,38,2,41800,2200,44000
220290,202102,1478,1273,205,1400300,225500,1625800
220300,202102,34,33,1,36300,1100,37400
220310,202102,327,278,49,305800,53900,359700
220320,202102,441,408,33,448800,36300,485100
220323,202102,1,0,1,0,1100,1100
220325,202102,11,10,1,11000,1100,12100
220327,202102,10,10,0,11000,0,11000
220330,202102,231,169,62,185900,68200,254100
220335,202102,141,123,18,135300,19800,155100
220340,202102,39,27,12,29700,13200,42900
220342,202102,56,48,8,52800,8800,61600
220345,202102,81,73,8,80300,8800,89100
220350,202102,445,383,62,421300,68200,489500
220360,202102,43,31,12,34100,13200,47300
220370,202102,1231,1020,211,1122000,232100,1354100
220375,202102,19,17,2,18700,2200,20900
220380,202102,23,17,6,18700,6600,25300
220385,202102,14,13,1,14300,1100,15400
220390,202102,2323,1318,1005,1450900,1105500,2556400
220400,202102,34,30,4,33000,4400,37400
220410,202102,20,18,2,19800,2200,22000
220415,202102,13,11,2,12100,2200,14300
220420,202102,124,104,20,114400,22000,136400
220430,202102,128,114,14,125400,15400,140800
220435,202102,24,17,7,18700,7700,26400
220440,202102,285,242,43,266200,47300,313500
220450,202102,339,171,168,188100,184800,372900
220455,202102,51,50,1,55000,1100,56100
220460,202102,20,18,2,19800,2200,22000
220465,202102,90,59,31,64900,34100,99000
220470,202102,246,213,33,234300,36300,270600
220480,202102,73,66,7,72600,7700,80300
220490,202102,86,73,13,80300,14300,94600
220500,202102,107,92,15,101200,16500,117700
220510,202102,414,321,93,353100,102300,455400
220515,202102,20,18,2,20900,2200,23100
220520,202102,367,329,38,361900,41800,403700
220525,202102,12,7,5,7700,5500,13200
220527,202102,18,14,4,15400,4400,19800
220530,202102,34,13,21,14300,23100,37400
220535,202102,5,4,1,4400,1100,5500
220540,202102,66,54,12,59400,13200,72600
220545,202102,39,26,13,28600,14300,42900
220550,202102,714,563,151,619300,166100,785400
220551,202102,16,12,4,13200,4400,17600
220552,202102,17,16,1,17600,1100,18700
220553,202102,54,49,5,53900,5500,59400
220554,202102,11,8,3,8800,3300,12100
220555,202102,36,31,5,35200,5500,40700
220556,202102,40,38,2,41800,2200,44000
220557,202102,56,53,3,58300,3300,61600
220558,202102,7,3,4,3300,4400,7700
220559,202102,4,4,0,4400,0,4400
220560,202102,69,45,24,49500,26400,75900
220570,202102,732,452,280,497200,308000,805200
220580,202102,547,500,47,551100,51700,602800
220585,202102,9,8,1,8800,1100,9900
220590,202102,14,14,0,15400,0,15400
220595,202102,63,47,16,51700,17600,69300
220600,202102,20,12,8,13200,8800,22000
220605,202102,25,22,3,24200,3300,27500
220610,202102,79,67,12,73700,13200,86900
220620,202102,555,460,95,507100,104500,611600
220630,202102,5,4,1,4400,1100,5500
220635,202102,35,30,5,33000,5500,38500
220640,202102,102,85,17,94600,18700,113300
220650,202102,111,105,6,115500,6600,122100
220660,202102,57,46,11,50600,12100,62700
220665,202102,5,5,0,5500,0,5500
220667,202102,19,17,2,18700,2200,20900
220669,202102,27,23,4,25300,4400,29700
220670,202102,66,52,14,57200,15400,72600
220672,202102,80,57,23,62700,25300,88000
220675,202102,36,28,8,30800,8800,39600
220680,202102,43,37,6,40700,6600,47300
220690,202102,47,44,3,48400,3300,51700
220695,202102,32,16,16,17600,17600,35200
220700,202102,1710,1322,388,1454200,426800,1881000
220710,202102,6,4,2,4400,2200,6600
220720,202102,108,91,17,100100,18700,118800
220730,202102,15,15,0,16500,0,16500
220735,202102,4,0,4,0,4400,4400
220740,202102,46,42,4,47300,4400,51700
220750,202102,113,96,17,105600,18700,124300
220755,202102,14,13,1,14300,1100,15400
220760,202102,64,58,6,63800,6600,70400
220770,202102,5730,3127,2603,3440800.7,2863300,6304100.7
220775,202102,17,11,6,12100,6600,18700
220777,202102,19,18,1,19800,1100,20900
220779,202102,1,0,1,0,1100,1100
220780,202102,895,762,133,839300,146300,985600
220785,202102,5,1,4,1100,4400,5500
220790,202102,1104,870,234,957000,257400,1214400
220793,202102,6,6,0,6600,0,6600
220795,202102,11,10,1,11000,1100,12100
220800,202102,4003,3078,925,3386900,1017500,4404400
220810,202102,66,57,9,62700,9900,72600
220820,202102,239,218,21,239800,23100,262900
220830,202102,1255,1084,171,1192400,188100,1380500
220840,202102,2407,1676,731,1843600.63,804100,2647700.63
220850,202102,61,52,9,57200,9900,67100
220855,202102,8,5,3,5500,3300,8800
220860,202102,13,10,3,11000,3300,14300
220865,202102,28,26,2,28600,2200,30800
220870,202102,78,70,8,77000,8800,85800
220880,202102,323,258,65,283800,71500,355300
220885,202102,33,29,4,31900,4400,36300
220887,202102,13,12,1,13200,1100,14300
220890,202102,93,81,12,89100,13200,102300
220900,202102,25,15,10,16500,11000,27500
220910,202102,51,42,9,46200,9900,56100
220915,202102,9,8,1,8800,1100,9900
220920,202102,47,42,5,46200,5500,51700
220930,202102,44,43,1,47300,1100,48400
220935,202102,15,15,0,16500,0,16500
220937,202102,33,32,1,35200,1100,36300
220940,202102,55,50,5,55000,5500,60500
220945,202102,3,3,0,3300,0,3300
220950,202102,39,30,9,33000,9900,42900
220955,202102,23,20,3,22000,3300,25300
220960,202102,16,16,0,17600,0,17600
220965,202102,37,33,4,36300,4400,40700
220970,202102,62,52,10,57200,11000,68200
220975,202102,16,14,2,15400,2200,17600
220980,202102,31,29,2,31900,2200,34100
220985,202102,61,54,7,59400,7700,67100
220987,202102,31,30,1,33000,1100,34100
220990,202102,27,26,1,28600,1100,29700
220995,202102,18,15,3,16500,3300,19800
220997,202102,65,54,11,59400,12100,71500
221000,202102,1189,1072,117,1179200,128700,1307900
221005,202102,46,41,5,45100,5500,50600
221010,202102,16,12,4,13200,4400,17600
221020,202102,35,34,1,37400,1100,38500
221030,202102,38,30,8,33000,8800,41800
221035,202102,21,21,0,23100,0,23100
221037,202102,12,8,4,8800,4400,13200
221038,202102,28,25,3,27500,3300,30800
221039,202102,23,22,1,24200,1100,25300
221040,202102,260,219,41,240900,45100,286000
221050,202102,235,195,40,214500,44000,258500
221060,202102,1870,1631,239,1795200,262900,2058100
221062,202102,34,33,1,36300,1100,37400
221063,202102,12,8,4,8800,4400,13200
221065,202102,62,49,13,53900,14300,68200
221070,202102,136,119,17,130900,18700,149600
221080,202102,374,318,56,349800,61600,411400
221090,202102,23,19,4,20900,4400,25300
221093,202102,45,33,12,36300,13200,49500
221095,202102,6,6,0,6600,0,6600
221097,202102,13,11,2,12100,2200,14300
221100,202102,25597,15161,10436,16682600.63,11481800,28164400.63
221110,202102,1099,837,262,920700,288200,1208900
221120,202102,541,396,145,435600,159500,595100
221130,202102,964,775,189,853600,207900,1061500
221135,202102,35,30,5,33000,5500,38500
221140,202102,45,39,6,42900,6600,49500
221150,202102,11,9,2,9900,2200,12100
221160,202102,12,12,0,13200,0,13200
221170,202102,15,15,0,16500,0,16500
230010,202102,149,137,12,150700,13200,163900
230015,202102,128,104,24,114400,26400,140800
230020,202102,1628,1368,260,1504800,286000,1790800
230030,202102,1678,1205,473,1325500,521400,1846900
230040,202102,220,184,36,202400,39600,242000
230050,202102,230,168,62,184800,68200,253000
230060,202102,163,129,34,141900,37400,179300
230070,202102,306,263,43,289300,47300,336600
230075,202102,847,730,117,803000,128700,931700
230080,202102,197,168,29,184800,31900,216700
230090,202102,130,94,36,103400,39600,143000
230100,202102,2192,1247,945,1371700,1039500,2411200
230110,202102,2870,1846,1024,2031700,1126400,3158100
230120,202102,1021,801,220,881100,242000,1123100
230125,202102,153,123,30,135300,33000,168300
230130,202102,476,424,52,466400,57200,523600
230140,202102,222,185,37,203500,40700,244200
230150,202102,152,116,36,127600,39600,167200
230160,202102,945,799,146,878900,161700,1040600
230170,202102,611,548,63,602800,69300,672100
230180,202102,74,67,7,73700,7700,81400
230185,202102,406,349,57,383900,62700,446600
230190,202102,2380,1863,517,2049300.32,568700,2618000.32
230195,202102,493,427,66,469700,72600,542300
230200,202102,416,338,78,371800,85800,457600
230205,202102,391,259,132,284900,145200,430100
230210,202102,1367,1060,307,1166000.46,337700,1503700.46
230220,202102,1580,1068,512,1174800,563200,1738000
230230,202102,970,815,155,896500,170500,1067000
230240,202102,1774,1530,244,1683275,268400,1951675
230250,202102,1793,1469,324,1617000,356400,1973400
230260,202102,3243,2012,1231,2213200,1354100,3567300
230270,202102,1378,1098,280,1207800.05,308000,1515800.05
230280,202102,2747,2057,690,2262700,760100,3022800
230290,202102,399,358,41,393800.5,45100,438900.5
230300,202102,524,378,146,415800,160600,576400
230310,202102,419,318,101,349800,111100,460900
230320,202102,928,788,140,866800,155100,1021900
230330,202102,309,247,62,271700,68200,339900
230340,202102,449,361,88,397100,96800,493900
230350,202102,3193,2004,1189,2204400,1307900,3512300
230360,202102,279,223,56,245300,61600,306900
230365,202102,132,109,23,119900,25300,145200
230370,202102,10213,4956,5257,5456000.92,5786000,11242000.92
230380,202102,495,421,74,463100,81400,544500
230390,202102,548,303,245,333300,269500,602800
230393,202102,246,203,43,223300,48400,271700
230395,202102,355,284,71,312400,78100,390500
230400,202102,624,497,127,546700,139700,686400
230410,202102,2667,1661,1006,1828200.5,1106600,2934800.5
230420,202102,6334,4179,2155,4600201.75,2372700,6972901.75
230423,202102,341,297,44,326700,48400,375100
230425,202102,427,348,79,382800,86900,469700
230426,202102,118,96,22,105600,24200,129800
230427,202102,74,70,4,77000,4400,81400
230428,202102,1543,761,782,837100,860200,1697300
230430,202102,456,370,86,408100,94600,502700
230435,202102,889,642,247,706200,271700.24,977900.24
230440,202102,90010,39886,50124,43884388.58,55171601.23,99055989.81
230445,202102,311,211,100,232100,110000,342100
230450,202102,566,446,120,491700,132000,623700
230460,202102,70,52,18,57200,19800,77000
230465,202102,307,249,58,273900,63800,337700
230470,202102,2014,1586,428,1744600,471900,2216500
230480,202102,154,145,9,159500,9900,169400
230490,202102,311,244,67,268400,73700,342100
230495,202102,457,334,123,367400,135300,502700
230500,202102,1031,759,272,834900,299200,1134100
230510,202102,58,44,14,48400,15400,63800
230520,202102,386,305,81,335500.56,89100,424600.56
230523,202102,2396,1487,909,1640100.74,999900,2640000.74
230526,202102,270,231,39,254100,42900,297000
230530,202102,687,511,176,562100,193600,755700
230533,202102,212,196,16,215600,17600,233200
230535,202102,369,274,95,301400,104500,405900
230540,202102,1801,1599,202,1758900,222200,1981100
230550,202102,3853,2462,1391,2709300,1530100,4239400
230560,202102,576,433,143,476300,157300,633600
230565,202102,223,164,59,180400,64900,245300
230570,202102,289,253,36,278300,39600,317900
230580,202102,1177,852,325,938300,358600,1296900
230590,202102,997,775,222,852500,244200,1096700
230600,202102,242,221,21,243100,23100,266200
230610,202102,384,292,92,321200,101200,422400
230620,202102,207,176,31,193600,34100,227700
230625,202102,780,538,242,592900,266200,859100
230630,202102,1343,1038,305,1141800,335500,1477300
230640,202102,3829,3224,605,3546400,666600,4213000
230650,202102,459,391,68,430100,74800,504900
230655,202102,695,584,111,642400,122100,764500
230660,202102,362,298,64,327800,71500,399300
230670,202102,450,381,69,419100,75900,495000
230680,202102,202,182,20,200200,22000,222200
230690,202102,914,771,143,848100,157300,1005400
230700,202102,854,717,137,788700,150700,939400
230710,202102,694,656,38,721600,41800,763400
230720,202102,153,131,22,144100,24200,168300
230725,202102,216,167,49,183700,53900,237600
230730,202102,12327,6624,5703,7286331.32,6275500.82,13561832.14
230740,202102,680,548,132,602800,146300,749100
230750,202102,826,695,131,765600,145200,910800
230760,202102,1461,1253,208,1378300,228800,1607100
230763,202102,332,273,59,300300,64900,365200
230765,202102,7666,3506,4160,3856600.67,4576000,8432600.67
230770,202102,5028,2549,2479,2806100,2728000,5534100
230780,202102,731,643,88,708400,97900,806300
230790,202102,294,246,48,270600,52800,323400
230800,202102,1147,820,327,902000,359700,1261700
230810,202102,1360,1197,163,1316700,179300,1496000
230820,202102,364,250,114,275000,125400,400400
230830,202102,967,822,145,904200,159500,1063700
230835,202102,280,240,40,264000,44000,308000
230837,202102,171,144,27,158400,29700,188100
230840,202102,930,724,206,796400,226600,1023000
230850,202102,1479,1272,207,1401400,227700,1629100
230860,202102,303,229,74,251900,81400,333300
230870,202102,1831,1552,279,1708300,306900,2015200
230880,202102,68,52,16,57200,17600,74800
230890,202102,539,491,48,540100,52800,592900
230900,202102,279,203,76,223300,83600.7,306900.7
230910,202102,223,172,51,189200,56100,245300
230920,202102,428,341,87,375100,95700,470800
230930,202102,994,692,302,761200,332200,1093400
230940,202102,851,658,193,723800,212300,936100
230945,202102,526,425,101,467500,111100,578600
230950,202102,416,360,56,396000,61600,457600
230960,202102,2677,1788,889,1967900,979000,2946900
230970,202102,1702,940,762,1035100,838200,1873300
230980,202102,203,165,38,181500,41800,223300
230990,202102,137,111,26,122100,28600,150700
231000,202102,191,176,15,193600,16500,210100
231010,202102,154,109,45,119900,49500,169400
231020,202102,1362,940,422,1034000,464200,1498200
231025,202102,1064,780,284,858000,312400,1170400
231030,202102,1090,909,181,999900,199100,1199000
231040,202102,145,96,49,105600,53900,159500
231050,202102,941,828,113,910800,124300,1035100
231060,202102,160,134,26,147400,28600,176000
231070,202102,1490,1034,456,1138500,501600,1640100
231080,202102,264,240,24,264000,26400,290400
231085,202102,629,380,249,418000,273900,691900
231090,202102,253,202,51,222200,56100,278300
231095,202102,168,134,34,147400,37400,184800
231100,202102,152,126,26,138600,28600,167200
231110,202102,375,319,56,350900,61600,412500
231120,202102,269,230,39,253000,42900,295900
231123,202102,153,144,9,158400,9900,168300
231126,202102,334,258,76,283800,83600,367400
231130,202102,4797,3748,1049,4123900,1155000,5278900
231135,202102,213,185,28,203500,30800,234300
231140,202102,3072,2236,836,2461800,919600,3381400
231150,202102,374,351,23,386100,25300,411400
231160,202102,1206,958,248,1053800,272800,1326600
231170,202102,516,357,159,392700,174900,567600
231180,202102,1712,1470,242,1617000,266200,1883200
231190,202102,207,174,33,191400,36300,227700
231195,202102,219,181,38,200200,41800,242000
231200,202102,798,652,146,717200,160600,877800
231210,202102,585,491,94,540100,103400,643500
231220,202102,1051,766,285,842600.85,313500,1156100.85
231230,202102,1481,1162,319,1279300,350900,1630200
231240,202102,1473,1042,431,1147300,474100,1621400
231250,202102,105,97,8,106700,8800,115500
231260,202102,271,176,95,193600,104500,298100
231270,202102,1001,807,194,887700,213400,1101100
231280,202102,76,58,18,63800,19800,83600
231290,202102,7725,4327,3398,4760800,3738900.57,8499700.57
231300,202102,606,560,46,616000,50600,666600
231310,202102,739,676,63,743600.81,69300,812900.81
231320,202102,597,449,148,493900,162800,656700
231325,202102,104,89,15,97900,16500,114400
231330,202102,1981,1531,450,1684375.74,495000,2179375.74
231335,202102,253,222,31,244200,34100,278300
231340,202102,1731,1256,475,1381600,522500,1904100
231350,202102,1304,1049,255,1153900,280500,1434400
231355,202102,433,367,66,403700,72600,476300
231360,202102,517,373,144,410300.65,158400,568700.65
231370,202102,88,77,11,84700,12100,96800
231375,202102,293,211,82,232100,90200,322300
231380,202102,493,392,101,431200,111100,542300
231390,202102,212,162,50,178200,55000,233200
231395,202102,743,466,277,512600,304700,817300
231400,202102,1130,936,194,1029600,213400,1243000
231410,202102,1342,1097,245,1206700,269500,1476200
240010,202102,389,169,220,185900.97,242000,427900.97
240020,202102,2249,1823,426,2007500,468600,2476100
240030,202102,121,101,20,111100,22000,133100
240040,202102,33,33,0,36300,0,36300
240050,202102,525,446,79,490600,86900,577500
240060,202102,67,63,4,69300,4400,73700
240070,202102,226,176,50,193600,55000,248600
240080,202102,535,364,171,400400,188100.7,588500.7
240090,202102,99,88,11,96800,12100,108900
240100,202102,1499,1409,90,1549900.5,99000,1648900.5
240110,202102,1037,675,362,742500,398200,1140700
240120,202102,141,110,31,121000,34100,155100
240130,202102,276,256,20,281600,22000,303600
240140,202102,81,58,23,63800,25300,89100
240145,202102,737,651,86,717200,94600,811800
240150,202102,22,17,5,18700,5500,24200
240160,202102,42,34,8,37400,8800,46200
240165,202102,36,28,8,30800,8800,39600
240170,202102,113,78,35,85800,38500,124300
240180,202102,91,69,22,75900,24200,100100
240185,202102,44,40,4,44000,4400,48400
240190,202102,14,12,2,13200,2200,15400
240200,202102,3075,1713,1362,1885400,1498200,3383600
240210,202102,173,133,40,146300,44000,190300
240220,202102,1099,795,304,874500,334400,1208900
240230,202102,845,773,72,850300,79200,929500
240240,202102,72,52,20,57200,22000,79200
240250,202102,92,80,12,88000,13200,101200
240260,202102,1806,1327,479,1459700,526900,1986600
240270,202102,183,161,22,177100,24200,201300
240280,202102,47,36,11,39600,12100,51700
240290,202102,47,45,2,49500,2200,51700
240300,202102,178,98,80,107800,88000,195800
240310,202102,2363,1292,1071,1421200.19,1178100,2599300.19
240320,202102,189,176,13,193600,14300,207900
240325,202102,4592,2702,1890,2973301.05,2080100,5053401.05
240330,202102,73,68,5,74800,5500,80300
240340,202102,72,46,26,50600,28600,79200
240350,202102,94,81,13,89100,14300,103400
240360,202102,556,339,217,372900,238700,611600
240370,202102,54,50,4,55000,4400,59400
240375,202102,63,38,25,41800,27500,69300
240380,202102,228,186,42,204600,46200,250800
240390,202102,13,11,2,12100,2200,14300
240400,202102,81,73,8,80300,8800,89100
240410,202102,14,8,6,8800,6600,15400
240420,202102,1016,739,277,812900,304700,1117600
240430,202102,263,246,17,270600,18700,289300
240440,202102,127,72,55,79200,60500,139700
240450,202102,230,153,77,168300,84700,253000
240460,202102,72,56,16,61600,17600,79200
240470,202102,236,211,25,232100,27500,259600
240480,202102,17,15,2,16500,2200,18700
240485,202102,83,69,14,75900,15400,91300
240490,202102,45,43,2,47300,2200,49500
240500,202102,86,65,21,71500,24200,95700
240510,202102,42,31,11,34100,12100,46200
240520,202102,113,108,5,118800,5500,124300
240530,202102,55,48,7,52800,7700,60500
240540,202102,79,67,12,73700,13200,86900
240550,202102,13,12,1,13200,1100,14300
240560,202102,378,275,103,302500,113300,415800
240570,202102,442,283,159,311300,174900,486200
240580,202102,1293,1014,279,1115400,306900,1422300
240590,202102,31,29,2,31900,2200,34100
240600,202102,100,95,5,104500,5500,110000
240610,202102,514,432,82,475200,90200,565400
240615,202102,17,16,1,17600,1100,18700
240620,202102,89,86,3,94600,3300,97900
240630,202102,41,35,6,38500,6600,45100
240640,202102,26,21,5,23100,5500,28600
240650,202102,241,199,42,218900,46200,265100
240660,202102,115,98,17,107800,18700,126500
240670,202102,315,177,138,194700,151800,346500
240680,202102,50,37,13,40700,14300,55000
240690,202102,48,45,3,49500,3300,52800
240700,202102,184,150,34,165000,37400,202400
240710,202102,2040,1252,788,1377200,866800,2244000
240720,202102,1069,787,282,865700,310200,1175900
240725,202102,68,63,5,69300,5500,74800
240730,202102,151,126,25,138600,27500,166100
240740,202102,228,194,34,213400,37400,250800
240750,202102,51,28,23,30800,25300,56100
240760,202102,46,41,5,45100,5500,50600
240770,202102,146,115,31,126500,34100,160600
240780,202102,688,572,116,629200,127600,756800
240790,202102,42,40,2,44000,2200,46200
240800,202102,9332,6333,2999,6968500.85,3300000,10268500.85
240810,202102,20693,11106,9587,12221000.51,10553400,22774400.51
240820,202102,239,143,96,157300.2,105600,262900.2
240830,202102,1617,1328,289,1460800,317900,1778700
240840,202102,77,67,10,73700,11000,84700
240850,202102,85,76,9,83600,9900,93500
240860,202102,103,99,4,108900,4400,113300
240870,202102,58,50,8,55000,8800,63800
240880,202102,31,28,3,30800,3300,34100
240890,202102,1136,643,493,707300,543400,1250700
240895,202102,60,41,19,45100,20900,66000
240910,202102,161,141,20,155100,22000,177100
240920,202102,14,10,4,11000,4400,15400
240930,202102,407,365,42,401500,46200,447700
240933,202102,53,34,19,37400,20900,58300
240940,202102,2361,2091,270,2300100,297000,2597100
240950,202102,49,44,5,48400,5500,53900
240960,202102,25,21,4,24200,4400,28600
240970,202102,117,85,32,93500,35200,128700
240980,202102,197,157,40,172700,44000,216700
240990,202102,132,88,44,96800,48400,145200
241000,202102,62,58,4,63800,4400,68200
241010,202102,74,55,19,60500,20900,81400
241020,202102,113,104,9,114400,9900,124300
241025,202102,13,6,7,6600,7700,14300
241030,202102,113,89,24,97900,26400,124300
241040,202102,44,32,12,35200,13200,48400
241050,202102,81,73,8,80300,8800,89100
241060,202102,28,23,5,25300,5500,30800
241070,202102,15,15,0,16500,0,16500
241080,202102,62,55,7,60500,7700,68200
241090,202102,56,46,10,50600,11000,61600
241100,202102,72,61,11,67100,12100,79200
241105,202102,8,3,5,3300,5500,8800
241110,202102,51,46,5,50600,5500,56100
241120,202102,1489,1127,362,1239700,398200,1637900
241140,202102,223,185,38,203500,41800,245300
241142,202102,40,34,6,37400,6600,44000
241150,202102,1196,1048,148,1153900,162800,1316700
241160,202102,18,17,1,18700,1100,19800
241170,202102,46,39,7,42900,7700,50600
241180,202102,44,37,7,40700,7700,48400
241190,202102,38,36,2,39600,2200,41800
241200,202102,4009,2075,1934,2283600,2127400,4411000
241210,202102,67,58,9,63800,9900,73700
241220,202102,1436,957,479,1052700.43,526900,1579600.43
241230,202102,246,203,43,223300,47300,270600
241240,202102,55,43,12,47300,13200,60500
241250,202102,1124,1030,94,1133000,103400,1236400
241255,202102,54,42,12,46200,13200,59400
241260,202102,680,526,154,578600,169400,748000
241270,202102,63,44,19,48400,20900,69300
241280,202102,94,83,11,91300,12100,103400
241290,202102,128,88,40,96800,44000,140800
241300,202102,82,56,26,61600,28600,90200
241310,202102,53,38,15,41800,16500,58300
241320,202102,31,18,13,19800,14300,34100
241330,202102,65,56,9,61600,9900,71500
241335,202102,75,67,8,73700,8800,82500
241340,202102,185,135,50,148500,55000,203500
241350,202102,64,55,9,60500,9900,70400
241355,202102,49,42,7,46200,7700,53900
241360,202102,49,48,1,52800,1100,53900
241370,202102,56,44,12,48400,13200,61600
241380,202102,36,32,4,35200,4400,39600
241390,202102,83,62,21,69300,23100,92400
241400,202102,219,174,45,191400,49500,240900
241410,202102,181,163,18,179300,19800,199100
241415,202102,101,83,18,91300,19800,111100
241420,202102,100,77,23,84700,25300,110000
241430,202102,26,24,2,26400,2200,28600
241440,202102,539,439,100,482900,110000,592900
241445,202102,39,34,5,37400,5500,42900
241450,202102,266,218,48,239800,52800,292600
241460,202102,143,129,14,141900,15400,157300
241470,202102,36,30,6,33000,6600,39600
241475,202102,52,49,3,53900,3300,57200
241480,202102,101,71,30,78100,33000,111100
241490,202102,11,10,1,11000,1100,12100
241500,202102,46,35,11,38500,12100,50600
250010,202102,103,89,14,97900,15400,113300
250020,202102,29,26,3,28600,3300,31900
250030,202102,901,672,229,739200,251900,991100
250040,202102,378,310,68,341000,74800,415800
250050,202102,254,208,46,228800,50600,279400
250053,202102,56,42,14,46200,15400,61600
250057,202102,1,1,0,1100,0,1100
250060,202102,589,421,168,463100,185900,649000
250070,202102,704,567,137,623700.22,150700,774400.22
250073,202102,7,7,0,7700,0,7700
250077,202102,176,131,45,144100,49500,193600
250080,202102,432,341,91,375100,100100,475200
250090,202102,223,145,78,159500,85800,245300
250100,202102,519,428,91,470800,100100,570900
250110,202102,640,486,154,534600,169400,704000
250115,202102,20,7,13,7700,14300,22000
250120,202102,121,87,34,95700,37400,133100
250130,202102,572,460,112,506000,123200,629200
250135,202102,19,11,8,12100,8800,20900
250140,202102,86,77,9,84700,9900,94600
250150,202102,596,427,169,469700,185900,655600
250153,202102,12,9,3,9900,3300,13200
250157,202102,32,26,6,28600,6600,35200
250160,202102,229,181,48,200200,52800,253000
250170,202102,65,42,23,46200,25300,71500
250180,202102,4387,2963,1424,3259300,1567500,4826800
250190,202102,840,551,289,606100,317900,924000
250200,202102,49,40,9,44000,9900,53900
250205,202102,23,20,3,22000,3300,25300
250210,202102,86,75,11,82500,12100,94600
250215,202102,67,53,14,58300,15400,73700
250220,202102,25,18,7,19800,7700,27500
250230,202102,77,69,8,75900,8800,84700
250240,202102,237,190,47,209000,51700,260700
250250,202102,391,333,58,366300,63800,430100
250260,202102,45,38,7,41800,7700,49500
250270,202102,75,54,21,59400,23100,82500
250280,202102,382,311,71,342100,78100,420200
250290,202102,92,84,8,92400,8800,101200
250300,202102,551,372,179,409200,196900,606100
250310,202102,49,41,8,45100,8800,53900
250320,202102,1955,1304,651,1434400,717200,2151600
250330,202102,100,84,16,92400,17600,110000
250340,202102,26,24,2,26400,2200,28600
250350,202102,179,115,64,126500,70400,196900
250355,202102,31,24,7,26400,7700,34100
250360,202102,194,160,34,176000,37400,213400
250370,202102,2403,1563,840,1719300,924000,2643300
250375,202102,12,7,5,7700,5500,13200
250380,202102,53,42,11,46200,12100,58300
250390,202102,46,35,11,38500,12100,50600
250400,202102,16470,8287,8183,9121181.46,9005700,18126881.46
250403,202102,325,261,64,287100,70400,357500
250407,202102,63,51,12,56100,13200,69300
250410,202102,29,25,4,27500,4400,31900
250415,202102,42,29,13,31900,14300,46200
250420,202102,43,37,6,40700,6600,47300
250430,202102,1450,1249,201,1374175,221100,1595275
250435,202102,19,14,5,15400,5500,20900
250440,202102,677,563,114,619300,125400,744700
250450,202102,85,65,20,71500,22000,93500
250460,202102,471,306,165,336600,181500,518100
250470,202102,93,64,29,70400,31900,102300
250480,202102,329,263,66,289300,73700,363000
250485,202102,2,2,0,2200,0,2200
250490,202102,233,188,45,206800,49500,256300
250500,202102,97,71,26,78100,28600,106700
250510,202102,786,623,163,685300,179300,864600
250520,202102,178,120,58,132000,63800,195800
250523,202102,121,96,25,105600,27500,133100
250527,202102,106,82,24,90200,26400,116600
250530,202102,9,6,3,6600,3300,9900
250535,202102,32,23,9,25300,9900,35200
250540,202102,134,104,30,114400,33000,147400
250550,202102,72,69,3,75900,3300,79200
250560,202102,50,35,15,38500,16500,55000
250570,202102,164,136,28,149600,30800,180400
250580,202102,107,83,24,91371,26400,117771
250590,202102,24,14,10,15400,11000,26400
250600,202102,1441,942,499,1036200.7,548900,1585100.7
250610,202102,162,133,29,146300,31900,178200
250620,202102,20,16,4,17600,4400,22000
250625,202102,73,55,18,60500,19800,80300
250630,202102,3091,1975,1116,2172500.62,1228700,3401200.62
250640,202102,222,177,45,194700,49500,244200
250650,202102,30,20,10,22000,11000,33000
250660,202102,52,40,12,44000,13200,57200
250670,202102,64,47,17,51700,18700,70400
250680,202102,412,330,82,364100,90200,454300
250690,202102,2095,1443,652,1587300.7,718300,2305600.7
250700,202102,931,805,126,885500,138600,1024100
250710,202102,439,342,97,376200,106700,482900
250720,202102,116,83,33,91300,36300,127600
250730,202102,389,323,66,355300,72600,427900
250740,202102,55,51,4,56100,4400,60500
250750,202102,22541,13464,9077,14812481.41,9988000,24800481.41
250760,202102,106,82,24,90200,26400,116600
250770,202102,363,239,124,262900,136400,399300
250780,202102,69,45,24,49500,26400,75900
250790,202102,463,303,160,333300,176000,509300
250800,202102,156,141,15,155100,16500,171600
250810,202102,75,60,15,67100,16500,83600
250820,202102,150,125,25,137500,27500,165000
250830,202102,433,289,144,317900,158400,476300
250840,202102,55,49,6,53900,6600,60500
250850,202102,56,46,10,50600,11000,61600
250855,202102,15,13,2,14300,2200,16500
250860,202102,226,152,74,167200,81400,248600
250870,202102,29,24,5,26400,5500,31900
250880,202102,87,63,24,69300,26400,95700
250890,202102,2876,2140,736,2354000,810700,3164700
250900,202102,52,43,9,47300,9900,57200
250905,202102,122,91,31,100100,34100,134200
250910,202102,1106,807,299,887700,328900,1216600
250915,202102,101,72,29,79200,31900,111100
250920,202102,138,100,38,110000,41800,151800
250930,202102,177,102,75,113300,82500,195800
250933,202102,6,4,2,4400,2200,6600
250937,202102,10,10,0,11000,0,11000
250939,202102,30,22,8,24200,8800,33000
250940,202102,106,77,29,84700,31900,116600
250950,202102,73,49,24,53900,26400,80300
250960,202102,91,51,40,56100,44000,100100
250970,202102,1213,856,357,941600,392700,1334300
250980,202102,103,67,36,73700,39600,113300
250990,202102,166,128,38,140800,41800,182600
251000,202102,74,67,7,73700,7700,81400
251010,202102,115,86,29,94600,31900,126500
251020,202102,75,61,14,67100,15400,82500
251030,202102,48,36,12,39600,13200,52800
251040,202102,56,38,18,41800,19800,61600
251050,202102,25,21,4,23100,4400,27500
251060,202102,51,41,10,45100,11000,56100
251065,202102,4,3,1,3300,1100,4400
251070,202102,20,16,4,17600,4400,22000
251080,202102,5076,2413,2663,2654300,2930400.1,5584700.1
251090,202102,180,154,26,169400,28600,198000
251100,202102,18,18,0,19800,1100,20900
251110,202102,47,37,10,40700,11000,51700
251120,202102,1867,1141,726,1255100,799700,2054800
251130,202102,413,336,77,369600,84700,454300
251140,202102,562,362,200,398200,220000,618200
251150,202102,342,289,53,317900,58300,376200
251160,202102,91,75,16,82500,17600,100100
251170,202102,102,82,20,90200,22000,112200
251180,202102,286,174,112,191400,123200,314600
251190,202102,206,133,73,146300,80300,226600
251200,202102,268,216,52,237600,57200,294800
251203,202102,33,31,2,34100,2200,36300
251207,202102,85,70,15,77000,17600,94600
251210,202102,1469,1070,399,1177000,438900,1615900
251220,202102,49,38,11,41800,12100,53900
251230,202102,592,492,100,541200,110000,651200
251240,202102,99,70,29,77000,31900,108900
251250,202102,1430,1029,401,1131900,441100,1573000
251260,202102,12,7,5,7700,5500,13200
251270,202102,323,250,73,275000,80300,355300
251272,202102,63,56,7,61600,7700,69300
251274,202102,29,22,7,24200,7700,31900
251275,202102,34,19,15,20900,16500,37400
251276,202102,17,13,4,14300,4400,18700
251278,202102,9,7,2,7700,2200,9900
251280,202102,103,97,6,106700,6600,113300
251290,202102,851,601,250,661100,275000,936100
251300,202102,15,12,3,13200,3300,16500
251310,202102,292,214,78,235400,85800,321200
251315,202102,33,29,4,31900,4400,36300
251320,202102,63,48,15,52800,16500,69300
251330,202102,77,68,9,74800,9900,84700
251335,202102,15,10,5,11000,5500,16500
251340,202102,751,444,307,488400,337700,826100
251350,202102,34,33,1,36300,1100,37400
251360,202102,82,72,10,79200,11000,90200
251365,202102,11,11,0,12100,0,12100
251370,202102,5572,3732,1840,4105200.32,2025100,6130300.32
251380,202102,44,35,9,38500,9900,48400
251385,202102,1,1,0,1100,0,1100
251390,202102,830,618,212,679800,233200,913000
251392,202102,18,10,8,11000,8800,19800
251394,202102,9,9,0,9900,0,9900
251396,202102,12,8,4,8800,4400,13200
251398,202102,17,15,2,16500,2200,18700
251400,202102,42,34,8,37400,8800,46200
251410,202102,39,33,6,36300,6600,42900
251420,202102,102,73,29,80300,31900,112200
251430,202102,45,41,4,45100,4400,49500
251440,202102,44,26,18,28600,19800,48400
251445,202102,51,45,6,49500,6600,56100
251450,202102,411,357,54,392700,59400,452100
251455,202102,3,2,1,2200,1100,3300
251460,202102,17,15,2,16500,2200,18700
251465,202102,7,4,3,4400,3300,7700
251470,202102,50,39,11,42900,12100,55000
251480,202102,27,22,5,24200,5500,29700
251490,202102,123,79,44,86900,48400,135300
251500,202102,129,104,25,114400,27500,141900
251510,202102,65,42,23,46200,25300,71500
251520,202102,30,29,1,31900,1100,33000
251530,202102,4513,3185,1328,3503500,1460800,4964300
251540,202102,76,64,12,70400,13200,83600
251550,202102,411,311,100,342100,110000,452100
251560,202102,24,16,8,17600,8800,26400
251570,202102,20,17,3,18700,3300,22000
251580,202102,135,105,30,115500,33000,148500
251590,202102,116,84,32,92607.9,35200,127807.9
251593,202102,24,14,10,15400,11000,26400
251597,202102,99,80,19,88000,20900,108900
251600,202102,1110,780,330,858000,363000,1221000
251610,202102,242,180,62,199100,68200,267300
251615,202102,11,10,1,11000,1100,12100
251620,202102,4236,2753,1483,3029400,1631300,4660700
251630,202102,466,344,122,378400,134200,512600
251640,202102,140,100,40,110000,44000,154000
251650,202102,280,202,78,222200,85800,308000
251660,202102,188,168,20,184800,22000,206800
251670,202102,377,292,85,321200,93500,414700
251675,202102,8,6,2,6600,2200,8800
251680,202102,100,88,12,96800,13200,110000
251690,202102,321,265,56,291500,61600,353100
251700,202102,289,250,39,275000,42900,317900
251710,202102,22,14,8,15400,8800,24200
251720,202102,23,15,8,16500,8800,25300
251740,202102,12,8,4,8800,4400,13200
260005,202102,3330,1792,1538,1971832.93,1691800,3663632.93
260010,202102,1641,1184,457,1303500.58,503800,1807300.58
260020,202102,416,360,56,396000,61600,457600
260030,202102,595,410,185,451000,203500,654500
260040,202102,803,501,302,552200,332200,884400
260050,202102,1163,830,333,914100,366300,1280400
260060,202102,380,346,34,380600,37400,418000
260070,202102,1340,824,516,907500,567600,1475100
260080,202102,724,556,168,611600,184800,796400
260090,202102,494,325,169,357500,185900,543400
260100,202102,219,153,66,168300,72600,240900
260105,202102,245,134,111,147400,122100,269500
260110,202102,2865,2092,773,2303400,850300,3153700
260120,202102,2867,1449,1418,1595293,1560900,3156193
260130,202102,171,117,54,128700,59400,188100
260140,202102,2110,1365,745,1501500.48,820600,2322100.48
260150,202102,205,130,75,143000,82500,225500
260160,202102,319,266,53,292600,58300,350900
260170,202102,3345,1987,1358,2185700,1494900,3680600
260180,202102,160,126,34,138600,37400,176000
260190,202102,2340,1571,769,1728100,847000,2575100
260200,202102,969,774,195,851400.63,214500,1065900.63
260210,202102,1416,1000,416,1100000,457600,1557600
260220,202102,678,611,67,672100,73700,745800
260230,202102,1222,912,310,1003200,341000,1344200
260240,202102,213,160,53,176000,58300,234300
260250,202102,91,66,25,72600,27500,100100
260260,202102,1037,726,311,798600,342100,1140700
260270,202102,403,317,86,348700,94600,443300
260280,202102,1224,912,312,1003200,343200,1346400
260290,202102,6548,3521,3027,3874200.21,3330800.59,7205000.80
260300,202102,949,812,137,893200,150700,1043900
260310,202102,517,413,104,454300,114400,568700
260320,202102,855,623,232,685300,255200,940500
260330,202102,66,45,21,49500,23100,72600
260340,202102,76,56,20,61600,22000,83600
260345,202102,5500,2962,2538,3258200.4,2791800,6050000.4
260350,202102,483,342,141,376200,155100,531300
260360,202102,238,132,106,145200,116600,261800
260370,202102,767,481,286,529100,314600,843700
260380,202102,587,430,157,473000,172700.6,645700.6
260390,202102,287,240,47,264000,51700,315700
260392,202102,107,92,15,101200,16500,117700
260400,202102,4240,2410,1830,2651000.5,2014100,4665100.5
260410,202102,14720,7681,7039,8449101.03,7746200.5,16195301.53
260415,202102,141,123,18,135300,19800,155100
260420,202102,1725,1045,680,1149500.5,748000,1897500.5
260430,202102,181,167,14,183700.48,15400,199100.48
260440,202102,195,139,56,152900,61600,214500
260450,202102,429,315,114,346501.13,125400,471901.13
260460,202102,818,427,391,469700,430100,899800
260470,202102,341,210,131,231000,144100,375100
260480,202102,241,156,85,171600,93500,265100
260490,202102,209,173,36,190300,39600,229900
260500,202102,1121,758,363,833800,399300,1233100
260510,202102,778,618,160,679800,176000,855800
260515,202102,235,213,22,234300,24200,258500
260520,202102,3264,2014,1250,2215400.53,1375000,3590400.53
260530,202102,793,648,145,713900,159500,873400
260540,202102,542,427,115,469700,126500,596200
260545,202102,16,11,5,12100,5500,17600
260550,202102,324,201,123,221100,135300,356400
260560,202102,509,384,125,422400,138600,561000
260570,202102,971,783,188,861300,206800,1068100
260580,202102,249,217,32,238700,35200,273900
260590,202102,634,365,269,402600,295900,698500
260600,202102,8068,4355,3713,4792701.78,4084300,8877001.78
260610,202102,491,325,166,357500,182600,540100
260620,202102,3654,1877,1777,2065800,1955800.19,4021600.19
260630,202102,80,75,5,82500,5500,88000
260640,202102,3451,1919,1532,2110900,1685200,3796100
260650,202102,328,236,92,259600,101200,360800
260660,202102,556,353,203,388300,223300,611600
260670,202102,104,75,29,82500,31900,114400
260680,202102,3788,2071,1717,2280300,1888700,4169000
260690,202102,122,91,31,100100,34100,134200
260700,202102,310,207,103,227700,113300,341000
260710,202102,45,36,9,39600,9900,49500
260720,202102,2483,1446,1037,1590600,1140700,2731300
260730,202102,705,526,179,578600,196900,775500
260740,202102,66,59,7,64900,7700,72600
260750,202102,591,421,170,463100,187000,650100
260760,202102,672,338,334,371800.3,367400,739200.3
260765,202102,984,512,472,563200,520300,1083500
260770,202102,224,163,61,179281,67100,246381
260775,202102,773,431,342,474100,376200,850300
260780,202102,243,149,94,163900,103400,267300
260790,202102,14337,7245,7092,7970600,7808900,15779500
260795,202102,168,109,59,119900,64900,184800
260800,202102,293,240,53,264000,58300,322300
260805,202102,177,117,60,129800,66000,195800
260810,202102,762,648,114,712800,125400,838200
260820,202102,285,180,105,198000,115500,313500
260825,202102,215,144,71,158400,78100,236500
260830,202102,309,180,129,198000,141900,339900
260840,202102,240,176,64,193600,70400,264000
260845,202102,166,112,54,123200,59400,182600
260850,202102,430,315,115,346500,126500,473000
260860,202102,252,191,61,210100,67100,277200
260870,202102,365,276,89,303600.2,97900,401500.2
260875,202102,731,519,212,570900,234300,805200
260880,202102,1599,1013,586,1114556.66,644600,1759156.66
260890,202102,2354,1654,700,1819400,770000,2589400
260900,202102,988,699,289,768900,319000,1087900
260910,202102,252,199,53,218900,58300,277200
260915,202102,288,213,75,234300,82500,316800
260920,202102,187,99,88,108900,96800,205700
260930,202102,393,333,60,366300,66000,432300
260940,202102,2664,1434,1230,1578500,1354100,2932600
260950,202102,2009,1143,866,1257300,952600,2209900
260960,202102,13681,6843,6838,7530600.9,7527300.5,15057901.4
260970,202102,415,345,70,379500,77000,456500
260980,202102,190,170,20,188100,22000,210100
260990,202102,2630,2122,508,2335300,558800,2894100
261000,202102,4224,2537,1687,2791800,1855700,4647500
261010,202102,193,116,77,127600,84700,212300
261020,202102,598,447,151,491700.47,166100,657800.47
261030,202102,265,178,87,195800,95700,291500
261040,202102,371,323,48,355300,52800,408100
261050,202102,506,435,71,478500,78100,556600
261060,202102,1384,870,514,957000,565400,1522400
261070,202102,8897,4302,4595,4735500,5057800.5,9793300.5
261080,202102,373,285,88,313500,96800,410300
261090,202102,2174,1656,518,1821602.03,569800.3,2391402.33
261100,202102,1168,816,352,897600,387200,1284800
261110,202102,8776,5354,3422,5889400,3765300,9654700
261120,202102,259,221,38,243100,41800,284900
261130,202102,575,345,230,379500,253000,632500
261140,202102,203,126,77,138600,84700,223300
261150,202102,692,430,262,473000.56,288200,761200.56
261153,202102,70,64,6,70400,6600,77000
261160,202102,74637,36692,37945,40378892.81,41757395.14,82136287.95
261170,202102,466,346,120,380600,132000,512600
261180,202102,1778,1103,675,1213300,743600,1956900
261190,202102,625,441,184,485100,202400,687500
261200,202102,220,182,38,200200,41800,242000
261210,202102,32,28,4,30800,4400,35200
261220,202102,2728,1914,814,2105400.66,895400,3000800.66
261230,202102,335,247,88,271700,96800,368500
261240,202102,450,393,57,432300,62700,495000
261245,202102,238,195,43,214500,47300,261800
261247,202102,169,132,37,145200,40700,185900
261250,202102,3214,1558,1656,1713800,1821600,3535400
261255,202102,245,221,24,243100,26400,269500
261260,202102,843,730,113,803000.12,124300,927300.12
261270,202102,201,143,58,157300,63800,221100
261280,202102,176,143,33,157300,36300,193600
261290,202102,112,81,31,89100,34100,123200
261300,202102,1295,949,346,1045000,380600,1425600
261310,202102,797,532,265,585200,291500,876700
261320,202102,589,371,218,408100.22,239800,647900.22
261330,202102,953,731,222,805200,244200.63,1049400.63
261340,202102,297,167,130,183700,143000,326700
261350,202102,850,596,254,655600,279400,935000
261360,202102,1288,834,454,917400,499400,1416800
261370,202102,4833,2870,1963,3157000,2159300,5316300
261380,202102,548,418,130,459800.78,143000,602800.78
261390,202102,3587,2404,1183,2645500,1301300,3946800
261400,202102,291,262,29,288200,31900,320100
261410,202102,1113,728,385,800800,423500,1224300
261420,202102,892,549,343,603900.32,377300,981200.32
261430,202102,325,294,31,323400,34100,357500
261440,202102,115,106,9,116600,9900,126500
261450,202102,2531,2014,517,2215400,568700,2784100
261460,202102,726,573,153,630300,168300,798600
261470,202102,239,190,49,210100,53900,264000
261480,202102,449,349,100,383900,109950.5,493850.5
261485,202102,360,214,146,235400,160600,396000
261500,202102,612,414,198,455400.59,218900,674300.59
261510,202102,54,35,19,38500,20900,59400
261520,202102,96,83,13,91300,14300,105600
261530,202102,4129,2619,1510,2880900.09,1662100,4543000.09
261540,202102,1353,795,558,874500,613800,1488300
261550,202102,247,116,131,127600,144100,271700
261560,202102,858,561,297,617100,326700,943800
261570,202102,399,314,85,345400,93500,438900
261580,202102,380,296,84,325600,92400,418000
261590,202102,189,151,38,166100,41800,207900
261600,202102,290,232,58,255200,63800,319000
261610,202102,84,72,12,79200,13200,92400
261618,202102,73,58,15,63800,16500,80300
261620,202102,197,122,75,134200,82500,216700
261630,202102,543,425,118,467500,129800,597300
261640,202102,6436,3362,3074,3698201.05,3381400,7079601.05
261650,202102,486,308,178,339900,195800,535700
270010,202102,514,454,60,499400,66000,565400
270020,202102,281,230,51,253000,56100,309100
270030,202102,8802,5658,3144,6227138.22,3459500,9686638.22
270040,202102,2040,1297,743,1426700,818400,2245100
270050,202102,163,127,36,139700,39600,179300
270060,202102,110,60,50,66000,55000,121000
270070,202102,859,626,233,688600,256300,944900
270080,202102,37,31,6,34100,6600,40700
270090,202102,23,17,6,18700,6600,25300
270100,202102,1247,839,408,925100,448800,1373900
270110,202102,102,84,18,92400,19800,112200
270120,202102,228,185,43,203500,47300,250800
270130,202102,291,208,83,228800,91300,320100
270135,202102,114,72,42,79200,46200,125400
270140,202102,1369,876,493,963600,542300,1505900
270150,202102,265,201,64,221100,70400,291500
270160,202102,495,392,103,431200,113300,544500
270170,202102,806,521,285,573100,313500,886600
270180,202102,56,43,13,47300,14300,61600
270190,202102,88,76,12,83600,13200,96800
270200,202102,108,94,14,103400,15400,118800
270210,202102,523,298,225,327800,247500,575300
270220,202102,179,140,39,154000,42900,196900
270230,202102,2121,1293,828,1422960,911900,2334860
270235,202102,683,532,151,585200,166100,751300
270240,202102,2974,2355,619,2591600.93,680900,3272500.93
270250,202102,157,115,42,126500,46200,172700
270255,202102,220,191,29,210100,31900,242000
270260,202102,367,299,68,329633.33,74800,404433.33
270270,202102,101,47,54,51700,59400,111100
270280,202102,231,132,99,145200,108900,254100
270290,202102,1154,886,268,975700,294800,1270500
270300,202102,321,227,94,250800,103400,354200
270310,202102,845,700,145,770000,159500,929500
270320,202102,828,707,121,777700.63,133100,910800.63
270330,202102,297,248,49,272800,53900,326700
270340,202102,56,43,13,47300,14300,61600
270350,202102,91,53,38,58300,41800,100100
270360,202102,70,40,30,44000,33000,77000
270370,202102,58,47,11,51700,12100,63800
270375,202102,73,44,29,48400,31900,80300
270380,202102,1018,655,363,720500,399300,1119800
270390,202102,185,112,73,123200,80300,203500
270400,202102,716,537,179,591800.2,196900,788700.2
270410,202102,656,479,177,526900,194700,721600
270420,202102,400,273,127,300300,139700,440000
270430,202102,33039,23722,9317,26114258.46,10254200,36368458.46
270440,202102,475,376,99,413600,108900,522500
270450,202102,799,455,344,501013.33,378400,879413.33
270460,202102,183,146,37,160600,40700,201300
270470,202102,1493,1035,458,1139600,503800,1643400
270480,202102,540,444,96,488400,105600,594000
270490,202102,22,17,5,18700,5500,24200
270500,202102,493,413,80,454300,88000,542300
270510,202102,818,510,308,561000,338800,899800
270520,202102,287,183,104,202400,114400,316800
270530,202102,65,58,7,63800,7700,71500
270540,202102,99,76,23,83600,25300,108900
270550,202102,1736,1331,405,1465200.6,445500,1910700.6
270560,202102,265,148,117,162800,128700,291500
270570,202102,526,370,156,407000,171600,578600
270580,202102,87,69,18,75900,19800,95700
270590,202102,65,52,13,57200,14300,71500
270600,202102,174,146,28,160600,30800,191400
270610,202102,256,175,81,192500,89100,281600
270620,202102,17,17,0,18700,0,18700
270630,202102,3726,2832,894,3116300,983400,4099700
270640,202102,868,643,225,707300,247500,954800
270642,202102,209,177,32,194700,35200,229900
270644,202102,256,165,91,181500,100100,281600
270650,202102,330,197,133,216700,146300,363000
270660,202102,239,202,37,222200,40700,262900
270670,202102,3039,2308,731,2538801.01,804100,3342901.01
270680,202102,422,252,170,277200,187000,464200
270690,202102,1180,777,403,855176.66,444400,1299576.66
270700,202102,27,22,5,24200,5500,29700
270710,202102,867,683,184,751300,202400,953700
270720,202102,237,185,52,203500,57200,260700
270730,202102,1852,1121,731,1233833.33,804100,2037933.33
270740,202102,43,30,13,33000,14300,47300
270750,202102,648,488,160,536800,176000,712800
270760,202102,290,209,81,229900,89100,319000
270770,202102,2745,1824,921,2006400,1014200,3020600
270780,202102,72,47,25,51700,27500,79200
270790,202102,265,172,93,189200,102300,291500
270800,202102,2085,1619,466,1782000,512600,2294600
270810,202102,227,186,41,205553.33,45100,250653.33
270820,202102,139,96,43,105600,47300,152900
270830,202102,778,582,196,640200,215600,855800
270840,202102,1368,1038,330,1141800.04,363000,1504800.04
270850,202102,1496,941,555,1035100,610500,1645600
270860,202102,2570,1706,864,1877151.35,950400,2827551.35
270870,202102,116,65,51,71500,56100,127600
270880,202102,887,698,189,767800,207900,975700
270890,202102,287,215,72,236500,79200,315700
270895,202102,50,46,4,50600,4400,55000
270900,202102,85,66,19,72600,20900,93500
270910,202102,304,248,56,272800,61600,334400
270915,202102,1889,1213,676,1335436.66,743600,2079036.66
270920,202102,463,386,77,424600,84700,509300
270930,202102,5908,4435,1473,4878500,1620300.14,6498800.14
270940,202102,2242,1757,485,1933286.66,533500,2466786.66
280010,202102,37,31,6,34100,6600,40700
280020,202102,482,411,71,452100,78100,530200
280030,202102,20634,13322,7312,14657501.98,8044301.82,22701803.80
280040,202102,332,216,116,237600,127600,365200
280050,202102,405,312,93,343200,102300,445500
280060,202102,340,218,122,239800,134200,374000
280067,202102,1084,784,300,864600,330000.5,1194600.5
280070,202102,125,101,24,111100,26400,137500
280100,202102,644,498,146,547800,160600,708400
280110,202102,72,67,5,73700,5500,79200
280120,202102,659,538,121,591800,133100,724900
280130,202102,1751,1150,601,1265000,661100,1926100
280140,202102,488,402,86,442200,94600,536800
280150,202102,401,281,120,309100,132000,441100
280160,202102,120,98,22,107800,24200,132000
280170,202102,405,283,122,311300,134200,445500
280190,202102,25,22,3,24200,3300,27500
280200,202102,31,26,5,28600,5500,34100
280210,202102,2946,2115,831,2327469.6,915200,3242669.6
280220,202102,39,32,7,35200,7700,42900
280230,202102,330,270,60,297000,66000,363000
280240,202102,124,118,6,129800,6600,136400
280250,202102,19,10,9,11000,9900,20900
280260,202102,77,70,7,77000,7700,84700
280270,202102,150,117,33,128700,36300,165000
280280,202102,196,127,69,139700.5,75900,215600.5
280290,202102,3382,2434,948,2677329.5,1043900,3721229.5
280300,202102,1598,1249,349,1373900,383900,1757800
280310,202102,98,93,5,102300,5500,107800
280320,202102,647,455,192,500500,211200,711700
280330,202102,323,235,88,258500,96800,355300
280340,202102,407,330,77,363000,84700,447700
280350,202102,3691,2863,828,3149300.66,910800.08,4060100.74
280360,202102,481,328,153,360800,168300,529100
280370,202102,95,83,12,91300,13200,104500
280380,202102,53,41,12,45100,13200,58300
280390,202102,175,150,25,165000,27500,192500
280400,202102,354,243,111,267300,122100,389400
280410,202102,287,237,50,260700,55000,315700
280420,202102,172,145,27,159500,29700,189200
280430,202102,55,43,12,47300,13200,60500
280440,202102,693,544,149,598400,163900,762300
280445,202102,119,108,11,118800,12100,130900
280450,202102,1202,1038,164,1141800,180400,1322200
280460,202102,619,452,167,497200.93,183700,680900.93
280470,202102,182,170,12,187000,13200,200200
280480,202102,2716,1890,826,2079001.67,908600.5,2987602.17
280490,202102,254,240,14,264000.96,15400,279400.96
280500,202102,44,40,4,44000,4400,48400
280510,202102,141,113,28,124300,30800,155100
280520,202102,53,38,15,41800,16500,58300
280530,202102,81,51,30,56100,33000,89100
280540,202102,533,449,84,493900,92400,586300
280550,202102,732,674,58,741400.65,63800,805200.65
280560,202102,494,438,56,481800,61600,543400
280570,202102,2222,1740,482,1914000,530200,2444200
280580,202102,589,456,133,501600,146300,647900
280590,202102,212,135,77,148500,84700,233200
280600,202102,383,321,62,353100,68200,421300
280610,202102,111,83,28,91300,30800,122100
280620,202102,548,447,101,492800,111100,603900
280630,202102,157,128,29,140800,31900,172700
280640,202102,193,151,42,166100,46200,212300
280650,202102,93,58,35,63800,38500,102300
280660,202102,142,104,38,114400,41800,156200
280670,202102,1868,1168,700,1284800.85,770000.48,2054801.33
280680,202102,199,175,24,192500,26400,218900
280690,202102,80,71,9,78100,9900,88000
280700,202102,22,22,0,24200,0,24200
280710,202102,1475,1137,338,1250700,371800,1622500
280720,202102,114,74,40,81400,44000,125400
280730,202102,28,23,5,25300,5500,30800
280740,202102,2518,1877,641,2064700,705100,2769800
280750,202102,236,207,29,227700,31900,259600
280760,202102,788,548,240,602800.57,264000,866800.57
290010,202102,202,141,61,155100,67100,222200
290020,202102,188,169,19,185900,20900,206800
290030,202102,614,396,218,435600,239800,675400
290035,202102,133,108,25,118800,27500,146300
290040,202102,299,202,97,222200,106700,328900
290050,202102,82,64,18,70400,19800,90200
290060,202102,259,115,144,126500,158400,284900
290070,202102,5693,2731,2962,3006300.69,3261500,6267800.69
290080,202102,450,203,247,223300,271700,495000
290090,202102,376,167,209,183700,229900,413600
290100,202102,1634,1058,576,1163800,634700,1798500
290110,202102,831,482,349,530200.85,383900,914100.85
290115,202102,195,181,14,199100,15400,214500
290120,202102,775,511,264,562100,290400,852500
290130,202102,430,266,164,292600,180400,473000
290135,202102,303,233,70,256300,77000,333300
290140,202102,316,260,56,286000,61600,347600
290150,202102,138,97,41,106700,45100,151800
290160,202102,242,186,56,204600,61600,266200
290170,202102,90,64,26,70400,28600,99000
290180,202102,181,131,50,144100,55000,199100
290190,202102,440,358,82,394900,90200,485100
290195,202102,312,202,110,222200,121000,343200
290200,202102,273,223,50,245300,55000,300300
290205,202102,150,93,57,102300,62700,165000
290210,202102,1169,864,305,950400,335500,1285900
290220,202102,217,119,98,130900,107800,238700
290225,202102,288,119,169,130900,185900,316800
290230,202102,80,50,30,55000,33000,88000
290240,202102,361,129,232,143000,255200,398200
290250,202102,254,234,20,257400,22000,279400
290260,202102,321,264,57,290400,62700,353100
290265,202102,192,164,28,180400,30800,211200
290270,202102,1411,1179,232,1298000,256300,1554300
290280,202102,475,335,140,368500,154000,522500
290290,202102,1327,793,534,872300.94,587400,1459700.94
290300,202102,426,365,61,401500,68200,469700
290310,202102,294,138,156,151800,171600,323400
290320,202102,4038,2497,1541,2747800.11,1696200,4444000.11
290323,202102,189,164,25,180400,27500,207900
290327,202102,169,133,36,146300,39600,185900
290330,202102,113,58,55,63800,60500,124300
290340,202102,809,329,480,361900,528000,889900
290350,202102,635,378,257,416900,282700,699600
290360,202102,348,268,80,294800.99,88000,382800.99
290370,202102,913,386,527,425700,579700,1005400
290380,202102,323,205,118,225500,129800,355300
290390,202102,2435,1521,914,1674200,1005400,2679600
290395,202102,243,138,105,151800,115500,267300
290400,202102,278,205,73,225500,80300,305800
290405,202102,245,210,35,231000,38500,269500
290410,202102,621,519,102,570900.3,112200,683100.3
290420,202102,254,205,49,225500,53900,279400
290430,202102,477,311,166,342100,183700,525800
290440,202102,76,67,9,73700,9900,83600
290450,202102,196,147,49,161700,53900,215600
290460,202102,1947,1162,785,1278200.39,863500,2141700.39
290470,202102,1369,603,766,663300,844800,1508100
290475,202102,559,524,35,576400.27,38500,614900.27
290480,202102,289,165,124,181500,136400,317900
290485,202102,241,218,23,239800,25300,265100
290490,202102,1227,877,350,964700,387200,1351900
290500,202102,738,378,360,415800,396000,811800
290510,202102,227,179,48,196900,52800,249700
290515,202102,160,97,63,106700,70400,177100
290520,202102,1395,912,483,1003200,532400.2,1535600.2
290530,202102,302,278,24,305800,26400,332200
290540,202102,106,54,52,59400,57200,116600
290550,202102,161,136,25,149600,27500,177100
290560,202102,3146,1368,1778,1505900,1956900,3462800
290570,202102,6227,2994,3233,3294500,3559600,6854100
290580,202102,1266,751,515,826100,566500,1392600
290590,202102,568,467,101,513700,111100,624800
290600,202102,1756,1205,551,1325500.67,606100,1931600.67
290610,202102,201,181,20,199100,22000,221100
290620,202102,353,320,33,352000,36300,388300
290630,202102,1996,847,1149,931700,1263900,2195600
290640,202102,145,116,29,127600,31900,159500
290650,202102,1780,828,952,910800.92,1047200,1958000.92
290660,202102,279,226,53,249700,58300,308000
290670,202102,929,480,449,528000,495000,1023000
290680,202102,1231,993,238,1092300,261800,1354100
290682,202102,305,228,77,250800.48,84700,335500.48
290685,202102,241,158,83,173800,91300,265100
290687,202102,1052,677,375,744879,412500,1157379
290689,202102,144,76,68,83600,74800,158400
290690,202102,613,262,351,288200,386100,674300
290700,202102,241,119,122,132000,134200,266200
290710,202102,758,516,242,567600,266200,833800
290720,202102,1023,828,195,911900,214500,1126400
290730,202102,1177,674,503,741400,553300,1294700
290740,202102,19,16,3,17600,3300,20900
290750,202102,1393,620,773,682000,851400,1533400
290755,202102,72,65,7,71500,7700,79200
290760,202102,292,252,40,277200,44000,321200
290770,202102,188,176,12,193600,13200,206800
290780,202102,1115,861,254,947100,279400,1226500
290790,202102,368,255,113,280500,124300,404800
290800,202102,2450,997,1453,1096700,1599400,2696100
290810,202102,465,320,145,352000,159500,511500
290820,202102,400,231,169,254100,185900,440000
290830,202102,426,304,122,334400,134200,468600
290840,202102,1766,1098,668,1208900,734800,1943700
290850,202102,847,437,410,481800,451000,932800
290860,202102,644,288,356,317900,391600,709500
290870,202102,624,445,179,489500,196900,686400
290880,202102,121,65,56,71500,61600,133100
290890,202102,411,265,146,291500,160600,452100
290900,202102,169,128,41,140800,45100,185900
290910,202102,379,286,93,314600,102300,416900
290920,202102,208,181,27,199100,29700,228800
290930,202102,817,620,197,682000,216700,898700
290940,202102,244,205,39,225500,42900,268400
290950,202102,159,96,63,105600,69300,174900
290960,202102,476,336,140,369600,154000,523600
290970,202102,247,216,31,237600,34100,271700
290980,202102,1617,1128,489,1241900,537900,1779800
290990,202102,398,337,61,371800,67100,438900
291000,202102,870,267,603,293700,663300,957000
291005,202102,2332,1010,1322,1111000,1454200.42,2565200.42
291010,202102,163,148,15,162800,16500,179300
291020,202102,101,81,20,89100,22000,111100
291030,202102,98,70,28,77000,30800,107800
291040,202102,614,347,267,381700,293700,675400
291050,202102,1442,789,653,867900,718300,1586200
291060,202102,1558,847,711,932800,782100,1714900
291070,202102,1976,1471,505,1618100.82,555501.3,2173602.12
291072,202102,7171,2660,4511,2927393.33,4964300,7891693.33
291075,202102,242,197,45,216700,49500,266200
291077,202102,60,41,19,45100,20900,66000
291080,202102,20300,8798,11502,9684400.75,12659900.55,22344301.30
291085,202102,295,241,54,265100,60500,325600
291090,202102,293,123,170,135300,188100,323400
291100,202102,651,202,449,222200,495000,717200
291110,202102,421,322,99,354200,108900,463100
291120,202102,2373,1193,1180,1313400,1300200,2613600
291125,202102,66,32,34,35200,37400,72600
291130,202102,199,175,24,192500,26400,218900
291140,202102,127,102,25,112200,27500,139700
291150,202102,394,146,248,160600,273900,434500
291160,202102,383,310,73,341000,80300,421300
291165,202102,46,37,9,40700,9900,50600
291170,202102,3134,1548,1586,1702800.5,1744600,3447400.5
291180,202102,1249,502,747,552200,821700,1373900
291185,202102,96,91,5,100100,5500,105600
291190,202102,1390,641,749,706200,823900,1530100
291200,202102,170,124,46,136400,50600,187000
291210,202102,2314,911,1403,1002100,1543300,2545400
291220,202102,280,210,70,231000,77000,308000
291230,202102,972,334,638,367400,702900,1070300
291240,202102,427,397,30,436700,33000,469700
291250,202102,434,352,82,387200,90200,477400
291260,202102,58,48,10,52800,11000,63800
291270,202102,1144,475,669,522500,735900,1258400
291280,202102,346,163,183,179300,201300,380600
291290,202102,1716,891,825,980100,907500,1887600
291300,202102,227,181,46,199100,50600,249700
291310,202102,226,203,23,223300,25300,248600
291320,202102,1358,961,397,1057100,437800,1494900
291330,202102,130,112,18,123200,19800,143000
291340,202102,215,128,87,140800,95700,236500
291345,202102,129,90,39,100100,42900,143000
291350,202102,1653,580,1073,638000,1180300,1818300
291360,202102,8335,4020,4315,4422000,4748700,9170700
291370,202102,1121,649,472,713900,520300,1234200
291380,202102,265,211,54,232100,59400,291500
291390,202102,3935,1733,2202,1906300,2422200,4328500
291400,202102,2071,1481,590,1629100,649000.42,2278100.42
291410,202102,193,168,25,184800,27500,212300
291420,202102,119,87,32,95700,35200,130900
291430,202102,164,89,75,97900,82500.5,180400.5
291440,202102,512,421,91,463100,100100,563200
291450,202102,932,597,335,656700,368500,1025200
291460,202102,1871,1515,356,1667600,391600,2059200
291465,202102,2203,1037,1166,1140700,1282600,2423300
291470,202102,2850,1431,1419,1575200.55,1560900,3136100.55
291480,202102,11786,5179,6607,5700201.62,7275400,12975601.62
291490,202102,609,244,365,269500,401500,671000
291500,202102,379,223,156,245300,171600,416900
291510,202102,1225,474,751,521400,827200,1348600
291520,202102,941,423,518,465300,569800,1035100
291530,202102,933,246,687,270600,755700,1026300
291535,202102,121,99,22,108900,24200,133100
291540,202102,353,111,242,122100,267300,389400
291550,202102,1242,583,659,641300,724900,1366200
291560,202102,5222,2616,2606,2879800,2868800,5748600
291570,202102,207,105,102,115500,112200,227700
291580,202102,1189,737,452,811800,497200,1309000
291590,202102,92,39,53,42900,58300,101200
291600,202102,1135,556,579,612700,638000,1250700
291610,202102,1457,699,758,768900,833800,1602700
291620,202102,567,263,304,289300,334400,623700
291630,202102,476,149,327,163900,359700,523600
291640,202102,3944,1989,1955,2187900,2151600,4339500
291650,202102,431,291,140,320100.5,154000,474100.5
291660,202102,381,155,226,170500,248600,419100
291670,202102,222,133,89,146300,97900,244200
291680,202102,638,386,252,424600,277200,701800
291685,202102,577,324,253,356400,278300,634700
291690,202102,519,312,207,343200,227700.92,570900.92
291700,202102,976,758,218,834900,239800,1074700
291710,202102,1617,783,834,862400,917400,1779800
291720,202102,426,286,140,314600,154000,468600
291730,202102,932,542,390,596200,429000,1025200
291733,202102,289,195,94,214500,103400,317900
291735,202102,73,56,17,61600,18700,80300
291740,202102,355,269,86,295900,94600,390500
291750,202102,2185,1418,767,1560901.11,843700,2404601.11
291760,202102,2935,1632,1303,1795200,1433300,3228500
291770,202102,763,518,245,569800,270600,840400
291780,202102,60,35,25,38500,27500,66000
291790,202102,157,82,75,90200,82500,172700
291800,202102,10049,4177,5872,4594701.05,6460300,11055001.05
291810,202102,1102,825,277,907500,304700,1212200
291820,202102,280,203,77,223300,84700,308000
291830,202102,1048,424,624,466400.59,687500,1153900.59
291835,202102,561,520,41,572000,45100,617100
291840,202102,4914,2485,2429,2734600,2673000,5407600
291845,202102,269,87,182,95700,200200,295900
291850,202102,325,288,37,316800,40700,357500
291855,202102,256,103,153,113300,168300,281600
291860,202102,169,105,64,115500,70400,185900
291870,202102,83,36,47,39600,52800,92400
291875,202102,180,166,14,182600,15400,198000
291880,202102,449,358,91,393800,100100,493900
291890,202102,250,82,168,90200,184800,275000
291900,202102,58,32,26,35200,28600,63800
291905,202102,125,91,34,100100,37400,137500
291910,202102,155,126,29,138600,31900,170500
291915,202102,429,379,50,416900,55000,471900
291920,202102,5129,2531,2598,2785200,2862200,5647400
291930,202102,169,101,68,111100.27,74800,185900.27
291940,202102,360,209,151,229900,166100,396000
291950,202102,1141,916,225,1007600,247500,1255100
291955,202102,1272,765,507,841500,558800,1400300
291960,202102,191,139,52,152900,57200,210100
291970,202102,753,570,183,627000,201300,828300
291980,202102,1498,1320,178,1452000.73,195800,1647800.73
291990,202102,137,127,10,139700,11000,150700
291992,202102,168,88,80,96800,88000,184800
291995,202102,186,121,65,134200,71500,205700
292000,202102,396,302,94,332200,103400,435600
292010,202102,317,220,97,242000,106700,348700
292020,202102,300,220,80,242000,88000,330000
292030,202102,144,110,34,121000,37400,158400
292040,202102,621,317,304,348700,335500,684200
292045,202102,108,97,11,106700,12100,118800
292050,202102,941,684,257,752400,282700,1035100
292060,202102,901,741,160,815100,176000,991100
292070,202102,61,18,43,19800,47300,67100
292080,202102,137,93,44,102300,48400,150700
292090,202102,539,188,351,206800,386100,592900
292100,202102,1479,631,848,695200,935000,1630200
292105,202102,186,165,21,181500,23100,204600
292110,202102,2258,821,1437,903100,1580700,2483800
292120,202102,690,543,147,597300,161700,759000
292130,202102,441,246,195,270600,214500,485100
292140,202102,207,167,40,183700,44000,227700
292145,202102,161,87,74,95700,81400,177100
292150,202102,1489,1220,269,1342000,297000,1639000
292160,202102,164,132,32,145200,35200,180400
292170,202102,1188,1029,159,1131900,174900,1306800
292180,202102,223,164,59,180400,64900,245300
292190,202102,160,104,56,114400,61600,176000
292200,202102,1344,485,859,533500,944900,1478400
292205,202102,126,109,17,119900,18700,138600
292210,202102,365,252,113,277200,124300,401500
292220,202102,32,23,9,25300,9900,35200
292225,202102,38,31,7,34100,7700,41800
292230,202102,952,753,199,829400,218900,1048300
292240,202102,608,441,167,485100,183700,668800
292250,202102,1704,1114,590,1225400,650100,1875500
292260,202102,403,240,163,264000,179300,443300
292265,202102,248,179,69,196900,75900,272800
292270,202102,733,338,395,371800,434500,806300
292273,202102,208,114,94,125400,103400,228800
292275,202102,174,87,87,95700,95700,191400
292280,202102,143,100,43,110000,47300,157300
292285,202102,76,62,14,68200,15400,83600
292290,202102,578,388,190,426800,209000,635800
292300,202102,1714,635,1079,698500,1186900,1885400
292303,202102,116,75,41,82500,46200,128700
292305,202102,116,86,30,94600,33000,127600
292310,202102,932,603,329,663300,361900,1025200
292320,202102,587,445,142,489500,156200,645700
292330,202102,177,102,75,112200,82500,194700
292335,202102,276,217,59,238700,64900,303600
292340,202102,578,401,177,441100,194700,635800
292350,202102,268,146,122,160600,134200,294800
292360,202102,702,534,168,587400,184800,772200
292370,202102,738,564,174,620400,191400,811800
292380,202102,635,514,121,565400,133100,698500
292390,202102,461,181,280,199100,308000,507100
292400,202102,3595,2233,1362,2457400,1501500,3958900
292405,202102,267,178,89,195800,97900,293700
292410,202102,132,80,52,88000,57200,145200
292420,202102,297,258,39,283800,42900,326700
292430,202102,549,409,140,449900,154000,603900
292440,202102,604,513,91,564300.56,100100,664400.56
292450,202102,239,185,54,203500,59400,262900
292460,202102,543,406,137,446600,150700,597300
292465,202102,209,175,34,192500,37400,229900
292467,202102,145,89,56,97900,61600,159500
292470,202102,290,196,94,215600,103400,319000
292480,202102,367,249,118,273900,129800,403700
292490,202102,236,168,68,184800,74800,259600
292500,202102,851,377,474,414700.32,521400,936100.32
292510,202102,3442,1587,1855,1746800,2042700,3789500
292520,202102,1091,505,586,555500,644600,1200100
292525,202102,398,283,115,311300,126500,437800
292530,202102,4425,1757,2668,1933800.65,2937000,4870800.65
292540,202102,480,269,211,295900,232100,528000
292550,202102,1098,579,519,636900,570900,1207800
292560,202102,332,309,23,339900,25300,365200
292570,202102,310,242,68,266200,74800,341000
292575,202102,486,325,161,357500,177100,534600
292580,202102,989,654,335,719400,368500,1087900
292590,202102,566,495,71,544500,78100,622600
292593,202102,140,110,30,121000,33000,154000
292595,202102,206,161,45,177100,49500,226600
292600,202102,1255,913,342,1004300.63,376200,1380500.63
292610,202102,128,99,29,108900,31900,140800
292620,202102,530,449,81,493900,89100,583000
292630,202102,1443,804,639,884400,702900,1587300
292640,202102,847,591,256,650100,282700,932800
292650,202102,188,156,32,172700.56,35200,207900.56
292660,202102,2032,1456,576,1601600,633600.92,2235200.92
292665,202102,143,101,42,111100,46200,157300
292670,202102,390,311,79,342100,86900,429000
292680,202102,256,191,65,210100,71500,281600
292690,202102,193,141,52,155100,57200,212300
292700,202102,975,643,332,707300.9,365200,1072500.9
292710,202102,117,102,15,112200,16500,128700
292720,202102,930,527,403,579700,443300,1023000
292730,202102,196,91,105,100100,115500,215600
292740,202102,69445,33696,35749,37082103.24,39341501.69,76423604.93
292750,202102,395,280,115,308000,126500,434500
292760,202102,337,281,56,309100,61600,370700
292770,202102,830,354,476,389400,523600,913000
292780,202102,407,157,250,172700,275000,447700
292790,202102,777,402,375,442200,412500,854700
292800,202102,1256,745,511,819500,563200,1382700
292805,202102,395,123,272,135300,299200,434500
292810,202102,1513,861,652,948200,717200,1665400
292820,202102,714,603,111,663300,122100,785400
292830,202102,113,91,22,100100,24200,124300
292840,202102,686,560,126,617100,138600,755700
292850,202102,142,94,48,103400,52800,156200
292860,202102,2132,1238,894,1361800,983400,2345200
292870,202102,3512,2334,1178,2569600,1296900,3866500
292880,202102,1489,977,512,1074700,564300,1639000
292890,202102,522,441,81,485100,89100,574200
292895,202102,141,93,48,102300,52800,155100
292900,202102,372,267,105,293700,115500,409200
292905,202102,481,236,245,259600,269500,529100
292910,202102,463,348,115,382800,126500,509300
292920,202102,522,228,294,250800,324500,575300
292925,202102,502,459,43,504900,47300,552200
292930,202102,629,375,254,412500,279400,691900
292935,202102,288,121,167,133100,183700,316800
292937,202102,223,152,71,167200,78100,245300
292940,202102,192,148,44,162800,48400,211200
292950,202102,1177,582,595,640200,654500.6,1294700.6
292960,202102,576,407,169,447700,187000,634700
292970,202102,240,168,72,184800.48,79200,264000.48
292975,202102,109,64,45,70400,49500,119900
292980,202102,290,198,92,217800.61,101200,319000.61
292990,202102,1326,983,343,1081300,377300,1458600
293000,202102,116,80,36,88000,39600,127600
293010,202102,2809,1657,1152,1822700.73,1267200.8,3089901.53
293015,202102,633,515,118,567600,129800,697400
293020,202102,333,273,60,300300,66000,366300
293030,202102,608,530,78,583000,85800,668800
293040,202102,362,288,74,316800,82500,399300
293050,202102,2882,1691,1191,1860100,1310100,3170200
293060,202102,257,205,52,225500.48,57200,282700.48
293070,202102,3517,1767,1750,1943700.25,1926100,3869800.25
293075,202102,88,58,30,63800,33000,96800
293076,202102,75,55,20,60500,22000,82500
293077,202102,534,304,230,334400.77,253000,587400.77
293080,202102,432,387,45,425700,50600,476300
293090,202102,130,117,13,128700,14300,143000
293100,202102,519,360,159,396000,174900,570900
293105,202102,342,250,92,275000,101200,376200
293110,202102,169,115,54,126500,59400,185900
293120,202102,302,203,99,223300,108900,332200
293130,202102,252,173,79,190300,86900,277200
293135,202102,8078,3141,4937,3456200,5430700,8886900
293140,202102,215,130,85,144100,93500,237600
293150,202102,316,275,41,302500,45100,347600
293160,202102,429,257,172,282700,189200,471900
293170,202102,186,121,65,133100,71500,204600
293180,202102,543,382,161,420200,177100,597300
293190,202102,1353,931,422,1025200.7,464200,1489400.7
293200,202102,554,484,70,532400,77000,609400
293210,202102,398,299,99,328900,108900,437800
293220,202102,2463,1051,1412,1157200,1553200,2710400
293230,202102,1762,655,1107,720500.1,1217700,1938200.1
293240,202102,233,213,20,234300,22000,256300
293245,202102,125,105,20,115500,22000,137500
293250,202102,730,268,462,294800.22,508200,803000.22
293260,202102,303,251,52,277200,57200,334400
293270,202102,1183,545,638,599500,701800,1301300
293280,202102,282,156,126,171600,138600,310200
293290,202102,3052,1981,1071,2180200,1178100,3358300
293300,202102,749,527,222,579700,244200,823900
293305,202102,198,154,44,169400,48400,217800
293310,202102,156,117,39,128700,42900,171600
293315,202102,166,130,36,143000,39600,182600
293317,202102,86,62,24,68200,26400,94600
293320,202102,1062,578,484,635800.5,532400,1168200.5
293325,202102,189,71,118,78100,129800,207900
293330,202102,13744,6364,7380,7001500.38,8120200,15121700.38
293340,202102,277,192,85,211200,93500,304700
293345,202102,251,204,47,224400,51700,276100
293350,202102,607,354,253,389400,278300,667700
293360,202102,1515,1082,433,1192400,476300,1668700
310010,202102,142,76,66,83600,72600,156200
310020,202102,1028,562,466,618200,512600,1130800
310030,202102,327,261,66,287100,72600,359700
310040,202102,42,28,14,30800,15400,46200
310050,202102,175,108,67,118800,73700,192500
310060,202102,253,176,77,193600,84700,278300
310070,202102,14,9,5,9900,5500,15400
310080,202102,40,24,16,26400,17600,44000
310090,202102,1010,529,481,581900,529100,1111000
310100,202102,308,223,85,246400,94600,341000
310110,202102,704,385,319,423500,350900,774400
310120,202102,379,215,164,236500,180400,416900
310130,202102,32,17,15,18700,16500,35200
310140,202102,24,10,14,11000,15400,26400
310150,202102,1174,789,385,869000,423500,1292500
310160,202102,2038,992,1046,1091200.22,1150600,2241800.22
310163,202102,87,49,38,53900,41800,95700
310170,202102,2518,1100,1418,1211100,1559800,2770900
310180,202102,153,57,96,62700,105600,168300
310190,202102,491,336,155,369600,170500,540100
310200,202102,479,306,173,336600,190300,526900
310205,202102,58,38,20,41800,22000,63800
310210,202102,284,227,57,250800,62700,313500
310220,202102,62,35,27,38500,29700,68200
310230,202102,278,192,86,211200,94600,305800
310240,202102,108,94,14,103400,15400,118800
310250,202102,98,81,17,89100,18700,107800
310260,202102,757,394,363,434500.92,399300,833800.92
310270,202102,269,171,98,188100,107800,295900
310280,202102,368,270,98,297000,107800,404800
310285,202102,206,151,55,166100,60500,226600
310290,202102,238,133,105,146300,115500,261800
310300,202102,159,130,29,143000,31900,174900
310310,202102,8,7,1,7700,1100,8800
310320,202102,26,10,16,11000,17600,28600
310330,202102,40,27,13,29700,14300,44000
310340,202102,1747,1153,594,1268300,653400,1921700
310350,202102,2776,1472,1304,1620300,1436600,3056900
310360,202102,40,33,7,37400,7700,45100
310370,202102,128,106,22,116600,24200,140800
310375,202102,106,38,68,41800,74800,116600
310380,202102,48,28,20,30800,22000,52800
310390,202102,100,65,35,71500,38500,110000
310400,202102,2352,1502,850,1652200,935000,2587200
310410,202102,127,69,58,75900,63800,139700
310420,202102,658,343,315,377300,346500,723800
310430,202102,293,180,113,198000,124300,322300
310440,202102,72,41,31,45100,34100,79200
310445,202102,80,64,16,70400,17600,88000
310450,202102,620,386,234,424600,257400,682000
310460,202102,255,179,76,196900,83600,280500
310470,202102,513,325,188,357500,206800,564300
310480,202102,84,54,30,59400,33000,92400
310490,202102,533,247,286,271700,314600,586300
310500,202102,135,53,82,58300,90200,148500
310510,202102,601,420,181,462000,199100,661100
310520,202102,137,96,41,105600,45100,150700
310530,202102,106,43,63,47300,69300,116600
310540,202102,473,269,204,295900,224400,520300
310550,202102,73,47,26,51700,28600,80300
310560,202102,2979,2051,928,2256100,1020800,3276900
310570,202102,92,58,34,63800,37400,101200
310590,202102,371,233,138,256300,151800,408100
310600,202102,147,80,67,88000,73700,161700
310610,202102,56,21,35,23100,38500,61600
310620,202102,46941,22240,24701,24472717.5,27186500,51659217.5
310630,202102,658,400,258,440000,283800,723800
310640,202102,122,95,27,104500,29700,134200
310650,202102,155,138,17,151800,18700,170500
310660,202102,99,67,32,73700,35200,108900
310665,202102,61,46,15,50600,16500,67100
310670,202102,6736,2860,3876,3149300,4264700,7414000
310680,202102,60,36,24,39600,26400,66000
310690,202102,605,422,183,464200,201300,665500
310700,202102,61,39,22,42900,24200,67100
310710,202102,1314,888,426,976800,469700,1446500
310720,202102,138,35,103,38500,113300,151800
310730,202102,1474,1007,467,1107700,513700,1621400
310740,202102,985,543,442,597300,486200,1083500
310750,202102,237,143,94,157300,103400,260700
310760,202102,64,49,15,53900,16500,70400
310770,202102,89,44,45,48400,49500,97900
310780,202102,359,290,69,319000,75900,394900
310790,202102,106,86,20,94600,22000,116600
310800,202102,450,208,242,228800,267300,496100
310810,202102,174,120,54,132000.72,59400.34,191401.06
310820,202102,335,264,71,290400,78100,368500
310825,202102,197,168,29,184800,31900,216700
310830,202102,475,226,249,248600,275000,523600
310840,202102,359,212,147,233200,161700,394900
310850,202102,82,66,16,72600,17600,90200
310855,202102,401,310,91,341000,100100,441100
310860,202102,1586,1167,419,1283700,460900,1744600
310870,202102,57,47,10,51700,11000,62700
310880,202102,85,67,18,73700,19800,93500
310890,202102,306,175,131,192500,144100,336600
310900,202102,649,291,358,320107.92,394911.52,715019.44
310910,202102,238,160,78,176000,85800,261800
310920,202102,452,261,191,287100,210100,497200
310925,202102,33,27,6,29700,6600,36300
310930,202102,1295,830,465,913000,511500,1424500
310940,202102,688,343,345,377300,379500,756800
310945,202102,121,78,43,85800,47300,133100
310950,202102,226,181,45,199100,49500,248600
310960,202102,77,24,53,26400,58300,84700
310970,202102,169,103,66,113300,72600,185900
310980,202102,47,32,15,35200,16500,51700
310990,202102,161,82,79,90200,86900,177100
311000,202102,809,392,417,431200.1,459800,891000.1
311010,202102,49,43,6,47300,6600,53900
311020,202102,44,25,19,27500,20900,48400
311030,202102,385,220,165,242000,181500,423500
311040,202102,43,32,11,35200,12100,47300
311050,202102,470,180,290,199100,319000,518100
311060,202102,774,424,350,466400,386100,852500
311070,202102,342,150,192,165000,212300,377300
311080,202102,108,60,48,66000,52800,118800
311090,202102,338,157,181,172700,199100,371800
311100,202102,567,337,230,370700,253000,623700
311110,202102,692,485,207,535700,227700,763400
311115,202102,72,51,21,56100,23100,79200
311120,202102,1056,561,495,617100,544500,1161600
311130,202102,327,193,134,212300,147400,359700
311140,202102,169,88,81,96800,89100,185900
311150,202102,338,218,120,239800,132000,371800
311160,202102,707,504,203,554400,223300,777700
311170,202102,85,68,17,74800,18700,93500
311180,202102,309,203,106,223300,117700,341000
311190,202102,40,18,22,19800,24200,44000
311200,202102,333,233,100,256300,110000,366300
311205,202102,34,25,9,27500,9900,37400
311210,202102,42,37,5,40700,5500,46200
311220,202102,29,24,5,26400,5500,31900
311230,202102,1640,1080,560,1188000,616000,1804000
311240,202102,195,124,71,136400,78100,214500
311250,202102,55,21,34,23100,37400,60500
311260,202102,561,353,208,388300,228800,617100
311265,202102,125,85,40,93500,44000,137500
311270,202102,284,196,88,215600,96800,312400
311280,202102,203,95,108,105600,118800,224400
311290,202102,104,85,19,93500,20900,114400
311300,202102,572,359,213,394900,234300,629200
311310,202102,21,16,5,17600,5500,23100
311320,202102,645,479,166,526900,183700,710600
311330,202102,1067,779,288,856900,316800,1173700
311340,202102,2624,1851,773,2037200,850300,2887500
311350,202102,274,212,62,233200,68200,301400
311360,202102,177,103,74,113300,81400,194700
311370,202102,1229,500,729,550000,801900,1351900
311380,202102,6,5,1,5500,1100,6600
311390,202102,249,138,111,151800,122100,273900
311400,202102,133,81,52,89100,57200,146300
311410,202102,113,58,55,63800,60500,124300
311420,202102,302,164,138,180400,151800,332200
311430,202102,843,560,283,616000,311300,927300
311440,202102,460,323,137,355300,150700,506000
311450,202102,304,184,120,202400,132000,334400
311455,202102,279,192,87,211200,95700,306900
311460,202102,136,60,76,66000,83600,149600
311470,202102,26,13,13,14300,14300,28600
311480,202102,49,23,26,25300,28600,53900
311490,202102,12,8,4,8800,4400,13200
311500,202102,25,12,13,13200,14300,27500
311510,202102,649,443,206,487300,226600,713900
311520,202102,39,31,8,34100,8800,42900
311530,202102,1814,1321,493,1453100,542300,1995400
311535,202102,65,44,21,48400,23100,71500
311540,202102,32,28,4,30800,4400,35200
311545,202102,166,121,45,133100,49500,182600
311547,202102,41,33,8,36300,8800,45100
311550,202102,686,309,377,341000,414700,755700
311560,202102,43,28,15,30800,16500,47300
311570,202102,286,190,96,209000,105600,314600
311580,202102,363,215,148,236500,162800,399300
311590,202102,32,29,3,31900,3300,35200
311600,202102,104,83,21,91300,23100,114400
311610,202102,249,212,37,233200,40700,273900
311615,202102,98,78,20,85800,22000,107800
311620,202102,24,14,10,15400,11000,26400
311630,202102,88,75,13,82500,14300,96800
311640,202102,133,63,70,69300,77000,146300
311650,202102,118,80,38,88000,41800,129800
311660,202102,403,195,208,214500,228800,443300
311670,202102,143,93,50,102300,55000,157300
311680,202102,206,154,52,169400,57200,226600
311690,202102,16,12,4,13200,4400,17600
311700,202102,191,138,53,151800,59400,211200
311710,202102,190,129,61,141900,67100,209000
311720,202102,42,30,12,33000,13200,46200
311730,202102,567,387,180,426800,198000,624800
311740,202102,27,20,7,22000,7700,29700
311750,202102,723,482,241,530200.7,265100,795300.7
311760,202102,71,31,40,34100,44000,78100
311770,202102,385,192,193,211200,212300,423500
311780,202102,177,87,90,95700,99000,194700
311783,202102,91,82,9,90200,9900,100100
311787,202102,35,12,23,13200,25300,38500
311790,202102,260,112,148,123200,162800,286000
311800,202102,686,444,242,488400,266200,754600
311810,202102,49,39,10,42900,11000,53900
311820,202102,121,98,23,107800,25300,133100
311830,202102,1875,1144,731,1259500,805200,2064700
311840,202102,1001,552,449,607200,495000,1102200
311850,202102,12,8,4,8800,4400,13200
311860,202102,9567,4098,5469,4514400,6018100,10532500
311870,202102,121,65,56,71500,61600,133100
311880,202102,923,668,255,734800,280500,1015300
311890,202102,199,96,103,105509,113300,218809
311900,202102,71,27,44,29700,48400,78100
311910,202102,1379,858,521,943800,573100,1516900
311920,202102,223,146,77,160600,84700,245300
311930,202102,889,497,392,546700,431200,977900
311940,202102,2525,1318,1207,1452000,1328800,2780800
311950,202102,58,40,18,44000,19800,63800
311960,202102,60,44,16,48400,17600,66000
311970,202102,25,15,10,16500,11000,27500
311980,202102,42,33,9,36300,9900,46200
311990,202102,37,28,9,30800,9900,40700
311995,202102,54,34,20,37400,22000,59400
312000,202102,25,16,9,17600,9900,27500
312010,202102,75,58,17,63800,18700,82500
312015,202102,72,54,18,59400,19800,79200
312020,202102,126,86,40,94600,44000,138600
312030,202102,60,44,16,48400,17600,66000
312040,202102,78,51,27,56100,29700,85800
312050,202102,201,111,90,122100,99000,221100
312060,202102,20,12,8,13200,8800,22000
312070,202102,76,48,28,52800,30800,83600
312080,202102,526,236,290,259600,319000,578600
312083,202102,56,37,19,40700,20900,61600
312087,202102,97,75,22,82500,24200,106700
312090,202102,3201,1914,1287,2105400,1415700,3521100
312100,202102,149,105,44,115247,48400,163647
312110,202102,116,65,51,71500,56100,127600
312120,202102,132,98,34,107800.63,37400,145200.63
312125,202102,88,51,37,56100,40700,96800
312130,202102,131,83,48,91300,52800,144100
312140,202102,135,104,31,114400,34100,148500
312150,202102,42,32,10,35200,11000,46200
312160,202102,1560,1020,540,1122099,594000,1716099
312170,202102,10,8,2,8800,2200,11000
312180,202102,108,66,42,72600,46200,118800
312190,202102,35,31,4,34100,4400,38500
312200,202102,751,641,110,705100,122100,827200
312210,202102,117,64,53,70400,58300,128700
312220,202102,131,100,31,110000,34100,144100
312230,202102,3643,1669,1974,1837000,2171400,4008400
312235,202102,153,102,51,112200,56100,168300
312240,202102,93,66,27,72600,29700,102300
312245,202102,190,128,62,141900,68200,210100
312247,202102,75,53,22,58300,24200,82500
312250,202102,171,81,90,89100,99000,188100
312260,202102,101,66,35,72600,38500,111100
312270,202102,130,78,52,85800,57200,143000
312280,202102,28,14,14,15400,15400,30800
312290,202102,144,101,43,111100,47300,158400
312300,202102,205,134,71,148500,78100,226600
312310,202102,62,55,7,60500,7700,68200
312320,202102,423,266,157,292600,172700,465300
312330,202102,87,76,11,83600,12100,95700
312340,202102,35,16,19,17600,20900,38500
312350,202102,16,9,7,9900,7700,17600
312352,202102,89,68,21,74800,23100,97900
312360,202102,567,240,327,264000,359700,623700
312370,202102,314,172,142,190300,156200,346500
312380,202102,135,89,46,97900,50600,148500
312385,202102,159,129,30,141900,33000,174900
312390,202102,297,187,110,205700,121000,326700
312400,202102,379,280,99,308000,108900,416900
312410,202102,1031,326,705,358600,775500,1134100
312420,202102,617,468,149,514800,163900,678700
312430,202102,868,637,231,700701.13,255200,955901.13
312440,202102,42,31,11,34100,12100,46200
312450,202102,202,131,71,144100,78100,222200
312460,202102,31,16,15,17600,16500,34100
312470,202102,42,28,14,31900,15400,47300
312480,202102,184,113,71,124300,78100,202400
312490,202102,272,188,84,206800,92400,299200
312500,202102,34,20,14,22000,15400,37400
312510,202102,522,196,326,215600,358600,574200
312520,202102,33,10,23,11000,25300,36300
312530,202102,45,31,14,34100,15400,49500
312540,202102,90,79,11,86900,12100,99000
312550,202102,37,29,8,31900,8800,40700
312560,202102,206,154,52,169400,57200,226600
312570,202102,430,254,176,279400,194700,474100
312580,202102,90,48,42,52800,46200,99000
312590,202102,242,195,47,214500,52800,267300
312595,202102,125,108,17,118800,18700,137500
312600,202102,68,37,31,40700,34100,74800
312610,202102,1600,824,776,906400,853600,1760000
312620,202102,217,156,61,171600,67100,238700
312630,202102,70,57,13,62700,14300,77000
312640,202102,42,11,31,12100,34100,46200
312650,202102,146,120,26,132370.7,28600,160970.7
312660,202102,92,65,27,71500.01,29700,101200.01
312670,202102,927,596,331,655600,364100,1019700
312675,202102,29,24,5,26400,5500,31900
312680,202102,72,43,29,47300,31900,79200
312690,202102,243,123,120,135300,133100,268400
312695,202102,27,23,4,25300,4400,29700
312700,202102,225,129,96,141900,106700,248600
312705,202102,82,63,19,69300,20900,90200
312707,202102,133,95,38,104500,41800,146300
312710,202102,1861,998,863,1097837.25,950400,2048237.25
312720,202102,54,28,26,30800,28600,59400
312730,202102,287,163,124,179300,136400,315700
312733,202102,45,36,9,39600,9900,49500
312735,202102,21,13,8,14300,8800,23100
312737,202102,63,33,30,36300,33000,69300
312738,202102,58,39,19,42900,20900,63800
312740,202102,82,53,29,58300,31900,90200
312750,202102,91,63,28,69300,30800,100100
312760,202102,291,209,82,229900,90200,320100
312770,202102,8184,3727,4457,4101900,4907100,9009000
312780,202102,440,335,105,368500,115500,484000
312790,202102,21,15,6,16500,6600,23100
312800,202102,1604,1124,480,1236400,528000.11,1764400.11
312810,202102,365,236,129,259600,141900,401500
312820,202102,184,141,43,155100,47300,202400
312825,202102,26,17,9,18700,9900,28600
312830,202102,220,127,93,139700,102300,242000
312840,202102,156,104,52,114400,57200,171600
312850,202102,43,37,6,40700,6600,47300
312860,202102,152,95,57,104500,62700,167200
312870,202102,1057,548,509,602800,559900,1162700
312880,202102,124,88,36,96800,39600,136400
312890,202102,156,109,47,119900,51700,171600
312900,202102,190,142,48,156200,52800,209000
312910,202102,169,88,81,96800,89100,185900
312920,202102,147,83,64,92400,70400,162800
312930,202102,322,226,96,248600,105600,354200
312940,202102,122,84,38,92400,41800,134200
312950,202102,688,468,220,514800,242000,756800
312960,202102,158,119,39,130900,42900,173800
312965,202102,85,67,18,73700,19800,93500
312970,202102,273,225,48,247500,52800,300300
312980,202102,2453,1221,1232,1343100,1356300,2699400
312990,202102,48,25,23,27500,25300,52800
313000,202102,55,29,26,31900,28600,60500
313005,202102,174,135,39,148500,42900,191400
313010,202102,907,355,552,390500,607200,997700
313020,202102,202,103,99,113300,108900,222200
313030,202102,198,131,67,144100,73700,217800
313040,202102,77,25,52,27500,57200,84700
313050,202102,180,131,49,144100,53900,198000
313055,202102,39,29,10,31900,11000,42900
313060,202102,132,89,43,97900,47300,145200
313065,202102,62,44,18,48400,19800,68200
313070,202102,135,70,65,77000,71500,148500
313080,202102,39,17,22,18700,24200,42900
313090,202102,661,432,229,475200,251900,727100
313100,202102,190,64,126,70400,138600,209000
313110,202102,140,71,69,78100,75900,154000
313115,202102,213,119,94,130900,103400,234300
313120,202102,826,467,359,513700,394900,908600
313130,202102,5798,3126,2672,3438600,2939200,6377800
313140,202102,138,75,63,82500,69300,151800
313150,202102,302,238,64,261800,70400,332200
313160,202102,189,141,48,155100,52800,207900
313170,202102,1395,925,470,1018600,518100,1536700
313180,202102,303,176,127,193600,139700,333300
313190,202102,740,435,305,478500,335500,814000
313200,202102,26,20,6,22000,6600,28600
313210,202102,992,844,148,928400,162800,1091200
313220,202102,288,176,112,193600,123200,316800
313230,202102,258,196,62,215600.5,68200,283800.5
313240,202102,2168,1112,1056,1224300,1162700,2387000
313250,202102,1254,955,299,1050500,330000,1380500
313260,202102,93,48,45,52800,49500,102300
313270,202102,989,573,416,630300,457600,1087900
313280,202102,49,42,7,46200,7700,53900
313290,202102,213,172,41,189200,45100,234300
313300,202102,341,178,163,195800,179300,375100
313310,202102,261,121,140,133100,154000,287100
313320,202102,388,286,102,314600,112200,426800
313330,202102,1396,847,549,932800,603900,1536700
313340,202102,321,226,95,248600,104500,353100
313350,202102,486,322,164,354200,180400,534600
313360,202102,148,69,79,75900,86900,162800
313370,202102,220,68,152,74800,167200,242000
313375,202102,288,169,119,185900,130900,316800
313380,202102,1352,704,648,775500,712800,1488300
313390,202102,48,44,4,48400,4400,52800
313400,202102,394,266,128,292600,140800,433400
313410,202102,26,13,13,14300,14300,28600
313420,202102,4552,2426,2126,2671900,2339700,5011600
313430,202102,139,67,72,73700,79200,152900
313440,202102,1397,963,434,1059301.13,477400,1536701.13
313450,202102,68,29,39,31900,42900,74800
313460,202102,380,166,214,182600,235400,418000
313470,202102,528,247,281,271700,309100,580800
313480,202102,146,108,38,118800,41800,160600
313490,202102,516,237,279,260700,306900,567600
313500,202102,29,16,13,17600,14300,31900
313505,202102,1034,806,228,886600,250800,1137400
313507,202102,101,61,40,67100,44000,111100
313510,202102,2833,1775,1058,1954797.1,1163800,3118597.1
313520,202102,3448,2695,753,2964501.5,828300,3792801.5
313530,202102,32,21,11,23100,13200,36300
313535,202102,64,50,14,55000,15400,70400
313540,202102,69,51,18,56100,19800,75900
313545,202102,112,95,17,104500,19800,124300
313550,202102,225,190,35,209000,38500,247500
313560,202102,343,165,178,181500,195800,377300
313570,202102,64,21,43,23100,47300,70400
313580,202102,1311,727,584,799700,642400,1442100
313590,202102,70,39,31,42900,34100,77000
313600,202102,674,406,268,446600,294800,741400
313610,202102,60,47,13,51700,14300,66000
313620,202102,1392,693,699,762300,768900.6,1531200.6
313630,202102,1607,1217,390,1338700,429000,1767700
313640,202102,120,72,48,79200,52800,132000
313650,202102,233,109,124,121000,136400,257400
313652,202102,21,21,0,23100,0,23100
313655,202102,65,41,24,45100,26400,71500
313657,202102,45,41,4,45100,4400,49500
313660,202102,133,89,44,97900,48419.8,146319.8
313665,202102,638,290,348,319000,382800,701800
313670,202102,10230,6929,3301,7623000.19,3632200,11255200.19
313680,202102,43,33,10,36300,11000,47300
313690,202102,137,103,34,113300,37400,150700
313695,202102,68,51,17,56100,18700,74800
313700,202102,309,246,63,270600,69300,339900
313710,202102,137,99,38,108900,41800,150700
313720,202102,1119,515,604,566500,664400,1230900
313730,202102,74,43,31,47300,34100,81400
313740,202102,146,118,28,129800,30800,160600
313750,202102,418,297,121,326700,133100,459800
313753,202102,231,172,59,189200,64900,254100
313760,202102,1312,469,843,515900.71,927300,1443200.71
313770,202102,382,272,110,299200,121000,420200
313780,202102,785,410,375,452100,412500,864600
313790,202102,28,27,1,29700,1100,30800
313800,202102,140,84,56,92400,61600,154000
313810,202102,76,44,32,48400,36300,84700
313820,202102,1300,609,691,669900,761200,1431100
313830,202102,55,41,14,45100,15400,60500
313835,202102,56,47,9,51700,9900,61600
313840,202102,1654,980,674,1078000,741400,1819400
313850,202102,204,74,130,81400,143000,224400
313860,202102,468,359,109,394900,121000,515900
313862,202102,160,106,54,116600,59400,176000
313865,202102,125,92,33,101200,36300,137500
313867,202102,52,41,11,45100,12100,57200
313868,202102,37,22,15,24200,16500,40700
313870,202102,110,58,52,63800,57200,121000
313880,202102,376,230,146,253000,160600,413600
313890,202102,326,168,158,184800,173800,358600
313900,202102,864,467,397,513700.66,437800,951500.66
313910,202102,148,102,46,112200,50600,162800
313920,202102,625,436,189,479600,207900.94,687500.94
313925,202102,33,28,5,30800,5500,36300
313930,202102,859,670,189,737000,207900,944900
313940,202102,1857,1139,718,1252900,789800,2042700
313950,202102,865,542,323,596200,355300,951500
313960,202102,1409,807,602,887700,662200,1549900
313970,202102,176,111,65,122100,71500,193600
313980,202102,197,127,70,140800,77000,217800
313990,202102,234,155,79,170500,86900,257400
314000,202102,882,580,302,638000,333300,971300
314010,202102,79,44,35,48400,38500,86900
314015,202102,61,16,45,17600,49500,67100
314020,202102,55,33,22,36300,24200,60500
314030,202102,72,32,40,35200,44000,79200
314040,202102,49,28,21,30800,23100,53900
314050,202102,283,170,113,187000,125400,312400
314053,202102,101,64,37,70400,40700,111100
314055,202102,297,184,113,202400,124300,326700
314060,202102,131,114,17,125400.83,18700,144100.83
314070,202102,1028,519,509,570900,559900,1130800
314080,202102,204,130,74,143000,81400,224400
314085,202102,153,101,52,111100,57200,168300
314090,202102,382,271,111,298100,122100,420200
314100,202102,511,412,99,453200,108900,562100
314110,202102,796,388,408,427900,448800,876700
314120,202102,76,45,31,49500,34100,83600
314130,202102,23,13,10,14300,11000,25300
314140,202102,1107,679,428,746900,470800,1217700
314150,202102,187,121,66,133100,72600,205700
314160,202102,330,246,84,270600,92400,363000
314170,202102,86,65,21,71500,23100,94600
314180,202102,732,643,89,707300,97900,805200
314190,202102,95,57,38,62700,41800,104500
314200,202102,499,339,160,372936.66,176000,548936.66
314210,202102,244,186,58,204600,63800,268400
314220,202102,293,213,80,235400,88000,323400
314225,202102,60,43,17,47300,18700,66000
314230,202102,116,51,65,56100,71500,127600
314240,202102,149,110,39,121000,44000,165000
314250,202102,51,29,22,31900,24200,56100
314260,202102,209,102,107,113300,117700,231000
314270,202102,384,296,88,325600,96800,422400
314280,202102,719,386,333,424550.5,366300,790850.5
314290,202102,548,437,111,480700,122100,602800
314300,202102,347,256,91,281600,100100,381700
314310,202102,1364,930,434,1023275.5,477400,1500675.5
314315,202102,35,26,9,28600,9900,38500
314320,202102,584,393,191,432300,210100,642400
314330,202102,11193,5435,5758,5980700,6334900,12315600
314340,202102,598,264,334,290400,367400,657800
314345,202102,51,34,17,37400,18700,56100
314350,202102,178,112,66,123200,72600,195800
314360,202102,59,35,24,38500,26400,64900
314370,202102,66,44,22,48400,24200,72600
314380,202102,100,62,38,68200,41800,110000
314390,202102,3330,2126,1204,2338600,1324400,3663000
314400,202102,694,489,205,537900,225500,763400
314410,202102,486,316,170,347600,187000,534600
314420,202102,14,8,6,8800,6600,15400
314430,202102,2416,884,1532,972401.51,1685200,2657601.51
314435,202102,180,105,75,115500,82500,198000
314437,202102,28,21,7,23100,7700,30800
314440,202102,96,66,30,72600,33000,105600
314450,202102,164,114,50,125400,55000,180400
314460,202102,630,298,332,327800,365200,693000
314465,202102,95,60,35,66000,38500,104500
314467,202102,68,55,13,60500,14300,74800
314470,202102,400,194,206,213400,226600,440000
314480,202102,1025,479,546,528000,600600,1128600
314490,202102,45,29,16,31900,17600,49500
314500,202102,282,197,85,216700,93500,310200
314505,202102,110,69,41,75900,45100,121000
314510,202102,245,200,45,220000,49500,269500
314520,202102,1307,695,612,764500,674300,1438800
314530,202102,722,580,142,638000.7,156200,794200.7
314535,202102,162,97,65,106700,71500,178200
314537,202102,64,38,26,41800,28600,70400
314540,202102,15,9,6,9900,6600,16500
314545,202102,50,33,17,36300,18700,55000
314550,202102,78,40,38,45100,41800,86900
314560,202102,846,455,391,500500,430100,930600
314570,202102,20,15,5,16500,5500,22000
314580,202102,13,5,8,5500,8800,14300
314585,202102,27,18,9,19800,9900,29700
314587,202102,81,68,13,74800,14300,89100
314590,202102,551,390,161,429000,177100,606100
314600,202102,936,596,340,656700,374000.63,1030700.63
314610,202102,936,480,456,529100,501600,1030700
314620,202102,135,100,35,110000,38500,148500
314625,202102,97,70,27,77000,29700,106700
314630,202102,1162,613,549,674300,605000,1279300
314640,202102,81,53,28,58300,30800,89100
314650,202102,176,99,77,108900,84700,193600
314655,202102,61,45,16,49500,17600,67100
314660,202102,16,13,3,14300,3300,17600
314670,202102,198,152,46,167200,50600,217800
314675,202102,210,124,86,136400,94600,231000
314690,202102,588,312,276,343200,303600,646800
314700,202102,2264,1215,1049,1337600,1153900,2491500
314710,202102,1723,977,746,1074700,821700,1896400
314720,202102,387,224,163,246400,180400,426800
314730,202102,519,272,247,299200,272800,572000
314740,202102,723,339,384,374000,422400,796400
314750,202102,18,15,3,16500,3300,19800
314760,202102,354,159,195,174900,214500,389400
314770,202102,105,72,33,79200,36300,115500
314780,202102,22,8,14,8800,15400,24200
314790,202102,2418,1529,889,1684100.76,979000,2663100.76
314795,202102,47,39,8,42900,9900,52800
314800,202102,2929,1693,1236,1862300.76,1359600,3221900.76
314810,202102,1489,843,646,928400,710600,1639000
314820,202102,108,61,47,67100,51700,118800
314830,202102,210,170,40,187000,44000,231000
314840,202102,86,52,34,57200,37400,94600
314850,202102,394,190,204,209000,224400,433400
314860,202102,657,505,152,555500,167200,722700
314870,202102,1525,793,732,872300,805200,1677500
314875,202102,52,47,5,51700,5500,57200
314880,202102,45,31,14,34100,15400,49500
314890,202102,49,28,21,30800,23100,53900
314900,202102,30,24,6,26400,6600,33000
314910,202102,240,156,84,171600,92400,264000
314915,202102,138,122,16,134200,17600,151800
314920,202102,99,62,37,68200,40700,108900
314930,202102,1033,504,529,554400,581900,1136300
314940,202102,47,38,9,41800,9900,51700
314950,202102,31,21,10,23100,11000,34100
314960,202102,31,23,8,25300,8800,34100
314970,202102,151,74,77,81400,84700,166100
314980,202102,311,200,111,220000,122100,342100
314990,202102,438,236,202,259600,222200.48,481800.48
314995,202102,157,62,95,68200,104500,172700
315000,202102,77,58,19,63800,20900,84700
315010,202102,42,28,14,30800,15400,46200
315015,202102,166,130,36,143000,39600,182600
315020,202102,67,56,11,62700,12100,74800
315030,202102,107,82,25,90200,27500,117700
315040,202102,73,48,25,52800,27500,80300
315050,202102,185,108,77,118800,84700,203500
315053,202102,44,33,11,36300,12100,48400
315057,202102,102,79,23,86900,25300,112200
315060,202102,74,62,12,68200,13200,81400
315070,202102,106,61,45,67100,49500,116600
315080,202102,369,288,81,316800,89100,405900
315090,202102,92,53,39,58300,42900,101200
315100,202102,76,39,37,42900,40700,83600
315110,202102,271,145,126,159500,138600,298100
315120,202102,1751,849,902,933900,992200,1926100
315130,202102,336,243,93,267300,102300,369600
315140,202102,532,296,236,325600,259600,585200
315150,202102,983,467,516,513700,567600,1081300
315160,202102,214,105,109,115500,119900,235400
315170,202102,309,205,104,225500,114400,339900
315180,202102,3228,1329,1899,1461900.59,2088900,3550800.59
315190,202102,309,186,123,204600,136400,341000
315200,202102,1203,709,494,779900,544500,1324400
315210,202102,1634,927,707,1019700,777700,1797400
315213,202102,30,18,12,19800,13200,33000
315217,202102,198,155,43,170500,47300,217800
315220,202102,1582,1189,393,1307900,432300,1740200
315230,202102,167,120,47,132000,51700,183700
315240,202102,413,264,149,290400,165000,455400
315250,202102,2567,1232,1335,1356300,1470700,2827000
315260,202102,145,82,63,90200,69300,159500
315270,202102,134,90,44,99000,48400,147400
315280,202102,642,414,228,456500,250800,707300
315290,202102,191,120,71,132000,78100,210100
315300,202102,79,58,21,63800,23100,86900
315310,202102,75,67,8,73700,8800,82500
315320,202102,155,92,63,101200,69300,170500
315330,202102,55,45,10,49500,11000,60500
315340,202102,385,281,104,309100,114400,423500
315350,202102,152,92,60,101200,66000,167200
315360,202102,88,41,47,45100,51700,96800
315370,202102,55,35,20,38500,22000,60500
315380,202102,6,6,0,6600,0,6600
315390,202102,62,16,46,17600,50600,68200
315400,202102,823,614,209,675400,231000,906400
315410,202102,322,188,134,206800,147400,354200
315415,202102,59,44,15,48400,16500,64900
315420,202102,199,144,55,158400,60500,218900
315430,202102,657,375,282,413600,310200,723800
315440,202102,95,64,31,70400,34100,104500
315445,202102,234,195,39,214500,42900,257400
315450,202102,180,135,45,148500,49500,198000
315460,202102,4092,1946,2146,2141700,2362800,4504500
315470,202102,40,16,24,17600,26400,44000
315480,202102,70,20,50,22000,55000,77000
315490,202102,694,426,268,468600,294800,763400
315500,202102,16,13,3,14300,3300,17600
315510,202102,148,100,48,110000,52800,162800
315520,202102,73,63,10,69300,11000,80300
315530,202102,40,22,18,24200,19800,44000
315540,202102,250,172,78,189200,85800,275000
315550,202102,177,144,33,158400,36300,194700
315560,202102,736,586,150,644600,165000,809600
315570,202102,309,152,157,167200.63,172700,339900.63
315580,202102,713,481,232,529100,255200,784300
315590,202102,199,101,98,111100,107800,218900
315600,202102,311,238,73,261800,80300,342100
315610,202102,101,50,51,55000,56100,111100
315620,202102,36,28,8,30800,8800,39600
315630,202102,124,81,43,89100,47300,136400
315640,202102,73,43,30,47300,33000,80300
315645,202102,45,30,15,33000,16500,49500
315650,202102,175,127,48,139700,52800,192500
315660,202102,450,195,255,214500,280500,495000
315670,202102,2370,1115,1255,1226500,1382700,2609200
315680,202102,819,581,238,639100,261800,900900
315690,202102,667,461,206,508200.5,226600,734800.5
315700,202102,1919,1005,914,1105500.28,1006500,2112000.28
315710,202102,350,102,248,112200,272800,385000
315720,202102,462,282,180,310200,198000,508200
315725,202102,186,151,35,166100,38500,204600
315727,202102,50,23,27,25300,29700,55000
315730,202102,46,43,3,47300,3300,50600
315733,202102,88,59,29,64900,31900,96800
315737,202102,50,37,13,40700,14300,55000
315740,202102,31,25,6,27500,6600,34100
315750,202102,152,114,38,125400,41800,167200
315760,202102,38,28,10,30800,11000,41800
315765,202102,115,66,49,72600,53900,126500
315770,202102,213,131,82,144100,90200,234300
315780,202102,3541,1742,1799,1919500,1981100,3900600
315790,202102,231,180,51,198000,56100,254100
315800,202102,295,203,92,223300,101200,324500
315810,202102,94,57,37,62700,40700,103400
315820,202102,750,548,202,602800,222200,825000
315830,202102,121,78,43,85800,47300,133100
315840,202102,85,55,30,60500,33000,93500
315850,202102,258,184,74,202400,81400,283800
315860,202102,13,5,8,5500,8800,14300
315870,202102,40,30,10,33000,11000,44000
315880,202102,104,66,38,72600,41800,114400
315890,202102,91,67,24,73700,26400,100100
315895,202102,419,276,143,303600.13,157300,460900.13
315900,202102,68,32,36,35200,39600,74800
315910,202102,37,21,16,23100,17600,40700
315920,202102,158,105,53,115500,58300,173800
315930,202102,53,20,33,22000,36300,58300
315935,202102,130,103,27,113300,29700,143000
315940,202102,102,75,27,82500,29700,112200
315950,202102,36,29,7,31900,7700,39600
315960,202102,532,253,279,278300,306900,585200
315970,202102,33,26,7,28600,7700,36300
315980,202102,674,333,341,366300,375100,741400
315990,202102,256,149,107,163900.19,117700,281600.19
316000,202102,48,30,18,33000,19800,52800
316010,202102,78,64,14,70400,15400,85800
316020,202102,116,100,16,110000,17600,127600
316030,202102,377,207,170,227700,187000,414700
316040,202102,528,219,309,240900,339900,580800
316045,202102,50,44,6,48400,6600,55000
316050,202102,16,12,4,13200,4400,17600
316060,202102,90,61,29,67100,31900,99000
316070,202102,1077,693,384,762300,423500,1185800
316080,202102,92,63,29,69396.8,31900,101296.8
316090,202102,41,21,20,23100,22000,45100
316095,202102,92,75,17,83600,18700,102300
316100,202102,316,178,138,195800,151800,347600
316105,202102,39,24,15,26400,16500,42900
316110,202102,1877,1481,396,1631300.5,436700,2068000.5
316120,202102,77,54,23,59400,26400,85800
316130,202102,122,91,31,100100,34100,134200
316140,202102,31,19,12,20900,13200,34100
316150,202102,209,145,64,159500,70400,229900
316160,202102,81,47,34,51700,37400,89100
316165,202102,64,45,19,49500,20900,70400
316170,202102,181,119,62,130900,68200,199100
316180,202102,198,83,115,91300,126500,217800
316190,202102,130,92,38,101200,41800,143000
316200,202102,669,358,311,393800,342100,735900
316210,202102,772,511,261,562289.2,287100,849389.2
316220,202102,120,79,41,86900,45100,132000
316225,202102,30,17,13,18700,14300,33000
316230,202102,35,18,17,19800,18700,38500
316240,202102,654,521,133,573100,146300,719400
316245,202102,135,117,18,128700,19800,148500
316250,202102,1533,1037,496,1140700,545600,1686300
316255,202102,127,101,26,111100,28600,139700
316257,202102,177,92,85,101200,93500,194700
316260,202102,193,137,56,150700,61600,212300
316265,202102,28,19,9,20900,9900,30800
316270,202102,685,481,204,529100,224400,753500
316280,202102,550,341,209,376200.63,229900,606100.63
316290,202102,749,489,260,537900,286000,823900
316292,202102,523,209,314,229900,346500,576400
316294,202102,104,65,39,71500,42900,114400
316295,202102,311,131,180,144100,198000,342100
316300,202102,107,69,38,75900,41800,117700
316310,202102,27,14,13,15400,14300,29700
316320,202102,52,27,25,29700,27500,57200
316330,202102,165,112,53,123200,58300,181500
316340,202102,133,88,45,96800,49500,146300
316350,202102,188,132,56,145200,61600,206800
316360,202102,23,15,8,16500,8800,25300
316370,202102,1125,567,558,623700,613800,1237500
316380,202102,112,84,28,92400,30800,123200
316390,202102,110,77,33,84700,36300,121000
316400,202102,133,103,30,113300,33000,146300
316410,202102,305,221,84,243100,92400,335500
316420,202102,203,134,69,147400,75900,223300
316430,202102,151,78,73,85800,80300,166100
316440,202102,86,42,44,46200,48400,94600
316443,202102,37,35,2,38500,2200,40700
316447,202102,48,36,12,39600,13200,52800
316450,202102,220,169,51,185900,56100,242000
316460,202102,80,29,51,31900,56100,88000
316470,202102,1669,1218,451,1341989.65,496100,1838089.65
316480,202102,11,8,3,8800,3300,12100
316490,202102,20,6,14,6600,15400,22000
316500,202102,157,106,51,116600,56100,172700
316510,202102,151,114,37,125400,40700,166100
316520,202102,193,113,80,124300,88000,212300
316530,202102,166,106,60,116600,66000,182600
316540,202102,146,75,71,82500,78100,160600
316550,202102,144,92,52,101200,57200,158400
316553,202102,307,136,171,149600,188100.72,337700.72
316555,202102,47,39,8,42900,8800,51700
316556,202102,13,9,4,9900,4400,14300
316557,202102,22,18,4,19800,4400,24200
316560,202102,66,45,21,49500,23100,72600
316570,202102,217,197,20,216700,22000,238700
316580,202102,21,14,7,15400,7700,23100
316590,202102,101,84,17,92400,18700,111100
316600,202102,171,140,31,154000,34100,188100
316610,202102,63,48,15,52800,16500,69300
316620,202102,137,99,38,108900,41800,150700
316630,202102,39,30,9,33000,9900,42900
316640,202102,22,14,8,15400,8800,24200
316650,202102,76,61,15,67100,16500,83600
316660,202102,7,2,5,2200,5500,7700
316670,202102,436,151,285,166100,313500,479600
316680,202102,154,108,46,118800,50600,169400
316690,202102,182,114,68,125400,74800,200200
316695,202102,59,50,9,55000,9900,64900
316700,202102,18,12,6,13200,6600,19800
316710,202102,774,582,192,642400,211200,853600
316720,202102,5028,2438,2590,2682900,2849000,5531900
316730,202102,16,16,0,17600,0,17600
316740,202102,139,90,49,99000,53900,152900
316750,202102,17,11,6,12100,6600,18700
316760,202102,316,254,62,279400,68200,347600
316770,202102,159,85,74,93500,81400,174900
316780,202102,66,41,25,45100,27500,72600
316790,202102,55,39,16,42900,17600,60500
316800,202102,1774,1099,675,1208900,742500,1951400
316805,202102,23,17,6,18700,6600,25300
316810,202102,65,40,25,44000,28600,72600
316820,202102,40,21,19,23100,20900,44000
316830,202102,97,44,53,48400,58300,106700
316840,202102,517,300,217,330000,239800,569800
316850,202102,320,212,108,234300,118800,353100
316860,202102,5915,2603,3312,2865500,3644300,6509800
316870,202102,1557,997,560,1097800,616000,1713800
316880,202102,128,61,67,67100,73700,140800
316890,202102,240,165,75,181500,82500,264000
316900,202102,414,288,126,316800,138600,455400
316905,202102,21,11,10,12100,11000,23100
316910,202102,67,28,39,30800,42900,73700
316920,202102,139,108,31,118800,34100,152900
316930,202102,1896,959,937,1056000,1031800,2087800
316935,202102,906,537,369,591800,405900,997700
316940,202102,1088,610,478,672100,525800,1197900
316950,202102,180,88,92,96800,101200,198000
316960,202102,1100,613,487,674300,537900,1212200
316970,202102,650,516,134,567600,147400,715000
316980,202102,74,41,33,45100,36300,81400
316990,202102,2152,1431,721,1574100,794200.84,2368300.84
317000,202102,332,254,78,279400,85800,365200
317005,202102,232,160,72,176000,79200,255200
317010,202102,6393,3536,2857,3892900,3146000,7038900
317020,202102,15907,6963,8944,7661500.85,9839500.4,17501001.25
317030,202102,77,29,48,31900,52800,84700
317040,202102,3053,1914,1139,2107600,1254000,3361600
317043,202102,68,50,18,55000,19800,74800
317047,202102,36,19,17,20900,18700,39600
317050,202102,159,119,40,130900,44000,174900
317052,202102,141,109,32,119900,35200,155100
317057,202102,168,128,40,140800,44000,184800
317060,202102,61,38,23,41800,25300,67100
317065,202102,49,38,11,41800,12100,53900
317070,202102,1937,892,1045,982300,1150600,2132900
317075,202102,99,53,46,58300,50600,108900
317080,202102,908,462,446,508200,491700,999900
317090,202102,680,536,144,589600,158400,748000
317100,202102,416,311,105,342100,115500,457600
317103,202102,109,86,23,94600,25300,119900
317107,202102,44,38,6,41800,6600,48400
317110,202102,114,50,64,55000,70400,125400
317115,202102,40,36,4,39600,4400,44000
317120,202102,1930,916,1014,1010900,1116500,2127400
317130,202102,1968,1308,660,1438800,727100,2165900
317140,202102,9,8,1,8800,1100,9900
317150,202102,267,158,109,173800,119900,293700
317160,202102,318,237,81,260700.63,89100,349800.63
317170,202102,223,150,73,165000,80300,245300
317180,202102,445,300,145,330000,159500,489500
317190,202102,264,187,77,205700,84700,290400
317200,202102,821,567,254,624800,279400,904200
317210,202102,182,99,83,108900,91300,200200
317220,202102,24,13,11,14300,12100,26400
320010,202102,591,424,167,466400,183700,650100
320013,202102,120,84,36,92400,39600,132000
320016,202102,264,170,94,187000,103400,290400
320020,202102,719,417,302,458700.5,332200,790900.5
320030,202102,154,109,45,119900.06,49500.08,169400.14
320035,202102,137,98,39,107800,42900,150700
320040,202102,500,256,244,281600,268400,550000
320050,202102,107,77,30,84700,33000,117700
320060,202102,1706,811,895,892100,984500,1876600
320070,202102,96,60,36,66000,39600,105600
320080,202102,800,462,338,508200,372900,881100
320090,202102,1250,827,423,909700,465300,1375000
320100,202102,327,190,137,209000,150700,359700
320110,202102,122,78,44,85800,49500,135300
320115,202102,112,93,19,102300,20900,123200
320120,202102,3549,1867,1682,2054800,1850200.74,3905000.74
320130,202102,7510,3378,4132,3719100.5,4548500,8267600.5
320140,202102,432,281,151,309100,167200.81,476300.81
320150,202102,2051,1142,909,1258400,999900,2258300
320160,202102,658,295,363,324500,399300,723800
320170,202102,109,86,23,94600.1,25300.02,119900.12
320180,202102,55,32,23,35200,25300,60500
320190,202102,240,154,86,169400,94600,264000
320200,202102,57,42,15,46200,16500,62700
320210,202102,903,491,412,540100,453200,993300
320220,202102,294,102,192,112200,211200,323400
320225,202102,86,67,19,73700,20900,94600
320230,202102,623,390,233,429000,256300,685300
320240,202102,3357,1611,1746,1772100,1922800,3694900
320245,202102,478,323,155,355300,170500,525800
320250,202102,228,116,112,127600,124300,251900
320255,202102,131,103,28,113300,30800,144100
320260,202102,219,136,83,149600.2,91300.12,240900.32
320265,202102,148,112,36,123200,39600,162800
320270,202102,148,115,33,126500,36300,162800
320280,202102,1136,645,491,709500.5,540100.02,1249600.52
320290,202102,56,48,8,52800,8800,61600
320300,202102,588,401,187,441100.02,205700,646800.02
320305,202102,676,351,325,386100,357500,743600
320310,202102,199,114,85,125400,93500,218900
320313,202102,342,162,180,178200,198000,376200
320316,202102,109,82,27,90200,29700,119900
320320,202102,3407,1508,1899,1659900,2091100,3751000
320330,202102,260,194,66,213400,72600,286000
320332,202102,768,461,307,507100,337700,844800
320334,202102,248,140,108,154000.02,118800,272800.02
320335,202102,145,97,48,106700,52800,159500
320340,202102,564,388,176,426800,193600,620400
320350,202102,1017,422,595,465300.5,654500,1119800.5
320360,202102,160,83,77,91300,84700,176000
320370,202102,241,179,62,196900,68200,265100
320380,202102,287,198,89,217800,97900,315700
320390,202102,1147,682,465,750200,511500,1261700
320400,202102,318,227,91,249700,100100,349800
320405,202102,960,387,573,425700,630300,1056000
320410,202102,953,482,471,530200,518100,1048300
320420,202102,519,249,270,273900,297000,570900
320425,202102,188,100,88,111100,96800,207900
320430,202102,394,211,183,232100,201300,433400
320435,202102,157,104,53,114400,58300,172700
320440,202102,198,115,83,126500.28,91300.2,217800.48
320450,202102,129,72,57,79200,62700,141900
320455,202102,249,199,50,218900,55000,273900
320460,202102,282,167,115,183700,126500,310200
320465,202102,113,75,38,82500,41800,124300
320470,202102,699,423,276,465300,303600,768900
320480,202102,198,126,72,138600,79200,217800
320490,202102,3055,1489,1566,1639001.23,1722601.3,3361602.53
320495,202102,110,66,44,72600,48400,121000
320500,202102,9598,4654,4944,5122700,5439500,10562200
320501,202102,540,271,269,298100,295900,594000
320503,202102,294,207,87,227700.1,95700.02,323400.12
320506,202102,261,182,79,200200,86900,287100
320510,202102,1064,474,590,521400,649000,1170400
320515,202102,82,62,20,68200,22000,90200
320517,202102,216,155,61,170500,67100,237600
320520,202102,7016,2975,4041,3276900,4446200,7723100
320530,202102,6306,3088,3218,3396781.76,3543100,6939881.76
330010,202102,3084,1531,1553,1684100.17,1708300,3392400.17
330015,202102,171,68,103,74800,113300,188100
330020,202102,3736,1524,2212,1677500,2433200,4110700
330022,202102,250,128,122,140800,134200,275000
330023,202102,655,207,448,227700,492800,720500
330025,202102,585,113,472,124300,519200,643500
330030,202102,1867,1154,713,1271600.5,784300,2055900.5
330040,202102,2432,1217,1215,1338700,1337600.5,2676300.5
330045,202102,9205,2745,6460,3021700.5,7114800,10136500.5
330050,202102,876,555,321,610500,353100,963600
330060,202102,1021,603,418,663300,459800,1123100
330070,202102,3810,1321,2489,1456400,2739000,4195400
330080,202102,1580,680,900,748000,990000,1738000
330090,202102,392,225,167,247500,183700,431200
330093,202102,264,114,150,125400,165000,290400
330095,202102,77,45,32,49500,35200,84700
330100,202102,9930,4917,5013,5410900.5,5517600,10928500.5
330110,202102,469,195,274,214500,301400,515900
330115,202102,513,271,242,298100,266200,564300
330120,202102,382,189,193,207900,212300,420200
330130,202102,1569,383,1186,421300,1305700,1727000
330140,202102,612,320,292,352000,321200,673200
330150,202102,512,290,222,319000,245300,564300
330160,202102,205,121,84,133100,92400,225500
330170,202102,27072,9003,18069,9907700,19885800,29793500
330180,202102,236,139,97,152900,106700,259600
330185,202102,980,347,633,382800,696300,1079100
330187,202102,404,122,282,134200,310200,444400
330190,202102,5891,2194,3697,2415600,4066700,6482300
330200,202102,4681,1392,3289,1531200.86,3617900,5149100.86
330205,202102,440,251,189,276100,207900,484000
330210,202102,946,575,371,632500,408100,1040600
330220,202102,2683,1565,1118,1721500,1232000,2953500
330225,202102,566,285,281,313500,309100,622600
330227,202102,2424,723,1701,795300,1872200,2667500
330230,202102,261,145,116,159500,127600,287100
330240,202102,3859,1895,1964,2086700,2164800,4251500
330245,202102,149,65,84,71500,92400,163900
330250,202102,6642,3288,3354,3622300,3694900,7317200
330260,202102,613,154,459,169400,504900,674300
330270,202102,3646,1198,2448,1318900,2693900,4012800
330280,202102,442,281,161,310200,177100,487300
330285,202102,6933,2121,4812,2333100,5298700,7631800
330290,202102,667,237,430,260700,473000,733700
330300,202102,769,497,272,547375.6,299200,846575.6
330310,202102,435,239,196,262900,215600,478500
330320,202102,7977,2855,5122,3144900,5636497.9,8781397.9
330330,202102,9130,3343,5787,3679500.02,6367900,10047400.02
330340,202102,2661,1535,1126,1688500,1239700,2928200
330350,202102,18635,6900,11735,7596600,12916200.5,20512800.5
330360,202102,2192,1040,1152,1145100,1270500,2415600
330370,202102,1015,499,516,548900,567600,1116500
330380,202102,911,375,536,412500,590700.01,1003200.01
330385,202102,629,320,309,352000,341000,693000
330390,202102,5649,2900,2749,3192200,3027200.29,6219400.29
330395,202102,313,183,130,201300,143000,344300
330400,202102,708,368,340,405900,374000,779900
330410,202102,500,361,139,397100,152900,550000
330411,202102,258,136,122,149600,134200,283800
330412,202102,225,88,137,96800,150700,247500
330414,202102,5324,2111,3213,2323200,3537600,5860800
330415,202102,608,264,344,290400,378400,668800
330420,202102,2217,1104,1113,1215500,1224300,2439800
330430,202102,1772,783,989,861300,1089000,1950300
330440,202102,299,135,164,148500,180400,328900
330450,202102,118,50,68,55000,74800,129800
330452,202102,2104,910,1194,1001000,1313400,2314400
330455,202102,113974,38821,75153,42737293.86,82754103.24,125491397.10
330460,202102,252,109,143,119900,157300,277200
330470,202102,1220,660,560,726000,616000,1342000
330475,202102,1573,411,1162,452100,1279300,1731400
330480,202102,820,442,378,486200,415800,902000
330490,202102,14868,4654,10214,5121705,11243100,16364805
330500,202102,1412,600,812,660000,893200,1553200
330510,202102,10850,3693,7157,4067800.93,7881500,11949300.93
330513,202102,97,49,48,53900,52800,106700
330515,202102,779,319,460,350900,506000,856900
330520,202102,2521,867,1654,954800,1819400,2774200
330530,202102,201,113,88,124300,96800,221100
330540,202102,358,177,181,194700,199100,393800
330550,202102,2914,987,1927,1085700,2120800,3206500
330555,202102,802,312,490,343200,539000,882200
330560,202102,693,227,466,250800,513700,764500
330570,202102,273,193,80,212300,88000,300300
330575,202102,801,279,522,308000,574200,882200
330580,202102,3376,1854,1522,2040500.5,1676400,3716900.5
330590,202102,275,143,132,157300.5,145200,302500.5
330600,202102,1190,734,456,808500,502700,1311200
330610,202102,1566,836,730,919600,804100,1723700
330615,202102,218,169,49,185900,53900,239800
330620,202102,1091,406,685,447700,753500,1201200
330630,202102,4098,2492,1606,2746701.05,1767700,4514401.05
350010,202102,574,380,194,418000.88,213400,631400.88
350020,202102,57,22,35,24200,38500,62700
350030,202102,511,318,193,349800,212300,562100
350040,202102,125,52,73,57200,80300,137500
350050,202102,321,166,155,182600,170500,353100
350055,202102,106,51,55,56100,60500,116600
350060,202102,87,31,56,34100,61600,95700
350070,202102,775,452,323,497200.2,355300,852500.2
350075,202102,72,47,25,51700,27500,79200
350080,202102,57,27,30,29700,33000,62700
350090,202102,81,46,35,50600,38500,89100
350100,202102,279,170,109,187000,119900,306900
350110,202102,59,42,17,46200,18700,64900
350115,202102,145,89,56,97900,61600,159500
350120,202102,105,66,39,72600,42900,115500
350130,202102,368,160,208,176000.56,228800,404800.56
350140,202102,41,25,16,27500,17600,45100
350150,202102,77,57,20,62700,22000,84700
350160,202102,2412,949,1463,1043900,1610400,2654300
350170,202102,386,220,166,243100,183700,426800
350180,202102,161,91,70,101200,77000,178200
350190,202102,1000,527,473,580800.63,520300,1101100.63
350200,202102,70,26,44,28600,48400,77000
350210,202102,1296,708,588,778800,646800.63,1425600.63
350220,202102,652,535,117,588500.63,128700,717200.63
350230,202102,72,47,25,51700,27500,79200
350240,202102,59,42,17,46200,18700,64900
350250,202102,1150,540,610,596200,672100,1268300
350260,202102,94,67,27,73700,29700,103400
350270,202102,883,593,290,652300,319000,971300
350275,202102,290,120,170,133100,187000,320100
350280,202102,4522,2273,2249,2502500,2475000,4977500
350290,202102,453,199,254,220000,279400,499400
350300,202102,55,28,27,30800,29700,60500
350310,202102,81,52,29,57200,31900,89100
350315,202102,60,28,32,30800,35200,66000
350320,202102,3321,1602,1719,1762200,1893100,3655300
350330,202102,1651,869,782,955901.26,860200,1816101.26
350335,202102,17,12,5,13200,5500,18700
350340,202102,124,54,70,59400,77000,136400
350350,202102,92,46,46,50600,50600,101200
350360,202102,108,71,37,78100,40700,118800
350370,202102,80,45,35,49500.63,38500,88000.63
350380,202102,778,325,453,357500,499400,856900
350390,202102,1628,600,1028,660000.5,1131900,1791900.5
350395,202102,23,19,4,20900,4400,25300
350400,202102,1688,835,853,920701.89,939400.63,1860102.52
350410,202102,2764,1162,1602,1278200,1765520.63,3043720.63
350420,202102,254,152,102,167200,112200,279400
350430,202102,73,41,32,45100,35200,80300
350440,202102,153,110,43,121000,47300,168300
350450,202102,1689,972,717,1069201.13,788700,1857901.13
350460,202102,403,135,268,148500,295900,444400
350470,202102,20,11,9,12100,9900,22000
350480,202102,176,97,79,106700,86900,193600
350490,202102,236,110,126,121000,138600,259600
350500,202102,53,22,31,24200,34100,58300
350510,202102,167,105,62,116600,68200,184800
350520,202102,439,230,209,253000,231000,484000
350530,202102,437,197,240,217213.33,265100,482313.33
350535,202102,82,62,20,68200,22000,90200
350540,202102,371,189,182,207900,200200,408100
350550,202102,2646,1523,1123,1675300.77,1237501.26,2912802.03
350560,202102,593,407,186,447700,204600,652300
350570,202102,4184,1714,2470,1886500.63,2722501.27,4609001.90
350580,202102,359,174,185,192500,203500,396000
350590,202102,932,503,429,553300,473000,1026300
350600,202102,6073,2869,3204,3159200.46,3527700,6686900.46
350610,202102,1494,770,724,848100.63,796400,1644500.63
350620,202102,27,17,10,18700,11000,29700
350630,202102,244,137,107,150700.63,118800.63,269501.26
350635,202102,981,387,594,425700,653400,1079100
350640,202102,120,91,29,100100,31900,132000
350650,202102,1852,1235,617,1359600,678700,2038300
350660,202102,748,310,438,341000,481800,822800
350670,202102,305,151,154,166100,169400,335500
350680,202102,174,89,85,97900,93500,191400
350690,202102,193,90,103,99000,113300,212300
350700,202102,801,383,418,421300,459800,881100
350710,202102,380,137,243,150700,267300,418000
350715,202102,55,43,12,47300,13200,60500
350720,202102,18,12,6,13200,6600,19800
350730,202102,45,28,17,30800,18700,49500
350740,202102,217,125,92,137500,101200,238700
350745,202102,24,9,15,9900,16500,26400
350750,202102,2223,1346,877,1480600,964700,2445300
350760,202102,3733,1557,2176,1714900.26,2396900,4111800.26
350770,202102,57,40,17,44000,18700,62700
350775,202102,43,30,13,33000,14300,47300
350780,202102,424,212,212,233200,233200,466400
350790,202102,365,151,214,166100,235400,401500
350800,202102,480,282,198,310200,218900,529100
350810,202102,517,411,106,452100,116600,568700
350820,202102,91,53,38,58300,41800,100100
350830,202102,72,36,36,40700,39600,80300
350840,202102,766,299,467,328900,514800,843700
350850,202102,1722,932,790,1026300,871200,1897500
350860,202102,605,331,274,364100,301400,665500
350870,202102,435,286,149,314600,163900,478500
350880,202102,285,158,127,173800,139700,313500
350890,202102,39,24,15,26400,16500,42900
350900,202102,1481,455,1026,500500,1129700.63,1630200.63
350910,202102,26,15,11,16500,12100,28600
350920,202102,700,360,340,396000,374000,770000
350925,202102,1178,624,554,688600,609400.63,1298000.63
350930,202102,100,60,40,66000,44000,110000
350940,202102,731,398,333,437800,367400,805200
350945,202102,112,81,31,89100,34100,123200
350950,202102,16392,7505,8887,8263200.63,9788900,18052100.63
350960,202102,1434,618,816,680900,897600,1578500
350970,202102,1076,552,524,607081.2,576400,1183481.2
350980,202102,96,64,32,70400,35200,105600
350990,202102,377,134,243,147400,267300,414700
350995,202102,38,18,20,19800,22000,41800
351000,202102,628,423,205,465300.63,225500,690800.63
351010,202102,54,33,21,36300,23100,59400
351015,202102,49,33,16,36300,17600,53900
351020,202102,1557,934,623,1029600,686400,1716000
351030,202102,334,208,126,228800,138600,367400
351040,202102,897,447,450,491700,495000.2,986700.2
351050,202102,3318,1480,1838,1630200,2021800,3652000
351060,202102,5325,2003,3322,2203300,3656400,5859700
351070,202102,398,254,144,279400.63,158400,437800.63
351080,202102,719,520,199,572000,218900,790900
351090,202102,52,24,28,26400,30800,57200
351100,202102,424,235,189,258500,207900,466400
351110,202102,2008,944,1064,1039501.13,1171500,2211001.13
351120,202102,66,35,31,38500,35200,73700
351130,202102,185,60,125,66000,137500,203500
351140,202102,320,208,112,228800,123200,352000
351150,202102,431,221,210,243100,231000,474100
351160,202102,276,177,99,194700.4,108900,303600.4
351170,202102,184,96,88,105600,96800,202400
351190,202102,86,61,25,67100,27500,94600
351200,202102,367,236,131,259600,144100,403700
351210,202102,114,52,62,57200,69300,126500
351220,202102,530,317,213,348701.18,234300,583001.18
351230,202102,263,182,81,200200,90200,290400
351240,202102,241,112,129,123200,141900,265100
351250,202102,79,54,25,59400.5,27500,86900.5
351260,202102,153,112,41,123200,45100,168300
351270,202102,46,18,28,19800,30800,50600
351280,202102,1015,463,552,509300.63,608300.63,1117601.26
351290,202102,241,107,134,117700,147400,265100
351300,202102,3739,1632,2107,1795113.6,2317700,4112813.6
351310,202102,741,364,377,400400,414700,815100
351320,202102,113,64,49,70400,53900,124300
351330,202102,37,25,12,27500,13200,40700
351340,202102,1259,735,524,808500,577500,1386000
351350,202102,2325,1326,999,1459700.17,1101100,2560800.17
351360,202102,781,371,410,408100,452100,860200
351370,202102,378,192,186,211200,204600,415800
351380,202102,8887,3918,4969,4315300,5468100.63,9783400.63
351385,202102,27,17,10,18700,11000,29700
351390,202102,278,212,66,233200,72600,305800
351400,202102,64,39,25,42900,27500,70400
351410,202102,430,265,165,291500.55,181500,473000.55
351420,202102,71,51,20,56100,22000,78100
351430,202102,74,42,32,46200,35200,81400
351440,202102,775,531,244,585201.26,268400,853601.26
351450,202102,261,126,135,138600,148500,287100
351460,202102,128,55,73,60500,80300,140800
351470,202102,143,79,64,86900,70400,157300
351480,202102,483,280,203,308000.63,223300,531300.63
351490,202102,286,105,181,115500,199100,314600
351492,202102,24,17,7,18700,7700,26400
351495,202102,28,19,9,20900,9900,30800
351500,202102,3506,1436,2070,1580700,2277000,3857700
351510,202102,1951,737,1214,810700,1335400,2146100
351512,202102,16,12,4,14300,4400,18700
351515,202102,182,106,76,116600,83600,200200
351518,202102,711,446,265,491700,291500,783200
351519,202102,77,44,33,48400,36300,84700
351520,202102,150,89,61,97900,67119.8,165019.8
351530,202102,26,15,11,16500,12100,28600
351535,202102,132,82,50,90200,55000,145200
351540,202102,462,323,139,355300,152900,508200
351550,202102,1408,817,591,898701.26,651200,1549901.26
351560,202102,76,44,32,48400,35200,83600
351565,202102,13,8,5,8800,5500,14300
351570,202102,2679,1282,1397,1413500,1537800,2951300
351580,202102,38,33,5,36300,5500,41800
351590,202102,59,38,21,41800,23100,64900
351600,202102,188,132,56,146300,61600,207900
351610,202102,47,21,26,23100,28600,51700
351620,202102,5797,3184,2613,3510100.82,2876500,6386600.82
351630,202102,2864,1390,1474,1529000,1624700,3153700
351640,202102,2042,900,1142,991100.55,1259500.63,2250601.18
351650,202102,29,25,4,27500,4400,31900
351660,202102,132,85,47,93500,51700,145200
351670,202102,706,434,272,477400,299200,776600
351680,202102,65,54,11,59400,12100,71500
351685,202102,13,10,3,11000,3300,14300
351690,202102,293,198,95,217800.5,104500,322300.5
351700,202102,169,113,56,124300,61600,185900
351710,202102,70,45,25,49500,27500,77000
351720,202102,128,73,55,80300,60500,140800
351730,202102,105,66,39,72600,42900,115500
351740,202102,714,451,263,496100.74,289300,785400.74
351750,202102,350,140,210,154000,231000,385000
351760,202102,750,571,179,628100,196900,825000
351770,202102,304,251,53,277200.63,58300,335500.63
351780,202102,163,95,68,104500,74800,179300
351790,202102,246,128,118,140800,129800,270600
351800,202102,40,25,15,27500,16500,44000
351810,202102,117,78,39,85800,42900,128700
351820,202102,804,578,226,636900,248600,885500
351830,202102,554,189,365,207900,401500,609400
351840,202102,1950,923,1027,1016400,1130800,2147200
351850,202102,234,166,68,182600,74800,257400
351860,202102,641,444,197,488400,216700,705100
351870,202102,5528,2543,2985,2798402.12,3286801.46,6085203.58
351880,202102,19705,7809,11896,8597600.63,13096600,21694200.63
351885,202102,83,51,32,56100,35200,91300
351890,202102,70,56,14,61600,15400,77000
351900,202102,231,132,99,145200,108900,254100
351905,202102,88,36,52,39600,57200,96800
351907,202102,3473,1405,2068,1545500,2277000,3822500
351910,202102,174,72,102,79200,113300,192500
351920,202102,111,59,52,64900,57200,122100
351925,202102,89,57,32,62700,35200,97900
351930,202102,380,244,136,268400,149600,418000
351940,202102,232,96,136,105600,149600,255200
351950,202102,138,72,66,79200,72600,151800
351960,202102,919,458,461,504144.93,507100,1011244.93
351970,202102,1948,1001,947,1102200,1043900,2146100
351980,202102,155,68,87,75900,96800,172700
351990,202102,256,163,93,179300,102300,281600
352000,202102,324,206,118,226600,129800,356400
352010,202102,388,237,151,260771,166100,426871
352020,202102,183,71,112,78100,123200,201300
352030,202102,1098,551,547,606100,601700,1207800
352040,202102,577,240,337,264000,370700,634700
352042,202102,277,72,205,79200,225500,304700
352044,202102,348,213,135,234300,148500,382800
352050,202102,3201,1198,2003,1318900.63,2204400,3523300.63
352060,202102,104,63,41,69300,45100,114400
352070,202102,90,67,23,73701.26,25300,99001.26
352080,202102,62,40,22,44000,24200,68200
352090,202102,156,103,53,113300,58300,171600
352100,202102,286,137,149,150700,163900,314600
352110,202102,116,37,79,40700,86900,127600
352115,202102,61,21,40,23100,44000,67100
352120,202102,77,52,25,57200.63,27500,84700.63
352130,202102,219,179,40,196900,45100,242000
352140,202102,183,85,98,93500,107800,201300
352150,202102,119,61,58,67100,63800,130900
352160,202102,135,87,48,95700,52800,148500
352170,202102,381,258,123,283800,135300,419100
352180,202102,638,393,245,432300.63,270600,702900.63
352190,202102,241,98,143,107800,157300,265100
352200,202102,30,14,16,15400,17600,33000
352210,202102,4161,1662,2499,1829300.95,2751100,4580400.95
352215,202102,65,38,27,41800,29700,71500
352220,202102,6605,2438,4167,2682900,4591400.63,7274300.63
352230,202102,3313,2130,1183,2347401.13,1303500.42,3650901.55
352240,202102,2505,1434,1071,1579601.13,1179200,2758801.13
352250,202102,2815,1322,1493,1457501.26,1643400,3100901.26
352260,202102,973,510,463,562100,510400,1072500
352265,202102,57,30,27,33000,29700,62700
352270,202102,385,217,168,238700,184800,423500
352280,202102,467,277,190,304701.26,209000,513701.26
352290,202102,178,104,74,114400,81400,195800
352300,202102,96,65,31,71500,34100,105600
352310,202102,6485,2832,3653,3116301.36,4019400,7135701.36
352320,202102,1066,549,517,603900,568700,1172600
352330,202102,521,252,269,278300,295900,574200
352340,202102,1351,608,743,669900,819500,1489400
352350,202102,342,197,145,216700,159500,376200
352360,202102,220,96,124,105600,136400,242000
352370,202102,106,68,38,74800,41800,116600
352380,202102,110,75,35,82500,38500,121000
352390,202102,2517,1093,1424,1202300,1569700,2772000
352400,202102,500,219,281,240900,311300,552200
352410,202102,856,589,267,647900.63,293700,941600.63
352420,202102,93,66,27,72600,29700,102300
352430,202102,1747,786,961,865702.52,1059301.26,1925003.78
352440,202102,3231,1568,1663,1724800,1830400,3555200
352450,202102,199,160,39,176000,42900,218900
352460,202102,627,314,313,345400,344300,689700
352470,202102,651,221,430,243100,473000,716100
352480,202102,1417,772,645,849200,710600,1559800
352490,202102,67,23,44,25300,48400,73700
352500,202102,1232,516,716,568700,787600,1356300
352510,202102,709,376,333,413600.63,366300,779900.63
352520,202102,733,321,412,353247.4,453200,806447.4
352530,202102,1746,908,838,999900,922900,1922800
352540,202102,71,46,25,50600,27500,78100
352550,202102,193,114,79,125400,86950.6,212350.6
352560,202102,49,39,10,42900,11000,53900
352570,202102,685,334,351,367400.63,387200,754600.63
352580,202102,59,44,15,48400,16500,64900
352585,202102,20,6,14,6600,15400,22000
352590,202102,4314,2117,2197,2341900.63,2423300,4765200.63
352600,202102,345,243,102,267300,112200,379500
352610,202102,917,418,499,459800.5,548900,1008700.5
352620,202102,1035,395,640,434500,704000,1138500
352630,202102,181,66,115,72600,126500,199100
352640,202102,519,339,180,372900,198000,570900
352650,202102,79,60,19,66000,20900,86900
352660,202102,62,37,25,40700,27500,68200
352670,202102,1675,875,800,962500.6,881100,1843600.6
352680,202102,910,563,347,621500,381700,1003200
352690,202102,4507,2006,2501,2208802.07,2753300.63,4962102.70
352700,202102,96,56,40,61600,44000,105600
352710,202102,1408,732,676,805420,743600,1549020
352720,202102,1406,634,772,698500,849200,1547700
352725,202102,22,18,4,19800,4400,24200
352730,202102,377,184,193,202400,212300,414700
352740,202102,410,265,145,291500,160600.8,452100.8
352750,202102,19,13,6,14300,6600,20900
352760,202102,186,118,68,129800,74800,204600
352770,202102,87,65,22,71500,24200,95700
352780,202102,78,42,36,46200,39600,85800
352790,202102,26,20,6,22000,6600,28600
352800,202102,234,175,59,193600,64900,258500
352810,202102,154,96,58,105600,63800,169400
352820,202102,50,39,11,42900,12100,55000
352830,202102,74,50,24,55000,26400,81400
352840,202102,659,318,341,349800,375100,724900
352850,202102,1580,505,1075,555500,1183600,1739100
352860,202102,115,74,41,81400,45100,126500
352870,202102,46,30,16,33000,17600,50600
352880,202102,182,116,66,127600,72600,200200
352885,202102,33,21,12,23100,13200,36300
352890,202102,55,36,19,39600,20900,60500
352900,202102,4672,2226,2446,2448600,2690600,5139200
352910,202102,38,31,7,34100,7700,41800
352920,202102,651,385,266,423500,292600,716100
352930,202102,1222,581,641,639100,706200,1345300
352940,202102,6049,2432,3617,2679600,3982000,6661600
352950,202102,115,39,76,42900,83600,126500
352960,202102,62,38,24,41800,26400,68200
352965,202102,18,9,9,9900,9900,19800
352970,202102,512,389,123,427900.35,135300,563200.35
352980,202102,158,85,73,93500,80300,173800
352990,202102,980,455,525,500500,578600,1079100
353000,202102,58,25,33,27500,36300,63800
353010,202102,541,332,209,365200,229900,595100
353020,202102,309,223,86,245300,94600,339900
353030,202102,1257,560,697,617100,766700,1383800
353040,202102,90,52,38,57200,41800,99000
353050,202102,1299,840,459,924000.9,504900,1428900.9
353060,202102,8416,3569,4847,3929200.71,5335000,9264200.71
353070,202102,1769,1064,705,1173701.26,777504.2,1951205.46
353080,202102,1262,671,591,739200.92,650100,1389300.92
353090,202102,63,33,30,36300,33000,69300
353100,202102,46,36,10,39600,11000,50600
353110,202102,2082,641,1441,705100,1588400,2293500
353120,202102,101,51,50,56100,56100,112200
353130,202102,851,414,437,455401.29,480700,936101.29
353140,202102,545,219,326,240900.63,359700,600600.63
353150,202102,325,182,143,200200.63,157300,357500.63
353160,202102,94,73,21,80300,23100,103400
353170,202102,216,71,145,78100,159500,237600
353180,202102,1096,488,608,536800,668800,1205600
353190,202102,485,351,134,386100,147400,533500
353200,202102,221,104,117,114400,128700,243100
353205,202102,20,13,7,14300,7700,22000
353210,202102,69,39,30,42900,33000,75900
353215,202102,42,23,19,25300,22000,47300
353220,202102,79,43,36,47300,39600,86900
353230,202102,160,61,99,67100,108900,176000
353240,202102,327,164,163,180400,179300,359700
353250,202102,207,99,108,108900,118800,227700
353260,202102,456,308,148,339900,162800,502700
353270,202102,74,54,20,59400,22000,81400
353280,202102,98,48,50,52800,55000,107800
353282,202102,128,91,37,100100,40700,140800
353284,202102,28,21,7,23100,7700,30800
353286,202102,2,0,2,0,2200,2200
353290,202102,79,43,36,47300,39600,86900
353300,202102,436,226,210,249701.26,232100,481801.26
353310,202102,48,40,8,44000,8800,52800
353320,202102,36,21,15,23100,16500,39600
353325,202102,48,28,20,30800,22000,52800
353330,202102,62,44,18,48400,19800,68200
353340,202102,644,230,414,253000,455400,708400
353350,202102,889,422,467,464200,514800,979000
353360,202102,101,81,20,89100,22000,111100
353370,202102,107,62,45,68200,49500,117700
353380,202102,29,15,14,16500,15400,31900
353390,202102,1103,518,585,569800,643500,1213300
353400,202102,42,23,19,25300,22000,47300
353410,202102,110,64,46,70400,50600,121000
353420,202102,58,22,36,25300,39600,64900
353430,202102,572,381,191,419101.13,210100,629201.13
353440,202102,11279,4845,6434,5340500.63,7084000,12424500.63
353450,202102,57,29,28,31900,30800,62700
353460,202102,610,326,284,358600,312400,671000
353470,202102,2161,1105,1056,1216600.6,1161600,2378200.6
353475,202102,244,162,82,179300,90200,269500
353480,202102,182,150,32,165000,35200,200200
353490,202102,235,136,99,149600,110000,259600
353500,202102,203,118,85,129800,94600,224400
353510,202102,92,64,28,70400,30800,101200
353520,202102,208,147,61,161700,67100,228800
353530,202102,463,241,222,265100,244200,509300
353540,202102,381,247,134,271700,147400,419100
353550,202102,714,461,253,507100.93,278300,785400.93
353560,202102,576,233,343,258500,377300,635800
353570,202102,63,36,27,39600,29700,69300
353580,202102,348,250,98,275000,107800,382800
353590,202102,79,59,20,64900,22000,86900
353600,202102,270,158,112,173800.63,123200,297000.63
353610,202102,127,67,60,73700,66000,139700
353620,202102,629,323,306,355300,336600,691900
353625,202102,53,26,27,28600,29700,58300
353630,202102,225,161,64,177100,70400,247500
353640,202102,122,79,43,89100,47300,136400
353650,202102,945,352,593,387200,653400,1040600
353657,202102,24,18,6,19800,6600,26400
353660,202102,273,144,129,158400,141900,300300
353670,202102,751,441,310,487300.63,341000,828300.63
353680,202102,110,79,31,86900,34100,121000
353690,202102,39,29,10,31900,11000,42900
353700,202102,274,191,83,210100,91300,301400
353710,202102,480,226,254,248600,279400,528000
353715,202102,49,31,18,34100,19800,53900
353720,202102,349,156,193,171600,212300,383900
353730,202102,1104,668,436,734800,479600,1214400
353740,202102,610,335,275,369600,302500,672100
353750,202102,75,44,31,48400,34100,82500
353760,202102,3030,1139,1891,1253193.33,2081200.9,3334394.23
353770,202102,82,64,18,71500,19800,91300
353780,202102,1258,590,668,650100.63,734800,1384900.63
353790,202102,495,303,192,333300,212300,545600
353800,202102,3448,1648,1800,1812820,1981174,3793994
353810,202102,232,124,108,137500,118800,256300
353820,202102,208,91,117,100100,128700,228800
353830,202102,53,46,7,50600,7700,58300
353850,202102,177,86,91,94600,100100,194700
353860,202102,511,221,290,243100,320100,563200
353870,202102,5390,2683,2707,2955700,2985400,5941100
353880,202102,685,465,220,512600,242000,754600
353890,202102,544,316,228,347600,250800.59,598400.59
353900,202102,131,68,63,75900,69300,145200
353910,202102,181,80,101,88000,111100,199100
353920,202102,416,228,188,250800,206800,457600
353930,202102,1022,594,428,653400,470800,1124200
353940,202102,192,96,96,105600,105600,211200
353950,202102,505,311,194,342100,213400,555500
353960,202102,78,64,14,71500,15400,86900
353970,202102,42,27,15,29700,16500,46200
353980,202102,1704,765,939,843700,1034000,1877700
353990,202102,71,42,29,46200,31900,78100
354000,202102,382,178,204,195800,224400,420200
354010,202102,89,52,37,57200,40700,97900
354020,202102,504,314,190,346500,209000,555500
354025,202102,36,31,5,34100,5500,39600
354030,202102,48,28,20,30800,22000,52800
354040,202102,96,72,24,79200,26400,105600
354050,202102,175,96,79,105600.63,86900,192500.63
354060,202102,752,362,390,399300,429000,828300
354070,202102,904,505,399,555500,440000,995500
354075,202102,179,82,97,90200,106700,196900
354080,202102,309,130,179,143000,196900,339900
354085,202102,19,13,6,14300,6600,20900
354090,202102,285,167,118,184707,129800,314507
354100,202102,5545,2244,3301,2470600.42,3635500,6106100.42
354105,202102,96,45,51,49500,56100,105600
354110,202102,46,22,24,24200,26400,50600
354120,202102,142,98,44,107800.93,48400,156200.93
354130,202102,709,442,267,486200,293700,779900
354140,202102,3184,1460,1724,1606000.55,1896400,3502400.55
354150,202102,629,372,257,410300.66,282700,693000.66
354160,202102,637,400,237,440000,260700,700700
354165,202102,16,13,3,14300,3300,17600
354170,202102,171,119,52,130900,57200,188100
354180,202102,58,35,23,38500.42,25300,63800.42
354190,202102,189,78,111,85800,122100,207900
354200,202102,109,57,52,62700,57200,119900
354210,202102,63,25,38,27500,41800,69300
354220,202102,641,405,236,445500.63,259600,705100.63
354230,202102,167,71,96,78100,105600,183700
354240,202102,334,214,120,235400.82,132000,367400.82
354250,202102,82,51,31,56100,34100,90200
354260,202102,2104,994,1110,1093400.5,1223200.85,2316601.35
354270,202102,87,64,23,70400,25300,95700
354280,202102,46,23,23,25300,25300,50600
354290,202102,139,97,42,106700,46200,152900
354300,202102,368,258,110,283800.63,121000,404800.63
354310,202102,86,66,20,72600,23100,95700
354320,202102,210,104,106,114400,116600,231000
354323,202102,10,9,1,9900,1100,11000
354325,202102,119,68,51,74800.83,56100,130900.83
354330,202102,2398,804,1594,885343,1756700,2642043
354340,202102,10245,4820,5425,5303968,5976300,11280268
354350,202102,141,90,51,99000,56100,155100
354360,202102,65,35,30,38500,34100,72600
354370,202102,236,122,114,135300,125400,260700
354380,202102,185,110,75,121000,82500,203500
354390,202102,2656,954,1702,1052700,1876600,2929300
354400,202102,297,164,133,180400,146300,326700
354410,202102,624,295,329,325600,361900,687500
354420,202102,265,170,95,187000,104500,291500
354425,202102,307,179,128,196951,140800,337751
354430,202102,185,106,79,116600,86900,203500
354440,202102,33,25,8,27500,8800,36300
354450,202102,51,33,18,36300,19800,56100
354460,202102,96,56,40,61600,44000,105600
354470,202102,32,17,15,18700,16500,35200
354480,202102,113,62,51,68200,57200,125400
354490,202102,139,86,53,94600,58300,152900
354500,202102,391,181,210,199100,231000,430100
354510,202102,91,62,29,68200,31900,100100
354515,202102,37,11,26,12100,28600,40700
354520,202102,1583,667,916,733543,1008700,1742243
354530,202102,786,390,396,429000,435600,864600
354540,202102,261,136,125,149600,137500,287100
354550,202102,35,23,12,25300,13200,38500
354560,202102,150,75,75,82500,82500,165000
354570,202102,136,91,45,100100,49500,149600
354580,202102,1814,849,965,935000,1062600,1997600
354600,202102,260,137,123,150700,135300,286000
354610,202102,72,61,11,67100,12100,79200
354620,202102,61,15,46,16500,50600,67100
354625,202102,14,9,5,9900,5500,15400
354630,202102,295,188,107,206800,117700,324500
354640,202102,799,505,294,555500.63,325600,881100.63
354650,202102,67,38,29,42900,31900,74800
354660,202102,783,582,201,641300.63,221100,862400.63
354670,202102,236,89,147,97900,161700,259600
354680,202102,1269,457,812,502700,893200,1395900
354690,202102,81,55,26,60500,28600,89100
354700,202102,73,52,21,57200,23100,80300
354710,202102,46,32,14,35200,15400,50600
354720,202102,19,19,0,20900,0,20900
354730,202102,1737,715,1022,786500,1125300,1911800
354740,202102,76,51,25,56100,27500,83600
354750,202102,421,240,181,264000,199100,463100
354760,202102,468,281,187,309100,205700,514800
354765,202102,9,4,5,5500,5500,11000
354770,202102,349,228,121,250800,133100,383900
354780,202102,8158,3153,5005,3474901.13,5506600,8981501.13
354790,202102,88,50,38,55000,42900,97900
354800,202102,445,239,206,262804.05,226600,489404.05
354805,202102,90,39,51,42900,56100,99000
354810,202102,111,66,45,72600,49500,122100
354820,202102,205,81,124,90200,136400,226600
354830,202102,43,22,21,24200,23100,47300
354840,202102,57,40,17,44000,18700,62700
354850,202102,4433,1927,2506,2121900.08,2756600.06,4878500.14
354860,202102,331,158,173,173800,190300.63,364100.63
354870,202102,11878,5225,6653,5753001.26,7327100,13080101.26
354880,202102,2692,992,1700,1092300.89,1874451.7,2966752.59
354890,202102,2873,1515,1358,1668701.43,1497100,3165801.43
354900,202102,62,42,20,46200,22000,68200
354910,202102,1254,638,616,701800,677600,1379400
354920,202102,41,33,8,36300,8800,45100
354925,202102,17,7,10,7700,11000,18700
354930,202102,36,32,4,35200.4,4400,39600.4
354940,202102,777,556,221,612975,243100,856075
354950,202102,200,126,74,138600,81400,220000
354960,202102,145,54,91,59400,100100,159500
354970,202102,986,655,331,720501.26,364100,1084601.26
354980,202102,8730,3087,5643,3397902.23,6216100.39,9614002.62
354990,202102,9425,4239,5186,4666200,5707900,10374100
354995,202102,541,169,372,185900,409200,595100
355000,202102,458,157,301,172700,332200,504900
355010,202102,593,361,232,397100,255200.63,652300.63
355020,202102,778,480,298,528000,327800,855800
355030,202102,207455,78410,129045,86326041.99,142061743.9,228387785.89
355040,202102,782,343,439,377300,482900,860200
355050,202102,153,89,64,97900,70400,168300
355060,202102,1616,797,819,878900,902000,1780900
355070,202102,1465,690,775,759000.08,854700.73,1613700.81
355080,202102,190,116,74,127600,81400,209000
355090,202102,283,162,121,178200,133100.57,311300.57
355100,202102,4994,2359,2635,2596990,2899600,5496590
355110,202102,240,159,81,174900,89100,264000
355120,202102,59,38,21,41800,23100,64900
355130,202102,48,27,21,29700,23100,52800
355140,202102,180,107,73,117700,80300,198000
355150,202102,667,386,281,424600,309100,733700
355160,202102,471,228,243,250800.63,269500,520300.63
355170,202102,2027,1047,980,1153900,1079100,2233000
355180,202102,684,284,400,312400,440000,752400
355190,202102,208,137,71,150700,78100,228800
355200,202102,108,60,48,66000,52800,118800
355210,202102,693,383,310,421300,341000,762300
355220,202102,7202,3625,3577,3989700,3942400,7932100
355230,202102,98,60,38,66000,41800,107800
355240,202102,4437,1814,2623,1996501.13,2889700,4886201.13
355250,202102,5861,2553,3308,2809421.06,3641000,6450421.06
355255,202102,50,28,22,30800,24200,55000
355260,202102,179,111,68,122100,74800,196900
355270,202102,170,110,60,121000,66000,187000
355280,202102,6458,2483,3975,2733500,4373600,7107100
355290,202102,73,60,13,66000,14300,80300
355300,202102,198,115,83,126500,91300,217800
355310,202102,109,57,52,62700,57200,119900
355320,202102,92,49,43,53900,47300,101200
355330,202102,276,157,119,172700,130900,303600
355340,202102,1454,501,953,551100.55,1048300,1599400.55
355350,202102,147,70,77,77000,85800,162800
355360,202102,169,110,59,121000,64900,185900
355365,202102,20,16,4,17600,4400,22000
355370,202102,1028,607,421,667700.63,463100,1130800.63
355380,202102,823,514,309,565400,339900,905300
355385,202102,76,51,25,56100,27500,83600
355390,202102,110,60,50,66000,55000,121000
355395,202102,194,105,89,115500.5,97900,213400.5
355400,202102,1723,1013,710,1116409,781000.63,1897409.63
355410,202102,4884,2268,2616,2495900,2883100,5379000
355420,202102,48,34,14,37400,15400,52800
355430,202102,392,243,149,267300,163900,431200
355440,202102,85,50,35,55000,38500,93500
355450,202102,444,217,227,238700,249700,488400
355460,202102,62,48,14,52800,15400,68200
355465,202102,46,27,19,29700,20900,50600
355470,202102,176,72,104,79200,114400,193600
355475,202102,11,7,4,7700,4400,12100
355480,202102,548,221,327,243100,359700,602800
355490,202102,115,81,34,89100,37400,126500
355495,202102,64,24,40,26400,44000,70400
355500,202102,1548,853,695,940500.48,765600,1706100.48
355510,202102,267,195,72,214500.63,81400,295900.63
355520,202102,32,24,8,26400,8800,35200
355530,202102,23,12,11,13200,12100,25300
355535,202102,74,33,41,36300,45100,81400
355540,202102,2501,971,1530,1069355.1,1684100.63,2753455.73
355550,202102,59,37,22,40700,24200,64900
355560,202102,246,115,131,126500,144100,270600
355570,202102,21,13,8,14300,8800,23100
355580,202102,243,171,72,188100,79200,267300
355590,202102,16,10,6,11000,6600,17600
355600,202102,269,136,133,149600,146300,295900
355610,202102,223,148,75,163900,82500,246400
355620,202102,1312,575,737,632500,810700,1443200
355630,202102,425,313,112,344300,123200.63,467500.63
355635,202102,111,51,60,56100,66000,122100
355640,202102,546,309,237,339900,260700,600600
355645,202102,851,331,520,364100,572000,936100
355650,202102,1932,812,1120,895400,1233100,2128500
355660,202102,236,127,109,139700,119900,259600
355670,202102,575,240,335,265100,368500,633600
355680,202102,202,111,91,122100,100100,222200
355690,202102,90,42,48,46200,52800,99000
355695,202102,22,13,9,14300,9900,24200
355700,202102,1135,582,553,640200,608300,1248500
355710,202102,2204,1194,1010,1314500,1114300,2428800
355715,202102,13,11,2,12100,2200,14300
355720,202102,228,137,91,150700,100100,250800
355730,202102,102,59,43,64900,47300,112200
410010,202102,129,106,23,116600,25300,141900
410020,202102,118,90,28,99000,30800,129800
410030,202102,166,92,74,101200,81400,182600
410040,202102,1204,593,611,652300,673200,1325500
410045,202102,37,29,8,31900,8800,40700
410050,202102,482,271,211,298100,232100,530200
410060,202102,274,200,74,220000,81400,301400
410070,202102,296,245,51,269500,56100,325600
410080,202102,173,104,69,115500,75900,191400
410090,202102,72,62,10,68200,11000,79200
410100,202102,290,202,88,223300,96800,320100
410105,202102,46,27,19,29700,20900,50600
410110,202102,331,196,135,215600,148500,364100
410115,202102,35,23,12,25300,13200,38500
410120,202102,420,204,216,224400,237600,462000
410130,202102,52,32,20,35200,22000,57200
410140,202102,3137,1462,1675,1609300.03,1843600.88,3452900.91
410150,202102,2661,1030,1631,1135200,1794100,2929300
410160,202102,504,308,196,338800,215600,554400
410165,202102,48,29,19,31900,20900,52800
410170,202102,179,114,65,125400,71500,196900
410180,202102,2229,1239,990,1362900,1089000,2451900
410185,202102,25,20,5,22000,5500,27500
410190,202102,496,307,189,337700,207900,545600
410200,202102,930,662,268,730400,294800,1025200
410210,202102,613,308,305,338800,335500,674300
410220,202102,46,21,25,23100,27500,50600
410230,202102,149,70,79,77000,86900,163900
410240,202102,741,470,271,518100,298100,816200
410250,202102,370,265,105,291500,115500,407000
410260,202102,298,166,132,182600,146300,328900
410270,202102,29,22,7,24200,7700,31900
410275,202102,57,44,13,48400,14300,62700
410280,202102,319,183,136,201300,149600,350900
410290,202102,248,146,102,160600,112200,272800
410300,202102,80,57,23,62700,25300,88000
410302,202102,23,15,8,16500,8800,25300
410304,202102,34,23,11,25300,12100,37400
410305,202102,215,112,103,123200,113300,236500
410310,202102,217,126,91,138600,100100,238700
410315,202102,44,32,12,35200,13200,48400
410320,202102,141,97,44,106700,48400,155100
410322,202102,31,20,11,22000,12100,34100
410330,202102,183,124,59,136400,64900,201300
410335,202102,104,58,46,63800,50600,114400
410337,202102,45,34,11,37400,12100,49500
410340,202102,39,32,7,35200,7700,42900
410345,202102,206,116,90,128700,99000,227700
410347,202102,46,35,11,38500,12100,50600
410350,202102,241,142,99,156200,108900,265100
410360,202102,459,287,172,315700,189200,504900
410370,202102,2313,960,1353,1057100,1488300,2545400
410380,202102,206,128,78,140800,85800,226600
410390,202102,381,259,122,284900,134200,419100
410395,202102,35,21,14,23100,15400,38500
410400,202102,834,368,466,404800.5,512600,917400.5
410405,202102,88,65,23,71500,25300,96800
410410,202102,28,20,8,22000,8800,30800
410420,202102,1687,786,901,864502.1,992200,1856702.1
410425,202102,179,72,107,80300,117700,198000
410430,202102,2308,1252,1056,1378300,1161600,2539900
410440,202102,379,276,103,304700,113300,418000
410442,202102,355,234,121,257400,133100,390500
410445,202102,429,304,125,334400,137500,471900
410450,202102,398,194,204,213400,224400,437800
410460,202102,531,266,265,292600,291500,584100
410465,202102,232,136,96,149600,105600,255200
410470,202102,245,145,100,159500,110000,269500
410480,202102,6229,2945,3284,3241700.69,3617900,6859600.69
410490,202102,1419,843,576,927300.33,633600,1560900.33
410500,202102,276,158,118,173800,129800,303600
410510,202102,171,126,45,138600,49500,188100
410520,202102,251,186,65,204600,71500,276100
410530,202102,303,103,200,113300,220000,333300
410540,202102,323,239,84,262900,92400,355300
410550,202102,1688,708,980,779900.8,1078000,1857900.8
410560,202102,154,109,45,119900,49500,169400
410570,202102,424,282,142,310200,156200,466400
410580,202102,3478,1478,2000,1625801.54,2202200,3828001.54
410590,202102,396,262,134,288181,147400,435581
410600,202102,192,165,27,181500,29700,211200
410610,202102,50,42,8,46200,8800,55000
410620,202102,248,165,83,181500.4,91300,272800.4
410630,202102,441,243,198,267300,217800,485100
410640,202102,1015,640,375,704000,412500,1116500
410645,202102,110,78,32,85800,35200,121000
410650,202102,357,227,130,249700,143000,392700
410655,202102,91,63,28,69300,30800,100100
410657,202102,29,11,18,12100,19800,31900
410660,202102,605,412,193,453200.5,212300,665500.5
410670,202102,73,61,12,67100,13200,80300
410680,202102,208,164,44,181500,48400,229900
410685,202102,22,15,7,16500,7700,24200
410690,202102,28480,11887,16593,13087800,18273200.74,31361000.74
410700,202102,322,238,84,261800,92400,354200
410710,202102,128,103,25,113300,27500,140800
410712,202102,40,27,13,29700,14300,44000
410715,202102,88,65,23,71500,25300,96800
410720,202102,676,378,298,415800.92,327800,743600.92
410725,202102,179,128,51,140800,56100,196900
410730,202102,94,45,49,49500,53900,103400
410740,202102,107,74,33,81400,36300,117700
410750,202102,271,181,90,199100,99000,298100
410752,202102,22,13,9,14300,9900,24200
410753,202102,57,23,34,25300,37400,62700
410754,202102,52,26,26,28600,29700,58300
410755,202102,84,50,34,55000,37400,92400
410760,202102,767,419,348,460900,382800,843700
410765,202102,1793,807,986,887700,1084600,1972300
410770,202102,114,84,30,92400,33000,125400
410773,202102,56,39,17,42900,18700,61600
410775,202102,186,140,46,154000,50600,204600
410780,202102,86,46,40,50600,44000,94600
410785,202102,52,40,12,44000,13200,57200
410790,202102,83,37,46,40700,50600,91300
410800,202102,287,178,109,195800,119900,315700
410810,202102,24,16,8,17600,8800,26400
410820,202102,171,123,48,135300,52800,188100
410830,202102,8632,3677,4955,4049100.4,5451600,9500700.4
410832,202102,105,71,34,78100,37400,115500
410840,202102,1461,783,678,862400.21,745800,1608200.21
410845,202102,49,29,20,31900,22000,53900
410850,202102,186,132,54,145200,59400,204600
410855,202102,64,53,11,58300,12100,70400
410860,202102,742,391,351,430100,386100,816200
410865,202102,102,73,29,80300,31900,112200
410870,202102,149,128,21,140800,23100,163900
410880,202102,1131,565,566,621500,623700,1245200
410890,202102,87,61,26,67100,28600,95700
410895,202102,71,54,17,59400,18700,78100
410900,202102,25,18,7,19800,7700,27500
410910,202102,19,14,5,15400,5500,20900
410920,202102,35,23,12,25300,13200,38500
410930,202102,537,329,208,361900,228800,590700
410940,202102,4399,2398,2001,2637800.6,2201100,4838900.6
410950,202102,106,76,30,83600,33000,116600
410960,202102,841,335,506,368500,556600,925100
410965,202102,63,43,20,47300,22000,69300
410970,202102,618,434,184,477400,203500,680900
410975,202102,127,78,49,85800.38,53900,139700.38
410980,202102,1630,718,912,789800,1003200,1793000
410990,202102,268,190,78,210100,85800,295900
411000,202102,65,39,26,42900,28600,71500
411005,202102,28,23,5,25300,5500,30800
411007,202102,252,145,107,159500,117700,277200
411010,202102,598,399,199,440000,220000,660000
411020,202102,281,185,96,203500,105600,309100
411030,202102,20,11,9,12100,9900,22000
411040,202102,54,37,17,40700,18700,59400
411050,202102,211,157,54,172700,59400,232100
411060,202102,516,344,172,378400,190300,568700
411065,202102,52,46,6,50600,6600,57200
411070,202102,1254,741,513,815100,565510,1380610
411080,202102,243,173,70,190300,77000,267300
411090,202102,98,76,22,83600,24200,107800
411095,202102,290,110,180,121000,198000,319000
411100,202102,118,95,23,104500,25300,129800
411110,202102,127,77,50,84700,55000,139700
411120,202102,213,141,72,155100,79200,234300
411125,202102,243,101,142,111100,156200,267300
411130,202102,128,108,20,118800,22000,140800
411140,202102,215,141,74,155100,81400,236500
411150,202102,1264,822,442,904200,486200.63,1390400.63
411155,202102,120,82,38,90200,41800,132000
411160,202102,25,10,15,11000,16500,27500
411170,202102,52,46,6,50600,6600,57200
411180,202102,969,635,334,698500,367400,1065900
411190,202102,336,190,146,209000,160600,369600
411200,202102,671,401,270,441100.63,297000,738100.63
411210,202102,678,357,321,392700,353100,745800
411220,202102,158,109,49,119900,53900,173800
411230,202102,40,33,7,36300,7700,44000
411240,202102,119,75,44,82500,48400,130900
411250,202102,429,310,119,341000,130900,471900
411260,202102,15,11,4,12100,4400,16500
411270,202102,274,144,130,158400,143000,301400
411275,202102,181,158,23,173800,25300,199100
411280,202102,205,147,58,161700.63,63800,225500.63
411290,202102,63,47,16,51700,17600,69300
411295,202102,130,103,27,113300,29700,143000
411300,202102,79,33,46,36300,50600,86900
411310,202102,90,68,22,74800,24200,99000
411320,202102,793,517,276,568700,303600,872300
411325,202102,59,40,19,44000,20900,64900
411330,202102,912,584,328,642400,360800.15,1003200.15
411340,202102,29,18,11,19800,12100,31900
411342,202102,57,42,15,46200,16500,62700
411345,202102,118,58,60,63800,66000,129800
411350,202102,485,367,118,403700,129800,533500
411360,202102,54,35,19,39600,20900,60500
411370,202102,14212,5677,8535,6249101.26,9396201.34,15645302.60
411373,202102,173,118,55,129800,60500,190300
411375,202102,80,63,17,69300,18700,88000
411380,202102,83,59,24,64900,26400,91300
411390,202102,131,78,53,85800,58300,144100
411400,202102,400,283,117,311300,128700,440000
411410,202102,456,218,238,239800,261800,501600
411420,202102,988,426,562,469700,618200,1087900
411430,202102,481,265,216,291500,237600,529100
411435,202102,31,18,13,19800,14300,34100
411440,202102,463,360,103,396000,113300,509300
411450,202102,425,356,69,391600,75900,467500
411460,202102,778,292,486,321200,535700.66,856900.66
411470,202102,92,65,27,71500,29700,101200
411480,202102,679,366,313,402600,344300,746900
411490,202102,291,186,105,204600,115500,320100
411500,202102,102,84,18,92400,19800,112200
411510,202102,213,171,42,188100,46200,234300
411520,202102,6012,2209,3803,2431000,4186600.7,6617600.7
411530,202102,127,85,42,93500,46200,139700
411535,202102,53,20,33,22000,36300,58300
411540,202102,360,245,115,269500,126500,396000
411545,202102,53,38,15,41800,16500,58300
411550,202102,82,63,19,69300,20900,90200
411560,202102,397,167,230,183700,253000,436700
411570,202102,879,303,576,333300,633600,966900
411573,202102,23,14,9,15400,9900,25300
411575,202102,302,185,117,203500,128700,332200
411580,202102,1255,447,808,492800,888800,1381600
411585,202102,74,36,38,39600,41800,81400
411590,202102,20,14,6,15400,6600,22000
411600,202102,23,10,13,11000,14300,25300
411605,202102,237,94,143,103400,157300,260700
411610,202102,212,136,76,149600,83600,233200
411620,202102,380,199,181,218900,199100,418000
411630,202102,54,36,18,39600,19800,59400
411640,202102,33,23,10,25300,11000,36300
411650,202102,12,7,5,7700,5500,13200
411660,202102,38,26,12,28600,13200,41800
411670,202102,238,172,66,189200,72600,261800
411680,202102,166,135,31,148500,34100,182600
411690,202102,594,312,282,345400,310200,655600
411695,202102,62,43,19,47300,20900,68200
411700,202102,143,113,30,124300,33000,157300
411705,202102,109,71,38,78100,41800,119900
411710,202102,290,193,97,212300,106700,319000
411720,202102,130,84,46,92400,50600,143000
411721,202102,73,60,13,66000,14300,80300
411722,202102,106,45,61,49500,67100,116600
411725,202102,156,116,40,127600,44000,171600
411727,202102,85,63,22,69300,24200,93500
411729,202102,39,31,8,34100,8800,42900
411730,202102,552,343,209,377300,229900,607200
411740,202102,36,21,15,23100,16500,39600
411745,202102,69,49,20,53900,22000,75900
411750,202102,841,365,476,401500,523600,925100
411760,202102,1175,867,308,953700,338800,1292500
411770,202102,455,300,155,330000,170500,500500
411780,202102,351,225,126,247500,138600,386100
411790,202102,533,298,235,327800.18,259600,587400.18
411800,202102,152,114,38,126500.65,41800,168300.65
411810,202102,177,133,44,146300,48400,194700
411820,202102,2260,972,1288,1069200,1416800,2486000
411830,202102,10,9,1,9900,1100,11000
411840,202102,2028,1225,803,1348600,883300,2231900
411845,202102,56,19,37,20900,40700,61600
411850,202102,1207,657,550,723800,605000,1328800
411860,202102,49,31,18,34100,19800,53900
411870,202102,73,47,26,51700,28600,80300
411880,202102,426,262,164,288200,180400,468600
411885,202102,99,64,35,70400,38500,108900
411890,202102,306,197,109,216700,119900,336600
411900,202102,81,64,17,70400,18700,89100
411910,202102,185,143,42,157300,46200,203500
411915,202102,2234,887,1347,976800,1481700,2458500
411920,202102,121,96,25,106700,27500,134200
411925,202102,12,6,6,6600,6600,13200
411930,202102,800,568,232,625970.4,255200,881170.4
411940,202102,578,381,197,419100,216700,635800
411950,202102,1050,492,558,541200.24,614900,1156100.24
411960,202102,1086,719,367,790900,403700,1194600
411965,202102,21,14,7,15400,7700,23100
411970,202102,92,78,14,85800,15400,101200
411980,202102,177,107,70,117700,77000,194700
411990,202102,5106,2862,2244,3148201.42,2470672,5618873.42
411995,202102,533,170,363,187000,399300,586300
412000,202102,320,204,116,224400,127600,352000
412010,202102,43,27,16,29700,17600,47300
412015,202102,40,30,10,33000,11000,44000
412020,202102,29,23,6,25300,6600,31900
412030,202102,45,43,2,47300,2200,49500
412033,202102,54,28,26,30800,28600,59400
412035,202102,72,44,28,48400,30800,79200
412040,202102,43,24,19,26400,20900,47300
412050,202102,209,153,56,169400,61600,231000
412060,202102,774,563,211,619666.66,232100,851766.66
412065,202102,51,31,20,34100,22000,56100
412070,202102,163,111,52,122100,57200,179300
412080,202102,304,149,155,163900,170500,334400
412085,202102,41,17,24,18700,26400,45100
412090,202102,810,510,300,561000,330000,891000
412100,202102,250,210,40,231000,44000,275000
412110,202102,73,55,18,60500,19800,80300
412120,202102,323,189,134,207900,147400,355300
412125,202102,78,49,29,53900,31900,85800
412130,202102,37,24,13,26400,14300,40700
412135,202102,29,16,13,17600,14300,31900
412140,202102,356,225,131,247500,145200,392700
412150,202102,250,165,85,181500,93500,275000
412160,202102,86,47,39,51700,42900,94600
412170,202102,698,474,224,521400,246400,767800
412175,202102,33,25,8,27500,8800,36300
412180,202102,189,143,46,158400,50600,209000
412190,202102,324,258,66,283800,72600,356400
412200,202102,183,119,64,130900,70400,201300
412210,202102,74,56,18,61600,19800,81400
412215,202102,234,165,69,181823.4,75900,257723.4
412217,202102,65,53,12,58300,13200,71500
412220,202102,830,574,256,631400,281600,913000
412230,202102,320,196,124,215600,137500,353100
412240,202102,1342,646,696,710600,765600,1476200
412250,202102,408,248,160,272800,176000,448800
412260,202102,106,73,33,80300,36300,116600
412265,202102,177,134,43,147400,47300,194700
412270,202102,89,60,29,66000,31900,97900
412280,202102,88,70,18,78100,19800,97900
412290,202102,95,65,30,71500,33000,104500
412300,202102,210,141,69,155100,75900,231000
412310,202102,52,42,10,46200,11000,57200
412320,202102,97,78,19,85800,20900,106700
412330,202102,181,150,31,166100,34100,200200
412340,202102,160,114,46,125400,50600,176000
412350,202102,628,304,324,334400,356400,690800
412360,202102,25,21,4,23100,4400,27500
412370,202102,161,138,23,151800,25300,177100
412380,202102,243,186,57,204600,62700,267300
412382,202102,59,33,26,36300,28600,64900
412385,202102,151,106,45,116600,49500,166100
412390,202102,284,213,71,234300,78100,312400
412395,202102,67,55,12,60500,13200,73700
412400,202102,95,64,31,70400,34100,104500
412402,202102,234,117,117,129800,128700,258500
412405,202102,893,305,588,336600,647900,984500
412410,202102,971,587,384,645700,422400,1068100
412420,202102,15,14,1,15400,1100,16500
412430,202102,20,17,3,18700,3300,22000
412440,202102,621,326,295,358600,324500,683100
412450,202102,77,67,10,73700,11000,84700
412460,202102,92,71,21,78100,23100,101200
412470,202102,219,174,45,191400,49500,240900
412480,202102,144,104,40,114400,44000,158400
412490,202102,156,137,19,150700,20900,171600
412500,202102,427,344,83,378400.44,91300,469700.44
412510,202102,169,138,31,151800,34100,185900
412520,202102,90,59,31,64900,34100,99000
412530,202102,106,55,51,60500,56100,116600
412535,202102,91,66,25,72600,27500,100100
412540,202102,83,39,44,42900,48400,91300
412545,202102,89,60,29,66000,31900,97900
412550,202102,3864,1581,2283,1739100.5,2511300,4250400.5
412555,202102,10,6,4,6600,4400,11000
412560,202102,621,430,191,473000,210100,683100
412570,202102,764,380,384,418000,422400,840400
412575,202102,92,64,28,70400,30800,101200
412580,202102,177,118,59,129800,64900,194700
412590,202102,35,30,5,33000,5500,38500
412600,202102,177,128,49,140800,53900,194700
412610,202102,35,15,20,16500,22000,38500
412620,202102,142,119,23,130900,25300,156200
412625,202102,2116,1085,1031,1194600.63,1135200,2329800.63
412627,202102,67,49,18,53900,19800,73700
412630,202102,393,259,134,284900,147400,432300
412635,202102,65,18,47,19800,51700,71500
412640,202102,101,72,29,79200,31900,111100
412650,202102,327,213,114,234300,126500,360800
412660,202102,463,273,190,301400,209000,510400
412665,202102,45,41,4,45100,4400,49500
412667,202102,304,205,99,225500,108900,334400
412670,202102,63,52,11,57200,12100,69300
412680,202102,300,230,70,253000,78100,331100
412690,202102,111,72,39,79200,42900,122100
412700,202102,166,112,54,123200,59400,182600
412710,202102,1349,793,556,872300,613800,1486100
412720,202102,232,140,92,154000,101200,255200
412730,202102,187,158,29,174900,31900,206800
412740,202102,425,215,210,236500,231000,467500
412750,202102,423,237,186,260700,204600,465300
412760,202102,294,148,146,162800,160600,323400
412770,202102,2133,1171,962,1288100.63,1058200,2346300.63
412780,202102,139,108,31,118800,34100,152900
412785,202102,294,141,153,155100,168300,323400
412788,202102,37,22,15,24200,16500,40700
412790,202102,120,99,21,108900,23100,132000
412795,202102,153,107,46,117700,50600,168300
412796,202102,306,198,108,217800,118800,336600
412800,202102,634,376,258,413600,284900,698500
412810,202102,2962,1576,1386,1734700,1524600,3259300
412820,202102,919,564,355,622600,392700,1015300
412830,202102,13,10,3,11000,3300,14300
412840,202102,237,166,71,182600,78100,260700
412850,202102,751,477,274,525800,301400,827200
412853,202102,173,85,88,93500,97900,191400
412855,202102,186,98,88,107800.26,97900,205700.26
412860,202102,94,62,32,68200,35200,103400
412862,202102,59,36,23,39600,25300,64900
412863,202102,7,5,2,5500,2200,7700
412865,202102,45,31,14,34100,15400,49500
412870,202102,103,62,41,68200,45100,113300
412880,202102,90,64,26,70400,28600,99000
420005,202102,41,37,4,40700,4400,45100
420010,202102,362,232,130,255200,143000,398200
420020,202102,80,68,12,74800,13200,88000
420030,202102,23,20,3,22000,3300,25300
420040,202102,101,79,22,86900,24200,111100
420050,202102,56,33,23,36300,25300,61600
420055,202102,19,19,0,20900,0,20900
420060,202102,29,21,8,23100,8800,31900
420070,202102,102,85,17,93500,18700,112200
420075,202102,11,11,0,12100,0,12100
420080,202102,43,38,5,41800,5500,47300
420090,202102,35,30,5,33000,5500,38500
420100,202102,148,125,23,137500,25300,162800
420110,202102,19,19,0,20900,0,20900
420120,202102,58,42,16,46200,17600,63800
420125,202102,78,60,18,66000,19800,85800
420127,202102,34,28,6,30800,6600,37400
420130,202102,447,262,185,288200,203500,491700
420140,202102,1301,719,582,792000,640200,1432200
420150,202102,45,35,10,38500,11000,49500
420160,202102,31,29,2,31900,2200,34100
420165,202102,15,10,5,11000,5500,16500
420170,202102,70,43,27,47300,29700,77000
420180,202102,22,18,4,19800,4400,24200
420190,202102,25,22,3,24200,3300,27500
420195,202102,130,62,68,68200,74800,143000
420200,202102,1249,548,701,602800,771100,1373900
420205,202102,91,49,42,53900,46200,100100
420207,202102,121,66,55,72600,60500,133100
420208,202102,19,15,4,16500,4400,20900
420209,202102,17,14,3,15400,3300,18700
420210,202102,518,240,278,265100,305800,570900
420213,202102,43,33,10,36300,11000,47300
420215,202102,28,24,4,26400,4400,30800
420220,202102,59,38,21,41800,23100,64900
420230,202102,845,484,361,532400,397100,929500
420240,202102,2191,1414,777,1559800,854700,2414500
420243,202102,41,32,9,35200,9900,45100
420245,202102,162,83,79,91300,86900,178200
420250,202102,63,41,22,45100,24200,69300
420253,202102,27,22,5,24200,5500,29700
420257,202102,11,8,3,8800,3300,12100
420260,202102,97,79,18,86900,19800,106700
420270,202102,29,24,5,26400,5500,31900
420280,202102,285,218,67,239800,73700,313500
420285,202102,21,13,8,14300,8800,23100
420287,202102,48,31,17,34100,18700,52800
420290,202102,954,649,305,715000,335500,1050500
420300,202102,1449,1145,304,1260600,334400,1595000
420310,202102,51,33,18,36300,19800,56100
420315,202102,34,27,7,29700,7700,37400
420320,202102,959,459,500,504900,550000,1054900
420325,202102,3,1,2,1100,2200,3300
420330,202102,124,79,45,86900,49500,136400
420340,202102,169,113,56,124300,61600,185900
420350,202102,255,179,76,196900,83600,280500
420360,202102,714,546,168,600600.88,184800,785400.88
420370,202102,127,75,52,82500,57200,139700
420380,202102,1182,819,363,903100,399300,1302400
420390,202102,240,169,71,185900,78100,264000
420395,202102,192,136,56,149600,61600,211200
420400,202102,246,189,57,207900.15,62700,270600.15
420410,202102,61,45,16,49500,17600,67100
420415,202102,34,28,6,30800,6600,37400
420417,202102,50,38,12,41800,13200,55000
420419,202102,12,12,0,13200,0,13200
420420,202102,2832,1734,1098,1908500,1208900,3117400
420425,202102,73,59,14,64900,15400,80300
420430,202102,1140,811,329,892100.37,361900,1254000.37
420435,202102,14,12,2,13200,2200,15400
420440,202102,104,72,32,79200,35200,114400
420445,202102,27,26,1,28600,1100,29700
420450,202102,75,37,38,40700,41800,82500
420455,202102,204,154,50,169400,55000,224400
420460,202102,2315,1477,838,1625800,921800,2547600
420470,202102,94,68,26,74800,28600,103400
420475,202102,8,8,0,8800,0,8800
420480,202102,856,641,215,705100,237600,942700
420490,202102,100,74,26,81400,28600,110000
420500,202102,449,234,215,257400.26,236500,493900.26
420510,202102,19,18,1,19800,1100,20900
420515,202102,27,17,10,18700,11000,29700
420517,202102,8,8,0,8800,0,8800
420519,202102,0,,,,,0.0
420520,202102,65,48,17,52800,18700,71500
420530,202102,161,105,56,115500,61600,177100
420535,202102,19,17,2,18700,2200,20900
420540,202102,5561,3352,2209,3690775,2434300,6125075
420543,202102,31,29,2,31900,2200,34100
420545,202102,203,146,57,160600,63800,224400
420550,202102,841,690,151,759000,166100,925100
420555,202102,28,18,10,19800,11000,30800
420560,202102,63,53,10,58300,11000,69300
420570,202102,172,97,75,106700,82500,189200
420580,202102,277,128,149,140800,165000,305800
420590,202102,495,331,164,364100,180400,544500
420600,202102,127,70,57,77000,62700,139700
420610,202102,39,36,3,39600,3300,42900
420620,202102,86,66,20,72600,22000,94600
420630,202102,149,98,51,107800,56100,163900
420640,202102,83,73,10,80300,11000,91300
420650,202102,247,124,123,136400,135300,271700
420660,202102,48,39,9,42900,9900,52800
420665,202102,36,25,11,27500,12100,39600
420670,202102,292,229,63,251900,69300,321200
420675,202102,12,10,2,11000,2200,13200
420680,202102,36,26,10,28600,11000,39600
420690,202102,179,138,41,151800,45100,196900
420700,202102,685,458,227,503800.7,249700,753500.7
420710,202102,144,77,67,84700,73700,158400
420720,202102,107,86,21,94600,23100,117700
420730,202102,620,381,239,420200,262900,683100
420740,202102,52,51,1,56100,1100,57200
420750,202102,483,327,156,359700,172700,532400
420757,202102,22,20,2,22000,2200,24200
420760,202102,39,31,8,34100,8800,42900
420765,202102,80,59,21,64900,23100,88000
420768,202102,50,43,7,47300,7700,55000
420770,202102,70,60,10,66000,11000,77000
420775,202102,39,36,3,39600,3300,42900
420780,202102,204,162,42,178200,46200,224400
420785,202102,21,13,8,14300,8800,23100
420790,202102,159,131,28,144100,30800,174900
420800,202102,64,48,16,52800,17600,70400
420810,202102,260,213,47,234300,51700,286000
420820,202102,2380,1338,1042,1475100,1146200.5,2621300.5
420830,202102,616,325,291,357500,320100,677600
420840,202102,151,105,46,115500,50600,166100
420845,202102,406,170,236,188100,259600,447700
420850,202102,255,187,68,205700,74800,280500
420860,202102,55,46,9,50600,9900,60500
420870,202102,129,89,40,97900,44000,141900
420880,202102,181,114,67,125400,73700,199100
420890,202102,949,467,482,513700,531300,1045000
420895,202102,8,8,0,8800,0,8800
420900,202102,408,322,86,354200,94600,448800
420910,202102,5794,3163,2631,3483701.3,2895200,6378901.3
420915,202102,60,56,4,61600,4400,66000
420917,202102,22,15,7,16500,7700,24200
420920,202102,22,15,7,16500,7700,24200
420930,202102,2795,1740,1055,1917082.33,1162700.18,3079782.51
420940,202102,588,434,154,477400,170500,647900
420945,202102,10,7,3,7700,3300,11000
420950,202102,50,43,7,47300,7700,55000
420960,202102,108,86,22,95700,24200,119900
420970,202102,279,224,55,246400,60500,306900
420980,202102,21,20,1,22000,1100,23100
420985,202102,56,50,6,55000,6600,61600
420990,202102,80,57,23,62700,25300,88000
421000,202102,44,26,18,28600,19800,48400
421003,202102,48,33,15,36300,16500,52800
421005,202102,7,4,3,4400,3300,7700
421010,202102,777,507,270,557700.47,297000,854700.47
421020,202102,24,19,5,20900,5500,26400
421030,202102,115,97,18,106700,19800,126500
421040,202102,73,55,18,60500,19800,80300
421050,202102,342,229,113,255200,124300,379500
421055,202102,21,16,5,17600,5500,23100
421060,202102,87,48,39,52800,42900,95700
421070,202102,49,41,8,45100,8800,53900
421080,202102,34,31,3,34100,3300,37400
421085,202102,21,17,4,18700,4400,23100
421090,202102,36,28,8,30800,8800,39600
421100,202102,126,91,35,100100,38500,138600
421105,202102,188,151,37,166100,40700,206800
421110,202102,110,85,25,93500,27500,121000
421120,202102,180,133,47,146300.92,51700,198000.92
421125,202102,18,12,6,13200,6600,19800
421130,202102,829,515,314,566500,345400,911900
421140,202102,30,21,9,23100,9900,33000
421145,202102,45,34,11,37400,12100,49500
421150,202102,98,71,27,78100,29700,107800
421160,202102,65,43,22,47300,24200,71500
421165,202102,16,13,3,14300,3300,17600
421170,202102,181,153,28,168432,30800,199232
421175,202102,162,110,52,121000,57200,178200
421180,202102,47,34,13,37400,14300,51700
421185,202102,16,12,4,13200,4400,17600
421187,202102,1,0,1,0,1100,1100
421189,202102,47,32,15,35200,16500,51700
421190,202102,1704,1057,647,1163800,711700,1875500
421200,202102,93,69,24,75900,26400,102300
421205,202102,26,17,9,18700,9900,28600
421210,202102,180,125,55,137500,60500,198000
421220,202102,261,199,62,218900,68200,287100
421223,202102,46,37,9,40700,9900,50600
421225,202102,71,45,26,49500,28600,78100
421227,202102,84,66,18,72600,19800,92400
421230,202102,57,43,14,47300,15400,62700
421240,202102,17,17,0,18700,0,18700
421250,202102,365,206,159,226600,174900,401500
421260,202102,22,18,4,19800,4400,24200
421265,202102,2,2,0,2200,0,2200
421270,202102,49,44,5,48400,5500,53900
421280,202102,346,184,162,202400,178200,380600
421290,202102,334,220,114,242000,126500,368500
421300,202102,23,19,4,20900,4400,25300
421310,202102,47,32,15,35200,16500,51700
421315,202102,32,18,14,19800,15400,35200
421320,202102,121,77,44,84700,48400,133100
421330,202102,106,75,31,82500,34100,116600
421335,202102,39,27,12,29700,13200,42900
421340,202102,244,158,86,173800,94600,268400
421350,202102,189,109,80,119900.39,88000,207900.39
421360,202102,654,465,189,512600,207900,720500
421370,202102,191,144,47,158400,51700,210100
421380,202102,127,98,29,108900,31900,140800
421390,202102,16,10,6,11000,6600,17600
421400,202102,113,97,16,106700,17600,124300
421410,202102,18,16,2,17600,2200,19800
421415,202102,18,17,1,18700,1100,19800
421420,202102,111,93,18,102300,19800,122100
421430,202102,19,14,5,15400,5500,20900
421440,202102,60,52,8,57200,8800,66000
421450,202102,90,74,16,81400,17600.51,99000.51
421460,202102,58,45,13,49500,14300,63800
421470,202102,70,42,28,46200,30800,77000
421480,202102,728,553,175,608300,192500,800800
421490,202102,23,22,1,24200,1100,25300
421500,202102,488,303,185,333300,203500,536800
421505,202102,23,16,7,17600,7700,25300
421507,202102,29,22,7,24200,7700,31900
421510,202102,71,46,25,50600,27500,78100
421520,202102,54,45,9,49500,9900,59400
421530,202102,50,42,8,46200,8800,55000
421535,202102,24,22,2,24200,2200,26400
421540,202102,52,42,10,46200,11000,57200
421545,202102,91,64,27,70400,29700,100100
421550,202102,282,204,78,224400,85800,310200
421555,202102,19,17,2,18700,2200,20900
421560,202102,8,7,1,7700,1100,8800
421565,202102,120,81,39,89100,42900,132000
421567,202102,31,24,7,26400,7700,34100
421568,202102,45,40,5,44000,5500,49500
421569,202102,12,12,0,13200,0,13200
421570,202102,199,133,66,146300,72600,218900
421575,202102,25,22,3,24200,3300,27500
421580,202102,717,429,288,471972,317900,789872
421590,202102,21,19,2,20900,2200,23100
421600,202102,152,98,54,107800,59400,167200
421605,202102,110,77,33,84700,36300,121000
421610,202102,177,134,43,147400,47300,194700
421620,202102,1017,591,426,650100,469700,1119800
421625,202102,20,17,3,18700,3300,22000
421630,202102,313,194,119,213400,130900,344300
421635,202102,19,10,9,11000,9900,20900
421640,202102,100,82,18,90200,19800,110000
421650,202102,289,169,120,187000,132000,319000
421660,202102,2283,1356,927,1491600,1019700,2511300
421670,202102,175,125,50,137500,55000,192500
421680,202102,179,162,17,178200,18700,196900
421690,202102,344,238,106,264000,116600,380600
421700,202102,53,36,17,39600,18700,58300
421710,202102,25,23,2,25300,2200,27500
421715,202102,5,4,1,4400,1100,5500
421720,202102,627,435,192,478500,211200,689700
421725,202102,19,7,12,7700,13200,20900
421730,202102,32,24,8,26400,8800,35200
421740,202102,94,33,61,37400,67100,104500
421750,202102,198,147,51,161700,56100,217800
421755,202102,21,19,2,20900,2200,23100
421760,202102,102,66,36,72600,39600,112200
421770,202102,670,421,249,463100,273900,737000
421775,202102,27,17,10,18700,11000,29700
421780,202102,189,146,43,160600,47300,207900
421790,202102,151,129,22,141900,24200,166100
421795,202102,17,14,3,15400,3300,18700
421800,202102,522,330,192,363000,211200,574200
421810,202102,69,54,15,59400,16500,75900
421820,202102,303,195,108,214500,118800,333300
421825,202102,146,123,23,135300,25300,160600
421830,202102,140,90,50,99000,55000,154000
421835,202102,7,3,4,3300,4400,7700
421840,202102,47,41,6,45100,6600,51700
421850,202102,80,67,13,73700,14300,88000
421860,202102,43,33,10,36300,11000,47300
421870,202102,1032,766,266,842600,292600,1135200
421875,202102,54,45,9,49500,9900,59400
421880,202102,168,120,48,133100,52800,185900
421885,202102,22,17,5,18700,5500,24200
421890,202102,134,92,42,101200,46200.5,147400.5
421895,202102,44,39,5,42900,5500,48400
421900,202102,149,116,33,127600,36300,163900
421910,202102,59,36,23,39600,25300,64900
421915,202102,29,24,5,26400,5500,31900
421917,202102,34,25,9,27500,9900,37400
421920,202102,39,35,4,38500,4400,42900
421930,202102,639,507,132,558800.84,145200,704000.84
421935,202102,52,45,7,49500,7700,57200
421940,202102,46,39,7,42900,7700,50600
421950,202102,877,586,291,644600,320100,964700
421960,202102,42,36,6,39600,6600,46200
421970,202102,333,214,119,236500,132000,368500
421985,202102,21,13,8,14300,8800,23100
422000,202102,0,,,,,0.0
430003,202102,194,54,140,59400,154000,213400
430005,202102,35,25,10,27500,11000,38500
430010,202102,268,195,73,214500,80300,294800
430020,202102,142,92,50,101200,55000,156200
430030,202102,121,99,22,108900,24200,133100
430040,202102,2894,1705,1189,1875500,1309000,3184500
430045,202102,66,55,11,60500,12100,72600
430047,202102,7,6,1,6600,1100,7700
430050,202102,78,63,15,69300,16500,85800
430055,202102,10,9,1,9900,1100,11000
430057,202102,5,4,1,4400,1100,5500
430060,202102,3694,2126,1568,2340800,1727000,4067800
430063,202102,51,46,5,51700,5500,57200
430064,202102,155,123,32,135300,35200,170500
430066,202102,5,2,3,2200,3300,5500
430070,202102,41,28,13,30800,14300,45100
430080,202102,68,44,24,48400,26400,74800
430085,202102,24,9,15,9900,16500,26400
430087,202102,24,17,7,18700,7700,26400
430090,202102,71,63,8,69300,8800,78100
430100,202102,127,85,42,93500,46200,139700
430105,202102,148,82,66,90200,72600,162800
430107,202102,18,12,6,13200,6600,19800
430110,202102,471,261,210,287100,231000,518100
430120,202102,159,147,12,161700,13200,174900
430130,202102,789,479,310,528000,342100,870100
430140,202102,122,113,9,124300,9900,134200
430150,202102,110,70,40,77000,44000,121000
430155,202102,32,27,5,29700,5500,35200
430160,202102,3571,2083,1488,2293500,1636800,3930300
430163,202102,364,157,207,172700,227700,400400
430165,202102,30,20,10,22000,11000,33000
430170,202102,88,73,15,80300,16500,96800
430175,202102,73,59,14,64900,15400,80300
430180,202102,107,87,20,95700,22000,117700
430185,202102,27,18,9,19800,9900,29700
430187,202102,54,29,25,31900,27500,59400
430190,202102,222,122,100,134200,110000,244200
430192,202102,13,11,2,12100,2200,14300
430195,202102,17,10,7,11000,7700,18700
430200,202102,160,137,23,150700,25300,176000
430205,202102,20,20,0,22000,0,22000
430210,202102,671,505,166,555500,183700,739200
430215,202102,11,10,1,11000,1100,12100
430220,202102,72,48,24,52800,26400,79200
430222,202102,14,6,8,6600,8800,15400
430223,202102,15,8,7,8800,7700,16500
430225,202102,2,1,1,1100,1100,2200
430230,202102,309,185,124,203500,136400,339900
430235,202102,53,40,13,44000,14300,58300
430237,202102,26,20,6,22000,6600,28600
430240,202102,106,74,32,81400,35200,116600
430245,202102,75,60,15,66000,16500,82500
430250,202102,182,106,76,116600,83600,200200
430258,202102,8,7,1,7700,1100,8800
430260,202102,31,27,4,30800,4400,35200
430265,202102,34,28,6,30800,6600,37400
430270,202102,511,384,127,422400,139700,562100
430280,202102,1033,615,418,676500,459800,1136300
430290,202102,408,216,192,237600,211200,448800
430300,202102,2111,1151,960,1266100,1056000,2322100
430310,202102,2016,991,1025,1090100,1127500.7,2217600.7
430320,202102,53,44,9,48400,9900,58300
430330,202102,99,87,12,95700,13200,108900
430340,202102,73,59,14,64900,16500,81400
430350,202102,1645,1096,549,1205600.66,605000,1810600.66
430355,202102,19,17,2,19800,2200,22000
430360,202102,86,41,45,45100,49500,94600
430367,202102,34,25,9,27500,9900,37400
430370,202102,54,49,5,53900,5500,59400
430380,202102,124,95,29,104500,31900,136400
430390,202102,590,368,222,404800,244200,649000
430400,202102,253,181,72,199100,79200,278300
430410,202102,54,43,11,47300,12100,59400
430420,202102,502,324,178,356400,195800,552200
430430,202102,53,52,1,56467.4,1100,57567.4
430435,202102,150,111,39,122100,42900,165000
430440,202102,501,323,178,355300,195800,551100
430450,202102,1141,936,205,1029600,225500,1255100
430460,202102,5317,2734,2583,3008500,2844600,5853100
430461,202102,16,15,1,16500,1100,17600
430462,202102,5,3,2,3300,2200,5500
430463,202102,1101,589,512,647900,564300,1212200
430465,202102,24,13,11,14300,12100,26400
430466,202102,643,449,194,493900,213400,707300
430467,202102,107,58,49,63800,53900,117700
430468,202102,122,72,50,79200,55000,134200
430469,202102,21,16,5,17600,5500,23100
430470,202102,1154,641,513,705427.5,564300,1269727.5
430471,202102,55,37,18,40700,19800,60500
430480,202102,101,64,37,70400,40700,111100
430485,202102,7,7,0,7700,0,7700
430490,202102,73,59,14,64900,15400,80300
430495,202102,34,25,9,27500,9900,37400
430500,202102,186,125,61,137500,67100,204600
430510,202102,3474,2236,1238,2459600.67,1361800,3821400.67
430511,202102,16,16,0,17600,0,17600
430512,202102,152,105,47,115500,51700,167200
430513,202102,52,42,10,46200,11000,57200
430515,202102,26,25,1,27500,1100,28600
430517,202102,172,146,26,160600,28600,189200
430520,202102,340,239,101,262900,111100,374000
430530,202102,83,47,36,51700,39600,91300
430535,202102,436,296,140,325600,154000,479600
430537,202102,11,11,0,12100,0,12100
430540,202102,82,55,27,60500,29700,90200
430543,202102,360,113,247,124300,271700,396000
430544,202102,45,41,4,45100,4400,49500
430545,202102,380,182,198,200200,217800,418000
430550,202102,39,31,8,35200,8800,44000
430558,202102,1,1,0,1100,0,1100
430560,202102,57,32,25,35200,27500,62700
430570,202102,106,40,66,44000,72600,116600
430580,202102,133,108,25,118800,27500,146300
430583,202102,14,14,0,15400,0,15400
430585,202102,11,5,6,5500,6600,12100
430587,202102,15,7,8,7700,8800,16500
430590,202102,145,119,26,130900,28600,159500
430593,202102,2,2,0,2200,0,2200
430595,202102,15,13,2,14300,2200,16500
430597,202102,45,22,23,24200,25300,49500
430600,202102,214,158,56,173800,61600,235400
430605,202102,163,99,64,108900,70400,179300
430607,202102,26,21,5,23100,5500,28600
430610,202102,1667,775,892,852500,982300,1834800
430613,202102,4,4,0,4400,0,4400
430620,202102,110,79,31,86900,34100,121000
430630,202102,45,39,6,42900,6600,49500
430632,202102,33,28,5,30800,5500,36300
430635,202102,36,32,4,35200,4400,39600
430637,202102,63,30,33,33000,36300,69300
430640,202102,178,96,82,105600,90200,195800
430642,202102,19,16,3,17600,3300,20900
430645,202102,33,27,6,29700,6600,36300
430650,202102,238,194,44,213400,48400,261800
430655,202102,1,1,0,1100,0,1100
430660,202102,969,483,486,531300,535700,1067000
430670,202102,76,52,24,57200,26400,83600
430673,202102,68,42,26,46200,28600,74800
430675,202102,10,8,2,8800,2200,11000
430676,202102,522,302,220,332200,242000,574200
430680,202102,237,162,75,178200,82500,260700
430690,202102,519,319,200,352000,220000.63,572000.63
430692,202102,9,7,2,7700,2200,9900
430693,202102,142,91,51,100100,56100,156200
430695,202102,64,52,12,57200,13200,70400
430697,202102,60,36,24,39600,26400,66000
430700,202102,1448,990,458,1089000,503800,1592800
430705,202102,28,25,3,27500,3300,30800
430710,202102,249,155,94,170500,103400,273900
430720,202102,111,94,17,103400,18700,122100
430730,202102,138,119,19,130900,20900,151800
430740,202102,73,50,23,55000,25300,80300
430745,202102,29,23,6,25300,6600,31900
430750,202102,334,226,108,248600,118800,367400
430755,202102,86,44,42,49500,46200,95700
430760,202102,386,214,172,235400,190351,425751
430770,202102,1495,775,720,852500,793100,1645600
430780,202102,298,186,112,204600,123200,327800
430781,202102,25,22,3,24200,3300,27500
430783,202102,61,50,11,55000,12100,67100
430786,202102,5,3,2,3300,2200,5500
430790,202102,511,332,179,365200,196900,562100
430800,202102,154,123,31,135300.01,34100,169400.01
430805,202102,42,33,9,36300,9900,46200
430807,202102,55,29,26,31900,28600,60500
430810,202102,76,46,30,50600,33000,83600
430820,202102,143,84,59,92400,64900,157300
430825,202102,10,8,2,8800,2200,11000
430830,202102,240,221,19,243100,20900,264000
430840,202102,131,86,45,94600,49500,144100
430843,202102,5,3,2,3300,2200,5500
430845,202102,77,42,35,46200,38500,84700
430850,202102,588,423,165,466400,181500,647900
430860,202102,153,98,55,107800,60500,168300
430865,202102,74,40,34,44000,37400,81400
430870,202102,78,64,14,70400,15400,85800
430880,202102,154,111,43,122100,47300,169400
430885,202102,11,9,2,9900,2200,12100
430890,202102,335,200,135,220000,148500,368500
430900,202102,516,354,162,389400,178200,567600
430905,202102,121,49,72,53900,79200,133100
430910,202102,285,161,124,177100,136400,313500
430912,202102,3,3,0,3300,0,3300
430915,202102,35,31,4,34100,4400,38500
430920,202102,4341,2282,2059,2511300,2266000.43,4777300.43
430925,202102,5,4,1,4400,1100,5500
430930,202102,2076,1194,882,1315600,970200,2285800
430940,202102,259,170,89,187000,97900,284900
430950,202102,151,124,27,136400,29700,166100
430955,202102,25,13,12,14300,13200,27500
430957,202102,20,17,3,18700,3300,22000
430960,202102,245,159,86,174900,94600,269500
430965,202102,111,70,41,77000,45100,122100
430970,202102,93,75,18,82500,19800,102300
430975,202102,45,39,6,42900,6600,49500
430980,202102,45,28,17,30800,18700,49500
430990,202102,96,74,22,81400,24200,105600
430995,202102,111,105,6,115500,6600,122100
431000,202102,293,142,151,156200.6,166100,322300.6
431010,202102,341,192,149,211200,163900,375100
431020,202102,1856,1067,789,1174800,867900,2042700
431030,202102,39,31,8,34100,8800,42900
431033,202102,407,190,217,209000,238700,447700
431036,202102,12,7,5,7700,5500,13200
431040,202102,142,86,56,94600,61600,156200
431041,202102,40,27,13,29700,14300,44000
431043,202102,42,25,17,27500,18700,46200
431046,202102,10,7,3,7700,3300,11000
431050,202102,197,124,73,136400,80300,216700
431053,202102,64,39,25,42900,27500,70400
431055,202102,63,44,19,48400,20900,69300
431057,202102,18,18,0,19800,0,19800
431060,202102,1592,1031,561,1134100.31,617100,1751200.31
431065,202102,16,10,6,11000,6600,17600
431070,202102,66,61,5,67100,5500,72600
431075,202102,7,7,0,7700,0,7700
431080,202102,133,77,56,85800,61600,147400
431085,202102,33,30,3,33000,3300,36300
431087,202102,12,10,2,11000,2200,13200
431090,202102,55,43,12,47300,13200,60500
431100,202102,1221,726,495,798600,544500,1343100
431110,202102,227,137,90,150700,99000,249700
431112,202102,23,15,8,16500,8800,25300
431113,202102,35,25,10,27500,11000,38500
431115,202102,162,114,48,125400,52800,178200
431120,202102,602,359,243,394900,267300,662200
431123,202102,3,2,1,2200,1100,3300
431125,202102,97,84,13,92400,14300,106700
431127,202102,10,6,4,6600,4400,11000
431130,202102,703,454,249,499400,273900,773300
431140,202102,745,518,227,569800,250800,820600
431142,202102,25,21,4,23100.55,4400,27500.55
431150,202102,189,140,49,154000,53900,207900
431160,202102,45,42,3,46200,3300,49500
431162,202102,4,3,1,3300,1100,4400
431164,202102,6,6,0,6600,0,6600
431170,202102,109,85,24,93500,26400,119900
431171,202102,68,39,29,42900,31900,74800
431173,202102,1,1,0,1100,0,1100
431175,202102,202,100,102,110000,112200,222200
431177,202102,83,60,23,66000,25300,91300
431179,202102,14,11,3,12100,3300,15400
431180,202102,429,260,169,286000,185900,471900
431190,202102,77,58,19,63800,20900,84700
431198,202102,74,53,21,58300,23100,81400
431200,202102,22,18,4,19800,4400,24200
431205,202102,20,19,1,20900,1100,22000
431210,202102,99,63,36,69300,39600,108900
431213,202102,30,26,4,28600,4400,33000
431215,202102,22,19,3,20900,3300,24200
431217,202102,5,5,0,5500,0,5500
431220,202102,66,57,9,62700,9900,72600
431225,202102,157,98,59,107800,64900,172700
431230,202102,95,82,13,90200,14300,104500
431235,202102,6,6,0,6600,0,6600
431237,202102,8,7,1,7700,1100,8800
431238,202102,11,7,4,7700,4400,12100
431240,202102,1024,639,385,704000,423500,1127500
431242,202102,40,39,1,42900,1100,44000
431244,202102,15,11,4,12100,4400,16500
431245,202102,49,37,12,40700,13200,53900
431247,202102,11,6,5,6600,5500,12100
431250,202102,280,142,138,156200,151800,308000
431260,202102,58,47,11,51700,12100,63800
431261,202102,18,11,7,12100,7700,19800
431262,202102,16,15,1,16500,1100,17600
431265,202102,149,79,70,86900,77000,163900
431267,202102,18,16,2,17600,2200,19800
431270,202102,326,263,63,289300,69300,358600
431275,202102,39,36,3,39600,3300,42900
431280,202102,20,16,4,17600,4400,22000
431290,202102,19,17,2,18700,2200,20900
431295,202102,2,1,1,1100,1100,2200
431300,202102,21,19,2,20900,2200,23100
431301,202102,5,5,0,5500,0,5500
431303,202102,62,40,22,44000,24200,68200
431306,202102,242,128,114,140604.2,125400,266004.2
431308,202102,6,4,2,4400,2200,6600
431310,202102,66,53,13,58300,14300,72600
431320,202102,151,90,61,100100,67100,167200
431330,202102,184,110,74,121000,81400,202400
431333,202102,26,20,6,22000,6600,28600
431335,202102,9,5,4,5500,4400,9900
431337,202102,366,161,205,177100,225500,402600
431339,202102,21,17,4,18700,4400,23100
431340,202102,3027,1652,1375,1820413.43,1513600,3334013.43
431342,202102,38,26,12,28600,13200,41800
431344,202102,18,18,0,19800,0,19800
431346,202102,4,4,0,4400,0,4400
431349,202102,36,32,4,35200,4400,39600
431350,202102,907,515,392,566500,431200,997700
431360,202102,52,43,9,47300,9900,57200
431365,202102,342,152,190,167200,209000,376200
431370,202102,1214,694,520,763400,574200,1337600
431380,202102,98,86,12,94600,13200,107800
431390,202102,498,267,231,293700,254100,547800
431395,202102,313,133,180,146300,198000,344300
431400,202102,45,30,15,33000,16500,49500
431402,202102,110,79,31,86900,34100,121000
431403,202102,24,15,9,16500,9900,26400
431405,202102,692,381,311,419100,342100,761200
431406,202102,33,27,6,29700,6600,36300
431407,202102,54,42,12,46200,13200,59400
431410,202102,3378,2052,1326,2257200,1458600,3715800
431413,202102,16,13,3,14300,3300,17600
431415,202102,65,47,18,51700,19800,71500
431417,202102,27,13,14,14300,15400,29700
431420,202102,327,221,106,243100,116600,359700
431430,202102,57,26,31,28600,34100,62700
431440,202102,8828,6062,2766,6674800,3043751,9718551
431442,202102,28,13,15,14300,16500,30800
431445,202102,29,27,2,29700,2200,31900
431446,202102,4,3,1,3300,1100,4400
431447,202102,87,60,27,66000,29700,95700
431449,202102,52,44,8,48400,8800,57200
431450,202102,406,270,136,298100,149600,447700
431454,202102,10,4,6,4400,6600,11000
431455,202102,50,40,10,44000,11000,55000
431460,202102,498,342,156,376200,171600,547800
431470,202102,117,87,30,96800,33000,129800
431475,202102,10,8,2,8800,2200,11000
431477,202102,37,24,13,26400,14300,40700
431478,202102,9,8,1,8800,1100,9900
431480,202102,524,312,212,343200,233200,576400
431490,202102,28499,15801,12698,17389900.85,13976600,31366500.85
431500,202102,78,62,16,68200,17600,85800
431505,202102,26,16,10,17600,11000,28600
431507,202102,8,7,1,7700,1100,8800
431510,202102,250,175,75,192500,83600,276100
431513,202102,24,21,3,23100,3300,26400
431514,202102,5,4,1,4400,1100,5500
431515,202102,80,66,14,72600,15400,88000
431517,202102,6,4,2,4400,2200,6600
431520,202102,39,35,4,38500,4400,42900
431530,202102,1433,640,793,704000,872300,1576300
431531,202102,23,22,1,24200,1100,25300
431532,202102,35,26,9,28600,9900,38500
431535,202102,29,15,14,16500,15400,31900
431540,202102,141,120,21,132000,23100.4,155100.4
431545,202102,15,12,3,13200,3300,16500
431550,202102,348,190,158,209000,173800,382800
431555,202102,12,12,0,13200,0,13200
431560,202102,4518,3064,1454,3372600,1601600,4974200
431570,202102,812,425,387,467500,425700,893200
431575,202102,44,23,21,25300,23100,48400
431580,202102,93,62,31,68200,34100,102300
431590,202102,136,115,21,126500,23100,149600
431595,202102,19,16,3,17600,3300,20900
431600,202102,244,141,103,155100,113300,268400
431610,202102,115,85,30,93500,33000,126500
431620,202102,45,38,7,41800,7700,49500
431630,202102,128,105,23,115500,25300,140800
431640,202102,1327,835,492,918500,541200,1459700
431642,202102,36,33,3,36300,3300,39600
431643,202102,47,20,27,22000,29700,51700
431645,202102,308,183,125,201300,137500,338800
431647,202102,9,8,1,8800,1100,9900
431650,202102,33,22,11,24200,12100,36300
431660,202102,280,176,104,193600,114400,308000
431670,202102,227,101,126,112200,138600,250800
431673,202102,7,7,0,7700,0,7700
431675,202102,23,18,5,19800,5500,25300
431680,202102,1110,814,296,896500,325600,1222100
431690,202102,4769,2846,1923,3130600.5,2117500,5248100.5
431695,202102,22,16,6,17600,6600,24200
431697,202102,1,0,1,0,1100,1100
431700,202102,181,138,43,152900,47300,200200
431710,202102,3985,1728,2257,1903000,2482700,4385700
431720,202102,1321,806,515,888323.33,566500,1454823.33
431725,202102,1,1,0,1100,0,1100
431730,202102,1158,778,380,855800,419100,1274900
431740,202102,1341,657,684,722700,752400,1475100
431750,202102,1826,1183,643,1301300.32,707300,2008600.32
431755,202102,6,5,1,5500,1100,6600
431760,202102,1014,633,381,697400,419100,1116500
431770,202102,415,292,123,321200,135300,456500
431775,202102,27,20,7,22000,7700,29700
431780,202102,543,323,220,355300,242000,597300
431790,202102,160,122,38,134200,41800,176000
431795,202102,13,10,3,11000,3300,14300
431800,202102,3150,1642,1508,1806200,1658800,3465000
431805,202102,22,20,2,22000,2200,24200
431810,202102,601,395,206,434500,226600,661100
431820,202102,329,196,133,215600,146300,361900
431830,202102,2269,1355,914,1491600,1005400,2497000
431840,202102,481,317,164,348700,180400,529100
431842,202102,33,26,7,28600,7700,36300
431843,202102,10,7,3,7700,3300,11000
431844,202102,17,13,4,14300,4400,18700
431845,202102,26,24,2,26400,2200,28600
431846,202102,26,22,4,24200,4400,28600
431848,202102,10,8,2,8800,2200,11000
431849,202102,7,6,1,6600,1100,7700
431850,202102,769,619,150,680900,165000,845900
431860,202102,114,77,37,84700,40700,125400
431861,202102,6,2,4,2200,4400,6600
431862,202102,55,37,18,40700,19800,60500
431870,202102,3479,1973,1506,2170300,1657700,3828000
431880,202102,925,674,251,741400,276100,1017500
431890,202102,1304,772,532,849201.04,585200,1434401.04
431900,202102,181,124,57,136400,62700,199100
431910,202102,52,38,14,41800,15400,57200
431912,202102,43,27,16,29700,17600,47300
431915,202102,129,99,30,108900,33000,141900
431920,202102,158,112,46,123200,50600,173800
431930,202102,77,64,13,70400,14300,84700
431935,202102,2,2,0,2200,0,2200
431936,202102,3,3,0,3300,0,3300
431937,202102,20,15,5,16500,5500,22000
431940,202102,455,302,153,332200,168300,500500
431950,202102,487,308,179,338800,196900,535700
431960,202102,735,393,342,432300,376200,808500
431970,202102,66,60,6,66000,6600,72600
431971,202102,3,3,0,3300,0,3300
431973,202102,19,15,4,16500,4400,20900
431975,202102,8,7,1,7700,1100,8800
431980,202102,211,128,83,140800,91300,232100
431990,202102,1116,594,522,653328.5,574200,1227528.5
432000,202102,1755,908,847,998800,933900,1932700
432010,202102,264,181,83,199100,91300,290400
432020,202102,178,146,32,160600,35200,195800
432023,202102,15,13,2,14300,2200,16500
432026,202102,65,58,7,63800,7700,71500
432030,202102,65,32,33,35200,36300,71500
432032,202102,20,14,6,15400,6600,22000
432035,202102,51,41,10,45100,11000,56100
432040,202102,89,61,28,67100,30800,97900
432045,202102,2,2,0,2200,0,2200
432050,202102,81,48,33,52800,36300,89100
432055,202102,123,90,33,99000,36300,135300
432057,202102,7,5,2,5500,2200,7700
432060,202102,33,30,3,33000,3300,36300
432065,202102,31,28,3,30800,3300,34100
432067,202102,88,78,10,86900,11000,97900
432070,202102,379,295,84,324775,92400,417175
432080,202102,815,570,245,628100,269500,897600
432085,202102,9,6,3,6600,3300,9900
432090,202102,266,176,90,193600,99000,292600
432100,202102,165,106,59,116600,64900,181500
432110,202102,541,358,183,393800,202400,596200
432120,202102,958,547,411,601700,454300,1056000
432130,202102,488,346,142,380600,156200,536800
432132,202102,24,21,3,23100,3300,26400
432135,202102,80,66,14,72600,15400,88000
432140,202102,270,206,64,226600,70400,297000
432143,202102,214,133,81,146300,89100,235400
432145,202102,275,189,86,207900,94600,302500
432146,202102,13,12,1,13200,1100,14300
432147,202102,112,59,53,64900,58300,123200
432149,202102,16,10,6,11000,6600,17600
432150,202102,888,537,351,590700,386100,976800
432160,202102,1497,751,746,826100.5,821700,1647800.5
432162,202102,3,2,1,2200,1100,3300
432163,202102,19,14,5,15400,5500,20900
432166,202102,123,93,30,102575,33000,135575
432170,202102,234,120,114,132000,125400,257400
432180,202102,548,332,216,366300,237600,603900
432183,202102,9,8,1,8800,1100,9900
432185,202102,75,64,11,70400,12100,82500
432190,202102,484,285,199,313500,218900,532400
432195,202102,90,73,17,80300,18700,99000
432200,202102,396,247,149,271700,163900,435600
432210,202102,114,71,43,78100,47300,125400
432215,202102,37,33,4,36300,4400,40700
432218,202102,21,20,1,22000,1100,23100
432220,202102,651,339,312,372900,343200.63,716100.63
432225,202102,14,9,5,9900,5500,15400
432230,202102,133,89,44,99000,48400,147400
432232,202102,13,11,2,12100,2200,14300
432234,202102,3,2,1,2200,1100,3300
432235,202102,3,2,1,2200,1100,3300
432237,202102,25,15,10,16500,11000,27500
432240,202102,4302,2386,1916,2626800,2107600,4734400
432250,202102,1124,731,393,805200,433400,1238600
432252,202102,48,46,2,50600,2200,52800
432253,202102,60,48,12,52800,13200,66000
432254,202102,26,11,15,12100,16500,28600
432255,202102,14,12,2,13200,2200,15400
432260,202102,826,650,176,715000,193600,908600
432270,202102,230,172,58,189200,63800,253000
432280,202102,141,105,36,115500,39600,155100
432285,202102,2,2,0,2200,0,2200
432290,202102,67,57,10,62700,11000,73700
432300,202102,4647,2496,2151,2745528.5,2370500.61,5116029.11
432310,202102,130,106,24,116600,26400,143000
432320,202102,22,17,5,18700,5500,24200
432330,202102,17,11,6,12100,6600,18700
432335,202102,8,6,2,6600,2200,8800
432340,202102,38,32,6,35200,6600,41800
432345,202102,105,69,36,75900,39600,115500
432350,202102,20,19,1,20900,1100,22000
432360,202102,4,3,1,3300,1100,4400
432370,202102,23,22,1,24200,1100,25300
432375,202102,32,29,3,31900,3300,35200
432377,202102,7,7,0,7700,0,7700
432380,202102,169,72,97,79200,106700,185900
500020,202102,242,130,112,143000,123200,266200
500025,202102,140,68,72,74800,79200,154000
500060,202102,1447,904,543,994400,597300,1591700
500070,202102,771,365,406,401500,446600,848100
500080,202102,134,107,27,117700,29700,147400
500085,202102,133,109,24,119900,26400,146300
500090,202102,355,162,193,178200,212300,390500
500100,202102,717,378,339,415800,372900,788700
500110,202102,2232,1038,1194,1141800.68,1313400,2455200.68
500124,202102,264,143,121,157300,133100,290400
500150,202102,348,135,213,148500,234300,382800
500190,202102,509,346,163,380600,180400,561000
500200,202102,195,167,28,183700,30800,214500
500210,202102,1584,531,1053,584100,1158300,1742400
500215,202102,237,131,106,144100,116600,260700
500220,202102,713,465,248,511500.92,272800,784300.92
500230,202102,233,142,91,156200,100100,256300
500240,202102,654,445,209,489500,229900,719400
500260,202102,580,224,356,246400,392700,639100
500270,202102,29807,12686,17121,13956526.15,18844100.52,32800626.67
500280,202102,198,66,132,72600,146300,218900
500290,202102,1165,712,453,783200,498300,1281500
500295,202102,443,288,155,316800,170500,487300
500310,202102,81,25,56,27500,61600,89100
500315,202102,772,439,333,482900,366300,849200
500320,202102,3573,1737,1836,1911690.84,2020700,3932390.84
500325,202102,932,507,425,557700,467500,1025200
500330,202102,1489,699,790,768900,871200,1640100
500345,202102,301,228,73,250800,80300,331100
500348,202102,252,145,107,159500,117700,277200
500350,202102,121,60,61,66000,67100,133100
500370,202102,5654,2519,3135,2772000,3448500.96,6220500.96
500375,202102,341,238,103,261800,113300,375100
500380,202102,586,331,255,366300,281600,647900
500390,202102,71,36,35,39600,38500,78100
500400,202102,221,139,82,152900,90200,243100
500410,202102,533,219,314,240900,345400,586300
500430,202102,522,368,154,405900,169400,575300
500440,202102,202,105,97,115500,106700,222200
500450,202102,400,170,230,187000,253000,440000
500460,202102,272,143,129,157300,141900,299200
500470,202102,427,330,97,363000,106700,469700
500480,202102,103,61,42,67100,46200,113300
500490,202102,105,46,59,50600,64900,115500
500500,202102,1410,513,897,564300,987800,1552100
500510,202102,43,35,8,38500,8800,47300
500515,202102,102,71,31,78100,34100,112200
500520,202102,299,159,140,176000,154000,330000
500525,202102,92,49,43,53900,47300,101200
500540,202102,874,376,498,413600,547800,961400
500560,202102,916,510,406,561000,446600,1007600
500568,202102,985,555,430,610500,473000,1083500
500570,202102,1184,696,488,765600,536800,1302400
500580,202102,325,161,164,177100,180400,357500
500600,202102,337,165,172,181500,189200,370700
500620,202102,917,646,271,711700.5,298100,1009800.5
500625,202102,77,60,17,66000,18700,84700
500627,202102,18,9,9,9900,9900,19800
500630,202102,1571,874,697,962500.76,766700,1729200.76
500635,202102,522,312,210,343200,231000,574200
500640,202102,378,202,176,222200,193600,415800
500660,202102,5583,2030,3553,2233000.62,3908300,6141300.62
500690,202102,602,204,398,224400,437800,662200
500710,202102,402,201,201,222200,221100,443300
500720,202102,918,526,392,579700.3,431200,1010900.3
500730,202102,181,107,74,117700,81400,199100
500740,202102,879,359,520,396000,572000,968000
500750,202102,149,47,102,51700,112200,163900
500755,202102,122,90,32,99000,35200,134200
500769,202102,745,405,340,445500,374000,819500
500770,202102,411,215,196,236500,215600,452100
500780,202102,148,98,50,107800,55000,162800
500790,202102,1053,527,526,581900,578600,1160500
500793,202102,272,143,129,157300,141900,299200
500795,202102,177,122,55,134200,60500,194700
500797,202102,47,33,14,36300,15400,51700
500800,202102,435,192,243,211200,267300,478500
500830,202102,2219,1226,993,1348600,1092300,2440900
500840,202102,131,97,34,106700,37400,144100
510010,202102,172,89,83,97900,91300,189200
510020,202102,506,214,292,236500,321200,557700
510025,202102,1667,955,712,1050500.37,784300,1834800.37
510030,202102,664,337,327,370700,360800,731500
510035,202102,126,62,64,68200,70400,138600
510040,202102,394,180,214,198000,236500,434500
510050,202102,384,212,172,233200,189200.3,422400.3
510060,202102,120,58,62,63800,68200,132000
510080,202102,227,90,137,99000,150700,249700
510100,202102,63,26,37,28600,40700,69300
510120,202102,33,20,13,22000,14300,36300
510125,202102,374,232,142,255200,157300,412500
510130,202102,532,314,218,345400,240900,586300
510140,202102,434,129,305,141900,335500,477400
510160,202102,109,35,74,38500,81400,119900
510170,202102,786,479,307,528000.56,337700,865700.56
510180,202102,2914,1355,1559,1492700,1719300,3212000
510185,202102,19,8,11,8800,12100,20900
510190,202102,236,85,151,93500,166100,259600
510250,202102,2572,1530,1042,1685860,1147300,2833160
510260,202102,174,127,47,139700,51700,191400
510263,202102,461,257,204,282700,224400,507100
510267,202102,648,361,287,397100,316800,713900
510268,202102,61,27,34,29700,37400,67100
510269,202102,73,31,42,34100,46200,80300
510270,202102,381,192,189,211200,207900,419100
510279,202102,216,164,52,180400,57200,237600
510285,202102,183,74,109,81400,119900,201300
510300,202102,508,266,242,292600,267300,559900
510305,202102,200,92,108,101200,118800,220000
510310,202102,107,54,53,59400,58300,117700
510320,202102,842,532,310,585200,341000,926200
510325,202102,418,174,244,191400,270600,462000
510330,202102,424,238,186,261800,204600,466400
510335,202102,633,357,276,392700,303600,696300
510336,202102,56,39,17,42900,18700,61600
510337,202102,107,45,62,49500,68200,117700
510340,202102,17165,7710,9455,8486500.63,10411500,18898000.63
510343,202102,62,44,18,48400,20900,69300
510345,202102,156,100,56,110000,61600,171600
510350,202102,646,351,295,386100,324500,710600
510360,202102,203,125,78,137500,85800,223300
510370,202102,153,72,81,79200,89100,168300
510380,202102,86,63,23,69300,25300,94600
510385,202102,62,27,35,29700,38500,68200
510390,202102,109,47,62,51700,68200,119900
510395,202102,45,32,13,35200,14300,49500
510410,202102,710,460,250,507100,275000,782100
510420,202102,556,269,287,297000,315700,612700
510450,202102,50,25,25,27500,27500,55000
510452,202102,51,24,27,26400,29700,56100
510454,202102,53,24,29,26400,33000,59400
510455,202102,136,76,60,83600,66000,149600
510460,202102,179,81,98,89100,107800,196900
510480,202102,700,414,286,456500,315700,772200
510490,202102,346,174,172,192500,189200,381700
510500,202102,240,181,59,199100,64900,264000
510510,202102,783,460,323,506000,355300,861300
510515,202102,1231,634,597,699600,656700,1356300
510517,202102,261,116,145,127600,159500,287100
510520,202102,222,146,76,160600,83600,244200
510523,202102,100,78,22,85800,24200,110000
510525,202102,821,492,329,541200,361900,903100
510530,202102,20,13,7,14300,7700,22000
510550,202102,238,109,129,119900.69,141900,261800.69
510558,202102,294,144,150,158400,165000,323400
510560,202102,414,242,172,266200,189200,455400
510562,202102,631,460,171,506000,188100,694100
510590,202102,743,383,360,421300,396000,817300
510600,202102,234,121,113,133100,124300,257400
510610,202102,218,91,127,100100,139700,239800
510615,202102,181,81,100,89100,110000,199100
510617,202102,21,10,11,11000,12100,23100
510618,202102,120,58,62,63800,68200,132000
510619,202102,94,66,28,72600,30800,103400
510620,202102,161,92,69,101200,75900,177100
510621,202102,179,114,65,125400,71500,196900
510622,202102,484,291,193,320100,213400,533500
510623,202102,314,214,100,235400,110000,345400
510624,202102,96,48,48,52800,52800,105600
510625,202102,521,326,195,358600,214500.63,573100.63
510626,202102,110,68,42,74800,46200,121000
510627,202102,81,56,25,61600,27500,89100
510628,202102,151,89,62,97900,68200,166100
510629,202102,272,160,112,176000,123219.8,299219.8
510630,202102,428,219,209,240900,229900,470800
510631,202102,14,4,10,4400,11000,15400
510637,202102,345,196,149,215600,163900,379500
510642,202102,1006,535,471,588500,518100,1106600
510645,202102,2,0,2,0,2200,2200
510650,202102,1368,891,477,980100,524700,1504800
510665,202102,83,35,48,38500,52800,91300
510670,202102,59,33,26,36300,28600,64900
510675,202102,1143,732,411,806300,452100,1258400
510677,202102,338,175,163,192500,179300,371800
510680,202102,100,58,42,63800,46200,110000
510682,202102,204,104,100,114400,110000,224400
510685,202102,53,40,13,44000,14300,58300
510700,202102,571,328,243,360800,267300,628100
510704,202102,1166,608,558,671000,613800,1284800
510706,202102,134,67,67,73700,74800,148500
510710,202102,392,280,112,308000,123200,431200
510715,202102,58,40,18,44000,19800,63800
510718,202102,216,108,108,118800,118800,237600
510719,202102,43,17,26,18700,28600,47300
510720,202102,186,129,57,141900,62700,204600
510724,202102,85,33,52,36300,57200,93500
510726,202102,52,27,25,29700,27500,57200
510729,202102,55,21,34,23100,37400,60500
510730,202102,479,263,216,290400,237600,528000
510735,202102,110,44,66,48400,72600,121000
510740,202102,19,11,8,12100,8800,20900
510757,202102,23,18,5,19800,5500,25300
510760,202102,7097,3618,3479,3982000,3831300,7813300
510770,202102,676,316,360,347600,396000,743600
510774,202102,17,5,12,5500,13200,18700
510775,202102,107,81,26,89100,28600,117700
510776,202102,28,11,17,12100,18700,30800
510777,202102,193,83,110,91300,121000,212300
510779,202102,51,25,26,27500,28600,56100
510780,202102,280,159,121,174900,133100,308000
510785,202102,383,205,178,225500,195800,421300
510787,202102,190,92,98,101200,107800,209000
510788,202102,5,1,4,1100,4400,5500
510790,202102,2494,1305,1189,1437787.66,1309000,2746787.66
510792,202102,1130,634,496,697400,545600.54,1243000.54
510794,202102,114,62,52,68200,57200,125400
510795,202102,2277,1333,944,1466300.11,1039500,2505800.11
510800,202102,172,104,68,114400,74800,189200
510805,202102,190,127,63,139700,69300,209000
510810,202102,99,44,55,48400,60500,108900
510820,202102,240,118,122,129800,134200.5,264000.5
510830,202102,72,41,31,45100,34100,79200
510835,202102,14,9,5,9900,5500,15400
510840,202102,9025,4267,4758,4698100,5242600,9940700
510850,202102,223,89,134,97900,147400,245300
510860,202102,369,165,204,181500,224400,405900
510880,202102,68,47,21,51700,23100,74800
510885,202102,69,38,31,41800,34100,75900
510890,202102,64,37,27,40700,29700,70400
510895,202102,169,100,69,110000,77000,187000
520005,202102,127,52,75,57200,82500,139700
520010,202102,286,129,157,141900,172700,314600
520013,202102,735,483,252,532840,277200,810040
520015,202102,51,37,14,40700,15400,56100
520017,202102,86,49,37,53900,40700,94600
520020,202102,17,10,7,11000,7700,18700
520025,202102,2390,1240,1150,1364000,1265000,2629000
520030,202102,807,428,379,471075,416900,887975
520050,202102,70,50,20,55000,22000,77000
520055,202102,55,34,21,37400,23100,60500
520060,202102,172,112,60,123200,66000,189200
520080,202102,583,423,160,466400,176000,642400
520082,202102,16,11,5,12503.33,5500,18003.33
520085,202102,89,65,24,71500,26400,97900
520090,202102,91,62,29,68200,31900,100100
520110,202102,9258,3956,5302,4351600,5835500,10187100
520120,202102,12,7,5,7700,5500,13200
520130,202102,803,560,243,616000,268400,884400
520140,202102,11949,6640,5309,7305100,5845400.4,13150500.4
520145,202102,53,32,21,35200,23100,58300
520150,202102,162,129,33,141900,36300,178200
520160,202102,40,29,11,31900,12100,44000
520170,202102,250,142,108,156200,118800,275000
520180,202102,172,81,91,89100,100100,189200
520215,202102,208,140,68,154000,74800,228800
520235,202102,79,63,16,69300,17600,86900
520250,202102,122,69,53,75900,58300,134200
520260,202102,114,73,41,80300,45100,125400
520280,202102,45,31,14,34100,15400,49500
520310,202102,39,26,13,28600,14300,42900
520320,202102,181,109,72,119900,79200,199100
520330,202102,801,427,374,469700,411400,881100
520340,202102,361,212,149,233200,163900,397100
520350,202102,509,241,268,265100,294800,559900
520355,202102,86,49,37,53900,40700,94600
520357,202102,26,19,7,20900,7700,28600
520360,202102,2,2,0,2200,0,2200
520380,202102,131,73,58,80300,63800,144100
520390,202102,255,107,148,117700,162800,280500
520393,202102,15,10,5,11000,5500,16500
520396,202102,76,49,27,53900,29700,83600
520400,202102,192,115,77,126500,84700,211200
520410,202102,196,96,100,105600,110000,215600
520420,202102,21,14,7,15400,7700,23100
520425,202102,282,141,141,155100,155100,310200
520430,202102,493,242,251,266301.2,276100,542401.2
520440,202102,696,503,193,553300,212300,765600
520450,202102,1987,848,1139,932800,1254000,2186800
520455,202102,58,33,25,36300,27500,63800
520460,202102,39,24,15,26400,16500,42900
520465,202102,32,27,5,29700,5500,35200
520470,202102,434,277,157,304700,172700,477400
520480,202102,78,47,31,51700,34100,85800
520485,202102,105,38,67,41800,73700,115500
520490,202102,411,306,105,336600,115500,452100
520495,202102,163,97,66,106700,72600,179300
520500,202102,189,149,40,163900,44000,207900
520505,202102,191,109,82,119900,90200,210100
520510,202102,1807,853,954,938300,1049400,1987700
520520,202102,45,30,15,33000,16500,49500
520530,202102,220,169,51,185900,56100,242000
520540,202102,592,399,193,438900,212300,651200
520545,202102,133,78,55,85800,60500,146300
520547,202102,61,35,26,38500,28600,67100
520549,202102,1225,561,664,617100,731500,1348600
520551,202102,311,166,145,182600,159500,342100
520552,202102,36,24,12,26400,13200,39600
520570,202102,15,9,6,9900,6600,16500
520580,202102,272,170,102,187000,112200,299200
520590,202102,139,84,55,92400,60500,152900
520620,202102,1129,526,603,579700,663300,1243000
520630,202102,39,22,17,24200,18700,42900
520640,202102,390,226,164,248600,180400,429000
520650,202102,66,36,30,39600,33000,72600
520660,202102,45,24,21,26400,23100,49500
520670,202102,35,29,6,31900,6600,38500
520680,202102,44,28,16,30800,17600,48400
520690,202102,38,10,28,11000,30800,41800
520710,202102,32,29,3,31900,3300,35200
520725,202102,202,148,54,162800,59400,222200
520735,202102,55,35,20,38500,22000,60500
520740,202102,416,204,212,224400,233200,457600
520750,202102,37,25,12,27500,13200,40700
520753,202102,66,45,21,49500,23100,72600
520760,202102,101,67,34,73700,37400,111100
520780,202102,283,209,74,229900,81400,311300
520790,202102,157,92,65,101200,71500,172700
520800,202102,3401,1843,1558,2028400,1713800,3742200
520810,202102,148,115,33,126500,36300,162800
520815,202102,5,4,1,4400,1100,5500
520830,202102,145,99,46,108900,50600,159500
520840,202102,363,238,125,261800,137500,399300
520850,202102,101,60,41,66000,45100,111100
520860,202102,1757,1134,623,1247400,686400,1933800
520870,202102,31643,14724,16919,16200800.98,18614200,34815000.98
520880,202102,1150,608,542,669900,596200,1266100
520890,202102,786,481,305,529100,335500,864600
520910,202102,973,516,457,567600.4,502700,1070300.4
520915,202102,94,73,21,80300,23100,103400
520920,202102,430,202,228,222200,250800,473000
520929,202102,18,16,2,17600,2200,19800
520940,202102,73,49,24,53900,26400,80300
520945,202102,15,10,5,11000,5500,16500
520960,202102,43,27,16,29700,17600,47300
520970,202102,349,208,141,228800,155100,383900
520980,202102,96,69,27,75900,29700,105600
520990,202102,451,311,140,342100,154000,496100
520993,202102,125,58,67,63800,73700,137500
520995,202102,245,138,107,151800,117700,269500
521000,202102,1551,894,657,984500,722700,1707200
521010,202102,676,336,340,369600,374000,743600
521015,202102,14,9,5,9900,5500,15400
521020,202102,1414,1001,413,1101100,454300,1555400
521030,202102,56,37,19,40700,20900,61600
521040,202102,936,601,335,661100,368500,1029600
521056,202102,51,34,17,37400,18700,56100
521060,202102,129,84,45,92400,49500,141900
521080,202102,403,311,92,342100,101200,443300
521090,202102,548,356,192,391600,211200,602800
521100,202102,267,200,67,220000,73700,293700
521120,202102,1054,743,311,817300,342100,1159400
521130,202102,350,250,100,275000,110000,385000
521140,202102,180,100,80,110000,88000,198000
521150,202102,2617,1128,1489,1240800,1637900,2878700
521160,202102,28,15,13,16500,14300,30800
521170,202102,218,122,96,134200,105600,239800
521180,202102,1171,750,421,826100,463100,1289200
521190,202102,2504,1062,1442,1168200,1586200,2754400
521200,202102,55,41,14,45100,15400,60500
521205,202102,11,8,3,8800,3300,12100
521210,202102,118,70,48,77000,52800,129800
521220,202102,751,523,228,575300,250800,826100
521225,202102,31,21,10,23100,11000,34100
521230,202102,108,69,39,75900,42900,118800
521250,202102,6174,3487,2687,3835701.64,2956800,6792501.64
521260,202102,29,14,15,15400,16500,31900
521270,202102,142,109,33,119900,36300,156200
521280,202102,425,259,166,284900,182600,467500
521290,202102,25,15,10,16500,11000,27500
521295,202102,98,63,35,69300,38500,107800
521300,202102,219,120,99,132000,108900,240900
521305,202102,37,26,11,28600,12100,40700
521308,202102,1041,801,240,882200,265100,1147300
521310,202102,1327,768,559,844800,614900,1459700
521340,202102,17,14,3,15400,3300,18700
521350,202102,124,94,30,103400,33000,136400
521370,202102,176,125,51,137500,56100,193600
521375,202102,180,95,85,104500,93500,198000
521377,202102,49,38,11,41800,12100,53900
521380,202102,1055,666,389,733700,427900,1161600
521385,202102,13,8,5,8800,5500,14300
521390,202102,99,81,18,89100,19800,108900
521400,202102,349,233,116,256300,127600,383900
521405,202102,142,78,64,85800,70400,156200
521410,202102,68,48,20,52800,22000,74800
521440,202102,198,142,56,156200,61600,217800
521450,202102,742,411,331,452100,364100,816200
521460,202102,1128,725,403,798600,443300,1241900
521470,202102,13,9,4,9900,4400,14300
521480,202102,43,29,14,31900,15400,47300
521483,202102,314,193,121,212300,133100,345400
521486,202102,284,184,100,202400,110000,312400
521487,202102,22,11,11,12100,12100,24200
521490,202102,23,12,11,13200,12100,25300
521500,202102,129,74,55,81400,60500,141900
521520,202102,45,32,13,35200,14300,49500
521523,202102,754,448,306,492800,337700,830500
521525,202102,47,29,18,31900,19800,51700
521530,202102,239,131,108,144100,118800,262900
521540,202102,34,17,17,18700,18700,37400
521550,202102,89,36,53,39600,58300,97900
521560,202102,816,555,261,610500,287100,897600
521565,202102,62,43,19,47300,20900,68200
521570,202102,531,356,175,391600,192500,584100
521580,202102,56,31,25,34100,27500,61600
521590,202102,38,18,20,19800,22000,41800
521600,202102,21,11,10,12100,11000,23100
521630,202102,244,132,112,146300,123200,269500
521640,202102,301,162,139,178200,152900,331100
521645,202102,36,17,19,18700,20900,39600
521680,202102,246,151,95,166100,104500,270600
521690,202102,2,2,0,2200,0,2200
521710,202102,1135,542,593,597300,652300,1249600
521720,202102,562,389,173,427900,190300,618200
521730,202102,665,318,347,349800,381700,731500
521740,202102,882,379,503,416900,553300,970200
521760,202102,1999,1027,972,1129700.95,1069200,2198900.95
521770,202102,823,518,305,569800,335500,905300
521800,202102,1972,1275,697,1402500,766700,2169200
521805,202102,33,17,16,18700,17600,36300
521810,202102,86,54,32,59400,35200,94600
521830,202102,960,684,276,752400.73,303600,1056000.73
521839,202102,86,52,34,57200,37400,94600
521850,202102,1108,577,531,635800.17,584100,1219900.17
521860,202102,332,206,126,226600,138600,365200
521870,202102,69,42,27,46200,29700,75900
521878,202102,36,16,20,17600,22000,39600
521880,202102,4735,2109,2626,2319900,2890800,5210700
521890,202102,593,414,179,455400.3,196900,652300.3
521900,202102,284,231,53,254100,58300,312400
521910,202102,159,112,47,123200,51700,174900
521920,202102,44,22,22,24200,24200,48400
521925,202102,53,31,22,34100,24200,58300
521930,202102,1150,643,507,707300,557700,1265000
521935,202102,34,24,10,26400,11000,37400
521940,202102,199,96,103,105600,113300,218900
521945,202102,18,13,5,14300,5500,19800
521950,202102,9,5,4,5500,4400,9900
521960,202102,70,52,18,57200,19800,77000
521970,202102,404,257,147,282700,161700,444400
521971,202102,106,58,48,63800,52800,116600
521973,202102,33,17,16,18700,17600,36300
521975,202102,1469,736,733,809600.75,806300.18,1615900.93
521980,202102,242,166,76,182600,83600,266200
521990,202102,75,53,22,58300,24200,82500
522000,202102,292,187,105,205316.1,115500,320816.1
522005,202102,18,10,8,11000,8800,19800
522010,202102,1132,631,501,694100,551100,1245200
522015,202102,58,33,25,36300,27500,63800
522020,202102,889,514,375,565400,413600,979000
522026,202102,23,14,9,15400,9900,25300
522028,202102,15,11,4,12100,4400,16500
522040,202102,769,313,456,344300,501600,845900
522045,202102,2348,1430,918,1573000,1009800,2582800
522050,202102,158,77,81,84700,89100,173800
522060,202102,545,336,209,369600,229900,599500
522068,202102,109,77,32,84700,35200,119900
522070,202102,9,9,0,9900,0,9900
522100,202102,37,21,16,23100,17600,40700
522108,202102,43,31,12,34100,13200,47300
522119,202102,56,32,24,35200,26400,61600
522130,202102,76,28,48,30800,52800,83600
522140,202102,4010,2047,1963,2252800.01,2159300,4412100.01
522145,202102,49,35,14,38500,15400,53900
522150,202102,97,68,29,74800,31900,106700
522155,202102,56,41,15,45100,16500,61600
522157,202102,6,3,3,3300,3300,6600
522160,202102,1689,994,695,1094500,764500,1859000
522170,202102,399,267,132,294800,145200,440000
522180,202102,36,17,19,18700,20900,39600
522185,202102,2102,845,1257,929500,1383800,2313300
522190,202102,52,27,25,29700,27500,57200
522200,202102,298,179,119,198000,130900,328900
522205,202102,139,93,46,102300,50600,152900
522220,202102,143,105,38,115500,41800,157300
522230,202102,30,24,6,26400,6600,33000
530010,202102,54009,27284,26725,30021885.6,29409777.54,59431663.14
110001,202103,509,410,99,451000,108900,559900
110002,202103,2826,1775,1051,1956900,1157200.34,3114100.34
110003,202103,79,66,13,72600,14300,86900
110004,202103,2032,1343,689,1477300,761200,2238500
110005,202103,432,344,88,378400,96800,475200
110006,202103,447,338,109,372240,119900,492140
110007,202103,69,57,12,62700,13200,75900
110008,202103,241,133,108,146300,118800,265100
110009,202103,906,664,242,732600,267300,999900
110010,202103,1675,1020,655,1122000,722700,1844700
110011,202103,1735,1348,387,1487200,425700,1912900
110012,202103,4071,2373,1698,2614700.06,1872200,4486900.06
110013,202103,766,610,156,674300,173800,848100
110014,202103,375,325,50,357500,55000,412500
110015,202103,1379,1104,275,1222100,302500,1524600
110018,202103,1077,671,406,740300,446600,1186900
110020,202103,15447,8850,6597,9753701.49,7280900,17034601.49
110025,202103,649,478,171,525800,188100,713900
110026,202103,36,26,10,28600,11000,39600
110028,202103,1607,1155,452,1271600,498300,1769900
110029,202103,133,119,14,132000,15400,147400
110030,202103,2389,1603,786,1766424.18,864600.85,2631025.03
110032,202103,320,245,75,270600,82500,353100
110033,202103,647,468,179,514800,196900,711700
110034,202103,334,246,88,270600.5,96800,367400.5
110037,202103,94,83,11,91300,12100,103400
110040,202103,377,255,122,280500,134200,414700
110045,202103,930,642,288,708400,316800,1025200
110050,202103,91,80,11,88000,12100,100100
110060,202103,66,39,27,42900,29700,72600
110070,202103,105,68,37,74800,40700,115500
110080,202103,495,278,217,305800,238700,544500
110090,202103,24,21,3,23100,3300,26400
110092,202103,103,55,48,61600,53900,115500
110094,202103,194,140,54,155100,59400,214500
110100,202103,40,27,13,29700,14300,44000
110110,202103,94,52,42,57200,46200,103400
110120,202103,68,60,8,66000,8800,74800
110130,202103,281,230,51,253000,56100,309100
110140,202103,240,169,71,185900,78100,264000
110143,202103,48,39,9,42900,9900,52800
110145,202103,29,22,7,24200,7700,31900
110146,202103,22,12,10,13200,11000,24200
110147,202103,37,25,12,27500,13200,40700
110148,202103,34,24,10,26400,11000,37400
110149,202103,310,221,89,244200,99000,343200
110150,202103,130,100,30,110000,33000,143000
110155,202103,10,10,0,11000,0,11000
110160,202103,66,52,14,57200,15400,72600
110170,202103,219,166,53,182600,58300,240900
110175,202103,66,50,16,55000,17600,72600
110180,202103,86,72,14,79200,15400,94600
120001,202103,194,143,51,157300,56100,213400
120005,202103,198,115,83,126500.41,91300,217800.41
120010,202103,1103,681,422,749100,464200,1213300
120013,202103,145,98,47,107800.33,51700,159500.33
120017,202103,108,60,48,66000,52800,118800
120020,202103,3508,2837,671,3122901.2,740300,3863201.2
120025,202103,535,303,232,333300.4,255200,588500.4
120030,202103,1053,910,143,1002100.7,158400,1160500.7
120032,202103,35,31,4,34100,4400,38500
120033,202103,213,190,23,209000,25300,234300
120034,202103,172,125,47,137500,51700,189200
120035,202103,37,31,6,34100,6600,40700
120038,202103,415,274,141,301400,155100,456500
120039,202103,29,28,1,30800,1100,31900
120040,202103,13874,9482,4392,10440904.8,4849900,15290804.8
120042,202103,44,38,6,41800,6600,48400
120043,202103,12,3,9,3300,9900,13200
120045,202103,530,338,192,372900,211200,584100
120050,202103,1273,973,300,1070301,330000,1400301
120060,202103,1468,1204,264,1326600,292600,1619200
120070,202103,417,302,115,332200.6,126500,458700.6
120080,202103,177,110,67,121000,73700,194700
130002,202103,162,116,46,127600,50600,178200
130006,202103,104,66,38,72600,41800,114400
130008,202103,129,70,59,77000,66000,143000
130010,202103,150,84,66,92400,72600,165000
130014,202103,272,196,76,216700,83600,300300
130020,202103,100,61,39,67100,42900,110000
130030,202103,975,569,406,625900,447700,1073600
130040,202103,337,164,173,180400,190300,370700
130050,202103,563,293,270,322300,297000,619300
130060,202103,835,570,265,628100,292600,920700
130063,202103,589,338,251,371800,277200,649000
130068,202103,184,113,71,124300,78100,202400
130070,202103,1300,879,421,966900,463100,1430000
130080,202103,716,479,237,526900,261800,788700
130083,202103,70,38,32,41800,35200,77000
130090,202103,322,166,156,182600,171600,354200
130100,202103,1111,470,641,517000,706200,1223200
130110,202103,742,317,425,348700,468600,817300
130115,202103,160,69,91,75900,100100,176000
130120,202103,1620,1014,606,1115400,667700,1783100
130130,202103,623,422,201,464200,221100,685300
130140,202103,1561,1223,338,1346400,371800,1718200
130150,202103,412,365,47,401500,51700,453200
130160,202103,454,262,192,288200,211200,499400
130165,202103,40,31,9,34100,9900,44000
130170,202103,1005,702,303,772129.6,333300.9,1105430.5
130180,202103,235,177,58,194700,63800,258500
130185,202103,2244,1037,1207,1142900,1327700,2470600
130190,202103,3358,2116,1242,2330900,1370600,3701500
130195,202103,276,219,57,240900,62700,303600
130200,202103,176,82,94,90200,103400,193600
130210,202103,74,36,38,39600,41800,81400
130220,202103,176,120,56,132000,61600,193600
130230,202103,384,250,134,275000,147400,422400
130240,202103,1292,821,471,904200,518100,1422300
130250,202103,4696,3013,1683,3314300,1854600,5168900
130255,202103,425,207,218,227700,239800,467500
130260,202103,56727,26813,29914,29523910.95,32970531,62494441.95
130270,202103,1547,1057,490,1162799,539000,1701799
130280,202103,118,66,52,72600,57200,129800
130290,202103,2082,1425,657,1567500,724900,2292400
130300,202103,427,297,130,326700,143000,469700
130310,202103,925,493,432,542300,475200,1017500
130320,202103,523,272,251,299200,276100,575300
130330,202103,782,490,292,539000,321200,860200
130340,202103,3441,1956,1485,2151600,1634600,3786200
130350,202103,475,318,157,350900,173800,524700
130353,202103,931,407,524,448800,576400,1025200
130356,202103,813,364,449,400400,493900,894300
130360,202103,89,66,23,72600,25300,97900
130370,202103,699,537,162,590700,178200,768900
130380,202103,664,510,154,562100,169400,731500
130390,202103,476,384,92,422400,101200,523600
130395,202103,157,38,119,41800,130900,172700
130400,202103,67,45,22,49500,24200,73700
130406,202103,2046,1219,827,1342000,910800,2252800
130410,202103,435,209,226,229900,248600,478500
130420,202103,2894,2344,550,2578400,605000,3183400
130423,202103,155,79,76,86900,83600,170500
130426,202103,157,78,79,85800,86900,172700
130430,202103,416,256,160,281600,176000,457600
130440,202103,195,58,137,63800,150700,214500
140002,202103,15,4,11,4400,12100,16500
140005,202103,201,120,81,132000,89100,221100
140010,202103,10943,6892,4051,7596602.9,4481400,12078002.9
140015,202103,135,61,74,67100,81400,148500
140017,202103,124,74,50,81400,55000,136400
140020,202103,468,303,165,333300,181500,514800
140023,202103,35,18,17,19800,18700,38500
140028,202103,23,12,11,13200,12100,25300
140030,202103,354,242,112,267300,123200,390500
140040,202103,62,44,18,48400,19800,68200
140045,202103,269,103,166,113300,182600,295900
140047,202103,411,278,133,305800,146300,452100
140050,202103,138,85,53,93500,58300,151800
140060,202103,55,37,18,40700,19800,60500
140070,202103,31,28,3,30800,3300,34100
150010,202103,4755,2877,1878,3168000,2065800,5233800
150013,202103,161,115,46,126500,50600,177100
150020,202103,1098,593,505,653400,557700,1211100
150030,202103,708,317,391,348700,430100,778800
150034,202103,204,126,78,138600,85800,224400
150040,202103,1493,851,642,938300,709500,1647800
150050,202103,696,390,306,429000,336600,765600
150060,202103,4892,3089,1803,3404407,1994755.4,5399162.4
150070,202103,417,216,201,237600,221100,458700
150080,202103,15427,7302,8125,8045400.06,8956200,17001600.06
150085,202103,433,273,160,300300,178200,478500
150090,202103,704,594,110,654500,121000,775500
150095,202103,367,231,136,254100,150700,404800
150100,202103,60,39,21,42900,23100,66000
150110,202103,201,108,93,118800,103400,222200
150120,202103,399,288,111,316800,123200,440000
150125,202103,49,17,32,18700,35200,53900
150130,202103,2058,1073,985,1183600,1083500,2267100
150140,202103,55521,24932,30589,27462600,33715000.7,61177600.7
150145,202103,223,121,102,134200.82,113300,247500.82
150150,202103,3034,1314,1720,1446500,1895300,3341800
150157,202103,381,266,115,292600,127600,420200
150160,202103,126,98,28,107800,30800,138600
150170,202103,3663,2718,945,2993100,1039500,4032600
150172,202103,342,240,102,264000,112200,376200
150175,202103,80,48,32,52800,35200,88000
150178,202103,759,503,256,553300,281600,834900
150180,202103,3186,1550,1636,1706100,1800700,3506800
150190,202103,351,218,133,239800,146300,386100
150195,202103,112,56,56,61600,61600,123200
150200,202103,193,91,102,100100,112200,212300
150210,202103,3155,2518,637,2773100,700700,3473800
150215,202103,573,358,215,393800,236500,630300
150220,202103,3592,2384,1208,2623500.82,1332100,3955600.82
150230,202103,1198,958,240,1054900.5,264000,1318900.5
150240,202103,6422,3626,2796,3990800.6,3081100,7071900.6
150250,202103,61,32,29,35200,31900,67100
150260,202103,93,61,32,67100,35200,102300
150270,202103,2197,1415,782,1558700,860200,2418900
150275,202103,529,335,194,368500,214500,583000
150276,202103,110,41,69,46200,75900,122100
150277,202103,796,351,445,386100,490600,876700
150280,202103,364,241,123,265100,135300,400400
150285,202103,109,54,55,59400,60324,119724
150290,202103,1150,676,474,743600,522500,1266100
150293,202103,707,329,378,361900,415800,777700
150295,202103,515,236,279,259600,306900,566500
150300,202103,83,39,44,44000,48400,92400
150304,202103,180,105,75,115500,82500,198000
150307,202103,404,334,70,367400,77000,444400
150309,202103,578,409,169,449900,185900.48,635800.48
150310,202103,244,158,86,173800,94600,268400
150320,202103,1892,1318,574,1449800,631400,2081200
150330,202103,2035,1173,862,1290300,951500,2241800
150340,202103,196,130,66,143000,72600,215600
150345,202103,628,349,279,383900,306900,690800
150350,202103,406,315,91,346500,100100,446600
150360,202103,4662,2862,1800,3150400,1980000,5130400
150370,202103,825,568,257,625900,282700,908600
150375,202103,199,91,108,100100,118800,218900
150380,202103,1502,995,507,1094500,557700,1652200
150390,202103,808,469,339,515900.86,374000,889900.86
150400,202103,110,91,19,100100,20900,121000
150405,202103,1226,779,447,858000,495000,1353000
150410,202103,118,74,44,81400,48400,129800
150420,202103,7450,4019,3431,4425480,3776300,8201780
150430,202103,624,390,234,429000,257400,686400
150440,202103,448,280,168,308000,184800,492800
150442,202103,2323,1236,1087,1360700,1196800,2557500
150445,202103,544,353,191,388300,211200,599500
150450,202103,225,121,104,133100,114400,247500
150460,202103,737,548,189,602800,207900,810700
150470,202103,1289,771,518,848100,569800,1417900
150475,202103,236,179,57,196900,62700,259600
150480,202103,1305,902,403,994400,444400,1438800
150490,202103,659,389,270,427900,297000,724900
150495,202103,335,247,88,271700,96800,368500
150497,202103,276,190,86,209000,94600,303600
150500,202103,226,136,90,149600,99000,248600
150503,202103,1080,541,539,595100,594000,1189100
150506,202103,929,617,312,678700,344300,1023000
150510,202103,1269,701,568,771100,625900,1397000
150520,202103,294,194,100,213400,110000,323400
150530,202103,1713,937,776,1032900,863500,1896400
150540,202103,225,163,62,179300,68200,247500
150543,202103,826,420,406,464200,447700,911900
150548,202103,467,332,135,365200,148500,513700
150549,202103,60,42,18,46200,19800,66000
150550,202103,2965,1490,1475,1642300,1622500,3264800
150553,202103,3374,1902,1472,2094400.2,1620300,3714700.2
150555,202103,147,80,67,88000,73700,161700
150560,202103,35,14,21,15400,23100,38500
150563,202103,118,55,63,60500,69300,129800
150565,202103,191,117,74,128700,81400,210100
150570,202103,425,281,144,309100,158400,467500
150580,202103,1684,809,875,891000,962500,1853500
150590,202103,813,536,277,589600,304700,894300
150600,202103,487,292,195,321200,215600,536800
150610,202103,147,118,29,129800,33000,162800
150611,202103,124,81,43,89100,47300,136400
150613,202103,3246,1894,1352,2086700,1488300,3575000
150616,202103,541,301,240,331100,264000,595100
150618,202103,1350,707,643,777700,708400,1486100
150619,202103,394,298,96,327800,105600,433400
150620,202103,1258,724,534,796400,587400,1383800
150630,202103,322,205,117,226600,128700,355300
150635,202103,461,189,272,207900,299200,507100
150640,202103,46,23,23,25300,25300,50600
150650,202103,2404,1397,1007,1536700,1108800,2645500
150655,202103,240,177,63,194700,69300,264000
150658,202103,85,51,34,56100,37400,93500
150660,202103,547,355,192,390500,211200,601700
150670,202103,1091,380,711,418000,783200,1201200
150680,202103,10236,5354,4882,5896000.57,5384500,11280500.57
150690,202103,19,10,9,11000,9900,20900
150700,202103,488,318,170,349800,187000,536800
150710,202103,292,163,129,179300,141900,321200
150715,202103,841,527,314,579700,345400,925100
150720,202103,416,318,98,349800,107800,457600
150730,202103,1035,515,520,567600,572000,1139600
150740,202103,229,150,79,166100,86900,253000
150745,202103,751,416,335,458700,368500,827200
150746,202103,62,34,28,37400,30800,68200
150747,202103,227,169,58,185900,63800,249700
150750,202103,136,76,60,83600,66000,149600
150760,202103,1831,1194,637,1313400.5,700700,2014100.5
150770,202103,388,214,174,235400,191400,426800
150775,202103,107,51,56,56100,61600,117700
150780,202103,200,110,90,121000,99000,220000
150790,202103,892,506,386,556600,424600,981200
150795,202103,1558,925,633,1019700,696300,1716000
150796,202103,351,199,152,218900,167200,386100
150797,202103,336,161,175,177100,192500,369600
150800,202103,1518,862,656,948200,721600,1669800
150803,202103,529,424,105,466400,115500,581900
150805,202103,205,120,85,133100,93500,226600
150808,202103,1001,535,466,588500,513700,1102200
150810,202103,3248,2205,1043,2426600.5,1152800,3579400.5
150812,202103,454,227,227,249700,249700,499400
150815,202103,1075,668,407,735900,451000,1186900
150820,202103,1555,928,627,1020800,690800,1711600
150830,202103,722,525,197,578600,217800,796400
150835,202103,209,125,84,137500,92400,229900
150840,202103,1369,830,539,913000,595100,1508100
160005,202103,64,45,19,49500,20900,70400
160010,202103,189,120,69,132000,75900,207900
160015,202103,130,78,52,85800,57200,143000
160020,202103,136,74,62,81400,68200,149600
160021,202103,61,28,33,30800,37400,68200
160023,202103,68,44,24,48400,26400,74800
160025,202103,26,12,14,13200,15400,28600
160027,202103,1468,834,634,917400,697400,1614800
160030,202103,16085,8250,7835,9082700.01,8628400,17711100.01
160040,202103,303,175,128,192500,140800,333300
160050,202103,729,360,369,396000,405900,801900
160053,202103,283,169,114,185900,126500,312400
160055,202103,24,15,9,16500,9900,26400
160060,202103,6578,3489,3089,3839000.23,3399000,7238000.23
160070,202103,179,101,78,111100,85800,196900
160080,202103,115,57,58,62700,63800,126500
170025,202103,29,15,14,16500,15400,31900
170030,202103,201,165,36,181500.03,39600,221100.03
170035,202103,217,102,115,112200,127600,239800
170040,202103,179,133,46,146300,50600,196900
170070,202103,321,198,123,217800,135300,353100
170100,202103,344,252,92,277200,101200,378400
170105,202103,56,45,11,49500,12100,61600
170110,202103,112,66,46,72600,50600,123200
170130,202103,70,35,35,38500,38500,77000
170190,202103,96,57,39,62700,42900,105600
170200,202103,368,255,113,281600,124300,405900
170210,202103,6156,3231,2925,3559334.25,3224100,6783434.25
170215,202103,111,49,62,53900,68200,122100
170220,202103,1370,1004,366,1107700,403700,1511400
170230,202103,147,97,50,106700,55000,161700
170240,202103,516,346,170,380600,187000,567600
170255,202103,1070,874,196,961400,215600,1177000
170270,202103,45,31,14,34100,15400,49500
170290,202103,114,76,38,83600,41800,125400
170300,202103,100,62,38,68200,41800,110000
170305,202103,48,37,11,40700,12100,52800
170307,202103,63,48,15,53900,16500,70400
170310,202103,118,64,54,70400,59400,129800
170320,202103,26,16,10,17600,11000,28600
170330,202103,25,22,3,24200,3300,27500
170360,202103,32,18,14,19800,15400,35200
170370,202103,101,50,51,55000,56100,111100
170380,202103,74,55,19,60500,20900,81400
170382,202103,43,36,7,39600,7700,47300
170384,202103,143,111,32,122100,35200,157300
170386,202103,67,26,41,28600,45100,73700
170388,202103,49,19,30,20900,33000,53900
170389,202103,26,21,5,23100,5500,28600
170390,202103,75,42,33,46200,36300,82500
170410,202103,27,22,5,24200,5500,29700
170460,202103,17,11,6,12100,6600,18700
170510,202103,35,28,7,30800,7700,38500
170550,202103,1536,890,646,980100,711700,1691800
170555,202103,111,81,30,89100,33000,122100
170560,202103,104,73,31,80300,34100,114400
170600,202103,41,15,26,16500,28600,45100
170610,202103,196,100,96,110000,105600,215600
170625,202103,37,22,15,24200,16500,40700
170650,202103,79,57,22,62700,24200,86900
170700,202103,585,434,151,477400,166100,643500
170710,202103,158,97,61,106700,67100,173800
170720,202103,90,70,20,77000,22000,99000
170730,202103,88,52,36,57200,39600,96800
170740,202103,87,59,28,64900,30800,95700
170755,202103,58,31,27,34100,29700,63800
170765,202103,142,75,67,82500,73700,156200
170770,202103,201,127,74,139700,82500,222200
170820,202103,610,404,206,444400,226600,671000
170825,202103,38,19,19,20900,20900,41800
170830,202103,86,67,19,73700,20900,94600
170900,202103,177,134,43,147400,47300,194700
170930,202103,921,492,429,542300,474100,1016400
170950,202103,3136,1436,1700,1581800,1873300.4,3455100.4
170980,202103,18,10,8,11000,8800,19800
171050,202103,148,114,34,125400,37400,162800
171070,202103,45,37,8,41800,8800,50600
171090,202103,49,36,13,39600,14300,53900
171110,202103,23,16,7,17600,7700,25300
171150,202103,41,21,20,23100,22000,45100
171180,202103,28,14,14,15400,15400,30800
171190,202103,158,92,66,101200,73700,174900
171195,202103,63,51,12,56100,13200,69300
171200,202103,49,24,25,26400,27500,53900
171215,202103,4,3,1,3300,1100,4400
171240,202103,60,42,18,46200,19800,66000
171245,202103,56,48,8,52800,8800,61600
171250,202103,78,44,34,48400,37400,85800
171270,202103,14,10,4,11000,4400,15400
171280,202103,39,34,5,37400,5500,42900
171320,202103,1004,573,431,630300,475200,1105500
171330,202103,428,216,212,237600,235400,473000
171360,202103,91,63,28,69300,30800,100100
171370,202103,33,16,17,17600,18700,36300
171380,202103,128,110,18,121000,19800,140800
171395,202103,51,31,20,35200,22000,57200
171420,202103,269,175,94,192500,103400,295900
171430,202103,72,57,15,63800,16500,80300
171488,202103,185,102,83,112200,91300,203500
171500,202103,61,34,27,37400,29700,67100
171510,202103,71,47,24,51700,26400,78100
171515,202103,41,32,9,35200,9900,45100
171525,202103,29,27,2,29700,2200,31900
171550,202103,15,9,6,9900,6600,16500
171570,202103,49,25,24,27500,26400,53900
171575,202103,299,195,104,214500,114400,328900
171610,202103,1734,881,853,969100,941600,1910700
171620,202103,139,94,45,103400,49500,152900
171630,202103,55,29,26,31900,28600,60500
171650,202103,313,220,93,242000,102300,344300
171660,202103,266,149,117,163900,128700,292600
171665,202103,64,42,22,46200,24200,70400
171670,202103,431,259,172,286000.06,189200,475200.06
171700,202103,64,56,8,61600,8800,70400
171720,202103,29,11,18,12100,19800,31900
171750,202103,104,54,50,59400,55000,114400
171780,202103,72,56,16,61600,17600,79200
171790,202103,81,67,14,74800,15400,90200
171800,202103,31,23,8,25300,8800,34100
171820,202103,2100,1196,904,1316700.7,995500,2312200.7
171830,202103,35,27,8,29700,8800,38500
171840,202103,65,41,24,45100,26400,71500
171845,202103,29,18,11,19800,12100,31900
171850,202103,38,31,7,34100,7700,41800
171855,202103,79,61,18,67100,19800,86900
171865,202103,8,7,1,7700,1100,8800
171870,202103,33,22,11,24200,12100,36300
171875,202103,80,57,23,62700,25300,88000
171880,202103,36,23,13,25300,14300,39600
171884,202103,50,27,23,29700,25300,55000
171886,202103,132,54,78,59400,85800,145200
171888,202103,29,23,6,25300,6600,31900
171889,202103,14,8,6,8800,6600,15400
171890,202103,54,45,9,49500,9900,59400
171900,202103,35,25,10,27500,11000,38500
172000,202103,39,31,8,34100,8800,42900
172010,202103,52,43,9,47300,9900,57200
172015,202103,24,17,7,18700,7700,26400
172020,202103,143,89,54,97900,59400,157300
172025,202103,40,26,14,28600,15400,44000
172030,202103,42,23,19,25300,20900,46200
172049,202103,85,55,30,60500,33000,93500
172065,202103,131,86,45,94600,50600,145200
172080,202103,105,67,38,73700,41800,115500
172085,202103,29,14,15,15400,16500,31900
172090,202103,431,326,105,358600.56,115500,474100.56
172093,202103,15,13,2,14300,2200,16500
172097,202103,18,11,7,12100,7700,19800
172100,202103,5178,2928,2250,3226300,2482700,5709000
172110,202103,77,49,28,53900,30800,84700
172120,202103,1652,1390,262,1532300,288200,1820500
172125,202103,9,8,1,8800,1100,9900
172130,202103,24,14,10,15400,11000,26400
172208,202103,206,124,82,136400,90200,226600
172210,202103,372,181,191,199100,211200,410300
210005,202103,2970,1863,1107,2049300.32,1218800.14,3268100.46
210010,202103,155,88,67,96800,73700,170500
210015,202103,40,29,11,31900,12100,44000
210020,202103,366,206,160,226600,176000,402600
210030,202103,326,217,109,238700,119900,358600
210040,202103,140,111,29,122100,31900,154000
210043,202103,256,195,61,214500,67100,281600
210047,202103,531,322,209,354200,229900,584100
210050,202103,283,210,73,231000,81400,312400
210055,202103,52,42,10,46200,11000,57200
210060,202103,536,430,106,473000,117700,590700
210070,202103,422,321,101,353100,111100,464200
210080,202103,128,115,13,126500,14300,140800
210083,202103,292,139,153,154000,168300,322300
210087,202103,2,1,1,1100,1100,2200
210090,202103,442,317,125,348700,137500,486200
210095,202103,427,326,101,358600,111100,469700
210100,202103,703,551,152,606100,167200,773300
210110,202103,126,81,45,89100,49500,138600
210120,202103,5003,3926,1077,4324100,1184700.5,5508800.5
210125,202103,187,115,72,126500,79200,205700
210130,202103,468,270,198,297000,217800,514800
210135,202103,26,19,7,20900,7700,28600
210140,202103,4390,3414,976,3757600.1,1074700,4832300.1
210150,202103,376,239,137,262900,150700,413600
210160,202103,3264,2778,486,3056900.54,534600,3591500.54
210170,202103,1161,932,229,1025200,251900,1277100
210173,202103,126,110,16,121000,17600,138600
210177,202103,354,201,153,221100,168300,389400
210180,202103,30,16,14,17600,15400,33000
210190,202103,432,286,146,314600,160600,475200
210193,202103,4,3,1,3300,1100,4400
210197,202103,75,54,21,59400,23100,82500
210200,202103,613,516,97,568700,106700,675400
210203,202103,222,151,71,166100,78100,244200
210207,202103,363,300,63,330000,69300,399300
210210,202103,741,685,56,753500,61600,815100
210215,202103,74,65,9,71500,9900,81400
210220,202103,384,324,60,356400,66000,422400
210230,202103,314,251,63,276100,69300,345400
210232,202103,1363,930,433,1025200,476300,1501500
210235,202103,175,133,42,146300,46200,192500
210237,202103,35,21,14,23100,15400,38500
210240,202103,98,76,22,83600,24200,107800
210250,202103,181,154,27,169400,29700,199100
210255,202103,352,267,85,293700,93500,387200
210260,202103,399,273,126,300300,138600,438900
210270,202103,652,437,215,481800,236500,718300
210275,202103,79,62,17,68200,18700,86900
210280,202103,1042,690,352,759000,387200,1146200
210290,202103,543,365,178,401500,195800,597300
210300,202103,5288,3349,1939,3685001.54,2134000,5819001.54
210310,202103,110,76,34,83600,37400,121000
210312,202103,116,81,35,89100,38500,127600
210315,202103,107,88,19,96800,20900,117700
210317,202103,135,101,34,111100,37400,148500
210320,202103,2308,1972,336,2170300,369600,2539900
210325,202103,140,88,52,96800,57200,154000
210330,202103,4562,2624,1938,2887500,2132900,5020400
210340,202103,1234,925,309,1017500,339900,1357400
210350,202103,648,542,106,596200,116600,712800
210355,202103,152,128,24,140800,26400,167200
210360,202103,2213,1528,685,1680800,753500,2434300
210370,202103,1239,611,628,673200,690800,1364000
210375,202103,191,97,94,106700,103400,210100
210380,202103,718,551,167,606100,183700,789800
210390,202103,195,167,28,183700,30800,214500
210400,202103,391,341,50,375100,55000,430100
210405,202103,975,685,290,754600,319000,1073600
210407,202103,58,47,11,51700,12100,63800
210408,202103,59,52,7,57200,7700,64900
210409,202103,327,286,41,315700,45100,360800
210410,202103,444,348,96,382800,106700,489500
210420,202103,200,165,35,182600,39600,222200
210430,202103,50,35,15,38500,17600,56100
210440,202103,341,229,112,251900,123200,375100
210450,202103,137,110,27,121000,29700,150700
210455,202103,232,123,109,135300,122100,257400
210460,202103,303,205,98,225500,107800,333300
210462,202103,69,58,11,63800,12100,75900
210465,202103,139,109,30,119900,33000,152900
210467,202103,517,380,137,418000,150700,568700
210470,202103,48,41,7,45100,7700,52800
210480,202103,1279,919,360,1010900,397100.5,1408000.5
210490,202103,196,130,66,143000,73700,216700
210500,202103,513,313,200,344300,220000,564300
210510,202103,546,437,109,480700,119900,600600
210515,202103,356,224,132,246400,145200,391600
210520,202103,401,363,38,399300,42900,442200
210530,202103,9373,4896,4477,5387800.48,4924700.83,10312501.31
210535,202103,133,100,33,110000,36300,146300
210540,202103,1520,1011,509,1112100,559900,1672000
210542,202103,1151,587,564,646800,620400,1267200
210545,202103,22,20,2,22000,2200,24200
210547,202103,129,115,14,126500,15400,141900
210550,202103,665,481,184,530200,202400,732600
210560,202103,158,138,20,151800,22000,173800
210565,202103,20,15,5,16500,5500,22000
210570,202103,1291,1048,243,1153900.59,267300,1421200.59
210580,202103,119,101,18,111100,19800,130900
210590,202103,730,605,125,665500,138600,804100
210592,202103,40,38,2,41800,2200,44000
210594,202103,112,94,18,103400,19800,123200
210596,202103,107,92,15,101200,16500,117700
210598,202103,136,102,34,113300,37400,150700
210600,202103,314,273,41,300300,45100,345400
210610,202103,261,246,15,270600,16500,287100
210620,202103,43,27,16,29700,17600,47300
210630,202103,73,70,3,77000,3300,80300
210632,202103,1024,727,297,800800,326700,1127500
210635,202103,23,20,3,22000,3300,25300
210637,202103,122,88,34,96800,37400,134200
210640,202103,583,510,73,561000,80300,641300
210650,202103,399,334,65,367400,71500,438900
210660,202103,371,293,78,323400,85800,409200
210663,202103,41,28,13,30800,14300,45100
210667,202103,101,40,61,44000,67100,111100
210670,202103,243,216,27,237600,29700,267300
210675,202103,541,293,248,322300,272800,595100
210680,202103,225,146,79,160600,86900,247500
210690,202103,620,511,109,562100,119900,682000
210700,202103,155,118,37,129800,40700,170500
210710,202103,241,152,89,167200,97900,265100
210720,202103,130,116,14,127600,15400,143000
210725,202103,63,55,8,60500,8800,69300
210730,202103,24,18,6,19800,6600,26400
210735,202103,294,212,82,233200,90200,323400
210740,202103,520,448,72,492800,79200,572000
210745,202103,153,114,39,125400,42900,168300
210750,202103,2425,1233,1192,1356300,1311200,2667500
210760,202103,256,197,59,216700,64900,281600
210770,202103,243,196,47,215600,51700,267300
210780,202103,437,327,110,359700,121000,480700
210790,202103,183,151,32,166100,35200,201300
210800,202103,175,132,43,145200,47300,192500
210805,202103,55,49,6,53900,6600,60500
210810,202103,466,378,88,415800,96800,512600
210820,202103,2113,1755,358,1930500,393800,2324300
210825,202103,156,88,68,96800,74800,171600
210830,202103,728,483,245,531300,269500,800800
210840,202103,194,134,60,147400,66000,213400
210845,202103,233,165,68,181500,74800,256300
210850,202103,756,517,239,568700,262900,831600
210860,202103,3563,2047,1516,2251700,1669800,3921500
210870,202103,432,342,90,377300,99000,476300
210880,202103,75,58,17,63800,18700,82500
210890,202103,319,278,41,306900,45100,352000
210900,202103,624,408,216,449900,237600,687500
210905,202103,62,34,28,37400,30800,68200
210910,202103,1948,1473,475,1623600.7,522500,2146100.7
210920,202103,164,62,102,68200,112200,180400
210923,202103,84,67,17,73700,18700,92400
210927,202103,423,197,226,216700,248600,465300
210930,202103,66,52,14,57200,15400,72600
210940,202103,85,66,19,72600,20900,93500
210945,202103,198,107,91,117700,101200,218900
210950,202103,524,381,143,420200,157300,577500
210955,202103,80,50,30,55000,33000,88000
210960,202103,2228,1117,1111,1229800,1223200,2453000
210970,202103,116,102,14,113300,15400,128700
210975,202103,83,77,6,84700,6600,91300
210980,202103,1082,530,552,583000,607200,1190200
210990,202103,4021,2669,1352,2937000,1487200,4424200
211000,202103,1309,1060,249,1166000,273900,1439900
211003,202103,973,703,270,773300,297000,1070300
211010,202103,490,437,53,481800,58300,540100
211020,202103,1412,610,802,671000,882200,1553200
211023,202103,37,32,5,35200,5500,40700
211027,202103,73,52,21,57200,23100,80300
211030,202103,369,263,106,289300,116600,405900
211040,202103,298,248,50,272800,55000,327800
211050,202103,1159,773,386,850300,425700,1276000
211060,202103,625,543,82,597300,90200.49,687500.49
211065,202103,21,18,3,19800,3300,23100
211070,202103,882,737,145,810700,159500,970200
211080,202103,83,81,2,89100,2200,91300
211085,202103,50,27,23,29700,25300,55000
211090,202103,74,63,11,69300,12100,81400
211100,202103,477,395,82,434500,90200,524700
211102,202103,240,170,70,187000,77000,264000
211105,202103,220,156,64,171600,70400,242000
211107,202103,126,79,47,86900,51700,138600
211110,202103,936,626,310,688600,341000,1029600
211120,202103,5264,2624,2640,2888600,2907300,5795900
211125,202103,32,23,9,25300,9900,35200
211130,202103,41294,19003,22291,20925300.2,24543200,45468500.2
211140,202103,395,346,49,380600,53900,434500
211150,202103,1187,813,374,894300,412500,1306800
211153,202103,169,105,64,115500,71500,187000
211157,202103,66,52,14,57200,15400,72600
211160,202103,692,594,98,655600,107800,763400
211163,202103,2,2,0,2200,0,2200
211167,202103,11,10,1,11000,1100,12100
211170,202103,416,309,107,339900,117700,457600
211172,202103,114,79,35,86900,38500,125400
211174,202103,256,160,96,176000,105600,281600
211176,202103,476,355,121,390500,133100,523600
211178,202103,91,60,31,66000,34100,100100
211180,202103,214,171,43,188100,47300,235400
211190,202103,72,65,7,71500,7700,79200
211195,202103,35,23,12,25300,13200,38500
211200,202103,150,132,18,145200,19800,165000
211210,202103,431,319,112,350900,123200,474100
211220,202103,4135,2454,1681,2700500.5,1853500,4554000.5
211223,202103,91,87,4,96800,4400,101200
211227,202103,64,50,14,55000,15400,70400
211230,202103,734,606,128,667700,140800,808500
211240,202103,396,315,81,346500,89100,435600
211245,202103,182,91,91,100100,100100,200200
211250,202103,1528,1323,205,1455300,225500,1680800
211260,202103,794,659,135,726000,148500,874500
211270,202103,1948,1593,355,1752300,390500,2142800
211280,202103,1740,1122,618,1234200,680900,1915100
211285,202103,204,126,78,138600,85800,224400
211290,202103,714,507,207,557700,227700,785400
211300,202103,748,596,152,655600,168300,823900
211400,202103,1531,935,596,1028500,655600,1684100
220005,202103,15,14,1,15400,1100,16500
220010,202103,86,68,18,74800,19800,94600
220020,202103,693,552,141,609400,155100,764500
220025,202103,106,103,3,113300,3300,116600
220027,202103,47,38,9,41800,9900,51700
220030,202103,111,88,23,96800,25300,122100
220040,202103,1255,954,301,1049400,331100,1380500
220045,202103,32,21,11,23100,12100,35200
220050,202103,694,577,117,634700.8,128700,763400.8
220060,202103,173,149,24,163900,26400,190300
220070,202103,113,102,11,112200,12100,124300
220080,202103,16,14,2,15400,2200,17600
220090,202103,33,27,6,29700,6600,36300
220095,202103,2,1,1,1100,1100,2200
220100,202103,19,16,3,17600,3300,20900
220105,202103,26,24,2,26400,2200,28600
220110,202103,230,210,20,231000,22000,253000
220115,202103,36,35,1,38500,1100,39600
220117,202103,21,20,1,22000,1100,23100
220120,202103,1470,1126,344,1239700,378400,1618100
220130,202103,30,29,1,31900,1100,33000
220140,202103,102,82,20,90200,22000,112200
220150,202103,496,369,127,405900,139700,545600
220155,202103,8,7,1,7700,1100,8800
220157,202103,20,16,4,17600,4400,22000
220160,202103,91,81,10,89100,11000,100100
220170,202103,34,31,3,34100,3300,37400
220173,202103,8,8,0,8800,0,8800
220177,202103,10,9,1,9900,1100,11000
220180,202103,67,65,2,71500,2200,73700
220190,202103,1079,949,130,1043900,143000,1186900
220191,202103,41,34,7,37400,7700,45100
220192,202103,86,82,4,90200,4400,94600
220194,202103,61,56,5,61600,5500,67100
220196,202103,96,81,15,89100,16500,105600
220198,202103,3,2,1,2200,1100,3300
220200,202103,412,344,68,379500,74800,454300
220202,202103,38,33,5,36300,5500,41800
220205,202103,55,48,7,52800,7700,60500
220207,202103,12,12,0,13200,0,13200
220208,202103,74,42,32,46200,35200,81400
220209,202103,32,27,5,29700,5500,35200
220210,202103,22,15,7,16500,7700,24200
220211,202103,28,26,2,28600,2200,30800
220213,202103,41,36,5,39600,5500,45100
220217,202103,38,28,10,30800,11000,41800
220220,202103,2206,1459,747,1607100,821700,2428800
220225,202103,8,3,5,3300,5500,8800
220230,202103,966,744,222,819500,245300,1064800
220240,202103,159,140,19,154000,20900,174900
220245,202103,33,30,3,33000.18,3300,36300.18
220250,202103,125,108,17,118800,18700,137500
220253,202103,46,39,7,42900,7700,50600
220255,202103,36,32,4,35200,4400,39600
220260,202103,705,528,177,583000,195800,778800
220265,202103,6,4,2,4400,2200,6600
220270,202103,761,686,75,756800,82500,839300
220271,202103,44,36,8,39600,8800,48400
220272,202103,22,22,0,24200,0,24200
220273,202103,17,15,2,16500,2200,18700
220275,202103,57,46,11,50600,12100,62700
220277,202103,17,12,5,13200,5500,18700
220280,202103,17,11,6,12100,6600,18700
220285,202103,41,39,2,42900,2200,45100
220290,202103,1480,1275,205,1404700,225500,1630200
220300,202103,34,33,1,36300,1100,37400
220310,202103,326,277,49,304700,53900,358600
220320,202103,440,407,33,447700,36300,484000
220323,202103,1,0,1,0,1100,1100
220325,202103,10,9,1,9900,1100,11000
220327,202103,11,11,0,12100,0,12100
220330,202103,231,168,63,184800,69300,254100
220335,202103,141,123,18,135300,19800,155100
220340,202103,39,27,12,29700,13200,42900
220342,202103,56,48,8,52800,8800,61600
220345,202103,79,71,8,78100,8800,86900
220350,202103,446,384,62,422400,68200,490600
220360,202103,42,30,12,33000,13200,46200
220370,202103,1235,1022,213,1125300,234300,1359600
220375,202103,19,17,2,18700,2200,20900
220380,202103,23,17,6,18700,6600,25300
220385,202103,14,13,1,14300,1100,15400
220390,202103,2312,1313,999,1446500,1098900,2545400
220400,202103,34,30,4,33000,4400,37400
220410,202103,21,19,2,20900,2200,23100
220415,202103,13,11,2,12100,2200,14300
220420,202103,126,105,21,115500,23100,138600
220430,202103,128,114,14,125400,15400,140800
220435,202103,24,17,7,18700,7700,26400
220440,202103,286,244,42,268400,47300,315700
220450,202103,339,170,169,187000,185900,372900
220455,202103,51,50,1,55000,1100,56100
220460,202103,18,17,1,18700,1100,19800
220465,202103,89,58,31,63800,34100,97900
220470,202103,249,215,34,237600,37400,275000
220480,202103,71,64,7,70400,7700,78100
220490,202103,86,73,13,80300,14300,94600
220500,202103,106,92,14,101200,15400,116600
220510,202103,414,321,93,353100,102300,455400
220515,202103,19,17,2,18700,2200,20900
220520,202103,367,327,40,359700,44000,403700
220525,202103,11,7,4,7700,4400,12100
220527,202103,18,14,4,15400,4400,19800
220530,202103,34,13,21,14300,23100,37400
220535,202103,5,4,1,4400,1100,5500
220540,202103,68,56,12,61600,13200,74800
220545,202103,39,26,13,28600,14300,42900
220550,202103,716,566,150,623700,165000,788700
220551,202103,16,12,4,13200,4400,17600
220552,202103,17,16,1,17600,1100,18700
220553,202103,55,50,5,55000,5500,60500
220554,202103,11,8,3,8800,3300,12100
220555,202103,36,30,6,33000,6600,39600
220556,202103,40,37,3,40700,3300,44000
220557,202103,56,52,4,57200,4400,61600
220558,202103,7,3,4,3300,4400,7700
220559,202103,4,4,0,4400,0,4400
220560,202103,69,45,24,49500,26400,75900
220570,202103,731,453,278,498300,305800,804100
220580,202103,549,502,47,552200,51700,603900
220585,202103,9,8,1,8800,1100,9900
220590,202103,14,14,0,15400,0,15400
220595,202103,64,48,16,52800,17600,70400
220600,202103,20,12,8,13200,8800,22000
220605,202103,23,20,3,23100,3300,26400
220610,202103,79,66,13,72600,14300,86900
220620,202103,556,462,94,508200,103400,611600
220630,202103,5,4,1,4400,1100,5500
220635,202103,36,31,5,34100,5500,39600
220640,202103,102,85,17,93500,18700,112200
220650,202103,111,105,6,115500,6600,122100
220660,202103,58,46,12,50600,14300,64900
220665,202103,5,5,0,5500,0,5500
220667,202103,19,17,2,18700,2200,20900
220669,202103,27,23,4,25300,4400,29700
220670,202103,63,51,12,56100,13200,69300
220672,202103,78,55,23,60500,25300,85800
220675,202103,36,28,8,30800,8800,39600
220680,202103,43,37,6,40700,6600,47300
220690,202103,47,44,3,48400,3300,51700
220695,202103,29,16,13,17600,14300,31900
220700,202103,1715,1327,388,1460800,426800,1887600
220710,202103,6,4,2,4400,2200,6600
220720,202103,108,90,18,99000,19800,118800
220730,202103,17,17,0,18700,0,18700
220735,202103,4,0,4,0,4400,4400
220740,202103,46,42,4,46200,4400,50600
220750,202103,116,98,18,107800,19800,127600
220755,202103,14,13,1,14300,1100,15400
220760,202103,66,60,6,66000,6600,72600
220770,202103,5747,3140,2607,3456200.76,2868800,6325000.76
220775,202103,16,10,6,11000,6600,17600
220777,202103,19,18,1,19800,1100,20900
220779,202103,1,0,1,0,1100,1100
220780,202103,894,762,132,839300,146300,985600
220785,202103,5,1,4,1100,4400,5500
220790,202103,1105,870,235,959200,258500,1217700
220793,202103,6,6,0,6600,0,6600
220795,202103,12,11,1,12100,1100,13200
220800,202103,4019,3094,925,3403604,1019700,4423304
220810,202103,64,56,8,61600,8800,70400
220820,202103,240,218,22,239800,24200,264000
220830,202103,1253,1081,172,1190200,190300,1380500
220840,202103,2418,1680,738,1850200.26,811800,2662000.26
220850,202103,61,52,9,57200,9900,67100
220855,202103,9,5,4,5500,4400,9900
220860,202103,12,10,2,11000,2200,13200
220865,202103,26,24,2,26400,2200,28600
220870,202103,79,70,9,77000,9900,86900
220880,202103,321,257,64,282700,70400,353100
220885,202103,32,29,3,31900,3300,35200
220887,202103,12,11,1,12100,1100,13200
220890,202103,94,82,12,90200,13200,103400
220900,202103,25,15,10,16500,11000,27500
220910,202103,52,43,9,47300,9900,57200
220915,202103,9,8,1,8800,1100,9900
220920,202103,47,42,5,46200,5500,51700
220930,202103,44,43,1,47300,1100,48400
220935,202103,15,15,0,16500,0,16500
220937,202103,33,32,1,35200,1100,36300
220940,202103,55,50,5,55000,5500,60500
220945,202103,3,3,0,3300,0,3300
220950,202103,38,30,8,33000,8800,41800
220955,202103,24,20,4,22000,4400,26400
220960,202103,16,16,0,17600,0,17600
220965,202103,36,32,4,35200,4400,39600
220970,202103,61,51,10,56100,11000,67100
220975,202103,16,14,2,15400,2200,17600
220980,202103,31,29,2,31900,2200,34100
220985,202103,62,55,7,60500,7700,68200
220987,202103,31,30,1,33000,1100,34100
220990,202103,27,26,1,28600,1100,29700
220995,202103,17,14,3,15400,3300,18700
220997,202103,65,54,11,59400,12100,71500
221000,202103,1188,1071,117,1179200,128700,1307900
221005,202103,46,41,5,45100,5500,50600
221010,202103,16,12,4,13200,4400,17600
221020,202103,36,35,1,38500,1100,39600
221030,202103,39,31,8,34100,8800,42900
221035,202103,22,22,0,24200,0,24200
221037,202103,13,9,4,9900,4400,14300
221038,202103,28,25,3,27500,3300,30800
221039,202103,25,24,1,26400,1100,27500
221040,202103,264,223,41,245300,45100,290400
221050,202103,237,197,40,216700,44000,260700
221060,202103,1879,1636,243,1800700,268400,2069100
221062,202103,34,32,2,35200,2200,37400
221063,202103,12,8,4,8800,4400,13200
221065,202103,63,50,13,55000,14300,69300
221070,202103,137,120,17,132000,18700,150700
221080,202103,372,318,54,349800,59400,409200
221090,202103,23,19,4,20900,4400,25300
221093,202103,43,32,11,35200,12100,47300
221095,202103,6,6,0,6600,0,6600
221097,202103,13,11,2,12100,2200,14300
221100,202103,25655,15220,10435,16758500.63,11493900,28252400.63
221110,202103,1104,839,265,922900,291500,1214400
221120,202103,542,396,146,435600,160600,596200
221130,202103,969,776,193,853600,212300,1065900
221135,202103,34,30,4,33000,4400,37400
221140,202103,46,40,6,44000,6600,50600
221150,202103,11,9,2,9900,2200,12100
221160,202103,12,12,0,13200,0,13200
221170,202103,15,15,0,16500,0,16500
230010,202103,149,137,12,150700,13200,163900
230015,202103,130,106,24,116600,26400,143000
230020,202103,1632,1371,261,1508100,287100,1795200
230030,202103,1685,1204,481,1325500,530200,1855700
230040,202103,222,187,35,205700,38500,244200
230050,202103,232,170,62,187000,68200,255200
230060,202103,166,130,36,143000,39600,182600
230070,202103,304,261,43,287100,47300,334400
230075,202103,849,733,116,806300,127600,933900
230080,202103,194,167,27,183700,29700,213400
230090,202103,132,96,36,105600,39600,145200
230100,202103,2199,1254,945,1380500,1039500,2420000
230110,202103,2854,1831,1023,2015200,1126400,3141600
230120,202103,1023,805,218,885500,239800,1125300
230125,202103,152,122,30,134200,33000,167200
230130,202103,480,428,52,470800,57200,528000
230140,202103,222,185,37,203500,40700,244200
230150,202103,153,116,37,127600,40700,168300
230160,202103,947,799,148,878900,162800,1041700
230170,202103,611,547,64,602800,70400,673200
230180,202103,75,68,7,74800,7700,82500
230185,202103,409,352,57,388300,62700,451000
230190,202103,2395,1872,523,2060300.32,577500,2637800.32
230195,202103,492,426,66,468600,72600,541200
230200,202103,418,340,78,374000,85800,459800
230205,202103,392,259,133,284900,146300,431200
230210,202103,1373,1065,308,1172600.46,338800,1511400.46
230220,202103,1573,1064,509,1172600,562100,1734700
230230,202103,982,826,156,908600,172700,1081300
230240,202103,1787,1545,242,1701975,267300,1969275
230250,202103,1793,1468,325,1615900,357500,1973400
230260,202103,3235,2006,1229,2206600,1351900,3558500
230270,202103,1388,1106,282,1217700.05,310200,1527900.05
230280,202103,2751,2063,688,2269300,756800,3026100
230290,202103,400,358,42,393800.5,46200,440000.5
230300,202103,525,378,147,415800,161700,577500
230310,202103,420,320,100,352000,110000,462000
230320,202103,928,788,140,866800,154000,1020800
230330,202103,312,251,61,276100,67100,343200
230340,202103,446,361,85,398200,93500,491700
230350,202103,3207,2013,1194,2214300,1314500,3528800
230360,202103,277,222,55,244200,60500,304700
230365,202103,133,110,23,121000,25300,146300
230370,202103,10259,4999,5260,5503300.92,5792600,11295900.92
230380,202103,493,419,74,460900,81400,542300
230390,202103,551,305,246,336600,270600,607200
230393,202103,245,204,41,224400,45100,269500
230395,202103,351,281,70,309100,78100,387200
230400,202103,623,496,127,545600,139700,685300
230410,202103,2667,1659,1008,1824900.5,1109900,2934800.5
230420,202103,6340,4183,2157,4603501.01,2374900,6978401.01
230423,202103,343,297,46,326700,50600,377300
230425,202103,434,354,80,390500,88000,478500
230426,202103,119,96,23,105600,25300,130900
230427,202103,74,70,4,77000,4400,81400
230428,202103,1542,762,780,839300,860200,1699500
230430,202103,456,370,86,408100,94600,502700
230435,202103,901,652,249,717200,273900.24,991100.24
230440,202103,90158,40144,50014,44203388.14,55114400.66,99317788.80
230445,202103,315,213,102,234300,112200,346500
230450,202103,573,449,124,493900,136400,630300
230460,202103,71,52,19,57200,20900,78100
230465,202103,310,251,59,276100,64900,341000
230470,202103,2022,1594,428,1756700,470800,2227500
230480,202103,153,144,9,158400,9900,168300
230490,202103,312,245,67,269500,73700,343200
230495,202103,457,335,122,368500,134200,502700
230500,202103,1029,758,271,833800,298100,1131900
230510,202103,58,45,13,49500,14300,63800
230520,202103,387,306,81,336600.75,89100,425700.75
230523,202103,2379,1471,908,1624700,999900,2624600
230526,202103,270,230,40,254100,44000,298100
230530,202103,693,513,180,564300,198000,762300
230533,202103,212,196,16,215600,17600,233200
230535,202103,367,272,95,299200,104500,403700
230540,202103,1811,1610,201,1772100,222200,1994300
230550,202103,3875,2477,1398,2725800,1538900,4264700
230560,202103,577,435,142,478500,156200,634700
230565,202103,222,163,59,179300,64900,244200
230570,202103,288,253,35,278300,38500,316800
230580,202103,1179,854,325,940500,357500,1298000
230590,202103,1000,778,222,856900,244200,1101100
230600,202103,246,225,21,247500,23100,270600
230610,202103,388,295,93,324500,102300,426800
230620,202103,205,175,30,192500,33000,225500
230625,202103,788,543,245,597300,270600,867900
230630,202103,1341,1034,307,1137400,337700,1475100
230640,202103,3826,3223,603,3549700,664400,4214100
230650,202103,463,396,67,435600,74800,510400
230655,202103,699,585,114,643500,125400,768900
230660,202103,365,301,64,331100,70400,401500
230670,202103,451,382,69,421300,75900,497200
230680,202103,202,183,19,201300,20900,222200
230690,202103,918,775,143,852500,157300,1009800
230700,202103,853,716,137,787600,150700,938300
230710,202103,695,655,40,720500,44000,764500
230720,202103,152,130,22,143000,24200,167200
230725,202103,216,166,50,182600,55000,237600
230730,202103,12341,6631,5710,7300631.32,6287600.82,13588232.14
230740,202103,681,549,132,605000,145200,750200
230750,202103,826,695,131,764500,144100,908600
230760,202103,1461,1253,208,1378300,228800,1607100
230763,202103,332,273,59,300300,64900,365200
230765,202103,7700,3542,4158,3901700.76,4585900,8487600.76
230770,202103,5028,2561,2467,2818200,2715900,5534100
230780,202103,741,650,91,715000,100100,815100
230790,202103,297,249,48,273900,52800,326700
230800,202103,1152,825,327,910800,360800,1271600
230810,202103,1360,1197,163,1316700,179300,1496000
230820,202103,366,251,115,277200,126500,403700
230830,202103,967,820,147,902000,161700,1063700
230835,202103,281,241,40,265100,44000,309100
230837,202103,173,144,29,158400,31900,190300
230840,202103,935,729,206,801900,226600,1028500
230850,202103,1476,1269,207,1395900,227700,1623600
230860,202103,301,226,75,249700,82500,332200
230870,202103,1833,1555,278,1710500,305800,2016300
230880,202103,68,52,16,57200,17600,74800
230890,202103,544,495,49,544500,53900,598400
230900,202103,276,202,74,222200,82500.7,304700.7
230910,202103,225,172,53,189200,58300,247500
230920,202103,427,340,87,375100,95700,470800
230930,202103,988,691,297,762300,326700,1089000
230940,202103,849,657,192,723800,211200,935000
230945,202103,523,423,100,467500,110000,577500
230950,202103,419,363,56,399300,61600,460900
230960,202103,2672,1785,887,1969000,976800,2945800
230970,202103,1702,948,754,1043900,832700,1876600
230980,202103,206,168,38,184800,41800,226600
230990,202103,137,111,26,123200,28600,151800
231000,202103,192,177,15,194700,16500,211200
231010,202103,156,110,46,121000,50600,171600
231020,202103,1362,937,425,1030700,468600,1499300
231025,202103,1065,780,285,858000,314600,1172600
231030,202103,1092,911,181,1003200,199100,1202300
231040,202103,143,95,48,104500,52800,157300
231050,202103,946,833,113,916300,124300,1040600
231060,202103,159,133,26,146300,28600,174900
231070,202103,1484,1028,456,1131900,502700,1634600
231080,202103,263,239,24,262900,26400,289300
231085,202103,624,380,244,418000,269500,687500
231090,202103,254,203,51,223300,56100,279400
231095,202103,170,135,35,149600,38500,188100
231100,202103,151,125,26,137500,28600,166100
231110,202103,370,315,55,348700,60500,409200
231120,202103,269,230,39,253000,42900,295900
231123,202103,152,143,9,157300,9900,167200
231126,202103,334,258,76,283800,83600,367400
231130,202103,4781,3736,1045,4110700,1150600,5261300
231135,202103,215,187,28,205700,30800,236500
231140,202103,3075,2237,838,2461800,921800,3383600
231150,202103,373,350,23,385000,25300,410300
231160,202103,1214,967,247,1063700,271700,1335400
231170,202103,518,360,158,396000,173800,569800
231180,202103,1715,1474,241,1622500,265100,1887600
231190,202103,207,174,33,191400,36300,227700
231195,202103,222,184,38,202400,41800,244200
231200,202103,797,652,145,718300,160600,878900
231210,202103,583,489,94,537900,103400,641300
231220,202103,1050,766,284,844800.85,313500,1158300.85
231230,202103,1476,1154,322,1273800,354200,1628000
231240,202103,1467,1038,429,1142900,474100,1617000
231250,202103,107,99,8,108900,8800,117700
231260,202103,271,178,93,195800,102300,298100
231270,202103,999,803,196,886600,215600,1102200
231280,202103,76,59,17,64900,18700,83600
231290,202103,7722,4327,3395,4764100,3737800.57,8501900.57
231300,202103,604,558,46,613800,50600,664400
231310,202103,741,679,62,746900.81,68200,815100.81
231320,202103,597,449,148,493900,163900,657800
231325,202103,105,91,14,100100,15400,115500
231330,202103,1973,1524,449,1677775.74,493900,2171675.74
231335,202103,253,222,31,244200,34100,278300
231340,202103,1740,1262,478,1389300,525800,1915100
231350,202103,1308,1052,256,1158300,282700,1441000
231355,202103,434,368,66,405900,72600,478500
231360,202103,517,372,145,409200.65,160600,569800.65
231370,202103,89,78,11,85800,12100,97900
231375,202103,295,212,83,233200,91300,324500
231380,202103,494,393,101,433400,111100,544500
231390,202103,209,159,50,174900,55000,229900
231395,202103,745,469,276,515900,304700,820600
231400,202103,1136,941,195,1035100,214500,1249600
231410,202103,1346,1103,243,1213300,268400,1481700
240010,202103,385,169,216,185900.97,238700,424600.97
240020,202103,2248,1823,425,2007500,467500,2475000
240030,202103,121,101,20,111100,22000,133100
240040,202103,33,33,0,36300,0,36300
240050,202103,530,450,80,495000,88000,583000
240060,202103,66,62,4,68200,4400,72600
240070,202103,228,178,50,195800,55000,250800
240080,202103,535,364,171,400400,188100.7,588500.7
240090,202103,101,90,11,99000,12100,111100
240100,202103,1497,1408,89,1549900.5,97900,1647800.5
240110,202103,1041,679,362,746900,398200,1145100
240120,202103,141,110,31,121000,34100,155100
240130,202103,274,254,20,281600,22000,303600
240140,202103,82,58,24,63800,26400,90200
240145,202103,736,650,86,716100,94600,810700
240150,202103,22,17,5,18700,5500,24200
240160,202103,42,34,8,37400,8800,46200
240165,202103,36,28,8,30800,8800,39600
240170,202103,115,78,37,85800,40700,126500
240180,202103,93,70,23,77000,25300,102300
240185,202103,43,39,4,42900,4400,47300
240190,202103,15,13,2,14300,2200,16500
240200,202103,3066,1706,1360,1881000,1497100,3378100
240210,202103,173,132,41,145200,45100,190300
240220,202103,1099,796,303,875600,335500,1211100
240230,202103,847,774,73,851400,80300,931700
240240,202103,72,52,20,57200,22000,79200
240250,202103,90,79,11,86900,12100,99000
240260,202103,1800,1326,474,1460800.33,522500,1983300.33
240270,202103,184,162,22,178200,24200,202400
240280,202103,47,36,11,39600,12100,51700
240290,202103,47,45,2,49500,2200,51700
240300,202103,177,98,79,107800,88000,195800
240310,202103,2363,1287,1076,1417900.19,1183600,2601500.19
240320,202103,188,175,13,192500,14300,206800
240325,202103,4587,2709,1878,2981001.05,2070200.54,5051201.59
240330,202103,73,68,5,74800,5500,80300
240340,202103,75,49,26,53900,28600,82500
240350,202103,94,81,13,89100,14300,103400
240360,202103,564,344,220,378400,242000,620400
240370,202103,54,50,4,55000,4400,59400
240375,202103,63,38,25,41800,27500,69300
240380,202103,230,187,43,205700,47300,253000
240390,202103,12,11,1,12100,1100,13200
240400,202103,82,74,8,81400,8800,90200
240410,202103,14,8,6,8800,6600,15400
240420,202103,1021,745,276,819500,303600,1123100
240430,202103,263,247,16,271700,17600,289300
240440,202103,127,72,55,79200,60500,139700
240450,202103,230,153,77,168300,84700,253000
240460,202103,72,56,16,61600,17600,79200
240470,202103,239,214,25,235400,27500,262900
240480,202103,17,15,2,16500,2200,18700
240485,202103,82,68,14,74800,15400,90200
240490,202103,44,42,2,46200,2200,48400
240500,202103,88,66,22,72600,24200,96800
240510,202103,43,31,12,34100,13200,47300
240520,202103,112,107,5,117700,5500,123200
240530,202103,55,48,7,52800,7700,60500
240540,202103,80,68,12,74800,13200,88000
240550,202103,14,13,1,14300,1100,15400
240560,202103,379,275,104,302500,114400,416900
240570,202103,442,282,160,310200,177100,487300
240580,202103,1294,1016,278,1118700,305800,1424500
240590,202103,31,29,2,31900,2200,34100
240600,202103,100,95,5,104500,5500,110000
240610,202103,515,433,82,477400,90200,567600
240615,202103,18,17,1,18700,1100,19800
240620,202103,90,87,3,95700,3300,99000
240630,202103,40,34,6,37400,6600,44000
240640,202103,25,20,5,22000,5500,27500
240650,202103,243,201,42,221100,46200,267300
240660,202103,113,97,16,106700,17600,124300
240670,202103,315,177,138,194700,151800,346500
240680,202103,50,37,13,40700,14300,55000
240690,202103,47,44,3,48400,3300,51700
240700,202103,182,149,33,163900,37400,201300
240710,202103,2047,1251,796,1378300,875600,2253900
240720,202103,1067,783,284,862400,312400,1174800
240725,202103,66,62,4,68200,4400,72600
240730,202103,149,124,25,136400,27500,163900
240740,202103,227,193,34,212300,37400,249700
240750,202103,49,27,22,29700,24200,53900
240760,202103,47,41,6,45100,6600,51700
240770,202103,148,116,32,127600,35200,162800
240780,202103,693,577,116,634700,127600,762300
240790,202103,42,40,2,44000,2200,46200
240800,202103,9334,6327,3007,6959701.62,3316500,10276201.62
240810,202103,20736,11141,9595,12272702.02,10575400,22848102.02
240820,202103,242,146,96,160600.2,105600,266200.2
240830,202103,1615,1327,288,1460800,316800,1777600
240840,202103,77,67,10,73700,11000,84700
240850,202103,84,75,9,82500,9900,92400
240860,202103,104,100,4,110000,4400,114400
240870,202103,58,50,8,55000,8800,63800
240880,202103,31,28,3,30800,3300,34100
240890,202103,1146,651,495,717200,544500,1261700
240895,202103,61,42,19,46200,20900,67100
240910,202103,160,140,20,154000,22000,176000
240920,202103,13,10,3,11000,3300,14300
240930,202103,410,367,43,403700,47300,451000
240933,202103,52,34,18,37400,19800,57200
240940,202103,2364,2095,269,2305600,295900,2601500
240950,202103,49,44,5,48400,5500,53900
240960,202103,26,21,5,23100,5500,28600
240970,202103,117,85,32,93500,35200,128700
240980,202103,198,159,39,174900,42900,217800
240990,202103,132,88,44,96800,48400,145200
241000,202103,61,58,3,63800,3300,67100
241010,202103,77,58,19,63800,20900,84700
241020,202103,112,103,9,113300,9900,123200
241025,202103,14,7,7,7700,7700,15400
241030,202103,113,89,24,97900,26400,124300
241040,202103,44,32,12,35200,13200,48400
241050,202103,82,73,9,80300,9900,90200
241060,202103,28,23,5,25300,5500,30800
241070,202103,15,15,0,16500,0,16500
241080,202103,62,55,7,60500,7700,68200
241090,202103,54,45,9,49500,9900,59400
241100,202103,72,61,11,67100,12100,79200
241105,202103,8,3,5,3300,5500,8800
241110,202103,50,45,5,49500,5500,55000
241120,202103,1497,1135,362,1249600,398200,1647800
241140,202103,224,188,36,206800,40700,247500
241142,202103,40,34,6,37400,6600,44000
241150,202103,1201,1053,148,1158300,162800,1321100
241160,202103,18,17,1,18700,1100,19800
241170,202103,47,39,8,42900,8800,51700
241180,202103,44,37,7,40700,7700,48400
241190,202103,38,36,2,39600,2200,41800
241200,202103,4032,2095,1937,2307800.53,2137300,4445100.53
241210,202103,67,58,9,63800,9900,73700
241220,202103,1436,958,478,1053800.43,526900,1580700.43
241230,202103,248,205,43,225500,47300,272800
241240,202103,55,43,12,47300,13200,60500
241250,202103,1133,1037,96,1144000,105600,1249600
241255,202103,53,41,12,45100,13200,58300
241260,202103,685,530,155,583000,170500,753500
241270,202103,64,44,20,48400,22000,70400
241280,202103,94,83,11,91300,12100,103400
241290,202103,129,89,40,97900,44000,141900
241300,202103,81,55,26,60500,28600,89100
241310,202103,52,38,14,41800,15400,57200
241320,202103,31,18,13,19800,14300,34100
241330,202103,65,56,9,61600,9900,71500
241335,202103,74,67,7,73700,7700,81400
241340,202103,184,135,49,148500,55000,203500
241350,202103,63,54,9,59400,9900,69300
241355,202103,49,42,7,46200,7700,53900
241360,202103,49,48,1,52800,1100,53900
241370,202103,57,45,12,49500,13200,62700
241380,202103,34,30,4,33000,4400,37400
241390,202103,82,62,20,68200,22000,90200
241400,202103,222,175,47,192500,51700,244200
241410,202103,182,164,18,180400,19800,200200
241415,202103,100,82,18,90200,19800,110000
241420,202103,102,77,25,84700,27500,112200
241430,202103,26,24,2,26400,2200,28600
241440,202103,536,437,99,480700,108900,589600
241445,202103,39,34,5,37400,5500,42900
241450,202103,267,219,48,240900,52800,293700
241460,202103,143,130,13,143000,14300,157300
241470,202103,37,31,6,34100,6600,40700
241475,202103,52,49,3,53900,3300,57200
241480,202103,100,71,29,78100,31900,110000
241490,202103,11,10,1,11000,1100,12100
241500,202103,46,35,11,38500,12100,50600
250010,202103,105,90,15,99000,16500,115500
250020,202103,29,26,3,28600,3300,31900
250030,202103,899,668,231,735900,254100,990000
250040,202103,382,315,67,346500,74800,421300
250050,202103,258,210,48,231000,52800,283800
250053,202103,57,43,14,47300,15400,62700
250057,202103,1,1,0,1100,0,1100
250060,202103,601,431,170,474100,187000,661100
250070,202103,705,567,138,623700.22,151800,775500.22
250073,202103,7,7,0,7700,0,7700
250077,202103,175,130,45,143000,49500,192500
250080,202103,433,342,91,376200,100100,476300
250090,202103,224,145,79,159500,86900,246400
250100,202103,522,433,89,477400,97900,575300
250110,202103,637,485,152,534600,167200,701800
250115,202103,19,6,13,6600,14300,20900
250120,202103,122,87,35,95700,38500,134200
250130,202103,574,460,114,508200,125400,633600
250135,202103,20,12,8,13200,8800,22000
250140,202103,86,76,10,83600,11000,94600
250150,202103,601,430,171,473000,188100,661100
250153,202103,12,9,3,9900,3300,13200
250157,202103,32,26,6,28600,6600,35200
250160,202103,229,181,48,199100,52800,251900
250170,202103,66,43,23,47300,25300,72600
250180,202103,4413,2990,1423,3292300,1569700,4862000
250190,202103,837,552,285,607200,313500,920700
250200,202103,52,42,10,46200,11000,57200
250205,202103,23,20,3,22000,3300,25300
250210,202103,87,76,11,83600,12100,95700
250215,202103,67,52,15,57200,16500,73700
250220,202103,25,18,7,19800,7700,27500
250230,202103,78,70,8,77000,8800,85800
250240,202103,239,190,49,209000,53900,262900
250250,202103,389,332,57,367400,62700,430100
250260,202103,44,37,7,40700,7700,48400
250270,202103,74,53,21,58300,23100,81400
250280,202103,385,313,72,344300,79200,423500
250290,202103,92,84,8,92400,8800,101200
250300,202103,561,380,181,418000,199100,617100
250310,202103,49,41,8,45100,8800,53900
250320,202103,1945,1302,643,1433300,707300,2140600
250330,202103,100,84,16,92400,17600,110000
250340,202103,26,24,2,26400,2200,28600
250350,202103,179,116,63,127600,69300,196900
250355,202103,31,24,7,26400,7700,34100
250360,202103,196,162,34,178200,37400,215600
250370,202103,2409,1568,841,1724800,925100,2649900
250375,202103,12,7,5,7700,5500,13200
250380,202103,55,43,12,47300,13200,60500
250390,202103,45,35,10,38500,11000,49500
250400,202103,16502,8311,8191,9157481.02,9023300,18180781.02
250403,202103,323,259,64,284900,70400,355300
250407,202103,63,51,12,56100,13200,69300
250410,202103,29,25,4,27500,4400,31900
250415,202103,42,29,13,31900,14300,46200
250420,202103,43,37,6,40700,6600,47300
250430,202103,1447,1246,201,1371975,221100,1593075
250435,202103,20,14,6,15400,6600,22000
250440,202103,678,563,115,619300,126500,745800
250450,202103,83,65,18,71500,19800,91300
250460,202103,472,307,165,337700,182600,520300
250470,202103,95,65,30,71500,33000,104500
250480,202103,331,265,66,291500,72600,364100
250485,202103,2,2,0,2200,0,2200
250490,202103,232,187,45,205700,49500,255200
250500,202103,98,72,26,79200,28600,107800
250510,202103,782,622,160,684200,176000,860200
250520,202103,177,119,58,130900,63800,194700
250523,202103,123,98,25,107800,27500,135300
250527,202103,106,83,23,91300,25300,116600
250530,202103,10,6,4,6600,4400,11000
250535,202103,30,22,8,24200,8800,33000
250540,202103,132,104,28,114400,30800,145200
250550,202103,73,70,3,77000,3300,80300
250560,202103,52,37,15,40700,16500,57200
250570,202103,165,136,29,149600,31900,181500
250580,202103,104,80,24,88071,26400,114471
250590,202103,24,14,10,15400,11000,26400
250600,202103,1444,948,496,1042800.7,547800,1590600.7
250610,202103,161,133,28,146300,30800,177100
250620,202103,21,17,4,18700,4400,23100
250625,202103,71,54,17,59400,18700,78100
250630,202103,3096,1981,1115,2182400.62,1232000,3414400.62
250640,202103,224,179,45,196900,49500,246400
250650,202103,30,20,10,22000,11000,33000
250660,202103,52,40,12,44000,13200,57200
250670,202103,65,48,17,52800,18700,71500
250680,202103,417,336,81,369600,89100,458700
250690,202103,2087,1441,646,1588400.7,710600,2299000.7
250700,202103,936,809,127,889900.8,139700,1029600.8
250710,202103,442,344,98,378400,107800,486200
250720,202103,117,84,33,92400,36300,128700
250730,202103,392,325,67,358600,73700,432300
250740,202103,56,53,3,58300,3300,61600
250750,202103,22566,13457,9109,14828981.41,10035300,24864281.41
250760,202103,102,80,22,89100,25300,114400
250770,202103,361,237,124,260700,136400,397100
250780,202103,69,45,24,49500,26400,75900
250790,202103,461,301,160,332200,176000,508200
250800,202103,156,141,15,155100,16500,171600
250810,202103,74,59,15,64900,16500,81400
250820,202103,150,125,25,137500,27500,165000
250830,202103,435,290,145,319000,159500,478500
250840,202103,55,49,6,53900,6600,60500
250850,202103,57,47,10,51700,11000,62700
250855,202103,16,14,2,15400,2200,17600
250860,202103,231,153,78,168300,85800,254100
250870,202103,26,23,3,25300,3300,28600
250880,202103,89,64,25,70400,27500,97900
250890,202103,2913,2171,742,2389200,816200,3205400
250900,202103,52,43,9,47300,9900,57200
250905,202103,123,92,31,101200,34100,135300
250910,202103,1109,808,301,888800,331100,1219900
250915,202103,100,72,28,79200,30800,110000
250920,202103,141,103,38,113300,41800,155100
250930,202103,176,101,75,111100,82500,193600
250933,202103,6,4,2,4400,2200,6600
250937,202103,10,10,0,11000,0,11000
250939,202103,30,22,8,24200,8800,33000
250940,202103,105,77,28,84700,31900,116600
250950,202103,75,50,25,55000,27500,82500
250960,202103,92,52,40,57200,44000,101200
250970,202103,1224,865,359,951500,394900,1346400
250980,202103,104,68,36,74800,39600,114400
250990,202103,166,128,38,140800,41800,182600
251000,202103,74,66,8,72600,8800,81400
251010,202103,114,85,29,93500,31900,125400
251020,202103,75,61,14,67100,15400,82500
251030,202103,46,35,11,38500,12100,50600
251040,202103,56,38,18,41800,19800,61600
251050,202103,24,21,3,23100,3300,26400
251060,202103,49,40,9,44000,9900,53900
251065,202103,5,3,2,3300,2200,5500
251070,202103,19,16,3,17600,3300,20900
251080,202103,5089,2423,2666,2666400,2934800.1,5601200.1
251090,202103,181,154,27,170500,29700,200200
251100,202103,19,19,0,20900,0,20900
251110,202103,49,38,11,41800,12100,53900
251120,202103,1869,1144,725,1262800,798600,2061400
251130,202103,416,338,78,371800,85800,457600
251140,202103,566,364,202,401500,223300,624800
251150,202103,344,289,55,317900,60500,378400
251160,202103,97,80,17,88000,18700,106700
251170,202103,101,80,21,88000,23100,111100
251180,202103,284,173,111,191400,122100,313500
251190,202103,202,129,73,141900,80300,222200
251200,202103,272,218,54,239800,59400,299200
251203,202103,33,31,2,34100,2200,36300
251207,202103,85,70,15,77000,16500,93500
251210,202103,1461,1070,391,1177000,430100,1607100
251220,202103,49,38,11,41800,12100,53900
251230,202103,591,491,100,540100,110000,650100
251240,202103,101,72,29,79200,31900,111100
251250,202103,1430,1032,398,1135200,440000,1575200
251260,202103,12,7,5,7700,5500,13200
251270,202103,323,251,72,276100,79200,355300
251272,202103,64,57,7,62700,7700,70400
251274,202103,29,22,7,24200,7700,31900
251275,202103,35,20,15,22000,16500,38500
251276,202103,17,13,4,14300,4400,18700
251278,202103,9,7,2,7700,2200,9900
251280,202103,103,97,6,106700,6600,113300
251290,202103,859,607,252,667700,277200,944900
251300,202103,15,12,3,13200,3300,16500
251310,202103,293,216,77,237600,84700,322300
251315,202103,33,29,4,31900,4400,36300
251320,202103,65,49,16,53900,17600,71500
251330,202103,78,69,9,75900,9900,85800
251335,202103,15,10,5,11000,5500,16500
251340,202103,751,446,305,490600,335500,826100
251350,202103,35,34,1,37400,1100,38500
251360,202103,81,71,10,78100,11000,89100
251365,202103,11,11,0,12100,0,12100
251370,202103,5572,3737,1835,4114000.32,2024000,6138000.32
251380,202103,44,35,9,38500,9900,48400
251385,202103,1,1,0,1100,0,1100
251390,202103,840,627,213,689700,235400,925100
251392,202103,19,11,8,12100,8800,20900
251394,202103,8,8,0,8800,0,8800
251396,202103,14,10,4,11000,4400,15400
251398,202103,17,15,2,16500,2200,18700
251400,202103,43,35,8,38500,8800,47300
251410,202103,40,34,6,37400,6600,44000
251420,202103,102,73,29,80300,31900,112200
251430,202103,45,40,5,44000,5500,49500
251440,202103,46,26,20,28600,22000,50600
251445,202103,54,48,6,52800,6600,59400
251450,202103,411,358,53,393800,58300,452100
251455,202103,3,2,1,2200,1100,3300
251460,202103,17,14,3,15400,3300,18700
251465,202103,8,5,3,5500,3300,8800
251470,202103,50,39,11,42900,12100,55000
251480,202103,27,22,5,24200,5500,29700
251490,202103,123,79,44,86900,48400,135300
251500,202103,128,102,26,112200,28600,140800
251510,202103,66,42,24,46200,26400,72600
251520,202103,31,29,2,31900,2200,34100
251530,202103,4498,3181,1317,3499100,1452000,4951100
251540,202103,78,65,13,71500,14300,85800
251550,202103,413,315,98,346500,107800,454300
251560,202103,24,16,8,17600,8800,26400
251570,202103,20,17,3,18700,3300,22000
251580,202103,136,106,30,116600,33000,149600
251590,202103,115,83,32,91507.9,35200,126707.9
251593,202103,24,14,10,15400,11000,26400
251597,202103,96,78,18,85800,19800,105600
251600,202103,1108,781,327,859100,360800,1219900
251610,202103,241,179,62,196900,68200,265100
251615,202103,12,11,1,12100,1100,13200
251620,202103,4243,2755,1488,3031600,1642300,4673900
251630,202103,465,345,120,379500,132000,511500
251640,202103,139,100,39,110000,42900,152900
251650,202103,283,205,78,225500,85800,311300
251660,202103,190,168,22,184800,24200,209000
251670,202103,383,298,85,327800,93500,421300
251675,202103,8,6,2,6600,2200,8800
251680,202103,101,89,12,97900,13200,111100
251690,202103,324,267,57,293700,62700,356400
251700,202103,291,252,39,277200,42900,320100
251710,202103,22,14,8,15400,8800,24200
251720,202103,24,16,8,17600,8800,26400
251740,202103,12,8,4,8800,4400,13200
260005,202103,3324,1787,1537,1968532.93,1690700,3659232.93
260010,202103,1638,1180,458,1303500.14,503800,1807300.14
260020,202103,414,359,55,396000,60500,456500
260030,202103,598,412,186,454300,205700,660000
260040,202103,800,497,303,547800,333300,881100
260050,202103,1156,828,328,911900,360800,1272700
260060,202103,381,348,33,382800,36300,419100
260070,202103,1342,824,518,907500,572000,1479500
260080,202103,722,554,168,609400,184800,794200
260090,202103,495,326,169,359700,185900,545600
260100,202103,218,152,66,167200,72600,239800
260105,202103,245,135,110,148500,121000,269500
260110,202103,2877,2103,774,2315500,851400,3166900
260120,202103,2851,1444,1407,1588692.6,1549900,3138592.6
260130,202103,174,118,56,129800,61600,191400
260140,202103,2104,1363,741,1499300,819500,2318800
260150,202103,204,129,75,141900,82500,224400
260160,202103,318,265,53,292600,58300,350900
260170,202103,3352,1995,1357,2196700,1494900,3691600
260180,202103,162,128,34,141900,37400,179300
260190,202103,2334,1567,767,1725900,845900,2571800
260200,202103,966,770,196,848100.63,215600,1063700.63
260210,202103,1416,1001,415,1102200,456500,1558700
260220,202103,680,612,68,673200,74800,748000
260230,202103,1222,910,312,1001000,343200,1344200
260240,202103,215,162,53,179300,58300,237600
260250,202103,91,66,25,72600,27500,100100
260260,202103,1031,722,309,795300,339900,1135200
260270,202103,401,314,87,345400,95700,441100
260280,202103,1232,919,313,1012000,344300,1356300
260290,202103,6559,3532,3027,3892900,3334100.59,7227000.59
260300,202103,950,813,137,894300,150700,1045000
260310,202103,518,413,105,454300,115500,569800
260320,202103,855,623,232,686400,255200,941600
260330,202103,64,44,20,48400,22000,70400
260340,202103,77,57,20,62700,22000,84700
260345,202103,5484,2954,2530,3257100.4,2788500,6045600.4
260350,202103,480,340,140,374000,154000,528000
260360,202103,234,128,106,141900,116600,258500
260370,202103,762,479,283,528000,311300,839300
260380,202103,584,426,158,471900,174900.6,646800.6
260390,202103,290,243,47,267300,51700,319000
260392,202103,109,94,15,103400,16500,119900
260400,202103,4243,2413,1830,2659800.5,2017400,4677200.5
260410,202103,14720,7681,7039,8461201.03,7753900.5,16215101.53
260415,202103,142,124,18,136400,19800,156200
260420,202103,1717,1043,674,1147300.5,744700,1892000.5
260430,202103,177,163,14,181500.48,15400,196900.48
260440,202103,197,141,56,155100,61600,216700
260450,202103,433,319,114,350901.13,125400,476301.13
260460,202103,821,433,388,478500,426800,905300
260470,202103,342,209,133,229900,146300,376200
260480,202103,240,154,86,170500,94600,265100
260490,202103,209,172,37,189200,40700,229900
260500,202103,1124,760,364,836000,400400,1236400
260510,202103,781,622,159,686400,176000,862400
260515,202103,236,214,22,235400,24200,259600
260520,202103,3278,2028,1250,2231900,1375000,3606900
260530,202103,792,650,142,716100,156200,872300
260540,202103,542,427,115,469700,126500,596200
260545,202103,16,11,5,12100,5500,17600
260550,202103,325,202,123,222200,135300,357500
260560,202103,511,385,126,424600,138600,563200
260570,202103,970,784,186,863500,204600,1068100
260580,202103,249,216,33,238700,36300,275000
260590,202103,634,367,267,403700,294800,698500
260600,202103,8065,4369,3696,4809201.91,4074400,8883601.91
260610,202103,485,322,163,354200,180400,534600
260620,202103,3652,1878,1774,2065800,1955800.19,4021600.19
260630,202103,81,76,5,83600,5500,89100
260640,202103,3443,1924,1519,2117500.22,1674200,3791700.22
260650,202103,332,239,93,262900,102300,365200
260660,202103,561,354,207,389400,227700,617100
260670,202103,104,76,28,83600,30800,114400
260680,202103,3802,2076,1726,2288000,1900800,4188800
260690,202103,122,91,31,100100,34100,134200
260700,202103,309,207,102,227700,112200,339900
260710,202103,45,36,9,39600,9900,49500
260720,202103,2490,1449,1041,1595000,1146200,2741200
260730,202103,704,525,179,578600,196900,775500
260740,202103,68,59,9,64900,9900,74800
260750,202103,588,420,168,462000,184800,646800
260760,202103,675,340,335,374000.3,368500,742500.3
260765,202103,981,507,474,558800,522500,1081300
260770,202103,226,164,62,180381,68200,248581
260775,202103,772,430,342,474100,377300,851400
260780,202103,242,148,94,162800,103400,266200
260790,202103,14395,7278,7117,8012730,7838600,15851330
260795,202103,165,107,58,117700,63800,181500
260800,202103,293,240,53,264000,58300,322300
260805,202103,177,117,60,128700,66000,194700
260810,202103,763,647,116,715000,128700,843700
260820,202103,283,181,102,199100,113300,312400
260825,202103,212,144,68,159500,74800,234300
260830,202103,318,179,139,196900,152900,349800
260840,202103,239,176,63,193600,69300,262900
260845,202103,165,110,55,121000,60500,181500
260850,202103,428,312,116,345400,127600,473000
260860,202103,253,191,62,210100,68200,278300
260870,202103,363,276,87,303600.2,95700,399300.2
260875,202103,730,524,206,576400,226600,803000
260880,202103,1603,1018,585,1122000,643500,1765500
260890,202103,2348,1649,699,1815000,770000,2585000
260900,202103,987,701,286,771100,314600,1085700
260910,202103,249,198,51,217800,57200,275000
260915,202103,289,214,75,236500,82500,319000
260920,202103,184,96,88,105600,96800,202400
260930,202103,391,333,58,367400,63800,431200
260940,202103,2652,1422,1230,1566400,1354100,2920500
260950,202103,2002,1137,865,1252900,952600,2205500
260960,202103,13637,6803,6834,7494300.9,7537200.5,15031501.4
260970,202103,414,343,71,378400,78100,456500
260980,202103,192,172,20,189200,22000,211200
260990,202103,2625,2117,508,2328700,558800,2887500
261000,202103,4220,2543,1677,2798400,1845800,4644200
261010,202103,186,112,74,123200,81400,204600
261020,202103,598,447,151,491700.47,166100,657800.47
261030,202103,261,178,83,195800,91300,287100
261040,202103,372,324,48,358600,52800,411400
261050,202103,506,437,69,480700,75900,556600
261060,202103,1386,872,514,959200,566500,1525700
261070,202103,8899,4311,4588,4750900,5058900.5,9809800.5
261080,202103,372,285,87,314600,95700,410300
261090,202103,2173,1654,519,1819402.03,570900.3,2390302.33
261100,202103,1170,816,354,900900,389400,1290300
261110,202103,8783,5369,3414,5909200.84,3764200,9673400.84
261120,202103,259,222,37,244200,40700,284900
261130,202103,573,344,229,379500,251900,631400
261140,202103,205,128,77,140800,84700,225500
261150,202103,692,433,259,477400.56,286000,763400.56
261153,202103,68,63,5,69300,5500,74800
261160,202103,74504,36612,37892,40335992.95,41792301.55,82128294.50
261170,202103,466,345,121,379500,133100,512600
261180,202103,1780,1110,670,1222351,739200,1961551
261190,202103,622,439,183,482900.71,203500,686400.71
261200,202103,219,182,37,200200,40700,240900
261210,202103,33,29,4,31900,4400,36300
261220,202103,2723,1914,809,2108700.66,895400,3004100.66
261230,202103,338,249,89,273900,97900,371800
261240,202103,449,391,58,430100,63800,493900
261245,202103,240,197,43,216700,47300,264000
261247,202103,168,131,37,144100,40700,184800
261250,202103,3232,1561,1671,1718200,1840300,3558500
261255,202103,248,223,25,245300,27500,272800
261260,202103,836,724,112,798600.12,124300,922900.12
261270,202103,202,144,58,158400,63800,222200
261280,202103,178,145,33,159500,36300,195800
261290,202103,112,83,29,91300,31900,123200
261300,202103,1293,952,341,1049400,376200,1425600
261310,202103,796,531,265,584100,292600,876700
261320,202103,583,371,212,409200.22,233200,642400.22
261330,202103,966,731,235,805200,259600.63,1064800.63
261340,202103,299,169,130,185900,143000,328900
261350,202103,849,594,255,655600,280500,936100
261360,202103,1305,846,459,931700,504900,1436600
261370,202103,4839,2874,1965,3163600,2161500,5325100
261380,202103,548,418,130,459800.78,143000,602800.78
261390,202103,3588,2406,1182,2654300,1304600,3958900
261400,202103,292,261,31,287100,34100,321200
261410,202103,1117,731,386,805200,424600,1229800
261420,202103,890,548,342,605000.32,378400,983400.32
261430,202103,324,293,31,322300,34100,356400
261440,202103,114,105,9,115500,9900,125400
261450,202103,2522,2012,510,2217600,562100,2779700
261460,202103,726,575,151,633600,166100,799700
261470,202103,242,194,48,213400,53900,267300
261480,202103,446,348,98,382800,107750.5,490550.5
261485,202103,361,215,146,236500,160600,397100
261500,202103,615,415,200,457600.59,220000,677600.59
261510,202103,54,35,19,38500,20900,59400
261520,202103,94,81,13,89100,14300,103400
261530,202103,4130,2620,1510,2886400.09,1661000,4547400.09
261540,202103,1359,802,557,883300,612700,1496000
261550,202103,249,116,133,128700,146300,275000
261560,202103,861,561,300,617100,330000,947100
261570,202103,394,310,84,342100,93500,435600
261580,202103,382,299,83,328900,91300,420200
261590,202103,188,151,37,166100,41800,207900
261600,202103,293,233,60,256300,66000,322300
261610,202103,82,71,11,78100,12100,90200
261618,202103,75,58,17,63800,18700,82500
261620,202103,194,120,74,132000,81400,213400
261630,202103,542,424,118,467500,129800,597300
261640,202103,6444,3361,3083,3699301.05,3392400,7091701.05
261650,202103,492,312,180,343200,198000,541200
270010,202103,515,455,60,500500,66000,566500
270020,202103,282,230,52,253000,57200,310200
270030,202103,8794,5647,3147,6221601.56,3463900,9685501.56
270040,202103,2042,1302,740,1432200,815100,2247300
270050,202103,165,129,36,141900,39600,181500
270060,202103,108,59,49,64900,53900,118800
270070,202103,857,628,229,690800,251900,942700
270080,202103,37,31,6,34100,6600,40700
270090,202103,23,17,6,18700,6600,25300
270100,202103,1254,845,409,932140,449900,1382040
270110,202103,101,84,17,92400,18700,111100
270120,202103,224,182,42,200200,46200,246400
270130,202103,294,210,84,231000,92400,323400
270135,202103,114,72,42,79200,46200,125400
270140,202103,1367,874,493,962280,542300,1504580
270150,202103,264,200,64,220000,70400,290400
270160,202103,497,394,103,433400,113300,546700
270170,202103,803,519,284,573870,312400,886270
270180,202103,57,44,13,48400,14300,62700
270190,202103,88,77,11,84700,12100,96800
270200,202103,111,96,15,105600,16500,122100
270210,202103,513,293,220,323400,243100,566500
270220,202103,177,138,39,151800,42900,194700
270230,202103,2127,1301,826,1434400,910800,2345200
270235,202103,684,532,152,585200,167200,752400
270240,202103,2978,2357,621,2594900.93,683100,3278000.93
270250,202103,155,113,42,125400,46200,171600
270255,202103,221,192,29,211200,31900,243100
270260,202103,365,297,68,327800,74800,402600
270270,202103,101,47,54,51700,59400,111100
270280,202103,230,132,98,145200,107800,253000
270290,202103,1156,889,267,979000,293700,1272700
270300,202103,319,225,94,247500,103400,350900
270310,202103,843,698,145,767800,159500,927300
270320,202103,826,709,117,779900.63,129800,909700.63
270330,202103,295,247,48,271700,52800,324500
270340,202103,56,43,13,47300,14300,61600
270350,202103,89,51,38,56100,41800,97900
270360,202103,68,39,29,42900,33000,75900
270370,202103,58,46,12,50600,13200,63800
270375,202103,74,45,29,49500,31900,81400
270380,202103,1021,658,363,723800,399300,1123100
270390,202103,185,112,73,123200,80300,203500
270400,202103,719,540,179,594000.2,196900,790900.2
270410,202103,649,477,172,525800,191400,717200
270420,202103,399,271,128,298100,140800,438900
270430,202103,33053,23752,9301,26157232.23,10252696.66,36409928.89
270440,202103,475,376,99,413600,108900,522500
270450,202103,798,454,344,501600,378400,880000
270460,202103,183,145,38,160600,41800,202400
270470,202103,1488,1031,457,1135236.66,502700,1637936.66
270480,202103,541,445,96,490600,105600,596200
270490,202103,22,17,5,18700,5500,24200
270500,202103,491,412,79,453200,86900,540100
270510,202103,824,513,311,564300,342100,906400
270520,202103,284,181,103,199100,113300,312400
270530,202103,63,56,7,61600,7700,69300
270540,202103,99,76,23,83600,25300,108900
270550,202103,1725,1324,401,1457500.6,442200,1899700.6
270560,202103,266,149,117,163900,128700,292600
270570,202103,530,372,158,409200,173800,583000
270580,202103,88,70,18,77000,19800,96800
270590,202103,65,52,13,57200,14300,71500
270600,202103,172,144,28,158400,30800,189200
270610,202103,255,178,77,195800,84700,280500
270620,202103,17,17,0,18700,0,18700
270630,202103,3722,2832,890,3117400,980100,4097500
270640,202103,866,643,223,707300,245300,952600
270642,202103,208,176,32,193600,35200,228800
270644,202103,254,165,89,181500,99000,280500
270650,202103,332,198,134,217800,147400,365200
270660,202103,239,202,37,222200,40700,262900
270670,202103,3048,2314,734,2546501.01,809600,3356101.01
270680,202103,430,259,171,284900,188100,473000
270690,202103,1186,785,401,865700,442200,1307900
270700,202103,27,22,5,24200,5500,29700
270710,202103,867,682,185,750200,203500,953700
270720,202103,234,184,50,203500,55000,258500
270730,202103,1856,1127,729,1239700,801900,2041600
270740,202103,42,29,13,31900,14300,46200
270750,202103,641,484,157,533536.66,172700,706236.66
270760,202103,288,209,79,229900,86900,316800
270770,202103,2754,1833,921,2019269.99,1015300,3034569.99
270780,202103,71,46,25,50600,27500,78100
270790,202103,263,171,92,188100,101200,289300
270800,202103,2099,1625,474,1793000,521400,2314400
270810,202103,228,187,41,205700,45100,250800
270820,202103,136,95,41,104500,45100,149600
270830,202103,783,587,196,646800,215600,862400
270840,202103,1370,1045,325,1149500.4,357500,1507000.4
270850,202103,1489,936,553,1031800,609400,1641200
270860,202103,2554,1702,852,1873300.7,937200,2810500.7
270870,202103,116,65,51,71500,56100,127600
270880,202103,883,697,186,768900,206800,975700
270890,202103,282,210,72,232100,79200,311300
270895,202103,51,47,4,51700,4400,56100
270900,202103,80,62,18,68200,19800,88000
270910,202103,303,250,53,275000,58300,333300
270915,202103,1887,1213,674,1335400,744700,2080100
270920,202103,461,385,76,423500,83600,507100
270930,202103,5905,4439,1466,4884000,1615900.14,6499900.14
270940,202103,2239,1756,483,1936000,531300,2467300
280010,202103,39,32,7,35200,7700,42900
280020,202103,484,413,71,456500,78100,534600
280030,202103,20655,13325,7330,14674002.84,8071801.25,22745804.09
280040,202103,329,213,116,234300,127600,361900
280050,202103,402,311,91,342100,100100,442200
280060,202103,340,220,120,242000,132000,374000
280067,202103,1090,786,304,864600,334400.5,1199000.5
280070,202103,126,102,24,112200,26400,138600
280100,202103,643,498,145,548900,160600,709500
280110,202103,73,68,5,74800,5500,80300
280120,202103,655,536,119,589600,132000,721600
280130,202103,1753,1153,600,1271600,660000,1931600
280140,202103,483,397,86,436700,94600,531300
280150,202103,399,279,120,306900,132000,438900
280160,202103,122,100,22,110000,24200,134200
280170,202103,405,283,122,311300,134200,445500
280190,202103,25,22,3,24200,3300,27500
280200,202103,32,28,4,30800,4400,35200
280210,202103,2939,2111,828,2326369.6,910800,3237169.6
280220,202103,39,32,7,35200,7700,42900
280230,202103,326,267,59,295900,66000,361900
280240,202103,124,118,6,129800,6600,136400
280250,202103,20,10,10,11000,11000,22000
280260,202103,76,69,7,77000,7700,84700
280270,202103,153,119,34,130900,37400,168300
280280,202103,197,129,68,141900.5,74800,216700.5
280290,202103,3397,2447,950,2693829.5,1045000,3738829.5
280300,202103,1598,1249,349,1375000,383900,1758900
280310,202103,97,92,5,101200,5500,106700
280320,202103,644,452,192,497200,211200,708400
280330,202103,322,234,88,257766.66,96800,354566.66
280340,202103,407,329,78,363000,85800,448800
280350,202103,3698,2874,824,3166900.66,908600.08,4075500.74
280360,202103,479,329,150,363000,166100,529100
280370,202103,96,84,12,92400,13200,105600
280380,202103,53,39,14,42900,15400,58300
280390,202103,172,147,25,161700,27500,189200
280400,202103,355,242,113,267300,124300,391600
280410,202103,288,238,50,261800,55000,316800
280420,202103,172,145,27,159500,29700,189200
280430,202103,57,44,13,48400,14300,62700
280440,202103,694,546,148,601700,163900,765600
280445,202103,120,109,11,119900,12100,132000
280450,202103,1199,1036,163,1141800,180400,1322200
280460,202103,626,458,168,506000.93,184800,690800.93
280470,202103,184,171,13,188100,14300,202400
280480,202103,2737,1903,834,2095501.67,917400.5,3012902.17
280490,202103,253,239,14,262900.96,15400,278300.96
280500,202103,44,40,4,44000,4400,48400
280510,202103,141,113,28,124300,30800,155100
280520,202103,53,38,15,41800,16500,58300
280530,202103,82,52,30,57200,33000,90200
280540,202103,536,452,84,497200,92400,589600
280550,202103,736,677,59,744700.65,64900,809600.65
280560,202103,494,439,55,482900,60500,543400
280570,202103,2229,1753,476,1928300,524700,2453000
280580,202103,589,456,133,501600,146300,647900
280590,202103,213,135,78,148500,85800,234300
280600,202103,381,318,63,352051.7,69300,421351.7
280610,202103,111,83,28,91300,30800,122100
280620,202103,547,447,100,492800,110000,602800
280630,202103,158,130,28,143000,30800,173800
280640,202103,194,152,42,167200,46200,213400
280650,202103,93,59,34,64900,37400,102300
280660,202103,139,101,38,111100,41800,152900
280670,202103,1893,1186,707,1305700.4,778800.48,2084500.88
280680,202103,204,179,25,196900,27500,224400
280690,202103,80,71,9,78100,9900,88000
280700,202103,21,21,0,23100,0,23100
280710,202103,1473,1137,336,1250700,372900,1623600
280720,202103,113,74,39,81400,42900,124300
280730,202103,28,23,5,25300,5500,30800
280740,202103,2508,1872,636,2061400,701800,2763200
280750,202103,237,208,29,231000,31900,262900
280760,202103,794,550,244,605000,268400,873400
290010,202103,201,141,60,155100,66000,221100
290020,202103,189,170,19,187000,20900,207900
290030,202103,612,395,217,434500,238700,673200
290035,202103,131,107,24,117700,27500,145200
290040,202103,302,204,98,225500,107800,333300
290050,202103,82,64,18,70400,19800,90200
290060,202103,259,115,144,126500,159500,286000
290070,202103,5685,2725,2960,2998600.69,3257100,6255700.69
290080,202103,448,202,246,222200,270600,492800
290090,202103,378,168,210,184800,231000,415800
290100,202103,1631,1057,574,1162700,632500.38,1795200.38
290110,202103,832,482,350,531300.85,386100,917400.85
290115,202103,195,181,14,199100,15400,214500
290120,202103,770,509,261,561000,287100,848100
290130,202103,433,267,166,293700,182600,476300
290135,202103,307,236,71,259600,78100,337700
290140,202103,315,259,56,284900,61600,346500
290150,202103,140,98,42,107800,46200,154000
290160,202103,243,186,57,204600,62700,267300
290170,202103,91,64,27,70400,29700,100100
290180,202103,181,132,49,145200,53900,199100
290190,202103,443,360,83,398200,91300,489500
290195,202103,311,201,110,221100,121000,342100
290200,202103,270,220,50,243100,55000,298100
290205,202103,149,92,57,101200,62700,163900
290210,202103,1169,865,304,952600,334400,1287000
290220,202103,214,119,95,130900,104500,235400
290225,202103,287,118,169,129800,185900,315700
290230,202103,81,50,31,55000,34100,89100
290240,202103,360,127,233,139700,256300,396000
290250,202103,254,234,20,257400,22000,279400
290260,202103,323,266,57,292600,62700,355300
290265,202103,189,163,26,179300,29700,209000
290270,202103,1418,1185,233,1303500,256300,1559800
290280,202103,478,337,141,370700,155100,525800
290290,202103,1330,795,535,874501.48,588500,1463001.48
290300,202103,425,364,61,401500,67100,468600
290310,202103,294,138,156,151800,171600,323400
290320,202103,4057,2510,1547,2763200.11,1703900,4467100.11
290323,202103,190,165,25,181500,27500,209000
290327,202103,172,135,37,148500,40700,189200
290330,202103,116,58,58,63800,63800,127600
290340,202103,806,332,474,365200,522500,887700
290350,202103,628,374,254,412500,279400,691900
290360,202103,346,266,80,292600.99,88000,380600.99
290370,202103,910,389,521,427900,573100,1001000
290380,202103,325,207,118,227700,130900,358600
290390,202103,2420,1513,907,1668700,998800,2667500
290395,202103,243,137,106,150700,116600,267300
290400,202103,276,203,73,224400,80300,304700
290405,202103,246,212,34,233200,37400,270600
290410,202103,624,520,104,572000.3,114400,686400.3
290420,202103,257,207,50,228800,55000,283800
290430,202103,482,314,168,346500,184800,531300
290440,202103,77,68,9,74800,9900,84700
290450,202103,196,147,49,161700,53900,215600
290460,202103,1936,1155,781,1273800,859100,2132900
290470,202103,1370,602,768,664400,845900,1510300
290475,202103,554,519,35,572000.27,38500,610500.27
290480,202103,288,165,123,181500,135300,316800
290485,202103,238,217,21,239800,23100,262900
290490,202103,1225,876,349,965800,385000,1350800
290500,202103,737,378,359,415800,394900,810700
290510,202103,230,183,47,202400,51700,254100
290515,202103,160,97,63,106700,69300,176000
290520,202103,1396,911,485,1006500,533500.2,1540000.2
290530,202103,301,276,25,303600,27500,331100
290540,202103,105,54,51,59400,56100,115500
290550,202103,162,136,26,149600,28600,178200
290560,202103,3130,1361,1769,1497100,1948100,3445200
290570,202103,6205,2983,3222,3289000,3551900,6840900
290580,202103,1268,754,514,829400,566500,1395900
290590,202103,572,470,102,517000,112200,629200
290600,202103,1756,1204,552,1326600.67,609400,1936000.67
290610,202103,203,183,20,201300,22000,223300
290620,202103,354,320,34,352000,37400,389400
290630,202103,1992,845,1147,930600,1262800,2193400
290640,202103,145,116,29,127600,31900,159500
290650,202103,1784,834,950,919600.92,1047200,1966800.92
290660,202103,284,231,53,254100,58300,312400
290670,202103,929,477,452,524700,497200,1021900
290680,202103,1232,992,240,1093400,265100,1358500
290682,202103,310,233,77,256300.48,84700,341000.48
290685,202103,244,159,85,174900,93500,268400
290687,202103,1068,691,377,761379,415800,1177179
290689,202103,143,76,67,83600,74800,158400
290690,202103,609,259,350,286000,385000,671000
290700,202103,241,120,121,132000,133100,265100
290710,202103,765,522,243,574200,267300,841500
290720,202103,1027,832,195,915200,214500,1129700
290730,202103,1175,676,499,743600,552200,1295800
290740,202103,19,16,3,17600,3300,20900
290750,202103,1396,619,777,680900,855800,1536700
290755,202103,72,66,6,72600,7700,80300
290760,202103,287,248,39,273900,42900,316800
290770,202103,187,175,12,193600,13200,206800
290780,202103,1111,857,254,942700,280500,1223200
290790,202103,372,258,114,283800,125400,409200
290800,202103,2443,997,1446,1096700,1591700,2688400
290810,202103,465,321,144,353100,158400,511500
290820,202103,401,232,169,255200,185900,441100
290830,202103,430,306,124,336600,136400,473000
290840,202103,1766,1099,667,1208900,735900,1944800
290850,202103,847,435,412,480700,453200,933900
290860,202103,643,286,357,314600,393800,708400
290870,202103,621,443,178,489500,195800,685300
290880,202103,121,65,56,71500,61600,133100
290890,202103,414,267,147,293700,162800,456500
290900,202103,167,126,41,138600,45100,183700
290910,202103,384,291,93,320100,102300,422400
290920,202103,208,181,27,199100,29700,228800
290930,202103,819,623,196,685300,215600,900900
290940,202103,241,202,39,223300,42900,266200
290950,202103,157,93,64,103400,70400,173800
290960,202103,475,335,140,368500,154000,522500
290970,202103,245,215,30,237600,33000,270600
290980,202103,1609,1126,483,1238600,533500,1772100
290990,202103,400,337,63,370700,69300,440000
291000,202103,871,270,601,297000,661100,958100
291005,202103,2337,1009,1328,1113200,1460800.42,2574000.42
291010,202103,163,147,16,162800,17600,180400
291020,202103,101,80,21,88000,23100,111100
291030,202103,97,69,28,75900,30800,106700
291040,202103,608,346,262,381700,289300,671000
291050,202103,1446,791,655,870100,721600,1591700
291060,202103,1561,848,713,932800,784300,1717100
291070,202103,1972,1468,504,1617000.82,554401.3,2171402.12
291072,202103,7160,2665,4495,2937000,4956600,7893600
291075,202103,242,198,44,217800,48400,266200
291077,202103,60,41,19,45100,20900,66000
291080,202103,20276,8789,11487,9675600.75,12653300.55,22328901.30
291085,202103,296,242,54,266200,59400,325600
291090,202103,292,122,170,134200,187000,321200
291100,202103,640,198,442,217800,487300,705100
291110,202103,422,323,99,356400,108900,465300
291120,202103,2378,1204,1174,1324400,1293600,2618000
291125,202103,64,31,33,34100,37400,71500
291130,202103,198,175,23,192500,25300,217800
291140,202103,128,103,25,113300,27500,140800
291150,202103,392,145,247,159500,271700,431200
291160,202103,384,312,72,343200,79200,422400
291165,202103,48,37,11,40700,12100,52800
291170,202103,3148,1562,1586,1718200.5,1745700,3463900.5
291180,202103,1248,505,743,555500,819500,1375000
291185,202103,100,95,5,104500,5500,110000
291190,202103,1388,642,746,706200,822800,1529000
291200,202103,169,124,45,137500,49500,187000
291210,202103,2316,915,1401,1007600,1543300,2550900
291220,202103,279,209,70,229900,77000,306900
291230,202103,967,331,636,364100,700700,1064800
291240,202103,432,402,30,443300,33000,476300
291250,202103,434,352,82,387200,90200,477400
291260,202103,59,50,9,55000,9900,64900
291270,202103,1146,478,668,525800,735900,1261700
291280,202103,346,163,183,179300,201300,380600
291290,202103,1711,894,817,984500,899800,1884300
291300,202103,226,180,46,199100,51700,250800
291310,202103,225,201,24,222200,26400,248600
291320,202103,1348,952,396,1049400,435600,1485000
291330,202103,131,113,18,124300,19800,144100
291340,202103,215,128,87,140800,95700,236500
291345,202103,128,89,39,97900,42900,140800
291350,202103,1647,579,1068,639100,1178100,1817200
291360,202103,8344,4021,4323,4427500,4763000,9190500
291370,202103,1118,649,469,715000,517000,1232000
291380,202103,265,211,54,233200,59400,292600
291390,202103,3926,1735,2191,1909600,2412300.04,4321900.04
291400,202103,2075,1484,591,1634600,653400.42,2288000.42
291410,202103,194,168,26,185900,28600,214500
291420,202103,118,87,31,95700,34100,129800
291430,202103,165,91,74,100100,81400.5,181500.5
291440,202103,514,422,92,464200,101200,565400
291450,202103,927,594,333,654500,367400,1021900
291460,202103,1877,1521,356,1675300,391600,2066900
291465,202103,2205,1044,1161,1149500,1277100,2426600
291470,202103,2839,1430,1409,1573000.55,1553200,3126200.55
291480,202103,11755,5161,6594,5681501.62,7260000,12941501.62
291490,202103,608,242,366,266200,402600,668800
291500,202103,380,224,156,246400,171600,418000
291510,202103,1228,473,755,520300,830500,1350800
291520,202103,940,426,514,468600,565400,1034000
291530,202103,927,245,682,270600,755700,1026300
291535,202103,121,99,22,108900,24200,133100
291540,202103,354,114,240,125400,264000,389400
291550,202103,1245,588,657,647900,724900,1372800
291560,202103,5209,2608,2601,2872100,2865500,5737600
291570,202103,209,107,102,117700,112200,229900
291580,202103,1183,731,452,805200,498300,1303500
291590,202103,93,40,53,44000,58300,102300
291600,202103,1136,558,578,613800,635800,1249600
291610,202103,1445,691,754,761200,831600,1592800
291620,202103,567,267,300,293700,330000,623700
291630,202103,475,149,326,163900,359700,523600
291640,202103,3955,1996,1959,2196700,2157100,4353800
291650,202103,431,291,140,320100.5,154000,474100.5
291660,202103,378,154,224,169400,246400,415800
291670,202103,219,131,88,144100,96800,240900
291680,202103,638,388,250,426800,276100,702900
291685,202103,578,324,254,356400,279400,635800
291690,202103,511,313,198,344300,218900.92,563200.92
291700,202103,980,758,222,833800,244200,1078000
291710,202103,1614,780,834,859100,920700.97,1779800.97
291720,202103,424,287,137,315700,150700,466400
291730,202103,933,543,390,598400,429000,1027400
291733,202103,288,194,94,213400,103400,316800
291735,202103,71,55,16,60500,17600,78100
291740,202103,351,267,84,293700,93500,387200
291750,202103,2202,1435,767,1580700.26,843700,2424400.26
291760,202103,2936,1630,1306,1796300,1438800,3235100
291770,202103,763,520,243,572000,267300,839300
291780,202103,59,35,24,38500,26400,64900
291790,202103,156,81,75,89100,82500,171600
291800,202103,10045,4183,5862,4604600.42,6454800,11059400.42
291810,202103,1100,824,276,907500,303600,1211100
291820,202103,278,202,76,222200,83600,305800
291830,202103,1048,425,623,467500.59,685300,1152800.59
291835,202103,555,514,41,568700,45100,613800
291840,202103,4916,2488,2428,2741200,2674100,5415300
291845,202103,268,86,182,94600,200200,294800
291850,202103,321,284,37,312400,40700,353100
291855,202103,256,103,153,113300,168300,281600
291860,202103,169,105,64,116600,70400,187000
291870,202103,83,36,47,39600,51700,91300
291875,202103,178,164,14,180400,15400,195800
291880,202103,445,355,90,390500,99000,489500
291890,202103,248,81,167,89100,184800,273900
291900,202103,59,33,26,36300,28600,64900
291905,202103,123,90,33,99000,36300,135300
291910,202103,154,124,30,136400,33000,169400
291915,202103,431,381,50,419100,55000,474100
291920,202103,5121,2533,2588,2790700,2852300,5643000
291930,202103,167,101,66,111100.27,74800,185900.27
291940,202103,358,209,149,229900,165000,394900
291950,202103,1136,912,224,1003200,246400,1249600
291955,202103,1276,775,501,854700,553300,1408000
291960,202103,193,141,52,155100,57200,212300
291970,202103,755,570,185,627000.31,203500,830500.31
291980,202103,1494,1315,179,1448700.73,198000,1646700.73
291990,202103,137,127,10,139700,11000,150700
291992,202103,164,86,78,94600,85800,180400
291995,202103,185,120,65,132000,71500,203500
292000,202103,392,298,94,327800,103400,431200
292010,202103,317,219,98,240900,107800,348700
292020,202103,299,219,80,240900,88000,328900
292030,202103,144,110,34,121000,37400,158400
292040,202103,620,320,300,352000,330000,682000
292045,202103,113,102,11,112200,12100,124300
292050,202103,937,682,255,750200,280500,1030700
292060,202103,904,740,164,814000,180400,994400
292070,202103,63,19,44,20900,48400,69300
292080,202103,138,94,44,103400,48400,151800
292090,202103,540,187,353,205700,388300,594000
292100,202103,1480,630,850,693000,936100,1629100
292105,202103,188,167,21,183700,23100,206800
292110,202103,2256,820,1436,903100,1580700,2483800
292120,202103,694,546,148,601700,162800,764500
292130,202103,445,247,198,271700,217800,489500
292140,202103,207,167,40,183700,44000,227700
292145,202103,161,87,74,95700,81400,177100
292150,202103,1490,1223,267,1348600,293700,1642300
292160,202103,160,131,29,144100,31900,176000
292170,202103,1183,1025,158,1128600,174900,1303500
292180,202103,220,161,59,177100,64900,242000
292190,202103,159,104,55,114400,60500,174900
292200,202103,1352,488,864,536800,952600,1489400
292205,202103,125,108,17,118800,18700,137500
292210,202103,367,251,116,276100,128700,404800
292220,202103,33,24,9,26400,9900,36300
292225,202103,40,32,8,35200,8800,44000
292230,202103,945,746,199,821700,218900,1040600
292240,202103,611,444,167,488400,184800,673200
292250,202103,1685,1100,585,1214400,645700,1860100
292260,202103,403,241,162,266200,178200,444400
292265,202103,247,179,68,198000,74800,272800
292270,202103,731,337,394,371800,433400,805200
292273,202103,208,115,93,126500,103400,229900
292275,202103,175,89,86,97900,94600,192500
292280,202103,142,99,43,108900,47300,156200
292285,202103,77,63,14,69300,15400,84700
292290,202103,577,387,190,425700,209000,634700
292300,202103,1719,640,1079,704000,1186900,1890900
292303,202103,117,76,41,83600,45100,128700
292305,202103,117,87,30,95700,33000,128700
292310,202103,931,604,327,664400,359700,1024100
292320,202103,591,447,144,491700,158400,650100
292330,202103,174,101,73,111100,81400,192500
292335,202103,276,217,59,238700,64900,303600
292340,202103,575,399,176,438900,193600,632500
292350,202103,270,148,122,162800,134200,297000
292360,202103,699,533,166,586300,182600,768900
292370,202103,747,573,174,630300,191400,821700
292380,202103,632,514,118,566500,129800,696300
292390,202103,459,182,277,200200,304700,504900
292400,202103,3596,2235,1361,2459600,1497100,3956700
292405,202103,270,180,90,198000,99000,297000
292410,202103,132,81,51,89100,56100,145200
292420,202103,295,256,39,281600,42900,324500
292430,202103,545,408,137,448800,151800,600600
292440,202103,609,516,93,567600.56,102300,669900.56
292450,202103,240,187,53,206800,58300,265100
292460,202103,543,405,138,446600,151800,598400
292465,202103,209,176,33,193600,37400,231000
292467,202103,143,87,56,95700,61600,157300
292470,202103,293,198,95,217800,105600,323400
292480,202103,366,248,118,272800,129800,402600
292490,202103,238,169,69,185900,77000,262900
292500,202103,848,379,469,416900.32,518100,935000.32
292510,202103,3454,1603,1851,1763300,2038300,3801600
292520,202103,1096,510,586,562100,645700,1207800
292525,202103,404,286,118,314600,129800,444400
292530,202103,4445,1770,2675,1948100.65,2942500,4890600.65
292540,202103,482,270,212,297000,233200,530200
292550,202103,1096,579,517,639100,569800,1208900
292560,202103,333,310,23,341000,25300,366300
292570,202103,309,240,69,264000,77000,341000
292575,202103,492,330,162,364100,178200,542300
292580,202103,990,654,336,721600,370700,1092300
292590,202103,563,492,71,541200,78100,619300
292593,202103,140,111,29,122100,31900,154000
292595,202103,204,160,44,176000,49500,225500
292600,202103,1261,921,340,1013100.63,375100,1388200.63
292610,202103,128,99,29,108900,31900,140800
292620,202103,531,451,80,496100,88000,584100
292630,202103,1442,802,640,882200,707300,1589500
292640,202103,851,596,255,655600,280500,936100
292650,202103,188,155,33,170500.5,36300,206800.5
292660,202103,2022,1442,580,1589500,638000.92,2227500.92
292665,202103,141,101,40,111100,44000,155100
292670,202103,395,315,80,346500,88000,434500
292680,202103,258,192,66,211200,72600,283800
292690,202103,194,141,53,155100,58300,213400
292700,202103,984,650,334,715000.9,367400,1082400.9
292710,202103,117,102,15,112200,16500,128700
292720,202103,930,526,404,580800,445500,1026300
292730,202103,198,92,106,101200,116600,217800
292740,202103,69535,33760,35775,37194304.1,39436101.84,76630405.94
292750,202103,397,282,115,310200,126500,436700
292760,202103,341,285,56,313500,61600,375100
292770,202103,832,356,476,391600,524700,916300
292780,202103,404,156,248,171600,272800,444400
292790,202103,778,404,374,444400,412500,856900
292800,202103,1258,749,509,827200,559900,1387100
292805,202103,394,122,272,134200,300300,434500
292810,202103,1513,862,651,950400,716100,1666500
292820,202103,708,600,108,661100,118800,779900
292830,202103,117,93,24,102300,26400,128700
292840,202103,685,558,127,614900,139700,754600
292850,202103,141,93,48,103400,52800,156200
292860,202103,2125,1238,887,1361800,977900,2339700
292870,202103,3503,2329,1174,2563000,1293600,3856600
292880,202103,1484,974,510,1071400,562100,1633500
292890,202103,525,443,82,487300,90200,577500
292895,202103,140,93,47,102300,51700,154000
292900,202103,371,268,103,294800,113300,408100
292905,202103,484,239,245,262900,269500,532400
292910,202103,459,346,113,380600,124300,504900
292920,202103,520,226,294,249700,323400,573100
292925,202103,502,460,42,507100,47300,554400
292930,202103,631,378,253,415800,278300,694100
292935,202103,290,120,170,132000,188100,320100
292937,202103,227,154,73,169400,80300,249700
292940,202103,191,147,44,161700,48400,210100
292950,202103,1173,581,592,640200,651200.6,1291400.6
292960,202103,573,404,169,446600,185900,632500
292970,202103,242,170,72,187000.48,79200,266200.48
292975,202103,106,62,44,69300,48400,117700
292980,202103,291,198,93,217800.61,102300,320100.61
292990,202103,1331,988,343,1087900,377300,1465200
293000,202103,116,79,37,86900,40700,127600
293010,202103,2811,1659,1152,1829300,1271600.8,3100900.8
293015,202103,633,515,118,567600,129800,697400
293020,202103,335,275,60,302500,66000,368500
293030,202103,605,528,77,580800,85800,666600
293040,202103,366,291,75,320100,82500,402600
293050,202103,2868,1686,1182,1855700,1302400,3158100
293060,202103,258,206,52,226600.48,57200,283800.48
293070,202103,3519,1766,1753,1945900.18,1930500,3876400.18
293075,202103,88,59,29,66000,31900,97900
293076,202103,75,55,20,60500,22000,82500
293077,202103,541,309,232,339900.77,255200,595100.77
293080,202103,434,389,45,427900,49500,477400
293090,202103,131,118,13,130900,14300,145200
293100,202103,518,360,158,396000,173800,569800
293105,202103,342,250,92,275000,101200,376200
293110,202103,168,115,53,126500,58300,184800
293120,202103,299,203,96,223300,105600,328900
293130,202103,253,172,81,190300,89100,279400
293135,202103,8093,3152,4941,3470500,5442800,8913300
293140,202103,213,130,83,143000,91300,234300
293150,202103,316,275,41,302500,45100,347600
293160,202103,426,254,172,279400,189200,468600
293170,202103,191,126,65,138600,71500,210100
293180,202103,555,391,164,430100,180400,610500
293190,202103,1345,931,414,1025201.4,455400,1480601.4
293200,202103,559,488,71,536800,78100,614900
293210,202103,398,299,99,328900,108900,437800
293220,202103,2455,1051,1404,1159400,1548800,2708200
293230,202103,1760,656,1104,721600.1,1218800,1940400.1
293240,202103,232,212,20,233200,22000,255200
293245,202103,127,106,21,117700,23100,140800
293250,202103,732,268,464,294800.22,510400,805200.22
293260,202103,303,250,53,275036.66,58300,333336.66
293270,202103,1180,544,636,598400,700700,1299100
293280,202103,282,160,122,176000,134200,310200
293290,202103,3043,1977,1066,2175800,1173700,3349500
293300,202103,755,530,225,583000,247500,830500
293305,202103,202,158,44,173800,48400,222200
293310,202103,161,121,40,133100,44000,177100
293315,202103,166,130,36,143000,39600,182600
293317,202103,89,65,24,71500,26400,97900
293320,202103,1068,579,489,636900.5,537900,1174800.5
293325,202103,188,70,118,77000,129800,206800
293330,202103,13700,6351,7349,6993800.38,8108100,15101900.38
293340,202103,277,194,83,213400,92400,305800
293345,202103,249,202,47,222200,51700,273900
293350,202103,607,354,253,389400,278300,667700
293360,202103,1521,1089,432,1197900,477400,1675300
310010,202103,139,74,65,81400,72600,154000
310020,202103,1027,564,463,620400,512600,1133000
310030,202103,324,259,65,286000,71500,357500
310040,202103,42,28,14,30800,15400,46200
310050,202103,174,107,67,117700,73700,191400
310060,202103,254,176,78,193600,85800,279400
310070,202103,14,9,5,9900,5500,15400
310080,202103,41,25,16,27500,17600,45100
310090,202103,1019,533,486,588500,534600,1123100
310100,202103,308,223,85,245300,93500,338800
310110,202103,704,382,322,421300,354200,775500
310120,202103,380,215,165,236500,181500,418000
310130,202103,33,18,15,19800,16500,36300
310140,202103,24,10,14,11000,15400,26400
310150,202103,1168,786,382,864600,420200,1284800
310160,202103,2035,989,1046,1091200.37,1152800,2244000.37
310163,202103,86,48,38,52800,41800,94600
310170,202103,2519,1105,1414,1215500,1559800,2775300
310180,202103,157,59,98,64900,107800,172700
310190,202103,493,337,156,370700,171600,542300
310200,202103,481,306,175,336600,192500,529100
310205,202103,59,38,21,41800,23100,64900
310210,202103,280,226,54,248600,60500,309100
310220,202103,59,34,25,37400,27500,64900
310230,202103,276,190,86,209000,94600,303600
310240,202103,107,93,14,103400,15400,118800
310250,202103,97,78,19,85800,20900,106700
310260,202103,752,393,359,432300.92,397100,829400.92
310270,202103,267,169,98,185900,107800,293700
310280,202103,371,272,99,300300,108900,409200
310285,202103,206,151,55,166100,60500,226600
310290,202103,236,133,103,146300,113300,259600
310300,202103,162,132,30,145200,33000,178200
310310,202103,8,7,1,7700,1100,8800
310320,202103,25,9,16,9900,17600,27500
310330,202103,41,27,14,29700,15400,45100
310340,202103,1760,1165,595,1281500,655600,1937100
310350,202103,2766,1469,1297,1618100,1428900,3047000
310360,202103,40,33,7,36300,7700,44000
310370,202103,128,106,22,117700,24200,141900
310375,202103,104,37,67,40700,73700,114400
310380,202103,48,28,20,30800,22000,52800
310390,202103,99,65,34,71500,37400,108900
310400,202103,2368,1518,850,1672000,935000,2607000
310410,202103,128,70,58,77000,63800,140800
310420,202103,661,342,319,376200,350900,727100
310430,202103,289,177,112,195800,123200,319000
310440,202103,73,42,31,46200,34100,80300
310445,202103,78,64,14,70400,16500,86900
310450,202103,622,388,234,426800,257400,684200
310460,202103,254,178,76,196900,83600,280500
310470,202103,508,322,186,355300,204600,559900
310480,202103,85,54,31,59400,34100,93500
310490,202103,528,244,284,269500,312400,581900
310500,202103,134,52,82,57200,90200,147400
310510,202103,598,418,180,462000,198000,660000
310520,202103,136,96,40,105600,45100,150700
310530,202103,104,42,62,47300,69300,116600
310540,202103,472,267,205,293700,227700,521400
310550,202103,72,45,27,49500,29700,79200
310560,202103,2954,2029,925,2236300,1018600,3254900
310570,202103,93,58,35,63800,38500,102300
310590,202103,374,237,137,260700,151800,412500
310600,202103,146,80,66,88000,72600,160600
310610,202103,56,21,35,23100,38500,61600
310620,202103,46918,22187,24731,24459517.5,27263500,51723017.5
310630,202103,660,400,260,440000,287100,727100
310640,202103,122,95,27,104500,29700,134200
310650,202103,156,138,18,151800,19800,171600
310660,202103,98,67,31,73700,34100,107800
310665,202103,61,46,15,50600,16500,67100
310670,202103,6728,2850,3878,3138300,4273500,7411800
310680,202103,61,36,25,39600,27500,67100
310690,202103,599,420,179,462000,198000,660000
310700,202103,60,38,22,41800,24200,66000
310710,202103,1313,888,425,976800,467500,1444300
310720,202103,138,35,103,39600,113300,152900
310730,202103,1475,1007,468,1109900,514800,1624700
310740,202103,984,544,440,598400,484000,1082400
310750,202103,239,145,94,159500,103400,262900
310760,202103,64,49,15,53900,16500,70400
310770,202103,91,45,46,49500,50600,100100
310780,202103,362,292,70,321200,78100,399300
310790,202103,104,85,19,93500,22000,115500
310800,202103,450,206,244,226600,268400,495000
310810,202103,171,118,53,129800.72,58300,188100.72
310820,202103,332,262,70,288200,77000,365200
310825,202103,197,168,29,184800,31900,216700
310830,202103,475,224,251,246400,276100,522500
310840,202103,359,210,149,231000,163900,394900
310850,202103,80,66,14,72600,15400,88000
310855,202103,405,315,90,346500,99000,445500
310860,202103,1587,1167,420,1285900,462000,1747900
310870,202103,56,46,10,50600,11000,61600
310880,202103,85,67,18,73700,19800,93500
310890,202103,307,174,133,191400,146300,337700
310900,202103,642,282,360,314607.2,396011.52,710618.72
310910,202103,238,160,78,176000,85800,261800
310920,202103,452,261,191,287100,210100,497200
310925,202103,33,27,6,29700,6600,36300
310930,202103,1298,837,461,921800,509300,1431100
310940,202103,687,341,346,377300,380600,757900
310945,202103,122,79,43,86900,47300,134200
310950,202103,226,181,45,199100,49500,248600
310960,202103,75,23,52,26400,58300,84700
310970,202103,168,105,63,115500,70400,185900
310980,202103,47,31,16,34100,17600,51700
310990,202103,164,83,81,91300,89100,180400
311000,202103,812,392,420,433400.1,463100,896500.1
311010,202103,50,44,6,48400,6600,55000
311020,202103,43,24,19,26400,20900,47300
311030,202103,384,220,164,243100,180400,423500
311040,202103,40,31,9,34100,9900,44000
311050,202103,465,175,290,193600,320100,513700
311060,202103,769,420,349,463100,386100,849200
311070,202103,338,148,190,162800,209000,371800
311080,202103,108,60,48,66000,52800,118800
311090,202103,335,157,178,173800,198000,371800
311100,202103,571,339,232,372900,255200,628100
311110,202103,690,486,204,535700,224400,760100
311115,202103,72,51,21,57200,23100,80300
311120,202103,1057,559,498,614900,547800,1162700
311130,202103,318,187,131,209000,145200,354200
311140,202103,168,89,79,97900,86900,184800
311150,202103,342,220,122,244200,134200,378400
311160,202103,710,506,204,556600,225500,782100
311170,202103,86,69,17,75900,18700,94600
311180,202103,307,204,103,224400,113300,337700
311190,202103,41,18,23,19800,25300,45100
311200,202103,335,236,99,260700,108900,369600
311205,202103,34,25,9,27500,9900,37400
311210,202103,43,38,5,41800,5500,47300
311220,202103,29,24,5,26400,5500,31900
311230,202103,1624,1068,556,1178100,612700,1790800
311240,202103,193,122,71,134200,78100,212300
311250,202103,54,21,33,23100,36300,59400
311260,202103,556,349,207,383900,227700,611600
311265,202103,128,87,41,95700,45100,140800
311270,202103,282,195,87,214500,95700,310200
311280,202103,199,92,107,101200,117700,218900
311290,202103,104,85,19,93500,20900,114400
311300,202103,576,364,212,401500,235400,636900
311310,202103,20,16,4,17600,4400,22000
311320,202103,646,479,167,526900,185900,712800
311330,202103,1064,777,287,855800,315700,1171500
311340,202103,2612,1841,771,2026200,851400,2877600
311350,202103,277,215,62,236500,68200,304700
311360,202103,180,104,76,114400,83600,198000
311370,202103,1228,501,727,551100,801900,1353000
311380,202103,5,4,1,4400,1100,5500
311390,202103,247,136,111,149600,122100,271700
311400,202103,134,81,53,89100,58300,147400
311410,202103,113,58,55,63800,60500,124300
311420,202103,298,162,136,179300,149600,328900
311430,202103,841,560,281,616000,309100,925100
311440,202103,458,322,136,355300,149600,504900
311450,202103,303,182,121,200200,133100,333300
311455,202103,276,189,87,209000,95700,304700
311460,202103,137,61,76,67100,83600,150700
311470,202103,25,13,12,14300,13200,27500
311480,202103,48,23,25,25300,27500,52800
311490,202103,12,8,4,8800,4400,13200
311500,202103,26,12,14,13200,15400,28600
311510,202103,651,447,204,491700,224400,716100
311520,202103,39,31,8,34100,8800,42900
311530,202103,1807,1314,493,1446500,542300,1988800
311535,202103,67,44,23,48400,25300,73700
311540,202103,32,28,4,30800,4400,35200
311545,202103,165,120,45,132000,49500,181500
311547,202103,42,33,9,36300,9900,46200
311550,202103,681,305,376,336600,413600,750200
311560,202103,42,27,15,29700,16500,46200
311570,202103,285,191,94,210100,104500,314600
311580,202103,359,212,147,233200,161700,394900
311590,202103,31,28,3,30800,3300,34100
311600,202103,103,83,20,91300,22000,113300
311610,202103,247,210,37,231000,40700,271700
311615,202103,102,81,21,89100,23100,112200
311620,202103,24,14,10,15400,11000,26400
311630,202103,88,75,13,82500,14300,96800
311640,202103,133,63,70,69300,77000,146300
311650,202103,120,82,38,90200,41800,132000
311660,202103,401,194,207,213400,227700,441100
311670,202103,141,93,48,102300,52800,155100
311680,202103,206,155,51,171600,56100,227700
311690,202103,16,12,4,13200,4400,17600
311700,202103,189,136,53,150700,58300,209000
311710,202103,188,126,62,138600,68200,206800
311720,202103,41,29,12,31900,13200,45100
311730,202103,571,391,180,430100,198000,628100
311740,202103,26,18,8,19800,8800,28600
311750,202103,722,485,237,534600.7,260700,795300.7
311760,202103,69,30,39,33000,42900,75900
311770,202103,378,187,191,206800,210100,416900
311780,202103,178,87,91,95700,100100,195800
311783,202103,91,82,9,90200,9900,100100
311787,202103,33,12,21,13200,24200,37400
311790,202103,259,110,149,121000,163900,284900
311800,202103,684,443,241,487300,265100,752400
311810,202103,50,40,10,45100,11000,56100
311820,202103,123,100,23,110000,25300,135300
311830,202103,1866,1136,730,1252900,804100,2057000
311840,202103,997,550,447,607200,492800,1100000
311850,202103,13,8,5,8800,5500,14300
311860,202103,9543,4082,5461,4494600,6021400,10516000
311870,202103,120,65,55,71500,60500,132000
311880,202103,923,668,255,735900,280500,1016400
311890,202103,201,96,105,105509,115500,221009
311900,202103,72,27,45,29700,49500,79200
311910,202103,1369,855,514,941600,566500,1508100
311920,202103,225,148,77,162800,84700,247500
311930,202103,889,500,389,550000,427900,977900
311940,202103,2535,1329,1206,1465200.71,1326600,2791800.71
311950,202103,60,41,19,45100,20900,66000
311960,202103,61,45,16,49500,17600,67100
311970,202103,25,15,10,16500,11000,27500
311980,202103,43,33,10,36300,11000,47300
311990,202103,38,29,9,31900,9900,41800
311995,202103,54,34,20,37400,22000,59400
312000,202103,25,16,9,17600,9900,27500
312010,202103,76,59,17,64900,18700,83600
312015,202103,71,54,17,59400,19800,79200
312020,202103,127,86,41,94600,45100,139700
312030,202103,60,44,16,48400,17600,66000
312040,202103,78,51,27,56100,29700,85800
312050,202103,202,113,89,124300,97900,222200
312060,202103,21,12,9,13200,9900,23100
312070,202103,77,49,28,53900,30800,84700
312080,202103,529,242,287,266200,315700,581900
312083,202103,55,36,19,39600,20900,60500
312087,202103,97,75,22,82500,24200,106700
312090,202103,3208,1929,1279,2125200,1411300,3536500
312100,202103,148,103,45,113047,49500,162547
312110,202103,115,65,50,71500,56100,127600
312120,202103,129,96,33,105600.63,37400,143000.63
312125,202103,87,51,36,56100,40700,96800
312130,202103,131,84,47,93500,51700,145200
312140,202103,136,105,31,116600,34100,150700
312150,202103,42,32,10,35200,11000,46200
312160,202103,1544,1015,529,1116599,584100,1700699
312170,202103,10,8,2,8800,2200,11000
312180,202103,109,67,42,73700,46200,119900
312190,202103,36,32,4,35200,4400,39600
312200,202103,748,638,110,702900,121000,823900
312210,202103,118,64,54,70400,59400,129800
312220,202103,131,101,30,111100,34100,145200
312230,202103,3638,1663,1975,1829300,2178000,4007300
312235,202103,153,103,50,113300,55000,168300
312240,202103,91,65,26,71500,28600,100100
312245,202103,190,128,62,140800,68200,209000
312247,202103,75,53,22,58300,24200,82500
312250,202103,164,78,86,85800,94600,180400
312260,202103,102,67,35,73700,38500,112200
312270,202103,130,78,52,85800,57200,143000
312280,202103,28,14,14,15400,15400,30800
312290,202103,143,99,44,108900,48400,157300
312300,202103,201,131,70,145200,77000,222200
312310,202103,63,55,8,60500,8800,69300
312320,202103,424,267,157,293700,172700,466400
312330,202103,88,77,11,84700,12100,96800
312340,202103,34,15,19,16500,20900,37400
312350,202103,16,9,7,9900,7700,17600
312352,202103,90,68,22,74800,24200,99000
312360,202103,570,242,328,266200,360800,627000
312370,202103,314,174,140,191400,154000,345400
312380,202103,136,90,46,99000,50600,149600
312385,202103,157,128,29,140800,33000,173800
312390,202103,294,184,110,202400,122100,324500
312400,202103,379,280,99,308000,108900,416900
312410,202103,1034,325,709,359700,783200,1142900
312420,202103,619,470,149,517000,163900,680900
312430,202103,866,633,233,697401.13,257400,954801.13
312440,202103,40,29,11,31900,12100,44000
312450,202103,203,131,72,144100,79200,223300
312460,202103,31,16,15,17600,16500,34100
312470,202103,42,28,14,30800,15400,46200
312480,202103,185,113,72,124300,79200,203500
312490,202103,275,190,85,209000,93500,302500
312500,202103,34,20,14,22000,15400,37400
312510,202103,522,197,325,216700,358600,575300
312520,202103,31,9,22,9900,24200,34100
312530,202103,46,31,15,34100,16500,50600
312540,202103,92,80,12,88000,13200,101200
312550,202103,37,29,8,31900,8800,40700
312560,202103,202,153,49,168300,55000,223300
312570,202103,432,257,175,282700,192500,475200
312580,202103,93,49,44,53900,48400,102300
312590,202103,241,193,48,212300,52800,265100
312595,202103,122,105,17,115500,18700,134200
312600,202103,68,37,31,40700,34100,74800
312610,202103,1598,824,774,909700,852500,1762200
312620,202103,219,158,61,173800,67100,240900
312630,202103,69,57,12,62700,13200,75900
312640,202103,42,11,31,12100,34100,46200
312650,202103,146,120,26,133470.7,28600,162070.7
312660,202103,93,64,29,70400.01,31900,102300.01
312670,202103,932,601,331,662200,365200,1027400
312675,202103,28,23,5,25300,5500,30800
312680,202103,72,43,29,47300,31900,79200
312690,202103,241,123,118,135300,129800,265100
312695,202103,27,23,4,25300,4400,29700
312700,202103,222,128,94,140800,103400,244200
312705,202103,81,63,18,69300,19800,89100
312707,202103,130,92,38,101200,41800,143000
312710,202103,1861,996,865,1097800.59,951500,2049300.59
312720,202103,54,30,24,33000,26400,59400
312730,202103,284,164,120,180400,133100,313500
312733,202103,45,36,9,39600,9900,49500
312735,202103,22,14,8,15400,8800,24200
312737,202103,65,34,31,37400,34100,71500
312738,202103,58,38,20,41800,22000,63800
312740,202103,83,54,29,59400,31900,91300
312750,202103,90,63,27,69300,29700,99000
312760,202103,293,211,82,232100,90200,322300
312770,202103,8206,3746,4460,4123900.08,4917000,9040900.08
312780,202103,438,335,103,368500,113300,481800
312790,202103,21,15,6,16500,6600,23100
312800,202103,1605,1128,477,1241900,524700,1766600
312810,202103,364,237,127,260700,139700,400400
312820,202103,183,140,43,154000,47300,201300
312825,202103,27,18,9,19800,9900,29700
312830,202103,220,128,92,140800,102300,243100
312840,202103,158,104,54,114400,59400,173800
312850,202103,42,36,6,40700,6600,47300
312860,202103,151,95,56,104500,61600,166100
312870,202103,1055,545,510,601700,563200,1164900
312880,202103,124,88,36,96800,39600,136400
312890,202103,157,110,47,121000,51700,172700
312900,202103,189,141,48,156200,52800,209000
312910,202103,171,90,81,99000,89100,188100
312920,202103,145,81,64,90200,70400,160600
312930,202103,327,229,98,253000,107800,360800
312940,202103,122,83,39,91300,42900,134200
312950,202103,691,469,222,518100,244200,762300
312960,202103,157,119,38,130900,41800,172700
312965,202103,87,69,18,75900,19800,95700
312970,202103,274,226,48,248600,52800,301400
312980,202103,2447,1216,1231,1342000,1356300,2698300
312990,202103,49,26,23,28600,25300,53900
313000,202103,55,29,26,31900,28600,60500
313005,202103,175,135,40,148500,44000,192500
313010,202103,908,356,552,393800,607200,1001000
313020,202103,203,104,99,114400,108900,223300
313030,202103,202,131,71,145200,78100,223300
313040,202103,77,25,52,27500,57200,84700
313050,202103,183,132,51,146300,56100,202400
313055,202103,39,29,10,31900,11000,42900
313060,202103,131,89,42,97900,46200,144100
313065,202103,63,45,18,49500,19800,69300
313070,202103,135,70,65,77000,71500,148500
313080,202103,39,17,22,18700,24200,42900
313090,202103,653,423,230,467500,254100,721600
313100,202103,189,63,126,69300,138600,207900
313110,202103,141,72,69,79200,75900,155100
313115,202103,213,119,94,130900,103400,234300
313120,202103,831,470,361,518100,397100,915200
313130,202103,5802,3134,2668,3454000,2939200,6393200
313140,202103,138,74,64,81400,70400,151800
313150,202103,301,238,63,262900,70400,333300
313160,202103,188,142,46,156200,51700,207900
313170,202103,1396,925,471,1021900,520300,1542200
313180,202103,297,174,123,191400,136400,327800
313190,202103,735,436,299,480700,330000,810700
313200,202103,26,21,5,23100,5500,28600
313210,202103,992,843,149,927300,163900,1091200
313220,202103,285,174,111,191400,122100,313500
313230,202103,260,200,60,220000.5,66000,286000.5
313240,202103,2162,1109,1053,1224300,1159400,2383700
313250,202103,1260,961,299,1058200,328900,1387100
313260,202103,93,48,45,52800,49500,102300
313270,202103,992,573,419,630300,460900,1091200
313280,202103,49,42,7,46200,7700,53900
313290,202103,211,170,41,188100,45100,233200
313300,202103,340,176,164,194700,181500,376200
313310,202103,257,119,138,130900,151800,282700
313320,202103,387,285,102,315700,112200,427900
313330,202103,1397,850,547,936100,601700,1537800
313340,202103,320,227,93,249700,104500,354200
313350,202103,485,320,165,354200,181500,535700
313360,202103,149,69,80,75900,88000,163900
313370,202103,219,68,151,75900,166100,242000
313375,202103,292,174,118,191400,129800,321200
313380,202103,1338,693,645,767800,710600,1478400
313390,202103,46,43,3,47300,3300,50600
313400,202103,394,268,126,294800,138600,433400
313410,202103,26,13,13,14300,14300,28600
313420,202103,4538,2428,2110,2673000,2325400,4998400
313430,202103,136,66,70,72600,79200,151800
313440,202103,1396,961,435,1059301.13,478500,1537801.13
313450,202103,68,29,39,31900,42900,74800
313460,202103,380,167,213,183700,234300,418000
313470,202103,528,247,281,271700,309100,580800
313480,202103,144,106,38,116600,41800,158400
313490,202103,511,233,278,259600,305800,565400
313500,202103,29,16,13,17600,14300,31900
313505,202103,1039,809,230,891000,253000,1144000
313507,202103,97,58,39,63800,42900,106700
313510,202103,2837,1786,1051,1965797.1,1159400,3125197.1
313520,202103,3446,2694,752,2966701.5,828300,3795001.5
313530,202103,32,21,11,23100,12100,35200
313535,202103,65,50,15,55000,16500,71500
313540,202103,69,51,18,56100,19800,75900
313545,202103,113,96,17,105600,18700,124300
313550,202103,225,190,35,209000,38500,247500
313560,202103,339,163,176,179300,194700,374000
313570,202103,65,21,44,23100,48400,71500
313580,202103,1307,726,581,799700,642400,1442100
313590,202103,70,39,31,42900,34100,77000
313600,202103,674,403,271,444400,299200,743600
313610,202103,57,45,12,49500,13200,62700
313620,202103,1393,693,700,763400,771100,1534500
313630,202103,1598,1210,388,1332100,426800,1758900
313640,202103,119,71,48,79200,52800,132000
313650,202103,231,107,124,117700,137500,255200
313652,202103,21,21,0,23100,0,23100
313655,202103,64,39,25,42900,27500,70400
313657,202103,44,40,4,44000,4400,48400
313660,202103,131,89,42,97900,47319.8,145219.8
313665,202103,640,288,352,316800,387200,704000
313670,202103,10229,6943,3286,7645000.41,3624500,11269500.41
313680,202103,45,35,10,39600,11000,50600
313690,202103,136,102,34,112200,38500,150700
313695,202103,67,50,17,55000,18700,73700
313700,202103,314,248,66,272800,72600,345400
313710,202103,138,100,38,110000,41800,151800
313720,202103,1114,510,604,562100,665500,1227600
313730,202103,72,42,30,46200,33000,79200
313740,202103,148,119,29,130900,31900,162800
313750,202103,420,299,121,330000,134200,464200
313753,202103,227,169,58,189200,63800,253000
313760,202103,1315,472,843,520300,929500,1449800
313770,202103,382,272,110,300300,121000,421300
313780,202103,786,410,376,452100,414700,866800
313790,202103,28,27,1,29700,1100,30800
313800,202103,141,85,56,93500,61600,155100
313810,202103,78,46,32,50600,35200,85800
313820,202103,1303,613,690,674300,760100,1434400
313830,202103,55,41,14,45100,15400,60500
313835,202103,57,48,9,52800,9900,62700
313840,202103,1651,980,671,1079100,740300,1819400
313850,202103,207,77,130,84700,143000,227700
313860,202103,468,358,110,394900,121000,515900
313862,202103,162,107,55,117700,60500,178200
313865,202103,125,92,33,102300,36300,138600
313867,202103,53,42,11,46200,12100,58300
313868,202103,37,22,15,24200,16500,40700
313870,202103,107,58,49,63800,53900,117700
313880,202103,372,229,143,254100,157300,411400
313890,202103,326,167,159,184800,174900,359700
313900,202103,855,459,396,506000.66,436700,942700.66
313910,202103,149,102,47,112200,52800,165000
313920,202103,629,438,191,481800,210100.94,691900.94
313925,202103,33,28,5,30800,5500,36300
313930,202103,864,676,188,743600,207900,951500
313940,202103,1851,1136,715,1249600,790900,2040500
313950,202103,864,541,323,596200,356400,952600
313960,202103,1417,812,605,894300,666600,1560900
313970,202103,177,111,66,122100,72600,194700
313980,202103,197,127,70,139700,77000,216700
313990,202103,238,156,82,171600,90200,261800
314000,202103,873,571,302,633600,332200,965800
314010,202103,80,45,35,49500,38500,88000
314015,202103,63,18,45,19800,49500,69300
314020,202103,54,32,22,36300,24200,60500
314030,202103,72,32,40,35200,44000,79200
314040,202103,51,28,23,30800,25300,56100
314050,202103,281,167,114,184800,125400,310200
314053,202103,100,63,37,69300,40700,110000
314055,202103,296,183,113,201300,124300,325600
314060,202103,132,116,16,127600.83,17600,145200.83
314070,202103,1027,521,506,575300,558800,1134100
314080,202103,207,129,78,143000,85800,228800
314085,202103,151,99,52,108900,57200,166100
314090,202103,377,267,110,293700.45,121000,414700.45
314100,202103,512,412,100,453200,110000,563200
314110,202103,786,378,408,421300,453200,874500
314120,202103,76,45,31,49500,34100,83600
314130,202103,23,13,10,14300,11000,25300
314140,202103,1101,676,425,744700,468600,1213300
314150,202103,188,121,67,133100,73700,206800
314160,202103,330,245,85,269500,93500,363000
314170,202103,86,65,21,71500,24200,95700
314180,202103,732,644,88,708400,96800,805200
314190,202103,92,55,37,60500,40700,101200
314200,202103,499,341,158,375100,173800,548900
314210,202103,245,186,59,204600,64900,269500
314220,202103,295,213,82,234300,90200,324500
314225,202103,60,43,17,47300,18700,66000
314230,202103,115,51,64,57200,71500,128700
314240,202103,145,107,38,117700,41800,159500
314250,202103,52,30,22,33000,24200,57200
314260,202103,211,104,107,114400,117700,232100
314270,202103,387,299,88,328900,96800,425700
314280,202103,715,382,333,421250.5,369600,790850.5
314290,202103,545,434,111,477400,122100,599500
314300,202103,347,255,92,281600,101200,382800
314310,202103,1357,931,426,1024375.5,471900,1496275.5
314315,202103,35,26,9,28600,9900,38500
314320,202103,580,388,192,426800,211200,638000
314330,202103,11191,5449,5742,6004900.82,6331636.66,12336537.48
314340,202103,594,266,328,292600,360800,653400
314345,202103,52,35,17,38500,18700,57200
314350,202103,176,109,67,119900,73700,193600
314360,202103,58,35,23,38500,25300,63800
314370,202103,68,46,22,50600,24200,74800
314380,202103,100,62,38,68200,41800,110000
314390,202103,3318,2124,1194,2340800,1317800,3658600
314400,202103,691,486,205,535700,225500,761200
314410,202103,484,313,171,345400,189200,534600
314420,202103,15,8,7,8800,7700,16500
314430,202103,2435,893,1542,982301.51,1696200,2678501.51
314435,202103,180,105,75,115500,83600,199100
314437,202103,29,22,7,24200,7700,31900
314440,202103,96,66,30,72600,33000,105600
314450,202103,165,115,50,126500,55000,181500
314460,202103,628,299,329,328900,363000,691900
314465,202103,95,59,36,64900,39600,104500
314467,202103,70,56,14,61600,15400,77000
314470,202103,398,196,202,215600,224400,440000
314480,202103,1025,474,551,522500,606100,1128600
314490,202103,46,29,17,31900,18700,50600
314500,202103,281,197,84,216700,92400,309100
314505,202103,109,68,41,74800,45100,119900
314510,202103,245,200,45,221100,49500,270600
314520,202103,1305,694,611,764500,673200,1437700
314530,202103,725,580,145,640200.7,159500,799700.7
314535,202103,161,96,65,105600,72600,178200
314537,202103,64,38,26,41800,28600,70400
314540,202103,15,9,6,9900,6600,16500
314545,202103,51,34,17,37400,18700,56100
314550,202103,77,40,37,44000,40700,84700
314560,202103,846,452,394,498300,433400,931700
314570,202103,22,17,5,18700,5500,24200
314580,202103,13,5,8,5500,8800,14300
314585,202103,25,16,9,18700,9900,28600
314587,202103,80,68,12,74800,13200,88000
314590,202103,549,388,161,427900,177100,605000
314600,202103,935,592,343,652300,377300,1029600
314610,202103,932,473,459,521400,506000,1027400
314620,202103,137,102,35,112200,38500,150700
314625,202103,97,71,26,78100,29700,107800
314630,202103,1156,614,542,675400,596200,1271600
314640,202103,81,53,28,58300,30800,89100
314650,202103,174,97,77,107800,84700,192500
314655,202103,60,44,16,48400,17600,66000
314660,202103,16,13,3,14300,3300,17600
314670,202103,196,150,46,165000,50600,215600
314675,202103,211,125,86,138600,94600,233200
314690,202103,589,312,277,343200,304700,647900
314700,202103,2265,1217,1048,1338700,1155000,2493700
314710,202103,1731,979,752,1080200,829400,1909600
314720,202103,391,225,166,248600,182600,431200
314730,202103,513,270,243,298100,269500,567600
314740,202103,733,347,386,381700,425700,807400
314750,202103,19,15,4,16500,4400,20900
314760,202103,353,156,197,171600,216700,388300
314770,202103,105,72,33,79200,36300,115500
314780,202103,22,8,14,8800,15400,24200
314790,202103,2416,1525,891,1679700,981200,2660900
314795,202103,49,41,8,45100,8800,53900
314800,202103,2922,1691,1231,1862300.76,1356300,3218600.76
314810,202103,1480,844,636,929500,699600,1629100
314820,202103,107,59,48,64900,52800,117700
314830,202103,211,171,40,188100,44000,232100
314840,202103,86,51,35,56100,38500,94600
314850,202103,394,190,204,209000,224400,433400
314860,202103,654,500,154,550000,169400,719400
314870,202103,1529,792,737,872300,810700,1683000
314875,202103,53,48,5,52800,5500,58300
314880,202103,45,31,14,34100,15400,49500
314890,202103,50,28,22,30800,24200,55000
314900,202103,30,24,6,26400,6600,33000
314910,202103,240,156,84,171600,92400,264000
314915,202103,138,123,15,135300,16500,151800
314920,202103,98,62,36,68200,40700,108900
314930,202103,1031,499,532,548900,586300,1135200
314940,202103,47,38,9,41800,9900,51700
314950,202103,31,21,10,23100,11000,34100
314960,202103,30,22,8,24200,8800,33000
314970,202103,150,74,76,82500,84700,167200
314980,202103,311,200,111,221100,122100,343200
314990,202103,434,236,198,259600,218900,478500
314995,202103,157,62,95,68200,104500,172700
315000,202103,77,58,19,63800,20900,84700
315010,202103,41,27,14,29700,15400,45100
315015,202103,166,129,37,141900,40700,182600
315020,202103,68,57,11,62700,12100,74800
315030,202103,108,83,25,91300,27500,118800
315040,202103,75,48,27,52800,29700,82500
315050,202103,188,111,77,122100,84700,206800
315053,202103,44,33,11,36300,12100,48400
315057,202103,102,79,23,86900,25300,112200
315060,202103,73,61,12,67100,13200,80300
315070,202103,106,61,45,67100,49500,116600
315080,202103,371,290,81,319000,89100,408100
315090,202103,93,54,39,59400,42900,102300
315100,202103,76,39,37,44000,40700,84700
315110,202103,270,144,126,158400,139700,298100
315120,202103,1754,848,906,933900,997700,1931600
315130,202103,338,244,94,268400,103400,371800
315140,202103,530,290,240,320100,264000,584100
315150,202103,981,468,513,515900,564300,1080200
315160,202103,211,104,107,114400,117700,232100
315170,202103,308,206,102,226600,113300,339900
315180,202103,3230,1331,1899,1465200,2095500,3560700
315190,202103,303,183,120,201300,132000,333300
315200,202103,1206,714,492,787600,542300,1329900
315210,202103,1621,923,698,1020800,770000,1790800
315213,202103,30,18,12,19800,13200,33000
315217,202103,200,155,45,170500,49500,220000
315220,202103,1586,1192,394,1312300,434500,1746800
315230,202103,169,122,47,134200,51700,185900
315240,202103,412,262,150,289300,165000,454300
315250,202103,2568,1236,1332,1365100,1470700,2835800
315260,202103,138,79,59,86900,66000,152900
315270,202103,133,89,44,99000,48400,147400
315280,202103,640,412,228,453200,251900,705100
315290,202103,191,119,72,130900,79200,210100
315300,202103,77,56,21,61600,23100,84700
315310,202103,75,66,9,72600,9900,82500
315320,202103,152,89,63,97900,70400,168300
315330,202103,56,46,10,50600,11000,61600
315340,202103,388,283,105,312400,115500,427900
315350,202103,153,93,60,102300,66000,168300
315360,202103,91,41,50,45100,55000,100100
315370,202103,55,35,20,38500,22000,60500
315380,202103,6,6,0,6600,0,6600
315390,202103,63,16,47,17600,51700,69300
315400,202103,813,606,207,666600,228800,895400
315410,202103,318,185,133,203500,146300,349800
315415,202103,58,44,14,48400,15400,63800
315420,202103,196,141,55,155100,60500,215600
315430,202103,654,374,280,411400,309100,720500
315440,202103,95,64,31,70400,34100,104500
315445,202103,230,192,38,211200,41800,253000
315450,202103,180,135,45,148500,49500,198000
315460,202103,4101,1942,2159,2140600,2378200,4518800
315470,202103,40,16,24,17600,26400,44000
315480,202103,70,20,50,22000,55000,77000
315490,202103,696,427,269,469700,295900,765600
315500,202103,16,13,3,14300,3300,17600
315510,202103,145,98,47,107800,51700,159500
315520,202103,72,62,10,68200,11000,79200
315530,202103,40,22,18,24200,19800,44000
315540,202103,253,175,78,192500,85800,278300
315550,202103,179,146,33,160600,36300,196900
315560,202103,738,587,151,645700,167200,812900
315570,202103,313,153,160,168300.63,176000,344300.63
315580,202103,715,485,230,533500,253000,786500
315590,202103,196,101,95,111100,104500,215600
315600,202103,311,238,73,261800,80300,342100
315610,202103,101,50,51,55000,56100,111100
315620,202103,36,28,8,30800,8800,39600
315630,202103,125,81,44,89100,48400,137500
315640,202103,71,43,28,47300,30800,78100
315645,202103,48,32,16,35200,17600,52800
315650,202103,173,125,48,137500,52800,190300
315660,202103,451,194,257,213400,282700,496100
315670,202103,2365,1111,1254,1223200,1380500,2603700
315680,202103,823,581,242,639100,266200,905300
315690,202103,670,464,206,510400.5,227700,738100.5
315700,202103,1922,1004,918,1105500.28,1009800,2115300.28
315710,202103,350,102,248,112200,273900,386100
315720,202103,463,282,181,311300,199100,510400
315725,202103,190,154,36,169400,39600,209000
315727,202103,50,24,26,26400.82,29700,56100.82
315730,202103,46,43,3,47300,3300,50600
315733,202103,89,60,29,66000,31900,97900
315737,202103,50,37,13,40700,14300,55000
315740,202103,31,25,6,27500,6600,34100
315750,202103,153,115,38,126500,41800,168300
315760,202103,39,29,10,31900,11000,42900
315765,202103,114,66,48,72600,52800,125400
315770,202103,213,131,82,144100,91300,235400
315780,202103,3545,1744,1801,1920600,1982200,3902800
315790,202103,232,181,51,200200,56100,256300
315800,202103,297,202,95,222200,104500,326700
315810,202103,95,58,37,63800,40700,104500
315820,202103,750,550,200,605000,220000,825000
315830,202103,120,77,43,85800,47300,133100
315840,202103,85,55,30,60500,33000,93500
315850,202103,259,184,75,202400,82500,284900
315860,202103,13,5,8,5500,8800,14300
315870,202103,40,30,10,33000,11000,44000
315880,202103,102,66,36,72600,39600,112200
315890,202103,91,67,24,73700,27500,101200
315895,202103,412,271,141,299200,155100,454300
315900,202103,67,32,35,35200,38500,73700
315910,202103,37,21,16,23100,17600,40700
315920,202103,161,106,55,116600,60500,177100
315930,202103,53,19,34,20900,37400,58300
315935,202103,129,103,26,113300,30800,144100
315940,202103,101,75,26,82500,29700,112200
315950,202103,37,29,8,31900,8800,40700
315960,202103,533,250,283,276100,311300,587400
315970,202103,33,26,7,28600,7700,36300
315980,202103,672,332,340,365200,374000,739200
315990,202103,255,148,107,162800,117700,280500
316000,202103,49,31,18,35200,19800,55000
316010,202103,78,64,14,70400,15400,85800
316020,202103,116,100,16,110000,17600,127600
316030,202103,375,206,169,226600,188100,414700
316040,202103,531,218,313,240900,344300,585200
316045,202103,51,45,6,49500,6600,56100
316050,202103,16,12,4,13200,4400,17600
316060,202103,94,64,30,70400,33000,103400
316070,202103,1074,691,383,763400,423500,1186900
316080,202103,91,62,29,68296.8,31900,100196.8
316090,202103,41,21,20,23100,22000,45100
316095,202103,92,75,17,82500,18700,101200
316100,202103,317,177,140,195800,155100,350900
316105,202103,40,24,16,26400,17600,44000
316110,202103,1875,1479,396,1630200.5,436700,2066900.5
316120,202103,77,54,23,59400,25300,84700
316130,202103,121,91,30,100100,34100,134200
316140,202103,30,18,12,19800,13200,33000
316150,202103,209,145,64,159500,71500,231000
316160,202103,84,47,37,52800,40700,93500
316165,202103,65,46,19,50600,20900,71500
316170,202103,181,119,62,130900,68200,199100
316180,202103,197,83,114,91300,125400,216700
316190,202103,131,92,39,101200,42900,144100
316200,202103,668,357,311,392700,344300,737000
316210,202103,771,513,258,565589.2,284900,850489.2
316220,202103,118,77,41,84700,45100,129800
316225,202103,30,17,13,18700,14300,33000
316230,202103,35,18,17,19800,18700,38500
316240,202103,657,523,134,575300,148500,723800
316245,202103,137,119,18,130900,19800,150700
316250,202103,1531,1034,497,1139600,546700,1686300
316255,202103,126,100,26,111100,28600,139700
316257,202103,175,90,85,100100,93500,193600
316260,202103,190,135,55,148500,61600,210100
316265,202103,28,20,8,22000,8800,30800
316270,202103,684,480,204,528000,224400,752400
316280,202103,549,340,209,375100.63,229900,605000.63
316290,202103,757,496,261,546700,287100,833800
316292,202103,529,211,318,232100,350900,583000
316294,202103,103,66,37,72600,40700,113300
316295,202103,309,131,178,144100,195800,339900
316300,202103,108,70,38,77000,41800,118800
316310,202103,27,14,13,15400,14300,29700
316320,202103,53,28,25,30800,27500,58300
316330,202103,165,112,53,123200,58300,181500
316340,202103,135,89,46,97900,50600,148500
316350,202103,191,135,56,149600,61600,211200
316360,202103,23,15,8,16500,8800,25300
316370,202103,1135,570,565,628100,621500,1249600
316380,202103,113,87,26,95700,28600,124300
316390,202103,112,79,33,86900,36300,123200
316400,202103,133,103,30,113300,33000,146300
316410,202103,305,220,85,242000,93500,335500
316420,202103,204,135,69,148500,78100,226600
316430,202103,151,78,73,85800,80300,166100
316440,202103,86,42,44,46200,48400,94600
316443,202103,37,35,2,38500,2200,40700
316447,202103,47,35,12,38500,13200,51700
316450,202103,221,170,51,187000,56100,243100
316460,202103,80,28,52,30800,57200,88000
316470,202103,1661,1213,448,1337589.65,493900,1831489.65
316480,202103,11,8,3,8800,3300,12100
316490,202103,20,6,14,6600,15400,22000
316500,202103,157,105,52,115500,57200,172700
316510,202103,149,112,37,123200,40700,163900
316520,202103,195,114,81,125400,89100,214500
316530,202103,164,108,56,118800.14,63800,182600.14
316540,202103,148,77,71,84700,78100,162800
316550,202103,140,88,52,96800,57200,154000
316553,202103,310,138,172,151800,190300.72,342100.72
316555,202103,48,40,8,44000,8800,52800
316556,202103,13,9,4,9900,4400,14300
316557,202103,23,19,4,20900,4400,25300
316560,202103,66,45,21,49500,23100,72600
316570,202103,214,194,20,213400,22000,235400
316580,202103,20,14,6,15400,6600,22000
316590,202103,101,84,17,92400,18700,111100
316600,202103,172,142,30,156200,33000,189200
316610,202103,63,48,15,52800,16500,69300
316620,202103,137,99,38,108900,41800,150700
316630,202103,40,30,10,33000,11000,44000
316640,202103,22,14,8,15400,8800,24200
316650,202103,77,62,15,68200,16500,84700
316660,202103,7,2,5,2200,5500,7700
316670,202103,440,152,288,167200,316800,484000
316680,202103,157,113,44,124300,48400,172700
316690,202103,178,111,67,123200,73700,196900
316695,202103,59,50,9,55000,9900,64900
316700,202103,18,12,6,13200,6600,19800
316710,202103,775,583,192,641300,211200,852500
316720,202103,5028,2432,2596,2682900,2857800,5540700
316730,202103,16,16,0,17600,0,17600
316740,202103,141,91,50,100100,55000,155100
316750,202103,17,11,6,12100,6600,18700
316760,202103,317,255,62,280500,68200,348700
316770,202103,164,88,76,96800,83600,180400
316780,202103,67,42,25,46200,27500,73700
316790,202103,55,39,16,42900,17600,60500
316800,202103,1764,1094,670,1205600,737000,1942600
316805,202103,23,17,6,18700,6600,25300
316810,202103,65,40,25,44000,27500,71500
316820,202103,38,19,19,20900,20900,41800
316830,202103,93,43,50,48400,55000,103400
316840,202103,509,296,213,325600,234300,559900
316850,202103,319,213,106,234300,116600,350900
316860,202103,5902,2604,3298,2868800,3635500,6504300
316870,202103,1547,988,559,1091200,619300,1710500
316880,202103,133,64,69,70400,75900,146300
316890,202103,237,163,74,180400,81400,261800
316900,202103,411,286,125,316800,137500,454300
316905,202103,20,10,10,11000,11000,22000
316910,202103,69,28,41,30800,45100,75900
316920,202103,139,108,31,118800,34100,152900
316930,202103,1887,952,935,1049400,1029600,2079000
316935,202103,902,536,366,591800,402600,994400
316940,202103,1085,612,473,673200,522500.24,1195700.24
316950,202103,179,88,91,96800,100100,196900
316960,202103,1100,615,485,676500.78,534600,1211100.78
316970,202103,648,515,133,566500,146300,712800
316980,202103,73,40,33,45100,37400,82500
316990,202103,2143,1421,722,1567500,794200.84,2361700.84
317000,202103,333,256,77,281600,84700,366300
317005,202103,233,161,72,177100,79200,256300
317010,202103,6383,3532,2851,3895100,3161400.5,7056500.5
317020,202103,15801,6926,8875,7634000,9792200,17426200
317030,202103,79,30,49,33000,53900,86900
317040,202103,3051,1919,1132,2116400,1249600,3366000
317043,202103,69,51,18,56100,19800,75900
317047,202103,36,18,18,19800,19800,39600
317050,202103,154,115,39,126500,42900,169400
317052,202103,140,108,32,118800,35200,154000
317057,202103,167,128,39,140800,42900,183700
317060,202103,60,38,22,41800,24200,66000
317065,202103,49,38,11,41800,12100,53900
317070,202103,1931,888,1043,979000,1151700,2130700
317075,202103,101,55,46,60500,50600,111100
317080,202103,906,462,444,508200,489500,997700
317090,202103,689,539,150,592900,165000,757900
317100,202103,414,311,103,344300,115500,459800
317103,202103,111,88,23,96800,25300,122100
317107,202103,45,39,6,42900,6600,49500
317110,202103,113,52,61,57200,67100,124300
317115,202103,40,36,4,39600,4400,44000
317120,202103,1931,918,1013,1010900,1114300,2125200
317130,202103,1977,1315,662,1448700,728200,2176900
317140,202103,9,8,1,8800,1100,9900
317150,202103,270,160,110,176000,122100,298100
317160,202103,321,241,80,265100.63,88000,353100.63
317170,202103,223,151,72,166100,79200,245300
317180,202103,446,301,145,331100,159500,490600
317190,202103,269,192,77,211200,84700,295900
317200,202103,820,566,254,622600,280500,903100
317210,202103,181,99,82,108900,90200,199100
317220,202103,24,13,11,14300,12100,26400
320010,202103,585,422,163,465300,180400,645700
320013,202103,120,84,36,93500,40700,134200
320016,202103,265,171,94,189200,103400,292600
320020,202103,727,423,304,465300.5,334400,799700.5
320030,202103,159,111,48,123200.08,52800.08,176000.16
320035,202103,136,98,38,107800,41800,149600
320040,202103,503,257,246,282700,270600,553300
320050,202103,108,77,31,84700,34100,118800
320060,202103,1709,819,890,902000,982300,1884300
320070,202103,99,62,37,68200,40700,108900
320080,202103,802,463,339,509300,372900,882200
320090,202103,1252,830,422,915200,465300,1380500
320100,202103,331,192,139,211200,152900,364100
320110,202103,118,75,43,82500,47300,129800
320115,202103,112,92,20,101200,22000,123200
320120,202103,3564,1874,1690,2061400.93,1862300.74,3923701.67
320130,202103,7526,3382,4144,3725700.5,4560600,8286300.5
320140,202103,433,282,151,310200,166100.81,476300.81
320150,202103,2052,1143,909,1258400,1001000,2259400
320160,202103,654,291,363,321200,402600,723800
320170,202103,107,84,23,92400.1,25300.02,117700.12
320180,202103,54,32,22,35200,24200,59400
320190,202103,236,152,84,167200,93500,260700
320200,202103,58,43,15,47300,16500,63800
320210,202103,897,486,411,534600,452100,986700
320220,202103,293,104,189,114400,207900,322300
320225,202103,85,66,19,72600,20900,93500
320230,202103,628,396,232,436700,255200,691900
320240,202103,3368,1605,1763,1767700,1940400,3708100
320245,202103,478,325,153,357500,168300,525800
320250,202103,227,115,112,126500,123200,249700
320255,202103,131,103,28,113300,30800,144100
320260,202103,219,136,83,149600.2,91300.12,240900.32
320265,202103,150,113,37,124300,40700,165000
320270,202103,149,116,33,127600,36300,163900
320280,202103,1143,653,490,718300.5,539000.02,1257300.52
320290,202103,56,48,8,53900,8800,62700
320300,202103,591,405,186,445500.02,205700,651200.02
320305,202103,679,355,324,390500,357500,748000
320310,202103,200,114,86,125400,94600,220000
320313,202103,340,161,179,177100,196900,374000
320316,202103,109,82,27,90200,29700,119900
320320,202103,3406,1502,1904,1656600,2094400,3751000
320330,202103,262,197,65,216700,71500,288200
320332,202103,762,453,309,499400,339900,839300
320334,202103,249,140,109,155100.02,119900,275000.02
320335,202103,144,96,48,105600,52800,158400
320340,202103,564,391,173,430100,190300,620400
320350,202103,1020,422,598,464200.5,657800,1122000.5
320360,202103,161,82,79,90200,86900,177100
320370,202103,240,177,63,194700,69300,264000
320380,202103,286,197,89,216700,97900,314600
320390,202103,1144,679,465,749100,512600,1261700
320400,202103,322,231,91,254100,100100,354200
320405,202103,971,391,580,430100,639100,1069200
320410,202103,959,486,473,534600,520300,1054900
320420,202103,519,247,272,271700,299200,570900
320425,202103,190,101,89,111100,97900,209000
320430,202103,394,208,186,232100,204600,436700
320435,202103,157,104,53,114400,58300,172700
320440,202103,201,117,84,128700.26,92400.2,221100.46
320450,202103,127,71,56,78100,61600,139700
320455,202103,249,199,50,220000,55000,275000
320460,202103,284,170,114,187000,125400,312400
320465,202103,113,75,38,82500,41800,124300
320470,202103,701,426,275,468600,302500,771100
320480,202103,194,124,70,136400,77000,213400
320490,202103,3043,1479,1564,1629101.23,1721501.3,3350602.53
320495,202103,112,67,45,73700,49500,123200
320500,202103,9570,4651,4919,5124900.29,5421900,10546800.29
320501,202103,542,272,270,299200,297000,596200
320503,202103,291,204,87,226600.1,96800.02,323400.12
320506,202103,261,181,80,199100,88000,287100
320510,202103,1075,481,594,530200,654500,1184700
320515,202103,81,61,20,67100,22000,89100
320517,202103,215,153,62,168300,68200,236500
320520,202103,7030,2978,4052,3281300,4463800,7745100
320530,202103,6360,3122,3238,3437481.5,3565100,7002581.5
330010,202103,3082,1523,1559,1680800,1717100,3397900
330015,202103,175,69,106,75900,116600,192500
330020,202103,3738,1522,2216,1678600,2440900,4119500
330022,202103,251,128,123,140800,135300,276100
330023,202103,661,209,452,229900,497200,727100
330025,202103,578,110,468,121000,514800,635800
330030,202103,1860,1152,708,1267200,779900,2047100
330040,202103,2435,1216,1219,1339800,1342000.5,2681800.5
330045,202103,9259,2756,6503,3034900.5,7164300,10199200.5
330050,202103,872,551,321,607200,353100,960300
330060,202103,1032,604,428,664400,470800,1135200
330070,202103,3865,1347,2518,1482800,2776400,4259200
330080,202103,1580,680,900,748000,990000,1738000
330090,202103,394,226,168,248600,184800,433400
330093,202103,260,113,147,124300,161700,286000
330095,202103,76,45,31,49500,34100,83600
330100,202103,9928,4909,5019,5403200.5,5533000,10936200.5
330110,202103,467,195,272,214500,299200,513700
330115,202103,510,270,240,297000,264000,561000
330120,202103,383,189,194,207900,214500,422400
330130,202103,1565,386,1179,424600,1299100,1723700
330140,202103,615,320,295,352000,327800,679800
330150,202103,511,288,223,316800,245300,562100
330160,202103,205,122,83,134200,91300,225500
330170,202103,27044,8973,18071,9885700,19919900.81,29805600.81
330180,202103,239,138,101,152900,111100,264000
330185,202103,973,346,627,380600,689700,1070300
330187,202103,414,121,293,134200,322300,456500
330190,202103,5876,2181,3695,2402400,4073300,6475700
330200,202103,4678,1399,3279,1538900.86,3615700,5154600.86
330205,202103,441,251,190,277200,209000,486200
330210,202103,938,572,366,630300,402600,1032900
330220,202103,2684,1568,1116,1729200,1227600,2956800
330225,202103,566,283,283,312400,311300,623700
330227,202103,2414,719,1695,790900,1865600,2656500
330230,202103,260,145,115,160600,126500,287100
330240,202103,3878,1908,1970,2101000,2169200,4270200
330245,202103,149,64,85,70400,93500,163900
330250,202103,6643,3290,3353,3627800,3696000,7323800
330260,202103,617,156,461,171600,507100,678700
330270,202103,3665,1193,2472,1312300,2720300,4032600
330280,202103,444,284,160,312400,176000,488400
330285,202103,6896,2111,4785,2326500,5273400,7599900
330290,202103,675,240,435,264000,478500,742500
330300,202103,773,499,274,549575.4,301400,850975.4
330310,202103,438,241,197,266200,216700,482900
330320,202103,7963,2846,5117,3135000.29,5637598.63,8772598.92
330330,202103,9146,3352,5794,3694900.02,6386600,10081500.02
330340,202103,2659,1532,1127,1686300,1243000,2929300
330350,202103,18621,6886,11735,7583400,12925000.73,20508400.73
330360,202103,2178,1030,1148,1134100,1263900,2398000
330370,202103,1009,498,511,548900,563200,1112100
330380,202103,909,373,536,410300,590700.01,1001000.01
330385,202103,627,319,308,350900,339900,690800
330390,202103,5681,2914,2767,3207600,3050300,6257900
330395,202103,316,182,134,200200,147400,347600
330400,202103,700,364,336,401500,371800,773300
330410,202103,496,358,138,396000,151800,547800
330411,202103,258,136,122,149600,134200,283800
330412,202103,226,88,138,96800,151800,248600
330414,202103,5322,2102,3220,2316600,3549700,5866300
330415,202103,612,262,350,288200,386100,674300
330420,202103,2230,1110,1120,1221000,1233100,2454100
330430,202103,1776,788,988,866800,1087900,1954700
330440,202103,299,135,164,148500,180400,328900
330450,202103,119,50,69,55000,75900,130900
330452,202103,2141,924,1217,1016400,1340900,2357300
330455,202103,114391,38910,75481,42857195.36,83163509.76,126020705.12
330460,202103,250,109,141,119900,156200,276100
330470,202103,1219,659,560,727100,618200,1345300
330475,202103,1583,416,1167,457600,1283700,1741300
330480,202103,820,443,377,487300,414700,902000
330490,202103,14925,4651,10274,5125005,11331100.12,16456105.12
330500,202103,1413,596,817,655600,899800,1555400
330510,202103,10859,3692,7167,4063400,7901300,11964700
330513,202103,96,49,47,53900,52800,106700
330515,202103,770,316,454,347600,501600,849200
330520,202103,2520,869,1651,957000,1819400,2776400
330530,202103,199,112,87,123200,95700,218900
330540,202103,354,175,179,192500,196900,389400
330550,202103,2907,979,1928,1079100,2124100,3203200
330555,202103,813,316,497,348700,547800,896500
330560,202103,694,226,468,248600,515900,764500
330570,202103,274,192,82,211200,90200,301400
330575,202103,804,280,524,308000,577500,885500
330580,202103,3368,1850,1518,2035000.5,1673100,3708100.5
330590,202103,278,144,134,158400.5,147400,305800.5
330600,202103,1191,731,460,805200,507100,1312300
330610,202103,1564,836,728,919967.31,804100,1724067.31
330615,202103,216,169,47,185900,51700,237600
330620,202103,1079,400,679,441100,748000,1189100
330630,202103,4106,2491,1615,2744501.19,1780900,4525401.19
350010,202103,572,378,194,419100.88,213400,632500.88
350020,202103,57,22,35,24200,38500,62700
350030,202103,514,319,195,352000,214500,566500
350040,202103,125,52,73,57200,80300,137500
350050,202103,322,168,154,184800,169400,354200
350055,202103,107,51,56,56100,61600,117700
350060,202103,83,28,55,30800,60500,91300
350070,202103,772,450,322,495000.2,354200,849200.2
350075,202103,72,47,25,51700,27500,79200
350080,202103,56,27,29,29700,31900,61600
350090,202103,78,44,34,48400,37400,85800
350100,202103,280,171,109,188100,119900,308000
350110,202103,58,42,16,46200,17600,63800
350115,202103,148,91,57,100100,62700,162800
350120,202103,107,67,40,73700,44000,117700
350130,202103,366,160,206,176000.56,227700,403700.56
350140,202103,40,25,15,27500,17600,45100
350150,202103,78,58,20,63800,22000,85800
350160,202103,2401,946,1455,1042800,1606000,2648800
350170,202103,384,221,163,243100,180400,423500
350180,202103,163,93,70,102300,77000,179300
350190,202103,993,524,469,578600.63,517000,1095600.63
350200,202103,69,25,44,27500,48400,75900
350210,202103,1295,707,588,778800.23,646800.63,1425600.86
350220,202103,646,532,114,588500.63,125400,713900.63
350230,202103,73,48,25,52800,27500,80300
350240,202103,60,42,18,46200,19800,66000
350250,202103,1153,541,612,597300,674300,1271600
350260,202103,93,66,27,72600,29700,102300
350270,202103,883,591,292,651200,322300,973500
350275,202103,286,116,170,127600,187000,314600
350280,202103,4502,2260,2242,2488200,2469500,4957700
350290,202103,448,197,251,216700,277200,493900
350300,202103,56,29,27,31900,29700,61600
350310,202103,79,51,28,56100,30800,86900
350315,202103,63,28,35,30800,38500,69300
350320,202103,3289,1587,1702,1747900,1881000,3628900
350330,202103,1649,866,783,952601.26,863500,1816101.26
350335,202103,18,12,6,13200,6600,19800
350340,202103,125,55,70,60500,77000,137500
350350,202103,92,47,45,51700,49500,101200
350360,202103,109,71,38,79200,41800,121000
350370,202103,80,44,36,48400.63,39600,88000.63
350380,202103,776,329,447,361900,496100,858000
350390,202103,1629,602,1027,662200.5,1133000,1795200.5
350395,202103,22,18,4,19800,4400,24200
350400,202103,1679,834,845,917401.89,935000.63,1852402.52
350410,202103,2753,1160,1593,1277100,1758920.63,3036020.63
350420,202103,253,152,101,168300,111100,279400
350430,202103,73,41,32,45100,35200,80300
350440,202103,155,111,44,122100,48400,170500
350450,202103,1684,967,717,1064801.13,792000,1856801.13
350460,202103,402,136,266,150700,293700,444400
350470,202103,19,10,9,11000,9900,20900
350480,202103,174,95,79,105600,86900,192500
350490,202103,234,110,124,121000,136400,257400
350500,202103,54,23,31,25300,34100,59400
350510,202103,167,104,63,114400,69300,183700
350520,202103,434,228,206,251900,226600,478500
350530,202103,436,200,236,220000,260700,480700
350535,202103,81,62,19,68200,20900,89100
350540,202103,372,191,181,210100,199100,409200
350550,202103,2640,1513,1127,1667600.77,1243001.26,2910602.03
350560,202103,591,406,185,446600,204600,651200
350570,202103,4184,1714,2470,1889800.63,2723601.27,4613401.90
350580,202103,363,176,187,193600,205700,399300
350590,202103,923,496,427,546700,469700,1016400
350600,202103,6060,2870,3190,3165800,3514500,6680300
350610,202103,1488,765,723,844800.63,797500,1642300.63
350620,202103,28,17,11,18700,12100,30800
350630,202103,248,139,109,152900.63,119900.63,272801.26
350635,202103,983,388,595,427900,656700,1084600
350640,202103,118,89,29,97900,31900,129800
350650,202103,1849,1236,613,1359600,677600,2037200
350660,202103,744,307,437,337700,482900,820600
350670,202103,305,151,154,166100,170500,336600
350680,202103,172,89,83,97900,92400,190300
350690,202103,192,88,104,97900,114400,212300
350700,202103,812,391,421,430100,463100,893200
350710,202103,376,138,238,152900,261800,414700
350715,202103,55,43,12,47300,13200,60500
350720,202103,18,12,6,13200,6600,19800
350730,202103,45,28,17,30800,18700,49500
350740,202103,215,122,93,135300,102300,237600
350745,202103,25,10,15,11000,16500,27500
350750,202103,2225,1347,878,1486100,968000,2454100
350760,202103,3713,1547,2166,1702800,2387000,4089800
350770,202103,58,41,17,45100,18700,63800
350775,202103,43,30,13,33000,14300,47300
350780,202103,429,215,214,236500,235400,471900
350790,202103,365,153,212,168300,233200,401500
350800,202103,482,284,198,313500,217800,531300
350810,202103,518,412,106,453200,116600,569800
350820,202103,91,52,39,58300,42900,101200
350830,202103,74,38,36,41800,39600,81400
350840,202103,760,298,462,327800,509300,837100
350850,202103,1728,930,798,1024100,878900,1903000
350860,202103,603,331,272,365200,300300,665500
350870,202103,440,288,152,316800,167200,484000
350880,202103,283,157,126,172700,139700,312400
350890,202103,39,24,15,26400,16500,42900
350900,202103,1481,456,1025,501600,1129700.63,1631300.63
350910,202103,27,15,12,16500,13200,29700
350920,202103,700,363,337,399300,370700,770000
350925,202103,1169,620,549,684200,607200.63,1291400.63
350930,202103,101,60,41,66000,45100,111100
350940,202103,730,399,331,440000,365200,805200
350945,202103,112,81,31,89100,34100,123200
350950,202103,16432,7542,8890,8306100.63,9805400,18111500.63
350960,202103,1428,608,820,672100,902000,1574100
350970,202103,1070,551,519,607081.2,572000,1179081.2
350980,202103,95,63,32,69300,35200,104500
350990,202103,374,134,240,148500,266200,414700
350995,202103,38,18,20,19800,22000,41800
351000,202103,626,421,205,464200.63,226600,690800.63
351010,202103,55,34,21,37400,23100,60500
351015,202103,48,32,16,35200,17600,52800
351020,202103,1550,931,619,1027400,682000,1709400
351030,202103,336,208,128,228800,141900,370700
351040,202103,889,441,448,487300,493900.2,981200.2
351050,202103,3312,1476,1836,1628000,2022900,3650900
351060,202103,5338,2002,3336,2205500,3671800,5877300
351070,202103,399,254,145,280500.63,160600,441100.63
351080,202103,710,515,195,567600,214500,782100
351090,202103,52,23,29,25300,31900,57200
351100,202103,429,234,195,257400,215600,473000
351110,202103,2001,939,1062,1034001.13,1169300,2203301.13
351120,202103,63,33,30,36300,33000,69300
351130,202103,183,59,124,64900,137500,202400
351140,202103,313,201,112,224400,123200,347600
351150,202103,431,220,211,242000,232100,474100
351160,202103,280,177,103,194700.4,114400,309100.4
351170,202103,187,97,90,106700,99000,205700
351190,202103,88,62,26,68200,28600,96800
351200,202103,364,233,131,256300,144100,400400
351210,202103,112,52,60,57200,66000,123200
351220,202103,526,313,213,344301.18,234300,578601.18
351230,202103,263,182,81,200200,89100,289300
351240,202103,246,115,131,126500,144100,270600
351250,202103,80,54,26,59400.5,28600,88000.5
351260,202103,155,113,42,125400,46200,171600
351270,202103,45,18,27,19800,29700,49500
351280,202103,1007,459,548,504900.63,603900.63,1108801.26
351290,202103,243,107,136,117700,149600,267300
351300,202103,3722,1626,2096,1789613.6,2308900,4098513.6
351310,202103,741,364,377,400400,414700,815100
351320,202103,112,65,47,71500,51700,123200
351330,202103,37,25,12,27500,13200,40700
351340,202103,1252,726,526,799700,578600,1378300
351350,202103,2330,1334,996,1470700.04,1098900,2569600.04
351360,202103,783,373,410,411400,451000,862400
351370,202103,376,190,186,209000,205700,414700
351380,202103,8861,3913,4948,4309800,5456000.63,9765800.63
351385,202103,28,18,10,19800,11000,30800
351390,202103,280,212,68,234300,74800,309100
351400,202103,63,39,24,42900,27500,70400
351410,202103,422,258,164,286000.55,180400,466400.55
351420,202103,69,49,20,53900,22000,75900
351430,202103,71,39,32,42900,35200,78100
351440,202103,765,525,240,579701.26,265100,844801.26
351450,202103,262,126,136,139700,149600,289300
351460,202103,127,55,72,60500,80300,140800
351470,202103,143,79,64,86900,70400,157300
351480,202103,480,279,201,308000.63,221100,529100.63
351490,202103,284,104,180,115500,198000,313500
351492,202103,25,17,8,18700,8800,27500
351495,202103,28,19,9,20900,9900,30800
351500,202103,3497,1440,2057,1586200,2268200,3854400
351510,202103,1948,735,1213,809600,1337600,2147200
351512,202103,16,12,4,13200,4400,17600
351515,202103,182,106,76,116600,83600,200200
351518,202103,708,444,264,489500,291500,781000
351519,202103,77,44,33,48400,36300,84700
351520,202103,152,88,64,96800,70419.8,167219.8
351530,202103,26,15,11,16500,12100,28600
351535,202103,130,80,50,88000,55000,143000
351540,202103,457,318,139,350900,152900,503800
351550,202103,1421,827,594,909701.83,654500,1564201.83
351560,202103,76,45,31,49500,35200,84700
351565,202103,12,8,4,8800,4400,13200
351570,202103,2677,1278,1399,1406900,1540000,2946900
351580,202103,38,33,5,36300,5500,41800
351590,202103,57,37,20,40700,22000,62700
351600,202103,189,133,56,146300,61600,207900
351610,202103,49,22,27,24200,29700,53900
351620,202103,5784,3178,2606,3504600.82,2866600,6371200.82
351630,202103,2871,1395,1476,1536700,1625800,3162500
351640,202103,2037,899,1138,988900.55,1257300.63,2246201.18
351650,202103,30,25,5,27500,5500,33000
351660,202103,129,82,47,91300,51700,143000
351670,202103,712,440,272,485100,300300,785400
351680,202103,64,53,11,58300,12100,70400
351685,202103,10,8,2,8800,2200,11000
351690,202103,292,195,97,216700.5,106700,323400.5
351700,202103,168,113,55,124300,60500,184800
351710,202103,68,43,25,47300,27500,74800
351720,202103,125,70,55,78100,60500,138600
351730,202103,107,68,39,74800,44000,118800
351740,202103,725,456,269,502700.74,295900,798600.74
351750,202103,348,139,209,152900,229900,382800
351760,202103,743,569,174,627000,193600,820600
351770,202103,306,253,53,279400.63,58300,337700.63
351780,202103,162,94,68,105600,74800,180400
351790,202103,248,129,119,141900,130900,272800
351800,202103,41,26,15,28600,16500,45100
351810,202103,116,77,39,84700,42900,127600
351820,202103,793,570,223,628100,246400,874500
351830,202103,552,187,365,205700,401500,607200
351840,202103,1942,917,1025,1014200,1130800,2145000
351850,202103,235,167,68,183700,74800,258500
351860,202103,636,441,195,485100,215600,700700
351870,202103,5526,2540,2986,2798402.14,3293401.46,6091803.60
351880,202103,19659,7785,11874,8574500.63,13086700.27,21661200.90
351885,202103,83,51,32,56100,35200,91300
351890,202103,68,54,14,59400,15400,74800
351900,202103,228,131,97,144100,106700,250800
351905,202103,87,34,53,37400,58300,95700
351907,202103,3459,1402,2057,1545500,2271500,3817000
351910,202103,173,71,102,78100,112200,190300
351920,202103,110,58,52,63800,57200,121000
351925,202103,89,57,32,62700,35200,97900
351930,202103,381,244,137,269500,151800,421300
351940,202103,232,96,136,106700,149600,256300
351950,202103,137,72,65,79200,72600,151800
351960,202103,918,454,464,499744.93,510400,1010144.93
351970,202103,1953,996,957,1098900,1053800,2152700
351980,202103,155,69,86,75900,94600,170500
351990,202103,254,162,92,178200,101200,279400
352000,202103,323,205,118,227700,129800,357500
352010,202103,400,245,155,269571,170500,440071
352020,202103,181,71,110,78100,123200,201300
352030,202103,1095,550,545,605000,602800,1207800
352040,202103,575,239,336,262900,369600,632500
352042,202103,279,71,208,79200,228800,308000
352044,202103,349,211,138,233200,151800,385000
352050,202103,3185,1192,1993,1312300.63,2198900,3511200.63
352060,202103,102,62,40,68200,44000,112200
352070,202103,90,67,23,73701.26,25300,99001.26
352080,202103,61,40,21,44000,23100,67100
352090,202103,155,102,53,112200,59400,171600
352100,202103,286,137,149,150700,163900,314600
352110,202103,115,36,79,39600,86900,126500
352115,202103,62,21,41,23100,45100,68200
352120,202103,78,53,25,58300.63,27500,85800.63
352130,202103,216,176,40,193600,44000,237600
352140,202103,181,85,96,93500,105600,199100
352150,202103,118,63,55,69300,60500,129800
352160,202103,137,86,51,94600,56100,150700
352170,202103,383,259,124,284900,136400,421300
352180,202103,639,395,244,435600.63,269500,705100.63
352190,202103,242,100,142,110000,156200,266200
352200,202103,30,14,16,15400,17600,33000
352210,202103,4168,1670,2498,1840300.95,2750000,4590300.95
352215,202103,65,38,27,41800,29700,71500
352220,202103,6586,2436,4150,2686200,4571600.63,7257800.63
352230,202103,3322,2134,1188,2349601.13,1309000.42,3658601.55
352240,202103,2510,1441,1069,1587300.63,1179200,2766500.63
352250,202103,2817,1321,1496,1456401.26,1647800,3104201.26
352260,202103,979,515,464,568700,510400,1079100
352265,202103,59,32,27,35200,29700,64900
352270,202103,388,220,168,242000,185900,427900
352280,202103,476,284,192,312401.26,211200,523601.26
352290,202103,179,103,76,113300,83600,196900
352300,202103,96,65,31,71500,34100,105600
352310,202103,6485,2825,3660,3110800.99,4034800,7145600.99
352320,202103,1065,545,520,601700,572000,1173700
352330,202103,520,255,265,280500,293700,574200
352340,202103,1349,606,743,667700,818400,1486100
352350,202103,339,196,143,215600,157300,372900
352360,202103,215,94,121,104500,133100,237600
352370,202103,105,67,38,73700,41800,115500
352380,202103,110,75,35,82500,38500,121000
352390,202103,2511,1088,1423,1200100,1567500,2767600
352400,202103,500,220,280,242000,309100,551100
352410,202103,861,586,275,644600.63,302500,947100.63
352420,202103,92,65,27,71500,29700,101200
352430,202103,1736,779,957,858001.89,1052701.26,1910703.15
352440,202103,3208,1560,1648,1719300,1817200.84,3536500.84
352450,202103,199,160,39,176000,42900,218900
352460,202103,625,314,311,345400,343200,688600
352470,202103,652,225,427,248600,473000,721600
352480,202103,1426,777,649,854700,713900,1568600
352490,202103,67,23,44,25300,48400,73700
352500,202103,1239,522,717,575300,792000,1367300
352510,202103,701,373,328,410300.63,361900,772200.63
352520,202103,733,322,411,354347.4,454300,808647.4
352530,202103,1736,897,839,992200,924000,1916200
352540,202103,71,46,25,50600,27500,78100
352550,202103,191,113,78,125400,85850.6,211250.6
352560,202103,47,38,9,42900,11000,53900
352570,202103,685,332,353,365200.63,388300,753500.63
352580,202103,60,45,15,49500,16500,66000
352585,202103,20,6,14,6600,15400,22000
352590,202103,4303,2116,2187,2330900.63,2406800,4737700.63
352600,202103,348,247,101,271700,111100,382800
352610,202103,916,419,497,460900.5,548900,1009800.5
352620,202103,1028,394,634,433400,698500,1131900
352630,202103,183,67,116,73700,127600,201300
352640,202103,511,335,176,369600,193600,563200
352650,202103,81,61,20,67100,22000,89100
352660,202103,62,37,25,40700,27500,68200
352670,202103,1671,875,796,962500.6,876700,1839200.6
352680,202103,904,563,341,621500,375100,996600
352690,202103,4493,1999,2494,2203302.07,2748900.63,4952202.70
352700,202103,95,55,40,60500,44000,104500
352710,202103,1403,729,674,801900,743600,1545500
352720,202103,1409,637,772,700700,849200,1549900
352725,202103,20,16,4,17600,4400,22000
352730,202103,374,182,192,200200,211200,411400
352740,202103,407,264,143,290400,157300.8,447700.8
352750,202103,19,13,6,14300,6600,20900
352760,202103,188,117,71,129800,78100,207900
352770,202103,85,64,21,70400,23100,93500
352780,202103,78,41,37,45100,40700,85800
352790,202103,25,19,6,22000,6600,28600
352800,202103,230,172,58,189200,63800,253000
352810,202103,154,97,57,106700,63800,170500
352820,202103,50,39,11,42900,12100,55000
352830,202103,74,50,24,55000,26400,81400
352840,202103,650,312,338,344300,371800,716100
352850,202103,1596,506,1090,558800,1201200,1760000
352860,202103,113,74,39,81400,42900,124300
352870,202103,47,30,17,33000,18700,51700
352880,202103,182,115,67,126500,73700,200200
352885,202103,33,21,12,23100,13200,36300
352890,202103,55,36,19,39600,20900,60500
352900,202103,4658,2222,2436,2448600,2685100,5133700
352910,202103,38,31,7,34100,7700,41800
352920,202103,651,386,265,424600,293700,718300
352930,202103,1217,578,639,636900,704000,1340900
352940,202103,6047,2431,3616,2678500,3984200,6662700
352950,202103,112,39,73,42900,81400,124300
352960,202103,60,36,24,39600,26400,66000
352965,202103,19,10,9,11000,9900,20900
352970,202103,510,386,124,427900.35,136400,564300.35
352980,202103,159,86,73,94600,80300,174900
352990,202103,976,453,523,499400,575300,1074700
353000,202103,57,25,32,27500,35200,62700
353010,202103,537,328,209,361900,229900,591800
353020,202103,306,223,83,246400,91300,337700
353030,202103,1255,564,691,621500,760100,1381600
353040,202103,89,51,38,56100,41800,97900
353050,202103,1294,834,460,918500.9,506000,1424500.9
353060,202103,8411,3565,4846,3925901.6,5341600,9267501.6
353070,202103,1779,1064,715,1173701.26,788504.2,1962205.46
353080,202103,1258,672,586,739200.92,647900,1387100.92
353090,202103,62,32,30,35200,33000,68200
353100,202103,46,36,10,39600,11000,50600
353110,202103,2083,650,1433,715000,1578500,2293500
353120,202103,102,52,50,57200,55000,112200
353130,202103,853,414,439,455401.29,484000,939401.29
353140,202103,543,219,324,240900.63,356400,597300.63
353150,202103,325,181,144,199100.63,158400,357500.63
353160,202103,96,74,22,81400,24200,105600
353170,202103,214,68,146,74800,160600,235400
353180,202103,1103,494,609,543400,673200,1216600
353190,202103,480,350,130,386100,146300,532400
353200,202103,220,104,116,114400,127600,242000
353205,202103,19,13,6,14300,7700,22000
353210,202103,70,40,30,44000,33000,77000
353215,202103,41,23,18,25300,19800,45100
353220,202103,78,42,36,46200,40700,86900
353230,202103,158,62,96,68200,105600,173800
353240,202103,327,162,165,179300,182600,361900
353250,202103,207,100,107,110000,117700,227700
353260,202103,451,302,149,332200,163900,496100
353270,202103,74,54,20,59400,22000,81400
353280,202103,99,49,50,53900,55000,108900
353282,202103,128,89,39,99000,42900,141900
353284,202103,26,19,7,20900,7700,28600
353286,202103,2,0,2,0,2200,2200
353290,202103,79,44,35,48400,39600,88000
353300,202103,435,225,210,247501.26,231000,478501.26
353310,202103,48,40,8,44000,8800,52800
353320,202103,34,20,14,22000,16500,38500
353325,202103,48,28,20,30800,22000,52800
353330,202103,61,43,18,47300,19800,67100
353340,202103,639,229,410,253000,452100,705100
353350,202103,887,425,462,467500,509300,976800
353360,202103,102,82,20,90200,22000,112200
353370,202103,109,64,45,70400,49500,119900
353380,202103,28,14,14,15400,15400,30800
353390,202103,1099,516,583,568700,642400,1211100
353400,202103,41,23,18,25300,20900,46200
353410,202103,112,65,47,71500,51700,123200
353420,202103,58,22,36,24200,39600,63800
353430,202103,563,373,190,411401.13,209000,620401.13
353440,202103,11320,4852,6468,5351500.63,7133500,12485000.63
353450,202103,56,29,27,31900,29700,61600
353460,202103,606,320,286,352000,314600,666600
353470,202103,2162,1107,1055,1218800.6,1166000,2384800.6
353475,202103,246,164,82,180400,90200,270600
353480,202103,182,148,34,162800,37400,200200
353490,202103,235,137,98,150700,107800,258500
353500,202103,206,119,87,130900,95700,226600
353510,202103,92,64,28,70400,30800,101200
353520,202103,213,153,60,168300,66000,234300
353530,202103,457,240,217,264000,239800,503800
353540,202103,382,246,136,271700,149600,421300
353550,202103,708,457,251,502700.93,276100,778800.93
353560,202103,573,231,342,254100,377300,631400
353570,202103,64,37,27,40700,29700,70400
353580,202103,347,249,98,276100,108900,385000
353590,202103,79,59,20,64900,22000,86900
353600,202103,269,156,113,172700.63,124300,297000.63
353610,202103,129,68,61,74800,67100,141900
353620,202103,628,323,305,355300,336600,691900
353625,202103,52,25,27,27500,29700,57200
353630,202103,226,162,64,178200,70400,248600
353640,202103,121,79,42,86900,46200,133100
353650,202103,943,352,591,387200,651200,1038400
353657,202103,24,18,6,19800,6600,26400
353660,202103,272,144,128,159500,141900,301400
353670,202103,753,444,309,488400.63,341000,829400.63
353680,202103,112,81,31,90200,34100,124300
353690,202103,40,30,10,33000,11000,44000
353700,202103,272,190,82,209000,90200,299200
353710,202103,479,226,253,249700,278300,528000
353715,202103,50,32,18,35200,19800,55000
353720,202103,346,154,192,170500,212300,382800
353730,202103,1110,674,436,742500,479600,1222100
353740,202103,604,330,274,363000,303600,666600
353750,202103,75,44,31,48400,34100,82500
353760,202103,3027,1138,1889,1254000,2082300.9,3336300.9
353770,202103,81,64,17,70400,18700,89100
353780,202103,1254,587,667,645700.63,734800,1380500.63
353790,202103,493,304,189,334400,207900,542300
353800,202103,3456,1653,1803,1819420,1988874,3808294
353810,202103,231,123,108,135300,118800,254100
353820,202103,213,94,119,103400,130900,234300
353830,202103,52,45,7,49500,7700,57200
353850,202103,175,86,89,94600,97900,192500
353860,202103,506,219,287,243100,315700,558800
353870,202103,5359,2669,2690,2943600.22,2964500,5908100.22
353880,202103,692,468,224,514800,246400,761200
353890,202103,540,318,222,349800,246400.59,596200.59
353900,202103,132,69,63,75900,69300,145200
353910,202103,178,79,99,86900,110000,196900
353920,202103,418,229,189,251900,207900,459800
353930,202103,1024,602,422,663300,467500,1130800
353940,202103,191,96,95,105600,104500,210100
353950,202103,502,311,191,343200,211200,554400
353960,202103,79,64,15,70400,16500,86900
353970,202103,43,28,15,30800,16500,47300
353980,202103,1706,764,942,840400,1036200,1876600
353990,202103,72,43,29,47300,31900,79200
354000,202103,381,177,204,194700,224400,419100
354010,202103,90,52,38,57200,41800,99000
354020,202103,497,308,189,338800,209000,547800
354025,202103,35,31,4,34100,4400,38500
354030,202103,46,26,20,28600,22000,50600
354040,202103,97,73,24,80300,26400,106700
354050,202103,172,95,77,104500.63,84700,189200.63
354060,202103,741,358,383,393800,421300,815100
354070,202103,907,509,398,559900,440000,999900
354075,202103,180,83,97,91300,106700,198000
354080,202103,310,132,178,145200,195800,341000
354085,202103,19,13,6,14300,6600,20900
354090,202103,285,167,118,183607,129800,313407
354100,202103,5546,2239,3307,2466200.4,3641000,6107200.4
354105,202103,96,45,51,49500,56100,105600
354110,202103,45,22,23,24200,25300,49500
354120,202103,143,98,45,107800.93,49500,157300.93
354130,202103,707,440,267,484000,293700,777700
354140,202103,3175,1456,1719,1603800.55,1896400,3500200.55
354150,202103,629,371,258,408100.66,284900,693000.66
354160,202103,642,402,240,442200,264000,706200
354165,202103,18,14,4,15400,4400,19800
354170,202103,175,123,52,135300,57200,192500
354180,202103,58,35,23,38500.42,25300,63800.42
354190,202103,189,77,112,84700,123200,207900
354200,202103,107,56,51,62700,56100,118800
354210,202103,63,25,38,27500,41800,69300
354220,202103,634,402,232,442200.63,256300,698500.63
354230,202103,172,73,99,80300,108900,189200
354240,202103,334,213,121,235400.82,133100,368500.82
354250,202103,82,51,31,56100,34100,90200
354260,202103,2104,996,1108,1096700.5,1221000.85,2317701.35
354270,202103,87,64,23,70400,25300,95700
354280,202103,46,23,23,25300,25300,50600
354290,202103,140,98,42,107800,46200,154000
354300,202103,364,255,109,280500.63,119900,400400.63
354310,202103,87,67,20,74800,22000,96800
354320,202103,210,104,106,114400,116600,231000
354323,202103,10,9,1,9900,1100,11000
354325,202103,121,68,53,74800.83,58300,133100.83
354330,202103,2382,803,1579,884243,1739100,2623343
354340,202103,10217,4796,5421,5281968,5971900.56,11253868.56
354350,202103,142,90,52,99000,57200,156200
354360,202103,67,37,30,40700,33000,73700
354370,202103,237,123,114,135300,125400,260700
354380,202103,183,108,75,119900,82500,202400
354390,202103,2641,952,1689,1053800,1863400,2917200
354400,202103,295,165,130,181500,143000,324500
354410,202103,620,291,329,322300,363000,685300
354420,202103,265,171,94,188100,103400,291500
354425,202103,310,181,129,199151,141900,341051
354430,202103,181,102,79,113300,86900,200200
354440,202103,33,25,8,27500,8800,36300
354450,202103,50,33,17,36300,18700,55000
354460,202103,95,55,40,60500,44000,104500
354470,202103,31,17,14,18700,15400,34100
354480,202103,111,62,49,68200,53900,122100
354490,202103,137,85,52,94600,57200,151800
354500,202103,387,179,208,196900,229900,426800
354510,202103,91,62,29,68200,31900,100100
354515,202103,38,10,28,11000,30800,41800
354520,202103,1577,667,910,734643,1003200,1737843
354530,202103,781,389,392,430100,432300,862400
354540,202103,261,135,126,148500,138600,287100
354550,202103,35,22,13,24200,14300,38500
354560,202103,147,76,71,84700,79200,163900
354570,202103,136,91,45,100100,49500,149600
354580,202103,1799,845,954,930600,1054900,1985500
354600,202103,260,139,121,152900,133100,286000
354610,202103,71,60,11,66000,12100,78100
354620,202103,58,14,44,15400,48400,63800
354625,202103,14,9,5,9900,5500,15400
354630,202103,294,187,107,205700,117700,323400
354640,202103,795,498,297,550000.63,326700,876700.63
354650,202103,67,38,29,41800,31900,73700
354660,202103,780,576,204,635800.63,224400,860200.63
354670,202103,233,87,146,96800,160600,257400
354680,202103,1268,455,813,501600,895400,1397000
354690,202103,82,57,25,62700,27500,90200
354700,202103,73,52,21,57200,23100,80300
354710,202103,46,32,14,35200,15400,50600
354720,202103,19,19,0,20900,0,20900
354730,202103,1736,712,1024,786500,1127500,1914000
354740,202103,76,51,25,56100,27500,83600
354750,202103,420,243,177,267300,194700,462000
354760,202103,467,281,186,309100,204600,513700
354765,202103,9,4,5,4400,5500,9900
354770,202103,350,230,120,253000,132000,385000
354780,202103,8100,3138,4962,3455101.13,5470300.47,8925401.60
354790,202103,90,52,38,57200,41800,99000
354800,202103,446,241,205,265004.05,225500,490504.05
354805,202103,90,39,51,42900,56100,99000
354810,202103,108,63,45,69300,49500,118800
354820,202103,207,83,124,91300,136400,227700
354830,202103,44,23,21,25300,23100,48400
354840,202103,55,39,16,42900,17600,60500
354850,202103,4438,1940,2498,2137300.08,2755500.06,4892800.14
354860,202103,330,158,172,173800,189200,363000
354870,202103,11817,5205,6612,5743101.26,7289700,13032801.26
354880,202103,2683,988,1695,1089000.89,1868951.7,2957952.59
354890,202103,2860,1508,1352,1661002.32,1488300,3149302.32
354900,202103,63,43,20,47300,22000,69300
354910,202103,1252,636,616,701800,679800,1381600
354920,202103,41,33,8,36300,8800,45100
354925,202103,18,7,11,7700,12100,19800
354930,202103,36,32,4,35200.4,4400,39600.4
354940,202103,772,553,219,608300,242000,850300
354950,202103,200,126,74,138600,81400,220000
354960,202103,144,55,89,60500,97900,158400
354970,202103,984,660,324,727101.26,357500,1084601.26
354980,202103,8728,3082,5646,3395702.23,6222700.39,9618402.62
354990,202103,9427,4243,5184,4676100,5717800,10393900
354995,202103,538,168,370,184800,407000,591800
355000,202103,460,158,302,173800,332200,506000
355010,202103,590,359,231,394900,256300.63,651200.63
355020,202103,776,480,296,528000,325600,853600
355030,202103,206948,78216,128732,86171947.25,141876946.04,228048893.29
355040,202103,786,345,441,380600,485100,865700
355050,202103,154,90,64,99000,70400,169400
355060,202103,1626,802,824,882200,907500,1789700
355070,202103,1467,689,778,759000.08,855800.73,1614800.81
355080,202103,189,115,74,126500,81400,207900
355090,202103,281,162,119,178200,130900.57,309100.57
355100,202103,5003,2367,2636,2606890,2909500,5516390
355110,202103,241,159,82,174900,90200,265100
355120,202103,58,37,21,40700,23100,63800
355130,202103,49,28,21,30800,23100,53900
355140,202103,180,106,74,116600,81400,198000
355150,202103,662,383,279,422400,306900,729300
355160,202103,468,226,242,248600.63,267300,515900.63
355170,202103,2019,1046,973,1152800,1071400,2224200
355180,202103,679,279,400,306900,440000,746900
355190,202103,209,136,73,149600,80300,229900
355200,202103,107,59,48,64900,52800,117700
355210,202103,687,378,309,416900,343200,760100
355220,202103,7186,3621,3565,3985300,3935800,7921100
355230,202103,97,59,38,64900,41800,106700
355240,202103,4438,1825,2613,2011901.13,2884200,4896101.13
355250,202103,5861,2558,3303,2817121.06,3641000.63,6458121.69
355255,202103,51,28,23,30800,25300,56100
355260,202103,178,110,68,121000,74800,195800
355270,202103,168,109,59,121000,64900,185900
355280,202103,6458,2472,3986,2720300,4392300,7112600
355290,202103,73,60,13,66000,14300,80300
355300,202103,206,121,85,133100,93500,226600
355310,202103,110,58,52,63800,57200,121000
355320,202103,92,49,43,53900,47300,101200
355330,202103,277,157,120,172700,132000,304700
355340,202103,1450,496,954,546700.55,1049400,1596100.55
355350,202103,147,71,76,78100,85800,163900
355360,202103,169,111,58,122100,64900,187000
355365,202103,19,15,4,16500,4400,20900
355370,202103,1018,603,415,664400.63,459800,1124200.63
355380,202103,817,509,308,561000,338800,899800
355385,202103,76,51,25,56100,27500,83600
355390,202103,111,61,50,67100,55000,122100
355395,202103,190,103,87,113300.5,95700,209000.5
355400,202103,1719,1009,710,1110909,783200.63,1894109.63
355410,202103,4875,2276,2599,2511300,2868800,5380100
355420,202103,48,34,14,37400,15400,52800
355430,202103,394,245,149,269500,163900,433400
355440,202103,83,50,33,55000,36300,91300
355450,202103,437,215,222,236500,245300,481800
355460,202103,61,48,13,52800,14300,67100
355465,202103,46,27,19,29700,20900,50600
355470,202103,176,71,105,78100,115500,193600
355475,202103,13,9,4,9900,4400,14300
355480,202103,552,224,328,246400,361900,608300
355490,202103,111,78,33,86900,37400,124300
355495,202103,66,24,42,26400,46200,72600
355500,202103,1541,846,695,932800.48,768900,1701700.48
355510,202103,268,195,73,215600.63,80300,295900.63
355520,202103,31,23,8,25300,8800,34100
355530,202103,23,12,11,13200,12100,25300
355535,202103,72,31,41,35200,45100,80300
355540,202103,2508,972,1536,1071555.1,1690700.63,2762255.73
355550,202103,58,37,21,40700,23100,63800
355560,202103,248,117,131,128700,145200,273900
355570,202103,21,13,8,14300,8800,23100
355580,202103,244,173,71,190300,78100,268400
355590,202103,16,10,6,11000,6600,17600
355600,202103,268,136,132,149600,146300,295900
355610,202103,223,149,74,163900,82500,246400
355620,202103,1295,571,724,630300,801900,1432200
355630,202103,417,312,105,343200,116600.63,459800.63
355635,202103,111,51,60,56100,66000,122100
355640,202103,539,303,236,333300,259600,592900
355645,202103,852,331,521,364100,575300,939400
355650,202103,1924,802,1122,885500,1236400,2121900
355660,202103,238,127,111,139700,122100,261800
355670,202103,577,240,337,264000,370700,634700
355680,202103,203,109,94,121000,103400,224400
355690,202103,90,42,48,46200,52800,99000
355695,202103,22,13,9,14300,9900,24200
355700,202103,1133,580,553,639100,609400,1248500
355710,202103,2201,1188,1013,1314500,1115400,2429900
355715,202103,13,11,2,12100,2200,14300
355720,202103,228,138,90,151800,99000,250800
355730,202103,100,57,43,63800,47300,111100
410010,202103,130,106,24,116600,26400,143000
410020,202103,119,91,28,100100,30800,130900
410030,202103,168,92,76,101200,83600,184800
410040,202103,1217,601,616,661100,679800,1340900
410045,202103,38,30,8,33000,8800,41800
410050,202103,484,272,212,299200,233200,532400
410060,202103,277,202,75,222200,82500,304700
410070,202103,293,242,51,266200,56100,322300
410080,202103,175,103,72,113300,79200,192500
410090,202103,69,59,10,64900,11000,75900
410100,202103,289,200,89,220000,97900,317900
410105,202103,47,28,19,30800,20900,51700
410110,202103,334,197,137,216700,150700,367400
410115,202103,36,23,13,25300,14300,39600
410120,202103,424,202,222,222200,244200,466400
410130,202103,53,32,21,35200,23100,58300
410140,202103,3130,1449,1681,1599400.03,1853500.88,3452900.91
410150,202103,2667,1030,1637,1136300,1805100,2941400
410160,202103,502,304,198,337700,217800,555500
410165,202103,48,29,19,31900,20900,52800
410170,202103,178,114,64,125400,70400,195800
410180,202103,2239,1234,1005,1360700,1108800,2469500
410185,202103,26,21,5,23100,5500,28600
410190,202103,496,308,188,341000,206800,547800
410200,202103,930,662,268,729300,294800,1024100
410210,202103,614,309,305,341000,335500,676500
410220,202103,46,21,25,23100,27500,50600
410230,202103,151,70,81,77000,89100,166100
410240,202103,741,467,274,514800,301400,816200
410250,202103,374,264,110,290400,121000,411400
410260,202103,298,165,133,182600,146300,328900
410270,202103,32,23,9,25300,9900,35200
410275,202103,58,43,15,47300,16500,63800
410280,202103,321,183,138,201300,151800,353100
410290,202103,250,144,106,160600,116600,277200
410300,202103,78,55,23,61600,25300,86900
410302,202103,23,15,8,16500,8800,25300
410304,202103,34,23,11,25300,12100,37400
410305,202103,222,116,106,127600,116600,244200
410310,202103,213,125,88,137500,96800,234300
410315,202103,44,32,12,35200,14300,49500
410320,202103,144,97,47,106700,51700,158400
410322,202103,31,19,12,20900,13200,34100
410330,202103,182,123,59,136400,64900,201300
410335,202103,102,58,44,63800,48400,112200
410337,202103,45,34,11,37400,12100,49500
410340,202103,40,33,7,36300,7700,44000
410345,202103,204,116,88,127600,96800,224400
410347,202103,46,35,11,38500,12100,50600
410350,202103,247,143,104,158400,114400,272800
410360,202103,453,283,170,312400,187000,499400
410370,202103,2308,951,1357,1047200,1497100,2544300
410380,202103,208,127,81,139700,89100,228800
410390,202103,387,261,126,287100,138600,425700
410395,202103,35,21,14,23100,15400,38500
410400,202103,845,372,473,409200.5,520300,929500.5
410405,202103,88,64,24,70400,26400,96800
410410,202103,29,20,9,22000,9900,31900
410420,202103,1697,784,913,862302.1,1008700,1871002.1
410425,202103,184,73,111,80300,122100,202400
410430,202103,2320,1255,1065,1381600,1173700,2555300
410440,202103,377,276,101,304700,111100,415800
410442,202103,356,233,123,257400,135300,392700
410445,202103,426,306,120,336600,135300,471900
410450,202103,393,196,197,215600,216700,432300
410460,202103,534,268,266,294800,293700,588500
410465,202103,231,135,96,149600,105600,255200
410470,202103,244,145,99,159500,110000,269500
410480,202103,6251,2934,3317,3234000,3650900,6884900
410490,202103,1424,843,581,928400.33,641300,1569700.33
410500,202103,274,156,118,171600,130900,302500
410510,202103,171,124,47,136400,52800,189200
410520,202103,252,184,68,202400,74800,277200
410530,202103,304,100,204,110000,224400,334400
410540,202103,324,241,83,265100,91300,356400
410550,202103,1701,712,989,783200,1090100,1873300
410560,202103,150,105,45,116600,49500,166100
410570,202103,426,284,142,312400,157300,469700
410580,202103,3501,1479,2022,1631301.04,2231900,3863201.04
410590,202103,396,260,136,287081,149600,436681
410600,202103,192,165,27,181500,29700,211200
410610,202103,51,43,8,47300,8800,56100
410620,202103,259,170,89,187000.4,97900,284900.4
410630,202103,443,242,201,267300,221100,488400
410640,202103,1016,637,379,701800,416900,1118700
410645,202103,113,80,33,88000,36300,124300
410650,202103,362,229,133,253000,146300,399300
410655,202103,91,63,28,69300,30800,100100
410657,202103,30,11,19,12100,20900,33000
410660,202103,611,412,199,453200.5,218900,672100.5
410670,202103,75,61,14,67100,15400,82500
410680,202103,207,162,45,178200,49500,227700
410685,202103,23,15,8,16500,8800,25300
410690,202103,28512,11867,16645,13081200,18348000.74,31429200.74
410700,202103,323,238,85,261800,93500,355300
410710,202103,128,103,25,113300,27500,140800
410712,202103,39,27,12,29700,13200,42900
410715,202103,87,65,22,71500,24200,95700
410720,202103,683,380,303,418000.92,334400,752400.92
410725,202103,179,128,51,140800,56100,196900
410730,202103,97,46,51,50600,56100,106700
410740,202103,108,74,34,81400,37400,118800
410750,202103,273,179,94,196900,103400,300300
410752,202103,22,13,9,14300,9900,24200
410753,202103,57,23,34,25300,37400,62700
410754,202103,52,26,26,28600,28600,57200
410755,202103,85,51,34,56100,37400,93500
410760,202103,766,418,348,459800,383900,843700
410765,202103,1801,803,998,883300,1101100,1984400
410770,202103,114,84,30,92400,33000,125400
410773,202103,58,40,18,44000,19800,63800
410775,202103,183,138,45,151800,49500,201300
410780,202103,85,47,38,51700,41800,93500
410785,202103,54,41,13,45100,14300,59400
410790,202103,85,37,48,40700,52800,93500
410800,202103,285,178,107,195800,119900,315700
410810,202103,21,14,7,15400,7700,23100
410820,202103,171,121,50,134200,55000,189200
410830,202103,8662,3649,5013,4027173.73,5531900,9559073.73
410832,202103,105,71,34,78100,37400,115500
410840,202103,1475,786,689,864600.21,759000,1623600.21
410845,202103,47,29,18,31900,20900,52800
410850,202103,185,130,55,143000,60500,203500
410855,202103,62,53,9,58300,9900,68200
410860,202103,747,390,357,430100,393800,823900
410865,202103,100,72,28,79200,30800,110000
410870,202103,148,128,20,140800,22000,162800
410880,202103,1140,564,576,622600,636900,1259500
410890,202103,87,61,26,67100,28600,95700
410895,202103,71,54,17,59400,18700,78100
410900,202103,26,18,8,19800,8800,28600
410910,202103,20,14,6,15400,6600,22000
410920,202103,35,22,13,24200,14300,38500
410930,202103,537,329,208,361900,228800,590700
410940,202103,4402,2386,2016,2631200.6,2225300,4856500.6
410950,202103,106,76,30,83600,33000,116600
410960,202103,853,336,517,369600,570900,940500
410965,202103,66,45,21,49500,23100,72600
410970,202103,618,434,184,477400,202400,679800
410975,202103,128,78,50,85800.38,55000,140800.38
410980,202103,1627,719,908,790900,1001000,1791900
410990,202103,271,191,80,210100,88000,298100
411000,202103,65,39,26,42900,28600,71500
411005,202103,28,23,5,25300,5500,30800
411007,202103,250,142,108,156200,118800,275000
411010,202103,593,394,199,434500,220000,654500
411020,202103,282,186,96,204600,105600,310200
411030,202103,19,11,8,12100,8800,20900
411040,202103,52,36,16,39600,17600,57200
411050,202103,212,157,55,172700,60500,233200
411060,202103,513,343,170,378400,189200,567600
411065,202103,52,46,6,50600,6600,57200
411070,202103,1250,733,517,811800,568700,1380500
411080,202103,244,172,72,189200,79200,268400
411090,202103,98,76,22,83600,24200,107800
411095,202103,298,110,188,121000,206800,327800
411100,202103,118,94,24,103400,26400,129800
411110,202103,127,77,50,84700,55000,139700
411120,202103,216,142,74,156200,81400,237600
411125,202103,248,105,143,115500,157300,272800
411130,202103,126,106,20,117700,22000,139700
411140,202103,215,142,73,156200,80300,236500
411150,202103,1266,822,444,904200,489500.63,1393700.63
411155,202103,119,82,37,91300,40700,132000
411160,202103,25,10,15,11000,16500,27500
411170,202103,51,45,6,49500,6600,56100
411180,202103,973,634,339,699600,372900,1072500
411190,202103,338,189,149,207900,163900,371800
411200,202103,664,395,269,436700.63,299200,735900.63
411210,202103,679,356,323,391600,356400,748000
411220,202103,159,109,50,119900,55000,174900
411230,202103,40,32,8,35200,8800,44000
411240,202103,118,73,45,81400,49500,130900
411250,202103,430,311,119,342100,132000,474100
411260,202103,15,11,4,12100,4400,16500
411270,202103,272,141,131,155100,145200,300300
411275,202103,179,156,23,173800,25300,199100
411280,202103,205,146,59,160600.63,66000,226600.63
411290,202103,62,47,15,51700,16500,68200
411295,202103,130,103,27,113300,29700,143000
411300,202103,81,34,47,37400,51700,89100
411310,202103,90,68,22,74800,24200,99000
411320,202103,795,515,280,566500,310200,876700
411325,202103,58,40,18,44000,19800,63800
411330,202103,915,586,329,645700,363000.15,1008700.15
411340,202103,30,19,11,20900,12100,33000
411342,202103,56,41,15,45100,16500,61600
411345,202103,118,59,59,64900,66000,130900
411350,202103,491,369,122,405900,134200,540100
411360,202103,54,35,19,38500,20900,59400
411370,202103,14247,5674,8573,6250201.26,9444601.34,15694802.60
411373,202103,174,118,56,129800,61600,191400
411375,202103,80,63,17,70400,18700,89100
411380,202103,83,59,24,64900,27500,92400
411390,202103,130,77,53,84700,58300,143000
411400,202103,406,286,120,315700,132000,447700
411410,202103,465,220,245,242000,269500,511500
411420,202103,984,421,563,464200,620400,1084600
411430,202103,481,265,216,291500,237600,529100
411435,202103,31,18,13,19800,14300,34100
411440,202103,464,361,103,397100,113300,510400
411450,202103,421,353,68,389400,75900,465300
411460,202103,788,295,493,324500,543400.66,867900.66
411470,202103,92,65,27,71500,29700,101200
411480,202103,682,367,315,403700,347600,751300
411490,202103,292,184,108,203500,119900,323400
411500,202103,101,83,18,91300,19800,111100
411510,202103,214,171,43,190300,47300,237600
411520,202103,6016,2195,3821,2420000,4210800.7,6630800.7
411530,202103,125,85,40,93500,44000,137500
411535,202103,51,19,32,20900,35200,56100
411540,202103,360,244,116,268400,127600,396000
411545,202103,53,38,15,41800,16500,58300
411550,202103,82,62,20,68200,22000,90200
411560,202103,396,167,229,184800,251900,436700
411570,202103,883,307,576,337700,633600,971300
411573,202103,22,14,8,15400,8800,24200
411575,202103,299,183,116,201300,127600,328900
411580,202103,1259,448,811,493900,893200,1387100
411585,202103,71,34,37,37400,40700,78100
411590,202103,19,13,6,15400,6600,22000
411600,202103,23,10,13,11000,14300,25300
411605,202103,237,94,143,104500,157300,261800
411610,202103,215,137,78,150700,86900,237600
411620,202103,380,199,181,218900,199100,418000
411630,202103,54,36,18,39600,19800,59400
411640,202103,32,22,10,25300,11000,36300
411650,202103,12,7,5,7700,5500,13200
411660,202103,39,26,13,28600,14300,42900
411670,202103,240,172,68,189200,74800,264000
411680,202103,166,134,32,147400,35200,182600
411690,202103,599,313,286,344300,314600,658900
411695,202103,64,44,20,48400,22000,70400
411700,202103,143,113,30,124300,33000,157300
411705,202103,106,70,36,77000,39600,116600
411710,202103,286,191,95,210100,104500,314600
411720,202103,132,86,46,94600,50600,145200
411721,202103,71,59,12,64900,13200,78100
411722,202103,106,45,61,49500,67100,116600
411725,202103,156,115,41,127600,45100,172700
411727,202103,89,67,22,73700,24200,97900
411729,202103,41,32,9,35200,9900,45100
411730,202103,551,342,209,377300,229900,607200
411740,202103,35,20,15,22000,16500,38500
411745,202103,68,49,19,53900,20900,74800
411750,202103,838,363,475,402600,524700,927300
411760,202103,1176,865,311,953700,343200,1296900
411770,202103,451,298,153,328900,169400,498300
411780,202103,350,225,125,247500,137500,385000
411790,202103,541,302,239,333300.18,262900,596200.18
411800,202103,149,113,36,126500.65,39600,166100.65
411810,202103,178,132,46,145200,50600,195800
411820,202103,2282,971,1311,1069200,1442100,2511300
411830,202103,10,9,1,9900,1100,11000
411840,202103,2036,1224,812,1347500,897600,2245100
411845,202103,58,19,39,20900,42900,63800
411850,202103,1215,661,554,729300,610500,1339800
411860,202103,49,31,18,34100,19800,53900
411870,202103,69,43,26,48400,28600,77000
411880,202103,426,263,163,289300,179300,468600
411885,202103,101,64,37,70400,40700,111100
411890,202103,305,197,108,216700,119900,336600
411900,202103,89,65,24,71500,26400,97900
411910,202103,181,140,41,154000,45100,199100
411915,202103,2244,887,1357,975700,1492700,2468400
411920,202103,120,94,26,103400,28600,132000
411925,202103,12,6,6,6600,6600,13200
411930,202103,799,568,231,627070.4,255200,882270.4
411940,202103,581,379,202,418000,222200,640200
411950,202103,1064,495,569,546700.24,625900,1172600.24
411960,202103,1094,717,377,788700,415800,1204500
411965,202103,21,14,7,15400,7700,23100
411970,202103,93,79,14,86900,15400,102300
411980,202103,181,108,73,118800,81400,200200
411990,202103,5115,2844,2271,3130601.42,2505872,5636473.42
411995,202103,539,169,370,185900,408100,594000
412000,202103,319,201,118,221100,129800,350900
412010,202103,44,27,17,29700,18700,48400
412015,202103,40,30,10,33000,11000,44000
412020,202103,29,23,6,25300,6600,31900
412030,202103,46,43,3,47300,3300,50600
412033,202103,55,29,26,31900,28600,60500
412035,202103,74,46,28,50600,30800,81400
412040,202103,44,24,20,26400,22000,48400
412050,202103,208,152,56,168300,61600,229900
412060,202103,776,562,214,620400,235400,855800
412065,202103,50,30,20,33000,22000,55000
412070,202103,166,113,53,124300,58300,182600
412080,202103,305,148,157,162800,173800,336600
412085,202103,39,16,23,17600,25300,42900
412090,202103,817,513,304,564300,334400,898700
412100,202103,257,213,44,234300,48400,282700
412110,202103,70,54,16,59400,17600,77000
412120,202103,328,189,139,207900,152900,360800
412125,202103,77,48,29,52800,31900,84700
412130,202103,39,26,13,28600,14300,42900
412135,202103,28,15,13,16500,14300,30800
412140,202103,354,227,127,250800,140800,391600
412150,202103,248,165,83,181500,91300,272800
412160,202103,85,47,38,51700,41800,93500
412170,202103,701,478,223,525800,245300,771100
412175,202103,33,25,8,27500,8800,36300
412180,202103,187,143,44,157300,48400,205700
412190,202103,322,254,68,282700,74800,357500
412200,202103,185,119,66,130900,72600,203500
412210,202103,75,57,18,62700,19800,82500
412215,202103,239,166,73,182923.4,80300,263223.4
412217,202103,65,53,12,58300,13200,71500
412220,202103,821,567,254,624800,279400,904200
412230,202103,317,193,124,212300,136400,348700
412240,202103,1337,645,692,709500,763400,1472900
412250,202103,411,249,162,273900,179300,453200
412260,202103,109,75,34,82500,37400,119900
412265,202103,177,133,44,147400,48400,195800
412270,202103,88,58,30,63800,33000,96800
412280,202103,88,70,18,77000,19800,96800
412290,202103,92,64,28,70400,30800,101200
412300,202103,209,140,69,154000,77000,231000
412310,202103,52,42,10,46200,11000,57200
412320,202103,96,78,18,85800,19800,105600
412330,202103,185,152,33,167200,36300,203500
412340,202103,163,113,50,124300,55000,179300
412350,202103,631,299,332,330000,365200,695200
412360,202103,25,21,4,23100,4400,27500
412370,202103,161,139,22,152900,24200,177100
412380,202103,238,180,58,198000,64900,262900
412382,202103,58,33,25,36300,27500,63800
412385,202103,154,108,46,118800,50600,169400
412390,202103,287,217,70,238700,77000,315700
412395,202103,68,56,12,61600,13200,74800
412400,202103,95,64,31,70400,34100,104500
412402,202103,231,115,116,127600,128700,256300
412405,202103,892,304,588,336600,647900,984500
412410,202103,978,585,393,644600,432300,1076900
412420,202103,15,14,1,15400,1100,16500
412430,202103,21,18,3,19800,3300,23100
412440,202103,623,327,296,360800,325600,686400
412450,202103,77,67,10,74800,11000,85800
412460,202103,92,70,22,77000,24200,101200
412470,202103,217,172,45,189200,49500,238700
412480,202103,146,105,41,115500,45100,160600
412490,202103,156,137,19,150700,20900,171600
412500,202103,428,344,84,378400.44,92400,470800.44
412510,202103,170,139,31,152900,34100,187000
412520,202103,93,60,33,66000,36300,102300
412530,202103,107,55,52,60500,57200,117700
412535,202103,89,65,24,72600,26400,99000
412540,202103,83,39,44,42900,48400,91300
412545,202103,87,58,29,63800,31900,95700
412550,202103,3892,1580,2312,1738000.5,2543200.92,4281201.42
412555,202103,10,6,4,6600,4400,11000
412560,202103,622,428,194,470800,215600,686400
412570,202103,772,384,388,423500,427900,851400
412575,202103,94,66,28,73700,30800,104500
412580,202103,174,118,56,129800,62700,192500
412590,202103,35,30,5,33000,5500,38500
412600,202103,177,127,50,139700,55000,194700
412610,202103,36,15,21,16500,23100,39600
412620,202103,143,120,23,132000,25300,157300
412625,202103,2114,1076,1038,1188000.63,1144000,2332000.63
412627,202103,67,49,18,53900,19800,73700
412630,202103,388,254,134,280500,147400,427900
412635,202103,64,19,45,20900,49500,70400
412640,202103,103,72,31,79200,34100,113300
412650,202103,326,212,114,233200,125400,358600
412660,202103,466,273,193,301400,213400,514800
412665,202103,43,39,4,42900,4400,47300
412667,202103,305,205,100,225500,110000,335500
412670,202103,65,54,11,59400,12100,71500
412680,202103,304,232,72,256300,79200,335500
412690,202103,115,73,42,80300,46200,126500
412700,202103,166,111,55,122100,60500,182600
412710,202103,1344,786,558,864600,616000,1480600
412720,202103,233,140,93,154000,103400,257400
412730,202103,191,161,30,177100,33000,210100
412740,202103,425,216,209,237600,232100,469700
412750,202103,426,238,188,261800,206800,468600
412760,202103,296,147,149,161700,163900,325600
412770,202103,2117,1159,958,1279300.63,1057100,2336400.63
412780,202103,138,107,31,117700,34100,151800
412785,202103,301,145,156,159500,171600,331100
412788,202103,38,22,16,24200,17600,41800
412790,202103,120,97,23,106700,25300,132000
412795,202103,152,106,46,116600,50600,167200
412796,202103,308,197,111,216700,122100,338800
412800,202103,635,377,258,414700,283800,698500
412810,202103,2967,1578,1389,1736900,1529000,3265900
412820,202103,925,562,363,620400,400400,1020800
412830,202103,13,10,3,11000,3300,14300
412840,202103,236,165,71,181500,79200,260700
412850,202103,751,475,276,525800,303600,829400
412853,202103,172,85,87,93500,95700,189200
412855,202103,190,97,93,106700.26,102300,209000.26
412860,202103,95,62,33,68200,36300,104500
412862,202103,58,35,23,38500,25300,63800
412863,202103,8,5,3,5500,3300,8800
412865,202103,45,32,13,35200,14300,49500
412870,202103,104,61,43,67100,47300,114400
412880,202103,92,64,28,70400,30800,101200
420005,202103,41,37,4,40700,4400,45100
420010,202103,360,232,128,255200,140800,396000
420020,202103,77,65,12,71500,13200,84700
420030,202103,25,20,5,22000,5500,27500
420040,202103,99,77,22,84700,24200,108900
420050,202103,56,33,23,36300,25300,61600
420055,202103,19,19,0,20900,0,20900
420060,202103,29,21,8,23100,8800,31900
420070,202103,100,84,16,92400,17600,110000
420075,202103,11,11,0,12100,0,12100
420080,202103,41,36,5,40700,5500,46200
420090,202103,35,30,5,33000,5500,38500
420100,202103,148,124,24,136400,26400,162800
420110,202103,19,19,0,20900,0,20900
420120,202103,59,42,17,46200,18700,64900
420125,202103,78,59,19,64900,20900,85800
420127,202103,34,28,6,30800,6600,37400
420130,202103,446,261,185,287100,203500,490600
420140,202103,1309,722,587,797500,646800,1444300
420150,202103,46,36,10,39600,11000,50600
420160,202103,30,28,2,31900,2200,34100
420165,202103,16,11,5,12100,5500,17600
420170,202103,63,38,25,41800,27500,69300
420180,202103,22,18,4,19800,4400,24200
420190,202103,25,22,3,24200,3300,27500
420195,202103,127,61,66,67100,72600,139700
420200,202103,1252,547,705,602800,778800,1381600
420205,202103,91,49,42,53900,46200,100100
420207,202103,123,66,57,72600,62700,135300
420208,202103,21,16,5,17600,5500,23100
420209,202103,16,14,2,15400,3300,18700
420210,202103,521,243,278,267300,309100,576400
420213,202103,44,34,10,37400,11000,48400
420215,202103,28,24,4,26400,4400,30800
420220,202103,59,37,22,40700,24200,64900
420230,202103,845,487,358,536800,394900,931700
420240,202103,2178,1405,773,1547700.86,853600,2401300.86
420243,202103,41,32,9,35200,9900,45100
420245,202103,163,82,81,90200,89100,179300
420250,202103,62,41,21,45100,23100,68200
420253,202103,27,21,6,23100,6600,29700
420257,202103,10,8,2,8800,2200,11000
420260,202103,97,78,19,85800,20900,106700
420270,202103,28,23,5,25300,5500,30800
420280,202103,284,217,67,238700,73700,312400
420285,202103,20,13,7,14300,7700,22000
420287,202103,49,32,17,35200,18700,53900
420290,202103,953,648,305,715000,335500,1050500
420300,202103,1451,1146,305,1261700,335500,1597200
420310,202103,51,32,19,36300,20900,57200
420315,202103,35,28,7,30800,7700,38500
420320,202103,964,460,504,506000,556600,1062600
420325,202103,4,1,3,1100,3300,4400
420330,202103,126,80,46,88000,50600,138600
420340,202103,172,116,56,127600,61600,189200
420350,202103,257,180,77,199100,84700,283800
420360,202103,708,543,165,598400.88,182600,781000.88
420370,202103,128,74,54,81400,59400,140800
420380,202103,1195,825,370,907500,408100,1315600
420390,202103,240,167,73,185900,80300,266200
420395,202103,191,135,56,148500,61600,210100
420400,202103,246,189,57,209000.15,63800,272800.15
420410,202103,60,45,15,49500,16500,66000
420415,202103,34,28,6,30800,6600,37400
420417,202103,51,40,11,44000,12100,56100
420419,202103,12,12,0,13200,0,13200
420420,202103,2807,1729,1078,1905200.16,1194600,3099800.16
420425,202103,72,58,14,63800,15400,79200
420430,202103,1137,809,328,891000,360800,1251800
420435,202103,14,12,2,13200,2200,15400
420440,202103,104,73,31,80300,35200,115500
420445,202103,28,27,1,29700,1100,30800
420450,202103,76,36,40,40700,44000,84700
420455,202103,206,157,49,172700,53900,226600
420460,202103,2332,1491,841,1641200,928400,2569600
420470,202103,95,69,26,75900,28600,104500
420475,202103,8,8,0,8800,0,8800
420480,202103,861,644,217,712800,238700,951500
420490,202103,98,72,26,79200,28600,107800
420500,202103,452,235,217,258500.26,239800,498300.26
420510,202103,19,18,1,19800,1100,20900
420515,202103,28,17,11,18700,12100,30800
420517,202103,9,9,0,9900,0,9900
420519,202103,0,,,,,0.0
420520,202103,64,47,17,51700,18700,70400
420530,202103,159,104,55,114400,61600,176000
420535,202103,19,17,2,18700,2200,20900
420540,202103,5603,3380,2223,3722675,2447500,6170175
420543,202103,31,29,2,31900,2200,34100
420545,202103,207,147,60,161700,66000,227700
420550,202103,834,685,149,754600,165000,919600
420555,202103,28,18,10,19800,11000,30800
420560,202103,62,52,10,58300,11000,69300
420570,202103,173,97,76,106700,83600,190300
420580,202103,280,129,151,141900,166100,308000
420590,202103,492,329,163,364100,179300,543400
420600,202103,133,73,60,80300,66000,146300
420610,202103,40,36,4,39600,4400,44000
420620,202103,85,65,20,72600,22000,94600
420630,202103,147,96,51,105600,56100,161700
420640,202103,81,72,9,80300,9900,90200
420650,202103,257,124,133,136400,146300,282700
420660,202103,48,39,9,42900,9900,52800
420665,202103,36,25,11,27500,12100,39600
420670,202103,292,230,62,253000,68200,321200
420675,202103,13,11,2,12100,2200,14300
420680,202103,35,25,10,27500,11000,38500
420690,202103,174,136,38,149600,41800,191400
420700,202103,683,453,230,498300.7,254100,752400.7
420710,202103,145,77,68,85140,74800,159940
420720,202103,106,84,22,92400,24200,116600
420730,202103,621,376,245,414700,269500,684200
420740,202103,53,52,1,57200,1100,58300
420750,202103,482,324,158,357500,174900,532400
420757,202103,19,17,2,18700,2200,20900
420760,202103,38,30,8,33000,8800,41800
420765,202103,80,59,21,64900,23100,88000
420768,202103,49,42,7,46200,7700,53900
420770,202103,69,59,10,64900,11000,75900
420775,202103,40,36,4,39600,4400,44000
420780,202103,204,162,42,178200,46200,224400
420785,202103,21,13,8,14300,8800,23100
420790,202103,156,128,28,140800,30800,171600
420800,202103,62,46,16,50600,17600,68200
420810,202103,262,215,47,236500,51700,288200
420820,202103,2380,1330,1050,1467400,1161600.5,2629000.5
420830,202103,610,322,288,354200,319000,673200
420840,202103,149,104,45,115500,49500,165000
420845,202103,409,171,238,188100,262900,451000
420850,202103,258,190,68,209000.5,75900,284900.5
420860,202103,55,45,10,49500,11000,60500
420870,202103,132,92,40,101200,44000,145200
420880,202103,184,116,68,127600,74800,202400
420890,202103,952,464,488,513700,536800,1050500
420895,202103,8,8,0,8800,0,8800
420900,202103,407,320,87,352000,96800,448800
420910,202103,5798,3151,2647,3472701.3,2916100,6388801.3
420915,202103,60,56,4,61600,4400,66000
420917,202103,23,15,8,16500,8800,25300
420920,202103,22,15,7,16500,7700,24200
420930,202103,2816,1747,1069,1924929,1179200.18,3104129.18
420940,202103,586,432,154,476300,169400,645700
420945,202103,10,7,3,7700,3300,11000
420950,202103,51,44,7,48400,7700,56100
420960,202103,107,86,21,94600,23100,117700
420970,202103,282,226,56,248600,61600,310200
420980,202103,23,22,1,24200,1100,25300
420985,202103,56,50,6,55000,6600,61600
420990,202103,79,57,22,63800,24200,88000
421000,202103,45,26,19,28600,20900,49500
421003,202103,48,33,15,36300,16500,52800
421005,202103,7,4,3,4400,3300,7700
421010,202103,785,514,271,566500,298100,864600
421020,202103,25,19,6,20900,6600,27500
421030,202103,116,98,18,107800,19800,127600
421040,202103,74,55,19,60500,20900,81400
421050,202103,341,229,112,251900,123200,375100
421055,202103,21,16,5,17600,5500,23100
421060,202103,86,47,39,51700,42900,94600
421070,202103,49,41,8,45100,8800,53900
421080,202103,34,31,3,34100,3300,37400
421085,202103,22,18,4,19800,4400,24200
421090,202103,36,28,8,30800,8800,39600
421100,202103,125,91,34,100100,37400,137500
421105,202103,186,149,37,165000,40700,205700
421110,202103,112,86,26,94600,29700,124300
421120,202103,177,130,47,143000.92,51700,194700.92
421125,202103,18,12,6,13200,6600,19800
421130,202103,834,515,319,567600,352000,919600
421140,202103,30,21,9,23100,9900,33000
421145,202103,47,36,11,39600,12100,51700
421150,202103,98,71,27,78100,29700,107800
421160,202103,65,43,22,47300,24200,71500
421165,202103,16,13,3,14300,3300,17600
421170,202103,183,155,28,170632,30800,201432
421175,202103,159,107,52,117700,57200,174900
421180,202103,47,34,13,37400,14300,51700
421185,202103,16,12,4,13200,4400,17600
421187,202103,1,0,1,0,1100,1100
421189,202103,46,32,14,35200,15400,50600
421190,202103,1719,1067,652,1174800,719400,1894200
421200,202103,95,69,26,75900,28600,104500
421205,202103,26,17,9,18700,9900,28600
421210,202103,176,122,54,136400,59400,195800
421220,202103,263,199,64,220000,70400,290400
421223,202103,46,36,10,40700,11000,51700
421225,202103,70,44,26,48400,28600,77000
421227,202103,83,66,17,72600,18700,91300
421230,202103,58,43,15,47300,16500,63800
421240,202103,17,17,0,18700,0,18700
421250,202103,366,206,160,226600,176000,402600
421260,202103,22,18,4,19800,4400,24200
421265,202103,2,2,0,2200,0,2200
421270,202103,50,44,6,48400,6600,55000
421280,202103,345,181,164,199100,180400,379500
421290,202103,330,216,114,238700,125400,364100
421300,202103,24,20,4,22000,4400,26400
421310,202103,48,33,15,36300,16500,52800
421315,202103,32,18,14,19800,15400,35200
421320,202103,121,76,45,83600,49500,133100
421330,202103,103,74,29,81400,31900,113300
421335,202103,39,27,12,29700,13200,42900
421340,202103,241,154,87,169400,96800,266200
421350,202103,191,110,81,121000.39,89100,210100.39
421360,202103,660,469,191,515900,210100,726000
421370,202103,193,144,49,158400,53900,212300
421380,202103,129,100,29,110000,31900,141900
421390,202103,17,10,7,11000,7700,18700
421400,202103,116,99,17,108900,18700,127600
421410,202103,21,18,3,20900,3300,24200
421415,202103,18,17,1,18700,1100,19800
421420,202103,107,90,17,99000,18700,117700
421430,202103,19,14,5,15400,5500,20900
421440,202103,59,51,8,56100,8800,64900
421450,202103,90,74,16,81400,17600.51,99000.51
421460,202103,58,45,13,49500,14300,63800
421470,202103,70,42,28,46200,30800,77000
421480,202103,734,554,180,609400,199100,808500
421490,202103,24,23,1,25300,1100,26400
421500,202103,487,302,185,332200,204600,536800
421505,202103,23,17,6,18700,6600,25300
421507,202103,32,24,8,26400,8800,35200
421510,202103,70,46,24,50600,26400,77000
421520,202103,53,44,9,48400,9900,58300
421530,202103,50,42,8,46200,8800,55000
421535,202103,22,21,1,23100,1100,24200
421540,202103,52,41,11,45100,12100,57200
421545,202103,89,62,27,68200,29700,97900
421550,202103,279,201,78,221100,85800,306900
421555,202103,19,17,2,18700,2200,20900
421560,202103,8,7,1,7700,1100,8800
421565,202103,120,81,39,89100,42900,132000
421567,202103,30,24,6,26400,6600,33000
421568,202103,47,41,6,45100,6600,51700
421569,202103,12,12,0,13200,0,13200
421570,202103,204,135,69,148500,75900,224400
421575,202103,27,24,3,26400,3300,29700
421580,202103,718,427,291,469772,320100,789872
421590,202103,20,19,1,20900,1100,22000
421600,202103,149,96,53,105600,58300,163900
421605,202103,111,77,34,84700,37400,122100
421610,202103,178,134,44,148500,48400,196900
421620,202103,1019,591,428,650100,470800,1120900
421625,202103,20,17,3,18700,3300,22000
421630,202103,313,194,119,213400,132000,345400
421635,202103,20,10,10,11000,11000,22000
421640,202103,101,83,18,91300,19800,111100
421650,202103,293,170,123,187000,135300,322300
421660,202103,2293,1364,929,1502600,1029600,2532200
421670,202103,172,122,50,134200,55000,189200
421680,202103,184,165,19,181500,20900,202400
421690,202103,345,239,106,262900,117700,380600
421700,202103,53,36,17,39600,18700,58300
421710,202103,25,23,2,25300,2200,27500
421715,202103,5,4,1,4400,1100,5500
421720,202103,626,434,192,477400,211200,688600
421725,202103,20,8,12,8800,13200,22000
421730,202103,29,21,8,23100,8800,31900
421740,202103,96,32,64,36300,70400,106700
421750,202103,200,147,53,161700,58300,220000
421755,202103,21,19,2,20900,2200,23100
421760,202103,102,67,35,73700,38500,112200
421770,202103,680,425,255,467500,281600,749100
421775,202103,27,17,10,18700,11000,29700
421780,202103,189,147,42,161700,47300,209000
421790,202103,149,127,22,139700,24200,163900
421795,202103,17,14,3,15400,3300,18700
421800,202103,523,328,195,360800,215600,576400
421810,202103,67,52,15,57200,16500,73700
421820,202103,300,193,107,213400.22,117700,331100.22
421825,202103,148,124,24,136400,26400,162800
421830,202103,140,89,51,97900,56100,154000
421835,202103,7,3,4,3300,4400,7700
421840,202103,47,41,6,45100,6600,51700
421850,202103,80,67,13,73700,14300,88000
421860,202103,44,33,11,36300,12100,48400
421870,202103,1030,763,267,841500,293700,1135200
421875,202103,53,44,9,48400,9900,58300
421880,202103,167,119,48,130900,52800,183700
421885,202103,23,18,5,19800,5500,25300
421890,202103,137,95,42,104500,46200.5,150700.5
421895,202103,44,39,5,42900,5500,48400
421900,202103,150,117,33,129800,36300,166100
421910,202103,59,36,23,39600,25300,64900
421915,202103,28,23,5,26400,5500,31900
421917,202103,31,22,9,24200,9900,34100
421920,202103,37,33,4,36300,4400,40700
421930,202103,635,503,132,556600,145200,701800
421935,202103,52,45,7,49500,7700,57200
421940,202103,45,38,7,41800,7700,49500
421950,202103,870,583,287,643500,316800,960300
421960,202103,42,36,6,39600,6600,46200
421970,202103,328,211,117,234300,129800,364100
421985,202103,21,13,8,14300,8800,23100
422000,202103,0,,,,,0.0
430003,202103,197,55,142,60500,156200,216700
430005,202103,34,24,10,26400,11000,37400
430010,202103,267,195,72,215600,79200,294800
430020,202103,141,91,50,100100,55000,155100
430030,202103,122,100,22,110000,24200,134200
430040,202103,2890,1698,1192,1870000,1313400,3183400
430045,202103,66,55,11,60500,12100,72600
430047,202103,7,6,1,6600,1100,7700
430050,202103,80,65,15,71500,16500,88000
430055,202103,10,9,1,9900,1100,11000
430057,202103,5,4,1,4400,1100,5500
430060,202103,3707,2131,1576,2345200,1739100,4084300
430063,202103,52,46,6,50600,6600,57200
430064,202103,158,126,32,138600,35200,173800
430066,202103,5,2,3,2200,3300,5500
430070,202103,41,28,13,30800,14300,45100
430080,202103,68,44,24,48400,26400,74800
430085,202103,25,10,15,12100,16500,28600
430087,202103,23,17,6,18700,6600,25300
430090,202103,72,63,9,69300,9900,79200
430100,202103,127,85,42,93500,46200,139700
430105,202103,145,80,65,88000,72600,160600
430107,202103,18,12,6,13200,6600,19800
430110,202103,470,259,211,286000,232100,518100
430120,202103,160,147,13,161700,14300,176000
430130,202103,787,478,309,525800,342100,867900
430140,202103,122,113,9,124300,9900,134200
430150,202103,108,68,40,75900,44000,119900
430155,202103,32,27,5,29700,5500,35200
430160,202103,3584,2074,1510,2284700,1663200,3947900
430163,202103,370,158,212,173800,233200,407000
430165,202103,32,22,10,24200,11000,35200
430170,202103,86,72,14,79200,15400,94600
430175,202103,74,59,15,64900,16500,81400
430180,202103,111,91,20,100100,22000,122100
430185,202103,27,18,9,19800,9900,29700
430187,202103,55,28,27,30800,29700,60500
430190,202103,225,124,101,136400,112200,248600
430192,202103,13,11,2,12100,2200,14300
430195,202103,17,10,7,11000,7700,18700
430200,202103,160,137,23,150700,25300,176000
430205,202103,20,20,0,22000,0,22000
430210,202103,674,508,166,559900,182600,742500
430215,202103,11,10,1,11000,1100,12100
430220,202103,73,49,24,53900,26400,80300
430222,202103,14,6,8,6600,8800,15400
430223,202103,15,8,7,8800,7700,16500
430225,202103,2,1,1,1100,1100,2200
430230,202103,308,184,124,203500,136400,339900
430235,202103,54,41,13,45100,14300,59400
430237,202103,26,20,6,22000,6600,28600
430240,202103,107,74,33,81400,36300,117700
430245,202103,73,58,15,63800,16500,80300
430250,202103,182,105,77,115500,84700,200200
430258,202103,8,7,1,7700,1100,8800
430260,202103,30,26,4,28600,4400,33000
430265,202103,33,27,6,29700,6600,36300
430270,202103,514,383,131,423500,144100,567600
430280,202103,1039,615,424,677600,466400,1144000
430290,202103,409,217,192,238700,211200,449900
430300,202103,2112,1143,969,1257300,1065900,2323200
430310,202103,2008,986,1022,1086800,1129700.7,2216500.7
430320,202103,53,44,9,48400,9900,58300
430330,202103,98,86,12,94600,13200,107800
430340,202103,70,56,14,61600,15400,77000
430350,202103,1648,1093,555,1203400,611600,1815000
430355,202103,19,17,2,18700,2200,20900
430360,202103,88,42,46,46200,50600,96800
430367,202103,36,25,11,27500,12100,39600
430370,202103,52,48,4,52800,4400,57200
430380,202103,124,96,28,105600,31900,137500
430390,202103,595,371,224,408100,246400,654500
430400,202103,254,183,71,201300,78100,279400
430410,202103,55,43,12,47300,13200,60500
430420,202103,507,326,181,358600,199100,557700
430430,202103,54,52,2,56467.4,2200,58667.4
430435,202103,150,112,38,123200,42900,166100
430440,202103,501,323,178,356400,198000,554400
430450,202103,1142,935,207,1028500,227700,1256200
430460,202103,5320,2723,2597,3005200,2866600,5871800
430461,202103,16,14,2,16500,2200,18700
430462,202103,5,3,2,3300,2200,5500
430463,202103,1094,584,510,643500,564300,1207800
430465,202103,24,13,11,14300,12100,26400
430466,202103,641,446,195,490600,215600,706200
430467,202103,108,58,50,63800,55000,118800
430468,202103,121,70,51,77000,56100,133100
430469,202103,21,16,5,17600,5500,23100
430470,202103,1148,638,510,703227.5,562100,1265327.5
430471,202103,59,38,21,41800,23100,64900
430480,202103,100,64,36,71500,39600,111100
430485,202103,7,7,0,7700,0,7700
430490,202103,72,58,14,63800,15400,79200
430495,202103,32,25,7,27500,7700,35200
430500,202103,186,126,60,138600,66000,204600
430510,202103,3490,2240,1250,2467300.67,1382700,3850000.67
430511,202103,16,16,0,17600,0,17600
430512,202103,151,105,46,115500,50600,166100
430513,202103,51,41,10,45100,11000,56100
430515,202103,25,24,1,26400,1100,27500
430517,202103,171,144,27,158400,29700,188100
430520,202103,336,237,99,260700,108900,369600
430530,202103,83,47,36,51700,39600,91300
430535,202103,437,294,143,324500,157300,481800
430537,202103,11,11,0,12100,0,12100
430540,202103,82,55,27,60500,29700,90200
430543,202103,365,110,255,121000,280500,401500
430544,202103,45,41,4,45100,4400,49500
430545,202103,381,179,202,196900,223300,420200
430550,202103,39,31,8,34100,8800,42900
430558,202103,1,1,0,1100,0,1100
430560,202103,57,31,26,34100,28600,62700
430570,202103,109,41,68,45100,75900,121000
430580,202103,132,107,25,117700,27500,145200
430583,202103,15,15,0,16500,0,16500
430585,202103,11,4,7,4400,7700,12100
430587,202103,14,8,6,8800,6600,15400
430590,202103,147,121,26,133100,28600,161700
430593,202103,2,2,0,2200,0,2200
430595,202103,15,13,2,14300,2200,16500
430597,202103,45,23,22,25300,24200,49500
430600,202103,212,157,55,172700,60500,233200
430605,202103,163,99,64,108900,70400,179300
430607,202103,27,22,5,25300,5500,30800
430610,202103,1685,776,909,854700,1001000,1855700
430613,202103,3,3,0,3300,0,3300
430620,202103,112,79,33,86900,36300,123200
430630,202103,45,39,6,42900,6600,49500
430632,202103,33,28,5,30800,5500,36300
430635,202103,38,34,4,37400,4400,41800
430637,202103,64,31,33,34100,36300,70400
430640,202103,178,97,81,107800,89100,196900
430642,202103,19,16,3,17600,3300,20900
430645,202103,33,27,6,29700,6600,36300
430650,202103,239,194,45,213400,49500,262900
430655,202103,1,1,0,1100,0,1100
430660,202103,970,482,488,530200,539000,1069200
430670,202103,77,53,24,58300,26400,84700
430673,202103,70,43,27,47300,29700,77000
430675,202103,10,8,2,8800,2200,11000
430676,202103,530,308,222,338800,245300,584100
430680,202103,234,159,75,174900,82500,257400
430690,202103,521,321,200,353100,220000.63,573100.63
430692,202103,9,7,2,7700,2200,9900
430693,202103,144,92,52,101200,57200,158400
430695,202103,64,52,12,57200,13200,70400
430697,202103,60,36,24,39600,26400,66000
430700,202103,1456,994,462,1094500,508200,1602700
430705,202103,28,25,3,27500,3300,30800
430710,202103,249,155,94,170500,103400,273900
430720,202103,111,94,17,103400,18700,122100
430730,202103,143,122,21,134200,23100,157300
430740,202103,73,50,23,55000,25300,80300
430745,202103,30,23,7,25300,7700,33000
430750,202103,335,226,109,248600,119900,368500
430755,202103,85,43,42,48400,46200,94600
430760,202103,392,218,174,239800,191400,431200
430770,202103,1504,777,727,856900,801900,1658800
430780,202103,299,185,114,203500,126500,330000
430781,202103,25,22,3,24200,3300,27500
430783,202103,60,49,11,55000,12100,67100
430786,202103,5,3,2,3300,2200,5500
430790,202103,507,329,178,364100,195800,559900
430800,202103,152,122,30,134200.01,33000,167200.01
430805,202103,44,34,10,37400,11000,48400
430807,202103,57,31,26,34100,28600,62700
430810,202103,76,45,31,49500,34100,83600
430820,202103,144,85,59,93500,64900,158400
430825,202103,10,8,2,8800,2200,11000
430830,202103,238,219,19,240900,20900,261800
430840,202103,130,86,44,95700,49500,145200
430843,202103,5,3,2,3300,2200,5500
430845,202103,76,41,35,45100,38500,83600
430850,202103,588,417,171,460900,188100,649000
430860,202103,153,98,55,107800,61600,169400
430865,202103,74,40,34,44000,37400,81400
430870,202103,77,63,14,69300,15400,84700
430880,202103,153,110,43,121000,47300,168300
430885,202103,11,9,2,9900,2200,12100
430890,202103,334,198,136,218900,149600,368500
430900,202103,515,353,162,390500,178200,568700
430905,202103,122,49,73,53900,80300,134200
430910,202103,283,163,120,179300,133100,312400
430912,202103,4,4,0,4400,0,4400
430915,202103,35,31,4,34100,4400,38500
430920,202103,4327,2272,2055,2503600,2270400,4774000
430925,202103,5,4,1,4400,1100,5500
430930,202103,2064,1185,879,1304600,970200,2274800
430940,202103,259,169,90,185900,99000,284900
430950,202103,148,122,26,135300,28600,163900
430955,202103,25,13,12,14300,13200,27500
430957,202103,20,17,3,18700,3300,22000
430960,202103,247,158,89,173800,97900,271700
430965,202103,113,71,42,78100,46200,124300
430970,202103,93,75,18,82500,19800,102300
430975,202103,45,39,6,42900,6600,49500
430980,202103,44,27,17,29700,18700,48400
430990,202103,99,76,23,83600,25300,108900
430995,202103,113,106,7,116600,7700,124300
431000,202103,289,138,151,152900.6,167200,320100.6
431010,202103,343,192,151,211200,166100,377300
431020,202103,1861,1068,793,1174800,874500,2049300
431030,202103,38,31,7,34100,8800,42900
431033,202103,414,188,226,206800,248600,455400
431036,202103,12,7,5,7700,5500,13200
431040,202103,143,87,56,95700,61600,157300
431041,202103,40,27,13,29700,14300,44000
431043,202103,42,25,17,27500,18700,46200
431046,202103,12,9,3,9900,3300,13200
431050,202103,199,126,73,138600,80300,218900
431053,202103,63,38,25,42900,27500,70400
431055,202103,62,43,19,47300,20900,68200
431057,202103,18,18,0,19800,0,19800
431060,202103,1587,1022,565,1127500.31,621500,1749000.31
431065,202103,16,10,6,11000,6600,17600
431070,202103,66,61,5,67100,5500,72600
431075,202103,7,7,0,7700,0,7700
431080,202103,134,77,57,84700,62700,147400
431085,202103,34,31,3,34100,3300,37400
431087,202103,11,9,2,9900,2200,12100
431090,202103,56,43,13,47300,14300,61600
431100,202103,1224,723,501,795300,551100,1346400
431110,202103,226,136,90,149600,99000,248600
431112,202103,23,15,8,16500,8800,25300
431113,202103,34,25,9,27500,9900,37400
431115,202103,159,112,47,123200,51700,174900
431120,202103,603,358,245,393800,269500,663300
431123,202103,3,2,1,2200,1100,3300
431125,202103,97,84,13,92400,14300,106700
431127,202103,11,6,5,6600,5500,12100
431130,202103,714,461,253,507100,279400,786500
431140,202103,755,525,230,577500,254100,831600
431142,202103,26,22,4,24200.55,4400,28600.55
431150,202103,187,140,47,154000,51700,205700
431160,202103,45,42,3,46200,3300,49500
431162,202103,3,3,0,3300,0,3300
431164,202103,6,6,0,6600,0,6600
431170,202103,111,86,25,94600,27500,122100
431171,202103,69,40,29,44000,31900,75900
431173,202103,1,1,0,1100,0,1100
431175,202103,203,99,104,108900,114400,223300
431177,202103,86,61,25,67100,27500,94600
431179,202103,14,11,3,12100,3300,15400
431180,202103,429,262,167,288200,185900,474100
431190,202103,76,57,19,62700,20900,83600
431198,202103,73,52,21,57200,23100,80300
431200,202103,22,18,4,19800,4400,24200
431205,202103,20,19,1,20900,1100,22000
431210,202103,100,63,37,69300,40700,110000
431213,202103,30,26,4,28600,4400,33000
431215,202103,21,18,3,19800,3300,23100
431217,202103,7,7,0,7700,0,7700
431220,202103,66,57,9,62700,9900,72600
431225,202103,157,98,59,107800,64900,172700
431230,202103,96,83,13,91300,14300,105600
431235,202103,6,6,0,6600,0,6600
431237,202103,8,7,1,7700,1100,8800
431238,202103,11,7,4,7700,4400,12100
431240,202103,1027,635,392,698500,432300,1130800
431242,202103,39,38,1,41800,1100,42900
431244,202103,15,11,4,12100,4400,16500
431245,202103,50,37,13,40700,14300,55000
431247,202103,11,6,5,6600,5500,12100
431250,202103,281,142,139,156200,154000,310200
431260,202103,59,48,11,52800,12100,64900
431261,202103,18,11,7,12100,7700,19800
431262,202103,16,15,1,16500,1100,17600
431265,202103,153,80,73,88000,80300,168300
431267,202103,18,15,3,16500,3300,19800
431270,202103,321,259,62,286000,69300,355300
431275,202103,39,36,3,39600,3300,42900
431280,202103,19,15,4,16500,4400,20900
431290,202103,19,17,2,18700,2200,20900
431295,202103,2,1,1,1100,1100,2200
431300,202103,21,18,3,19800,3300,23100
431301,202103,5,5,0,5500,0,5500
431303,202103,61,40,21,44000,23100,67100
431306,202103,238,124,114,136204.2,125400,261604.2
431308,202103,6,4,2,4400,2200,6600
431310,202103,66,53,13,58300,14300,72600
431320,202103,156,93,63,102300,69300,171600
431330,202103,188,113,75,124300,82500,206800
431333,202103,26,20,6,22000,6600,28600
431335,202103,10,6,4,6600,4400,11000
431337,202103,371,161,210,178200,231000,409200
431339,202103,20,16,4,17600,4400,22000
431340,202103,3043,1657,1386,1824813.1,1527900,3352713.1
431342,202103,37,25,12,27500,13200,40700
431344,202103,18,18,0,19800,0,19800
431346,202103,4,4,0,4400,0,4400
431349,202103,38,34,4,37400,4400,41800
431350,202103,909,509,400,562100,442200,1004300
431360,202103,53,43,10,47300,11000,58300
431365,202103,341,151,190,166100,210100,376200
431370,202103,1216,693,523,763400,575300,1338700
431380,202103,98,86,12,94600,13200,107800
431390,202103,495,267,228,293700,251900,545600
431395,202103,314,133,181,146300,199100,345400
431400,202103,43,30,13,33000,16500,49500
431402,202103,112,80,32,88000,35200,123200
431403,202103,24,14,10,16500,11000,27500
431405,202103,696,383,313,424600,344300,768900
431406,202103,33,26,7,28600,7700,36300
431407,202103,54,42,12,46200,13200,59400
431410,202103,3390,2052,1338,2259400,1476200,3735600
431413,202103,16,13,3,14300,3300,17600
431415,202103,64,45,19,49500,20900,70400
431417,202103,27,13,14,14300,15400,29700
431420,202103,330,224,106,246400,116600,363000
431430,202103,55,25,30,27500,33000,60500
431440,202103,8829,6040,2789,6649500,3075651,9725151
431442,202103,29,13,16,14300,17600,31900
431445,202103,28,26,2,28600,2200,30800
431446,202103,4,3,1,3300,1100,4400
431447,202103,87,60,27,66000,29700,95700
431449,202103,51,42,9,46200,9900,56100
431450,202103,408,270,138,297000,151800,448800
431454,202103,10,4,6,4400,6600,11000
431455,202103,48,39,9,44000,9900,53900
431460,202103,499,342,157,376200,173800,550000
431470,202103,118,86,32,94600,35200,129800
431475,202103,10,8,2,8800,2200,11000
431477,202103,37,23,14,26400,15400,41800
431478,202103,9,8,1,8800,1100,9900
431480,202103,533,320,213,354200,235400,589600
431490,202103,28436,15771,12665,17373401.67,13982100,31355501.67
431500,202103,78,62,16,68200,17600,85800
431505,202103,24,14,10,15400,11000,26400
431507,202103,8,7,1,7700,1100,8800
431510,202103,249,177,72,194700,80300,275000
431513,202103,24,21,3,23100,3300,26400
431514,202103,5,4,1,4400,1100,5500
431515,202103,78,64,14,70400,15400,85800
431517,202103,5,3,2,3300,2200,5500
431520,202103,39,35,4,38500,4400,42900
431530,202103,1439,637,802,702900,883300,1586200
431531,202103,23,22,1,24200,1100,25300
431532,202103,36,27,9,29700,9900,39600
431535,202103,29,16,13,17600,15400,33000
431540,202103,142,120,22,132000,24200,156200
431545,202103,15,12,3,13200,3300,16500
431550,202103,350,188,162,206800,178200,385000
431555,202103,12,12,0,13200,0,13200
431560,202103,4523,3051,1472,3358300,1621400,4979700
431570,202103,815,425,390,469700,430100,899800
431575,202103,43,23,20,25300,22000,47300
431580,202103,91,61,30,67100,33000,100100
431590,202103,135,114,21,125400,23100,148500
431595,202103,19,16,3,17600,3300,20900
431600,202103,245,141,104,156200,114400,270600
431610,202103,116,85,31,93500,34100,127600
431620,202103,44,37,7,40700,7700,48400
431630,202103,127,104,23,114400,25300,139700
431640,202103,1331,832,499,916300,551100,1467400
431642,202103,36,33,3,36300,3300,39600
431643,202103,46,19,27,20900,29700,50600
431645,202103,309,183,126,201300,138600,339900
431647,202103,9,8,1,8800,1100,9900
431650,202103,33,22,11,24200,12100,36300
431660,202103,280,175,105,192500,116600,309100
431670,202103,230,103,127,113300,139700,253000
431673,202103,7,7,0,7700,0,7700
431675,202103,23,18,5,19800,5500,25300
431680,202103,1111,816,295,903100,327800,1230900
431690,202103,4779,2844,1935,3133900.5,2130700,5264600.5
431695,202103,22,16,6,17600,6600,24200
431697,202103,1,0,1,0,1100,1100
431700,202103,182,139,43,152900,47300,200200
431710,202103,4010,1730,2280,1904100,2509100,4413200
431720,202103,1318,804,514,886050,567600,1453650
431725,202103,1,1,0,1100,0,1100
431730,202103,1154,775,379,853600,416900,1270500
431740,202103,1348,653,695,720500,765600,1486100
431750,202103,1824,1182,642,1301300.32,707300,2008600.32
431755,202103,6,5,1,5500,1100,6600
431760,202103,1012,627,385,693000,424600,1117600
431770,202103,418,292,126,321200,138600,459800
431775,202103,27,20,7,22000,7700,29700
431780,202103,542,322,220,354200,242000,596200
431790,202103,159,121,38,133100,41800,174900
431795,202103,13,10,3,11000,3300,14300
431800,202103,3150,1638,1512,1802900,1666500,3469400
431805,202103,22,20,2,22000,2200,24200
431810,202103,600,394,206,435600,226600,662200
431820,202103,332,196,136,216700,149600,366300
431830,202103,2273,1359,914,1496000,1008700,2504700
431840,202103,483,318,165,349800,182600,532400
431842,202103,35,28,7,30800,7700,38500
431843,202103,11,8,3,8800,3300,12100
431844,202103,17,13,4,14300,4400,18700
431845,202103,27,25,2,27500,2200,29700
431846,202103,27,23,4,25300,4400,29700
431848,202103,10,8,2,8800,2200,11000
431849,202103,7,6,1,6600,1100,7700
431850,202103,767,615,152,677600,167200,844800
431860,202103,117,77,40,84700,44000,128700
431861,202103,6,2,4,2200,4400,6600
431862,202103,55,38,17,41800,18700,60500
431870,202103,3495,1970,1525,2170352,1685200,3855552
431880,202103,927,675,252,743600,277200,1020800
431890,202103,1297,763,534,840400,588500,1428900
431900,202103,182,125,57,137500,62700,200200
431910,202103,50,37,13,40700,14300,55000
431912,202103,43,27,16,29700,17600,47300
431915,202103,130,99,31,108900,34100,143000
431920,202103,158,112,46,123200,50600,173800
431930,202103,78,65,13,71500,14300,85800
431935,202103,2,2,0,2200,0,2200
431936,202103,3,3,0,3300,0,3300
431937,202103,21,16,5,17600,5500,23100
431940,202103,459,305,154,335500,169400,504900
431950,202103,489,311,178,343200,195800,539000
431960,202103,735,392,343,433400,378400,811800
431970,202103,68,62,6,68200,6600,74800
431971,202103,3,3,0,3300,0,3300
431973,202103,19,15,4,16500,4400,20900
431975,202103,8,7,1,7700,1100,8800
431980,202103,212,129,83,141900,91300,233200
431990,202103,1109,590,519,650028.5,572000,1222028.5
432000,202103,1747,904,843,997700,928400,1926100
432010,202103,264,182,82,200200,91300,291500
432020,202103,177,146,31,160600,34100,194700
432023,202103,14,12,2,13200,2200,15400
432026,202103,65,58,7,63800,7700,71500
432030,202103,66,32,34,35200,37400,72600
432032,202103,20,15,5,16500,5500,22000
432035,202103,51,41,10,45100,11000,56100
432040,202103,89,61,28,67100,30800,97900
432045,202103,2,2,0,2200,0,2200
432050,202103,81,48,33,52800,36300,89100
432055,202103,124,91,33,100100,36300,136400
432057,202103,7,5,2,5500,2200,7700
432060,202103,33,30,3,33000,3300,36300
432065,202103,31,28,3,30800,3300,34100
432067,202103,87,77,10,85800,11000,96800
432070,202103,377,294,83,323675,91300,414975
432080,202103,823,575,248,633600,272800,906400
432085,202103,9,6,3,6600,3300,9900
432090,202103,269,179,90,196900,99000,295900
432100,202103,165,105,60,115500,67100,182600
432110,202103,538,359,179,394900,196900,591800
432120,202103,965,548,417,602800,459800,1062600
432130,202103,490,348,142,383900,156200,540100
432132,202103,25,22,3,24200,3300,27500
432135,202103,80,66,14,72600,15400,88000
432140,202103,268,205,63,225500,69300,294800
432143,202103,214,132,82,146300,90200,236500
432145,202103,276,190,86,209000,94600,303600
432146,202103,14,12,2,13200,2200,15400
432147,202103,112,58,54,63800,59400,123200
432149,202103,16,10,6,11000,6600,17600
432150,202103,900,543,357,597300,392700,990000
432160,202103,1496,754,742,832700.5,821700,1654400.5
432162,202103,4,2,2,2200,2200,4400
432163,202103,19,14,5,15400,5500,20900
432166,202103,125,92,33,101475,36300,137775
432170,202103,232,119,113,130900,124300,255200
432180,202103,546,331,215,365200,236500,601700
432183,202103,9,8,1,8800,1100,9900
432185,202103,74,63,11,71500,12100,83600
432190,202103,488,287,201,315700,221100,536800
432195,202103,90,73,17,80300,18700,99000
432200,202103,399,248,151,272800,167200,440000
432210,202103,115,71,44,78100,48400,126500
432215,202103,36,32,4,35200,4400,39600
432218,202103,21,20,1,22000,1100,23100
432220,202103,655,339,316,372900,347600.63,720500.63
432225,202103,14,9,5,9900,5500,15400
432230,202103,132,89,43,97900,47300,145200
432232,202103,13,11,2,12100,2200,14300
432234,202103,3,2,1,2200,1100,3300
432235,202103,3,2,1,2200,1100,3300
432237,202103,25,15,10,16500,11000,27500
432240,202103,4317,2383,1934,2622400,2130700,4753100
432250,202103,1128,730,398,804100,438900,1243000
432252,202103,48,46,2,51700,2200,53900
432253,202103,60,48,12,52800,13200,66000
432254,202103,27,11,16,12100,17600,29700
432255,202103,14,12,2,13200,2200,15400
432260,202103,822,647,175,712800,192500,905300
432270,202103,225,169,56,187000,61600,248600
432280,202103,141,107,34,117700,37400,155100
432285,202103,1,1,0,1100,0,1100
432290,202103,64,54,10,61600,11000,72600
432300,202103,4647,2476,2171,2732328.5,2394700.61,5127029.11
432310,202103,132,108,24,118800,26400,145200
432320,202103,22,17,5,18700,5500,24200
432330,202103,16,10,6,11000,6600,17600
432335,202103,8,6,2,6600,2200,8800
432340,202103,39,33,6,36300,6600,42900
432345,202103,105,69,36,75900,39600,115500
432350,202103,20,19,1,20900,1100,22000
432360,202103,4,3,1,3300,1100,4400
432370,202103,24,23,1,25300,1100,26400
432375,202103,31,28,3,30800,3300,34100
432377,202103,7,7,0,7700,0,7700
432380,202103,169,73,96,80300,105600,185900
500020,202103,250,133,117,146300,128700,275000
500025,202103,141,67,74,73700,81400,155100
500060,202103,1442,902,540,993300,598400,1591700
500070,202103,773,368,405,404800,447700,852500
500080,202103,134,106,28,116673.33,30800,147473.33
500085,202103,135,110,25,121000,27500,148500
500090,202103,352,160,192,177100,211200,388300
500100,202103,718,380,338,418000,371800,789800
500110,202103,2224,1034,1190,1138500,1310100,2448600
500124,202103,267,145,122,159500,134200,293700
500150,202103,347,135,212,148500,233200,381700
500190,202103,504,341,163,377300,179300,556600
500200,202103,199,171,28,188100,30800,218900
500210,202103,1582,532,1050,586300,1156100,1742400
500215,202103,236,130,106,144100,116600,260700
500220,202103,716,465,251,511500.92,276100,787600.92
500230,202103,230,140,90,154000,100100,254100
500240,202103,651,444,207,490600,227700,718300
500260,202103,581,226,355,248600,390500,639100
500270,202103,29780,12675,17105,13974823.24,18896900.44,32871723.68
500280,202103,199,68,131,74800,144100,218900
500290,202103,1158,711,447,783200,492800,1276000
500295,202103,441,287,154,315700,169400,485100
500310,202103,81,25,56,27500,61600,89100
500315,202103,779,442,337,486200,370700,856900
500320,202103,3583,1737,1846,1915100.84,2030600,3945700.84
500325,202103,934,504,430,554400,473000,1027400
500330,202103,1487,697,790,766700,871200,1637900
500345,202103,301,228,73,250800,80300,331100
500348,202103,250,144,106,158400,116600,275000
500350,202103,118,57,61,62700,67100,129800
500370,202103,5681,2545,3136,2802800.5,3454000,6256800.5
500375,202103,338,237,101,260700,111100,371800
500380,202103,588,332,256,365200,281600,646800
500390,202103,72,36,36,39600,39600,79200
500400,202103,221,140,81,154000,89100,243100
500410,202103,531,219,312,240900,344300,585200
500430,202103,526,371,155,409200,170500,579700
500440,202103,201,104,97,114400,106700,221100
500450,202103,403,172,231,189200,254100,443300
500460,202103,272,143,129,157300,143000,300300
500470,202103,425,329,96,361900,106700,468600
500480,202103,102,59,43,64900,47300,112200
500490,202103,104,46,58,50600,63800,114400
500500,202103,1403,509,894,562100,985600,1547700
500510,202103,43,35,8,38500,8800,47300
500515,202103,103,71,32,78100,35200,113300
500520,202103,296,158,138,173800,151800,325600
500525,202103,90,48,42,52800,46200,99000
500540,202103,882,384,498,422400,547800,970200
500560,202103,910,506,404,558800,444400,1003200
500568,202103,984,557,427,612700,470800,1083500
500570,202103,1177,687,490,762300,539000,1301300
500580,202103,328,163,165,179300,181500,360800
500600,202103,338,167,171,183700,188100,371800
500620,202103,919,646,273,711700.5,300300,1012000.5
500625,202103,76,61,15,67100,16500,83600
500627,202103,18,9,9,9900,9900,19800
500630,202103,1568,869,699,959200.63,768900,1728100.63
500635,202103,529,315,214,346500,235400,581900
500640,202103,375,202,173,222200,190300,412500
500660,202103,5599,2044,3555,2252800,3918200,6171000
500690,202103,603,204,399,224400,438900,663300
500710,202103,403,199,204,218900,224400,443300
500720,202103,912,522,390,575300.3,431200,1006500.3
500730,202103,182,107,75,117700,82500,200200
500740,202103,879,357,522,392700,574200,966900
500750,202103,150,46,104,50600,114400,165000
500755,202103,121,90,31,99000,34100,133100
500769,202103,749,405,344,445500,379500,825000
500770,202103,412,216,196,237600,216700,454300
500780,202103,145,95,50,104500,55000,159500
500790,202103,1058,529,529,583000,581900,1164900
500793,202103,271,141,130,155100,144100,299200
500795,202103,175,121,54,133100,59400,192500
500797,202103,47,33,14,36300,15400,51700
500800,202103,436,189,247,209000,273900,482900
500830,202103,2221,1230,991,1353000,1094500,2447500
500840,202103,128,96,32,105600,35200,140800
510010,202103,172,88,84,96800,92400,189200
510020,202103,505,216,289,238700,317900,556600
510025,202103,1666,952,714,1048300.37,786500,1834800.37
510030,202103,665,337,328,370700,360800,731500
510035,202103,126,62,64,69300,70400,139700
510040,202103,394,181,213,199100,235400,434500
510050,202103,382,212,170,233200,189200.3,422400.3
510060,202103,121,58,63,63800,69300,133100
510080,202103,232,92,140,101200,154000,255200
510100,202103,63,28,35,30800,38500,69300
510120,202103,33,20,13,22000,14300,36300
510125,202103,376,234,142,257400,156200,413600
510130,202103,534,318,216,349800,237600,587400
510140,202103,431,129,302,141900,332200,474100
510160,202103,105,34,71,37400,78100,115500
510170,202103,785,479,306,526900.56,336600,863500.56
510180,202103,2909,1351,1558,1487200,1716000,3203200
510185,202103,19,8,11,8800,12100,20900
510190,202103,236,85,151,93500,166100,259600
510250,202103,2572,1530,1042,1685200,1150600,2835800
510260,202103,174,127,47,139700,51700,191400
510263,202103,458,256,202,282700,222200,504900
510267,202103,646,361,285,397100,314600,711700
510268,202103,61,27,34,29700,37400,67100
510269,202103,73,31,42,34100,46200,80300
510270,202103,379,192,187,211200,205700,416900
510279,202103,217,165,52,181500,57200,238700
510285,202103,183,74,109,81400,121000,202400
510300,202103,506,265,241,291500,265100,556600
510305,202103,202,91,111,100100,122100,222200
510310,202103,107,54,53,59400,58300,117700
510320,202103,844,533,311,586300,342100,928400
510325,202103,419,173,246,191400,271700,463100
510330,202103,421,236,185,260700,203500,464200
510335,202103,634,359,275,394900,302500,697400
510336,202103,55,38,17,41800,18700,60500
510337,202103,108,47,61,51700,67100,118800
510340,202103,17153,7687,9466,8472200.63,10437900,18910100.63
510343,202103,63,45,18,49500,19800,69300
510345,202103,155,99,56,108900,61600,170500
510350,202103,645,349,296,386100,325600,711700
510360,202103,205,125,80,137500,88000,225500
510370,202103,151,70,81,77000,89100,166100
510380,202103,86,63,23,69300,25300,94600
510385,202103,62,27,35,29700,38500,68200
510390,202103,108,47,61,51700,68200,119900
510395,202103,45,32,13,35200,14300,49500
510410,202103,707,457,250,502700,277200,779900
510420,202103,556,267,289,294800,317900,612700
510450,202103,51,25,26,27500,29700,57200
510452,202103,53,25,28,27500,30800,58300
510454,202103,55,24,31,26400,34100,60500
510455,202103,137,76,61,83600,67100,150700
510460,202103,177,80,97,88000,106700,194700
510480,202103,696,415,281,456500,310200,766700
510490,202103,340,170,170,187000,188100,375100
510500,202103,237,178,59,195800,64900,260700
510510,202103,788,463,325,509300,357500,866800
510515,202103,1233,633,600,698500,662200,1360700
510517,202103,261,117,144,128700,158400,287100
510520,202103,221,146,75,160600,83600,244200
510523,202103,100,77,23,84700,25300,110000
510525,202103,819,491,328,541200,360800,902000
510530,202103,20,13,7,14300,7700,22000
510550,202103,239,109,130,119900.56,143000,262900.56
510558,202103,293,143,150,159500,167200,326700
510560,202103,414,241,173,265100,190300,455400
510562,202103,631,458,173,504900,191400,696300
510590,202103,736,380,356,420200,392700,812900
510600,202103,232,120,112,132000,123200,255200
510610,202103,220,92,128,101200,140800,242000
510615,202103,184,83,101,91300,111100,202400
510617,202103,21,10,11,11000,12100,23100
510618,202103,119,57,62,62700,68200,130900
510619,202103,94,66,28,72600,30800,103400
510620,202103,163,91,72,100100,79200,179300
510621,202103,177,113,64,124300,70400,194700
510622,202103,473,284,189,314600,207900,522500
510623,202103,311,212,99,234300,108900,343200
510624,202103,94,49,45,53900,50600,104500
510625,202103,523,327,196,359700,215600.63,575300.63
510626,202103,109,67,42,73700,46200,119900
510627,202103,81,56,25,61600,27500,89100
510628,202103,152,89,63,97900,69300,167200
510629,202103,273,162,111,178200,122119.8,300319.8
510630,202103,428,219,209,240900,229900,470800
510631,202103,15,4,11,4400,12100,16500
510637,202103,342,194,148,214500,162800,377300
510642,202103,998,533,465,586300,515900,1102200
510645,202103,2,0,2,0,2200,2200
510650,202103,1362,887,475,976800,522500,1499300
510665,202103,82,36,46,39600,50600,90200
510670,202103,59,33,26,36300,28600,64900
510675,202103,1146,737,409,810700,451000,1261700
510677,202103,338,172,166,191400,183700,375100
510680,202103,99,57,42,62700,46200,108900
510682,202103,204,105,99,115500,108900,224400
510685,202103,52,39,13,42900,14300,57200
510700,202103,572,329,243,361900,268400,630300
510704,202103,1168,614,554,675400,610500,1285900
510706,202103,135,68,67,74800,73700,148500
510710,202103,395,283,112,311300,123200,434500
510715,202103,58,40,18,44000,19800,63800
510718,202103,220,111,109,122100,119900,242000
510719,202103,41,17,24,18700,26400,45100
510720,202103,189,133,56,146300,61600,207900
510724,202103,86,33,53,36300,58300,94600
510726,202103,51,26,25,28600,27500,56100
510729,202103,54,21,33,23100,37400,60500
510730,202103,474,261,213,288200,234300,522500
510735,202103,112,45,67,49500,73700,123200
510740,202103,21,12,9,13200,9900,23100
510757,202103,22,17,5,18700,5500,24200
510760,202103,7050,3588,3462,3958900,3823600,7782500
510770,202103,676,315,361,347600,397100,744700
510774,202103,17,5,12,5500,13200,18700
510775,202103,110,83,27,91300,29700,121000
510776,202103,30,12,18,13200,19800,33000
510777,202103,195,84,111,92400,122100,214500
510779,202103,52,25,27,27500,29700,57200
510780,202103,274,159,115,176000,127600,303600
510785,202103,380,204,176,224400,193600,418000
510787,202103,186,88,98,97900,107800,205700
510788,202103,6,1,5,1100,5500,6600
510790,202103,2489,1306,1183,1441051,1302400,2743451
510792,202103,1130,637,493,700700,542300.54,1243000.54
510794,202103,112,62,50,68200,56100,124300
510795,202103,2274,1327,947,1463000.11,1045000,2508000.11
510800,202103,176,108,68,118800,74800,193600
510805,202103,191,127,64,139700,70400,210100
510810,202103,100,44,56,48400,61600,110000
510820,202103,238,117,121,128700,133100.5,261800.5
510830,202103,71,41,30,45100,33000,78100
510835,202103,14,9,5,9900,5500,15400
510840,202103,9024,4234,4790,4665100,5276700,9941800
510850,202103,225,90,135,99000,148500,247500
510860,202103,370,166,204,182600,225500,408100
510880,202103,68,48,20,52800,22000,74800
510885,202103,69,38,31,41800,34100,75900
510890,202103,65,37,28,40700,30800,71500
510895,202103,171,101,70,111100,77000,188100
520005,202103,128,52,76,57200,83600,140800
520010,202103,288,131,157,144100,172700,316800
520013,202103,733,484,249,533023.33,273900,806923.33
520015,202103,51,37,14,40700,15400,56100
520017,202103,87,50,37,55000,40700,95700
520020,202103,17,10,7,11000,7700,18700
520025,202103,2406,1245,1161,1372800,1279300,2652100
520030,202103,814,428,386,471075,425700,896775
520050,202103,71,50,21,55000,23100,78100
520055,202103,55,34,21,37400,23100,60500
520060,202103,173,112,61,123200,67100,190300
520080,202103,581,422,159,464200,174900,639100
520082,202103,16,11,5,12100,5500,17600
520085,202103,89,66,23,72600,25300,97900
520090,202103,91,62,29,68200,31900,100100
520110,202103,9240,3955,5285,4358200,5825600,10183800
520120,202103,12,7,5,7700,5500,13200
520130,202103,806,566,240,625900,266200,892100
520140,202103,11902,6613,5289,7288600,5834400.4,13123000.4
520145,202103,53,32,21,35200,23100,58300
520150,202103,163,129,34,141900,37400,179300
520160,202103,40,29,11,31900,12100,44000
520170,202103,249,141,108,155100,118800,273900
520180,202103,173,81,92,89100,101200,190300
520215,202103,204,138,66,152900,72600,225500
520235,202103,79,63,16,69300,17600,86900
520250,202103,122,70,52,77000,57200,134200
520260,202103,114,73,41,80300,45100,125400
520280,202103,45,31,14,34100,15400,49500
520310,202103,39,26,13,28600,14300,42900
520320,202103,180,109,71,119900,78100,198000
520330,202103,800,429,371,471900,411400,883300
520340,202103,359,210,149,231000,163900,394900
520350,202103,507,239,268,262900,294800,557700
520355,202103,87,49,38,53900,41800,95700
520357,202103,27,20,7,22000,7700,29700
520360,202103,3,2,1,2200,1100,3300
520380,202103,131,73,58,80300,63800,144100
520390,202103,252,107,145,117700,161700,279400
520393,202103,15,10,5,11000,5500,16500
520396,202103,75,49,26,53900,28600,82500
520400,202103,189,113,76,124300,83600,207900
520410,202103,194,96,98,105600,107800,213400
520420,202103,22,14,8,15400,8800,24200
520425,202103,281,141,140,155100,155100,310200
520430,202103,493,243,250,268501.2,275000,543501.2
520440,202103,692,500,192,551100,211200,762300
520450,202103,1993,847,1146,932800,1261700,2194500
520455,202103,57,32,25,35200,27500,62700
520460,202103,38,24,14,26400,16500,42900
520465,202103,32,27,5,29700,5500,35200
520470,202103,438,281,157,309100,172700,481800
520480,202103,79,47,32,51700,35200,86900
520485,202103,106,39,67,42900,73700,116600
520490,202103,412,307,105,337700,115500,453200
520495,202103,162,97,65,106700,72600,179300
520500,202103,192,151,41,166100,45100,211200
520505,202103,189,109,80,121000,89100,210100
520510,202103,1797,851,946,936100,1042800,1978900
520520,202103,45,30,15,33000,16500,49500
520530,202103,219,169,50,185900,55000,240900
520540,202103,589,396,193,435600,212300,647900
520545,202103,131,76,55,83600,60500,144100
520547,202103,59,34,25,38500,27500,66000
520549,202103,1234,564,670,621500,738100,1359600
520551,202103,311,166,145,182600,159500,342100
520552,202103,35,24,11,26400,12100,38500
520570,202103,15,9,6,9900,6600,16500
520580,202103,272,170,102,188100,112200,300300
520590,202103,137,83,54,91300,59400,150700
520620,202103,1124,522,602,576400,662200,1238600
520630,202103,39,22,17,24200,18700,42900
520640,202103,384,223,161,245300,178200,423500
520650,202103,68,37,31,40700,34100,74800
520660,202103,45,24,21,26400,23100,49500
520670,202103,35,30,5,33000,5500,38500
520680,202103,43,28,15,30800,17600,48400
520690,202103,39,9,30,9900,33000,42900
520710,202103,32,29,3,31900,3300,35200
520725,202103,200,147,53,161700,58300,220000
520735,202103,55,35,20,38500,22000,60500
520740,202103,417,204,213,224400,234300,458700
520750,202103,36,25,11,27500,12100,39600
520753,202103,67,45,22,49500,24200,73700
520760,202103,101,67,34,73700,37400,111100
520780,202103,281,208,73,228800,80300,309100
520790,202103,161,93,68,102300,74800,177100
520800,202103,3407,1848,1559,2037200,1721500,3758700
520810,202103,149,116,33,127600,36300,163900
520815,202103,5,4,1,4400,1100,5500
520830,202103,145,99,46,108900,50600,159500
520840,202103,369,242,127,266200,139700,405900
520850,202103,100,60,40,66000,44000,110000
520860,202103,1752,1125,627,1243000,690800,1933800
520870,202103,31593,14714,16879,16205200.98,18604300,34809500.98
520880,202103,1163,618,545,679800,599500,1279300
520890,202103,784,480,304,529100,334400,863500
520910,202103,970,519,451,570900.4,497200,1068100.4
520915,202103,94,73,21,80300,23100,103400
520920,202103,434,205,229,225500,253000,478500
520929,202103,18,16,2,17600,2200,19800
520940,202103,71,49,22,53900,24200,78100
520945,202103,15,10,5,11000,5500,16500
520960,202103,43,27,16,29700,17600,47300
520970,202103,351,207,144,227700,158400,386100
520980,202103,96,69,27,75900,29700,105600
520990,202103,450,312,138,343200,151800,495000
520993,202103,126,60,66,66000,72600,138600
520995,202103,247,139,108,152900,118800,271700
521000,202103,1548,892,656,981200,722700,1703900
521010,202103,679,339,340,372900,375100,748000
521015,202103,15,10,5,11000,5500,16500
521020,202103,1420,1005,415,1106600,457600,1564200
521030,202103,58,37,21,40700,23100,63800
521040,202103,938,602,336,662200,370700.69,1032900.69
521056,202103,49,33,16,36300,17600,53900
521060,202103,128,82,46,90236.66,50600,140836.66
521080,202103,400,308,92,338800,101200,440000
521090,202103,549,356,193,391600,212300,603900
521100,202103,268,201,67,221100,73700,294800
521120,202103,1057,744,313,819500,344300,1163800
521130,202103,351,251,100,276100,110000,386100
521140,202103,180,100,80,111100,88000,199100
521150,202103,2615,1129,1486,1243000,1637900,2880900
521160,202103,27,13,14,14300,15400,29700
521170,202103,220,123,97,135300,106700,242000
521180,202103,1170,752,418,828300,460900,1289200
521190,202103,2496,1058,1438,1164900,1581800,2746700
521200,202103,55,41,14,45100,15400,60500
521205,202103,11,8,3,8800,3300,12100
521210,202103,119,71,48,78100,52800,130900
521220,202103,743,518,225,570900,247500,818400
521225,202103,31,21,10,23100,11000,34100
521230,202103,106,68,38,74800,41800,116600
521250,202103,6192,3498,2694,3851101.64,2966700,6817801.64
521260,202103,29,14,15,15400,16500,31900
521270,202103,139,106,33,116600,36300,152900
521280,202103,427,261,166,287100,182600,469700
521290,202103,26,16,10,17600,11000,28600
521295,202103,100,64,36,70400,39600,110000
521300,202103,219,122,97,134200,106700,240900
521305,202103,37,26,11,28600,12100,40700
521308,202103,1036,793,243,873400,267300.51,1140700.51
521310,202103,1329,767,562,844800,618200,1463000
521340,202103,17,14,3,15400,3300,18700
521350,202103,124,94,30,103400,33000,136400
521370,202103,176,125,51,137500,56100,193600
521375,202103,180,95,85,105600,93500,199100
521377,202103,48,37,11,40700,12100,52800
521380,202103,1048,661,387,727100,425700,1152800
521385,202103,13,8,5,8800,5500,14300
521390,202103,99,80,19,88000,20900,108900
521400,202103,349,232,117,255200,128700,383900
521405,202103,143,80,63,88000,69300,157300
521410,202103,68,48,20,52800,22000,74800
521440,202103,199,141,58,155100,63800.82,218900.82
521450,202103,744,411,333,452100,366300,818400
521460,202103,1126,724,402,798600,443300,1241900
521470,202103,12,9,3,9900,3300,13200
521480,202103,44,30,14,33000,15400,48400
521483,202103,315,193,122,212300,134200,346500
521486,202103,287,186,101,204600,111100,315700
521487,202103,22,10,12,11000,13200,24200
521490,202103,24,12,12,13200,13200,26400
521500,202103,128,72,56,79200,61600,140800
521520,202103,46,33,13,36300,14300,50600
521523,202103,765,455,310,500500,341000,841500
521525,202103,48,29,19,31900,20900,52800
521530,202103,237,130,107,144100,117700,261800
521540,202103,32,17,15,18700,16500,35200
521550,202103,92,39,53,42900,58300,101200
521560,202103,815,552,263,608300,289300,897600
521565,202103,62,43,19,47300,20900,68200
521570,202103,535,360,175,397100,192500,589600
521580,202103,56,31,25,34100,27500,61600
521590,202103,38,18,20,19800,22000,41800
521600,202103,22,11,11,12100,12100,24200
521630,202103,240,129,111,141900,123200,265100
521640,202103,301,162,139,178200,152900,331100
521645,202103,37,18,19,19800,20900,40700
521680,202103,242,149,93,165000,102300,267300
521690,202103,2,2,0,2200,0,2200
521710,202103,1136,541,595,596200,655600,1251800
521720,202103,560,389,171,427900,188100,616000
521730,202103,666,319,347,350900,381700,732600
521740,202103,886,380,506,419100,556600,975700
521760,202103,2017,1038,979,1141800.95,1078000,2219800.95
521770,202103,822,516,306,567600,337700,905300
521800,202103,1973,1276,697,1404700,766700,2171400
521805,202103,32,17,15,18700,16500,35200
521810,202103,87,55,32,60500,35200,95700
521830,202103,959,682,277,750200.73,304700,1054900.73
521839,202103,87,53,34,58300,37400,95700
521850,202103,1100,574,526,631400.17,580800,1212200.17
521860,202103,329,204,125,225500,137500,363000
521870,202103,69,42,27,46200,29700,75900
521878,202103,38,17,21,18700,23100,41800
521880,202103,4726,2105,2621,2317700,2887500,5205200
521890,202103,594,413,181,455400.3,199100,654500.3
521900,202103,284,231,53,254100,58300,312400
521910,202103,160,112,48,123200,52800,176000
521920,202103,44,22,22,24200,24200,48400
521925,202103,53,31,22,34100,24200,58300
521930,202103,1152,642,510,706200,561000,1267200
521935,202103,35,24,11,26400,12100,38500
521940,202103,199,96,103,105600,113300,218900
521945,202103,17,13,4,14300,4400,18700
521950,202103,9,5,4,5500,4400,9900
521960,202103,70,52,18,57200,19800,77000
521970,202103,404,258,146,283800,160600,444400
521971,202103,107,58,49,63800,53900,117700
521973,202103,33,18,15,19800,16500,36300
521975,202103,1484,745,739,819500.75,814000.18,1633500.93
521980,202103,241,165,76,181500,83600,265100
521990,202103,73,53,20,58300,23100,81400
522000,202103,290,185,105,203116.1,116600,319716.1
522005,202103,18,10,8,11000,8800,19800
522010,202103,1134,634,500,697400,553300,1250700
522015,202103,56,32,24,35200,26400,61600
522020,202103,894,518,376,569800,413600,983400
522026,202103,23,14,9,15400,9900,25300
522028,202103,15,11,4,12100,4400,16500
522040,202103,769,315,454,346500,499400,845900
522045,202103,2369,1445,924,1593900.29,1016400,2610300.29
522050,202103,156,77,79,84700,89100,173800
522060,202103,544,337,207,371800,227700,599500
522068,202103,107,75,32,83600,35200,118800
522070,202103,10,9,1,9900,1100,11000
522100,202103,36,21,15,23100,17600,40700
522108,202103,42,31,11,35200,12100,47300
522119,202103,56,32,24,35200,26400,61600
522130,202103,77,29,48,31900,52800,84700
522140,202103,4003,2044,1959,2249500,2158200,4407700
522145,202103,48,35,13,38500,14300,52800
522150,202103,99,70,29,77000,31900,108900
522155,202103,52,38,14,41800,15400,57200
522157,202103,6,3,3,3300,3300,6600
522160,202103,1693,998,695,1098900,764500,1863400
522170,202103,397,266,131,293700,144100,437800
522180,202103,36,17,19,18700,20900,39600
522185,202103,2107,853,1254,938300,1381600,2319900
522190,202103,51,27,24,29700,26400,56100
522200,202103,299,179,120,196900,132000,328900
522205,202103,140,94,46,103400,50600,154000
522220,202103,143,105,38,115500,41800,157300
522230,202103,30,24,6,26400,6600,33000
530010,202103,54051,27309,26742,30091933.65,29462614.19,59554547.84
110001,202104,503,407,96,448800,106700,555500
110002,202104,2827,1780,1047,1960200,1152800,3113000
110003,202104,79,66,13,72600,14300,86900
110004,202104,2023,1342,681,1476200,751300,2227500
110005,202104,432,345,87,379500,95700,475200
110006,202104,446,337,109,370700,119900,490600
110007,202104,68,57,11,62700,13200,75900
110008,202104,244,135,109,148500,119900,268400
110009,202104,901,663,238,729300,262900,992200
110010,202104,1675,1018,657,1120900,722700,1843600
110011,202104,1727,1343,384,1479500,422400,1901900
110012,202104,4063,2377,1686,2619100,1857900,4477000
110013,202104,759,606,153,668800,168300,837100
110014,202104,373,324,49,356400.14,53900,410300.14
110015,202104,1374,1099,275,1210000,302500,1512500
110018,202104,1075,668,407,735900,447700,1183600
110020,202104,15475,8865,6610,9753700.75,7272100,17025800.75
110025,202104,648,477,171,525800,188100,713900
110026,202104,38,27,11,29700,12100,41800
110028,202104,1603,1150,453,1268300,498300,1766600
110029,202104,136,122,14,134200,15400,149600
110030,202104,2388,1607,781,1769724.18,859100.85,2628825.03
110032,202104,321,247,74,271700,82500,354200
110033,202104,645,468,177,514800,194700,709500
110034,202104,331,246,85,270600.5,94600,365200.5
110037,202104,94,83,11,91300,12100,103400
110040,202104,377,255,122,280500,134200,414700
110045,202104,931,644,287,708400,315700,1024100
110050,202104,90,79,11,86900,12100,99000
110060,202104,67,40,27,44000,29700,73700
110070,202104,106,68,38,74800,41800,116600
110080,202104,495,276,219,303600,240900,544500
110090,202104,24,21,3,23100,3300,26400
110092,202104,105,57,48,62700,52800,115500
110094,202104,197,143,54,157300,59400,216700
110100,202104,41,28,13,30800,14300,45100
110110,202104,92,52,40,57200,44000,101200
110120,202104,67,59,8,64900,8800,73700
110130,202104,282,231,51,254100,56100,310200
110140,202104,241,169,72,185900.61,79200,265100.61
110143,202104,48,39,9,42900,9900,52800
110145,202104,31,23,8,25300,8800,34100
110146,202104,22,12,10,13200,11000,24200
110147,202104,36,24,12,26400,13200,39600
110148,202104,33,23,10,25300,11000,36300
110149,202104,311,223,88,245300,96800,342100
110150,202104,135,102,33,112200,36300,148500
110155,202104,10,10,0,11000,0,11000
110160,202104,67,53,14,58300,15400,73700
110170,202104,222,169,53,185900,58300,244200
110175,202104,67,50,17,55000,18700,73700
110180,202104,87,72,15,79200,16500,95700
120001,202104,196,144,52,158400,57200,215600
120005,202104,200,115,85,126500.41,93500,220000.41
120010,202104,1104,682,422,753500,464200,1217700
120013,202104,143,96,47,105600,51700,157300
120017,202104,109,60,49,66000,53900,119900
120020,202104,3498,2833,665,3120701.31,731500,3852201.31
120025,202104,537,302,235,332200.4,258500,590700.4
120030,202104,1056,913,143,1005400.7,157300,1162700.7
120032,202104,36,32,4,35200,4400,39600
120033,202104,216,192,24,211200,26400,237600
120034,202104,173,126,47,139700,51700,191400
120035,202104,35,29,6,31900,6600,38500
120038,202104,417,276,141,303600,155100,458700
120039,202104,29,28,1,30800,1100,31900
120040,202104,13863,9486,4377,10441564.15,4818000,15259564.15
120042,202104,41,35,6,38500,6600,45100
120043,202104,11,2,9,2200,9900,12100
120045,202104,524,333,191,366300,210100,576400
120050,202104,1277,977,300,1075801,330000,1405801
120060,202104,1468,1207,261,1328800,287100,1615900
120070,202104,414,301,113,331100.6,124300,455400.6
120080,202104,176,109,67,119900,73700,193600
130002,202104,161,115,46,126500,50600,177100
130006,202104,103,65,38,71500,41800,113300
130008,202104,129,70,59,77000,64900,141900
130010,202104,150,85,65,93500,71500,165000
130014,202104,275,199,76,218900,83600,302500
130020,202104,99,61,38,67100,41800,108900
130030,202104,976,570,406,627000,446600,1073600
130040,202104,342,168,174,184800,191400,376200
130050,202104,560,291,269,320100,295900,616000
130060,202104,828,566,262,622600,288200,910800
130063,202104,592,342,250,376200,275000,651200
130068,202104,185,114,71,125400,78100,203500
130070,202104,1352,921,431,1014200,474100,1488300
130080,202104,712,478,234,525800,257400,783200
130083,202104,69,38,31,41800,34100,75900
130090,202104,321,165,156,181500,171600,353100
130100,202104,1105,469,636,515900,699600,1215500
130110,202104,731,312,419,343200,460900,804100
130115,202104,158,69,89,75900,97900,173800
130120,202104,1616,1011,605,1113200,666600,1779800
130130,202104,622,419,203,460900,223300,684200
130140,202104,1562,1225,337,1347500,370700,1718200
130150,202104,410,363,47,399300,51700,451000
130160,202104,454,264,190,290400,209000,499400
130165,202104,42,32,10,35200,11000,46200
130170,202104,1013,711,302,782029.6,332200.9,1114230.5
130180,202104,238,179,59,196900,64900,261800
130185,202104,2246,1035,1211,1140700,1333200,2473900
130190,202104,3367,2123,1244,2335300,1368400,3703700
130195,202104,276,218,58,239800,63800,303600
130200,202104,182,86,96,94600,105600,200200
130210,202104,74,36,38,39600,41800,81400
130220,202104,177,121,56,133100,61600,194700
130230,202104,382,248,134,272800,147400,420200
130240,202104,1289,818,471,900900,519200,1420100
130250,202104,4682,3013,1669,3314300,1835900,5150200
130255,202104,428,207,221,227700,245300,473000
130260,202104,56933,26883,30050,29589910.95,33091531,62681441.95
130270,202104,1553,1060,493,1167199,542300,1709499
130280,202104,120,67,53,73700,58300,132000
130290,202104,2074,1424,650,1567500,716100,2283600
130300,202104,424,294,130,323400,143000,466400
130310,202104,921,493,428,543400,473000,1016400
130320,202104,527,275,252,302500,277200,579700
130330,202104,776,488,288,536800,316800,853600
130340,202104,3439,1951,1488,2146100,1637900,3784000
130350,202104,481,324,157,357500,172700,530200
130353,202104,932,409,523,452100,575300,1027400
130356,202104,816,364,452,400400,497200,897600
130360,202104,88,66,22,72600,24200,96800
130370,202104,696,534,162,587400,178200,765600
130380,202104,661,508,153,558800,168300,727100
130390,202104,472,382,90,420200,99000,519200
130395,202104,158,38,120,41800,132000,173800
130400,202104,68,46,22,50600,24200,74800
130406,202104,2055,1224,831,1346400,914100,2260500
130410,202104,434,209,225,229900,247500,477400
130420,202104,2882,2341,541,2575100,596200,3171300
130423,202104,156,79,77,86900,84700,171600
130426,202104,156,78,78,85800,85800,171600
130430,202104,418,255,163,280500,179300,459800
130440,202104,196,59,137,64900,150700,215600
140002,202104,19,7,12,7700,13200,20900
140005,202104,201,120,81,132000,89100,221100
140010,202104,11003,6920,4083,7620804.43,4496800,12117604.43
140015,202104,138,62,76,68200,83600,151800
140017,202104,125,75,50,82500,55000,137500
140020,202104,470,303,167,333300,183700,517000
140023,202104,35,17,18,18700,19800,38500
140028,202104,21,11,10,12100,11000,23100
140030,202104,356,243,113,267300,124300,391600
140040,202104,61,44,17,48400,18700,67100
140045,202104,266,103,163,113300,180400,293700
140047,202104,412,280,132,308000,145200,453200
140050,202104,138,83,55,92400,60500,152900
140060,202104,56,38,18,41800,19800,61600
140070,202104,30,28,2,30800,2200,33000
150010,202104,4767,2886,1881,3176800.61,2071300,5248100.61
150013,202104,161,114,47,125400,52800,178200
150020,202104,1102,597,505,656700,555500,1212200
150030,202104,717,318,399,349800,438900,788700
150034,202104,202,125,77,137500,85800,223300
150040,202104,1502,863,639,950400,702900,1653300
150050,202104,688,393,295,432300,326700,759000
150060,202104,4898,3084,1814,3395607,1996955.4,5392562.4
150070,202104,424,218,206,239800,226600,466400
150080,202104,15455,7329,8126,8068500,8941900.39,17010400.39
150085,202104,438,278,160,305800,176000,481800
150090,202104,699,591,108,650100,118800,768900
150095,202104,366,231,135,254100,148500,402600
150100,202104,62,41,21,45100,23100,68200
150110,202104,200,107,93,117700,102300,220000
150120,202104,394,284,110,312400,121000,433400
150125,202104,49,17,32,18700,35200,53900
150130,202104,2064,1077,987,1184700,1087900,2272600
150140,202104,55641,24982,30659,27493400,33742500.7,61235900.7
150145,202104,228,126,102,138600,112200,250800
150150,202104,3050,1322,1728,1455300,1901900,3357200
150157,202104,379,264,115,290400,126500,416900
150160,202104,130,100,30,110000,33000,143000
150170,202104,3679,2728,951,3003000,1048300,4051300
150172,202104,341,240,101,265100,112200,377300
150175,202104,81,48,33,52800,36300,89100
150178,202104,757,503,254,553300,279400,832700
150180,202104,3177,1550,1627,1708300,1789700,3498000
150190,202104,351,221,130,243100,143000,386100
150195,202104,110,56,54,61600,59400,121000
150200,202104,192,92,100,101200,110000,211200
150210,202104,3150,2516,634,2767600,698500,3466100
150215,202104,571,359,212,394900,233200,628100
150220,202104,3582,2385,1197,2625700.82,1317800,3943500.82
150230,202104,1210,970,240,1068100.5,265100,1333200.5
150240,202104,6454,3648,2806,4015000.6,3091000,7106000.6
150250,202104,59,32,27,35200.65,29700,64900.65
150260,202104,92,61,31,67100,34100,101200
150270,202104,2202,1423,779,1565300,856900,2422200
150275,202104,531,337,194,371800,213400,585200
150276,202104,108,40,68,44000,75900,119900
150277,202104,802,355,447,390500,491700,882200
150280,202104,363,241,122,265100,134200,399300
150285,202104,112,56,56,61600,61424,123024
150290,202104,1144,668,476,735900,523600,1259500
150293,202104,706,330,376,363000,414700,777700
150295,202104,514,236,278,260700,305800,566500
150300,202104,83,39,44,42900,48400,91300
150304,202104,181,107,74,117700,81400,199100
150307,202104,403,332,71,365200,78100,443300
150309,202104,582,412,170,453200,187000.48,640200.48
150310,202104,248,160,88,176000,96800,272800
150320,202104,1877,1315,562,1446500,618200,2064700
150330,202104,2029,1174,855,1293600,941600,2235200
150340,202104,190,127,63,140800,69300,210100
150345,202104,630,352,278,387200,305800,693000
150350,202104,404,318,86,349800,95700,445500
150360,202104,4668,2873,1795,3162500,1975600,5138100
150370,202104,821,567,254,623700,279400,903100
150375,202104,199,92,107,101200,117700,218900
150380,202104,1507,998,509,1098900,559900,1658800
150390,202104,812,474,338,521400,371800,893200
150400,202104,108,89,19,97900,20900,118800
150405,202104,1233,782,451,861300,496100,1357400
150410,202104,118,74,44,81400,48400,129800
150420,202104,7440,4030,3410,4438680,3753200,8191880
150430,202104,624,391,233,430100,256300,686400
150440,202104,450,281,169,309100,185900,495000
150442,202104,2328,1238,1090,1361800,1199000,2560800
150445,202104,550,356,194,391600,213400,605000
150450,202104,226,122,104,134200,114400,248600
150460,202104,729,544,185,598400,203500,801900
150470,202104,1277,769,508,845900,558800,1404700
150475,202104,237,179,58,196900,63800,260700
150480,202104,1314,907,407,997700,447700,1445400
150490,202104,650,385,265,423500,291500,715000
150495,202104,335,248,87,272800,95700,368500
150497,202104,280,191,89,210100,97900,308000
150500,202104,231,139,92,152900,101200,254100
150503,202104,1083,545,538,599500,591800,1191300
150506,202104,920,620,300,683100,331100,1014200
150510,202104,1271,702,569,772200.02,627000,1399200.02
150520,202104,295,198,97,217800,106700,324500
150530,202104,1717,942,775,1037300,853600,1890900
150540,202104,227,164,63,180400,70400,250800
150543,202104,821,418,403,460900,443300,904200
150548,202104,464,331,133,364100,146300,510400
150549,202104,60,42,18,46200,19800,66000
150550,202104,2956,1492,1464,1644500,1611500,3256000
150553,202104,3384,1910,1474,2104300,1621400,3725700
150555,202104,145,79,66,86900,72600,159500
150560,202104,36,15,21,16500,23100,39600
150563,202104,117,57,60,62700,66000,128700
150565,202104,190,117,73,128700,80300,209000
150570,202104,426,283,143,311300,157300,468600
150580,202104,1684,810,874,891000,961400,1852400
150590,202104,814,536,278,589600,305800,895400
150600,202104,483,290,193,319000,212300,531300
150610,202104,149,118,31,129800,34100,163900
150611,202104,123,81,42,89100,46200,135300
150613,202104,3235,1878,1357,2066900,1493800,3560700
150616,202104,542,303,239,333300,262900,596200
150618,202104,1352,708,644,781000,709500,1490500
150619,202104,394,300,94,330000,103400,433400
150620,202104,1257,726,531,798600,584100,1382700
150630,202104,324,206,118,226600,129800,356400
150635,202104,454,188,266,206800,292600,499400
150640,202104,45,23,22,25300,24200,49500
150650,202104,2397,1393,1004,1532300,1105500,2637800
150655,202104,240,178,62,195800,68200,264000
150658,202104,83,51,32,56100,35200,91300
150660,202104,545,352,193,387200,212300,599500
150670,202104,1092,381,711,419100,782100,1201200
150680,202104,10270,5385,4885,5927900.57,5376800,11304700.57
150690,202104,20,11,9,12100,9900,22000
150700,202104,488,317,171,348700,188100,536800
150710,202104,287,163,124,179300.04,136400,315700.04
150715,202104,842,527,315,579700,346500,926200
150720,202104,414,316,98,347600,107800,455400
150730,202104,1036,514,522,565400,576400,1141800
150740,202104,230,152,78,167200,85800,253000
150745,202104,750,416,334,457600,367400,825000
150746,202104,63,36,27,39600,29700,69300
150747,202104,227,169,58,185900,63800,249700
150750,202104,138,76,62,83600,68200,151800
150760,202104,1812,1185,627,1304600.5,691900,1996500.5
150770,202104,388,217,171,238700,188100,426800
150775,202104,107,50,57,55000,62700,117700
150780,202104,197,108,89,118800,97900,216700
150790,202104,895,511,384,562100,422400,984500
150795,202104,1559,937,622,1030700,685300,1716000
150796,202104,349,199,150,220000,165000,385000
150797,202104,343,163,180,179300,198000,377300
150800,202104,1519,866,653,952600,718300,1670900
150803,202104,531,425,106,467500,116600,584100
150805,202104,207,121,86,133100,94600,227700
150808,202104,1001,532,469,585200,517000,1102200
150810,202104,3240,2201,1039,2421100.5,1142900,3564000.5
150812,202104,459,230,229,253000,251900,504900
150815,202104,1083,673,410,740300,451000,1191300
150820,202104,1548,931,617,1028500,684200,1712700
150830,202104,715,523,192,575300,211200,786500
150835,202104,209,124,85,136400,93500,229900
150840,202104,1376,834,542,917400,597300,1514700
160005,202104,63,45,18,49500,19800,69300
160010,202104,189,120,69,132000.06,75900.04,207900.10
160015,202104,134,81,53,89100.04,58300,147400.04
160020,202104,136,74,62,81400,68200,149600
160021,202104,62,28,34,30800,37400,68200
160023,202104,66,42,24,46200,26400,72600
160025,202104,27,12,15,13200,16500,29700
160027,202104,1461,831,630,914100.84,694100.4,1608201.24
160030,202104,16112,8295,7817,9130004.72,8605302.54,17735307.26
160040,202104,301,174,127,191400.04,139700.02,331100.06
160050,202104,722,358,364,393800.08,400400.02,794200.10
160053,202104,283,172,111,189200.06,122100,311300.06
160055,202104,24,15,9,16500.02,9900,26400.02
160060,202104,6597,3508,3089,3859904.05,3397902.24,7257806.29
160070,202104,180,104,76,114400,83600.02,198000.02
160080,202104,115,56,59,61600,64900,126500
170025,202104,30,15,15,16500,16500,33000
170030,202104,195,160,35,176000.03,38500,214500.03
170035,202104,212,100,112,111100,123200,234300
170040,202104,180,133,47,146300,51700,198000
170070,202104,320,197,123,216700,135300,352000
170100,202104,346,255,91,280500,100100,380600
170105,202104,57,46,11,50600,12100,62700
170110,202104,113,67,46,73700,50600,124300
170130,202104,72,35,37,38500,40700,79200
170190,202104,95,57,38,62700,41800,104500
170200,202104,364,252,112,277200,123200,400400
170210,202104,6159,3241,2918,3568134.25,3220801.55,6788935.80
170215,202104,112,50,62,55000,68200,123200
170220,202104,1368,1008,360,1108800,396000,1504800
170230,202104,145,96,49,105600,53900,159500
170240,202104,518,348,170,382800,187000,569800
170255,202104,1069,873,196,960300,215600,1175900
170270,202104,45,31,14,34100,15400,49500
170290,202104,117,77,40,84700,44000,128700
170300,202104,100,62,38,68200,41800,110000
170305,202104,47,36,11,39600,12100,51700
170307,202104,61,47,14,51700,15400,67100
170310,202104,118,65,53,71500,58300,129800
170320,202104,26,16,10,17600,11000,28600
170330,202104,26,22,4,24200,4400,28600
170360,202104,31,18,13,19800,14300,34100
170370,202104,96,46,50,51700,55000,106700
170380,202104,75,55,20,60500,22000,82500
170382,202104,43,36,7,39600,7700,47300
170384,202104,141,109,32,119900,35200,155100
170386,202104,65,25,40,27500,44000,71500
170388,202104,48,19,29,20900,31900,52800
170389,202104,25,21,4,23100,4400,27500
170390,202104,75,42,33,46200,36300,82500
170410,202104,25,22,3,24200,3300,27500
170460,202104,15,10,5,11000,5500,16500
170510,202104,34,27,7,29700,7700,37400
170550,202104,1543,887,656,975700,722700,1698400
170555,202104,111,81,30,89100,33000,122100
170560,202104,105,74,31,81400,34100,115500
170600,202104,40,15,25,16500,27500,44000
170610,202104,194,101,93,112200,103400,215600
170625,202104,37,22,15,24200,16500,40700
170650,202104,80,58,22,63800,24200,88000
170700,202104,588,435,153,478500,168300,646800
170710,202104,158,99,59,108900,64900,173800
170720,202104,92,71,21,78100,23100,101200
170730,202104,88,53,35,58300,38500,96800
170740,202104,86,60,26,66000,28600,94600
170755,202104,56,30,26,33000,28600,61600
170765,202104,139,74,65,81400,71500,152900
170770,202104,198,127,71,139700,78100,217800
170820,202104,609,402,207,442200,227700,669900
170825,202104,38,19,19,20900,20900,41800
170830,202104,84,66,18,72600,19800,92400
170900,202104,173,132,41,145200,45100,190300
170930,202104,909,488,421,539000,464200,1003200
170950,202104,3128,1438,1690,1581800,1863400.4,3445200.4
170980,202104,18,10,8,11000,8800,19800
171050,202104,149,115,34,126500,37400,163900
171070,202104,49,40,9,44000,9900,53900
171090,202104,50,37,13,40700,14300,55000
171110,202104,22,16,6,17600,6600,24200
171150,202104,41,21,20,23100,22000,45100
171180,202104,28,14,14,15400,15400,30800
171190,202104,159,93,66,102300,72600,174900
171195,202104,63,52,11,57200,12100,69300
171200,202104,47,23,24,25300,26400,51700
171215,202104,4,3,1,3300,1100,4400
171240,202104,60,43,17,47300,18700,66000
171245,202104,58,50,8,55000,8800,63800
171250,202104,73,41,32,45100,35200,80300
171270,202104,14,10,4,11000,4400,15400
171280,202104,40,35,5,38500,5500,44000
171320,202104,1004,571,433,629200,477400,1106600
171330,202104,426,216,210,237600,232100,469700
171360,202104,90,62,28,68200,30800,99000
171370,202104,33,16,17,17600,18700,36300
171380,202104,130,112,18,124300,19800,144100
171395,202104,50,30,20,33000,22000,55000
171420,202104,267,174,93,191400,102300,293700
171430,202104,73,58,15,63800,16500,80300
171488,202104,186,102,84,113300,92400,205700
171500,202104,62,35,27,38500,29700,68200
171510,202104,69,45,24,49500,26400,75900
171515,202104,42,33,9,36300,9900,46200
171525,202104,29,27,2,29700,2200,31900
171550,202104,15,9,6,9900,6600,16500
171570,202104,49,25,24,27500,26400,53900
171575,202104,298,196,102,215600,112200,327800
171610,202104,1722,875,847,964700,933900,1898600
171620,202104,139,94,45,103400,49500,152900
171630,202104,55,29,26,31900,28600,60500
171650,202104,313,221,92,243100,101200,344300
171660,202104,265,150,115,165000,126500,291500
171665,202104,64,42,22,46200,24200,70400
171670,202104,430,257,173,282700,191400,474100
171700,202104,63,55,8,60500,8800,69300
171720,202104,29,11,18,12100,19800,31900
171750,202104,103,54,49,59400,53900,113300
171780,202104,72,56,16,61600,17600,79200
171790,202104,83,68,15,74800,16500,91300
171800,202104,32,24,8,26400,8800,35200
171820,202104,2089,1198,891,1317800.7,980100,2297900.7
171830,202104,35,27,8,29700,8800,38500
171840,202104,65,41,24,45100,26400,71500
171845,202104,27,17,10,19800,11000,30800
171850,202104,39,32,7,35200,7700,42900
171855,202104,78,60,18,66000,19800,85800
171865,202104,6,5,1,5500,1100,6600
171870,202104,34,23,11,25300,12100,37400
171875,202104,78,56,22,62700,24200,86900
171880,202104,36,23,13,25300,14300,39600
171884,202104,49,27,22,29700,25300,55000
171886,202104,127,55,72,60500,79200,139700
171888,202104,26,20,6,22000,6600,28600
171889,202104,14,8,6,8800,6600,15400
171890,202104,55,45,10,49500,11000,60500
171900,202104,35,25,10,27500,11000,38500
172000,202104,40,32,8,35200,8800,44000
172010,202104,54,45,9,49500,9900,59400
172015,202104,24,17,7,18700,7700,26400
172020,202104,142,90,52,99000,57200,156200
172025,202104,40,26,14,28600,15400,44000
172030,202104,42,23,19,25300,20900,46200
172049,202104,83,54,29,59400,31900,91300
172065,202104,130,86,44,94600,48400,143000
172080,202104,107,67,40,73700,44000,117700
172085,202104,27,13,14,14300,15400,29700
172090,202104,432,325,107,357500.56,118800,476300.56
172093,202104,15,13,2,14300,2200,16500
172097,202104,18,11,7,12100,7700,19800
172100,202104,5195,2946,2249,3241040,2476100,5717140
172110,202104,77,49,28,53900,30800,84700
172120,202104,1660,1395,265,1534500,291500,1826000
172125,202104,9,8,1,8800,1100,9900
172130,202104,24,14,10,15400,11000,26400
172208,202104,206,124,82,136400,90200,226600
172210,202104,368,178,190,195800,209000,404800
210005,202104,2960,1857,1103,2043800.32,1215500,3259300.32
210010,202104,154,89,65,97900,71500,169400
210015,202104,39,29,10,31900,11000,42900
210020,202104,362,205,157,225500,172700,398200
210030,202104,324,216,108,237600,118800,356400
210040,202104,136,109,27,119900,29700,149600
210043,202104,252,194,58,213400,63800,277200
210047,202104,529,319,210,350900,231000,581900
210050,202104,282,210,72,231000,79200,310200
210055,202104,53,43,10,47300,11000,58300
210060,202104,535,432,103,476300,113300,589600
210070,202104,421,324,97,356400,106700,463100
210080,202104,129,117,12,128700,13200,141900
210083,202104,288,139,149,152900,163900,316800
210087,202104,2,1,1,1100,1100,2200
210090,202104,438,314,124,346500,136400,482900
210095,202104,425,327,98,359700,107800,467500
210100,202104,702,551,151,606100,167200,773300
210110,202104,124,81,43,89100,47300,136400
210120,202104,4987,3918,1069,4310900,1175900.5,5486800.5
210125,202104,186,114,72,125400,79200,204600
210130,202104,466,269,197,295900,216700,512600
210135,202104,27,20,7,22000,7700,29700
210140,202104,4401,3425,976,3767500.1,1074700,4842200.1
210150,202104,375,238,137,261800,150700,412500
210160,202104,3263,2783,480,3061300.54,528000,3589300.54
210170,202104,1167,941,226,1035100,248600,1283700
210173,202104,125,109,16,119900,17600,137500
210177,202104,352,201,151,221100,166100,387200
210180,202104,30,16,14,17600,15400,33000
210190,202104,427,284,143,312400,157300,469700
210193,202104,4,3,1,3300,1100,4400
210197,202104,75,54,21,59400,23100,82500
210200,202104,612,515,97,566500,106700,673200
210203,202104,216,148,68,162800,74800,237600
210207,202104,363,300,63,330000,69300,399300
210210,202104,736,681,55,749100,60500,809600
210215,202104,74,64,10,70400,11000,81400
210220,202104,380,321,59,354200,64900,419100
210230,202104,314,251,63,276100,69300,345400
210232,202104,1338,920,418,1012000,459800,1471800
210235,202104,174,132,42,145200,46200,191400
210237,202104,36,22,14,24200,15400,39600
210240,202104,93,76,17,83600,18700,102300
210250,202104,179,153,26,168300,28600,196900
210255,202104,356,271,85,298100,93500,391600
210260,202104,394,271,123,298100,135300,433400
210270,202104,642,432,210,475200,231000,706200
210275,202104,79,62,17,68200,18700,86900
210280,202104,1043,691,352,760100,387200,1147300
210290,202104,539,365,174,401500,191400,592900
210300,202104,5260,3347,1913,3683900.98,2107600,5791500.98
210310,202104,109,76,33,83600,36300,119900
210312,202104,117,81,36,89100,39600,128700
210315,202104,104,87,17,95700,18700,114400
210317,202104,134,101,33,111100,36300,147400
210320,202104,2309,1976,333,2173600,366300,2539900
210325,202104,143,90,53,99000,58300,157300
210330,202104,4506,2602,1904,2862200,2094400,4956600
210340,202104,1225,922,303,1014200,333300,1347500
210350,202104,647,541,106,595100,116600,711700
210355,202104,151,127,24,139700,26400,166100
210360,202104,2178,1520,658,1673100,723800,2396900
210370,202104,1231,610,621,671000,683100,1354100
210375,202104,192,98,94,107800,103400,211200
210380,202104,714,552,162,607200,178200,785400
210390,202104,194,167,27,183700,29700,213400
210400,202104,386,336,50,369600,55000,424600
210405,202104,980,693,287,762300,315700,1078000
210407,202104,58,47,11,51700,12100,63800
210408,202104,59,52,7,57200,7700,64900
210409,202104,323,284,39,312400,42900,355300
210410,202104,443,347,96,381700,105600,487300
210420,202104,198,164,34,180400,37400,217800
210430,202104,49,36,13,39600,14300,53900
210440,202104,340,229,111,251900,122100,374000
210450,202104,135,109,26,119900,28600,148500
210455,202104,233,124,109,136400,119900,256300
210460,202104,304,206,98,226600,107800,334400
210462,202104,67,57,10,62700,11000,73700
210465,202104,140,110,30,121000,33000,154000
210467,202104,516,381,135,419100,148500,567600
210470,202104,48,41,7,45100,7700,52800
210480,202104,1280,923,357,1015300,392700.5,1408000.5
210490,202104,195,131,64,144100,70400,214500
210500,202104,508,311,197,342100,216700,558800
210510,202104,541,436,105,479600,115500,595100
210515,202104,355,224,131,246400,144100,390500
210520,202104,398,360,38,396000,41800,437800
210530,202104,9361,4900,4461,5391100.48,4907100.83,10298201.31
210535,202104,132,99,33,108900,36300,145200
210540,202104,1514,1013,501,1116500,552200,1668700
210542,202104,1138,581,557,640200,612700,1252900
210545,202104,22,20,2,22000,2200,24200
210547,202104,128,114,14,125400,15400,140800
210550,202104,656,472,184,519200,202400,721600
210560,202104,157,138,19,151800,20900,172700
210565,202104,21,15,6,16500,6600,23100
210570,202104,1291,1051,240,1157200.59,264000,1421200.59
210580,202104,119,101,18,111100,19800,130900
210590,202104,726,606,120,666600,132000,798600
210592,202104,40,38,2,41800,2200,44000
210594,202104,112,94,18,103400,19800,123200
210596,202104,108,93,15,102300,16500,118800
210598,202104,137,103,34,113300,37400,150700
210600,202104,316,275,41,302500,45100,347600
210610,202104,256,241,15,265100,16500,281600
210620,202104,41,26,15,28600,16500,45100
210630,202104,75,72,3,79200,3300,82500
210632,202104,1020,726,294,798600,323400,1122000
210635,202104,22,19,3,20900,3300,24200
210637,202104,123,90,33,99000,36300,135300
210640,202104,578,510,68,561000,74800,635800
210650,202104,396,331,65,364100,71500,435600
210660,202104,372,294,78,323400,85800,409200
210663,202104,43,30,13,33000,14300,47300
210667,202104,100,40,60,44000,66000,110000
210670,202104,246,219,27,240900,29700,270600
210675,202104,530,290,240,319000,264000,583000
210680,202104,222,145,77,159500,84700,244200
210690,202104,616,511,105,562100,115500,677600
210700,202104,153,117,36,128700,39600,168300
210710,202104,236,151,85,166100,93500,259600
210720,202104,129,116,13,127600,14300,141900
210725,202104,62,54,8,59400,8800,68200
210730,202104,24,18,6,19800,6600,26400
210735,202104,292,212,80,233200,88000,321200
210740,202104,519,447,72,491700,79200,570900
210745,202104,153,114,39,125400,42900,168300
210750,202104,2429,1240,1189,1365100,1307900,2673000
210760,202104,254,198,56,217800,61600,279400
210770,202104,245,198,47,217800,51700,269500
210780,202104,434,325,109,358600,119900,478500
210790,202104,182,150,32,165000,35200,200200
210800,202104,174,133,41,146300,45100,191400
210805,202104,55,49,6,53900,6600,60500
210810,202104,470,381,89,419100,97900,517000
210820,202104,2103,1752,351,1927200,386100,2313300
210825,202104,153,87,66,95700,72600,168300
210830,202104,721,482,239,531300,262900,794200
210840,202104,190,134,56,147400,61600,209000
210845,202104,230,164,66,180400,72600,253000
210850,202104,749,514,235,565400,258500,823900
210860,202104,3549,2047,1502,2252800,1652200,3905000
210870,202104,430,340,90,374000,99000,473000
210880,202104,75,58,17,63800,18700,82500
210890,202104,320,279,41,306900,45100,352000
210900,202104,622,407,215,447700,236500,684200
210905,202104,61,33,28,36300,30800,67100
210910,202104,1943,1471,472,1619200.7,519200,2138400.7
210920,202104,154,62,92,68200,101200,169400
210923,202104,83,67,16,73700,17600,91300
210927,202104,416,198,218,217800,239800,457600
210930,202104,66,53,13,58300,14300,72600
210940,202104,81,63,18,69300,19800,89100
210945,202104,197,107,90,117700,99000,216700
210950,202104,524,383,141,421300,155100,576400
210955,202104,81,51,30,56100,33000,89100
210960,202104,2197,1119,1078,1230900,1185800,2416700
210970,202104,116,102,14,112200,15400,127600
210975,202104,83,77,6,84700,6600,91300
210980,202104,1075,528,547,580800,601700,1182500
210990,202104,4000,2666,1334,2933700,1467400,4401100
211000,202104,1312,1065,247,1171500,271700,1443200
211003,202104,972,703,269,773300,297000,1070300
211010,202104,492,440,52,484000,57200,541200
211020,202104,1399,608,791,668800,870100,1538900
211023,202104,38,34,4,37400,4400,41800
211027,202104,72,52,20,57200,22000,79200
211030,202104,368,264,104,290400,114400,404800
211040,202104,296,249,47,273900,51700,325600
211050,202104,1150,771,379,848100,416900,1265000
211060,202104,621,543,78,597300,85800.49,683100.49
211065,202104,21,18,3,19800,3300,23100
211070,202104,880,737,143,810700,158400,969100
211080,202104,84,82,2,90200,2200,92400
211085,202104,49,27,22,29700,24200,53900
211090,202104,74,63,11,69300,12100,81400
211100,202104,471,393,78,432300,85800,518100
211102,202104,237,169,68,185900,74800,260700
211105,202104,219,155,64,170500,70400,240900
211107,202104,125,79,46,86900,50600,137500
211110,202104,933,627,306,689700,336600,1026300
211120,202104,5225,2613,2612,2877600,2874300,5751900
211125,202104,32,22,10,24200,11000,35200
211130,202104,41109,18968,22141,20885700.31,24368300,45254000.31
211140,202104,398,349,49,383900,53900,437800
211150,202104,1172,810,362,892100,398200,1290300
211153,202104,167,105,62,115500,68200,183700
211157,202104,66,53,13,58300,14300,72600
211160,202104,689,592,97,651200,106700,757900
211163,202104,2,2,0,2200,0,2200
211167,202104,10,9,1,9900,1100,11000
211170,202104,415,308,107,338800,117700,456500
211172,202104,114,79,35,86900,38500,125400
211174,202104,254,159,95,174900,104500,279400
211176,202104,469,349,120,383900,132000,515900
211178,202104,90,60,30,66000,33000,99000
211180,202104,212,171,41,188100,45100,233200
211190,202104,73,66,7,72600,7700,80300
211195,202104,36,23,13,25300,14300,39600
211200,202104,151,131,20,144100,22000,166100
211210,202104,425,315,110,346500,121000,467500
211220,202104,4138,2463,1675,2709300.5,1842500,4551800.5
211223,202104,91,87,4,95700,4400,100100
211227,202104,63,49,14,53900,15400,69300
211230,202104,728,603,125,663300,137500,800800
211240,202104,397,316,81,347600,89100,436700
211245,202104,179,90,89,99000,97900,196900
211250,202104,1527,1323,204,1455300,224400,1679700
211260,202104,795,662,133,728200,146300,874500
211270,202104,1932,1591,341,1750100,376200,2126300
211280,202104,1747,1127,620,1239700,682000,1921700
211285,202104,202,127,75,139700,82500,222200
211290,202104,711,507,204,557700,224400,782100
211300,202104,750,598,152,657800,167200,825000
211400,202104,1521,938,583,1031800,641300,1673100
220005,202104,15,14,1,15400,1100,16500
220010,202104,84,67,17,73700,18700,92400
220020,202104,686,549,137,605000,150700,755700
220025,202104,106,103,3,113300,3300,116600
220027,202104,47,38,9,41800,9900,51700
220030,202104,112,89,23,97900,25300,123200
220040,202104,1246,948,298,1042800,327800,1370600
220045,202104,32,21,11,23100,12100,35200
220050,202104,694,579,115,636900.8,126500,763400.8
220060,202104,173,150,23,165000,25300,190300
220070,202104,111,100,11,110000,12100,122100
220080,202104,15,13,2,14300,2200,16500
220090,202104,33,27,6,29700,6600,36300
220095,202104,2,1,1,1100,1100,2200
220100,202104,19,16,3,17600,3300,20900
220105,202104,26,24,2,26400,2200,28600
220110,202104,233,212,21,233200,23100,256300
220115,202104,36,35,1,38500,1100,39600
220117,202104,21,20,1,22000,1100,23100
220120,202104,1462,1122,340,1235300,374000,1609300
220130,202104,30,29,1,31900,1100,33000
220140,202104,99,79,20,86900,22000,108900
220150,202104,492,368,124,405900,136400,542300
220155,202104,8,7,1,7700,1100,8800
220157,202104,20,16,4,17600,4400,22000
220160,202104,92,81,11,89100,12100,101200
220170,202104,34,31,3,34100,3300,37400
220173,202104,8,8,0,8800,0,8800
220177,202104,10,9,1,9900,1100,11000
220180,202104,67,65,2,71500,2200,73700
220190,202104,1073,944,129,1038400,141900,1180300
220191,202104,41,34,7,37400,7700,45100
220192,202104,86,82,4,90200,4400,94600
220194,202104,60,55,5,60500,5500,66000
220196,202104,97,82,15,90200,16500,106700
220198,202104,3,2,1,2200,1100,3300
220200,202104,410,344,66,378400,72600,451000
220202,202104,38,33,5,36300,5500,41800
220205,202104,56,49,7,53900,7700,61600
220207,202104,13,13,0,14300,0,14300
220208,202104,74,42,32,46200,35200,81400
220209,202104,31,26,5,28600,5500,34100
220210,202104,22,15,7,16500,7700,24200
220211,202104,27,25,2,27500,2200,29700
220213,202104,40,35,5,38500,5500,44000
220217,202104,37,28,9,30800,9900,40700
220220,202104,2198,1454,744,1600500,821700,2422200
220225,202104,8,3,5,3300,5500,8800
220230,202104,969,746,223,820600,245300,1065900
220240,202104,159,141,18,155100,19800,174900
220245,202104,33,30,3,33000.18,3300,36300.18
220250,202104,125,107,18,117700,19800,137500
220253,202104,46,39,7,42900,7700,50600
220255,202104,38,33,5,36300,5500,41800
220260,202104,705,528,177,580800,194700,775500
220265,202104,6,4,2,4400,2200,6600
220270,202104,762,687,75,757900,82500,840400
220271,202104,44,36,8,39600,8800,48400
220272,202104,22,22,0,25300,0,25300
220273,202104,17,15,2,16500,2200,18700
220275,202104,57,47,10,51700,11000,62700
220277,202104,19,13,6,14300,6600,20900
220280,202104,17,11,6,12100,6600,18700
220285,202104,41,39,2,42900,2200,45100
220290,202104,1476,1269,207,1397000,227700,1624700
220300,202104,34,33,1,36300,1100,37400
220310,202104,326,278,48,305800,52800,358600
220320,202104,445,412,33,454300,36300,490600
220323,202104,1,0,1,0,1100,1100
220325,202104,10,9,1,9900,1100,11000
220327,202104,10,10,0,11000,0,11000
220330,202104,233,169,64,185900,70400,256300
220335,202104,143,125,18,137500,19800,157300
220340,202104,39,27,12,29700,13200,42900
220342,202104,57,49,8,53900,8800,62700
220345,202104,79,71,8,78100,8800,86900
220350,202104,444,383,61,421300,67100,488400
220360,202104,39,29,10,31900,11000,42900
220370,202104,1241,1026,215,1129700,236500,1366200
220375,202104,19,17,2,18700,2200,20900
220380,202104,23,17,6,18700,6600,25300
220385,202104,14,13,1,14300,1100,15400
220390,202104,2303,1308,995,1438800,1095600.25,2534400.25
220400,202104,33,29,4,31900,4400,36300
220410,202104,21,19,2,20900,2200,23100
220415,202104,13,11,2,12100,2200,14300
220420,202104,127,106,21,116600,23100,139700
220430,202104,128,114,14,125400,15400,140800
220435,202104,24,17,7,18700,7700,26400
220440,202104,289,245,44,269500,48400,317900
220450,202104,338,170,168,187000,184800,371800
220455,202104,51,50,1,55000,1100,56100
220460,202104,18,17,1,18700,1100,19800
220465,202104,88,58,30,63800,33000,96800
220470,202104,247,213,34,234300,37400,271700
220480,202104,72,65,7,71500,7700,79200
220490,202104,87,74,13,81400,14300,95700
220500,202104,107,92,15,101200,16500,117700
220510,202104,408,317,91,348700,101200,449900
220515,202104,19,17,2,18700,2200,20900
220520,202104,370,330,40,363000,44000,407000
220525,202104,11,7,4,7700,4400,12100
220527,202104,17,14,3,15400,3300,18700
220530,202104,35,14,21,15400,23100,38500
220535,202104,5,4,1,4400,1100,5500
220540,202104,70,58,12,63800,13200,77000
220545,202104,39,26,13,28600,14300,42900
220550,202104,716,566,150,622600,165000,787600
220551,202104,18,14,4,15400,4400,19800
220552,202104,15,15,0,16500,0,16500
220553,202104,56,51,5,56100,5500,61600
220554,202104,11,8,3,8800,3300,12100
220555,202104,37,30,7,33000,7700,40700
220556,202104,40,37,3,40700,3300,44000
220557,202104,56,52,4,57200,4400,61600
220558,202104,7,3,4,3300,4400,7700
220559,202104,3,3,0,3300,0,3300
220560,202104,69,45,24,49500,26400,75900
220570,202104,733,456,277,501600,304700,806300
220580,202104,550,502,48,552200,52800,605000
220585,202104,9,8,1,8800,1100,9900
220590,202104,13,13,0,14300,0,14300
220595,202104,64,48,16,52800,17600,70400
220600,202104,20,12,8,13200,8800,22000
220605,202104,23,20,3,22000,3300,25300
220610,202104,79,66,13,72600,14300,86900
220620,202104,550,458,92,503800,102300,606100
220630,202104,5,4,1,4400,1100,5500
220635,202104,36,31,5,34100,5500,39600
220640,202104,103,85,18,93500,19800,113300
220650,202104,112,106,6,116600,6600,123200
220660,202104,58,46,12,50600,13200,63800
220665,202104,6,6,0,6600,0,6600
220667,202104,21,19,2,20900,2200,23100
220669,202104,27,23,4,25300,4400,29700
220670,202104,64,52,12,58300,13200,71500
220672,202104,77,55,22,60500,24200,84700
220675,202104,36,28,8,30800,8800,39600
220680,202104,44,38,6,41800,6600,48400
220690,202104,47,44,3,48400,3300,51700
220695,202104,29,16,13,17600,14300,31900
220700,202104,1717,1332,385,1465200,424600,1889800
220710,202104,6,4,2,4400,2200,6600
220720,202104,109,91,18,100100,19800,119900
220730,202104,18,17,1,18700,1100,19800
220735,202104,4,0,4,0,4400,4400
220740,202104,47,43,4,47300,4400,51700
220750,202104,114,97,17,106700,18700,125400
220755,202104,14,13,1,14300,1100,15400
220760,202104,68,61,7,67100,7700,74800
220770,202104,5748,3156,2592,3473800.7,2851200,6325000.7
220775,202104,16,10,6,11000,6600,17600
220777,202104,19,18,1,19800,1100,20900
220779,202104,1,0,1,0,1100,1100
220780,202104,895,765,130,841500,145200,986700
220785,202104,5,1,4,1100,4400,5500
220790,202104,1097,862,235,948200,258500,1206700
220793,202104,6,6,0,6600,0,6600
220795,202104,12,11,1,12100,1100,13200
220800,202104,4021,3093,928,3406904,1021900,4428804
220810,202104,66,58,8,63800,8800,72600
220820,202104,239,217,22,238700,24200,262900
220830,202104,1257,1086,171,1194600,188100,1382700
220840,202104,2404,1678,726,1846900,799700,2646600
220850,202104,62,54,8,59400,8800,68200
220855,202104,8,4,4,4400,4400,8800
220860,202104,12,10,2,11000,2200,13200
220865,202104,26,24,2,26400,2200,28600
220870,202104,79,70,9,77000,9900,86900
220880,202104,324,260,64,286000,70400,356400
220885,202104,31,29,2,31900,2200,34100
220887,202104,12,11,1,12100,1100,13200
220890,202104,96,83,13,91300,14300,105600
220900,202104,25,15,10,16500,11000,27500
220910,202104,52,43,9,47300,9900,57200
220915,202104,9,8,1,8800,1100,9900
220920,202104,48,42,6,46200,6600,52800
220930,202104,45,44,1,48400,1100,49500
220935,202104,15,15,0,16500,0,16500
220937,202104,33,32,1,35200,1100,36300
220940,202104,53,49,4,53900,4400,58300
220945,202104,2,2,0,2200,0,2200
220950,202104,38,30,8,33000,8800,41800
220955,202104,24,20,4,22000,4400,26400
220960,202104,17,17,0,18700,0,18700
220965,202104,36,32,4,35200,4400,39600
220970,202104,61,51,10,56100,11000,67100
220975,202104,16,14,2,15400,2200,17600
220980,202104,32,30,2,33000,2200,35200
220985,202104,61,55,6,60500,6600,67100
220987,202104,31,30,1,33000,1100,34100
220990,202104,27,26,1,28600,1100,29700
220995,202104,17,14,3,15400,3300,18700
220997,202104,63,53,10,59400,11000,70400
221000,202104,1186,1069,117,1175900,128700,1304600
221005,202104,44,40,4,44000,4400,48400
221010,202104,17,13,4,14300,4400,18700
221020,202104,37,36,1,39600,1100,40700
221030,202104,39,31,8,34100,8800,42900
221035,202104,22,22,0,24200,0,24200
221037,202104,13,9,4,9900,4400,14300
221038,202104,28,25,3,27500,3300,30800
221039,202104,26,25,1,27500,1100,28600
221040,202104,268,228,40,250800,44000,294800
221050,202104,236,196,40,215600,44000,259600
221060,202104,1880,1637,243,1801800,267300,2069100
221062,202104,34,32,2,35200,2200,37400
221063,202104,13,8,5,8800,5500,14300
221065,202104,63,50,13,55000,14300,69300
221070,202104,136,120,16,132000,17600,149600
221080,202104,372,319,53,350900,58300,409200
221090,202104,23,19,4,20900,4400,25300
221093,202104,43,32,11,35200,12100,47300
221095,202104,5,5,0,5500,0,5500
221097,202104,13,11,2,12100,2200,14300
221100,202104,25599,15232,10367,16765100.63,11411950,28177050.63
221110,202104,1102,838,264,921800,291500,1213300
221120,202104,543,399,144,438900,158400,597300
221130,202104,967,777,190,855800,210100,1065900
221135,202104,34,30,4,33000,4400,37400
221140,202104,46,40,6,44000,6600,50600
221150,202104,11,9,2,9900,2200,12100
221160,202104,12,12,0,13200,0,13200
221170,202104,17,17,0,18700,0,18700
230010,202104,149,136,13,149600,14300,163900
230015,202104,133,108,25,118800,27500,146300
230020,202104,1631,1370,261,1507000,287100,1794100
230030,202104,1684,1203,481,1323300,530200,1853500
230040,202104,224,189,35,207900,38500,246400
230050,202104,234,172,62,189200,68200,257400
230060,202104,162,127,35,139700,39600,179300
230070,202104,301,258,43,283800,47300,331100
230075,202104,851,736,115,810700,126500,937200
230080,202104,193,166,27,182600,29700,212300
230090,202104,135,98,37,107800,40700,148500
230100,202104,2205,1261,944,1387100,1039500,2426600
230110,202104,2843,1825,1018,2008600,1119800,3128400
230120,202104,1030,812,218,893200,239800,1133000
230125,202104,155,125,30,137500,33000,170500
230130,202104,479,427,52,469700,57200,526900
230140,202104,220,184,36,202400,39600,242000
230150,202104,154,117,37,128700,40700,169400
230160,202104,947,800,147,880000,162800,1042800
230170,202104,610,546,64,601700,70400,672100
230180,202104,75,68,7,74800,7700,82500
230185,202104,412,355,57,390500,62700,453200
230190,202104,2394,1873,521,2061400.32,573100,2634500.32
230195,202104,497,431,66,474100,72600,546700
230200,202104,416,338,78,371800,85800,457600
230205,202104,387,259,128,284900,140800,425700
230210,202104,1371,1066,305,1173700,335500,1509200
230220,202104,1567,1066,501,1173700,551100,1724800
230230,202104,975,821,154,903100,169400,1072500
230240,202104,1792,1550,242,1706375,266200,1972575
230250,202104,1794,1470,324,1617000,356400,1973400
230260,202104,3206,1988,1218,2190100,1340900,3531000
230270,202104,1389,1109,280,1219900.05,309100,1529000.05
230280,202104,2765,2084,681,2292400,751300,3043700
230290,202104,403,360,43,396000.5,47300,443300.5
230300,202104,525,379,146,416900,160600,577500
230310,202104,414,317,97,348700,106700,455400
230320,202104,920,780,140,859100,154000,1013100
230330,202104,312,251,61,276100,67100,343200
230340,202104,446,361,85,397100,93500,490600
230350,202104,3221,2024,1197,2226400,1316700,3543100
230360,202104,275,223,52,245300,57200,302500
230365,202104,132,109,23,119900,25300,145200
230370,202104,10230,5011,5219,5514301.77,5742000,11256301.77
230380,202104,496,422,74,464200,81400,545600
230390,202104,541,305,236,335500,259600,595100
230393,202104,248,206,42,226600,46200,272800
230395,202104,349,280,69,308000,75900,383900
230400,202104,620,494,126,543400,138600,682000
230410,202104,2670,1662,1008,1830400.5,1109900,2940300.5
230420,202104,6331,4182,2149,4602401.62,2365000,6967401.62
230423,202104,342,298,44,327800,48400,376200
230425,202104,436,355,81,390500,89100,479600
230426,202104,118,95,23,104500,25300,129800
230427,202104,74,70,4,77000,4400,81400
230428,202104,1534,754,780,829400,859100,1688500
230430,202104,454,369,85,407000,93500,500500
230435,202104,903,654,249,719400,273900.24,993300.24
230440,202104,90022,40260,49762,44312288.77,54813001.63,99125290.40
230445,202104,317,215,102,236500,112200,348700
230450,202104,574,453,121,498300,133100,631400
230460,202104,71,52,19,57200,20900,78100
230465,202104,306,247,59,272800,64900,337700
230470,202104,2020,1589,431,1749000,474100,2223100
230480,202104,153,144,9,158400,9900,168300
230490,202104,317,248,69,273900,75900,349800
230495,202104,461,339,122,372900,134200,507100
230500,202104,1026,756,270,831600,298100,1129700
230510,202104,57,44,13,48400,14300,62700
230520,202104,389,305,84,335500,92400,427900
230523,202104,2368,1468,900,1614800,992200.28,2607000.28
230526,202104,270,230,40,253000,44000,297000
230530,202104,689,511,178,563200,195800,759000
230533,202104,213,197,16,216700,17600,234300
230535,202104,367,273,94,300300,103400,403700
230540,202104,1813,1614,199,1775400,218900,1994300
230550,202104,3873,2478,1395,2726900,1535600,4262500
230560,202104,576,433,143,477400,158400,635800
230565,202104,223,163,60,179300,66000,245300
230570,202104,286,251,35,276100,38500,314600
230580,202104,1177,851,326,938300,359700,1298000
230590,202104,1000,780,220,858000,242000,1100000
230600,202104,246,225,21,248600,23100,271700
230610,202104,392,297,95,326700,104500,431200
230620,202104,205,175,30,192500,33000,225500
230625,202104,786,540,246,594000,270600,864600
230630,202104,1326,1023,303,1125300,333300,1458600
230640,202104,3824,3226,598,3549700,658900,4208600
230650,202104,465,399,66,438900,72600,511500
230655,202104,701,586,115,644600,126500,771100
230660,202104,362,299,63,328900,69300,398200
230670,202104,448,379,69,418000,75900,493900
230680,202104,202,182,20,200200,22000,222200
230690,202104,913,770,143,848100,157300,1005400
230700,202104,861,723,138,795300,151800,947100
230710,202104,695,656,39,721600,42900,764500
230720,202104,152,130,22,143000,24200,167200
230725,202104,220,165,55,181500,60500,242000
230730,202104,12336,6634,5702,7299531.32,6277700.82,13577232.14
230740,202104,679,548,131,602800,144100,746900
230750,202104,830,701,129,771100,141900,913000
230760,202104,1455,1247,208,1372800,228800,1601600
230763,202104,338,278,60,305800,66000,371800
230765,202104,7694,3569,4125,3930300.6,4547400,8477700.6
230770,202104,4991,2553,2438,2811600.76,2686200,5497800.76
230780,202104,737,648,89,712800,97900,810700
230790,202104,297,249,48,273900,52800,326700
230800,202104,1152,828,324,913000,358600,1271600
230810,202104,1363,1200,163,1320000,179300,1499300
230820,202104,363,250,113,275000,124300,399300
230830,202104,968,822,146,904200,160600,1064800
230835,202104,281,241,40,265100,44000,309100
230837,202104,173,144,29,158400,31900,190300
230840,202104,932,725,207,797500,227700,1025200
230850,202104,1468,1265,203,1391500,223300,1614800
230860,202104,303,227,76,249700,83600,333300
230870,202104,1835,1557,278,1714900,305800,2020700
230880,202104,67,52,15,57200,16500,73700
230890,202104,544,494,50,543400,55000,598400
230900,202104,274,203,71,223300,79200.7,302500.7
230910,202104,222,171,51,189200,56100,245300
230920,202104,427,340,87,375100,95700,470800
230930,202104,993,696,297,768900,326700,1095600
230940,202104,849,657,192,722700,211200,933900
230945,202104,523,421,102,463100,112200,575300
230950,202104,422,367,55,403700,60500,464200
230960,202104,2668,1789,879,1970100,968000,2938100
230970,202104,1699,951,748,1046100,822800,1868900
230980,202104,199,163,36,181500,39600,221100
230990,202104,138,110,28,121000,30800,151800
231000,202104,193,177,16,194700,17600,212300
231010,202104,159,111,48,122100,52800,174900
231020,202104,1363,936,427,1030700.07,470800,1501500.07
231025,202104,1064,780,284,858000,312400,1170400
231030,202104,1087,906,181,996600,199100,1195700
231040,202104,143,95,48,104500,52800,157300
231050,202104,948,836,112,919600,123200,1042800
231060,202104,158,132,26,145200,28600,173800
231070,202104,1477,1030,447,1133000,495000,1628000
231080,202104,264,240,24,264000,26400,290400
231085,202104,629,383,246,421300.13,270600,691900.13
231090,202104,253,202,51,222200,56100,278300
231095,202104,170,134,36,147400,39600,187000
231100,202104,152,126,26,138600,28600,167200
231110,202104,369,312,57,343200,62700,405900
231120,202104,270,231,39,254100,42900,297000
231123,202104,153,144,9,158400,9900,168300
231126,202104,334,258,76,283800,83600,367400
231130,202104,4806,3758,1048,4136000,1152800,5288800
231135,202104,215,187,28,205700,30800,236500
231140,202104,3070,2232,838,2457400,922900,3380300
231150,202104,373,349,24,383900,26400,410300
231160,202104,1206,965,241,1061500,265100,1326600
231170,202104,515,359,156,394900,171600,566500
231180,202104,1718,1478,240,1626900,264000,1890900
231190,202104,206,174,32,191400,35200,226600
231195,202104,219,184,35,202400,39600,242000
231200,202104,798,655,143,720500,157300,877800
231210,202104,578,487,91,535700,100100,635800
231220,202104,1042,761,281,837100.85,310200,1147300.85
231230,202104,1467,1147,320,1261700,352000,1613700
231240,202104,1462,1034,428,1139600,473000,1612600
231250,202104,107,99,8,108900,8800,117700
231260,202104,269,176,93,193600,102300,295900
231270,202104,995,800,195,881100,214500,1095600
231280,202104,75,58,17,63800,18700,82500
231290,202104,7697,4334,3363,4771800,3701500.57,8473300.57
231300,202104,610,565,45,621500,50600,672100
231310,202104,748,686,62,754600.81,68200,822800.81
231320,202104,595,447,148,491700,162800,654500
231325,202104,103,90,13,99000,15400,114400
231330,202104,1966,1520,446,1672275.74,491700,2163975.74
231335,202104,255,224,31,246400,34100,280500
231340,202104,1731,1260,471,1387100,519200,1906300
231350,202104,1305,1052,253,1158300,278300,1436600
231355,202104,433,368,65,404800,71500,476300
231360,202104,518,372,146,409200.65,160600,569800.65
231370,202104,88,77,11,84700,12100,96800
231375,202104,292,212,80,233200,88000,321200
231380,202104,493,392,101,431200,112200,543400
231390,202104,210,160,50,176000,55000,231000
231395,202104,749,474,275,521400,305800,827200
231400,202104,1132,938,194,1032900,213400,1246300
231410,202104,1339,1102,237,1213300,260700,1474000
240010,202104,384,169,215,185900.97,236500,422400.97
240020,202104,2241,1816,425,1998700,467500.55,2466200.55
240030,202104,123,102,21,112200,23100,135300
240040,202104,33,33,0,36300,0,36300
240050,202104,530,451,79,496100,86900,583000
240060,202104,66,62,4,68200,4400,72600
240070,202104,229,179,50,196900,55000,251900
240080,202104,533,361,172,398200,189200.7,587400.7
240090,202104,104,93,11,102300,12100,114400
240100,202104,1496,1409,87,1552100.5,95700,1647800.5
240110,202104,1037,679,358,748000.61,393800,1141800.61
240120,202104,140,109,31,119900,34100,154000
240130,202104,274,253,21,278300,23100,301400
240140,202104,81,57,24,62700,26400,89100
240145,202104,735,650,85,715000,93500,808500
240150,202104,22,17,5,18700,5500,24200
240160,202104,42,34,8,37400,8800,46200
240165,202104,36,28,8,30800,8800,39600
240170,202104,114,77,37,84700,40700,125400
240180,202104,95,71,24,78100,26400,104500
240185,202104,42,38,4,41800,4400,46200
240190,202104,16,14,2,15400,2200,17600
240200,202104,3054,1697,1357,1866700,1494900,3361600
240210,202104,169,129,40,143000,44000,187000
240220,202104,1102,796,306,875600,336600,1212200
240230,202104,845,771,74,848100,81400,929500
240240,202104,70,50,20,55000,22000,77000
240250,202104,92,80,12,88000,13200,101200
240260,202104,1795,1324,471,1456400,518100,1974500
240270,202104,186,164,22,180400,24200,204600
240280,202104,49,38,11,41800,12100,53900
240290,202104,47,45,2,49500,2200,51700
240300,202104,176,98,78,107800,85800,193600
240310,202104,2363,1288,1075,1417900.19,1183600,2601500.19
240320,202104,188,175,13,192500,14300,206800
240325,202104,4574,2706,1868,2978801.85,2059200,5038001.85
240330,202104,72,68,4,74800,4400,79200
240340,202104,78,53,25,58300,27500,85800
240350,202104,96,83,13,91300,14300,105600
240360,202104,564,348,216,382800,237600,620400
240370,202104,54,50,4,55000,4400,59400
240375,202104,63,38,25,41800,27500,69300
240380,202104,231,188,43,206800,47300,254100
240390,202104,12,11,1,12100,1100,13200
240400,202104,82,74,8,81400,8800,90200
240410,202104,13,7,6,7700,6600,14300
240420,202104,1026,750,276,825000,303600,1128600
240430,202104,261,245,16,269500,17600,287100
240440,202104,124,70,54,77000,59400,136400
240450,202104,231,153,78,168300,85800,254100
240460,202104,72,56,16,61600,17600,79200
240470,202104,237,212,25,234300,27500,261800
240480,202104,17,15,2,16500,2200,18700
240485,202104,82,67,15,73700,16500,90200
240490,202104,45,43,2,47300,2200,49500
240500,202104,89,66,23,72600,25300,97900
240510,202104,43,31,12,34100,13200,47300
240520,202104,108,103,5,113300,5500,118800
240530,202104,55,48,7,52800,7700,60500
240540,202104,81,69,12,75900,13200,89100
240550,202104,13,12,1,13200,1100,14300
240560,202104,377,274,103,301400,113300,414700
240570,202104,440,278,162,306900,178200,485100
240580,202104,1298,1019,279,1120900,306900,1427800
240590,202104,31,29,2,31900,2200,34100
240600,202104,103,99,4,108900,4400,113300
240610,202104,514,432,82,475200,90200,565400
240615,202104,18,17,1,18700,1100,19800
240620,202104,89,86,3,94600,3300,97900
240630,202104,40,34,6,37400,6600,44000
240640,202104,25,20,5,22000,5500,27500
240650,202104,242,200,42,221100,46200,267300
240660,202104,112,95,17,104500,18700,123200
240670,202104,314,177,137,194700,150700,345400
240680,202104,51,38,13,41800,14300,56100
240690,202104,46,43,3,47300,3300,50600
240700,202104,184,150,34,165000,37400,202400
240710,202104,2045,1252,793,1377200,872300,2249500
240720,202104,1065,780,285,858000,313500,1171500
240725,202104,65,61,4,67100,4400,71500
240730,202104,149,124,25,136400,27500,163900
240740,202104,230,195,35,214500,38500,253000
240750,202104,47,27,20,29700,23100,52800
240760,202104,47,42,5,46200,6600,52800
240770,202104,150,117,33,128700,36300,165000
240780,202104,695,579,116,636900,127600,764500
240790,202104,41,39,2,42900,2200,45100
240800,202104,9338,6325,3013,6964100.85,3315400,10279500.85
240810,202104,20681,11129,9552,12249600,10514900,22764500
240820,202104,242,145,97,159500.2,106700,266200.2
240830,202104,1616,1328,288,1460800,316800,1777600
240840,202104,77,67,10,73700,11000,84700
240850,202104,83,74,9,81400,9900,91300
240860,202104,106,102,4,112200,4400,116600
240870,202104,58,50,8,55000,8800,63800
240880,202104,31,28,3,30800,3300,34100
240890,202104,1143,648,495,712800,544500,1257300
240895,202104,59,42,17,46200,18700,64900
240910,202104,162,141,21,155100,23100,178200
240920,202104,14,11,3,12100,3300,15400
240930,202104,410,367,43,404800,47300,452100
240933,202104,52,34,18,37400,19800,57200
240940,202104,2359,2091,268,2301475,294800,2596275
240950,202104,47,42,5,46200,5500,51700
240960,202104,26,21,5,23100,5500,28600
240970,202104,114,84,30,92400,34100,126500
240980,202104,198,159,39,174900,42900,217800
240990,202104,132,88,44,96800,48400,145200
241000,202104,61,58,3,63800,3300,67100
241010,202104,77,59,18,64900,19800,84700
241020,202104,112,103,9,113300,9900,123200
241025,202104,16,8,8,8800,8800,17600
241030,202104,116,92,24,101200,26400,127600
241040,202104,43,31,12,34100,13200,47300
241050,202104,81,73,8,80300,8800,89100
241060,202104,28,23,5,25300,5500,30800
241070,202104,16,16,0,17600,0,17600
241080,202104,62,55,7,60500,7700,68200
241090,202104,54,45,9,49500,9900,59400
241100,202104,72,61,11,67100,12100,79200
241105,202104,9,3,6,3300,6600,9900
241110,202104,48,43,5,47300,5500,52800
241120,202104,1503,1138,365,1252900,401500,1654400
241140,202104,223,187,36,205700,39600,245300
241142,202104,41,34,7,37400,7700,45100
241150,202104,1196,1049,147,1153900,161700,1315600
241160,202104,18,17,1,18700,1100,19800
241170,202104,47,39,8,42900,8800,51700
241180,202104,44,37,7,40700,7700,48400
241190,202104,38,36,2,39600,2200,41800
241200,202104,4007,2093,1914,2302300.53,2108700,4411000.53
241210,202104,67,58,9,63800,9900,73700
241220,202104,1437,962,475,1058200.43,522500,1580700.43
241230,202104,247,204,43,224400,47300,271700
241240,202104,54,42,12,46200,13200,59400
241250,202104,1135,1039,96,1142900,105600,1248500
241255,202104,51,40,11,44000,12100,56100
241260,202104,683,526,157,578600,172700,751300
241270,202104,64,45,19,49500,20900,70400
241280,202104,94,83,11,91300,12100,103400
241290,202104,130,90,40,99000,44000,143000
241300,202104,81,55,26,60500,28600,89100
241310,202104,52,38,14,41800,15400,57200
241320,202104,32,19,13,20900,14300,35200
241330,202104,64,54,10,59400,11000,70400
241335,202104,76,69,7,75900,7700,83600
241340,202104,185,136,49,149600,53900,203500
241350,202104,62,53,9,58300,9900,68200
241355,202104,49,42,7,46200,7700,53900
241360,202104,49,48,1,52800,1100,53900
241370,202104,56,44,12,48400,13200,61600
241380,202104,34,30,4,33000,4400,37400
241390,202104,82,63,19,69300,20900,90200
241400,202104,220,173,47,190300,51700,242000
241410,202104,182,164,18,180400,19800,200200
241415,202104,101,83,18,91300,19800,111100
241420,202104,104,79,25,86900,27500,114400
241430,202104,26,24,2,26400,2200,28600
241440,202104,536,441,95,485100,104500,589600
241445,202104,39,34,5,37400,5500,42900
241450,202104,264,218,46,239800,50600,290400
241460,202104,146,133,13,146300,14300,160600
241470,202104,36,31,5,34100,5500,39600
241475,202104,52,49,3,53900,3300,57200
241480,202104,100,71,29,78100,31900,110000
241490,202104,11,10,1,11000,1100,12100
241500,202104,45,34,11,37400,12100,49500
250010,202104,104,89,15,97900,16500,114400
250020,202104,30,27,3,29700,3300,33000
250030,202104,898,669,229,735900,253000,988900
250040,202104,385,318,67,349800,73700,423500
250050,202104,259,210,49,231000,53900,284900
250053,202104,56,43,13,47300,14300,61600
250057,202104,1,1,0,1100,0,1100
250060,202104,601,431,170,474100,187000,661100
250070,202104,702,563,139,620400.22,152900,773300.22
250073,202104,7,7,0,7700,0,7700
250077,202104,175,130,45,143000,49500,192500
250080,202104,429,340,89,375100,97900,473000
250090,202104,222,143,79,157300,86900,244200
250100,202104,529,440,89,484000,97900,581900
250110,202104,636,483,153,531300,168300,699600
250115,202104,17,4,13,4400,14300,18700
250120,202104,121,88,33,96800,36300,133100
250130,202104,575,461,114,507100,125400,632500
250135,202104,19,11,8,12100,8800,20900
250140,202104,86,76,10,83600,11000,94600
250150,202104,600,430,170,473000,187000,660000
250153,202104,11,8,3,8800,3300,12100
250157,202104,33,27,6,29700,6600,36300
250160,202104,228,181,47,199100,51700,250800
250170,202104,66,43,23,47300,25300,72600
250180,202104,4416,3001,1415,3301100,1557600,4858700
250190,202104,828,548,280,602800,308000,910800
250200,202104,54,43,11,47300,12100,59400
250205,202104,23,20,3,22000,3300,25300
250210,202104,86,75,11,83600,12100,95700
250215,202104,67,52,15,57200,16500,73700
250220,202104,25,18,7,19800,7700,27500
250230,202104,78,70,8,77000,8800,85800
250240,202104,238,190,48,209000,52800,261800
250250,202104,387,330,57,363000,62700,425700
250260,202104,45,37,8,40700,8800,49500
250270,202104,74,53,21,58300,23100,81400
250280,202104,380,309,71,339900,78100,418000
250290,202104,92,84,8,92400,8800,101200
250300,202104,557,376,181,414700,199100,613800
250310,202104,48,41,7,45100,8800,53900
250320,202104,1934,1295,639,1427800,702900,2130700
250330,202104,102,86,16,94600,17600,112200
250340,202104,26,24,2,26400,2200,28600
250350,202104,184,121,63,134200,69300,203500
250355,202104,30,23,7,25300,7700,33000
250360,202104,199,163,36,179300,39600,218900
250370,202104,2398,1566,832,1723700,915200,2638900
250375,202104,11,6,5,6600,5500,12100
250380,202104,55,43,12,47300,13200,60500
250390,202104,45,35,10,38500,11000,49500
250400,202104,16463,8294,8169,9137681.69,8998000,18135681.69
250403,202104,323,259,64,284900,70400,355300
250407,202104,63,51,12,56100,13200,69300
250410,202104,29,25,4,27500,4400,31900
250415,202104,41,28,13,31900,14300,46200
250420,202104,43,37,6,40700,6600,47300
250430,202104,1446,1245,201,1369775,221100,1590875
250435,202104,20,14,6,15400,6600,22000
250440,202104,684,567,117,623700,128700,752400
250450,202104,83,64,19,70400,20900,91300
250460,202104,474,309,165,339900,181500,521400
250470,202104,96,66,30,72600,33000,105600
250480,202104,335,268,67,294800,73700,368500
250485,202104,2,2,0,2200,0,2200
250490,202104,228,184,44,202400,48400,250800
250500,202104,97,72,25,79200,27500,106700
250510,202104,782,624,158,686400,173800,860200
250520,202104,175,119,56,130900,61600,192500
250523,202104,122,98,24,107800,26400,134200
250527,202104,106,84,22,92400,24200,116600
250530,202104,9,6,3,6600,3300,9900
250535,202104,30,22,8,24200,8800,33000
250540,202104,137,109,28,119900,30800,150700
250550,202104,74,71,3,78100,3300,81400
250560,202104,53,36,17,39600,18700,58300
250570,202104,164,135,29,148500,31900,180400
250580,202104,103,80,23,88071,25300,113371
250590,202104,24,14,10,15400,11000,26400
250600,202104,1444,951,493,1046100.7,542300,1588400.7
250610,202104,162,134,28,147400,30800,178200
250620,202104,21,17,4,18700,4400,23100
250625,202104,73,55,18,60500,19800,80300
250630,202104,3106,1989,1117,2189000.62,1228700,3417700.62
250640,202104,223,178,45,196900,49500,246400
250650,202104,30,20,10,22000,11000,33000
250660,202104,55,40,15,44000,16500,60500
250670,202104,65,48,17,52800,18700,71500
250680,202104,416,336,80,369600,89100,458700
250690,202104,2085,1443,642,1588400.7,706200,2294600.7
250700,202104,931,804,127,885500,139700,1025200
250710,202104,444,346,98,380600,107800,488400
250720,202104,118,86,32,94600,36300,130900
250730,202104,395,329,66,361900,72600,434500
250740,202104,57,54,3,59400,3300,62700
250750,202104,22591,13491,9100,14849881.41,10019900,24869781.41
250760,202104,103,81,22,89100,24200,113300
250770,202104,360,236,124,259600,136400,396000
250780,202104,68,45,23,49500,25300,74800
250790,202104,457,296,161,326700,177100,503800
250800,202104,155,140,15,154000,16500,170500
250810,202104,74,59,15,64900,16500,81400
250820,202104,150,125,25,137500,27500,165000
250830,202104,440,293,147,322300,161700,484000
250840,202104,56,50,6,55000,6600,61600
250850,202104,56,46,10,50600,11000,61600
250855,202104,16,14,2,15400,2200,17600
250860,202104,248,153,95,169400,104500,273900
250870,202104,27,24,3,26400,3300,29700
250880,202104,89,64,25,70400,27500,97900
250890,202104,2927,2181,746,2400200,821700,3221900
250900,202104,52,43,9,47300,9900,57200
250905,202104,122,92,30,101200,34100,135300
250910,202104,1097,802,295,882200,325600,1207800
250915,202104,99,72,27,79200,29700,108900
250920,202104,140,104,36,114400,39600,154000
250930,202104,176,102,74,112200,81400,193600
250933,202104,6,4,2,4400,2200,6600
250937,202104,10,10,0,11000,0,11000
250939,202104,30,22,8,24200,8800,33000
250940,202104,104,76,28,84700,30800,115500
250950,202104,74,49,25,53900,27500,81400
250960,202104,93,52,41,57200,45100,102300
250970,202104,1229,870,359,958100,394900,1353000
250980,202104,104,68,36,74800,39600,114400
250990,202104,171,131,40,144100,44000,188100
251000,202104,73,65,8,71500,8800,80300
251010,202104,114,85,29,93500,31900,125400
251020,202104,74,60,14,66000,15400,81400
251030,202104,46,35,11,38500,12100,50600
251040,202104,56,38,18,41800,19800,61600
251050,202104,24,21,3,23100,3300,26400
251060,202104,49,40,9,44000,9900,53900
251065,202104,5,3,2,3300,2200,5500
251070,202104,18,15,3,16500,3300,19800
251080,202104,5075,2421,2654,2665300,2922700.1,5588000.1
251090,202104,181,154,27,169400,29700,199100
251100,202104,19,19,0,20900,0,20900
251110,202104,49,38,11,41800,12100,53900
251120,202104,1872,1146,726,1260600,798600,2059200
251130,202104,417,340,77,374000,84700,458700
251140,202104,565,364,201,400400,221100,621500
251150,202104,345,290,55,319000,60500,379500
251160,202104,96,79,17,86900,18700,105600
251170,202104,100,79,21,86900,23100,110000
251180,202104,288,175,113,192500,124300,316800
251190,202104,203,130,73,143000,80300,223300
251200,202104,275,221,54,243100,59400,302500
251203,202104,33,31,2,34100,2200,36300
251207,202104,84,69,15,77000,16500,93500
251210,202104,1468,1076,392,1184700,431200,1615900
251220,202104,49,38,11,41800,12100,53900
251230,202104,594,493,101,542300,112200,654500
251240,202104,103,74,29,81400,31900,113300
251250,202104,1428,1032,396,1135200,435600,1570800
251260,202104,12,7,5,7700,5500,13200
251270,202104,317,247,70,271700,77000,348700
251272,202104,63,56,7,61600,7700,69300
251274,202104,29,22,7,24200,7700,31900
251275,202104,35,20,15,22000,16500,38500
251276,202104,17,14,3,15400,3300,18700
251278,202104,9,7,2,7700,2200,9900
251280,202104,103,97,6,106700,6600,113300
251290,202104,874,622,252,684200,277200,961400
251300,202104,16,12,4,13200,4400,17600
251310,202104,292,215,77,236500,84700,321200
251315,202104,34,30,4,33000,4400,37400
251320,202104,66,50,16,55000,17600,72600
251330,202104,79,70,9,77000,9900,86900
251335,202104,15,10,5,11000,5500,16500
251340,202104,753,444,309,488400,339900,828300
251350,202104,36,34,2,37400,2200,39600
251360,202104,81,71,10,78100,11000,89100
251365,202104,12,11,1,12100,1100,13200
251370,202104,5559,3739,1820,4114000.32,2002000,6116000.32
251380,202104,45,36,9,39600,9900,49500
251385,202104,1,1,0,1100,0,1100
251390,202104,844,634,210,697400,231000,928400
251392,202104,20,11,9,12100,9900,22000
251394,202104,8,8,0,8800,0,8800
251396,202104,14,10,4,11000,4400,15400
251398,202104,17,15,2,16500,2200,18700
251400,202104,42,34,8,37400,8800,46200
251410,202104,39,33,6,36300,6600,42900
251420,202104,103,74,29,81400,31900,113300
251430,202104,48,41,7,45100,7700,52800
251440,202104,46,26,20,28600,22000,50600
251445,202104,57,51,6,56100,6600,62700
251450,202104,412,359,53,394900,58300,453200
251455,202104,3,2,1,2200,1100,3300
251460,202104,17,15,2,16500,2200,18700
251465,202104,8,5,3,5500,3300,8800
251470,202104,51,39,12,42900,13200,56100
251480,202104,27,22,5,24200,5500,29700
251490,202104,124,79,45,86900,49500,136400
251500,202104,129,103,26,113300,28600,141900
251510,202104,68,44,24,48400,26400,74800
251520,202104,31,29,2,31900,2200,34100
251530,202104,4470,3166,1304,3483700,1435500,4919200
251540,202104,79,66,13,72600,14300,86900
251550,202104,415,316,99,347600,108900,456500
251560,202104,24,16,8,17600,8800,26400
251570,202104,18,16,2,17600,2200,19800
251580,202104,136,107,29,117700,31900,149600
251590,202104,115,82,33,90407.9,36300,126707.9
251593,202104,23,14,9,15400,9900,25300
251597,202104,97,80,17,88000,18700,106700
251600,202104,1109,781,328,859100,360800,1219900
251610,202104,242,179,63,196900,69300,266200
251615,202104,12,11,1,12100,1100,13200
251620,202104,4232,2746,1486,3022800,1634600,4657400
251630,202104,463,344,119,378400,132000,510400
251640,202104,136,99,37,108900,40700,149600
251650,202104,283,207,76,227700,84700,312400
251660,202104,192,170,22,187000,24200,211200
251670,202104,380,295,85,325600,93500,419100
251675,202104,8,6,2,6600,2200,8800
251680,202104,101,89,12,97900,13200,111100
251690,202104,320,264,56,290400,61600,352000
251700,202104,291,251,40,276100,44000,320100
251710,202104,22,14,8,15400,8800,24200
251720,202104,24,16,8,17600,8800,26400
251740,202104,11,8,3,8800,3300,12100
260005,202104,3339,1790,1549,1969632.93,1705000,3674632.93
260010,202104,1624,1178,446,1295800.58,490600,1786400.58
260020,202104,416,361,55,397100,60500,457600
260030,202104,597,410,187,452100,205700,657800
260040,202104,801,496,305,545600,336600,882200
260050,202104,1154,831,323,914100,356400,1270500
260060,202104,380,347,33,381700,36300,418000
260070,202104,1345,826,519,908600,570900,1479500
260080,202104,724,554,170,609400,187000,796400
260090,202104,498,327,171,359700,188100,547800
260100,202104,220,153,67,168300,73700,242000
260105,202104,249,138,111,151800,122100,273900
260110,202104,2886,2113,773,2324300,850300,3174600
260120,202104,2830,1445,1385,1589792.6,1524600,3114392.6
260130,202104,174,116,58,127600,63800,191400
260140,202104,2104,1365,739,1501500,812900,2314400
260150,202104,204,130,74,143000,81400,224400
260160,202104,322,268,54,294800,59400,354200
260170,202104,3344,1992,1352,2192300,1488300,3680600
260180,202104,158,124,34,136400,37400,173800
260190,202104,2335,1564,771,1721500,848100,2569600
260200,202104,970,773,197,850300.63,216700,1067000.63
260210,202104,1419,1006,413,1106600,455400,1562000
260220,202104,676,610,66,671000,73700,744700
260230,202104,1226,910,316,1002100,347600,1349700
260240,202104,216,164,52,180400,57200,237600
260250,202104,91,66,25,72600,27500,100100
260260,202104,1037,728,309,800800,339900,1140700
260270,202104,398,312,86,343200,94600,437800
260280,202104,1221,923,298,1016400,327800,1344200
260290,202104,6570,3547,3023,3905000,3327500.59,7232500.59
260300,202104,957,819,138,900900,151800,1052700
260310,202104,516,411,105,452100,115500,567600
260320,202104,848,617,231,678700,254100,932800
260330,202104,64,44,20,48400,22000,70400
260340,202104,75,57,18,62700,19800,82500
260345,202104,5478,2937,2541,3234000.4,2798400,6032400.4
260350,202104,479,339,140,372900,154000,526900
260360,202104,230,126,104,141900,115500,257400
260370,202104,761,476,285,523600,313500,837100
260380,202104,586,429,157,473000,173800.6,646800.6
260390,202104,291,245,46,269500,50600,320100
260392,202104,110,95,15,104500,16500,121000
260400,202104,4222,2406,1816,2646600.5,1998700,4645300.5
260410,202104,14681,7692,6989,8468901.03,7692300.85,16161201.88
260415,202104,142,123,19,135300,20900,156200
260420,202104,1722,1044,678,1148400.5,745800,1894200.5
260430,202104,176,162,14,178200.48,15400,193600.48
260440,202104,195,139,56,152900,61600,214500
260450,202104,431,319,112,350901.13,123200,474101.13
260460,202104,815,432,383,475200,421300,896500
260470,202104,341,208,133,228800,146300,375100
260480,202104,244,158,86,173800,94600,268400
260490,202104,212,175,37,192500,40700,233200
260500,202104,1124,758,366,833800,402600,1236400
260510,202104,786,626,160,688600,176000,864600
260515,202104,232,210,22,232100,24200,256300
260520,202104,3270,2028,1242,2231900,1367300,3599200
260530,202104,792,648,144,712800,158400,871200
260540,202104,538,423,115,465300,126500,591800
260545,202104,14,11,3,12100,3300,15400
260550,202104,323,202,121,223300,133100,356400
260560,202104,513,387,126,425700,138600,564300
260570,202104,979,792,187,871200,205700,1076900
260580,202104,250,216,34,237600,37400,275000
260590,202104,625,359,266,394900,292600,687500
260600,202104,8068,4389,3679,4829001.78,4046900,8875901.78
260610,202104,488,322,166,354200,182600,536800
260620,202104,3651,1889,1762,2079000,1938200.19,4017200.19
260630,202104,80,75,5,82500,5500,88000
260640,202104,3430,1925,1505,2119700,1656600,3776300
260650,202104,327,238,89,261800,97900,359700
260660,202104,564,352,212,387200,233200,620400
260670,202104,104,77,27,84700,29700,114400
260680,202104,3808,2081,1727,2289100,1900800,4189900
260690,202104,122,92,30,101200,33000,134200
260700,202104,310,206,104,227700,114400,342100
260710,202104,46,37,9,40700,9900,50600
260720,202104,2510,1467,1043,1615900,1147300,2763200
260730,202104,709,531,178,584100,195800,779900
260740,202104,67,58,9,63800,9900,73700
260750,202104,586,419,167,460900,183700,644600
260760,202104,675,340,335,374000.3,368500,742500.3
260765,202104,986,512,474,563200,521400,1084600
260770,202104,223,162,61,179281,67100,246381
260775,202104,772,430,342,473000,376200,849200
260780,202104,239,148,91,162800,101200,264000
260790,202104,14426,7316,7110,8049800,7827600,15877400
260795,202104,164,107,57,117700,62700,180400
260800,202104,288,238,50,261800,55000,316800
260805,202104,178,118,60,129800,66000,195800
260810,202104,768,649,119,713900,130900,844800
260820,202104,281,180,101,198000,111100,309100
260825,202104,224,146,78,160600,85800,246400
260830,202104,347,177,170,194700,187000,381700
260840,202104,241,176,65,193600,71500,265100
260845,202104,163,109,54,119900,59400,179300
260850,202104,423,311,112,342100,123200,465300
260860,202104,253,191,62,210100,68200,278300
260870,202104,362,275,87,302500.2,95700,398200.2
260875,202104,737,532,205,585200,225500,810700
260880,202104,1599,1022,577,1125300,635800,1761100
260890,202104,2345,1643,702,1808400,772200,2580600
260900,202104,982,698,284,767800,312400,1080200
260910,202104,246,195,51,214500,56100,270600
260915,202104,289,213,76,234300,83600,317900
260920,202104,186,96,90,105600,99000,204600
260930,202104,388,330,58,363000,63800,426800
260940,202104,2633,1404,1229,1545500,1351900,2897400
260950,202104,2007,1143,864,1257300,950400,2207700
260960,202104,13573,6768,6805,7449200.9,7498700.5,14947901.4
260970,202104,412,342,70,376200,77000,453200
260980,202104,193,173,20,190300,22000,212300
260990,202104,2638,2125,513,2337500,564300,2901800
261000,202104,4209,2551,1658,2808300,1824900,4633200
261010,202104,190,110,80,121000,90200,211200
261020,202104,594,446,148,490600.47,162800,653400.47
261030,202104,264,179,85,196900,93500,290400
261040,202104,375,327,48,359700,52800,412500
261050,202104,499,431,68,475200,74800,550000
261060,202104,1374,860,514,946000,565400,1511400
261070,202104,8903,4318,4585,4753100,5045700.5,9798800.5
261080,202104,372,285,87,313500,95700,409200
261090,202104,2157,1644,513,1808402.03,564300.3,2372702.33
261100,202104,1167,815,352,896500,388300,1284800
261110,202104,8792,5386,3406,5926800,3752100,9678900
261120,202104,257,219,38,240900,41800,282700
261130,202104,573,343,230,377300,253000,630300
261140,202104,210,132,78,145200,85800,231000
261150,202104,687,431,256,475200.56,281600,756800.56
261153,202104,69,64,5,70400,5500,75900
261160,202104,74212,36528,37684,40208391.94,41484302.25,81692694.19
261170,202104,469,348,121,382800,133100,515900
261180,202104,1765,1099,666,1209151,732600,1941751
261190,202104,624,441,183,485100,201300,686400
261200,202104,220,182,38,200200,41800,242000
261210,202104,33,29,4,31900,4400,36300
261220,202104,2728,1919,809,2112000.66,891000,3003000.66
261230,202104,344,247,97,271700,106700,378400
261240,202104,448,390,58,429000,63800,492800
261245,202104,240,196,44,215600,48400,264000
261247,202104,168,131,37,145200,40700,185900
261250,202104,3235,1564,1671,1722600,1840300,3562900
261255,202104,247,222,25,244200,27500,271700
261260,202104,838,725,113,797500.12,124300,921800.12
261270,202104,201,143,58,157300,63800,221100
261280,202104,179,146,33,160600,36300,196900
261290,202104,113,83,30,91300,33000,124300
261300,202104,1300,959,341,1054900,375100,1430000
261310,202104,795,530,265,583000,291500,874500
261320,202104,588,376,212,414700.22,233200,647900.22
261330,202104,960,731,229,804100,251900.63,1056000.63
261340,202104,299,165,134,181500,147400,328900
261350,202104,847,593,254,652300,279400,931700
261360,202104,1304,846,458,931700,503800,1435500
261370,202104,4819,2856,1963,3143800,2159300,5303100
261380,202104,549,419,130,460900.78,143000,603900.78
261390,202104,3572,2394,1178,2634500,1299100,3933600
261400,202104,287,257,30,282700,33000,315700
261410,202104,1115,730,385,803000,424600,1227600
261420,202104,896,552,344,607200.32,378400,985600.32
261430,202104,323,293,30,322300,33000,355300
261440,202104,115,106,9,116600,9900,126500
261450,202104,2518,2015,503,2216500,553300,2769800
261460,202104,726,574,152,633600,167200,800800
261470,202104,241,195,46,214500,50600,265100
261480,202104,447,349,98,385000,107750.5,492750.5
261485,202104,359,214,145,236500,159500,396000
261500,202104,608,412,196,453200.59,215600,668800.59
261510,202104,54,34,20,37400,22000,59400
261520,202104,93,80,13,88000,14300,102300
261530,202104,4116,2616,1500,2877600.09,1652200,4529800.09
261540,202104,1368,806,562,886600,618200,1504800
261550,202104,249,116,133,127600,146300,273900
261560,202104,854,559,295,617100,328900,946000
261570,202104,393,308,85,338800,93500,432300
261580,202104,384,301,83,332200,91300,423500
261590,202104,187,151,36,166100,39600,205700
261600,202104,294,232,62,255200,68200,323400
261610,202104,83,72,11,79200,12100,91300
261618,202104,76,59,17,64900,18700,83600
261620,202104,194,120,74,132000,81400,213400
261630,202104,541,423,118,466400,129800,596200
261640,202104,6453,3365,3088,3702601.82,3396800,7099401.82
261650,202104,491,314,177,345400,195800,541200
270010,202104,514,455,59,501600,64900,566500
270020,202104,281,230,51,253000,56100,309100
270030,202104,8755,5635,3120,6205138.22,3437500,9642638.22
270040,202104,2034,1304,730,1436453.33,803000,2239453.33
270050,202104,165,130,35,144100,38500,182600
270060,202104,110,61,49,67100,53900,121000
270070,202104,854,627,227,689700,249700,939400
270080,202104,35,29,6,31900,6600,38500
270090,202104,23,17,6,18700,6600,25300
270100,202104,1255,844,411,928400,452100,1380500
270110,202104,87,72,15,79200,16500,95700
270120,202104,223,180,43,199100,47300,246400
270130,202104,287,208,79,228800,86900,315700
270135,202104,114,72,42,79200,46200,125400
270140,202104,1373,880,493,968000,542300,1510300
270150,202104,255,198,57,217800,62700,280500
270160,202104,497,393,104,433400,114400,547800
270170,202104,811,524,287,576400,315700,892100
270180,202104,55,43,12,47300,13200,60500
270190,202104,89,78,11,85800,12100,97900
270200,202104,110,96,14,105600,15400,121000
270210,202104,510,295,215,324500,238700,563200
270220,202104,179,138,41,151800,45100,196900
270230,202104,2120,1301,819,1433300,900900,2334200
270235,202104,684,532,152,585200,167200,752400
270240,202104,2985,2363,622,2600401.67,685300,3285701.67
270250,202104,154,113,41,125400,45100,170500
270255,202104,221,192,29,212300,31900,244200
270260,202104,368,299,69,328900.72,75900,404800.72
270270,202104,100,46,54,50600,59400,110000
270280,202104,226,128,98,140800,107800,248600
270290,202104,1149,887,262,977900,288200,1266100
270300,202104,322,229,93,251900,102300,354200
270310,202104,838,696,142,765600.92,156200,921800.92
270320,202104,824,708,116,779900.63,127600,907500.63
270330,202104,300,253,47,279400,51700,331100
270340,202104,56,43,13,47300,14300,61600
270350,202104,89,51,38,56100,41800,97900
270360,202104,64,35,29,38500,31900,70400
270370,202104,57,45,12,49500,13200,62700
270375,202104,76,47,29,51700,31900,83600
270380,202104,1028,664,364,730400,400400,1130800
270390,202104,162,95,67,104500.68,73700,178200.68
270400,202104,720,541,179,595100.2,196900,792000.2
270410,202104,646,476,170,524700,187000,711700
270420,202104,400,272,128,300300,140800,441100
270430,202104,33064,23795,9269,26189828.63,10205800,36395628.63
270440,202104,470,372,98,409200,107800,517000
270450,202104,803,464,339,510400,372900,883300
270460,202104,184,145,39,159500.41,42900,202400.41
270470,202104,1484,1035,449,1138353.33,493900,1632253.33
270480,202104,545,448,97,492800,106700,599500
270490,202104,20,15,5,16500,5500,22000
270500,202104,493,416,77,457600,84700,542300
270510,202104,824,517,307,568700,337700,906400
270520,202104,277,178,99,195800,108900,304700
270530,202104,58,51,7,56100,7700,63800
270540,202104,96,75,21,82500,23100,105600
270550,202104,1717,1321,396,1454200.6,435600,1889800.6
270560,202104,269,154,115,169400,126500,295900
270570,202104,531,373,158,410300,173800,584100
270580,202104,84,68,16,74800,17600,92400
270590,202104,65,52,13,57200,14300,71500
270600,202104,170,142,28,156200,30800,187000
270610,202104,245,184,61,202400,68200,270600
270620,202104,16,16,0,17600,0,17600
270630,202104,3723,2839,884,3122900,972400,4095300
270640,202104,863,643,220,707300,243100,950400
270642,202104,200,168,32,185900,35200,221100
270644,202104,255,167,88,183700,96800,280500
270650,202104,332,199,133,220000,146300,366300
270660,202104,237,200,37,220000,40700,260700
270670,202104,3026,2300,726,2531101.01,798600,3329701.01
270680,202104,430,260,170,286000,187000,473000
270690,202104,1187,785,402,864600,442200,1306800
270700,202104,26,21,5,23100,5500,28600
270710,202104,869,684,185,752400,203500,955900
270720,202104,234,184,50,202400,55000,257400
270730,202104,1869,1144,725,1258400,797500,2055900
270740,202104,41,28,13,30800,14300,45100
270750,202104,640,484,156,532400,171600,704000
270760,202104,290,209,81,229900,89100,319000
270770,202104,2741,1827,914,2010176.66,1005400,3015576.66
270780,202104,69,44,25,48400,27500,75900
270790,202104,256,166,90,182600,99000,281600
270800,202104,2067,1631,436,1794100,479600,2273700
270810,202104,214,177,37,194700,40700,235400
270820,202104,133,94,39,103400,44000,147400
270830,202104,784,591,193,651200,212300,863500
270840,202104,1368,1048,320,1152800.4,352000,1504800.4
270850,202104,1488,940,548,1034000,602800,1636800
270860,202104,2546,1698,848,1870000.7,932800,2802800.7
270870,202104,116,65,51,71500,56100,127600
270880,202104,885,701,184,771100,202400,973500
270890,202104,280,211,69,232100,75900,308000
270895,202104,47,44,3,48400,3300,51700
270900,202104,77,61,16,67100,17600,84700
270910,202104,304,252,52,277200,57200,334400
270915,202104,1893,1226,667,1348600,734800,2083400
270920,202104,459,383,76,421300,83600,504900
270930,202104,5908,4457,1451,4904900,1600500.14,6505400.14
270940,202104,2238,1758,480,1936000,528000,2464000
280010,202104,39,32,7,35200,7700,42900
280020,202104,485,414,71,455400,78100,533500
280030,202104,20626,13344,7282,14685002.73,8016801.25,22701803.98
280040,202104,328,213,115,234300,126500,360800
280050,202104,404,311,93,342100,102300,444400
280060,202104,338,221,117,243100,128700,371800
280067,202104,1089,789,300,867900,330000.5,1197900.5
280070,202104,125,102,23,112200,25300,137500
280100,202104,639,496,143,545600,157300,702900
280110,202104,71,66,5,72600,5500,78100
280120,202104,654,539,115,592900,127600,720500
280130,202104,1740,1146,594,1260600,654500,1915100
280140,202104,482,398,84,437800,92400,530200
280150,202104,402,281,121,309100,133100,442200
280160,202104,123,99,24,108900,26400,135300
280170,202104,403,283,120,311300,132000,443300
280190,202104,26,23,3,25300,3300,28600
280200,202104,34,30,4,33000,4400,37400
280210,202104,2960,2133,827,2346169.98,910800,3256969.98
280220,202104,40,33,7,36300,7700,44000
280230,202104,328,267,61,293700,67100,360800
280240,202104,123,117,6,128700,6600,135300
280250,202104,19,10,9,11000,9900,20900
280260,202104,76,69,7,75900,7700,83600
280270,202104,148,114,34,126500,37400,163900
280280,202104,198,130,68,143000.5,74800,217800.5
280290,202104,3413,2465,948,2712529.5,1042800,3755329.5
280300,202104,1601,1254,347,1379400,381700,1761100
280310,202104,96,91,5,100100,5500,105600
280320,202104,638,449,189,496100,207900,704000
280330,202104,323,236,87,259600,96800,356400
280340,202104,407,331,76,364100,83600,447700
280350,202104,3697,2873,824,3160300.66,906400.08,4066700.74
280360,202104,473,324,149,356400,163900,520300
280370,202104,96,84,12,92400,13200,105600
280380,202104,50,36,14,39600,15400,55000
280390,202104,171,146,25,160600,27500,188100
280400,202104,353,241,112,265100,123200,388300
280410,202104,286,237,49,260700,53900,314600
280420,202104,170,144,26,158400.85,28600,187000.85
280430,202104,60,48,12,52800,13200,66000
280440,202104,687,540,147,595100,161700,756800
280445,202104,120,109,11,119900,12100,132000
280450,202104,1205,1039,166,1142900,182600,1325500
280460,202104,631,462,169,508200.93,185900,694100.93
280470,202104,184,171,13,188100,14300.5,202400.5
280480,202104,2732,1900,832,2091101.67,916300.5,3007402.17
280490,202104,253,239,14,262900.96,15400,278300.96
280500,202104,44,40,4,44000,4400,48400
280510,202104,140,112,28,123200,30800,154000
280520,202104,52,37,15,40700,16500,57200
280530,202104,81,53,28,58300,30800,89100
280540,202104,534,451,83,496100,91300,587400
280550,202104,735,676,59,744700.65,64900,809600.65
280560,202104,490,436,54,479600,59400,539000
280570,202104,2242,1766,476,1943700,523600,2467300
280580,202104,591,458,133,503800,146300,650100
280590,202104,210,135,75,148500,82500,231000
280600,202104,379,315,64,347651.7,70400,418051.7
280610,202104,109,81,28,89100,30800,119900
280620,202104,548,447,101,491700,111100,602800
280630,202104,156,128,28,140800,30800,171600
280640,202104,192,152,40,167200,44000,211200
280650,202104,93,60,33,66000,36300,102300
280660,202104,139,101,38,111100,41800,152900
280670,202104,1898,1193,705,1313400.4,775500.48,2088900.88
280680,202104,205,179,26,196900,28600,225500
280690,202104,80,71,9,78100,9900,88000
280700,202104,20,20,0,22000,0,22000
280710,202104,1471,1138,333,1251800,366300,1618100
280720,202104,111,72,39,79200,42900,122100
280730,202104,29,24,5,26400,5500,31900
280740,202104,2512,1879,633,2069100,699600,2768700
280750,202104,236,206,30,226600,33000,259600
280760,202104,801,550,251,608300,276100,884400
290010,202104,199,139,60,152900,66000,218900
290020,202104,189,170,19,187000,20900,207900
290030,202104,611,395,216,434500,237600,672100
290035,202104,132,108,24,118800,26400,145200
290040,202104,306,207,99,227700,108900,336600
290050,202104,84,66,18,72600,19800,92400
290060,202104,258,115,143,126500,157300,283800
290070,202104,5689,2725,2964,3000801.35,3263700,6264501.35
290080,202104,447,202,245,222200,269500,491700
290090,202104,376,168,208,184800,228800,413600
290100,202104,1627,1058,569,1163800,628100,1791900
290110,202104,833,485,348,533500.85,382800,916300.85
290115,202104,194,180,14,199100,15400,214500
290120,202104,771,513,258,564300,284900,849200
290130,202104,436,271,165,298100,181500,479600
290135,202104,306,236,70,259600,78100,337700
290140,202104,319,263,56,289300,61600,350900
290150,202104,139,97,42,106700,46200,152900
290160,202104,243,186,57,205700,62700,268400
290170,202104,90,63,27,69300,29700,99000
290180,202104,182,133,49,146300,53900,200200
290190,202104,442,359,83,394900,91300,486200
290195,202104,309,199,110,218900,121000,339900
290200,202104,271,221,50,243100,55000,298100
290205,202104,148,91,57,100100,62700,162800
290210,202104,1170,867,303,953700,333300,1287000
290220,202104,215,120,95,132000,104500,236500
290225,202104,287,119,168,130900,184800,315700
290230,202104,80,49,31,53900,34100,88000
290240,202104,360,126,234,138600,257400,396000
290250,202104,256,236,20,259600,22000,281600
290260,202104,322,266,56,292600,61600,354200
290265,202104,187,162,25,178200,27500,205700
290270,202104,1417,1187,230,1305700,253000,1558700
290280,202104,473,335,138,369600,152900,522500
290290,202104,1335,802,533,882200.94,586300,1468500.94
290300,202104,426,365,61,401500,67100,468600
290310,202104,291,137,154,150700,169400,320100
290320,202104,4063,2512,1551,2763200.11,1707200,4470400.11
290323,202104,189,164,25,180400,27500,207900
290327,202104,174,136,38,149600,41800,191400
290330,202104,113,57,56,62700,61600,124300
290340,202104,802,332,470,365200,517000,882200
290350,202104,623,371,252,409200,278300,687500
290360,202104,347,268,79,294800.99,86900,381700.99
290370,202104,906,392,514,431200,566500,997700
290380,202104,327,209,118,229900,129800,359700
290390,202104,2415,1507,908,1658800,999900,2658700
290395,202104,241,137,104,150700,114400,265100
290400,202104,277,203,74,224400,81400,305800
290405,202104,248,214,34,235400,37400,272800
290410,202104,626,523,103,575300.3,113300,688600.3
290420,202104,258,208,50,228800,55000,283800
290430,202104,482,315,167,346500,183700,530200
290440,202104,78,69,9,75900,9900,85800
290450,202104,195,146,49,160600,53900,214500
290460,202104,1933,1159,774,1274900,851400,2126300
290470,202104,1370,601,769,662200,845900,1508100
290475,202104,551,517,34,569800.27,37400,607200.27
290480,202104,285,164,121,180400,133100,313500
290485,202104,238,217,21,238700,23100,261800
290490,202104,1225,876,349,963600,383900,1347500
290500,202104,735,377,358,415800,393800,809600
290510,202104,233,185,48,203500,52800,256300
290515,202104,159,98,61,107800,67100,174900
290520,202104,1395,910,485,1002100,533500.2,1535600.2
290530,202104,299,274,25,301400,27500,328900
290540,202104,106,55,51,60500,56100,116600
290550,202104,166,139,27,152900,29700,182600
290560,202104,3116,1361,1755,1499300,1933800,3433100
290570,202104,6212,2992,3220,3294500,3542000,6836500
290580,202104,1264,752,512,827200,563200,1390400
290590,202104,571,469,102,515900,112200,628100
290600,202104,1760,1208,552,1328800.67,607200,1936000.67
290610,202104,203,183,20,201300,22000,223300
290620,202104,356,322,34,354200,37400,391600
290630,202104,1986,844,1142,929500,1258400,2187900
290640,202104,146,117,29,128700,31900,160600
290650,202104,1785,841,944,925100.92,1039500,1964600.92
290660,202104,283,230,53,253000,58300,311300
290670,202104,931,479,452,526900,497200,1024100
290680,202104,1231,988,243,1086800,267300,1354100
290682,202104,308,232,76,255200.48,83600,338800.48
290685,202104,246,161,85,177100,93500,270600
290687,202104,1074,697,377,766879,414700,1181579
290689,202104,143,76,67,83600,73700,157300
290690,202104,609,259,350,284900,385000,669900
290700,202104,240,120,120,132000,132000,264000
290710,202104,765,524,241,576400,265100,841500
290720,202104,1030,838,192,921800,211200,1133000
290730,202104,1174,675,499,742500,548900,1291400
290740,202104,20,17,3,18700,3300,22000
290750,202104,1387,617,770,680900,848100,1529000
290755,202104,72,65,7,71500,7700,79200
290760,202104,287,249,38,273900,41800,315700
290770,202104,186,174,12,191400,13200,204600
290780,202104,1107,855,252,940500,277200,1217700
290790,202104,372,257,115,282700,126500,409200
290800,202104,2443,997,1446,1096700,1590600,2687300
290810,202104,465,321,144,353100,158400,511500
290820,202104,397,232,165,255200,181500,436700
290830,202104,423,302,121,332200,133100,465300
290840,202104,1773,1105,668,1215500,734800,1950300
290850,202104,844,437,407,480700,447700,928400
290860,202104,640,287,353,315700,389400,705100
290870,202104,621,444,177,488400,194700,683100
290880,202104,118,63,55,69300,60500,129800
290890,202104,416,266,150,292600,165000,457600
290900,202104,167,126,41,138600,45100,183700
290910,202104,382,291,91,320100,100100,420200
290920,202104,209,183,26,201300,28600,229900
290930,202104,819,625,194,687500,213400,900900
290940,202104,242,203,39,223300,42900,266200
290950,202104,159,94,65,103400,71500,174900
290960,202104,475,335,140,368500,154000,522500
290970,202104,246,216,30,237600,33000,270600
290980,202104,1615,1127,488,1241900,536800,1778700
290990,202104,398,335,63,368500,69300,437800
291000,202104,863,268,595,294800,654500,949300
291005,202104,2333,1005,1328,1106600,1460800.42,2567400.42
291010,202104,161,145,16,159500,17600,177100
291020,202104,100,79,21,86900,23100,110000
291030,202104,98,70,28,77000,30800,107800
291040,202104,609,346,263,380600,289300,669900
291050,202104,1455,794,661,873400,727100,1600500
291060,202104,1563,850,713,936100,784300,1720400
291070,202104,1962,1463,499,1609300.82,548901.3,2158202.12
291072,202104,7136,2663,4473,2930400,4923600.68,7854000.68
291075,202104,243,198,45,217800,49500,267300
291077,202104,59,40,19,44000,20900,64900
291080,202104,20280,8803,11477,9691000.75,12639000.55,22330001.30
291085,202104,296,240,56,264000,61600,325600
291090,202104,278,116,162,127600,180400,308000
291100,202104,641,198,443,217800,487300,705100
291110,202104,425,327,98,359700,107800,467500
291120,202104,2381,1209,1172,1329900,1289200,2619100
291125,202104,64,30,34,34100,37400,71500
291130,202104,196,175,21,192500,23100,215600
291140,202104,127,103,24,113300,26400,139700
291150,202104,391,146,245,160600,269500,430100
291160,202104,387,314,73,345400,80300,425700
291165,202104,48,37,11,40700,12100,52800
291170,202104,3159,1573,1586,1731400.5,1745700,3477100.5
291180,202104,1250,506,744,556600,818400,1375000
291185,202104,100,95,5,104500,5500,110000
291190,202104,1384,643,741,707300,816200,1523500
291200,202104,169,124,45,136400,49500,185900
291210,202104,2320,920,1400,1013100,1541100,2554200
291220,202104,280,212,68,233200,74800,308000
291230,202104,966,332,634,365200,697400,1062600
291240,202104,426,396,30,435600,33000,468600
291250,202104,432,351,81,386100,89100,475200
291260,202104,57,49,8,53900,8800,62700
291270,202104,1143,483,660,531300,726000,1257300
291280,202104,348,164,184,180400,202400,382800
291290,202104,1708,896,812,988900,894300.54,1883200.54
291300,202104,227,181,46,199100,50600,249700
291310,202104,226,202,24,222200,26400,248600
291320,202104,1340,944,396,1039500,435600,1475100
291330,202104,130,113,17,124300,18700,143000
291340,202104,213,127,86,139700,94600,234300
291345,202104,130,90,40,99000,44000,143000
291350,202104,1656,589,1067,647900,1173700,1821600
291360,202104,8312,4006,4306,4413200,4738800,9152000
291370,202104,1106,642,464,707300,510400,1217700
291380,202104,264,210,54,231000,59400,290400
291390,202104,3914,1733,2181,1906300,2399100,4305400
291400,202104,2086,1492,594,1641200,653400.42,2294600.42
291410,202104,193,167,26,183700,28600,212300
291420,202104,116,87,29,95700,31900,127600
291430,202104,163,90,73,99000,80300.5,179300.5
291440,202104,522,427,95,469700,104500,574200
291450,202104,929,594,335,654500,368500,1023000
291460,202104,1883,1524,359,1676400,394900,2071300
291465,202104,2200,1045,1155,1149500,1270500,2420000
291470,202104,2829,1433,1396,1576300.55,1537800,3114100.55
291480,202104,11705,5148,6557,5662801.62,7213800,12876601.62
291490,202104,610,245,365,269500,401500,671000
291500,202104,382,227,155,250800,171600,422400
291510,202104,1218,476,742,523600,817300,1340900
291520,202104,936,425,511,467500,562100,1029600
291530,202104,924,245,679,269500,749100,1018600
291535,202104,120,98,22,107800,24200,132000
291540,202104,354,114,240,125400,264000,389400
291550,202104,1241,584,657,642400,722700,1365100
291560,202104,5182,2593,2589,2860000,2852300,5712300
291570,202104,209,107,102,117700,112200,229900
291580,202104,1181,728,453,800800,499400,1300200
291590,202104,93,39,54,42900,59400,102300
291600,202104,1136,558,578,613800,635800,1249600
291610,202104,1435,693,742,762300,816200,1578500
291620,202104,564,266,298,293700,327800,621500
291630,202104,476,148,328,162800,360800,523600
291640,202104,3942,1993,1949,2193400,2145000,4338400
291650,202104,431,290,141,319000.5,155100,474100.5
291660,202104,377,155,222,170500,244200,414700
291670,202104,217,131,86,144100,94600,238700
291680,202104,635,385,250,423500,275000,698500
291685,202104,576,321,255,353100,280500,633600
291690,202104,505,309,196,341000,215600.92,556600.92
291700,202104,979,758,221,833800,243100,1076900
291710,202104,1602,776,826,853600,909700,1763300
291720,202104,425,288,137,316800,150700,467500
291730,202104,932,544,388,598400,426800,1025200
291733,202104,287,194,93,213400,102300,315700
291735,202104,73,57,16,62700,17600,80300
291740,202104,351,266,85,292600,93500,386100
291750,202104,2200,1442,758,1586200.25,834900,2421100.25
291760,202104,2944,1634,1310,1798500,1441000,3239500
291770,202104,757,516,241,567600,265100,832700
291780,202104,60,37,23,40700,25300,66000
291790,202104,154,81,73,89100,81400,170500
291800,202104,10002,4176,5826,4594700.42,6413000.9,11007701.32
291810,202104,1098,823,275,905300,302500,1207800
291820,202104,275,200,75,221100,82500,303600
291830,202104,1038,423,615,465300.59,676500,1141800.59
291835,202104,556,515,41,567600,45100,612700
291840,202104,4923,2490,2433,2741200.75,2676300,5417500.75
291845,202104,263,85,178,93500,195800,289300
291850,202104,320,284,36,312400,39600,352000
291855,202104,250,101,149,111100,165000,276100
291860,202104,168,104,64,114400,70400,184800
291870,202104,81,36,45,39600,49500,89100
291875,202104,177,163,14,179300,15400,194700
291880,202104,439,352,87,387200,96800,484000
291890,202104,247,81,166,89100,182600,271700
291900,202104,59,33,26,36300,28600,64900
291905,202104,123,91,32,100100,35200,135300
291910,202104,156,125,31,137500,34100,171600
291915,202104,433,384,49,422400,53900,476300
291920,202104,5125,2539,2586,2795100,2845700,5640800
291930,202104,166,99,67,108900.27,73700,182600.27
291940,202104,359,209,150,229900,165000,394900
291950,202104,1142,917,225,1009800,247500,1257300
291955,202104,1276,774,502,852500,554400,1406900
291960,202104,195,142,53,156200,58300,214500
291970,202104,752,568,184,624800,202400,827200
291980,202104,1492,1315,177,1446500.73,194700,1641200.73
291990,202104,138,128,10,140800,11000,151800
291992,202104,162,86,76,94600,83600,178200
291995,202104,187,121,66,133100,72600,205700
292000,202104,391,298,93,327800,102300,430100
292010,202104,317,220,97,242000,106700,348700
292020,202104,300,219,81,240900,89100,330000
292030,202104,142,108,34,118800,37400,156200
292040,202104,613,319,294,350900,323400,674300
292045,202104,115,104,11,114400,12100,126500
292050,202104,936,682,254,750200,279400,1029600
292060,202104,903,739,164,812900,180400,993300
292070,202104,61,20,41,22000,45100,67100
292080,202104,138,95,43,104500,47300,151800
292090,202104,531,185,346,203500,382800,586300
292100,202104,1479,633,846,696300,931700,1628000
292105,202104,187,167,20,183700,22000,205700
292110,202104,2249,818,1431,900900,1575200,2476100
292120,202104,692,546,146,600600,162800,763400
292130,202104,444,247,197,271700,216700,488400
292140,202104,211,171,40,188100,44000,232100
292145,202104,161,87,74,95700,81400,177100
292150,202104,1489,1225,264,1347500,290400,1637900
292160,202104,161,133,28,146300,30800,177100
292170,202104,1175,1021,154,1123100,169400,1292500
292180,202104,220,162,58,178200,63800,242000
292190,202104,157,103,54,113300,59400,172700
292200,202104,1354,492,862,541200,948200,1489400
292205,202104,125,108,17,118800,18700,137500
292210,202104,370,254,116,279400,127600,407000
292220,202104,33,24,9,26400,9900,36300
292225,202104,40,32,8,35200,8800,44000
292230,202104,952,746,206,820600,226600,1047200
292240,202104,614,445,169,489500,185900,675400
292250,202104,1681,1098,583,1208900,642400,1851300
292260,202104,397,237,160,260700,176000,436700
292265,202104,248,181,67,199100,73700,272800
292270,202104,724,338,386,371800,424600,796400
292273,202104,208,116,92,127600,101200,228800
292275,202104,173,87,86,95700,94600,190300
292280,202104,142,99,43,108900,47300,156200
292285,202104,80,65,15,71500,16500,88000
292290,202104,579,390,189,429000,209000,638000
292300,202104,1728,644,1084,709500,1192400,1901900
292303,202104,118,76,42,83600,46200,129800
292305,202104,119,89,30,97900,33000,130900
292310,202104,927,602,325,663300,357500,1020800
292320,202104,589,446,143,490600,157300,647900
292330,202104,172,101,71,112200,78100,190300
292335,202104,277,218,59,239800,64900,304700
292340,202104,572,397,175,437800,192500,630300
292350,202104,272,150,122,166100,134200,300300
292360,202104,703,537,166,590700,182600,773300
292370,202104,746,575,171,634700,188100,822800
292380,202104,627,512,115,564300,126500,690800
292390,202104,456,180,276,198000,303600,501600
292400,202104,3591,2236,1355,2459600,1491600,3951200
292405,202104,271,179,92,196900,101200,298100
292410,202104,129,80,49,88000,53900,141900
292420,202104,294,255,39,280500,42900,323400
292430,202104,546,409,137,449900,150700,600600
292440,202104,611,517,94,568700.56,103400,672100.56
292450,202104,240,189,51,207900,56100,264000
292460,202104,545,407,138,448800,151800,600600
292465,202104,208,175,33,192500,36300,228800
292467,202104,141,85,56,93500,61600,155100
292470,202104,295,199,96,218900,105600,324500
292480,202104,371,251,120,276100,132000,408100
292490,202104,237,170,67,187000,73700,260700
292500,202104,856,389,467,429000.32,513700,942700.32
292510,202104,3470,1619,1851,1780900,2036100,3817000
292520,202104,1094,511,583,562100,641300,1203400
292525,202104,408,289,119,317900,130900,448800
292530,202104,4453,1776,2677,1953600.65,2948000,4901600.65
292540,202104,479,268,211,294800,232100,526900
292550,202104,1098,580,518,638000,569800,1207800
292560,202104,332,309,23,339900,25300,365200
292570,202104,311,242,69,267300,75900,343200
292575,202104,492,332,160,365200,176000,541200
292580,202104,988,653,335,718300,368500,1086800
292590,202104,563,493,70,542300,77000,619300
292593,202104,140,112,28,123200,30800,154000
292595,202104,204,160,44,176000,48400,224400
292600,202104,1257,918,339,1010900.63,372900,1383800.63
292610,202104,127,98,29,107800,31900,139700
292620,202104,535,455,80,500500,88000,588500
292630,202104,1436,799,637,880000,701800,1581800
292640,202104,847,594,253,654500,278300,932800
292650,202104,188,154,34,169400.5,37400,206800.5
292660,202104,2003,1428,575,1571900,632500.92,2204400.92
292665,202104,142,103,39,113300,42900,156200
292670,202104,397,317,80,348700,88000,436700
292680,202104,258,192,66,211200,72600,283800
292690,202104,196,142,54,156200,59400,215600
292700,202104,977,647,330,711700.9,363000,1074700.9
292710,202104,116,101,15,111100,16500,127600
292720,202104,927,524,403,576400,444400,1020800
292730,202104,197,93,104,102300,114400,216700
292740,202104,69553,33822,35731,37237202.61,39341500.88,76578703.49
292750,202104,392,279,113,306900,124300,431200
292760,202104,340,285,55,313500,60500,374000
292770,202104,832,357,475,392700,522500,915200
292780,202104,402,154,248,169400,272800,442200
292790,202104,771,401,370,441100,407000,848100
292800,202104,1259,751,508,826100,558800,1384900
292805,202104,393,124,269,136400,295900,432300
292810,202104,1507,859,648,944900,712800,1657700
292820,202104,707,600,107,660000,117700,777700
292830,202104,118,93,25,102300,27500,129800
292840,202104,684,559,125,614900,137500,752400
292850,202104,139,92,47,101200,51700,152900
292860,202104,2116,1235,881,1358500,969100,2327600
292870,202104,3507,2338,1169,2571800,1285900,3857700
292880,202104,1483,980,503,1079100,554400,1633500
292890,202104,524,442,82,486200,90200,576400
292895,202104,141,94,47,103400,51700,155100
292900,202104,371,268,103,295900,113300,409200
292905,202104,487,241,246,265100,270600,535700
292910,202104,459,345,114,379500,125400,504900
292920,202104,523,227,296,249700,325600,575300
292925,202104,495,454,41,499400,45100,544500
292930,202104,629,378,251,415800,277200,693000
292935,202104,289,120,169,132000,185900,317900
292937,202104,222,153,69,168300,75900,244200
292940,202104,189,145,44,159500,48400,207900
292950,202104,1173,587,586,645700,644600.6,1290300.6
292960,202104,571,401,170,441100,187000,628100
292970,202104,238,167,71,183700.48,78100,261800.48
292975,202104,104,61,43,67100,48400,115500
292980,202104,290,195,95,214500.61,104500,319000.61
292990,202104,1329,985,344,1083500,378400,1461900
293000,202104,115,80,35,88000,38500,126500
293010,202104,2830,1677,1153,1844700,1268300.8,3113000.8
293015,202104,631,515,116,566500,127600,694100
293020,202104,333,275,58,302500,63800,366300
293030,202104,602,526,76,578600,83600,662200
293040,202104,365,291,74,320100,82500,402600
293050,202104,2873,1694,1179,1864500,1296900,3161400
293060,202104,258,205,53,225500.48,58300,283800.48
293070,202104,3512,1764,1748,1940400.18,1922800,3863200.18
293075,202104,89,60,29,66000,31900,97900
293076,202104,75,55,20,60500,22000,82500
293077,202104,542,311,231,342100,254100,596200
293080,202104,433,388,45,426800,49500,476300
293090,202104,129,116,13,127600,14300,141900
293100,202104,520,362,158,398200,174900,573100
293105,202104,342,249,93,273900,102300,376200
293110,202104,167,114,53,126500,58300,184800
293120,202104,302,205,97,225500,106700,332200
293130,202104,254,173,81,190300,89100,279400
293135,202104,8055,3134,4921,3447400,5416400,8863800
293140,202104,212,129,83,141900,91300,233200
293150,202104,314,273,41,300300,45100,345400
293160,202104,428,255,173,280500,190300,470800
293170,202104,190,125,65,137500,71500,209000
293180,202104,565,398,167,437800,183700,621500
293190,202104,1347,936,411,1029600.7,452100,1481700.7
293200,202104,559,489,70,539000,77000,616000
293210,202104,402,305,97,335500,106700,442200
293220,202104,2442,1045,1397,1149500,1536700,2686200
293230,202104,1755,659,1096,724900.1,1205600,1930500.1
293240,202104,233,213,20,234300,22000,256300
293245,202104,127,106,21,116600,23100,139700
293250,202104,738,273,465,300300.22,511500,811800.22
293260,202104,304,252,52,277200,57200,334400
293270,202104,1179,544,635,598400,698500,1296900
293280,202104,284,164,120,180400,133100,313500
293290,202104,3030,1967,1063,2164800,1170400,3335200
293300,202104,760,534,226,587400,248600,836000
293305,202104,202,159,43,174900,47300,222200
293310,202104,158,119,39,130900,42900,173800
293315,202104,165,129,36,143000,39600,182600
293317,202104,89,65,24,71500,26400,97900
293320,202104,1066,580,486,638000.5,534600,1172600.5
293325,202104,187,70,117,77000,128700,205700
293330,202104,13671,6347,7324,6990500.38,8063000,15053500.38
293340,202104,276,193,83,212300,91300,303600
293345,202104,251,203,48,223300,52800,276100
293350,202104,603,355,248,390500,272800,663300
293360,202104,1516,1086,430,1194600,474100,1668700
310010,202104,142,75,67,82500,73700,156200
310020,202104,1023,557,466,617100,513700,1130800
310030,202104,323,257,66,282700,72600,355300
310040,202104,42,28,14,30800,15400,46200
310050,202104,170,105,65,115500,71500,187000
310060,202104,255,177,78,194700,85800,280500
310070,202104,14,9,5,9900,5500,15400
310080,202104,41,25,16,27500,17600,45100
310090,202104,1029,542,487,598400,535700.18,1134100.18
310100,202104,311,225,86,247500,94600,342100
310110,202104,709,385,324,423500,356400,779900
310120,202104,384,220,164,242000,180400,422400
310130,202104,31,17,14,18700,15400,34100
310140,202104,24,10,14,11000,15400,26400
310150,202104,1165,783,382,862400,420200,1282600
310160,202104,2041,991,1050,1090100.22,1155000,2245100.22
310163,202104,86,48,38,52800,41800,94600
310170,202104,2518,1113,1405,1225400,1546600,2772000
310180,202104,158,58,100,63800,110000,173800
310190,202104,487,333,154,366300,169400,535700
310200,202104,480,305,175,335500,192500,528000
310205,202104,58,38,20,41800,22000,63800
310210,202104,279,226,53,248600,58300,306900
310220,202104,60,34,26,37400,28600,66000
310230,202104,278,191,87,210100,95700,305800
310240,202104,107,93,14,102300,15400,117700
310250,202104,98,79,19,86900,20900,107800
310260,202104,739,390,349,430100.92,385000,815100.92
310270,202104,264,167,97,183700,106700,290400
310280,202104,370,272,98,299200,107800,407000
310285,202104,206,151,55,166100,60500,226600
310290,202104,237,134,103,147400,113300,260700
310300,202104,172,141,31,155100,34100,189200
310310,202104,10,7,3,7700,3300,11000
310320,202104,24,8,16,8800,17600,26400
310330,202104,41,27,14,29700,15400,45100
310340,202104,1786,1186,600,1304600,661100,1965700
310350,202104,2751,1462,1289,1609300,1420100,3029400
310360,202104,40,33,7,36300,7700,44000
310370,202104,128,106,22,116600,24200,140800
310375,202104,104,36,68,39600,74800,114400
310380,202104,48,28,20,30800,22000,52800
310390,202104,101,65,36,71500,39600,111100
310400,202104,2385,1534,851,1688500.44,936100,2624600.44
310410,202104,126,71,55,78100,60500,138600
310420,202104,655,338,317,371800,348700,720500
310430,202104,285,176,109,193600,122100,315700
310440,202104,73,42,31,46200,34100,80300
310445,202104,78,64,14,70400,15400,85800
310450,202104,627,392,235,431200,258500,689700
310460,202104,250,175,75,192500,82500,275000
310470,202104,510,325,185,357500,203500,561000
310480,202104,85,53,32,58300,35200,93500
310490,202104,530,245,285,269500,314600,584100
310500,202104,133,51,82,56100,90200,146300
310510,202104,601,421,180,463100,198000,661100
310520,202104,137,97,40,106700,44000,150700
310530,202104,107,43,64,47300,70400,117700
310540,202104,467,265,202,291500,222200,513700
310550,202104,72,45,27,49500,29700,79200
310560,202104,2942,2014,928,2217600,1026300,3243900
310570,202104,96,60,36,66000,39600,105600
310590,202104,370,235,135,258500,148500,407000
310600,202104,145,79,66,86900,72600,159500
310610,202104,57,21,36,23100,39600,62700
310620,202104,46887,22192,24695,24440818.76,27221700.75,51662519.51
310630,202104,659,400,259,441100,284900,726000
310640,202104,121,94,27,103400,29700,133100
310650,202104,158,141,17,155100,18700,173800
310660,202104,100,69,31,75900,34100,110000
310665,202104,62,46,16,50600,17600,68200
310670,202104,6734,2860,3874,3153700,4266900,7420600
310680,202104,64,38,26,41800,28600,70400
310690,202104,603,423,180,465300,198000,663300
310700,202104,61,38,23,41800,25300,67100
310710,202104,1322,895,427,984500,469700,1454200
310720,202104,139,35,104,38500,114400,152900
310730,202104,1480,1012,468,1115400,514800,1630200
310740,202104,986,547,439,601700,485100,1086800
310750,202104,240,147,93,161700,102300,264000
310760,202104,67,51,16,56100,17600,73700
310770,202104,91,45,46,49500,50600,100100
310780,202104,356,286,70,315700,77000,392700
310790,202104,105,85,20,93500,22000,115500
310800,202104,448,205,243,225500,267300,492800
310810,202104,172,119,53,130900.72,58300,189200.72
310820,202104,332,262,70,288200,77000,365200
310825,202104,199,170,29,187000,31900,218900
310830,202104,476,225,251,247500,277200,524700
310840,202104,359,210,149,231000,163900,394900
310850,202104,82,68,14,74800,15400,90200
310855,202104,406,315,91,346500,100100,446600
310860,202104,1585,1168,417,1287000,458700,1745700
310870,202104,53,43,10,47300,11000,58300
310880,202104,83,65,18,72600,19800,92400
310890,202104,309,174,135,191400,148500,339900
310900,202104,640,281,359,309107.2,396010.8,705118.0
310910,202104,239,160,79,176000,86900,262900
310920,202104,452,263,189,289300,207900,497200
310925,202104,34,28,6,30800,6600,37400
310930,202104,1295,835,460,919600,506000,1425600
310940,202104,684,339,345,372900,379500,752400
310945,202104,121,78,43,85800,47300,133100
310950,202104,228,183,45,201300,49500,250800
310960,202104,76,24,52,26400,57200,83600
310970,202104,168,104,64,114400,70400,184800
310980,202104,50,31,19,34100,20900,55000
310990,202104,167,86,81,94600,89100,183700
311000,202104,812,394,418,433400.1,460900,894300.1
311010,202104,48,42,6,46200,6600,52800
311020,202104,45,24,21,26400,23100,49500
311030,202104,386,219,167,240900,183700,424600
311040,202104,42,33,9,36300,9900,46200
311050,202104,465,174,291,191400,320100,511500
311060,202104,768,419,349,462000,386100,848100
311070,202104,338,146,192,160600,211200,371800
311080,202104,109,60,49,66000,53900,119900
311090,202104,335,157,178,172700,196900,369600
311100,202104,571,337,234,370700,257400,628100
311110,202104,691,487,204,536800,224400,761200
311115,202104,75,53,22,58300,24200,82500
311120,202104,1061,563,498,619300,547800,1167100
311130,202104,313,184,129,202400,141900,344300
311140,202104,168,87,81,95700,89100,184800
311150,202104,342,219,123,240900,135300,376200
311160,202104,706,502,204,553300,224400,777700
311170,202104,86,69,17,75900,18700,94600
311180,202104,301,200,101,220000,111100,331100
311190,202104,42,18,24,19800,26400,46200
311200,202104,342,242,100,266200,110000,376200
311205,202104,34,25,9,27500,9900,37400
311210,202104,42,37,5,41800,5500,47300
311220,202104,29,25,4,27500,4400,31900
311230,202104,1627,1073,554,1180300,609400,1789700
311240,202104,192,121,71,133100,78100,211200
311250,202104,54,21,33,23100,36300,59400
311260,202104,555,349,206,383900,226600,610500
311265,202104,128,87,41,95700,45100,140800
311270,202104,284,197,87,216700,96800,313500
311280,202104,197,91,106,100100,116600,216700
311290,202104,103,84,19,92400,20900,113300
311300,202104,578,366,212,402600,233200,635800
311310,202104,20,16,4,17600,4400,22000
311320,202104,644,480,164,528000,180400,708400
311330,202104,1060,773,287,851400,315700,1167100
311340,202104,2599,1840,759,2025100,834900,2860000
311350,202104,272,213,59,234300,64900,299200
311360,202104,183,106,77,116600,84700,201300
311370,202104,1235,510,725,561000,798600,1359600
311380,202104,5,4,1,4400,1100,5500
311390,202104,250,137,113,150700,124300,275000
311400,202104,133,80,53,88000,58300,146300
311410,202104,113,58,55,63800,60500,124300
311420,202104,300,163,137,179300,150700,330000
311430,202104,837,558,279,614900,308000,922900
311440,202104,460,323,137,355300,150700,506000
311450,202104,301,180,121,198000,133100,331100
311455,202104,278,189,89,207900,97900,305800
311460,202104,138,61,77,67100,84700,151800
311470,202104,27,14,13,15400,14300,29700
311480,202104,48,23,25,25300,27500,52800
311490,202104,13,8,5,8800,5500,14300
311500,202104,26,12,14,13200,15400,28600
311510,202104,655,448,207,492800,227700,720500
311520,202104,38,30,8,34100,8800,42900
311530,202104,1793,1305,488,1436600,536800,1973400
311535,202104,66,43,23,47300,25300,72600
311540,202104,32,28,4,30800,4400,35200
311545,202104,165,120,45,132000,49500,181500
311547,202104,43,34,9,37400,9900,47300
311550,202104,676,305,371,336600,408100,744700
311560,202104,42,27,15,29700,16500,46200
311570,202104,284,190,94,209000,103400,312400
311580,202104,365,216,149,237600,163900,401500
311590,202104,31,27,4,29700,4400,34100
311600,202104,104,82,22,90200,24200,114400
311610,202104,244,207,37,227700,40700,268400
311615,202104,105,83,22,91300,24200,115500
311620,202104,24,15,9,16500,9900,26400
311630,202104,87,74,13,81400,14300,95700
311640,202104,134,65,69,71500,75900,147400
311650,202104,123,85,38,93500,41800,135300
311660,202104,402,195,207,214500,227700,442200
311670,202104,140,92,48,101200,52800,154000
311680,202104,209,157,52,172700,57200,229900
311690,202104,16,12,4,13200,4400,17600
311700,202104,188,135,53,148500,58300,206800
311710,202104,189,127,62,139700,68200,207900
311720,202104,38,28,10,30800,11000,41800
311730,202104,565,388,177,426800,194700,621500
311740,202104,25,17,8,18700,8800,27500
311750,202104,720,483,237,533501.12,260700,794201.12
311760,202104,69,30,39,33000,42900,75900
311770,202104,381,187,194,206800,213400,420200
311780,202104,183,90,93,99000,102300,201300
311783,202104,91,82,9,90200,9900,100100
311787,202104,34,12,22,13200,24200,37400
311790,202104,263,112,151,123200,166100,289300
311800,202104,682,440,242,484000,268400,752400
311810,202104,50,40,10,44000,11000,55000
311820,202104,122,99,23,108900,25300,134200
311830,202104,1856,1131,725,1248500,798600,2047100
311840,202104,994,550,444,606100,488400,1094500
311850,202104,13,9,4,9900,4400,14300
311860,202104,9507,4060,5447,4470400.65,5997200,10467600.65
311870,202104,118,64,54,70400,59400,129800
311880,202104,926,671,255,740300,280500,1020800
311890,202104,202,98,104,107709,114400,222109
311900,202104,70,28,42,30800,47300,78100
311910,202104,1368,855,513,940500,565400,1505900
311920,202104,228,150,78,165000,85800,250800
311930,202104,889,502,387,552200,425700,977900
311940,202104,2528,1324,1204,1457500,1326600,2784100
311950,202104,62,42,20,46200,22000,68200
311960,202104,63,46,17,50600,18700,69300
311970,202104,24,15,9,16500,9900,26400
311980,202104,44,34,10,37400,11000,48400
311990,202104,38,29,9,31900,9900,41800
311995,202104,54,33,21,36300,23100,59400
312000,202104,23,16,7,17600,7700,25300
312010,202104,76,58,18,63800,19800,83600
312015,202104,70,53,17,58300,18700,77000
312020,202104,128,87,41,95700,45100,140800
312030,202104,63,47,16,51700,17600,69300
312040,202104,78,52,26,57200,28600,85800
312050,202104,201,113,88,124300,96800,221100
312060,202104,22,13,9,14300,9900,24200
312070,202104,79,49,30,53900,33000,86900
312080,202104,531,243,288,269500,316800,586300
312083,202104,55,36,19,39600,20900,60500
312087,202104,96,74,22,81400,24200,105600
312090,202104,3222,1942,1280,2139500,1412400,3551900
312100,202104,148,103,45,113047,49500,162547
312110,202104,115,66,49,72600,53900,126500
312120,202104,131,97,34,106700.63,37400,144100.63
312125,202104,89,52,37,57200,40700,97900
312130,202104,134,86,48,94600,52800,147400
312140,202104,137,106,31,116600,34100,150700
312150,202104,42,32,10,35200,11000,46200
312160,202104,1539,1013,526,1115499,578600,1694099
312170,202104,10,8,2,8800,2200,11000
312180,202104,115,73,42,80300,46200,126500
312190,202104,36,32,4,35200,4400,39600
312200,202104,748,640,108,705100,118800,823900
312210,202104,119,64,55,70400,60500,130900
312220,202104,131,101,30,111100,33000,144100
312230,202104,3630,1656,1974,1822700,2172500,3995200
312235,202104,153,103,50,113300,55000,168300
312240,202104,89,63,26,69300,28600,97900
312245,202104,193,131,62,144100,68200,212300
312247,202104,76,54,22,59400,24200,83600
312250,202104,166,82,84,90200,92400,182600
312260,202104,103,69,34,75900,38500,114400
312270,202104,134,81,53,89100,58300,147400
312280,202104,28,13,15,14300,16500,30800
312290,202104,143,98,45,107800,49500,157300
312300,202104,205,135,70,148500,77000,225500
312310,202104,63,55,8,60500,8800,69300
312320,202104,423,265,158,292600,173800,466400
312330,202104,89,78,11,85800,12100,97900
312340,202104,35,16,19,17600,20900,38500
312350,202104,15,9,6,9900,6600,16500
312352,202104,94,70,24,77000,26400,103400
312360,202104,566,240,326,265100,358600,623700
312370,202104,313,174,139,191400,152900,344300
312380,202104,138,91,47,100100,51700,151800
312385,202104,157,128,29,140800,33000,173800
312390,202104,294,187,107,205700,117700,323400
312400,202104,378,279,99,306900,108900,415800
312410,202104,1039,324,715,358600,787600,1146200
312420,202104,623,473,150,520300,166100,686400
312430,202104,869,634,235,697401.13,258500,955901.13
312440,202104,41,30,11,33000,12100,45100
312450,202104,202,131,71,144100,78100,222200
312460,202104,31,16,15,17600,16500,34100
312470,202104,42,29,13,31900,14300,46200
312480,202104,182,112,70,123200,77000,200200
312490,202104,276,190,86,209000,94600,303600
312500,202104,35,20,15,22000,16500,38500
312510,202104,513,195,318,216700,349800,566500
312520,202104,30,9,21,9900,23100,33000
312530,202104,47,32,15,35200,16500,51700
312540,202104,90,79,11,86900,12100,99000
312550,202104,36,28,8,30800,8800,39600
312560,202104,201,152,49,167200,53900,221100
312570,202104,431,255,176,280500,193600,474100
312580,202104,93,49,44,53900,48400,102300
312590,202104,242,194,48,213400,52800,266200
312595,202104,127,110,17,121000,18700,139700
312600,202104,69,37,32,40700,35200,75900
312610,202104,1585,820,765,903100,843700,1746800
312620,202104,218,158,60,174900,66000,240900
312630,202104,69,57,12,62700,13200,75900
312640,202104,41,11,30,12100,33000,45100
312650,202104,147,121,26,133470.7,28600,162070.7
312660,202104,92,64,28,70400.01,30800,101200.01
312670,202104,931,604,327,665500,361900,1027400
312675,202104,27,22,5,24200,5500,29700
312680,202104,71,41,30,45100,33000,78100
312690,202104,240,121,119,133100,130900,264000
312695,202104,27,23,4,25300,4400,29700
312700,202104,220,128,92,140800,101200,242000
312705,202104,82,65,17,71500,19800,91300
312707,202104,130,92,38,101200,41800,143000
312710,202104,1848,994,854,1093400.59,941600,2035000.59
312720,202104,55,31,24,34100,26400,60500
312730,202104,280,163,117,179300,129800,309100
312733,202104,46,37,9,40700,9900,50600
312735,202104,21,14,7,15400,7700,23100
312737,202104,65,33,32,36300,35200,71500
312738,202104,57,37,20,40700,22000,62700
312740,202104,81,53,28,58300,30800,89100
312750,202104,89,62,27,68200,29700,97900
312760,202104,291,210,81,231000,89100,320100
312770,202104,8193,3730,4463,4112900.78,4913700,9026600.78
312780,202104,441,336,105,370700,115500,486200
312790,202104,21,15,6,16500,6600,23100
312800,202104,1606,1129,477,1243000,525800,1768800
312810,202104,366,240,126,264000,138600,402600
312820,202104,185,142,43,156200,47300,203500
312825,202104,29,19,10,20900,11000,31900
312830,202104,216,128,88,140800,96800,237600
312840,202104,158,104,54,114400,59400,173800
312850,202104,43,37,6,40700,6600,47300
312860,202104,151,95,56,104500,61600,166100
312870,202104,1057,544,513,599500,564300,1163800
312880,202104,121,85,36,93500,39600,133100
312890,202104,156,110,46,121000,50600,171600
312900,202104,188,140,48,154000,52800,206800
312910,202104,174,93,81,102300,89100,191400
312920,202104,142,79,63,86900,69300,156200
312930,202104,326,229,97,253000,106700,359700
312940,202104,122,83,39,91300,42900,134200
312950,202104,694,474,220,521400,242000,763400
312960,202104,155,117,38,128700,41800,170500
312965,202104,89,70,19,77000,20900,97900
312970,202104,279,231,48,254100,52800,306900
312980,202104,2448,1219,1229,1344200,1354100,2698300
312990,202104,49,25,24,27500,26400,53900
313000,202104,55,29,26,31900,28600,60500
313005,202104,177,136,41,149600,45100,194700
313010,202104,913,359,554,394900,611600,1006500
313020,202104,202,104,98,114400,107800,222200
313030,202104,201,130,71,143000,78100,221100
313040,202104,78,25,53,27500,58300,85800
313050,202104,183,132,51,145200,56100,201300
313055,202104,37,27,10,29700,11000,40700
313060,202104,131,88,43,96800,47300,144100
313065,202104,63,46,17,50600,18700,69300
313070,202104,134,69,65,75900,71500,147400
313080,202104,38,17,21,18700,23100,41800
313090,202104,654,426,228,468600,251900,720500
313100,202104,185,62,123,68200,136400,204600
313110,202104,143,73,70,80300,77000,157300
313115,202104,209,114,95,125400,105600,231000
313120,202104,837,470,367,517000,403700,920700
313130,202104,5826,3162,2664,3481500.48,2935900,6417400.48
313140,202104,136,75,61,82500,67100,149600
313150,202104,294,233,61,256300,67100,323400
313160,202104,185,139,46,152900,50600,203500
313170,202104,1397,930,467,1023000,513700,1536700
313180,202104,298,177,121,194700,133100,327800
313190,202104,737,437,300,480700,331100,811800
313200,202104,28,23,5,25300,5500,30800
313210,202104,991,843,148,927300,162800,1090100
313220,202104,290,175,115,193600,127600,321200
313230,202104,258,198,60,217800.5,66000,283800.5
313240,202104,2153,1100,1053,1213300,1159400,2372700
313250,202104,1258,958,300,1053800,331100,1384900
313260,202104,91,46,45,50600,49500,100100
313270,202104,988,572,416,629200,458700,1087900
313280,202104,49,42,7,46200,7700,53900
313290,202104,211,171,40,189200,44000,233200
313300,202104,338,175,163,192500,180400,372900
313310,202104,257,119,138,130900,151800,282700
313320,202104,388,287,101,315700,111100,426800
313330,202104,1399,854,545,939400,599500,1538900
313340,202104,318,225,93,248600,102300,350900
313350,202104,487,321,166,353100,182600,535700
313360,202104,149,69,80,75900,88000,163900
313370,202104,218,68,150,74800,165000,239800
313375,202104,292,173,119,191400,130900,322300
313380,202104,1331,687,644,755700,709500,1465200
313390,202104,46,43,3,47300,3300,50600
313400,202104,393,266,127,292600,139700,432300
313410,202104,27,14,13,15400,14300,29700
313420,202104,4532,2425,2107,2669700,2317700,4987400
313430,202104,136,66,70,72600,77000,149600
313440,202104,1392,965,427,1062601.13,470800,1533401.13
313450,202104,68,29,39,31900,42900,74800
313460,202104,378,163,215,180400,236500,416900
313470,202104,528,249,279,273900,306900,580800
313480,202104,145,106,39,116600,42900,159500
313490,202104,510,233,277,256300,304700,561000
313500,202104,30,16,14,17600,15400,33000
313505,202104,1034,807,227,887700,249700,1137400
313507,202104,96,56,40,61600,44000,105600
313510,202104,2836,1790,1046,1973497.1,1150600,3124097.1
313520,202104,3448,2695,753,2965601.5,828300,3793901.5
313530,202104,32,21,11,23100,12100,35200
313535,202104,67,52,15,57200,16500,73700
313540,202104,69,51,18,56100,19800,75900
313545,202104,119,101,18,111100,19800,130900
313550,202104,224,188,36,206800,39600,246400
313560,202104,340,164,176,180400,193600,374000
313570,202104,66,21,45,23100,49500,72600
313580,202104,1315,731,584,804100,642400,1446500
313590,202104,69,38,31,41800,34100,75900
313600,202104,674,402,272,443300,299200,742500
313610,202104,57,45,12,49500,13200,62700
313620,202104,1388,681,707,751300,778800,1530100
313630,202104,1592,1204,388,1326600,426800,1753400
313640,202104,120,72,48,79200,52800,132000
313650,202104,230,107,123,117700,135300,253000
313652,202104,22,22,0,24200,0,24200
313655,202104,66,41,25,45100,27500,72600
313657,202104,45,41,4,45100,4400,49500
313660,202104,131,88,43,96800,47319.8,144119.8
313665,202104,637,288,349,316800,385000,701800
313670,202104,10276,6991,3285,7701100,3620100,11321200
313680,202104,42,32,10,35200,11000,46200
313690,202104,137,102,35,112200,38500,150700
313695,202104,67,50,17,55000,18700,73700
313700,202104,316,250,66,275000,72600,347600
313710,202104,136,98,38,107800,41800,149600
313720,202104,1113,515,598,566500,660000,1226500
313730,202104,72,42,30,46200,33000,79200
313740,202104,147,119,28,130900,30800,161700
313750,202104,420,300,120,330000,133100,463100
313753,202104,229,169,60,185900,66000,251900
313760,202104,1314,473,841,520300,925100,1445400
313770,202104,384,272,112,299200,123200,422400
313780,202104,786,408,378,449900,415800,865700
313790,202104,28,27,1,29700,1100,30800
313800,202104,141,85,56,94600,61600,156200
313810,202104,78,46,32,50600,35200,85800
313820,202104,1312,618,694,680900,763400,1444300
313830,202104,53,39,14,42900,15400,58300
313835,202104,57,48,9,52800,9900,62700
313840,202104,1653,977,676,1076900.45,743600,1820500.45
313850,202104,209,79,130,86900,143000,229900
313860,202104,464,353,111,388300,122100,510400
313862,202104,160,104,56,114400,61600,176000
313865,202104,124,90,34,99000,37400,136400
313867,202104,55,44,11,48400,12100,60500
313868,202104,37,22,15,24200,16500,40700
313870,202104,107,58,49,63800,53900,117700
313880,202104,375,230,145,253000,159500,412500
313890,202104,327,168,159,184800,174900,359700
313900,202104,852,458,394,504900.66,434500,939400.66
313910,202104,148,102,46,112200,50600,162800
313920,202104,626,435,191,478500,210100.94,688600.94
313925,202104,33,28,5,30800,5500,36300
313930,202104,864,673,191,740300,210100,950400
313940,202104,1856,1133,723,1246300,796400,2042700
313950,202104,865,541,324,595100,357500,952600
313960,202104,1412,809,603,889900,663300,1553200
313970,202104,173,112,61,123200,67100,190300
313980,202104,197,128,69,140800,75900,216700
313990,202104,240,156,84,171600,92400,264000
314000,202104,871,570,301,627000,331100,958100
314010,202104,75,43,32,48400,35200,83600
314015,202104,68,18,50,19800,55000,74800
314020,202104,54,32,22,35200,24200,59400
314030,202104,74,33,41,36300,45100,81400
314040,202104,50,28,22,30800,24200,55000
314050,202104,284,167,117,183700,128700,312400
314053,202104,103,65,38,71500,41800,113300
314055,202104,294,182,112,200200,123200,323400
314060,202104,130,114,16,125400.83,17600,143000.83
314070,202104,1024,517,507,569800,559900,1129700
314080,202104,205,127,78,139700,85800,225500
314085,202104,153,101,52,111100,57200,168300
314090,202104,379,268,111,294800,122100,416900
314100,202104,512,412,100,453200,110000,563200
314110,202104,784,374,410,413600,451000,864600
314120,202104,74,43,31,47300,34100,81400
314130,202104,24,14,10,15400,11000,26400
314140,202104,1094,673,421,740300,463100,1203400
314150,202104,187,121,66,133100,73700,206800
314160,202104,331,246,85,271700,93500,365200
314170,202104,84,64,20,70400,22000,92400
314180,202104,731,643,88,707300,96800,804100
314190,202104,91,54,37,59400,40700,100100
314200,202104,498,341,157,375100,172700,547800
314210,202104,244,184,60,202400,66000,268400
314220,202104,292,210,82,231000,90200,321200
314225,202104,60,43,17,47300,18700,66000
314230,202104,114,50,64,55000,70400,125400
314240,202104,150,111,39,122100,42900,165000
314250,202104,54,31,23,34100,25300,59400
314260,202104,212,104,108,114400,118800,233200
314270,202104,392,303,89,333300,97900,431200
314280,202104,721,386,335,424550.5,368500,793050.5
314290,202104,543,432,111,475200,122100,597300
314300,202104,347,255,92,280500,101200,381700
314310,202104,1351,931,420,1024375.5,463100,1487475.5
314315,202104,37,28,9,30800,9900,40700
314320,202104,580,387,193,425700,212300,638000
314330,202104,11201,5473,5728,6021400.38,6310700,12332100.38
314340,202104,591,265,326,291500,358600,650100
314345,202104,52,36,16,39600,17600,57200
314350,202104,176,109,67,119900,73700,193600
314360,202104,60,36,24,39600,26400,66000
314370,202104,68,46,22,50600,24200,74800
314380,202104,99,61,38,68200,41800,110000
314390,202104,3315,2121,1194,2335300,1316700,3652000
314400,202104,690,488,202,536800,222200,759000
314410,202104,485,314,171,345400,188100,533500
314420,202104,15,8,7,8800,7700,16500
314430,202104,2445,896,1549,985601.51,1706100,2691701.51
314435,202104,181,107,74,117700,83600,201300
314437,202104,29,22,7,24200,7700,31900
314440,202104,96,65,31,71500,34100,105600
314450,202104,163,113,50,124300,55000,179300
314460,202104,634,303,331,333300,366300,699600
314465,202104,96,60,36,66000,39600,105600
314467,202104,70,56,14,62700,15400,78100
314470,202104,400,198,202,217800,222200,440000
314480,202104,1020,469,551,517000,606100,1123100
314490,202104,45,29,16,31900,17600,49500
314500,202104,279,194,85,213400,93500,306900
314505,202104,109,67,42,73700,46200,119900
314510,202104,246,201,45,221100,49500,270600
314520,202104,1301,694,607,764500,667700,1432200
314530,202104,725,575,150,632500.7,165000,797500.7
314535,202104,162,98,64,107800,70400,178200
314537,202104,63,37,26,40700,28600,69300
314540,202104,15,9,6,9900,6600,16500
314545,202104,52,34,18,37400,19800,57200
314550,202104,78,41,37,45100,40700,85800
314560,202104,847,455,392,500500,432300,932800
314570,202104,20,15,5,16500,5500,22000
314580,202104,13,5,8,5500,8800,14300
314585,202104,25,16,9,17600,9900,27500
314587,202104,80,68,12,74800,13200,88000
314590,202104,549,385,164,423500,180400,603900
314600,202104,932,589,343,650100,378400,1028500
314610,202104,928,471,457,518100,502700,1020800
314620,202104,139,103,36,113300,39600,152900
314625,202104,95,69,26,75900,28600,104500
314630,202104,1150,610,540,672100,594000,1266100
314640,202104,81,53,28,58300,30800,89100
314650,202104,170,95,75,104500,82500,187000
314655,202104,60,44,16,48400,17600,66000
314660,202104,16,13,3,14300,3300,17600
314670,202104,196,150,46,165000,50600,215600
314675,202104,207,123,84,135300,92400,227700
314690,202104,591,312,279,343200,306900,650100
314700,202104,2258,1210,1048,1332100,1153900,2486000
314710,202104,1730,977,753,1076900,828300,1905200
314720,202104,392,224,168,246400,184800,431200
314730,202104,512,270,242,297000,266200,563200
314740,202104,742,350,392,386100,431200,817300
314750,202104,19,15,4,16500,4400,20900
314760,202104,355,156,199,171600,218900,390500
314770,202104,106,72,34,79200,37400,116600
314780,202104,22,8,14,8800,15400,24200
314790,202104,2415,1523,892,1677500,981200,2658700
314795,202104,52,44,8,48400,8800,57200
314800,202104,2921,1689,1232,1860100.76,1355200,3215300.76
314810,202104,1482,847,635,932800,698500,1631300
314820,202104,106,59,47,64900,51700,116600
314830,202104,213,173,40,190300,44000,234300
314840,202104,86,51,35,56100,38500,94600
314850,202104,398,194,204,213400,224400,437800
314860,202104,655,501,154,551100,169400,720500
314870,202104,1529,792,737,872300,810700,1683000
314875,202104,54,49,5,53900,5500,59400
314880,202104,45,31,14,34100,15400,49500
314890,202104,49,27,22,29700,24200,53900
314900,202104,29,23,6,25300,6600,31900
314910,202104,238,155,83,170500,92400,262900
314915,202104,138,123,15,135300,16500,151800
314920,202104,96,62,34,69300,37400,106700
314930,202104,1028,494,534,544500,588500,1133000
314940,202104,47,38,9,41800,9900,51700
314950,202104,30,22,8,24200,8800,33000
314960,202104,30,22,8,24200,8800,33000
314970,202104,150,74,76,81400,83600,165000
314980,202104,309,199,110,220000,121000,341000
314990,202104,433,236,197,259600,216700,476300
314995,202104,157,63,94,69300,103400,172700
315000,202104,77,58,19,63800,20900,84700
315010,202104,39,25,14,27500,15400,42900
315015,202104,167,131,36,144100,40700,184800
315020,202104,68,57,11,62700,12100,74800
315030,202104,109,85,24,93500,26400,119900
315040,202104,76,48,28,52800,30800,83600
315050,202104,191,115,76,126500,83600,210100
315053,202104,42,31,11,34100,12100,46200
315057,202104,105,82,23,90200,25300,115500
315060,202104,72,60,12,67100,13200,80300
315070,202104,107,61,46,67100,50600,117700
315080,202104,378,297,81,326700,89100,415800
315090,202104,93,53,40,58300,44000,102300
315100,202104,77,39,38,42900,41800,84700
315110,202104,270,143,127,157300,139700,297000
315120,202104,1766,849,917,935000,1009800,1944800
315130,202104,337,244,93,268400,102300,370700
315140,202104,533,291,242,320100,266200,586300
315150,202104,984,471,513,519200,564300,1083500
315160,202104,206,101,105,111100,115500,226600
315170,202104,308,206,102,226600,112200,338800
315180,202104,3241,1337,1904,1471800,2094400,3566200
315190,202104,303,183,120,201300,132000,333300
315200,202104,1203,716,487,788700.75,539000,1327700.75
315210,202104,1621,920,701,1014200,772200,1786400
315213,202104,30,18,12,19800,13200,33000
315217,202104,202,157,45,172700,49500,222200
315220,202104,1578,1184,394,1303500,433400,1736900
315230,202104,169,122,47,134200,51700,185900
315240,202104,413,262,151,288200,166100,454300
315250,202104,2561,1237,1324,1362900,1458600,2821500
315260,202104,137,79,58,86900,63800,150700
315270,202104,133,89,44,97900,48400,146300
315280,202104,643,417,226,458700,249700,708400
315290,202104,191,120,71,132000,78100,210100
315300,202104,79,58,21,63800,23100,86900
315310,202104,77,67,10,73700,11000,84700
315320,202104,153,90,63,99000,69300,168300
315330,202104,57,46,11,50600,12100,62700
315340,202104,387,283,104,311300,114400,425700
315350,202104,153,93,60,102300,66000,168300
315360,202104,93,43,50,47300,55000,102300
315370,202104,56,36,20,39600,22000,61600
315380,202104,6,6,0,6600,0,6600
315390,202104,62,16,46,17600,50600,68200
315400,202104,810,602,208,663300,228800,892100
315410,202104,317,185,132,203500,145200,348700
315415,202104,58,44,14,48400,15400,63800
315420,202104,196,142,54,156200,59400,215600
315430,202104,653,373,280,411400,308000,719400
315440,202104,98,64,34,70400,37400,107800
315445,202104,230,193,37,212300,40700,253000
315450,202104,182,135,47,148500,51700,200200
315460,202104,4097,1941,2156,2138400,2379300,4517700
315470,202104,40,16,24,17600,26400,44000
315480,202104,72,21,51,23100,56100,79200
315490,202104,695,425,270,467500,298100,765600
315500,202104,16,13,3,14300,3300,17600
315510,202104,147,100,47,110000,51700,161700
315520,202104,71,62,9,68200,9900,78100
315530,202104,41,22,19,24200,20900,45100
315540,202104,251,176,75,193600,82500,276100
315550,202104,180,147,33,161700,36300,198000
315560,202104,736,588,148,646800,163900,810700
315570,202104,312,153,159,168300.63,174900,343200.63
315580,202104,727,493,234,542300,257400,799700
315590,202104,194,100,94,110000,104500,214500
315600,202104,311,237,74,260700,81400,342100
315610,202104,101,49,52,53900,57200,111100
315620,202104,36,28,8,30800,8800,39600
315630,202104,124,83,41,91300,45100,136400
315640,202104,70,43,27,47300,29700,77000
315645,202104,48,32,16,35200,17600,52800
315650,202104,174,126,48,138600,52800,191400
315660,202104,453,195,258,214500,283800,498300
315670,202104,2368,1102,1266,1212200,1392600,2604800
315680,202104,821,582,239,641300,262900,904200
315690,202104,675,462,213,509300,234300,743600
315700,202104,1931,1007,924,1109900.28,1017500,2127400.28
315710,202104,352,101,251,111100,276100,387200
315720,202104,467,286,181,314600,199100,513700
315725,202104,190,154,36,169400,39600,209000
315727,202104,50,23,27,25300,29700,55000
315730,202104,46,42,4,46200,4400,50600
315733,202104,88,59,29,64900,31900,96800
315737,202104,52,39,13,42900,14300,57200
315740,202104,31,25,6,27500,6600,34100
315750,202104,150,113,37,124300,41800,166100
315760,202104,39,29,10,31900,11000,42900
315765,202104,116,67,49,73700,53900,127600
315770,202104,216,134,82,147400,90200,237600
315780,202104,3564,1759,1805,1937100,1987700,3924800
315790,202104,235,183,52,201300,57200,258500
315800,202104,299,202,97,222200,106700,328900
315810,202104,94,57,37,62700,40700,103400
315820,202104,756,555,201,611600,221100,832700
315830,202104,117,76,41,83600,45100,128700
315840,202104,86,55,31,60500,34100,94600
315850,202104,257,183,74,201300,81400,282700
315860,202104,13,5,8,5500,8800,14300
315870,202104,41,30,11,33000,12100,45100
315880,202104,101,67,34,73700,37400,111100
315890,202104,93,68,25,74800,27500,102300
315895,202104,414,276,138,303600,152900,456500
315900,202104,67,32,35,35200,38500,73700
315910,202104,39,23,16,25300,17600,42900
315920,202104,157,103,54,113300,59400,172700
315930,202104,54,18,36,19800,39600,59400
315935,202104,129,103,26,113300,28600,141900
315940,202104,101,75,26,82500,28600,111100
315950,202104,37,29,8,31900,8800,40700
315960,202104,535,249,286,273900,314600,588500
315970,202104,32,26,6,28600,6600,35200
315980,202104,676,334,342,367400,376200,743600
315990,202104,254,146,108,161700,118800,280500
316000,202104,48,31,17,34100,18700,52800
316010,202104,78,64,14,70400,15400,85800
316020,202104,116,100,16,110000,17600,127600
316030,202104,375,206,169,226600,185900,412500
316040,202104,536,219,317,240900,349800,590700
316045,202104,51,45,6,49500,6600,56100
316050,202104,17,13,4,14300,4400,18700
316060,202104,93,64,29,70400,31900,102300
316070,202104,1070,691,379,761200,418000,1179200
316080,202104,90,62,28,68296.8,30800,99096.8
316090,202104,39,21,18,23100,19800,42900
316095,202104,90,75,15,82500,16500,99000
316100,202104,320,180,140,198000,154000,352000
316105,202104,42,25,17,27500,18700,46200
316110,202104,1874,1477,397,1624700.5,436700,2061400.5
316120,202104,75,53,22,58300,24200,82500
316130,202104,121,91,30,100100,33000,133100
316140,202104,30,17,13,18700,14300,33000
316150,202104,207,145,62,159500,68200,227700
316160,202104,84,47,37,51700,40700,92400
316165,202104,66,46,20,50600,22000,72600
316170,202104,180,118,62,129800,68200,198000
316180,202104,201,84,117,92400,128700,221100
316190,202104,131,92,39,101200,42900,144100
316200,202104,665,356,309,391600,339900,731500
316210,202104,767,511,256,564489.2,281600,846089.2
316220,202104,119,77,42,84700,46200,130900
316225,202104,30,17,13,18700,14300,33000
316230,202104,36,18,18,19800,19800,39600
316240,202104,656,522,134,577500,147400,724900
316245,202104,139,120,19,132000,20900,152900
316250,202104,1535,1035,500,1138500,552200,1690700
316255,202104,127,101,26,111100,28600,139700
316257,202104,173,88,85,96800,93500,190300
316260,202104,189,134,55,147400,60500,207900
316265,202104,29,21,8,23100,8800,31900
316270,202104,683,478,205,525800,225500,751300
316280,202104,550,340,210,374000.63,232100,606100.63
316290,202104,766,506,260,556600,286000,842600
316292,202104,530,211,319,232100,350900,583000
316294,202104,103,66,37,72600,40700,113300
316295,202104,311,134,177,147400,194700,342100
316300,202104,108,71,37,78100,40700,118800
316310,202104,26,13,13,14300,14300,28600
316320,202104,53,28,25,30800,27500,58300
316330,202104,168,113,55,124300,60500,184800
316340,202104,135,89,46,97900,50600,148500
316350,202104,191,135,56,148500,61600,210100
316360,202104,22,14,8,15400,8800,24200
316370,202104,1143,575,568,632500,628100,1260600
316380,202104,113,87,26,95736.66,28600,124336.66
316390,202104,111,78,33,85800,36300,122100
316400,202104,132,101,31,111100,34100,145200
316410,202104,305,220,85,242000,93500,335500
316420,202104,210,141,69,155100,75900,231000
316430,202104,151,79,72,86900,79200,166100
316440,202104,84,42,42,46200,46200,92400
316443,202104,38,35,3,38500,3300,41800
316447,202104,48,36,12,39600,13200,52800
316450,202104,219,169,50,185900,55000,240900
316460,202104,79,28,51,30800,56100,86900
316470,202104,1656,1206,450,1327689.65,495000,1822689.65
316480,202104,11,8,3,8800,3300,12100
316490,202104,20,6,14,6600,15400,22000
316500,202104,158,105,53,115500,58300,173800
316510,202104,150,113,37,124300,40700,165000
316520,202104,197,114,83,125400,91300,216700
316530,202104,163,107,56,117700,61600,179300
316540,202104,150,77,73,84700,80300,165000
316550,202104,144,90,54,99000,59400,158400
316553,202104,313,141,172,155100,189200.72,344300.72
316555,202104,49,41,8,45100,8800,53900
316556,202104,14,10,4,11000,4400,15400
316557,202104,25,21,4,23100,4400,27500
316560,202104,66,45,21,49500,23100,72600
316570,202104,212,192,20,211200,22000,233200
316580,202104,20,14,6,15400,6600,22000
316590,202104,100,83,17,91300,18700,110000
316600,202104,173,144,29,158400,31900,190300
316610,202104,66,50,16,55000,17600,72600
316620,202104,138,100,38,110000,41800,151800
316630,202104,40,30,10,33000,11000,44000
316640,202104,22,14,8,15400,8800,24200
316650,202104,78,63,15,69300,16500,85800
316660,202104,8,2,6,2200,6600,8800
316670,202104,445,153,292,168300,321200,489500
316680,202104,158,114,44,125400,48400,173800
316690,202104,175,108,67,118800,73700,192500
316695,202104,60,51,9,56100,9900,66000
316700,202104,18,12,6,13200,6600,19800
316710,202104,766,579,187,636900,205700,842600
316720,202104,5040,2441,2599,2687300,2861100,5548400
316730,202104,16,16,0,17600,0,17600
316740,202104,141,92,49,101200,53900,155100
316750,202104,18,12,6,13200,6600,19800
316760,202104,312,252,60,277200,66000,343200
316770,202104,165,88,77,99000,84700,183700
316780,202104,68,43,25,47300,27500,74800
316790,202104,56,40,16,44000,17600,61600
316800,202104,1764,1095,669,1205600,738100,1943700
316805,202104,24,18,6,19800,6600,26400
316810,202104,65,41,24,45100,26400,71500
316820,202104,38,19,19,20900,20900,41800
316830,202104,93,43,50,47300,55000,102300
316840,202104,504,292,212,321200,234300,555500
316850,202104,324,217,107,238700,117700,356400
316860,202104,5905,2609,3296,2871000,3628900,6499900
316870,202104,1554,993,561,1093400,618200,1711600
316880,202104,135,66,69,72600,77000,149600
316890,202104,234,160,74,176000,81400,257400
316900,202104,412,285,127,313500,139700,453200
316905,202104,20,10,10,11000,11000,22000
316910,202104,67,28,39,30800,42900,73700
316920,202104,138,107,31,117700,34100,151800
316930,202104,1880,941,939,1036200,1034000,2070200
316935,202104,898,536,362,589600,398200,987800
316940,202104,1087,616,471,678700,518100,1196800
316950,202104,176,88,88,96800,96800,193600
316960,202104,1097,615,482,678700,531300,1210000
316970,202104,642,511,131,562100,145200,707300
316980,202104,73,40,33,44000,36300,80300
316990,202104,2140,1426,714,1569700,785400.84,2355100.84
317000,202104,329,252,77,277200,84700,361900
317005,202104,229,159,70,174900,77000,251900
317010,202104,6384,3529,2855,3891800,3142700,7034500
317020,202104,15725,6889,8836,7588900.11,9727300,17316200.11
317030,202104,81,31,50,34100,55000,89100
317040,202104,3040,1919,1121,2112000,1236400.13,3348400.13
317043,202104,69,51,18,56100,19800,75900
317047,202104,35,17,18,18700,19800,38500
317050,202104,153,115,38,126500,42900,169400
317052,202104,138,106,32,117700,35200,152900
317057,202104,166,128,38,141900,42900,184800
317060,202104,60,38,22,42900,24200,67100
317065,202104,48,38,10,41800,11000,52800
317070,202104,1927,886,1041,974600,1146200,2120800
317075,202104,99,54,45,59400,49500,108900
317080,202104,898,455,443,502700,487300,990000
317090,202104,694,544,150,598400,165000,763400
317100,202104,415,312,103,344300,113300,457600
317103,202104,109,88,21,96800,25300,122100
317107,202104,45,39,6,42900,6600,49500
317110,202104,113,52,61,57200,67100,124300
317115,202104,42,38,4,41800,4400,46200
317120,202104,1936,915,1021,1006500,1125300,2131800
317130,202104,1970,1303,667,1433300,734800,2168100
317140,202104,10,9,1,9900,1100,11000
317150,202104,274,163,111,179300,122100,301400
317160,202104,322,243,79,267300.63,86900,354200.63
317170,202104,225,152,73,167200,80300,247500
317180,202104,447,303,144,333300,158400,491700
317190,202104,269,191,78,211200,85800,297000
317200,202104,816,564,252,620400,277200,897600
317210,202104,180,98,82,107800,90200,198000
317220,202104,23,12,11,13200,12100,25300
320010,202104,579,419,160,460900,176000,636900
320013,202104,120,85,35,93500,38500,132000
320016,202104,269,173,96,190300,105600,295900
320020,202104,725,421,304,464200.5,334400,798600.5
320030,202104,161,110,51,121000.08,56100.08,177100.16
320035,202104,138,98,40,107800,44000,151800
320040,202104,504,256,248,281600,272800,554400
320050,202104,109,77,32,84700,35200,119900
320060,202104,1716,821,895,903100,985600,1888700
320070,202104,101,62,39,68200,42900,111100
320080,202104,805,467,338,513700,371800,885500
320090,202104,1254,828,426,911900,469700,1381600
320100,202104,333,194,139,213400,152900,366300
320110,202104,117,73,44,81400,48400,129800
320115,202104,113,92,21,101200,23100,124300
320120,202104,3585,1884,1701,2073500,1872200.74,3945700.74
320130,202104,7554,3381,4173,3721300.5,4598000,8319300.5
320140,202104,430,279,151,309100,166100.81,475200.81
320150,202104,2067,1148,919,1265000,1010900,2275900
320160,202104,656,290,366,319000,402600,721600
320170,202104,109,86,23,94600.1,25300.02,119900.12
320180,202104,54,32,22,35200,24200,59400
320190,202104,236,150,86,165000,94600,259600
320200,202104,56,42,14,47300,15400,62700
320210,202104,896,485,411,533500,452100,985600
320220,202104,299,107,192,117700,213400,331100
320225,202104,85,67,18,73700,20900,94600
320230,202104,635,401,234,441100,257400,698500
320240,202104,3406,1610,1796,1773200,1975600,3748800
320245,202104,484,329,155,361900,170500,532400
320250,202104,230,116,114,127600,125400,253000
320255,202104,131,103,28,113300,30800,144100
320260,202104,220,135,85,149600.81,93500.12,243100.93
320265,202104,153,114,39,125400,42900,168300
320270,202104,152,120,32,132000,35200,167200
320280,202104,1146,654,492,720500.5,541200.02,1261700.52
320290,202104,57,48,9,52800,9900,62700
320300,202104,593,406,187,446600.02,205700,652300.02
320305,202104,687,359,328,394900,360800,755700
320310,202104,198,114,84,125400,93500,218900
320313,202104,338,157,181,174900,199100,374000
320316,202104,110,84,26,92400,28600,121000
320320,202104,3407,1498,1909,1648900,2102100,3751000
320330,202104,262,195,67,214500,73700,288200
320332,202104,762,453,309,498300,339900,838200
320334,202104,249,137,112,151800.02,123200,275000.02
320335,202104,142,93,49,102300,53900,156200
320340,202104,568,396,172,435600,191400,627000
320350,202104,1022,424,598,466400.5,657800,1124200.5
320360,202104,164,83,81,91300,89100,180400
320370,202104,239,176,63,193600,69300,262900
320380,202104,284,197,87,217800,95700,313500
320390,202104,1147,679,468,748000,514800,1262800
320400,202104,321,231,90,255200,99000,354200
320405,202104,976,395,581,434500,639100,1073600
320410,202104,961,486,475,534600,523600,1058200
320420,202104,519,246,273,270600,300300,570900
320425,202104,192,103,89,113300,97900,211200
320430,202104,386,205,181,225500,199100,424600
320435,202104,157,104,53,114400,58300,172700
320440,202104,201,116,85,127600.24,93500.2,221100.44
320450,202104,126,70,56,77000,61600,138600
320455,202104,251,201,50,221100,55000,276100
320460,202104,282,170,112,187000,123200,310200
320465,202104,112,75,37,82500,41800,124300
320470,202104,706,429,277,471900,305800,777700
320480,202104,197,126,71,138600,78100,216700
320490,202104,3068,1482,1586,1631301.23,1744601.3,3375902.53
320495,202104,113,68,45,74800,49500,124300
320500,202104,9574,4669,4905,5142500.28,5402100,10544600.28
320501,202104,543,272,271,299200,298100,597300
320503,202104,289,202,87,222200.1,95700.02,317900.12
320506,202104,262,183,79,201300,86900,288200
320510,202104,1078,478,600,526900,660000,1186900
320515,202104,80,60,20,66000,22000,88000
320517,202104,214,154,60,169400,66000,235400
320520,202104,7062,2973,4089,3273600,4501200,7774800
320530,202104,6353,3109,3244,3422081.5,3572800,6994881.5
330010,202104,3077,1516,1561,1669800,1718200,3388000
330015,202104,177,71,106,78100,117700,195800
330020,202104,3759,1517,2242,1672000,2468400,4140400
330022,202104,253,128,125,141900,137500,279400
330023,202104,654,199,455,218900,501600,720500
330025,202104,580,106,474,116600,522500,639100
330030,202104,1843,1136,707,1251800,779900,2031700
330040,202104,2446,1226,1220,1348600.43,1342000.5,2690600.93
330045,202104,9298,2756,6542,3032701.2,7205000,10237701.2
330050,202104,874,554,320,609400,352000,961400
330060,202104,1041,612,429,674300,473000,1147300
330070,202104,3898,1362,2536,1498200,2792900,4291100
330080,202104,1581,682,899,750200,990000,1740200
330090,202104,394,227,167,249700,183700,433400
330093,202104,260,113,147,124300,161700,286000
330095,202104,77,45,32,49500,35200,84700
330100,202104,9975,4939,5036,5438400.52,5548400,10986800.52
330110,202104,464,194,270,213400,297000,510400
330115,202104,508,268,240,294800,264000,558800
330120,202104,384,190,194,209000,213400,422400
330130,202104,1563,388,1175,426800,1294700,1721500
330140,202104,613,321,292,353100,321200,674300
330150,202104,514,292,222,322300,244200,566500
330160,202104,207,121,86,134200,94600,228800
330170,202104,27008,8957,18051,9868100,19872600.59,29740700.59
330180,202104,238,137,101,150700,111100,261800
330185,202104,968,345,623,379500,685300,1064800
330187,202104,423,122,301,134200,332200,466400
330190,202104,5908,2188,3720,2406800,4095300,6502100
330200,202104,4660,1385,3275,1524600.86,3606900,5131500.86
330205,202104,438,250,188,275000,206800,481800
330210,202104,939,571,368,628100,405900,1034000
330220,202104,2674,1560,1114,1718200,1227600,2945800
330225,202104,567,283,284,311300,312400,623700
330227,202104,2407,721,1686,794200,1861200,2655400
330230,202104,256,143,113,157300,124300,281600
330240,202104,3906,1933,1973,2128500.2,2172500,4301000.2
330245,202104,151,64,87,71500,95700,167200
330250,202104,6658,3282,3376,3613500,3721300,7334800
330260,202104,628,157,471,172700,519200,691900
330270,202104,3679,1198,2481,1317800,2732400,4050200
330280,202104,448,286,162,314600,179300,493900
330285,202104,6885,2099,4786,2311100,5270100,7581200
330290,202104,675,239,436,262900,480700,743600
330300,202104,766,493,273,546275.4,300300,846575.4
330310,202104,439,241,198,265100,217800,482900
330320,202104,7962,2834,5128,3120700,5652997.9,8773697.9
330330,202104,9169,3367,5802,3704800.02,6386600,10091400.02
330340,202104,2660,1528,1132,1681900,1248500,2930400
330350,202104,18667,6905,11762,7602100,12953600.5,20555700.5
330360,202104,2175,1025,1150,1127500,1265000,2392500
330370,202104,1003,496,507,545600,557700,1103300
330380,202104,912,375,537,412500,590700.01,1003200.01
330385,202104,627,320,307,352000,339900,691900
330390,202104,5726,2941,2785,3238400,3070100,6308500
330395,202104,318,188,130,206800,143000,349800
330400,202104,696,362,334,398200.85,367400,765600.85
330410,202104,497,357,140,392700,154000,546700
330411,202104,266,136,130,149600,143000,292600
330412,202104,222,87,135,95700,148500,244200
330414,202104,5330,2106,3224,2318800,3547500,5866300
330415,202104,609,260,349,287100,385000,672100
330420,202104,2240,1117,1123,1229800,1236400,2466200
330430,202104,1785,788,997,867900,1098900,1966800
330440,202104,303,136,167,150700,183700,334400
330450,202104,120,51,69,56100,75900,132000
330452,202104,2155,924,1231,1017500.61,1355200,2372700.61
330455,202104,114733,38924,75809,42874796,83541910.05,126416706.05
330460,202104,250,108,142,118800,156200,275000
330470,202104,1221,663,558,729300,613800,1343100
330475,202104,1591,418,1173,459800,1291400,1751200
330480,202104,821,445,376,489500,413600,903100
330490,202104,14963,4644,10319,5111805,11365200,16477005
330500,202104,1409,596,813,655600,894300,1549900
330510,202104,10888,3692,7196,4064500,7925500,11990000
330513,202104,94,47,47,51700,51700,103400
330515,202104,762,312,450,344300,496100,840400
330520,202104,2513,864,1649,951500,1815000,2766500
330530,202104,197,112,85,123200,93500,216700
330540,202104,352,175,177,192500,194700,387200
330550,202104,2912,972,1940,1069200,2137300,3206500
330555,202104,812,316,496,347600,545600,893200
330560,202104,694,227,467,249700,513700,763400
330570,202104,272,190,82,209000,90200,299200
330575,202104,799,278,521,305800,575300,881100
330580,202104,3373,1852,1521,2041600.5,1673100,3714700.5
330590,202104,275,143,132,157300.5,145200,302500.5
330600,202104,1197,734,463,807400,511500,1318900
330610,202104,1571,835,736,918500,809600,1728100
330615,202104,214,167,47,183700,51700,235400
330620,202104,1080,398,682,438900,750200,1189100
330630,202104,4113,2491,1622,2743401.05,1787720,4531121.05
350010,202104,572,378,194,415800.88,213400,629200.88
350020,202104,58,22,36,24200,39600,63800
350030,202104,511,318,193,349800,212300,562100
350040,202104,123,52,71,57200,78100,135300
350050,202104,323,167,156,183700,171600,355300
350055,202104,105,49,56,53900,61600,115500
350060,202104,83,29,54,31900,59400,91300
350070,202104,774,455,319,500500.2,352000,852500.2
350075,202104,72,47,25,51700,27500,79200
350080,202104,56,27,29,29700,31900,61600
350090,202104,79,45,34,49500,37400,86900
350100,202104,280,172,108,189200,118800,308000
350110,202104,58,42,16,46200,17600,63800
350115,202104,146,91,55,100100,60500,160600
350120,202104,108,68,40,74800,44000,118800
350130,202104,366,163,203,179300.56,223300,402600.56
350140,202104,40,25,15,27500,16500,44000
350150,202104,78,58,20,63800,22000,85800
350160,202104,2401,949,1452,1046100,1600500,2646600
350170,202104,376,216,160,237600,177100,414700
350180,202104,167,97,70,106700,77000,183700
350190,202104,995,525,470,577500.63,517000,1094500.63
350200,202104,67,25,42,27500,46200,73700
350210,202104,1281,705,576,775500,634700.63,1410200.63
350220,202104,644,529,115,581900.63,126500,708400.63
350230,202104,74,51,23,56100,25300,81400
350240,202104,59,41,18,45100,19800,64900
350250,202104,1148,536,612,590700,674300,1265000
350260,202104,95,68,27,75900,29700,105600
350270,202104,885,595,290,654500,320100,974600
350275,202104,289,119,170,130900,187000,317900
350280,202104,4472,2246,2226,2470600,2449700,4920300
350290,202104,447,198,249,218900,273900,492800
350300,202104,56,29,27,31900,29700,61600
350310,202104,79,51,28,56100,30800,86900
350315,202104,63,28,35,30800,38500,69300
350320,202104,3278,1582,1696,1743500,1866700,3610200
350330,202104,1645,865,780,951501.26,858000,1809501.26
350335,202104,16,12,4,13200,4400,17600
350340,202104,126,55,71,60500,78100,138600
350350,202104,95,49,46,53900,50600,104500
350360,202104,108,71,37,78100,40700,118800
350370,202104,79,43,36,47300.63,39600,86900.63
350380,202104,781,333,448,367400,493900,861300
350390,202104,1632,601,1031,662200.5,1135200,1797400.5
350395,202104,22,18,4,19800,4400,24200
350400,202104,1664,827,837,910801.89,924000.63,1834802.52
350410,202104,2758,1171,1587,1288100,1746820.63,3034920.63
350420,202104,252,152,100,167200,110000,277200
350430,202104,73,41,32,45100,35200,80300
350440,202104,154,110,44,122100.02,48400,170500.02
350450,202104,1681,966,715,1063700.63,786500,1850200.63
350460,202104,398,135,263,149600,289300,438900
350470,202104,19,10,9,11000,9900,20900
350480,202104,179,99,80,108900,88000,196900
350490,202104,236,111,125,122100,137500,259600
350500,202104,54,23,31,25300,34100,59400
350510,202104,165,104,61,114400,67100,181500
350520,202104,430,227,203,250800,223300,474100
350530,202104,430,198,232,217800,256300,474100
350535,202104,82,62,20,68200,22000,90200
350540,202104,371,191,180,210100,198000,408100
350550,202104,2647,1521,1126,1674200.77,1241901.26,2916102.03
350560,202104,588,403,185,443300,204600,647900
350570,202104,4169,1711,2458,1885400.63,2708201.27,4593601.90
350580,202104,361,176,185,193600,204600,398200
350590,202104,921,490,431,540100,474100,1014200
350600,202104,6047,2870,3177,3159200,3498000,6657200
350610,202104,1479,762,717,840400.63,789800,1630200.63
350620,202104,26,16,10,17600,11000,28600
350630,202104,245,137,108,150700.63,118800.63,269501.26
350635,202104,982,388,594,426800,654500,1081300
350640,202104,117,88,29,96800,31900,128700
350650,202104,1850,1237,613,1364000,675400,2039400
350660,202104,748,308,440,338800,484000,822800
350670,202104,305,150,155,166100,170500,336600
350680,202104,171,88,83,96800,91300,188100
350690,202104,193,88,105,96800,115500,212300
350700,202104,811,391,420,430100,463100,893200
350710,202104,376,138,238,151800,261800,413600
350715,202104,54,43,11,47300,12100,59400
350720,202104,17,11,6,12100,6600,18700
350730,202104,44,27,17,29700,18700,48400
350740,202104,218,126,92,138600,101200,239800
350745,202104,25,10,15,11000,16500,27500
350750,202104,2217,1340,877,1474000,964700,2438700
350760,202104,3691,1536,2155,1692900,2377100,4070000
350770,202104,55,40,15,44000,17600,61600
350775,202104,43,31,12,34100,13200,47300
350780,202104,426,214,212,235400,233200,468600
350790,202104,364,153,211,171600,232100,403700
350800,202104,476,284,192,312400,211200,523600
350810,202104,518,412,106,453200,116600,569800
350820,202104,91,52,39,57200,42900,100100
350830,202104,76,40,36,44000,39600,83600
350840,202104,760,302,458,332200,503800,836000
350850,202104,1730,935,795,1028500,875600,1904100
350860,202104,601,329,272,361900,299200,661100
350870,202104,437,287,150,315700,165000,480700
350880,202104,277,154,123,169400,135300,304700
350890,202104,39,24,15,26400,16500,42900
350900,202104,1482,458,1024,503800,1128600.63,1632400.63
350910,202104,28,16,12,17600,13200,30800
350920,202104,704,366,338,402600,371800,774400
350925,202104,1160,614,546,675400,601700.63,1277100.63
350930,202104,99,60,39,66000,42900,108900
350940,202104,726,399,327,438900,363000,801900
350945,202104,112,81,31,89100,34100,123200
350950,202104,16422,7565,8857,8328100.63,9759200.59,18087301.22
350960,202104,1419,600,819,661100,903100,1564200
350970,202104,1070,551,519,605981.2,572000,1177981.2
350980,202104,95,63,32,69300,35200,104500
350990,202104,368,133,235,146300,258500,404800
350995,202104,38,18,20,19800,22000,41800
351000,202104,625,418,207,459800.63,227700,687500.63
351010,202104,53,34,19,37400,20900,58300
351015,202104,47,32,15,35200,16500,51700
351020,202104,1543,928,615,1021900,676500,1698400
351030,202104,334,208,126,228800,138600,367400
351040,202104,894,443,451,487300,497200.2,984500.2
351050,202104,3299,1476,1823,1624700,2006400,3631100
351060,202104,5324,2003,3321,2206600,3660800,5867400
351070,202104,398,254,144,279400.63,158400,437800.63
351080,202104,708,513,195,564300,214500,778800
351090,202104,51,23,28,25300,30800,56100
351100,202104,426,234,192,257400,211200,468600
351110,202104,1986,934,1052,1030701.13,1158300,2189001.13
351120,202104,63,32,31,35200,34100,69300
351130,202104,183,59,124,64900,136400,201300
351140,202104,313,199,114,220000,125400,345400
351150,202104,431,222,209,244200,231000,475200
351160,202104,273,173,100,190300.4,111100,301400.4
351170,202104,188,100,88,110000,97900,207900
351190,202104,88,62,26,68200,28600,96800
351200,202104,358,229,129,253000,141900,394900
351210,202104,112,54,58,59400,63800,123200
351220,202104,524,313,211,344300.65,232100,576400.65
351230,202104,265,185,80,203500,88000,291500
351240,202104,245,116,129,127600,143000,270600
351250,202104,79,54,25,59400.5,27500,86900.5
351260,202104,154,112,42,123200,46200,169400
351270,202104,46,18,28,19800,30800,50600
351280,202104,1006,466,540,512600.63,595100.63,1107701.26
351290,202104,242,108,134,118800,147400,266200
351300,202104,3714,1632,2082,1797313.6,2292400,4089713.6
351310,202104,740,362,378,399300,415800,815100
351320,202104,110,64,46,70400,50600,121000
351330,202104,37,25,12,27500,13200,40700
351340,202104,1248,724,524,797500,577500.75,1375000.75
351350,202104,2327,1343,984,1479500.04,1084600,2564100.04
351360,202104,780,373,407,411400,447700,859100
351370,202104,378,190,188,209000,206800,415800
351380,202104,8807,3897,4910,4290000,5412000.63,9702000.63
351385,202104,28,18,10,19800,11000,30800
351390,202104,277,210,67,231000,73700,304700
351400,202104,63,39,24,42900,27500,70400
351410,202104,421,259,162,284900,178200,463100
351420,202104,67,48,19,52800,20900,73700
351430,202104,72,40,32,44000,35200,79200
351440,202104,758,519,239,570901.26,262900,833801.26
351450,202104,260,125,135,137500,148500,286000
351460,202104,123,53,70,58300,78100,136400
351470,202104,142,79,63,86900,69300,156200
351480,202104,480,279,201,306900.63,221100,528000.63
351490,202104,281,102,179,112200,196900,309100
351492,202104,24,17,7,18700,7700,26400
351495,202104,28,19,9,20900,9900,30800
351500,202104,3473,1429,2044,1573000,2251700,3824700
351510,202104,1942,731,1211,805200,1334300,2139500
351512,202104,16,12,4,13200,4400,17600
351515,202104,184,107,77,117700,84700,202400
351518,202104,700,439,261,482900,287100,770000
351519,202104,76,43,33,47300,36300,83600
351520,202104,153,89,64,97900,70419.8,168319.8
351530,202104,25,15,10,16500,11000,27500
351535,202104,129,81,48,89100,52800,141900
351540,202104,454,316,138,350900,151800,502700
351550,202104,1433,842,591,927301.26,652300,1579601.26
351560,202104,76,44,32,48400,35200,83600
351565,202104,12,8,4,8800,4400,13200
351570,202104,2662,1269,1393,1398100,1533400,2931500
351580,202104,38,33,5,36300,5500,41800
351590,202104,58,38,20,41800,22000,63800
351600,202104,188,131,57,145200,62700,207900
351610,202104,49,22,27,24200,29700,53900
351620,202104,5782,3184,2598,3509000.82,2863300,6372300.82
351630,202104,2863,1397,1466,1537800,1614800,3152600
351640,202104,2028,895,1133,987800.55,1248500.63,2236301.18
351650,202104,30,25,5,27500,5500,33000
351660,202104,129,83,46,91300,50600,141900
351670,202104,716,442,274,487300,301400,788700
351680,202104,64,53,11,58300,12100,70400
351685,202104,10,8,2,8800,2200,11000
351690,202104,292,195,97,214500.5,106700,321200.5
351700,202104,167,112,55,124537,61600,186137
351710,202104,66,41,25,45100,27500,72600
351720,202104,126,71,55,78100,60500,138600
351730,202104,107,68,39,74800,42900,117700
351740,202104,725,457,268,502700.74,294800,797500.74
351750,202104,351,141,210,155100,232100,387200
351760,202104,732,565,167,622600,183700,806300
351770,202104,303,250,53,276100.63,58300,334400.63
351780,202104,160,93,67,102300,73700,176000
351790,202104,247,128,119,140800,130900,271700
351800,202104,42,27,15,29700,16500,46200
351810,202104,116,77,39,84700,42900,127600
351820,202104,792,571,221,628100,243100,871200
351830,202104,551,186,365,205700,401500,607200
351840,202104,1930,917,1013,1008700,1115400,2124100
351850,202104,231,166,65,182600,72600,255200
351860,202104,632,438,194,484000,214500,698500
351870,202104,5497,2541,2956,2798402.12,3256001.44,6054403.56
351880,202104,19584,7785,11799,8573400,12992100,21565500
351885,202104,83,51,32,56100,35200,91300
351890,202104,66,52,14,57200,15400,72600
351900,202104,226,130,96,143000,105600,248600
351905,202104,88,36,52,39600,57200,96800
351907,202104,3440,1401,2039,1542200,2245100,3787300
351910,202104,175,73,102,80300,113300,193600
351920,202104,112,60,52,66000,57200,123200
351925,202104,89,56,33,62700,36300,99000
351930,202104,378,242,136,266200,150700,416900
351940,202104,232,96,136,105600,149600,255200
351950,202104,135,71,64,79200,70400,149600
351960,202104,918,453,465,498644.93,511500,1010144.93
351970,202104,1957,1003,954,1103300,1050500,2153800
351980,202104,152,68,84,74800,92400,167200
351990,202104,254,163,91,179300,101200,280500
352000,202104,325,207,118,227700,129800,357500
352010,202104,402,246,156,270671,171600,442271
352020,202104,178,69,109,75900,119900,195800
352030,202104,1087,540,547,597300,601700,1199000
352040,202104,573,239,334,262900,368500,631400
352042,202104,277,70,207,77000,228800,305800
352044,202104,344,209,135,229900,149600,379500
352050,202104,3177,1199,1978,1320000.63,2180200,3500200.63
352060,202104,102,62,40,68200,44000,112200
352070,202104,90,67,23,73701.26,25300,99001.26
352080,202104,59,38,21,41800,23100,64900
352090,202104,153,100,53,110000,58300,168300
352100,202104,285,137,148,150700,162800,313500
352110,202104,118,39,79,42900,86900,129800
352115,202104,60,19,41,20900,45100,66000
352120,202104,78,54,24,59400.63,26400,85800.63
352130,202104,215,173,42,191400,46200,237600
352140,202104,181,86,95,94600,104500,199100
352150,202104,120,64,56,70400,61600,132000
352160,202104,137,87,50,95700,55000,150700
352170,202104,382,260,122,287100,134200,421300
352180,202104,634,396,238,436700.63,264000,700700.63
352190,202104,241,99,142,110000,156200,266200
352200,202104,30,14,16,15400,17600,33000
352210,202104,4171,1677,2494,1845800.95,2745600,4591400.95
352215,202104,66,39,27,42900,29700,72600
352220,202104,6535,2424,4111,2667500.05,4528700.63,7196200.68
352230,202104,3317,2140,1177,2356201.13,1298000.42,3654201.55
352240,202104,2507,1442,1065,1588400.63,1171500,2759900.63
352250,202104,2819,1326,1493,1459701.26,1643400,3103101.26
352260,202104,974,512,462,564300,508200,1072500
352265,202104,60,33,27,36300,29700,66000
352270,202104,388,219,169,240900,187000,427900
352280,202104,472,284,188,312400.63,207900,520300.63
352290,202104,179,104,75,114400,82500,196900
352300,202104,94,64,30,70400,33000,103400
352310,202104,6457,2814,3643,3102000.99,4011700,7113700.99
352320,202104,1062,543,519,600600,570900,1171500
352330,202104,519,261,258,287100,283800,570900
352340,202104,1344,611,733,673200,806300,1479500
352350,202104,340,197,143,217800,157300,375100
352360,202104,218,95,123,104500,135300,239800
352370,202104,104,67,37,73700,41800,115500
352380,202104,109,75,34,82500,37400,119900
352390,202104,2501,1084,1417,1192400,1562000,2754400
352400,202104,501,220,281,243100,309100,552200
352410,202104,861,586,275,644600.63,302500,947100.63
352420,202104,93,66,27,72600,29700,102300
352430,202104,1730,781,949,859101.89,1045001.26,1904103.15
352440,202104,3215,1568,1647,1727000,1812800,3539800
352450,202104,196,157,39,172700,42900,215600
352460,202104,618,311,307,342100,337700,679800
352470,202104,647,224,423,246400,465300,711700
352480,202104,1423,777,646,856900,711700,1568600
352490,202104,66,22,44,24200,48400,72600
352500,202104,1231,519,712,570900,784300,1355200
352510,202104,696,370,326,409200.63,358600,767800.63
352520,202104,735,322,413,354347.4,455400,809747.4
352530,202104,1735,900,835,992200,918500,1910700
352540,202104,72,47,25,51700,27500,79200
352550,202104,189,112,77,123200,84750.6,207950.6
352560,202104,47,38,9,41800,9900,51700
352570,202104,684,333,351,366300.63,387200,753500.63
352580,202104,60,46,14,50600,15400,66000
352585,202104,20,6,14,6600,15400,22000
352590,202104,4291,2105,2186,2318800.63,2405797,4724597.63
352600,202104,343,242,101,267300,111100,378400
352610,202104,911,416,495,457600.5,544500,1002100.5
352620,202104,1020,386,634,426800,698500,1125300
352630,202104,181,68,113,74800,124300,199100
352640,202104,510,335,175,368500,192500,561000
352650,202104,80,60,20,66000,22000,88000
352660,202104,61,36,25,39600,27500,67100
352670,202104,1666,879,787,966900.6,865700,1832600.6
352680,202104,904,558,346,613800,380600,994400
352690,202104,4484,1991,2493,2194502.07,2744500.63,4939002.70
352700,202104,95,56,39,61600,42900,104500
352710,202104,1404,730,674,803000,741400,1544400
352720,202104,1399,636,763,699600,839300,1538900
352725,202104,20,16,4,17600,4400,22000
352730,202104,373,180,193,199100,212300,411400
352740,202104,402,261,141,287100,156200.8,443300.8
352750,202104,19,13,6,14300,7700,22000
352760,202104,188,117,71,128700,78100,206800
352770,202104,84,63,21,69300,23100,92400
352780,202104,77,40,37,44000,40700,84700
352790,202104,25,19,6,20900,6600,27500
352800,202104,234,174,60,191400,66000,257400
352810,202104,152,96,56,105600,62700,168300
352820,202104,51,40,11,44000,12100,56100
352830,202104,74,50,24,55000,26400,81400
352840,202104,644,306,338,336600,371800,708400
352850,202104,1603,508,1095,559900,1206700,1766600
352860,202104,111,73,38,81400,41800,123200
352870,202104,46,30,16,33000,17600,50600
352880,202104,181,114,67,125400,73700,199100
352885,202104,32,21,11,23100,12100,35200
352890,202104,55,36,19,39600,20900,60500
352900,202104,4644,2221,2423,2446400,2669700.05,5116100.05
352910,202104,38,31,7,34100,7700,41800
352920,202104,650,385,265,423500,291500,715000
352930,202104,1204,572,632,631400,696300,1327700
352940,202104,6009,2429,3580,2675200,3942400,6617600
352950,202104,116,42,74,46200,81400,127600
352960,202104,60,36,24,39600,26400,66000
352965,202104,19,10,9,11000,9900,20900
352970,202104,503,379,124,418000.35,136400,554400.35
352980,202104,160,89,71,97900,78100,176000
352990,202104,969,450,519,495000,572000,1067000
353000,202104,56,24,32,26400,35200,61600
353010,202104,537,330,207,363000,227700,590700
353020,202104,303,219,84,240900,92400,333300
353030,202104,1240,560,680,616000,748000,1364000
353040,202104,71,40,31,44000,34100,78100
353050,202104,1294,836,458,919600.9,503800,1423400.9
353060,202104,8378,3562,4816,3922600.71,5310800,9233400.71
353070,202104,1779,1068,711,1180301.26,783004.2,1963305.46
353080,202104,1260,673,587,740300.92,645700,1386000.92
353090,202104,63,33,30,36300,33000,69300
353100,202104,45,35,10,38500,11000,49500
353110,202104,2079,659,1420,724900,1564200,2289100
353120,202104,102,53,49,58300,53900,112200
353130,202104,847,409,438,449901.92,482900,932801.92
353140,202104,539,219,320,242000.63,353100,595100.63
353150,202104,326,183,143,201300.63,157300,358600.63
353160,202104,96,74,22,81400,24200,105600
353170,202104,213,68,145,74800,159500,234300
353180,202104,1101,496,605,545600,665500,1211100
353190,202104,476,346,130,381700,143000,524700
353200,202104,221,105,116,115500,127600,243100
353205,202104,20,13,7,14300,7700,22000
353210,202104,70,39,31,42900,34100,77000
353215,202104,41,23,18,25300,19800,45100
353220,202104,77,41,36,45100,39600,84700
353230,202104,157,63,94,69300,103400,172700
353240,202104,329,164,165,181500,182600,364100
353250,202104,205,100,105,110000,115500,225500
353260,202104,449,300,149,330000,163900,493900
353270,202104,73,54,19,59400,20900,80300
353280,202104,99,49,50,53900,55000,108900
353282,202104,129,92,37,101200,40700,141900
353284,202104,26,19,7,20900,7700,28600
353286,202104,2,0,2,0,2200,2200
353290,202104,81,46,35,50600,38500,89100
353300,202104,432,225,207,247501.76,227700,475201.76
353310,202104,48,40,8,44000,8800,52800
353320,202104,34,20,14,22000,15400,37400
353325,202104,47,28,19,30800,20900,51700
353330,202104,61,43,18,47300,19800,67100
353340,202104,631,227,404,249700,446600,696300
353350,202104,888,430,458,473000,504900,977900
353360,202104,102,82,20,90200,22000,112200
353370,202104,108,64,44,70400,48400,118800
353380,202104,28,14,14,15400,15400,30800
353390,202104,1092,513,579,565400,638000,1203400
353400,202104,41,23,18,25300,19800,45100
353410,202104,110,64,46,70400,50600,121000
353420,202104,57,21,36,24200,39600,63800
353430,202104,559,370,189,408101.13,207900,616001.13
353440,202104,11312,4866,6446,5357000.63,7107100,12464100.63
353450,202104,56,29,27,31900,29700,61600
353460,202104,605,319,286,352000,314600,666600
353470,202104,2167,1108,1059,1219900.6,1166000,2385900.6
353475,202104,245,163,82,180400,90200,270600
353480,202104,177,144,33,159500,36300,195800
353490,202104,237,137,100,151800,110000,261800
353500,202104,207,121,86,133100,94600,227700
353510,202104,93,63,30,69300,33000,102300
353520,202104,214,154,60,170500,66000,236500
353530,202104,452,236,216,260700,237600,498300
353540,202104,382,247,135,271700,148500,420200
353550,202104,705,453,252,498300.93,277200,775500.93
353560,202104,574,232,342,255200,376200,631400
353570,202104,62,35,27,38500,29700,68200
353580,202104,347,250,97,275000,106700,381700
353590,202104,80,60,20,66000,22000,88000
353600,202104,264,153,111,169400.63,122100,291500.63
353610,202104,130,68,62,74800,68200,143000
353620,202104,631,323,308,356400,338800,695200
353625,202104,52,25,27,27500,29700,57200
353630,202104,224,162,62,178200,68200,246400
353640,202104,118,78,40,85800,44000,129800
353650,202104,940,353,587,388300,645700,1034000
353657,202104,23,18,5,19800,5500,25300
353660,202104,274,145,129,159500,141900,301400
353670,202104,742,439,303,482900.63,333300,816200.63
353680,202104,112,81,31,89100,34100,123200
353690,202104,40,30,10,33000,11000,44000
353700,202104,273,189,84,207900,92400,300300
353710,202104,473,220,253,242000,278300,520300
353715,202104,49,31,18,34100,19800,53900
353720,202104,345,152,193,167200,212300,379500
353730,202104,1113,677,436,745800,482900,1228700
353740,202104,604,329,275,361900,302500,664400
353750,202104,74,44,30,48400,33000,81400
353760,202104,3012,1134,1878,1247400,2068000.9,3315400.9
353770,202104,78,62,16,68200,17600,85800
353780,202104,1250,587,663,646800.63,729300,1376100.63
353790,202104,490,305,185,335500,203500,539000
353800,202104,3461,1652,1809,1821620,1992174,3813794
353810,202104,229,122,107,134200,117700,251900
353820,202104,217,96,121,105600,133100,238700
353830,202104,52,45,7,49500,7700,57200
353850,202104,175,87,88,95700,96800,192500
353860,202104,508,220,288,242000,316800,558800
353870,202104,5350,2674,2676,2946900.86,2951300,5898200.86
353880,202104,690,463,227,509300,249700,759000
353890,202104,542,320,222,352000,244200.59,596200.59
353900,202104,131,69,62,75900,68200,144100
353910,202104,172,75,97,82500,106700,189200
353920,202104,415,228,187,250800,205700,456500
353930,202104,1022,599,423,660000,466400,1126400
353940,202104,193,98,95,107800,104500,212300
353950,202104,496,308,188,339900,206800,546700
353960,202104,78,63,15,69300,16500,85800
353970,202104,43,28,15,30800,16500,47300
353980,202104,1704,769,935,848100,1029600,1877700
353990,202104,72,43,29,47300,31900,79200
354000,202104,379,176,203,193600,223300,416900
354010,202104,90,52,38,57200,41800,99000
354020,202104,491,307,184,337700,202400,540100
354025,202104,35,31,4,34100,4400,38500
354030,202104,46,26,20,28600,22000,50600
354040,202104,94,70,24,77000,26400,103400
354050,202104,174,95,79,104500.63,86900,191400.63
354060,202104,734,354,380,390500,419100,809600
354070,202104,904,511,393,563200,434500,997700
354075,202104,177,80,97,88000,106700,194700
354080,202104,308,132,176,145200,194700,339900
354085,202104,20,13,7,14300,7700,22000
354090,202104,284,170,114,186907,126500,313407
354100,202104,5522,2240,3282,2466200.4,3616800,6083000.4
354105,202104,94,44,50,48400,55000,103400
354110,202104,45,23,22,25300,24200,49500
354120,202104,142,97,45,106700.93,49500,156200.93
354130,202104,708,438,270,481800.81,297000,778800.81
354140,202104,3165,1455,1710,1602700.55,1883200,3485900.55
354150,202104,624,369,255,407000.66,281600,688600.66
354160,202104,636,399,237,440000,260700,700700
354165,202104,18,14,4,15400,4400,19800
354170,202104,173,121,52,134200,57200,191400
354180,202104,58,35,23,38500.42,25300,63800.42
354190,202104,189,76,113,83600,124300,207900
354200,202104,109,57,52,62700,57200,119900
354210,202104,62,24,38,26400,41800,68200
354220,202104,629,401,228,441100.63,251900,693000.63
354230,202104,167,71,96,78100,105600,183700
354240,202104,330,212,118,233200.82,129800,363000.82
354250,202104,80,50,30,55000,33000,88000
354260,202104,2089,990,1099,1089000.5,1208900.85,2297901.35
354270,202104,88,64,24,70400,26400,96800
354280,202104,45,22,23,24200,25300,49500
354290,202104,138,96,42,106700,46200,152900
354300,202104,364,253,111,278300.63,122100,400400.63
354310,202104,87,67,20,73700,22000,95700
354320,202104,209,104,105,114400,115500,229900
354323,202104,10,9,1,9900,1100,11000
354325,202104,120,67,53,74800.83,58300,133100.83
354330,202104,2364,799,1565,879843,1722600,2602443
354340,202104,10178,4789,5389,5272068.03,5935600,11207668.03
354350,202104,139,88,51,96800,56100,152900
354360,202104,67,37,30,40700,33000,73700
354370,202104,233,121,112,134200,124300,258500
354380,202104,182,107,75,117700,82500,200200
354390,202104,2634,960,1674,1057100,1845800,2902900
354400,202104,293,164,129,180400,141900,322300
354410,202104,617,289,328,319000,360800,679800
354420,202104,266,171,95,188100,104500,292600
354425,202104,309,180,129,198051,141900,339951
354430,202104,184,104,80,114400,88000,202400
354440,202104,33,25,8,27500,8800,36300
354450,202104,50,33,17,36300,18700,55000
354460,202104,96,56,40,61600,44000,105600
354470,202104,31,17,14,18700,15400,34100
354480,202104,111,62,49,68200,53900,122100
354490,202104,135,84,51,92400,56100,148500
354500,202104,386,177,209,194700,229900,424600
354510,202104,91,63,28,69300,30800,100100
354515,202104,39,10,29,11000,31900,42900
354520,202104,1577,673,904,742343,994400,1736743
354530,202104,777,389,388,429000,426800,855800
354540,202104,260,136,124,150700,136400,287100
354550,202104,37,23,14,25300,15400,40700
354560,202104,148,78,70,85800,77000,162800
354570,202104,135,92,43,101200,48400,149600
354580,202104,1795,848,947,933900,1042800,1976700
354600,202104,260,139,121,152900,133100,286000
354610,202104,71,59,12,64900,13200,78100
354620,202104,57,12,45,13200,49500,62700
354625,202104,14,9,5,9900,5500,15400
354630,202104,295,187,108,205700,118800,324500
354640,202104,802,504,298,554400.63,328900,883300.63
354650,202104,66,38,28,41800,30800,72600
354660,202104,777,573,204,630300.63,224400,854700.63
354670,202104,231,87,144,96800,158400,255200
354680,202104,1265,456,809,502700,892100,1394800
354690,202104,82,57,25,62700,27500,90200
354700,202104,72,51,21,56100,23100,79200
354710,202104,47,33,14,36300,15400,51700
354720,202104,19,19,0,20900,0,20900
354730,202104,1729,713,1016,784300,1119800,1904100
354740,202104,75,51,24,56100,26400,82500
354750,202104,419,244,175,268400,193600,462000
354760,202104,470,282,188,310200,206800,517000
354765,202104,9,4,5,4400,5500,9900
354770,202104,347,231,116,254100,127600,381700
354780,202104,8036,3113,4923,3432001.13,5424100,8856101.13
354790,202104,91,53,38,58300,41800,100100
354800,202104,444,243,201,267204.05,221100,488304.05
354805,202104,89,38,51,41800,56100,97900
354810,202104,107,63,44,69300,48400,117700
354820,202104,206,84,122,92400,134200,226600
354830,202104,44,23,21,25300,23100,48400
354840,202104,56,39,17,42900,18700,61600
354850,202104,4445,1951,2494,2149400.08,2745600.06,4895000.14
354860,202104,332,159,173,174900,190300,365200
354870,202104,11764,5185,6579,5712301.26,7245700,12958001.26
354880,202104,2666,984,1682,1083500.89,1853551.7,2937052.59
354890,202104,2844,1497,1347,1648900.93,1483900,3132800.93
354900,202104,64,43,21,47300,23100,70400
354910,202104,1251,639,612,704000,674300,1378300
354920,202104,41,33,8,36300,8800,45100
354925,202104,18,7,11,7700,12100,19800
354930,202104,36,32,4,35200.4,4400,39600.4
354940,202104,774,556,218,612700,239800,852500
354950,202104,200,126,74,138600,81400,220000
354960,202104,142,54,88,59400,96800,156200
354970,202104,981,659,322,724901.26,354200,1079101.26
354980,202104,8716,3090,5626,3404502.23,6195200.39,9599702.62
354990,202104,9408,4242,5166,4670600,5692500,10363100
354995,202104,541,170,371,187000,408100,595100
355000,202104,458,159,299,174900,328900,503800
355010,202104,582,358,224,393800,246400.63,640200.63
355020,202104,777,483,294,532400,323400,855800
355030,202104,205815,77926,127889,85816796.1,140860543.9,226677340.0
355040,202104,789,354,435,389400,479600,869000
355050,202104,154,90,64,99000,70400,169400
355060,202104,1625,801,824,881100,906400,1787500
355070,202104,1463,688,775,756800.08,854700.73,1611500.81
355080,202104,187,114,73,126500,81400,207900
355090,202104,284,165,119,181500,130900.57,312400.57
355100,202104,4982,2368,2614,2607990.28,2878700,5486690.28
355110,202104,238,159,79,174900,89100,264000
355120,202104,57,37,20,40700,22000,62700
355130,202104,50,29,21,31900,23100,55000
355140,202104,182,109,73,119900,80300,200200
355150,202104,656,383,273,421300,301400,722700
355160,202104,465,225,240,247500.63,264000,511500.63
355170,202104,2008,1044,964,1152800,1061500,2214300
355180,202104,676,277,399,305800,440000,745800
355190,202104,208,138,70,151800,78100,229900
355200,202104,107,59,48,64900,52800,117700
355210,202104,682,377,305,414700,336600,751300
355220,202104,7152,3610,3542,3974300,3901700,7876000
355230,202104,97,59,38,64900,41800,106700
355240,202104,4410,1815,2595,1999801.13,2855600,4855401.13
355250,202104,5847,2563,3284,2825921.06,3619000.63,6444921.69
355255,202104,51,28,23,30800,25300,56100
355260,202104,178,109,69,119900,75900,195800
355270,202104,165,107,58,117700,63800,181500
355280,202104,6444,2467,3977,2717000,4378000,7095000
355290,202104,72,59,13,64900,14300,79200
355300,202104,206,121,85,133100,93500,226600
355310,202104,109,58,51,63800,56100,119900
355320,202104,92,49,43,53900,47300,101200
355330,202104,276,156,120,171600,132000,303600
355340,202104,1440,493,947,546700.55,1042800,1589500.55
355350,202104,148,73,75,80300,82500,162800
355360,202104,170,112,58,123200,63800,187000
355365,202104,19,15,4,16500,4400,20900
355370,202104,1008,597,411,658900.63,452100,1111000.63
355380,202104,809,505,304,555500,336600,892100
355385,202104,76,51,25,56100,27500,83600
355390,202104,111,61,50,67100,55000,122100
355395,202104,187,101,86,111100.5,94600,205700.5
355400,202104,1709,1004,705,1107609,777700.63,1885309.63
355410,202104,4861,2265,2596,2494800,2858900,5353700
355420,202104,50,36,14,39600,15400,55000
355430,202104,393,243,150,267300,165000,432300
355440,202104,83,50,33,55000,36300,91300
355450,202104,436,214,222,235400,245300,480700
355460,202104,61,48,13,53900,14300,68200
355465,202104,45,27,18,29700,19800,49500
355470,202104,178,74,104,81400,115500,196900
355475,202104,13,9,4,9900,4400,14300
355480,202104,554,227,327,250800,359700,610500
355490,202104,110,77,33,84700,36300,121000
355495,202104,65,24,41,26400,45100,71500
355500,202104,1546,848,698,932800.48,767800,1700600.48
355510,202104,272,197,75,216700.63,82500,299200.63
355520,202104,31,23,8,25300,8800,34100
355530,202104,22,11,11,12100,12100,24200
355535,202104,72,31,41,34100,45100,79200
355540,202104,2513,977,1536,1074855.1,1689600.63,2764455.73
355550,202104,59,37,22,40700,24200,64900
355560,202104,246,116,130,127600,143000,270600
355570,202104,20,13,7,14300,7700,22000
355580,202104,245,174,71,191400,78100,269500
355590,202104,16,9,7,9900,7700,17600
355600,202104,269,139,130,152900,144100,297000
355610,202104,222,147,75,161700,82500,244200
355620,202104,1285,565,720,621500,794200,1415700
355630,202104,415,311,104,342100,114400.63,456500.63
355635,202104,114,52,62,57200,68200,125400
355640,202104,538,302,236,332200,259600,591800
355645,202104,849,331,518,364100,573100,937200
355650,202104,1909,802,1107,882200,1219900,2102100
355660,202104,237,127,110,139700,121000,260700
355670,202104,575,239,336,264000,371800,635800
355680,202104,207,112,95,123200,104500,227700
355690,202104,91,42,49,46200,53900,100100
355695,202104,22,13,9,14300,9900,24200
355700,202104,1129,576,553,634700,608300,1243000
355710,202104,2197,1188,1009,1306800,1112100,2418900
355715,202104,13,11,2,12100,2200,14300
355720,202104,228,139,89,152900,97900,250800
355730,202104,99,56,43,62700,47300,110000
410010,202104,129,104,25,114400,27500,141900
410020,202104,119,89,30,97900,33000,130900
410030,202104,168,93,75,102300,82500,184800
410040,202104,1212,601,611,664400,674300,1338700
410045,202104,38,30,8,33000,8800,41800
410050,202104,482,271,211,298100,233200,531300
410060,202104,277,201,76,221100,83600,304700
410070,202104,287,239,48,264000,52800,316800
410080,202104,176,102,74,112200,81400,193600
410090,202104,70,60,10,66000,11000,77000
410100,202104,289,197,92,216700,101200,317900
410105,202104,47,28,19,30800,20900,51700
410110,202104,332,196,136,215600,149600,365200
410115,202104,37,23,14,25300,15400,40700
410120,202104,427,201,226,221100,248600,469700
410130,202104,54,32,22,35200,24200,59400
410140,202104,3113,1442,1671,1586200.03,1843600.88,3429800.91
410150,202104,2652,1025,1627,1130800,1790800,2921600
410160,202104,494,297,197,327800,216700,544500
410165,202104,48,29,19,31900,20900,52800
410170,202104,181,116,65,127600,71500,199100
410180,202104,2246,1234,1012,1358500,1113200,2471700
410185,202104,26,22,4,24200,5500,29700
410190,202104,494,305,189,337700,209000,546700
410200,202104,930,659,271,724900,299200,1024100
410210,202104,618,310,308,341000,338800,679800
410220,202104,46,21,25,23100,27500,50600
410230,202104,151,69,82,75900,90200,166100
410240,202104,734,464,270,511500,297000,808500
410250,202104,372,264,108,290400,118800,409200
410260,202104,294,166,128,182600,145200,327800
410270,202104,31,23,8,25300,8800,34100
410275,202104,58,43,15,47300,16500,63800
410280,202104,319,180,139,198000,152900,350900
410290,202104,250,142,108,156200,118800,275000
410300,202104,78,54,24,59400,26400,85800
410302,202104,24,15,9,16500,9900,26400
410304,202104,34,23,11,25300,12100,37400
410305,202104,223,116,107,127600,117700,245300
410310,202104,211,125,86,137500,94600,232100
410315,202104,44,32,12,35200,13200,48400
410320,202104,141,94,47,103400,51700,155100
410322,202104,30,18,12,19800,13200,33000
410330,202104,179,120,59,134200,64900,199100
410335,202104,102,58,44,63800,48400,112200
410337,202104,45,34,11,37400,12100,49500
410340,202104,39,33,6,36300,6600,42900
410345,202104,203,115,88,126500,96800,223300
410347,202104,46,35,11,38500,12100,50600
410350,202104,252,142,110,156200,122100,278300
410360,202104,455,283,172,312400,189200,501600
410370,202104,2295,942,1353,1040600,1488300,2528900
410380,202104,204,124,80,137500,88000,225500
410390,202104,386,260,126,286000,138600,424600
410395,202104,34,21,13,23100,14300,37400
410400,202104,850,372,478,410300.5,525800,936100.5
410405,202104,86,64,22,70400,24200,94600
410410,202104,28,19,9,20900,9900,30800
410420,202104,1707,790,917,870002.1,1013100,1883102.1
410425,202104,185,73,112,81400,123200,204600
410430,202104,2305,1243,1062,1370600,1170400,2541000
410440,202104,381,275,106,303600,116600,420200
410442,202104,358,233,125,256300,137500,393800
410445,202104,424,306,118,336600,132000,468600
410450,202104,387,192,195,212300,215600,427900
410460,202104,540,271,269,298100,297000,595100
410465,202104,237,137,100,150700,110000,260700
410470,202104,246,145,101,159500,111100,270600
410480,202104,6244,2928,3316,3227400,3657500,6884900
410490,202104,1420,836,584,919600.33,643500,1563100.33
410500,202104,271,154,117,169400,128700,298100
410510,202104,171,124,47,136400,52800,189200
410520,202104,257,188,69,206800,75900,282700
410530,202104,304,99,205,108900,225500,334400
410540,202104,328,245,83,269500,91300,360800
410550,202104,1689,700,989,771100,1087900,1859000
410560,202104,149,104,45,114400,49500,163900
410570,202104,419,279,140,306900,154000,460900
410580,202104,3494,1470,2024,1618101.04,2228600,3846701.04
410590,202104,388,255,133,281581,146300,427881
410600,202104,193,166,27,182600,29700,212300
410610,202104,50,42,8,46200,8800,55000
410620,202104,258,171,87,188100.4,96800,284900.4
410630,202104,443,241,202,265100,222200,487300
410640,202104,1018,637,381,700700,419100,1119800
410645,202104,112,79,33,86900,36300,123200
410650,202104,359,228,131,250800,145200,396000
410655,202104,92,64,28,70400,30800,101200
410657,202104,30,11,19,12100,20900,33000
410660,202104,611,411,200,453200.5,220000,673200.5
410670,202104,75,61,14,67100,15400,82500
410680,202104,202,160,42,176000,47300,223300
410685,202104,26,15,11,16500,12100,28600
410690,202104,28439,11812,16627,13018500,18318301.02,31336801.02
410700,202104,323,237,86,260700,94600,355300
410710,202104,128,103,25,113300,27500,140800
410712,202104,42,28,14,30800,15400,46200
410715,202104,88,66,22,72600,24200,96800
410720,202104,680,384,296,422400.92,326700,749100.92
410725,202104,179,127,52,139700,57200,196900
410730,202104,97,46,51,50600,56100,106700
410740,202104,109,74,35,81400,38500,119900
410750,202104,271,180,91,198000,100100,298100
410752,202104,22,13,9,14300,9900,24200
410753,202104,58,23,35,25300,38500,63800
410754,202104,53,26,27,28600,29700,58300
410755,202104,85,51,34,56100,37400,93500
410760,202104,765,418,347,459800,382800,842600
410765,202104,1787,802,985,882200,1089000,1971200
410770,202104,114,83,31,91300,34100,125400
410773,202104,57,39,18,42900,19800,62700
410775,202104,184,137,47,150700,51700,202400
410780,202104,88,48,40,52800,44000,96800
410785,202104,55,44,11,48400,12100,60500
410790,202104,88,38,50,41800,55000,96800
410800,202104,281,176,105,193600,115500,309100
410810,202104,20,13,7,14300,7700,22000
410820,202104,172,121,51,133100,56100,189200
410830,202104,8661,3640,5021,4010600.4,5539600,9550200.4
410832,202104,106,71,35,78100,38500,116600
410840,202104,1465,780,685,858000.21,755700,1613700.21
410845,202104,47,29,18,31900,19800,51700
410850,202104,181,128,53,140800,59400,200200
410855,202104,62,53,9,59400,9900,69300
410860,202104,752,392,360,432300,396000,828300
410865,202104,100,72,28,79200,30800,110000
410870,202104,147,127,20,139700,22000,161700
410880,202104,1139,560,579,617100,636900,1254000
410890,202104,88,61,27,67100,29700,96800
410895,202104,74,56,18,61600,19800,81400
410900,202104,26,18,8,19800,8800,28600
410910,202104,20,14,6,15400,6600,22000
410920,202104,38,23,15,25300,16500,41800
410930,202104,542,330,212,363000,233200,596200
410940,202104,4403,2379,2024,2619100.6,2227500,4846600.6
410950,202104,104,75,29,82500,31900,114400
410960,202104,852,334,518,367400,569800,937200
410965,202104,66,45,21,49500,23100,72600
410970,202104,612,428,184,470800,202400,673200
410975,202104,127,78,49,85800.38,53900,139700.38
410980,202104,1631,719,912,793100,1007600,1800700
410990,202104,270,190,80,209000,88000,297000
411000,202104,65,38,27,41800,29700,71500
411005,202104,28,23,5,25300,5500,30800
411007,202104,254,147,107,161700,118800,280500
411010,202104,591,391,200,431200,220000,651200
411020,202104,283,188,95,206800,104500,311300
411030,202104,19,11,8,12100,8800,20900
411040,202104,54,37,17,40700,18700,59400
411050,202104,213,159,54,174900,59400,234300
411060,202104,513,342,171,376200,188100,564300
411065,202104,51,46,5,50600,5500,56100
411070,202104,1256,731,525,804100,577500,1381600
411080,202104,243,169,74,185900,81400,267300
411090,202104,97,75,22,82500,24200,106700
411095,202104,305,113,192,124300,211200,335500
411100,202104,119,94,25,103400,27500,130900
411110,202104,127,77,50,85800,55000,140800
411120,202104,219,144,75,158400,82500,240900
411125,202104,253,108,145,118800,160600,279400
411130,202104,124,104,20,114400,22000,136400
411140,202104,216,143,73,157300,80300,237600
411150,202104,1256,820,436,902000,479600.63,1381600.63
411155,202104,119,82,37,90200,40700,130900
411160,202104,25,10,15,11000,16500,27500
411170,202104,49,44,5,48400,5500,53900
411180,202104,973,634,339,698500,374000,1072500
411190,202104,333,186,147,205700,161700,367400
411200,202104,660,394,266,433400.63,294800,728200.63
411210,202104,677,356,321,392700,353100,745800
411220,202104,163,111,52,122100,57200,179300
411230,202104,40,33,7,36300,7700,44000
411240,202104,117,73,44,80300,48400,128700
411250,202104,432,313,119,344300,130900,475200
411260,202104,15,11,4,12100,4400,16500
411270,202104,268,138,130,151800,143000,294800
411275,202104,178,155,23,170500,25300,195800
411280,202104,202,143,59,157300.63,64900,222200.63
411290,202104,61,47,14,51700,15400,67100
411295,202104,129,103,26,113300,28600,141900
411300,202104,82,36,46,39600,50600,90200
411310,202104,93,69,24,75900,26400,102300
411320,202104,790,515,275,566500,305800,872300
411325,202104,60,42,18,46200,19800,66000
411330,202104,914,589,325,649000,357500.15,1006500.15
411340,202104,30,18,12,19800,13200,33000
411342,202104,56,41,15,45100,16500,61600
411345,202104,117,59,58,64900,63800,128700
411350,202104,493,369,124,408100,136400,544500
411360,202104,54,34,20,38500,22000,60500
411370,202104,14199,5647,8552,6220502.23,9418201.34,15638703.57
411373,202104,175,117,58,128700,63800,192500
411375,202104,81,64,17,70400,18700,89100
411380,202104,83,59,24,64900,26400,91300
411390,202104,128,75,53,82500,58300,140800
411400,202104,405,281,124,309100,137500,446600
411410,202104,464,219,245,240900,270600,511500
411420,202104,984,425,559,467500.4,617100,1084600.4
411430,202104,486,267,219,293700,240900,534600
411435,202104,31,18,13,19800,14300,34100
411440,202104,466,363,103,399300,114400,513700
411450,202104,422,354,68,389400,74800,464200
411460,202104,781,292,489,321200,537900.66,859100.66
411470,202104,93,64,29,70400,31900,102300
411480,202104,680,363,317,400400,348700,749100
411490,202104,291,185,106,203500,117700,321200
411500,202104,101,83,18,91300,19800,111100
411510,202104,215,171,44,188100,48400,236500
411520,202104,6003,2179,3824,2399100,4214100.7,6613200.7
411530,202104,127,83,44,92400,48400,140800
411535,202104,50,19,31,20900,34100,55000
411540,202104,369,248,121,272800,133100,405900
411545,202104,54,38,16,41800,17600,59400
411550,202104,83,62,21,68200,23100,91300
411560,202104,401,165,236,181500,259600,441100
411570,202104,895,313,582,344300,640200,984500
411573,202104,23,14,9,15400,9900,25300
411575,202104,302,186,116,204600,127600,332200
411580,202104,1258,443,815,487300,896500,1383800
411585,202104,71,34,37,37400,40700,78100
411590,202104,18,12,6,13200,6600,19800
411600,202104,23,10,13,11000,14300,25300
411605,202104,240,94,146,103400,160600,264000
411610,202104,214,136,78,150700,85800,236500
411620,202104,373,196,177,216700,194700,411400
411630,202104,52,36,16,39600,17600,57200
411640,202104,33,23,10,25300,11000,36300
411650,202104,10,6,4,6600,4400,11000
411660,202104,40,27,13,29700,14300,44000
411670,202104,238,170,68,187000,74800,261800
411680,202104,167,135,32,148500,35200,183700
411690,202104,599,313,286,344300,314600,658900
411695,202104,64,44,20,48400,22000,70400
411700,202104,143,114,29,125400,31900,157300
411705,202104,106,70,36,77000,39600,116600
411710,202104,286,191,95,210100,105600,315700
411720,202104,131,85,46,93500,50600,144100
411721,202104,73,60,13,66000,14300,80300
411722,202104,105,44,61,48400,67100,115500
411725,202104,157,115,42,126500,46200,172700
411727,202104,93,71,22,78100,24200,102300
411729,202104,42,32,10,35200,11000,46200
411730,202104,549,344,205,379500,227700,607200
411740,202104,33,18,15,19800,16500,36300
411745,202104,68,49,19,53900,20900,74800
411750,202104,837,362,475,398200,522500,920700
411760,202104,1170,858,312,944900,343200,1288100
411770,202104,451,298,153,327800,168300,496100
411780,202104,355,225,130,247500,143000,390500
411790,202104,543,302,241,333300.18,265100,598400.18
411800,202104,149,112,37,124300.65,40700,165000.65
411810,202104,179,132,47,145200,51700,196900
411820,202104,2301,977,1324,1074700,1457500,2532200
411830,202104,10,9,1,9900,1100,11000
411840,202104,2039,1219,820,1342000,903100,2245100
411845,202104,58,20,38,22000,41800,63800
411850,202104,1207,656,551,721600.28,607200,1328800.28
411860,202104,50,32,18,35200,19800,55000
411870,202104,69,42,27,46200,29700,75900
411880,202104,428,263,165,289300,181500,470800
411885,202104,103,64,39,71500,42900,114400
411890,202104,308,198,110,218900,121000,339900
411900,202104,95,67,28,73700,30800,104500
411910,202104,181,140,41,154000,45100,199100
411915,202104,2245,884,1361,973500,1498200,2471700
411920,202104,119,93,26,102300,28600,130900
411925,202104,11,6,5,6600,5500,12100
411930,202104,801,572,229,629270.4,253000,882270.4
411940,202104,582,376,206,414700,226600,641300
411950,202104,1074,499,575,552200.24,635800,1188000.24
411960,202104,1094,717,377,788700,414700,1203400
411965,202104,23,14,9,15400,9900,25300
411970,202104,94,80,14,88000,15400,103400
411980,202104,183,108,75,118800,82500,201300
411990,202104,5106,2833,2273,3117401.42,2501472,5618873.42
411995,202104,546,171,375,188100,413600,601700
412000,202104,322,204,118,225500,129800,355300
412010,202104,43,27,16,29700,18700,48400
412015,202104,40,30,10,33000,11000,44000
412020,202104,30,24,6,26400,6600,33000
412030,202104,46,43,3,47300,3300,50600
412033,202104,56,30,26,33000,28600,61600
412035,202104,73,45,28,49500,30800,80300
412040,202104,42,24,18,26400,19800,46200
412050,202104,208,154,54,169400,59400,228800
412060,202104,774,560,214,616000,236500,852500
412065,202104,50,30,20,33000,22000,55000
412070,202104,169,117,52,128700,57200,185900
412080,202104,302,144,158,158400,173800,332200
412085,202104,39,16,23,17600,25300,42900
412090,202104,821,512,309,564300,339900,904200
412100,202104,260,215,45,236500,49500,286000
412110,202104,69,53,16,58300,17600,75900
412120,202104,327,188,139,206800,152900,359700
412125,202104,73,48,25,52800,27500,80300
412130,202104,40,26,14,28600,15400,44000
412135,202104,28,15,13,16500,14300,30800
412140,202104,352,223,129,245300,141900,387200
412150,202104,244,160,84,176000,92400,268400
412160,202104,87,50,37,55000,40700,95700
412170,202104,700,479,221,526900,243100,770000
412175,202104,32,25,7,27500,8800,36300
412180,202104,187,143,44,157300,48400,205700
412190,202104,324,255,69,280500,75900,356400
412200,202104,185,118,67,129800,73700,203500
412210,202104,92,69,23,75900,25300,101200
412215,202104,236,162,74,179623.4,81400,261023.4
412217,202104,63,52,11,57200,12100,69300
412220,202104,818,564,254,620400,279400,899800
412230,202104,317,193,124,212300,136400,348700
412240,202104,1331,640,691,706200,761200,1467400
412250,202104,410,249,161,273900,177100,451000
412260,202104,108,75,33,82500,36300,118800
412265,202104,179,134,45,147400,49500,196900
412270,202104,89,59,30,64900,33000,97900
412280,202104,88,69,19,75900,20900,96800
412290,202104,92,63,29,70400,31900,102300
412300,202104,211,141,70,155100,77000,232100
412310,202104,53,43,10,47300,11000,58300
412320,202104,97,78,19,85800,20900,106700
412330,202104,184,152,32,167200,35200,202400
412340,202104,163,112,51,123200,56100,179300
412350,202104,639,300,339,330000,372900,702900
412360,202104,25,21,4,23100,4400,27500
412370,202104,159,137,22,150700,24200,174900
412380,202104,231,175,56,192500,61600,254100
412382,202104,60,35,25,38500,27500,66000
412385,202104,157,109,48,119900,52800,172700
412390,202104,293,221,72,244200,79200,323400
412395,202104,69,57,12,62700,13200,75900
412400,202104,96,65,31,71500,34100,105600
412402,202104,227,113,114,124300,125400,249700
412405,202104,889,302,587,332200,646800,979000
412410,202104,973,582,391,640200,430100,1070300
412420,202104,17,16,1,17600,1100,18700
412430,202104,22,19,3,20900,3300,24200
412440,202104,623,325,298,359700,327800,687500
412450,202104,76,67,9,73700,9900,83600
412460,202104,89,68,21,74800,23100,97900
412470,202104,216,171,45,188100,49500,237600
412480,202104,144,104,40,114400,44000,158400
412490,202104,156,137,19,150700,20900,171600
412500,202104,425,343,82,377300.44,90200,467500.44
412510,202104,171,141,30,155100,33000,188100
412520,202104,93,60,33,66000,36300,102300
412530,202104,107,54,53,59400,58300,117700
412535,202104,88,65,23,71500,26400,97900
412540,202104,83,39,44,42900,48400,91300
412545,202104,89,59,30,64900,33000,97900
412550,202104,3882,1575,2307,1734700,2542100,4276800
412555,202104,10,6,4,6600,4400,11000
412560,202104,625,428,197,470800,216700,687500
412570,202104,771,377,394,414700,433400,848100
412575,202104,95,66,29,72600,31900,104500
412580,202104,174,117,57,128700,62700,191400
412590,202104,35,30,5,33000,5500,38500
412600,202104,174,126,48,138600,53900,192500
412610,202104,35,15,20,16500,22000,38500
412620,202104,146,122,24,134200,26400,160600
412625,202104,2111,1065,1046,1171500.63,1151700,2323200.63
412627,202104,66,48,18,52800,19800,72600
412630,202104,386,251,135,276100,148500,424600
412635,202104,64,19,45,20900,49500,70400
412640,202104,101,72,29,79200,31900,111100
412650,202104,324,211,113,232100,124300,356400
412660,202104,464,271,193,298100,212300,510400
412665,202104,44,39,5,42900,5500,48400
412667,202104,304,202,102,222200,112200,334400
412670,202104,65,54,11,59400,12100,71500
412680,202104,303,229,74,253000,81400,334400
412690,202104,114,71,43,78100,47300,125400
412700,202104,168,112,56,123200,61600,184800
412710,202104,1331,776,555,855800,610500,1466300
412720,202104,233,140,93,154000,102300,256300
412730,202104,188,158,30,176000,33000,209000
412740,202104,424,215,209,237600,229900,467500
412750,202104,428,236,192,259600,211200,470800
412760,202104,301,148,153,162800,168300,331100
412770,202104,2112,1156,956,1273800.63,1051600,2325400.63
412780,202104,140,107,33,117700,36300,154000
412785,202104,298,145,153,159500,168300,327800
412788,202104,39,23,16,25300.61,17600,42900.61
412790,202104,122,100,22,110000,25300,135300
412795,202104,149,105,44,115500,48400,163900
412796,202104,311,197,114,216700,125400,342100
412800,202104,643,381,262,419100,289300,708400
412810,202104,2968,1575,1393,1734700,1533400,3268100
412820,202104,930,560,370,616000,407000,1023000
412830,202104,13,10,3,11000,3300,14300
412840,202104,232,160,72,176000,79200,255200
412850,202104,741,467,274,514800,301400,816200
412853,202104,169,83,86,91300,94600,185900
412855,202104,194,99,95,108900.26,104500,213400.26
412860,202104,95,64,31,70400,34100,104500
412862,202104,59,37,22,40700,24200,64900
412863,202104,8,5,3,5500,3300,8800
412865,202104,45,32,13,35200,14300,49500
412870,202104,104,61,43,67100,47300,114400
412880,202104,92,64,28,70400,30800,101200
420005,202104,41,37,4,40700,4400,45100
420010,202104,365,235,130,258500,143000,401500
420020,202104,79,66,13,72600,14300,86900
420030,202104,26,21,5,23100,5500,28600
420040,202104,96,75,21,82500,23100,105600
420050,202104,56,33,23,36300,25300,61600
420055,202104,19,19,0,20900,0,20900
420060,202104,29,21,8,23100,8800,31900
420070,202104,102,86,16,94600,17600,112200
420075,202104,11,11,0,12100,0,12100
420080,202104,41,36,5,39600,5500,45100
420090,202104,35,30,5,33000,5500,38500
420100,202104,151,126,25,138600,27500,166100
420110,202104,20,20,0,22000,0,22000
420120,202104,58,42,16,46200,17600,63800
420125,202104,78,60,18,66000,19800,85800
420127,202104,32,26,6,28600,6600,35200
420130,202104,441,261,180,287833.33,198000,485833.33
420140,202104,1303,722,581,794200,639100,1433300
420150,202104,46,36,10,39600,11000,50600
420160,202104,30,28,2,30800,2200,33000
420165,202104,16,11,5,12100,5500,17600
420170,202104,62,37,25,40700,27500,68200
420180,202104,19,16,3,17600,3300,20900
420190,202104,26,23,3,25300,3300,28600
420195,202104,126,59,67,64900,73700,138600
420200,202104,1253,543,710,598400,782100,1380500
420205,202104,91,49,42,53900,48400,102300
420207,202104,123,66,57,72600,62700,135300
420208,202104,21,16,5,17600,5500,23100
420209,202104,16,14,2,15400,2200,17600
420210,202104,523,246,277,270600,304700,575300
420213,202104,45,35,10,38500,11000,49500
420215,202104,28,24,4,26400,4400,30800
420220,202104,58,36,22,39600,24200,63800
420230,202104,844,483,361,533500,397100,930600
420240,202104,2187,1409,778,1554300,855800,2410100
420243,202104,42,33,9,36300,9900,46200
420245,202104,167,82,85,90200,93500,183700
420250,202104,63,41,22,45100,24200,69300
420253,202104,26,20,6,22000,6600,28600
420257,202104,12,9,3,9900,3300,13200
420260,202104,98,79,19,86900,20900,107800
420270,202104,27,22,5,24200,5500,29700
420280,202104,282,214,68,236500,74800,311300
420285,202104,20,13,7,14300,7700,22000
420287,202104,48,32,16,35200,17600,52800
420290,202104,948,645,303,711700,334400,1046100
420300,202104,1455,1147,308,1261700,338800,1600500
420310,202104,49,32,17,35200,18700,53900
420315,202104,34,27,7,29700,7700,37400
420320,202104,963,459,504,507100,554400,1061500
420325,202104,3,1,2,1100,2200,3300
420330,202104,127,81,46,89100,50600,139700
420340,202104,170,115,55,126500,60500,187000
420350,202104,261,180,81,198000,89100,287100
420360,202104,702,538,164,592900.88,180400,773300.88
420370,202104,129,75,54,82500,59400,141900
420380,202104,1192,823,369,905300,407000,1312300
420390,202104,234,163,71,179300,78100,257400
420395,202104,191,135,56,148500,61600,210100
420400,202104,244,188,56,206800,61600,268400
420410,202104,59,45,14,49500,15400,64900
420415,202104,34,28,6,30800,6600,37400
420417,202104,52,41,11,45100,12100,57200
420419,202104,12,12,0,13200,0,13200
420420,202104,2800,1723,1077,1899700,1184700,3084400
420425,202104,70,57,13,62700,14300,77000
420430,202104,1126,804,322,886600,355300,1241900
420435,202104,14,12,2,13200,2200,15400
420440,202104,101,72,29,79200,31900,111100
420445,202104,27,26,1,28600,1100,29700
420450,202104,77,36,41,39600,45100,84700
420455,202104,201,153,48,169400,52800,222200
420460,202104,2322,1480,842,1630200,929500,2559700
420470,202104,96,69,27,75900,29700,105600
420475,202104,9,8,1,8800,1100,9900
420480,202104,862,646,216,711700,237600,949300
420490,202104,98,72,26,79200,28600,107800
420500,202104,447,237,210,261800.26,231000,492800.26
420510,202104,19,18,1,19800,1100,20900
420515,202104,28,16,12,17600,13200,30800
420517,202104,9,9,0,9900,0,9900
420519,202104,0,,,,,0.0
420520,202104,65,48,17,52800,18700,71500
420530,202104,157,104,53,114400,58300,172700
420535,202104,19,17,2,18700,2200,20900
420540,202104,5640,3410,2230,3765575.59,2455200,6220775.59
420543,202104,31,29,2,31900,2200,34100
420545,202104,209,148,61,162800,67100,229900
420550,202104,834,686,148,754600,162800,917400
420555,202104,27,17,10,18700,11000,29700
420560,202104,62,52,10,57200,11000,68200
420570,202104,172,97,75,106700,82500,189200
420580,202104,284,132,152,145200,167200,312400
420590,202104,482,322,160,356400,176000,532400
420600,202104,133,73,60,80300,66000,146300
420610,202104,39,35,4,38500,4400,42900
420620,202104,84,64,20,70400,22000,92400
420630,202104,147,95,52,105600,57200,162800
420640,202104,79,70,9,77000,9900,86900
420650,202104,254,125,129,137500,141900,279400
420660,202104,48,39,9,42900,9900,52800
420665,202104,36,25,11,27500,12100,39600
420670,202104,292,230,62,253000,68200,321200
420675,202104,13,11,2,12100,2200,14300
420680,202104,35,25,10,27500,11000,38500
420690,202104,173,135,38,148500,41800,190300
420700,202104,681,452,229,497200.7,253000,750200.7
420710,202104,147,78,69,85800,75900,161700
420720,202104,104,82,22,91300,24200,115500
420730,202104,623,375,248,413600,273900,687500
420740,202104,54,53,1,58300,1100,59400
420750,202104,481,323,158,355300,174900,530200
420757,202104,19,17,2,18700,2200,20900
420760,202104,38,30,8,33000,8800,41800
420765,202104,80,59,21,64900,23100,88000
420768,202104,50,42,8,46200,8800,55000
420770,202104,74,61,13,67100,14300,81400
420775,202104,40,36,4,39600,4400,44000
420780,202104,206,162,44,179300,48400,227700
420785,202104,21,13,8,14300,8800,23100
420790,202104,156,129,27,141900,29700,171600
420800,202104,62,46,16,50600,17600,68200
420810,202104,257,212,45,235400,49500,284900
420820,202104,2376,1327,1049,1464100,1157200.5,2621300.5
420830,202104,604,317,287,352000,317900,669900
420840,202104,151,105,46,115500,50600,166100
420845,202104,409,173,236,190300,260700,451000
420850,202104,257,189,68,207900.5,74800,282700.5
420860,202104,55,45,10,49500,11000,60500
420870,202104,133,93,40,102300,44000,146300
420880,202104,182,116,66,127600,72600,200200
420890,202104,941,460,481,507100,532400,1039500
420895,202104,8,8,0,8800,0,8800
420900,202104,400,315,85,347600,93500,441100
420910,202104,5750,3119,2631,3441901.3,2902900,6344801.3
420915,202104,60,55,5,60500,5500,66000
420917,202104,22,15,7,16500,7700,24200
420920,202104,22,15,7,16500,7700,24200
420930,202104,2844,1782,1062,1961229,1169300.18,3130529.18
420940,202104,591,436,155,479600,170500,650100
420945,202104,10,7,3,7700,3300,11000
420950,202104,51,44,7,48400,7700,56100
420960,202104,108,87,21,96800,23100,119900
420970,202104,283,227,56,249700,61600,311300
420980,202104,23,22,1,24200,1100,25300
420985,202104,57,51,6,56100,6600,62700
420990,202104,79,57,22,62700,24200,86900
421000,202104,45,26,19,28600,20900,49500
421003,202104,48,33,15,36300,16500,52800
421005,202104,7,4,3,4400,3300,7700
421010,202104,788,515,273,568700,300300,869000
421020,202104,24,18,6,19800,6600,26400
421030,202104,115,97,18,106700,19800,126500
421040,202104,75,56,19,61600,20900,82500
421050,202104,335,227,108,249700,118800,368500
421055,202104,21,16,5,17600,5500,23100
421060,202104,88,48,40,53900,44000,97900
421070,202104,51,42,9,46200,9900,56100
421080,202104,34,31,3,34100,3300,37400
421085,202104,21,17,4,18700,4400,23100
421090,202104,36,28,8,30800,8800,39600
421100,202104,125,91,34,100100,37400,137500
421105,202104,185,150,35,165000,38500,203500
421110,202104,112,86,26,94600,28600,123200
421120,202104,177,131,46,146300.92,50600,196900.92
421125,202104,17,11,6,12100,6600,18700
421130,202104,823,504,319,555500,352000,907500
421140,202104,31,22,9,24200,9900,34100
421145,202104,49,38,11,41800,12100,53900
421150,202104,98,71,27,78100,29700,107800
421160,202104,66,44,22,48400,24200,72600
421165,202104,16,13,3,14300,3300,17600
421170,202104,181,154,27,169532,29700,199232
421175,202104,159,107,52,117700,57200,174900
421180,202104,49,34,15,37400,16500,53900
421185,202104,16,12,4,13200,4400,17600
421187,202104,1,0,1,0,1100,1100
421189,202104,45,31,14,34100,15400,49500
421190,202104,1728,1071,657,1179200.66,724900,1904100.66
421200,202104,93,68,25,75900,27500,103400
421205,202104,26,17,9,18700,9900,28600
421210,202104,177,124,53,136400,58300,194700
421220,202104,264,201,63,221100,69300,290400
421223,202104,46,36,10,39600,11000,50600
421225,202104,69,43,26,47300,28600,75900
421227,202104,82,66,16,72600,17600,90200
421230,202104,58,44,14,48400,15400,63800
421240,202104,17,17,0,18700,0,18700
421250,202104,364,206,158,226600,173800,400400
421260,202104,22,18,4,19800,4400,24200
421265,202104,2,2,0,2200,0,2200
421270,202104,52,45,7,49500,7700,57200
421280,202104,350,185,165,203500,181500,385000
421290,202104,327,214,113,236500,124300,360800
421300,202104,25,20,5,22000,5500,27500
421310,202104,48,32,16,35200,17600,52800
421315,202104,32,18,14,19800,15400,35200
421320,202104,124,78,46,85800,50600,136400
421330,202104,104,75,29,82500,31900,114400
421335,202104,40,28,12,30800,13200,44000
421340,202104,237,152,85,167200,93500,260700
421350,202104,187,107,80,118800.39,88000,206800.39
421360,202104,663,469,194,515900,213400,729300
421370,202104,189,141,48,155100,52800,207900
421380,202104,131,102,29,112200,31900,144100
421390,202104,16,10,6,11000,6600,17600
421400,202104,116,99,17,108900,18700,127600
421410,202104,21,18,3,19800,3300,23100
421415,202104,20,19,1,20900,1100,22000
421420,202104,106,89,17,97900,18700,116600
421430,202104,19,14,5,15400,5500,20900
421440,202104,60,52,8,57200,8800,66000
421450,202104,89,73,16,80300,17600.51,97900.51
421460,202104,59,45,14,49500,15400,64900
421470,202104,69,41,28,45100,30800,75900
421480,202104,738,558,180,614900,199100,814000
421490,202104,25,24,1,26400,1100,27500
421500,202104,488,302,186,332200,204600,536800
421505,202104,23,17,6,18700,6600,25300
421507,202104,32,25,7,27500,7700,35200
421510,202104,73,47,26,51700,28600,80300
421520,202104,53,44,9,48400,9900,58300
421530,202104,51,43,8,47300,8800,56100
421535,202104,21,20,1,23100,1100,24200
421540,202104,52,41,11,45100,12100,57200
421545,202104,88,61,27,67100,29700,96800
421550,202104,278,201,77,222200.79,84700,306900.79
421555,202104,19,17,2,18700,2200,20900
421560,202104,8,7,1,7700,1100,8800
421565,202104,120,80,40,88000,44000,132000
421567,202104,29,23,6,25300,6600,31900
421568,202104,44,39,5,42900,5500,48400
421569,202104,12,12,0,13200,0,13200
421570,202104,202,134,68,147400,74800,222200
421575,202104,27,24,3,26400,3300,29700
421580,202104,720,427,293,469772,323400,793172
421590,202104,20,19,1,20900,1100,22000
421600,202104,146,95,51,104500,56100,160600
421605,202104,111,77,34,85800,37400,123200
421610,202104,174,131,43,144100,47300,191400
421620,202104,1023,589,434,649000,477400,1126400
421625,202104,21,18,3,19800,3300,23100
421630,202104,320,199,121,218900,133100,352000
421635,202104,21,10,11,11000,12100,23100
421640,202104,101,83,18,91300,19800,111100
421650,202104,291,167,124,183700,136400,320100
421660,202104,2316,1380,936,1518000,1031800,2549800
421670,202104,173,122,51,134200,56100,190300
421680,202104,188,168,20,184800,22000,206800
421690,202104,341,236,105,261800,115500,377300
421700,202104,53,36,17,39600,18700,58300
421710,202104,25,23,2,25300,2200,27500
421715,202104,5,4,1,4400,1100,5500
421720,202104,618,429,189,471900,207900,679800
421725,202104,20,8,12,8800,13200,22000
421730,202104,29,21,8,23100,8800,31900
421740,202104,97,32,65,35200,71500,106700
421750,202104,199,145,54,159500,59400,218900
421755,202104,21,19,2,22000,2200,24200
421760,202104,100,65,35,71500,38500,110000
421770,202104,677,424,253,466400,278300.78,744700.78
421775,202104,27,17,10,18700,11000,29700
421780,202104,186,145,41,159500,45100,204600
421790,202104,147,125,22,137500,24200,161700
421795,202104,18,14,4,15400,4400,19800
421800,202104,524,326,198,358600,217800,576400
421810,202104,68,52,16,57200,17600,74800
421820,202104,299,192,107,211200,118800,330000
421825,202104,147,123,24,135300,26400,161700
421830,202104,145,89,56,97900,61600,159500
421835,202104,7,3,4,3300,4400,7700
421840,202104,47,41,6,45100,6600,51700
421850,202104,81,67,14,73700,15400,89100
421860,202104,44,33,11,36300,12100,48400
421870,202104,1026,762,264,840400,292600,1133000
421875,202104,52,43,9,47300,9900,57200
421880,202104,170,120,50,132000,55000,187000
421885,202104,23,18,5,19800,5500,25300
421890,202104,142,100,42,110000,46200.5,156200.5
421895,202104,46,41,5,45100,5500,50600
421900,202104,146,114,32,126500,35200,161700
421910,202104,58,35,23,38500,25300,63800
421915,202104,28,23,5,25300,5500,30800
421917,202104,31,22,9,24200,9900,34100
421920,202104,37,32,5,35200,5500,40700
421930,202104,629,497,132,547800,145200,693000
421935,202104,51,44,7,48400,7700,56100
421940,202104,46,38,8,41800,8800,50600
421950,202104,863,579,284,638000,313500,951500
421960,202104,39,34,5,37400,5500,42900
421970,202104,328,211,117,232100,128700,360800
421985,202104,20,12,8,13200,8800,22000
422000,202104,0,,,,,0.0
430003,202104,193,54,139,59400,154000,213400
430005,202104,36,26,10,28600,11000,39600
430010,202104,264,192,72,211200,79200,290400
430020,202104,145,95,50,104500,55000,159500
430030,202104,123,101,22,111100,24200,135300
430040,202104,2882,1695,1187,1866700,1306800,3173500
430045,202104,66,55,11,60500,12100,72600
430047,202104,7,6,1,6600,1100,7700
430050,202104,79,65,14,71500,15400,86900
430055,202104,11,10,1,11000,1100,12100
430057,202104,5,4,1,4400,1100,5500
430060,202104,3729,2145,1584,2361700,1745700.28,4107400.28
430063,202104,51,45,6,49500,6600,56100
430064,202104,156,123,33,135300,36300,171600
430066,202104,5,2,3,2200,3300,5500
430070,202104,41,29,12,31900,13200,45100
430080,202104,68,44,24,48400,26400,74800
430085,202104,26,10,16,11000,17600,28600
430087,202104,24,17,7,18700,7700,26400
430090,202104,70,61,9,67100,9900,77000
430100,202104,127,85,42,93500,46200,139700
430105,202104,146,81,65,90200,71500,161700
430107,202104,18,12,6,13200,6600,19800
430110,202104,471,257,214,282700,235400,518100
430120,202104,159,146,13,160600,14300,174900
430130,202104,781,472,309,520300,341000,861300
430140,202104,126,117,9,128700,9900,138600
430150,202104,108,68,40,74800,45100,119900
430155,202104,32,27,5,29700,5500,35200
430160,202104,3580,2067,1513,2274800,1668700,3943500
430163,202104,375,157,218,172700,240900,413600
430165,202104,31,21,10,23100,11000,34100
430170,202104,87,72,15,79200,16500,95700
430175,202104,74,59,15,64900,16500,81400
430180,202104,111,92,19,101200,22000,123200
430185,202104,27,18,9,19800,9900,29700
430187,202104,53,29,24,31900,26400,58300
430190,202104,229,124,105,136400,115500,251900
430192,202104,13,11,2,12100,2200,14300
430195,202104,18,11,7,12100,7700,19800
430200,202104,161,138,23,151800,25300,177100
430205,202104,20,20,0,22000,0,22000
430210,202104,671,505,166,558800,183700,742500
430215,202104,11,10,1,11000,1100,12100
430220,202104,72,48,24,52800,26400,79200
430222,202104,12,4,8,4400,8800,13200
430223,202104,15,8,7,8800,7700,16500
430225,202104,2,1,1,1100,1100,2200
430230,202104,309,185,124,203500,137500,341000
430235,202104,54,40,14,45100,15400,60500
430237,202104,25,19,6,20900,6600,27500
430240,202104,104,73,31,81400,34100,115500
430245,202104,73,58,15,63800,16500,80300
430250,202104,183,105,78,115500,85800,201300
430258,202104,8,7,1,7700,1100,8800
430260,202104,31,27,4,29700,4400,34100
430265,202104,34,28,6,30800,6600,37400
430270,202104,518,385,133,424600,146300,570900
430280,202104,1036,613,423,674300,466400,1140700
430290,202104,410,218,192,239800,211200,451000
430300,202104,2097,1132,965,1245200,1062600,2307800
430310,202104,2005,986,1019,1086800,1123100.7,2209900.7
430320,202104,54,45,9,49500,9900,59400
430330,202104,100,88,12,96800,13200,110000
430340,202104,70,56,14,61600,15400,77000
430350,202104,1638,1090,548,1200100,603900,1804000
430355,202104,20,18,2,19800,2200,22000
430360,202104,90,43,47,47300,51700,99000
430367,202104,35,25,10,27500,11000,38500
430370,202104,53,48,5,52800,5500,58300
430380,202104,123,95,28,104500,30800,135300
430390,202104,584,368,216,407000,237600,644600
430400,202104,253,183,70,201300,77000,278300
430410,202104,55,43,12,47300,13200,60500
430420,202104,504,324,180,356400,198000,554400
430430,202104,54,52,2,56467.4,2200,58667.4
430435,202104,149,112,37,123200,41800,165000
430440,202104,500,320,180,352000,198000,550000
430450,202104,1143,933,210,1027400,232100,1259500
430460,202104,5332,2722,2610,3000800,2875400,5876200
430461,202104,16,14,2,15400,2200,17600
430462,202104,5,3,2,3300,2200,5500
430463,202104,1102,585,517,644600,568700,1213300
430465,202104,24,13,11,14300,12100,26400
430466,202104,633,440,193,485100,212300,697400
430467,202104,112,61,51,67100,56100,123200
430468,202104,122,69,53,77000,58300,135300
430469,202104,21,16,5,17600,5500,23100
430470,202104,1149,636,513,701027.5,564300,1265327.5
430471,202104,60,39,21,42900,23100,66000
430480,202104,105,69,36,75900,39600,115500
430485,202104,7,7,0,7700,0,7700
430490,202104,73,58,15,63800,16500,80300
430495,202104,32,25,7,27500,7700,35200
430500,202104,189,128,61,140800,67100,207900
430510,202104,3511,2243,1268,2469500.67,1395900,3865400.67
430511,202104,16,16,0,17600,0,17600
430512,202104,149,103,46,113300,50600,163900
430513,202104,51,41,10,45100,11000,56100
430515,202104,24,23,1,26400,1100,27500
430517,202104,170,143,27,157300,29700,187000
430520,202104,336,236,100,259600,110000,369600
430530,202104,83,47,36,51700,39600,91300
430535,202104,440,295,145,324500,159500,484000
430537,202104,11,11,0,12100,0,12100
430540,202104,83,57,26,62700,28600,91300
430543,202104,366,110,256,121000,281600,402600
430544,202104,44,41,3,45100,3300,48400
430545,202104,379,180,199,198000.61,220000,418000.61
430550,202104,39,31,8,34100,8800,42900
430558,202104,1,1,0,1100,0,1100
430560,202104,56,31,25,34100,27500,61600
430570,202104,109,42,67,46200,73700,119900
430580,202104,131,106,25,116600,27500,144100
430583,202104,15,15,0,16500,0,16500
430585,202104,11,4,7,4400,7700,12100
430587,202104,15,9,6,9900,6600,16500
430590,202104,148,119,29,132000,31900,163900
430593,202104,2,2,0,2200,0,2200
430595,202104,16,14,2,15400,2200,17600
430597,202104,43,22,21,24200,23100,47300
430600,202104,215,159,56,174900,61600,236500
430605,202104,160,97,63,106700,69300,176000
430607,202104,27,22,5,24200,5500,29700
430610,202104,1690,778,912,855800,1005400,1861200
430613,202104,3,3,0,3300,0,3300
430620,202104,115,82,33,90200,36300,126500
430630,202104,46,39,7,42900,7700,50600
430632,202104,33,28,5,30800,5500,36300
430635,202104,38,34,4,37400,4400,41800
430637,202104,64,31,33,34100,36300,70400
430640,202104,176,96,80,106700,88000,194700
430642,202104,19,16,3,17600,3300,20900
430645,202104,32,26,6,28600,6600,35200
430650,202104,242,197,45,216700,49500,266200
430655,202104,2,1,1,1100,1100,2200
430660,202104,970,482,488,530200,536800,1067000
430670,202104,77,53,24,58300,26400,84700
430673,202104,71,43,28,47300,30800,78100
430675,202104,9,7,2,7700,2200,9900
430676,202104,537,316,221,347600,243100,590700
430680,202104,236,158,78,173800,85800,259600
430690,202104,519,318,201,349800,222200.63,572000.63
430692,202104,9,7,2,7700,2200,9900
430693,202104,143,90,53,99000,58300,157300
430695,202104,64,52,12,57200,13200,70400
430697,202104,60,36,24,39600,26400,66000
430700,202104,1461,995,466,1094500,512600,1607100
430705,202104,28,25,3,27500,3300,30800
430710,202104,250,155,95,170500,104500,275000
430720,202104,111,95,16,104500,17600,122100
430730,202104,145,124,21,136400,23100,159500
430740,202104,73,50,23,55000,25300,80300
430745,202104,30,23,7,25300,7700,33000
430750,202104,336,226,110,248600,121000,369600
430755,202104,83,43,40,47300,45100,92400
430760,202104,390,215,175,237600,192500,430100
430770,202104,1503,771,732,849200,805200,1654400
430780,202104,298,185,113,204600,124300,328900
430781,202104,25,22,3,24200,3300,27500
430783,202104,60,49,11,53900,12100,66000
430786,202104,5,3,2,3300,2200,5500
430790,202104,508,329,179,363000,196900,559900
430800,202104,154,122,32,134200.01,35200,169400.01
430805,202104,43,34,9,37400,9900,47300
430807,202104,57,31,26,34100,28600,62700
430810,202104,76,46,30,50600,33000,83600
430820,202104,138,83,55,91300,60500,151800
430825,202104,10,8,2,8800,2200,11000
430830,202104,238,220,18,242000,19800,261800
430840,202104,131,86,45,94600,49500,144100
430843,202104,5,3,2,3300,2200,5500
430845,202104,77,41,36,45100,39600,84700
430850,202104,584,416,168,459800,184800,644600
430860,202104,154,97,57,106700,62700,169400
430865,202104,75,40,35,44000,38500,82500
430870,202104,78,64,14,70400,15400,85800
430880,202104,148,108,40,118800,44000,162800
430885,202104,11,9,2,9900,2200,12100
430890,202104,335,200,135,220000,148500,368500
430900,202104,518,356,162,391600,178200,569800
430905,202104,122,50,72,55000,79200,134200
430910,202104,279,159,120,177100,134200,311300
430912,202104,4,4,0,4400,0,4400
430915,202104,34,30,4,33000,4400,37400
430920,202104,4337,2273,2064,2505800,2271500,4777300
430925,202104,5,4,1,4400,1100,5500
430930,202104,2052,1179,873,1301300,964700,2266000
430940,202104,259,169,90,185900,99000,284900
430950,202104,149,124,25,136400,27500,163900
430955,202104,26,14,12,15400,13200,28600
430957,202104,20,18,2,19800,2200,22000
430960,202104,244,158,86,173800,94600,268400
430965,202104,111,70,41,77000,45100,122100
430970,202104,92,74,18,81400,19800,101200
430975,202104,45,39,6,42900,6600,49500
430980,202104,47,29,18,31900,19800,51700
430990,202104,99,77,22,84700,24200,108900
430995,202104,114,107,7,117700,7700,125400
431000,202104,286,136,150,149600.6,165000,314600.6
431010,202104,345,193,152,212300,168300,380600
431020,202104,1866,1072,794,1179200,874500,2053700
431030,202104,38,31,7,34100,7700,41800
431033,202104,417,191,226,210100,248600,458700
431036,202104,12,7,5,8800,5500,14300
431040,202104,143,87,56,95700,61600,157300
431041,202104,39,26,13,28600,14300,42900
431043,202104,43,25,18,27500,19800,47300
431046,202104,12,9,3,9900,3300,13200
431050,202104,203,126,77,138600,84700,223300
431053,202104,67,38,29,41800,31900,73700
431055,202104,63,44,19,48400,20900,69300
431057,202104,18,18,0,19800,0,19800
431060,202104,1581,1024,557,1128600.31,613800,1742400.31
431065,202104,16,10,6,11000,6600,17600
431070,202104,65,60,5,66000,5500,71500
431075,202104,7,7,0,7700,0,7700
431080,202104,133,77,56,84700,61600,146300
431085,202104,34,31,3,34100,3300,37400
431087,202104,11,9,2,9900,2200,12100
431090,202104,55,42,13,46200,14300,60500
431100,202104,1220,722,498,795300,547800,1343100
431110,202104,227,137,90,150700,99000,249700
431112,202104,24,15,9,16500,9900,26400
431113,202104,33,24,9,26400,9900,36300
431115,202104,160,113,47,124300,52800,177100
431120,202104,599,354,245,390500,269500,660000
431123,202104,3,2,1,2200,1100,3300
431125,202104,97,83,14,91300,15400,106700
431127,202104,10,6,4,6600,4400,11000
431130,202104,709,462,247,508200,273900,782100
431140,202104,758,527,231,579700,254100,833800
431142,202104,26,22,4,24200.55,4400,28600.55
431150,202104,189,141,48,155100,52800,207900
431160,202104,45,42,3,46200,3300,49500
431162,202104,3,3,0,3300,0,3300
431164,202104,6,6,0,6600,0,6600
431170,202104,111,86,25,94600,27500,122100
431171,202104,69,40,29,44000,31900,75900
431173,202104,1,1,0,1100,0,1100
431175,202104,202,99,103,108900,114400,223300
431177,202104,87,62,25,68200,27500,95700
431179,202104,14,11,3,12100,3300,15400
431180,202104,426,259,167,288200,184800,473000
431190,202104,75,57,18,62700,20900,83600
431198,202104,72,51,21,56100,23100,79200
431200,202104,22,18,4,19800,4400,24200
431205,202104,22,21,1,23100,1100,24200
431210,202104,100,63,37,69300,40700,110000
431213,202104,31,27,4,29700,4400,34100
431215,202104,21,18,3,19800,3300,23100
431217,202104,7,7,0,7700,0,7700
431220,202104,67,58,9,63800,9900,73700
431225,202104,155,98,57,107800,62700,170500
431230,202104,96,83,13,91300,14300,105600
431235,202104,6,6,0,6600,0,6600
431237,202104,8,7,1,7700,1100,8800
431238,202104,12,8,4,8800,4400,13200
431240,202104,1034,637,397,702900,437800,1140700
431242,202104,39,38,1,41800,1100,42900
431244,202104,15,11,4,12100,4400,16500
431245,202104,50,37,13,40700,14300,55000
431247,202104,11,6,5,6600,5500,12100
431250,202104,283,141,142,155100,156200,311300
431260,202104,57,46,11,50600,12100,62700
431261,202104,17,11,6,12100,6600,18700
431262,202104,16,15,1,16500,1100,17600
431265,202104,156,83,73,91300,80300,171600
431267,202104,18,15,3,16500,3300,19800
431270,202104,321,257,64,282700,70400,353100
431275,202104,39,36,3,39600,3300,42900
431280,202104,19,15,4,16500,4400,20900
431290,202104,18,16,2,18700,2200,20900
431295,202104,2,1,1,1100,1100,2200
431300,202104,22,19,3,20900,3300,24200
431301,202104,5,5,0,5500,0,5500
431303,202104,61,40,21,44000,23100,67100
431306,202104,239,125,114,137304.2,125400,262704.2
431308,202104,6,4,2,4400,2200,6600
431310,202104,65,53,12,58300,13200,71500
431320,202104,158,93,65,102300,71500,173800
431330,202104,184,111,73,122100,80300,202400
431333,202104,26,20,6,22000,6600,28600
431335,202104,10,6,4,6600,4400,11000
431337,202104,370,161,209,177100,229900,407000
431339,202104,21,16,5,17600,5500,23100
431340,202104,3039,1653,1386,1819313.1,1526800,3346113.1
431342,202104,39,26,13,28600,14300,42900
431344,202104,16,16,0,17600,0,17600
431346,202104,4,4,0,4400,0,4400
431349,202104,37,33,4,36300,4400,40700
431350,202104,912,511,401,564300,442200,1006500
431360,202104,54,44,10,48400,11000,59400
431365,202104,342,149,193,163900,213400,377300
431370,202104,1211,691,520,760100,572000,1332100
431380,202104,97,86,11,94600,12100,106700
431390,202104,494,267,227,293700,249700,543400
431395,202104,315,133,182,146300,202400,348700
431400,202104,43,30,13,33000,14300,47300
431402,202104,112,80,32,88000,35200,123200
431403,202104,24,14,10,15400,11000,26400
431405,202104,692,383,309,422400,341000,763400
431406,202104,33,26,7,28600,7700,36300
431407,202104,53,42,11,46200,12100,58300
431410,202104,3415,2070,1345,2278100,1486100,3764200
431413,202104,16,13,3,14300,3300,17600
431415,202104,63,44,19,49500,20900,70400
431417,202104,29,14,15,15400,16500,31900
431420,202104,327,223,104,245300,114400,359700
431430,202104,54,25,29,27500,31900,59400
431440,202104,8816,6016,2800,6631900.5,3085551,9717451.5
431442,202104,29,13,16,14300,17600,31900
431445,202104,28,26,2,28600,2200,30800
431446,202104,4,3,1,3300,1100,4400
431447,202104,87,60,27,66000,29700,95700
431449,202104,51,42,9,46200,9900,56100
431450,202104,408,269,139,295900,154000,449900
431454,202104,10,5,5,5500,5500,11000
431455,202104,48,39,9,42900,9900,52800
431460,202104,498,341,157,375100,173800,548900
431470,202104,119,86,33,94600,36300,130900
431475,202104,10,8,2,8800,2200,11000
431477,202104,38,23,15,25300,16500,41800
431478,202104,9,8,1,8800,1100,9900
431480,202104,542,325,217,357500,238700,596200
431490,202104,28390,15764,12626,17364486.85,13913900,31278386.85
431500,202104,79,63,16,69300,17600,86900
431505,202104,24,14,10,15400,11000,26400
431507,202104,8,7,1,7700,1100,8800
431510,202104,248,177,71,194700,78100,272800
431513,202104,23,20,3,22000,3300,25300
431514,202104,5,4,1,4400,1100,5500
431515,202104,78,64,14,70400,15400,85800
431517,202104,5,3,2,3300,2200,5500
431520,202104,39,35,4,38500,4400,42900
431530,202104,1432,632,800,695200,881100,1576300
431531,202104,22,21,1,23100,1100,24200
431532,202104,37,28,9,30800,9900,40700
431535,202104,28,16,12,17600,13200,30800
431540,202104,142,121,21,133100,24200,157300
431545,202104,14,11,3,12100,3300,15400
431550,202104,357,189,168,207900,184800,392700
431555,202104,12,12,0,13200,0,13200
431560,202104,4522,3043,1479,3355000,1630200,4985200
431570,202104,811,424,387,466400,426800,893200
431575,202104,43,23,20,25300,22000,47300
431580,202104,90,59,31,64900,34100,99000
431590,202104,138,116,22,127600,24200,151800
431595,202104,19,16,3,17600,3300,20900
431600,202104,244,143,101,157300,112200,269500
431610,202104,116,86,30,94600,33000,127600
431620,202104,42,35,7,38500,7700,46200
431630,202104,127,105,22,115500,24200,139700
431640,202104,1343,835,508,919600,558800,1478400
431642,202104,37,34,3,37400,3300,40700
431643,202104,45,18,27,20900,29700,50600
431645,202104,312,184,128,202400,140800,343200
431647,202104,9,8,1,8800,1100,9900
431650,202104,34,22,12,24200,13200,37400
431660,202104,275,171,104,188100,114400,302500
431670,202104,228,103,125,113300,138600,251900
431673,202104,7,7,0,7700,0,7700
431675,202104,23,18,5,19800,5500,25300
431680,202104,1108,813,295,894300,326700,1221000
431690,202104,4784,2847,1937,3141600.5,2136200.91,5277801.41
431695,202104,22,16,6,17600,6600,24200
431697,202104,1,0,1,0,1100,1100
431700,202104,183,138,45,151800,49500,201300
431710,202104,4017,1730,2287,1904100,2519000,4423100
431720,202104,1317,804,513,883850,565400,1449250
431725,202104,1,1,0,1100,0,1100
431730,202104,1160,778,382,858000,420200,1278200
431740,202104,1335,644,691,709500,760100,1469600
431750,202104,1833,1186,647,1304600.32,711700,2016300.32
431755,202104,6,5,1,5500,1100,6600
431760,202104,1004,625,379,688600,418000,1106600
431770,202104,418,291,127,320100,139700,459800
431775,202104,27,20,7,22000,7700,29700
431780,202104,542,323,219,356400,240900,597300
431790,202104,157,121,36,133100,39600,172700
431795,202104,13,10,3,11000,3300,14300
431800,202104,3143,1628,1515,1794100,1668700,3462800
431805,202104,20,18,2,19800,2200,22000
431810,202104,604,395,209,434500,229900,664400
431820,202104,332,195,137,214500,150700,365200
431830,202104,2273,1357,916,1492700,1009800,2502500
431840,202104,479,315,164,346500,180400,526900
431842,202104,36,29,7,31900,7700,39600
431843,202104,10,7,3,7700,3300,11000
431844,202104,17,13,4,14300,4400,18700
431845,202104,27,25,2,27500,2200,29700
431846,202104,26,23,3,25300,3300,28600
431848,202104,11,9,2,9900,2200,12100
431849,202104,7,6,1,6600,1100,7700
431850,202104,763,609,154,669900,169400,839300
431860,202104,115,75,40,82500,44000,126500
431861,202104,6,2,4,2200,4400,6600
431862,202104,54,37,17,40700,18700,59400
431870,202104,3491,1967,1524,2167052,1680800,3847852
431880,202104,935,680,255,749100,280500,1029600
431890,202104,1291,756,535,832700,589600,1422300
431900,202104,182,124,58,136400,63800,200200
431910,202104,48,35,13,39600,14300,53900
431912,202104,44,27,17,29700,18700,48400
431915,202104,132,100,32,110000,35200,145200
431920,202104,156,110,46,122100,50600,172700
431930,202104,79,66,13,72600,14300,86900
431935,202104,2,2,0,2200,0,2200
431936,202104,3,3,0,3300,0,3300
431937,202104,20,15,5,16500,5500,22000
431940,202104,456,304,152,335500,167200,502700
431950,202104,484,311,173,342100,190300,532400
431960,202104,733,389,344,429000,378400,807400
431970,202104,70,64,6,70400,6600,77000
431971,202104,3,3,0,3300,0,3300
431973,202104,18,15,3,16500,4400,20900
431975,202104,8,7,1,7700,1100,8800
431980,202104,211,128,83,141900,91300,233200
431990,202104,1105,590,515,648928.5,566500,1215428.5
432000,202104,1757,911,846,1002100,931700,1933800
432010,202104,267,184,83,202400,91300,293700
432020,202104,178,147,31,161700,34100,195800
432023,202104,15,12,3,13200,3300,16500
432026,202104,66,59,7,64900,7700,72600
432030,202104,67,32,35,35200,38500,73700
432032,202104,19,14,5,15400,5500,20900
432035,202104,53,41,12,45100,13200,58300
432040,202104,88,61,27,67100,29700,96800
432045,202104,2,2,0,2200,0,2200
432050,202104,83,50,33,55000,36300,91300
432055,202104,122,89,33,97900,36300,134200
432057,202104,7,5,2,5500,2200,7700
432060,202104,32,29,3,31900,3300,35200
432065,202104,31,28,3,30800,3300,34100
432067,202104,86,77,9,84700,9900,94600
432070,202104,377,292,85,321475,93500,414975
432080,202104,821,572,249,629200,273900,903100
432085,202104,9,6,3,6600,3300,9900
432090,202104,264,174,90,191400,100100,291500
432100,202104,162,102,60,114400,66000,180400
432110,202104,533,354,179,390500,196900,587400
432120,202104,970,551,419,606100,460900,1067000
432130,202104,488,346,142,380600,156200,536800
432132,202104,24,21,3,23100,3300,26400
432135,202104,79,66,13,72600,14300,86900
432140,202104,269,206,63,227700,70400,298100
432143,202104,216,132,84,145200,92400,237600
432145,202104,277,191,86,210100,94600,304700
432146,202104,14,12,2,13200,2200,15400
432147,202104,111,61,50,67100,55000,122100
432149,202104,16,10,6,11000,6600,17600
432150,202104,899,539,360,594000,397100,991100
432160,202104,1504,756,748,832700.5,825000,1657700.5
432162,202104,4,2,2,2200,2200,4400
432163,202104,19,14,5,15400,5500,20900
432166,202104,126,93,33,102575,36300,138875
432170,202104,230,116,114,128333.33,125400,253733.33
432180,202104,550,335,215,369600,237600,607200
432183,202104,9,8,1,8800,1100,9900
432185,202104,75,64,11,70400,12100,82500
432190,202104,493,286,207,314600,227700,542300
432195,202104,90,72,18,79200,19800,99000
432200,202104,398,247,151,271700,166100,437800
432210,202104,114,71,43,78100,47300,125400
432215,202104,35,31,4,34100,4400,38500
432218,202104,22,21,1,23100,1100,24200
432220,202104,655,339,316,372900,347600.63,720500.63
432225,202104,14,9,5,9900,5500,15400
432230,202104,130,86,44,95700,48400,144100
432232,202104,13,11,2,12100,2200,14300
432234,202104,3,2,1,2200,1100,3300
432235,202104,4,2,2,2200,2200,4400
432237,202104,23,15,8,16500,8800,25300
432240,202104,4316,2373,1943,2612500,2143900,4756400
432250,202104,1129,730,399,803000,440000,1243000
432252,202104,47,46,1,50600,1100,51700
432253,202104,61,49,12,53900,13200,67100
432254,202104,27,11,16,12100,17600,29700
432255,202104,14,12,2,13200,2200,15400
432260,202104,821,647,174,711700,192500,904200
432270,202104,221,166,55,183700,61600,245300
432280,202104,138,104,34,115500,37400,152900
432285,202104,1,1,0,1100,0,1100
432290,202104,64,54,10,59400,11000,70400
432300,202104,4639,2468,2171,2721328.5,2390300.61,5111629.11
432310,202104,131,107,24,117700,26400,144100
432320,202104,21,17,4,19800,4400,24200
432330,202104,15,9,6,11000,6600,17600
432335,202104,8,6,2,6600,2200,8800
432340,202104,37,31,6,34100,6600,40700
432345,202104,107,70,37,77000,40700,117700
432350,202104,20,19,1,20900,1100,22000
432360,202104,4,3,1,3300,1100,4400
432370,202104,24,23,1,25300,1100,26400
432375,202104,32,29,3,31900,3300,35200
432377,202104,7,7,0,7700,0,7700
432380,202104,170,74,96,82500,105600,188100
500020,202104,249,132,117,145200,128700,273900
500025,202104,141,67,74,73700,81400,155100
500060,202104,1438,901,537,992200,590700,1582900
500070,202104,772,367,405,403700,445500,849200
500080,202104,135,107,28,117700,30800,148500
500085,202104,134,109,25,121000,27500,148500
500090,202104,353,162,191,178200,210100,388300
500100,202104,717,379,338,416900,371800,788700
500110,202104,2220,1037,1183,1141800,1301300,2443100
500124,202104,270,147,123,161700,136400,298100
500150,202104,344,135,209,148500,229900,378400
500190,202104,507,343,164,377300,180400,557700
500200,202104,199,171,28,188100,30800,218900
500210,202104,1577,530,1047,583000,1151700,1734700
500215,202104,234,130,104,143000,114400,257400
500220,202104,716,462,254,508200.92,279400,787600.92
500230,202104,230,141,89,155100,97900,253000
500240,202104,654,441,213,485100,234300,719400
500260,202104,582,226,356,248600,391600,640200
500270,202104,29730,12662,17068,13944022.97,18799000,32743022.97
500280,202104,200,69,131,75900,145200,221100
500290,202104,1161,713,448,785400,495000,1280400
500295,202104,441,284,157,314600,172700,487300
500310,202104,84,26,58,28600,63800,92400
500315,202104,787,442,345,486200,379500,865700
500320,202104,3547,1721,1826,1893100.84,2008600,3901700.84
500325,202104,933,506,427,556600,469700,1026300
500330,202104,1488,697,791,766700,870100,1636800
500345,202104,302,228,74,250800,81400,332200
500348,202104,248,145,103,159500,114400,273900
500350,202104,118,57,61,62700,67100,129800
500370,202104,5683,2551,3132,2806100,3451800,6257900
500375,202104,340,237,103,260700,113300,374000
500380,202104,589,332,257,365200,282700,647900
500390,202104,72,36,36,39600,39600,79200
500400,202104,217,138,79,152900,86900,239800
500410,202104,534,223,311,245300,342100,587400
500430,202104,524,369,155,405900,170500,576400
500440,202104,202,106,96,116600,106700,223300
500450,202104,401,173,228,190300,250800,441100
500460,202104,271,144,127,158400.47,139700,298100.47
500470,202104,424,329,95,361900.71,104500,466400.71
500480,202104,101,59,42,64900,46200,111100
500490,202104,103,46,57,50600,62700,113300
500500,202104,1400,509,891,559900,981200,1541100
500510,202104,44,36,8,39600,8800,48400
500515,202104,104,72,32,79200,35200,114400
500520,202104,297,157,140,172700,154000,326700
500525,202104,89,48,41,52800,45100,97900
500540,202104,884,387,497,425700,546700,972400
500560,202104,914,507,407,557700,447700,1005400
500568,202104,977,552,425,608300,467500,1075800
500570,202104,1176,686,490,755700,540100,1295800
500580,202104,329,163,166,179300,182600,361900
500600,202104,340,167,173,183700,190300,374000
500620,202104,926,651,275,716100.99,302500,1018600.99
500625,202104,77,62,15,68200,16500,84700
500627,202104,19,10,9,11000,9900,20900
500630,202104,1556,866,690,954801.24,762300,1717101.24
500635,202104,526,314,212,345400,233200,578600
500640,202104,370,199,171,218900,188100,407000
500660,202104,5607,2048,3559,2256100,3918200,6174300
500690,202104,600,205,395,225500,435600,661100
500710,202104,411,200,211,221100,232100,453200
500720,202104,912,523,389,575300.3,427900,1003200.3
500730,202104,180,107,73,117700,80300,198000
500740,202104,880,358,522,393800,574200,968000
500750,202104,150,48,102,52800,112200,165000
500755,202104,120,90,30,99000,33000,132000
500769,202104,752,408,344,448800,378400,827200
500770,202104,414,219,195,240900,215600,456500
500780,202104,143,94,49,103400,53900,157300
500790,202104,1049,525,524,577500,576400,1153900
500793,202104,271,141,130,155100,143000,298100
500795,202104,175,121,54,133100,59400,192500
500797,202104,47,33,14,36300,15400,51700
500800,202104,437,190,247,209000,272800,481800
500830,202104,2205,1229,976,1353000,1076900,2429900
500840,202104,127,95,32,104500,35200,139700
510010,202104,169,87,82,95700,90200,185900
510020,202104,513,220,293,242000,322300,564300
510025,202104,1651,944,707,1038400.37,777700,1816100.37
510030,202104,662,337,325,370700,358600,729300
510035,202104,128,63,65,69300,71500,140800
510040,202104,398,182,216,200200,237600,437800
510050,202104,385,214,171,235400,188100.3,423500.3
510060,202104,119,58,61,63800,67100,130900
510080,202104,232,93,139,102300,154000,256300
510100,202104,65,29,36,31900,39600,71500
510120,202104,33,20,13,22000,14300,36300
510125,202104,375,232,143,255200,157300,412500
510130,202104,532,319,213,350900,236500,587400
510140,202104,429,129,300,141900,330000,471900
510160,202104,102,33,69,36300,75900,112200
510170,202104,775,473,302,520300.56,332200,852500.56
510180,202104,2908,1352,1556,1487200,1713800,3201000
510185,202104,19,8,11,8800,12100,20900
510190,202104,236,85,151,93500,166100,259600
510250,202104,2564,1530,1034,1683000,1137400,2820400
510260,202104,172,125,47,137500,51700,189200
510263,202104,460,256,204,282700,224400,507100
510267,202104,636,357,279,393800,306900,700700
510268,202104,61,27,34,29700,37400,67100
510269,202104,73,31,42,34100,46200,80300
510270,202104,382,191,191,210100,210100,420200
510279,202104,216,163,53,179300,58300,237600
510285,202104,183,74,109,81400,119900,201300
510300,202104,507,267,240,293700,264000,557700
510305,202104,201,92,109,101200,119900,221100
510310,202104,108,54,54,59400,59400,118800
510320,202104,841,532,309,587400,339900,927300
510325,202104,416,171,245,188100,269500,457600
510330,202104,425,237,188,260700,206800,467500
510335,202104,636,365,271,402600,298100,700700
510336,202104,55,38,17,41800,18700,60500
510337,202104,107,48,59,52800,64900,117700
510340,202104,17136,7674,9462,8445801.24,10408200,18854001.24
510343,202104,62,45,17,49500,18700,68200
510345,202104,157,100,57,110000,62700,172700
510350,202104,636,344,292,378400,321200,699600
510360,202104,202,125,77,137500,84700,222200
510370,202104,150,68,82,74800,90200,165000
510380,202104,84,62,22,69300,24200,93500
510385,202104,62,27,35,29700,38500,68200
510390,202104,108,47,61,51700,67100,118800
510395,202104,44,31,13,35200,14300,49500
510410,202104,708,459,249,504900,273900,778800
510420,202104,554,268,286,294800,314600,609400
510450,202104,50,25,25,27500,27500,55000
510452,202104,53,25,28,27500,30800,58300
510454,202104,55,24,31,26400,34100,60500
510455,202104,133,74,59,81400,64900,146300
510460,202104,174,79,95,86900,104500,191400
510480,202104,693,411,282,452100,310200,762300
510490,202104,341,169,172,185900,189200,375100
510500,202104,239,179,60,196900,66000,262900
510510,202104,787,464,323,511500,355300,866800
510515,202104,1243,640,603,704000,663300,1367300
510517,202104,260,117,143,128700,158400,287100
510520,202104,221,147,74,161700,81400,243100
510523,202104,100,77,23,84700,25300,110000
510525,202104,816,489,327,539000,361900,900900
510530,202104,20,13,7,14300,7700,22000
510550,202104,241,111,130,122100,143000,265100
510558,202104,289,142,147,157300,161700,319000
510560,202104,409,239,170,262900,187000,449900
510562,202104,630,456,174,503800,191400,695200
510590,202104,736,380,356,419100,392700,811800
510600,202104,231,119,112,130900,123200,254100
510610,202104,220,92,128,101200,140800,242000
510615,202104,183,83,100,91300,110000,201300
510617,202104,21,10,11,11000,12100,23100
510618,202104,120,58,62,63800,68200,132000
510619,202104,93,65,28,71500,30800,102300
510620,202104,164,92,72,101200,79200,180400
510621,202104,177,114,63,125400,69300,194700
510622,202104,467,278,189,305800,209000,514800
510623,202104,311,211,100,233200,110000,343200
510624,202104,93,49,44,53900,49500,103400
510625,202104,518,323,195,355300,214500.63,569800.63
510626,202104,112,69,43,75900,47300,123200
510627,202104,80,56,24,61600,26400,88000
510628,202104,149,89,60,97900,67100,165000
510629,202104,273,164,109,180400,119919.8,300319.8
510630,202104,441,222,219,244200,243100,487300
510631,202104,14,4,10,4400,11000,15400
510637,202104,337,193,144,212300,158400,370700
510642,202104,1000,536,464,589600,510400,1100000
510645,202104,3,0,3,0,4400,4400
510650,202104,1357,887,470,976800,517000,1493800
510665,202104,83,36,47,39600,51700,91300
510670,202104,59,33,26,36300,28600,64900
510675,202104,1154,742,412,817300,453200,1270500
510677,202104,341,175,166,192500,182600,375100
510680,202104,102,58,44,63800,48400,112200
510682,202104,203,103,100,113300,110000,223300
510685,202104,54,41,13,45100,14300,59400
510700,202104,566,325,241,359700,267300,627000
510704,202104,1170,612,558,673200,613800,1287000
510706,202104,137,69,68,75900,74800,150700
510710,202104,392,281,111,309100,122100,431200
510715,202104,58,40,18,44000,19800,63800
510718,202104,218,110,108,121000,118800,239800
510719,202104,41,17,24,18700,26400,45100
510720,202104,187,132,55,145200,60500,205700
510724,202104,84,33,51,36300,56100,92400
510726,202104,54,28,26,30800,28600,59400
510729,202104,51,20,31,22000,35200,57200
510730,202104,472,260,212,286000,233200,519200
510735,202104,110,43,67,47300,73700,121000
510740,202104,22,12,10,13200,11000,24200
510757,202104,21,17,4,18700,4400,23100
510760,202104,7041,3590,3451,3951200,3803800,7755000
510770,202104,669,312,357,344300,392700,737000
510774,202104,16,5,11,5500,12100,17600
510775,202104,111,84,27,92400,29700,122100
510776,202104,32,12,20,13200,22000,35200
510777,202104,196,85,111,93500,122100,215600
510779,202104,34,18,16,19800,17600,37400
510780,202104,271,155,116,170500,127600,298100
510785,202104,377,203,174,223300,191400,414700
510787,202104,188,90,98,99000,107800,206800
510788,202104,6,1,5,1100,5500,6600
510790,202104,2488,1303,1185,1433351,1305700.57,2739051.57
510792,202104,1135,641,494,705100,544500.54,1249600.54
510794,202104,115,65,50,71500,55000,126500
510795,202104,2272,1321,951,1453100.11,1049400,2502500.11
510800,202104,179,110,69,121000,75900,196900
510805,202104,195,130,65,143000,71500,214500
510810,202104,98,43,55,47300,61600,108900
510820,202104,236,116,120,127600,134200.5,261800.5
510830,202104,72,41,31,45100,34100,79200
510835,202104,14,9,5,9900,5500,15400
510840,202104,9006,4221,4785,4644200.61,5266800,9911000.61
510850,202104,219,89,130,97900,146300,244200
510860,202104,368,166,202,183700,222200,405900
510880,202104,68,48,20,52800,22000,74800
510885,202104,67,38,29,41800,31900,73700
510890,202104,64,37,27,40700,29700,70400
510895,202104,171,101,70,111100,77000,188100
520005,202104,131,54,77,59400,84700,144100
520010,202104,288,130,158,143000,173800,316800
520013,202104,733,485,248,534600.64,273900,808500.64
520015,202104,51,37,14,40700,15400,56100
520017,202104,86,50,36,55000,40700,95700
520020,202104,17,10,7,11000,7700,18700
520025,202104,2422,1253,1169,1379400.17,1288100,2667500.17
520030,202104,812,429,383,472175,421300,893475
520050,202104,71,50,21,55000,23100,78100
520055,202104,56,35,21,38500,23100,61600
520060,202104,175,115,60,126500,66000,192500
520080,202104,582,424,158,466400,174900,641300
520082,202104,16,11,5,12100,5500,17600
520085,202104,87,65,22,71500,24200,95700
520090,202104,90,62,28,68200,30800,99000
520110,202104,9219,3953,5266,4359300,5800300,10159600
520120,202104,11,6,5,6600,5500,12100
520130,202104,801,562,239,619300,262900,882200
520140,202104,11859,6601,5258,7273676.66,5793700.4,13067377.06
520145,202104,53,32,21,35200,23100,58300
520150,202104,163,130,33,143000,36300,179300
520160,202104,40,29,11,31900,12100,44000
520170,202104,247,142,105,156200,115500,271700
520180,202104,173,80,93,88000,102300,190300
520215,202104,203,138,65,151800,71500,223300
520235,202104,80,63,17,69300,18700,88000
520250,202104,121,69,52,75900,57200,133100
520260,202104,115,74,41,81400,45100,126500
520280,202104,46,31,15,34100,16500,50600
520310,202104,40,27,13,29700,14300,44000
520320,202104,177,109,68,119900,74800,194700
520330,202104,798,431,367,474100,403700,877800
520340,202104,354,209,145,229900,159500,389400
520350,202104,506,238,268,261800,295900,557700
520355,202104,88,49,39,53900,42900,96800
520357,202104,27,20,7,22000,7700,29700
520360,202104,3,2,1,2200,1100,3300
520380,202104,134,74,60,81400,66000,147400
520390,202104,249,105,144,115500,158400,273900
520393,202104,16,11,5,12100,5500,17600
520396,202104,76,49,27,53900,29700,83600
520400,202104,192,116,76,127600,83600,211200
520410,202104,193,94,99,103400,108900,212300
520420,202104,22,14,8,15400,8800,24200
520425,202104,280,140,140,154000,154000,308000
520430,202104,498,244,254,269601.2,279400,549001.2
520440,202104,689,499,190,548900,210100,759000
520450,202104,1987,846,1141,930600,1257300,2187900
520455,202104,59,33,26,36300,28600,64900
520460,202104,37,23,14,25300,15400,40700
520465,202104,31,26,5,29700,5500,35200
520470,202104,434,279,155,306900,170500,477400
520480,202104,80,47,33,51700,36300,88000
520485,202104,108,40,68,44000,74800,118800
520490,202104,409,308,101,338800,113300,452100
520495,202104,162,96,66,105600,72600,178200
520500,202104,193,150,43,165000,47300,212300
520505,202104,188,109,79,119900,86900,206800
520510,202104,1813,865,948,952600,1043900,1996500
520520,202104,45,30,15,33000,16500,49500
520530,202104,214,167,47,183700,51700,235400
520540,202104,591,398,193,437800,212300,650100
520545,202104,131,77,54,84700,59400,144100
520547,202104,59,34,25,37400,27500,64900
520549,202104,1233,565,668,621500,735900,1357400
520551,202104,312,165,147,181500,161700,343200
520552,202104,35,24,11,26400,12100,38500
520570,202104,15,9,6,9900,6600,16500
520580,202104,276,173,103,190300,113300,303600
520590,202104,136,81,55,89100,60500,149600
520620,202104,1116,519,597,573100,656700,1229800
520630,202104,39,22,17,24200,18700,42900
520640,202104,380,222,158,244200,173800,418000
520650,202104,67,36,31,39600,34100,73700
520660,202104,45,24,21,26400,23100,49500
520670,202104,38,32,6,35200,6600,41800
520680,202104,42,27,15,29700,16500,46200
520690,202104,39,9,30,9900,33000,42900
520710,202104,31,28,3,30800,3300,34100
520725,202104,200,148,52,162800,57200,220000
520735,202104,56,35,21,38500,23100,61600
520740,202104,419,206,213,226600,234300,460900
520750,202104,35,24,11,26400,12100,38500
520753,202104,66,44,22,48400,24200,72600
520760,202104,103,69,34,75900,37400,113300
520780,202104,276,207,69,227700,75900,303600
520790,202104,159,92,67,102300,73700,176000
520800,202104,3415,1863,1552,2052600,1709400,3762000
520810,202104,148,115,33,126500,36300,162800
520815,202104,5,4,1,4400,1100,5500
520830,202104,145,99,46,108900,50600,159500
520840,202104,370,244,126,268400,138600,407000
520850,202104,96,56,40,63800,44000,107800
520860,202104,1748,1125,623,1237500,686400,1923900
520870,202104,31469,14664,16805,16149103.36,18500900,34650003.36
520880,202104,1156,618,538,679800,591800,1271600
520890,202104,785,479,306,526900,336600,863500
520910,202104,978,522,456,575300.4,501600,1076900.4
520915,202104,91,70,21,77000,23100,100100
520920,202104,439,205,234,225500,257400,482900
520929,202104,18,16,2,17600,2200,19800
520940,202104,69,49,20,53900,22000,75900
520945,202104,14,10,4,11000,4400,15400
520960,202104,43,27,16,29700,17600,47300
520970,202104,356,208,148,228800,162800,391600
520980,202104,95,69,26,75900,28600,104500
520990,202104,448,314,134,345400,147400,492800
520993,202104,126,60,66,66000,72600,138600
520995,202104,248,138,110,151800,121000,272800
521000,202104,1539,889,650,977900,717200,1695100
521010,202104,677,337,340,370700,374000,744700
521015,202104,15,10,5,11000,5500,16500
521020,202104,1414,1002,412,1102200,454300,1556500
521030,202104,57,36,21,40700,23100,63800
521040,202104,933,600,333,661100,366300,1027400
521056,202104,48,31,17,34100,18700,52800
521060,202104,127,82,45,90200,49500,139700
521080,202104,391,301,90,331100,99000,430100
521090,202104,546,354,192,389400,211200,600600
521100,202104,267,199,68,218900,74800,293700
521120,202104,1054,741,313,816200,344300,1160500
521130,202104,354,252,102,277200,112200,389400
521140,202104,178,98,80,108900,88000,196900
521150,202104,2602,1124,1478,1237500,1629100,2866600
521160,202104,26,12,14,13200,15400,28600
521170,202104,217,124,93,136400,102300,238700
521180,202104,1159,747,412,821700,453200,1274900
521190,202104,2480,1050,1430,1157200,1574100,2731300
521200,202104,55,41,14,45100,15400,60500
521205,202104,11,8,3,8800,3300,12100
521210,202104,118,71,47,78100,51700,129800
521220,202104,740,516,224,567600,246400,814000
521225,202104,30,21,9,23100,9900,33000
521230,202104,106,68,38,74800,41800,116600
521250,202104,6179,3496,2683,3846701.64,2954600,6801301.64
521260,202104,29,14,15,15400,16500,31900
521270,202104,139,106,33,116600,36300,152900
521280,202104,424,260,164,287100,180400,467500
521290,202104,26,16,10,17600,11000,28600
521295,202104,99,64,35,70400,38500,108900
521300,202104,222,124,98,136400,107800,244200
521305,202104,37,26,11,28600,12100,40700
521308,202104,1043,798,245,877800,269500,1147300
521310,202104,1319,758,561,834900,617100,1452000
521340,202104,17,14,3,15400,3300,18700
521350,202104,122,93,29,102300,31900,134200
521370,202104,175,126,49,138600,53900,192500
521375,202104,178,95,83,104500,91300,195800
521377,202104,49,38,11,41800,12100,53900
521380,202104,1051,661,390,727100,429000,1156100
521385,202104,13,8,5,8800,5500,14300
521390,202104,98,80,18,88000,19800,107800
521400,202104,346,230,116,253000,127600,380600
521405,202104,144,83,61,91300,67100,158400
521410,202104,68,48,20,52800,22000,74800
521440,202104,201,142,59,156200,64900,221100
521450,202104,750,413,337,455400,370700,826100
521460,202104,1125,723,402,797500,442200,1239700
521470,202104,11,8,3,8800,3300,12100
521480,202104,44,30,14,33000,15400,48400
521483,202104,317,197,120,216700,132000,348700
521486,202104,287,186,101,204600,111100,315700
521487,202104,22,10,12,11000,13200,24200
521490,202104,25,12,13,13200,14300,27500
521500,202104,129,71,58,79200,63800,143000
521520,202104,48,35,13,38500,14300,52800
521523,202104,778,460,318,508200,350900,859100
521525,202104,47,28,19,30800,20900,51700
521530,202104,240,131,109,144100,119900,264000
521540,202104,33,17,16,18700,17600,36300
521550,202104,91,39,52,42900,57200,100100
521560,202104,815,553,262,608300.25,288200,896500.25
521565,202104,62,44,18,48400,19800,68200
521570,202104,539,358,181,393800,199100,592900
521580,202104,57,32,25,35200,27500,62700
521590,202104,37,17,20,18700,22000,40700
521600,202104,22,11,11,12100,12100,24200
521630,202104,243,130,113,143000,124300,267300
521640,202104,297,161,136,177100,150700,327800
521645,202104,37,19,18,20900,19800,40700
521680,202104,245,152,93,167200,102300,269500
521690,202104,2,2,0,2200,0,2200
521710,202104,1126,538,588,591800,647900,1239700
521720,202104,554,386,168,425516.66,184800,610316.66
521730,202104,668,321,347,353100,381700,734800
521740,202104,887,383,504,421300,554400,975700
521760,202104,2043,1057,986,1162772.45,1089000,2251772.45
521770,202104,816,512,304,563200,334400,897600
521800,202104,1966,1273,693,1401400,762300,2163700
521805,202104,32,18,14,19800,16500,36300
521810,202104,88,54,34,59400,37400,96800
521830,202104,958,679,279,748000.73,306900,1054900.73
521839,202104,86,51,35,57200,38500,95700
521850,202104,1094,569,525,625900.17,577500,1203400.17
521860,202104,329,206,123,226600,135300,361900
521870,202104,68,41,27,45100,29700,74800
521878,202104,38,17,21,18700,23100,41800
521880,202104,4736,2111,2625,2324300,2888600,5212900
521890,202104,595,413,182,454300.3,200200,654500.3
521900,202104,285,231,54,254100,59400,313500
521910,202104,164,113,51,124300,56100,180400
521920,202104,44,22,22,24200,24200,48400
521925,202104,52,31,21,34100,23100,57200
521930,202104,1140,631,509,696300,561000,1257300
521935,202104,34,23,11,25300,12100,37400
521940,202104,199,95,104,104500,114400,218900
521945,202104,17,13,4,14300,4400,18700
521950,202104,9,5,4,5500,4400,9900
521960,202104,69,52,17,57200,18700,75900
521970,202104,409,261,148,287100,162800,449900
521971,202104,106,56,50,61600,55000,116600
521973,202104,33,18,15,19800,16500,36300
521975,202104,1495,753,742,830501.65,816200.18,1646701.83
521980,202104,242,168,74,184800,81400,266200
521990,202104,72,53,19,58300,22000,80300
522000,202104,295,189,106,207516.1,116600,324116.1
522005,202104,18,10,8,11000,8800,19800
522010,202104,1132,635,497,698500,546700,1245200
522015,202104,56,33,23,36300,25300,61600
522020,202104,893,519,374,572000,411400,983400
522026,202104,23,14,9,15400,9900,25300
522028,202104,15,11,4,12100,4400,16500
522040,202104,764,313,451,345400,496100,841500
522045,202104,2380,1455,925,1602700,1017500,2620200
522050,202104,157,77,80,84700,88000,172700
522060,202104,547,340,207,374000,228800,602800
522068,202104,106,74,32,81400,35200,116600
522070,202104,8,8,0,8800,0,8800
522100,202104,35,20,15,22000,16500,38500
522108,202104,43,31,12,34100,13200,47300
522119,202104,56,32,24,35200,26400,61600
522130,202104,78,29,49,31900,53900,85800
522140,202104,4003,2052,1951,2257200,2149400.38,4406600.38
522145,202104,48,34,14,37400,15400,52800
522150,202104,97,69,28,75900,30800,106700
522155,202104,51,37,14,41800,15400,57200
522157,202104,6,3,3,3300,3300,6600
522160,202104,1690,1002,688,1102200,756800,1859000
522170,202104,397,267,130,293700,143000,436700
522180,202104,36,17,19,18700,20900,39600
522185,202104,2110,856,1254,943800,1382700,2326500
522190,202104,50,26,24,28600,26400,55000
522200,202104,300,181,119,199100,130900,330000
522205,202104,143,95,48,104500,52800,157300
522220,202104,141,104,37,114400,40700,155100
522230,202104,28,22,6,24200,6600,30800
530010,202104,53989,27324,26665,30089733.68,29374577.3,59464310.98
110001,202105,500,405,95,445500,104500,550000
110002,202105,2837,1794,1043,1973400,1148400,3121800
110003,202105,79,65,14,71500,15400,86900
110004,202105,2018,1340,678,1475100.93,746900,2222000.93
110005,202105,428,343,85,377300,93500,470800
110006,202105,445,338,107,371800,117700,489500
110007,202105,68,57,11,62700,12100,74800
110008,202105,244,135,109,148500,121000,269500
110009,202105,907,669,238,735900,262900,998800
110010,202105,1662,1010,652,1112100,718300,1830400
110011,202105,1722,1338,384,1474000,422400,1896400
110012,202105,4053,2372,1681,2614700,1853500,4468200
110013,202105,757,604,153,664400,168300,832700
110014,202105,368,319,49,352366.66,53900,406266.66
110015,202105,1370,1097,273,1207800,300300,1508100
110018,202105,1071,662,409,728200,449900,1178100
110020,202105,15476,8861,6615,9759200.75,7282000,17041200.75
110025,202105,645,475,170,522500,187000,709500
110026,202105,36,25,11,27500,12100,39600
110028,202105,1598,1149,449,1263900,496100,1760000
110029,202105,138,124,14,136400,15400,151800
110030,202105,2381,1599,782,1758724.96,860200.85,2618925.81
110032,202105,316,242,74,267300,81400,348700
110033,202105,647,470,177,517000,195800,712800
110034,202105,330,244,86,269500.5,95700,365200.5
110037,202105,93,81,12,89100,13200,102300
110040,202105,381,258,123,283800,136400,420200
110045,202105,933,645,288,709500,316800,1026300
110050,202105,88,77,11,84700,12100,96800
110060,202105,67,40,27,44000,29700,73700
110070,202105,104,67,37,73700,40700,114400
110080,202105,489,273,216,303600,240900,544500
110090,202105,23,20,3,22000,3300,25300
110092,202105,108,58,50,63800,55000,118800
110094,202105,197,143,54,158400,59400,217800
110100,202105,43,29,14,31900,15400,47300
110110,202105,93,54,39,59400,42900,102300
110120,202105,69,61,8,67100,8800,75900
110130,202105,279,228,51,251900,56100,308000
110140,202105,242,171,71,188100,78100,266200
110143,202105,49,39,10,42900,11000,53900
110145,202105,32,25,7,27500,8800,36300
110146,202105,24,12,12,13200,13200,26400
110147,202105,36,24,12,26400,13200,39600
110148,202105,33,23,10,25300,11000,36300
110149,202105,313,223,90,247500,99000,346500
110150,202105,138,105,33,115500,36300,151800
110155,202105,10,10,0,11000,0,11000
110160,202105,66,52,14,57200,15400,72600
110170,202105,220,167,53,183700,58300,242000
110175,202105,66,50,16,55000,17600,72600
110180,202105,88,73,15,80300,16500,96800
120001,202105,196,145,51,159500,56100,215600
120005,202105,189,110,79,121000.41,86900,207900.41
120010,202105,1121,690,431,759000,474100,1233100
120013,202105,144,96,48,106700,52800,159500
120017,202105,108,60,48,66000,52800,118800
120020,202105,3490,2827,663,3111901.2,729300,3841201.2
120025,202105,535,303,232,333300.4,256300,589600.4
120030,202105,1054,911,143,1003200.7,157300,1160500.7
120032,202105,36,32,4,35200,4400,39600
120033,202105,214,190,24,209000,26400,235400
120034,202105,174,126,48,138600,52800,191400
120035,202105,36,29,7,31900,7700,39600
120038,202105,416,274,142,301400,156200,457600
120039,202105,29,28,1,30800,1100,31900
120040,202105,13880,9477,4403,10429464.15,4844400,15273864.15
120042,202105,40,35,5,38500,5500,44000
120043,202105,11,2,9,2200,9900,12100
120045,202105,526,336,190,369600,209000,578600
120050,202105,1276,974,302,1071401,332200,1403601
120060,202105,1463,1206,257,1326600,282700,1609300
120070,202105,414,300,114,330000.6,125400,455400.6
120080,202105,179,112,67,123200,73700,196900
130002,202105,162,116,46,127600,50600,178200
130006,202105,102,64,38,70400,41800,112200
130008,202105,130,71,59,78100,64900,143000
130010,202105,151,87,64,95700,70400,166100
130014,202105,274,198,76,217800,83600,301400
130020,202105,99,60,39,66000,42900,108900
130030,202105,958,563,395,619300,434500,1053800
130040,202105,340,168,172,184800,190300,375100
130050,202105,556,286,270,314600,297000,611600
130060,202105,827,564,263,620400,289300,909700
130063,202105,594,345,249,379500,273900,653400
130068,202105,189,116,73,127600,80300,207900
130070,202105,1354,920,434,1013100,477400,1490500
130080,202105,704,472,232,519200,256300,775500
130083,202105,69,38,31,41800,34100,75900
130090,202105,333,176,157,193600,172700,366300
130100,202105,1098,468,630,514800,693000,1207800
130110,202105,731,316,415,347600,456500,804100
130115,202105,155,68,87,74800,95700,170500
130120,202105,1617,1008,609,1108800,669900,1778700
130130,202105,622,419,203,460900,223300,684200
130140,202105,1575,1230,345,1353000,379500,1732500
130150,202105,411,364,47,400400,52800,453200
130160,202105,453,262,191,288200,210100,498300
130165,202105,43,33,10,36300,11000,47300
130170,202105,1014,709,305,779829.6,335500.9,1115330.5
130180,202105,241,179,62,196900,68200,265100
130185,202105,2193,1014,1179,1115400,1296900,2412300
130190,202105,3386,2133,1253,2348500,1378300,3726800
130195,202105,286,229,57,251900,62700,314600
130200,202105,180,86,94,94600,103400,198000
130210,202105,74,36,38,39600,41800,81400
130220,202105,176,120,56,133100,61600,194700
130230,202105,379,245,134,270600,147400,418000
130240,202105,1337,868,469,958100,518100,1476200
130250,202105,4658,2999,1659,3300000,1824900,5124900
130255,202105,424,205,219,225500,240900,466400
130260,202105,57080,26973,30107,29687810.95,33139931,62827741.95
130270,202105,1546,1052,494,1157299,543400,1700699
130280,202105,120,67,53,73700,58300,132000
130290,202105,2075,1425,650,1567500,715000,2282500
130300,202105,422,290,132,319000,145200,464200
130310,202105,918,492,426,541200,468600,1009800
130320,202105,528,277,251,304700,276100,580800
130330,202105,773,486,287,534600,315700,850300
130340,202105,3433,1945,1488,2140600,1637900,3778500
130350,202105,483,329,154,361900,169400,531300
130353,202105,927,408,519,449900,570900,1020800
130356,202105,795,350,445,386100,489500,875600
130360,202105,88,66,22,72600,24200,96800
130370,202105,688,531,157,585200,177100,762300
130380,202105,666,512,154,563200,169400,732600
130390,202105,471,382,89,420200,97900,518100
130395,202105,159,40,119,44000,132000,176000
130400,202105,69,47,22,51700,24200,75900
130406,202105,2056,1220,836,1342000,920700,2262700
130410,202105,445,219,226,240900,248600,489500
130420,202105,2872,2331,541,2565200,595100,3160300
130423,202105,156,79,77,86900,84700,171600
130426,202105,155,76,79,83600,86900,170500
130430,202105,415,252,163,277200,179300,456500
130440,202105,200,61,139,67100,152900,220000
140002,202105,18,6,12,6600,13200,19800
140005,202105,200,122,78,134200,85800,220000
140010,202105,11061,6945,4116,7651602.67,4533100,12184702.67
140015,202105,142,64,78,70400,85800,156200
140017,202105,124,74,50,81400,55000,136400
140020,202105,468,301,167,331100,183700,514800
140023,202105,36,17,19,18700,20900,39600
140028,202105,22,11,11,12100,12100,24200
140030,202105,353,242,111,267300,122100,389400
140040,202105,61,44,17,48400,18700,67100
140045,202105,265,102,163,112200,180400,292600
140047,202105,420,284,136,312400,151800,464200
140050,202105,138,84,54,92400,59400,151800
140060,202105,59,40,19,44000,20900,64900
140070,202105,30,28,2,30800,2200,33000
150010,202105,4802,2909,1893,3199900,2082300,5282200
150013,202105,163,116,47,127600,51700,179300
150020,202105,1109,602,507,662200,557700,1219900
150030,202105,709,314,395,345400.02,435600,781000.02
150034,202105,203,125,78,138600,85800,224400
150040,202105,1511,868,643,954800,707300,1662100
150050,202105,684,394,290,433400,320100,753500
150060,202105,4876,3064,1812,3371407,1993655.6,5365062.6
150070,202105,429,221,208,243100,229900,473000
150080,202105,15555,7381,8174,8127900,9006800,17134700
150085,202105,435,273,162,300300,178200,478500
150090,202105,701,593,108,652300,118800,771100
150095,202105,370,234,136,257400,149600,407000
150100,202105,63,42,21,46200,23100,69300
150110,202105,202,107,95,118800,104500,223300
150120,202105,392,283,109,311300,119900,431200
150125,202105,48,17,31,18700,34100,52800
150130,202105,2065,1078,987,1188000,1086800,2274800
150140,202105,55904,25130,30774,27688101.88,33936100.7,61624202.58
150145,202105,233,131,102,144100,112200,256300
150150,202105,3083,1348,1735,1483900,1908500,3392400
150157,202105,381,265,116,291500,127600,419100
150160,202105,131,101,30,111100,33000,144100
150170,202105,3696,2735,961,3008500,1058200,4066700
150172,202105,344,242,102,267300,112200,379500
150175,202105,81,48,33,52800,36300,89100
150178,202105,756,502,254,552200,279400,831600
150180,202105,3180,1549,1631,1705000,1796300,3501300
150190,202105,354,223,131,245300,144100,389400
150195,202105,112,56,56,61600,61600,123200
150200,202105,197,93,104,102300,114400,216700
150210,202105,3163,2521,642,2773100,706200,3479300
150215,202105,571,356,215,391600,236500,628100
150220,202105,3575,2385,1190,2626800.82,1309000,3935800.82
150230,202105,1239,989,250,1089000.5,275000,1364000.5
150240,202105,6507,3681,2826,4051300.6,3111900,7163200.6
150250,202105,57,31,26,34100,28600,62700
150260,202105,93,62,31,68200,34100,102300
150270,202105,2210,1431,779,1575200,856900,2432100
150275,202105,532,337,195,370700,214500,585200
150276,202105,109,41,68,45100,74800,119900
150277,202105,807,359,448,394900,492800,887700
150280,202105,366,243,123,267300,135300,402600
150285,202105,116,58,58,63800,63624,127424
150290,202105,1141,665,476,732600,524700,1257300
150293,202105,715,332,383,365200,421300,786500
150295,202105,516,237,279,260700,306900,567600
150300,202105,83,39,44,42900,48400,91300
150304,202105,181,107,74,117700,81400,199100
150307,202105,407,335,72,368500,79200,447700
150309,202105,571,407,164,447700,180400.48,628100.48
150310,202105,248,160,88,176000,96800,272800
150320,202105,1884,1318,566,1449800,622600,2072400
150330,202105,2040,1183,857,1301300,942700,2244000
150340,202105,190,126,64,138600,70400,209000
150345,202105,639,355,284,390500,312400,702900
150350,202105,403,318,85,349800,93500,443300
150360,202105,4690,2891,1799,3181200,1982200,5163400
150370,202105,831,573,258,630300,283800,914100
150375,202105,199,92,107,101200,117700,218900
150380,202105,1506,999,507,1098900,558800,1657700
150390,202105,814,474,340,521400,374000,895400
150400,202105,111,91,20,100100,22000,122100
150405,202105,1236,784,452,862400,498300,1360700
150410,202105,117,74,43,81400,47300,128700
150420,202105,7477,4051,3426,4459580,3769700,8229280
150430,202105,626,390,236,429000,259600,688600
150440,202105,449,281,168,309100,184800,493900
150442,202105,2341,1253,1088,1379400,1199000,2578400
150445,202105,554,360,194,396000,213400,609400
150450,202105,228,122,106,134200,116600,250800
150460,202105,729,543,186,597300,204600,801900
150470,202105,1283,772,511,849200,563200,1412400
150475,202105,243,184,59,202400,64900,267300
150480,202105,1315,913,402,1005400,442200,1447600
150490,202105,656,391,265,430100,291500,721600
150495,202105,339,250,89,275000,97900,372900
150497,202105,283,194,89,213400,97900,311300
150500,202105,234,139,95,152900,104500,257400
150503,202105,1081,549,532,605000,585200,1190200
150506,202105,923,622,301,684200,331100,1015300
150510,202105,1291,701,590,771100,649000,1420100
150520,202105,298,200,98,220000,107800,327800
150530,202105,1737,951,786,1046100,865700,1911800
150540,202105,200,147,53,161700,58300,220000
150543,202105,821,421,400,463100,441100,904200
150548,202105,470,337,133,370700,146300,517000
150549,202105,62,43,19,47300,20900,68200
150550,202105,2976,1509,1467,1659900,1613700,3273600
150553,202105,3386,1909,1477,2104300,1628000,3732300
150555,202105,147,79,68,86900,74800,161700
150560,202105,36,15,21,16500,23100,39600
150563,202105,119,57,62,62700,68200,130900
150565,202105,194,118,76,129800,83600,213400
150570,202105,428,284,144,312400,158400,470800
150580,202105,1687,810,877,892100,965800,1857900
150590,202105,814,535,279,588500,306900,895400
150600,202105,485,291,194,320100,213400,533500
150610,202105,150,119,31,130900,34100,165000
150611,202105,123,81,42,89100,46200,135300
150613,202105,3266,1891,1375,2081200,1514700,3595900
150616,202105,547,306,241,336600,266200,602800
150618,202105,1356,708,648,779900,712800,1492700
150619,202105,399,303,96,333300,105600,438900
150620,202105,1254,725,529,797500,583000,1380500
150630,202105,326,208,118,229900,129800,359700
150635,202105,455,189,266,207900,292600,500500
150640,202105,46,23,23,25300,25300,50600
150650,202105,2393,1392,1001,1532300,1101100,2633400
150655,202105,242,180,62,198000,68200,266200
150658,202105,86,53,33,58300,36300,94600
150660,202105,546,353,193,388300,212300,600600
150670,202105,1108,387,721,425700,793100,1218800
150680,202105,10322,5424,4898,5966400.57,5390000,11356400.57
150690,202105,22,11,11,12100,12100,24200
150700,202105,491,320,171,352000,188100,540100
150710,202105,291,168,123,184800,137500,322300
150715,202105,845,528,317,581900,348700,930600
150720,202105,420,321,99,353100,108900,462000
150730,202105,1050,518,532,570900,586300,1157200
150740,202105,228,150,78,165000,85800,250800
150745,202105,749,415,334,457600,368500,826100
150746,202105,64,37,27,40700,29700,70400
150747,202105,225,170,55,187000,60500,247500
150750,202105,140,77,63,84700,69300,154000
150760,202105,1813,1184,629,1303500.5,691900,1995400.5
150770,202105,388,217,171,238700,188100,426800
150775,202105,108,50,58,55000,63800,118800
150780,202105,197,108,89,119900,97900,217800
150790,202105,894,510,384,561000,422400,983400
150795,202105,1557,936,621,1030700,684200,1714900
150796,202105,348,198,150,217800,166100,383900
150797,202105,353,167,186,183700,204600,388300
150800,202105,1527,873,654,961400,719400,1680800
150803,202105,533,428,105,470800,115500,586300
150805,202105,209,125,84,137500,92400,229900
150808,202105,1001,531,470,584100,517000,1101100
150810,202105,3256,2207,1049,2428800.5,1153900,3582700.5
150812,202105,464,238,226,261800,248600,510400
150815,202105,1090,675,415,743600,457600,1201200
150820,202105,1538,926,612,1018600,673200,1691800
150830,202105,708,518,190,569800,209000,778800
150835,202105,208,124,84,136400,92400,228800
150840,202105,1378,837,541,920700,596200,1516900
160005,202105,61,43,18,47300.06,19800.04,67100.10
160010,202105,191,122,69,134200.1,75900.06,210100.16
160015,202105,133,80,53,88000.1,58300.04,146300.14
160020,202105,138,74,64,81400.04,71500,152900.04
160021,202105,63,30,33,33000.04,36300.04,69300.08
160023,202105,65,41,24,45100.06,26400.04,71500.10
160025,202105,27,12,15,13200.02,16500.02,29700.04
160027,202105,1459,835,624,918501.74,686400.82,1604902.56
160030,202105,16160,8337,7823,9172912.58,8611908.22,17784820.80
160040,202105,300,175,125,192500.12,138600.02,331100.14
160050,202105,721,359,362,394900.16,399300.04,794200.20
160053,202105,285,173,112,190300.14,123200.1,313500.24
160055,202105,25,16,9,17600.02,9900,27500.02
160060,202105,6608,3512,3096,3864308.85,3405605.58,7269914.43
160070,202105,185,109,76,119900.02,83600.04,203500.06
160080,202105,114,56,58,61600,63800,125400
170025,202105,30,15,15,16500,16500,33000
170030,202105,193,158,35,174900.03,38500,213400.03
170035,202105,209,99,110,108900,121000,229900
170040,202105,177,130,47,143000,51700,194700
170070,202105,317,196,121,215600,133100,348700
170100,202105,345,253,92,278300,101200,379500
170105,202105,57,46,11,50600,12100,62700
170110,202105,116,70,46,77000,50600,127600
170130,202105,71,34,37,37400,40700,78100
170190,202105,94,57,37,62700,40700,103400
170200,202105,361,250,111,275000,122100,397100
170210,202105,6194,3259,2935,3584634.25,3231800.8,6816435.05
170215,202105,111,50,61,55000,67100,122100
170220,202105,1375,1007,368,1108800,404800,1513600
170230,202105,145,97,48,107800,52800,160600
170240,202105,516,344,172,380600,189200,569800
170255,202105,1066,871,195,958100,214500,1172600
170270,202105,45,31,14,34100,15400,49500
170290,202105,118,77,41,84700,45100,129800
170300,202105,100,62,38,68200,41800,110000
170305,202105,48,36,12,39600,13200,52800
170307,202105,60,46,14,50600,15400,66000
170310,202105,121,65,56,71500,62700,134200
170320,202105,26,16,10,17600,11000,28600
170330,202105,27,23,4,25300,4400,29700
170360,202105,32,19,13,20900,14300,35200
170370,202105,98,48,50,52800,55000,107800
170380,202105,76,56,20,61600,22000,83600
170382,202105,43,36,7,39600,7700,47300
170384,202105,144,111,33,122100,36300,158400
170386,202105,67,27,40,29700,44000,73700
170388,202105,46,18,28,19800,30800,50600
170389,202105,25,21,4,23100,4400,27500
170390,202105,74,42,32,46200,35200,81400
170410,202105,24,22,2,24200,2200,26400
170460,202105,15,10,5,11000,5500,16500
170510,202105,34,27,7,29700,7700,37400
170550,202105,1548,893,655,982300,721600,1703900
170555,202105,109,78,31,86900,34100,121000
170560,202105,104,73,31,80300,34100,114400
170600,202105,40,15,25,16500,27500,44000
170610,202105,197,100,97,111100,106700,217800
170625,202105,37,23,14,25300,16500,41800
170650,202105,84,61,23,67100,25300,92400
170700,202105,583,432,151,475200,166100,641300
170710,202105,157,98,59,107800,64900,172700
170720,202105,93,72,21,79200,23100,102300
170730,202105,89,54,35,59400,38500,97900
170740,202105,87,61,26,67100,28600,95700
170755,202105,56,30,26,33000,28600,61600
170765,202105,136,72,64,79200,70400,149600
170770,202105,196,126,70,138600,77000,215600
170820,202105,609,404,205,444400,226600,671000
170825,202105,40,20,20,22000,22000,44000
170830,202105,87,68,19,74800,20900,95700
170900,202105,174,133,41,146300,45100,191400
170930,202105,913,493,420,542300,464200,1006500
170950,202105,3129,1441,1688,1585100,1859000.4,3444100.4
170980,202105,18,11,7,12100,7700,19800
171050,202105,149,115,34,126500,37400,163900
171070,202105,47,40,7,44000,8800,52800
171090,202105,48,35,13,38500,14300,52800
171110,202105,23,17,6,18700,6600,25300
171150,202105,41,21,20,23100,22000,45100
171180,202105,28,14,14,15400,15400,30800
171190,202105,160,94,66,103400,72600,176000
171195,202105,61,50,11,55000,12100,67100
171200,202105,47,21,26,23100,28600,51700
171215,202105,5,4,1,4400,1100,5500
171240,202105,59,42,17,47300,18700,66000
171245,202105,59,51,8,56100,8800,64900
171250,202105,73,41,32,45100,35200,80300
171270,202105,14,10,4,11000,4400,15400
171280,202105,41,36,5,39600,5500,45100
171320,202105,1008,571,437,630300,480700,1111000
171330,202105,424,216,208,238700,229900,468600
171360,202105,93,63,30,69300,33000,102300
171370,202105,34,16,18,17600,19800,37400
171380,202105,132,114,18,125400,19800,145200
171395,202105,48,28,20,31900,22000,53900
171420,202105,266,172,94,189200,103400,292600
171430,202105,73,58,15,63800,16500,80300
171488,202105,188,102,86,112200,94600,206800
171500,202105,62,34,28,37400,30800,68200
171510,202105,70,46,24,50600,26400,77000
171515,202105,41,33,8,36300,8800,45100
171525,202105,29,27,2,29700,2200,31900
171550,202105,15,9,6,9900,6600,16500
171570,202105,49,25,24,27500,26400,53900
171575,202105,293,193,100,212300,110000,322300
171610,202105,1726,876,850,964700,935000,1899700
171620,202105,140,96,44,105600,49500,155100
171630,202105,54,29,25,31900,27500,59400
171650,202105,315,223,92,245300,101200,346500
171660,202105,259,148,111,162800,122100,284900
171665,202105,68,43,25,47300,27500,74800
171670,202105,426,258,168,283800,185900,469700
171700,202105,64,56,8,61600,8800,70400
171720,202105,29,11,18,12100,19800,31900
171750,202105,103,54,49,59400,53900,113300
171780,202105,73,57,16,62700,17600,80300
171790,202105,84,69,15,75900,16500,92400
171800,202105,32,24,8,26400,8800,35200
171820,202105,2077,1200,877,1321100.7,966900,2288000.7
171830,202105,34,26,8,28600,8800,37400
171840,202105,64,40,24,44000,26400,70400
171845,202105,29,19,10,20900,11000,31900
171850,202105,38,31,7,34100,7700,41800
171855,202105,77,61,16,67100,17600,84700
171865,202105,6,5,1,5500,1100,6600
171870,202105,31,20,11,23100,12100,35200
171875,202105,78,56,22,61600,24200,85800
171880,202105,36,23,13,25300,14300,39600
171884,202105,50,28,22,30800,24200,55000
171886,202105,128,55,73,60500,80300,140800
171888,202105,25,19,6,20900,6600,27500
171889,202105,12,6,6,6600,6600,13200
171890,202105,56,46,10,50600,11000,61600
171900,202105,32,22,10,25300,11000,36300
172000,202105,38,31,7,34100,8800,42900
172010,202105,53,44,9,48400,9900,58300
172015,202105,23,16,7,17600,7700,25300
172020,202105,143,91,52,100100,57200,157300
172025,202105,40,26,14,28600,15400,44000
172030,202105,44,24,20,26400,22000,48400
172049,202105,84,55,29,60500,31900,92400
172065,202105,128,84,44,93500,48400,141900
172080,202105,107,67,40,73700,44000,117700
172085,202105,28,14,14,15400,15400,30800
172090,202105,431,323,108,355300.56,118800,474100.56
172093,202105,15,13,2,14300,2200,16500
172097,202105,18,11,7,12100,7700,19800
172100,202105,5222,2959,2263,3262600,2492600,5755200
172110,202105,78,50,28,55000,30800,85800
172120,202105,1675,1408,267,1549900,293700,1843600
172125,202105,11,10,1,11000,1100,12100
172130,202105,24,14,10,15400,11000,26400
172208,202105,205,122,83,134200,91300,225500
172210,202105,367,178,189,195800,207900,403700
210005,202105,2947,1849,1098,2037200.32,1207800,3245000.32
210010,202105,154,89,65,97900,71500,169400
210015,202105,39,29,10,31900,11000,42900
210020,202105,365,206,159,226600,174900,401500
210030,202105,323,216,107,237600,117700,355300
210040,202105,137,109,28,119900,30800,150700
210043,202105,254,195,59,214500,64900,279400
210047,202105,525,317,208,348700,228800,577500
210050,202105,282,210,72,231000,79200,310200
210055,202105,53,43,10,47300,11000,58300
210060,202105,538,436,102,479600,112200,591800
210070,202105,427,327,100,359700,110000,469700
210080,202105,130,119,11,130900,12100,143000
210083,202105,290,141,149,155100,163900,319000
210087,202105,2,1,1,1100,1100,2200
210090,202105,439,313,126,344300,138600,482900
210095,202105,427,327,100,359700,110000,469700
210100,202105,701,552,149,607200,163900,771100
210110,202105,120,78,42,85800,46200,132000
210120,202105,4946,3888,1058,4276800,1163800.5,5440600.5
210125,202105,186,114,72,125400,81400,206800
210130,202105,464,267,197,293700,216700,510400
210135,202105,28,21,7,23100,7700,30800
210140,202105,4414,3441,973,3788400,1071400,4859800
210150,202105,373,237,136,260700,149600,410300
210160,202105,3276,2793,483,3072300.54,531300,3603600.54
210170,202105,1175,946,229,1040600,253000,1293600
210173,202105,125,109,16,119900,17600,137500
210177,202105,348,199,149,218900,163900,382800
210180,202105,29,16,13,17600,14300,31900
210190,202105,426,284,142,312400,157300,469700
210193,202105,4,3,1,3300,1100,4400
210197,202105,76,54,22,59400,24200,83600
210200,202105,615,518,97,570900,106700,677600
210203,202105,215,148,67,162800,73700,236500
210207,202105,358,296,62,325600,68200,393800
210210,202105,737,682,55,750200,60500,810700
210215,202105,74,65,9,71500,11000,82500
210220,202105,379,320,59,353100,64900,418000
210230,202105,313,250,63,275000,69300,344300
210232,202105,1328,915,413,1006500,454300,1460800
210235,202105,174,133,41,146300,45100,191400
210237,202105,34,21,13,23100,14300,37400
210240,202105,92,76,16,83600,17600,101200
210250,202105,179,153,26,168300,28600,196900
210255,202105,356,271,85,298100,93500,391600
210260,202105,393,272,121,299200,133100,432300
210270,202105,640,431,209,474100,231000,705100
210275,202105,80,62,18,68200,19800,88000
210280,202105,1041,693,348,762300,382800,1145100
210290,202105,540,366,174,402600,191400,594000
210300,202105,5233,3326,1907,3659700.98,2098800,5758500.98
210310,202105,108,76,32,83600,35200,118800
210312,202105,116,81,35,89100,38500,127600
210315,202105,104,87,17,95700,18700,114400
210317,202105,138,104,34,114400,37400,151800
210320,202105,2307,1975,332,2172500,365200,2537700
210325,202105,144,90,54,99000,59400,158400
210330,202105,4487,2592,1895,2852300,2085600,4937900
210340,202105,1225,925,300,1017500,331100,1348600
210350,202105,649,542,107,596200,117700,713900
210355,202105,148,126,22,138600,24200,162800
210360,202105,2180,1525,655,1677500,720500,2398000
210370,202105,1230,611,619,672100,680900,1353000
210375,202105,192,98,94,107800,103400,211200
210380,202105,714,553,161,608300,177100,785400
210390,202105,194,167,27,183700,29700,213400
210400,202105,389,337,52,370700,57200,427900
210405,202105,986,701,285,771100,313500,1084600
210407,202105,59,47,12,51700,13200,64900
210408,202105,61,54,7,59400,7700,67100
210409,202105,326,287,39,315700,42900,358600
210410,202105,446,350,96,385000,105600,490600
210420,202105,200,166,34,182600,37400,220000
210430,202105,49,36,13,39600,14300,53900
210440,202105,377,256,121,281600,133100,414700
210450,202105,99,83,16,91300,17600,108900
210455,202105,235,127,108,139700,119900,259600
210460,202105,302,206,96,226600,105600,332200
210462,202105,70,57,13,62700,14300,77000
210465,202105,141,111,30,122100,33000,155100
210467,202105,519,381,138,419100,151800,570900
210470,202105,48,41,7,45100,7700,52800
210480,202105,1284,928,356,1020800,391600.5,1412400.5
210490,202105,195,131,64,144100,70400,214500
210500,202105,507,311,196,342100,215600,557700
210510,202105,542,437,105,480700,115500,596200
210515,202105,357,226,131,248600,144100,392700
210520,202105,397,359,38,394900,41800,436700
210530,202105,9319,4886,4433,5385600.48,4890600.83,10276201.31
210535,202105,132,99,33,108900,36300,145200
210540,202105,1517,1013,504,1114300,554400,1668700
210542,202105,1138,581,557,639100,613800,1252900
210545,202105,23,21,2,23100,2200,25300
210547,202105,128,114,14,125400,15400,140800
210550,202105,644,467,177,513700,195800,709500
210560,202105,155,136,19,149600,20900,170500
210565,202105,21,15,6,16500,6600,23100
210570,202105,1286,1051,235,1156100.59,258500,1414600.59
210580,202105,119,101,18,111100,19800,130900
210590,202105,729,608,121,668800,133100,801900
210592,202105,38,36,2,39600,2200,41800
210594,202105,112,95,17,104500,18700,123200
210596,202105,107,93,14,102300,15400,117700
210598,202105,138,104,34,115500,37400,152900
210600,202105,315,274,41,301400,45100,346500
210610,202105,254,239,15,262900,16500,279400
210620,202105,42,27,15,29700,16500,46200
210630,202105,75,72,3,79200,3300,82500
210632,202105,1020,726,294,798600,323400,1122000
210635,202105,22,19,3,20900,3300,24200
210637,202105,124,91,33,100100,36300,136400
210640,202105,578,511,67,562100,73700,635800
210650,202105,396,332,64,365200,70400,435600
210660,202105,370,291,79,320100,86900,407000
210663,202105,47,32,15,35200,16500,51700
210667,202105,99,40,59,44000,64900,108900
210670,202105,249,222,27,244200,29700,273900
210675,202105,522,288,234,316800,257400,574200
210680,202105,226,146,80,160600,88000,248600
210690,202105,615,510,105,561000,115500,676500
210700,202105,154,118,36,129800,39600,169400
210710,202105,235,150,85,165000,93500,258500
210720,202105,128,115,13,126500,14300,140800
210725,202105,62,54,8,59400,8800,68200
210730,202105,24,18,6,19800,6600,26400
210735,202105,293,213,80,234300,88000,322300
210740,202105,517,445,72,489500,79200,568700
210745,202105,153,114,39,125400,42900,168300
210750,202105,2433,1245,1188,1371700,1306800,2678500
210760,202105,254,197,57,216700,62700,279400
210770,202105,246,200,46,220000,50600,270600
210780,202105,432,327,105,359700,115500,475200
210790,202105,182,150,32,165000,35200,200200
210800,202105,174,133,41,146300,45100,191400
210805,202105,56,50,6,55000,6600,61600
210810,202105,466,381,85,419100,93500,512600
210820,202105,2093,1746,347,1920600,382800,2303400
210825,202105,154,88,66,96800,72600,169400
210830,202105,721,482,239,530200,262900,793100
210840,202105,191,135,56,148500,61600,210100
210845,202105,233,166,67,182600,73700,256300
210850,202105,747,512,235,563200,258500,821700
210860,202105,3537,2047,1490,2251700,1639000,3890700
210870,202105,431,340,91,374000,100100,474100
210880,202105,73,57,16,62700,17600,80300
210890,202105,318,277,41,304700,45100,349800
210900,202105,623,407,216,447700,237600,685300
210905,202105,63,35,28,38500,30800,69300
210910,202105,1939,1471,468,1618100.7,515900,2134000.7
210920,202105,153,62,91,68200,100100,168300
210923,202105,82,67,15,73700,16500,90200
210927,202105,412,199,213,218900,234300,453200
210930,202105,68,55,13,60500,14300,74800
210940,202105,84,66,18,72600,19800,92400
210945,202105,199,110,89,121000,97900,218900
210950,202105,526,385,141,423500,155100,578600
210955,202105,81,51,30,56100,33000,89100
210960,202105,2196,1123,1073,1235300,1180300,2415600
210970,202105,116,102,14,112200,15400,127600
210975,202105,82,76,6,83600,6600,90200
210980,202105,1072,527,545,579700,599500,1179200
210990,202105,3969,2652,1317,2918300,1450900,4369200
211000,202105,1310,1064,246,1171500,270600,1442100
211003,202105,971,702,269,772200,295900,1068100
211010,202105,478,427,51,470800,56100,526900
211020,202105,1390,605,785,665500,864600,1530100
211023,202105,38,34,4,37400,4400,41800
211027,202105,74,54,20,59400,22000,81400
211030,202105,370,264,106,290400,116600,407000
211040,202105,296,249,47,275000,51700,326700
211050,202105,1144,767,377,843700,414700,1258400
211060,202105,637,559,78,614900,85800.49,700700.49
211065,202105,22,19,3,20900,3300,24200
211070,202105,884,741,143,815100,157300,972400
211080,202105,86,84,2,92400,2200,94600
211085,202105,49,27,22,29700,24200,53900
211090,202105,73,62,11,68200,12100,80300
211100,202105,470,392,78,431200,85800,517000
211102,202105,239,171,68,188100,74800,262900
211105,202105,223,155,68,170500,74800,245300
211107,202105,125,79,46,86900,50600,137500
211110,202105,934,626,308,689700,338800,1028500
211120,202105,5211,2617,2594,2878700,2855600,5734300
211125,202105,31,21,10,23100,11000,34100
211130,202105,41108,19021,22087,20933000,24313300,45246300
211140,202105,393,344,49,378400,53900,432300
211150,202105,1175,813,362,894300,398200,1292500
211153,202105,168,105,63,115500,69300,184800
211157,202105,66,53,13,58300,14300,72600
211160,202105,686,589,97,647900,106700,754600
211163,202105,2,2,0,2200,0,2200
211167,202105,10,9,1,9900,1100,11000
211170,202105,417,309,108,339900,118800,458700
211172,202105,113,78,35,85800,38500,124300
211174,202105,253,160,93,176000,102300,278300
211176,202105,466,347,119,381700,130900,512600
211178,202105,88,59,29,64900,31900,96800
211180,202105,212,171,41,188100,45100,233200
211190,202105,73,66,7,72600,7700,80300
211195,202105,35,22,13,24200,14300,38500
211200,202105,152,132,20,145200,22000,167200
211210,202105,419,309,110,341000,121000,462000
211220,202105,4158,2483,1675,2731300.5,1846900,4578200.5
211223,202105,91,88,3,96800,3300,100100
211227,202105,63,49,14,53900,15400,69300
211230,202105,728,601,127,662200,139700,801900
211240,202105,396,315,81,346500,89100,435600
211245,202105,179,91,88,100100,96800,196900
211250,202105,1532,1328,204,1460800,224400,1685200
211260,202105,795,663,132,730400,145200,875600
211270,202105,1935,1593,342,1753400,376200,2129600
211280,202105,1762,1139,623,1252900,685300,1938200
211285,202105,202,126,76,139700,83600,223300
211290,202105,717,512,205,563200,225500,788700
211300,202105,751,599,152,658900,167200,826100
211400,202105,1532,940,592,1034000,651200,1685200
220005,202105,16,15,1,16500,1100,17600
220010,202105,86,69,17,75900,18700,94600
220020,202105,688,551,137,606100,150700,756800
220025,202105,106,103,3,113300,3300,116600
220027,202105,48,39,9,42900,9900,52800
220030,202105,114,91,23,100100,25300,125400
220040,202105,1247,953,294,1049400,324500,1373900
220045,202105,32,21,11,23100,12100,35200
220050,202105,699,583,116,642400.8,127600,770000.8
220060,202105,173,151,22,166100,24200,190300
220070,202105,111,100,11,110000,12100,122100
220080,202105,15,13,2,14300,2200,16500
220090,202105,34,27,7,29700,7700,37400
220095,202105,2,1,1,1100,1100,2200
220100,202105,19,16,3,17600,3300,20900
220105,202105,27,25,2,27500,2200,29700
220110,202105,230,209,21,229900,23100,253000
220115,202105,36,35,1,38500,1100,39600
220117,202105,21,20,1,22000,1100,23100
220120,202105,1465,1120,345,1232000,379500,1611500
220130,202105,30,29,1,31900,1100,33000
220140,202105,99,79,20,86900,22000,108900
220150,202105,493,370,123,407000,136400,543400
220155,202105,11,10,1,11000,1100,12100
220157,202105,20,16,4,17600,4400,22000
220160,202105,91,80,11,88000,12100,100100
220170,202105,35,32,3,35200,3300,38500
220173,202105,8,8,0,8800,0,8800
220177,202105,11,10,1,11000,1100,12100
220180,202105,67,65,2,71500,2200,73700
220190,202105,1075,945,130,1040600,143000,1183600
220191,202105,42,35,7,38500,7700,46200
220192,202105,87,83,4,91300,4400,95700
220194,202105,60,55,5,60500,5500,66000
220196,202105,98,83,15,91300,16500,107800
220198,202105,4,2,2,2200,2200,4400
220200,202105,412,346,66,380600,72600,453200
220202,202105,37,32,5,35200,5500,40700
220205,202105,57,49,8,53900,8800,62700
220207,202105,13,13,0,14300,0,14300
220208,202105,74,42,32,46200,35200,81400
220209,202105,30,25,5,27500,5500,33000
220210,202105,22,15,7,16500,7700,24200
220211,202105,27,25,2,27500,2200,29700
220213,202105,39,35,4,38500,4400,42900
220217,202105,40,31,9,34100,9900,44000
220220,202105,2201,1453,748,1601600,822800,2424400
220225,202105,8,3,5,3300,5500,8800
220230,202105,959,735,224,809600,246400,1056000
220240,202105,162,144,18,158400,19800,178200
220245,202105,34,31,3,34100.18,3300,37400.18
220250,202105,125,107,18,117700,19800,137500
220253,202105,47,40,7,44000,7700,51700
220255,202105,39,33,6,36300,6600,42900
220260,202105,710,534,176,587400,193600,781000
220265,202105,8,6,2,6600,2200,8800
220270,202105,773,698,75,768900,82500,851400
220271,202105,44,36,8,39600,8800,48400
220272,202105,23,23,0,25300,0,25300
220273,202105,17,15,2,16500,2200,18700
220275,202105,57,47,10,51700,11000,62700
220277,202105,21,15,6,16500,6600,23100
220280,202105,16,11,5,12100,5500,17600
220285,202105,41,38,3,41800,3300,45100
220290,202105,1478,1271,207,1398100,227700,1625800
220300,202105,34,33,1,36300,1100,37400
220310,202105,328,280,48,308000,52800,360800
220320,202105,441,408,33,449900,36300,486200
220323,202105,1,0,1,0,1100,1100
220325,202105,10,9,1,9900,1100,11000
220327,202105,10,10,0,11000,0,11000
220330,202105,235,172,63,189200,69300,258500
220335,202105,142,124,18,136400,19800,156200
220340,202105,41,29,12,31900,13200,45100
220342,202105,57,49,8,53900,8800,62700
220345,202105,79,71,8,78100,8800,86900
220350,202105,441,380,61,418000,67100,485100
220360,202105,39,29,10,31900,11000,42900
220370,202105,1247,1029,218,1131900,239800,1371700
220375,202105,19,17,2,18700,2200,20900
220380,202105,23,17,6,18700,6600,25300
220385,202105,14,13,1,14300,1100,15400
220390,202105,2297,1296,1001,1426700,1101100,2527800
220400,202105,36,32,4,35200,4400,39600
220410,202105,21,19,2,20900,2200,23100
220415,202105,13,11,2,12100,2200,14300
220420,202105,127,106,21,116600,23100,139700
220430,202105,128,114,14,125400,15400,140800
220435,202105,24,17,7,18700,7700,26400
220440,202105,287,244,43,268400,47300,315700
220450,202105,339,172,167,189200,183700,372900
220455,202105,51,50,1,55000,1100,56100
220460,202105,18,17,1,18700,1100,19800
220465,202105,87,56,31,61600,34100,95700
220470,202105,247,213,34,234300,37400,271700
220480,202105,72,65,7,71500,7700,79200
220490,202105,86,74,12,81400,13200,94600
220500,202105,107,92,15,101200,16500,117700
220510,202105,406,315,91,346500,100100,446600
220515,202105,20,18,2,19800,2200,22000
220520,202105,372,331,41,364100,45100,409200
220525,202105,9,6,3,6600,3300,9900
220527,202105,17,14,3,15400,3300,18700
220530,202105,35,14,21,15400,23100,38500
220535,202105,6,5,1,5500,1100,6600
220540,202105,73,61,12,67100,13200,80300
220545,202105,38,26,12,28600,13200,41800
220550,202105,714,566,148,622600.73,162800,785400.73
220551,202105,17,13,4,14300,4400,18700
220552,202105,15,15,0,16500,0,16500
220553,202105,56,51,5,56100,5500,61600
220554,202105,12,9,3,9900,3300,13200
220555,202105,35,30,5,33000,5500,38500
220556,202105,40,37,3,40700,3300,44000
220557,202105,56,52,4,57200,4400,61600
220558,202105,7,3,4,3300,4400,7700
220559,202105,3,3,0,3300,0,3300
220560,202105,69,45,24,49500,26400,75900
220570,202105,731,455,276,500500,303600,804100
220580,202105,546,498,48,548900,52800,601700
220585,202105,9,8,1,8800,1100,9900
220590,202105,14,13,1,14300,1100,15400
220595,202105,67,51,16,56100,17600,73700
220600,202105,23,15,8,16500,8800,25300
220605,202105,23,20,3,22000,3300,25300
220610,202105,80,67,13,74800,14300,89100
220620,202105,554,462,92,509300,101200,610500
220630,202105,5,4,1,4400,1100,5500
220635,202105,36,31,5,34100,5500,39600
220640,202105,105,86,19,94600,20900,115500
220650,202105,113,107,6,117700,6600,124300
220660,202105,58,46,12,50600,13200,63800
220665,202105,7,7,0,7700,0,7700
220667,202105,21,19,2,20900,2200,23100
220669,202105,29,24,5,26400,5500,31900
220670,202105,67,55,12,60500,13200,73700
220672,202105,78,56,22,61600,24200,85800
220675,202105,33,25,8,27500,8800,36300
220680,202105,44,38,6,41800,6600,48400
220690,202105,47,44,3,48400,3300,51700
220695,202105,29,16,13,17600,14300,31900
220700,202105,1724,1337,387,1472900.37,425700,1898600.37
220710,202105,7,5,2,5500,2200,7700
220720,202105,108,91,17,100100,18700,118800
220730,202105,17,16,1,17600,1100,18700
220735,202105,4,0,4,0,4400,4400
220740,202105,48,43,5,47300,5500,52800
220750,202105,114,98,16,107800,17600,125400
220755,202105,15,14,1,15400,1100,16500
220760,202105,69,61,8,67100,8800,75900
220770,202105,5766,3186,2580,3505700.7,2841300,6347000.7
220775,202105,15,10,5,11000,5500,16500
220777,202105,19,18,1,19800,1100,20900
220779,202105,1,0,1,0,1100,1100
220780,202105,895,764,131,841500,144100,985600
220785,202105,5,1,4,1100,4400,5500
220790,202105,1100,866,234,952600,257400,1210000
220793,202105,6,6,0,6600,0,6600
220795,202105,13,12,1,13200,1100,14300
220800,202105,4034,3099,935,3412404,1028500,4440904
220810,202105,68,60,8,66000,8800,74800
220820,202105,239,216,23,237600,25300,262900
220830,202105,1276,1105,171,1215500,188100,1403600
220840,202105,2414,1686,728,1857900,800800,2658700
220850,202105,62,54,8,59400,8800,68200
220855,202105,9,5,4,5500,4400,9900
220860,202105,11,10,1,11000,1100,12100
220865,202105,26,24,2,26400,2200,28600
220870,202105,78,69,9,75900,9900,85800
220880,202105,325,260,65,286000,71500,357500
220885,202105,30,28,2,30800,2200,33000
220887,202105,12,11,1,12100,1100,13200
220890,202105,94,82,12,90200,13200,103400
220900,202105,26,16,10,17600,11000,28600
220910,202105,52,43,9,47300,9900,57200
220915,202105,10,9,1,9900,1100,11000
220920,202105,48,42,6,46200,6600,52800
220930,202105,46,45,1,49500,1100,50600
220935,202105,15,15,0,16500,0,16500
220937,202105,32,31,1,34100,1100,35200
220940,202105,54,50,4,55000,4400,59400
220945,202105,3,3,0,3300,0,3300
220950,202105,38,30,8,33000,8800,41800
220955,202105,21,19,2,20900,2200,23100
220960,202105,20,19,1,20900,1100,22000
220965,202105,38,34,4,37400,4400,41800
220970,202105,61,51,10,56100,11000,67100
220975,202105,14,12,2,13200,2200,15400
220980,202105,31,29,2,31900,2200,34100
220985,202105,60,54,6,59400,6600,66000
220987,202105,31,30,1,33000,1100,34100
220990,202105,27,26,1,28600,1100,29700
220995,202105,16,13,3,14300,3300,17600
220997,202105,62,52,10,57200,11000,68200
221000,202105,1189,1072,117,1179200,128700,1307900
221005,202105,45,42,3,46200,3300,49500
221010,202105,17,13,4,14300,4400,18700
221020,202105,36,35,1,38500,1100,39600
221030,202105,39,31,8,34100,8800,42900
221035,202105,24,24,0,26400,0,26400
221037,202105,13,9,4,9900,4400,14300
221038,202105,28,25,3,27500,3300,30800
221039,202105,25,25,0,27500,0,27500
221040,202105,268,229,39,251900,42900,294800
221050,202105,231,194,37,213400,40700,254100
221060,202105,1882,1641,241,1807300,265100,2072400
221062,202105,34,33,1,36300,1100,37400
221063,202105,13,9,4,9900,4400,14300
221065,202105,61,49,12,53900,14300,68200
221070,202105,137,121,16,133100,17600,150700
221080,202105,372,319,53,350900,58300,409200
221090,202105,24,19,5,20900,5500,26400
221093,202105,43,32,11,35200,12100,47300
221095,202105,5,5,0,5500,0,5500
221097,202105,13,11,2,12100,2200,14300
221100,202105,25688,15304,10384,16846500.94,11427900,28274400.94
221110,202105,1103,836,267,919600,293700,1213300
221120,202105,542,400,142,440000,156200,596200
221130,202105,969,779,190,858000,209000,1067000
221135,202105,33,29,4,31900,4400,36300
221140,202105,49,43,6,47300,6600,53900
221150,202105,11,9,2,9900,2200,12100
221160,202105,12,12,0,13200,0,13200
221170,202105,17,17,0,18700,0,18700
230010,202105,151,136,15,149600,16500,166100
230015,202105,135,110,25,121000,27500,148500
230020,202105,1630,1369,261,1505900,287100,1793000
230030,202105,1676,1195,481,1316700,529100,1845800
230040,202105,223,188,35,206800,38500,245300
230050,202105,233,173,60,190300,66000,256300
230060,202105,163,128,35,141900,38500,180400
230070,202105,296,253,43,278300,47300,325600
230075,202105,851,737,114,810700,125400,936100
230080,202105,193,166,27,182600,29700,212300
230090,202105,137,101,36,111100,39600,150700
230100,202105,2227,1273,954,1400300,1050500,2450800
230110,202105,2882,1847,1035,2033900,1139600,3173500
230120,202105,1039,821,218,903100,239800,1142900
230125,202105,152,123,29,135300,33000,168300
230130,202105,475,423,52,466400,57200,523600
230140,202105,222,185,37,203500,40700,244200
230150,202105,154,118,36,129800,39600,169400
230160,202105,952,805,147,885500,162800,1048300
230170,202105,614,548,66,602800,72600,675400
230180,202105,75,68,7,74800,7700,82500
230185,202105,411,352,59,387200,64900,452100
230190,202105,2397,1873,524,2063600.32,576400,2640000.32
230195,202105,501,433,68,476300,74800,551100
230200,202105,420,340,80,374000,88000,462000
230205,202105,391,259,132,284900,146300,431200
230210,202105,1373,1069,304,1175900,334400,1510300
230220,202105,1569,1068,501,1175900,552200,1728100
230230,202105,970,818,152,900900,167200,1068100
230240,202105,1799,1557,242,1714075.34,266200,1980275.34
230250,202105,1796,1470,326,1617000,358600,1975600
230260,202105,3197,1981,1216,2180200,1338700,3518900
230270,202105,1386,1106,280,1216600.05,309100,1525700.05
230280,202105,2754,2084,670,2294600,739200.68,3033800.68
230290,202105,369,328,41,363000.5,45100,408100.5
230300,202105,523,381,142,419100,156200,575300
230310,202105,418,321,97,353100,106700,459800
230320,202105,920,780,140,859100,154000,1013100
230330,202105,310,249,61,275000,67100,342100
230340,202105,443,359,84,394900.67,93500,488400.67
230350,202105,3219,2023,1196,2225300,1317800,3543100
230360,202105,272,223,49,245300,56100,301400
230365,202105,132,109,23,119900,25300,145200
230370,202105,10280,5050,5230,5562700.92,5759600,11322300.92
230380,202105,493,421,72,463100,80300,543400
230390,202105,536,301,235,333300,258500,591800
230393,202105,247,205,42,225500,46200,271700
230395,202105,346,276,70,303600,77000,380600
230400,202105,627,500,127,550000,139700,689700
230410,202105,2678,1667,1011,1834800.5,1113200,2948000.5
230420,202105,6317,4174,2143,4594701.01,2362800,6957501.01
230423,202105,340,296,44,325600,48400,374000
230425,202105,439,357,82,392700,90200,482900
230426,202105,118,95,23,104500,25300,129800
230427,202105,72,68,4,74800,4400,79200
230428,202105,1542,757,785,833800,863500,1697300
230430,202105,455,368,87,404800,95700,500500
230435,202105,908,661,247,727100,272800.24,999900.24
230440,202105,90308,40529,49779,44627988.14,54820700.55,99448688.69
230445,202105,313,213,100,234300,110000,344300
230450,202105,577,456,121,501600,133100,634700
230460,202105,73,53,20,58300,22000,80300
230465,202105,306,246,60,270600,66000,336600
230470,202105,2024,1590,434,1749000,478500,2227500
230480,202105,152,142,10,156200,11000,167200
230490,202105,319,252,67,277200,73700,350900
230495,202105,460,336,124,369600,136400,506000
230500,202105,1030,757,273,834900,300300,1135200
230510,202105,56,43,13,47300,14300,61600
230520,202105,389,305,84,336600,92400,429000
230523,202105,2389,1483,906,1632400,997700,2630100
230526,202105,271,232,39,255200,42900,298100
230530,202105,688,508,180,559900,199100,759000
230533,202105,214,197,17,217800,18700,236500
230535,202105,366,274,92,301400,101200,402600
230540,202105,1805,1608,197,1769900,217800,1987700
230550,202105,3892,2491,1401,2741200,1542200,4283400
230560,202105,577,434,143,477400,157300,634700
230565,202105,225,164,61,180400,67100,247500
230570,202105,287,252,35,277200,38500,315700
230580,202105,1180,853,327,938300,359700,1298000
230590,202105,1001,779,222,859100,244200,1103300
230600,202105,254,233,21,256300,23100,279400
230610,202105,400,302,98,332200,107800,440000
230620,202105,169,146,23,160600,25300,185900
230625,202105,789,539,250,594000,275000,869000
230630,202105,1329,1021,308,1124200,338800,1463000
230640,202105,3822,3225,597,3549700,656700,4206400
230650,202105,499,431,68,474100,75900,550000
230655,202105,696,581,115,639100,126500,765600
230660,202105,362,298,64,327800,70400,398200
230670,202105,444,376,68,413600,74800,488400
230680,202105,204,184,20,202400,22000,224400
230690,202105,916,769,147,845900,161700,1007600
230700,202105,861,723,138,795300,152900,948200
230710,202105,696,657,39,722700,44000,766700
230720,202105,148,126,22,139700,24200,163900
230725,202105,224,167,57,183700,62700,246400
230730,202105,12357,6648,5709,7318231.32,6283200.82,13601432.14
230740,202105,675,544,131,599500,144100,743600
230750,202105,831,700,131,770000,144100,914100
230760,202105,1442,1233,209,1358500,229900,1588400
230763,202105,337,277,60,304700,66000,370700
230765,202105,7743,3598,4145,3960001.43,4561700.12,8521701.55
230770,202105,4975,2542,2433,2798400,2677400,5475800
230780,202105,740,651,89,716100,97900,814000
230790,202105,295,247,48,273900,52800,326700
230800,202105,1154,829,325,913000,357500,1270500
230810,202105,1364,1201,163,1322200,179300,1501500
230820,202105,363,248,115,272800,126500,399300
230830,202105,965,818,147,900900,161700,1062600
230835,202105,282,240,42,264000,46200,310200
230837,202105,172,144,28,158400,30800,189200
230840,202105,928,722,206,794200,226600,1020800
230850,202105,1469,1267,202,1394800,222200,1617000
230860,202105,304,227,77,249700,84706,334406
230870,202105,1821,1544,277,1701700,304700,2006400
230880,202105,68,53,15,58300,16500,74800
230890,202105,543,492,51,541200,56100,597300
230900,202105,275,204,71,224400,78100.7,302500.7
230910,202105,223,172,51,189200,56100,245300
230920,202105,477,378,99,418000,108900,526900
230930,202105,999,700,299,772200,328900,1101100
230940,202105,852,658,194,723800,213400,937200
230945,202105,527,422,105,464200,115500,579700
230950,202105,421,366,55,402600,60500,463100
230960,202105,2677,1794,883,1973400,971300,2944700
230970,202105,1705,954,751,1049400,826100,1875500
230980,202105,201,164,37,180400,40700,221100
230990,202105,137,109,28,119900,30800,150700
231000,202105,191,175,16,192500,17600,210100
231010,202105,156,111,45,122100,49500,171600
231020,202105,1366,942,424,1036200,466400,1502600
231025,202105,1064,777,287,854700,315700,1170400
231030,202105,1086,905,181,995500,199100,1194600
231040,202105,144,96,48,105600,52800,158400
231050,202105,947,833,114,917400,125400,1042800
231060,202105,159,133,26,146300,28600,174900
231070,202105,1481,1033,448,1137400,492800,1630200
231080,202105,265,241,24,265100,26400,291500
231085,202105,631,384,247,422400,271700,694100
231090,202105,255,205,50,225500,55000,280500
231095,202105,171,135,36,148500,39600,188100
231100,202105,156,128,28,140800,30800,171600
231110,202105,369,312,57,343200,62700,405900
231120,202105,270,229,41,251900,45100,297000
231123,202105,153,144,9,158400,9900,168300
231126,202105,333,257,76,282700,83600,366300
231130,202105,4835,3785,1050,4166800,1155000,5321800
231135,202105,211,183,28,201300,31900,233200
231140,202105,3068,2230,838,2455200,922900,3378100
231150,202105,374,351,23,386100,25300,411400
231160,202105,1208,968,240,1064800,264000,1328800
231170,202105,513,357,156,392700,171600,564300
231180,202105,1726,1484,242,1632400,266200,1898600
231190,202105,207,174,33,191400,36300,227700
231195,202105,222,188,34,206800,37400,244200
231200,202105,800,659,141,724900,156200,881100
231210,202105,528,447,81,492800,89100,581900
231220,202105,1041,762,279,838200.85,306900,1145100.85
231230,202105,1467,1144,323,1258400,355300,1613700
231240,202105,1469,1039,430,1142900,474100,1617000
231250,202105,100,94,6,103400,6600,110000
231260,202105,266,175,91,193600,100100,293700
231270,202105,989,795,194,875600,213400,1089000
231280,202105,76,59,17,64900,18700,83600
231290,202105,7716,4353,3363,4791600,3699300.57,8490900.57
231300,202105,607,561,46,618200,50600,668800
231310,202105,754,689,65,757900.81,71500,829400.81
231320,202105,599,451,148,497200,162800,660000
231325,202105,101,88,13,96800,14300,111100
231330,202105,1960,1513,447,1665675.74,491700,2157375.74
231335,202105,254,224,30,246400,33000,279400
231340,202105,1733,1261,472,1387100.01,519200,1906300.01
231350,202105,1309,1054,255,1159400,281600,1441000
231355,202105,435,370,65,408100,71500,479600
231360,202105,527,378,149,415800.65,163900,579700.65
231370,202105,92,81,11,89100,12100,101200
231375,202105,292,211,81,232100,89100,321200
231380,202105,498,394,104,433400,114400,547800
231390,202105,210,160,50,176000,55000,231000
231395,202105,751,470,281,517000,309100,826100
231400,202105,1137,945,192,1039500,211200,1250700
231410,202105,1337,1104,233,1214400.71,256300,1470700.71
240010,202105,383,167,216,183700.97,237600,421300.97
240020,202105,2236,1812,424,1993200,466400,2459600
240030,202105,120,99,21,108900,23100,132000
240040,202105,31,31,0,34100,0,34100
240050,202105,531,451,80,496100,88000,584100
240060,202105,65,61,4,67100,4400,71500
240070,202105,231,180,51,198000,56100,254100
240080,202105,534,361,173,398200,190300.7,588500.7
240090,202105,104,93,11,102300,12100,114400
240100,202105,1489,1402,87,1542200.5,95700,1637900.5
240110,202105,1033,677,356,744700,391600,1136300
240120,202105,141,109,32,121000,35200,156200
240130,202105,273,252,21,277200,23100,300300
240140,202105,81,57,24,62700,26400,89100
240145,202105,728,643,85,707300,93500,800800
240150,202105,22,17,5,18700,5500,24200
240160,202105,42,34,8,37400,8800,46200
240165,202105,37,29,8,31900,8800,40700
240170,202105,114,77,37,84700,40700,125400
240180,202105,93,70,23,78100,25300,103400
240185,202105,45,40,5,44000,5500,49500
240190,202105,17,15,2,16500,2200,18700
240200,202105,3052,1696,1356,1866700,1491600,3358300
240210,202105,170,129,41,141900,45100,187000
240220,202105,1108,799,309,878900,339900,1218800
240230,202105,842,768,74,844800,81400,926200
240240,202105,69,49,20,55000,22000,77000
240250,202105,92,79,13,86900,14300,101200
240260,202105,1803,1325,478,1458600,526900,1985500
240270,202105,184,162,22,178200,24200,202400
240280,202105,51,40,11,44000,12100,56100
240290,202105,46,44,2,48400,2200,50600
240300,202105,175,97,78,106700,85800,192500
240310,202105,2380,1296,1084,1425600.21,1193500,2619100.21
240320,202105,185,172,13,189200,14300,203500
240325,202105,4607,2732,1875,3006301.85,2063600,5069901.85
240330,202105,70,66,4,72600,4400,77000
240340,202105,79,53,26,58300,28600,86900
240350,202105,96,83,13,91300,14300,105600
240360,202105,572,350,222,386100,245300,631400
240370,202105,54,50,4,55000,4400,59400
240375,202105,63,38,25,41800,27500,69300
240380,202105,229,187,42,205700,46200,251900
240390,202105,12,11,1,12100,1100,13200
240400,202105,82,74,8,81400,8800,90200
240410,202105,14,8,6,8800,6600,15400
240420,202105,1031,755,276,830500,303600,1134100
240430,202105,260,244,16,268400,17600,286000
240440,202105,127,72,55,79200,60500,139700
240450,202105,233,153,80,168300,88000,256300
240460,202105,73,57,16,62700,17600,80300
240470,202105,238,213,25,234300,27500,261800
240480,202105,17,15,2,16500,2200,18700
240485,202105,83,68,15,74800,16500,91300
240490,202105,46,43,3,47300,3300,50600
240500,202105,90,68,22,74800,24200,99000
240510,202105,43,31,12,34100,13200,47300
240520,202105,107,102,5,112200,5500,117700
240530,202105,55,48,7,52800,7700,60500
240540,202105,81,69,12,75900,13200,89100
240550,202105,13,12,1,13200,1100,14300
240560,202105,376,274,102,301400,112200,413600
240570,202105,438,275,163,302500,179300,481800
240580,202105,1294,1016,278,1119800,306900,1426700
240590,202105,31,29,2,31900,2200,34100
240600,202105,102,98,4,107800,4400,112200
240610,202105,513,430,83,473000.98,91300,564300.98
240615,202105,18,17,1,18700,1100,19800
240620,202105,89,86,3,94600,3300,97900
240630,202105,40,34,6,37400,6600,44000
240640,202105,25,20,5,22000,5500,27500
240650,202105,241,199,42,220000,46200,266200
240660,202105,112,95,17,104500,18700,123200
240670,202105,316,179,137,196900,150700,347600
240680,202105,51,38,13,41800,14300,56100
240690,202105,47,44,3,48400,3300,51700
240700,202105,185,152,33,167200,36300,203500
240710,202105,2061,1263,798,1390400,877800,2268200
240720,202105,1065,780,285,859100,313500,1172600
240725,202105,67,63,4,69300,4400,73700
240730,202105,148,123,25,135300,27500,162800
240740,202105,229,195,34,214500,37400,251900
240750,202105,48,28,20,30800,22000,52800
240760,202105,48,43,5,47300,5500,52800
240770,202105,149,116,33,127600,36300,163900
240780,202105,698,583,115,641300,126500,767800
240790,202105,42,40,2,44000,2200,46200
240800,202105,9344,6326,3018,6965201.83,3320900,10286101.83
240810,202105,20771,11186,9585,12314500,10555600,22870100
240820,202105,240,144,96,158400,105600,264000
240830,202105,1620,1332,288,1465200,316800,1782000
240840,202105,76,66,10,72600,11000,83600
240850,202105,82,74,8,81400,8800,90200
240860,202105,106,102,4,112200,4400,116600
240870,202105,58,50,8,55000,8800,63800
240880,202105,31,28,3,30800,3300,34100
240890,202105,1135,642,493,709500,542300,1251800
240895,202105,62,45,17,49500,18700,68200
240910,202105,162,140,22,154000,24200,178200
240920,202105,14,11,3,12100,3300,15400
240930,202105,408,365,43,401500,47300,448800
240933,202105,52,34,18,37400,19800,57200
240940,202105,2350,2084,266,2293500,293700,2587200
240950,202105,48,43,5,47300,5500,52800
240960,202105,27,22,5,24200,5500,29700
240970,202105,114,84,30,92400,33000,125400
240980,202105,202,164,38,180400,41800,222200
240990,202105,133,89,44,97900,48400,146300
241000,202105,61,58,3,63800,3300,67100
241010,202105,75,57,18,62700,19800,82500
241020,202105,111,102,9,112200,9900,122100
241025,202105,15,8,7,8800,7700,16500
241030,202105,114,90,24,99000,26400,125400
241040,202105,42,30,12,33000,13200,46200
241050,202105,80,72,8,79200,8800,88000
241060,202105,28,23,5,25300,5500,30800
241070,202105,16,16,0,17600,0,17600
241080,202105,61,54,7,59400,7700,67100
241090,202105,54,44,10,48400,11000,59400
241100,202105,73,62,11,68200,12100,80300
241105,202105,10,3,7,3300,7700,11000
241110,202105,46,41,5,45100,5500,50600
241120,202105,1512,1149,363,1263900,400400,1664300
241140,202105,219,184,35,202400,38500,240900
241142,202105,43,35,8,38500,8800,47300
241150,202105,1198,1053,145,1158300,159500,1317800
241160,202105,18,17,1,18700,1100,19800
241170,202105,48,40,8,44000,8800,52800
241180,202105,45,38,7,41800,7700,49500
241190,202105,38,36,2,39600,2200,41800
241200,202105,4038,2122,1916,2335300.02,2110900,4446200.02
241210,202105,68,58,10,63800,11000,74800
241220,202105,1451,971,480,1068100.43,528000,1596100.43
241230,202105,253,209,44,229900,48400,278300
241240,202105,54,42,12,46200,13200,59400
241250,202105,1134,1038,96,1141800,105600,1247400
241255,202105,55,44,11,48400,12100,60500
241260,202105,679,523,156,575300,172700,748000
241270,202105,66,46,20,50600,22000,72600
241280,202105,95,83,12,91300,13200,104500
241290,202105,132,90,42,99000,46200,145200
241300,202105,82,56,26,61600,28600,90200
241310,202105,52,37,15,40700,16500,57200
241320,202105,33,20,13,22000,14300,36300
241330,202105,64,54,10,59400,11000,70400
241335,202105,75,68,7,74800,7700,82500
241340,202105,184,136,48,149600,52800,202400
241350,202105,61,52,9,57200,9900,67100
241355,202105,50,42,8,46200,8800,55000
241360,202105,50,49,1,53900,1100,55000
241370,202105,57,45,12,49500,13200,62700
241380,202105,34,30,4,33000,4400,37400
241390,202105,83,64,19,70400,20900,91300
241400,202105,216,168,48,184800,52800,237600
241410,202105,182,164,18,180400,19800,200200
241415,202105,101,83,18,91300,19800,111100
241420,202105,105,79,26,86900,28600,115500
241430,202105,26,23,3,25300,3300,28600
241440,202105,532,440,92,484000,102300,586300
241445,202105,39,34,5,37400,5500,42900
241450,202105,259,214,45,235400,49500,284900
241460,202105,146,133,13,146300,14300,160600
241470,202105,35,30,5,33000,5500,38500
241475,202105,52,49,3,53900,3300,57200
241480,202105,107,78,29,85800,31900,117700
241490,202105,11,10,1,11000,1100,12100
241500,202105,45,34,11,37400,12100,49500
250010,202105,102,88,14,96800,15400,112200
250020,202105,30,27,3,29700,3300,33000
250030,202105,892,665,227,731500,249700,981200
250040,202105,385,318,67,349800,73700,423500
250050,202105,260,211,49,232100,53900,286000
250053,202105,56,43,13,47300,14300,61600
250057,202105,1,1,0,1100,0,1100
250060,202105,602,433,169,476300,185900,662200
250070,202105,699,563,136,620400.22,149600,770000.22
250073,202105,7,7,0,7700,0,7700
250077,202105,176,130,46,143000,50600,193600
250080,202105,429,340,89,374000,97900,471900
250090,202105,222,142,80,156200,88000,244200
250100,202105,528,441,87,485100,95700,580800
250110,202105,637,481,156,529100,172700,701800
250115,202105,17,4,13,4400,14300,18700
250120,202105,120,87,33,95700,36300,132000
250130,202105,571,458,113,504900,124300,629200
250135,202105,19,11,8,12100,8800,20900
250140,202105,85,75,10,82500,11000,93500
250150,202105,603,433,170,476300,187000,663300
250153,202105,12,9,3,9900,3300,13200
250157,202105,28,23,5,25300,5500,30800
250160,202105,229,182,47,200200,51700,251900
250170,202105,66,43,23,47300,25300,72600
250180,202105,4448,3032,1416,3335200,1562000,4897200
250190,202105,830,550,280,605000,308000,913000
250200,202105,56,43,13,47300,14300,61600
250205,202105,23,19,4,20900,4400,25300
250210,202105,87,76,11,83600,12100,95700
250215,202105,67,52,15,57200,16500,73700
250220,202105,25,18,7,19800,7700,27500
250230,202105,76,69,7,75900,7700,83600
250240,202105,238,187,51,205700,56100,261800
250250,202105,383,328,55,361900,60500,422400
250260,202105,45,37,8,40700,8800,49500
250270,202105,74,53,21,58300,23100,81400
250280,202105,377,306,71,336600,78100,414700
250290,202105,90,83,7,91300,7700,99000
250300,202105,558,378,180,415800,198000,613800
250310,202105,45,41,4,45100,4400,49500
250320,202105,1935,1301,634,1432200,697400,2129600
250330,202105,102,87,15,95700,17600,113300
250340,202105,28,24,4,26400,4400,30800
250350,202105,182,119,63,132000,69300,201300
250355,202105,33,24,9,26400,9900,36300
250360,202105,199,163,36,179300,39600,218900
250370,202105,2385,1555,830,1711600,914100,2625700
250375,202105,11,6,5,6600,5500,12100
250380,202105,57,45,12,49500,13200,62700
250390,202105,45,35,10,38500,11000,49500
250400,202105,16459,8287,8172,9126681.02,8999100,18125781.02
250403,202105,323,258,65,283800,71500,355300
250407,202105,63,51,12,56100,13200,69300
250410,202105,30,26,4,28600,4400,33000
250415,202105,41,28,13,30800,14300,45100
250420,202105,43,37,6,40700,6600,47300
250430,202105,1450,1248,202,1373075,222200,1595275
250435,202105,20,14,6,15400,6600,22000
250440,202105,681,565,116,621500,127600,749100
250450,202105,83,64,19,70400,20900,91300
250460,202105,472,308,164,339900.57,181500,521400.57
250470,202105,95,66,29,72600,31900,104500
250480,202105,332,265,67,291500,73700,365200
250485,202105,2,2,0,2200,0,2200
250490,202105,229,186,43,204600,47300,251900
250500,202105,98,72,26,79200,28600,107800
250510,202105,784,627,157,689700,173800,863500
250520,202105,174,117,57,128700,62700,191400
250523,202105,123,99,24,108900,26400,135300
250527,202105,107,84,23,92400,25300,117700
250530,202105,9,6,3,6600,3300,9900
250535,202105,30,22,8,24200,8800,33000
250540,202105,137,109,28,119900,30800,150700
250550,202105,73,70,3,77000,3300,80300
250560,202105,60,37,23,40700,25300,66000
250570,202105,161,132,29,145200,31900,177100
250580,202105,103,80,23,88071,25300,113371
250590,202105,25,15,10,16500,11000,27500
250600,202105,1455,959,496,1054900.7,545600,1600500.7
250610,202105,162,133,29,146300,31900,178200
250620,202105,21,17,4,18700,4400,23100
250625,202105,75,56,19,61600,20900,82500
250630,202105,3111,1989,1122,2191200.62,1234200,3425400.62
250640,202105,202,162,40,178200,44000,222200
250650,202105,30,20,10,22000,11000,33000
250660,202105,56,40,16,44000,17600,61600
250670,202105,65,48,17,52800,18700,71500
250680,202105,416,336,80,369600,88000,457600
250690,202105,2095,1454,641,1601600.7,706200,2307800.7
250700,202105,926,799,127,881100,139700,1020800
250710,202105,448,351,97,386100,106700,492800
250720,202105,117,85,32,93500,35200,128700
250730,202105,396,329,67,363000,73700,436700
250740,202105,56,53,3,58300,3300,61600
250750,202105,22718,13572,9146,14935681.41,10066100,25001781.41
250760,202105,105,82,23,90200,25300,115500
250770,202105,360,236,124,259600,136400,396000
250780,202105,69,46,23,50600,25300,75900
250790,202105,460,296,164,325600,180400,506000
250800,202105,154,139,15,152900,16500,169400
250810,202105,74,59,15,64900,16500,81400
250820,202105,151,126,25,138600,27500,166100
250830,202105,440,292,148,321200,162800,484000
250840,202105,55,49,6,53900,6600,60500
250850,202105,56,46,10,50600,11000,61600
250855,202105,16,14,2,15400,2200,17600
250860,202105,249,152,97,167200,106700,273900
250870,202105,28,25,3,27500,3300,30800
250880,202105,88,64,24,70400,26400,96800
250890,202105,2937,2189,748,2409000,822800,3231800
250900,202105,54,45,9,49500,9900,59400
250905,202105,121,92,29,101200,31900,133100
250910,202105,1088,798,290,877800,319000,1196800
250915,202105,100,72,28,79200,30800,110000
250920,202105,139,103,36,113300,39600,152900
250930,202105,175,103,72,113300,79200,192500
250933,202105,6,4,2,4400,2200,6600
250937,202105,11,11,0,12100,0,12100
250939,202105,31,23,8,25300,8800,34100
250940,202105,106,77,29,84700,31900,116600
250950,202105,73,50,23,55000,25300,80300
250960,202105,94,52,42,57200,46200,103400
250970,202105,1231,871,360,958100,396000,1354100
250980,202105,105,68,37,74800,40700,115500
250990,202105,170,130,40,144100,44000,188100
251000,202105,74,65,9,71500,9900,81400
251010,202105,115,87,28,95700,30800,126500
251020,202105,74,60,14,66000,15400,81400
251030,202105,46,35,11,38500,12100,50600
251040,202105,56,38,18,41800,19800,61600
251050,202105,25,22,3,24200,3300,27500
251060,202105,49,40,9,44000,9900,53900
251065,202105,5,3,2,3300,2200,5500
251070,202105,18,15,3,16500,3300,19800
251080,202105,5087,2425,2662,2669700,2928200.1,5597900.1
251090,202105,181,152,29,167200,31900,199100
251100,202105,19,19,0,20900,0,20900
251110,202105,50,39,11,42900,12100,55000
251120,202105,1877,1147,730,1261700,803000,2064700
251130,202105,417,341,76,375100,83600,458700
251140,202105,564,363,201,399300,221100,620400
251150,202105,342,289,53,317900,58300,376200
251160,202105,95,78,17,85800,18700,104500
251170,202105,100,79,21,86900,23100,110000
251180,202105,287,174,113,191400,124300,315700
251190,202105,202,129,73,141900,80300,222200
251200,202105,273,218,55,239800,61600,301400
251203,202105,34,32,2,35200,2200,37400
251207,202105,83,69,14,75900,15400,91300
251210,202105,1472,1076,396,1183600,435600,1619200
251220,202105,48,37,11,40700,12100,52800
251230,202105,594,492,102,542300,112200,654500
251240,202105,103,73,30,80300,33000,113300
251250,202105,1433,1036,397,1140700,437800,1578500
251260,202105,11,7,4,7700,4400,12100
251270,202105,313,246,67,270600,73700,344300
251272,202105,64,57,7,62700,7700,70400
251274,202105,29,22,7,24200,7700,31900
251275,202105,35,20,15,22000,16500,38500
251276,202105,17,14,3,15400,3300,18700
251278,202105,9,7,2,7700,2200,9900
251280,202105,102,96,6,105600,6600,112200
251290,202105,877,626,251,688600,276100,964700
251300,202105,16,12,4,13200,4400,17600
251310,202105,292,215,77,236500,84700,321200
251315,202105,35,31,4,34100,4400,38500
251320,202105,66,50,16,55000,17600,72600
251330,202105,80,71,9,78100,9900,88000
251335,202105,18,10,8,11000,8800,19800
251340,202105,747,439,308,482900,338800,821700
251350,202105,36,34,2,37400,2200,39600
251360,202105,82,71,11,78100,12100,90200
251365,202105,11,11,0,12100,0,12100
251370,202105,5574,3753,1821,4131600.32,2005300,6136900.32
251380,202105,46,37,9,40700,9900,50600
251385,202105,1,1,0,1100,0,1100
251390,202105,847,635,212,698500,233200,931700
251392,202105,20,11,9,12100,9900,22000
251394,202105,9,9,0,9900,0,9900
251396,202105,14,10,4,11000,4400,15400
251398,202105,16,14,2,15400,2200,17600
251400,202105,41,33,8,36300,8800,45100
251410,202105,39,33,6,36300,6600,42900
251420,202105,102,74,28,81400,30800,112200
251430,202105,45,41,4,45100,4400,49500
251440,202105,47,26,21,28600,23100,51700
251445,202105,59,52,7,57200,7700,64900
251450,202105,407,353,54,389400,59400,448800
251455,202105,3,2,1,2200,1100,3300
251460,202105,17,15,2,16500,2200,18700
251465,202105,7,5,2,5500,2200,7700
251470,202105,51,39,12,42900,13200,56100
251480,202105,27,22,5,24200,5500,29700
251490,202105,113,72,41,79200,45100,124300
251500,202105,129,103,26,113300,28600,141900
251510,202105,67,43,24,47300,26400,73700
251520,202105,31,29,2,31900,2200,34100
251530,202105,4457,3167,1290,3484800,1420100,4904900
251540,202105,80,67,13,74800,14300,89100
251550,202105,412,313,99,344300,108900,453200
251560,202105,24,16,8,17600,8800,26400
251570,202105,18,16,2,17600,2200,19800
251580,202105,137,108,29,118800,31900,150700
251590,202105,115,82,33,90407.9,36300,126707.9
251593,202105,22,13,9,14300,9900,24200
251597,202105,98,81,17,89100,18700,107800
251600,202105,1111,783,328,862400,361900,1224300
251610,202105,241,178,63,195800,69300,265100
251615,202105,11,10,1,11000,1100,12100
251620,202105,4222,2741,1481,3017300,1630200,4647500
251630,202105,465,345,120,379500,132000,511500
251640,202105,137,100,37,110000,40700,150700
251650,202105,283,207,76,227700,83600,311300
251660,202105,192,170,22,187000,24200,211200
251670,202105,381,295,86,324500,94600,419100
251675,202105,8,6,2,6600,2200,8800
251680,202105,103,91,12,100100,13200,113300
251690,202105,317,262,55,288200,60500,348700
251700,202105,287,249,38,273900,41800,315700
251710,202105,23,14,9,15400,9900,25300
251720,202105,24,16,8,17600,8800,26400
251740,202105,11,8,3,8800,3300,12100
260005,202105,3346,1787,1559,1968532.93,1716000.71,3684533.64
260010,202105,1626,1181,445,1299100.14,489500,1788600.14
260020,202105,419,363,56,399300,61600,460900
260030,202105,598,413,185,454300,203500,657800
260040,202105,801,494,307,543400,337700,881100
260050,202105,1162,840,322,924000,354200,1278200
260060,202105,379,346,33,380600,36300,416900
260070,202105,1343,823,520,907500,572000,1479500
260080,202105,723,553,170,608300,187000,795300
260090,202105,498,327,171,359700,189200,548900
260100,202105,218,151,67,166100,73700,239800
260105,202105,249,137,112,150700,123200,273900
260110,202105,2896,2123,773,2340800,852500,3193300
260120,202105,2795,1455,1340,1601892.6,1477300,3079192.6
260130,202105,172,115,57,126500,62700,189200
260140,202105,2165,1415,750,1557600,826100,2383700
260150,202105,203,129,74,141900,81400,223300
260160,202105,325,269,56,295900,61600,357500
260170,202105,3343,1999,1344,2200000,1478400,3678400
260180,202105,161,127,34,140800,37400,178200
260190,202105,2335,1567,768,1723700,844800,2568500
260200,202105,972,775,197,852500.63,216700,1069200.63
260210,202105,1421,1004,417,1104400,458700,1563100
260220,202105,673,606,67,666600,73700,740300
260230,202105,1229,909,320,999900,352000,1351900
260240,202105,211,161,50,177100,55000,232100
260250,202105,90,66,24,72600,26400,99000
260260,202105,1041,733,308,808500,338800,1147300
260270,202105,256,190,66,209000,72600,281600
260280,202105,1218,933,285,1026300,313500,1339800
260290,202105,6576,3561,3015,3920400,3319800.59,7240200.59
260300,202105,963,822,141,905300,155100,1060400
260310,202105,521,415,106,456500,116600,573100
260320,202105,851,617,234,678700,257400,936100
260330,202105,66,45,21,49500,23100,72600
260340,202105,76,57,19,62700,20900,83600
260345,202105,5494,2939,2555,3236200.65,2813800,6050000.65
260350,202105,483,342,141,376200,155100,531300
260360,202105,231,125,106,137500,116600,254100
260370,202105,759,479,280,526900,310200,837100
260380,202105,581,423,158,467500,173800.6,641300.6
260390,202105,293,247,46,271700,50600,322300
260392,202105,111,96,15,105600,16500,122100
260400,202105,4219,2407,1812,2651000.5,1996500,4647500.5
260410,202105,14707,7714,6993,8492001.03,7700000.5,16192001.53
260415,202105,142,123,19,135300,20900,156200
260420,202105,1725,1044,681,1148400.5,749100,1897500.5
260430,202105,177,162,15,178200.48,16500,194700.48
260440,202105,194,138,56,151800,61600,213400
260450,202105,431,320,111,352001.13,123200,475201.13
260460,202105,818,432,386,475200,424600,899800
260470,202105,342,209,133,229900,146300,376200
260480,202105,245,159,86,174900,94600,269500
260490,202105,214,176,38,193600,41800,235400
260500,202105,1126,757,369,832700,407000,1239700
260510,202105,783,624,159,686400,174900,861300
260515,202105,236,214,22,235400,24200,259600
260520,202105,3271,2027,1244,2230800,1370600,3601400
260530,202105,792,651,141,716100,157300,873400
260540,202105,536,422,114,464200,125400,589600
260545,202105,15,12,3,13200,3300,16500
260550,202105,323,203,120,223300,132000,355300
260560,202105,511,387,124,425700,136400,562100
260570,202105,982,795,187,874500,205700,1080200
260580,202105,255,221,34,243100,37400,280500
260590,202105,625,357,268,392700,294800,687500
260600,202105,8052,4411,3641,4857601.78,4009500,8867101.78
260610,202105,487,322,165,354200,181500,535700
260620,202105,3648,1882,1766,2075700,1943700.19,4019400.19
260630,202105,82,76,6,83600,6600,90200
260640,202105,3408,1922,1486,2116400,1635700,3752100
260650,202105,327,239,88,262900,96800,359700
260660,202105,565,354,211,389400,232100,621500
260670,202105,101,75,26,82500,28600,111100
260680,202105,3834,2104,1730,2315500,1903000,4218500
260690,202105,125,94,31,103400,34100,137500
260700,202105,310,205,105,225500,115500,341000
260710,202105,46,37,9,40700,9900,50600
260720,202105,2553,1492,1061,1642300,1168200,2810500
260730,202105,717,535,182,589600,200200,789800
260740,202105,67,58,9,63800,9900,73700
260750,202105,585,420,165,463100,181500,644600
260760,202105,677,338,339,371800.3,372900,744700.3
260765,202105,978,504,474,556600,522500,1079100
260770,202105,227,164,63,180381,69300,249681
260775,202105,777,428,349,471900,383900,855800
260780,202105,237,148,89,162800,97900,260700
260790,202105,14494,7350,7144,8096000,7865000,15961000
260795,202105,165,107,58,117700,63800,181500
260800,202105,290,239,51,262900,56100,319000
260805,202105,175,117,58,128700,63800,192500
260810,202105,781,655,126,720500,139700,860200
260820,202105,281,180,101,198000,111100,309100
260825,202105,222,146,76,160600,83600,244200
260830,202105,437,181,256,199100,284900,484000
260840,202105,242,177,65,194700,71500,266200
260845,202105,157,106,51,116600,56100,172700
260850,202105,422,311,111,343200,123200,466400
260860,202105,254,191,63,210100,69300,279400
260870,202105,361,274,87,302500,95700,398200
260875,202105,738,537,201,590700,222200,812900
260880,202105,1572,1022,550,1126400,607200,1733600
260890,202105,2338,1635,703,1798500,773300,2571800
260900,202105,982,700,282,770000,310200,1080200
260910,202105,245,194,51,214500,56100,270600
260915,202105,288,212,76,233200,83600,316800
260920,202105,188,97,91,106700,100100,206800
260930,202105,387,329,58,361900,63800,425700
260940,202105,2625,1397,1228,1538900,1350800,2889700
260950,202105,1995,1138,857,1252900,943800,2196700
260960,202105,13555,6768,6787,7447000.9,7476700.5,14923701.4
260970,202105,412,342,70,376200,77000,453200
260980,202105,195,175,20,192500,22000,214500
260990,202105,2641,2133,508,2348500,559900,2908400
261000,202105,4208,2553,1655,2811600.2,1821600,4633200.2
261010,202105,202,110,92,121000,101200,222200
261020,202105,595,446,149,490600.47,163900,654500.47
261030,202105,263,182,81,200200,89100,289300
261040,202105,378,328,50,360800,55000,415800
261050,202105,497,429,68,471900,74800,546700
261060,202105,1379,863,516,950400,567600,1518000
261070,202105,8923,4326,4597,4766300,5062200.5,9828500.5
261080,202105,374,285,89,313500,97900,411400
261090,202105,2149,1641,508,1806202.03,558800.3,2365002.33
261100,202105,1174,816,358,897600,393800,1291400
261110,202105,8829,5435,3394,5979600.57,3735600.22,9715200.79
261120,202105,254,217,37,238700,40700,279400
261130,202105,571,341,230,376200,253000,629200
261140,202105,212,133,79,146300,86900,233200
261150,202105,687,434,253,477400.56,279400,756800.56
261153,202105,69,64,5,70400,5500,75900
261160,202105,74182,36520,37662,40200691.94,41471101.55,81671793.49
261170,202105,473,351,122,387200,134200,521400
261180,202105,1766,1101,665,1212451,732600,1945051
261190,202105,572,399,173,438900,190300,629200
261200,202105,220,181,39,199100,42900,242000
261210,202105,33,28,5,30800,5500,36300
261220,202105,2729,1925,804,2118600.66,886600,3005200.66
261230,202105,350,248,102,272800,112200,385000
261240,202105,438,384,54,422400,60500,482900
261245,202105,242,198,44,217800,48400,266200
261247,202105,168,131,37,144100.89,40700,184800.89
261250,202105,3249,1570,1679,1729200,1846900,3576100
261255,202105,250,222,28,244200,30800,275000
261260,202105,840,727,113,799700.12,124300,924000.12
261270,202105,201,143,58,157300,63800,221100
261280,202105,179,145,34,159500,37400,196900
261290,202105,113,83,30,91300,33000,124300
261300,202105,1311,971,340,1068100,374000,1442100
261310,202105,790,528,262,580800,289300,870100
261320,202105,586,375,211,412500,232100,644600
261330,202105,961,729,232,803000,255200.63,1058200.63
261340,202105,303,166,137,182600,150700,333300
261350,202105,845,592,253,653400,280500,933900
261360,202105,1312,851,461,936100,507100,1443200
261370,202105,4821,2855,1966,3143800,2162600,5306400
261380,202105,545,416,129,457600.78,141900,599500.78
261390,202105,3562,2384,1178,2623500,1296900,3920400
261400,202105,286,256,30,281600,33000,314600
261410,202105,1111,725,386,798600,425700,1224300
261420,202105,907,564,343,620400.32,378400,998800.32
261430,202105,322,292,30,321200,33000,354200
261440,202105,116,107,9,117700,9900,127600
261450,202105,2508,2003,505,2204400,556600,2761000
261460,202105,732,578,154,635800,169400,805200
261470,202105,241,196,45,215600,49500,265100
261480,202105,449,350,99,385000,108850.5,493850.5
261485,202105,356,213,143,234300,157300,391600
261500,202105,607,411,196,452100.59,215600,667700.59
261510,202105,53,34,19,37400,20900,58300
261520,202105,91,78,13,85800,14300,100100
261530,202105,4114,2613,1501,2875400.09,1653300,4528700.09
261540,202105,1383,817,566,898700,623700,1522400
261550,202105,249,118,131,129800,145200,275000
261560,202105,860,564,296,620400,325600,946000
261570,202105,391,307,84,338800,92400,431200
261580,202105,391,307,84,337700,92400,430100
261590,202105,189,153,36,168300,39600,207900
261600,202105,293,231,62,254100,68200,322300
261610,202105,82,72,10,79200,11000,90200
261618,202105,77,60,17,66000,18700,84700
261620,202105,195,120,75,132000,82500,214500
261630,202105,674,538,136,591800,150700,742500
261640,202105,6405,3348,3057,3689401.05,3367100,7056501.05
261650,202105,494,317,177,348700,194700,543400
270010,202105,516,456,60,501600,66000,567600
270020,202105,254,205,49,225500,53900,279400
270030,202105,8765,5642,3123,6207301.56,3438600,9645901.56
270040,202105,2049,1317,732,1450900,805200,2256100
270050,202105,171,134,37,147400,40700,188100
270060,202105,112,63,49,69300,53900,123200
270070,202105,854,628,226,690800,248600,939400
270080,202105,35,29,6,31900,6600,38500
270090,202105,23,17,6,18700,6600,25300
270100,202105,1304,888,416,976800,457600,1434400
270110,202105,87,72,15,79200,16500,95700
270120,202105,225,182,43,200200,47300,247500
270130,202105,296,214,82,235400,90200,325600
270135,202105,115,72,43,79200,47300,126500
270140,202105,1376,884,492,974600,542300,1516900
270150,202105,258,198,60,217800,66000,283800
270160,202105,497,393,104,432300,114400,546700
270170,202105,812,524,288,576400,316800,893200
270180,202105,55,43,12,47300,13200,60500
270190,202105,117,99,18,110000,19800,129800
270200,202105,111,97,14,106700,15400,122100
270210,202105,519,304,215,334400,237600,572000
270220,202105,180,138,42,151800,46200,198000
270230,202105,2122,1308,814,1442100,897600,2339700
270235,202105,685,533,152,588500,167200,755700
270240,202105,2987,2363,624,2605901.56,686400,3292301.56
270250,202105,124,91,33,100100,36300,136400
270255,202105,217,188,29,206800,31900,238700
270260,202105,369,298,71,327800,79200,407000
270270,202105,98,46,52,50600,58300,108900
270280,202105,235,136,99,149600,108900,258500
270290,202105,1146,886,260,974600,286000,1260600
270300,202105,323,231,92,254100,101200,355300
270310,202105,835,694,141,763400,155100,918500
270320,202105,823,709,114,779900.63,125400,905300.63
270330,202105,304,257,47,282700,51700,334400
270340,202105,56,43,13,47300,14300,61600
270350,202105,89,52,37,57200,40700,97900
270360,202105,65,35,30,38500,33000,71500
270370,202105,58,46,12,50600,13200,63800
270375,202105,78,48,30,52800,33000,85800
270380,202105,1039,677,362,746826.66,398200,1145026.66
270390,202105,160,93,67,102300,73700,176000
270400,202105,728,550,178,605000.2,195800,800800.2
270410,202105,643,472,171,520300,188100,708400
270420,202105,402,274,128,301400,140800,442200
270430,202105,33283,23966,9317,26382366,10257500.47,36639866.47
270440,202105,496,391,105,431200,115500,546700
270450,202105,814,475,339,522500,372900,895400
270460,202105,181,143,38,157300,41800,199100
270470,202105,1490,1038,452,1146273.33,498300,1644573.33
270480,202105,539,441,98,485100,107800,592900
270490,202105,21,16,5,17600,5500,23100
270500,202105,494,417,77,458700,84700,543400
270510,202105,833,527,306,579700,336600,916300
270520,202105,278,179,99,196900,108900,305800
270530,202105,59,52,7,57200,7700,64900
270540,202105,94,73,21,80300,23100,103400
270550,202105,1712,1314,398,1446500.6,437800,1884300.6
270560,202105,265,153,112,168300,123200,291500
270570,202105,533,374,159,412500,174900,587400
270580,202105,83,67,16,73700,17600,91300
270590,202105,64,51,13,56100,14300,70400
270600,202105,171,142,29,156200,31900,188100
270610,202105,237,184,53,203500,58300,261800
270620,202105,16,16,0,17600,0,17600
270630,202105,3731,2853,878,3141600,966900,4108500
270640,202105,866,647,219,711700,240900,952600
270642,202105,200,168,32,184800,35200,220000
270644,202105,255,167,88,183700,96800,280500
270650,202105,321,193,128,212300,140800,353100
270660,202105,207,178,29,195800,31900,227700
270670,202105,3032,2293,739,2522301.01,812900,3335201.01
270680,202105,427,260,167,286000,183700,469700
270690,202105,1192,790,402,872300,442200,1314500
270700,202105,26,21,5,23100,5500,28600
270710,202105,870,685,185,755700,203500,959200
270720,202105,232,182,50,200200,55000,255200
270730,202105,1883,1158,725,1273983.33,797500,2071483.33
270740,202105,40,27,13,29700,14300,44000
270750,202105,642,485,157,533500,172700,706200
270760,202105,292,211,81,232100,89100,321200
270770,202105,2770,1855,915,2042773.33,1006500,3049273.33
270780,202105,69,45,24,49500,26400,75900
270790,202105,257,165,92,181500,101200,282700
270800,202105,2074,1632,442,1796300,486200,2282500
270810,202105,214,177,37,194700,40700,235400
270820,202105,133,95,38,104500,41800,146300
270830,202105,794,600,194,661100,213400,874500
270840,202105,1363,1043,320,1148400.4,352000,1500400.4
270850,202105,1516,963,553,1059667.5,608300,1667967.5
270860,202105,2552,1707,845,1878800.7,929500,2808300.7
270870,202105,115,64,51,70400,56100,126500
270880,202105,886,701,185,773850,203500,977350
270890,202105,283,214,69,235400,75900,311300
270895,202105,50,47,3,51700,3300,55000
270900,202105,76,61,15,67100,16500,83600
270910,202105,303,251,52,276100,57200,333300
270915,202105,1902,1238,664,1362973.33,730400,2093373.33
270920,202105,457,380,77,418000,84700,502700
270930,202105,5911,4467,1444,4915900,1590600.14,6506500.14
270940,202105,2231,1757,474,1934900,522500,2457400
280010,202105,39,32,7,35200,7700,42900
280020,202105,486,417,69,459800,75900,535700
280030,202105,20698,13391,7307,14737802.58,8041001.25,22778803.83
280040,202105,326,211,115,232100,126500,358600
280050,202105,406,313,93,344300,102300,446600
280060,202105,337,222,115,244200,128700,372900
280067,202105,1088,789,299,869000,328900.5,1197900.5
280070,202105,126,103,23,113300,25300,138600
280100,202105,647,502,145,552200,159500,711700
280110,202105,72,66,6,72600,6600,79200
280120,202105,663,550,113,605000,124300,729300
280130,202105,1751,1153,598,1270500,657800,1928300
280140,202105,488,403,85,443300,93500,536800
280150,202105,405,283,122,311300,134200,445500
280160,202105,125,101,24,111100,26400,137500
280170,202105,411,287,124,315700,136400,452100
280190,202105,26,23,3,25300,3300,28600
280200,202105,34,29,5,31900,5500,37400
280210,202105,2949,2125,824,2342869.6,906400,3249269.6
280220,202105,40,34,6,37400,6600,44000
280230,202105,329,268,61,294800,67100,361900
280240,202105,126,120,6,132000,6600,138600
280250,202105,19,10,9,11000,9900,20900
280260,202105,78,70,8,77000,8800,85800
280270,202105,147,113,34,124300,37400,161700
280280,202105,198,131,67,144100.5,74800,218900.5
280290,202105,3429,2479,950,2726829.5,1045000,3771829.5
280300,202105,1612,1264,348,1390400,382800,1773200
280310,202105,97,92,5,101200,5500,106700
280320,202105,652,458,194,503800,213400,717200
280330,202105,322,237,85,260700,93500,354200
280340,202105,411,331,80,364100,88000,452100
280350,202105,3710,2877,833,3166900.66,916300.08,4083200.74
280360,202105,470,322,148,354200,163900,518100
280370,202105,97,85,12,93500,13200,106700
280380,202105,52,37,15,40700,16500,57200
280390,202105,170,145,25,159500,27500,187000
280400,202105,351,239,112,262900,123200,386100
280410,202105,287,238,49,261800,53900,315700
280420,202105,144,126,18,138600,19800,158400
280430,202105,67,55,12,60500,13200,73700
280440,202105,734,588,146,646800,160600,807400
280445,202105,122,112,10,123200,11000,134200
280450,202105,1232,1056,176,1162700,193600,1356300
280460,202105,634,462,172,508200.93,189200,697400.93
280470,202105,114,104,10,114400,11000,125400
280480,202105,2750,1909,841,2103202.46,925100.5,3028302.96
280490,202105,207,196,11,215600.96,12100,227700.96
280500,202105,44,40,4,44000,4400,48400
280510,202105,139,112,27,124300,29700,154000
280520,202105,52,37,15,40700,16500,57200
280530,202105,80,52,28,57200,30800,88000
280540,202105,536,454,82,499400,90200,589600
280550,202105,735,676,59,743600.65,64900,808500.65
280560,202105,491,436,55,479600.85,60500,540100.85
280570,202105,2316,1835,481,2018500,530200,2548700
280580,202105,589,457,132,502700,145200,647900
280590,202105,211,136,75,149600,82500,232100
280600,202105,383,319,64,350951.7,70400,421351.7
280610,202105,108,80,28,88000,30800,118800
280620,202105,539,439,100,482900,110000,592900
280630,202105,153,127,26,140800,28600,169400
280640,202105,190,150,40,165000,44000,209000
280650,202105,93,60,33,66000,36300,102300
280660,202105,140,102,38,112200,41800,154000
280670,202105,1909,1202,707,1322200,777700.48,2099900.48
280680,202105,207,179,28,196900,30800,227700
280690,202105,82,72,10,79200,11000,90200
280700,202105,19,19,0,20900,0,20900
280710,202105,1475,1143,332,1257300,366300,1623600
280720,202105,114,75,39,82500,42900,125400
280730,202105,27,22,5,26400,5500,31900
280740,202105,2519,1882,637,2071300,700700,2772000
280750,202105,227,199,28,218900,30800,249700
280760,202105,799,553,246,609400,270600,880000
290010,202105,195,138,57,151800,62700,214500
290020,202105,191,172,19,189200,20900,210100
290030,202105,609,392,217,431200,238700,669900
290035,202105,131,107,24,117700,26400,144100
290040,202105,309,209,100,229900,110000,339900
290050,202105,85,67,18,73700,19800,93500
290060,202105,258,114,144,125400,158400,283800
290070,202105,5722,2739,2983,3014000.69,3283500,6297500.69
290080,202105,445,200,245,220000,269500,489500
290090,202105,373,167,206,183700,226600,410300
290100,202105,1665,1088,577,1197900,635800,1833700
290110,202105,833,487,346,535700.85,380600,916300.85
290115,202105,195,181,14,199100,15400,214500
290120,202105,777,521,256,574200,281600,855800
290130,202105,435,271,164,298100,180400,478500
290135,202105,303,233,70,256300,77000,333300
290140,202105,319,264,55,291500,60500,352000
290150,202105,139,96,43,105600,47300,152900
290160,202105,246,188,58,207900,63800,271700
290170,202105,92,65,27,71500,29700,101200
290180,202105,181,131,50,144100,55000,199100
290190,202105,379,303,76,333300.07,84700,418000.07
290195,202105,307,197,110,216700,121000,337700
290200,202105,269,219,50,240900,55000,295900
290205,202105,149,93,56,102300,61600,163900
290210,202105,1176,867,309,954800,341000,1295800
290220,202105,184,104,80,114400,88000,202400
290225,202105,288,119,169,130900,185900,316800
290230,202105,80,49,31,53900,34100,88000
290240,202105,363,127,236,139700,260700,400400
290250,202105,258,238,20,262900,22000,284900
290260,202105,322,266,56,292600,61600,354200
290265,202105,188,163,25,179300,27500,206800
290270,202105,1423,1192,231,1311200,254100,1565300
290280,202105,474,335,139,368500,154000,522500
290290,202105,1349,812,537,893200.94,591800,1485000.94
290300,202105,425,363,62,399300,68200,467500
290310,202105,290,136,154,149600,169400,319000
290320,202105,4088,2527,1561,2780800.11,1717100,4497900.11
290323,202105,191,166,25,182600,27500,210100
290327,202105,172,134,38,147400.5,41800,189200.5
290330,202105,113,57,56,62700,61600,124300
290340,202105,798,331,467,364100,514800,878900
290350,202105,653,397,256,436700,281600,718300
290360,202105,347,268,79,294800.99,86900,381700.99
290370,202105,916,399,517,438900,568700,1007600
290380,202105,329,210,119,231000,130900,361900
290390,202105,2412,1508,904,1658800,995500,2654300
290395,202105,242,138,104,151800,114400,266200
290400,202105,278,204,74,224400,81400,305800
290405,202105,247,214,33,235400,36300,271700
290410,202105,623,521,102,574200,113300,687500
290420,202105,257,208,49,228800,55000,283800
290430,202105,456,295,161,324500,177100,501600
290440,202105,79,70,9,77000,9900,86900
290450,202105,192,144,48,159500,52800,212300
290460,202105,1935,1156,779,1272700,858000,2130700
290470,202105,1368,602,766,662200,842600,1504800
290475,202105,557,522,35,574200.27,38500,612700.27
290480,202105,282,162,120,179300,132000,311300
290485,202105,237,216,21,237600,23100,260700
290490,202105,1239,882,357,971300,392700,1364000
290500,202105,739,381,358,419100,393800,812900
290510,202105,213,172,41,189200,45100,234300
290515,202105,160,99,61,108900,67100,176000
290520,202105,1390,903,487,993300,536800.2,1530100.2
290530,202105,298,273,25,303600,27500,331100
290540,202105,106,55,51,60500,56100,116600
290550,202105,169,142,27,156200,29700,185900
290560,202105,3164,1382,1782,1522400,1962400,3484800
290570,202105,6230,3017,3213,3319800,3538700,6858500
290580,202105,1268,755,513,831600,564300,1395900
290590,202105,572,469,103,515900,113300,629200
290600,202105,1770,1217,553,1338700.67,608300,1947000.67
290610,202105,194,179,15,198000,16500,214500
290620,202105,356,323,33,355300,36300,391600
290630,202105,1981,844,1137,929500,1250700,2180200
290640,202105,145,116,29,127600,31900,159500
290650,202105,1800,848,952,932800.92,1047200,1980000.92
290660,202105,284,228,56,250800,61600,312400
290670,202105,939,480,459,528000,504900,1032900
290680,202105,1229,985,244,1083500,268400,1351900
290682,202105,309,232,77,255200.48,84700,339900.48
290685,202105,247,161,86,179300,94600,273900
290687,202105,1081,704,377,774579,414700,1189279
290689,202105,143,76,67,83600,73700,157300
290690,202105,602,256,346,281600,380600,662200
290700,202105,237,119,118,130900,129800,260700
290710,202105,763,523,240,575300,264000,839300
290720,202105,1033,840,193,926200,212300,1138500
290730,202105,1180,680,500,748000,550000,1298000
290740,202105,20,17,3,18700,3300,22000
290750,202105,1393,622,771,684200,849200,1533400
290755,202105,72,65,7,71500,7700,79200
290760,202105,287,248,39,272800,42900,315700
290770,202105,184,172,12,189200,13200,202400
290780,202105,1105,856,249,942700,275000,1217700
290790,202105,375,258,117,283800,128700,412500
290800,202105,2444,996,1448,1096700,1593900,2690600
290810,202105,469,325,144,357500,158400,515900
290820,202105,399,235,164,258500,181500,440000
290830,202105,421,299,122,328900,134200,463100
290840,202105,1771,1106,665,1216600,731500,1948100
290850,202105,865,448,417,492800,458700,951500
290860,202105,642,288,354,316800,389400,706200
290870,202105,622,443,179,487300,196900,684200
290880,202105,118,63,55,69300,60500,129800
290890,202105,416,269,147,295900,161700,457600
290900,202105,168,127,41,139700,45100,184800
290910,202105,385,294,91,323400,100100,423500
290920,202105,208,182,26,200200,28600,228800
290930,202105,820,625,195,687500,214500,902000
290940,202105,242,202,40,222200,44000,266200
290950,202105,159,94,65,103400,71500,174900
290960,202105,474,332,142,365200,156200,521400
290970,202105,248,219,29,242000,33000,275000
290980,202105,1635,1145,490,1260600,539000,1799600
290990,202105,401,338,63,371800,69300,441100
291000,202105,860,269,591,295900,650100,946000
291005,202105,2339,1006,1333,1107700,1466300.42,2574000.42
291010,202105,163,147,16,161700,17600,179300
291020,202105,100,79,21,86900,23100,110000
291030,202105,97,69,28,75900,30800,106700
291040,202105,610,347,263,381700,289300,671000
291050,202105,1460,794,666,873400,732600,1606000
291060,202105,1631,905,726,995500,798600,1794100
291070,202105,1969,1474,495,1621400.82,544501.3,2165902.12
291072,202105,7150,2677,4473,2946900,4924700,7871600
291075,202105,244,199,45,218900,49500,268400
291077,202105,59,40,19,44000,20900,64900
291080,202105,20356,8833,11523,9726200.75,12684100.55,22410301.30
291085,202105,272,224,48,246400,52800,299200
291090,202105,279,118,161,129800,177100,306900
291100,202105,640,196,444,215600,488400,704000
291110,202105,424,328,96,360800,105600,466400
291120,202105,2392,1222,1170,1346400,1288100,2634500
291125,202105,63,30,33,33000,36300,69300
291130,202105,198,175,23,192500,25300,217800
291140,202105,125,102,23,112200,25300,137500
291150,202105,389,146,243,160600,268400,429000
291160,202105,383,312,71,343200,78100,421300
291165,202105,46,36,10,40700,11000,51700
291170,202105,3151,1577,1574,1734700.5,1733600.76,3468301.26
291180,202105,1253,507,746,558800,821700,1380500
291185,202105,100,95,5,104500,5500,110000
291190,202105,1387,645,742,709500,818400,1527900
291200,202105,170,126,44,138600,48400,187000
291210,202105,2327,924,1403,1016400,1543300,2559700
291220,202105,283,215,68,236500,74800,311300
291230,202105,968,330,638,363000,701800,1064800
291240,202105,424,394,30,433400,33000,466400
291250,202105,433,352,81,387200,89100,476300
291260,202105,56,48,8,53900,8800,62700
291270,202105,1042,453,589,498300,647900,1146200
291280,202105,348,165,183,181500,201300,382800
291290,202105,1707,895,812,984500,893200,1877700
291300,202105,224,178,46,196900,50600,247500
291310,202105,226,204,22,224400,24200,248600
291320,202105,1338,942,396,1036200,435600,1471800
291330,202105,130,112,18,123200,19800,143000
291340,202105,212,127,85,139700,93500,233200
291345,202105,130,89,41,97900,45100,143000
291350,202105,1667,599,1068,658900,1174800,1833700
291360,202105,8314,4002,4312,4412100,4753100,9165200
291370,202105,1106,640,466,704000,512600,1216600
291380,202105,261,207,54,227700,59400,287100
291390,202105,3919,1742,2177,1916200,2395800,4312000
291400,202105,2088,1494,594,1643400,656700.42,2300100.42
291410,202105,191,165,26,181500,28600,210100
291420,202105,116,87,29,95700,31900,127600
291430,202105,162,91,71,100100,78100.5,178200.5
291440,202105,528,432,96,475200,105600,580800
291450,202105,934,596,338,655600,371800,1027400
291460,202105,1886,1527,359,1680800,394900,2075700
291465,202105,2206,1046,1160,1150600,1276000,2426600
291470,202105,2839,1436,1403,1579600.55,1545500,3125100.55
291480,202105,11689,5148,6541,5666101.62,7206100,12872201.62
291490,202105,611,243,368,268400,404800,673200
291500,202105,383,229,154,251900,169400,421300
291510,202105,1209,471,738,518100,812900,1331000
291520,202105,940,425,515,467500,566500,1034000
291530,202105,929,249,680,273900,748000,1021900
291535,202105,121,99,22,108900,24200,133100
291540,202105,357,115,242,126500,266200,392700
291550,202105,1276,602,674,662200,741400,1403600
291560,202105,5177,2591,2586,2852300,2850100,5702400
291570,202105,209,106,103,116600,113300,229900
291580,202105,1186,729,457,801900,503800,1305700
291590,202105,93,39,54,42900,59400,102300
291600,202105,1139,559,580,617100,638000,1255100
291610,202105,1447,703,744,774400,818400,1592800
291620,202105,563,267,296,293700,325600,619300
291630,202105,474,149,325,163900,357500,521400
291640,202105,3944,1988,1956,2186800,2152700,4339500
291650,202105,431,292,139,321200.5,152900,474100.5
291660,202105,375,153,222,168300,244200,412500
291670,202105,184,115,69,126500,75900,202400
291680,202105,632,384,248,422400,273900,696300
291685,202105,576,321,255,353100,280500,633600
291690,202105,500,307,193,337700,213400.92,551100.92
291700,202105,1003,779,224,856900,246400,1103300
291710,202105,1604,781,823,860200,905300,1765500
291720,202105,421,285,136,313500,149600,463100
291730,202105,937,546,391,600600,430100,1030700
291733,202105,286,193,93,212300,102300,314600
291735,202105,75,58,17,63800,18700,82500
291740,202105,347,263,84,289300,92400,381700
291750,202105,2232,1464,768,1611500.25,845900.25,2457400.50
291760,202105,2976,1651,1325,1816100,1457500,3273600
291770,202105,759,517,242,568700,266200,834900
291780,202105,62,38,24,41800,26400,68200
291790,202105,152,80,72,88000,79200,167200
291800,202105,10029,4190,5839,4616700.42,6422900,11039600.42
291810,202105,1089,818,271,899800,298100,1197900
291820,202105,273,198,75,218900,82500,301400
291830,202105,1037,421,616,463100.59,678700,1141800.59
291835,202105,557,516,41,567600,45100,612700
291840,202105,4928,2491,2437,2741200,2682900,5424100
291845,202105,264,84,180,92400,198000,290400
291850,202105,320,284,36,312400,39600,352000
291855,202105,253,103,150,113300,165000,278300
291860,202105,169,105,64,115500,70400,185900
291870,202105,81,36,45,39600,49500,89100
291875,202105,178,164,14,180400,15400,195800
291880,202105,439,354,85,389400,93500,482900
291890,202105,248,82,166,90200,182600,272800
291900,202105,57,33,24,36300,26400,62700
291905,202105,119,89,30,97900,33000,130900
291910,202105,158,127,31,139700,34100,173800
291915,202105,434,384,50,422400,55000,477400
291920,202105,5159,2561,2598,2820400,2858900,5679300
291930,202105,167,100,67,110000.27,73700,183700.27
291940,202105,361,210,151,231000,166100,397100
291950,202105,1140,916,224,1009800,246400,1256200
291955,202105,1286,784,502,863500,552200,1415700
291960,202105,197,144,53,158400,58300,216700
291970,202105,754,569,185,625900,203500,829400
291980,202105,1482,1306,176,1436600.73,193600,1630200.73
291990,202105,140,130,10,143000,11000,154000
291992,202105,161,86,75,94600,82500,177100
291995,202105,190,122,68,134200,74800,209000
292000,202105,395,299,96,328900,105600,434500
292010,202105,323,223,100,245300,110000,355300
292020,202105,301,220,81,242000,89100,331100
292030,202105,143,108,35,118800,38500,157300
292040,202105,612,319,293,350900,324500,675400
292045,202105,115,104,11,114400,12100,126500
292050,202105,938,685,253,753500,279400,1032900
292060,202105,901,735,166,808500,182600,991100
292070,202105,59,20,39,22000,44000,66000
292080,202105,141,97,44,106700,48400,155100
292090,202105,530,181,349,200200,383900,584100
292100,202105,1475,633,842,696300,927300,1623600
292105,202105,190,169,21,185900,23100,209000
292110,202105,2247,818,1429,899800,1573000,2472800
292120,202105,697,549,148,603900,162800,766700
292130,202105,446,249,197,273900,216700,490600
292140,202105,213,173,40,190300,44000,234300
292145,202105,161,87,74,95700,81400,177100
292150,202105,1495,1231,264,1354100,291500,1645600
292160,202105,163,134,29,147400,31900,179300
292170,202105,1181,1027,154,1129700,169400,1299100
292180,202105,221,163,58,179300,63800,243100
292190,202105,156,101,55,111100,60500,171600
292200,202105,1366,495,871,544500,960300,1504800
292205,202105,125,108,17,118800,18700,137500
292210,202105,374,257,117,282700,128700,411400
292220,202105,33,24,9,26400,9900,36300
292225,202105,41,34,7,37400,7700,45100
292230,202105,964,750,214,825000,236500,1061500
292240,202105,619,448,171,492800,188100,680900
292250,202105,1676,1094,582,1203400,641300,1844700
292260,202105,396,237,159,260700,174900,435600
292265,202105,246,180,66,198000,73700,271700
292270,202105,724,340,384,374000,422400,796400
292273,202105,208,118,90,129800,99000,228800
292275,202105,170,86,84,94600,92400,187000
292280,202105,142,100,42,110000,46200,156200
292285,202105,82,67,15,73700,16500,90200
292290,202105,577,389,188,427900,206800,634700
292300,202105,1732,648,1084,712800,1192400,1905200
292303,202105,122,78,44,85800,48400,134200
292305,202105,121,90,31,99000,34100,133100
292310,202105,930,607,323,667700,355300,1023000
292320,202105,589,446,143,490600,157300,647900
292330,202105,172,101,71,111100,78100,189200
292335,202105,278,219,59,240900,64900,305800
292340,202105,570,396,174,435600,191400,627000
292350,202105,269,149,120,163900,132000,295900
292360,202105,705,539,166,594000,182600,776600
292370,202105,745,572,173,629200,190300,819500
292380,202105,628,513,115,564300,126500,690800
292390,202105,397,159,238,174900,261800,436700
292400,202105,3599,2239,1360,2462900,1497100,3960000
292405,202105,270,178,92,195800,102300,298100
292410,202105,130,80,50,88000,55000,143000
292420,202105,295,257,38,282700,41800,324500
292430,202105,539,406,133,447700,146300,594000
292440,202105,616,519,97,570900.56,106700,677600.56
292450,202105,243,191,52,210100,57200,267300
292460,202105,547,408,139,449900,152900,602800
292465,202105,208,175,33,192500,36300,228800
292467,202105,139,84,55,92400,60500,152900
292470,202105,297,200,97,220000,106700,326700
292480,202105,384,264,120,290400,132000,422400
292490,202105,240,172,68,189200,74800,264000
292500,202105,860,393,467,432300.32,514800,947100.32
292510,202105,3474,1620,1854,1784200,2039400.17,3823600.17
292520,202105,1102,514,588,565400,646800,1212200
292525,202105,409,291,118,320100,129800,449900
292530,202105,4474,1786,2688,1964600.65,2961200,4925800.65
292540,202105,479,270,209,297000,229900,526900
292550,202105,1096,577,519,634700,570900,1205600
292560,202105,330,306,24,336600,26400,363000
292570,202105,313,243,70,267300,78100,345400
292575,202105,493,332,161,365200,177100,542300
292580,202105,993,659,334,724900,368500,1093400
292590,202105,564,494,70,543400,77000,620400
292593,202105,142,111,31,122100,34100,156200
292595,202105,200,158,42,173800,46200,220000
292600,202105,1259,920,339,1012000.63,372900,1384900.63
292610,202105,129,100,29,111100,31900,143000
292620,202105,532,452,80,497200,88000,585200
292630,202105,1481,824,657,906400,722700,1629100
292640,202105,846,589,257,649000,282700,931700
292650,202105,189,155,34,170500.5,37400,207900.5
292660,202105,1996,1421,575,1564200,632500.92,2196700.92
292665,202105,142,103,39,113300,42900,156200
292670,202105,403,320,83,352000,91300,443300
292680,202105,258,192,66,211200,72600,283800
292690,202105,197,141,56,155100,61600,216700
292700,202105,978,647,331,711700.9,364100,1075800.9
292710,202105,114,99,15,110000,16500,126500
292720,202105,933,527,406,580800,446600,1027400
292730,202105,196,93,103,102300,113300,215600
292740,202105,69729,33965,35764,37403302.61,39392100.88,76795403.49
292750,202105,392,280,112,309100,123200,432300
292760,202105,339,284,55,312400,60500,372900
292770,202105,833,357,476,393800,523600,917400
292780,202105,402,154,248,169400,272800,442200
292790,202105,775,403,372,443300,409200,852500
292800,202105,1263,754,509,829400,559900,1389300
292805,202105,392,123,269,135300,298100,433400
292810,202105,1514,861,653,947100,718300,1665400
292820,202105,714,602,112,662200,123200,785400
292830,202105,115,91,24,100100,26400,126500
292840,202105,689,562,127,619300,139700,759000
292850,202105,139,92,47,101200,51700,152900
292860,202105,2124,1240,884,1366200,973500,2339700
292870,202105,3520,2345,1175,2580600,1292500,3873100
292880,202105,1484,982,502,1081300,553300,1634600
292890,202105,528,444,84,488400,92400,580800
292895,202105,143,95,48,104500,52800,157300
292900,202105,370,265,105,291500,115500,407000
292905,202105,486,241,245,265100,269500,534600
292910,202105,462,347,115,381700,126500,508200
292920,202105,525,228,297,250800,327800,578600
292925,202105,492,451,41,496100,45100,541200
292930,202105,630,379,251,416900,276100,693000
292935,202105,288,121,167,133100,183700,316800
292937,202105,222,154,68,169400,74800,244200
292940,202105,190,146,44,160600,48400,209000
292950,202105,1181,594,587,653400,647900.6,1301300.6
292960,202105,564,395,169,434500,187000,621500
292970,202105,235,165,70,181500.48,77000,258500.48
292975,202105,103,61,42,67100,46200,113300
292980,202105,297,199,98,218900.61,107800,326700.61
292990,202105,1331,986,345,1085700,379500,1465200
293000,202105,111,78,33,85800,37400,123200
293010,202105,2854,1694,1160,1864500,1276000.8,3140500.8
293015,202105,633,517,116,568700,127600,696300
293020,202105,332,273,59,300300,64900,365200
293030,202105,598,523,75,575300,82500,657800
293040,202105,369,294,75,323400,82500,405900
293050,202105,2880,1705,1175,1875500,1292500,3168000
293060,202105,256,204,52,224400.48,58300,282700.48
293070,202105,3523,1770,1753,1948100.18,1928300,3876400.18
293075,202105,90,61,29,67100,31900,99000
293076,202105,75,55,20,60500,22000,82500
293077,202105,549,318,231,349800,255200,605000
293080,202105,428,383,45,421300,49500,470800
293090,202105,130,117,13,128700,14300,143000
293100,202105,525,366,159,402600,174900,577500
293105,202105,342,251,91,276100,101200,377300
293110,202105,119,85,34,93500,38500,132000
293120,202105,302,205,97,225500,107800,333300
293130,202105,251,169,82,185900,90200,276100
293135,202105,8065,3137,4928,3450700,5424100,8874800
293140,202105,190,116,74,127600,81400,209000
293150,202105,314,272,42,299200,46200,345400
293160,202105,422,250,172,275000,189200,464200
293170,202105,193,126,67,138600,73700,212300
293180,202105,544,379,165,418000,181500,599500
293190,202105,1345,934,411,1028500.7,452100,1480600.7
293200,202105,559,490,69,539000,75900,614900
293210,202105,402,307,95,337700,104500,442200
293220,202105,2435,1047,1388,1151700,1527900,2679600
293230,202105,1865,690,1175,759000.1,1292500,2051500.1
293240,202105,237,216,21,237600,23100,260700
293245,202105,128,107,21,117700,23100,140800
293250,202105,738,276,462,303600.22,510400,814000.22
293260,202105,306,253,53,278300,58300,336600
293270,202105,1143,525,618,578600,682000,1260600
293280,202105,293,169,124,185900,136400,322300
293290,202105,3022,1964,1058,2160400,1164900,3325300
293300,202105,766,537,229,590700,251900,842600
293305,202105,200,158,42,174900,47300,222200
293310,202105,159,120,39,132000,42900,174900
293315,202105,166,129,37,141900,40700,182600
293317,202105,89,65,24,71500,26400,97900
293320,202105,1073,590,483,649001.14,531300,1180301.14
293325,202105,186,69,117,75900,128700,204600
293330,202105,13690,6355,7335,6992700.38,8080600,15073300.38
293340,202105,284,197,87,216700,95700,312400
293345,202105,255,207,48,227700,52800,280500
293350,202105,601,356,245,391600,269500,661100
293360,202105,1519,1090,429,1199000,471900,1670900
310010,202105,143,76,67,83600,73700,157300
310020,202105,1030,561,469,617100,515900,1133000
310030,202105,324,258,66,283800,72600,356400
310040,202105,41,27,14,29700,15400,45100
310050,202105,167,105,62,115500,68200,183700
310060,202105,257,177,80,194700,89100,283800
310070,202105,14,9,5,9900,5500,15400
310080,202105,42,26,16,28600,17600,46200
310090,202105,1039,552,487,607200,536800,1144000
310100,202105,310,224,86,246400,95700,342100
310110,202105,709,386,323,424600,355300,779900
310120,202105,387,221,166,244200,182600,426800
310130,202105,31,17,14,18700,15400,34100
310140,202105,24,10,14,11000,15400,26400
310150,202105,1166,783,383,861300,422400,1283700
310160,202105,2046,992,1054,1092300.22,1159400,2251700.22
310163,202105,85,44,41,48400,45100,93500
310170,202105,2525,1117,1408,1228700,1549900,2778600
310180,202105,159,58,101,63800,111100,174900
310190,202105,486,334,152,367400,168300,535700
310200,202105,480,305,175,335500,193600,529100
310205,202105,59,38,21,41800,23100,64900
310210,202105,281,229,52,251900,57200,309100
310220,202105,62,35,27,38500,29700,68200
310230,202105,276,189,87,207900,95700,303600
310240,202105,107,93,14,102300,15400,117700
310250,202105,98,79,19,88000,20900,108900
310260,202105,740,390,350,429000.92,385000,814000.92
310270,202105,266,168,98,184800,107800,292600
310280,202105,370,271,99,298100,108900,407000
310285,202105,206,151,55,166100,60500,226600
310290,202105,237,135,102,148500,112200,260700
310300,202105,173,140,33,154000,36300,190300
310310,202105,10,7,3,7700,3300,11000
310320,202105,25,9,16,9900,17600,27500
310330,202105,40,26,14,28600,15400,44000
310340,202105,1805,1202,603,1325500,663300,1988800
310350,202105,2766,1472,1294,1619200,1423400.07,3042600.07
310360,202105,43,35,8,38500,8800,47300
310370,202105,128,106,22,116600,24200,140800
310375,202105,102,36,66,40700,72600,113300
310380,202105,49,29,20,31900,22000,53900
310390,202105,104,67,37,73700,40700,114400
310400,202105,2399,1543,856,1700600,944900,2645500
310410,202105,126,73,53,80300,58300,138600
310420,202105,659,340,319,374000,350900,724900
310430,202105,282,174,108,191400,118800,310200
310440,202105,72,41,31,45100,34100,79200
310445,202105,77,64,13,70400,14300,84700
310450,202105,626,392,234,431200,257400,688600
310460,202105,249,172,77,189200,84700,273900
310470,202105,511,326,185,358600,203500,562100
310480,202105,84,53,31,58300,34100,92400
310490,202105,532,242,290,266200,320100,586300
310500,202105,133,51,82,56100,90200,146300
310510,202105,604,424,180,467500,199100,666600
310520,202105,138,97,41,106700,45100,151800
310530,202105,108,43,65,47300,71500,118800
310540,202105,465,266,199,293700,218900,512600
310550,202105,74,46,28,50600,30800,81400
310560,202105,2958,2022,936,2226400,1029600,3256000
310570,202105,95,60,35,66000,38500,104500
310590,202105,367,231,136,257400,149600,407000
310600,202105,149,81,68,90200,74800,165000
310610,202105,56,21,35,23100,38500,61600
310620,202105,46969,22214,24755,24472717.5,27262400,51735117.5
310630,202105,663,404,259,444400,284900,729300
310640,202105,124,96,28,105600,30800,136400
310650,202105,157,140,17,155100,18700,173800
310660,202105,102,71,31,78100,34100,112200
310665,202105,62,46,16,50600,17600,68200
310670,202105,6770,2879,3891,3171300.7,4284500,7455800.7
310680,202105,63,38,25,41800,28600,70400
310690,202105,617,434,183,477400,201300,678700
310700,202105,62,39,23,42900,25300,68200
310710,202105,1325,899,426,988900,469700,1458600
310720,202105,139,35,104,38500,114400,152900
310730,202105,1480,1012,468,1114300,515900,1630200
310740,202105,990,548,442,602800,487300,1090100
310750,202105,243,150,93,165000,102300,267300
310760,202105,69,53,16,58300,18700,77000
310770,202105,92,45,47,50600,51700,102300
310780,202105,351,281,70,309100,77000,386100
310790,202105,105,85,20,93500,22000,115500
310800,202105,453,208,245,228800,269500,498300
310810,202105,172,119,53,130900.72,58300,189200.72
310820,202105,330,261,69,287100,75900,363000
310825,202105,202,172,30,189200,33000,222200
310830,202105,473,224,249,246400,273900,520300
310840,202105,362,213,149,234300,163900,398200
310850,202105,81,67,14,73700,15400,89100
310855,202105,402,312,90,343200,100100,443300
310860,202105,1592,1172,420,1290300,463100,1753400
310870,202105,52,43,9,47300,9900,57200
310880,202105,84,66,18,72600,19800,92400
310890,202105,307,174,133,191400,146300,337700
310900,202105,639,279,360,306907.2,396010.8,702918.0
310910,202105,236,159,77,176000,84700,260700
310920,202105,452,263,189,289300,209000,498300
310925,202105,34,28,6,30800,6600,37400
310930,202105,1289,832,457,915200,502700,1417900
310940,202105,690,344,346,378400,381700,760100
310945,202105,120,77,43,84700,47300,132000
310950,202105,231,186,45,204600,49500,254100
310960,202105,75,24,51,26400,56100,82500
310970,202105,169,105,64,115500,70400,185900
310980,202105,49,31,18,34100,19800,53900
310990,202105,166,85,81,94600,89100,183700
311000,202105,816,396,420,435600.1,462000,897600.1
311010,202105,49,43,6,47300,6600,53900
311020,202105,43,23,20,25300,22000,47300
311030,202105,391,222,169,244200,187000,431200
311040,202105,43,34,9,37400,9900,47300
311050,202105,470,177,293,194700,322300,517000
311060,202105,775,425,350,467500,385000,852500
311070,202105,335,146,189,160600,207900,368500
311080,202105,110,62,48,68200,52800,121000
311090,202105,339,159,180,174900,198000,372900
311100,202105,573,337,236,370700,259600,630300
311110,202105,694,491,203,540100,223300,763400
311115,202105,75,53,22,58300,24200,82500
311120,202105,1059,561,498,618200,551100,1169300
311130,202105,313,184,129,202400,141900,344300
311140,202105,159,83,76,91300,83600,174900
311150,202105,343,220,123,242000,136400,378400
311160,202105,712,505,207,556600,227700,784300
311170,202105,87,70,17,77000,18700,95700
311180,202105,297,198,99,217800,108900,326700
311190,202105,43,18,25,19800,27500,47300
311200,202105,344,242,102,268400,112200,380600
311205,202105,34,25,9,27500,9900,37400
311210,202105,41,36,5,39600,5500,45100
311220,202105,28,24,4,26400,4400,30800
311230,202105,1630,1076,554,1183600,609400,1793000
311240,202105,192,121,71,133100,78100,211200
311250,202105,54,21,33,23100,36300,59400
311260,202105,552,352,200,387200,223300,610500
311265,202105,128,88,40,96800,44000,140800
311270,202105,288,199,89,218900,97900,316800
311280,202105,196,89,107,97900,117700,215600
311290,202105,101,83,18,91300,19800,111100
311300,202105,578,366,212,403700,233200,636900
311310,202105,20,16,4,17600,4400,22000
311320,202105,643,478,165,525800,181500,707300
311330,202105,1056,771,285,848100,313500,1161600
311340,202105,2610,1846,764,2030600,841500,2872100
311350,202105,271,211,60,233200,66000,299200
311360,202105,184,108,76,119900,84700,204600
311370,202105,1233,507,726,557700,798600,1356300
311380,202105,5,4,1,4400,1100,5500
311390,202105,255,141,114,155100,125400,280500
311400,202105,135,82,53,90200,58300,148500
311410,202105,109,56,53,61600,58300,119900
311420,202105,300,163,137,180400,150700,331100
311430,202105,834,554,280,611600,308000,919600
311440,202105,460,322,138,355300,151800,507100
311450,202105,300,180,120,198000,132000,330000
311455,202105,276,187,89,205700,97900,303600
311460,202105,138,60,78,66000,85800,151800
311470,202105,27,14,13,15400,14300,29700
311480,202105,48,23,25,25300,27500,52800
311490,202105,13,9,4,9900,4400,14300
311500,202105,25,12,13,13200,15400,28600
311510,202105,657,450,207,496100,227700,723800
311520,202105,40,31,9,34100,9900,44000
311530,202105,1803,1306,497,1438800,546700,1985500
311535,202105,63,42,21,46200,23100,69300
311540,202105,34,29,5,31900,5500,37400
311545,202105,163,118,45,130900,49500,180400
311547,202105,43,34,9,37400,9900,47300
311550,202105,671,301,370,332200,407000,739200
311560,202105,42,27,15,29700,16500,46200
311570,202105,282,188,94,207900,103400,311300
311580,202105,369,218,151,239800,167200,407000
311590,202105,31,26,5,28600,5500,34100
311600,202105,102,81,21,89100,23100,112200
311610,202105,245,209,36,229900,39600,269500
311615,202105,113,91,22,100100,24200,124300
311620,202105,25,15,10,16500,11000,27500
311630,202105,86,74,12,81400,13200,94600
311640,202105,139,69,70,75900,77000,152900
311650,202105,124,85,39,93500,42900,136400
311660,202105,404,194,210,213400,231000,444400
311670,202105,143,95,48,104500,52800,157300
311680,202105,210,158,52,173800,57200,231000
311690,202105,16,12,4,13200,4400,17600
311700,202105,190,136,54,149600,59400,209000
311710,202105,186,125,61,137500,67100,204600
311720,202105,38,29,9,31900,9900,41800
311730,202105,571,389,182,427900,200200,628100
311740,202105,25,17,8,18700,8800,27500
311750,202105,726,490,236,540100.7,259600,799700.7
311760,202105,69,30,39,33000,42900,75900
311770,202105,382,187,195,205700,214500,420200
311780,202105,184,92,92,101200,102300,203500
311783,202105,91,82,9,90200,9900,100100
311787,202105,34,12,22,13200,24200,37400
311790,202105,265,113,152,124300,167200,291500
311800,202105,673,433,240,477400,264000,741400
311810,202105,51,41,10,45100,11000,56100
311820,202105,121,99,22,110000,25300,135300
311830,202105,1870,1141,729,1255100,803000,2058100
311840,202105,998,555,443,610500,487300,1097800
311850,202105,14,10,4,11000,4400,15400
311860,202105,9508,4058,5450,4473700,6008200,10481900
311870,202105,117,63,54,69300,59400,128700
311880,202105,933,674,259,741400,284900,1026300
311890,202105,204,99,105,108809,115500,224309
311900,202105,70,28,42,30800,46200,77000
311910,202105,1366,855,511,940500,563200,1503700
311920,202105,229,152,77,167200,84700,251900
311930,202105,893,506,387,556600,426800,983400
311940,202105,2537,1335,1202,1470700,1325500,2796200
311950,202105,63,43,20,47300,22000,69300
311960,202105,61,45,16,50600,17600,68200
311970,202105,24,14,10,15400,11000,26400
311980,202105,44,34,10,37400,11000,48400
311990,202105,36,28,8,30800,8800,39600
311995,202105,52,31,21,35200,23100,58300
312000,202105,22,15,7,16500,7700,24200
312010,202105,76,59,17,64900,18700,83600
312015,202105,70,53,17,58300,18700,77000
312020,202105,128,86,42,94600,46200,140800
312030,202105,63,47,16,51700,17600,69300
312040,202105,76,50,26,55000,28600,83600
312050,202105,202,114,88,125400,96800,222200
312060,202105,22,13,9,14300,9900,24200
312070,202105,80,52,28,57200,30800,88000
312080,202105,532,245,287,269500,315700,585200
312083,202105,60,38,22,41800,24200,66000
312087,202105,96,74,22,82500,24200,106700
312090,202105,3236,1954,1282,2150500,1415700,3566200
312100,202105,147,102,45,111947,49500,161447
312110,202105,116,66,50,72600,55000,127600
312120,202105,131,97,34,106700.63,37400,144100.63
312125,202105,89,51,38,56100,41800,97900
312130,202105,134,88,46,97900,50600,148500
312140,202105,136,106,30,116600,33000,149600
312150,202105,41,32,9,35200,9900,45100
312160,202105,1536,1012,524,1113299,576400,1689699
312170,202105,10,8,2,8800,2200,11000
312180,202105,113,72,41,79200,45100,124300
312190,202105,37,33,4,36300,4400,40700
312200,202105,752,645,107,709500,117700,827200
312210,202105,120,65,55,71500,61600,133100
312220,202105,131,101,30,111100,33000,144100
312230,202105,3658,1675,1983,1845800,2183500,4029300
312235,202105,153,103,50,113300,55000,168300
312240,202105,88,62,26,68200,28600,96800
312245,202105,193,130,63,143000,69300,212300
312247,202105,76,53,23,60500,25300,85800
312250,202105,170,84,86,92400,94600,187000
312260,202105,108,73,35,80300,38500,118800
312270,202105,131,78,53,85800,58300,144100
312280,202105,30,15,15,16500,16500,33000
312290,202105,141,95,46,104500,50600,155100
312300,202105,206,135,71,148500,78100,226600
312310,202105,64,56,8,61600,8800,70400
312320,202105,421,263,158,289300,174900,464200
312330,202105,89,78,11,85800,12100,97900
312340,202105,35,16,19,17600,20900,38500
312350,202105,14,8,6,8800,6600,15400
312352,202105,95,70,25,77000,27500,104500
312360,202105,563,238,325,262900,359700,622600
312370,202105,317,178,139,195800,152900,348700
312380,202105,138,92,46,102300,51700,154000
312385,202105,156,127,29,139700,31900,171600
312390,202105,294,188,106,207900,116600,324500
312400,202105,382,281,101,309100,111100,420200
312410,202105,1053,330,723,364100,795300,1159400
312420,202105,623,474,149,521400,163900,685300
312430,202105,877,635,242,698501.13,266200,964701.13
312440,202105,39,30,9,33000,9900,42900
312450,202105,199,128,71,140800,78100,218900
312460,202105,30,15,15,16500,16500,33000
312470,202105,43,28,15,30800,16500,47300
312480,202105,178,109,69,119900,75900,195800
312490,202105,278,189,89,207900,97900,305800
312500,202105,35,20,15,22000,16500,38500
312510,202105,517,195,322,214500,354200,568700
312520,202105,30,9,21,9900,23100,33000
312530,202105,46,32,14,35200,15400,50600
312540,202105,90,79,11,88000,12100,100100
312550,202105,38,30,8,33000,8800,41800
312560,202105,203,154,49,169400,53900,223300
312570,202105,431,254,177,279400,195800,475200
312580,202105,96,51,45,56100,49500,105600
312590,202105,240,192,48,211200,52800,264000
312595,202105,131,114,17,125400,18700,144100
312600,202105,69,36,33,39600,36300,75900
312610,202105,1594,822,772,905300,849200,1754500
312620,202105,221,159,62,174900,68200,243100
312630,202105,71,57,14,62700,15400,78100
312640,202105,41,11,30,12100,33000,45100
312650,202105,147,122,25,134570.7,27500,162070.7
312660,202105,93,65,28,71500.01,30800,102300.01
312670,202105,927,600,327,661100,361900,1023000
312675,202105,27,22,5,24200,5500,29700
312680,202105,72,42,30,46200,33000,79200
312690,202105,237,119,118,132000,129800,261800
312695,202105,29,25,4,27500,4400,31900
312700,202105,226,130,96,143000,105600,248600
312705,202105,82,66,16,72600,17600,90200
312707,202105,134,95,39,104500,42900,147400
312710,202105,1852,1002,850,1103300.59,939400,2042700.59
312720,202105,54,30,24,33000,26400,59400
312730,202105,277,161,116,177100,127600,304700
312733,202105,49,37,12,40700,13200,53900
312735,202105,20,13,7,14300,7700,22000
312737,202105,64,33,31,36300,34100,70400
312738,202105,59,38,21,41800,23100,64900
312740,202105,82,54,28,59400,30800,90200
312750,202105,90,64,26,71500,28600,100100
312760,202105,290,208,82,228800,90200,319000
312770,202105,8220,3754,4466,4134900,4915900,9050800
312780,202105,443,337,106,370700,116600,487300
312790,202105,22,15,7,16500,7700,24200
312800,202105,1610,1131,479,1244100,526900,1771000
312810,202105,363,238,125,261800,137500,399300
312820,202105,185,142,43,156200,47300,203500
312825,202105,31,21,10,23100,11000,34100
312830,202105,217,130,87,143000,95700,238700
312840,202105,161,107,54,118800,59400,178200
312850,202105,43,37,6,40700,6600,47300
312860,202105,148,93,55,102300,60500,162800
312870,202105,1056,541,515,596200,567600,1163800
312880,202105,122,85,37,93500,40700,134200
312890,202105,157,112,45,123200,49500,172700
312900,202105,186,138,48,152900,52800,205700
312910,202105,177,94,83,103400,91300,194700
312920,202105,138,78,60,85800,66000,151800
312930,202105,322,226,96,248600,105600,354200
312940,202105,124,85,39,93500,42900,136400
312950,202105,693,472,221,521400,243100,764500
312960,202105,154,116,38,127600,41800,169400
312965,202105,89,70,19,77000,20900,97900
312970,202105,282,233,49,256300.92,53900,310200.92
312980,202105,2470,1243,1227,1367300,1353000,2720300
312990,202105,49,25,24,27500,26400,53900
313000,202105,54,28,26,30800,28600,59400
313005,202105,181,137,44,150700,48400,199100
313010,202105,915,364,551,400400,606100,1006500
313020,202105,200,105,95,115500,104500,220000
313030,202105,201,130,71,143000,78100,221100
313040,202105,78,25,53,27500,58300,85800
313050,202105,186,134,52,147400,57200,204600
313055,202105,39,29,10,31900,11000,42900
313060,202105,132,89,43,97900,47300,145200
313065,202105,63,46,17,50600,18700,69300
313070,202105,133,69,64,75900,70400,146300
313080,202105,38,17,21,18700,23100,41800
313090,202105,660,426,234,468600,257400,726000
313100,202105,188,63,125,69300,137500,206800
313110,202105,146,74,72,82500,79200,161700
313115,202105,213,117,96,128700,105600,234300
313120,202105,832,467,365,515900,401500,917400
313130,202105,5872,3192,2680,3513400,2951300,6464700
313140,202105,135,74,61,81400,67100,148500
313150,202105,294,233,61,256300,67100,323400
313160,202105,186,140,46,154000,50600,204600
313170,202105,1397,926,471,1020800,518100,1538900
313180,202105,301,178,123,195800,135300,331100
313190,202105,732,436,296,480700,326700,807400
313200,202105,30,25,5,27500,5500,33000
313210,202105,996,848,148,932800,162800,1095600
313220,202105,287,174,113,191400,124300,315700
313230,202105,255,197,58,216700.5,63800,280500.5
313240,202105,2146,1095,1051,1205600,1160500,2366100
313250,202105,1260,958,302,1053800,332200,1386000
313260,202105,91,45,46,49500,50600,100100
313270,202105,988,570,418,630300,459800,1090100
313280,202105,49,41,8,45100,8800,53900
313290,202105,211,170,41,187000,45100,232100
313300,202105,340,175,165,192500,181500,374000
313310,202105,251,114,137,126500,150700,277200
313320,202105,385,283,102,311300,112200,423500
313330,202105,1408,860,548,947100.42,602800,1549900.42
313340,202105,319,226,93,248600,102300,350900
313350,202105,478,315,163,346500,179300,525800
313360,202105,153,71,82,78100,90200,168300
313370,202105,221,70,151,77000,166100,243100
313375,202105,296,175,121,192500,133100,325600
313380,202105,1336,690,646,761200,710600,1471800
313390,202105,47,44,3,48400,3300,51700
313400,202105,389,264,125,290400,137500,427900
313410,202105,27,14,13,15400,14300,29700
313420,202105,4538,2438,2100,2685100,2310000,4995100
313430,202105,138,67,71,73700,79200,152900
313440,202105,1397,969,428,1067001.13,471900,1538901.13
313450,202105,68,30,38,33000,42900,75900
313460,202105,378,164,214,180400,235400,415800
313470,202105,529,251,278,276100,305800,581900
313480,202105,143,103,40,113300,44000,157300
313490,202105,516,238,278,261800,305800,567600
313500,202105,29,16,13,17600,14300,31900
313505,202105,1038,812,226,893200,248600,1141800
313507,202105,97,57,40,62700,44000,106700
313510,202105,2850,1792,1058,1974597.1,1163800,3138397.1
313520,202105,3444,2691,753,2961201.5,829400,3790601.5
313530,202105,33,22,11,24200,12100,36300
313535,202105,65,52,13,57200,14300,71500
313540,202105,70,51,19,56100,20900,77000
313545,202105,118,100,18,110000,19800,129800
313550,202105,226,189,37,207900,40700,248600
313560,202105,338,164,174,180400,191400,371800
313570,202105,66,20,46,22000,50600,72600
313580,202105,1312,732,580,806300,638000,1444300
313590,202105,69,38,31,41800,34100,75900
313600,202105,677,405,272,445500,299200,744700
313610,202105,57,45,12,49500,13200,62700
313620,202105,1373,674,699,741400,772200,1513600
313630,202105,1594,1204,390,1325500,429000,1754500
313640,202105,121,72,49,79200,53900,133100
313650,202105,228,105,123,115500,136400,251900
313652,202105,22,22,0,24200,0,24200
313655,202105,67,42,25,46200,27500,73700
313657,202105,45,41,4,45100,4400,49500
313660,202105,130,86,44,94600,48419.8,143019.8
313665,202105,642,290,352,321200,388300,709500
313670,202105,10306,7027,3279,7744000,3617900,11361900
313680,202105,44,33,11,36300,12100,48400
313690,202105,135,100,35,110000,38500,148500
313695,202105,70,53,17,58300,18700,77000
313700,202105,318,250,68,275000,74800,349800
313710,202105,135,98,37,107800,40700,148500
313720,202105,1119,518,601,570900,665500,1236400
313730,202105,72,42,30,46200,33000,79200
313740,202105,145,117,28,128700,30800,159500
313750,202105,420,300,120,330000,132000,462000
313753,202105,222,163,59,180400,64900,245300
313760,202105,1318,473,845,520300,931700,1452000
313770,202105,387,272,115,299200,126500,425700
313780,202105,793,410,383,451000,421300,872300
313790,202105,28,27,1,29700,1100,30800
313800,202105,143,86,57,94600,62700,157300
313810,202105,81,48,33,52800,36300,89100
313820,202105,1323,621,702,685300,773300,1458600
313830,202105,54,40,14,44000,15400,59400
313835,202105,57,48,9,52800,9900,62700
313840,202105,1647,975,672,1073600,739200,1812800
313850,202105,210,81,129,89100,141900,231000
313860,202105,463,353,110,388300,121000,509300
313862,202105,162,105,57,115500,62700,178200
313865,202105,130,95,35,104500,38500,143000
313867,202105,53,43,10,47300,11000,58300
313868,202105,37,22,15,24200,16500,40700
313870,202105,108,58,50,63800,55000,118800
313880,202105,377,230,147,253000,161700,414700
313890,202105,327,170,157,187000,172700,359700
313900,202105,849,460,389,507100.66,427900,935000.66
313910,202105,148,100,48,110000,52800,162800
313920,202105,629,437,192,480700,211200.94,691900.94
313925,202105,33,28,5,30800,5500,36300
313930,202105,864,673,191,741400,211200,952600
313940,202105,1868,1138,730,1251800,803000,2054800
313950,202105,866,540,326,595100,359700,954800
313960,202105,1413,809,604,889900.08,664400,1554300.08
313970,202105,174,112,62,124300,68200,192500
313980,202105,198,129,69,141900,75900,217800
313990,202105,238,155,83,170500,92400,262900
314000,202105,878,575,303,632500,333300,965800
314010,202105,76,44,32,48400,35200,83600
314015,202105,69,18,51,19800,56100,75900
314020,202105,54,32,22,35200,24200,59400
314030,202105,72,33,39,36300,42900,79200
314040,202105,51,29,22,31900,24200,56100
314050,202105,286,169,117,185900,128700,314600
314053,202105,104,65,39,71500,42900,114400
314055,202105,294,183,111,201300,122100,323400
314060,202105,132,116,16,127600.83,17600,145200.83
314070,202105,1027,512,515,563200,566500,1129700
314080,202105,207,131,76,144100,84700,228800
314085,202105,154,102,52,112200,57200,169400
314090,202105,379,267,112,294800,123200,418000
314100,202105,512,413,99,454300,108900,563200
314110,202105,774,366,408,404800,448800,853600
314120,202105,74,42,32,46200,35200,81400
314130,202105,24,14,10,15400,11000,26400
314140,202105,1091,673,418,741400,460900,1202300
314150,202105,188,122,66,134200,72600,206800
314160,202105,329,245,84,269500,92400,361900
314170,202105,84,64,20,70400,22000,92400
314180,202105,733,644,89,708400,97900,806300
314190,202105,91,54,37,59400,40700,100100
314200,202105,499,340,159,374000,174900,548900
314210,202105,245,185,60,203500,66000,269500
314220,202105,289,208,81,228800,89100,317900
314225,202105,60,43,17,47300,18700,66000
314230,202105,112,48,64,52800,70400,123200
314240,202105,150,111,39,122100,42900,165000
314250,202105,58,34,24,37400,26400,63800
314260,202105,216,105,111,115500,122100,237600
314270,202105,395,307,88,337700,96800,434500
314280,202105,727,388,339,426750.5,372900,799650.5
314290,202105,543,430,113,473000,124300,597300
314300,202105,349,257,92,282700,101200,383900
314310,202105,1349,930,419,1023275.5,460900,1484175.5
314315,202105,38,29,9,31900,9900,41800
314320,202105,578,386,192,425700,212300,638000
314330,202105,11276,5507,5769,6063200,6355800,12419000
314340,202105,590,262,328,289300,364100,653400
314345,202105,52,36,16,39600,17600,57200
314350,202105,174,108,66,118800,72600,191400
314360,202105,61,36,25,39600,27500,67100
314370,202105,71,48,23,52800,25300,78100
314380,202105,99,61,38,67100,41800,108900
314390,202105,3305,2109,1196,2324300,1315600,3639900
314400,202105,688,486,202,534600,222200,756800
314410,202105,486,317,169,348700,187000,535700
314420,202105,16,8,8,8800,8800,17600
314430,202105,2436,895,1541,985601.51,1697300,2682901.51
314435,202105,182,107,75,117700,82500,200200
314437,202105,29,22,7,24200,7700,31900
314440,202105,96,65,31,71500,34100,105600
314450,202105,164,113,51,124300,56100,180400
314460,202105,636,305,331,335500,364100,699600
314465,202105,99,61,38,67100,41800,108900
314467,202105,72,57,15,62700,16500,79200
314470,202105,402,200,202,220000,222200,442200
314480,202105,1011,458,553,504900,608300,1113200
314490,202105,45,28,17,30800,18700,49500
314500,202105,279,193,86,212300,94600,306900
314505,202105,110,67,43,73700,47300,121000
314510,202105,247,202,45,223300,49500,272800
314520,202105,1299,697,602,766700,662200,1428900
314530,202105,733,582,151,642400.7,166100,808500.7
314535,202105,166,102,64,112200,70400,182600
314537,202105,63,37,26,40700,28600,69300
314540,202105,16,10,6,11000,6600,17600
314545,202105,53,35,18,38500,19800,58300
314550,202105,78,41,37,45100,40700,85800
314560,202105,849,457,392,502700,432300,935000
314570,202105,20,15,5,16500,5500,22000
314580,202105,13,5,8,5500,8800,14300
314585,202105,24,16,8,17600,8800,26400
314587,202105,81,69,12,75900,13200,89100
314590,202105,557,391,166,430100,182600,612700
314600,202105,946,598,348,658900,382800,1041700
314610,202105,926,470,456,517000,501600,1018600
314620,202105,139,103,36,113300,39600,152900
314625,202105,95,69,26,77000,28600,105600
314630,202105,1149,610,539,674300,592900,1267200
314640,202105,83,53,30,58300,33000,91300
314650,202105,169,94,75,103400,82500,185900
314655,202105,61,45,16,49500,17600,67100
314660,202105,16,13,3,14300,3300,17600
314670,202105,197,151,46,166100,50600,216700
314675,202105,209,125,84,137500,92400,229900
314690,202105,592,313,279,344300,308000,652300
314700,202105,2256,1200,1056,1323300,1162700,2486000
314710,202105,1746,988,758,1089000,836000,1925000
314720,202105,388,221,167,244200,183700,427900
314730,202105,511,271,240,298100,264000,562100
314740,202105,744,349,395,385000,434500,819500
314750,202105,19,15,4,16500,4400,20900
314760,202105,361,159,202,174900,222200,397100
314770,202105,106,71,35,78100,38500,116600
314780,202105,23,9,14,9900,15400,25300
314790,202105,2424,1522,902,1676400.87,993300,2669700.87
314795,202105,53,45,8,49500,8800,58300
314800,202105,2913,1686,1227,1856800.76,1350800,3207600.76
314810,202105,1477,847,630,931700,693000,1624700
314820,202105,103,57,46,62700,50600,113300
314830,202105,213,173,40,190300,44000,234300
314840,202105,87,51,36,56100,39600,95700
314850,202105,392,187,205,205700,225500,431200
314860,202105,654,502,152,552200,167200,719400
314870,202105,1533,793,740,872300,814000,1686300
314875,202105,52,47,5,51700,5500,57200
314880,202105,44,31,13,34100,14300,48400
314890,202105,49,27,22,29700,24200,53900
314900,202105,29,23,6,25300,6600,31900
314910,202105,241,156,85,171600,93500,265100
314915,202105,138,122,16,135300,17600,152900
314920,202105,94,61,33,67100,36300,103400
314930,202105,1027,491,536,541200,590700,1131900
314940,202105,46,37,9,40700,9900,50600
314950,202105,19,15,4,16500,4400,20900
314960,202105,28,20,8,22000,8800,30800
314970,202105,153,74,79,81400,86900,168300
314980,202105,311,201,110,221100,121000,342100
314990,202105,435,237,198,260700,217800,478500
314995,202105,155,63,92,69300,101200,170500
315000,202105,79,60,19,66000,22000,88000
315010,202105,39,25,14,27500,15400,42900
315015,202105,164,129,35,141900,38500,180400
315020,202105,67,56,11,61600,12100,73700
315030,202105,112,86,26,94600,28600,123200
315040,202105,76,48,28,52800,30800,83600
315050,202105,195,119,76,130900,83600,214500
315053,202105,44,33,11,36300,12100,48400
315057,202105,110,86,24,94600,26400,121000
315060,202105,73,60,13,67100,14300,81400
315070,202105,108,61,47,67100,51700,118800
315080,202105,379,298,81,328900,89100,418000
315090,202105,91,53,38,58300,42900,101200
315100,202105,77,39,38,42900,41800,84700
315110,202105,271,142,129,156200,141900,298100
315120,202105,1764,848,916,935000,1009800,1944800
315130,202105,331,240,91,264000,100100,364100
315140,202105,535,295,240,325600,265100,590700
315150,202105,992,473,519,522500,570900,1093400
315160,202105,202,100,102,110000,112200,222200
315170,202105,308,207,101,227700,112200,339900
315180,202105,3257,1346,1911,1481700,2102100,3583800
315190,202105,304,183,121,201300,133100,334400
315200,202105,1219,727,492,799700,541200,1340900
315210,202105,1625,923,702,1017500,773300,1790800
315213,202105,29,17,12,18700,13200,31900
315217,202105,200,156,44,171600,48400,220000
315220,202105,1589,1189,400,1309000,440000,1749000
315230,202105,167,121,46,133100,50600,183700
315240,202105,407,258,149,286000,163900,449900
315250,202105,2543,1227,1316,1354100,1452000,2806100
315260,202105,137,78,59,85800,64900,150700
315270,202105,133,90,43,99000,48400,147400
315280,202105,644,418,226,459800,248600,708400
315290,202105,187,118,69,129800,75900,205700
315300,202105,83,62,21,68200,23100,91300
315310,202105,78,68,10,74800,11000,85800
315320,202105,152,89,63,97900,69300,167200
315330,202105,57,46,11,50600,12100,62700
315340,202105,395,287,108,315700,118800,434500
315350,202105,154,94,60,103400,66000,169400
315360,202105,96,45,51,49500,56100,105600
315370,202105,54,35,19,38500,22000,60500
315380,202105,5,5,0,5500,0,5500
315390,202105,61,17,44,18700,48400,67100
315400,202105,805,597,208,656700,228800,885500
315410,202105,318,186,132,204600,145200,349800
315415,202105,56,42,14,46200,16500,62700
315420,202105,200,145,55,159500,60500,220000
315430,202105,652,373,279,410300,308000,718300
315440,202105,95,64,31,70400,35200,105600
315445,202105,227,191,36,210100,39600,249700
315450,202105,182,135,47,148500,51700,200200
315460,202105,4133,1956,2177,2154900,2396900,4551800
315470,202105,40,16,24,17600,26400,44000
315480,202105,72,21,51,23100,56100,79200
315490,202105,698,426,272,469700,299200,768900
315500,202105,15,11,4,12100,4400,16500
315510,202105,144,98,46,107800,50600,158400
315520,202105,73,62,11,68200,12100,80300
315530,202105,41,22,19,24200,20900,45100
315540,202105,252,176,76,193600,84700,278300
315550,202105,179,146,33,160600,36300,196900
315560,202105,736,583,153,643500,168300,811800
315570,202105,311,153,158,168300.63,173800,342100.63
315580,202105,728,492,236,541200,259600,800800
315590,202105,195,101,94,111100,103400,214500
315600,202105,314,243,71,267300,78100,345400
315610,202105,101,48,53,52800,58300,111100
315620,202105,36,28,8,30800,8800,39600
315630,202105,124,83,41,91300,45100,136400
315640,202105,66,40,26,44000,28600,72600
315645,202105,50,33,17,36300,18700,55000
315650,202105,175,127,48,139700,52800,192500
315660,202105,455,197,258,216700,283800,500500
315670,202105,2375,1111,1264,1223200,1391500,2614700
315680,202105,814,574,240,631400,265100,896500
315690,202105,677,463,214,509300,235400,744700
315700,202105,1938,1011,927,1112100.28,1020800,2132900.28
315710,202105,350,101,249,111100,273900,385000
315720,202105,473,290,183,319000,201300,520300
315725,202105,193,156,37,171600,40700,212300
315727,202105,52,25,27,27500,29700,57200
315730,202105,48,44,4,48436.66,4400,52836.66
315733,202105,89,60,29,66000,31900,97900
315737,202105,50,37,13,41800,14300,56100
315740,202105,31,24,7,26400,7700,34100
315750,202105,149,112,37,123200,40700,163900
315760,202105,40,30,10,33000,11000,44000
315765,202105,117,68,49,74800,53900,128700
315770,202105,213,130,83,143000,91300,234300
315780,202105,3600,1782,1818,1963500,2003100,3966600
315790,202105,236,183,53,201300,58300,259600
315800,202105,302,204,98,224400,107800,332200
315810,202105,93,56,37,61600,40700,102300
315820,202105,757,556,201,611600,221100,832700
315830,202105,117,76,41,83600,45100,128700
315840,202105,84,53,31,58300,34100,92400
315850,202105,254,181,73,199100,80300,279400
315860,202105,13,5,8,5500,8800,14300
315870,202105,41,30,11,33000,12100,45100
315880,202105,99,66,33,72600,37400,110000
315890,202105,93,68,25,74800,27500,102300
315895,202105,415,278,137,305800,150700,456500
315900,202105,67,33,34,36300,37400,73700
315910,202105,40,24,16,26400,17600,44000
315920,202105,157,102,55,112200,60500,172700
315930,202105,53,18,35,19800,38500,58300
315935,202105,128,102,26,112200,28600,140800
315940,202105,100,74,26,81400,28600,110000
315950,202105,37,28,9,30800,9900,40700
315960,202105,536,249,287,275000,315700,590700
315970,202105,32,26,6,28600,6600,35200
315980,202105,674,334,340,367400,374000,741400
315990,202105,257,148,109,162800,119900,282700
316000,202105,47,30,17,33000,18700,51700
316010,202105,78,64,14,70400,15400,85800
316020,202105,116,100,16,110000,17600,127600
316030,202105,379,210,169,231000,185900,416900
316040,202105,535,218,317,239800,348700,588500
316045,202105,50,45,5,49500,5500,55000
316050,202105,19,15,4,16500,4400,20900
316060,202105,95,66,29,72600,31900,104500
316070,202105,1071,693,378,764500,415800,1180300
316080,202105,91,63,28,69396.8,30800,100196.8
316090,202105,40,21,19,23100,20900,44000
316095,202105,90,75,15,82500,16500,99000
316100,202105,321,182,139,200200,152900,353100
316105,202105,41,24,17,26400,18700,45100
316110,202105,1878,1482,396,1632400.5,435600,2068000.5
316120,202105,76,53,23,58300,25300,83600
316130,202105,119,89,30,97900,33000,130900
316140,202105,31,19,12,20900,13200,34100
316150,202105,207,144,63,158400,69300,227700
316160,202105,84,47,37,51700,40700,92400
316165,202105,63,44,19,48400,20900,69300
316170,202105,183,120,63,132000,69300,201300
316180,202105,203,83,120,91300,132000,223300
316190,202105,131,92,39,101200,42900,144100
316200,202105,664,354,310,389400,341000,730400
316210,202105,771,514,257,565589.2,282700,848289.2
316220,202105,119,77,42,84700,46200,130900
316225,202105,31,18,13,19800,14300,34100
316230,202105,36,18,18,19800,19800,39600
316240,202105,662,528,134,580800,147400,728200
316245,202105,141,122,19,134200,20900,155100
316250,202105,1540,1042,498,1147300,548900,1696200
316255,202105,134,106,28,116600,30800,147400
316257,202105,174,88,86,96800,94600,191400
316260,202105,189,133,56,146300,61600,207900
316265,202105,29,21,8,23100,8800,31900
316270,202105,681,476,205,523600,225500,749100
316280,202105,550,340,210,375100.63,231000,606100.63
316290,202105,779,520,259,572000,284900,856900
316292,202105,539,212,327,233200,359700,592900
316294,202105,105,69,36,75900,39600,115500
316295,202105,312,136,176,149600,193600,343200
316300,202105,109,72,37,79200,40700,119900
316310,202105,27,14,13,15400,14300,29700
316320,202105,53,28,25,30800,27500,58300
316330,202105,167,113,54,124300,59400,183700
316340,202105,133,88,45,96800,49500,146300
316350,202105,192,135,57,148500,62700,211200
316360,202105,21,13,8,14300,8800,23100
316370,202105,1152,576,576,634700,634700,1269400
316380,202105,115,88,27,96800,29700,126500
316390,202105,110,77,33,84700,36300,121000
316400,202105,134,102,32,112200,35200,147400
316410,202105,307,220,87,242000,95700,337700
316420,202105,209,141,68,155100,74800,229900
316430,202105,152,79,73,86900,80300,167200
316440,202105,83,41,42,46200,46200,92400
316443,202105,38,35,3,38500,3300,41800
316447,202105,47,36,11,39600,12100,51700
316450,202105,221,170,51,187000,56100,243100
316460,202105,79,29,50,31900,55000,86900
316470,202105,1655,1204,451,1325489.65,496100,1821589.65
316480,202105,11,8,3,8800,3300,12100
316490,202105,20,6,14,6600,15400,22000
316500,202105,158,106,52,116600,57200,173800
316510,202105,151,114,37,125400,40700,166100
316520,202105,197,114,83,125400,91300,216700
316530,202105,164,107,57,117700,62700,180400
316540,202105,152,77,75,84700,82500,167200
316550,202105,143,89,54,97900,59400,157300
316553,202105,316,142,174,156200,191400.72,347600.72
316555,202105,45,39,6,42900,6600,49500
316556,202105,15,11,4,12100,4400,16500
316557,202105,26,22,4,24200,4400,28600
316560,202105,64,44,20,48400,22000,70400
316570,202105,210,191,19,210100,20900,231000
316580,202105,20,14,6,15400,6600,22000
316590,202105,97,82,15,90200,16500,106700
316600,202105,173,145,28,159500,31900,191400
316610,202105,67,50,17,55000,18700,73700
316620,202105,136,98,38,107800,41800,149600
316630,202105,39,29,10,33000,11000,44000
316640,202105,22,14,8,15400,8800,24200
316650,202105,81,66,15,72600,16500,89100
316660,202105,7,2,5,2200,5500,7700
316670,202105,444,153,291,169400,322300,491700
316680,202105,159,116,43,127600,47300,174900
316690,202105,175,108,67,118800,73700,192500
316695,202105,60,51,9,56100,9900,66000
316700,202105,18,12,6,13200,6600,19800
316710,202105,771,584,187,643500,205700,849200
316720,202105,5050,2435,2615,2682900.6,2880900,5563800.6
316730,202105,16,16,0,17600,0,17600
316740,202105,142,93,49,102300,53900,156200
316750,202105,19,13,6,14300,6600,20900
316760,202105,313,253,60,278300,66000,344300
316770,202105,168,90,78,99000,85800,184800
316780,202105,68,43,25,47300,27500,74800
316790,202105,57,40,17,44000,18700,62700
316800,202105,1770,1093,677,1203400,744700,1948100
316805,202105,23,17,6,18700,6600,25300
316810,202105,64,40,24,44000,26400,70400
316820,202105,39,20,19,22000,20900,42900
316830,202105,93,43,50,47300,55000,102300
316840,202105,509,296,213,325600,234300,559900
316850,202105,327,220,107,243100,117700,360800
316860,202105,5913,2610,3303,2873200,3636600,6509800
316870,202105,1565,1000,565,1101100,621500,1722600
316880,202105,136,66,70,72600,77000,149600
316890,202105,235,160,75,176000,82500,258500
316900,202105,411,287,124,317900,136400,454300
316905,202105,19,9,10,9900,11000,20900
316910,202105,66,27,39,29700,42900,72600
316920,202105,141,110,31,121000,34100,155100
316930,202105,1879,942,937,1038400,1030700,2069100
316935,202105,902,541,361,595100,397100,992200
316940,202105,1085,615,470,676500,518100,1194600
316950,202105,178,88,90,96800,99000,195800
316960,202105,1093,609,484,669900,532400,1202300
316970,202105,642,510,132,561000,145200,706200
316980,202105,73,40,33,44000,36300,80300
316990,202105,2142,1424,718,1567500,792000.84,2359500.84
317000,202105,332,255,77,280500,84700,365200
317005,202105,228,160,68,176000,74800,250800
317010,202105,6412,3543,2869,3899500,3157000,7056500
317020,202105,15760,6924,8836,7625200,9732800.95,17358000.95
317030,202105,81,31,50,34100,55000,89100
317040,202105,3043,1928,1115,2124100,1226500,3350600
317043,202105,69,51,18,56100,19800,75900
317047,202105,35,17,18,18700,19800,38500
317050,202105,153,115,38,126500,41800,168300
317052,202105,141,108,33,118800,36300,155100
317057,202105,166,128,38,140800,41800,182600
317060,202105,61,38,23,41800,25300,67100
317065,202105,49,38,11,41800,12100,53900
317070,202105,1932,894,1038,983400,1141800,2125200
317075,202105,98,53,45,58300,49500,107800
317080,202105,904,459,445,507100,489500,996600
317090,202105,699,547,152,601700,167200,768900
317100,202105,417,312,105,344300,115500,459800
317103,202105,112,92,20,101200,22000,123200
317107,202105,45,39,6,42900,6600,49500
317110,202105,111,51,60,56100,66000,122100
317115,202105,44,40,4,44000,4400,48400
317120,202105,1931,912,1019,1004300,1124200,2128500
317130,202105,1964,1294,670,1425600,738100,2163700
317140,202105,10,9,1,9900,1100,11000
317150,202105,276,163,113,179300,124300,303600
317160,202105,330,249,81,273900.63,89100,363000.63
317170,202105,226,152,74,167200,81400,248600
317180,202105,449,306,143,336600,157300,493900
317190,202105,264,189,75,207900,83600,291500
317200,202105,809,558,251,614900,276100,891000
317210,202105,183,99,84,108900,92400,201300
317220,202105,24,12,12,13200,13200,26400
320010,202105,579,418,161,459800,177100,636900
320013,202105,120,83,37,91300,40700,132000
320016,202105,268,174,94,191400,103400,294800
320020,202105,728,421,307,463100.8,337700,800800.8
320030,202105,159,109,50,119900.08,55000.08,174900.16
320035,202105,136,95,41,104500,45100,149600
320040,202105,503,256,247,281600,271700,553300
320050,202105,109,77,32,84700,35200,119900
320060,202105,1721,821,900,904200,991100,1895300
320070,202105,101,61,40,67100,44000,111100
320080,202105,811,467,344,513700,378400,892100
320090,202105,1254,829,425,913000,467500,1380500
320100,202105,334,192,142,212300,156200,368500
320110,202105,117,72,45,79200,49500,128700
320115,202105,112,91,21,100100,23100,123200
320120,202105,3596,1894,1702,2086700,1873301.37,3960001.37
320130,202105,7593,3384,4209,3724600.5,4635400,8360000.5
320140,202105,429,276,153,303600,168300.81,471900.81
320150,202105,2088,1161,927,1278200,1019700,2297900
320160,202105,658,292,366,321200,403700,724900
320170,202105,107,84,23,92400.1,25300.02,117700.12
320180,202105,54,33,21,36300,23100,59400
320190,202105,240,151,89,166100,97900,264000
320200,202105,60,46,14,50600,15400,66000
320210,202105,901,484,417,532400,459800,992200
320220,202105,304,108,196,118800,215600,334400
320225,202105,88,70,18,77000,19800,96800
320230,202105,650,414,236,456500,259600,716100
320240,202105,3425,1619,1806,1782000,1988800,3770800
320245,202105,485,328,157,360800,172700,533500
320250,202105,233,116,117,127600,128700,256300
320255,202105,130,102,28,112200,30800,143000
320260,202105,221,134,87,148500.2,95700.12,244200.32
320265,202105,154,115,39,126500,42900,169400
320270,202105,154,121,33,133100,36300,169400
320280,202105,1157,658,499,723800.5,548900.02,1272700.52
320290,202105,57,48,9,52800,9900,62700
320300,202105,596,409,187,450046.68,206800,656846.68
320305,202105,692,365,327,401500,359700,761200
320310,202105,197,113,84,124300,92400,216700
320313,202105,341,158,183,173800,201300,375100
320316,202105,109,84,25,92400,27500,119900
320320,202105,3421,1509,1912,1662100,2104300,3766400
320330,202105,263,196,67,215600,73700,289300
320332,202105,757,446,311,490600,343200,833800
320334,202105,251,137,114,150700.02,125400,276100.02
320335,202105,142,93,49,102300,53900,156200
320340,202105,569,397,172,437800,189200,627000
320350,202105,1030,426,604,468600.5,664400,1133000.5
320360,202105,165,83,82,91300,90200,181500
320370,202105,236,174,62,191400,68200,259600
320380,202105,288,202,86,222200,95700,317900
320390,202105,1148,679,469,746900,515900,1262800
320400,202105,320,230,90,253000,99000,352000
320405,202105,947,384,563,422400,621500,1043900
320410,202105,964,485,479,533500,526900,1060400
320420,202105,520,247,273,271700,300300,572000
320425,202105,191,103,88,113300,96800,210100
320430,202105,382,204,178,224400,196900,421300
320435,202105,160,106,54,116600,59400,176000
320440,202105,202,116,86,128700.24,94600.2,223300.44
320450,202105,129,72,57,79200,62700,141900
320455,202105,254,201,53,221100,58300,279400
320460,202105,283,174,109,192500,119900,312400
320465,202105,113,74,39,81400,42900,124300
320470,202105,705,427,278,470800,305800,776600
320480,202105,201,130,71,143000,79200,222200
320490,202105,3114,1500,1614,1654401.52,1776501.3,3430902.82
320495,202105,115,70,45,77000,49500,126500
320500,202105,9634,4704,4930,5184300.12,5431800,10616100.12
320501,202105,542,269,273,297000,300300,597300
320503,202105,293,204,89,224400.1,97900.02,322300.12
320506,202105,263,184,79,202400,86900,289300
320510,202105,1090,484,606,532400,667700,1200100
320515,202105,79,59,20,64900,22000,86900
320517,202105,214,154,60,169400,66000,235400
320520,202105,7111,2993,4118,3295600,4534200,7829800
320530,202105,6412,3121,3291,3436381.5,3622300.63,7058682.13
330010,202105,3069,1513,1556,1667600,1717100,3384700
330015,202105,181,73,108,80300,118800,199100
330020,202105,3762,1512,2250,1664300,2476100,4140400
330022,202105,256,129,127,141900,139700,281600
330023,202105,662,201,461,221100,507100,728200
330025,202105,589,110,479,121000,529100,650100
330030,202105,1847,1137,710,1250700,781000,2031700
330040,202105,2479,1245,1234,1372800,1359600.5,2732400.5
330045,202105,9356,2760,6596,3038200.5,7267700,10305900.5
330050,202105,868,554,314,609400,346500,955900
330060,202105,1048,620,428,683100,474100,1157200
330070,202105,3932,1371,2561,1510300,2821500,4331800
330080,202105,1593,687,906,755700,997700,1753400
330090,202105,391,225,166,247500,182600,430100
330093,202105,262,114,148,125400,163900,289300
330095,202105,76,45,31,49500,34100,83600
330100,202105,10004,4942,5062,5440600.5,5584700.91,11025301.41
330110,202105,467,196,271,215600,299200,514800
330115,202105,513,269,244,295900.78,268400,564300.78
330120,202105,385,190,195,209000,214500,423500
330130,202105,1578,392,1186,431200,1304600,1735800
330140,202105,613,322,291,354200,320100,674300
330150,202105,513,293,220,322300,242000,564300
330160,202105,214,124,90,136400,99000,235400
330170,202105,27064,8986,18078,9894500.1,19916600,29811100.1
330180,202105,241,135,106,148500,116600,265100
330185,202105,975,340,635,374000,698500.33,1072500.33
330187,202105,430,123,307,135300,337700,473000
330190,202105,5954,2192,3762,2411200,4143700,6554900
330200,202105,4678,1394,3284,1535600.88,3615700.23,5151301.11
330205,202105,439,252,187,277200,205700,482900
330210,202105,937,566,371,623700,409200,1032900
330220,202105,2688,1568,1120,1725900,1234200,2960100
330225,202105,570,285,285,313500,313500,627000
330227,202105,2417,727,1690,799700,1861200,2660900
330230,202105,261,144,117,158400,128700,287100
330240,202105,3929,1942,1987,2137300,2187900,4325200
330245,202105,153,67,86,73700,94600,168300
330250,202105,6690,3288,3402,3619000,3745500,7364500
330260,202105,639,160,479,176000,526900,702900
330270,202105,3695,1195,2500,1315600,2753300,4068900
330280,202105,447,284,163,313500,179300,492800
330285,202105,6879,2083,4796,2296800,5284400,7581200
330290,202105,676,242,434,266200,479600,745800
330300,202105,764,490,274,540775.4,301400,842175.4
330310,202105,440,239,201,262900,222200,485100
330320,202105,7991,2843,5148,3131700.82,5678297.9,8809998.72
330330,202105,9233,3388,5845,3727900.02,6435000,10162900.02
330340,202105,2669,1530,1139,1686300,1252900,2939200
330350,202105,18770,6929,11841,7629636.66,13042700.5,20672337.16
330360,202105,2164,1020,1144,1124200,1258400,2382600
330370,202105,1005,500,505,551100,556600,1107700
330380,202105,914,373,541,411400,595100.01,1006500.01
330385,202105,635,322,313,355300,345400,700700
330390,202105,5771,2965,2806,3263700,3091000,6354700
330395,202105,319,190,129,209000,141900,350900
330400,202105,692,357,335,392700,368500,761200
330410,202105,499,355,144,390500,158400,548900
330411,202105,269,140,129,154000,141900,295900
330412,202105,231,92,139,101200,152900,254100
330414,202105,5321,2106,3215,2317700,3540900,5858600
330415,202105,604,260,344,286000,380600,666600
330420,202105,2255,1125,1130,1238600,1247400,2486000
330430,202105,1788,783,1005,862400,1107700,1970100
330440,202105,312,140,172,154000,190300,344300
330450,202105,117,51,66,56100,72600,128700
330452,202105,2174,933,1241,1026300,1366200,2392500
330455,202105,115636,39166,76470,43140994.82,84224803.97,127365798.79
330460,202105,250,109,141,119900,156200,276100
330470,202105,1218,657,561,723800,618200,1342000
330475,202105,1616,425,1191,470800,1315600,1786400
330480,202105,822,445,377,490600,415800,906400
330490,202105,15108,4663,10445,5134905,11503800.36,16638705.36
330500,202105,1424,608,816,668800,897600,1566400
330510,202105,10943,3694,7249,4068900.44,7981600,12050500.44
330513,202105,95,48,47,52800,51700,104500
330515,202105,756,310,446,343200,492800,836000
330520,202105,2520,859,1661,944900,1829300,2774200
330530,202105,194,110,84,121000,92400,213400
330540,202105,349,175,174,192500,192500,385000
330550,202105,2913,975,1938,1072500,2135100,3207600
330555,202105,813,316,497,348700,546700,895400
330560,202105,696,228,468,250800,519200,770000
330570,202105,273,191,82,210100,90200,300300
330575,202105,801,279,522,306900,575300,882200
330580,202105,3367,1844,1523,2029500.5,1678600,3708100.5
330590,202105,275,143,132,157300.5,146300,303600.5
330600,202105,1215,743,472,817300.3,520300,1337600.3
330610,202105,1582,836,746,920700,820600,1741300
330615,202105,216,169,47,185900,51700,237600
330620,202105,1055,396,659,435600,724900,1160500
330630,202105,4141,2508,1633,2762101.05,1799600,4561701.05
350010,202105,573,376,197,415800.88,216700,632500.88
350020,202105,56,21,35,24200,38500,62700
350030,202105,511,319,192,352000,212300,564300
350040,202105,123,52,71,57200,78100,135300
350050,202105,326,167,159,183700,174900,358600
350055,202105,106,49,57,53900,62700,116600
350060,202105,83,27,56,29700,61600,91300
350070,202105,777,459,318,504900.2,349800,854700.2
350075,202105,75,49,26,53900,28600,82500
350080,202105,56,27,29,29700,31900,61600
350090,202105,80,46,34,50600,37400,88000
350100,202105,277,170,107,187000,118800,305800
350110,202105,57,41,16,45100,17600,62700
350115,202105,147,91,56,100100,61600,161700
350120,202105,111,72,39,79200,42900,122100
350130,202105,370,163,207,180400.56,227700,408100.56
350140,202105,40,25,15,27500,16500,44000
350150,202105,78,59,19,64900,20900,85800
350160,202105,2391,948,1443,1045000,1589500,2634500
350170,202105,384,222,162,244200,178200,422400
350180,202105,167,97,70,106700,77000,183700
350190,202105,995,527,468,581900.63,515900,1097800.63
350200,202105,67,25,42,27500,46200,73700
350210,202105,1285,706,579,778800,638000.63,1416800.63
350220,202105,643,528,115,580800.63,126500,707300.63
350230,202105,74,50,24,55000,26400,81400
350240,202105,59,41,18,45100,19800,64900
350250,202105,1155,541,614,596200,676500,1272700
350260,202105,99,72,27,79200,29700,108900
350270,202105,884,595,289,655600,319000,974600
350275,202105,288,115,173,126500,190300,316800
350280,202105,4463,2233,2230,2458500,2455200,4913700
350290,202105,454,200,254,220000,280500,500500
350300,202105,55,27,28,30800,30800,61600
350310,202105,79,51,28,56100,30800,86900
350315,202105,63,28,35,30800,38500,69300
350320,202105,3299,1600,1699,1761100,1871100,3632200
350330,202105,1650,868,782,955901.66,863500,1819401.66
350335,202105,16,12,4,13200,4400,17600
350340,202105,128,56,72,61600,79200,140800
350350,202105,96,49,47,53900,52800,106700
350360,202105,107,70,37,77000,40700,117700
350370,202105,79,42,37,46200.63,40700,86900.63
350380,202105,774,329,445,361900,489500.28,851400.28
350390,202105,1646,607,1039,667700.5,1145100,1812800.5
350395,202105,22,18,4,19800,4400,24200
350400,202105,1673,830,843,913001.89,929500.63,1842502.52
350410,202105,2775,1178,1597,1299100,1756720.63,3055820.63
350420,202105,253,151,102,166100,112200,278300
350430,202105,75,42,33,46200,36300,82500
350440,202105,154,110,44,121000,48400,169400
350450,202105,1694,972,722,1073600.63,795300,1868900.63
350460,202105,398,133,265,147400,291500,438900
350470,202105,21,11,10,12100,11000,23100
350480,202105,182,101,81,111100,90200,201300
350490,202105,241,113,128,124300,140800,265100
350500,202105,53,23,30,25300,33000,58300
350510,202105,162,100,62,110000,68200,178200
350520,202105,427,224,203,246400,224400,470800
350530,202105,435,204,231,224400,254100,478500
350535,202105,79,62,17,68200,19800,88000
350540,202105,372,193,179,212300,198000,410300
350550,202105,2652,1522,1130,1674200,1244101.26,2918301.26
350560,202105,586,401,185,441100,205700,646800
350570,202105,4190,1717,2473,1894200.76,2724701.27,4618902.03
350580,202105,360,174,186,192500,204600,397100
350590,202105,924,493,431,544500,475200,1019700
350600,202105,6040,2869,3171,3164700,3491400,6656100
350610,202105,1478,766,712,843700,787600,1631300
350620,202105,26,16,10,17600,11000,28600
350630,202105,241,133,108,147400.63,118800,266200.63
350635,202105,995,394,601,433400,662200,1095600
350640,202105,117,89,28,97900,30800,128700
350650,202105,1850,1230,620,1353000,682000,2035000
350660,202105,749,308,441,338800,486200,825000
350670,202105,303,148,155,162800,170500,333300
350680,202105,171,87,84,95700,93500,189200
350690,202105,196,90,106,99000,116600,215600
350700,202105,810,386,424,427900,467500,895400
350710,202105,382,142,240,156200,264000,420200
350715,202105,54,43,11,48400,12100,60500
350720,202105,17,11,6,12100,6600,18700
350730,202105,44,27,17,29700,18700,48400
350740,202105,217,122,95,136400,104500,240900
350745,202105,25,10,15,11000,16500,27500
350750,202105,2220,1335,885,1468500,976800,2445300
350760,202105,3714,1546,2168,1702800,2385900,4088700
350770,202105,56,41,15,45100,16500,61600
350775,202105,44,31,13,34100,14300,48400
350780,202105,426,215,211,236500,232100,468600
350790,202105,362,151,211,166100,232100,398200
350800,202105,484,288,196,316800,215600,532400
350810,202105,514,408,106,448800,117700,566500
350820,202105,92,52,40,57200,44000,101200
350830,202105,76,40,36,44000,39600,83600
350840,202105,760,300,460,331100,506000,837100
350850,202105,1756,943,813,1040600,895400,1936000
350860,202105,606,330,276,365200,303600,668800
350870,202105,438,287,151,315700,166100,481800
350880,202105,276,154,122,169400,134200,303600
350890,202105,40,25,15,27500,16500,44000
350900,202105,1486,458,1028,504900,1134100.63,1639000.63
350910,202105,28,16,12,17600,13200,30800
350920,202105,706,365,341,401500,375100,776600
350925,202105,1147,604,543,665500,598400.63,1263900.63
350930,202105,99,60,39,67100,42900,110000
350940,202105,728,397,331,437800,364100,801900
350945,202105,112,80,32,88000,35200,123200
350950,202105,16489,7573,8916,8345701.49,9816400,18162101.49
350960,202105,1423,600,823,661100,908600,1569700
350970,202105,1073,552,521,607081.2,573100,1180181.2
350980,202105,98,65,33,71500,36300,107800
350990,202105,370,135,235,148500,258500,407000
350995,202105,37,18,19,19800,20900,40700
351000,202105,624,418,206,460900.63,227700,688600.63
351010,202105,52,33,19,36300,20900,57200
351015,202105,48,32,16,35200,17600,52800
351020,202105,1539,926,613,1019700,675400,1695100
351030,202105,338,208,130,229900,143000,372900
351040,202105,901,447,454,491700,500500.2,992200.2
351050,202105,3311,1481,1830,1634600,2015200,3649800
351060,202105,5341,2011,3330,2214300,3666300,5880600
351070,202105,399,256,143,281600.63,157300,438900.63
351080,202105,715,516,199,568700,218900,787600
351090,202105,52,23,29,25300,31900,57200
351100,202105,426,233,193,257400,212300,469700
351110,202105,1991,934,1057,1028501.13,1163800,2192301.13
351120,202105,63,32,31,35200,34100,69300
351130,202105,183,59,124,64900,136400,201300
351140,202105,315,199,116,218900,127600,346500
351150,202105,437,228,209,250800,231000,481800
351160,202105,267,168,99,187000.4,110000,297000.4
351170,202105,188,100,88,110000,96800,206800
351190,202105,86,60,26,66000,28600,94600
351200,202105,355,223,132,245300,145200,390500
351210,202105,114,56,58,61600,63800,125400
351220,202105,523,310,213,341000.65,234300,575300.65
351230,202105,267,185,82,203500,90200,293700
351240,202105,247,117,130,128700,144100,272800
351250,202105,79,54,25,59400.5,27500,86900.5
351260,202105,153,110,43,123200,47300,170500
351270,202105,47,19,28,20900,30800,51700
351280,202105,1013,465,548,511500.63,602800.63,1114301.26
351290,202105,242,108,134,118800,147400,266200
351300,202105,3718,1633,2085,1799513.6,2294600,4094113.6
351310,202105,736,362,374,398200,411400,809600
351320,202105,114,65,49,71500,53900,125400
351330,202105,38,25,13,27500,14300,41800
351340,202105,1246,723,523,796400,575300,1371700
351350,202105,2343,1353,990,1490500.04,1091200,2581700.04
351360,202105,777,374,403,411400,445500,856900
351370,202105,379,191,188,210100,207900,418000
351380,202105,8802,3896,4906,4293300,5403200.99,9696500.99
351385,202105,28,18,10,19800,11000,30800
351390,202105,278,209,69,229900,75900,305800
351400,202105,64,41,23,45100,25300,70400
351410,202105,421,259,162,286000.93,178200,464200.93
351420,202105,66,47,19,51700,20900,72600
351430,202105,74,41,33,45100,36300,81400
351440,202105,754,510,244,562101.26,268400,830501.26
351450,202105,260,125,135,137500,148500,286000
351460,202105,121,52,69,57200,75900,133100
351470,202105,142,79,63,86900,70400,157300
351480,202105,480,278,202,305800.63,222200,528000.63
351490,202105,282,102,180,113300,198000,311300
351492,202105,25,17,8,18700,8800,27500
351495,202105,28,19,9,20900,9900,30800
351500,202105,3470,1431,2039,1576300,2249500,3825800
351510,202105,1951,725,1226,797500,1349700,2147200
351512,202105,15,12,3,13200,3300,16500
351515,202105,185,109,76,119900,83600,203500
351518,202105,698,437,261,482900,288200,771100
351519,202105,76,43,33,47300,36300,83600
351520,202105,151,87,64,95700,70419.8,166119.8
351530,202105,25,15,10,16500,11000,27500
351535,202105,130,82,48,90200,52800,143000
351540,202105,450,312,138,344300,152900,497200
351550,202105,1449,851,598,938301.38,657800,1596101.38
351560,202105,78,46,32,50600,35200,85800
351565,202105,11,8,3,8800,3300,12100
351570,202105,2664,1265,1399,1393700,1543300,2937000
351580,202105,39,34,5,37400,5500,42900
351590,202105,58,39,19,42900,20900,63800
351600,202105,187,132,55,145200,61600,206800
351610,202105,50,21,29,23100,31900,55000
351620,202105,5771,3178,2593,3499100.82,2855600,6354700.82
351630,202105,2888,1403,1485,1545500,1636800,3182300
351640,202105,2041,901,1140,991100.55,1254000.63,2245101.18
351650,202105,30,25,5,27500,5500,33000
351660,202105,130,83,47,91300,51700,143000
351670,202105,718,442,276,486200,303600,789800
351680,202105,66,54,12,59400,13200,72600
351685,202105,11,8,3,8800,3300,12100
351690,202105,290,193,97,212300.5,106700,319000.5
351700,202105,166,113,53,124537,58300,182837
351710,202105,67,42,25,46200,27500,73700
351720,202105,125,70,55,77000,60500,137500
351730,202105,109,71,38,78100,42900,121000
351740,202105,731,461,270,507100.74,297000,804100.74
351750,202105,355,143,212,157300,233200,390500
351760,202105,734,566,168,622600,185900,808500
351770,202105,305,252,53,277200.63,58300,335500.63
351780,202105,158,93,65,102300,71500,173800
351790,202105,245,127,118,139700,129800,269500
351800,202105,42,27,15,29700,16500,46200
351810,202105,117,78,39,85800,42900,128700
351820,202105,796,567,229,624800,251900,876700
351830,202105,551,183,368,201300,404800,606100
351840,202105,1949,925,1024,1017500,1127500,2145000
351850,202105,225,160,65,176000,71500,247500
351860,202105,626,434,192,477400,211200,688600
351870,202105,5536,2570,2966,2828102.1,3264801.42,6092903.52
351880,202105,19694,7820,11874,8608600,13075700,21684300
351885,202105,83,50,33,55000,36300,91300
351890,202105,64,51,13,56100,14300,70400
351900,202105,227,131,96,144100,105600,249700
351905,202105,89,36,53,39600,58300,97900
351907,202105,3456,1407,2049,1549900,2257200,3807100
351910,202105,170,70,100,78100,111100,189200
351920,202105,110,60,50,66000,55000,121000
351925,202105,88,55,33,60500,36300,96800
351930,202105,382,246,136,270600,149600,420200
351940,202105,233,97,136,106700,149600,256300
351950,202105,135,71,64,78100,70400,148500
351960,202105,922,458,464,504144.93,512600,1016744.93
351970,202105,1968,998,970,1098900,1067000,2165900
351980,202105,150,68,82,74800,91300,166100
351990,202105,251,161,90,177100,99000,276100
352000,202105,325,205,120,225500,132000,357500
352010,202105,407,251,156,278371,171600,449971
352020,202105,179,70,109,78100,119900,198000
352030,202105,1086,542,544,596200,599500,1195700
352040,202105,572,237,335,260700,368500,629200
352042,202105,285,72,213,79200,234300,313500
352044,202105,342,207,135,227700,148500,376200
352050,202105,3194,1198,1996,1317800.63,2197800,3515600.63
352060,202105,103,63,40,69300,44000,113300
352070,202105,90,67,23,73701.26,25300,99001.26
352080,202105,62,41,21,45100,23100,68200
352090,202105,149,97,52,106700,58300,165000
352100,202105,288,138,150,151800,165000,316800
352110,202105,118,39,79,42900,86900,129800
352115,202105,62,20,42,23100,46200,69300
352120,202105,79,56,23,61600.63,25300,86900.63
352130,202105,216,173,43,190300,47300,237600
352140,202105,176,84,92,92400,102300,194700
352150,202105,120,64,56,70400,61600,132000
352160,202105,137,87,50,95700,55000,150700
352170,202105,386,264,122,290400,135300,425700
352180,202105,634,397,237,438900.63,267300,706200.63
352190,202105,238,97,141,106700,156200,262900
352200,202105,29,14,15,15400,16500,31900
352210,202105,4181,1679,2502,1848000.95,2755500,4603500.95
352215,202105,68,40,28,44000,30800,74800
352220,202105,6515,2422,4093,2665300,4510000.63,7175300.63
352230,202105,3340,2155,1185,2372701.13,1306801.05,3679502.18
352240,202105,2518,1442,1076,1587300,1186900,2774200
352250,202105,2831,1324,1507,1459701.68,1661000,3120701.68
352260,202105,980,519,461,572000,509300,1081300
352265,202105,59,32,27,35200,29700,64900
352270,202105,386,217,169,239800,185900,425700
352280,202105,472,283,189,312400.63,207900,520300.63
352290,202105,178,103,75,113300,82500,195800
352300,202105,93,64,29,70400,33000,103400
352310,202105,6495,2828,3667,3116301.66,4040300,7156601.66
352320,202105,1069,549,520,605000,572000,1177000
352330,202105,518,258,260,283800,286000,569800
352340,202105,1337,608,729,669900,805200,1475100
352350,202105,344,198,146,218900,160600,379500
352360,202105,218,96,122,105600,134200,239800
352370,202105,104,68,36,74800,39600,114400
352380,202105,109,75,34,82500,37400,119900
352390,202105,2502,1086,1416,1195700,1558700,2754400
352400,202105,511,226,285,248600,313500,562100
352410,202105,864,592,272,651200.63,300300,951500.63
352420,202105,93,66,27,72600,29700,102300
352430,202105,1731,784,947,862401.89,1041701.26,1904103.15
352440,202105,3221,1565,1656,1725900,1821600,3547500
352450,202105,197,157,40,172700,44000,216700
352460,202105,622,316,306,347600,336600,684200
352470,202105,645,225,420,247500,463100,710600
352480,202105,1431,778,653,856900,719400,1576300
352490,202105,51,16,35,17600,38500,56100
352500,202105,1237,522,715,574200,788700,1362900
352510,202105,704,377,327,414700.63,359700,774400.63
352520,202105,748,327,421,362047.4,465300,827347.4
352530,202105,1709,877,832,964700,916300,1881000
352540,202105,71,46,25,50600,27500,78100
352550,202105,189,112,77,123200,84750.6,207950.6
352560,202105,47,38,9,41800,9900,51700
352570,202105,677,326,351,360800.63,387200,748000.63
352580,202105,61,47,14,51700,15400,67100
352585,202105,20,6,14,6600,15400,22000
352590,202105,4287,2098,2189,2314401.61,2413497,4727898.61
352600,202105,343,242,101,266200,111100,377300
352610,202105,907,411,496,453200.5,545600,998800.5
352620,202105,1023,384,639,422400,704000,1126400
352630,202105,181,68,113,74800,124300,199100
352640,202105,515,338,177,372900,195800,568700
352650,202105,80,60,20,66000,22000,88000
352660,202105,62,37,25,40700,27500,68200
352670,202105,1669,880,789,969100.6,867900,1837000.6
352680,202105,903,554,349,609400,383900,993300
352690,202105,4495,1997,2498,2204402.07,2751100.63,4955502.70
352700,202105,94,55,39,60500,42900,103400
352710,202105,1412,735,677,810700,745800,1556500
352720,202105,1404,637,767,700700,844800,1545500
352725,202105,20,16,4,17600,4400,22000
352730,202105,375,182,193,200200,212300,412500
352740,202105,398,260,138,286000,151800.8,437800.8
352750,202105,19,13,6,14300,6600,20900
352760,202105,193,120,73,132000,80300,212300
352770,202105,84,63,21,69300,23100,92400
352780,202105,76,40,36,44000,39600,83600
352790,202105,25,19,6,20900,6600,27500
352800,202105,230,175,55,192500,60500,253000
352810,202105,153,97,56,106700,61600,168300
352820,202105,50,39,11,44000,12100,56100
352830,202105,74,50,24,55000,26400,81400
352840,202105,644,304,340,335500,376200,711700
352850,202105,1620,512,1108,565400,1218800,1784200
352860,202105,110,72,38,79200,41800,121000
352870,202105,47,31,16,34100,17600,51700
352880,202105,179,114,65,125400,71500,196900
352885,202105,33,22,11,24200,12100,36300
352890,202105,54,35,19,38500,20900,59400
352900,202105,4626,2212,2414,2437600,2658700,5096300
352910,202105,39,32,7,35200,7700,42900
352920,202105,649,381,268,421300,294800,716100
352930,202105,1203,571,632,629200,695200,1324400
352940,202105,6026,2428,3598,2674100,3964400,6638500
352950,202105,117,42,75,47300,82500,129800
352960,202105,62,36,26,39600,28600,68200
352965,202105,19,10,9,11000,9900,20900
352970,202105,506,380,126,418000.35,138600,556600.35
352980,202105,160,88,72,96800,79200,176000
352990,202105,973,452,521,498300,573100,1071400
353000,202105,57,25,32,27500,35200,62700
353010,202105,532,326,206,358600,226600,585200
353020,202105,301,218,83,239800,91300,331100
353030,202105,1242,559,683,614900,754600,1369500
353040,202105,70,38,32,41800,35200,77000
353050,202105,1281,826,455,910800.9,501600,1412400.9
353060,202105,8396,3558,4838,3918200.71,5329500,9247700.71
353070,202105,1792,1078,714,1188001.26,786304.2,1974305.46
353080,202105,1247,667,580,733700.92,639100,1372800.92
353090,202105,61,32,29,35200,31900,67100
353100,202105,45,35,10,38500,11000,49500
353110,202105,2083,657,1426,722700,1571900.62,2294600.62
353120,202105,99,51,48,56100,52800,108900
353130,202105,858,413,445,455401.92,490600,946001.92
353140,202105,540,220,320,242000.63,352000,594000.63
353150,202105,327,184,143,202400.63,157300,359700.63
353160,202105,97,76,21,83600,23100,106700
353170,202105,210,66,144,73700,158400,232100
353180,202105,1106,496,610,545600,671000,1216600
353190,202105,474,342,132,378400,145200,523600
353200,202105,228,110,118,121000,129800,250800
353205,202105,20,13,7,14300,7700,22000
353210,202105,70,39,31,42900,34100,77000
353215,202105,41,23,18,25300,19800,45100
353220,202105,76,40,36,44000,39600,83600
353230,202105,158,63,95,69300,104500,173800
353240,202105,336,165,171,181500,188100,369600
353250,202105,203,99,104,108900,114400,223300
353260,202105,454,302,152,332200,167200,499400
353270,202105,72,54,18,59400,20900,80300
353280,202105,100,50,50,55000,55000,110000
353282,202105,131,94,37,103400,41800,145200
353284,202105,26,19,7,20900,7700,28600
353286,202105,2,0,2,0,2200,2200
353290,202105,82,47,35,51700,38500,90200
353300,202105,434,225,209,247501.26,229900,477401.26
353310,202105,46,39,7,42900,8800,51700
353320,202105,34,20,14,22000,15400,37400
353325,202105,46,27,19,29700,22000,51700
353330,202105,63,45,18,49500,19800,69300
353340,202105,630,226,404,248600,444400,693000
353350,202105,889,434,455,477400,501600,979000
353360,202105,100,80,20,88000,22000,110000
353370,202105,109,65,44,71500,48400,119900
353380,202105,28,14,14,15400,15400,30800
353390,202105,1101,516,585,567600,644600,1212200
353400,202105,41,24,17,26400,18700,45100
353410,202105,110,63,47,70400,51700,122100
353420,202105,58,22,36,24200,39600,63800
353430,202105,561,371,190,408101.13,209000,617101.13
353440,202105,11392,4886,6506,5384500.63,7161000,12545500.63
353450,202105,56,29,27,31900,29700,61600
353460,202105,607,317,290,349800,319000,668800
353470,202105,2169,1102,1067,1214400.6,1173700,2388100.6
353475,202105,244,164,80,181500,88000,269500
353480,202105,177,143,34,157300,37400,194700
353490,202105,235,136,99,149600,108900,258500
353500,202105,207,120,87,132000,95700,227700
353510,202105,93,63,30,69300,33000,102300
353520,202105,217,157,60,172700,66000,238700
353530,202105,453,236,217,259600,239800,499400
353540,202105,384,247,137,272800,150700,423500
353550,202105,705,452,253,498300.93,278300,776600.93
353560,202105,575,231,344,254100,378400,632500
353570,202105,63,36,27,39600,29700,69300
353580,202105,344,247,97,273900.25,106700,380600.25
353590,202105,80,59,21,64900,23100,88000
353600,202105,264,153,111,169400.63,122100,291500.63
353610,202105,130,68,62,74800,68200,143000
353620,202105,635,323,312,355300,343200,698500
353625,202105,53,26,27,28600,29700,58300
353630,202105,223,160,63,176000,69300,245300
353640,202105,119,79,40,86900,44000,130900
353650,202105,938,353,585,390500,647900,1038400
353657,202105,23,18,5,19800,5500,25300
353660,202105,273,144,129,158400,143000,301400
353670,202105,737,436,301,481800.63,331100,812900.63
353680,202105,113,79,34,86900,37400,124300
353690,202105,39,29,10,31900,11000,42900
353700,202105,278,194,84,213400,92400,305800
353710,202105,476,222,254,244200,281600,525800
353715,202105,50,31,19,34100,20900,55000
353720,202105,345,152,193,167200,213400,380600
353730,202105,1117,683,434,753500,477400,1230900
353740,202105,604,329,275,363000,302500,665500
353750,202105,74,44,30,48400,33000,81400
353760,202105,3026,1143,1883,1258400,2074600.9,3333000.9
353770,202105,80,64,16,70400,17600,88000
353780,202105,1252,585,667,643500.63,733700,1377200.63
353790,202105,488,299,189,330000,209000,539000
353800,202105,3475,1654,1821,1822720,2004274,3826994
353810,202105,228,120,108,133100,118800,251900
353820,202105,217,94,123,103400,135300,238700
353830,202105,54,45,9,49500,9900,59400
353850,202105,176,88,88,96800,96800,193600
353860,202105,504,220,284,243100,312400,555500
353870,202105,5397,2718,2679,2993100.36,2953500,5946600.36
353880,202105,693,462,231,509300,254100,763400
353890,202105,545,323,222,355300,245300.59,600600.59
353900,202105,132,69,63,75900,69300,145200
353910,202105,174,77,97,84700,106700,191400
353920,202105,408,225,183,247500,203500,451000
353930,202105,1029,598,431,660000,474100,1134100
353940,202105,195,100,95,110000,104500,214500
353950,202105,495,306,189,339900,209000,548900
353960,202105,78,63,15,69300,16500,85800
353970,202105,43,28,15,30800,16500,47300
353980,202105,1722,776,946,854700,1041700,1896400
353990,202105,75,44,31,48400,34100,82500
354000,202105,378,176,202,193600,223300,416900
354010,202105,90,52,38,57200,41800,99000
354020,202105,493,312,181,344300,200200,544500
354025,202105,36,31,5,34100,5500,39600
354030,202105,46,26,20,28600,22000,50600
354040,202105,92,68,24,75900,26400,102300
354050,202105,175,95,80,104500.63,88000,192500.63
354060,202105,736,354,382,390500,420200,810700
354070,202105,901,508,393,558800,432300,991100
354075,202105,177,81,96,89100,106700,195800
354080,202105,310,132,178,145200,195800,341000
354085,202105,21,13,8,14300,8800,23100
354090,202105,286,169,117,185807,128700,314507
354100,202105,5541,2249,3292,2478300.4,3624500,6102800.4
354105,202105,95,45,50,50600,55000,105600
354110,202105,45,23,22,25300,24200,49500
354120,202105,143,97,46,106700.93,50600,157300.93
354130,202105,701,430,271,473000.33,298100,771100.33
354140,202105,3156,1443,1713,1588400.55,1886500,3474900.55
354150,202105,624,368,256,404800.66,282700,687500.66
354160,202105,639,401,238,441100,261800,702900
354165,202105,17,14,3,15400,3300,18700
354170,202105,174,122,52,134200,57200,191400
354180,202105,58,35,23,38500.42,25300,63800.42
354190,202105,187,76,111,83600,123200,206800
354200,202105,107,56,51,61600,56100,117700
354210,202105,63,24,39,26400,42900,69300
354220,202105,629,399,230,440000.63,253000,693000.63
354230,202105,167,72,95,79200,104500,183700
354240,202105,332,211,121,233200.82,133100,366300.82
354250,202105,81,50,31,55000,34100,89100
354260,202105,2106,999,1107,1100001.34,1217700.85,2317702.19
354270,202105,88,65,23,71500,25300,96800
354280,202105,45,22,23,24200,25300,49500
354290,202105,138,95,43,104500,47300,151800
354300,202105,363,254,109,279400.63,119900,399300.63
354310,202105,89,69,20,75900,22000,97900
354320,202105,211,103,108,113300,118800,232100
354323,202105,10,9,1,9900,1100,11000
354325,202105,119,65,54,71500.83,59400,130900.83
354330,202105,2377,805,1572,887543,1731400,2618943
354340,202105,10189,4792,5397,5281968,5943300,11225268
354350,202105,140,89,51,97900,56100,154000
354360,202105,70,38,32,41800,35200,77000
354370,202105,236,122,114,134200,125400,259600
354380,202105,182,105,77,115500,84700,200200
354390,202105,2635,956,1679,1052700,1850200.64,2902900.64
354400,202105,297,166,131,182600,145200,327800
354410,202105,622,291,331,320100,365200,685300
354420,202105,265,169,96,187000,105600,292600
354425,202105,308,179,129,196951,143000,339951
354430,202105,186,104,82,114400,90200,204600
354440,202105,32,25,7,27500,7700,35200
354450,202105,51,33,18,36300,19800,56100
354460,202105,96,56,40,62700,44000,106700
354470,202105,27,14,13,15400,14300,29700
354480,202105,110,61,49,67100,53900,121000
354490,202105,135,84,51,92400,56100,148500
354500,202105,385,175,210,192500,232100,424600
354510,202105,92,63,29,69300,31900,101200
354515,202105,39,10,29,11000,31900,42900
354520,202105,1589,677,912,745643,1004300.78,1749943.78
354530,202105,781,389,392,430100,432300,862400
354540,202105,264,136,128,149600,140800,290400
354550,202105,37,22,15,24200,16500,40700
354560,202105,147,77,70,85800,77000,162800
354570,202105,138,95,43,105600,47300,152900
354580,202105,1797,847,950,931700.44,1047200,1978900.44
354600,202105,260,137,123,150700,135300,286000
354610,202105,69,58,11,63800,12100,75900
354620,202105,59,14,45,15400,49500,64900
354625,202105,14,9,5,9900,5500,15400
354630,202105,295,188,107,207900,117700,325600
354640,202105,808,507,301,558800.63,332200,891000.63
354650,202105,66,38,28,41800,30800,72600
354660,202105,778,571,207,629200.63,227700,856900.63
354670,202105,228,85,143,93500,157300,250800
354680,202105,1272,455,817,501600,899800,1401400
354690,202105,80,56,24,61600,26400,88000
354700,202105,73,51,22,56100,24200,80300
354710,202105,48,33,15,36300,16500,52800
354720,202105,19,19,0,20900,0,20900
354730,202105,1728,704,1024,775500,1126400,1901900
354740,202105,77,53,24,58300,26400,84700
354750,202105,419,244,175,269500,192500,462000
354760,202105,479,291,188,320100,206800,526900
354765,202105,9,4,5,4400,5500,9900
354770,202105,351,231,120,254100,132000,386100
354780,202105,8055,3111,4944,3427601.37,5442800,8870401.37
354790,202105,90,52,38,58300,41800,100100
354800,202105,440,240,200,266105.02,220000,486105.02
354805,202105,88,38,50,41800,55000,96800
354810,202105,105,63,42,69300,47300,116600
354820,202105,205,84,121,92400,134200,226600
354830,202105,43,23,20,25300,22000,47300
354840,202105,57,39,18,42900,19800,62700
354850,202105,4454,1961,2493,2160400.08,2747800.06,4908200.14
354860,202105,330,159,171,174900,188100,363000
354870,202105,11800,5202,6598,5728801.26,7266600,12995401.26
354880,202105,2668,982,1686,1081300.89,1856851.7,2938152.59
354890,202105,2842,1500,1342,1651101.52,1477300,3128401.52
354900,202105,65,44,21,48400,23100,71500
354910,202105,1257,639,618,704000,679800,1383800
354920,202105,41,33,8,36300,8800,45100
354925,202105,19,8,11,8800,12100,20900
354930,202105,36,32,4,35200.4,4400,39600.4
354940,202105,765,550,215,609400.79,236500,845900.79
354950,202105,204,125,79,137500,86900,224400
354960,202105,141,54,87,59400,95700,155100
354970,202105,987,666,321,733701.26,353100,1086801.26
354980,202105,8770,3107,5663,3421002.23,6238100.39,9659102.62
354990,202105,9458,4258,5200,4689300,5725500,10414800
354995,202105,536,169,367,187000,404800,591800
355000,202105,455,157,298,173800,328900,502700
355010,202105,578,355,223,391600.84,245300.63,636901.47
355020,202105,776,482,294,530200,323400,853600
355030,202105,206386,78001,128385,85910147.69,141423745.28,227333892.97
355040,202105,802,361,441,397100,485100,882200
355050,202105,152,88,64,96800,70400,167200
355060,202105,1632,800,832,884400,918500,1802900
355070,202105,1472,689,783,757900.08,861300.73,1619200.81
355080,202105,190,116,74,128700,81400,210100
355090,202105,284,167,117,184800,128700.57,313500.57
355100,202105,5007,2377,2630,2615690,2895200,5510890
355110,202105,235,157,78,172700,85800,258500
355120,202105,57,36,21,39600,23100,62700
355130,202105,50,29,21,31900,23100,55000
355140,202105,184,111,73,122100,80300,202400
355150,202105,652,380,272,418000,300300,718300
355160,202105,469,224,245,246400.63,269500,515900.63
355170,202105,2016,1051,965,1159400,1062600,2222000
355180,202105,678,275,403,302500,443300,745800
355190,202105,211,139,72,154000,79200,233200
355200,202105,108,60,48,66000,52800,118800
355210,202105,687,378,309,415800,339900,755700
355220,202105,7164,3626,3538,3993000,3898400,7891400
355230,202105,98,60,38,66000,41800,107800
355240,202105,4429,1825,2604,2008600.5,2872100,4880700.5
355250,202105,5891,2577,3314,2835821.06,3647600,6483421.06
355255,202105,49,28,21,30800,23100,53900
355260,202105,175,108,67,118800,75900,194700
355270,202105,165,107,58,117700,63800,181500
355280,202105,6485,2473,4012,2722500,4419800,7142300
355290,202105,73,59,14,64900,15400,80300
355300,202105,207,121,86,134200,94600,228800
355310,202105,108,57,51,63800,56100,119900
355320,202105,93,49,44,53900,48400,102300
355330,202105,277,155,122,171600,134200,305800
355340,202105,1439,491,948,540100.55,1045000,1585100.55
355350,202105,152,74,78,81400,85800,167200
355360,202105,173,114,59,125400,64900,190300
355365,202105,18,14,4,15400,4400,19800
355370,202105,1017,604,413,664400.63,455400,1119800.63
355380,202105,806,500,306,553300,338800,892100
355385,202105,76,51,25,56100,27500,83600
355390,202105,110,60,50,66000,55000,121000
355395,202105,187,102,85,113300.5,93500,206800.5
355400,202105,1707,999,708,1098809,778800.63,1877609.63
355410,202105,4876,2272,2604,2501400,2868800,5370200
355420,202105,49,35,14,39600,15400,55000
355430,202105,395,247,148,271700,162800,434500
355440,202105,82,50,32,55000,35200,90200
355450,202105,435,213,222,234300,244200,478500
355460,202105,61,48,13,52800,14300,67100
355465,202105,44,26,18,28600,19800,48400
355470,202105,180,74,106,81400,116600,198000
355475,202105,13,9,4,9900,4400,14300
355480,202105,561,231,330,254100,363000,617100
355490,202105,110,75,35,83600,38500,122100
355495,202105,66,23,43,25300,47300,72600
355500,202105,1553,856,697,944900.48,767800,1712700.48
355510,202105,270,195,75,214500.63,82500,297000.63
355520,202105,30,22,8,24200,8800,33000
355530,202105,22,11,11,12100,12100,24200
355535,202105,73,32,41,35200,45100,80300
355540,202105,2531,985,1546,1083655.1,1700600.63,2784255.73
355550,202105,60,37,23,40700,25300,66000
355560,202105,246,115,131,127600,144100,271700
355570,202105,20,13,7,14300,7700,22000
355580,202105,244,173,71,191400,78100,269500
355590,202105,16,9,7,9900,7700,17600
355600,202105,266,136,130,150700,143000,293700
355610,202105,222,146,76,160600,83600,244200
355620,202105,1287,562,725,619300,797500,1416800
355630,202105,414,308,106,339900,116600.63,456500.63
355635,202105,117,53,64,58300,70400,128700
355640,202105,538,300,238,330000,261800,591800
355645,202105,857,333,524,366300,578600,944900
355650,202105,1910,808,1102,889900,1215500,2105400
355660,202105,235,125,110,137500,122100,259600
355670,202105,580,241,339,266200,374000,640200
355680,202105,203,110,93,122100,102300,224400
355690,202105,91,42,49,46200,55000,101200
355695,202105,23,13,10,14300,11000,25300
355700,202105,1137,582,555,640200,611600,1251800
355710,202105,2189,1183,1006,1306800,1108800,2415600
355715,202105,13,11,2,12100,2200,14300
355720,202105,230,141,89,155100,99000,254100
355730,202105,99,56,43,61600,47300,108900
410010,202105,132,104,28,114400,30800,145200
410020,202105,118,89,29,97900,31900,129800
410030,202105,173,95,78,104500,85800,190300
410040,202105,1229,605,624,667700,687500,1355200
410045,202105,39,30,9,33000,9900,42900
410050,202105,484,272,212,299200,235400,534600
410060,202105,278,201,77,221100,84700,305800
410070,202105,279,231,48,256300,52800,309100
410080,202105,174,105,69,116600,75900,192500
410090,202105,70,60,10,66000,11000,77000
410100,202105,288,196,92,216700,101200,317900
410105,202105,45,26,19,28600,20900,49500
410110,202105,333,196,137,215600,150700,366300
410115,202105,35,21,14,24200,15400,39600
410120,202105,430,200,230,221100,254100,475200
410130,202105,55,33,22,36300,24200,60500
410140,202105,3127,1435,1692,1579600.03,1863400.88,3443000.91
410150,202105,2655,1022,1633,1125300,1798500,2923800
410160,202105,499,296,203,325600,224400,550000
410165,202105,48,29,19,31900,20900,52800
410170,202105,181,114,67,127600,73700,201300
410180,202105,2261,1236,1025,1359600,1128600,2488200
410185,202105,28,24,4,26400,4400,30800
410190,202105,491,305,186,335500,204600,540100
410200,202105,945,667,278,733700,305800,1039500
410210,202105,616,308,308,338800,342100,680900
410220,202105,48,21,27,23100,29700,52800
410230,202105,153,67,86,73700,94600,168300
410240,202105,738,463,275,509300,302500,811800
410250,202105,372,261,111,287100,123200,410300
410260,202105,300,167,133,183700,146300,330000
410270,202105,29,22,7,24200,7700,31900
410275,202105,59,43,16,47300,17600,64900
410280,202105,321,182,139,200200,152900,353100
410290,202105,255,143,112,157300,123200,280500
410300,202105,82,55,27,60500,29700,90200
410302,202105,24,15,9,16500,9900,26400
410304,202105,34,23,11,25300,12100,37400
410305,202105,221,115,106,126500,116600,243100
410310,202105,213,126,87,138600,95700,234300
410315,202105,44,31,13,34100,14300,48400
410320,202105,142,93,49,103400,53900,157300
410322,202105,31,18,13,19800,14300,34100
410330,202105,181,120,61,132000,67100,199100
410335,202105,102,57,45,62700,49500,112200
410337,202105,45,34,11,37400,12100,49500
410340,202105,39,32,7,35200,7700,42900
410345,202105,204,115,89,126500,99000,225500
410347,202105,47,36,11,39600,12100,51700
410350,202105,253,141,112,155100,124300,279400
410360,202105,450,278,172,306900,190300,497200
410370,202105,2298,942,1356,1036200,1492700,2528900
410380,202105,203,121,82,133100,90200,223300
410390,202105,388,263,125,289300,137500,426800
410395,202105,35,22,13,24200,14300,38500
410400,202105,862,373,489,410300.5,537900,948200.5
410405,202105,86,65,21,71500,23100,94600
410410,202105,27,18,9,19800,9900,29700
410420,202105,1715,791,924,870002.1,1018600,1888602.1
410425,202105,185,72,113,79200,124300,203500
410430,202105,2294,1233,1061,1358500,1168200,2526700
410440,202105,374,270,104,298100,114400,412500
410442,202105,361,234,127,257400,139700,397100
410445,202105,423,304,119,334400,130900,465300
410450,202105,386,190,196,210100,215600,425700
410460,202105,543,274,269,301400,297000,598400
410465,202105,237,134,103,147400,113300,260700
410470,202105,248,143,105,157300,116600,273900
410480,202105,6299,2948,3351,3245000,3691600,6936600
410490,202105,1427,837,590,920700,649000,1569700
410500,202105,271,154,117,169400,128700,298100
410510,202105,177,127,50,140800,55000,195800
410520,202105,262,191,71,210100,78100,288200
410530,202105,307,101,206,111100,227700,338800
410540,202105,326,242,84,266200,92400,358600
410550,202105,1700,696,1004,766700,1106600,1873300
410560,202105,148,103,45,113300,49500,162800
410570,202105,424,279,145,306900,159500,466400
410580,202105,3520,1471,2049,1619201.04,2261600,3880801.04
410590,202105,391,255,136,280481,149600,430081
410600,202105,192,165,27,181500,30800,212300
410610,202105,50,42,8,46200,8800,55000
410620,202105,260,172,88,189200.4,96800,286000.4
410630,202105,443,240,203,264000,223300,487300
410640,202105,1025,637,388,700700,426800,1127500
410645,202105,110,78,32,85800,35200,121000
410650,202105,362,226,136,248600,149600,398200
410655,202105,91,63,28,70400,30800,101200
410657,202105,30,11,19,12100,20900,33000
410660,202105,615,413,202,454300.5,222200,676500.5
410670,202105,73,60,13,66000,15400,81400
410680,202105,199,159,40,174900,44000,218900
410685,202105,26,15,11,16500,12100,28600
410690,202105,28526,11779,16747,12982200.1,18441500.74,31423700.84
410700,202105,322,236,86,259600,94600,354200
410710,202105,128,103,25,113300,27500,140800
410712,202105,42,28,14,30800,15400,46200
410715,202105,88,66,22,72600,24200,96800
410720,202105,686,383,303,422400.92,334400,756800.92
410725,202105,178,125,53,138600,58300,196900
410730,202105,98,47,51,51700,56100,107800
410740,202105,109,74,35,81400,38500,119900
410750,202105,290,189,101,207900,112200,320100
410752,202105,21,13,8,14300,8800,23100
410753,202105,59,23,36,25300,39600,64900
410754,202105,53,27,26,29700,28600,58300
410755,202105,83,49,34,53900,37400,91300
410760,202105,768,415,353,457600,390500,848100
410765,202105,1802,814,988,895400,1086800,1982200
410770,202105,114,83,31,91300,34100,125400
410773,202105,57,38,19,41800,20900,62700
410775,202105,184,136,48,149600,53900,203500
410780,202105,89,48,41,52800,45100,97900
410785,202105,58,46,12,50600,13200,63800
410790,202105,90,38,52,41800,57200,99000
410800,202105,280,176,104,193600,114400,308000
410810,202105,21,13,8,14300,8800,23100
410820,202105,171,120,51,132000,56100,188100
410830,202105,8700,3642,5058,4012800.4,5575900,9588700.4
410832,202105,107,71,36,78100,39600,117700
410840,202105,1453,768,685,844800.21,756800,1601600.21
410845,202105,46,29,17,31900,18700,50600
410850,202105,179,127,52,139700,57200,196900
410855,202105,65,55,10,60500,11000,71500
410860,202105,758,387,371,426800,408100,834900
410865,202105,98,71,27,78100,29700,107800
410870,202105,146,125,21,137500,23100,160600
410880,202105,1143,560,583,616000,641300,1257300
410890,202105,87,60,27,67100,29700,96800
410895,202105,74,56,18,61600,19800,81400
410900,202105,26,18,8,19800,8800,28600
410910,202105,19,13,6,15400,6600,22000
410920,202105,39,23,16,25300,17600,42900
410930,202105,535,327,208,360800,229900,590700
410940,202105,4413,2364,2049,2604800.6,2263800,4868600.6
410950,202105,105,76,29,83600,31900,115500
410960,202105,852,334,518,367400,570900,938300
410965,202105,66,45,21,49500,23100,72600
410970,202105,619,431,188,475200,207900,683100
410975,202105,130,79,51,86900.38,56100,143000.38
410980,202105,1633,719,914,792000,1006500,1798500
410990,202105,272,191,81,210100,89100,299200
411000,202105,65,36,29,39600,31900,71500
411005,202105,29,23,6,25300,6600,31900
411007,202105,255,146,109,160600,119900,280500
411010,202105,599,394,205,433400,225500,658900
411020,202105,290,190,100,209000,110000,319000
411030,202105,20,11,9,12100,9900,22000
411040,202105,55,38,17,41800,18700,60500
411050,202105,215,161,54,177100,59400,236500
411060,202105,513,343,170,377300,187000,564300
411065,202105,51,46,5,50600,5500,56100
411070,202105,1252,726,526,799700,581900,1381600
411080,202105,245,172,73,189200,80300,269500
411090,202105,95,73,22,82500,24200,106700
411095,202105,307,111,196,122100,215600,337700
411100,202105,122,95,27,104500,29700,134200
411110,202105,130,77,53,84700,58300,143000
411120,202105,219,142,77,156200,85800,242000
411125,202105,258,111,147,122100,162800,284900
411130,202105,123,103,20,113300,22000,135300
411140,202105,215,142,73,157300,80300,237600
411150,202105,1248,806,442,889900,487300.63,1377200.63
411155,202105,119,82,37,90200,40700,130900
411160,202105,26,10,16,11000,17600,28600
411170,202105,48,43,5,47300,5500,52800
411180,202105,981,639,342,702900,378400,1081300
411190,202105,332,186,146,204600,160600,365200
411200,202105,667,398,269,437800.63,295900,733700.63
411210,202105,681,360,321,396000,354200,750200
411220,202105,163,110,53,121000,58300,179300
411230,202105,39,32,7,35200,7700,42900
411240,202105,115,71,44,79200,48400,127600
411250,202105,430,311,119,342100,130900,473000
411260,202105,15,11,4,12100,4400,16500
411270,202105,269,137,132,150700,145200,295900
411275,202105,183,159,24,174900,26400,201300
411280,202105,202,140,62,155100.63,68200,223300.63
411290,202105,62,48,14,52800,15400,68200
411295,202105,128,102,26,112200,28600,140800
411300,202105,81,36,45,39600,50600,90200
411310,202105,94,69,25,75900,27500,103400
411320,202105,798,515,283,566500,311300,877800
411325,202105,54,37,17,40700,18700,59400
411330,202105,913,589,324,647900,356400.15,1004300.15
411340,202105,29,18,11,19800,12100,31900
411342,202105,56,41,15,45100,16500,61600
411345,202105,114,58,56,63800,61600,125400
411350,202105,503,374,129,412500,141900,554400
411360,202105,54,34,20,37400,22000,59400
411370,202105,14200,5613,8587,6186401.26,9466601.34,15653002.60
411373,202105,179,118,61,129800,67100,196900
411375,202105,81,65,16,71500,18700,90200
411380,202105,84,61,23,67100,25300,92400
411390,202105,130,75,55,82500,60500,143000
411400,202105,402,277,125,304700,139700,444400
411410,202105,467,216,251,238700,276100,514800
411420,202105,972,415,557,458700,613800,1072500
411430,202105,495,272,223,299200,246400,545600
411435,202105,31,18,13,19800,14300,34100
411440,202105,471,366,105,402600,115500,518100
411450,202105,421,355,66,391600,74800,466400
411460,202105,783,294,489,323400,537900.66,861300.66
411470,202105,93,64,29,70400,31900,102300
411480,202105,689,366,323,403700,355300,759000
411490,202105,292,186,106,205700,116600,322300
411500,202105,101,81,20,89100,22000,111100
411510,202105,219,172,47,189200,51700,240900
411520,202105,6035,2165,3870,2382600,4262500.7,6645100.7
411530,202105,128,84,44,92400,48400,140800
411535,202105,50,19,31,20900,34100,55000
411540,202105,365,246,119,271700,130900,402600
411545,202105,54,38,16,41800,17600,59400
411550,202105,83,62,21,68200,23100,91300
411560,202105,401,165,236,181500,259600,441100
411570,202105,902,317,585,348700,643500,992200
411573,202105,24,14,10,15400,11000,26400
411575,202105,304,186,118,204600,129800,334400
411580,202105,1270,448,822,492800,904200,1397000
411585,202105,72,33,39,36300,42900,79200
411590,202105,18,12,6,13200,6600,19800
411600,202105,23,10,13,11000,14300,25300
411605,202105,245,97,148,106700,162800,269500
411610,202105,210,134,76,148500,84700,233200
411620,202105,381,196,185,215600,203500,419100
411630,202105,52,36,16,39600,17600,57200
411640,202105,34,23,11,25300,12100,37400
411650,202105,10,6,4,6600,4400,11000
411660,202105,40,27,13,29700,14300,44000
411670,202105,240,170,70,187000,77000,264000
411680,202105,166,134,32,148500,35200,183700
411690,202105,604,312,292,343200,322300,665500
411695,202105,65,45,20,49500,22000,71500
411700,202105,143,114,29,125400,31900,157300
411705,202105,107,71,36,78100,39600,117700
411710,202105,289,193,96,212300,105600,317900
411720,202105,132,86,46,94600,50600,145200
411721,202105,76,60,16,66000,17600,83600
411722,202105,106,43,63,47300,69300,116600
411725,202105,158,115,43,126500,47300,173800
411727,202105,92,70,22,77000,24200,101200
411729,202105,42,31,11,34100,12100,46200
411730,202105,548,340,208,375100,228800,603900
411740,202105,32,18,14,19800,15400,35200
411745,202105,66,47,19,51700,20900,72600
411750,202105,840,360,480,396000,528000,924000
411760,202105,1172,854,318,941600,349800,1291400
411770,202105,448,295,153,324500,168300,492800
411780,202105,361,232,129,255200,143000,398200
411790,202105,541,300,241,331100.18,266200,597300.18
411800,202105,150,112,38,123200.65,41800,165000.65
411810,202105,181,134,47,147400,51700,199100
411820,202105,2307,977,1330,1075800,1466300,2542100
411830,202105,10,9,1,9900,1100,11000
411840,202105,2054,1217,837,1338700,920700,2259400
411845,202105,61,21,40,23100,44000,67100
411850,202105,1216,658,558,726000,613800,1339800
411860,202105,50,31,19,34100,20900,55000
411870,202105,70,43,27,47300,29700,77000
411880,202105,434,265,169,291500,185900,477400
411885,202105,103,63,40,69300,44000,113300
411890,202105,305,198,107,217800,117700,335500
411900,202105,96,67,29,73700,31900,105600
411910,202105,184,141,43,155100,47300,202400
411915,202105,2286,901,1385,992200,1526800,2519000
411920,202105,118,91,27,100100,29700,129800
411925,202105,13,8,5,8800,5500,14300
411930,202105,804,573,231,631470.4,254100,885570.4
411940,202105,582,376,206,413600,226600,640200
411950,202105,1086,506,580,556600.24,640200,1196800.24
411960,202105,1107,718,389,789800,427900,1217700
411965,202105,24,14,10,15400,11000,26400
411970,202105,93,79,14,86900,15400,102300
411980,202105,191,108,83,118800,91300,210100
411990,202105,5114,2823,2291,3113001.42,2527871.5,5640872.92
411995,202105,561,175,386,193600,424600,618200
412000,202105,322,205,117,225500,128700,354200
412010,202105,46,28,18,30800,19800,50600
412015,202105,38,29,9,31900,9900,41800
412020,202105,21,17,4,18700,4400,23100
412030,202105,46,43,3,47300,3300,50600
412033,202105,58,31,27,34100,29700,63800
412035,202105,72,45,27,49500,29700,79200
412040,202105,41,22,19,25300,20900,46200
412050,202105,208,153,55,168300,60500,228800
412060,202105,771,559,212,614900,237600,852500
412065,202105,50,30,20,33000,22000,55000
412070,202105,173,120,53,132000,58300,190300
412080,202105,306,145,161,159500,177100,336600
412085,202105,38,15,23,16500,25300,41800
412090,202105,829,512,317,564300,348700,913000
412100,202105,262,217,45,238700,49500,288200
412110,202105,69,53,16,58300,17600,75900
412120,202105,334,190,144,209000,158400,367400
412125,202105,72,47,25,51700,27500,79200
412130,202105,41,25,16,27500,17600,45100
412135,202105,28,15,13,16500,14300,30800
412140,202105,357,226,131,248600,144100,392700
412150,202105,244,158,86,173800,94600,268400
412160,202105,89,51,38,56100,41800,97900
412170,202105,700,478,222,528000,244200,772200
412175,202105,34,26,8,28600,8800,37400
412180,202105,189,143,46,157300,50600,207900
412190,202105,321,252,69,277200,75900,353100
412200,202105,185,116,69,128700,75900,204600
412210,202105,93,70,23,77000,25300,102300
412215,202105,238,161,77,177423.4,84700,262123.4
412217,202105,62,50,12,56100,13200,69300
412220,202105,823,565,258,621500,283800,905300
412230,202105,312,188,124,207900,136400,344300
412240,202105,1335,642,693,707300,763400,1470700
412250,202105,409,249,160,273900,176000,449900
412260,202105,109,75,34,82500,37400,119900
412265,202105,180,135,45,148500,50600,199100
412270,202105,89,60,29,66000,31900,97900
412280,202105,88,69,19,75900,20900,96800
412290,202105,92,63,29,69300,31900,101200
412300,202105,210,143,67,157300,73700,231000
412310,202105,53,43,10,47300,11000,58300
412320,202105,94,76,18,84700,20900,105600
412330,202105,182,150,32,165000,35200,200200
412340,202105,162,110,52,121000,57200,178200
412350,202105,640,300,340,330000,375100,705100
412360,202105,25,21,4,23100,4400,27500
412370,202105,158,135,23,149600,25300,174900
412380,202105,227,171,56,188100,61600,249700
412382,202105,58,34,24,37400,26400,63800
412385,202105,156,109,47,119900,52800,172700
412390,202105,297,221,76,243100,83600,326700
412395,202105,70,57,13,62700,14300,77000
412400,202105,97,65,32,71500,35200,106700
412402,202105,230,114,116,125400,127600,253000
412405,202105,898,301,597,332200,656700,988900
412410,202105,968,582,386,640200,429000,1069200
412420,202105,17,16,1,17600,1100,18700
412430,202105,21,19,2,20900,2200,23100
412440,202105,628,328,300,361900,330000,691900
412450,202105,76,67,9,73700,9900,83600
412460,202105,91,69,22,75900,24200,100100
412470,202105,215,170,45,187000,50600,237600
412480,202105,145,105,40,115500,44000,159500
412490,202105,156,136,20,150700,22000,172700
412500,202105,423,338,85,372900.44,93500,466400.44
412510,202105,172,140,32,154000,35200,189200
412520,202105,94,60,34,66000,37400,103400
412530,202105,109,54,55,59400,60500,119900
412535,202105,88,65,23,71500,25300,96800
412540,202105,83,40,43,44000,47300,91300
412545,202105,87,58,29,63800,31900,95700
412550,202105,3931,1582,2349,1742400,2588300.49,4330700.49
412555,202105,10,6,4,6600,4400,11000
412560,202105,629,429,200,473000,220000,693000
412570,202105,785,378,407,416900,447700,864600
412575,202105,95,65,30,71500,33000,104500
412580,202105,173,116,57,127600,62700,190300
412590,202105,34,29,5,31900,5500,37400
412600,202105,176,126,50,138600,55000,193600
412610,202105,34,14,20,15400,22000,37400
412620,202105,148,124,24,136400,26400,162800
412625,202105,2112,1052,1060,1158300.63,1166000,2324300.63
412627,202105,68,49,19,53900,20900,74800
412630,202105,391,254,137,279400,150700,430100
412635,202105,67,19,48,20900,52800,73700
412640,202105,101,73,28,80300,30800,111100
412650,202105,329,214,115,235400,126500,361900
412660,202105,461,269,192,295900,212300,508200
412665,202105,44,39,5,42900,5500,48400
412667,202105,306,198,108,217800,118800,336600
412670,202105,68,56,12,61600,13200,74800
412680,202105,304,228,76,251900,83600,335500
412690,202105,115,72,43,79200,47300,126500
412700,202105,169,111,58,122100,63800,185900
412710,202105,1327,768,559,847000,616000,1463000
412720,202105,233,137,96,150700,105600,256300
412730,202105,182,154,28,169400,30800,200200
412740,202105,421,213,208,235400,228800,464200
412750,202105,428,235,193,258500,212300,470800
412760,202105,306,149,157,165000,172700,337700
412770,202105,2119,1153,966,1269400.63,1064800,2334200.63
412780,202105,139,105,34,115500,37400,152900
412785,202105,303,146,157,160600,173800,334400
412788,202105,40,23,17,25300,18700,44000
412790,202105,122,98,24,108900,26400,135300
412795,202105,150,106,44,116600,49500,166100
412796,202105,308,196,112,216700,123200,339900
412800,202105,648,383,265,422400,291500,713900
412810,202105,2994,1580,1414,1741300.62,1557600,3298900.62
412820,202105,935,560,375,617100,413600,1030700
412830,202105,13,10,3,11000,3300,14300
412840,202105,233,158,75,173800,82500,256300
412850,202105,743,466,277,512600,305800,818400
412853,202105,170,82,88,90200,96800,187000
412855,202105,193,99,94,108900.26,103400,212300.26
412860,202105,97,66,31,72600,34100,106700
412862,202105,58,37,21,40700,23100,63800
412863,202105,8,6,2,6600,2200,8800
412865,202105,44,32,12,35200,13200,48400
412870,202105,104,61,43,67100,47300,114400
412880,202105,91,64,27,70400,29700,100100
420005,202105,40,36,4,39600,4400,44000
420010,202105,366,233,133,256300,146300,402600
420020,202105,80,66,14,72600,15400,88000
420030,202105,25,21,4,23100,4400,27500
420040,202105,98,77,21,84700,23100,107800
420050,202105,56,33,23,36300,25300,61600
420055,202105,18,18,0,19800,0,19800
420060,202105,28,21,7,23100,7700,30800
420070,202105,103,87,16,95700,17600,113300
420075,202105,11,11,0,12100,0,12100
420080,202105,41,36,5,39600,5500,45100
420090,202105,36,31,5,34100,5500,39600
420100,202105,152,128,24,140800,26400,167200
420110,202105,20,20,0,22000,0,22000
420120,202105,57,41,16,45100,17600,62700
420125,202105,83,65,18,71500,19800,91300
420127,202105,32,26,6,28600,6600,35200
420130,202105,441,260,181,286000,199100,485100
420140,202105,1308,724,584,799700,643500,1443200
420150,202105,46,36,10,39600,11000,50600
420160,202105,30,28,2,30800,2200,33000
420165,202105,16,11,5,12100,5500,17600
420170,202105,64,38,26,41800,28600,70400
420180,202105,20,17,3,18700,3300,22000
420190,202105,25,22,3,24200,3300,27500
420195,202105,134,65,69,71500,75900,147400
420200,202105,1264,546,718,600600,792000,1392600
420205,202105,91,50,41,55000,45100,100100
420207,202105,128,70,58,77000,63800,140800
420208,202105,22,17,5,18700,5500,24200
420209,202105,16,14,2,15400,2200,17600
420210,202105,526,246,280,270600,308000,578600
420213,202105,47,36,11,39600,12100,51700
420215,202105,28,24,4,26400,4400,30800
420220,202105,59,35,24,38500,26400,64900
420230,202105,849,489,360,537900,397100,935000
420240,202105,2195,1416,779,1559800.02,856900,2416700.02
420243,202105,43,34,9,37400,9900,47300
420245,202105,171,85,86,93500,94600,188100
420250,202105,62,41,21,45100,23100,68200
420253,202105,25,19,6,20900,6600,27500
420257,202105,12,9,3,9900,3300,13200
420260,202105,103,81,22,89100,24200,113300
420270,202105,27,22,5,24200,5500,29700
420280,202105,287,217,70,238700,77000,315700
420285,202105,22,15,7,16500,7700,24200
420287,202105,48,32,16,35200,17600,52800
420290,202105,948,646,302,712800,333300,1046100
420300,202105,1452,1146,306,1261700,336600,1598300
420310,202105,49,32,17,35200,18700,53900
420315,202105,32,25,7,27500,7700,35200
420320,202105,979,467,512,514800,563200,1078000
420325,202105,3,1,2,1100,2200,3300
420330,202105,125,82,43,91300,48400,139700
420340,202105,171,115,56,126500,61600,188100
420350,202105,262,181,81,199100,89100,288200
420360,202105,698,534,164,588500.88,180400,768900.88
420370,202105,128,73,55,81400,60500,141900
420380,202105,1193,820,373,904200.63,411400,1315600.63
420390,202105,235,163,72,179300,79200,258500
420395,202105,191,134,57,147400,62700,210100
420400,202105,243,187,56,205700,61600,267300
420410,202105,59,45,14,49500,15400,64900
420415,202105,32,28,4,30800,4400,35200
420417,202105,52,41,11,45100,12100,57200
420419,202105,13,12,1,13200,1100,14300
420420,202105,2788,1721,1067,1895300,1177000,3072300
420425,202105,72,58,14,64900,15400,80300
420430,202105,1119,801,318,881100,349800,1230900
420435,202105,14,12,2,13200,2200,15400
420440,202105,101,73,28,80300,30800,111100
420445,202105,27,26,1,28600,1100,29700
420450,202105,77,35,42,38500,46200,84700
420455,202105,202,153,49,168300,53900,222200
420460,202105,2324,1480,844,1631300,929500,2560800
420470,202105,96,68,28,74800,30800,105600
420475,202105,9,8,1,8800,1100,9900
420480,202105,866,648,218,713900,239800,953700
420490,202105,99,72,27,79200,29700,108900
420500,202105,446,236,210,260700.26,231000,491700.26
420510,202105,19,18,1,19800,1100,20900
420515,202105,29,17,12,18700,13200,31900
420517,202105,9,9,0,9900,0,9900
420519,202105,0,,,,,0.0
420520,202105,65,48,17,52800,18700,71500
420530,202105,157,102,55,113300,60500,173800
420535,202105,19,17,2,18700,2200,20900
420540,202105,5700,3441,2259,3790875,2487100,6277975
420543,202105,31,29,2,31900,2200,34100
420545,202105,212,151,61,167200,67100,234300
420550,202105,828,681,147,751300,163900,915200
420555,202105,27,17,10,18700,11000,29700
420560,202105,60,50,10,55000,11000,66000
420570,202105,176,98,78,108900,85800,194700
420580,202105,281,131,150,144100,165000,309100
420590,202105,480,317,163,349800,179300,529100
420600,202105,134,73,61,80300,67100,147400
420610,202105,39,35,4,38500,4400,42900
420620,202105,82,62,20,68200,22000,90200
420630,202105,147,94,53,105600,58300,163900
420640,202105,80,70,10,77000,11000,88000
420650,202105,254,125,129,137500,141900,279400
420660,202105,48,39,9,42900,9900,52800
420665,202105,40,26,14,28600,15400,44000
420670,202105,288,228,60,250800,67100,317900
420675,202105,13,11,2,12100,2200,14300
420680,202105,35,25,10,27500,11000,38500
420690,202105,177,137,40,150700,44000,194700
420700,202105,682,448,234,492800.7,258500,751300.7
420710,202105,144,77,67,84700,73700,158400
420720,202105,103,81,22,89100,24200,113300
420730,202105,643,388,255,426800,281600,708400
420740,202105,54,53,1,58300,1100,59400
420750,202105,475,313,162,346500,178200,524700
420757,202105,19,17,2,18700,2200,20900
420760,202105,37,29,8,31900,8800,40700
420765,202105,81,60,21,66000,23100,89100
420768,202105,47,40,7,45100,7700,52800
420770,202105,72,59,13,64900,14300,79200
420775,202105,40,37,3,40700,3300,44000
420780,202105,206,161,45,177100,49500,226600
420785,202105,21,13,8,14300,8800,23100
420790,202105,153,125,28,139700,30800,170500
420800,202105,63,46,17,50600,18700,69300
420810,202105,263,214,49,235400,53900,289300
420820,202105,2399,1338,1061,1471800,1169300.5,2641100.5
420830,202105,618,324,294,357500,324500,682000
420840,202105,152,105,47,115500,51700,167200
420845,202105,413,172,241,189200,265100,454300
420850,202105,256,187,69,205700,75900,281600
420860,202105,54,44,10,48400,11000,59400
420870,202105,134,94,40,103400,44000,147400
420880,202105,180,114,66,127600,72600,200200
420890,202105,948,463,485,510400,535700,1046100
420895,202105,8,8,0,8800,0,8800
420900,202105,403,318,85,349800,93500,443300
420910,202105,5739,3100,2639,3421001.3,2910600,6331601.3
420915,202105,60,55,5,60500,5500,66000
420917,202105,22,15,7,16500,7700,24200
420920,202105,20,14,6,15400,7700,23100
420930,202105,2884,1805,1079,1993129,1189100.77,3182229.77
420940,202105,587,432,155,475200,170500,645700
420945,202105,10,7,3,7700,3300,11000
420950,202105,51,44,7,48400,7700,56100
420960,202105,109,88,21,96800,23100,119900
420970,202105,282,227,55,249700,60500,310200
420980,202105,23,22,1,24200,1100,25300
420985,202105,57,51,6,56100,6600,62700
420990,202105,82,60,22,66000,24200,90200
421000,202105,47,27,20,29700,22000,51700
421003,202105,46,32,14,35200,15400,50600
421005,202105,7,4,3,4400,3300,7700
421010,202105,799,523,276,575300,303600,878900
421020,202105,24,18,6,19800,6600,26400
421030,202105,115,98,17,107800,18700,126500
421040,202105,72,53,19,58300,20900,79200
421050,202105,338,229,109,253000,119900,372900
421055,202105,21,16,5,17600,5500,23100
421060,202105,90,49,41,53900,45100,99000
421070,202105,38,32,6,35200,6600,41800
421080,202105,34,30,4,33000,4400,37400
421085,202105,22,18,4,19800,4400,24200
421090,202105,35,27,8,29700,8800,38500
421100,202105,124,91,33,100100,36300,136400
421105,202105,185,149,36,165000,39600,204600
421110,202105,113,86,27,94600,29700,124300
421120,202105,178,129,49,143000.92,53900,196900.92
421125,202105,18,12,6,13200,6600,19800
421130,202105,829,508,321,559900,353100,913000
421140,202105,33,22,11,24200,12100,36300
421145,202105,47,35,12,38500,13200,51700
421150,202105,99,71,28,78100,30800,108900
421160,202105,66,44,22,48400,24200,72600
421165,202105,16,13,3,14300,3300,17600
421170,202105,181,152,29,167332,31900,199232
421175,202105,165,110,55,121000,60500,181500
421180,202105,43,29,14,33000,15400,48400
421185,202105,16,12,4,13200,4400,17600
421187,202105,1,0,1,0,1100,1100
421189,202105,46,31,15,34100,16500,50600
421190,202105,1748,1083,665,1193500,732600,1926100
421200,202105,94,69,25,75900,27500,103400
421205,202105,26,17,9,18700,9900,28600
421210,202105,178,124,54,136400,59400,195800
421220,202105,263,200,63,220000,69300,289300
421223,202105,45,35,10,38500,11000,49500
421225,202105,69,43,26,47300,28600,75900
421227,202105,80,63,17,69300,18700,88000
421230,202105,57,43,14,47300,15400,62700
421240,202105,17,17,0,18700,0,18700
421250,202105,368,209,159,229900,174900,404800
421260,202105,22,18,4,19800,4400,24200
421265,202105,3,3,0,3300,0,3300
421270,202105,49,43,6,47300,6600,53900
421280,202105,352,184,168,202400,184800,387200
421290,202105,329,216,113,238700,124300,363000
421300,202105,24,19,5,20900,5500,26400
421310,202105,51,35,16,38500,17600,56100
421315,202105,31,17,14,18700,15400,34100
421320,202105,124,78,46,85800,50600,136400
421330,202105,106,77,29,84700,31900,116600
421335,202105,41,29,12,31900,13200,45100
421340,202105,242,156,86,171600,94600,266200
421350,202105,185,107,78,117700.39,85800,203500.39
421360,202105,682,479,203,528000,223300,751300
421370,202105,191,142,49,157300,53900,211200
421380,202105,131,102,29,112200,31900,144100
421390,202105,16,10,6,11000,6600,17600
421400,202105,116,97,19,107800,20900,128700
421410,202105,21,18,3,19800,3300,23100
421415,202105,18,17,1,18700,1100,19800
421420,202105,109,92,17,101200,18700,119900
421430,202105,19,14,5,15400,5500,20900
421440,202105,59,52,7,57200,8800,66000
421450,202105,89,73,16,80300,17600.51,97900.51
421460,202105,58,44,14,48400,15400,63800
421470,202105,69,40,29,44000,31900,75900
421480,202105,741,562,179,619300,196900,816200
421490,202105,26,25,1,27500,1100,28600
421500,202105,485,301,184,331100,203500,534600
421505,202105,23,17,6,18700,6600,25300
421507,202105,33,26,7,28600,7700,36300
421510,202105,72,47,25,51700,28600,80300
421520,202105,55,45,10,49500,11000,60500
421530,202105,52,44,8,48400,8800,57200
421535,202105,21,20,1,22000,1100,23100
421540,202105,50,39,11,42900,12100,55000
421545,202105,85,61,24,67100,27500,94600
421550,202105,277,201,76,221100,84700,305800
421555,202105,18,17,1,18700,1100,19800
421560,202105,8,7,1,7700,1100,8800
421565,202105,122,82,40,90200,44000,134200
421567,202105,29,24,5,26400,6600,33000
421568,202105,44,39,5,42900,5500,48400
421569,202105,12,12,0,13200,0,13200
421570,202105,203,131,72,144100,79200,223300
421575,202105,25,22,3,24200,3300,27500
421580,202105,719,423,296,467572,326700,794272
421590,202105,20,19,1,20900,1100,22000
421600,202105,144,95,49,104500,55000,159500
421605,202105,113,78,35,85800,38500,124300
421610,202105,173,130,43,143000,47300,190300
421620,202105,1018,586,432,644600,476300,1120900
421625,202105,20,17,3,18700,3300,22000
421630,202105,325,202,123,223300,135300,358600
421635,202105,21,11,10,12100,11000,23100
421640,202105,100,83,17,91300,18700,110000
421650,202105,292,166,126,182600,138600,321200
421660,202105,2326,1379,947,1521300,1042800,2564100
421670,202105,175,124,51,136400,56100,192500
421680,202105,188,168,20,184800,22000,206800
421690,202105,343,236,107,259600,117700,377300
421700,202105,53,36,17,39600,18700,58300
421710,202105,25,23,2,25300,2200,27500
421715,202105,5,4,1,4400,1100,5500
421720,202105,624,436,188,479600,207900,687500
421725,202105,21,9,12,9900,13200,23100
421730,202105,28,20,8,22000,8800,30800
421740,202105,96,33,63,36300,71500,107800
421750,202105,203,148,55,162800,60500,223300
421755,202105,21,19,2,20900,2200,23100
421760,202105,100,65,35,71500,38500,110000
421770,202105,686,434,252,479600,280500,760100
421775,202105,27,17,10,18700,11000,29700
421780,202105,185,143,42,157300,46200,203500
421790,202105,145,123,22,135300,24200,159500
421795,202105,18,14,4,15400,4400,19800
421800,202105,526,326,200,358600,220000,578600
421810,202105,71,53,18,58300,19800,78100
421820,202105,295,188,107,206800,117700,324500
421825,202105,145,121,24,133100,26400,159500
421830,202105,146,90,56,99000,61600,160600
421835,202105,7,3,4,3300,4400,7700
421840,202105,46,40,6,45100,6600,51700
421850,202105,84,70,14,77000,15400,92400
421860,202105,46,33,13,36300,14300,50600
421870,202105,1023,758,265,834900,291500.21,1126400.21
421875,202105,53,44,9,48400,9900,58300
421880,202105,175,125,50,137500,55000,192500
421885,202105,24,18,6,19800,6600,26400
421890,202105,140,99,41,108900,46200.5,155100.5
421895,202105,48,43,5,47300,5500,52800
421900,202105,144,110,34,121000,37400,158400
421910,202105,60,37,23,40700,25300,66000
421915,202105,30,23,7,25300,7700,33000
421917,202105,35,25,10,27500,11000,38500
421920,202105,37,32,5,35200,5500,40700
421930,202105,628,492,136,542300,149600,691900
421935,202105,51,44,7,48400,7700,56100
421940,202105,48,40,8,44000,8800,52800
421950,202105,864,575,289,633600,319000,952600
421960,202105,40,35,5,38500,5500,44000
421970,202105,328,213,115,234300,127600,361900
421985,202105,22,13,9,14300,9900,24200
422000,202105,0,,,,,0.0
430003,202105,195,55,140,60500,154000,214500
430005,202105,36,26,10,28600,11000,39600
430010,202105,265,193,72,212300,79200,291500
430020,202105,145,96,49,105600.36,53900,159500.36
430030,202105,125,103,22,113300,24200,137500
430040,202105,2896,1693,1203,1864500,1324400,3188900
430045,202105,67,55,12,60500,13200,73700
430047,202105,7,6,1,6600,1100,7700
430050,202105,78,64,14,70400,15400,85800
430055,202105,11,10,1,11000,1100,12100
430057,202105,5,4,1,4400,1100,5500
430060,202105,3780,2166,1614,2387000,1777600,4164600
430063,202105,54,46,8,50600,8800,59400
430064,202105,156,123,33,135300,36300,171600
430066,202105,5,2,3,2200,3300,5500
430070,202105,41,30,11,33000,13200,46200
430080,202105,70,44,26,48400,28600,77000
430085,202105,27,10,17,11000,18700,29700
430087,202105,24,16,8,17600,8800,26400
430090,202105,69,60,9,66000,9900,75900
430100,202105,127,87,40,95700,45100,140800
430105,202105,150,82,68,90200,74800,165000
430107,202105,18,12,6,13200,6600,19800
430110,202105,476,259,217,284900,238700,523600
430120,202105,158,144,14,159500,15400,174900
430130,202105,779,471,308,519200,339900,859100
430140,202105,127,118,9,129800,9900,139700
430150,202105,104,65,39,73700,44000,117700
430155,202105,33,28,5,30800,5500,36300
430160,202105,3571,2053,1518,2260500,1673100,3933600
430163,202105,371,155,216,171600,239800,411400
430165,202105,32,22,10,24200,11000,35200
430170,202105,85,71,14,78100,15400,93500
430175,202105,73,58,15,63800,16500,80300
430180,202105,105,88,17,96800,18700,115500
430185,202105,27,18,9,19800,9900,29700
430187,202105,53,29,24,31900,26400,58300
430190,202105,228,123,105,135300,116600,251900
430192,202105,13,11,2,12100,2200,14300
430195,202105,19,12,7,13200,7700,20900
430200,202105,159,136,23,149600,25300,174900
430205,202105,20,20,0,22000,0,22000
430210,202105,683,516,167,568700,183700,752400
430215,202105,11,10,1,11000,1100,12100
430220,202105,71,47,24,51700,26400,78100
430222,202105,11,4,7,4400,7700,12100
430223,202105,15,9,6,9900,7700,17600
430225,202105,2,1,1,1100,1100,2200
430230,202105,311,186,125,204600,137500,342100
430235,202105,54,40,14,44000,15400,59400
430237,202105,24,18,6,19800,6600,26400
430240,202105,107,75,32,82500,35200,117700
430245,202105,73,58,15,63800,16500,80300
430250,202105,184,106,78,116600,85800,202400
430258,202105,8,7,1,7700,1100,8800
430260,202105,33,28,5,30800,5500,36300
430265,202105,33,28,5,30800,5500,36300
430270,202105,515,382,133,423500,147400,570900
430280,202105,1041,617,424,679800,466400,1146200
430290,202105,412,219,193,240900,212300,453200
430300,202105,2108,1135,973,1250700,1072500,2323200
430310,202105,2014,987,1027,1088816.66,1131900.7,2220717.36
430320,202105,54,45,9,49500,9900,59400
430330,202105,98,86,12,94600,13200,107800
430340,202105,69,55,14,60500,15400,75900
430350,202105,1643,1095,548,1204500,603900,1808400
430355,202105,19,18,1,19800,1100,20900
430360,202105,89,43,46,47300,50600,97900
430367,202105,35,25,10,27500,11000,38500
430370,202105,54,49,5,53900,5500,59400
430380,202105,124,95,29,104500,31900,136400
430390,202105,583,365,218,402600,239800,642400
430400,202105,255,184,71,202400,79200,281600
430410,202105,55,42,13,46200,14300,60500
430420,202105,502,322,180,354200,198000,552200
430430,202105,52,50,2,55367.4,2200,57567.4
430435,202105,149,112,37,123200,40700,163900
430440,202105,498,317,181,350900,199100,550000
430450,202105,1146,932,214,1026300,235400,1261700
430460,202105,5387,2744,2643,3019500,2912800,5932300
430461,202105,16,14,2,15400,2200,17600
430462,202105,5,3,2,3300,2200,5500
430463,202105,1114,590,524,649000,578600,1227600
430465,202105,24,13,11,14300,12100,26400
430466,202105,641,443,198,489500,217800,707300
430467,202105,112,62,50,68200,55000,123200
430468,202105,126,70,56,77000,61600,138600
430469,202105,21,16,5,17600,5500,23100
430470,202105,1146,632,514,698827.5,566500,1265327.5
430471,202105,61,39,22,42900,24200,67100
430480,202105,108,72,36,79200,39600,118800
430485,202105,7,7,0,7700,0,7700
430490,202105,73,58,15,63800,16500,80300
430495,202105,32,25,7,27500,7700,35200
430500,202105,190,129,61,141900,69300,211200
430510,202105,3537,2263,1274,2492600.67,1406900,3899500.67
430511,202105,16,16,0,17600,0,17600
430512,202105,141,96,45,105600,50600,156200
430513,202105,52,41,11,45100,12100,57200
430515,202105,25,24,1,26400,1100,27500
430517,202105,171,144,27,158400,29700,188100
430520,202105,336,236,100,259600,110000,369600
430530,202105,82,46,36,50600,39600,90200
430535,202105,439,293,146,322300,160600,482900
430537,202105,11,11,0,12100,0,12100
430540,202105,84,57,27,62700,29700,92400
430543,202105,370,111,259,122100,284900,407000
430544,202105,45,42,3,46200,3300,49500
430545,202105,355,162,193,180400,213400,393800
430550,202105,39,31,8,34100,8800,42900
430558,202105,1,1,0,1100,0,1100
430560,202105,54,30,24,33000,26400,59400
430570,202105,111,43,68,47300,74800,122100
430580,202105,129,104,25,114400,27500,141900
430583,202105,15,15,0,16500,0,16500
430585,202105,11,4,7,4400,7700,12100
430587,202105,15,9,6,9900,6600,16500
430590,202105,149,119,30,130900,33000,163900
430593,202105,2,2,0,2200,0,2200
430595,202105,18,15,3,16500,3300,19800
430597,202105,44,23,21,25300,23100,48400
430600,202105,214,160,54,176000,60500,236500
430605,202105,165,99,66,108900,72600,181500
430607,202105,28,22,6,24200,6600,30800
430610,202105,1690,771,919,849200,1013100,1862300
430613,202105,3,3,0,3300,0,3300
430620,202105,111,79,32,86900,35200,122100
430630,202105,45,38,7,41800,7700,49500
430632,202105,32,27,5,29700,5500,35200
430635,202105,38,34,4,37400,4400,41800
430637,202105,63,31,32,34100,35200,69300
430640,202105,180,98,82,107800,90200,198000
430642,202105,17,14,3,16500,3300,19800
430645,202105,30,25,5,27500,5500,33000
430650,202105,245,199,46,218900,50600,269500
430655,202105,4,2,2,2200,2200,4400
430660,202105,972,481,491,530200,540100,1070300
430670,202105,78,54,24,59400,26400,85800
430673,202105,71,44,27,48400,29700,78100
430675,202105,9,7,2,7700,2200,9900
430676,202105,539,316,223,347600,246400,594000
430680,202105,238,159,79,174900,86900,261800
430690,202105,517,318,199,349800,218900.63,568700.63
430692,202105,9,7,2,7700,2200,9900
430693,202105,146,91,55,101200,60500,161700
430695,202105,62,51,11,56100,12100,68200
430697,202105,61,36,25,39600,27500,67100
430700,202105,1457,989,468,1092300,514800,1607100
430705,202105,29,26,3,28600,3300,31900
430710,202105,253,156,97,171600,106700,278300
430720,202105,111,95,16,104500,17600,122100
430730,202105,143,123,20,135300,22000,157300
430740,202105,72,49,23,53900,25300,79200
430745,202105,30,23,7,25300,7700,33000
430750,202105,336,224,112,246400,123200,369600
430755,202105,85,44,41,48400,45100,93500
430760,202105,388,213,175,234300,192500,426800
430770,202105,1500,768,732,845900,805200,1651100
430780,202105,297,182,115,200200,126500,326700
430781,202105,25,22,3,24200,3300,27500
430783,202105,59,47,12,51700,13200,64900
430786,202105,5,3,2,3300,2200,5500
430790,202105,512,331,181,365200,199100,564300
430800,202105,154,122,32,134200.01,35200,169400.01
430805,202105,42,33,9,36300,9900,46200
430807,202105,58,32,26,35200,28600,63800
430810,202105,76,46,30,50600,33000,83600
430820,202105,141,84,57,92400,62700,155100
430825,202105,11,9,2,9900,2200,12100
430830,202105,239,222,17,244200,18700,262900
430840,202105,132,88,44,96800,48400,145200
430843,202105,6,3,3,3300,3300,6600
430845,202105,76,40,36,44000,39600,83600
430850,202105,585,416,169,458700,185900,644600
430860,202105,149,93,56,102300,61600,163900
430865,202105,79,42,37,46200,40700,86900
430870,202105,76,63,13,69300,14300,83600
430880,202105,147,105,42,115500,46200,161700
430885,202105,11,9,2,9900,2200,12100
430890,202105,330,198,132,217800,145200,363000
430900,202105,521,356,165,391600,181500,573100
430905,202105,123,51,72,56100,79200,135300
430910,202105,280,163,117,180400,129800,310200
430912,202105,4,4,0,4400,0,4400
430915,202105,35,32,3,35200,3300,38500
430920,202105,4365,2284,2081,2516800,2290200,4807000
430925,202105,5,4,1,4400,1100,5500
430930,202105,2057,1171,886,1290300,976800,2267100
430940,202105,260,169,91,185900,100100,286000
430950,202105,149,125,24,137500,27500,165000
430955,202105,26,14,12,15400,13200,28600
430957,202105,21,19,2,20900,2200,23100
430960,202105,244,157,87,173800,95700,269500
430965,202105,110,70,40,77000,45100,122100
430970,202105,92,74,18,81400,19800,101200
430975,202105,45,39,6,42900,6600,49500
430980,202105,47,29,18,31900,19800,51700
430990,202105,98,76,22,83600,24200,107800
430995,202105,115,108,7,118800,7700,126500
431000,202105,286,136,150,149600.6,165000,314600.6
431010,202105,350,195,155,214500,170500,385000
431020,202105,1881,1078,803,1189100,885500,2074600
431030,202105,38,31,7,34100,7700,41800
431033,202105,420,188,232,206800,255200,462000
431036,202105,12,7,5,7700,5500,13200
431040,202105,143,87,56,96800,62700,159500
431041,202105,41,26,15,28600,16500,45100
431043,202105,42,24,18,26400,19800,46200
431046,202105,12,9,3,9900,3300,13200
431050,202105,202,126,76,138600,83600,222200
431053,202105,67,38,29,41800,31900,73700
431055,202105,66,44,22,48400,24200,72600
431057,202105,20,19,1,20900,1100,22000
431060,202105,1599,1036,563,1139600.31,620400,1760000.31
431065,202105,17,10,7,11000,7700,18700
431070,202105,65,60,5,66000,5500,71500
431075,202105,7,7,0,7700,0,7700
431080,202105,130,76,54,83600,59400,143000
431085,202105,35,32,3,35200,3300,38500
431087,202105,10,8,2,8800,2200,11000
431090,202105,55,42,13,46200,14300,60500
431100,202105,1231,726,505,798600,556600,1355200
431110,202105,224,136,88,149600,97900,247500
431112,202105,24,15,9,16500,9900,26400
431113,202105,32,23,9,25300,9900,35200
431115,202105,160,113,47,124300,51700,176000
431120,202105,602,354,248,389400,272800,662200
431123,202105,2,2,0,2200,0,2200
431125,202105,96,82,14,90200,15400,105600
431127,202105,10,6,4,6600,4400,11000
431130,202105,722,472,250,519200,275000,794200
431140,202105,765,532,233,586300,257400,843700
431142,202105,26,22,4,24200.55,4400,28600.55
431150,202105,189,141,48,155100,52800,207900
431160,202105,47,44,3,48400,3300,51700
431162,202105,3,3,0,3300,0,3300
431164,202105,5,5,0,6600,0,6600
431170,202105,113,85,28,93500,30800,124300
431171,202105,72,42,30,46200,33000,79200
431173,202105,1,1,0,1100,0,1100
431175,202105,203,100,103,110000,113300,223300
431177,202105,86,61,25,67100,27500,94600
431179,202105,17,13,4,14300,4400,18700
431180,202105,425,256,169,281600,185900,467500
431190,202105,78,59,19,64900,20900,85800
431198,202105,72,51,21,56100,23100,79200
431200,202105,22,18,4,19800,4400,24200
431205,202105,23,22,1,24200,1100,25300
431210,202105,100,63,37,69300,40700,110000
431213,202105,31,26,5,28600,5500,34100
431215,202105,21,18,3,19800,3300,23100
431217,202105,8,7,1,7700,1100,8800
431220,202105,66,57,9,62700,9900,72600
431225,202105,158,102,56,112200,61600,173800
431230,202105,94,82,12,90200,13200,103400
431235,202105,6,6,0,6600,0,6600
431237,202105,9,7,2,7700,2200,9900
431238,202105,12,8,4,8800,4400,13200
431240,202105,1033,634,399,698500,441100,1139600
431242,202105,39,38,1,41800,1100,42900
431244,202105,17,13,4,14300,4400,18700
431245,202105,51,37,14,40700,15400,56100
431247,202105,11,6,5,6600,5500,12100
431250,202105,285,143,142,157300,156200,313500
431260,202105,57,46,11,50600,12100,62700
431261,202105,19,13,6,14300,6600,20900
431262,202105,16,14,2,15400,2200,17600
431265,202105,155,83,72,91300,79200,170500
431267,202105,18,15,3,16500,3300,19800
431270,202105,319,254,65,279400,71500,350900
431275,202105,38,35,3,38500,3300,41800
431280,202105,19,15,4,16500,4400,20900
431290,202105,18,16,2,17600,2200,19800
431295,202105,2,1,1,1100,1100,2200
431300,202105,23,21,2,23100,2200,25300
431301,202105,5,5,0,5500,0,5500
431303,202105,61,39,22,42900,24200,67100
431306,202105,241,126,115,138404.2,126500,264904.2
431308,202105,7,4,3,4400,3300,7700
431310,202105,65,53,12,58300,13200,71500
431320,202105,158,91,67,100100,73700,173800
431330,202105,188,115,73,126500,80300,206800
431333,202105,27,21,6,23100,6600,29700
431335,202105,8,5,3,5500,3300,8800
431337,202105,377,165,212,181500,234300,415800
431339,202105,19,14,5,16500,5500,22000
431340,202105,3063,1657,1406,1823713.1,1548800,3372513.1
431342,202105,37,24,13,26400,14300,40700
431344,202105,16,16,0,17600,0,17600
431346,202105,4,4,0,4400,0,4400
431349,202105,37,33,4,36300,4400,40700
431350,202105,922,510,412,561000,454300,1015300
431360,202105,53,43,10,47300,11000,58300
431365,202105,345,149,196,163900,215600,379500
431370,202105,1208,690,518,760100,570900,1331000
431380,202105,98,87,11,95700,12100,107800
431390,202105,495,267,228,293700,250800,544500
431395,202105,320,135,185,148500,203500,352000
431400,202105,41,28,13,30800,14300,45100
431402,202105,111,79,32,86900,35200,122100
431403,202105,23,14,9,15400,9900,25300
431405,202105,693,384,309,422400,339900,762300
431406,202105,32,25,7,27500,7700,35200
431407,202105,53,42,11,46200,12100,58300
431410,202105,3422,2070,1352,2277000,1489400,3766400
431413,202105,16,13,3,14300,3300,17600
431415,202105,63,44,19,48400,20900,69300
431417,202105,27,13,14,14300,15400,29700
431420,202105,340,232,108,255200,118800,374000
431430,202105,56,27,29,29700,31900,61600
431440,202105,8806,5993,2813,6603300,3103150.6,9706450.6
431442,202105,27,12,15,13200,16500,29700
431445,202105,28,26,2,28600,2200,30800
431446,202105,4,3,1,3300,1100,4400
431447,202105,88,61,27,67100,29700,96800
431449,202105,50,42,8,46200,8800,55000
431450,202105,408,269,139,295900,152900,448800
431454,202105,11,5,6,5500,6600,12100
431455,202105,47,38,9,41800,9900,51700
431460,202105,495,339,156,372900,172700,545600
431470,202105,121,87,34,95700,37400,133100
431475,202105,12,10,2,11000,2200,13200
431477,202105,39,24,15,26400,16500,42900
431478,202105,9,8,1,8800,1100,9900
431480,202105,545,323,222,356400,244200,600600
431490,202105,28588,15834,12754,17437086.85,14052500,31489586.85
431500,202105,78,62,16,68200,17600,85800
431505,202105,24,14,10,15400,11000,26400
431507,202105,9,8,1,8800,1100,9900
431510,202105,245,175,70,192500,77000,269500
431513,202105,23,20,3,22000,3300,25300
431514,202105,5,4,1,4400,1100,5500
431515,202105,81,67,14,73700,15400,89100
431517,202105,5,3,2,3300,2200,5500
431520,202105,39,35,4,38500,4400,42900
431530,202105,1427,628,799,690800,880000,1570800
431531,202105,22,21,1,23100,1100,24200
431532,202105,37,28,9,30800,9900,40700
431535,202105,28,16,12,17600,13200,30800
431540,202105,143,121,22,133100,24200,157300
431545,202105,12,9,3,9900,3300,13200
431550,202105,360,192,168,211200,184800,396000
431555,202105,11,11,0,13200,0,13200
431560,202105,4558,3064,1494,3377000,1646700,5023700
431570,202105,819,427,392,469700,432300,902000
431575,202105,44,23,21,26400,23100,49500
431580,202105,91,59,32,64900,35200,100100
431590,202105,138,117,21,128700,23100,151800
431595,202105,19,16,3,17600,3300,20900
431600,202105,248,147,101,161700,111100,272800
431610,202105,116,86,30,94600,33000,127600
431620,202105,41,34,7,37400,7700,45100
431630,202105,127,105,22,115500,24200,139700
431640,202105,1348,839,509,924000,561000,1485000
431642,202105,37,34,3,37400,3300,40700
431643,202105,44,17,27,18700,29700,48400
431645,202105,310,182,128,200200,140800,341000
431647,202105,9,8,1,8800,1100,9900
431650,202105,35,23,12,25300,13200,38500
431660,202105,277,173,104,190300,114400,304700
431670,202105,229,104,125,115500,138600,254100
431673,202105,9,7,2,7700,2200,9900
431675,202105,23,18,5,19800,5500,25300
431680,202105,1114,815,299,897600,330000,1227600
431690,202105,4816,2857,1959,3147100.5,2161500,5308600.5
431695,202105,22,16,6,17600,6600,24200
431697,202105,2,1,1,1100,1100,2200
431700,202105,185,139,46,152900,50600,203500
431710,202105,4035,1737,2298,1916200,2530000,4446200
431720,202105,1312,801,511,881650,564300,1445950
431725,202105,1,1,0,1100,0,1100
431730,202105,1157,774,383,852500,421300,1273800
431740,202105,1340,643,697,707300,766700,1474000
431750,202105,1847,1193,654,1315600.32,720500,2036100.32
431755,202105,6,5,1,5500,1100,6600
431760,202105,1009,624,385,686400,423500,1109900
431770,202105,423,291,132,320100,145200,465300
431775,202105,27,20,7,22000,7700,29700
431780,202105,545,326,219,358600,240900,599500
431790,202105,156,120,36,133100,39600,172700
431795,202105,13,10,3,11000,3300,14300
431800,202105,3144,1628,1516,1793000,1672000,3465000
431805,202105,20,18,2,19800,2200,22000
431810,202105,604,393,211,435600,232100,667700
431820,202105,331,193,138,213400,151800,365200
431830,202105,2273,1361,912,1498200,1004300,2502500
431840,202105,481,314,167,345400,183700,529100
431842,202105,36,29,7,31900,7700,39600
431843,202105,10,7,3,7700,3300,11000
431844,202105,18,13,5,14300,5500,19800
431845,202105,27,24,3,26400,3300,29700
431846,202105,27,23,4,25300,4400,29700
431848,202105,11,9,2,9900,2200,12100
431849,202105,7,6,1,6600,1100,7700
431850,202105,755,602,153,664400,168300,832700
431860,202105,123,80,43,88000,47300,135300
431861,202105,7,3,4,3300,4400,7700
431862,202105,53,36,17,39600,18700,58300
431870,202105,3508,1966,1542,2171452.41,1697300,3868752.41
431880,202105,958,695,263,765600,289300,1054900
431890,202105,1290,756,534,831600,588500,1420100
431900,202105,182,123,59,136400,64900,201300
431910,202105,48,35,13,38500,14300,52800
431912,202105,45,27,18,29700,19800,49500
431915,202105,133,101,32,111100,35200,146300
431920,202105,157,112,45,123200,49500,172700
431930,202105,81,68,13,74800,14300,89100
431935,202105,4,2,2,2200,2200,4400
431936,202105,3,3,0,3300,0,3300
431937,202105,20,15,5,16500,5500,22000
431940,202105,452,304,148,334400,163900,498300
431950,202105,488,312,176,343200,193600,536800
431960,202105,743,394,349,433400,385000,818400
431970,202105,69,63,6,70400,6600,77000
431971,202105,6,4,2,4400,2200,6600
431973,202105,18,15,3,16500,3300,19800
431975,202105,8,7,1,7700,1100,8800
431980,202105,208,126,82,138600,90200,228800
431990,202105,1108,586,522,644968.5,574200,1219168.5
432000,202105,1778,920,858,1012000,944900,1956900
432010,202105,267,184,83,204600,91300,295900
432020,202105,176,145,31,159500,34100,193600
432023,202105,15,12,3,13200,3300,16500
432026,202105,65,58,7,63800,7700,71500
432030,202105,65,30,35,33000,38500,71500
432032,202105,17,13,4,14300,4400,18700
432035,202105,57,44,13,48400,14300,62700
432040,202105,88,61,27,67100,30800,97900
432045,202105,2,2,0,2200,0,2200
432050,202105,84,51,33,56100,36300,92400
432055,202105,125,91,34,100100,37400,137500
432057,202105,7,5,2,5500,2200,7700
432060,202105,33,30,3,33000,3300,36300
432065,202105,30,27,3,29700,3300,33000
432067,202105,89,79,10,86900,11000,97900
432070,202105,380,292,88,321475,96800,418275
432080,202105,819,572,247,630300,272800,903100
432085,202105,8,5,3,5500,3300,8800
432090,202105,262,174,88,191400,96800,288200
432100,202105,168,106,62,116600,68200,184800
432110,202105,536,357,179,392700,196900,589600
432120,202105,970,552,418,608300,462000,1070300
432130,202105,489,345,144,380600,158400,539000
432132,202105,24,21,3,23100,3300,26400
432135,202105,80,66,14,72600,15400,88000
432140,202105,268,205,63,225500,69300,294800
432143,202105,217,133,84,146300,92400,238700
432145,202105,278,192,86,211200,94600,305800
432146,202105,13,12,1,13200,1100,14300
432147,202105,111,61,50,67100,55000,122100
432149,202105,15,9,6,9900,6600,16500
432150,202105,905,545,360,599500,396000,995500
432160,202105,1545,786,759,865700.5,834900,1700600.5
432162,202105,4,2,2,2200,2200,4400
432163,202105,18,13,5,14300,5500,19800
432166,202105,128,94,34,103675,37400,141075
432170,202105,227,115,112,126500,123200,249700
432180,202105,548,334,214,367400,235400,602800
432183,202105,8,8,0,8800,0,8800
432185,202105,74,63,11,70400,12100,82500
432190,202105,493,286,207,315700,229900,545600
432195,202105,91,73,18,80300,19800,100100
432200,202105,401,248,153,272800,168300,441100
432210,202105,116,73,43,80300,47300,127600
432215,202105,35,31,4,34100,4400,38500
432218,202105,22,21,1,23100,1100,24200
432220,202105,652,338,314,371800,345400,717200
432225,202105,14,9,5,9900,5500,15400
432230,202105,130,86,44,94600,48400,143000
432232,202105,13,11,2,12100,2200,14300
432234,202105,3,2,1,2200,1100,3300
432235,202105,4,2,2,2200,2200,4400
432237,202105,23,15,8,16500,8800,25300
432240,202105,4339,2386,1953,2631200,2149400,4780600
432250,202105,1131,735,396,809600,436700,1246300
432252,202105,47,46,1,50600,1100,51700
432253,202105,62,50,12,55000,13200,68200
432254,202105,28,11,17,12100,18700,30800
432255,202105,13,11,2,12100,2200,14300
432260,202105,821,648,173,712800,190300,903100
432270,202105,222,166,56,182600,61600,244200
432280,202105,137,104,33,114400,36300,150700
432285,202105,1,1,0,1100,0,1100
432290,202105,63,54,9,59400,9900,69300
432300,202105,4683,2478,2205,2731228.5,2432100.61,5163329.11
432310,202105,130,106,24,116600,26400,143000
432320,202105,22,17,5,18700,5500,24200
432330,202105,15,9,6,9900,6600,16500
432335,202105,8,6,2,6600,2200,8800
432340,202105,37,31,6,34100,6600,40700
432345,202105,98,66,32,72600,35200,107800
432350,202105,19,18,1,19800,1100,20900
432360,202105,4,3,1,3300,1100,4400
432370,202105,24,23,1,25300,1100,26400
432375,202105,29,27,2,29700,2200,31900
432377,202105,7,7,0,7700,0,7700
432380,202105,173,75,98,82500,107800,190300
500020,202105,251,134,117,147400,128700,276100
500025,202105,139,67,72,73700,80300,154000
500060,202105,1450,911,539,1004300,592900,1597200
500070,202105,757,363,394,399300,433400,832700
500080,202105,135,106,29,116600,31900,148500
500085,202105,136,111,25,123200,27500,150700
500090,202105,356,164,192,180400,212300,392700
500100,202105,720,380,340,418000,374000,792000
500110,202105,2252,1054,1198,1160500,1318900,2479400
500124,202105,269,147,122,161700,134200,295900
500150,202105,346,138,208,151800,228800.95,380600.95
500190,202105,520,352,168,387200,184800,572000
500200,202105,201,171,30,188100,33000,221100
500210,202105,1583,532,1051,585200,1158300,1743500
500215,202105,215,125,90,137500,99000,236500
500220,202105,717,462,255,508200.92,280500,788700.92
500230,202105,232,141,91,155100,100100,255200
500240,202105,656,443,213,488400,235400,723800
500260,202105,586,229,357,251900,393800,645700
500270,202105,29780,12692,17088,13971523.66,18815500.07,32787023.73
500280,202105,200,67,133,73700,146300,220000
500290,202105,1160,708,452,779900,497200,1277100
500295,202105,446,286,160,314600,176000,490600
500310,202105,88,29,59,31900,64900,96800
500315,202105,802,447,355,491700,390500,882200
500320,202105,3565,1723,1842,1897500.84,2026200,3923700.84
500325,202105,941,513,428,564300,471900,1036200
500330,202105,1492,694,798,763400,877800,1641200
500345,202105,304,229,75,253000,82500,335500
500348,202105,247,145,102,159500,112200,271700
500350,202105,117,59,58,64900,63800,128700
500370,202105,5700,2569,3131,2832500,3446300,6278800
500375,202105,338,235,103,258500,113300,371800
500380,202105,588,334,254,367400,280500,647900
500390,202105,72,35,37,38500,40700,79200
500400,202105,218,138,80,151800,88000,239800
500410,202105,533,226,307,248600,337700,586300
500430,202105,524,368,156,404800,171600,576400
500440,202105,207,109,98,119900,107800,227700
500450,202105,403,172,231,189200,254100,443300
500460,202105,267,144,123,158400,136400,294800
500470,202105,431,332,99,366300,111100,477400
500480,202105,100,60,40,66000,44000,110000
500490,202105,104,47,57,51700,62700,114400
500500,202105,1410,515,895,567600,984500,1552100
500510,202105,43,36,7,39600,7700,47300
500515,202105,102,71,31,78100,34100,112200
500520,202105,296,155,141,170500,155100,325600
500525,202105,91,50,41,55000,45100,100100
500540,202105,885,392,493,431200,542300,973500
500560,202105,932,515,417,567600,459800,1027400
500568,202105,981,550,431,607200,474100,1081300
500570,202105,1178,682,496,751300,545600,1296900
500580,202105,326,164,162,180400,178200,358600
500600,202105,342,169,173,185900,190300,376200
500620,202105,932,654,278,720500.5,305800,1026300.5
500625,202105,77,62,15,68200,16500,84700
500627,202105,18,9,9,9900,9900,19800
500630,202105,1557,869,688,955900.84,757900,1713800.84
500635,202105,529,318,211,349800,232100,581900
500640,202105,371,200,171,220000,188100,408100
500660,202105,5648,2071,3577,2278100,3942400,6220500
500690,202105,606,210,396,231000,435600,666600
500710,202105,404,199,205,218900,226600,445500
500720,202105,910,516,394,567600.3,433400,1001000.3
500730,202105,181,108,73,118800,80300,199100
500740,202105,874,354,520,391600,572000,963600
500750,202105,150,49,101,53900,111100,165000
500755,202105,119,89,30,97900,33000,130900
500769,202105,755,408,347,449900,382800,832700
500770,202105,431,235,196,258500,216700,475200
500780,202105,142,94,48,103400,53900,157300
500790,202105,1051,523,528,576400,580800,1157200
500793,202105,272,142,130,156200,143000,299200
500795,202105,160,104,56,114400,61600,176000
500797,202105,48,34,14,37400,15400,52800
500800,202105,437,190,247,209000,271700,480700
500830,202105,2210,1231,979,1356300,1079100,2435400
500840,202105,130,100,30,110000,33000,143000
510010,202105,169,89,80,97900,88000,185900
510020,202105,517,225,292,247500,322300,569800
510025,202105,1649,943,706,1038400.37,777700,1816100.37
510030,202105,665,338,327,371800,361900.44,733700.44
510035,202105,128,63,65,69300,71500,140800
510040,202105,396,179,217,198000,238700,436700
510050,202105,351,198,153,218900,169400.3,388300.3
510060,202105,118,57,61,62700,67100,129800
510080,202105,233,93,140,102300,154000,256300
510100,202105,67,30,37,33000,40700,73700
510120,202105,32,19,13,20900,14300,35200
510125,202105,376,232,144,255200,158400,413600
510130,202105,546,330,216,363000,238700,601700
510140,202105,432,133,299,146300,328900,475200
510160,202105,102,34,68,37400,74800,112200
510170,202105,768,470,298,517000.56,327800,844800.56
510180,202105,2891,1345,1546,1479500,1702800,3182300
510185,202105,19,8,11,8800,12100,20900
510190,202105,236,84,152,92400,168300,260700
510250,202105,2569,1535,1034,1690700,1137400,2828100
510260,202105,172,126,46,138600,50600,189200
510263,202105,456,252,204,277200,224400,501600
510267,202105,638,356,282,392700,310200,702900
510268,202105,61,27,34,29700,37400,67100
510269,202105,77,34,43,37400,47300,84700
510270,202105,385,193,192,213400,211200,424600
510279,202105,210,160,50,176000,55000,231000
510285,202105,182,74,108,81400,118800,200200
510300,202105,506,264,242,290400,266200,556600
510305,202105,202,92,110,101200,121000,222200
510310,202105,111,56,55,61600,60500,122100
510320,202105,837,530,307,583000,338800,921800
510325,202105,419,171,248,188100,272800,460900
510330,202105,427,236,191,259600,211200,470800
510335,202105,643,372,271,410300,298100,708400
510336,202105,55,38,17,41800,18700,60500
510337,202105,104,47,57,51700,62700,114400
510340,202105,17115,7660,9455,8442500.63,10404900.06,18847400.69
510343,202105,61,44,17,48400,18700,67100
510345,202105,159,101,58,111100,63800,174900
510350,202105,668,359,309,394900,342100,737000
510360,202105,206,128,78,140800,86900,227700
510370,202105,150,68,82,74800,90200,165000
510380,202105,82,61,21,67100,24200,91300
510385,202105,61,27,34,29700,38500,68200
510390,202105,108,47,61,51700,67100,118800
510395,202105,44,30,14,34100,15400,49500
510410,202105,709,459,250,504900,276100,781000
510420,202105,556,268,288,294800,316800,611600
510450,202105,50,25,25,27500,27500,55000
510452,202105,51,24,27,26400,29700,56100
510454,202105,53,24,29,26400,33000,59400
510455,202105,134,75,59,82500,64900,147400
510460,202105,178,81,97,89100,106700,195800
510480,202105,692,408,284,449900,313500,763400
510490,202105,340,168,172,185900,189200,375100
510500,202105,237,177,60,194700,66000,260700
510510,202105,787,465,322,511500,355300,866800
510515,202105,1237,634,603,698500,666600,1365100
510517,202105,264,119,145,130900,159500,290400
510520,202105,218,144,74,158400,81400,239800
510523,202105,102,79,23,86900,25300,112200
510525,202105,820,493,327,543400,359700,903100
510530,202105,22,15,7,16500,7700,24200
510550,202105,240,110,130,121000,143000,264000
510558,202105,294,143,151,157300,166100,323400
510560,202105,406,235,171,258500,188100,446600
510562,202105,630,458,172,504900,189200,694100
510590,202105,734,379,355,416900,390500,807400
510600,202105,214,110,104,121000,114400,235400
510610,202105,220,93,127,102300,139700,242000
510615,202105,185,85,100,93500,110000,203500
510617,202105,22,10,12,11000,13200,24200
510618,202105,121,57,64,63800,70400,134200
510619,202105,92,65,27,71500,29700,101200
510620,202105,164,92,72,101200,79200,180400
510621,202105,176,114,62,125400,68200,193600
510622,202105,471,279,192,306900,211200,518100
510623,202105,309,209,100,229900,111100,341000
510624,202105,93,49,44,53900,48400,102300
510625,202105,520,324,196,358600,216700.63,575300.63
510626,202105,112,67,45,73700,49500,123200
510627,202105,83,56,27,61600,29700,91300
510628,202105,151,91,60,100100,66000,166100
510629,202105,275,165,110,181500,121019.8,302519.8
510630,202105,443,224,219,246400,240900,487300
510631,202105,14,4,10,4400,11000,15400
510637,202105,339,196,143,215600,158400,374000
510642,202105,994,537,457,590700,502700,1093400
510645,202105,3,1,2,1100,2200,3300
510650,202105,1353,885,468,973500,515900,1489400
510665,202105,84,36,48,39600,52800,92400
510670,202105,58,32,26,35200,28600,63800
510675,202105,1153,739,414,812900,455400,1268300
510677,202105,343,175,168,193600,184800,378400
510680,202105,99,58,41,63800,45100,108900
510682,202105,202,103,99,114400,108900,223300
510685,202105,55,42,13,46200,14300,60500
510700,202105,572,326,246,358600,270600,629200
510704,202105,1174,611,563,672100,619300,1291400
510706,202105,140,72,68,79200,75900,155100
510710,202105,390,280,110,308000,121000,429000
510715,202105,59,41,18,45100,19800,64900
510718,202105,220,110,110,121000,121000,242000
510719,202105,42,17,25,18700,27500,46200
510720,202105,190,134,56,147400,61600,209000
510724,202105,85,33,52,36300,57200,93500
510726,202105,56,29,27,31900,30800,62700
510729,202105,50,20,30,22000,34100,56100
510730,202105,469,258,211,283800,233200,517000
510735,202105,111,44,67,48400,74800,123200
510740,202105,22,12,10,13200,11000,24200
510757,202105,23,19,4,20900,4400,25300
510760,202105,7037,3584,3453,3945700,3802700,7748400
510770,202105,673,314,359,345400,394900,740300
510774,202105,15,5,10,5500,11000,16500
510775,202105,110,83,27,91300,29700,121000
510776,202105,32,10,22,12100,24200,36300
510777,202105,197,85,112,93500,123200,216700
510779,202105,35,19,16,20900,17600,38500
510780,202105,274,156,118,171600,129800,301400
510785,202105,378,204,174,224400,191400,415800
510787,202105,187,90,97,99000,106700,205700
510788,202105,6,1,5,1100,5500,6600
510790,202105,2488,1300,1188,1431151,1309000,2740151
510792,202105,1140,642,498,706200,548900.54,1255100.54
510794,202105,113,64,49,71500,53900,125400
510795,202105,2257,1315,942,1447600.11,1039500,2487100.11
510800,202105,178,109,69,119900,75900,195800
510805,202105,198,131,67,144100,73700,217800
510810,202105,99,43,56,47300,61600,108900
510820,202105,237,116,121,127600,133100.5,260700.5
510830,202105,73,41,32,45100,35200,80300
510835,202105,14,9,5,9900,5500,15400
510840,202105,8992,4217,4775,4642000,5253600,9895600
510850,202105,218,89,129,97900,141900,239800
510860,202105,374,169,205,185900,225500,411400
510880,202105,69,49,20,53900,22000,75900
510885,202105,68,38,30,41800,33000,74800
510890,202105,62,35,27,39600,29700,69300
510895,202105,170,99,71,108900,78100,187000
520005,202105,132,55,77,60500,84700,145200
520010,202105,289,131,158,144100,173800,317900
520013,202105,726,481,245,529100,269500,798600
520015,202105,51,37,14,40700,15400,56100
520017,202105,86,51,35,56100,38500,94600
520020,202105,17,10,7,11000,7700,18700
520025,202105,2450,1266,1184,1394800,1303500,2698300
520030,202105,816,434,382,477675,420200,897875
520050,202105,70,49,21,53900,23100,77000
520055,202105,55,35,20,39600,22000,61600
520060,202105,179,118,61,129800,67100,196900
520080,202105,585,429,156,471900.8,171600,643500.8
520082,202105,16,11,5,12100,5500,17600
520085,202105,86,65,21,71500,23100,94600
520090,202105,91,63,28,69300,30800,100100
520110,202105,9207,3952,5255,4350500,5788200,10138700
520120,202105,11,6,5,6600,5500,12100
520130,202105,808,565,243,622600,267300,889900
520140,202105,11888,6628,5260,7295200,5791500.4,13086700.4
520145,202105,52,31,21,34100,23100,57200
520150,202105,161,128,33,140800,36300,177100
520160,202105,41,29,12,31900,13200,45100
520170,202105,246,140,106,154000,117700,271700
520180,202105,175,81,94,89100,103400,192500
520215,202105,203,138,65,151800,71500,223300
520235,202105,80,63,17,69300,18700,88000
520250,202105,121,69,52,75900,57200,133100
520260,202105,115,74,41,81400,45100,126500
520280,202105,45,30,15,33000,16500,49500
520310,202105,41,27,14,29700,15400,45100
520320,202105,175,107,68,117700,74800,192500
520330,202105,809,438,371,482900,408100,891000
520340,202105,356,210,146,231000,160600,391600
520350,202105,512,243,269,267300,295900,563200
520355,202105,87,48,39,52800,42900,95700
520357,202105,26,19,7,20900,7700,28600
520360,202105,3,2,1,2200,1100,3300
520380,202105,136,76,60,83600,66000,149600
520390,202105,248,104,144,114400,158400,272800
520393,202105,17,11,6,12100,6600,18700
520396,202105,74,49,25,53900,28600,82500
520400,202105,197,119,78,130900,85800,216700
520410,202105,194,95,99,104500,108900,213400
520420,202105,22,14,8,15400,8800,24200
520425,202105,279,139,140,152900,154000,306900
520430,202105,499,245,254,269601.2,279400,549001.2
520440,202105,686,496,190,546700,209000,755700
520450,202105,2000,854,1146,939400,1261700,2201100
520455,202105,62,35,27,38500,29700,68200
520460,202105,36,23,13,25300,14300,39600
520465,202105,31,25,6,27500,6600,34100
520470,202105,430,275,155,302500,170500,473000
520480,202105,81,48,33,52800,36300,89100
520485,202105,106,38,68,41800,74800,116600
520490,202105,413,311,102,342100,112200,454300
520495,202105,158,94,64,103400,70400,173800
520500,202105,194,150,44,165000,48400,213400
520505,202105,189,110,79,121000,86900,207900
520510,202105,1817,867,950,955900,1046100.52,2002000.52
520520,202105,45,30,15,33000,16500,49500
520530,202105,215,169,46,185900,50600,236500
520540,202105,601,405,196,445500,215600,661100
520545,202105,135,78,57,85800,62700,148500
520547,202105,58,34,24,37400,26400,63800
520549,202105,1244,574,670,632500,740300,1372800
520551,202105,313,166,147,182600,161700,344300
520552,202105,35,24,11,26400,12100,38500
520570,202105,15,9,6,9900,6600,16500
520580,202105,271,169,102,185900,112200,298100
520590,202105,136,80,56,88000,61600,149600
520620,202105,1114,520,594,573100,653400,1226500
520630,202105,39,22,17,24200,18700,42900
520640,202105,376,219,157,240900,172700,413600
520650,202105,68,36,32,39600,35200,74800
520660,202105,45,24,21,26400,23100,49500
520670,202105,37,31,6,34100,6600,40700
520680,202105,43,27,16,29700,17600,47300
520690,202105,39,9,30,9900,33000,42900
520710,202105,31,28,3,30800,3300,34100
520725,202105,199,148,51,162800,56100,218900
520735,202105,56,35,21,38500,23100,61600
520740,202105,422,209,213,229900,234300,464200
520750,202105,34,24,10,26400,11000,37400
520753,202105,66,44,22,48400,24200,72600
520760,202105,102,68,34,74800,37400,112200
520780,202105,273,207,66,227700,72600,300300
520790,202105,159,91,68,100100,74800,174900
520800,202105,3419,1867,1552,2058100,1709400,3767500
520810,202105,147,114,33,125400,36300,161700
520815,202105,5,4,1,4400,1100,5500
520830,202105,146,100,46,110000,50600,160600
520840,202105,369,240,129,266200,141900,408100
520850,202105,100,57,43,62700,47300,110000
520860,202105,1742,1118,624,1230900,686400,1917300
520870,202105,31516,14670,16846,16157900.98,18554800.2,34712701.18
520880,202105,1155,618,537,679800,591800,1271600
520890,202105,784,477,307,524700,338800,863500
520910,202105,990,530,460,584100.4,506000,1090100.4
520915,202105,91,69,22,75900,24200,100100
520920,202105,434,202,232,223300,256300,479600
520929,202105,18,16,2,17600,2200,19800
520940,202105,68,49,19,53900,20900,74800
520945,202105,14,10,4,11000,4400,15400
520960,202105,43,27,16,30800,17600,48400
520970,202105,360,213,147,234300,161700,396000
520980,202105,96,69,27,75900,29700,105600
520990,202105,448,315,133,347600,146300,493900
520993,202105,126,59,67,64900,73700,138600
520995,202105,248,138,110,151800,121000,272800
521000,202105,1546,894,652,983400,717200,1700600
521010,202105,682,339,343,372900,377300,750200
521015,202105,15,10,5,11000,5500,16500
521020,202105,1409,997,412,1097800,453200,1551000
521030,202105,57,36,21,39600,23100,62700
521040,202105,931,598,333,657800,366300,1024100
521056,202105,48,31,17,34100,18700,52800
521060,202105,127,82,45,90200,49500,139700
521080,202105,391,301,90,331100.63,99000,430100.63
521090,202105,550,356,194,391600,213400,605000
521100,202105,269,201,68,221100,74800,295900
521120,202105,1053,737,316,811800,347600,1159400
521130,202105,355,254,101,279400,111100,390500
521140,202105,181,101,80,111100,88000,199100
521150,202105,2589,1118,1471,1232000,1620300,2852300
521160,202105,26,12,14,13200,15400,28600
521170,202105,218,125,93,137500,102300,239800
521180,202105,1152,742,410,817300,453200,1270500
521190,202105,2482,1052,1430,1158300,1574100,2732400
521200,202105,55,41,14,45100,15400,60500
521205,202105,11,8,3,8800,3300,12100
521210,202105,119,71,48,78100,52800,130900
521220,202105,737,514,223,565400,245300,810700
521225,202105,30,21,9,23100,9900,33000
521230,202105,105,68,37,74800,40700,115500
521250,202105,6155,3476,2679,3825801.64,2950200,6776001.64
521260,202105,31,14,17,15400,18700,34100
521270,202105,137,104,33,114400,36300,150700
521280,202105,428,262,166,288200,182600,470800
521290,202105,25,16,9,17600,9900,27500
521295,202105,100,66,34,72600,37400,110000
521300,202105,222,124,98,136400,107800,244200
521305,202105,36,26,10,28600,11000,39600
521308,202105,1034,789,245,867900.75,270600,1138500.75
521310,202105,1324,758,566,836000,622600,1458600
521340,202105,17,14,3,15400,3300,18700
521350,202105,122,93,29,102300,31900,134200
521370,202105,177,127,50,139700,55000,194700
521375,202105,177,94,83,104500,91300,195800
521377,202105,50,39,11,42900,12100,55000
521380,202105,1046,653,393,718300,433400,1151700
521385,202105,14,8,6,8800,6600,15400
521390,202105,100,81,19,89100,20900,110000
521400,202105,345,231,114,254100,127600,381700
521405,202105,141,80,61,88000,67100,155100
521410,202105,69,49,20,53900,22000,75900
521440,202105,197,140,57,154000,62700,216700
521450,202105,753,414,339,456500,374000,830500
521460,202105,1124,724,400,796400,442200,1238600
521470,202105,11,8,3,8800,3300,12100
521480,202105,41,29,12,31900,13200,45100
521483,202105,322,200,122,220000,134200,354200
521486,202105,283,181,102,199100,112200,311300
521487,202105,23,10,13,11000,14300,25300
521490,202105,24,11,13,12100,14300,26400
521500,202105,130,73,57,80300,62700,143000
521520,202105,47,35,12,38500,13200,51700
521523,202105,784,465,319,511500,350900,862400
521525,202105,47,28,19,30800,20900,51700
521530,202105,236,128,108,140800,118800,259600
521540,202105,34,18,16,19800,17600,37400
521550,202105,91,38,53,41800,58300,100100
521560,202105,821,556,265,612700,291500,904200
521565,202105,63,45,18,49500,19800,69300
521570,202105,538,357,181,393800,199100,592900
521580,202105,56,32,24,35200,26400,61600
521590,202105,36,16,20,17600,22000,39600
521600,202105,23,11,12,12100,13200,25300
521630,202105,243,131,112,144100,123200,267300
521640,202105,296,161,135,178200,148500,326700
521645,202105,36,19,17,20900,18700,39600
521680,202105,244,152,92,168300,101200,269500
521690,202105,2,2,0,2200,0,2200
521710,202105,1133,541,592,596200,651200,1247400
521720,202105,549,381,168,421300,184800,606100
521730,202105,669,321,348,353100,382800,735900
521740,202105,891,386,505,424600,555500,980100
521760,202105,2066,1074,992,1184772.45,1092300,2277072.45
521770,202105,810,507,303,559900,333300,893200
521800,202105,1974,1284,690,1415700,759000,2174700
521805,202105,33,19,14,20900,15400,36300
521810,202105,88,54,34,59400,37400,96800
521830,202105,962,682,280,751300.73,308000,1059300.73
521839,202105,87,52,35,57200,38500,95700
521850,202105,1095,567,528,624800.17,580800,1205600.17
521860,202105,326,204,122,224400,134200,358600
521870,202105,69,42,27,46200,29700,75900
521878,202105,37,17,20,18700,22000,40700
521880,202105,4754,2121,2633,2336400,2897400,5233800
521890,202105,592,411,181,452100.3,201300,653400.3
521900,202105,282,229,53,251900,58300,310200
521910,202105,164,113,51,124300,56100,180400
521920,202105,46,23,23,25300,25300,50600
521925,202105,53,31,22,34100,24200,58300
521930,202105,1152,638,514,701800,565400,1267200
521935,202105,34,23,11,25300,12100,37400
521940,202105,199,95,104,104500,114400,218900
521945,202105,17,13,4,14300,4400,18700
521950,202105,9,5,4,5500,4400,9900
521960,202105,70,53,17,58300,18700,77000
521970,202105,412,261,151,287100,166100,453200
521971,202105,105,55,50,60500,55000,115500
521973,202105,34,18,16,19800,17600,37400
521975,202105,1504,760,744,836000.75,818400.18,1654400.93
521980,202105,240,165,75,181500,82500,264000
521990,202105,74,55,19,60500,20900,81400
522000,202105,295,191,104,209716.1,114400,324116.1
522005,202105,18,10,8,11000,8800,19800
522010,202105,1131,638,493,702900,542300,1245200
522015,202105,57,34,23,37400,25300,62700
522020,202105,894,519,375,570900,412500,983400
522026,202105,23,15,8,16500,8800,25300
522028,202105,15,11,4,12100,4400,16500
522040,202105,761,313,448,344300,492800,837100
522045,202105,2415,1466,949,1615900.73,1045000,2660900.73
522050,202105,158,77,81,84700,89100,173800
522060,202105,546,340,206,374000,226600,600600
522068,202105,106,74,32,81400,35200,116600
522070,202105,9,9,0,9900,0,9900
522100,202105,36,21,15,23100,16500,39600
522108,202105,44,32,12,35200,13200,48400
522119,202105,55,32,23,35200,25300,60500
522130,202105,78,29,49,31900,53900,85800
522140,202105,4072,2109,1963,2321000.14,2163700,4484700.14
522145,202105,48,34,14,37400,15400,52800
522150,202105,98,69,29,75900,31900,107800
522155,202105,52,38,14,41800,15400,57200
522157,202105,6,3,3,3300,3300,6600
522160,202105,1683,995,688,1096700.48,756800,1853500.48
522170,202105,398,268,130,294800,143000,437800
522180,202105,34,15,19,16500,20900,37400
522185,202105,2127,873,1254,960300,1381600,2341900
522190,202105,50,26,24,28600,26400,55000
522200,202105,299,180,119,198000,130900,328900
522205,202105,144,96,48,105600,53900,159500
522220,202105,142,105,37,115500,40700,156200
522230,202105,28,22,6,24200,6600,30800
530010,202105,54035,27384,26651,30146420.55,29351477.44,59497897.99
110001,202106,504,409,95,449900,104500,554400
110002,202106,2827,1785,1042,1965700,1149500,3115200
110003,202106,80,66,14,72600,15400,88000
110004,202106,2025,1349,676,1486100,744700,2230800
110005,202106,425,337,88,371800,96800,468600
110006,202106,449,338,111,373523.33,122100,495623.33
110007,202106,66,55,11,60500,12100,72600
110008,202106,243,134,109,147400,119900,267300
110009,202106,906,669,237,735900,260700,996600
110010,202106,1659,1006,653,1111000,718300,1829300
110011,202106,1718,1332,386,1467400,424600,1892000
110012,202106,4056,2370,1686,2610300,1855700,4466000
110013,202106,754,601,153,663300,169400,832700
110014,202106,368,318,50,350350,55000,405350
110015,202106,1361,1088,273,1199000,301400,1500400
110018,202106,1072,663,409,729300,452100,1181400
110020,202106,15477,8850,6627,9748200.75,7290800,17039000.75
110025,202106,640,469,171,515900,188100,704000
110026,202106,36,25,11,27500,12100,39600
110028,202106,1595,1142,453,1257300,498300,1755600
110029,202106,137,123,14,135300,15400,150700
110030,202106,2367,1589,778,1748824,858000.85,2606824.85
110032,202106,319,242,77,267300,84700,352000
110033,202106,645,468,177,514800,194700,709500
110034,202106,329,243,86,267300.5,94600,361900.5
110037,202106,92,80,12,88000,13200,101200
110040,202106,385,264,121,291500,134200,425700
110045,202106,928,642,286,706200,315700,1021900
110050,202106,88,77,11,84700,12100,96800
110060,202106,68,41,27,45100,29700,74800
110070,202106,103,65,38,71500,41800,113300
110080,202106,494,273,221,300300,243100,543400
110090,202106,23,20,3,22000,3300,25300
110092,202106,108,59,49,64900,53900,118800
110094,202106,198,144,54,158400,59400,217800
110100,202106,43,29,14,31900,15400,47300
110110,202106,94,55,39,60500,42900,103400
110120,202106,68,60,8,66000,8800,74800
110130,202106,279,228,51,250800,56100,306900
110140,202106,240,171,69,188100,75900,264000
110143,202106,50,40,10,44000,11000,55000
110145,202106,32,25,7,27500,7700,35200
110146,202106,24,13,11,14300,12100,26400
110147,202106,36,24,12,26400,13200,39600
110148,202106,33,23,10,25300,11000,36300
110149,202106,317,227,90,249700,100100,349800
110150,202106,138,105,33,115500,36300,151800
110155,202106,11,10,1,11000,1100,12100
110160,202106,66,52,14,57200,15400,72600
110170,202106,220,167,53,183700,58300,242000
110175,202106,64,50,14,55000,15400,70400
110180,202106,88,73,15,80300,16500,96800
120001,202106,196,144,52,159500,57200,216700
120005,202106,189,110,79,121000.41,86900,207900.41
120010,202106,1124,689,435,757900,478500,1236400
120013,202106,145,97,48,106700,52800,159500
120017,202106,107,58,49,63800,53900,117700
120020,202106,3513,2849,664,3133901.2,733700,3867601.2
120025,202106,537,304,233,334400.4,256300,590700.4
120030,202106,1048,904,144,995500.7,159500,1155000.7
120032,202106,36,32,4,35200,4400,39600
120033,202106,218,192,26,211200,28600,239800
120034,202106,175,127,48,139700,52800,192500
120035,202106,36,30,6,33000,6600,39600
120038,202106,417,271,146,298100,160600,458700
120039,202106,30,29,1,31900,1100,33000
120040,202106,13880,9468,4412,10418464.15,4855400,15273864.15
120042,202106,43,37,6,40700,6600,47300
120043,202106,12,2,10,2200,11000,13200
120045,202106,527,337,190,370700,209000,579700
120050,202106,1263,967,296,1063701,325600,1389301
120060,202106,1462,1206,256,1327700,281600,1609300
120070,202106,412,299,113,328900.6,124300,453200.6
120080,202106,182,113,69,124300,75900,200200
130002,202106,163,117,46,128700,50600,179300
130006,202106,102,64,38,70400,41800,112200
130008,202106,130,71,59,78100,64900,143000
130010,202106,149,87,62,95700,68200,163900
130014,202106,275,198,77,217800,84700,302500
130020,202106,100,61,39,67100,42900,110000
130030,202106,955,559,396,614900,435600,1050500
130040,202106,342,168,174,184800,191400,376200
130050,202106,553,285,268,313500,294800,608300
130060,202106,826,564,262,620400,289300,909700
130063,202106,618,372,246,409200,270600,679800
130068,202106,192,119,73,130900,80300,211200
130070,202106,1345,914,431,1007600,474100,1481700
130080,202106,702,472,230,519200,253000,772200
130083,202106,68,37,31,40700,34100,74800
130090,202106,345,189,156,207900,172700,380600
130100,202106,1166,529,637,581900,700700,1282600
130110,202106,729,317,412,348700,453200,801900
130115,202106,149,67,82,73700,90200,163900
130120,202106,1612,1009,603,1111000,664400,1775400
130130,202106,619,419,200,460900,221100,682000
130140,202106,1574,1227,347,1349700,381700,1731400
130150,202106,411,363,48,399300,52800,452100
130160,202106,447,258,189,283800,207900,491700
130165,202106,43,33,10,36300,11000,47300
130170,202106,1010,705,305,775429.6,335500.9,1110930.5
130180,202106,244,180,64,198000,70400,268400
130185,202106,2194,1014,1180,1116500,1299100,2415600
130190,202106,3391,2141,1250,2355100,1379400,3734500
130195,202106,287,229,58,251900,63800,315700
130200,202106,179,86,93,94600,102300,196900
130210,202106,84,44,40,48400,44000,92400
130220,202106,182,123,59,135300,64900,200200
130230,202106,375,241,134,265100,147400,412500
130240,202106,1336,866,470,953700,517000,1470700
130250,202106,4657,3000,1657,3300000.79,1823800,5123800.79
130255,202106,418,203,215,223300,236500,459800
130260,202106,57228,27034,30194,29768111.12,33241131,63009242.12
130270,202106,1535,1043,492,1147399,542300,1689699
130280,202106,120,67,53,73700,58300,132000
130290,202106,2072,1421,651,1563100,716100,2279200
130300,202106,424,290,134,319000,148500,467500
130310,202106,916,491,425,542300,467500,1009800
130320,202106,525,276,249,303600,273900,577500
130330,202106,771,487,284,535700,313500,849200
130340,202106,3424,1937,1487,2135100,1635700,3770800
130350,202106,484,330,154,363000,169400,532400
130353,202106,927,410,517,451000,568700,1019700
130356,202106,792,349,443,385000,487300,872300
130360,202106,88,66,22,72600,24200,96800
130370,202106,688,531,157,584100,172700,756800
130380,202106,666,513,153,565400,168300,733700
130390,202106,468,381,87,419100,95700,514800
130395,202106,159,40,119,44000,130900,174900
130400,202106,70,47,23,51700,25300,77000
130406,202106,2062,1220,842,1343100,926200,2269300
130410,202106,456,227,229,249700,251900,501600
130420,202106,2869,2331,538,2564100,591800,3155900
130423,202106,155,78,77,86900,84700,171600
130426,202106,156,78,78,85800,85800,171600
130430,202106,418,250,168,275000,184800,459800
130440,202106,202,61,141,67100,155100,222200
140002,202106,18,6,12,6600,14300,20900
140005,202106,200,124,76,136400,83600,220000
140010,202106,11089,6949,4140,7654903.55,4556200.18,12211103.73
140015,202106,143,64,79,70400,86900,157300
140017,202106,123,73,50,80300,55000,135300
140020,202106,464,299,165,328900,181500,510400
140023,202106,37,17,20,18700,22000,40700
140028,202106,23,12,11,13200,12100,25300
140030,202106,354,241,113,265100,124300,389400
140040,202106,61,44,17,48400,18700,67100
140045,202106,268,104,164,114400,180400,294800
140047,202106,420,283,137,312400,150700,463100
140050,202106,142,87,55,95700,60500,156200
140060,202106,59,40,19,45100,20900,66000
140070,202106,30,28,2,30800,2200,33000
150010,202106,4824,2918,1906,3209800,2096600,5306400
150013,202106,163,116,47,127600,51700,179300
150020,202106,1109,602,507,662200,557700,1219900
150030,202106,708,312,396,343200.02,435600,778800.02
150034,202106,205,128,77,140800,84700,225500
150040,202106,1505,861,644,948200,709500,1657700
150050,202106,681,389,292,427900,321200,749100
150060,202106,4871,3058,1813,3367007,1994755.4,5361762.4
150070,202106,428,220,208,242000,228800,470800
150080,202106,15610,7414,8196,8158701.18,9021100,17179801.18
150085,202106,430,272,158,299200,176000,475200
150090,202106,697,590,107,650100,117700,767800
150095,202106,372,237,135,260700,148500,409200
150100,202106,63,41,22,45100,24200,69300
150110,202106,214,118,96,129800,105600,235400
150120,202106,393,284,109,312400,121000,433400
150125,202106,50,18,32,19800,35200,55000
150130,202106,2065,1075,990,1184700,1091200,2275900
150140,202106,56029,25156,30873,27691400,33970200.7,61661600.7
150145,202106,231,128,103,140800,113300,254100
150150,202106,3106,1368,1738,1505900,1915100,3421000
150157,202106,377,263,114,289300,125400,414700
150160,202106,131,100,31,110000,34100,144100
150170,202106,3703,2735,968,3009600,1064800,4074400
150172,202106,342,242,100,266200,110000,376200
150175,202106,82,49,33,53900,36300,90200
150178,202106,756,504,252,555500,278300,833800
150180,202106,3176,1549,1627,1706100,1790800,3496900
150190,202106,359,229,130,251900,143000,394900
150195,202106,114,59,55,64900,60500,125400
150200,202106,195,94,101,103400,111100,214500
150210,202106,3184,2535,649,2789600,713900,3503500
150215,202106,575,358,217,393800,238700,632500
150220,202106,3561,2372,1189,2610300.82,1307900,3918200.82
150230,202106,1251,991,260,1092300.5,286000,1378300.5
150240,202106,6548,3706,2842,4078800.6,3126200,7205000.6
150250,202106,63,35,28,38500,30800,69300
150260,202106,94,63,31,69300,34100,103400
150270,202106,2201,1428,773,1570800,850300,2421100
150275,202106,535,338,197,371800,216700,588500
150276,202106,110,41,69,45100,75900,121000
150277,202106,801,359,442,394900,486200,881100
150280,202106,374,252,122,277200,134200,411400
150285,202106,120,59,61,64900,66924,131824
150290,202106,1144,665,479,731500,526900,1258400
150293,202106,716,333,383,367400,421300,788700
150295,202106,520,239,281,262900,309100,572000
150300,202106,87,39,48,42900,52800,95700
150304,202106,180,106,74,117700,81400,199100
150307,202106,406,335,71,369600,78100,447700
150309,202106,576,409,167,449900,183700.48,633600.48
150310,202106,251,162,89,178200,97900,276100
150320,202106,1885,1316,569,1447600.5,625900,2073500.5
150330,202106,2057,1193,864,1312300,950400.2,2262700.2
150340,202106,192,128,64,140800,70400,211200
150345,202106,646,362,284,398200,312400,710600
150350,202106,397,313,84,345400,92400,437800
150360,202106,4697,2887,1810,3177900,1993200.44,5171100.44
150370,202106,834,578,256,636900,281600,918500
150375,202106,200,93,107,102300,117700,220000
150380,202106,1509,1002,507,1103300,557700,1661000
150390,202106,830,479,351,526900,386100,913000
150400,202106,112,92,20,101200,22000,123200
150405,202106,1234,782,452,860200.8,497200,1357400.8
150410,202106,117,74,43,81400,47300,128700
150420,202106,7471,4048,3423,4456280,3768600,8224880
150430,202106,623,391,232,430100,255200,685300
150440,202106,452,282,170,310200,187000,497200
150442,202106,2340,1251,1089,1376100,1200100,2576200
150445,202106,551,358,193,393800,213400,607200
150450,202106,229,124,105,136400,115500,251900
150460,202106,730,542,188,596200,206800,803000
150470,202106,1279,776,503,853600,553300,1406900
150475,202106,240,181,59,199100,64900,264000
150480,202106,1321,915,406,1007600.5,447700,1455300.5
150490,202106,656,390,266,429000,292600,721600
150495,202106,340,252,88,277200,96800,374000
150497,202106,283,194,89,213400,97900,311300
150500,202106,236,141,95,155100,104500,259600
150503,202106,1090,560,530,616000,583000,1199000
150506,202106,924,622,302,684200,332200,1016400
150510,202106,1287,701,586,771100,644600,1415700
150520,202106,297,200,97,220000,106700,326700
150530,202106,1746,962,784,1058200,865700,1923900
150540,202106,198,146,52,160600,57200,217800
150543,202106,819,422,397,464200,437800,902000
150548,202106,472,340,132,374000,145200,519200
150549,202106,63,43,20,47300,22000,69300
150550,202106,2974,1505,1469,1656600,1615900,3272500
150553,202106,3394,1916,1478,2110900,1628000,3738900
150555,202106,147,80,67,88000,73700,161700
150560,202106,37,16,21,17600,23100,40700
150563,202106,122,59,63,64900,69300,134200
150565,202106,194,120,74,132000,81400,213400
150570,202106,429,285,144,314600,158400,473000
150580,202106,1689,810,879,891000,966900,1857900
150590,202106,815,534,281,587400,309100,896500
150600,202106,488,293,195,322300,214500,536800
150610,202106,150,120,30,132000,34100,166100
150611,202106,121,80,41,88000,45100,133100
150613,202106,3255,1892,1363,2083400,1499300,3582700
150616,202106,549,304,245,334400,269500,603900
150618,202106,1359,709,650,779900,716100,1496000
150619,202106,402,306,96,336600,105600,442200
150620,202106,1248,721,527,794200,580800,1375000
150630,202106,327,208,119,228800,130900,359700
150635,202106,453,193,260,212300,286000,498300
150640,202106,46,22,24,24200,26400,50600
150650,202106,2404,1398,1006,1540000,1106600,2646600
150655,202106,240,178,62,195800,68200,264000
150658,202106,85,51,34,56100,37400,93500
150660,202106,549,355,194,390500,213400,603900
150670,202106,1114,390,724,429000,798600,1227600
150680,202106,10338,5433,4905,5982900.57,5402100,11385000.57
150690,202106,21,10,11,11000,12100,23100
150700,202106,498,324,174,356400,191400,547800
150710,202106,292,167,125,183700,137500,321200
150715,202106,844,529,315,583000,346500,929500
150720,202106,424,325,99,357500,108900,466400
150730,202106,1048,512,536,564300,590700,1155000
150740,202106,232,153,79,168300,86900,255200
150745,202106,747,417,330,458700,364100,822800
150746,202106,66,37,29,40700,31900,72600
150747,202106,225,171,54,189200,59400,248600
150750,202106,140,77,63,84700,70400,155100
150760,202106,1822,1185,637,1304600.5,700700,2005300.5
150770,202106,386,216,170,237600,187000,424600
150775,202106,107,50,57,55000,63800,118800
150780,202106,196,106,90,117700,99000,216700
150790,202106,886,506,380,556600,418000,974600
150795,202106,1557,941,616,1035100,679800,1714900
150796,202106,342,193,149,212300,163900,376200
150797,202106,355,168,187,184800,205700,390500
150800,202106,1533,876,657,964700,723800,1688500
150803,202106,532,427,105,469700,115500,585200
150805,202106,210,125,85,137500,93500,231000
150808,202106,1003,534,469,587400,515900,1103300
150810,202106,3258,2210,1048,2432100.5,1152800,3584900.5
150812,202106,468,244,224,268400,246400,514800
150815,202106,1092,677,415,744700,457600,1202300
150820,202106,1541,926,615,1019700,677600,1697300
150830,202106,714,520,194,572000,213400,785400
150835,202106,209,125,84,137500,93500,231000
150840,202106,1372,836,536,919600,591800,1511400
160005,202106,59,42,17,46200.08,18700.04,64900.12
160010,202106,196,124,72,136400.14,79200.1,215600.24
160015,202106,134,81,53,89100.12,58300.02,147400.14
160020,202106,138,74,64,81400.04,70400,151800.04
160021,202106,61,29,32,31900.04,35200.04,67100.08
160023,202106,64,40,24,44000.06,26400.04,70400.10
160025,202106,26,12,14,13200.04,15400.04,28600.08
160027,202106,1460,835,625,918502,687500.98,1606002.98
160030,202106,16196,8352,7844,9192715.74,8636110.98,17828826.72
160040,202106,300,175,125,192500.12,137500.02,330000.14
160050,202106,717,356,361,391600.2,397100.04,788700.24
160053,202106,279,170,109,187000.26,119900.14,306900.40
160055,202106,24,16,8,17600.02,8800.02,26400.04
160060,202106,6604,3519,3085,3872010.93,3395706.9,7267717.83
160070,202106,185,111,74,122100.02,81400.02,203500.04
160080,202106,113,55,58,60500,63800,124300
170025,202106,31,16,15,17600,16500,34100
170030,202106,194,158,36,173800.03,39600,213400.03
170035,202106,207,100,107,110000,117700,227700
170040,202106,178,131,47,144100,51700,195800
170070,202106,317,198,119,217800,130900,348700
170100,202106,346,254,92,279400,101200,380600
170105,202106,54,44,10,48400,11000,59400
170110,202106,118,71,47,78100,51700,129800
170130,202106,69,34,35,37400,38500,75900
170190,202106,94,57,37,62700,40700,103400
170200,202106,359,249,110,273900,121000,394900
170210,202106,6216,3278,2938,3608834.25,3235101.1,6843935.35
170215,202106,112,52,60,57200,66000,123200
170220,202106,1380,1009,371,1109900,408100,1518000
170230,202106,145,95,50,104500,55000,159500
170240,202106,512,341,171,376200,188100,564300
170255,202106,1062,867,195,953700,214500,1168200
170270,202106,47,32,15,35200,16500,51700
170290,202106,116,76,40,83600,44000,127600
170300,202106,99,62,37,68200,41800,110000
170305,202106,47,36,11,39600,12100,51700
170307,202106,58,45,13,49500,14300,63800
170310,202106,120,66,54,72600,60500,133100
170320,202106,27,16,11,17600,12100,29700
170330,202106,26,22,4,24200,4400,28600
170360,202106,32,19,13,20900,14300,35200
170370,202106,97,47,50,51700,55000,106700
170380,202106,74,56,18,61600,19800,81400
170382,202106,41,35,6,38500,6600,45100
170384,202106,141,109,32,119900,35200,155100
170386,202106,68,28,40,30800,44000,74800
170388,202106,46,18,28,19800,30800,50600
170389,202106,25,21,4,23100,4400,27500
170390,202106,73,42,31,46200,34100,80300
170410,202106,24,22,2,24200,2200,26400
170460,202106,15,10,5,11000,5500,16500
170510,202106,34,27,7,29700,7700,37400
170550,202106,1539,893,646,983400,712800,1696200
170555,202106,109,78,31,85800,34100,119900
170560,202106,105,74,31,81400,34100,115500
170600,202106,40,15,25,16500,27500,44000
170610,202106,193,100,93,110000,103400,213400
170625,202106,38,24,14,26400,15400,41800
170650,202106,87,62,25,68200,27500,95700
170700,202106,576,425,151,468600,167200,635800
170710,202106,155,98,57,107800,62700,170500
170720,202106,93,72,21,79200,23100,102300
170730,202106,90,55,35,60500,38500,99000
170740,202106,85,59,26,64900,28600,93500
170755,202106,56,30,26,33000,28600,61600
170765,202106,137,72,65,79200,71500,150700
170770,202106,196,126,70,138600,77000,215600
170820,202106,600,396,204,441100,226600,667700
170825,202106,39,19,20,20900,22000,42900
170830,202106,86,68,18,74800,19800,94600
170900,202106,172,132,40,145200,44000,189200
170930,202106,914,496,418,545600,459800,1005400
170950,202106,3120,1434,1686,1581800,1854600.4,3436400.4
170980,202106,18,11,7,12100,7700,19800
171050,202106,149,115,34,126500,37400,163900
171070,202106,47,40,7,44000,7700,51700
171090,202106,48,35,13,38500,14300,52800
171110,202106,23,17,6,18700,6600,25300
171150,202106,41,21,20,23100,22000,45100
171180,202106,28,13,15,15400,16500,31900
171190,202106,162,94,68,103400,74800,178200
171195,202106,63,52,11,57200,12100,69300
171200,202106,45,21,24,23100,26400,49500
171215,202106,5,4,1,4400,1100,5500
171240,202106,61,44,17,48400,18700,67100
171245,202106,58,50,8,55000,8800,63800
171250,202106,73,41,32,45100,36300,81400
171270,202106,14,10,4,11000,4400,15400
171280,202106,41,36,5,39600,5500,45100
171320,202106,1002,568,434,625900,479600,1105500
171330,202106,423,216,207,237600,228800,466400
171360,202106,94,64,30,70400,33000,103400
171370,202106,33,17,16,18700,17600,36300
171380,202106,131,113,18,124300,19800,144100
171395,202106,48,28,20,30800,22000,52800
171420,202106,264,171,93,188100,102300,290400
171430,202106,72,58,14,63800,15400,79200
171488,202106,192,102,90,112200,99000,211200
171500,202106,62,34,28,37400,30800,68200
171510,202106,70,46,24,50600,26400,77000
171515,202106,40,32,8,35200,8800,44000
171525,202106,29,27,2,29700,2200,31900
171550,202106,15,9,6,9900,6600,16500
171570,202106,49,25,24,27500,26400,53900
171575,202106,289,190,99,209000,108900,317900
171610,202106,1737,881,856,969100,942700,1911800
171620,202106,140,94,46,103400,50600,154000
171630,202106,54,29,25,31900,27500,59400
171650,202106,320,225,95,247500,104500,352000
171660,202106,260,148,112,162800,123200,286000
171665,202106,69,43,26,47300,28600,75900
171670,202106,425,257,168,282700,184800,467500
171700,202106,63,55,8,60500,8800,69300
171720,202106,30,11,19,12100,20900,33000
171750,202106,104,54,50,59400,55000,114400
171780,202106,72,57,15,62700,16500,79200
171790,202106,85,70,15,77000,16500,93500
171800,202106,32,24,8,26400,8800,35200
171820,202106,2068,1197,871,1321100.7,960300,2281400.7
171830,202106,36,26,10,28600,11000,39600
171840,202106,62,39,23,42900,25300,68200
171845,202106,29,19,10,20900,11000,31900
171850,202106,38,31,7,34100,7700,41800
171855,202106,79,62,17,68200,18700,86900
171865,202106,6,5,1,5500,1100,6600
171870,202106,31,20,11,22000,12100,34100
171875,202106,78,57,21,62700,24200,86900
171880,202106,37,23,14,25300,15400,40700
171884,202106,50,28,22,30800,24200,55000
171886,202106,129,56,73,61600,80300,141900
171888,202106,25,19,6,20900,6600,27500
171889,202106,12,6,6,6600,6600,13200
171890,202106,55,46,9,50600,9900,60500
171900,202106,32,22,10,24200,11000,35200
172000,202106,37,30,7,33000,7700,40700
172010,202106,53,44,9,48400,9900,58300
172015,202106,24,17,7,18700,7700,26400
172020,202106,144,91,53,100100,58300,158400
172025,202106,39,26,13,28600,14300,42900
172030,202106,44,24,20,26400,22000,48400
172049,202106,84,54,30,59400,33000,92400
172065,202106,128,83,45,91300,49500,140800
172080,202106,105,66,39,72600,42900,115500
172085,202106,28,14,14,15400,15400,30800
172090,202106,430,323,107,355300.56,117700,473000.56
172093,202106,15,13,2,14300,2200,16500
172097,202106,19,11,8,12100,8800,20900
172100,202106,5240,2966,2274,3265900,2501400,5767300
172110,202106,80,51,29,56100,31900,88000
172120,202106,1678,1410,268,1551000,294800,1845800
172125,202106,11,10,1,11000,1100,12100
172130,202106,24,14,10,15400,11000,26400
172208,202106,204,120,84,132000,92400,224400
172210,202106,363,177,186,194700,204600,399300
210005,202106,2933,1838,1095,2024000.32,1204500,3228500.32
210010,202106,155,89,66,97900,72600,170500
210015,202106,39,29,10,31900,11000,42900
210020,202106,364,207,157,227700,172700,400400
210030,202106,321,214,107,236500,117700,354200
210040,202106,140,112,28,123200,30800,154000
210043,202106,254,197,57,216700,62700,279400
210047,202106,521,316,205,347600,225500,573100
210050,202106,283,211,72,232100,79200,311300
210055,202106,52,43,9,47300,11000,58300
210060,202106,539,437,102,480700,112200,592900
210070,202106,433,327,106,359700,116600,476300
210080,202106,130,119,11,130900,12100,143000
210083,202106,289,140,149,154000,163900,317900
210087,202106,2,1,1,1100,1100,2200
210090,202106,438,313,125,344300,138600,482900
210095,202106,426,327,99,360800,108900,469700
210100,202106,696,549,147,603900,162800,766700
210110,202106,120,79,41,86900,45100,132000
210120,202106,4931,3878,1053,4268000,1158300.5,5426300.5
210125,202106,185,116,69,127600,75900,203500
210130,202106,464,267,197,293700,216700,510400
210135,202106,27,21,6,23100,6600,29700
210140,202106,4418,3442,976,3786200.53,1073600,4859800.53
210150,202106,367,234,133,257400,146300,403700
210160,202106,3269,2795,474,3075600.54,521400,3597000.54
210170,202106,1185,954,231,1049400,254100,1303500
210173,202106,124,109,15,119900,16500,136400
210177,202106,346,198,148,217800,163900,381700
210180,202106,29,16,13,17600,14300,31900
210190,202106,428,284,144,312400,158400,470800
210193,202106,5,4,1,4400,1100,5500
210197,202106,75,55,20,60500,23100,83600
210200,202106,614,519,95,573100,104500,677600
210203,202106,216,150,66,165000,72600,237600
210207,202106,359,298,61,327800,67100,394900
210210,202106,730,676,54,744700,59400,804100
210215,202106,76,63,13,69300,14300,83600
210220,202106,380,321,59,353100,66000,419100
210230,202106,311,249,62,273900,68200,342100
210232,202106,1323,912,411,1004300,453200,1457500
210235,202106,171,131,40,145200,44000,189200
210237,202106,35,21,14,23100,15400,38500
210240,202106,90,76,14,83600,15400,99000
210250,202106,179,153,26,168300,28600,196900
210255,202106,357,271,86,298100,94600,392700
210260,202106,393,273,120,300300,132000,432300
210270,202106,638,430,208,474100,228800,702900
210275,202106,80,62,18,68200,19800,88000
210280,202106,1041,689,352,759000,388300,1147300
210290,202106,539,366,173,402600,190300,592900
210300,202106,5215,3311,1904,3646500.98,2097700,5744200.98
210310,202106,107,76,31,83600,34100,117700
210312,202106,118,82,36,90200,39600,129800
210315,202106,104,88,16,96800,17600,114400
210317,202106,138,104,34,114400,38500,152900
210320,202106,2313,1983,330,2182400,363000,2545400
210325,202106,142,88,54,96800,59400,156200
210330,202106,4453,2577,1876,2838000,2064700,4902700
210340,202106,1224,925,299,1018600,328900,1347500
210350,202106,656,547,109,601700,119900,721600
210355,202106,151,129,22,141900,24200,166100
210360,202106,2176,1524,652,1676400,717200,2393600
210370,202106,1230,612,618,675400,679800,1355200
210375,202106,191,97,94,106700,103400,210100
210380,202106,714,554,160,609400,176000,785400
210390,202106,193,165,28,182600,30800,213400
210400,202106,387,335,52,368500,57200,425700
210405,202106,990,704,286,775500,314600,1090100
210407,202106,59,47,12,51700,13200,64900
210408,202106,63,55,8,60500,8800,69300
210409,202106,326,287,39,316800,42900,359700
210410,202106,440,346,94,380600,103400,484000
210420,202106,200,166,34,182600,37400,220000
210430,202106,50,36,14,39600,15400,55000
210440,202106,375,258,117,283800,129800,413600
210450,202106,99,83,16,91300,17600,108900
210455,202106,233,125,108,137500,118800,256300
210460,202106,304,206,98,226600,107800,334400
210462,202106,68,56,12,61600,13200,74800
210465,202106,142,112,30,123200,33000,156200
210467,202106,515,381,134,419100,147400,566500
210470,202106,48,41,7,45100,7700,52800
210480,202106,1286,925,361,1018600,398200.5,1416800.5
210490,202106,195,131,64,144100,70400,214500
210500,202106,509,312,197,343200,216700,559900
210510,202106,539,435,104,478500,114400,592900
210515,202106,358,225,133,248600,146300,394900
210520,202106,400,362,38,398200,41800,440000
210530,202106,9297,4873,4424,5365800.48,4871900.83,10237701.31
210535,202106,130,98,32,107800,35200,143000
210540,202106,1519,1011,508,1112100,559900,1672000
210542,202106,1137,582,555,641300,610500,1251800
210545,202106,22,20,2,22000,2200,24200
210547,202106,127,114,13,125400,15400,140800
210550,202106,637,459,178,507100,195800,702900
210560,202106,155,136,19,149600,20900,170500
210565,202106,21,15,6,16500,6600,23100
210570,202106,1283,1049,234,1153900.59,257400,1411300.59
210580,202106,119,101,18,111100,19800,130900
210590,202106,728,607,121,667700,133100,800800
210592,202106,37,35,2,38500,2200,40700
210594,202106,112,94,18,103400,19800,123200
210596,202106,108,94,14,103400,15400,118800
210598,202106,140,106,34,116600,37400,154000
210600,202106,315,274,41,301400,45100,346500
210610,202106,254,239,15,262900,16500,279400
210620,202106,42,27,15,29700,16500,46200
210630,202106,75,72,3,79200,3300,82500
210632,202106,1018,722,296,795300,326700,1122000
210635,202106,22,19,3,20900,3300,24200
210637,202106,126,92,34,101200,37400,138600
210640,202106,580,514,66,565400,72600,638000
210650,202106,398,333,65,366300,71500,437800
210660,202106,369,291,78,321200,85800,407000
210663,202106,47,32,15,35200,16500,51700
210667,202106,99,40,59,45100,64900,110000
210670,202106,252,225,27,247500,29700,277200
210675,202106,516,286,230,316800,253000,569800
210680,202106,221,144,77,158400,84700,243100
210690,202106,615,510,105,561000,115500,676500
210700,202106,155,119,36,132000,39600,171600
210710,202106,238,150,88,165000,96800,261800
210720,202106,129,116,13,127600,14300,141900
210725,202106,62,54,8,59400,8800,68200
210730,202106,23,18,5,19800,5500,25300
210735,202106,294,215,79,236500,86900,323400
210740,202106,515,443,72,487300,79200,566500
210745,202106,153,113,40,124300,44000,168300
210750,202106,2438,1253,1185,1379400,1304600,2684000
210760,202106,252,196,56,215600,61600,277200
210770,202106,247,201,46,221100,50600,271700
210780,202106,428,324,104,356400,115500,471900
210790,202106,182,150,32,166100,35200,201300
210800,202106,173,132,41,145200,45100,190300
210805,202106,56,50,6,55000,6600,61600
210810,202106,465,382,83,420200,91300,511500
210820,202106,2086,1741,345,1916200,380600,2296800
210825,202106,152,87,65,95700,71500,167200
210830,202106,720,481,239,529100,262900,792000
210840,202106,190,134,56,147400,61600,209000
210845,202106,231,166,65,182600,71500,254100
210850,202106,743,509,234,559900,257400,817300
210860,202106,3538,2047,1491,2251700,1640100,3891800
210870,202106,429,338,91,371800,100100,471900
210880,202106,74,58,16,63800,17600,81400
210890,202106,319,278,41,305800,45100,350900
210900,202106,628,411,217,452100,238700,690800
210905,202106,63,36,27,39600,29700,69300
210910,202106,1929,1468,461,1617000.7,507100,2124100.7
210920,202106,152,62,90,68200,99000,167200
210923,202106,82,67,15,73700,16500,90200
210927,202106,412,200,212,220000,234300,454300
210930,202106,69,56,13,61600,14300,75900
210940,202106,83,65,18,71500,19800,91300
210945,202106,198,109,89,119900,97900,217800
210950,202106,521,384,137,423500,150700,574200
210955,202106,83,52,31,57200,34100,91300
210960,202106,2203,1130,1073,1243000,1181400,2424400
210970,202106,115,101,14,111100,15400,126500
210975,202106,83,77,6,84700,6600,91300
210980,202106,1079,531,548,584100,602800,1186900
210990,202106,3958,2647,1311,2912800,1442100,4354900
211000,202106,1311,1063,248,1171500,272800,1444300
211003,202106,971,702,269,773300,295900,1069200
211010,202106,482,431,51,474100,56100,530200
211020,202106,1386,604,782,664400,860200,1524600
211023,202106,40,36,4,39600,4400,44000
211027,202106,72,53,19,58300,20900,79200
211030,202106,370,266,104,292600,114400,407000
211040,202106,295,248,47,272800,51700,324500
211050,202106,1134,762,372,838200,409200,1247400
211060,202106,635,558,77,613800,84700.49,698500.49
211065,202106,23,20,3,22000,3300,25300
211070,202106,882,739,143,812900,157300,970200
211080,202106,87,85,2,93500,2200,95700
211085,202106,50,28,22,30800,24200,55000
211090,202106,73,62,11,68200,12100,80300
211100,202106,467,390,77,429000,84700,513700
211102,202106,241,172,69,189200,75900,265100
211105,202106,222,156,66,171600,72600,244200
211107,202106,125,79,46,86900,50600,137500
211110,202106,934,625,309,688600,339900,1028500
211120,202106,5191,2617,2574,2879800,2833600,5713400
211125,202106,30,21,9,23100,9900,33000
211130,202106,40971,18998,21973,20917600,24198900,45116500
211140,202106,391,342,49,376200,53900,430100
211150,202106,1175,815,360,896500,396000,1292500
211153,202106,170,107,63,117700,69300,187000
211157,202106,66,53,13,58300,14300,72600
211160,202106,683,586,97,644600,106700,751300
211163,202106,3,3,0,3300,0,3300
211167,202106,10,9,1,9900,1100,11000
211170,202106,419,311,108,342100,118800,460900
211172,202106,114,79,35,86900,38500,125400
211174,202106,250,158,92,173800,101200,275000
211176,202106,464,344,120,378400,132000,510400
211178,202106,87,58,29,63800,31900,95700
211180,202106,211,170,41,187000,45100,232100
211190,202106,72,65,7,72600,7700,80300
211195,202106,35,22,13,24200,14300,38500
211200,202106,152,132,20,145200,22000,167200
211210,202106,418,307,111,337700,122100,459800
211220,202106,4145,2474,1671,2724700.5,1838100,4562800.5
211223,202106,91,88,3,96800,3300,100100
211227,202106,61,48,13,52800,14300,67100
211230,202106,726,600,126,660000,138600,798600
211240,202106,397,317,80,348700,88000,436700
211245,202106,177,91,86,100100,94600,194700
211250,202106,1522,1321,201,1453100,221100,1674200
211260,202106,793,661,132,727100,145200,872300
211270,202106,1919,1582,337,1741300,370700,2112000
211280,202106,1765,1144,621,1259500,683100,1942600
211285,202106,200,124,76,137500,83600,221100
211290,202106,717,514,203,565400,223300,788700
211300,202106,749,600,149,660000,165000,825000
211400,202106,1531,942,589,1036200,649000,1685200
220005,202106,16,15,1,16500,1100,17600
220010,202106,86,69,17,75900,18700,94600
220020,202106,685,550,135,605000,148500,753500
220025,202106,106,103,3,113300,3300,116600
220027,202106,48,39,9,42900,9900,52800
220030,202106,116,93,23,102300,25300,127600
220040,202106,1250,958,292,1053800,321200,1375000
220045,202106,33,22,11,24200,12100,36300
220050,202106,696,581,115,640200.8,126500,766700.8
220060,202106,175,153,22,168300,24200,192500
220070,202106,111,100,11,110000,12100,122100
220080,202106,15,13,2,14300,2200,16500
220090,202106,35,28,7,30800,7700,38500
220095,202106,2,1,1,1100,1100,2200
220100,202106,20,17,3,18700,3300,22000
220105,202106,27,25,2,27500,2200,29700
220110,202106,232,211,21,232100,23100,255200
220115,202106,37,36,1,39600,1100,40700
220117,202106,21,20,1,22000,1100,23100
220120,202106,1460,1115,345,1226500,379500,1606000
220130,202106,29,28,1,30800,1100,31900
220140,202106,99,79,20,88000,22000,110000
220150,202106,493,371,122,408100,134200,542300
220155,202106,11,10,1,11000,1100,12100
220157,202106,20,16,4,17600,4400,22000
220160,202106,94,83,11,91300,12100,103400
220170,202106,37,33,4,36300,4400,40700
220173,202106,8,8,0,8800,0,8800
220177,202106,11,10,1,11000,1100,12100
220180,202106,66,64,2,70400,2200,72600
220190,202106,1073,943,130,1038400,143000,1181400
220191,202106,42,34,8,37400,8800,46200
220192,202106,86,82,4,90200,4400,94600
220194,202106,59,55,4,60500,4400,64900
220196,202106,97,83,14,91300,15400,106700
220198,202106,4,2,2,2200,2200,4400
220200,202106,408,342,66,377300,72600,449900
220202,202106,36,31,5,35200,5500,40700
220205,202106,58,50,8,55000,8800,63800
220207,202106,13,13,0,14300,0,14300
220208,202106,74,42,32,46200,35200,81400
220209,202106,30,25,5,27500,5500,33000
220210,202106,22,15,7,16500,7700,24200
220211,202106,27,25,2,27500,2200,29700
220213,202106,39,35,4,38500,4400,42900
220217,202106,41,32,9,35200,9900,45100
220220,202106,2204,1454,750,1602700,828300,2431000
220225,202106,8,3,5,3300,5500,8800
220230,202106,952,731,221,804100,244200,1048300
220240,202106,163,145,18,159500,19800,179300
220245,202106,34,31,3,34100.18,3300,37400.18
220250,202106,125,107,18,117700,19800,137500
220253,202106,48,41,7,45100,7700,52800
220255,202106,39,33,6,36300,6600,42900
220260,202106,704,530,174,585200,192500,777700
220265,202106,9,7,2,7700,2200,9900
220270,202106,779,703,76,773300,83600,856900
220271,202106,42,34,8,37400,8800,46200
220272,202106,22,22,0,24200,0,24200
220273,202106,18,16,2,17600,2200,19800
220275,202106,57,47,10,51700,11000,62700
220277,202106,21,15,6,16500,6600,23100
220280,202106,16,11,5,12100,5500,17600
220285,202106,40,38,2,41800,2200,44000
220290,202106,1477,1271,206,1398100,226600,1624700
220300,202106,34,33,1,36300,1100,37400
220310,202106,327,279,48,306900,52800,359700
220320,202106,442,409,33,449900,36300,486200
220323,202106,1,0,1,0,1100,1100
220325,202106,11,10,1,11000,1100,12100
220327,202106,10,10,0,11000,0,11000
220330,202106,234,171,63,188100,69300,257400
220335,202106,140,122,18,134200,19800,154000
220340,202106,42,30,12,33000,13200,46200
220342,202106,57,49,8,53900,8800,62700
220345,202106,78,70,8,77000,8800,85800
220350,202106,448,387,61,425700,67100,492800
220360,202106,38,28,10,30800,11000,41800
220370,202106,1256,1038,218,1141800,239800,1381600
220375,202106,18,17,1,18700,1100,19800
220380,202106,23,17,6,18700,6600,25300
220385,202106,14,13,1,14300,1100,15400
220390,202106,2299,1291,1008,1423400,1109900,2533300
220400,202106,34,30,4,33000,4400,37400
220410,202106,21,19,2,20900,2200,23100
220415,202106,13,11,2,12100,2200,14300
220420,202106,126,106,20,116600,23100,139700
220430,202106,126,112,14,123200,15400,138600
220435,202106,24,17,7,18700,7700,26400
220440,202106,290,247,43,271700,47300,319000
220450,202106,336,171,165,188100,181500,369600
220455,202106,51,50,1,55000,1100,56100
220460,202106,18,17,1,18700,1100,19800
220465,202106,84,54,30,59400,33000,92400
220470,202106,248,214,34,235400,37400,272800
220480,202106,70,63,7,69300,7700,77000
220490,202106,87,75,12,83600,13200,96800
220500,202106,108,93,15,102300,16500,118800
220510,202106,404,313,91,344300,100100,444400
220515,202106,20,18,2,19800,2200,22000
220520,202106,370,329,41,363000,45100,408100
220525,202106,9,6,3,6600,3300,9900
220527,202106,18,14,4,15400,4400,19800
220530,202106,36,14,22,15400,24200,39600
220535,202106,6,5,1,5500,1100,6600
220540,202106,73,61,12,67100,13200,80300
220545,202106,37,25,12,27500,13200,40700
220550,202106,710,565,145,621500,159500,781000
220551,202106,17,13,4,14300,4400,18700
220552,202106,13,13,0,14300,0,14300
220553,202106,56,51,5,56100,5500,61600
220554,202106,11,8,3,8800,3300,12100
220555,202106,36,30,6,33000,6600,39600
220556,202106,38,36,2,39600,2200,41800
220557,202106,56,52,4,58300,4400,62700
220558,202106,7,3,4,3300,4400,7700
220559,202106,3,3,0,3300,0,3300
220560,202106,69,45,24,49500,26400,75900
220570,202106,729,455,274,500500,301400,801900
220580,202106,544,496,48,546700.1,52800,599500.1
220585,202106,10,9,1,9900,1100,11000
220590,202106,14,13,1,14300,1100,15400
220595,202106,67,51,16,56100,17600,73700
220600,202106,22,14,8,15400,8800,24200
220605,202106,24,21,3,23100,3300,26400
220610,202106,84,71,13,78100,14300,92400
220620,202106,550,460,90,507100,99000,606100
220630,202106,5,4,1,4400,1100,5500
220635,202106,38,33,5,36300,5500,41800
220640,202106,106,87,19,95700,20900,116600
220650,202106,113,107,6,117700,6600,124300
220660,202106,58,46,12,50600,13200,63800
220665,202106,7,7,0,7700,0,7700
220667,202106,20,18,2,19800,2200,22000
220669,202106,30,25,5,27500,5500,33000
220670,202106,68,56,12,61600,13200,74800
220672,202106,79,57,22,62700,24200,86900
220675,202106,33,25,8,27500,8800,36300
220680,202106,44,38,6,41800,6600,48400
220690,202106,49,46,3,50600,3300,53900
220695,202106,28,16,12,17600,13200,30800
220700,202106,1722,1334,388,1468500,426800,1895300
220710,202106,6,4,2,4400,2200,6600
220720,202106,107,92,15,101200,17600,118800
220730,202106,18,16,2,17600,2200,19800
220735,202106,4,0,4,0,4400,4400
220740,202106,49,44,5,48400,5500,53900
220750,202106,112,97,15,106700,17600,124300
220755,202106,15,14,1,15400,1100,16500
220760,202106,68,60,8,66000,8800,74800
220770,202106,5767,3189,2578,3510100.7,2835800,6345900.7
220775,202106,15,10,5,11000,5500,16500
220777,202106,19,18,1,19800,1100,20900
220779,202106,1,0,1,0,1100,1100
220780,202106,895,765,130,841500,143000,984500
220785,202106,5,1,4,1100,4400,5500
220790,202106,1109,876,233,964700,257400,1222100
220793,202106,7,7,0,7700,0,7700
220795,202106,13,12,1,13200,1100,14300
220800,202106,4036,3097,939,3411304,1032900,4444204
220810,202106,69,61,8,67100,8800,75900
220820,202106,239,216,23,237600,25300,262900
220830,202106,1278,1107,171,1218800,188100,1406900
220840,202106,2417,1691,726,1861200,799700,2660900
220850,202106,63,55,8,60500,8800,69300
220855,202106,9,5,4,5500,4400,9900
220860,202106,11,10,1,11000,1100,12100
220865,202106,28,26,2,28600,2200,30800
220870,202106,81,72,9,79200,9900,89100
220880,202106,322,257,65,282700,71500,354200
220885,202106,31,29,2,31900,2200,34100
220887,202106,11,10,1,11000,1100,12100
220890,202106,91,79,12,86900,13200,100100
220900,202106,27,16,11,17600,12100,29700
220910,202106,51,42,9,46200,9900,56100
220915,202106,11,10,1,11000,1100,12100
220920,202106,48,42,6,46200,6600,52800
220930,202106,47,46,1,50600,1100,51700
220935,202106,15,15,0,16500,0,16500
220937,202106,32,31,1,34100,1100,35200
220940,202106,54,50,4,55000,4400,59400
220945,202106,3,3,0,3300,0,3300
220950,202106,38,30,8,33000,8800,41800
220955,202106,20,19,1,20900,1100,22000
220960,202106,21,20,1,22000,1100,23100
220965,202106,38,34,4,37400,4400,41800
220970,202106,60,50,10,55000,11000,66000
220975,202106,14,12,2,13200,2200,15400
220980,202106,33,30,3,33000,3300,36300
220985,202106,60,54,6,59400,6600,66000
220987,202106,31,30,1,33000,1100,34100
220990,202106,27,26,1,28600,1100,29700
220995,202106,16,13,3,14300,3300,17600
220997,202106,60,52,8,57200,8800,66000
221000,202106,1185,1069,116,1177000,128700,1305700
221005,202106,46,43,3,47300,3300,50600
221010,202106,18,14,4,15400,4400,19800
221020,202106,35,34,1,37400,1100,38500
221030,202106,39,31,8,34100,8800,42900
221035,202106,24,24,0,26400,0,26400
221037,202106,13,9,4,9900,4400,14300
221038,202106,28,25,3,27500,3300,30800
221039,202106,25,25,0,27500,0,27500
221040,202106,264,226,38,248600,41800,290400
221050,202106,231,195,36,214500,39600,254100
221060,202106,1886,1640,246,1804000,270600,2074600
221062,202106,33,32,1,35200,1100,36300
221063,202106,13,9,4,9900,4400,14300
221065,202106,61,49,12,53900,13200,67100
221070,202106,136,121,15,133100,16500,149600
221080,202106,373,320,53,352000,58300,410300
221090,202106,24,19,5,20900,5500,26400
221093,202106,43,32,11,35200,12100,47300
221095,202106,5,5,0,5500,0,5500
221097,202106,14,12,2,13200,2200,15400
221100,202106,25655,15295,10360,16837700.63,11403700,28241400.63
221110,202106,1106,839,267,924000,294800,1218800
221120,202106,538,398,140,438900,154000,592900
221130,202106,965,776,189,853600,207900,1061500
221135,202106,33,29,4,31900,4400,36300
221140,202106,49,43,6,47300,6600,53900
221150,202106,10,8,2,8800,2200,11000
221160,202106,12,12,0,13200,0,13200
221170,202106,17,17,0,18700,0,18700
230010,202106,150,135,15,148500,16500,165000
230015,202106,137,111,26,122100,28600,150700
230020,202106,1640,1371,269,1509200,295900,1805100
230030,202106,1669,1198,471,1317800,518100,1835900
230040,202106,226,190,36,209000,39600,248600
230050,202106,232,172,60,189200,66000,255200
230060,202106,160,126,34,138600,37400,176000
230070,202106,299,255,44,280500,48400,328900
230075,202106,852,735,117,808500,128700,937200
230080,202106,193,166,27,182600,29700,212300
230090,202106,136,100,36,110000,39600,149600
230100,202106,2235,1271,964,1404700,1061500,2466200
230110,202106,2867,1836,1031,2020700,1135200,3155900
230120,202106,1041,819,222,900900,245300,1146200
230125,202106,154,125,29,137500,31900,169400
230130,202106,470,419,51,460900,56100,517000
230140,202106,221,184,37,202400,40700,243100
230150,202106,152,117,35,128700,38500,167200
230160,202106,953,805,148,885500,162800,1048300
230170,202106,611,544,67,599500,73700,673200
230180,202106,73,67,6,73700,6600,80300
230185,202106,412,354,58,389400,63800,453200
230190,202106,2381,1858,523,2044900.32,575300,2620200.32
230195,202106,497,431,66,474100,72600,546700
230200,202106,417,337,80,370700,88000,458700
230205,202106,391,259,132,284900,145200,430100
230210,202106,1369,1063,306,1172600,337700,1510300
230220,202106,1577,1074,503,1182500,553300,1735800
230230,202106,966,813,153,894300,168300,1062600
230240,202106,1817,1574,243,1732775,267300,2000075
230250,202106,1783,1464,319,1611500,352000,1963500
230260,202106,3198,1982,1216,2182400,1337600,3520000
230270,202106,1379,1097,282,1211100.05,310200,1521300.05
230280,202106,2744,2080,664,2288000,730400,3018400
230290,202106,363,323,40,355300.5,44000,399300.5
230300,202106,524,381,143,419100,157300,576400
230310,202106,421,325,96,357500,105600,463100
230320,202106,912,774,138,852500,152900,1005400
230330,202106,307,246,61,271700,67100,338800
230340,202106,443,359,84,396000,92400,488400
230350,202106,3223,2022,1201,2225300,1321100,3546400
230360,202106,272,224,48,246400,52800,299200
230365,202106,131,108,23,119900,25300,145200
230370,202106,10348,5098,5250,5608900.92,5779400.2,11388301.12
230380,202106,497,426,71,468600,78100,546700
230390,202106,534,298,236,327800,259600,587400
230393,202106,249,207,42,227700,46200,273900
230395,202106,342,273,69,300300,77000,377300
230400,202106,628,502,126,552200,138600,690800
230410,202106,2659,1649,1010,1817200.5,1111000,2928200.5
230420,202106,6334,4192,2142,4612301.01,2358400,6970701.01
230423,202106,338,294,44,323400,48400,371800
230425,202106,440,355,85,392700,93500,486200
230426,202106,117,94,23,103400,25300,128700
230427,202106,69,65,4,72600,4400,77000
230428,202106,1542,756,786,832700,864600,1697300
230430,202106,454,366,88,403700,96800,500500
230435,202106,913,666,247,734800,271700.24,1006500.24
230440,202106,90563,40706,49857,44821589.08,54910900.55,99732489.63
230445,202106,314,213,101,234300,111100,345400
230450,202106,576,454,122,499400,135300,634700
230460,202106,73,52,21,57200,23100,80300
230465,202106,308,248,60,272800,66000,338800
230470,202106,2024,1590,434,1749000,478500,2227500
230480,202106,152,142,10,156200,11000,167200
230490,202106,317,249,68,273900,74800,348700
230495,202106,458,335,123,368500,135300,503800
230500,202106,1031,760,271,836000,298100,1134100
230510,202106,56,43,13,47300,14300,61600
230520,202106,389,304,85,334400,93500,427900
230523,202106,2373,1476,897,1624700.79,992200,2616900.79
230526,202106,271,233,38,256300,41800,298100
230530,202106,685,509,176,559900,194700,754600
230533,202106,211,194,17,213400,18700,232100
230535,202106,368,276,92,304700,101200,405900
230540,202106,1799,1605,194,1766600,214500,1981100
230550,202106,3900,2495,1405,2748900,1547700,4296600
230560,202106,577,435,142,478500,157300,635800
230565,202106,225,166,59,182600,64900,247500
230570,202106,285,249,36,273900,39600,313500
230580,202106,1178,847,331,935000,364100,1299100
230590,202106,1005,782,223,861300,245300,1106600
230600,202106,252,231,21,254100,23100,277200
230610,202106,401,302,99,332200,108900,441100
230620,202106,168,145,23,159500,25300,184800
230625,202106,796,545,251,599500,277200,876700
230630,202106,1330,1022,308,1124200,338800,1463000
230640,202106,3825,3223,602,3548600,662200,4210800
230650,202106,497,427,70,470800,77000,547800
230655,202106,696,579,117,641300,128700,770000
230660,202106,363,299,64,328900,70400,399300
230670,202106,442,375,67,412500,73700,486200
230680,202106,205,185,20,203500,22000,225500
230690,202106,918,770,148,847000,163900,1010900
230700,202106,872,731,141,804100,155100,959200
230710,202106,694,655,39,720500,42900,763400
230720,202106,146,125,21,137500,23100,160600
230725,202106,224,168,56,184800,61600,246400
230730,202106,12338,6646,5692,7323731.32,6279901.48,13603632.80
230740,202106,670,540,130,594000,143000,737000
230750,202106,826,697,129,768900,143000,911900
230760,202106,1433,1228,205,1351900,225500,1577400
230763,202106,333,273,60,300300,66000,366300
230765,202106,7776,3621,4155,3987500.6,4574900,8562400.6
230770,202106,4951,2525,2426,2781900,2671900,5453800
230780,202106,738,650,88,715000,96800,811800
230790,202106,297,247,50,271700,55000,326700
230800,202106,1158,836,322,924000,354200,1278200
230810,202106,1358,1197,161,1317800,177100,1494900
230820,202106,367,251,116,276100,127600,403700
230830,202106,964,817,147,899800,161700,1061500
230835,202106,279,238,41,261800,45100,306900
230837,202106,172,144,28,158400,30800,189200
230840,202106,926,720,206,792000,226600,1018600
230850,202106,1457,1256,201,1382700,221100,1603800
230860,202106,303,226,77,248600,84706,333306
230870,202106,1822,1543,279,1700600,306900,2007500
230880,202106,70,55,15,60500,16500,77000
230890,202106,541,490,51,539000,56100,595100
230900,202106,273,203,70,224400,77000.7,301400.7
230910,202106,221,170,51,188100,56100,244200
230920,202106,479,380,99,418000,108900,526900
230930,202106,1009,707,302,777700,332200,1109900
230940,202106,848,655,193,721600,213400,935000
230945,202106,526,422,104,465300,114400,579700
230950,202106,420,365,55,401500,60500,462000
230960,202106,2683,1794,889,1974500,979000,2953500
230970,202106,1704,953,751,1048300,826100,1874400
230980,202106,200,162,38,178200,41800,220000
230990,202106,136,109,27,119900,29700,149600
231000,202106,194,177,17,194700,18700,213400
231010,202106,155,111,44,122100,48400,170500
231020,202106,1371,952,419,1048300,463100,1511400
231025,202106,1063,772,291,849200,320100,1169300
231030,202106,1081,901,180,992200,198000,1190200
231040,202106,148,99,49,108900,53900,162800
231050,202106,942,828,114,910800,125400,1036200
231060,202106,157,132,25,145200,27500,172700
231070,202106,1481,1029,452,1134100,498300,1632400
231080,202106,264,238,26,261800,28600,290400
231085,202106,631,380,251,418000,276100,694100
231090,202106,254,205,49,225500,53900,279400
231095,202106,168,133,35,146300,38500,184800
231100,202106,161,132,29,145200,31900,177100
231110,202106,370,313,57,345400,62700,408100
231120,202106,268,227,41,249700,45100,294800
231123,202106,154,145,9,159500,9900,169400
231126,202106,330,255,75,280500,82500,363000
231130,202106,4840,3795,1045,4180000,1151700,5331700
231135,202106,209,182,27,200200,29700,229900
231140,202106,3068,2228,840,2453000,924000,3377000
231150,202106,374,351,23,386100,25300,411400
231160,202106,1206,968,238,1065900,261800,1327700
231170,202106,512,356,156,392700,171600,564300
231180,202106,1716,1478,238,1629100,262900,1892000
231190,202106,207,174,33,191400,36300,227700
231195,202106,222,188,34,206800,37400,244200
231200,202106,803,661,142,727100,156200,883300
231210,202106,526,445,81,490600,89100,579700
231220,202106,1037,756,281,832700.85,309100,1141800.85
231230,202106,1464,1140,324,1256200,356400,1612600
231240,202106,1461,1032,429,1137400,474100,1611500
231250,202106,99,93,6,102300,6600,108900
231260,202106,266,176,90,193600,99000,292600
231270,202106,990,795,195,876700,215600,1092300
231280,202106,75,58,17,63800,18700,82500
231290,202106,7716,4355,3361,4799300.57,3700400.57,8499701.14
231300,202106,607,561,46,617100,50600,667700
231310,202106,755,688,67,756800.2,73700,830500.2
231320,202106,594,448,146,492800,160600,653400
231325,202106,101,88,13,96800,14300,111100
231330,202106,1947,1499,448,1651375.74,493900,2145275.74
231335,202106,255,225,30,247500,33000,280500
231340,202106,1734,1258,476,1386000,523600,1909600
231350,202106,1311,1056,255,1161600,280500,1442100
231355,202106,431,367,64,403700,70400,474100
231360,202106,532,379,153,416900.65,169400,586300.65
231370,202106,92,81,11,89100,12100,101200
231375,202106,292,211,81,232100,89100,321200
231380,202106,500,395,105,434500,115500,550000
231390,202106,212,162,50,178200,55000,233200
231395,202106,758,473,285,520300,313500,833800
231400,202106,1127,940,187,1034000,206800,1240800
231410,202106,1331,1097,234,1208900,257400,1466300
240010,202106,378,166,212,182600.33,233200,415800.33
240020,202106,2214,1797,417,1976700,458700,2435400
240030,202106,116,97,19,106700,20900,127600
240040,202106,30,30,0,34100,0,34100
240050,202106,533,453,80,498300,88000,586300
240060,202106,66,62,4,68200,4400,72600
240070,202106,231,181,50,199100,55000,254100
240080,202106,535,362,173,398200,190300.7,588500.7
240090,202106,103,92,11,101200,12100,113300
240100,202106,1477,1391,86,1532300.5,94600,1626900.5
240110,202106,1030,675,355,742500,390500,1133000
240120,202106,143,110,33,121000,36300,157300
240130,202106,273,252,21,277200,23100,300300
240140,202106,82,57,25,62700,27500,90200
240145,202106,721,636,85,702900,93500,796400
240150,202106,22,17,5,18700,5500,24200
240160,202106,45,35,10,38500,11000,49500
240165,202106,37,29,8,31900,8800,40700
240170,202106,116,79,37,86900,40700,127600
240180,202106,96,73,23,80300,25300,105600
240185,202106,43,39,4,42900,4400,47300
240190,202106,17,15,2,16500,2200,18700
240200,202106,3051,1691,1360,1865600,1496000,3361600
240210,202106,171,131,40,144100,44000,188100
240220,202106,1106,795,311,874500,342100,1216600
240230,202106,839,766,73,842600,80300,922900
240240,202106,69,49,20,53900,22000,75900
240250,202106,91,78,13,85800,14300,100100
240260,202106,1807,1328,479,1463000,526900,1989900
240270,202106,180,158,22,173800,24200,198000
240280,202106,51,39,12,44000,13200,57200
240290,202106,47,45,2,49500,2200,51700
240300,202106,173,95,78,104500,85800,190300
240310,202106,2379,1297,1082,1426700.19,1191300,2618000.19
240320,202106,186,173,13,190300,14300,204600
240325,202106,4616,2739,1877,3014001.85,2068000,5082001.85
240330,202106,70,66,4,72600,4400,77000
240340,202106,79,53,26,58300,28600,86900
240350,202106,96,83,13,91300,14300,105600
240360,202106,575,349,226,385000,248600,633600
240370,202106,54,50,4,55000,4400,59400
240375,202106,63,38,25,41800,27500,69300
240380,202106,230,188,42,206800,46200,253000
240390,202106,12,11,1,12100,1100,13200
240400,202106,80,72,8,79200,8800,88000
240410,202106,14,8,6,8800,6600,15400
240420,202106,1032,754,278,830500,305800,1136300
240430,202106,261,244,17,268400,18700,287100
240440,202106,127,72,55,80300,60500,140800
240450,202106,233,153,80,168300,89100,257400
240460,202106,73,57,16,62700,17600,80300
240470,202106,235,210,25,231000,27500,258500
240480,202106,16,14,2,15400,2200,17600
240485,202106,84,69,15,75900,16500,92400
240490,202106,47,44,3,48400,3300,51700
240500,202106,90,68,22,74800,24200,99000
240510,202106,43,31,12,34100,13200,47300
240520,202106,105,100,5,110000,5500,115500
240530,202106,55,48,7,52800,7700,60500
240540,202106,80,68,12,74800,13200,88000
240550,202106,13,12,1,13200,1100,14300
240560,202106,375,274,101,301400,111100,412500
240570,202106,437,276,161,304700,177100,481800
240580,202106,1286,1006,280,1107700,308000,1415700
240590,202106,31,29,2,31900,2200,34100
240600,202106,101,97,4,106700,4400,111100
240610,202106,509,425,84,469700,92400,562100
240615,202106,17,16,1,17600,1100,18700
240620,202106,88,85,3,93500,3300,96800
240630,202106,39,34,5,37400,5500,42900
240640,202106,26,21,5,23100,5500,28600
240650,202106,240,198,42,217800,46200,264000
240660,202106,111,94,17,103400,18700,122100
240670,202106,314,176,138,194700,151800,346500
240680,202106,52,39,13,42900,14300,57200
240690,202106,47,44,3,48400,3300,51700
240700,202106,184,151,33,166100,36300,202400
240710,202106,2063,1265,798,1392600,877800,2270400
240720,202106,1063,778,285,855800,313500,1169300
240725,202106,66,62,4,68200,4400,72600
240730,202106,149,124,25,136400,27500,163900
240740,202106,230,196,34,215600,37400,253000
240750,202106,47,28,19,30800,20900,51700
240760,202106,47,43,4,47300,4400,51700
240770,202106,148,115,33,127600,36300,163900
240780,202106,699,583,116,641300,128700,770000
240790,202106,44,42,2,46200,2200,48400
240800,202106,9328,6315,3013,6950902.66,3318700,10269602.66
240810,202106,20807,11188,9619,12324400,10595200,22919600
240820,202106,246,147,99,161700,108900,270600
240830,202106,1616,1328,288,1460800,316800,1777600
240840,202106,77,67,10,73700,11000,84700
240850,202106,82,74,8,81400,8800,90200
240860,202106,106,102,4,112200,4400,116600
240870,202106,58,50,8,55000,8800,63800
240880,202106,31,28,3,30800,3300,34100
240890,202106,1132,641,491,706200,540100,1246300
240895,202106,62,45,17,49500,18700,68200
240910,202106,165,141,24,155100,26400,181500
240920,202106,13,11,2,12100,2200,14300
240930,202106,405,363,42,401500,46200,447700
240933,202106,52,34,18,37400,19800,57200
240940,202106,2339,2074,265,2281400,291500,2572900
240950,202106,49,43,6,47300,6600,53900
240960,202106,26,21,5,23100,5500,28600
240970,202106,113,83,30,91300,33000,124300
240980,202106,202,164,38,180400,41800,222200
240990,202106,133,90,43,99000,48400,147400
241000,202106,58,55,3,60500,3300,63800
241010,202106,75,57,18,62700,19800,82500
241020,202106,109,100,9,110000,9900,119900
241025,202106,15,8,7,8800,7700,16500
241030,202106,112,88,24,96800,26400,123200
241040,202106,42,30,12,33000,13200,46200
241050,202106,77,70,7,77000,8800,85800
241060,202106,28,23,5,25300,5500,30800
241070,202106,16,16,0,17600,0,17600
241080,202106,61,54,7,59400,7700,67100
241090,202106,53,42,11,46200,12100,58300
241100,202106,73,62,11,68200,12100,80300
241105,202106,11,4,7,4400,7700,12100
241110,202106,45,40,5,44000,5500,49500
241120,202106,1513,1149,364,1263900,400400,1664300
241140,202106,215,180,35,198000,38500,236500
241142,202106,43,35,8,38500,8800,47300
241150,202106,1204,1056,148,1161600,162800,1324400
241160,202106,19,17,2,18700,2200,20900
241170,202106,48,40,8,44000,8800,52800
241180,202106,45,37,8,40700,8800,49500
241190,202106,38,36,2,39600,2200,41800
241200,202106,4041,2117,1924,2332000.53,2119700,4451700.53
241210,202106,67,58,9,63800,9900,73700
241220,202106,1441,963,478,1059300.43,526900,1586200.43
241230,202106,251,207,44,227700,48400,276100
241240,202106,53,41,12,45100,13200,58300
241250,202106,1128,1034,94,1138500,104500,1243000
241255,202106,55,44,11,48400,12100,60500
241260,202106,676,522,154,574200,169400,743600
241270,202106,65,45,20,49500,22000,71500
241280,202106,97,85,12,93500,13200,106700
241290,202106,131,91,40,100100,44000,144100
241300,202106,83,57,26,62700,28600,91300
241310,202106,52,37,15,40700,16500,57200
241320,202106,31,18,13,19800,14300,34100
241330,202106,62,53,9,58300,9900,68200
241335,202106,73,66,7,72600,7700,80300
241340,202106,182,134,48,147400,52800,200200
241350,202106,62,53,9,58300,9900,68200
241355,202106,50,42,8,46200,8800,55000
241360,202106,49,48,1,52800,1100,53900
241370,202106,57,45,12,49500,13200,62700
241380,202106,34,30,4,33000,4400,37400
241390,202106,83,64,19,70400,20900,91300
241400,202106,218,170,48,187000,52800,239800
241410,202106,182,164,18,180400,19800,200200
241415,202106,101,83,18,91300,19800,111100
241420,202106,106,79,27,86900,29700,116600
241430,202106,25,23,2,25300,2200,27500
241440,202106,532,441,91,485100,100100,585200
241445,202106,40,35,5,38500,5500,44000
241450,202106,264,218,46,239800,50600,290400
241460,202106,147,134,13,148500,14300,162800
241470,202106,34,29,5,31900,5500,37400
241475,202106,52,49,3,53900,3300,57200
241480,202106,113,83,30,91300,33000,124300
241490,202106,12,11,1,12100,1100,13200
241500,202106,44,34,10,37400,11000,48400
250010,202106,102,87,15,95700,16500,112200
250020,202106,31,28,3,30800,3300,34100
250030,202106,890,666,224,732600,247500,980100
250040,202106,385,317,68,348700,74800,423500
250050,202106,260,211,49,232100,53900,286000
250053,202106,58,45,13,49500,14300,63800
250057,202106,1,1,0,1100,0,1100
250060,202106,603,436,167,479600,185900,665500
250070,202106,696,559,137,617100.22,150700,767800.22
250073,202106,7,7,0,7700,0,7700
250077,202106,177,130,47,143000,51700,194700
250080,202106,424,334,90,367400,99000,466400
250090,202106,221,142,79,156200,86900,243100
250100,202106,531,442,89,486200,97900,584100
250110,202106,641,484,157,532400,172700,705100
250115,202106,17,4,13,4400,14300,18700
250120,202106,120,87,33,97900,36300,134200
250130,202106,570,457,113,503800,124300,628100
250135,202106,19,11,8,12100,8800,20900
250140,202106,83,74,9,81400,9900,91300
250150,202106,605,434,171,479600,188100,667700
250153,202106,12,9,3,9900,3300,13200
250157,202106,28,23,5,25300,5500,30800
250160,202106,228,181,47,199100,51700,250800
250170,202106,66,43,23,47300,25300,72600
250180,202106,4463,3046,1417,3352800,1562000,4914800
250190,202106,827,549,278,603900,305800,909700
250200,202106,56,43,13,47300,14300,61600
250205,202106,23,18,5,19800,5500,25300
250210,202106,86,75,11,82500,12100,94600
250215,202106,68,52,16,57200,17600,74800
250220,202106,25,18,7,19800,7700,27500
250230,202106,76,69,7,75900,7700,83600
250240,202106,235,187,48,205700,52800,258500
250250,202106,381,326,55,358600,60500,419100
250260,202106,43,35,8,38500,8800,47300
250270,202106,74,52,22,57200,24200,81400
250280,202106,377,306,71,336600,78100,414700
250290,202106,90,83,7,91300,7700,99000
250300,202106,560,379,181,416900,199100,616000
250310,202106,44,40,4,44000,4400,48400
250320,202106,1950,1306,644,1437700,708400,2146100
250330,202106,102,87,15,95700,16500,112200
250340,202106,28,24,4,26400,4400,30800
250350,202106,183,119,64,130900,70400,201300
250355,202106,32,23,9,25300,9900,35200
250360,202106,196,161,35,178200,38500,216700
250370,202106,2380,1547,833,1702800,916300,2619100
250375,202106,11,6,5,6600,5500,12100
250380,202106,58,46,12,50600,13200,63800
250390,202106,46,36,10,39600,11000,50600
250400,202106,16432,8268,8164,9107981.67,8992500,18100481.67
250403,202106,322,256,66,281600,72600,354200
250407,202106,63,51,12,56100,13200,69300
250410,202106,29,25,4,27500,4400,31900
250415,202106,40,27,13,29700,14300,44000
250420,202106,43,37,6,40700,6600,47300
250430,202106,1435,1237,198,1363175,217800,1580975
250435,202106,21,15,6,16500,6600,23100
250440,202106,681,567,114,623700,125400,749100
250450,202106,83,64,19,70400,20900,91300
250460,202106,466,305,161,336600,177100,513700
250470,202106,97,67,30,73700,33000,106700
250480,202106,330,263,67,289300,73700,363000
250485,202106,2,2,0,2200,0,2200
250490,202106,227,185,42,203500,46200,249700
250500,202106,98,73,25,80300,27500,107800
250510,202106,784,627,157,689700,172700,862400
250520,202106,174,116,58,127600,63800,191400
250523,202106,122,98,24,107800,26400,134200
250527,202106,108,85,23,93500,25300,118800
250530,202106,9,6,3,6600,3300,9900
250535,202106,30,22,8,24200,8800,33000
250540,202106,140,110,30,121000,33000,154000
250550,202106,69,67,2,73700,2200,75900
250560,202106,56,38,18,41800,19800,61600
250570,202106,159,130,29,143000,31900,174900
250580,202106,104,80,24,88071,26400,114471
250590,202106,24,14,10,15400,11000,26400
250600,202106,1456,961,495,1057100.7,544500,1601600.7
250610,202106,159,132,27,145200,29700,174900
250620,202106,21,17,4,18700,4400,23100
250625,202106,75,56,19,61600,20900,82500
250630,202106,3096,1980,1116,2180200.62,1228700,3408900.62
250640,202106,203,163,40,180400,44000,224400
250650,202106,30,20,10,22000,11000,33000
250660,202106,55,39,16,42900,17600,60500
250670,202106,68,48,20,52800,22000,74800
250680,202106,410,330,80,364100,88000,452100
250690,202106,2092,1454,638,1600500.7,701800,2302300.7
250700,202106,928,799,129,880000,141900,1021900
250710,202106,444,347,97,381700,106700,488400
250720,202106,117,85,32,93500,35200,128700
250730,202106,402,333,69,366300,75900,442200
250740,202106,58,54,4,59400,4400,63800
250750,202106,22826,13616,9210,14992882.3,10139800,25132682.3
250760,202106,105,82,23,90200,25300,115500
250770,202106,360,237,123,260700,135300,396000
250780,202106,69,46,23,50600,25300,75900
250790,202106,456,293,163,322300,179300,501600
250800,202106,154,139,15,152900,16500,169400
250810,202106,74,59,15,64900,16500,81400
250820,202106,150,126,24,138600,26400,165000
250830,202106,441,293,148,322300,162800,485100
250840,202106,55,49,6,53900,6600,60500
250850,202106,56,46,10,50600,11000,61600
250855,202106,16,14,2,15400,2200,17600
250860,202106,250,151,99,166100,108900,275000
250870,202106,28,25,3,27500,3300,30800
250880,202106,87,63,24,69300,26400,95700
250890,202106,2952,2200,752,2425500,828300,3253800
250900,202106,54,45,9,49500,9900,59400
250905,202106,124,95,29,104500,31900,136400
250910,202106,1080,794,286,874500,314600,1189100
250915,202106,101,72,29,79200,31900,111100
250920,202106,140,103,37,113300,40700,154000
250930,202106,173,103,70,113300,77000,190300
250933,202106,7,5,2,5500,2200,7700
250937,202106,11,11,0,12100,0,12100
250939,202106,32,24,8,26400,8800,35200
250940,202106,110,81,29,89100,31900,121000
250950,202106,73,49,24,53900,26400,80300
250960,202106,93,51,42,56100,46200,102300
250970,202106,1226,866,360,953700,397100,1350800
250980,202106,104,68,36,74800,39600,114400
250990,202106,167,128,39,140800,42900,183700
251000,202106,75,66,9,72600,9900,82500
251010,202106,116,88,28,96800,30800,127600
251020,202106,74,60,14,66000,15400,81400
251030,202106,45,34,11,37400,12100,49500
251040,202106,56,38,18,41800,19800,61600
251050,202106,25,22,3,24200,3300,27500
251060,202106,49,40,9,45100,9900,55000
251065,202106,5,3,2,3300,2200,5500
251070,202106,17,14,3,15400,3300,18700
251080,202106,5094,2422,2672,2664200,2941400.1,5605600.1
251090,202106,181,152,29,167200,31900,199100
251100,202106,19,19,0,20900,0,20900
251110,202106,50,39,11,42900,12100,55000
251120,202106,1869,1146,723,1262800.8,796400,2059200.8
251130,202106,417,342,75,376200,83600,459800
251140,202106,564,365,199,401500,218900,620400
251150,202106,342,288,54,316800,59400,376200
251160,202106,94,76,18,84700,19800,104500
251170,202106,100,79,21,86900,23100,110000
251180,202106,289,175,114,192500,125400,317900
251190,202106,201,127,74,140800,81400,222200
251200,202106,271,217,54,239800,59400,299200
251203,202106,33,31,2,34100,2200,36300
251207,202106,82,68,14,74800,15400,90200
251210,202106,1481,1083,398,1191300,437800,1629100
251220,202106,46,36,10,39600,11000,50600
251230,202106,594,492,102,541200,112200,653400
251240,202106,104,73,31,80300,34100,114400
251250,202106,1428,1031,397,1135200,437800,1573000
251260,202106,11,7,4,7700,4400,12100
251270,202106,311,242,69,268400,75900,344300
251272,202106,65,58,7,63800,7700,71500
251274,202106,29,22,7,24200,7700,31900
251275,202106,33,18,15,19800,16500,36300
251276,202106,19,16,3,17600,3300,20900
251278,202106,9,7,2,7700,2200,9900
251280,202106,101,96,5,105600,5500,111100
251290,202106,879,630,249,695200,273900,969100
251300,202106,16,12,4,13200,4400,17600
251310,202106,295,218,77,239800,85800,325600
251315,202106,36,32,4,35200,4400,39600
251320,202106,66,50,16,55000,17600,72600
251330,202106,80,71,9,78100,9900,88000
251335,202106,21,10,11,11000,12100,23100
251340,202106,751,441,310,485100,341000,826100
251350,202106,35,34,1,37400,1100,38500
251360,202106,82,71,11,78100,12100,90200
251365,202106,11,11,0,12100,0,12100
251370,202106,5586,3764,1822,4140400.32,2005300,6145700.32
251380,202106,45,35,10,38500,11000,49500
251385,202106,2,2,0,2200,0,2200
251390,202106,855,638,217,701800,238700,940500
251392,202106,21,12,9,13200,9900,23100
251394,202106,9,9,0,9900,0,9900
251396,202106,14,10,4,11000,4400,15400
251398,202106,16,14,2,15400,2200,17600
251400,202106,43,34,9,37400,9900,47300
251410,202106,39,33,6,36300,6600,42900
251420,202106,103,75,28,82500,30800,113300
251430,202106,45,41,4,45100,4400,49500
251440,202106,47,26,21,28600,23100,51700
251445,202106,59,52,7,57200,7700,64900
251450,202106,403,349,54,383900,59400,443300
251455,202106,3,2,1,2200,1100,3300
251460,202106,17,15,2,16500,2200,18700
251465,202106,7,5,2,5500,2200,7700
251470,202106,50,37,13,41800,14300,56100
251480,202106,27,22,5,24200,5500,29700
251490,202106,112,71,41,78100,45100,123200
251500,202106,129,103,26,113300,28600,141900
251510,202106,69,44,25,48400,27500,75900
251520,202106,31,29,2,31900,2200,34100
251530,202106,4416,3138,1278,3457300,1405800,4863100
251540,202106,80,68,12,74800,13200,88000
251550,202106,412,313,99,344300,108900,453200
251560,202106,24,16,8,17600,8800,26400
251570,202106,19,16,3,17600,3300,20900
251580,202106,134,107,27,117700,29700,147400
251590,202106,115,82,33,90407.9,36300,126707.9
251593,202106,22,13,9,14300,9900,24200
251597,202106,102,84,18,92400,19800,112200
251600,202106,1108,781,327,859100,359700,1218800
251610,202106,241,176,65,194700,71500,266200
251615,202106,11,10,1,11000,1100,12100
251620,202106,4210,2731,1479,3005200,1628000,4633200
251630,202106,462,343,119,377300,132000,509300
251640,202106,135,100,35,110000,38500,148500
251650,202106,286,211,75,232100,82500,314600
251660,202106,193,170,23,187000,25300,212300
251670,202106,382,296,86,325600,95700,421300
251675,202106,8,6,2,6600,2200,8800
251680,202106,103,91,12,100100,13200,113300
251690,202106,323,267,56,293700,61600,355300
251700,202106,284,246,38,270600,41800,312400
251710,202106,22,14,8,15400,8800,24200
251720,202106,25,17,8,18700,8800,27500
251740,202106,11,8,3,8800,3300,12100
260005,202106,3364,1798,1566,1979532.93,1723700,3703232.93
260010,202106,1624,1180,444,1299100.58,488400,1787500.58
260020,202106,418,361,57,398200,62700,460900
260030,202106,602,414,188,455400,206800,662200
260040,202106,801,491,310,541200,341000,882200
260050,202106,1159,834,325,919600,357500,1277100
260060,202106,379,345,34,379500,37400,416900
260070,202106,1342,823,519,905300,570900,1476200
260080,202106,727,555,172,610500,189200,799700
260090,202106,513,326,187,358600,207900,566500
260100,202106,220,152,68,167200,74800,242000
260105,202106,249,137,112,150700,124300,275000
260110,202106,2892,2125,767,2338600,844800,3183400
260120,202106,2764,1449,1315,1595292.6,1450900,3046192.6
260130,202106,173,117,56,128700,61600,190300
260140,202106,2155,1411,744,1554300,818400,2372700
260150,202106,201,128,73,140800,80300,221100
260160,202106,326,271,55,298100,60500,358600
260170,202106,3332,1994,1338,2194500,1471800,3666300
260180,202106,164,129,35,141900,38500,180400
260190,202106,2333,1560,773,1717100,851400,2568500
260200,202106,975,776,199,853600.63,218900,1072500.63
260210,202106,1421,1002,419,1104400,462000,1566400
260220,202106,667,602,65,662200,71500,733700
260230,202106,1223,907,316,997700,348700,1346400
260240,202106,211,161,50,177100,55000,232100
260250,202106,88,65,23,71500,25300,96800
260260,202106,1040,731,309,805200,339900,1145100
260270,202106,254,188,66,207900,72600,280500
260280,202106,1220,933,287,1026300,315700,1342000
260290,202106,6603,3585,3018,3944600,3325300.59,7269900.59
260300,202106,961,822,139,904200,152900,1057100
260310,202106,522,416,106,457600,116600,574200
260320,202106,853,618,235,679800,260700,940500
260330,202106,67,46,21,50600,23100,73700
260340,202106,76,56,20,61600,22000,83600
260345,202106,5504,2942,2562,3240600.4,2820400,6061000.4
260350,202106,484,343,141,377300,155100,532400
260360,202106,230,123,107,135300,117700,253000
260370,202106,756,477,279,524700,308000,832700
260380,202106,577,420,157,462000,172700.6,634700.6
260390,202106,293,246,47,270600,51700,322300
260392,202106,112,96,16,105600,17600,123200
260400,202106,4210,2400,1810,2640000.5,1993200,4633200.5
260410,202106,14683,7708,6975,8485400.63,7678000.5,16163401.13
260415,202106,144,125,19,137500,20900,158400
260420,202106,1732,1051,681,1156100.7,750200,1906300.7
260430,202106,176,161,15,178200.48,16500,194700.48
260440,202106,192,138,54,151800,59400,211200
260450,202106,427,317,110,348701.13,121000,469701.13
260460,202106,815,430,385,474100,423500,897600
260470,202106,340,206,134,226600,147400,374000
260480,202106,243,157,86,172700,94600,267300
260490,202106,212,174,38,191400,41800,233200
260500,202106,1127,756,371,833800,408100,1241900
260510,202106,783,622,161,684200,177100,861300
260515,202106,235,213,22,234300,24200,258500
260520,202106,3260,2023,1237,2228600,1360700,3589300
260530,202106,792,648,144,713900,158400,872300
260540,202106,531,419,112,460900,123200,584100
260545,202106,15,12,3,13200,3300,16500
260550,202106,325,204,121,224400,133100,357500
260560,202106,511,387,124,425700,136400,562100
260570,202106,978,790,188,869000,207900,1076900
260580,202106,254,221,33,243100,36300,279400
260590,202106,621,356,265,391600,292600,684200
260600,202106,8027,4411,3616,4852101.78,3984200,8836301.78
260610,202106,484,321,163,353100,180400,533500
260620,202106,3627,1869,1758,2057000,1934900.19,3991900.19
260630,202106,83,77,6,84700,6600,91300
260640,202106,3393,1924,1469,2117500,1618100,3735600
260650,202106,328,238,90,262900,100100,363000
260660,202106,563,352,211,387200,233200,620400
260670,202106,100,75,25,82500,27500,110000
260680,202106,3836,2098,1738,2310000,1911800,4221800
260690,202106,125,94,31,103400,34100,137500
260700,202106,305,203,102,223300,113300,336600
260710,202106,47,38,9,41800,9900,51700
260720,202106,2572,1509,1063,1661000,1169300,2830300
260730,202106,719,534,185,587400,203500,790900
260740,202106,67,58,9,63800,9900,73700
260750,202106,580,416,164,458700,180400,639100
260760,202106,678,339,339,372900.3,372900,745800.3
260765,202106,970,500,470,550000,517000,1067000
260770,202106,226,164,62,180381,68200.47,248581.47
260775,202106,772,427,345,469700.37,379500,849200.37
260780,202106,234,146,88,160600,96800,257400
260790,202106,14529,7342,7187,8079500,7911200,15990700
260795,202106,165,108,57,118800,62700,181500
260800,202106,289,239,50,262900,55000,317900
260805,202106,174,116,58,127600,63800,191400
260810,202106,777,652,125,718300,137500,855800
260820,202106,284,183,101,201300,111100,312400
260825,202106,226,146,80,160600,88000,248600
260830,202106,427,181,246,200200,271700,471900
260840,202106,245,179,66,196900,72600,269500
260845,202106,161,106,55,116600,60500,177100
260850,202106,424,314,110,345400,122100,467500
260860,202106,254,193,61,212300,67100,279400
260870,202106,359,272,87,299200,95700,394900
260875,202106,734,533,201,586300,221100,807400
260880,202106,1571,1021,550,1123100,605000,1728100
260890,202106,2325,1622,703,1787500,774400,2561900
260900,202106,980,699,281,770000,309100,1079100
260910,202106,249,196,53,215600,58300,273900
260915,202106,287,213,74,234300,81400,315700
260920,202106,190,97,93,106700,102300,209000
260930,202106,386,329,57,361900,62700,424600
260940,202106,2612,1395,1217,1536700,1340900,2877600
260950,202106,1992,1135,857,1249600,943800,2193400
260960,202106,13512,6732,6780,7414000.9,7465700.5,14879701.4
260970,202106,410,338,72,371800,80300,452100
260980,202106,198,178,20,195800,22000,217800
260990,202106,2636,2128,508,2343000,559900,2902900
261000,202106,4205,2556,1649,2811600,1815000,4626600
261010,202106,211,111,100,122100,110000,232100
261020,202106,595,444,151,488400.47,166100,654500.47
261030,202106,265,184,81,202400,90200,292600
261040,202106,380,329,51,361900,56100,418000
261050,202106,503,431,72,474100,79200,553300
261060,202106,1382,864,518,950400,569800,1520200
261070,202106,8911,4315,4596,4754200,5058900.5,9813100.5
261080,202106,373,286,87,314600,95700,410300
261090,202106,2141,1635,506,1807302.03,556600.3,2363902.33
261100,202106,1180,821,359,904200,394900,1299100
261110,202106,8858,5459,3399,6007100,3744400,9751500
261120,202106,252,216,36,237600,39600,277200
261130,202106,566,337,229,371800,251900,623700
261140,202106,212,133,79,146300,86900,233200
261150,202106,684,433,251,476300.56,277200,753500.56
261153,202106,70,65,5,71500,5500,77000
261160,202106,74104,36467,37637,40151191.94,41433701.55,81584893.49
261170,202106,473,347,126,381700,138600,520300
261180,202106,1761,1097,664,1209151,731500,1940651
261190,202106,574,398,176,438900,193600,632500
261200,202106,221,182,39,200200,42900,243100
261210,202106,35,30,5,33000,5500,38500
261220,202106,2727,1921,806,2114200.66,888800,3003000.66
261230,202106,349,248,101,272800,111100,383900
261240,202106,437,383,54,422400,59400,481800
261245,202106,243,199,44,218900,48400,267300
261247,202106,168,131,37,144100,40700,184800
261250,202106,3273,1586,1687,1745700,1855700,3601400
261255,202106,248,220,28,242000,30800,272800
261260,202106,844,732,112,807400.12,123200,930600.12
261270,202106,203,143,60,157300,66000,223300
261280,202106,180,146,34,160600,37400,198000
261290,202106,115,85,30,93500,33000,126500
261300,202106,1322,981,341,1079100,375100,1454200
261310,202106,787,527,260,579700,288200,867900
261320,202106,595,378,217,415800,238700,654500
261330,202106,958,730,228,803000,250800.63,1053800.63
261340,202106,306,169,137,185900,150700,336600
261350,202106,851,594,257,653400,282700,936100
261360,202106,1320,854,466,940500,513700,1454200
261370,202106,4807,2845,1962,3129500,2158200,5287700
261380,202106,539,414,125,456500.78,138600,595100.78
261390,202106,3563,2384,1179,2624600,1296900,3921500
261400,202106,282,253,29,278300,31900,310200
261410,202106,1113,726,387,799700,427900,1227600
261420,202106,907,564,343,621500.32,378400,999900.32
261430,202106,320,291,29,321200,31900,353100
261440,202106,114,105,9,115500,9900,125400
261450,202106,2491,1986,505,2186800,556600,2743400
261460,202106,739,583,156,641300,171600,812900
261470,202106,236,192,44,211200,48400,259600
261480,202106,450,349,101,383900,111050.5,494950.5
261485,202106,362,215,147,236500,161700,398200
261500,202106,607,410,197,451000.59,217800,668800.59
261510,202106,53,34,19,37400,20900,58300
261520,202106,90,77,13,84700,14300,99000
261530,202106,4105,2606,1499,2868800.09,1653300,4522100.09
261540,202106,1386,816,570,898700,627000,1525700
261550,202106,251,120,131,132000,144100,276100
261560,202106,862,565,297,622600,327800,950400
261570,202106,391,307,84,337700,92400,430100
261580,202106,389,308,81,338800,89100,427900
261590,202106,187,151,36,166100,39600,205700
261600,202106,291,230,61,254100,67100,321200
261610,202106,82,72,10,79200,11000,90200
261618,202106,77,60,17,66000,18700,84700
261620,202106,194,119,75,132000,82500,214500
261630,202106,672,537,135,592900,148500,741400
261640,202106,6402,3348,3054,3686101.05,3362700.66,7048801.71
261650,202106,495,318,177,349800,194700,544500
270010,202106,515,454,61,499400,67100,566500
270020,202106,251,204,47,224400,53900,278300
270030,202106,8770,5640,3130,6208400.6,3447351,9655751.6
270040,202106,2056,1319,737,1452001,812900,2264901
270050,202106,177,137,40,151800,44000,195800
270060,202106,81,53,28,58300,30800,89100
270070,202106,850,623,227,686400,249700,936100
270080,202106,35,29,6,31900,6600,38500
270090,202106,23,17,6,18700,6600,25300
270100,202106,1305,892,413,982300,456500,1438800
270110,202106,86,71,15,78100,16500,94600
270120,202106,225,183,42,201300,46200,247500
270130,202106,298,215,83,236500,91300,327800
270135,202106,114,74,40,81400,44000,125400
270140,202106,1373,888,485,976800,535700,1512500
270150,202106,258,201,57,221100,63800,284900
270160,202106,496,394,102,433400,112200,545600
270170,202106,809,524,285,576400,313500,889900
270180,202106,55,43,12,48400,13200,61600
270190,202106,117,99,18,110000,19800,129800
270200,202106,113,98,15,107800,16500,124300
270210,202106,525,311,214,342100,235400,577500
270220,202106,185,142,43,156200,47300,203500
270230,202106,2133,1314,819,1445400,900900,2346300
270235,202106,678,527,151,580800,166100,746900
270240,202106,2979,2356,623,2593801.56,685300,3279101.56
270250,202106,125,92,33,101200,36300,137500
270255,202106,217,187,30,205700,33000,238700
270260,202106,367,298,69,327800,75900,403700
270270,202106,97,46,51,50600,56100,106700
270280,202106,236,137,99,150700,108900,259600
270290,202106,1137,878,259,965800,284900,1250700
270300,202106,327,234,93,257766.66,102300,360066.66
270310,202106,825,686,139,754636.66,152900,907536.66
270320,202106,821,707,114,778800.63,125400,904200.63
270330,202106,304,257,47,283800,51700,335500
270340,202106,57,44,13,48400,14300,62700
270350,202106,90,52,38,57200,41800,99000
270360,202106,65,36,29,39600,31900,71500
270370,202106,58,46,12,50600,13200,63800
270375,202106,78,48,30,52800.9,33000,85800.9
270380,202106,1051,687,364,755700,400400,1156100
270390,202106,158,91,67,100100,73700,173800
270400,202106,725,547,178,601700.2,195800,797500.2
270410,202106,634,466,168,512600,185900,698500
270420,202106,405,275,130,302500,144100,446600
270430,202106,33323,23999,9324,26431498.16,10267400,36698898.16
270440,202106,496,391,105,430100,115500,545600
270450,202106,819,479,340,526900,374000,900900
270460,202106,180,143,37,157300,40700,198000
270470,202106,1530,1056,474,1161600,521400,1683000
270480,202106,534,437,97,481800,106700,588500
270490,202106,21,16,5,17600,5500,23100
270500,202106,501,417,84,458700,92400,551100
270510,202106,834,528,306,580800,336600,917400
270520,202106,280,180,100,198000,110000,308000
270530,202106,58,51,7,56100,7700,63800
270540,202106,93,72,21,79200,23100,102300
270550,202106,1705,1308,397,1441733.32,436700,1878433.32
270560,202106,265,154,111,169400,122100,291500
270570,202106,529,372,157,411400,173800,585200
270580,202106,84,68,16,74800,17600,92400
270590,202106,63,50,13,55000,14300,69300
270600,202106,168,141,27,155100,29700,184800
270610,202106,237,184,53,202400,58300,260700
270620,202106,15,15,0,16500,0,16500
270630,202106,3725,2840,885,3126786.66,973500,4100286.66
270640,202106,865,649,216,713900,237600,951500
270642,202106,204,172,32,189200,35200,224400
270644,202106,252,165,87,181500,95700,277200
270650,202106,323,195,128,214500,141900,356400
270660,202106,202,175,27,192500,29700,222200
270670,202106,3021,2277,744,2506901.01,819500,3326401.01
270680,202106,427,260,167,286000,183700,469700
270690,202106,1197,792,405,871676.66,445500,1317176.66
270700,202106,25,20,5,22000,5500,27500
270710,202106,870,685,185,753500,203500,957000
270720,202106,231,181,50,199100,55000,254100
270730,202106,1883,1162,721,1279116.66,794200,2073316.66
270740,202106,40,27,13,29700,14300,44000
270750,202106,643,486,157,534600,172700,707300
270760,202106,296,213,83,234300,91300,325600
270770,202106,2771,1859,912,2049923.33,1004300,3054223.33
270780,202106,68,44,24,48400,26400,74800
270790,202106,254,164,90,180400,99000,279400
270800,202106,2075,1636,439,1801800,486200,2288000
270810,202106,217,178,39,195800,42900,238700
270820,202106,132,94,38,103400,41800,145200
270830,202106,796,601,195,662200,214500,876700
270840,202106,1362,1040,322,1146200.4,355300,1501500.4
270850,202106,1514,966,548,1064800,602800,1667600
270860,202106,2543,1707,836,1880267.36,921800,2802067.36
270870,202106,115,64,51,70400,56100,126500
270880,202106,880,696,184,768900.6,202400,971300.6
270890,202106,284,216,68,238700,74800,313500
270895,202106,51,48,3,52800,3300,56100
270900,202106,74,60,14,66000,15400,81400
270910,202106,301,249,52,273900,57200,331100
270915,202106,1908,1243,665,1369500,731500,2101000
270920,202106,451,376,75,414700,82500,497200
270930,202106,5908,4471,1437,4919200,1581800.14,6501000.14
270940,202106,2231,1759,472,1938200,519200,2457400
280010,202106,39,32,7,35200,7700,42900
280020,202106,484,416,68,457600,74800,532400
280030,202106,20723,13403,7320,14757601.68,8060801.49,22818403.17
280040,202106,327,211,116,232100,127600,359700
280050,202106,403,310,93,341000,102300,443300
280060,202106,340,224,116,247500,127600,375100
280067,202106,1087,789,298,867900,327800.5,1195700.5
280070,202106,124,101,23,112200,25300,137500
280100,202106,644,498,146,548900,160600,709500
280110,202106,70,64,6,70400,6600,77000
280120,202106,666,553,113,608300,124300,732600
280130,202106,1741,1147,594,1261700.96,655600,1917300.96
280140,202106,493,405,88,445500,96800,542300
280150,202106,408,285,123,313500,135300,448800
280160,202106,126,101,25,111100,27500,138600
280170,202106,404,281,123,309100,135300,444400
280190,202106,29,24,5,26400,5500,31900
280200,202106,32,27,5,29700,5500,35200
280210,202106,2930,2115,815,2328569.6,897600,3226169.6
280220,202106,40,34,6,37400,6600,44000
280230,202106,324,266,58,293700,63800,357500
280240,202106,126,120,6,132000,6600,138600
280250,202106,18,10,8,11000,8800,19800
280260,202106,79,71,8,78100,8800,86900
280270,202106,146,112,34,123200,37400,160600
280280,202106,193,126,67,139700.5,73700,213400.5
280290,202106,3437,2488,949,2740029.5,1045000,3785029.5
280300,202106,1613,1266,347,1392600,381700,1774300
280310,202106,97,92,5,101200,5500,106700
280320,202106,654,458,196,503800,215600,719400
280330,202106,318,233,85,256300,93500,349800
280340,202106,418,336,82,369600,90200,459800
280350,202106,3716,2879,837,3169100.66,920700.08,4089800.74
280360,202106,469,321,148,353100,162800,515900
280370,202106,97,85,12,93500,13200,106700
280380,202106,48,36,12,39600,13200,52800
280390,202106,171,145,26,159500,28600,188100
280400,202106,356,241,115,266200,127600,393800
280410,202106,287,237,50,260700,55000,315700
280420,202106,143,125,18,137500,19800,157300
280430,202106,69,56,13,61600,14300,75900
280440,202106,736,591,145,650100,159500,809600
280445,202106,123,113,10,125400,11000,136400
280450,202106,1234,1059,175,1166000,192500,1358500
280460,202106,634,462,172,508200.93,189200,697400.93
280470,202106,110,100,10,110000,11000,121000
280480,202106,2754,1905,849,2097701.67,933900.5,3031602.17
280490,202106,204,193,11,212300.96,12100,224400.96
280500,202106,43,39,4,42900,4400,47300
280510,202106,138,111,27,122100,29700,151800
280520,202106,52,37,15,40700,16500,57200
280530,202106,80,52,28,57200,30800,88000
280540,202106,534,453,81,499400,89100,588500
280550,202106,734,675,59,744700.65,66000,810700.65
280560,202106,483,429,54,471900.85,59400,531300.85
280570,202106,2319,1838,481,2026200,529100,2555300
280580,202106,589,458,131,503800,144100,647900
280590,202106,207,134,73,147400,80300,227700
280600,202106,380,317,63,348751.7,69300,418051.7
280610,202106,111,82,29,90200,31900,122100
280620,202106,534,438,96,482900,106700,589600
280630,202106,157,130,27,143000,29700,172700
280640,202106,191,151,40,166100,44000,210100
280650,202106,94,60,34,66000,37400,103400
280660,202106,141,101,40,112200,44000,156200
280670,202106,1904,1194,710,1315600,781000.48,2096600.48
280680,202106,211,183,28,201300,30800,232100
280690,202106,82,72,10,79200,11000,90200
280700,202106,19,19,0,20900,0,20900
280710,202106,1472,1142,330,1257300.54,365200,1622500.54
280720,202106,114,75,39,82500,42900,125400
280730,202106,27,22,5,24200,5500,29700
280740,202106,2520,1883,637,2072400,701800,2774200
280750,202106,228,199,29,218900,31900,250800
280760,202106,812,557,255,612700,280500,893200
290010,202106,193,136,57,150700,62700,213400
290020,202106,193,174,19,191400,20900,212300
290030,202106,612,394,218,433400,240900,674300
290035,202106,134,109,25,119900,27500,147400
290040,202106,310,210,100,231000,110000,341000
290050,202106,85,67,18,73700,19800,93500
290060,202106,258,114,144,125400,158400,283800
290070,202106,5719,2735,2984,3012900.69,3284600,6297500.69
290080,202106,443,199,244,218900,268400,487300
290090,202106,369,166,203,183700,223300,407000
290100,202106,1667,1090,577,1200100,636900,1837000
290110,202106,830,486,344,534600.85,378400,913000.85
290115,202106,193,180,13,198000,14300,212300
290120,202106,781,524,257,576400,282700,859100
290130,202106,437,271,166,298100,182600,480700
290135,202106,301,231,70,254100,77000,331100
290140,202106,319,264,55,290400,60500,350900
290150,202106,138,95,43,104500,47300,151800
290160,202106,247,189,58,207900,63800,271700
290170,202106,93,66,27,72600,29700,102300
290180,202106,183,132,51,145200,56100,201300
290190,202106,378,302,76,332200,83600,415800
290195,202106,309,198,111,217800,122100,339900
290200,202106,267,218,49,240900,53900,294800
290205,202106,149,93,56,102300,61600,163900
290210,202106,1179,868,311,955900,342100,1298000
290220,202106,185,104,81,114400,89100,203500
290225,202106,283,114,169,126500,185900,312400
290230,202106,81,49,32,53900,35200,89100
290240,202106,362,126,236,138600,260700,399300
290250,202106,257,237,20,260700,22000,282700
290260,202106,321,265,56,291500,61600,353100
290265,202106,186,161,25,177100,27500,204600
290270,202106,1419,1187,232,1306800,255200,1562000
290280,202106,476,336,140,369600,155100,524700
290290,202106,1350,815,535,896501.38,588500,1485001.38
290300,202106,422,363,59,399300,66000,465300
290310,202106,290,137,153,150700,168300,319000
290320,202106,4084,2523,1561,2777500.11,1719300,4496800.11
290323,202106,191,166,25,182600,27500,210100
290327,202106,158,125,33,138600,36300,174900
290330,202106,111,56,55,61600,60500,122100
290340,202106,797,329,468,361900,514800,876700
290350,202106,654,399,255,438900,280500,719400
290360,202106,323,251,72,277200.99,79200,356400.99
290370,202106,913,394,519,433400,572000,1005400
290380,202106,331,212,119,233200,130900,364100
290390,202106,2408,1508,900,1659900,992200,2652100
290395,202106,241,138,103,151800,114400,266200
290400,202106,278,203,75,223300,82500,305800
290405,202106,247,214,33,235400,36300,271700
290410,202106,625,521,104,573100,114400,687500
290420,202106,257,208,49,228800,53900,282700
290430,202106,456,294,162,323400,178200,501600
290440,202106,80,70,10,77000,11000,88000
290450,202106,191,143,48,158400,52800,211200
290460,202106,1937,1159,778,1274900,855800,2130700
290470,202106,1374,603,771,663300,848100,1511400
290475,202106,561,526,35,578600.27,38500,617100.27
290480,202106,281,163,118,179300,130900,310200
290485,202106,238,217,21,238700,23100,261800
290490,202106,1243,888,355,977900,390500,1368400
290500,202106,733,377,356,418000,391600,809600
290510,202106,209,169,40,185900,44000,229900
290515,202106,157,95,62,104500,68200,172700
290520,202106,1401,914,487,1005400,536800.2,1542200.2
290530,202106,299,274,25,301400,27500,328900
290540,202106,109,56,53,61600,58300,119900
290550,202106,170,143,27,157300,29700,187000
290560,202106,3164,1380,1784,1519100,1965700,3484800
290570,202106,6223,3008,3215,3313200,3539800,6853000
290580,202106,1273,757,516,833800,568700,1402500
290590,202106,575,470,105,517000,115500,632500
290600,202106,1757,1210,547,1333200.67,601700,1934900.67
290610,202106,191,176,15,193600,16500,210100
290620,202106,361,327,34,359700,37400,397100
290630,202106,1977,844,1133,928400,1246300,2174700
290640,202106,142,114,28,125400,30800,156200
290650,202106,1794,841,953,927300.92,1051600,1978900.92
290660,202106,279,225,54,248600,59400,308000
290670,202106,942,480,462,528000,509300,1037300
290680,202106,1225,981,244,1080200,269500,1349700
290682,202106,313,235,78,258500.48,85800,344300.48
290685,202106,245,159,86,174900,94600,269500
290687,202106,1088,710,378,782279,416900,1199179
290689,202106,144,76,68,83600,74800,158400
290690,202106,599,255,344,280500,379500,660000
290700,202106,238,119,119,130900,130900,261800
290710,202106,760,519,241,570900,265100,836000
290720,202106,1039,843,196,928400,215600,1144000
290730,202106,1184,683,501,752400,551100,1303500
290740,202106,20,17,3,18700,3300,22000
290750,202106,1390,617,773,678700,850300,1529000
290755,202106,72,65,7,71500,7700,79200
290760,202106,266,231,35,254100,38500,292600
290770,202106,181,171,10,188100,12100,200200
290780,202106,1107,856,251,942700,276100,1218800
290790,202106,376,256,120,282700,132000,414700
290800,202106,2437,989,1448,1087900,1595000,2682900
290810,202106,470,326,144,358600,158400,517000
290820,202106,402,238,164,261800,180400,442200
290830,202106,422,300,122,330000,134200,464200
290840,202106,1783,1115,668,1227600,735900,1963500
290850,202106,871,449,422,496100,464200,960300
290860,202106,644,288,356,316800,391600,708400
290870,202106,620,443,177,487300,195800,683100
290880,202106,120,64,56,70400,61600,132000
290890,202106,425,273,152,300300,167200,467500
290900,202106,170,128,42,140800,46200,187000
290910,202106,383,293,90,322300,100100,422400
290920,202106,207,181,26,199100,28600,227700
290930,202106,815,622,193,687500,213400,900900
290940,202106,240,202,38,222200,41800,264000
290950,202106,161,95,66,104500,72600,177100
290960,202106,474,333,141,366300,155100,521400
290970,202106,246,218,28,240900,30800,271700
290980,202106,1657,1160,497,1276000,546700,1822700
290990,202106,400,337,63,370700.77,69300,440000.77
291000,202106,862,269,593,295900,652300,948200
291005,202106,2355,1014,1341,1116500,1475100.42,2591600.42
291010,202106,163,147,16,161700,17600,179300
291020,202106,101,80,21,89100,23100,112200
291030,202106,98,69,29,75900,31900,107800
291040,202106,611,349,262,383900,290400,674300
291050,202106,1454,787,667,866800,734800,1601600
291060,202106,1631,906,725,999900,799700,1799600
291070,202106,1980,1483,497,1631300.82,546701.3,2178002.12
291072,202106,7126,2670,4456,2942500,4906000,7848500
291075,202106,243,199,44,218900,48400,267300
291077,202106,58,39,19,42900,20900,63800
291080,202106,20347,8820,11527,9707500.91,12692900.55,22400401.46
291085,202106,274,226,48,248600,52800,301400
291090,202106,280,119,161,130900,177100,308000
291100,202106,637,194,443,213400,487300,700700
291110,202106,418,326,92,358600,101200,459800
291120,202106,2396,1229,1167,1351900,1283700,2635600
291125,202106,62,30,32,33000,35200,68200
291130,202106,196,173,23,190300,25300,215600
291140,202106,123,102,21,113300,24200,137500
291150,202106,389,147,242,161700,266200,427900
291160,202106,380,309,71,341000,78100,419100
291165,202106,48,37,11,40700,12100,52800
291170,202106,3155,1578,1577,1735800.5,1738000,3473800.5
291180,202106,1249,504,745,556600,819500,1376100
291185,202106,101,96,5,105600,5500,111100
291190,202106,1378,642,736,706200,809600,1515800
291200,202106,170,126,44,138600,48400,187000
291210,202106,2327,922,1405,1015300,1545500,2560800
291220,202106,287,217,70,238700,77000,315700
291230,202106,963,328,635,360800,698500,1059300
291240,202106,422,392,30,431200,33000,464200
291250,202106,435,353,82,388300,90200,478500
291260,202106,58,50,8,55000,8800,63800
291270,202106,1036,450,586,496100,644600,1140700
291280,202106,352,167,185,183700,203500,387200
291290,202106,1706,893,813,983400,895400,1878800
291300,202106,226,180,46,198000,50600,248600
291310,202106,228,205,23,225500,25300,250800
291320,202106,1338,943,395,1037300,434500,1471800
291330,202106,131,113,18,124300,19800,144100
291340,202106,214,127,87,140800,95700,236500
291345,202106,130,89,41,97900,45100,143000
291350,202106,1672,604,1068,665500,1174800,1840300
291360,202106,8288,3986,4302,4387900,4739900,9127800
291370,202106,1105,639,466,702900,512600,1215500
291380,202106,259,207,52,227700,57200,284900
291390,202106,3913,1744,2169,1919500,2387000,4306500
291400,202106,2086,1489,597,1641200,656701.27,2297901.27
291410,202106,192,164,28,180400,30800,211200
291420,202106,115,87,28,95700,30800,126500
291430,202106,163,92,71,101200,78100.5,179300.5
291440,202106,526,430,96,473000,105600,578600
291450,202106,934,595,339,654500,372900,1027400
291460,202106,1913,1541,372,1697300,409200,2106500
291465,202106,2206,1050,1156,1155000,1273800.52,2428800.52
291470,202106,2844,1432,1412,1577400.55,1554300,3131700.55
291480,202106,11684,5136,6548,5652901.62,7208300,12861201.62
291490,202106,614,245,369,269500,407000,676500
291500,202106,382,228,154,250800,169400,420200
291510,202106,1205,467,738,514800,811800,1326600
291520,202106,935,420,515,463100,566500,1029600
291530,202106,921,248,673,273900,740300,1014200
291535,202106,122,100,22,110000,24200,134200
291540,202106,358,117,241,128700,265100,393800
291550,202106,1272,598,674,658900,741400,1400300
291560,202106,5150,2586,2564,2845700,2824800,5670500
291570,202106,208,105,103,115500,113300,228800
291580,202106,1188,735,453,808500,498300,1306800
291590,202106,95,40,55,44000,60500,104500
291600,202106,1139,559,580,614900,638000,1252900
291610,202106,1436,698,738,767800,811800,1579600
291620,202106,562,268,294,297000,323400,620400
291630,202106,478,149,329,163900,361900,525800
291640,202106,3936,1982,1954,2181300.32,2152700,4334000.32
291650,202106,434,295,139,324500.5,152900,477400.5
291660,202106,375,153,222,168300,244200,412500
291670,202106,182,115,67,126500,73700,200200
291680,202106,630,384,246,422400,270600,693000
291685,202106,578,326,252,358600,277200,635800
291690,202106,489,306,183,337700,201300.92,539000.92
291700,202106,1002,779,223,858000,245300,1103300
291710,202106,1611,780,831,858000,915200,1773200
291720,202106,415,282,133,310200,146300,456500
291730,202106,940,547,393,601700,432300,1034000
291733,202106,288,196,92,215600,101200,316800
291735,202106,75,58,17,63800,18700,82500
291740,202106,347,262,85,288200,93500,381700
291750,202106,2236,1469,767,1617000.25,843700,2460700.25
291760,202106,2982,1652,1330,1818300,1464100,3282400
291770,202106,762,520,242,573100,266200,839300
291780,202106,67,39,28,42900,30800,73700
291790,202106,153,81,72,89100,79200,168300
291800,202106,10041,4198,5843,4622200.42,6436100,11058300.42
291810,202106,1084,815,269,897600,297000,1194600
291820,202106,277,202,75,222200,82500,304700
291830,202106,1032,415,617,457600.59,678700,1136300.59
291835,202106,554,514,40,565400,44000,609400
291840,202106,4939,2491,2448,2744500,2700500,5445000
291845,202106,263,82,181,90200,199100,289300
291850,202106,318,282,36,310200,39600,349800
291855,202106,253,103,150,113300,165000,278300
291860,202106,170,106,64,116600,71500,188100
291870,202106,81,36,45,39600,49500,89100
291875,202106,163,152,11,167200,12100,179300
291880,202106,433,348,85,383900,93500,477400
291890,202106,246,81,165,89100,181500,270600
291900,202106,59,34,25,37400,27500,64900
291905,202106,121,91,30,100100,33000,133100
291910,202106,157,126,31,138600,34100,172700
291915,202106,433,384,49,422400,53900,476300
291920,202106,5165,2555,2610,2810500,2874300,5684800
291930,202106,166,98,68,107800.27,74800,182600.27
291940,202106,358,207,151,228800,166100,394900
291950,202106,1137,908,229,998800,251900,1250700
291955,202106,1292,789,503,869000,553300,1422300
291960,202106,196,143,53,158400,58300,216700
291970,202106,751,569,182,625900,200200,826100
291980,202106,1476,1297,179,1427800.73,196900,1624700.73
291990,202106,140,129,11,141900,12100,154000
291992,202106,163,86,77,94600,84700,179300
291995,202106,189,121,68,133100,74800,207900
292000,202106,397,301,96,331100,106700,437800
292010,202106,323,223,100,245300,110000,355300
292020,202106,298,217,81,238700,89100,327800
292030,202106,145,110,35,121000,38500,159500
292040,202106,607,314,293,345400,322300,667700
292045,202106,115,104,11,114400,12100,126500
292050,202106,937,681,256,749100,281600,1030700
292060,202106,896,731,165,805200,181500,986700
292070,202106,62,22,40,24200,44000,68200
292080,202106,144,100,44,110000,48400,158400
292090,202106,529,180,349,198000,383900,581900
292100,202106,1475,632,843,695200,927300,1622500
292105,202106,190,169,21,185900,23100,209000
292110,202106,2247,816,1431,899800,1574100,2473900
292120,202106,695,547,148,601700,162800,764500
292130,202106,448,250,198,276100,218900,495000
292140,202106,216,173,43,190300,47300,237600
292145,202106,158,85,73,93500,80300,173800
292150,202106,1490,1226,264,1354100,292600,1646700
292160,202106,160,131,29,144100,31900,176000
292170,202106,1186,1031,155,1134100,170500,1304600
292180,202106,220,163,57,179300,63800,243100
292190,202106,158,104,54,115500,59400,174900
292200,202106,1366,495,871,544500,959200,1503700
292205,202106,124,107,17,117700,18700,136400
292210,202106,375,257,118,283800,129800,413600
292220,202106,32,23,9,25300,9900,35200
292225,202106,41,34,7,37400,7700,45100
292230,202106,966,750,216,826100,237600,1063700
292240,202106,621,450,171,495000,189200,684200
292250,202106,1681,1101,580,1211100,639100,1850200
292260,202106,397,238,159,261800,174900,436700
292265,202106,248,182,66,200200,72600,272800
292270,202106,725,342,383,376200,421300,797500
292273,202106,210,121,89,133100,97900,231000
292275,202106,169,85,84,93500,92400,185900
292280,202106,144,102,42,112200,46200,158400
292285,202106,82,67,15,73700,16500,90200
292290,202106,575,388,187,426800,205700,632500
292300,202106,1732,652,1080,719400,1191300,1910700
292303,202106,122,78,44,85800,48400,134200
292305,202106,121,90,31,99000,34100,133100
292310,202106,934,607,327,667700,359700,1027400
292320,202106,588,445,143,489500,157300,646800
292330,202106,174,103,71,113300,78100,191400
292335,202106,281,222,59,244200,64900,309100
292340,202106,570,397,173,436700,190300,627000
292350,202106,267,148,119,162800,130900,293700
292360,202106,703,537,166,590700,182600,773300
292370,202106,748,573,175,630300,192500,822800
292380,202106,626,512,114,563200,125400,688600
292390,202106,393,157,236,172700,260700,433400
292400,202106,3600,2241,1359,2468400,1494900,3963300
292405,202106,270,179,91,196900,100100,297000
292410,202106,131,81,50,89100,55000,144100
292420,202106,296,258,38,284900,41800,326700
292430,202106,540,405,135,446600,148500,595100
292440,202106,621,524,97,576400.56,107800,684200.56
292450,202106,241,189,52,209000,57200,266200
292460,202106,541,404,137,445500,150700,596200
292465,202106,207,175,32,192500,35200,227700
292467,202106,140,85,55,93500,60500,154000
292470,202106,296,200,96,220000,106700,326700
292480,202106,381,262,119,288200,132000,420200
292490,202106,241,173,68,190300,74800,265100
292500,202106,866,397,469,436700.32,517000,953700.32
292510,202106,3489,1629,1860,1793000,2046000,3839000
292520,202106,1104,517,587,569800,645700,1215500
292525,202106,409,290,119,319000,130900,449900
292530,202106,4502,1803,2699,1985500.65,2971100,4956600.65
292540,202106,480,271,209,298100,229900,528000
292550,202106,1099,576,523,633600,575300,1208900
292560,202106,330,306,24,336600,26400,363000
292570,202106,309,241,68,265100,74800,339900
292575,202106,492,331,161,364100,177100,541200
292580,202106,996,662,334,728200,369600,1097800
292590,202106,566,494,72,543400,79200,622600
292593,202106,142,112,30,123200,34100,157300
292595,202106,201,159,42,174900,46200,221100
292600,202106,1258,919,339,1010900.63,372900,1383800.63
292610,202106,120,95,25,104500,27500,132000
292620,202106,535,454,81,499400,89100,588500
292630,202106,1486,822,664,904200,730400,1634600
292640,202106,847,590,257,650100,282700,932800
292650,202106,189,155,34,170500.5,37400,207900.5
292660,202106,1995,1422,573,1565300,630300.92,2195600.92
292665,202106,143,103,40,113300,44000,157300
292670,202106,402,319,83,350900,91300,442200
292680,202106,258,192,66,211200,72600,283800
292690,202106,196,141,55,156200,60500,216700
292700,202106,977,644,333,708400,367400,1075800
292710,202106,114,99,15,108900,16500,125400
292720,202106,933,531,402,584100,444400,1028500
292730,202106,197,94,103,103400,113300,216700
292740,202106,69785,33989,35796,37440702.98,39426200.88,76866903.86
292750,202106,391,279,112,306900,123200,430100
292760,202106,337,284,53,312400,58300,370700
292770,202106,826,354,472,390500,519200,909700
292780,202106,399,151,248,167200,272800,440000
292790,202106,775,404,371,444400,408100,852500
292800,202106,1264,756,508,833800,561000,1394800
292805,202106,388,123,265,135300,292600,427900
292810,202106,1512,861,651,948200,717200,1665400
292820,202106,715,603,112,663300,123200,786500
292830,202106,114,91,23,100100,25300,125400
292840,202106,690,563,127,620400,139700,760100
292850,202106,138,92,46,101200,50600,151800
292860,202106,2131,1241,890,1365100,980100,2345200
292870,202106,3520,2339,1181,2575100,1299100,3874200
292880,202106,1475,979,496,1079100,546700,1625800
292890,202106,533,448,85,492800,93500,586300
292895,202106,145,97,48,106700,52800,159500
292900,202106,367,262,105,288200,115500,403700
292905,202106,483,241,242,265100,267300,532400
292910,202106,457,344,113,379500,124300,503800
292920,202106,526,230,296,253000,325600,578600
292925,202106,489,447,42,491700,46200,537900
292930,202106,633,381,252,419100,277200,696300
292935,202106,285,120,165,132000,181500,313500
292937,202106,222,154,68,169400,74800,244200
292940,202106,189,144,45,158400,49500,207900
292950,202106,1180,596,584,655600,643500.6,1299100.6
292960,202106,563,393,170,432300,187000,619300
292970,202106,234,164,70,180400.48,77000,257400.48
292975,202106,101,61,40,67100,44000,111100
292980,202106,296,198,98,218900.61,108900,327800.61
292990,202106,1324,983,341,1084600,377300,1461900
293000,202106,111,78,33,85800,36300,122100
293010,202106,2867,1705,1162,1877700,1279300.5,3157000.5
293015,202106,632,516,116,568700,127600,696300
293020,202106,336,275,61,302500,67100,369600
293030,202106,593,520,73,574200,80300,654500
293040,202106,371,296,75,325600,82500,408100
293050,202106,2921,1734,1187,1907400,1306800,3214200
293060,202106,253,201,52,221100.48,57200,278300.48
293070,202106,3525,1780,1745,1958000.18,1922800,3880800.18
293075,202106,91,62,29,68200,31900,100100
293076,202106,77,56,21,61600,23100,84700
293077,202106,555,322,233,354200,256300,610500
293080,202106,432,386,46,424600,50600,475200
293090,202106,131,118,13,129800,14300,144100
293100,202106,528,366,162,402600,178200,580800
293105,202106,344,253,91,278300,100100,378400
293110,202106,119,85,34,93500,37400,130900
293120,202106,300,205,95,225500,105600,331100
293130,202106,253,170,83,187000,91300,278300
293135,202106,8064,3130,4934,3446300,5431800,8878100
293140,202106,191,116,75,127600,82500,210100
293150,202106,313,271,42,299200,46200,345400
293160,202106,426,254,172,279400,189200,468600
293170,202106,195,127,68,139700,74800,214500
293180,202106,541,375,166,414700,182600,597300
293190,202106,1349,930,419,1024100.7,460900,1485000.7
293200,202106,557,488,69,536800,75900,612700
293210,202106,402,307,95,337700,104500,442200
293220,202106,2417,1038,1379,1144000,1519100,2663100
293230,202106,1858,689,1169,759000.1,1288100,2047100.1
293240,202106,238,217,21,238700,23100,261800
293245,202106,129,108,21,118800,23100,141900
293250,202106,744,281,463,309100.22,510400,819500.22
293260,202106,306,252,54,277200,59400,336600
293270,202106,1143,522,621,575300,683100,1258400
293280,202106,291,168,123,184800,136400,321200
293290,202106,3024,1962,1062,2162600,1168200,3330800
293300,202106,763,535,228,589600,250800,840400
293305,202106,201,159,42,174900,47300,222200
293310,202106,164,124,40,136400,45100,181500
293315,202106,169,132,37,145200,40700,185900
293317,202106,88,64,24,70400,26400,96800
293320,202106,1077,596,481,655600.5,529100,1184700.5
293325,202106,193,70,123,77000,135300,212300
293330,202106,13702,6353,7349,6994900.38,8087200,15082100.38
293340,202106,286,198,88,217800,96800,314600
293345,202106,252,204,48,224400,52800,277200
293350,202106,596,355,241,390500,266200,656700
293360,202106,1522,1095,427,1205600,470800,1676400
310010,202106,147,77,70,84700,77000,161700
310020,202106,1025,563,462,620400,513700,1134100
310030,202106,325,259,66,284900,72600,357500
310040,202106,42,28,14,30800,15400,46200
310050,202106,168,106,62,116600,68200,184800
310060,202106,258,179,79,196900,86900,283800
310070,202106,13,8,5,8800,5500,14300
310080,202106,42,26,16,28600,17600,46200
310090,202106,1037,551,486,609400,537900,1147300
310100,202106,309,221,88,243100,96800,339900
310110,202106,706,383,323,422400,355300,777700
310120,202106,384,219,165,240900,181500,422400
310130,202106,31,17,14,18700,15400,34100
310140,202106,24,10,14,11000,15400,26400
310150,202106,1162,779,383,859100,422400,1281500
310160,202106,2034,987,1047,1086800.22,1155000,2241800.22
310163,202106,86,45,41,49500,45100,94600
310170,202106,2516,1116,1400,1227600,1547700,2775300
310180,202106,157,57,100,62700,110000,172700
310190,202106,480,328,152,363000,168300,531300
310200,202106,479,303,176,333300,193600,526900
310205,202106,59,38,21,41800,23100,64900
310210,202106,273,223,50,246400,56100,302500
310220,202106,61,35,26,38500,29700,68200
310230,202106,274,187,87,206800,95700,302500
310240,202106,108,93,15,102300,16500,118800
310250,202106,99,79,20,86900,22000,108900
310260,202106,734,386,348,425700.92,383900,809600.92
310270,202106,263,165,98,182600,107800,290400
310280,202106,372,271,101,299200,111100,410300
310285,202106,208,153,55,168300,60500,228800
310290,202106,234,133,101,146300,111100,257400
310300,202106,171,138,33,151800,36300,188100
310310,202106,10,7,3,7700,3300,11000
310320,202106,27,9,18,9900,19800,29700
310330,202106,39,25,14,27500,15400,42900
310340,202106,1818,1219,599,1342000,660000,2002000
310350,202106,2758,1473,1285,1621400,1416800,3038200
310360,202106,46,38,8,41800,8800,50600
310370,202106,128,105,23,115500,25300,140800
310375,202106,102,36,66,39600,72600,112200
310380,202106,49,29,20,31900,22000,53900
310390,202106,106,68,38,74800,41800,116600
310400,202106,2382,1533,849,1691800,935000,2626800
310410,202106,124,72,52,79200,58300,137500
310420,202106,659,338,321,371800,353100,724900
310430,202106,276,168,108,184800,118800,303600
310440,202106,71,40,31,44000,34100,78100
310445,202106,77,64,13,70400,14300,84700
310450,202106,626,392,234,432300,258500,690800
310460,202106,249,172,77,190300,84700,275000
310470,202106,511,329,182,361900,201300,563200
310480,202106,84,52,32,57200,35200,92400
310490,202106,532,244,288,268400,317900,586300
310500,202106,132,51,81,56100,89100,145200
310510,202106,602,421,181,463100,199100,662200
310520,202106,138,97,41,106700,45100,151800
310530,202106,108,43,65,47300,71500,118800
310540,202106,464,264,200,290400,221100,511500
310550,202106,72,46,26,50600,28600,79200
310560,202106,2950,2013,937,2214300,1031800,3246100
310570,202106,91,56,35,61600,38500,100100
310590,202106,367,231,136,254100,150700,404800
310600,202106,148,80,68,88000,74800,162800
310610,202106,56,21,35,23100,38500,61600
310620,202106,46896,22155,24741,24405617.5,27258000,51663617.5
310630,202106,662,403,259,443300,286000,729300
310640,202106,126,95,31,104500,34100,138600
310650,202106,155,139,16,152900,17600,170500
310660,202106,103,72,31,79200,34100,113300
310665,202106,63,46,17,50600,18700,69300
310670,202106,6765,2890,3875,3185600,4266900,7452500
310680,202106,67,41,26,45100,28600,73700
310690,202106,620,437,183,481800,201300,683100
310700,202106,63,40,23,44000,25300,69300
310710,202106,1317,893,424,984500,467500,1452000
310720,202106,142,38,104,41800,114400,156200
310730,202106,1489,1018,471,1122000.74,519200,1641200.74
310740,202106,985,547,438,603900,481800,1085700
310750,202106,243,150,93,166100,102300,268400
310760,202106,69,52,17,57200,18700,75900
310770,202106,94,47,47,51700,51700,103400
310780,202106,351,281,70,309100,77000,386100
310790,202106,105,85,20,93500,22000,115500
310800,202106,455,210,245,232100,269500,501600
310810,202106,175,121,54,133100.72,59400,192500.72
310820,202106,332,264,68,290400,74800,365200
310825,202106,201,171,30,188100,33000,221100
310830,202106,470,221,249,243100,275000,518100
310840,202106,360,211,149,232100,163900,396000
310850,202106,83,69,14,75900,15400,91300
310855,202106,401,312,89,343200,97900,441100
310860,202106,1597,1176,421,1295800,464200,1760000
310870,202106,52,43,9,47300,9900,57200
310880,202106,84,66,18,72600,19800,92400
310890,202106,306,175,131,192500,144100,336600
310900,202106,637,278,359,306907.2,397111.52,704018.72
310910,202106,233,158,75,173800,82500,256300
310920,202106,452,263,189,289300,207900,497200
310925,202106,34,28,6,30800,6600,37400
310930,202106,1288,831,457,915200,503800,1419000
310940,202106,691,343,348,377300,382800,760100
310945,202106,119,76,43,83600,47300,130900
310950,202106,230,185,45,203500,49500,253000
310960,202106,74,23,51,25300,56100,81400
310970,202106,168,104,64,114400,70400,184800
310980,202106,46,30,16,33000,17600,50600
310990,202106,167,85,82,93500,90200,183700
311000,202106,816,398,418,438900.1,459800,898700.1
311010,202106,48,42,6,46200,6600,52800
311020,202106,42,22,20,24200,22000,46200
311030,202106,389,219,170,243100,187000,430100
311040,202106,40,31,9,34100,9900,44000
311050,202106,475,178,297,195800,326700,522500
311060,202106,772,424,348,466400,383900,850300
311070,202106,331,146,185,160600,204600,365200
311080,202106,109,61,48,67100,52800,119900
311090,202106,337,159,178,174900,196900,371800
311100,202106,571,333,238,366300,264000,630300
311110,202106,696,492,204,541200,224400,765600
311115,202106,75,53,22,58300,24200,82500
311120,202106,1060,560,500,619300,550000,1169300
311130,202106,311,184,127,202400,139700,342100
311140,202106,159,83,76,91300,83600,174900
311150,202106,344,218,126,240900,138600,379500
311160,202106,719,511,208,563200,229900,793100
311170,202106,88,71,17,78100,18700,96800
311180,202106,294,196,98,215600,107800,323400
311190,202106,43,18,25,19800,27500,47300
311200,202106,347,243,104,267300,114400,381700
311205,202106,34,25,9,27500,9900,37400
311210,202106,40,35,5,38500,5500,44000
311220,202106,28,24,4,26400,4400,30800
311230,202106,1622,1067,555,1174800,611600,1786400
311240,202106,195,123,72,135300,79200,214500
311250,202106,53,21,32,23100,36300,59400
311260,202106,553,354,199,389400,218900,608300
311265,202106,126,87,39,95700,44000,139700
311270,202106,292,202,90,222200,99000,321200
311280,202106,197,88,109,96800,119900,216700
311290,202106,103,85,18,93500,19800,113300
311300,202106,577,367,210,403700,231000,634700
311310,202106,19,15,4,16500,4400,20900
311320,202106,638,474,164,521400,180400,701800
311330,202106,1061,777,284,854700,312400,1167100
311340,202106,2612,1851,761,2037200,839300,2876500
311350,202106,270,210,60,231000,66000,297000
311360,202106,184,107,77,118800,84700,203500
311370,202106,1227,504,723,554400,796400,1350800
311380,202106,5,4,1,4400,1100,5500
311390,202106,254,141,113,155100,124300,279400
311400,202106,137,83,54,91300,59400,150700
311410,202106,108,55,53,61600,58300,119900
311420,202106,302,163,139,180400,152900,333300
311430,202106,827,552,275,608300,304700,913000
311440,202106,457,319,138,352000,151800,503800
311450,202106,295,178,117,196900,129800,326700
311455,202106,277,188,89,206800,97900,304700
311460,202106,136,58,78,63800,85800,149600
311470,202106,28,14,14,15400,15400,30800
311480,202106,48,23,25,25300,27500,52800
311490,202106,13,9,4,9900,4400,14300
311500,202106,26,13,13,14300,14300,28600
311510,202106,654,445,209,489500,229900,719400
311520,202106,40,31,9,34100,9900,44000
311530,202106,1800,1305,495,1436600,544500,1981100
311535,202106,63,43,20,47300,22000,69300
311540,202106,34,29,5,31900,5500,37400
311545,202106,163,119,44,130900,48400,179300
311547,202106,42,33,9,36300,11000,47300
311550,202106,664,295,369,324500,407000,731500
311560,202106,43,27,16,29700,17600,47300
311570,202106,281,188,93,207900,102300,310200
311580,202106,374,222,152,244200,167200,411400
311590,202106,30,26,4,28600,4400,33000
311600,202106,98,78,20,85800,23100,108900
311610,202106,245,209,36,229900,39600,269500
311615,202106,114,91,23,100100,25300,125400
311620,202106,25,15,10,16500,11000,27500
311630,202106,87,75,12,82500,13200,95700
311640,202106,141,69,72,75900,79200,155100
311650,202106,125,86,39,94600,42900,137500
311660,202106,402,194,208,213400,229900,443300
311670,202106,143,96,47,105600,51700,157300
311680,202106,211,159,52,174900,57200,232100
311690,202106,15,12,3,13200,3300,16500
311700,202106,189,135,54,148500,59400,207900
311710,202106,185,125,60,137500,66000,203500
311720,202106,39,30,9,33000,9900,42900
311730,202106,570,386,184,425700,203500,629200
311740,202106,25,17,8,18700,8800,27500
311750,202106,722,488,234,536800.7,257400,794200.7
311760,202106,70,30,40,33000,44000,77000
311770,202106,383,189,194,207900,213400,421300
311780,202106,185,94,91,104500,100100,204600
311783,202106,89,81,8,89100,8800,97900
311787,202106,34,12,22,13200,24200,37400
311790,202106,267,114,153,125400,168300,293700
311800,202106,677,435,242,478500,267300,745800
311810,202106,51,41,10,45100,11000,56100
311820,202106,120,99,21,108900,23100,132000
311830,202106,1864,1139,725,1254000,798600,2052600
311840,202106,1000,556,444,611600,488400,1100000
311850,202106,14,10,4,11000,4400,15400
311860,202106,9513,4061,5452,4473700.24,6000500,10474200.24
311870,202106,114,62,52,69300,57200,126500
311880,202106,934,674,260,741400,286000,1027400
311890,202106,201,97,104,106609,114400,221009
311900,202106,70,28,42,30800,46200,77000
311910,202106,1358,849,509,936100,559900,1496000
311920,202106,229,153,76,168300,84700,253000
311930,202106,897,509,388,559900,426800,986700
311940,202106,2551,1341,1210,1476200,1331000,2807200
311950,202106,62,41,21,45100,23100,68200
311960,202106,62,45,17,49500,18700,68200
311970,202106,24,14,10,15400,11000,26400
311980,202106,44,34,10,37400,11000,48400
311990,202106,36,27,9,29700,9900,39600
311995,202106,50,30,20,33000,22000,55000
312000,202106,22,16,6,17600,6600,24200
312010,202106,76,59,17,64900,18700,83600
312015,202106,71,53,18,58300,19800,78100
312020,202106,128,86,42,95700,46200,141900
312030,202106,63,47,16,51700,17600,69300
312040,202106,80,52,28,57200,30800,88000
312050,202106,203,115,88,126500,96800,223300
312060,202106,22,13,9,14300,9900,24200
312070,202106,80,52,28,57200,30800,88000
312080,202106,531,243,288,269500,316800,586300
312083,202106,59,37,22,41800,24200,66000
312087,202106,95,73,22,81400,24200,105600
312090,202106,3239,1956,1283,2153800,1413500,3567300
312100,202106,146,101,45,110847,49500,160347
312110,202106,115,66,49,72600,53900,126500
312120,202106,131,96,35,106700.63,38500,145200.63
312125,202106,87,50,37,55000,40700,95700
312130,202106,135,88,47,96800,51700,148500
312140,202106,137,105,32,115500,35200,150700
312150,202106,41,32,9,35200,9900,45100
312160,202106,1524,996,528,1095699,580800,1676499
312170,202106,10,8,2,8800,2200,11000
312180,202106,111,71,40,78100,44000,122100
312190,202106,38,34,4,37400,4400,41800
312200,202106,753,645,108,709500,118800,828300
312210,202106,120,65,55,71500,60500,132000
312220,202106,130,100,30,111100,33000,144100
312230,202106,3675,1689,1986,1859000,2186800,4045800
312235,202106,153,103,50,113300,55000,168300
312240,202106,89,62,27,68200,29700,97900
312245,202106,191,129,62,144100,69300,213400
312247,202106,76,53,23,58300,25300,83600
312250,202106,167,83,84,91300,92400,183700
312260,202106,107,73,34,81400,37400,118800
312270,202106,130,76,54,83600,59400,143000
312280,202106,30,15,15,16500,16500,33000
312290,202106,140,95,45,104500,50600,155100
312300,202106,202,133,69,146300,75900,222200
312310,202106,63,56,7,61600,7700,69300
312320,202106,424,264,160,290400,177100,467500
312330,202106,87,76,11,83600,12100,95700
312340,202106,34,15,19,16500,20900,37400
312350,202106,14,8,6,8800,6600,15400
312352,202106,94,69,25,75900,27500,103400
312360,202106,563,236,327,259600,359700,619300
312370,202106,317,179,138,196900,152900,349800
312380,202106,137,92,45,101200,49500,150700
312385,202106,156,127,29,140800,31900,172700
312390,202106,297,190,107,210100,117700,327800
312400,202106,384,283,101,311300,111100,422400
312410,202106,1062,337,725,371800,797500,1169300
312420,202106,624,473,151,520300,166100,686400
312430,202106,876,634,242,697401.13,266200,963601.13
312440,202106,38,29,9,31900,9900,41800
312450,202106,200,129,71,141900,78100,220000
312460,202106,30,15,15,16500,16500,33000
312470,202106,43,28,15,30800,16500,47300
312480,202106,175,106,69,116600,75900,192500
312490,202106,278,190,88,209000,96800,305800
312500,202106,35,20,15,22000,16500,38500
312510,202106,519,196,323,215600,355300,570900
312520,202106,29,9,20,9900,22000,31900
312530,202106,45,31,14,34100,15400,49500
312540,202106,89,78,11,86900,12100,99000
312550,202106,39,31,8,34100,8800,42900
312560,202106,202,153,49,168300,53900,222200
312570,202106,435,257,178,282700,195800,478500
312580,202106,95,50,45,55000,49500,104500
312590,202106,241,193,48,212300,52800,265100
312595,202106,130,113,17,124300,18700,143000
312600,202106,69,35,34,38500,37400,75900
312610,202106,1579,812,767,894300,843700,1738000
312620,202106,221,159,62,174900,68200,243100
312630,202106,71,58,13,63800,15400,79200
312640,202106,40,10,30,11000,33000,44000
312650,202106,146,121,25,134570.7,27500,162070.7
312660,202106,93,65,28,71500,30800,102300
312670,202106,928,598,330,658900,363000,1021900
312675,202106,28,23,5,25300,5500,30800
312680,202106,70,40,30,44000,33000,77000
312690,202106,237,119,118,130900,130900,261800
312695,202106,29,25,4,27500,4400,31900
312700,202106,225,129,96,143000,105600,248600
312705,202106,82,66,16,72600,17600,90200
312707,202106,133,94,39,103400,42900,146300
312710,202106,1848,999,849,1102200.59,933900,2036100.59
312720,202106,50,29,21,31900,23100,55000
312730,202106,275,159,116,176000,127600,303600
312733,202106,49,37,12,40700,13200,53900
312735,202106,20,13,7,14300,7700,22000
312737,202106,65,34,31,37400,34100,71500
312738,202106,58,37,21,40700,23100,63800
312740,202106,80,54,26,59400,28600,88000
312750,202106,90,62,28,68200,30800,99000
312760,202106,289,205,84,226600,92400,319000
312770,202106,8196,3754,4442,4132700,4895000,9027700
312780,202106,441,337,104,370700,114400,485100
312790,202106,24,17,7,18700,7700,26400
312800,202106,1613,1130,483,1245200,531300,1776500
312810,202106,364,239,125,262900,137500,400400
312820,202106,186,143,43,157300,47300,204600
312825,202106,30,20,10,22000,11000,33000
312830,202106,216,129,87,141900,95700,237600
312840,202106,163,109,54,119900,59400,179300
312850,202106,42,37,5,40700,5500,46200
312860,202106,148,93,55,102300,60500,162800
312870,202106,1061,547,514,601700,565400,1167100
312880,202106,123,85,38,93500,41800,135300
312890,202106,159,114,45,125400,49500,174900
312900,202106,186,138,48,151800,52800,204600
312910,202106,177,95,82,104500,90200,194700
312920,202106,133,75,58,83600,63800,147400
312930,202106,322,226,96,248600,105600,354200
312940,202106,124,85,39,94600,42900,137500
312950,202106,690,473,217,522500,238700,761200
312960,202106,154,117,37,128700,41800,170500
312965,202106,92,73,19,80300,20900,101200
312970,202106,281,233,48,256300,52800,309100
312980,202106,2451,1235,1216,1362900,1340900,2703800
312990,202106,49,24,25,26400,27500,53900
313000,202106,54,28,26,30800,28600,59400
313005,202106,178,134,44,147400,48400,195800
313010,202106,916,367,549,403700,606100,1009800
313020,202106,199,104,95,114400,104500,218900
313030,202106,198,127,71,140800,78100,218900
313040,202106,79,25,54,27500,59400,86900
313050,202106,187,135,52,149600,57200,206800
313055,202106,41,31,10,34100,11000,45100
313060,202106,132,88,44,96800,48400,145200
313065,202106,63,46,17,50600,18700,69300
313070,202106,133,69,64,77000,70400,147400
313080,202106,36,17,19,18700,20900,39600
313090,202106,659,426,233,468600,257400,726000
313100,202106,189,65,124,71500,136400,207900
313110,202106,146,75,71,82500,78100,160600
313115,202106,215,120,95,132000,104500,236500
313120,202106,839,469,370,515900,407000.39,922900.39
313130,202106,5883,3208,2675,3532100,2948000,6480100
313140,202106,133,73,60,80300,66000,146300
313150,202106,293,232,61,255200,67100,322300
313160,202106,183,137,46,150700,50600,201300
313170,202106,1392,927,465,1019700,513700,1533400
313180,202106,299,178,121,195800,133100,328900
313190,202106,726,435,291,479600,320100,799700
313200,202106,29,24,5,26400,5500,31900
313210,202106,998,849,149,936100,163900,1100000
313220,202106,288,174,114,191400,125400,316800
313230,202106,254,196,58,215600.5,63800,279400.5
313240,202106,2144,1086,1058,1196800,1164900,2361700
313250,202106,1254,954,300,1049400,330000,1379400
313260,202106,91,46,45,50600,49500,100100
313270,202106,990,574,416,631400,457600,1089000
313280,202106,49,41,8,45100,8800,53900
313290,202106,214,172,42,189200,46200,235400
313300,202106,335,174,161,191400,177100,368500
313310,202106,252,115,137,126500,150700,277200
313320,202106,382,281,101,309100,111100,420200
313330,202106,1402,852,550,938300,605000,1543300
313340,202106,323,229,94,253000,103400,356400
313350,202106,479,314,165,346500,181500,528000
313360,202106,153,72,81,79200,89100,168300
313370,202106,218,70,148,77000,162800,239800
313375,202106,297,174,123,191400,135300,326700
313380,202106,1346,698,648,768900,715000,1483900
313390,202106,46,44,2,48400,2200,50600
313400,202106,390,265,125,291500,137500,429000
313410,202106,28,14,14,15400,15400,30800
313420,202106,4530,2433,2097,2681800,2310000,4991800
313430,202106,137,67,70,73700,77000,150700
313440,202106,1387,965,422,1061501.13,466400,1527901.13
313450,202106,66,29,37,33000,40700,73700
313460,202106,381,164,217,180400,238700,419100
313470,202106,531,253,278,278300,305800,584100
313480,202106,145,105,40,115500,44000,159500
313490,202106,519,239,280,262900,308000,570900
313500,202106,29,16,13,17600,14300,31900
313505,202106,1040,814,226,896500,248600,1145100
313507,202106,96,57,39,62700,44000,106700
313510,202106,2848,1795,1053,1975697.1,1160500,3136197.1
313520,202106,3441,2689,752,2959001.5,828300,3787301.5
313530,202106,33,22,11,24200,12100,36300
313535,202106,65,52,13,57200,14300,71500
313540,202106,72,53,19,58300,20900,79200
313545,202106,116,99,17,108900,19800,128700
313550,202106,222,186,36,204600,39600,244200
313560,202106,338,164,174,180400,191400,371800
313570,202106,66,21,45,23100,49500,72600
313580,202106,1316,736,580,809600,638000,1447600
313590,202106,69,41,28,45100,31900,77000
313600,202106,673,402,271,443300,298100,741400
313610,202106,54,44,10,48400,11000,59400
313620,202106,1371,676,695,744700,766700,1511400
313630,202106,1591,1201,390,1325500.65,431200,1756700.65
313640,202106,121,72,49,79200,53900,133100
313650,202106,228,107,121,117700,134200,251900
313652,202106,22,22,0,24200,0,24200
313655,202106,68,42,26,46200,28600,74800
313657,202106,45,41,4,45100,4400,49500
313660,202106,128,84,44,92400,49519.8,141919.8
313665,202106,648,292,356,322300,392700,715000
313670,202106,10328,7044,3284,7766000,3619000,11385000
313680,202106,41,31,10,34100,11000,45100
313690,202106,134,100,34,110000,37400,147400
313695,202106,71,54,17,59400,18700,78100
313700,202106,313,246,67,270600,73700,344300
313710,202106,135,98,37,107800,40700,148500
313720,202106,1120,520,600,573100,661100,1234200
313730,202106,71,42,29,46200,31900,78100
313740,202106,146,118,28,129800,30800,160600
313750,202106,421,300,121,330000,133100,463100
313753,202106,224,165,59,181500,64900,246400
313760,202106,1312,471,841,519200,927300,1446500
313770,202106,384,272,112,299200,123200,422400
313780,202106,794,410,384,451000,422400,873400
313790,202106,28,27,1,29700,1100,30800
313800,202106,145,89,56,97900,61600,159500
313810,202106,80,48,32,52800,35200,88000
313820,202106,1322,620,702,682000,774400,1456400
313830,202106,55,41,14,45100,15400,60500
313835,202106,57,48,9,52800,9900,62700
313840,202106,1639,970,669,1069200,737000,1806200
313850,202106,211,81,130,89100,143000,232100
313860,202106,462,352,110,388300,121000,509300
313862,202106,165,108,57,118800,62700,181500
313865,202106,133,96,37,105600,40700,146300
313867,202106,53,43,10,47300,11000,58300
313868,202106,38,23,15,25300,16500,41800
313870,202106,105,58,47,63800,51700,115500
313880,202106,379,232,147,255200,161700,416900
313890,202106,329,172,157,189200,172700,361900
313900,202106,851,460,391,508200.66,431200,939400.66
313910,202106,146,99,47,108900,51700,160600
313920,202106,628,438,190,484000,209000.94,693000.94
313925,202106,34,29,5,31900,5500,37400
313930,202106,869,677,192,744700,211200,955900
313940,202106,1861,1131,730,1244100,803000,2047100
313950,202106,864,538,326,591800,359700,951500
313960,202106,1412,812,600,894300,662200,1556500
313970,202106,175,112,63,124300,69300,193600
313980,202106,198,129,69,141900,75900,217800
313990,202106,238,154,84,169400,92400,261800
314000,202106,871,568,303,624836.66,334400,959236.66
314010,202106,78,46,32,50600,35200,85800
314015,202106,69,18,51,19800,56100,75900
314020,202106,54,32,22,35200,24200,59400
314030,202106,71,33,38,36300,41800,78100
314040,202106,51,28,23,30800,25300,56100
314050,202106,288,171,117,188100,129800,317900
314053,202106,104,65,39,71500,42900,114400
314055,202106,291,182,109,200200,119900,320100
314060,202106,131,114,17,125400.83,18700,144100.83
314070,202106,1039,516,523,567600,576400,1144000
314080,202106,205,129,76,141900,83600,225500
314085,202106,153,103,50,113300,55000,168300
314090,202106,374,265,109,292600,119900,412500
314100,202106,514,412,102,453200,112200,565400
314110,202106,772,366,406,402600,447700,850300
314120,202106,73,42,31,46200,34100,80300
314130,202106,23,14,9,15400,9900,25300
314140,202106,1091,672,419,739200,462000,1201200
314150,202106,191,122,69,134200,75900,210100
314160,202106,324,242,82,266200,90200,356400
314170,202106,85,65,20,71500,22000,93500
314180,202106,734,644,90,709500,99000,808500
314190,202106,90,55,35,60500,38500,99000
314200,202106,506,346,160,380600,176000,556600
314210,202106,247,187,60,205700,66000,271700
314220,202106,292,209,83,229900,91300,321200
314225,202106,59,42,17,46200,18700,64900
314230,202106,112,48,64,52800,70400,123200
314240,202106,155,112,43,123200,47300,170500
314250,202106,59,35,24,38500,26400,64900
314260,202106,217,107,110,117700,122100,239800
314270,202106,394,306,88,337700,96800,434500
314280,202106,732,392,340,431150.5,374000,805150.5
314290,202106,540,428,112,470800,123200,594000
314300,202106,345,256,89,282700,97900,380600
314310,202106,1350,929,421,1022175.23,463100,1485275.23
314315,202106,38,29,9,31900,9900,41800
314320,202106,579,386,193,424600,212300,636900
314330,202106,11297,5524,5773,6081900,6358000,12439900
314340,202106,593,264,329,290400,363000,653400
314345,202106,52,36,16,39600,17600,57200
314350,202106,175,108,67,118800,73700,192500
314360,202106,61,36,25,39600,27500,67100
314370,202106,71,48,23,52800,25300,78100
314380,202106,100,62,38,68200,41800,110000
314390,202106,3300,2109,1191,2325400,1310100,3635500
314400,202106,683,484,199,533500,218900,752400
314410,202106,488,317,171,348700,188100,536800
314420,202106,15,7,8,7700,8800,16500
314430,202106,2439,897,1542,987801.51,1697300,2685101.51
314435,202106,180,106,74,116600,81400,198000
314437,202106,30,21,9,23100,9900,33000
314440,202106,93,64,29,71500,31900,103400
314450,202106,163,112,51,123200,56100,179300
314460,202106,634,305,329,335500,361900,697400
314465,202106,99,61,38,67100,41800,108900
314467,202106,72,57,15,62700,16500,79200
314470,202106,403,203,200,223300,220000,443300
314480,202106,1012,460,552,506000,607200,1113200
314490,202106,45,28,17,30800,18700,49500
314500,202106,280,195,85,215600,93500,309100
314505,202106,105,65,40,72600,44000,116600
314510,202106,247,202,45,222200,50600,272800
314520,202106,1304,698,606,768900,666600,1435500
314530,202106,727,577,150,635800.7,165000,800800.7
314535,202106,166,103,63,113300,69300,182600
314537,202106,60,35,25,38500,28600,67100
314540,202106,17,11,6,12100,6600,18700
314545,202106,55,37,18,40700,19800,60500
314550,202106,75,39,36,42900,39600,82500
314560,202106,849,458,391,503800,431200,935000
314570,202106,20,15,5,16500,5500,22000
314580,202106,13,5,8,5500,8800,14300
314585,202106,24,16,8,17600,8800,26400
314587,202106,81,69,12,75900,13200,89100
314590,202106,563,395,168,434500,184800,619300
314600,202106,943,597,346,660000,380600,1040600
314610,202106,937,476,461,523600,507100,1030700
314620,202106,140,104,36,114400,39600,154000
314625,202106,95,69,26,75900,28600,104500
314630,202106,1145,609,536,669900,590700,1260600
314640,202106,83,53,30,58300,33000,91300
314650,202106,171,95,76,104500,83600,188100
314655,202106,61,45,16,49500,17600,67100
314660,202106,16,13,3,14300,3300,17600
314670,202106,198,151,47,166100,51700,217800
314675,202106,210,127,83,139700,91300,231000
314690,202106,591,312,279,344300,308000,652300
314700,202106,2251,1199,1052,1321100,1159400,2480500
314710,202106,1750,989,761,1089000,838200,1927200
314720,202106,384,219,165,240900,182600,423500
314730,202106,505,267,238,295900,261800,557700
314740,202106,747,352,395,388300,434500,822800
314750,202106,19,15,4,16500,4400,20900
314760,202106,359,159,200,174900,221100,396000
314770,202106,106,72,34,79200,38500,117700
314780,202106,23,9,14,9900,15400,25300
314790,202106,2442,1539,903,1696200,996600,2692800
314795,202106,55,47,8,51700,8800,60500
314800,202106,2908,1679,1229,1852401.51,1354100,3206501.51
314810,202106,1474,846,628,931700,690800,1622500
314820,202106,104,59,45,64900,50600,115500
314830,202106,212,171,41,188100,45100,233200
314840,202106,88,51,37,56100,40700,96800
314850,202106,396,192,204,211200,224400,435600
314860,202106,656,503,153,553300,168300,721600
314870,202106,1525,793,732,876700,807400,1684100
314875,202106,52,47,5,51700,5500,57200
314880,202106,44,31,13,34100,14300,48400
314890,202106,49,27,22,29700,24200,53900
314900,202106,29,23,6,26400,6600,33000
314910,202106,236,154,82,169400,90200,259600
314915,202106,138,122,16,134200,17600,151800
314920,202106,94,61,33,67100,36300,103400
314930,202106,1012,476,536,526900,589600,1116500
314940,202106,45,37,8,40700,9900,50600
314950,202106,19,15,4,16500,4400,20900
314960,202106,27,19,8,20900,8800,29700
314970,202106,155,74,81,81400,89100,170500
314980,202106,311,201,110,221100,121000,342100
314990,202106,436,238,198,261800,217800,479600
314995,202106,152,61,91,68200,100100,168300
315000,202106,81,62,19,68200,20900,89100
315010,202106,39,25,14,27500,15400,42900
315015,202106,166,130,36,143000,39600,182600
315020,202106,67,56,11,61600,12100,73700
315030,202106,110,85,25,93500,27500,121000
315040,202106,76,47,29,51700,31900,83600
315050,202106,195,118,77,129800,84700,214500
315053,202106,43,32,11,35200,12100,47300
315057,202106,110,86,24,94600,26400,121000
315060,202106,72,59,13,64900,14300,79200
315070,202106,105,59,46,64900,50600,115500
315080,202106,381,301,80,331100,88000,419100
315090,202106,91,53,38,58300,41800,100100
315100,202106,77,39,38,42900,41800,84700
315110,202106,273,143,130,157300,143000,300300
315120,202106,1765,849,916,935000,1009800,1944800
315130,202106,331,243,88,267300,96800,364100
315140,202106,536,297,239,326700,262900,589600
315150,202106,992,470,522,518100,575300,1093400
315160,202106,202,101,101,111100,112200,223300
315170,202106,309,208,101,228800,111100,339900
315180,202106,3243,1351,1892,1488300,2087800,3576100
315190,202106,298,182,116,201300,129800,331100
315200,202106,1219,727,492,800800,542300,1343100
315210,202106,1614,919,695,1012000,765600,1777600
315213,202106,28,16,12,18700,13200,31900
315217,202106,197,153,44,168300,48400,216700
315220,202106,1592,1193,399,1312300,440000,1752300
315230,202106,170,125,45,137500,49500,187000
315240,202106,401,254,147,279400,161700,441100
315250,202106,2553,1231,1322,1357400,1455300,2812700
315260,202106,135,76,59,84700,64900,149600
315270,202106,130,88,42,96800,46200,143000
315280,202106,640,417,223,458700,245300,704000
315290,202106,184,116,68,128700,74800,203500
315300,202106,83,62,21,68200,23100,91300
315310,202106,79,70,9,77000,9900,86900
315320,202106,150,88,62,96800,68200,165000
315330,202106,57,46,11,50600,12100,62700
315340,202106,394,287,107,315700,117700,433400
315350,202106,153,93,60,102300,66000,168300
315360,202106,95,44,51,48400,56100,104500
315370,202106,55,36,19,39600,20900,60500
315380,202106,5,5,0,5500,0,5500
315390,202106,59,17,42,18700,46200,64900
315400,202106,807,600,207,660000,227700,887700
315410,202106,318,185,133,203500,146300,349800
315415,202106,55,42,13,46200,14300,60500
315420,202106,197,142,55,156200,60500,216700
315430,202106,650,369,281,405900,311300,717200
315440,202106,94,63,31,69300,34100,103400
315445,202106,223,187,36,205700,39600,245300
315450,202106,183,136,47,149600,51700,201300
315460,202106,4144,1956,2188,2151600,2407900,4559500
315470,202106,40,16,24,17600,26400,44000
315480,202106,71,22,49,24200,53900,78100
315490,202106,703,428,275,470800,302500,773300
315500,202106,14,11,3,12100,3300,15400
315510,202106,145,98,47,107800,51700,159500
315520,202106,76,64,12,70400,13200,83600
315530,202106,42,23,19,25300,20900,46200
315540,202106,254,180,74,198000,81400,279400
315550,202106,181,148,33,162800,36300,199100
315560,202106,730,579,151,638000,166100,804100
315570,202106,312,153,159,169400.63,174900,344300.63
315580,202106,732,494,238,544500,261800,806300
315590,202106,194,100,94,110000,103400,213400
315600,202106,310,238,72,261800,79200,341000
315610,202106,101,48,53,52800,58300,111100
315620,202106,36,28,8,30800,8800,39600
315630,202106,124,84,40,92400,44000,136400
315640,202106,67,41,26,45100,28600,73700
315645,202106,50,33,17,36300,18700,55000
315650,202106,172,125,47,137500,51700,189200
315660,202106,453,197,256,216700,281600,498300
315670,202106,2374,1115,1259,1227600,1391500,2619100
315680,202106,813,575,238,632500,262900,895400
315690,202106,673,460,213,506000,234300,740300
315700,202106,1954,1023,931,1126401.1,1025200,2151601.1
315710,202106,354,106,248,116600,272800,389400
315720,202106,476,291,185,320100,203500,523600
315725,202106,192,156,36,172700,39600,212300
315727,202106,53,25,28,27500,30800,58300
315730,202106,47,44,3,48400,3300,51700
315733,202106,89,60,29,66000,31900,97900
315737,202106,50,37,13,40700,14300,55000
315740,202106,31,23,8,25300,8800,34100
315750,202106,149,112,37,123200,41800,165000
315760,202106,38,29,9,31900,9900,41800
315765,202106,117,68,49,74800,53900,128700
315770,202106,213,130,83,143000,92400,235400
315780,202106,3608,1781,1827,1960200,2014100,3974300
315790,202106,239,187,52,205700,57200,262900
315800,202106,302,202,100,223300,110000,333300
315810,202106,92,56,36,61600,40700,102300
315820,202106,754,555,199,611600,220000,831600
315830,202106,116,75,41,82500,45100,127600
315840,202106,84,53,31,58300,34100,92400
315850,202106,256,181,75,199100,82500,281600
315860,202106,14,5,9,5500,9900,15400
315870,202106,39,30,9,33000,9900,42900
315880,202106,98,66,32,73700,35200,108900
315890,202106,93,68,25,74800,27500,102300
315895,202106,413,276,137,304700,150700,455400
315900,202106,70,34,36,37400,39600,77000
315910,202106,41,24,17,26400,18700,45100
315920,202106,154,100,54,110000,59400,169400
315930,202106,53,17,36,18700,39600,58300
315935,202106,125,100,25,110000,27500,137500
315940,202106,99,73,26,80300,28600,108900
315950,202106,37,28,9,30800,9900,40700
315960,202106,543,256,287,281600,315700,597300
315970,202106,33,26,7,28600,7700,36300
315980,202106,672,334,338,368500,371800,740300
315990,202106,256,147,109,161700,119900,281600
316000,202106,45,29,16,31900,17600,49500
316010,202106,79,65,14,71500,15400,86900
316020,202106,116,100,16,110000,17600,127600
316030,202106,382,213,169,234300,185900,420200
316040,202106,536,219,317,240900,348700,589600
316045,202106,51,46,5,50600,5500,56100
316050,202106,20,16,4,17600,4400,22000
316060,202106,97,68,29,74800,31900,106700
316070,202106,1077,702,375,773300,413600,1186900
316080,202106,90,62,28,68296.8,30800,99096.8
316090,202106,40,21,19,23100,20900,44000
316095,202106,89,74,15,81400,16500,97900
316100,202106,319,181,138,199100,151800,350900
316105,202106,40,24,16,26400,17600,44000
316110,202106,1874,1480,394,1629100.5,434500,2063600.5
316120,202106,77,53,24,59400,26400,85800
316130,202106,119,89,30,99000,33000,132000
316140,202106,31,19,12,20900,13200,34100
316150,202106,209,146,63,160600,69300,229900
316160,202106,84,47,37,51700,40700,92400
316165,202106,64,45,19,49500,20900,70400
316170,202106,184,121,63,133100,69300,202400
316180,202106,203,83,120,91300,133100,224400
316190,202106,131,92,39,101200,42900,144100
316200,202106,658,353,305,388300,336600,724900
316210,202106,770,513,257,566689.2,282700,849389.2
316220,202106,117,75,42,83600,46200,129800
316225,202106,31,18,13,19800,14300,34100
316230,202106,36,18,18,19800,19800,39600
316240,202106,663,529,134,581900,147400,729300
316245,202106,141,122,19,134200,20900,155100
316250,202106,1544,1040,504,1144000,555500,1699500
316255,202106,132,105,27,115500,29700,145200
316257,202106,174,88,86,96800,94600,191400
316260,202106,188,133,55,146300,60500,206800
316265,202106,29,21,8,23100,8800,31900
316270,202106,681,475,206,522500,226600,749100
316280,202106,549,340,209,374000.63,229900,603900.63
316290,202106,787,530,257,583000,282700,865700
316292,202106,538,213,325,234300,358600,592900
316294,202106,103,67,36,73700,39600,113300
316295,202106,312,136,176,150700,193600,344300
316300,202106,109,72,37,79200,40700,119900
316310,202106,28,14,14,15400,15400,30800
316320,202106,52,28,24,30800,26400,57200
316330,202106,166,113,53,124300,58300,182600
316340,202106,130,86,44,94600,48400,143000
316350,202106,191,134,57,147400,62700,210100
316360,202106,23,13,10,14300,11000,25300
316370,202106,1149,578,571,639100,630300,1269400
316380,202106,113,86,27,94600,29700,124300
316390,202106,109,76,33,84700,36300,121000
316400,202106,133,101,32,111100,35200,146300
316410,202106,306,220,86,242000,94600,336600
316420,202106,209,141,68,155100,74800,229900
316430,202106,152,79,73,86900,80300,167200
316440,202106,83,41,42,45100,46200,91300
316443,202106,41,37,4,40700,4400,45100
316447,202106,47,35,12,38500,13200,51700
316450,202106,221,171,50,189200,55000,244200
316460,202106,80,27,53,30800,59400,90200
316470,202106,1653,1200,453,1321089.65,499400,1820489.65
316480,202106,11,8,3,8800,3300,12100
316490,202106,20,6,14,6600,15400,22000
316500,202106,160,106,54,116600,59400,176000
316510,202106,149,113,36,124300,39600,163900
316520,202106,197,114,83,125400,91300,216700
316530,202106,164,107,57,118800,62700,181500
316540,202106,149,76,73,83600,80300,163900
316550,202106,144,90,54,99000,59400,158400
316553,202106,322,145,177,159500,194700.72,354200.72
316555,202106,47,41,6,45100,6600,51700
316556,202106,14,10,4,11000,4400,15400
316557,202106,26,22,4,24200,4400,28600
316560,202106,65,45,20,49500,22000,71500
316570,202106,209,190,19,209000,20900,229900
316580,202106,21,15,6,16500,6600,23100
316590,202106,95,80,15,89100,16500,105600
316600,202106,174,146,28,160600,30800,191400
316610,202106,67,51,16,56100,17600,73700
316620,202106,136,98,38,108900,41800,150700
316630,202106,40,30,10,33000,11000,44000
316640,202106,22,14,8,15400,8800,24200
316650,202106,82,67,15,73700,16500,90200
316660,202106,7,2,5,2200,5500,7700
316670,202106,439,150,289,165000,317900,482900
316680,202106,159,115,44,126500,48400,174900
316690,202106,174,107,67,117700,73700,191400
316695,202106,60,51,9,56100,9900,66000
316700,202106,18,12,6,13200,6600,19800
316710,202106,765,579,186,638000,204600,842600
316720,202106,5056,2441,2615,2686200,2882000,5568200
316730,202106,16,16,0,17600,0,17600
316740,202106,144,93,51,102300,56100,158400
316750,202106,19,13,6,14300,6600,20900
316760,202106,309,251,58,277200,64900,342100
316770,202106,170,92,78,101200,85800,187000
316780,202106,68,42,26,46200,28600,74800
316790,202106,57,40,17,44000,18700,62700
316800,202106,1763,1091,672,1201200,742500,1943700
316805,202106,23,17,6,18700,6600,25300
316810,202106,64,40,24,44000,26400,70400
316820,202106,40,21,19,23100,20900,44000
316830,202106,94,44,50,48400,55000,103400
316840,202106,511,296,215,325600,237600,563200
316850,202106,326,220,106,242000,116600,358600
316860,202106,5920,2623,3297,2886400,3630000,6516400
316870,202106,1571,1004,567,1105500,623700,1729200
316880,202106,137,67,70,73700,77000,150700
316890,202106,234,159,75,174900,82500,257400
316900,202106,411,287,124,315700,137500,453200
316905,202106,19,9,10,9900,11000,20900
316910,202106,65,27,38,29700,41800,71500
316920,202106,141,110,31,121000,34100,155100
316930,202106,1878,943,935,1042800,1028500,2071300
316935,202106,905,544,361,599500,397100,996600
316940,202106,1083,613,470,675400,518100,1193500
316950,202106,176,87,89,95700,99000,194700
316960,202106,1088,608,480,671000,528000,1199000
316970,202106,641,508,133,558800,146300,705100
316980,202106,75,41,34,45100,37400,82500
316990,202106,2149,1429,720,1573000.2,792000.84,2365001.04
317000,202106,327,253,74,278300,81400,359700
317005,202106,226,161,65,177100,71500,248600
317010,202106,6421,3553,2868,3910500,3159200,7069700
317020,202106,15714,6915,8799,7621900,9685500,17307400
317030,202106,80,31,49,34100,55000,89100
317040,202106,3027,1912,1115,2107600,1229800,3337400
317043,202106,68,51,17,56100,18700,74800
317047,202106,37,19,18,20900,19800,40700
317050,202106,151,114,37,126500,41800,168300
317052,202106,140,108,32,118800,35200,154000
317057,202106,169,129,40,141900,44000,185900
317060,202106,61,38,23,41800,25300,67100
317065,202106,48,37,11,40700,12100,52800
317070,202106,1921,887,1034,975700,1139600,2115300
317075,202106,97,53,44,58300,48400,106700
317080,202106,909,464,445,510400,489500,999900
317090,202106,701,548,153,603900,168300,772200
317100,202106,421,316,105,347600,115500,463100
317103,202106,115,95,20,104500,22000,126500
317107,202106,45,39,6,42900,6600,49500
317110,202106,110,51,59,56100,64900,121000
317115,202106,44,40,4,44000,4400,48400
317120,202106,1934,912,1022,1003200,1126400,2129600
317130,202106,1973,1301,672,1434400,740300,2174700
317140,202106,11,9,2,9900,2200,12100
317150,202106,274,163,111,180400,122100,302500
317160,202106,330,249,81,273900.63,89100,363000.63
317170,202106,227,153,74,168300,81400,249700
317180,202106,446,305,141,335500,155100,490600
317190,202106,265,190,75,209000,82500,291500
317200,202106,807,559,248,614900,273900,888800
317210,202106,182,98,84,107800,92400,200200
317220,202106,24,12,12,13200,13200,26400
320010,202106,572,413,159,454300,174900,629200
320013,202106,124,85,39,93500,42900,136400
320016,202106,266,172,94,189200,103400,292600
320020,202106,723,423,300,465300.8,330000,795300.8
320030,202106,160,109,51,119900.08,56100.08,176000.16
320035,202106,138,98,40,107800,44000,151800
320040,202106,500,255,245,280500,269500,550000
320050,202106,110,77,33,84700,36300,121000
320060,202106,1724,825,899,911900,990000,1901900
320070,202106,100,59,41,64900,45100,110000
320080,202106,812,469,343,515900,378400,894300
320090,202106,1247,828,419,910800,460900,1371700
320100,202106,334,192,142,211200,157300,368500
320110,202106,117,71,46,78100,50600,128700
320115,202106,113,92,21,101200,23100,124300
320120,202106,3603,1902,1701,2094400,1872200.74,3966600.74
320130,202106,7592,3388,4204,3734133.82,4628800,8362933.82
320140,202106,431,276,155,303600,170500.81,474100.81
320150,202106,2078,1149,929,1265000,1021900,2286900
320160,202106,653,289,364,317900,400400,718300
320170,202106,109,85,24,93500.1,26400.02,119900.12
320180,202106,54,33,21,36300,23100,59400
320190,202106,238,150,88,165000,96800,261800
320200,202106,61,47,14,51700,15400,67100
320210,202106,897,485,412,533500,454300,987800
320220,202106,303,107,196,117700,215600,333300
320225,202106,87,69,18,75900,19800,95700
320230,202106,657,422,235,464200,258500,722700
320240,202106,3415,1615,1800,1776500.79,1981100,3757600.79
320245,202106,484,328,156,361900,172700,534600
320250,202106,229,114,115,126500,127600,254100
320255,202106,130,102,28,112200,30800,143000
320260,202106,225,135,90,148500.2,99000.12,247500.32
320265,202106,153,115,38,126500,41800,168300
320270,202106,153,120,33,132000,36300,168300
320280,202106,1163,663,500,729300.5,552200.02,1281500.52
320290,202106,56,47,9,51700,9900,61600
320300,202106,602,414,188,455400.02,206800,662200.02
320305,202106,691,364,327,400400,359700,760100
320310,202106,198,113,85,124300,93500,217800
320313,202106,339,158,181,173800,199100,372900
320316,202106,108,83,25,91300,27500,118800
320320,202106,3417,1514,1903,1667600,2096600,3764200
320330,202106,266,198,68,217800,74800,292600
320332,202106,761,447,314,491700,345400,837100
320334,202106,257,141,116,155100.02,127600,282700.02
320335,202106,142,93,49,102300,53900,156200
320340,202106,569,397,172,436700,189200,625900
320350,202106,1029,426,603,469700.5,663300,1133000.5
320360,202106,162,81,81,89100,89100,178200
320370,202106,232,172,60,189200,67100,256300
320380,202106,288,201,87,222200,95700,317900
320390,202106,1145,677,468,745800,514800,1260600
320400,202106,318,229,89,251900,97900,349800
320405,202106,952,389,563,427900,620400,1048300
320410,202106,958,484,474,532400,521400,1053800
320420,202106,525,246,279,270600,306900,577500
320425,202106,193,106,87,116600,95700,212300
320430,202106,378,203,175,224400,192500,416900
320435,202106,160,106,54,116600,59400,176000
320440,202106,198,114,84,125400.24,92400.2,217800.44
320450,202106,129,72,57,79200,62700,141900
320455,202106,249,195,54,215600,59400,275000
320460,202106,286,175,111,192500,122100,314600
320465,202106,113,74,39,81400,42900,124300
320470,202106,701,426,275,468600,303600,772200
320480,202106,199,129,70,141900,77000,218900
320490,202106,3116,1493,1623,1643401.23,1786401.3,3429802.53
320495,202106,113,68,45,74800,49500,124300
320500,202106,9599,4686,4913,5161200,5413100,10574300
320501,202106,538,270,268,297000,295900,592900
320503,202106,298,208,90,228800.08,99000.02,327800.10
320506,202106,262,183,79,201300,86900,288200
320510,202106,1095,489,606,537900,666600,1204500
320515,202106,80,60,20,66000,22000,88000
320517,202106,211,152,59,167200,64900,232100
320520,202106,7149,3011,4138,3318700,4556200,7874900
320530,202106,6401,3119,3282,3433081.5,3612400.69,7045482.19
330010,202106,3065,1515,1550,1667600,1708300,3375900
330015,202106,181,71,110,80300,121000,201300
330020,202106,3762,1516,2246,1672000,2475000,4147000
330022,202106,257,129,128,141900,140800,282700
330023,202106,664,202,462,222200,508200,730400
330025,202106,590,110,480,121000,528000,649000
330030,202106,1825,1123,702,1238600,772200,2010800
330040,202106,2471,1246,1225,1372800,1358500.5,2731300.5
330045,202106,9398,2768,6630,3045900.5,7299600,10345500.5
330050,202106,861,552,309,607200,341000,948200
330060,202106,1053,619,434,683100,477400,1160500
330070,202106,3958,1375,2583,1514700,2846800,4361500
330080,202106,1600,692,908,761200,999900,1761100
330090,202106,387,222,165,244200,181500,425700
330093,202106,258,111,147,122100,161700,283800
330095,202106,74,44,30,48400,33000,81400
330100,202106,10014,4953,5061,5454900.5,5579200,11034100.5
330110,202106,468,198,270,218900,298100,517000
330115,202106,515,268,247,294800,271700,566500
330120,202106,384,191,193,210100,212300,422400
330130,202106,1573,387,1186,426800,1304600,1731400
330140,202106,620,327,293,359700,322300,682000
330150,202106,512,291,221,321200,243100,564300
330160,202106,214,124,90,136400,99000,235400
330170,202106,27025,8988,18037,9895600.79,19864900,29760500.79
330180,202106,239,134,105,147400,115500,262900
330185,202106,974,336,638,369600,701800,1071400
330187,202106,437,126,311,138600,342100,480700
330190,202106,5956,2192,3764,2415600,4148100,6563700
330200,202106,4674,1397,3277,1537801.32,3609100,5146901.32
330205,202106,439,248,191,277200,210100,487300
330210,202106,943,568,375,625900,412500,1038400
330220,202106,2700,1579,1121,1736900,1234200,2971100
330225,202106,566,284,282,312400,311300,623700
330227,202106,2405,723,1682,796400,1856800,2653200
330230,202106,262,143,119,157300,130900,288200
330240,202106,3933,1939,1994,2135100,2194500,4329600
330245,202106,152,66,86,72600,94600,167200
330250,202106,6682,3280,3402,3613500.5,3746600,7360100.5
330260,202106,647,161,486,177100,535700,712800
330270,202106,3707,1200,2507,1320000,2763200,4083200
330280,202106,439,278,161,305800,177100,482900
330285,202106,6866,2085,4781,2295700,5262400,7558100
330290,202106,679,244,435,269500,479600,749100
330300,202106,756,482,274,531572.06,301400,832972.06
330310,202106,451,246,205,270600,225500,496100
330320,202106,7999,2850,5149,3138300,5674997.9,8813297.9
330330,202106,9236,3385,5851,3730100.02,6443800.09,10173900.11
330340,202106,2673,1531,1142,1685200,1259500,2944700
330350,202106,18818,6932,11886,7631800,13098800.5,20730600.5
330360,202106,2141,1004,1137,1107700,1252900,2360600
330370,202106,1004,501,503,551100,555500,1106600
330380,202106,909,369,540,407000,595100.01,1002100.01
330385,202106,634,322,312,355300,343200,698500
330390,202106,5790,2989,2801,3292300,3087700,6380000
330395,202106,322,193,129,213400,141900,355300
330400,202106,691,356,335,391600,370700,762300
330410,202106,496,353,143,388300,157300,545600
330411,202106,272,140,132,155100,145200,300300
330412,202106,227,91,136,100100,149600,249700
330414,202106,5330,2113,3217,2325400,3546400.75,5871800.75
330415,202106,605,261,344,287100,378400,665500
330420,202106,2262,1136,1126,1251800,1243000,2494800
330430,202106,1784,773,1011,853600,1113200,1966800
330440,202106,312,141,171,156200,188100,344300
330450,202106,116,51,65,57200,71500,128700
330452,202106,2184,938,1246,1032900,1373900,2406800
330455,202106,115737,39211,76526,43186094.66,84278704.67,127464799.33
330460,202106,251,107,144,117700,158400,276100
330470,202106,1223,664,559,730400,616000,1346400
330475,202106,1620,431,1189,474100,1310100,1784200
330480,202106,820,445,375,489500,412500,902000
330490,202106,15140,4679,10461,5151405,11517000,16668405
330500,202106,1426,609,817,671000,899800,1570800
330510,202106,10934,3701,7233,4074400,7961800,12036200
330513,202106,96,48,48,52800,52800,105600
330515,202106,752,308,444,339900,488400,828300
330520,202106,2521,856,1665,942700,1831500,2774200
330530,202106,195,110,85,121000,93500,214500
330540,202106,346,173,173,191400,191400,382800
330550,202106,2873,969,1904,1067000,2097700,3164700
330555,202106,809,309,500,339900,551100,891000
330560,202106,699,229,470,251900,517000,768900
330570,202106,275,192,83,211200,91300,302500
330575,202106,802,279,523,306900,575300.59,882200.59
330580,202106,3356,1840,1516,2026200.5,1673100,3699300.5
330590,202106,271,143,128,158400.5,141900,300300.5
330600,202106,1229,753,476,829400,524700,1354100
330610,202106,1587,839,748,922900,822800,1745700
330615,202106,216,170,46,187000,50600,237600
330620,202106,1047,393,654,432300,720500,1152800
330630,202106,4145,2499,1646,2752201.07,1812800,4565001.07
350010,202106,581,381,200,420200.88,220000,640200.88
350020,202106,58,21,37,23100,40700,63800
350030,202106,514,321,193,355300,212300,567600
350040,202106,125,53,72,58300,79200,137500
350050,202106,329,168,161,184800,177100,361900
350055,202106,107,50,57,55000,62700,117700
350060,202106,84,27,57,29700,62700,92400
350070,202106,780,459,321,506000.2,353100,859100.2
350075,202106,76,49,27,53900,29700,83600
350080,202106,56,27,29,29700,31900,61600
350090,202106,83,49,34,53900,37400,91300
350100,202106,274,168,106,184800,117700,302500
350110,202106,57,41,16,45100,17600,62700
350115,202106,149,92,57,101200,62700,163900
350120,202106,111,72,39,79200,42900,122100
350130,202106,370,163,207,179300.56,227700,407000.56
350140,202106,41,26,15,28600,16500,45100
350150,202106,80,58,22,63800,24200,88000
350160,202106,2381,942,1439,1038400,1582900,2621300
350170,202106,381,221,160,243100,176000,419100
350180,202106,164,94,70,103400,77000,180400
350190,202106,1004,533,471,586301.42,519200,1105501.42
350200,202106,65,25,40,27500,45100,72600
350210,202106,1282,707,575,779900,632500.63,1412400.63
350220,202106,639,526,113,579700.63,126500,706200.63
350230,202106,75,52,23,57200,25300,82500
350240,202106,58,39,19,42900,20900,63800
350250,202106,1147,539,608,592900,668800,1261700
350260,202106,101,73,28,80300,30800,111100
350270,202106,890,596,294,657800,323400,981200
350275,202106,287,114,173,125400,191400,316800
350280,202106,4445,2213,2232,2437600,2459600,4897200
350290,202106,456,199,257,220000,282700,502700
350300,202106,55,27,28,29700,30800,60500
350310,202106,77,50,27,55000,29700,84700
350315,202106,64,28,36,30800,39600,70400
350320,202106,3291,1594,1697,1756700,1871100,3627800
350330,202106,1641,864,777,951501.66,854700,1806201.66
350335,202106,15,11,4,12100,4400,16500
350340,202106,125,55,70,60500,77000,137500
350350,202106,97,49,48,53900,52800,106700
350360,202106,107,71,36,78100,39600,117700
350370,202106,79,42,37,46200.63,40700,86900.63
350380,202106,776,327,449,359700,495000,854700
350390,202106,1659,602,1057,664400.5,1164900,1829300.5
350395,202106,22,18,4,19800,4400,24200
350400,202106,1670,824,846,907501.89,932800.63,1840302.52
350410,202106,2793,1181,1612,1299100,1775420.79,3074520.79
350420,202106,253,150,103,165000,113300,278300
350430,202106,79,46,33,50600,36300,86900
350440,202106,157,113,44,125400,48400,173800
350450,202106,1690,972,718,1070300.63,793100,1863400.63
350460,202106,400,134,266,147400,292600,440000
350470,202106,21,12,9,13200,11000,24200
350480,202106,180,100,80,110000,89100,199100
350490,202106,243,115,128,126500,140800,267300
350500,202106,54,24,30,26400,33000,59400
350510,202106,159,97,62,107800,68200,176000
350520,202106,430,224,206,246400,226600,473000
350530,202106,436,206,230,226600,253000,479600
350535,202106,80,62,18,68200,19800,88000
350540,202106,372,194,178,213400,198000,411400
350550,202106,2652,1519,1133,1672000,1246301.26,2918301.26
350560,202106,589,402,187,442200,205700,647900
350570,202106,4220,1731,2489,1906300.63,2740101.27,4646401.90
350580,202106,360,174,186,191400,205700,397100
350590,202106,925,493,432,545600,475200,1020800
350600,202106,6045,2870,3175,3169100,3495800,6664900
350610,202106,1470,763,707,841500,781000,1622500
350620,202106,26,16,10,17600,11000,28600
350630,202106,241,133,108,146300.63,119900,266200.63
350635,202106,1004,399,605,438900,666600,1105500
350640,202106,118,89,29,97900,31900,129800
350650,202106,1849,1229,620,1354100,683100,2037200
350660,202106,746,306,440,336600,485100,821700
350670,202106,307,153,154,169400,170500,339900
350680,202106,167,84,83,92400,91300,183700
350690,202106,195,89,106,97900,116600,214500
350700,202106,815,388,427,427900,469700,897600
350710,202106,384,141,243,155100,267300,422400
350715,202106,57,45,12,49500,13200,62700
350720,202106,17,11,6,12100,6600,18700
350730,202106,43,26,17,28600,18700,47300
350740,202106,224,125,99,137500,110000,247500
350745,202106,25,10,15,11000,16500,27500
350750,202106,2225,1339,886,1474000,977900,2451900
350760,202106,3699,1542,2157,1699500,2377100,4076600
350770,202106,55,41,14,45100,16500,61600
350775,202106,47,33,14,36300,15400,51700
350780,202106,421,213,208,236500,229900,466400
350790,202106,363,150,213,166100,234300,400400
350800,202106,484,290,194,319000,214500,533500
350810,202106,510,405,105,446600,115500,562100
350820,202106,91,51,40,56100,44000,100100
350830,202106,75,40,35,44000,38500,82500
350840,202106,754,300,454,330000,499400,829400
350850,202106,1773,950,823,1048300,906400,1954700
350860,202106,605,328,277,360800,304700,665500
350870,202106,438,288,150,317900,165000,482900
350880,202106,270,151,119,167200,130900,298100
350890,202106,39,24,15,26400,16500,42900
350900,202106,1493,459,1034,506000,1138500.63,1644500.63
350910,202106,27,16,11,17600,13200,30800
350920,202106,700,362,338,399300,374000,773300
350925,202106,1131,593,538,654500,591800.63,1246300.63
350930,202106,97,57,40,63800,44000,107800
350940,202106,731,396,335,436700,368500,805200
350945,202106,112,80,32,88000,35200,123200
350950,202106,16504,7570,8934,8340200.63,9845000.45,18185201.08
350960,202106,1432,598,834,658900,919600,1578500
350970,202106,1064,548,516,604881.2,569800,1174681.2
350980,202106,98,65,33,71500,36300,107800
350990,202106,370,135,235,148500,259600,408100
350995,202106,38,18,20,19800,22000,41800
351000,202106,613,410,203,452100.63,223300,675400.63
351010,202106,51,33,18,36300,20900,57200
351015,202106,47,32,15,35200,16500,51700
351020,202106,1526,920,606,1012000,666600,1678600
351030,202106,341,208,133,228800,146300,375100
351040,202106,905,449,456,493900,502700.2,996600.2
351050,202106,3312,1480,1832,1631300,2017400,3648700
351060,202106,5374,2012,3362,2216500,3703700,5920200
351070,202106,398,255,143,281600.63,157300,438900.63
351080,202106,722,520,202,572000,222200,794200
351090,202106,50,23,27,25300,29700,55000
351100,202106,425,231,194,256300,213400,469700
351110,202106,1989,933,1056,1028501.13,1162700,2191201.13
351120,202106,64,33,31,36300,34100,70400
351130,202106,182,58,124,63800,137500,201300
351140,202106,312,197,115,217800,127600,345400
351150,202106,436,228,208,250800,229900,480700
351160,202106,267,165,102,181500.4,112200,293700.4
351170,202106,188,100,88,110000,96800,206800
351190,202106,85,58,27,63800,29700,93500
351200,202106,351,221,130,243100,143000,386100
351210,202106,112,56,56,61600,63800,125400
351220,202106,524,311,213,342100.65,234300,576400.65
351230,202106,268,186,82,204600,90200,294800
351240,202106,249,118,131,129800,144100,273900
351250,202106,79,54,25,59400.5,27500,86900.5
351260,202106,153,110,43,121000,47300,168300
351270,202106,49,20,29,22000,31900,53900
351280,202106,1019,469,550,515900.63,605000.63,1120901.26
351290,202106,240,107,133,117700,146300,264000
351300,202106,3730,1639,2091,1803913.6,2303400,4107313.6
351310,202106,737,364,373,400400,410300,810700
351320,202106,115,66,49,72600,53900,126500
351330,202106,38,25,13,27500,14300,41800
351340,202106,1250,725,525,798600,578600,1377200
351350,202106,2330,1345,985,1483900.04,1085700,2569600.04
351360,202106,773,375,398,412500,441100,853600
351370,202106,381,193,188,214500,210100,424600
351380,202106,8801,3898,4903,4297700,5398800.63,9696500.63
351385,202106,28,18,10,19800,11000,30800
351390,202106,278,210,68,231000,74800,305800
351400,202106,65,42,23,46200,25300,71500
351410,202106,422,260,162,286000.55,178200,464200.55
351420,202106,67,47,20,51700,22000,73700
351430,202106,74,42,32,46200,36300,82500
351440,202106,759,514,245,565401.26,270600,836001.26
351450,202106,260,126,134,138600,147400,286000
351460,202106,123,52,71,57200,78100,135300
351470,202106,143,79,64,86900,70400,157300
351480,202106,482,284,198,312400.63,217800,530200.63
351490,202106,280,101,179,111100,196900,308000
351492,202106,25,17,8,18700,8800,27500
351495,202106,28,19,9,20900,9900,30800
351500,202106,3474,1424,2050,1569700,2257200,3826900
351510,202106,1962,723,1239,797500,1362900,2160400
351512,202106,15,12,3,13200,3300,16500
351515,202106,188,111,77,122100,84700,206800
351518,202106,697,435,262,478500,288200,766700
351519,202106,78,43,35,47300,38500,85800
351520,202106,152,88,64,96800,70419.8,167219.8
351530,202106,25,15,10,16500,11000,27500
351535,202106,129,81,48,90200,52800,143000
351540,202106,449,307,142,338800,157300,496100
351550,202106,1442,844,598,929501.26,658900,1588401.26
351560,202106,77,45,32,49500,35200,84700
351565,202106,12,8,4,8800,4400,13200
351570,202106,2668,1261,1407,1388200,1547700.12,2935900.12
351580,202106,39,34,5,37400,5500,42900
351590,202106,58,39,19,42900,20900,63800
351600,202106,186,130,56,143000,61600,204600
351610,202106,50,21,29,23100,31900,55000
351620,202106,5738,3150,2588,3478200.82,2853400,6331600.82
351630,202106,2889,1403,1486,1545500,1641200,3186700
351640,202106,2055,902,1153,993300.55,1268300.63,2261601.18
351650,202106,30,25,5,27500,5500,33000
351660,202106,127,81,46,90200,51700,141900
351670,202106,713,439,274,482900,302500,785400
351680,202106,65,54,11,59400,12100,71500
351685,202106,11,8,3,8800,3300,12100
351690,202106,289,194,95,213400.5,104500,317900.5
351700,202106,168,114,54,125637,59400,185037
351710,202106,69,43,26,47300,28600,75900
351720,202106,128,72,56,79200,61600,140800
351730,202106,108,70,38,77000,41800,118800
351740,202106,737,464,273,511500.74,300300,811800.74
351750,202106,351,141,210,155100,232100,387200
351760,202106,734,567,167,624800,183700,808500
351770,202106,302,249,53,275000.63,58300,333300.63
351780,202106,158,93,65,102300,71500,173800
351790,202106,244,125,119,137500,130900,268400
351800,202106,43,27,16,29700,17600,47300
351810,202106,118,79,39,86900,42900,129800
351820,202106,790,563,227,619300,250800,870100
351830,202106,549,183,366,201300,403700,605000
351840,202106,1962,927,1035,1019700,1139600,2159300
351850,202106,226,161,65,177100,72600,249700
351860,202106,622,430,192,473000,212300,685300
351870,202106,5535,2566,2969,2824802.04,3271401.38,6096203.42
351880,202106,19704,7788,11916,8584400,13120800,21705200
351885,202106,84,50,34,55000,37400,92400
351890,202106,64,50,14,56100,15400,71500
351900,202106,225,130,95,143000,105600,248600
351905,202106,90,37,53,40700,58300,99000
351907,202106,3469,1409,2060,1549900,2267100.02,3817000.02
351910,202106,171,71,100,78100,110000,188100
351920,202106,111,61,50,67100,56100,123200
351925,202106,87,54,33,59400,36300,95700
351930,202106,388,249,139,275000,152900,427900
351940,202106,233,94,139,103400,152900,256300
351950,202106,132,69,63,77000,69300,146300
351960,202106,917,453,464,500844.93,510400,1011244.93
351970,202106,1974,989,985,1089000,1085700,2174700
351980,202106,149,67,82,73700,90200,163900
351990,202106,252,161,91,177100,100100,277200
352000,202106,327,207,120,227700,133100,360800
352010,202106,407,251,156,277271,171600,448871
352020,202106,178,69,109,75900,119900,195800
352030,202106,1086,543,543,599500,599500,1199000
352040,202106,568,235,333,258500,368500,627000
352042,202106,283,72,211,79200,232100,311300
352044,202106,345,206,139,227700.63,152900,380600.63
352050,202106,3193,1198,1995,1321100.63,2201100,3522200.63
352060,202106,103,61,42,67100,46200,113300
352070,202106,89,66,23,72601.26,25300,97901.26
352080,202106,62,41,21,45100,23100,68200
352090,202106,150,98,52,107800,57200,165000
352100,202106,284,135,149,148500,163900,312400
352110,202106,119,38,81,41800,89100,130900
352115,202106,65,20,45,22000,49500,71500
352120,202106,82,58,24,63800.63,26400,90200.63
352130,202106,216,172,44,189200,48400,237600
352140,202106,176,84,92,93500,101200,194700
352150,202106,119,63,56,69300,61600,130900
352160,202106,140,90,50,99000,55000,154000
352170,202106,382,258,124,284900,136400,421300
352180,202106,639,396,243,435600.63,267300,702900.63
352190,202106,240,96,144,106700,159500,266200
352200,202106,29,14,15,15400,16500,31900
352210,202106,4184,1693,2491,1865600.95,2746700,4612300.95
352215,202106,66,39,27,42900,29700,72600
352220,202106,6489,2413,4076,2658700,4489100.63,7147800.63
352230,202106,3339,2153,1186,2369401.13,1305700.43,3675101.56
352240,202106,2521,1444,1077,1590600,1190200,2780800
352250,202106,2850,1327,1523,1461901.89,1675300,3137201.89
352260,202106,977,521,456,575300,502700,1078000
352265,202106,60,32,28,35200,30800,66000
352270,202106,389,217,172,238700,189200,427900
352280,202106,472,283,189,311300.63,209000,520300.63
352290,202106,180,104,76,114400,83600,198000
352300,202106,92,64,28,70400,30800,101200
352310,202106,6490,2821,3669,3106401.62,4043600,7150001.62
352320,202106,1068,550,518,606100,572000,1178100
352330,202106,517,261,256,288200,281600,569800
352340,202106,1340,610,730,672100,804100,1476200
352350,202106,348,201,147,221100,161700,382800
352360,202106,220,95,125,105600,137500,243100
352370,202106,105,68,37,74800,40700,115500
352380,202106,109,75,34,82500,37400,119900
352390,202106,2510,1085,1425,1193500,1569700,2763200
352400,202106,514,226,288,249700,316800,566500
352410,202106,872,591,281,651200.63,309100,960300.63
352420,202106,92,65,27,71500,29700,101200
352430,202106,1733,783,950,862401.89,1046101.26,1908503.15
352440,202106,3223,1559,1664,1718200,1835900,3554100
352450,202106,198,158,40,173800,45100,218900
352460,202106,621,315,306,346500,336600,683100
352470,202106,652,229,423,251900,465300,717200
352480,202106,1423,779,644,859100,710600,1569700
352490,202106,45,14,31,15400,34100,49500
352500,202106,1237,517,720,570900,793100,1364000
352510,202106,702,377,325,414700.63,359700,774400.63
352520,202106,763,332,431,365347.4,474100,839447.4
352530,202106,1732,895,837,986700,921800,1908500
352540,202106,71,47,24,51700,26400,78100
352550,202106,188,111,77,123200,84700,207900
352560,202106,47,37,10,40700,11000,51700
352570,202106,684,328,356,361900.63,391600,753500.63
352580,202106,61,47,14,51700,15400,67100
352585,202106,20,6,14,6600,15400,22000
352590,202106,4275,2092,2183,2304862.63,2406897,4711759.63
352600,202106,344,240,104,264000,114400,378400
352610,202106,904,407,497,449900.5,548900,998800.5
352620,202106,1022,377,645,414700,711700,1126400
352630,202106,180,67,113,73700,124300,198000
352640,202106,511,333,178,366300,196900,563200
352650,202106,81,60,21,66000,23100,89100
352660,202106,62,38,24,41800,26400,68200
352670,202106,1663,873,790,963600.6,871200,1834800.6
352680,202106,896,554,342,609400,378400,987800
352690,202106,4491,1987,2504,2191201.44,2762100.63,4953302.07
352700,202106,92,55,37,60500,40700,101200
352710,202106,1419,735,684,809600,752400,1562000
352720,202106,1405,640,765,705100,842600,1547700
352725,202106,20,16,4,17600,4400,22000
352730,202106,379,183,196,201300,215600,416900
352740,202106,394,258,136,286000,149600.8,435600.8
352750,202106,21,14,7,15400,7700,23100
352760,202106,195,122,73,134200,80300,214500
352770,202106,85,64,21,70400,23100,93500
352780,202106,73,38,35,42900,38500,81400
352790,202106,23,17,6,18700,6600,25300
352800,202106,229,175,54,192500,59400,251900
352810,202106,153,97,56,106700,61600,168300
352820,202106,47,36,11,39600,12100,51700
352830,202106,73,49,24,55000,26400,81400
352840,202106,642,300,342,330000.16,377300,707300.16
352850,202106,1621,513,1108,565400,1221000,1786400
352860,202106,108,71,37,78100,41800,119900
352870,202106,46,30,16,33000,17600,50600
352880,202106,175,112,63,123200,69300,192500
352885,202106,33,22,11,24200,12100,36300
352890,202106,54,35,19,38500,20900,59400
352900,202106,4615,2208,2407,2434300,2654300,5088600
352910,202106,39,32,7,35200,7700,42900
352920,202106,653,382,271,420200,300300,720500
352930,202106,1201,566,635,623700,698500,1322200
352940,202106,6026,2417,3609,2659800,3978700,6638500
352950,202106,115,42,73,46200,81400,127600
352960,202106,62,36,26,39600,28600,68200
352965,202106,19,10,9,11000,9900,20900
352970,202106,508,379,129,418000.35,141900,559900.35
352980,202106,161,88,73,96800,80300,177100
352990,202106,970,452,518,497200,570900,1068100
353000,202106,58,25,33,27500,36300,63800
353010,202106,532,326,206,358600,227700,586300
353020,202106,300,217,83,238700,91300,330000
353030,202106,1243,559,684,617100,756800,1373900
353040,202106,73,39,34,42900,37400,80300
353050,202106,1265,816,449,900900.9,495000,1395900.9
353060,202106,8394,3538,4856,3898400.71,5347100,9245500.71
353070,202106,1788,1070,718,1179201.26,789604.2,1968805.46
353080,202106,1252,670,582,739200.92,641300,1380500.92
353090,202106,60,31,29,34100,31900,66000
353100,202106,46,36,10,39600,11000,50600
353110,202106,2091,659,1432,726000,1577400,2303400
353120,202106,100,50,50,55000,55000,110000
353130,202106,857,409,448,451001.55,492800,943801.55
353140,202106,540,220,320,242000.63,352000,594000.63
353150,202106,327,182,145,201300.63,159500,360800.63
353160,202106,97,76,21,83600,23100,106700
353170,202106,209,66,143,72600,157300,229900
353180,202106,1112,496,616,545600,677600,1223200
353190,202106,474,341,133,375100,146300,521400
353200,202106,229,111,118,122100,129800,251900
353205,202106,19,13,6,14300,6600,20900
353210,202106,67,37,30,40700,33000,73700
353215,202106,41,23,18,25300,19800,45100
353220,202106,76,40,36,44000,39600,83600
353230,202106,156,63,93,69300,103400,172700
353240,202106,343,165,178,182600,195800,378400
353250,202106,203,99,104,108900,114400,223300
353260,202106,452,304,148,335500,163900,499400
353270,202106,72,54,18,59400,19800,79200
353280,202106,97,48,49,52800,55000,107800
353282,202106,128,91,37,102300,40700,143000
353284,202106,26,19,7,20900,7700,28600
353286,202106,2,0,2,0,2200,2200
353290,202106,82,49,33,53900,37400,91300
353300,202106,433,224,209,249701.26,229900,479601.26
353310,202106,47,39,8,42900,8800,51700
353320,202106,35,20,15,22000,16500,38500
353325,202106,47,28,19,30800,20900,51700
353330,202106,63,45,18,49500,19800,69300
353340,202106,628,223,405,247500,445500,693000
353350,202106,884,433,451,476300,497200,973500
353360,202106,100,79,21,86900,23100,110000
353370,202106,108,64,44,70400,48400,118800
353380,202106,28,14,14,15400,15400,30800
353390,202106,1095,514,581,565400,639100,1204500
353400,202106,42,25,17,27500,18700,46200
353410,202106,110,64,46,70400,50600,121000
353420,202106,57,21,36,23100,39600,62700
353430,202106,563,369,194,405901.13,213400,619301.13
353440,202106,11492,4914,6578,5409800.63,7245700,12655500.63
353450,202106,56,29,27,31900,29700,61600
353460,202106,608,318,290,349800,320100,669900
353470,202106,2176,1097,1079,1208900.6,1191300,2400200.6
353475,202106,243,164,79,180400,88000,268400
353480,202106,178,143,35,157300,38500,195800
353490,202106,232,135,97,148500,107800,256300
353500,202106,205,119,86,132000,94600,226600
353510,202106,93,63,30,69300,33000,102300
353520,202106,217,156,61,172700,67100,239800
353530,202106,455,236,219,259600,240900,500500
353540,202106,380,245,135,270600,148500,419100
353550,202106,703,450,253,495000.93,279400,774400.93
353560,202106,571,230,341,253000,377300,630300
353570,202106,63,36,27,39600,29700,69300
353580,202106,342,242,100,266200,110000,376200
353590,202106,79,57,22,62700,24200,86900
353600,202106,265,154,111,170500.63,122100,292600.63
353610,202106,130,67,63,73700,69300,143000
353620,202106,636,325,311,357500,343200,700700
353625,202106,52,26,26,28600,28600,57200
353630,202106,221,158,63,176000,69300,245300
353640,202106,119,79,40,86900,44000,130900
353650,202106,941,357,584,393800,643500,1037300
353657,202106,24,18,6,19800,6600,26400
353660,202106,273,145,128,159500,140800,300300
353670,202106,733,430,303,475200.63,333300,808500.63
353680,202106,113,79,34,86900,37400,124300
353690,202106,39,29,10,31900,11000,42900
353700,202106,277,191,86,211200,94600,305800
353710,202106,477,220,257,242000,282700,524700
353715,202106,50,31,19,34100,20900,55000
353720,202106,339,151,188,166100,207900,374000
353730,202106,1117,683,434,753756.66,478500,1232256.66
353740,202106,601,326,275,358600,302500,661100
353750,202106,70,42,28,47300,31900,79200
353760,202106,3046,1150,1896,1268300,2088900.9,3357200.9
353770,202106,79,64,15,70400,16500,86900
353780,202106,1253,586,667,644600.63,735900,1380500.63
353790,202106,490,297,193,327800,213400,541200
353800,202106,3475,1654,1821,1820520,2005374,3825894
353810,202106,226,121,105,133100,115500,248600
353820,202106,215,94,121,103400,134200,237600
353830,202106,55,46,9,50600,9900,60500
353850,202106,180,88,92,96800,101200,198000
353860,202106,505,219,286,240900,314600,555500
353870,202106,5408,2709,2699,2985400.26,2976600,5962000.26
353880,202106,692,460,232,506000,255200,761200
353890,202106,543,320,223,353100,245300.59,598400.59
353900,202106,128,67,61,73700,68200,141900
353910,202106,176,77,99,84700,108900,193600
353920,202106,413,225,188,248600,206800,455400
353930,202106,1030,600,430,660000,473000,1133000
353940,202106,195,100,95,110000,104500,214500
353950,202106,494,308,186,341000,204600,545600
353960,202106,78,63,15,69300,16500,85800
353970,202106,43,28,15,30800,16500,47300
353980,202106,1723,774,949,855800,1048300,1904100
353990,202106,75,43,32,47300,35200,82500
354000,202106,378,175,203,192500,223300,415800
354010,202106,93,54,39,59400,42900,102300
354020,202106,491,310,181,341000,200200,541200
354025,202106,34,30,4,34100,4400,38500
354030,202106,47,27,20,29700,22000,51700
354040,202106,91,68,23,74800,25300,100100
354050,202106,177,97,80,106700.63,88000,194700.63
354060,202106,740,353,387,389400,426800,816200
354070,202106,909,515,394,566500,433400,999900
354075,202106,178,82,96,90200,105600,195800
354080,202106,311,133,178,146300,195800,342100
354085,202106,22,13,9,14300,9900,24200
354090,202106,283,168,115,185807,127600,313407
354100,202106,5550,2249,3301,2476100.4,3639900,6116000.4
354105,202106,97,46,51,50600,56100,106700
354110,202106,45,23,22,25300,24200,49500
354120,202106,141,95,46,104500.93,50600,155100.93
354130,202106,700,430,270,474100.81,299200,773300.81
354140,202106,3155,1433,1722,1580700.55,1895300,3476000.55
354150,202106,625,367,258,403700.66,283800,687500.66
354160,202106,633,400,233,440000,256300,696300
354165,202106,16,13,3,15400,3300,18700
354170,202106,173,120,53,133100,58300,191400
354180,202106,58,35,23,38500.42,25300,63800.42
354190,202106,187,76,111,83600,122100,205700
354200,202106,108,56,52,61600,57200,118800
354210,202106,62,23,39,25300,42900,68200
354220,202106,624,398,226,437800.63,248600,686400.63
354230,202106,166,73,93,80300,103400,183700
354240,202106,326,207,119,227700.82,133100,360800.82
354250,202106,81,50,31,55000,34100,89100
354260,202106,2099,993,1106,1094500.5,1216600.85,2311101.35
354270,202106,87,64,23,70400,25300,95700
354280,202106,43,22,21,24200,23100,47300
354290,202106,140,96,44,105600,48400,154000
354300,202106,361,252,109,277200.63,119900,397100.63
354310,202106,91,69,22,75900,24200,100100
354320,202106,210,102,108,113300,118800,232100
354323,202106,10,9,1,9900,1100,11000
354325,202106,120,66,54,72600.83,59400,132000.83
354330,202106,2379,803,1576,883143,1735800,2618943
354340,202106,10175,4771,5404,5261068,5955400,11216468
354350,202106,140,90,50,99000,55000,154000
354360,202106,70,39,31,42900,34100,77000
354370,202106,235,122,113,134200,124300,258500
354380,202106,181,105,76,115500,83600,199100
354390,202106,2629,951,1678,1048300,1852400,2900700
354400,202106,297,167,130,183700,143000,326700
354410,202106,617,286,331,314600.5,366300,680900.5
354420,202106,261,168,93,187000,102300,289300
354425,202106,309,179,130,196951,143000,339951
354430,202106,186,105,81,115500,89100,204600
354440,202106,32,25,7,27500,7700,35200
354450,202106,52,34,18,37400,19800,57200
354460,202106,96,56,40,61600,44000,105600
354470,202106,27,14,13,15400,14300,29700
354480,202106,111,61,50,68200,55000,123200
354490,202106,135,83,52,91300,57200,148500
354500,202106,384,175,209,192500,231000,423500
354510,202106,91,62,29,68200,31900,100100
354515,202106,39,10,29,11000,31900,42900
354520,202106,1585,671,914,737943,1006500,1744443
354530,202106,784,392,392,431200,432300,863500
354540,202106,259,134,125,147400,137500,284900
354550,202106,38,23,15,25300,16500,41800
354560,202106,150,78,72,85800,79200,165000
354570,202106,136,94,42,103400,46200,149600
354580,202106,1795,848,947,932800,1046100,1978900
354600,202106,261,137,124,150700,136400,287100
354610,202106,66,56,10,61600,11000,72600
354620,202106,59,14,45,15400,49500,64900
354625,202106,14,9,5,9900,5500,15400
354630,202106,295,192,103,212300,116600,328900
354640,202106,809,504,305,555500.63,335500,891000.63
354650,202106,66,38,28,41800,30800,72600
354660,202106,782,574,208,632500.63,229900,862400.63
354670,202106,228,86,142,94600,158400,253000
354680,202106,1270,457,813,502700,897600,1400300
354690,202106,78,54,24,59400,26400,85800
354700,202106,74,51,23,56100,26400,82500
354710,202106,47,33,14,36300,16500,52800
354720,202106,19,19,0,20900,0,20900
354730,202106,1728,703,1025,773300,1127500,1900800
354740,202106,75,51,24,56100,26400,82500
354750,202106,418,244,174,268400,192500,460900
354760,202106,486,295,191,324500,210100,534600
354765,202106,9,4,5,4400,5500,9900
354770,202106,349,231,118,254100,129800,383900
354780,202106,8067,3101,4966,3419901.13,5468100,8888001.13
354790,202106,92,54,38,59400,41800,101200
354800,202106,444,244,200,268304.32,220000,488304.32
354805,202106,86,36,50,40700,55000,95700
354810,202106,108,65,43,71500,47300,118800
354820,202106,203,83,120,91300,132000,223300
354830,202106,42,23,19,25300,20900,46200
354840,202106,56,38,18,41800,19800,61600
354850,202106,4446,1950,2496,2148300.08,2746700.06,4895000.14
354860,202106,333,160,173,176000,190300,366300
354870,202106,11770,5184,6586,5710101.26,7255600,12965701.26
354880,202106,2667,987,1680,1087900.89,1852451.7,2940352.59
354890,202106,2844,1506,1338,1656601.52,1474000,3130601.52
354900,202106,66,44,22,48400,24200,72600
354910,202106,1250,638,612,701800,674300,1376100
354920,202106,41,33,8,36300,8800,45100
354925,202106,19,8,11,8800,12100,20900
354930,202106,36,32,4,35200.4,4400,39600.4
354940,202106,769,554,215,611600,237600,849200
354950,202106,205,126,79,138600,86900,225500
354960,202106,138,52,86,57200,94600,151800
354970,202106,990,669,321,735901.26,354200,1090101.26
354980,202106,8780,3115,5665,3433102.23,6239200.39,9672302.62
354990,202106,9494,4263,5231,4699200,5764000.46,10463200.46
354995,202106,533,167,366,184800,403700,588500
355000,202106,457,158,299,173800,330000,503800
355010,202106,574,352,222,389400,245300.63,634700.63
355020,202106,780,484,296,533500,326700,860200
355030,202106,206391,77882,128509,85801247.71,141570044.95,227371292.66
355040,202106,810,369,441,405900,485100,891000
355050,202106,152,87,65,95700,72600,168300
355060,202106,1647,803,844,883300,929500,1812800
355070,202106,1477,688,789,756800.08,869000.73,1625800.81
355080,202106,189,116,73,128700,81400,210100
355090,202106,288,171,117,188100,129800.57,317900.57
355100,202106,5014,2386,2628,2631090,2900700,5531790
355110,202106,234,156,78,171600,85800,257400
355120,202106,55,35,20,38500,22000,60500
355130,202106,49,29,20,31900,22000,53900
355140,202106,184,110,74,122100,81400,203500
355150,202106,656,382,274,420200,301400,721600
355160,202106,469,225,244,248600.63,268400,517000.63
355170,202106,2003,1036,967,1144000,1065900,2209900
355180,202106,677,276,401,303600,442200,745800
355190,202106,212,141,71,155100,78100,233200
355200,202106,107,59,48,66000,52800,118800
355210,202106,687,380,307,418000,337700,755700
355220,202106,7219,3649,3570,4019400,3936900,7956300
355230,202106,98,60,38,66000,41800,107800
355240,202106,4441,1826,2615,2011900.5,2880900,4892800.5
355250,202106,5915,2586,3329,2850121.63,3667400,6517521.63
355255,202106,48,27,21,29700,23100,52800
355260,202106,174,107,67,118800,73700,192500
355270,202106,167,109,58,119900,63800,183700
355280,202106,6511,2476,4035,2726900,4441800,7168700
355290,202106,72,59,13,64900,14300,79200
355300,202106,207,120,87,132000,95700,227700
355310,202106,108,57,51,62700,56100,118800
355320,202106,93,49,44,53900,48400,102300
355330,202106,277,156,121,171600,134200,305800
355340,202106,1440,490,950,539000.55,1046100,1585100.55
355350,202106,154,75,79,82500,86900,169400
355360,202106,174,115,59,126500,64900,191400
355365,202106,18,14,4,15400,4400,19800
355370,202106,1021,608,413,668800.63,455400,1124200.63
355380,202106,801,496,305,545600,335500,881100
355385,202106,76,52,24,57200,26400,83600
355390,202106,110,59,51,64900,56100,121000
355395,202106,188,102,86,112200.5,94600,206800.5
355400,202106,1705,995,710,1098809,782100.63,1880909.63
355410,202106,4882,2279,2603,2510200,2867700,5377900
355420,202106,49,35,14,38500,15400,53900
355430,202106,396,244,152,268400,167200,435600
355440,202106,82,50,32,55000,35200,90200
355450,202106,422,206,216,226600,238700,465300
355460,202106,58,46,12,50600,13200,63800
355465,202106,44,26,18,28600,19800,48400
355470,202106,182,73,109,80300,119900,200200
355475,202106,13,9,4,9900,4400,14300
355480,202106,565,231,334,254100,367400,621500
355490,202106,111,76,35,83600,38500,122100
355495,202106,66,23,43,25300,47300,72600
355500,202106,1558,859,699,944900.48,771100,1716000.48
355510,202106,266,192,74,212300.63,82500,294800.63
355520,202106,30,22,8,24200,8800,33000
355530,202106,23,12,11,13200,12100,25300
355535,202106,75,34,41,37400,45100,82500
355540,202106,2536,980,1556,1079255.1,1711600.63,2790855.73
355550,202106,60,36,24,40700,26400,67100
355560,202106,244,114,130,125400,143000,268400
355570,202106,20,13,7,14300,7700,22000
355580,202106,242,171,71,188100,78100,266200
355590,202106,16,9,7,9900,7700,17600
355600,202106,268,137,131,150700,144100,294800
355610,202106,222,146,76,160600,83600,244200
355620,202106,1289,561,728,619300,803000,1422300
355630,202106,418,311,107,342100,117700.63,459800.63
355635,202106,122,55,67,60500,73700,134200
355640,202106,535,296,239,325600,262900,588500
355645,202106,856,333,523,366300,575300,941600
355650,202106,1911,810,1101,891000,1214400,2105400
355660,202106,235,122,113,135300,124300,259600
355670,202106,581,243,338,268400,374000,642400
355680,202106,201,109,92,119900,102300,222200
355690,202106,90,43,47,47300,52800,100100
355695,202106,22,13,9,14300,9900,24200
355700,202106,1143,584,559,642400,614900,1257300
355710,202106,2196,1187,1009,1306800,1112100,2418900
355715,202106,13,11,2,12100,2200,14300
355720,202106,234,142,92,156200,101200,257400
355730,202106,101,58,43,63800,47300,111100
410010,202106,132,104,28,114400,30800,145200
410020,202106,116,87,29,95700,31900,127600
410030,202106,172,95,77,104500,84700,189200
410040,202106,1229,608,621,668800,684200,1353000
410045,202106,42,32,10,35200,11000,46200
410050,202106,487,274,213,301400,234300,535700
410060,202106,281,201,80,221100,88000,309100
410070,202106,280,232,48,255200,52800,308000
410080,202106,175,102,73,115500,80300,195800
410090,202106,71,61,10,67100,11000,78100
410100,202106,292,197,95,216700,104500,321200
410105,202106,45,26,19,28600,20900,49500
410110,202106,328,194,134,213400,148500,361900
410115,202106,37,22,15,24200,16500,40700
410120,202106,426,197,229,216700,253000,469700
410130,202106,55,33,22,36300,24200,60500
410140,202106,3132,1429,1703,1574100.03,1874400.88,3448500.91
410150,202106,2651,1017,1634,1119800,1798500,2918300
410160,202106,494,294,200,323400,220000,543400
410165,202106,48,29,19,31900,20900,52800
410170,202106,182,113,69,124300,75900,200200
410180,202106,2262,1227,1035,1351900,1139600,2491500
410185,202106,30,26,4,28600,4400,33000
410190,202106,489,305,184,335500,203500,539000
410200,202106,942,662,280,729300,309100,1038400
410210,202106,609,303,306,334400,337700,672100
410220,202106,47,21,26,23100,28600,51700
410230,202106,160,71,89,78100,97900,176000
410240,202106,738,462,276,509300,303600,812900
410250,202106,371,260,111,286000,122100,408100
410260,202106,300,165,135,181500,148500,330000
410270,202106,29,22,7,24200,7700,31900
410275,202106,57,41,16,45100,17600,62700
410280,202106,321,181,140,199100,154000,353100
410290,202106,255,145,110,160600,121000,281600
410300,202106,82,54,28,59400,30800,90200
410302,202106,24,15,9,16500,9900,26400
410304,202106,34,23,11,25300,12100,37400
410305,202106,222,115,107,126500,117700,244200
410310,202106,210,123,87,135300,95700,231000
410315,202106,45,32,13,35200,14300,49500
410320,202106,136,89,47,99000,51700,150700
410322,202106,31,18,13,19800,14300,34100
410330,202106,181,119,62,130900,68200,199100
410335,202106,102,57,45,62700,49500,112200
410337,202106,45,34,11,37400,12100,49500
410340,202106,40,32,8,35200,8800,44000
410345,202106,206,117,89,128700,99000,227700
410347,202106,46,35,11,38500,12100,50600
410350,202106,255,142,113,156200,124300,280500
410360,202106,449,280,169,308000,185900,493900
410370,202106,2308,939,1369,1034000,1508100,2542100
410380,202106,199,117,82,129800,90200,220000
410390,202106,384,257,127,282700,139700,422400
410395,202106,36,22,14,24200,15400,39600
410400,202106,862,372,490,409200.5,539000,948200.5
410405,202106,83,62,21,68200,23100,91300
410410,202106,28,18,10,19800,11000,30800
410420,202106,1711,786,925,868902.1,1018600,1887502.1
410425,202106,183,69,114,75900,125400,201300
410430,202106,2293,1229,1064,1355200,1174800,2530000
410440,202106,372,266,106,292600,116600,409200
410442,202106,363,235,128,258500,140800,399300
410445,202106,423,302,121,332200,134200,466400
410450,202106,385,190,195,209000,214500,423500
410460,202106,549,278,271,305800,298100,603900
410465,202106,237,135,102,148500,112200,260700
410470,202106,249,144,105,158400,116600,275000
410480,202106,6318,2950,3368,3251600,3710300,6961900
410490,202106,1431,835,596,918500,655600,1574100
410500,202106,272,154,118,169400,129800,299200
410510,202106,175,127,48,139700,53900,193600
410520,202106,260,189,71,209000,78100,287100
410530,202106,307,100,207,110000,227700,337700
410540,202106,326,240,86,264000,94600,358600
410550,202106,1703,695,1008,764500,1111000.72,1875500.72
410560,202106,149,104,45,114400,49500,163900
410570,202106,434,289,145,317900,159500,477400
410580,202106,3546,1476,2070,1628001.04,2284700,3912701.04
410590,202106,398,258,140,283781,154000,437781
410600,202106,194,166,28,182600,30800,213400
410610,202106,50,42,8,46200,8800,55000
410620,202106,262,172,90,189200.4,99000,288200.4
410630,202106,442,239,203,262900,223300,486200
410640,202106,1019,630,389,696300,429000,1125300
410645,202106,109,77,32,84700,35200,119900
410650,202106,364,227,137,249700,151800,401500
410655,202106,90,63,27,69300,30800,100100
410657,202106,31,11,20,12100,22000,34100
410660,202106,622,414,208,455400.5,228800,684200.5
410670,202106,73,60,13,66000,14300,80300
410680,202106,196,158,38,173800,42900,216700
410685,202106,27,17,10,18700,11000,29700
410690,202106,28522,11752,16770,12959100,18488800.74,31447900.74
410700,202106,322,236,86,259600,94600,354200
410710,202106,128,103,25,113300,27500,140800
410712,202106,43,29,14,31900,15400,47300
410715,202106,89,67,22,73700,24200,97900
410720,202106,680,381,299,420200.92,328900,749100.92
410725,202106,177,125,52,137500,58300,195800
410730,202106,97,45,52,49500,57200,106700
410740,202106,108,73,35,80300,38500,118800
410750,202106,287,187,100,206800,111100,317900
410752,202106,21,13,8,14300,8800,23100
410753,202106,59,23,36,25300,39600,64900
410754,202106,54,27,27,29700,29700,59400
410755,202106,80,46,34,51700,37400,89100
410760,202106,767,414,353,455400,389400,844800
410765,202106,1809,818,991,899800,1092300,1992100
410770,202106,115,84,31,92400,34100,126500
410773,202106,58,39,19,42900,20900,63800
410775,202106,183,135,48,149600,52800,202400
410780,202106,89,49,40,53900,44000,97900
410785,202106,56,45,11,49500,12100,61600
410790,202106,88,37,51,40700,56100,96800
410800,202106,281,175,106,192500,117700,310200
410810,202106,23,13,10,14300,11000,25300
410820,202106,170,119,51,130900,56100,187000
410830,202106,8730,3647,5083,4013900.4,5611100,9625000.4
410832,202106,106,71,35,78100,38500,116600
410840,202106,1451,763,688,842600.21,757900,1600500.21
410845,202106,48,28,20,30800,22000,52800
410850,202106,180,127,53,139700,58300,198000
410855,202106,67,57,10,62700,11000,73700
410860,202106,763,385,378,423500,416900,840400
410865,202106,98,71,27,78100,29700,107800
410870,202106,145,123,22,135300,24200,159500
410880,202106,1150,567,583,623700,642400,1266100
410890,202106,87,61,26,67100,28600,95700
410895,202106,74,56,18,61600,19800,81400
410900,202106,25,17,8,18700,8800,27500
410910,202106,18,12,6,13200,6600,19800
410920,202106,37,23,14,25300,15400,40700
410930,202106,540,330,210,363000,231000,594000
410940,202106,4399,2332,2067,2571800.6,2279200,4851000.6
410950,202106,103,75,28,82500,30800,113300
410960,202106,857,333,524,367400,576400,943800
410965,202106,67,44,23,48400,25300,73700
410970,202106,615,424,191,467500,211200,678700
410975,202106,132,81,51,89100.38,56100,145200.38
410980,202106,1629,715,914,787600,1005400,1793000
410990,202106,273,192,81,211200,89100,300300
411000,202106,65,37,28,40700,30800,71500
411005,202106,26,21,5,24200,5500,29700
411007,202106,250,142,108,157300,118800,276100
411010,202106,600,392,208,432300,228800,661100
411020,202106,290,189,101,209000,111100,320100
411030,202106,20,11,9,12100,9900,22000
411040,202106,56,38,18,41800,19800,61600
411050,202106,219,160,59,176000,64900,240900
411060,202106,526,353,173,388300,190300,578600
411065,202106,51,46,5,50600,5500,56100
411070,202106,1265,733,532,807400,586300,1393700
411080,202106,246,173,73,190300,80300,270600
411090,202106,95,73,22,80300,24200,104500
411095,202106,312,111,201,122100,221100,343200
411100,202106,121,95,26,104500,29700,134200
411110,202106,132,78,54,85800,59400,145200
411120,202106,220,142,78,156200,85800,242000
411125,202106,258,114,144,125400,158400,283800
411130,202106,121,101,20,112200,22000,134200
411140,202106,216,144,72,158400,80300,238700
411150,202106,1242,801,441,883300,487300.63,1370600.63
411155,202106,124,84,40,92400.01,44000,136400.01
411160,202106,28,12,16,13200,17600,30800
411170,202106,48,43,5,47300,5500,52800
411180,202106,982,636,346,700700,381700,1082400
411190,202106,328,184,144,202400,159500,361900
411200,202106,661,394,267,435600.63,294800,730400.63
411210,202106,676,351,325,386100,357500,743600
411220,202106,162,109,53,121000,58300,179300
411230,202106,38,31,7,34100,7700,41800
411240,202106,114,69,45,75900,49500,125400
411250,202106,426,306,120,336600,132000,468600
411260,202106,14,10,4,12100,4400,16500
411270,202106,266,138,128,151800,141900,293700
411275,202106,183,158,25,173800,27500,201300
411280,202106,200,140,60,155100.63,66000,221100.63
411290,202106,62,48,14,52800,15400,68200
411295,202106,128,102,26,112200,28600,140800
411300,202106,80,35,45,38500,49500,88000
411310,202106,94,69,25,75900,27500,103400
411320,202106,796,513,283,567600,311300,878900
411325,202106,54,37,17,40700,18700,59400
411330,202106,908,587,321,646800,353100.15,999900.15
411340,202106,29,18,11,19800,12100,31900
411342,202106,58,43,15,47300,16500,63800
411345,202106,114,57,57,63800,62700,126500
411350,202106,500,371,129,408100,143000,551100
411360,202106,55,34,21,37400,23100,60500
411370,202106,14176,5594,8582,6160001.26,9457802.29,15617803.55
411373,202106,181,120,61,132000,67100,199100
411375,202106,81,65,16,71500,17600,89100
411380,202106,84,61,23,67100,25300,92400
411390,202106,129,74,55,82500,60500,143000
411400,202106,402,279,123,306900,135300,442200
411410,202106,464,212,252,234300,277200,511500
411420,202106,974,413,561,454300,617100,1071400
411430,202106,497,270,227,297000,249700,546700
411435,202106,31,18,13,19800,14300,34100
411440,202106,474,368,106,405900,117700,523600
411450,202106,418,353,65,389400,71500,460900
411460,202106,782,290,492,320100,541200,861300
411470,202106,97,66,31,72600,34100,106700
411480,202106,694,365,329,401500,361900,763400
411490,202106,288,184,104,203500,114400,317900
411500,202106,100,80,20,88000,22000,110000
411510,202106,217,170,47,187000,51700,238700
411520,202106,6054,2152,3902,2370500.5,4299900.7,6670401.2
411530,202106,125,84,41,92400,45100,137500
411535,202106,51,19,32,20900,35200,56100
411540,202106,363,244,119,268400,132000,400400
411545,202106,55,39,16,42900,17600,60500
411550,202106,82,61,21,67100,23100,90200
411560,202106,401,162,239,180400,262900,443300
411570,202106,894,312,582,344300,641300,985600
411573,202106,24,14,10,15400,11000,26400
411575,202106,303,184,119,202400,130900,333300
411580,202106,1258,445,813,489500,895400,1384900
411585,202106,73,34,39,37400,42900,80300
411590,202106,18,12,6,13200,6600,19800
411600,202106,23,10,13,11000,14300,25300
411605,202106,249,95,154,105600,169400,275000
411610,202106,209,132,77,145200,84700,229900
411620,202106,382,196,186,216700,204600,421300
411630,202106,52,36,16,39600,17600,57200
411640,202106,31,22,9,24200,9900,34100
411650,202106,9,6,3,6600,3300,9900
411660,202106,40,27,13,29700,14300,44000
411670,202106,235,165,70,181500,77000,258500
411680,202106,165,132,33,145200,36300,181500
411690,202106,604,314,290,345400,321200,666600
411695,202106,66,46,20,50600,22000,72600
411700,202106,142,113,29,125400,31900,157300
411705,202106,107,70,37,77000,40700,117700
411710,202106,291,194,97,213400,106700,320100
411720,202106,131,86,45,94600,49500,144100
411721,202106,76,60,16,66000,17600,83600
411722,202106,108,43,65,47300,71500,118800
411725,202106,162,117,45,129800,49500,179300
411727,202106,94,72,22,79200,24200,103400
411729,202106,42,31,11,34100,12100,46200
411730,202106,554,343,211,377300,232100,609400
411740,202106,32,18,14,19800,15400,35200
411745,202106,65,47,18,51700,19800,71500
411750,202106,839,358,481,396000,530200,926200
411760,202106,1175,855,320,940500,352000,1292500
411770,202106,446,294,152,323400,168300,491700
411780,202106,356,231,125,254100,137500,391600
411790,202106,545,298,247,328900.18,271700,600600.18
411800,202106,147,109,38,119900.65,41800,161700.65
411810,202106,180,133,47,146300,52800,199100
411820,202106,2324,979,1345,1076900,1486100,2563000
411830,202106,9,9,0,9900,0,9900
411840,202106,2060,1215,845,1337600,931700,2269300
411845,202106,61,21,40,23100,44000,67100
411850,202106,1217,658,559,726000,618200,1344200
411860,202106,47,30,17,33000,18700,51700
411870,202106,69,42,27,46200,29700,75900
411880,202106,433,262,171,288200,188100,476300
411885,202106,100,60,40,66000,44000,110000
411890,202106,303,199,104,218900,114400,333300
411900,202106,98,68,30,74800,33000,107800
411910,202106,182,138,44,152900,48400,201300
411915,202106,2279,892,1387,984500,1530100,2514600
411920,202106,117,90,27,99000,29700,128700
411925,202106,14,9,5,9900,5500,15400
411930,202106,807,572,235,630370.4,258500,888870.4
411940,202106,581,374,207,411400,227700,639100
411950,202106,1105,509,596,561000.24,656700,1217700.24
411960,202106,1109,716,393,787600,432300,1219900
411965,202106,24,14,10,15400,11000,26400
411970,202106,93,79,14,86900,15400,102300
411980,202106,190,106,84,116600,92400,209000
411990,202106,5114,2814,2300,3100901.42,2535571.5,5636472.92
411995,202106,568,180,388,198000,426800,624800
412000,202106,320,203,117,224400,129800,354200
412010,202106,44,27,17,29700,18700,48400
412015,202106,38,29,9,31900,9900,41800
412020,202106,19,15,4,16500,4400,20900
412030,202106,44,41,3,45100,3300,48400
412033,202106,56,31,25,34100,27500,61600
412035,202106,72,45,27,49500,29700,79200
412040,202106,39,21,18,23100,19800,42900
412050,202106,211,156,55,171600,60500,232100
412060,202106,774,561,213,617100,234300,851400
412065,202106,50,30,20,33000,22000,55000
412070,202106,170,119,51,130900,56100,187000
412080,202106,308,147,161,161700,177100,338800
412085,202106,38,15,23,16500,25300,41800
412090,202106,834,515,319,567600,352000,919600
412100,202106,262,217,45,238700,49500,288200
412110,202106,69,53,16,58300,17600,75900
412120,202106,337,189,148,209000,162800,371800
412125,202106,73,48,25,52800,27500,80300
412130,202106,41,25,16,27500,17600,45100
412135,202106,28,16,12,17600,13200,30800
412140,202106,369,233,136,256300,149600,405900
412150,202106,242,156,86,171600,94600,266200
412160,202106,90,52,38,57200,41800,99000
412170,202106,704,480,224,528000,246400,774400
412175,202106,34,26,8,28600,8800,37400
412180,202106,187,141,46,155100,50600,205700
412190,202106,317,248,69,272800,78100,350900
412200,202106,185,115,70,126500,77000,203500
412210,202106,94,70,24,77000,26400,103400
412215,202106,238,158,80,173800,88000,261800
412217,202106,61,50,11,55000,12100,67100
412220,202106,823,565,258,622600,283800,906400
412230,202106,311,188,123,206800,135300,342100
412240,202106,1335,646,689,711700,759000,1470700
412250,202106,410,251,159,277200,174900,452100
412260,202106,109,74,35,81400,38500,119900
412265,202106,181,135,46,148500,50600,199100
412270,202106,89,60,29,66000,31900,97900
412280,202106,90,70,20,77000,22000,99000
412290,202106,92,62,30,69300,33000,102300
412300,202106,209,141,68,155100,74800,229900
412310,202106,52,42,10,46200,11000,57200
412320,202106,92,75,17,82500,18700,101200
412330,202106,180,149,31,163900,34100,198000
412340,202106,161,112,49,123200,53900,177100
412350,202106,646,299,347,328900,381700,710600
412360,202106,25,21,4,23100,4400,27500
412370,202106,157,134,23,148500,25300,173800
412380,202106,226,170,56,187000,61600,248600
412382,202106,58,33,25,36300,27500,63800
412385,202106,155,109,46,119900,50600,170500
412390,202106,300,224,76,246400,83600,330000
412395,202106,70,57,13,62700,14300,77000
412400,202106,96,64,32,70400,35200,105600
412402,202106,230,114,116,125400,127600,253000
412405,202106,910,306,604,336600,664400,1001000
412410,202106,964,577,387,634700,427900,1062600
412420,202106,18,17,1,18700,1100,19800
412430,202106,21,19,2,20900,2200,23100
412440,202106,632,328,304,361900,335500,697400
412450,202106,77,68,9,74800,9900,84700
412460,202106,91,69,22,75900,24200,100100
412470,202106,217,171,46,188100,50600,238700
412480,202106,146,105,41,115500,45100,160600
412490,202106,158,137,21,150700,23100,173800
412500,202106,419,333,86,367400.44,94600,462000.44
412510,202106,166,135,31,149783.33,34100,183883.33
412520,202106,93,59,34,66000,37400,103400
412530,202106,107,53,54,58300,59400,117700
412535,202106,88,65,23,71500,25300,96800
412540,202106,83,40,43,44000,48400,92400
412545,202106,86,58,28,63800,30800,94600
412550,202106,3957,1597,2360,1757800.56,2600400,4358200.56
412555,202106,10,6,4,6600,4400,11000
412560,202106,635,431,204,476300,225500,701800
412570,202106,789,379,410,416900,453200,870100
412575,202106,95,65,30,71500,33000,104500
412580,202106,173,116,57,127600,62700,190300
412590,202106,33,29,4,31900,4400,36300
412600,202106,177,125,52,138600,57200,195800
412610,202106,33,13,20,14300,22000,36300
412620,202106,149,124,25,136400,27500,163900
412625,202106,2109,1046,1063,1152800.63,1170400,2323200.63
412627,202106,70,51,19,56100,20900,77000
412630,202106,393,254,139,280500,152900,433400
412635,202106,70,19,51,22000,56100,78100
412640,202106,102,73,29,80300,31900,112200
412650,202106,330,215,115,236500,126500,363000
412660,202106,457,265,192,291500,211200,502700
412665,202106,43,38,5,41800,5500,47300
412667,202106,304,194,110,213400,121000,334400
412670,202106,70,57,13,62700,14300,77000
412680,202106,304,226,78,248600,85800,334400
412690,202106,117,74,43,81400,47300,128700
412700,202106,173,114,59,125400,64900,190300
412710,202106,1313,756,557,837100,616000,1453100
412720,202106,233,137,96,150700,106700,257400
412730,202106,182,153,29,168300,31900,200200
412740,202106,423,211,212,232100,233200,465300
412750,202106,428,234,194,258500,213400,471900
412760,202106,308,150,158,165000,173800,338800
412770,202106,2121,1150,971,1267200.63,1069200,2336400.63
412780,202106,140,104,36,114400,39600,154000
412785,202106,304,145,159,159500,174900,334400
412788,202106,41,24,17,26400,18700,45100
412790,202106,119,96,23,105600,25300,130900
412795,202106,152,107,45,117700,49500,167200
412796,202106,304,193,111,213400,122100,335500
412800,202106,645,379,266,419100,293700,712800
412810,202106,3006,1589,1417,1750100.59,1562000,3312100.59
412820,202106,938,560,378,617100,415800,1032900
412830,202106,13,10,3,11000,3300,14300
412840,202106,234,158,76,173800,84700,258500
412850,202106,739,462,277,509300,304700,814000
412853,202106,170,81,89,89100,97900,187000
412855,202106,194,101,93,111100.26,102300,213400.26
412860,202106,97,66,31,72600,34100,106700
412862,202106,60,37,23,40700,26400,67100
412863,202106,9,7,2,7700,2200,9900
412865,202106,41,30,11,34100,12100,46200
412870,202106,106,62,44,68200,48400,116600
412880,202106,92,64,28,70400,30800,101200
420005,202106,41,37,4,40700,4400,45100
420010,202106,368,233,135,256300,148500,404800
420020,202106,80,66,14,72600,15400,88000
420030,202106,25,21,4,23100,4400,27500
420040,202106,98,76,22,83600,24200,107800
420050,202106,56,33,23,36300,25300,61600
420055,202106,17,17,0,18700,0,18700
420060,202106,27,20,7,22000,7700,29700
420070,202106,104,88,16,97900,17600,115500
420075,202106,11,11,0,12100,0,12100
420080,202106,43,38,5,41800,5500,47300
420090,202106,38,32,6,35200,6600,41800
420100,202106,154,131,23,144100,26400,170500
420110,202106,20,20,0,22000,0,22000
420120,202106,57,41,16,45100,17600,62700
420125,202106,84,64,20,70400,22000,92400
420127,202106,32,26,6,28600,6600,35200
420130,202106,443,261,182,288200,201300,489500
420140,202106,1302,719,583,793100,641300,1434400
420150,202106,46,36,10,39600,11000,50600
420160,202106,29,27,2,29700,2200,31900
420165,202106,16,11,5,12100,5500,17600
420170,202106,63,37,26,40700,28600,69300
420180,202106,21,18,3,19800,3300,23100
420190,202106,25,22,3,24200,3300,27500
420195,202106,138,67,71,73700,78100,151800
420200,202106,1274,548,726,603900,799700,1403600
420205,202106,91,51,40,56100,44000,100100
420207,202106,131,71,60,78100,66000,144100
420208,202106,21,16,5,17600,5500,23100
420209,202106,15,13,2,14300,2200,16500
420210,202106,531,247,284,271700,314600,586300
420213,202106,47,35,12,38500,13200,51700
420215,202106,28,24,4,26400,4400,30800
420220,202106,60,36,24,39600,26400,66000
420230,202106,859,501,358,551100,394900,946000
420240,202106,2188,1408,780,1551000,858000,2409000
420243,202106,43,34,9,37400,9900,47300
420245,202106,181,92,89,101200,97900,199100
420250,202106,61,41,20,45100,22000,67100
420253,202106,26,20,6,22000,6600,28600
420257,202106,12,9,3,9900,3300,13200
420260,202106,101,81,20,89100,22000,111100
420270,202106,29,23,6,25300,6600,31900
420280,202106,285,215,70,239800,77000,316800
420285,202106,22,15,7,16500,7700,24200
420287,202106,48,32,16,35200,17600,52800
420290,202106,951,647,304,712800,334400,1047200
420300,202106,1454,1149,305,1263900,336600,1600500
420310,202106,49,33,16,36300,18700,55000
420315,202106,32,25,7,27500,7700,35200
420320,202106,980,463,517,510400,569800,1080200
420325,202106,3,1,2,1100,2200,3300
420330,202106,126,81,45,89100,49500,138600
420340,202106,168,114,54,125400,59400,184800
420350,202106,255,176,79,193600,86900,280500
420360,202106,694,531,163,584100.88,180400,764500.88
420370,202106,129,74,55,81400,60500,141900
420380,202106,1192,818,374,902000,412500,1314500
420390,202106,232,161,71,177100,79200,256300
420395,202106,191,135,56,148500,61600,210100
420400,202106,244,188,56,206800,61600,268400
420410,202106,58,44,14,48400,15400,63800
420415,202106,32,27,5,29700,5500,35200
420417,202106,53,42,11,46200,12100,58300
420419,202106,12,11,1,12100,1100,13200
420420,202106,2785,1720,1065,1894200.48,1172600,3066800.48
420425,202106,72,58,14,63800,15400,79200
420430,202106,1124,807,317,887700,349800,1237500
420435,202106,14,12,2,13200,2200,15400
420440,202106,98,70,28,78100,30800,108900
420445,202106,27,26,1,28600,1100,29700
420450,202106,80,35,45,38500,49500,88000
420455,202106,201,152,49,167200,53900,221100
420460,202106,2312,1464,848,1611500,932800,2544300
420470,202106,97,69,28,75900,30800,106700
420475,202106,9,8,1,8800,1100,9900
420480,202106,862,647,215,711700,236500,948200
420490,202106,99,72,27,79200,29700,108900
420500,202106,452,238,214,262900.26,235400,498300.26
420510,202106,20,19,1,20900,1100,22000
420515,202106,28,16,12,17600,13200,30800
420517,202106,9,9,0,9900,0,9900
420519,202106,0,,,,,0.0
420520,202106,63,48,15,52800,16500,69300
420530,202106,155,100,55,110000,60500,170500
420535,202106,19,17,2,18700,2200,20900
420540,202106,5743,3476,2267,3832675,2495900,6328575
420543,202106,31,29,2,31900,2200,34100
420545,202106,211,149,62,163900,68200,232100
420550,202106,825,679,146,746900,160600,907500
420555,202106,28,17,11,18700,12100,30800
420560,202106,61,50,11,55000,12100,67100
420570,202106,179,98,81,107800,89100,196900
420580,202106,281,133,148,147400,162800,310200
420590,202106,473,311,162,343200,178200,521400
420600,202106,139,75,64,82500,70400,152900
420610,202106,39,35,4,38500,4400,42900
420620,202106,82,62,20,68200,22000,90200
420630,202106,146,92,54,101200,59400,160600
420640,202106,79,69,10,77000,11000,88000
420650,202106,254,123,131,135300,144100,279400
420660,202106,46,37,9,40700,9900,50600
420665,202106,43,28,15,30800,16500,47300
420670,202106,285,224,61,246400,67100,313500
420675,202106,13,11,2,12100,2200,14300
420680,202106,36,26,10,28600,11000,39600
420690,202106,180,138,42,151800,46200,198000
420700,202106,687,451,236,498300.7,261800,760100.7
420710,202106,146,76,70,83600,77000,160600
420720,202106,104,83,21,91300,24200,115500
420730,202106,646,388,258,426800,283800,710600
420740,202106,54,53,1,58300,1100,59400
420750,202106,467,307,160,339900,177100,517000
420757,202106,18,16,2,17600,2200,19800
420760,202106,37,29,8,31900,8800,40700
420765,202106,82,60,22,66000,24200,90200
420768,202106,48,40,8,44000,8800,52800
420770,202106,73,60,13,67100,14300,81400
420775,202106,40,37,3,40700,3300,44000
420780,202106,204,160,44,177100,48400,225500
420785,202106,21,13,8,14300,8800,23100
420790,202106,153,125,28,137500,30800,168300
420800,202106,63,46,17,50600,18700,69300
420810,202106,261,212,49,234300,53900,288200
420820,202106,2413,1343,1070,1478473.33,1179200.5,2657673.83
420830,202106,623,326,297,358600,328900,687500
420840,202106,152,105,47,115500,51700,167200
420845,202106,412,171,241,188100,265100,453200
420850,202106,252,186,66,204600,73700,278300
420860,202106,56,44,12,48400,13200,61600
420870,202106,132,92,40,101200,44000,145200
420880,202106,180,114,66,125400,72600,198000
420890,202106,956,465,491,511500,541200,1052700
420895,202106,8,8,0,8800,0,8800
420900,202106,404,319,85,350900,93500,444400
420910,202106,5726,3070,2656,3388001.3,2924900,6312901.3
420915,202106,59,54,5,59400,5500,64900
420917,202106,22,15,7,16500,7700,24200
420920,202106,21,14,7,15400,7700,23100
420930,202106,2893,1814,1079,1998629,1191300.68,3189929.68
420940,202106,587,429,158,473000.79,173800,646800.79
420945,202106,10,7,3,7700,3300,11000
420950,202106,52,44,8,48400,8800,57200
420960,202106,110,90,20,99000,22000,121000
420970,202106,282,227,55,249700,60500,310200
420980,202106,23,22,1,24200,1100,25300
420985,202106,56,50,6,55000,6600,61600
420990,202106,82,60,22,66000,24200,90200
421000,202106,46,26,20,28600,22000,50600
421003,202106,46,32,14,35200,15400,50600
421005,202106,6,3,3,3300,3300,6600
421010,202106,804,522,282,574200,311300,885500
421020,202106,24,18,6,19800,6600,26400
421030,202106,115,98,17,107800,18700,126500
421040,202106,71,52,19,58300,20900,79200
421050,202106,338,231,107,255200,117700,372900
421055,202106,20,15,5,16500,5500,22000
421060,202106,91,49,42,53900,46200,100100
421070,202106,36,30,6,33000,6600,39600
421080,202106,37,31,6,34100,6600,40700
421085,202106,22,18,4,19800,4400,24200
421090,202106,34,26,8,28600,8800,37400
421100,202106,121,88,33,97900,36300,134200
421105,202106,188,152,36,167200,39600,206800
421110,202106,115,86,29,94600,31900,126500
421120,202106,179,131,48,144100.92,52800,196900.92
421125,202106,18,12,6,13200,6600,19800
421130,202106,839,514,325,565400,358600,924000
421140,202106,33,22,11,24200,12100,36300
421145,202106,47,35,12,38500,13200,51700
421150,202106,97,70,27,77000,29700.09,106700.09
421160,202106,66,43,23,47300,25300,72600
421165,202106,16,13,3,14300,3300,17600
421170,202106,180,151,29,166232,31900,198132
421175,202106,165,111,54,122100,59400,181500
421180,202106,42,28,14,30800,16500,47300
421185,202106,16,12,4,13200,4400,17600
421187,202106,1,0,1,0,1100,1100
421189,202106,45,31,14,34100,15400,49500
421190,202106,1751,1086,665,1199000,733700,1932700
421200,202106,93,67,26,74800,28600,103400
421205,202106,27,18,9,19800,9900,29700
421210,202106,177,123,54,135300,59400,194700
421220,202106,257,198,59,221100,64900,286000
421223,202106,46,35,11,38500,12100,50600
421225,202106,69,43,26,47300,28600,75900
421227,202106,80,63,17,69300,18700,88000
421230,202106,59,43,16,47300,17600,64900
421240,202106,17,17,0,18700,0,18700
421250,202106,371,213,158,234300,174900,409200
421260,202106,22,18,4,19800,4400,24200
421265,202106,2,2,0,2200,0,2200
421270,202106,49,43,6,47300,6600,53900
421280,202106,351,182,169,200200,185900,386100
421290,202106,325,213,112,235400,123200,358600
421300,202106,23,18,5,20900,5500,26400
421310,202106,51,34,17,37400,18700,56100
421315,202106,31,17,14,18700,15400,34100
421320,202106,124,78,46,85800,50600,136400
421330,202106,106,77,29,84700,31900,116600
421335,202106,40,28,12,30800,13200,44000
421340,202106,245,158,87,173800,95700,269500
421350,202106,184,109,75,119900.39,82500,202400.39
421360,202106,681,476,205,523600,226600,750200
421370,202106,188,139,49,154000,53900,207900
421380,202106,131,102,29,112200,31900,144100
421390,202106,16,10,6,11000,6600,17600
421400,202106,117,98,19,107800,20900,128700
421410,202106,21,18,3,19800,3300,23100
421415,202106,20,18,2,19800,2200,22000
421420,202106,105,89,16,97900,17600,115500
421430,202106,17,12,5,13200,5500,18700
421440,202106,59,52,7,57200,7700,64900
421450,202106,88,72,16,79200,17600.51,96800.51
421460,202106,58,44,14,48400,15400,63800
421470,202106,71,40,31,44000,34100,78100
421480,202106,745,563,182,620400,201300,821700
421490,202106,26,25,1,28600,1100,29700
421500,202106,486,302,184,332200,202400,534600
421505,202106,22,16,6,17600,6600,24200
421507,202106,33,26,7,28600,7700,36300
421510,202106,69,45,24,49500,27500,77000
421520,202106,55,45,10,49500,11000,60500
421530,202106,53,44,9,48400,9900,58300
421535,202106,19,18,1,19800,1100,20900
421540,202106,51,40,11,44000,12100,56100
421545,202106,85,61,24,67100,26400,93500
421550,202106,281,203,78,223300,85800,309100
421555,202106,17,16,1,17600,1100,18700
421560,202106,8,7,1,7700,1100,8800
421565,202106,118,77,41,84700,45100,129800
421567,202106,29,24,5,26400,5500,31900
421568,202106,44,39,5,42900,5500,48400
421569,202106,12,12,0,13200,0,13200
421570,202106,205,132,73,145200,80300,225500
421575,202106,25,22,3,24200,3300,27500
421580,202106,716,424,292,467572,323400,790972
421590,202106,20,19,1,20900,1100,22000
421600,202106,142,93,49,102300,53900,156200
421605,202106,109,75,34,82500,37400,119900
421610,202106,171,128,43,140800,47300,188100
421620,202106,1020,589,431,647900,474100.73,1122000.73
421625,202106,18,16,2,17600,2200,19800
421630,202106,324,201,123,222200,135300,357500
421635,202106,21,11,10,12100,11000,23100
421640,202106,101,83,18,91300,19800,111100
421650,202106,293,168,125,184800,138600,323400
421660,202106,2331,1390,941,1529000,1036200,2565200
421670,202106,171,123,48,135300,53900,189200
421680,202106,191,170,21,187000,23100,210100
421690,202106,342,237,105,261800,116600,378400
421700,202106,52,36,16,39600,17600,57200
421710,202106,25,23,2,25300,2200,27500
421715,202106,5,4,1,4400,1100,5500
421720,202106,621,430,191,475200,210100,685300
421725,202106,22,9,13,9900,14300,24200
421730,202106,28,20,8,22000,8800,30800
421740,202106,98,34,64,37400,70400,107800
421750,202106,201,146,55,160600,60500,221100
421755,202106,21,19,2,20900,2200,23100
421760,202106,100,65,35,71500,38500,110000
421770,202106,699,446,253,490600,279400,770000
421775,202106,28,18,10,19800,11000,30800
421780,202106,183,141,42,155100.34,46200,201300.34
421790,202106,145,123,22,135300,24200,159500
421795,202106,17,13,4,14300,4400,18700
421800,202106,534,330,204,363000,224400,587400
421810,202106,70,53,17,58300,18700,77000
421820,202106,296,188,108,206800,118800,325600
421825,202106,144,120,24,133100,26400,159500
421830,202106,145,89,56,97900,61600,159500
421835,202106,7,3,4,3300,4400,7700
421840,202106,46,40,6,44000,6600,50600
421850,202106,83,70,13,77000,14300,91300
421860,202106,46,32,14,35200,15400,50600
421870,202106,1033,765,268,842600,298100,1140700
421875,202106,53,44,9,48400,9900,58300
421880,202106,180,126,54,138600,59400,198000
421885,202106,24,18,6,19800,6600,26400
421890,202106,142,100,42,110000,46200.5,156200.5
421895,202106,45,40,5,44000,5500,49500
421900,202106,140,108,32,118800,35200,154000
421910,202106,60,37,23,40700,25300,66000
421915,202106,29,23,6,25300,6600,31900
421917,202106,36,26,10,28600,11000,39600
421920,202106,38,33,5,36300,5500,41800
421930,202106,621,487,134,535700,147400,683100
421935,202106,51,44,7,48400,7700,56100
421940,202106,48,40,8,44000,8800,52800
421950,202106,857,574,283,632500,314600,947100
421960,202106,40,35,5,38500,5500,44000
421970,202106,326,213,113,234300,124300,358600
421985,202106,18,11,7,12100,8800,20900
422000,202106,0,,,,,0.0
430003,202106,194,55,139,60500,152900,213400
430005,202106,36,26,10,28600,11000,39600
430010,202106,266,193,73,213400,80300,293700
430020,202106,147,97,50,106700,55000,161700
430030,202106,124,103,21,114400,24200,138600
430040,202106,2908,1699,1209,1870000,1331000,3201000
430045,202106,66,54,12,59400,13200,72600
430047,202106,6,5,1,5500,1100,6600
430050,202106,80,66,14,72600,15400,88000
430055,202106,11,10,1,11000,1100,12100
430057,202106,5,4,1,4400,1100,5500
430060,202106,3809,2176,1633,2398000,1799600,4197600
430063,202106,53,44,9,48400,9900,58300
430064,202106,155,121,34,133100,37400,170500
430066,202106,5,2,3,2200,3300,5500
430070,202106,41,30,11,33000,12100,45100
430080,202106,74,46,28,50600,30800,81400
430085,202106,27,11,16,12100,17600,29700
430087,202106,25,16,9,17600,9900,27500
430090,202106,68,59,9,64900,9900,74800
430100,202106,127,86,41,94600,45100,139700
430105,202106,152,84,68,92400,74800,167200
430107,202106,18,12,6,13200,6600,19800
430110,202106,480,258,222,283800,244200,528000
430120,202106,159,145,14,159500,15400,174900
430130,202106,783,473,310,520300,341000,861300
430140,202106,126,116,10,127600,11000,138600
430150,202106,104,65,39,71500,42900,114400
430155,202106,32,27,5,29700,5500,35200
430160,202106,3589,2052,1537,2259400,1694000,3953400
430163,202106,372,157,215,172700,236500,409200
430165,202106,32,22,10,24200,11000,35200
430170,202106,84,70,14,78100,16500,94600
430175,202106,72,57,15,62700,16500,79200
430180,202106,105,88,17,96800,18700,115500
430185,202106,27,18,9,19800,9900,29700
430187,202106,55,29,26,31900,28600,60500
430190,202106,234,125,109,137500,119900,257400
430192,202106,13,11,2,12100,2200,14300
430195,202106,18,12,6,13200,6600,19800
430200,202106,158,135,23,148500,25300.95,173800.95
430205,202106,20,20,0,22000,0,22000
430210,202106,693,523,170,576400,188100,764500
430215,202106,11,10,1,11000,1100,12100
430220,202106,72,48,24,52800,26400,79200
430222,202106,12,5,7,5500,7700,13200
430223,202106,15,9,6,9900,6600,16500
430225,202106,2,1,1,1100,1100,2200
430230,202106,312,186,126,204600,138600,343200
430235,202106,51,37,14,40700,15400,56100
430237,202106,25,19,6,20900,6600,27500
430240,202106,109,77,32,84700,35200,119900
430245,202106,73,58,15,63800,16500,80300
430250,202106,184,105,79,116600,86900,203500
430258,202106,8,7,1,7700,1100,8800
430260,202106,33,28,5,30800,5500,36300
430265,202106,32,27,5,30800,5500,36300
430270,202106,508,373,135,412500,148500,561000
430280,202106,1037,616,421,678700,463100,1141800
430290,202106,425,222,203,244200,223300,467500
430300,202106,2097,1132,965,1247400,1062600,2310000
430310,202106,2027,989,1038,1089000,1141800.7,2230800.7
430320,202106,54,45,9,49500,9900,59400
430330,202106,97,85,12,93500,13200,106700
430340,202106,69,55,14,60500,15400,75900
430350,202106,1635,1085,550,1193500,607200,1800700
430355,202106,19,18,1,19800,1100,20900
430360,202106,90,43,47,47300,51700,99000
430367,202106,35,25,10,27500,11000,38500
430370,202106,55,50,5,55000,5500,60500
430380,202106,123,94,29,103400,31900,135300
430390,202106,583,361,222,397100,244200,641300
430400,202106,259,186,73,204600,81400,286000
430410,202106,56,43,13,47300,14300,61600
430420,202106,500,317,183,349800,201300,551100
430430,202106,54,52,2,56467.4,2200,58667.4
430435,202106,145,108,37,118800,40700,159500
430440,202106,504,317,187,348700,205700,554400
430450,202106,1146,931,215,1026300,237600,1263900
430460,202106,5449,2800,2649,3080000.8,2921600,6001600.8
430461,202106,17,15,2,16500,2200,18700
430462,202106,4,2,2,2200,2200,4400
430463,202106,1117,591,526,651200,579700,1230900
430465,202106,24,13,11,14300,12100,26400
430466,202106,640,442,198,487300,217800,705100
430467,202106,114,63,51,69300,56100,125400
430468,202106,129,73,56,80300,61600,141900
430469,202106,21,16,5,17600,5500,23100
430470,202106,1143,630,513,694427.5,565400,1259827.5
430471,202106,65,40,25,44000,27500,71500
430480,202106,112,74,38,81400,41800,123200
430485,202106,8,8,0,8800,0,8800
430490,202106,72,57,15,63800,16500,80300
430495,202106,32,25,7,27500,7700,35200
430500,202106,193,132,61,145200,67100,212300
430510,202106,3551,2276,1275,2506900.67,1404700,3911600.67
430511,202106,16,16,0,17600,0,17600
430512,202106,144,98,46,107800,50600,158400
430513,202106,53,41,12,45100,13200,58300
430515,202106,25,24,1,26400,1100,27500
430517,202106,171,144,27,158400,29700,188100
430520,202106,338,237,101,260700,111100,371800
430530,202106,81,45,36,49500,39600,89100
430535,202106,440,292,148,322300,162800,485100
430537,202106,11,11,0,12100,0,12100
430540,202106,85,57,28,62700,30800,93500
430543,202106,367,111,256,122100,282700,404800
430544,202106,44,41,3,45100,3300,48400
430545,202106,364,167,197,183700,216700,400400
430550,202106,40,31,9,34100,9900,44000
430558,202106,1,1,0,1100,0,1100
430560,202106,56,31,25,35200,27500,62700
430570,202106,112,44,68,48400,74800,123200
430580,202106,126,101,25,111100,27500,138600
430583,202106,15,15,0,16500,0,16500
430585,202106,10,4,6,4400,7700,12100
430587,202106,14,9,5,9900,5500,15400
430590,202106,151,121,30,133100,33000,166100
430593,202106,2,2,0,2200,0,2200
430595,202106,17,14,3,16500,3300,19800
430597,202106,45,23,22,25300,24200,49500
430600,202106,218,164,54,181500,59400,240900
430605,202106,169,101,68,111100,74800,185900
430607,202106,29,23,6,25300,6600,31900
430610,202106,1712,782,930,863500,1023000,1886500
430613,202106,3,3,0,3300,0,3300
430620,202106,113,81,32,89100,35200,124300
430630,202106,47,39,8,42900,8800,51700
430632,202106,32,27,5,29700,5500,35200
430635,202106,37,33,4,36300,4400,40700
430637,202106,63,31,32,34100,35200,69300
430640,202106,179,97,82,107800,90200,198000
430642,202106,17,14,3,15400,3300,18700
430645,202106,30,25,5,27500,5500,33000
430650,202106,244,197,47,217800,51700,269500
430655,202106,4,2,2,2200,2200,4400
430660,202106,968,476,492,525800,541200,1067000
430670,202106,78,54,24,59400,26400,85800
430673,202106,72,43,29,47300,31900,79200
430675,202106,9,7,2,7700,2200,9900
430676,202106,544,321,223,353100,246400,599500
430680,202106,238,160,78,176000,85800,261800
430690,202106,518,318,200,350900,220000.63,570900.63
430692,202106,9,7,2,7700,2200,9900
430693,202106,144,89,55,97900,60500,158400
430695,202106,61,51,10,56100,11000,67100
430697,202106,61,36,25,39600,27500,67100
430700,202106,1449,981,468,1083500,514800,1598300
430705,202106,30,27,3,29700,3300,33000
430710,202106,250,154,96,169400,105600,275000
430720,202106,111,95,16,104500,17600,122100
430730,202106,140,120,20,132000,22000,154000
430740,202106,74,50,24,55000,26400,81400
430745,202106,30,23,7,25300,7700,33000
430750,202106,334,219,115,243100,126500,369600
430755,202106,85,45,40,49500,44000,93500
430760,202106,392,216,176,237600,193600,431200
430770,202106,1507,774,733,851400,807400,1658800
430780,202106,305,192,113,211200,124300,335500
430781,202106,25,22,3,24200,3300,27500
430783,202106,59,47,12,51700,13200,64900
430786,202106,5,3,2,3300,2200,5500
430790,202106,517,332,185,366300,203500,569800
430800,202106,155,124,31,136400.01,34100,170500.01
430805,202106,41,33,8,36300,8800,45100
430807,202106,61,34,27,37400,29700,67100
430810,202106,77,47,30,51700,34100,85800
430820,202106,147,88,59,96800,64900,161700
430825,202106,11,9,2,9900,2200,12100
430830,202106,243,225,18,247500,19800,267300
430840,202106,133,89,44,97900,49500,147400
430843,202106,5,3,2,3300,2200,5500
430845,202106,77,41,36,45100,39600,84700
430850,202106,587,420,167,463100,183700,646800
430860,202106,151,94,57,103400,62700,166100
430865,202106,78,41,37,45100,40700,85800
430870,202106,79,65,14,71500,15400,86900
430880,202106,146,107,39,117700,42900,160600
430885,202106,12,9,3,9900,3300,13200
430890,202106,334,201,133,222200,146300,368500
430900,202106,526,357,169,393800,185900,579700
430905,202106,122,51,71,56100,79200,135300
430910,202106,289,166,123,182600,136400,319000
430912,202106,4,4,0,4400,0,4400
430915,202106,35,32,3,35200,3300,38500
430920,202106,4387,2291,2096,2522300,2310000,4832300
430925,202106,5,4,1,4400,1100,5500
430930,202106,2057,1169,888,1289200,977900,2267100
430940,202106,260,168,92,185900,101200,287100
430950,202106,148,125,23,138600,25300,163900
430955,202106,26,14,12,15400,13200,28600
430957,202106,22,19,3,20900,3300,24200
430960,202106,247,159,88,174900,96800,271700
430965,202106,109,70,39,77000,42900,119900
430970,202106,92,74,18,81400,19800,101200
430975,202106,43,37,6,41800,6600,48400
430980,202106,47,29,18,31900,19800,51700
430990,202106,99,77,22,84700,24200,108900
430995,202106,116,108,8,118800,8800,127600
431000,202106,283,133,150,146300.6,165000,311300.6
431010,202106,348,193,155,213400,170500,383900
431020,202106,1883,1080,803,1188000,886600,2074600
431030,202106,37,30,7,33000,7700,40700
431033,202106,412,187,225,205700,248600,454300
431036,202106,12,7,5,7700,5500,13200
431040,202106,142,87,55,95700,60500,156200
431041,202106,41,26,15,28600,16500,45100
431043,202106,42,24,18,26400,19800,46200
431046,202106,12,9,3,9900,3300,13200
431050,202106,203,126,77,138600,84700,223300
431053,202106,67,39,28,42900,30800,73700
431055,202106,66,44,22,48400,24200,72600
431057,202106,18,18,0,19800,0,19800
431060,202106,1597,1033,564,1140700.31,622600,1763300.31
431065,202106,17,10,7,11000,7700,18700
431070,202106,64,59,5,64900,5500,70400
431075,202106,7,7,0,7700,0,7700
431080,202106,128,74,54,82500,59400,141900
431085,202106,34,31,3,34100,3300,37400
431087,202106,10,8,2,8800,2200,11000
431090,202106,55,42,13,46200,14300,60500
431100,202106,1229,724,505,796400,556600,1353000
431110,202106,224,136,88,149600,96800,246400
431112,202106,23,15,8,16500,8800,25300
431113,202106,32,23,9,25300,9900,35200
431115,202106,162,115,47,126500,51700,178200
431120,202106,604,351,253,386100,278300,664400
431123,202106,2,2,0,2200,0,2200
431125,202106,95,82,13,90200,15400,105600
431127,202106,9,5,4,5500,4400,9900
431130,202106,718,471,247,518100,271700,789800
431140,202106,775,539,236,594000,259600,853600
431142,202106,25,21,4,23100.55,4400,27500.55
431150,202106,191,142,49,156200,53900,210100
431160,202106,46,43,3,47300,3300,50600
431162,202106,3,3,0,3300,0,3300
431164,202106,5,5,0,5500,0,5500
431170,202106,113,84,29,92400,31900,124300
431171,202106,72,42,30,46200,33000,79200
431173,202106,1,1,0,1100,0,1100
431175,202106,200,100,100,110000,110000,220000
431177,202106,88,61,27,67100,29700,96800
431179,202106,17,13,4,14300,4400,18700
431180,202106,422,256,166,281600,182600,464200
431190,202106,76,57,19,62700,20900,83600
431198,202106,71,50,21,55000,23100,78100
431200,202106,23,19,4,20900,4400,25300
431205,202106,23,22,1,24200,1100,25300
431210,202106,100,63,37,69300,40700,110000
431213,202106,31,26,5,28600,5500,34100
431215,202106,22,18,4,19800,4400,24200
431217,202106,8,7,1,7700,1100,8800
431220,202106,66,56,10,62700,11000,73700
431225,202106,162,106,56,116600,61600,178200
431230,202106,95,83,12,91300,13200,104500
431235,202106,6,6,0,6600,0,6600
431237,202106,8,7,1,7700,1100,8800
431238,202106,12,8,4,8800,4400,13200
431240,202106,1033,632,401,695200,441100,1136300
431242,202106,38,37,1,40700,1100,41800
431244,202106,17,13,4,14300,4400,18700
431245,202106,51,38,13,41800,14300,56100
431247,202106,11,6,5,6600,5500,12100
431250,202106,284,142,142,156200,157300,313500
431260,202106,55,45,10,49500,11000,60500
431261,202106,17,11,6,12100,6600,18700
431262,202106,17,15,2,16500,2200,18700
431265,202106,153,83,70,91300,78100,169400
431267,202106,17,14,3,15400,3300,18700
431270,202106,323,255,68,281600,74800,356400
431275,202106,38,35,3,38500,3300,41800
431280,202106,20,16,4,17600,4400,22000
431290,202106,17,15,2,16500,2200,18700
431295,202106,2,1,1,1100,1100,2200
431300,202106,22,20,2,22000,2200,24200
431301,202106,5,5,0,5500,0,5500
431303,202106,61,38,23,42900,25300,68200
431306,202106,239,125,114,137304.2,125400,262704.2
431308,202106,8,5,3,5500,3300,8800
431310,202106,64,52,12,57200,13200,70400
431320,202106,159,91,68,100100,74800,174900
431330,202106,188,116,72,127600,80300,207900
431333,202106,27,21,6,23100,6600,29700
431335,202106,7,4,3,4400,3300,7700
431337,202106,372,163,209,180400,229900,410300
431339,202106,19,14,5,15400,5500,20900
431340,202106,3072,1651,1421,1820413.1,1566400,3386813.1
431342,202106,35,23,12,25300,13200,38500
431344,202106,16,16,0,17600,0,17600
431346,202106,4,4,0,4400,0,4400
431349,202106,37,33,4,36300,4400,40700
431350,202106,936,515,421,567600,465300,1032900
431360,202106,50,40,10,45100,11000,56100
431365,202106,345,148,197,163900,216700,380600
431370,202106,1210,689,521,759000,575300,1334300
431380,202106,98,87,11,95700,12100,107800
431390,202106,499,266,233,293700,256300,550000
431395,202106,318,133,185,146300,203500.59,349800.59
431400,202106,42,27,15,29700,16500,46200
431402,202106,109,77,32,84700,35200,119900
431403,202106,23,14,9,15400,9900,25300
431405,202106,696,383,313,421300,344300,765600
431406,202106,34,27,7,29700,7700,37400
431407,202106,54,43,11,47300,12100,59400
431410,202106,3396,2049,1347,2257200,1483900,3741100
431413,202106,16,13,3,14300,3300,17600
431415,202106,60,42,18,46200,19800,66000
431417,202106,26,12,14,13200,15400,28600
431420,202106,344,234,110,257400,121000,378400
431430,202106,55,26,29,28600,31900,60500
431440,202106,8846,6022,2824,6630800.47,3116350.6,9747151.07
431442,202106,28,13,15,14300,16500,30800
431445,202106,27,25,2,27500,2200,29700
431446,202106,4,3,1,3300,1100,4400
431447,202106,88,62,26,68200,28600,96800
431449,202106,50,42,8,46200,8800,55000
431450,202106,410,269,141,295900,155100,451000
431454,202106,11,5,6,5500,6600,12100
431455,202106,47,37,10,40700,11000,51700
431460,202106,495,339,156,372900,172700,545600
431470,202106,121,89,32,97900,35200,133100
431475,202106,12,10,2,11000,2200,13200
431477,202106,38,23,15,25300,16500,41800
431478,202106,11,10,1,11000,1100,12100
431480,202106,550,326,224,358600,246400,605000
431490,202106,28619,15826,12793,17442586.85,14094300,31536886.85
431500,202106,78,62,16,68200,17600,85800
431505,202106,27,16,11,17600,12100,29700
431507,202106,9,8,1,8800,1100,9900
431510,202106,242,174,68,191400,75900,267300
431513,202106,24,21,3,23100,3300,26400
431514,202106,4,3,1,4400,1100,5500
431515,202106,82,69,13,75900,14300,90200
431517,202106,5,3,2,3300,2200,5500
431520,202106,40,36,4,39600,4400,44000
431530,202106,1433,634,799,698500,878900,1577400
431531,202106,21,20,1,22000,1100,23100
431532,202106,37,28,9,30800,9900,40700
431535,202106,28,16,12,17600,13200,30800
431540,202106,140,118,22,129800,24200,154000
431545,202106,12,9,3,9900,3300,13200
431550,202106,359,189,170,209000,187000,396000
431555,202106,11,11,0,12100,0,12100
431560,202106,4569,3065,1504,3377000,1658800,5035800
431570,202106,820,425,395,469700,434500,904200
431575,202106,45,23,22,25300,24200,49500
431580,202106,90,58,32,64900,35200,100100
431590,202106,136,115,21,126500,23100,149600
431595,202106,20,16,4,17600,4400,22000
431600,202106,246,145,101,159500,111100,270600
431610,202106,117,86,31,94600,34100,128700
431620,202106,41,34,7,37400,7700,45100
431630,202106,126,104,22,114400,24200,138600
431640,202106,1344,837,507,921800,558800,1480600
431642,202106,37,34,3,37400,3300,40700
431643,202106,45,18,27,19800,29700,49500
431645,202106,309,180,129,199100,143000,342100
431647,202106,9,8,1,8800,1100,9900
431650,202106,36,23,13,25300,14300,39600
431660,202106,278,173,105,190300,115500,305800
431670,202106,230,104,126,114400,138600,253000
431673,202106,10,7,3,7700,3300,11000
431675,202106,23,18,5,19800,5500,25300
431680,202106,1116,817,299,898700,331100,1229800
431690,202106,4820,2856,1964,3144900.5,2163700,5308600.5
431695,202106,22,16,6,17600,6600,24200
431697,202106,1,0,1,0,1100,1100
431700,202106,183,137,46,151800,50600,202400
431710,202106,4057,1750,2307,1926100,2543200,4469300
431720,202106,1295,789,506,868450,559900,1428350
431725,202106,1,1,0,1100,0,1100
431730,202106,1155,770,385,848100,424600,1272700
431740,202106,1346,645,701,709500,773300,1482800
431750,202106,1844,1192,652,1312300.32,722700,2035000.32
431755,202106,6,5,1,5500,1100,6600
431760,202106,1001,621,380,683100,419100,1102200
431770,202106,424,291,133,320100,146300,466400
431775,202106,27,20,7,22000,7700,29700
431780,202106,548,327,221,359700,243100,602800
431790,202106,155,120,35,132000,38500,170500
431795,202106,12,9,3,9900,3300,13200
431800,202106,3157,1634,1523,1799600,1678600,3478200
431805,202106,19,17,2,18700,2200,20900
431810,202106,605,392,213,431200,234300,665500
431820,202106,329,194,135,214500,148500,363000
431830,202106,2271,1360,911,1498200,1006500,2504700
431840,202106,476,308,168,339900,184800,524700
431842,202106,35,28,7,30800,7700,38500
431843,202106,10,7,3,7700,3300,11000
431844,202106,18,13,5,14300,5500,19800
431845,202106,26,24,2,26400,2200,28600
431846,202106,24,21,3,23100,3300,26400
431848,202106,11,9,2,9900,2200,12100
431849,202106,7,6,1,6600,1100,7700
431850,202106,756,601,155,661100,170500,831600
431860,202106,121,79,42,86900,47300,134200
431861,202106,7,3,4,3300,4400,7700
431862,202106,53,37,16,40700,17600,58300
431870,202106,3526,1979,1547,2180200,1705000,3885200
431880,202106,957,693,264,768900,292600,1061500
431890,202106,1282,749,533,823900,586300,1410200
431900,202106,183,124,59,136400,64900,201300
431910,202106,48,35,13,38500,14300,52800
431912,202106,45,27,18,29700,19800,49500
431915,202106,136,104,32,114400,35200,149600
431920,202106,155,111,44,122100,49500,171600
431930,202106,78,66,12,72600,13200,85800
431935,202106,3,2,1,2200,1100,3300
431936,202106,3,3,0,3300,0,3300
431937,202106,20,15,5,16500,5500,22000
431940,202106,452,303,149,333300,163900,497200
431950,202106,490,315,175,347600,194700,542300
431960,202106,743,395,348,435600,385000,820600
431970,202106,67,61,6,67100,6600,73700
431971,202106,5,3,2,3300,2200,5500
431973,202106,18,15,3,16500,3300,19800
431975,202106,8,7,1,7700,1100,8800
431980,202106,209,126,83,138600,91300,229900
431990,202106,1103,575,528,634628.5,583000,1217628.5
432000,202106,1789,916,873,1010900,960300,1971200
432010,202106,269,187,82,205700,91300,297000
432020,202106,178,146,32,160600,35200,195800
432023,202106,15,12,3,13200,3300,16500
432026,202106,63,56,7,61600,7700,69300
432030,202106,65,30,35,34100,38500,72600
432032,202106,18,14,4,15400,4400,19800
432035,202106,56,43,13,47300,14300,61600
432040,202106,86,59,27,64900,29700,94600
432045,202106,2,2,0,2200,0,2200
432050,202106,83,50,33,55000,36300,91300
432055,202106,125,91,34,101200,37400,138600
432057,202106,7,5,2,5500,2200,7700
432060,202106,33,30,3,33000,3300,36300
432065,202106,30,27,3,29700,3300,33000
432067,202106,90,80,10,88000,11000,99000
432070,202106,381,294,87,323675,95700,419375
432080,202106,820,570,250,629200,275000,904200
432085,202106,9,5,4,5500,4400,9900
432090,202106,261,174,87,191400,95700,287100
432100,202106,168,107,61,118800,67100,185900
432110,202106,537,357,180,392700,198000,590700
432120,202106,974,549,425,603900,468600,1072500
432130,202106,488,344,144,382800,159500,542300
432132,202106,24,21,3,23100,3300,26400
432135,202106,79,64,15,70400,16500,86900
432140,202106,264,202,62,222200,68200,290400
432143,202106,216,131,85,144100,93500,237600
432145,202106,278,192,86,213400,94600,308000
432146,202106,13,12,1,13200,1100,14300
432147,202106,115,61,54,67100,59400,126500
432149,202106,15,9,6,9900,6600,16500
432150,202106,902,543,359,598400,394900,993300
432160,202106,1555,786,769,864600.5,847000,1711600.5
432162,202106,4,2,2,2200,2200,4400
432163,202106,18,13,5,14300,5500,19800
432166,202106,125,92,33,101475,36300,137775
432170,202106,226,114,112,126500,124300,250800
432180,202106,539,331,208,366300,232100,598400
432183,202106,8,8,0,8800,0,8800
432185,202106,75,63,12,69300,13200,82500
432190,202106,490,284,206,312400,226600,539000
432195,202106,91,74,17,81400,19800,101200
432200,202106,403,250,153,275000,168300,443300
432210,202106,117,73,44,81400,48400,129800
432215,202106,35,31,4,34100,4400,38500
432218,202106,21,20,1,22000,1100,23100
432220,202106,653,339,314,372900,345400,718300
432225,202106,14,9,5,9900,5500,15400
432230,202106,128,84,44,92400,48400,140800
432232,202106,15,13,2,14300,2200,16500
432234,202106,4,2,2,2200,2200,4400
432235,202106,4,2,2,2200,2200,4400
432237,202106,23,15,8,16500,8800,25300
432240,202106,4338,2389,1949,2629000,2150500,4779500
432250,202106,1123,733,390,806300,430100,1236400
432252,202106,48,47,1,52800,1100,53900
432253,202106,60,48,12,52800,13200,66000
432254,202106,28,11,17,12100,18700,30800
432255,202106,13,11,2,12100,2200,14300
432260,202106,827,651,176,717200,193600,910800
432270,202106,224,167,57,183700,62700,246400
432280,202106,140,107,33,117700,36300,154000
432285,202106,1,1,0,1100,0,1100
432290,202106,63,54,9,59400,9900,69300
432300,202106,4716,2493,2223,2745528.5,2446400.61,5191929.11
432310,202106,130,106,24,116600,26400,143000
432320,202106,22,17,5,18700,5500,24200
432330,202106,16,10,6,11000,6600,17600
432335,202106,8,6,2,6600,2200,8800
432340,202106,37,31,6,34100,6600,40700
432345,202106,98,66,32,72600,35200,107800
432350,202106,19,18,1,19800,1100,20900
432360,202106,4,3,1,3300,1100,4400
432370,202106,25,24,1,26400,1100,27500
432375,202106,29,27,2,29700,2200,31900
432377,202106,7,7,0,7700,0,7700
432380,202106,174,79,95,86900,104500,191400
500020,202106,252,134,118,147400,130900,278300
500025,202106,139,68,71,74800,78100,152900
500060,202106,1456,912,544,1006500,599500,1606000
500070,202106,756,360,396,398200,435600,833800
500080,202106,135,107,28,117700,30800,148500
500085,202106,138,111,27,122100,29700,151800
500090,202106,355,164,191,180400,210100,390500
500100,202106,717,377,340,414700,374000,788700
500110,202106,2240,1043,1197,1150600,1317800,2468400
500124,202106,267,146,121,160600,133100,293700
500150,202106,342,139,203,154000,225500,379500
500190,202106,526,356,170,391600,187000,578600
500200,202106,201,171,30,188100,33000,221100
500210,202106,1582,531,1051,584100,1156100,1740200
500215,202106,213,123,90,135300,99000,234300
500220,202106,719,461,258,509300.92,283800,793100.92
500230,202106,233,141,92,155100,101200,256300
500240,202106,648,438,210,481800,231000,712800
500260,202106,581,227,354,249700,389400,639100
500270,202106,29720,12659,17061,13963749.48,18803400,32767149.48
500280,202106,200,67,133,73700,146300,220000
500290,202106,1162,713,449,785400,493900,1279300
500295,202106,449,290,159,319000,176000,495000
500310,202106,89,29,60,31900,66000,97900
500315,202106,801,445,356,489500,391600,881100
500320,202106,3582,1734,1848,1908501.69,2033900,3942401.69
500325,202106,943,517,426,568700,469700,1038400
500330,202106,1492,693,799,762300,878900,1641200
500345,202106,305,231,74,254100,81400,335500
500348,202106,246,144,102,158400,112200,270600
500350,202106,113,56,57,61600,62700,124300
500370,202106,5677,2556,3121,2816000,3437500,6253500
500375,202106,342,238,104,261800,115500,377300
500380,202106,585,334,251,367400,276100,643500
500390,202106,70,34,36,37400,39600,77000
500400,202106,215,137,78,150700,85800,236500
500410,202106,529,224,305,246400,336600,583000
500430,202106,532,374,158,411400,173800,585200
500440,202106,207,109,98,119900,108900,228800
500450,202106,407,174,233,193600,257400,451000
500460,202106,265,144,121,159500,133100,292600
500470,202106,424,326,98,359700,107800,467500
500480,202106,99,59,40,64900,44000,108900
500490,202106,102,46,56,50600,61600,112200
500500,202106,1410,521,889,573100,979000,1552100
500510,202106,43,36,7,39600,7700,47300
500515,202106,100,70,30,78100,33000,111100
500520,202106,299,159,140,174900,154000,328900
500525,202106,93,51,42,56100,46200,102300
500540,202106,875,391,484,430100,532400,962500
500560,202106,934,515,419,566500,460900,1027400
500568,202106,979,548,431,603900,474100,1078000
500570,202106,1173,683,490,751300,544500,1295800
500580,202106,327,167,160,183700,176000,359700
500600,202106,339,165,174,182600,191400,374000
500620,202106,930,652,278,717200.5,305800,1023000.5
500625,202106,77,62,15,68200,16500,84700
500627,202106,18,9,9,9900,9900,19800
500630,202106,1560,874,686,965800,756800,1722600
500635,202106,529,319,210,350900,231000,581900
500640,202106,368,198,170,218900,187000,405900
500660,202106,5653,2066,3587,2282500,3949000,6231500
500690,202106,606,211,395,232100,434500,666600
500710,202106,401,197,204,216700,225500,442200
500720,202106,912,514,398,565400.3,437800,1003200.3
500730,202106,180,108,72,118800,79200,198000
500740,202106,881,356,525,391600,577500,969100
500750,202106,152,49,103,53900,113300,167200
500755,202106,119,90,29,99000,31900,130900
500769,202106,755,407,348,448800,382800,831600
500770,202106,423,231,192,256300,213400,469700
500780,202106,140,94,46,103400,51700,155100
500790,202106,1048,522,526,575300,579700,1155000
500793,202106,277,142,135,157300,148500,305800
500795,202106,162,106,56,116600,61600,178200
500797,202106,48,34,14,37400,15400,52800
500800,202106,433,192,241,211200,267300,478500
500830,202106,2210,1227,983,1353000,1081300,2434300
500840,202106,129,99,30,108900,33000,141900
510010,202106,170,89,81,97900,89100,187000
510020,202106,521,225,296,247500,325600,573100
510025,202106,1645,934,711,1027400.37,782100,1809500.37
510030,202106,669,336,333,371800,366300,738100
510035,202106,127,65,62,71500,68200,139700
510040,202106,393,177,216,195800,237600,433400
510050,202106,352,197,155,216700,170500.3,387200.3
510060,202106,118,57,61,62700,67100,129800
510080,202106,232,93,139,102300,152900,255200
510100,202106,65,28,37,30800,40700,71500
510120,202106,31,18,13,19800,14300,34100
510125,202106,377,232,145,255200,160600,415800
510130,202106,543,329,214,364100,236500,600600
510140,202106,433,133,300,146300,330000,476300
510160,202106,100,31,69,34100,75900,110000
510170,202106,761,466,295,512600.56,324500,837100.56
510180,202106,2905,1351,1554,1487200,1712700,3199900
510185,202106,20,9,11,9900,12100,22000
510190,202106,236,84,152,92400,167200,259600
510250,202106,2562,1531,1031,1685200,1136300,2821500
510260,202106,174,125,49,137500,53900,191400
510263,202106,455,250,205,275000,225500,500500
510267,202106,635,357,278,392700,306900,699600
510268,202106,62,27,35,29700,38500,68200
510269,202106,77,34,43,37400,47300,84700
510270,202106,387,193,194,212300,213400,425700
510279,202106,208,158,50,173800,55000,228800
510285,202106,184,74,110,81400,121000,202400
510300,202106,502,262,240,288200,264000,552200
510305,202106,201,91,110,101200,121000,222200
510310,202106,109,55,54,60500,59400,119900
510320,202106,834,526,308,580800,338800,919600
510325,202106,421,169,252,185900,278300,464200
510330,202106,421,233,188,257400,206800,464200
510335,202106,649,377,272,414700,299200,713900
510336,202106,54,38,16,41800,17600,59400
510337,202106,105,48,57,52800,62700,115500
510340,202106,17146,7669,9477,8448000.63,10437900,18885900.63
510343,202106,61,44,17,48400,18700,67100
510345,202106,156,98,58,110000,63800,173800
510350,202106,663,356,307,392700,337700.43,730400.43
510360,202106,208,130,78,143000,85800,228800
510370,202106,152,69,83,75900,92400,168300
510380,202106,82,61,21,67100,23100,90200
510385,202106,63,28,35,30800,38500,69300
510390,202106,107,46,61,50600,67100,117700
510395,202106,45,31,14,34100,15400,49500
510410,202106,711,458,253,503800,278300,782100
510420,202106,558,269,289,295900,317900,613800
510450,202106,51,25,26,27500,28600,56100
510452,202106,49,22,27,24200,29700,53900
510454,202106,52,24,28,26400,30800,57200
510455,202106,133,75,58,82500,63800,146300
510460,202106,178,80,98,88000,107800,195800
510480,202106,690,407,283,447700,312400,760100
510490,202106,338,168,170,184800,187000,371800
510500,202106,236,176,60,193600,66000,259600
510510,202106,786,465,321,511500,354200,865700
510515,202106,1229,630,599,695200,661100,1356300
510517,202106,264,119,145,130900,159500,290400
510520,202106,218,144,74,158400,81400,239800
510523,202106,103,80,23,88000,25300,113300
510525,202106,825,499,326,548900,359700,908600
510530,202106,21,14,7,15400,7700,23100
510550,202106,239,108,131,119900,144100,264000
510558,202106,294,144,150,159500,165000,324500
510560,202106,404,233,171,258500,188100,446600
510562,202106,628,458,170,504900,187000,691900
510590,202106,741,380,361,420200,398200,818400
510600,202106,214,111,103,122100,113300,235400
510610,202106,218,90,128,99000,140800,239800
510615,202106,187,88,99,96800,108900,205700
510617,202106,24,11,13,12100,14300,26400
510618,202106,119,57,62,62700,68200,130900
510619,202106,92,65,27,71500,29700,101200
510620,202106,162,91,71,100100,78100,178200
510621,202106,175,113,62,124300,68200,192500
510622,202106,475,280,195,308000,214500,522500
510623,202106,307,208,99,228800,108900,337700
510624,202106,91,49,42,53900,46200,100100
510625,202106,517,324,193,356400,212300.63,568700.63
510626,202106,112,67,45,73700,49500,123200
510627,202106,84,56,28,61600,30800,92400
510628,202106,153,92,61,101200,67100,168300
510629,202106,271,163,108,179300,118819.8,298119.8
510630,202106,438,219,219,240900,240900,481800
510631,202106,14,4,10,4400,11000,15400
510637,202106,338,194,144,213400,158400,371800
510642,202106,991,532,459,585200,504900,1090100
510645,202106,3,1,2,1100,2200,3300
510650,202106,1348,883,465,972400,511500,1483900
510665,202106,84,36,48,39600,52800,92400
510670,202106,57,31,26,34100,28600,62700
510675,202106,1143,731,412,806300,453200,1259500
510677,202106,345,177,168,194700,184800,379500
510680,202106,99,58,41,63800,45100,108900
510682,202106,202,103,99,113300,108900,222200
510685,202106,55,42,13,46200,14300,60500
510700,202106,566,324,242,356400,269500,625900
510704,202106,1173,608,565,668800,621500.12,1290300.12
510706,202106,141,72,69,79200,75900,155100
510710,202106,392,278,114,305800,125400,431200
510715,202106,58,41,17,45100,19800,64900
510718,202106,219,110,109,121000,121000,242000
510719,202106,43,17,26,18700,28600,47300
510720,202106,187,132,55,145200,60500,205700
510724,202106,85,33,52,36300,57200,93500
510726,202106,57,30,27,33000,29700,62700
510729,202106,50,20,30,22000,33000,55000
510730,202106,469,257,212,282700,233200,515900
510735,202106,111,44,67,49500,73700,123200
510740,202106,22,12,10,13200,11000,24200
510757,202106,25,20,5,22000,5500,27500
510760,202106,7052,3587,3465,3951200,3813700.61,7764900.61
510770,202106,670,312,358,343200,393800,737000
510774,202106,15,5,10,5500,11000,16500
510775,202106,111,83,28,91300,30800,122100
510776,202106,31,9,22,9900,24200,34100
510777,202106,196,85,111,93500,122100,215600
510779,202106,35,19,16,20900,17600,38500
510780,202106,268,153,115,169400,126500,295900
510785,202106,375,203,172,223300,190300,413600
510787,202106,185,89,96,99000,105600,204600
510788,202106,5,1,4,1100,4400,5500
510790,202106,2485,1307,1178,1439951,1296900,2736851
510792,202106,1133,638,495,704000,545600.54,1249600.54
510794,202106,112,63,49,69300,53900,123200
510795,202106,2240,1301,939,1433300.11,1032900,2466200.11
510800,202106,178,108,70,118800,77000,195800
510805,202106,198,132,66,146300,72600,218900
510810,202106,98,42,56,46200,61600,107800
510820,202106,231,114,117,125400,128700.5,254100.5
510830,202106,72,40,32,44000,35200,79200
510835,202106,14,9,5,9900,5500,15400
510840,202106,9004,4217,4787,4643100,5271200,9914300
510850,202106,217,90,127,99000,139700,238700
510860,202106,375,171,204,188100,224400,412500
510880,202106,70,50,20,55000,22000,77000
510885,202106,67,38,29,41800,33000,74800
510890,202106,61,36,25,39600,27500,67100
510895,202106,168,98,70,108900,77000,185900
520005,202106,130,54,76,59400,83600,143000
520010,202106,295,131,164,144100,180400,324500
520013,202106,734,487,247,535846.66,271700,807546.66
520015,202106,49,35,14,38500,15400,53900
520017,202106,87,51,36,56100,39600,95700
520020,202106,17,10,7,11000,7700,18700
520025,202106,2467,1264,1203,1390400,1325500,2715900
520030,202106,816,437,379,480975,416900,897875
520050,202106,68,48,20,52800,23100,75900
520055,202106,56,35,21,38500,23100,61600
520060,202106,181,119,62,130900,68200,199100
520080,202106,588,431,157,474100,172700,646800
520082,202106,16,11,5,12100,5500,17600
520085,202106,88,66,22,72600,24200,96800
520090,202106,89,62,27,68200,29700,97900
520110,202106,9191,3944,5247,4346576.66,5779400,10125976.66
520120,202106,11,6,5,6600,5500,12100
520130,202106,811,567,244,624800,269500,894300
520140,202106,11879,6611,5268,7279800.91,5810200.92,13090001.83
520145,202106,53,31,22,34100,24200,58300
520150,202106,162,129,33,141900,36300,178200
520160,202106,42,29,13,31900,14300,46200
520170,202106,240,135,105,148500,115500,264000
520180,202106,176,82,94,90200,103400,193600
520215,202106,203,138,65,151800,71500,223300
520235,202106,80,63,17,69300,18700,88000
520250,202106,124,70,54,77000,59400,136400
520260,202106,114,73,41,80300,45100,125400
520280,202106,44,30,14,33000,15400,48400
520310,202106,43,28,15,30800,16500,47300
520320,202106,176,108,68,118800,75900,194700
520330,202106,815,441,374,485100,411400,896500
520340,202106,356,212,144,233200,159500,392700
520350,202106,507,243,264,268400,291500,559900
520355,202106,85,47,38,51700,41800,93500
520357,202106,25,19,6,20900,6600,27500
520360,202106,3,2,1,2200,1100,3300
520380,202106,134,75,59,82500,64900,147400
520390,202106,247,103,144,113300,158400,271700
520393,202106,18,12,6,13200,6600,19800
520396,202106,74,49,25,53900,27500,81400
520400,202106,193,117,76,128700,84700,213400
520410,202106,193,95,98,104500,108900,213400
520420,202106,22,14,8,15400,8800,24200
520425,202106,277,139,138,152900,151800,304700
520430,202106,499,243,256,269601.2,281600,551201.2
520440,202106,682,492,190,543400,209000,752400
520450,202106,1999,855,1144,941783.33,1262800,2204583.33
520455,202106,60,34,26,37400,28600,66000
520460,202106,36,23,13,25300,14300,39600
520465,202106,31,25,6,27500,6600,34100
520470,202106,432,275,157,302500,172700,475200
520480,202106,81,48,33,53900,36300,90200
520485,202106,105,38,67,41800,73700,115500
520490,202106,409,308,101,338800,111100,449900
520495,202106,155,91,64,100100,70400,170500
520500,202106,193,150,43,165000,47300,212300
520505,202106,191,112,79,123200,86900,210100
520510,202106,1828,873,955,960300,1052700,2013000
520520,202106,48,32,16,35200,17600,52800
520530,202106,215,170,45,187000,50600,237600
520540,202106,602,405,197,445500,216700,662200
520545,202106,136,77,59,84700,64900,149600
520547,202106,58,34,24,37400,26400,63800
520549,202106,1260,585,675,643500.34,742500,1386000.34
520551,202106,317,169,148,185900,162800,348700
520552,202106,36,25,11,27500,12100,39600
520570,202106,15,9,6,9900,6600,16500
520580,202106,274,171,103,188100,113300,301400
520590,202106,134,77,57,84700,62700,147400
520620,202106,1115,519,596,570900,656700,1227600
520630,202106,39,22,17,24200,18700,42900
520640,202106,371,217,154,239800,170500,410300
520650,202106,68,36,32,39600,35200,74800
520660,202106,46,25,21,27500,23100,50600
520670,202106,37,31,6,34100,6600,40700
520680,202106,42,27,15,29700,16500,46200
520690,202106,39,9,30,9900,33000,42900
520710,202106,32,28,4,30800,4400,35200
520725,202106,198,147,51,161700,56100,217800
520735,202106,56,36,20,39600,22000,61600
520740,202106,424,209,215,229900,236500,466400
520750,202106,34,24,10,26400,11000,37400
520753,202106,68,44,24,48400,26400,74800
520760,202106,99,67,32,73700,35200,108900
520780,202106,272,206,66,227700,72600,300300
520790,202106,158,90,68,99000,74800,173800
520800,202106,3425,1874,1551,2063600,1708300,3771900
520810,202106,148,115,33,126500,36300,162800
520815,202106,5,4,1,4400,1100,5500
520830,202106,147,101,46,111100,50600,161700
520840,202106,373,240,133,264000,146300,410300
520850,202106,98,56,42,61600,46200,107800
520860,202106,1743,1120,623,1234200,686400,1920600
520870,202106,31515,14653,16862,16126001.45,18570200,34696201.45
520880,202106,1161,622,539,685300,594000,1279300
520890,202106,779,476,303,524700,333300,858000
520910,202106,986,528,458,580800.4,504900,1085700.4
520915,202106,90,69,21,75900,23100,99000
520920,202106,437,203,234,223300,257400,480700
520929,202106,18,16,2,17600,2200,19800
520940,202106,69,50,19,55000,20900,75900
520945,202106,14,10,4,11000,4400,15400
520960,202106,42,26,16,28600,17600,46200
520970,202106,361,215,146,236500,162800,399300
520980,202106,96,69,27,75900,29700,105600
520990,202106,447,315,132,346500,145200,491700
520993,202106,124,59,65,64900,71500,136400
520995,202106,250,138,112,151800,123200,275000
521000,202106,1548,893,655,982300,721600,1703900
521010,202106,682,342,340,376200,374000,750200
521015,202106,15,10,5,11000,5500,16500
521020,202106,1403,990,413,1090100,455400,1545500
521030,202106,57,36,21,39600,23100,62700
521040,202106,930,596,334,658900,367400,1026300
521056,202106,47,30,17,33000,18700,51700
521060,202106,125,81,44,89100,48400,137500
521080,202106,384,296,88,325600,96800,422400
521090,202106,551,358,193,393800,212300,606100
521100,202106,268,200,68,220000,74800,294800
521120,202106,1049,735,314,809600,345400,1155000
521130,202106,355,254,101,279400,111100,390500
521140,202106,181,100,81,110000,90200,200200
521150,202106,2586,1117,1469,1229800,1618100,2847900
521160,202106,26,12,14,13200,15400,28600
521170,202106,215,123,92,136400,102300,238700
521180,202106,1157,746,411,820600,454300,1274900
521190,202106,2480,1048,1432,1155000,1575200,2730200
521200,202106,54,40,14,45100,15400,60500
521205,202106,11,8,3,8800,3300,12100
521210,202106,120,72,48,79200,52800,132000
521220,202106,734,513,221,565400,244200,809600
521225,202106,29,21,8,23100,8800,31900
521230,202106,105,67,38,73700,41800,115500
521250,202106,6167,3484,2683,3833501.64,2952400,6785901.64
521260,202106,31,14,17,15400,18700,34100
521270,202106,135,103,32,113300,35200,148500
521280,202106,429,263,166,289300,182600,471900
521290,202106,25,16,9,17600,9900,27500
521295,202106,99,65,34,71500,37400,108900
521300,202106,223,125,98,137500,107800,245300
521305,202106,36,26,10,28600,11000,39600
521308,202106,1026,783,243,862400,267300,1129700
521310,202106,1322,755,567,830500,623700,1454200
521340,202106,18,14,4,15400,4400,19800
521350,202106,122,93,29,102300,31900,134200
521370,202106,176,126,50,138600,55000,193600
521375,202106,179,95,84,104500,92400,196900
521377,202106,51,39,12,42900,13200,56100
521380,202106,1040,649,391,713900.56,430100,1144000.56
521385,202106,13,8,5,8800,5500,14300
521390,202106,99,81,18,89100,19800,108900
521400,202106,343,230,113,253000,124300,377300
521405,202106,142,80,62,88000,68200,156200
521410,202106,69,49,20,53900,22000,75900
521440,202106,199,140,59,155100,64900,220000
521450,202106,761,419,342,462000,376200,838200
521460,202106,1120,725,395,799700,434500,1234200
521470,202106,10,7,3,7700,3300,11000
521480,202106,41,29,12,31900,13200,45100
521483,202106,318,199,119,220000,130900,350900
521486,202106,284,181,103,199100,113300,312400
521487,202106,23,10,13,11000,14300,25300
521490,202106,25,12,13,13200,14300,27500
521500,202106,127,70,57,77000,62700,139700
521520,202106,45,33,12,36300,13200,49500
521523,202106,792,469,323,517000,355300,872300
521525,202106,47,28,19,30800,20900,51700
521530,202106,238,129,109,141900,119900,261800
521540,202106,35,18,17,19800,18700,38500
521550,202106,92,39,53,42900,58300,101200
521560,202106,818,556,262,612700,288200,900900
521565,202106,64,46,18,50600,19800,70400
521570,202106,537,354,183,389400,202400,591800
521580,202106,56,32,24,35200,26400,61600
521590,202106,34,15,19,16500,22000,38500
521600,202106,25,12,13,13200,14300,27500
521630,202106,241,128,113,140800,124300,265100
521640,202106,299,162,137,178200,150700,328900
521645,202106,37,21,16,23100,18700,41800
521680,202106,245,152,93,167200,102300,269500
521690,202106,3,3,0,3300,0,3300
521710,202106,1125,538,587,595100,650100,1245200
521720,202106,548,380,168,418000,184800,602800
521730,202106,669,321,348,353100,383900,737000
521740,202106,882,383,499,423500,553300,976800
521760,202106,2088,1092,996,1201272.45,1097800,2299072.45
521770,202106,806,505,301,556600,331100,887700
521800,202106,1964,1275,689,1405800,757900,2163700
521805,202106,33,18,15,19800,16500,36300
521810,202106,89,54,35,59400,38500,97900
521830,202106,964,684,280,754600.73,308000,1062600.73
521839,202106,87,52,35,57200,39600,96800
521850,202106,1094,567,527,624800.17,580800,1205600.17
521860,202106,327,205,122,225500,135300,360800
521870,202106,69,43,26,47300,28600,75900
521878,202106,37,16,21,17600,23100,40700
521880,202106,4742,2110,2632,2323200,2898500,5221700
521890,202106,589,408,181,452100.3,199100,651200.3
521900,202106,282,228,54,250800,59400,310200
521910,202106,164,114,50,125400,55000,180400
521920,202106,46,23,23,25300,25300,50600
521925,202106,54,32,22,35200,24200,59400
521930,202106,1148,637,511,701800,563200,1265000
521935,202106,34,23,11,25300,12100,37400
521940,202106,200,95,105,104500,115500,220000
521945,202106,17,13,4,14300,4400,18700
521950,202106,8,4,4,4400,4400,8800
521960,202106,70,53,17,58300,18700,77000
521970,202106,413,261,152,287100,167200,454300
521971,202106,105,55,50,60500,55000,115500
521973,202106,35,18,17,19800,18700,38500
521975,202106,1504,765,739,843700.75,821700.18,1665400.93
521980,202106,241,165,76,181500,83600,265100
521990,202106,72,53,19,58300,20900,79200
522000,202106,294,190,104,209716.1,114400,324116.1
522005,202106,18,10,8,11000,8800,19800
522010,202106,1117,631,486,694100,535700,1229800
522015,202106,59,35,24,38500,26400,64900
522020,202106,895,520,375,572000,412500,984500
522026,202106,23,15,8,16500,8800,25300
522028,202106,15,11,4,12100,4400,16500
522040,202106,764,316,448,347600,493900,841500
522045,202106,2431,1477,954,1628000,1049400,2677400
522050,202106,159,78,81,85800,89100,174900
522060,202106,548,342,206,376200,227700,603900
522068,202106,105,73,32,80300,35200,115500
522070,202106,9,9,0,9900,0,9900
522100,202106,38,22,16,24200,17600,41800
522108,202106,44,32,12,35200,13200,48400
522119,202106,55,32,23,35200,25300,60500
522130,202106,78,28,50,30800,55000,85800
522140,202106,4069,2116,1953,2328700,2152700,4481400
522145,202106,48,34,14,37400,15400,52800
522150,202106,97,69,28,75900,30800,106700
522155,202106,51,38,13,41800,14300,56100
522157,202106,5,3,2,3300,2200,5500
522160,202106,1674,989,685,1089000,753500,1842500
522170,202106,399,268,131,295900,144100,440000
522180,202106,35,15,20,16500,22000,38500
522185,202106,2130,882,1248,970200,1375000,2345200
522190,202106,54,30,24,33000,26400,59400
522200,202106,301,181,120,199100,132000,331100
522205,202106,146,98,48,107800,52800,160600
522220,202106,140,104,36,115500,39600,155100
522230,202106,27,21,6,23100,6600,29700
530010,202106,54001,27375,26626,30157932.81,29321776.86,59479709.67
110001,202107,504,412,92,453200,102300,555500
110002,202107,2827,1792,1035,1971201.8,1140700,3111901.8
110003,202107,79,65,14,71500,15400,86900
110004,202107,2008,1342,666,1477300.79,733700,2211000.79
110005,202107,430,342,88,376200,96800,473000
110006,202107,441,331,110,364100,121000,485100
110007,202107,70,57,13,62700,14300,77000
110008,202107,243,134,109,147400,119900,267300
110009,202107,905,673,232,741400,255200,996600
110010,202107,1665,1007,658,1107700.19,723800,1831500.19
110011,202107,1718,1333,385,1466300,423500,1889800
110012,202107,4043,2363,1680,2600400,1849100,4449500
110013,202107,743,593,150,652300,165000,817300
110014,202107,365,318,47,350900,52800,403700
110015,202107,1356,1081,275,1189100,302500,1491600
110018,202107,1052,649,403,713900,444400,1158300
110020,202107,15523,8866,6657,9760300.75,7328200,17088500.75
110025,202107,634,464,170,510400,187000,697400
110026,202107,36,25,11,27500,12100,39600
110028,202107,1595,1138,457,1251800,502700,1754500
110029,202107,135,123,12,135300,13200,148500
110030,202107,2359,1584,775,1743324,854700.85,2598024.85
110032,202107,315,242,73,267300,81400,348700
110033,202107,646,468,178,516120,195800,711920
110034,202107,328,243,85,268400.5,93500,361900.5
110037,202107,92,80,12,88000,13200,101200
110040,202107,388,264,124,291500,136400,427900
110045,202107,920,636,284,701800,312400,1014200
110050,202107,88,77,11,85360.88,12100,97460.88
110060,202107,67,40,27,44000,29700,73700
110070,202107,104,66,38,72600,41800,114400
110080,202107,500,281,219,309100,240900,550000
110090,202107,24,21,3,23100,3300,26400
110092,202107,109,59,50,64900,55000,119900
110094,202107,192,139,53,152900,58300,211200
110100,202107,42,29,13,31900,14300,46200
110110,202107,95,54,41,59400,45100,104500
110120,202107,65,58,7,63800,7700,71500
110130,202107,279,226,53,248600.3,58300,306900.3
110140,202107,236,170,66,187000,73700,260700
110143,202107,51,41,10,45100,11000,56100
110145,202107,31,25,6,27500,7700,35200
110146,202107,24,13,11,14300,12100,26400
110147,202107,39,26,13,28600,14300,42900
110148,202107,34,24,10,26400,11000,37400
110149,202107,317,227,90,249700,99000,348700
110150,202107,138,104,34,114400,37400,151800
110155,202107,11,10,1,11000,1100,12100
110160,202107,66,52,14,57200,15400,72600
110170,202107,220,167,53,184800,58300,243100
110175,202107,64,50,14,55000,15400,70400
110180,202107,90,74,16,81400,17600,99000
120001,202107,194,143,51,159500,56100.55,215600.55
120005,202107,191,111,80,122100.41,88000,210100.41
120010,202107,1131,696,435,765600,479600,1245200
120013,202107,147,98,49,107800,53900,161700
120017,202107,112,62,50,68200,55000,123200
120020,202107,3495,2836,659,3120721.55,724903.3,3845624.85
120025,202107,540,305,235,335500.95,258500,594000.95
120030,202107,1047,903,144,993329.4,158403.85,1151733.25
120032,202107,36,32,4,35200,4400,39600
120033,202107,218,191,27,210104.95,29700.55,239805.50
120034,202107,173,126,47,138600,52800,191400
120035,202107,37,31,6,34100,6600,40700
120038,202107,416,270,146,297000.55,161700.55,458701.10
120039,202107,29,28,1,30800,1100,31900
120040,202107,13880,9448,4432,10405804.01,4880871.05,15286675.06
120042,202107,43,37,6,40700,6600,47300
120043,202107,13,3,10,3300,11000,14300
120045,202107,533,338,195,371800.55,214501.1,586301.65
120050,202107,1262,967,295,1063722.55,324503.85,1388226.40
120060,202107,1452,1198,254,1322228.6,279403.85,1601632.45
120070,202107,406,296,110,325601.15,122100,447701.15
120080,202107,183,114,69,125400,75900.55,201300.55
130002,202107,160,115,45,126500,49500,176000
130006,202107,101,64,37,70400,40700,111100
130008,202107,128,69,59,75900,64900,140800
130010,202107,155,93,62,102300,68200,170500
130014,202107,274,197,77,216700,84700,301400
130020,202107,100,61,39,67100,42900,110000
130030,202107,956,558,398,613800,437800,1051600
130040,202107,349,170,179,187000,198000,385000
130050,202107,550,285,265,313500,292600,606100
130060,202107,823,561,262,617100,288200,905300
130063,202107,619,371,248,408100,272800,680900
130068,202107,193,118,75,129800,82500,212300
130070,202107,1337,905,432,997700,475200,1472900
130080,202107,702,469,233,515900,256300,772200
130083,202107,66,36,30,39600,33000,72600
130090,202107,348,192,156,211200,171600,382800
130100,202107,1200,558,642,613800,706200,1320000
130110,202107,724,318,406,349800,446600,796400
130115,202107,149,67,82,73700,90200,163900
130120,202107,1613,1009,604,1109900,664400,1774300
130130,202107,620,422,198,464200,218900,683100
130140,202107,1571,1225,346,1347500,380600,1728100
130150,202107,409,363,46,399300,50600,449900
130160,202107,442,255,187,280500,206800,487300
130165,202107,44,34,10,37400,11000,48400
130170,202107,1009,704,305,774329.6,335500.9,1109830.5
130180,202107,245,181,64,199100,70400,269500
130185,202107,2191,1013,1178,1115400,1295800,2411200
130190,202107,3376,2126,1250,2339700.26,1376100,3715800.26
130195,202107,287,229,58,251900,63800,315700
130200,202107,181,88,93,96800,102300,199100
130210,202107,92,48,44,52800,48400,101200
130220,202107,197,138,59,151800,64900,216700
130230,202107,376,241,135,265100,148500,413600
130240,202107,1332,863,469,950400,518100,1468500
130250,202107,4664,3007,1657,3309900,1822700,5132600
130255,202107,416,201,215,221100,236500,457600
130260,202107,57534,27193,30341,29937510.95,33396232.52,63333743.47
130270,202107,1533,1041,492,1145199,541200,1686399
130280,202107,131,76,55,83600,60500,144100
130290,202107,2087,1428,659,1570800,726000,2296800
130300,202107,424,290,134,319000,147400,466400
130310,202107,909,488,421,537900,463100,1001000
130320,202107,531,279,252,306900,277200,584100
130330,202107,771,490,281,539000,309100,848100
130340,202107,3405,1932,1473,2125200,1620300,3745500
130350,202107,485,332,153,365200,168300,533500
130353,202107,927,409,518,449900,574200,1024100
130356,202107,789,350,439,385000,482900,867900
130360,202107,89,66,23,72600,25300,97900
130370,202107,690,533,157,586300,172700,759000
130380,202107,666,513,153,564300,168300,732600
130390,202107,465,378,87,415800,95700,511500
130395,202107,159,41,118,45100,129800,174900
130400,202107,71,48,23,52800,25300,78100
130406,202107,2065,1220,845,1342000,929500,2271500
130410,202107,456,227,229,249700,251900,501600
130420,202107,2848,2312,536,2546500,590700,3137200
130423,202107,154,78,76,85800,83600,169400
130426,202107,164,84,80,92400,88000,180400
130430,202107,413,246,167,270600,183700,454300
130440,202107,200,61,139,67100,152900,220000
140002,202107,17,5,12,5500,13200,18700
140005,202107,205,127,78,139700,85800,225500
140010,202107,11108,6953,4155,7653326,4574900.91,12228226.91
140015,202107,143,64,79,70400,86900,157300
140017,202107,124,71,53,78100,58300,136400
140020,202107,463,300,163,330000,179300,509300
140023,202107,38,18,20,19800,22000,41800
140028,202107,21,11,10,12100,11000,23100
140030,202107,356,240,116,264000,127600,391600
140040,202107,63,44,19,48400,20900,69300
140045,202107,270,105,165,115500,181500,297000
140047,202107,427,288,139,316800,152900,469700
140050,202107,144,90,54,99000,59400,158400
140060,202107,61,40,21,44000,23100,67100
140070,202107,31,29,2,31900,2200,34100
150010,202107,4858,2945,1913,3243900,2109800,5353700
150013,202107,162,116,46,127600,50600,178200
150020,202107,1111,607,504,667700,554400,1222100
150030,202107,705,313,392,344300.02,431200,775500.02
150034,202107,205,127,78,140800,85800,226600
150040,202107,1513,863,650,949300,716100,1665400
150050,202107,690,395,295,434500,324500,759000
150060,202107,4876,3055,1821,3363707,2004655.4,5368362.4
150070,202107,429,220,209,242000,229900,471900
150080,202107,15754,7461,8293,8211501.13,9125600,17337101.13
150085,202107,425,272,153,299200,168300,467500
150090,202107,703,597,106,656700,116600,773300
150095,202107,377,242,135,266200,148500,414700
150100,202107,63,40,23,44000,25300,69300
150110,202107,215,120,95,132000,104500,236500
150120,202107,391,283,108,312400,118800,431200
150125,202107,50,18,32,19800,35200,55000
150130,202107,2086,1082,1004,1191300,1104400,2295700
150140,202107,56307,25206,31101,27734300.25,34221001.68,61955301.93
150145,202107,234,130,104,143000,114400,257400
150150,202107,3142,1387,1755,1526800,1931600,3458400
150157,202107,380,265,115,291500,127600,419100
150160,202107,130,99,31,108900,34100,143000
150170,202107,3706,2730,976,3005200,1073600,4078800
150172,202107,346,245,101,269500,111100,380600
150175,202107,81,49,32,53900,35200,89100
150178,202107,762,508,254,558800,279400,838200
150180,202107,3190,1550,1640,1705000,1805100,3510100
150190,202107,359,229,130,251900,143000,394900
150195,202107,113,59,54,64900,59400,124300
150200,202107,195,93,102,102300,112200,214500
150210,202107,3201,2545,656,2800600,721600,3522200
150215,202107,574,362,212,399300,234300,633600
150220,202107,3545,2360,1185,2597100.82,1303500,3900600.82
150230,202107,1265,1000,265,1100000.5,291500,1391500.5
150240,202107,6590,3722,2868,4096400.6,3155900,7252300.6
150250,202107,65,36,29,39600,31900,71500
150260,202107,95,64,31,70400,34100,104500
150270,202107,2199,1424,775,1567500,852500,2420000
150275,202107,530,334,196,367400,215600,583000
150276,202107,112,42,70,46200,77000,123200
150277,202107,797,358,439,396000,482900,878900
150280,202107,375,254,121,279400,134200,413600
150285,202107,120,59,61,64900,66924,131824
150290,202107,1151,668,483,734800,531300,1266100
150293,202107,719,334,385,367400,424600,792000
150295,202107,522,240,282,264000,311300,575300
150300,202107,88,40,48,44000,52800,96800
150304,202107,180,106,74,116600,81400,198000
150307,202107,408,337,71,370700,78100,448800
150309,202107,575,407,168,448800,184800.48,633600.48
150310,202107,253,164,89,180400,97900,278300
150320,202107,1887,1317,570,1448700.5,627000,2075700.5
150330,202107,2062,1197,865,1316700,951500,2268200
150340,202107,196,130,66,143000.78,72600,215600.78
150345,202107,644,360,284,396000,312400,708400
150350,202107,397,314,83,345400,91300,436700
150360,202107,4714,2884,1830,3173500,2016300,5189800
150370,202107,839,576,263,635800,289300,925100
150375,202107,198,92,106,102300,116600,218900
150380,202107,1508,1000,508,1101100,558800,1659900
150390,202107,833,482,351,530200,386100,916300
150400,202107,114,94,20,103400,22000,125400
150405,202107,1237,780,457,858000,502700,1360700
150410,202107,120,75,45,82500,49500,132000
150420,202107,7501,4058,3443,4468379.3,3789500,8257879.3
150430,202107,621,386,235,424600,258500,683100
150440,202107,455,284,171,312400,188100,500500
150442,202107,2347,1256,1091,1382700,1201200,2583900
150445,202107,546,354,192,389400,211200,600600
150450,202107,229,125,104,137500,114400,251900
150460,202107,729,541,188,595100,206800,801900
150470,202107,1285,778,507,855800,557700,1413500
150475,202107,244,184,60,202400,66000,268400
150480,202107,1328,921,407,1015300,447700,1463000
150490,202107,658,391,267,430100,293700,723800
150495,202107,338,253,85,278300,94600,372900
150497,202107,285,195,90,215600,99000,314600
150500,202107,241,143,98,157300,107800,265100
150503,202107,1103,567,536,623700,590700,1214400
150506,202107,929,625,304,687500,334400,1021900
150510,202107,1283,693,590,762300,649000,1411300
150520,202107,316,217,99,238700,108900,347600
150530,202107,1758,971,787,1070300,869000,1939300
150540,202107,198,144,54,158400,59400,217800
150543,202107,823,427,396,469700,435600,905300
150548,202107,471,339,132,372900,145200,518100
150549,202107,63,43,20,47300,22000,69300
150550,202107,2980,1504,1476,1654400,1624700,3279100
150553,202107,3398,1908,1490,2099900,1640100,3740000
150555,202107,146,77,69,84700,75900,160600
150560,202107,43,19,24,20900,26400,47300
150563,202107,124,60,64,66000,70400,136400
150565,202107,197,122,75,134200,82500,216700
150570,202107,430,284,146,312400,160600,473000
150580,202107,1697,817,880,899800,969100,1868900
150590,202107,820,537,283,590700,311300,902000
150600,202107,499,299,200,328900,220000,548900
150610,202107,150,120,30,132000,33000,165000
150611,202107,121,80,41,88000,45100,133100
150613,202107,3268,1884,1384,2072400,1522400,3594800
150616,202107,550,307,243,337700,268400,606100
150618,202107,1366,709,657,781000,722700,1503700
150619,202107,404,305,99,335500,108900,444400
150620,202107,1243,715,528,786500,580800,1367300
150630,202107,329,209,120,231000,132000,363000
150635,202107,454,192,262,212300,288200,500500
150640,202107,45,22,23,24200,25300,49500
150650,202107,2419,1397,1022,1536700,1124200,2660900
150655,202107,242,178,64,196900,70400,267300
150658,202107,88,53,35,58300,38500,96800
150660,202107,548,355,193,390500,212300,602800
150670,202107,1121,392,729,431200,801900,1233100
150680,202107,10397,5453,4944,6000500.57,5442800,11443300.57
150690,202107,24,12,12,13200,13200,26400
150700,202107,496,321,175,353100,192500,545600
150710,202107,293,167,126,183700,139700,323400
150715,202107,843,528,315,580800,346500,927300
150720,202107,423,324,99,356400,108900,465300
150730,202107,1060,518,542,569800,596200,1166000
150740,202107,233,153,80,168300,88000,256300
150745,202107,750,419,331,460900,365200,826100
150746,202107,67,36,31,39600,34100,73700
150747,202107,225,170,55,187000,60500,247500
150750,202107,142,79,63,86900,69300,156200
150760,202107,1827,1187,640,1305700.5,704000,2009700.5
150770,202107,391,219,172,240900,189200,430100
150775,202107,109,52,57,57200,62700,119900
150780,202107,199,109,90,119900,99000,218900
150790,202107,885,508,377,558800,414700,973500
150795,202107,1576,946,630,1041700,693000,1734700
150796,202107,341,192,149,211200,163900,375100
150797,202107,355,169,186,185900,204600,390500
150800,202107,1529,869,660,957000,726000,1683000
150803,202107,533,427,106,470800,117700,588500
150805,202107,211,124,87,136400,95700,232100
150808,202107,1016,538,478,591800,525800,1117600
150810,202107,3232,2191,1041,2410100.52,1146200,3556300.52
150812,202107,470,245,225,269500,247500,517000
150815,202107,1094,679,415,746900,456500,1203400
150820,202107,1545,931,614,1024100,676500,1700600
150830,202107,713,521,192,573100,211200,784300
150835,202107,216,124,92,136400,101200,237600
150840,202107,1377,836,541,919600,595100,1514700
160005,202107,59,41,18,45100.08,19800.04,64900.12
160010,202107,197,125,72,137500.14,79200.1,216700.24
160015,202107,135,83,52,91300.1,57200,148500.1
160020,202107,140,76,64,83600.04,70400,154000.04
160021,202107,61,29,32,31900.04,35200.04,67100.08
160023,202107,64,40,24,44000.06,26400.04,70400.10
160025,202107,26,13,13,14300.04,14300.04,28600.08
160027,202107,1457,834,623,918501.94,685300.98,1603802.92
160030,202107,16232,8365,7867,9211415.37,8658110.5,17869525.87
160040,202107,300,174,126,191400.12,138600.02,330000.14
160050,202107,723,360,363,396000.2,399300.04,795300.24
160053,202107,279,170,109,187000.24,119900.14,306900.38
160055,202107,22,14,8,15400.02,8800.02,24200.04
160060,202107,6601,3518,3083,3877510.65,3412206.88,7289717.53
160070,202107,188,112,76,123200.02,83600.02,206800.04
160080,202107,117,60,57,66000,62700,128700
170025,202107,29,14,15,15400,16500,31900
170030,202107,195,158,37,174900.03,40700,215600.03
170035,202107,207,100,107,110000,117700,227700
170040,202107,175,129,46,141900,50600,192500
170070,202107,319,199,120,218900,132000,350900
170100,202107,348,256,92,281600,101200,382800
170105,202107,54,44,10,48400,11000,59400
170110,202107,117,69,48,75900,52800,128700
170130,202107,72,36,36,39600,39600,79200
170190,202107,95,59,36,66000,39600,105600
170200,202107,353,244,109,268400,119900,388300
170210,202107,6238,3298,2940,3627534.25,3236200.8,6863735.05
170215,202107,125,57,68,62700,74800,137500
170220,202107,1373,1005,368,1106600,407000,1513600
170230,202107,143,93,50,102300,55000,157300
170240,202107,511,340,171,374000,188100,562100
170255,202107,1057,861,196,947100,215600,1162700
170270,202107,47,32,15,35200,16500,51700
170290,202107,119,77,42,84700,46200,130900
170300,202107,100,62,38,68200,41800,110000
170305,202107,46,35,11,38500,12100,50600
170307,202107,58,45,13,49500,14300,63800
170310,202107,122,66,56,72600,61600,134200
170320,202107,27,15,12,16500,13200,29700
170330,202107,27,23,4,25300,4400,29700
170360,202107,32,19,13,20900,14300,35200
170370,202107,94,46,48,50600,52800,103400
170380,202107,74,56,18,61600,19800,81400
170382,202107,38,32,6,35200,6600,41800
170384,202107,143,110,33,121000,36300,157300
170386,202107,69,29,40,31900,44000,75900
170388,202107,46,19,27,20900,29700,50600
170389,202107,25,21,4,23100,4400,27500
170390,202107,71,41,30,45100,33000,78100
170410,202107,24,22,2,24200,2200,26400
170460,202107,15,10,5,11000,5500,16500
170510,202107,34,27,7,29700,7700,37400
170550,202107,1545,900,645,990000,709500,1699500
170555,202107,107,78,29,85800,31900,117700
170560,202107,105,75,30,82500,33000,115500
170600,202107,41,14,27,15400,29700,45100
170610,202107,191,98,93,108900,102300,211200
170625,202107,39,24,15,26400,16500,42900
170650,202107,90,65,25,71500,27500,99000
170700,202107,575,423,152,465300,167200,632500
170710,202107,155,98,57,107800,62700,170500
170720,202107,94,74,20,81400,22000,103400
170730,202107,92,55,37,60500,40700,101200
170740,202107,87,61,26,67100,28600,95700
170755,202107,56,30,26,33000,28600,61600
170765,202107,137,72,65,79200,71500,150700
170770,202107,197,128,69,140800,75900,216700
170820,202107,603,397,206,437800,226600,664400
170825,202107,39,20,19,22000,20900,42900
170830,202107,86,68,18,74800,19800,94600
170900,202107,173,133,40,146300,44000,190300
170930,202107,923,502,421,553300,465300,1018600
170950,202107,3143,1460,1683,1609300,1853500.4,3462800.4
170980,202107,18,12,6,13200,6600,19800
171050,202107,150,114,36,125400,39600,165000
171070,202107,48,40,8,44000,8800,52800
171090,202107,48,35,13,38500,14300,52800
171110,202107,23,17,6,18700,6600,25300
171150,202107,40,21,19,23100,20900,44000
171180,202107,28,13,15,14300,16500,30800
171190,202107,165,96,69,105600,75900,181500
171195,202107,63,52,11,57200,12100,69300
171200,202107,44,21,23,23100,25300,48400
171215,202107,6,4,2,4400,2200,6600
171240,202107,61,44,17,48400,18700,67100
171245,202107,59,51,8,56100,8800,64900
171250,202107,75,42,33,46200,36300,82500
171270,202107,16,12,4,13200,4400,17600
171280,202107,40,35,5,38500,5500,44000
171320,202107,994,567,427,624800,469700,1094500
171330,202107,419,210,209,231000,229900,460900
171360,202107,94,65,29,71500,31900,103400
171370,202107,34,17,17,18700,18700,37400
171380,202107,132,114,18,125400,19800,145200
171395,202107,48,28,20,30800,22000,52800
171420,202107,264,170,94,187000,103400,290400
171430,202107,71,57,14,63800,15400,79200
171488,202107,196,105,91,115500,100100,215600
171500,202107,62,34,28,37400,30800,68200
171510,202107,71,47,24,51700,26400,78100
171515,202107,40,32,8,35200,8800,44000
171525,202107,28,26,2,28600,2200,30800
171550,202107,15,9,6,9900,6600,16500
171570,202107,48,24,24,26400,26400,52800
171575,202107,284,186,98,204600,107800,312400
171610,202107,1747,884,863,972400,949300,1921700
171620,202107,144,98,46,107800,50600,158400
171630,202107,55,30,25,33000,27500,60500
171650,202107,322,224,98,246400,107800,354200
171660,202107,264,152,112,167200,123200,290400
171665,202107,72,45,27,49500,29700,79200
171670,202107,425,259,166,284900,182600,467500
171700,202107,64,56,8,61600,8800,70400
171720,202107,29,11,18,12100,19800,31900
171750,202107,105,54,51,59400,56100,115500
171780,202107,73,57,16,62700,17600,80300
171790,202107,83,69,14,77000,16500,93500
171800,202107,32,24,8,26400,8800,35200
171820,202107,2065,1201,864,1322200.7,950400,2272600.7
171830,202107,37,26,11,28600,12100,40700
171840,202107,63,40,23,44000,25300,69300
171845,202107,29,19,10,20900,11000,31900
171850,202107,38,32,6,35200,6600,41800
171855,202107,79,62,17,69300,18700,88000
171865,202107,7,6,1,6600,1100,7700
171870,202107,31,19,12,20900,13200,34100
171875,202107,80,59,21,64900,23100,88000
171880,202107,37,23,14,25300,15400,40700
171884,202107,50,28,22,30800,24200,55000
171886,202107,129,58,71,63800,78100,141900
171888,202107,25,19,6,20900,6600,27500
171889,202107,12,6,6,6600,6600,13200
171890,202107,55,46,9,50600,9900,60500
171900,202107,32,22,10,24200,11000,35200
172000,202107,37,30,7,33000,7700,40700
172010,202107,53,44,9,48400,9900,58300
172015,202107,24,17,7,18700,7700,26400
172020,202107,146,91,55,100100,60500,160600
172025,202107,38,25,13,27500,14300,41800
172030,202107,45,25,20,27500,22000,49500
172049,202107,85,55,30,60500,33000,93500
172065,202107,129,83,46,91300,50600,141900
172080,202107,107,68,39,74800,42900,117700
172085,202107,28,14,14,15400,15400,30800
172090,202107,431,323,108,355300.56,118800,474100.56
172093,202107,15,13,2,14300,2200,16500
172097,202107,19,11,8,12100,8800,20900
172100,202107,5275,2975,2300,3274883.33,2530000,5804883.33
172110,202107,79,50,29,55000,31900,86900
172120,202107,1712,1440,272,1584000,299200,1883200
172125,202107,11,10,1,11000,1100,12100
172130,202107,24,13,11,14300,12100,26400
172208,202107,206,122,84,134200,92400,226600
172210,202107,368,181,187,199100,205700,404800
210005,202107,2928,1838,1090,2022900.32,1200100,3223000.32
210010,202107,155,88,67,96800,73700,170500
210015,202107,39,29,10,31900,11000,42900
210020,202107,365,208,157,228800,172700,401500
210030,202107,321,214,107,235400,117700,353100
210040,202107,138,110,28,121000,30800,151800
210043,202107,254,199,55,218900,60500,279400
210047,202107,519,317,202,348700,222200,570900
210050,202107,282,211,71,232100,78100,310200
210055,202107,51,42,9,46200,9900,56100
210060,202107,535,435,100,478500,110000,588500
210070,202107,433,327,106,359700,116600,476300
210080,202107,131,120,11,132000,12100,144100
210083,202107,293,141,152,155100,167200,322300
210087,202107,2,1,1,1100,1100,2200
210090,202107,439,315,124,346500,136400,482900
210095,202107,423,323,100,355300,110000,465300
210100,202107,702,554,148,609400,162800,772200
210110,202107,120,78,42,85800,46200,132000
210120,202107,4951,3903,1048,4295500,1153900,5449400
210125,202107,185,113,72,124300,79200,203500
210130,202107,462,268,194,294800,213400,508200
210135,202107,28,22,6,24200,6600,30800
210140,202107,4397,3420,977,3764200,1075800,4840000
210150,202107,364,232,132,256300,145200,401500
210160,202107,3262,2791,471,3070100.54,518100,3588200.54
210170,202107,1192,962,230,1058200,253000,1311200
210173,202107,123,108,15,119900,16500,136400
210177,202107,342,195,147,214500,161700,376200
210180,202107,29,16,13,17600,14300,31900
210190,202107,435,288,147,316800,161700,478500
210193,202107,5,4,1,4400,1100,5500
210197,202107,75,55,20,60500,22000,82500
210200,202107,616,524,92,576400,101200,677600
210203,202107,216,150,66,165000,72600,237600
210207,202107,357,296,61,326700,67100,393800
210210,202107,732,676,56,743600,61600,805200
210215,202107,75,63,12,69300,13200,82500
210220,202107,380,321,59,353100,64900,418000
210230,202107,311,250,61,275000,67100,342100
210232,202107,1318,913,405,1005400,445500,1450900
210235,202107,172,132,40,145200,44000,189200
210237,202107,36,21,15,23100,16500,39600
210240,202107,86,73,13,80300,14300,94600
210250,202107,177,151,26,166100,28600,194700
210255,202107,365,278,87,305800,95700,401500
210260,202107,392,273,119,300300,130900,431200
210270,202107,639,431,208,474100,228800,702900
210275,202107,82,62,20,68200,22000,90200
210280,202107,1041,688,353,756103.33,388300,1144403.33
210290,202107,537,366,171,403700,188100,591800
210300,202107,5179,3292,1887,3624501.59,2075700,5700201.59
210310,202107,104,74,30,82500,33000,115500
210312,202107,117,82,35,90200,38500,128700
210315,202107,104,88,16,96800,17600,114400
210317,202107,137,103,34,113300,37400,150700
210320,202107,2309,1982,327,2182400,359700,2542100
210325,202107,142,88,54,96800,59400,156200
210330,202107,4424,2564,1860,2820400,2047100,4867500
210340,202107,1224,926,298,1018600,327800,1346400
210350,202107,660,548,112,602800,123200,726000
210355,202107,151,128,23,140800,25300,166100
210360,202107,2173,1519,654,1672000,720500,2392500
210370,202107,1231,616,615,677600,677600,1355200
210375,202107,190,96,94,105600,103400,209000
210380,202107,720,559,161,614900,177100,792000
210390,202107,192,163,29,179300,31900,211200
210400,202107,390,339,51,372900,56100,429000
210405,202107,987,702,285,772200,313500,1085700
210407,202107,60,47,13,51700,14300,66000
210408,202107,62,54,8,59400,8800,68200
210409,202107,326,287,39,315700,42900,358600
210410,202107,438,344,94,379500,103400,482900
210420,202107,200,165,35,181500,38500,220000
210430,202107,50,35,15,38500,16500,55000
210440,202107,371,253,118,278300,129800,408100
210450,202107,99,83,16,91300,17600,108900
210455,202107,236,125,111,137500,122100,259600
210460,202107,303,205,98,225500,107800,333300
210462,202107,70,57,13,62700,14300,77000
210465,202107,140,110,30,121000,33000,154000
210467,202107,511,378,133,415800,146300,562100
210470,202107,48,41,7,45100,7700,52800
210480,202107,1291,927,364,1019700,400400.5,1420100.5
210490,202107,192,130,62,143000,68200,211200
210500,202107,511,313,198,344300,217800,562100
210510,202107,536,433,103,476300,113300,589600
210515,202107,364,229,135,251900,148500,400400
210520,202107,402,365,37,401500,40700,442200
210530,202107,9306,4869,4437,5357000.48,4881800.83,10238801.31
210535,202107,130,97,33,106700,36300,143000
210540,202107,1512,1009,503,1111000,553300,1664300
210542,202107,1134,580,554,638000,611600,1249600
210545,202107,22,20,2,22000,2200,24200
210547,202107,128,115,13,126500,14300,140800
210550,202107,636,455,181,500500,199100,699600
210560,202107,156,137,19,150700,20900,171600
210565,202107,21,15,6,16500,6600,23100
210570,202107,1282,1051,231,1156100.59,254100,1410200.59
210580,202107,121,103,18,113300,19800,133100
210590,202107,725,605,120,665500,132000,797500
210592,202107,37,35,2,38500,2200,40700
210594,202107,112,94,18,103400,19800,123200
210596,202107,109,94,15,103400,16500,119900
210598,202107,139,106,33,116600,36300,152900
210600,202107,316,274,42,301400,46200,347600
210610,202107,251,236,15,259600,16500,276100
210620,202107,43,28,15,30800,16500,47300
210630,202107,75,72,3,79200,3300,82500
210632,202107,1017,721,296,794200,326700,1120900
210635,202107,22,19,3,20900,3300,24200
210637,202107,125,92,33,101200,36300,137500
210640,202107,578,514,64,565400,70400,635800
210650,202107,396,331,65,364100,71500,435600
210660,202107,369,292,77,321200,84700,405900
210663,202107,48,34,14,37400,15400,52800
210667,202107,97,38,59,41800,64900,106700
210670,202107,255,228,27,250800,29700,280500
210675,202107,520,287,233,315700,256300,572000
210680,202107,216,142,74,156200,81400,237600
210690,202107,612,510,102,562100,112200,674300
210700,202107,153,117,36,128700,39600,168300
210710,202107,240,151,89,166100,97900,264000
210720,202107,129,116,13,127600,14300,141900
210725,202107,62,54,8,59400,8800,68200
210730,202107,24,19,5,20900,5500,26400
210735,202107,292,213,79,234300,86900,321200
210740,202107,523,451,72,496100,79200,575300
210745,202107,152,113,39,124300,42900,167200
210750,202107,2446,1255,1191,1381600,1310100,2691700
210760,202107,251,195,56,215600,61600,277200
210770,202107,243,198,45,218900,49500,268400
210780,202107,426,322,104,355300.62,114400,469700.62
210790,202107,182,150,32,165000,35200,200200
210800,202107,172,132,40,145200,44000,189200
210805,202107,57,51,6,56100,6600,62700
210810,202107,466,383,83,422400,92400,514800
210820,202107,2090,1746,344,1921700,378400,2300100
210825,202107,151,86,65,94600,71500,166100
210830,202107,717,479,238,526900,261800,788700
210840,202107,192,136,56,149600,61600,211200
210845,202107,231,167,64,183700,70400,254100
210850,202107,738,506,232,556600,255200,811800
210860,202107,3498,2024,1474,2227500,1621400,3848900
210870,202107,433,341,92,375100,101200,476300
210880,202107,75,58,17,63800,18700,82500
210890,202107,319,278,41,305800,45100,350900
210900,202107,625,409,216,449900,238700,688600
210905,202107,63,35,28,38500,30800,69300
210910,202107,1924,1466,458,1612600.7,503800,2116400.7
210920,202107,152,62,90,68200,99000,167200
210923,202107,84,68,16,74800,17600,92400
210927,202107,412,199,213,218900,234300,453200
210930,202107,68,55,13,60500,14300,74800
210940,202107,83,65,18,71500,19800,91300
210945,202107,200,111,89,122100,97900,220000
210950,202107,521,383,138,421300,151800,573100
210955,202107,85,52,33,57200,36300,93500
210960,202107,2216,1140,1076,1255100,1184700,2439800
210970,202107,116,102,14,112200,15400,127600
210975,202107,83,77,6,84700,6600,91300
210980,202107,1078,530,548,583000,602800,1185800
210990,202107,3949,2637,1312,2902900,1443200,4346100
211000,202107,1315,1068,247,1174800,271700,1446500
211003,202107,970,703,267,773300,293700,1067000
211010,202107,482,430,52,473000,57200,530200
211020,202107,1387,607,780,669900,858000,1527900
211023,202107,40,35,5,38500,5500,44000
211027,202107,73,53,20,58300,22000,80300
211030,202107,368,265,103,291500,113300,404800
211040,202107,293,248,45,272800,49500,322300
211050,202107,1132,760,372,836000,409200,1245200
211060,202107,633,557,76,613800.44,83600.49,697400.93
211065,202107,23,20,3,22000,3300,25300
211070,202107,879,737,142,810700,156200,966900
211080,202107,87,85,2,93500,2200,95700
211085,202107,49,27,22,29700,24200,53900
211090,202107,73,62,11,68200,12100,80300
211100,202107,466,389,77,427900,84700,512600
211102,202107,241,172,69,189200,75900,265100
211105,202107,223,156,67,171600,73700,245300
211107,202107,125,79,46,86900,50600,137500
211110,202107,929,624,305,686400,336600,1023000
211120,202107,5152,2613,2539,2874300,2792900,5667200
211125,202107,29,20,9,22000,9900,31900
211130,202107,40964,19047,21917,20958300.11,24116400,45074700.11
211140,202107,393,344,49,378400,53900,432300
211150,202107,1174,815,359,897600,394900,1292500
211153,202107,170,107,63,117700,69300,187000
211157,202107,67,54,13,59400,14300,73700
211160,202107,678,583,95,642400,104500,746900
211163,202107,3,3,0,3300,0,3300
211167,202107,10,9,1,9900,1100,11000
211170,202107,419,311,108,342100,118800,460900
211172,202107,114,78,36,85800,39600,125400
211174,202107,251,159,92,174900,101200,276100
211176,202107,464,345,119,379500,130900,510400
211178,202107,87,58,29,63800,31900,95700
211180,202107,209,170,39,187000,42900,229900
211190,202107,71,64,7,70400,7700,78100
211195,202107,34,22,12,24200,13200,37400
211200,202107,152,132,20,145200,22000,167200
211210,202107,416,307,109,337700,119900,457600
211220,202107,4138,2463,1675,2712600.5,1843600,4556200.5
211223,202107,92,89,3,97900,3300,101200
211227,202107,58,46,12,50600,13200,63800
211230,202107,726,598,128,657800,140800,798600
211240,202107,395,316,79,347600,86900,434500
211245,202107,178,91,87,100100,95700,195800
211250,202107,1521,1317,204,1449800,224400,1674200
211260,202107,790,656,134,721600,147400,869000
211270,202107,1916,1580,336,1740200,369600,2109800
211280,202107,1757,1149,608,1263900,668800,1932700
211285,202107,199,123,76,135300,83600,218900
211290,202107,721,515,206,566500,226600,793100
211300,202107,749,601,148,661100,162800,823900
211400,202107,1524,942,582,1036200,641300,1677500
220005,202107,16,15,1,16500,1100,17600
220010,202107,88,71,17,78100,18700,96800
220020,202107,687,552,135,607200,148500,755700
220025,202107,107,104,3,114400,3300,117700
220027,202107,48,39,9,42900,9900,52800
220030,202107,117,94,23,103400,25300,128700
220040,202107,1250,960,290,1058200,319000,1377200
220045,202107,33,22,11,24200,12100,36300
220050,202107,698,582,116,640384.13,127600,767984.13
220060,202107,175,153,22,169400,24200,193600
220070,202107,111,99,12,108900,13200,122100
220080,202107,15,13,2,14300,2200,16500
220090,202107,35,27,8,29700,8800,38500
220095,202107,2,1,1,1100,1100,2200
220100,202107,22,19,3,20900,3300,24200
220105,202107,25,23,2,25300,2200,27500
220110,202107,232,211,21,232100,23100,255200
220115,202107,37,36,1,39600,1100,40700
220117,202107,21,20,1,22000,1100,23100
220120,202107,1468,1123,345,1235300,379500,1614800
220130,202107,29,28,1,30800,1100,31900
220140,202107,99,79,20,86900,22000,108900
220150,202107,485,367,118,403700,130900,534600
220155,202107,10,9,1,9900,1100,11000
220157,202107,20,16,4,17600,4400,22000
220160,202107,96,85,11,93500,12100,105600
220170,202107,37,33,4,36300,4400,40700
220173,202107,8,8,0,8800,0,8800
220177,202107,11,10,1,11000,1100,12100
220180,202107,66,64,2,70400,2200,72600
220190,202107,1073,942,131,1036200,144100,1180300
220191,202107,41,34,7,37400,7700,45100
220192,202107,87,83,4,91300,4400,95700
220194,202107,59,55,4,60500,4400,64900
220196,202107,97,83,14,91300,15400,106700
220198,202107,3,2,1,2200,1100,3300
220200,202107,410,344,66,378400,72600,451000
220202,202107,36,31,5,34100,5500,39600
220205,202107,59,51,8,56100,8800,64900
220207,202107,13,13,0,14300,0,14300
220208,202107,75,43,32,47300,35200,82500
220209,202107,31,26,5,28600,5500,34100
220210,202107,22,15,7,16500,7700,24200
220211,202107,27,25,2,27500,2200,29700
220213,202107,37,33,4,36300,4400,40700
220217,202107,39,31,8,34100,8800,42900
220220,202107,2204,1454,750,1599400,825000,2424400
220225,202107,9,3,6,3300,6600,9900
220230,202107,956,737,219,811800,240900,1052700
220240,202107,163,144,19,158400,20900,179300
220245,202107,34,31,3,34100.18,3300,37400.18
220250,202107,124,106,18,116600,19800,136400
220253,202107,50,43,7,47300,7700,55000
220255,202107,37,31,6,34100,6600,40700
220260,202107,700,528,172,580800,189200,770000
220265,202107,9,7,2,7700,2200,9900
220270,202107,781,705,76,775500,84700,860200
220271,202107,42,34,8,37400,8800,46200
220272,202107,22,22,0,24200,0,24200
220273,202107,17,15,2,16500,2200,18700
220275,202107,58,48,10,52800,11000,63800
220277,202107,21,15,6,16500,6600,23100
220280,202107,16,11,5,12100,5500,17600
220285,202107,40,38,2,41800,2200,44000
220290,202107,1480,1270,210,1398100,231000,1629100
220300,202107,34,33,1,36300,1100,37400
220310,202107,327,279,48,306900,52800,359700
220320,202107,449,415,34,456500,37400,493900
220323,202107,2,1,1,1100,1100,2200
220325,202107,10,9,1,9900,1100,11000
220327,202107,11,11,0,12100,0,12100
220330,202107,233,170,63,187000,69300,256300
220335,202107,139,121,18,133100,19800,152900
220340,202107,42,30,12,33000,13200,46200
220342,202107,56,48,8,52800,8800,61600
220345,202107,78,70,8,77000,8800,85800
220350,202107,452,390,62,429000,68200,497200
220360,202107,38,28,10,30800,11000,41800
220370,202107,1261,1040,221,1145100,243100,1388200
220375,202107,18,17,1,18700,1100,19800
220380,202107,23,17,6,18700,6600,25300
220385,202107,15,14,1,15400,1100,16500
220390,202107,2304,1296,1008,1425600,1108800,2534400
220400,202107,34,30,4,33000,4400,37400
220410,202107,21,19,2,20900,2200,23100
220415,202107,12,11,1,12100,1100,13200
220420,202107,127,107,20,117700,22000,139700
220430,202107,127,113,14,124300,15400,139700
220435,202107,24,17,7,18700,7700,26400
220440,202107,284,243,41,268400,45100,313500
220450,202107,335,171,164,188100,180400,368500
220455,202107,51,50,1,55000,1100,56100
220460,202107,18,17,1,18700,1100,19800
220465,202107,88,58,30,63800,33000,96800
220470,202107,247,213,34,234300,37400,271700
220480,202107,70,63,7,69300,7700,77000
220490,202107,87,74,13,81400,14300,95700
220500,202107,108,93,15,102300,16500,118800
220510,202107,398,310,88,341000,97900,438900
220515,202107,20,18,2,19800,2200,22000
220520,202107,370,328,42,361900,46200,408100
220525,202107,10,7,3,7700,3300,11000
220527,202107,17,14,3,15400,3300,18700
220530,202107,36,14,22,15400,24200,39600
220535,202107,5,4,1,4400,1100,5500
220540,202107,74,62,12,68200,13200,81400
220545,202107,37,25,12,27500,13200,40700
220550,202107,706,563,143,619300,157300,776600
220551,202107,17,13,4,14300,4400,18700
220552,202107,11,11,0,12100,0,12100
220553,202107,53,48,5,52800,5500,58300
220554,202107,11,8,3,8800,3300,12100
220555,202107,36,30,6,33000,6600,39600
220556,202107,39,36,3,39600,3300,42900
220557,202107,56,52,4,57200,4400,61600
220558,202107,7,3,4,3300,4400,7700
220559,202107,3,3,0,3300,0,3300
220560,202107,69,45,24,49500,26400,75900
220570,202107,728,455,273,500500,300300,800800
220580,202107,546,498,48,547800,52800,600600
220585,202107,10,9,1,9900,1100,11000
220590,202107,14,13,1,14300,1100,15400
220595,202107,71,55,16,60500,17600,78100
220600,202107,22,14,8,15400,8800,24200
220605,202107,25,22,3,24200,3300,27500
220610,202107,84,71,13,78100,14300,92400
220620,202107,556,465,91,511500,100100,611600
220630,202107,5,4,1,4400,1100,5500
220635,202107,40,35,5,38500,5500,44000
220640,202107,107,88,19,96800,20900,117700
220650,202107,112,106,6,116600,6600,123200
220660,202107,59,47,12,51700,13200,64900
220665,202107,7,7,0,7700,0,7700
220667,202107,18,16,2,17600,2200,19800
220669,202107,30,24,6,26400,6600,33000
220670,202107,70,57,13,62700,14300,77000
220672,202107,79,57,22,62700,24200,86900
220675,202107,36,27,9,29700,9900,39600
220680,202107,43,38,5,41800,5500,47300
220690,202107,51,48,3,52800,3300,56100
220695,202107,27,15,12,16500,13200,29700
220700,202107,1722,1334,388,1467400,426800,1894200
220710,202107,6,4,2,4400,2200,6600
220720,202107,107,92,15,101200,16500,117700
220730,202107,19,16,3,17600,3300,20900
220735,202107,4,0,4,0,4400,4400
220740,202107,50,44,6,48400,6600,55000
220750,202107,112,97,15,106700,16500,123200
220755,202107,15,14,1,15400,1100,16500
220760,202107,68,61,7,67100,7700,74800
220770,202107,5771,3203,2568,3525500.7,2825900,6351400.7
220775,202107,16,11,5,12100,5500,17600
220777,202107,20,19,1,20900,1100,22000
220779,202107,1,0,1,0,1100,1100
220780,202107,900,769,131,845900,144100,990000
220785,202107,5,1,4,1100,4400,5500
220790,202107,1112,877,235,966900,258500,1225400
220793,202107,6,6,0,6600,0,6600
220795,202107,13,12,1,13200,1100,14300
220800,202107,4020,3082,938,3392604,1032900,4425504
220810,202107,68,59,9,66000,9900,75900
220820,202107,240,217,23,238700,25300,264000
220830,202107,1273,1101,172,1212200,189200,1401400
220840,202107,2430,1705,725,1876600,799700,2676300
220850,202107,64,56,8,61600,8800,70400
220855,202107,9,5,4,5500,4400,9900
220860,202107,11,10,1,11000,1100,12100
220865,202107,28,26,2,28600,2200,30800
220870,202107,83,74,9,81400,9900,91300
220880,202107,321,256,65,281600,71500,353100
220885,202107,30,28,2,30800,2200,33000
220887,202107,10,9,1,9900,1100,11000
220890,202107,90,78,12,85800,13200,99000
220900,202107,27,16,11,17600,12100,29700
220910,202107,52,43,9,47300,9900,57200
220915,202107,12,11,1,12100,1100,13200
220920,202107,48,42,6,46200,6600,52800
220930,202107,48,46,2,50600,2200,52800
220935,202107,15,15,0,17600,0,17600
220937,202107,32,31,1,34100,1100,35200
220940,202107,54,50,4,55000,4400,59400
220945,202107,3,3,0,3300,0,3300
220950,202107,38,30,8,33000,8800,41800
220955,202107,20,19,1,20900,1100,22000
220960,202107,22,21,1,23100,1100,24200
220965,202107,38,34,4,37400,4400,41800
220970,202107,59,50,9,55000,9900,64900
220975,202107,13,12,1,13200,1100,14300
220980,202107,32,29,3,31900,3300,35200
220985,202107,60,54,6,59400,6600,66000
220987,202107,30,29,1,31900,1100,33000
220990,202107,27,26,1,28600,1100,29700
220995,202107,16,13,3,14300,3300,17600
220997,202107,59,51,8,56100,8800,64900
221000,202107,1187,1070,117,1178100,128700,1306800
221005,202107,45,42,3,46200,3300,49500
221010,202107,18,14,4,15400,4400,19800
221020,202107,35,34,1,37400,1100,38500
221030,202107,40,32,8,35200,8800,44000
221035,202107,24,24,0,26400,0,26400
221037,202107,13,9,4,9900,4400,14300
221038,202107,28,25,3,27500,3300,30800
221039,202107,25,25,0,27500,0,27500
221040,202107,264,227,37,250800,40700,291500
221050,202107,227,191,36,211200,39600,250800
221060,202107,1890,1642,248,1806200,272800,2079000
221062,202107,31,30,1,33000,1100,34100
221063,202107,14,10,4,11000,4400,15400
221065,202107,63,51,12,56100,13200,69300
221070,202107,137,122,15,134200,16500,150700
221080,202107,374,321,53,353100,58300,411400
221090,202107,24,19,5,20900,5500,26400
221093,202107,43,32,11,35200,12100,47300
221095,202107,5,5,0,5500,0,5500
221097,202107,13,11,2,12100,2200,14300
221100,202107,25710,15339,10371,16889401.17,11420200,28309601.17
221110,202107,1112,843,269,927300,295900,1223200
221120,202107,535,396,139,435600,152900,588500
221130,202107,968,782,186,860200,204600,1064800
221135,202107,33,29,4,31900,4400,36300
221140,202107,46,40,6,44000,6600,50600
221150,202107,11,8,3,8800,3300,12100
221160,202107,11,11,0,12100,0,12100
221170,202107,17,17,0,18700,0,18700
230010,202107,151,136,15,149600,16500,166100
230015,202107,138,112,26,123200,28600,151800
230020,202107,1630,1366,264,1503700,290400,1794100
230030,202107,1662,1196,466,1317800,512600,1830400
230040,202107,228,191,37,210100,40700,250800
230050,202107,232,172,60,189200,66000,255200
230060,202107,161,127,34,139700,37400,177100
230070,202107,302,259,43,284900,48400,333300
230075,202107,855,735,120,808500,132000,940500
230080,202107,194,167,27,183700,29700,213400
230090,202107,141,104,37,114400,40700,155100
230100,202107,2253,1273,980,1401400,1078000,2479400
230110,202107,2874,1837,1037,2022900.11,1141800,3164700.11
230120,202107,1041,819,222,902000,245300,1147300
230125,202107,154,125,29,137500,31900,169400
230130,202107,471,420,51,462000,56100,518100
230140,202107,218,180,38,198000,41800,239800
230150,202107,153,118,35,129800,38500,168300
230160,202107,950,799,151,880000,166100,1046100
230170,202107,609,541,68,595100,74800,669900
230180,202107,71,65,6,71500,6600,78100
230185,202107,410,352,58,387200,63800,451000
230190,202107,2372,1849,523,2033900.32,575300,2609200.32
230195,202107,498,431,67,474100,73700,547800
230200,202107,412,331,81,364100,89100,453200
230205,202107,385,256,129,282700,141900,424600
230210,202107,1378,1066,312,1172600,343200,1515800
230220,202107,1573,1071,502,1178100,552200,1730300
230230,202107,964,814,150,895400,166100,1061500
230240,202107,1820,1577,243,1734975,267300,2002275
230250,202107,1783,1465,318,1613700,349800,1963500
230260,202107,3207,1985,1222,2186800,1344200,3531000
230270,202107,1376,1098,278,1207800.05,306900,1514700.05
230280,202107,2744,2081,663,2290200,729300,3019500
230290,202107,365,325,40,357500.5,44000,401500.5
230300,202107,529,386,143,424600,157300,581900
230310,202107,424,327,97,360800,107800,468600
230320,202107,907,770,137,847000,150700,997700
230330,202107,304,243,61,267300,67100,334400
230340,202107,443,359,84,394900,92400,487300
230350,202107,3216,2009,1207,2212100,1327700,3539800
230360,202107,271,223,48,245300,52800,298100
230365,202107,130,107,23,117700,25300,143000
230370,202107,10418,5142,5276,5659500.92,5804700,11464200.92
230380,202107,496,425,71,467500,78100,545600
230390,202107,533,298,235,327800,258500,586300
230393,202107,249,207,42,227700,46200,273900
230395,202107,342,277,65,304700,72600,377300
230400,202107,632,506,126,557700,138600,696300
230410,202107,2658,1644,1014,1810600.5,1116500,2927100.5
230420,202107,6348,4198,2150,4620001.01,2365000,6985001.01
230423,202107,339,295,44,324500,48400,372900
230425,202107,442,354,88,389400,96800,486200
230426,202107,116,93,23,102300,25300,127600
230427,202107,69,65,4,71500,4400,75900
230428,202107,1548,759,789,834900,867900,1702800
230430,202107,454,365,89,401500,97900,499400
230435,202107,915,670,245,737000,269500.24,1006500.24
230440,202107,91070,40980,50090,45106490.56,55125400.55,100231891.11
230445,202107,312,212,100,233200,110000,343200
230450,202107,578,455,123,501600,135300,636900
230460,202107,76,56,20,61600,23100,84700
230465,202107,307,247,60,271700,66000,337700
230470,202107,2025,1591,434,1751200,477400,2228600
230480,202107,152,142,10,156200,11000,167200
230490,202107,319,252,67,277200,73700,350900
230495,202107,467,334,133,367400,146300,513700
230500,202107,1023,756,267,832700,293700,1126400
230510,202107,55,42,13,46200,14300,60500
230520,202107,391,305,86,335500,94600,430100
230523,202107,2370,1467,903,1614800,993300,2608100
230526,202107,270,233,37,256300,40700,297000
230530,202107,685,507,178,557700,195800,753500
230533,202107,209,192,17,211200.6,18700,229900.6
230535,202107,367,276,91,303600,100100,403700
230540,202107,1800,1603,197,1764400,216700,1981100
230550,202107,3888,2478,1410,2726900,1552356.66,4279256.66
230560,202107,580,438,142,481800,156200,638000
230565,202107,219,161,58,178200,63800,242000
230570,202107,286,248,38,273900,41800,315700
230580,202107,1178,847,331,932800,364100,1296900
230590,202107,1000,778,222,856900,244200,1101100
230600,202107,251,230,21,253000,23100,276100
230610,202107,401,301,100,331100,110000,441100
230620,202107,166,143,23,157300,25300,182600
230625,202107,796,545,251,599500,277200,876700
230630,202107,1327,1021,306,1124200,336600,1460800
230640,202107,3815,3212,603,3536500.53,663300,4199800.53
230650,202107,496,424,72,466400,79200,545600
230655,202107,698,580,118,639100,129800,768900
230660,202107,361,297,64,326700,70400,397100
230670,202107,442,373,69,410300,75900,486200
230680,202107,203,184,19,202400,20900,223300
230690,202107,914,769,145,848100,159500,1007600
230700,202107,873,732,141,805200,155100,960300
230710,202107,693,654,39,719400,42900,762300
230720,202107,144,124,20,137500,23100,160600
230725,202107,227,171,56,188100,61600,249700
230730,202107,12378,6667,5711,7336931.32,6288700.82,13625632.14
230740,202107,667,537,130,591800,143000,734800
230750,202107,827,697,130,766700,143000,909700
230760,202107,1421,1220,201,1342000,221100,1563100
230763,202107,337,277,60,304700,66000,370700
230765,202107,7832,3655,4177,4021600.6,4599100,8620700.6
230770,202107,4956,2527,2429,2779700,2676300,5456000
230780,202107,741,653,88,719400,96800,816200
230790,202107,296,245,51,269500,56100,325600
230800,202107,1162,840,322,924000,354200,1278200
230810,202107,1356,1197,159,1316700,174900,1491600
230820,202107,361,248,113,272800,124300,397100
230830,202107,965,817,148,898700,162800,1061500
230835,202107,280,239,41,262900,45100,308000
230837,202107,173,145,28,159500,30800,190300
230840,202107,920,717,203,790900,223300,1014200
230850,202107,1442,1242,200,1366200,220000,1586200
230860,202107,302,224,78,246400,85806,332206
230870,202107,1825,1544,281,1700600,309100,2009700
230880,202107,73,57,16,62700,17600,80300
230890,202107,539,488,51,537900,56100,594000
230900,202107,276,207,69,227700,75900.7,303600.7
230910,202107,223,171,52,188100,57200,245300
230920,202107,479,380,99,418000,108900,526900
230930,202107,1009,707,302,778800,332200,1111000
230940,202107,842,651,191,716100,210100,926200
230945,202107,521,419,102,460900,112200,573100
230950,202107,422,366,56,403700,61600,465300
230960,202107,2693,1798,895,1981100,986700,2967800
230970,202107,1717,963,754,1060400.25,829400,1889800.25
230980,202107,201,162,39,178200,42900,221100
230990,202107,137,110,27,121000,29700,150700
231000,202107,192,175,17,192500,18700,211200
231010,202107,157,113,44,124300,48400,172700
231020,202107,1371,953,418,1048300,460900,1509200
231025,202107,1061,769,292,847000,322300,1169300
231030,202107,1074,894,180,985600,198000,1183600
231040,202107,150,101,49,111100,53900,165000
231050,202107,942,827,115,909700,126500,1036200
231060,202107,156,130,26,143000,28600,171600
231070,202107,1491,1036,455,1140700,500500,1641200
231080,202107,262,235,27,259600,29700,289300
231085,202107,631,382,249,421300,273900,695200
231090,202107,256,208,48,228800,53900,282700
231095,202107,165,131,34,144100,38500,182600
231100,202107,161,132,29,145200,31900,177100
231110,202107,370,312,58,343200,63800,407000
231120,202107,267,225,42,248600,46200,294800
231123,202107,154,144,10,158400,11000,169400
231126,202107,329,253,76,278300,83600,361900
231130,202107,4844,3796,1048,4176700,1152800,5329500
231135,202107,212,184,28,202400,30800,233200
231140,202107,3070,2227,843,2451900,928400,3380300
231150,202107,373,350,23,385000,25300,410300
231160,202107,1209,966,243,1063700,267300,1331000
231170,202107,515,360,155,396000,170500,566500
231180,202107,1712,1476,236,1624700,259600,1884300
231190,202107,208,174,34,191400,37400,228800
231195,202107,224,189,35,207900,38500,246400
231200,202107,807,663,144,729300,158400,887700
231210,202107,526,446,80,490600,88000,578600
231220,202107,1040,757,283,833800.85,312400,1146200.85
231230,202107,1464,1139,325,1254000,357500,1611500
231240,202107,1456,1027,429,1130800,473000,1603800
231250,202107,99,93,6,102300,6600,108900
231260,202107,266,177,89,194700,97900,292600
231270,202107,995,796,199,875600,218900,1094500
231280,202107,74,57,17,62700,18700,81400
231290,202107,7744,4366,3378,4805900,3722400.57,8528300.57
231300,202107,604,557,47,612700,51700,664400
231310,202107,749,685,64,755700,70400,826100
231320,202107,589,445,144,490600,158400,649000
231325,202107,102,89,13,97900,14300,112200
231330,202107,1937,1489,448,1639000.74,493900,2132900.74
231335,202107,254,225,29,247500,31900,279400
231340,202107,1739,1263,476,1389300,523600,1912900
231350,202107,1311,1055,256,1160500,281600,1442100
231355,202107,432,368,64,405900,70400,476300
231360,202107,530,375,155,413600.65,170500,584100.65
231370,202107,93,82,11,90200,12100,102300
231375,202107,294,212,82,233200,90200,323400
231380,202107,498,393,105,432300,115500,547800
231390,202107,213,163,50,179300,55000,234300
231395,202107,758,469,289,517000,317900,834900
231400,202107,1130,942,188,1036200,206800,1243000
231410,202107,1330,1096,234,1208900,258500,1467400
240010,202107,377,165,212,181500.97,233200,414700.97
240020,202107,2203,1788,415,1966800.9,456500,2423300.9
240030,202107,117,98,19,107800,20900,128700
240040,202107,29,29,0,31900,0,31900
240050,202107,535,455,80,500500,88000,588500
240060,202107,65,61,4,67100,4400,71500
240070,202107,229,180,49,198000,53900,251900
240080,202107,532,361,171,397100,188100.7,585200.7
240090,202107,103,92,11,101200,12100,113300
240100,202107,1484,1397,87,1537800.5,95700,1633500.5
240110,202107,1031,678,353,745800,388300,1134100
240120,202107,142,108,34,118800,37400,156200
240130,202107,274,254,20,279400,22000,301400
240140,202107,83,57,26,62700,28600,91300
240145,202107,719,636,83,699600,92400,792000
240150,202107,22,17,5,18700,5500,24200
240160,202107,44,35,9,38500,9900,48400
240165,202107,38,30,8,33000,8800,41800
240170,202107,116,80,36,89100,39600,128700
240180,202107,97,74,23,81400,25300,106700
240185,202107,44,40,4,44000,4400,48400
240190,202107,17,15,2,16500,2200,18700
240200,202107,3050,1683,1367,1852400,1504800,3357200
240210,202107,170,131,39,144100,42900,187000
240220,202107,1110,796,314,875600,345400,1221000
240230,202107,840,767,73,843700,80300,924000
240240,202107,68,48,20,52800,22000,74800
240250,202107,92,78,14,85800,15400,101200
240260,202107,1807,1321,486,1456400,534600,1991000
240270,202107,180,158,22,173800,24200,198000
240280,202107,52,40,12,44000,13200,57200
240290,202107,47,45,2,49500,2200,51700
240300,202107,172,93,79,102300,86900,189200
240310,202107,2382,1291,1091,1421200.19,1201200,2622400.19
240320,202107,186,173,13,190300,14300,204600
240325,202107,4624,2733,1891,3010701.85,2080100,5090801.85
240330,202107,70,66,4,72600,4400,77000
240340,202107,79,53,26,58300,28600,86900
240350,202107,94,80,14,88000,15400,103400
240360,202107,589,361,228,397100,250800,647900
240370,202107,55,51,4,56100,4400,60500
240375,202107,64,38,26,41800,28600,70400
240380,202107,229,188,41,206800,45100,251900
240390,202107,12,11,1,12100,1100,13200
240400,202107,82,73,9,80300,9900,90200
240410,202107,14,8,6,8800,6600,15400
240420,202107,1043,764,279,840400,306900,1147300
240430,202107,261,245,16,269500,17600,287100
240440,202107,124,68,56,74800,61600,136400
240450,202107,231,151,80,166100,88000,254100
240460,202107,73,57,16,62700,17600,80300
240470,202107,231,208,23,228800,25300,254100
240480,202107,16,14,2,15400,2200,17600
240485,202107,83,69,14,75900,15400,91300
240490,202107,48,44,4,48400,4400,52800
240500,202107,89,68,21,74800,23100,97900
240510,202107,43,31,12,34100,13200,47300
240520,202107,103,98,5,107800,5500,113300
240530,202107,58,51,7,56100,7700,63800
240540,202107,81,69,12,75900,13200,89100
240550,202107,13,12,1,13200,1100,14300
240560,202107,373,270,103,297000,113300,410300
240570,202107,437,276,161,303600,177100,480700
240580,202107,1279,997,282,1096700,310200,1406900
240590,202107,31,29,2,31900,2200,34100
240600,202107,100,96,4,105600,4400,110000
240610,202107,509,423,86,465300,94600,559900
240615,202107,17,16,1,17600,1100,18700
240620,202107,89,86,3,94600,3300,97900
240630,202107,39,34,5,37400,5500,42900
240640,202107,26,21,5,23100,5500,28600
240650,202107,237,195,42,214500,46200,260700
240660,202107,111,94,17,103400,18700,122100
240670,202107,312,175,137,192500,150700,343200
240680,202107,52,39,13,42900,14300,57200
240690,202107,47,44,3,48400,3300,51700
240700,202107,186,153,33,168300,36300,204600
240710,202107,2061,1265,796,1391500,877800,2269300
240720,202107,1063,776,287,853600,315700,1169300
240725,202107,67,62,5,68200,5500,73700
240730,202107,148,123,25,135300,27500,162800
240740,202107,230,195,35,214500,38500,253000
240750,202107,51,30,21,33000,23100,56100
240760,202107,47,43,4,47300,4400,51700
240770,202107,150,116,34,127600,37400,165000
240780,202107,704,586,118,645700,129800,775500
240790,202107,44,42,2,46200,2200,48400
240800,202107,9295,6301,2994,6931394.18,3295600,10226994.18
240810,202107,20904,11212,9692,12345300.08,10667800.95,23013101.03
240820,202107,252,148,104,162800,114400,277200
240830,202107,1618,1333,285,1466300,313500,1779800
240840,202107,77,67,10,73700,11000,84700
240850,202107,83,75,8,82500,8800,91300
240860,202107,105,101,4,111100,4400,115500
240870,202107,58,50,8,56100.9,8800,64900.9
240880,202107,31,28,3,30800,3300,34100
240890,202107,1141,643,498,707300,547800,1255100
240895,202107,63,46,17,50600,18700,69300
240910,202107,165,141,24,155100,26400,181500
240920,202107,13,11,2,12100,2200,14300
240930,202107,402,360,42,396000,46200,442200
240933,202107,52,34,18,37400,19800,57200
240940,202107,2327,2063,264,2272600,290400,2563000
240950,202107,47,42,5,46200,5500,51700
240960,202107,25,21,4,23100,4400,27500
240970,202107,115,85,30,93500,33000,126500
240980,202107,199,162,37,179300,40700,220000
240990,202107,133,90,43,99000,47300,146300
241000,202107,59,56,3,61600,3300,64900
241010,202107,76,57,19,62700,20900,83600
241020,202107,107,98,9,107800,9900,117700
241025,202107,14,7,7,7700,7700,15400
241030,202107,111,88,23,96800,25300,122100
241040,202107,42,30,12,33000,13200,46200
241050,202107,77,70,7,77000,7700,84700
241060,202107,28,23,5,25300,5500,30800
241070,202107,16,16,0,17600,0,17600
241080,202107,60,53,7,58300,7700,66000
241090,202107,52,41,11,45100,12100,57200
241100,202107,73,62,11,68200,12100,80300
241105,202107,11,4,7,4400,7700,12100
241110,202107,45,40,5,44000,5500,49500
241120,202107,1524,1152,372,1269400,409200,1678600
241140,202107,216,180,36,199100,39600,238700
241142,202107,43,35,8,38500,8800,47300
241150,202107,1204,1054,150,1159400,165000,1324400
241160,202107,17,16,1,17600,1100,18700
241170,202107,48,40,8,44000,8800,52800
241180,202107,43,35,8,39600,8800,48400
241190,202107,38,36,2,39600,2200,41800
241200,202107,4047,2125,1922,2338600.53,2114200,4452800.53
241210,202107,67,58,9,63800,9900,73700
241220,202107,1442,962,480,1058201.1,528000,1586201.1
241230,202107,246,205,41,225500,45100,270600
241240,202107,53,41,12,45100,13200,58300
241250,202107,1127,1032,95,1137400,104500,1241900
241255,202107,54,44,10,48400,11000,59400
241260,202107,675,520,155,572000,170500,742500
241270,202107,64,44,20,48400,22000,70400
241280,202107,96,85,11,93500,12100,105600
241290,202107,129,91,38,100100,41800,141900
241300,202107,83,57,26,62700,28600,91300
241310,202107,51,36,15,39600,16500,56100
241320,202107,30,16,14,17600,15400,33000
241330,202107,62,54,8,59400,8800,68200
241335,202107,74,67,7,73700,7700,81400
241340,202107,182,134,48,147400,52800,200200
241350,202107,62,53,9,58300,9900,68200
241355,202107,51,42,9,46200,9900,56100
241360,202107,49,48,1,52800,1100,53900
241370,202107,56,44,12,48400,13200,61600
241380,202107,34,30,4,33000,4400,37400
241390,202107,83,64,19,70400,20900,91300
241400,202107,215,169,46,185900,50600,236500
241410,202107,183,166,17,182600,18700,201300
241415,202107,101,83,18,91300,19800,111100
241420,202107,106,78,28,85800,30800,116600
241430,202107,24,22,2,24200,2200,26400
241440,202107,528,439,89,482900,97900,580800
241445,202107,39,34,5,37400,5500,42900
241450,202107,265,219,46,242000,50600,292600
241460,202107,145,132,13,145200,14300,159500
241470,202107,34,29,5,31900,5500,37400
241475,202107,52,49,3,53900,3300,57200
241480,202107,116,85,31,93500,34100,127600
241490,202107,11,10,1,11000,1100,12100
241500,202107,44,33,11,36300,12100,48400
250010,202107,100,86,14,94600,15400,110000
250020,202107,31,28,3,30800,3300,34100
250030,202107,893,666,227,732600,249700,982300
250040,202107,387,320,67,352000,73700,425700
250050,202107,258,210,48,231000,52800,283800
250053,202107,60,47,13,51700,14300,66000
250057,202107,1,1,0,1100,0,1100
250060,202107,598,432,166,475200,182600,657800
250070,202107,687,552,135,607200.22,148500,755700.22
250073,202107,7,7,0,7700,0,7700
250077,202107,177,130,47,143000,51700,194700
250080,202107,422,332,90,365200,99000,464200
250090,202107,224,144,80,158400,88000,246400
250100,202107,532,444,88,488400,96800,585200
250110,202107,642,486,156,534600,171600,706200
250115,202107,17,4,13,4400,14300,18700
250120,202107,124,90,34,99000,37400,136400
250130,202107,567,456,111,501600,122100,623700
250135,202107,20,11,9,12100,9900,22000
250140,202107,83,74,9,81400,9900,91300
250150,202107,601,429,172,471900,189200,661100
250153,202107,12,9,3,9900,3300,13200
250157,202107,29,24,5,26400,5500,31900
250160,202107,227,180,47,198000,51700,249700
250170,202107,67,43,24,47300,26400,73700
250180,202107,4482,3060,1422,3366000,1565300,4931300
250190,202107,834,556,278,611600,305800,917400
250200,202107,57,43,14,47300,15400,62700
250205,202107,23,19,4,20900,4400,25300
250210,202107,86,75,11,82500,12100,94600
250215,202107,68,52,16,57200,17600,74800
250220,202107,26,19,7,20900,7700,28600
250230,202107,77,69,8,75900,8800,84700
250240,202107,234,184,50,202400,55000,257400
250250,202107,381,328,53,360800,58300,419100
250260,202107,42,34,8,37400,8800,46200
250270,202107,75,52,23,57200,25300,82500
250280,202107,378,307,71,337700,78100,415800
250290,202107,92,85,7,93500,7700,101200
250300,202107,562,379,183,416900,201300,618200
250310,202107,44,40,4,44000,4400,48400
250320,202107,1952,1308,644,1438800,708400,2147200
250330,202107,103,88,15,97900,16500,114400
250340,202107,28,24,4,26400,4400,30800
250350,202107,185,120,65,132000,71500,203500
250355,202107,31,23,8,25300,8800,34100
250360,202107,198,164,34,180400,38500,218900
250370,202107,2371,1543,828,1699500,910800,2610300
250375,202107,11,6,5,6600,5500,12100
250380,202107,56,45,11,49500,12100,61600
250390,202107,46,36,10,39600,11000,50600
250400,202107,16436,8271,8165,9103581.02,8996900,18100481.02
250403,202107,323,255,68,280500,74800,355300
250407,202107,62,50,12,55000,13200,68200
250410,202107,29,25,4,27500,4400,31900
250415,202107,42,28,14,30800,15400,46200
250420,202107,42,36,6,39600,6600,46200
250430,202107,1435,1237,198,1360975,217800,1578775
250435,202107,20,14,6,15400,6600,22000
250440,202107,679,566,113,622600,124300,746900
250450,202107,83,64,19,70400,20900,91300
250460,202107,470,310,160,341000,176000,517000
250470,202107,97,67,30,73700,33000,106700
250480,202107,330,263,67,289300,73700,363000
250485,202107,4,4,0,4400,0,4400
250490,202107,230,186,44,204600,48400,253000
250500,202107,98,74,24,81400,26400,107800
250510,202107,780,626,154,688600,169400,858000
250520,202107,171,114,57,125400,62700,188100
250523,202107,122,98,24,107800,26400,134200
250527,202107,109,85,24,93500,26400,119900
250530,202107,8,5,3,5500,3300,8800
250535,202107,30,22,8,24200,8800,33000
250540,202107,138,109,29,119900,31900,151800
250550,202107,69,66,3,72600,3300,75900
250560,202107,54,35,19,38500,20900,59400
250570,202107,159,130,29,143000,31900,174900
250580,202107,102,79,23,88071,25300,113371
250590,202107,24,14,10,15400,11000,26400
250600,202107,1462,961,501,1057100.7,552200,1609300.7
250610,202107,160,132,28,145200,30800,176000
250620,202107,21,17,4,18700,4400,23100
250625,202107,72,54,18,59400,19800,79200
250630,202107,3114,1987,1127,2186800.62,1239700,3426500.62
250640,202107,199,159,40,174900,44000,218900
250650,202107,28,20,8,22000,8800,30800
250660,202107,56,40,16,44000,17600,61600
250670,202107,67,50,17,55000,18700,73700
250680,202107,412,331,81,364100,89100,453200
250690,202107,2090,1449,641,1597200.7,705100,2302300.7
250700,202107,927,797,130,876700,143000,1019700
250710,202107,444,348,96,382800,105600,488400
250720,202107,119,86,33,94600,36556.66,131156.66
250730,202107,409,337,72,370700,79200,449900
250740,202107,60,58,2,63800,2200,66000
250750,202107,22905,13692,9213,15070981.41,10158500,25229481.41
250760,202107,105,82,23,90200,25300,115500
250770,202107,355,233,122,256300,135300,391600
250780,202107,69,46,23,50600,25300,75900
250790,202107,456,291,165,321200,181500,502700
250800,202107,154,139,15,152900,16500,169400
250810,202107,73,58,15,63800,16500,80300
250820,202107,150,126,24,138600,26400,165000
250830,202107,442,289,153,317900,168300,486200
250840,202107,54,48,6,52800,6600,59400
250850,202107,56,47,9,51700,9900,61600
250855,202107,16,14,2,15400,2200,17600
250860,202107,236,151,85,166100,93500,259600
250870,202107,28,25,3,27500,3300,30800
250880,202107,87,63,24,69300,26400,95700
250890,202107,2976,2216,760,2437600,836000,3273600
250900,202107,55,45,10,49500,11000,60500
250905,202107,123,94,29,103400,31900,135300
250910,202107,1071,791,280,870100,308000,1178100
250915,202107,101,72,29,79200,31900,111100
250920,202107,141,104,37,114400,40700,155100
250930,202107,174,102,72,112200,79200,191400
250933,202107,7,5,2,5500,2200,7700
250937,202107,11,11,0,12100,0,12100
250939,202107,32,25,7,27500,7700,35200
250940,202107,112,82,30,90200,33000,123200
250950,202107,71,48,23,52800,25300,78100
250960,202107,91,49,42,53900,46200,100100
250970,202107,1230,872,358,959200,393800,1353000
250980,202107,103,67,36,73700,39600,113300
250990,202107,169,130,39,143000,42900,185900
251000,202107,76,66,10,72600,11000,83600
251010,202107,115,87,28,95700,30800,126500
251020,202107,73,59,14,66000,15400,81400
251030,202107,45,34,11,37400,12100,49500
251040,202107,55,37,18,40700,19800,60500
251050,202107,25,22,3,24200,3300,27500
251060,202107,49,40,9,44000,9900,53900
251065,202107,6,4,2,4400,2200,6600
251070,202107,16,13,3,14300,3300,17600
251080,202107,5083,2409,2674,2652100,2944700.1,5596800.1
251090,202107,184,153,31,168300,34100,202400
251100,202107,19,19,0,20900,0,20900
251110,202107,49,38,11,41800,12100,53900
251120,202107,1888,1159,729,1276001.19,801900,2077901.19
251130,202107,412,339,73,374000,80300,454300
251140,202107,565,363,202,399300,222200,621500
251150,202107,342,288,54,316800,59400,376200
251160,202107,95,78,17,85800,18700,104500
251170,202107,98,78,20,85800,22000,107800
251180,202107,287,174,113,191400,124300,315700
251190,202107,200,128,72,140800,79200,220000
251200,202107,273,219,54,240900,59400,300300
251203,202107,33,31,2,34100,2200,36300
251207,202107,83,69,14,75900,15400,91300
251210,202107,1480,1083,397,1192400,436700,1629100
251220,202107,45,36,9,39600,9900,49500
251230,202107,588,489,99,537900,108900,646800
251240,202107,103,73,30,80300,33000,113300
251250,202107,1433,1035,398,1138500,437800,1576300
251260,202107,12,8,4,8800,4400,13200
251270,202107,305,239,66,264000,72600,336600
251272,202107,65,58,7,63800,7700,71500
251274,202107,29,22,7,24200,7700,31900
251275,202107,33,18,15,19800,16500,36300
251276,202107,19,16,3,17600,3300,20900
251278,202107,9,7,2,7700,2200,9900
251280,202107,99,94,5,103400,5500,108900
251290,202107,893,639,254,702900,279400,982300
251300,202107,16,12,4,13200,4400,17600
251310,202107,292,216,76,238700,83600,322300
251315,202107,38,34,4,37400,4400,41800
251320,202107,66,50,16,55000,17600,72600
251330,202107,79,71,8,78100,8800,86900
251335,202107,22,10,12,11000,13200,24200
251340,202107,752,442,310,486200,342100,828300
251350,202107,34,33,1,36300,1100,37400
251360,202107,84,72,12,79200,13200,92400
251365,202107,11,11,0,12100,0,12100
251370,202107,5612,3783,1829,4164600.32,2015200,6179800.32
251380,202107,44,34,10,37400,11000,48400
251385,202107,2,2,0,2200,0,2200
251390,202107,862,643,219,707300,240900,948200
251392,202107,21,12,9,13200,9900,23100
251394,202107,9,9,0,9900,0,9900
251396,202107,14,10,4,11000,4400,15400
251398,202107,15,13,2,14300,2200,16500
251400,202107,45,36,9,39600,9900,49500
251410,202107,39,33,6,36300,6600,42900
251420,202107,102,74,28,81400,30800,112200
251430,202107,45,41,4,45100,4400,49500
251440,202107,46,25,21,27500,23100,50600
251445,202107,57,50,7,55000,7700,62700
251450,202107,403,349,54,385000,59400,444400
251455,202107,4,3,1,3300,1100,4400
251460,202107,17,15,2,16500,2200,18700
251465,202107,7,5,2,5500,2200,7700
251470,202107,50,37,13,40700,14300,55000
251480,202107,27,22,5,24200,5500,29700
251490,202107,110,70,40,77000,44000,121000
251500,202107,125,101,24,111100,26400,137500
251510,202107,72,46,26,50600,28600,79200
251520,202107,31,29,2,31900,2200,34100
251530,202107,4382,3113,1269,3425400,1398100,4823500
251540,202107,82,67,15,73700,16500,90200
251550,202107,410,312,98,343200,107800,451000
251560,202107,24,16,8,17600,8800,26400
251570,202107,18,16,2,17600,2200,19800
251580,202107,134,107,27,117700,29700,147400
251590,202107,113,80,33,88207.9,36300,124507.9
251593,202107,24,15,9,16500,9900,26400
251597,202107,100,82,18,90200,19800,110000
251600,202107,1108,779,329,856900,361900,1218800
251610,202107,241,177,64,194700,70400,265100
251615,202107,12,11,1,12100,1100,13200
251620,202107,4194,2715,1479,2987600,1626900,4614500
251630,202107,461,343,118,377300,129800,507100
251640,202107,131,98,33,107800,36300,144100
251650,202107,285,211,74,232100,82500,314600
251660,202107,192,169,23,185900,25300,211200
251670,202107,385,298,87,327800,95700,423500
251675,202107,8,6,2,6600,2200,8800
251680,202107,101,89,12,97900,13200,111100
251690,202107,322,266,56,293700,61600,355300
251700,202107,283,246,37,270600,40700,311300
251710,202107,22,14,8,15400,8800,24200
251720,202107,25,17,8,18700,8800.11,27500.11
251740,202107,11,8,3,8800,3300,12100
260005,202107,3377,1807,1570,1988332.93,1727000,3715332.93
260010,202107,1614,1185,429,1303500.58,471900,1775400.58
260020,202107,419,360,59,397100,64900,462000
260030,202107,600,411,189,453200,207900,661100
260040,202107,805,492,313,542300,344300,886600
260050,202107,1160,832,328,917400,360800,1278200
260060,202107,375,344,31,378400,34100,412500
260070,202107,1333,815,518,897600,570900,1468500
260080,202107,718,548,170,605000,187000,792000
260090,202107,514,329,185,361900,203500,565400
260100,202107,219,152,67,167200,73700,240900
260105,202107,248,139,109,152900,119900,272800
260110,202107,2891,2121,770,2337500,848100,3185600
260120,202107,2706,1446,1260,1590892.6,1391500,2982392.6
260130,202107,174,118,56,129800,61600,191400
260140,202107,2157,1412,745,1553200,820600,2373800
260150,202107,200,128,72,140800,79200,220000
260160,202107,330,273,57,300300,62700,363000
260170,202107,3319,1998,1321,2200000,1454200,3654200
260180,202107,165,130,35,143000,38500,181500
260190,202107,2340,1568,772,1724800,850300,2575100
260200,202107,976,773,203,850300.63,223300,1073600.63
260210,202107,1414,1004,410,1104400.52,451000,1555400.52
260220,202107,663,598,65,657800,71500,729300
260230,202107,1227,910,317,1001000,348700,1349700
260240,202107,213,163,50,179300,55000,234300
260250,202107,86,63,23,69300,25300,94600
260260,202107,1043,731,312,805200,343200,1148400
260270,202107,254,187,67,205700,73700,279400
260280,202107,1166,938,228,1031800,261800,1293600
260290,202107,6633,3598,3035,3960000,3338500.59,7298500.59
260300,202107,968,829,139,911900,152900,1064800
260310,202107,522,417,105,458700,115500,574200
260320,202107,858,622,236,684200,259600,943800
260330,202107,68,47,21,51700,23100,74800
260340,202107,76,57,19,62700,20900,83600
260345,202107,5522,2946,2576,3240600,2833600,6074200
260350,202107,481,339,142,372900,156200,529100
260360,202107,231,126,105,138600,115500,254100
260370,202107,748,475,273,522500,301400,823900
260380,202107,574,417,157,458700,172700.6,631400.6
260390,202107,291,247,44,271700,48400,320100
260392,202107,114,99,15,108900,16500,125400
260400,202107,4232,2417,1815,2658700.5,1999800,4658500.5
260410,202107,14672,7717,6955,8495301.2,7659300,16154601.2
260415,202107,141,122,19,134200,20900,155100
260420,202107,1714,1043,671,1148400.2,739200,1887600.2
260430,202107,174,159,15,174900.48,16500,191400.48
260440,202107,188,135,53,148500,58300,206800
260450,202107,423,315,108,346501.13,118800,465301.13
260460,202107,817,430,387,474100,425700,899800
260470,202107,341,207,134,228800,147400,376200
260480,202107,246,157,89,173800,97900,271700
260490,202107,212,174,38,191400,41800,233200
260500,202107,1126,756,370,831600,407000,1238600
260510,202107,782,620,162,682000,178200,860200
260515,202107,235,212,23,233200,25300,258500
260520,202107,3247,2014,1233,2217600,1358500,3576100
260530,202107,790,645,145,709500,159500,869000
260540,202107,527,415,112,456500,123200,579700
260545,202107,15,12,3,13200,3300,16500
260550,202107,327,206,121,227700,133100,360800
260560,202107,504,382,122,420200,134200,554400
260570,202107,977,788,189,866800,207900,1074700
260580,202107,257,222,35,244200,38500,282700
260590,202107,625,357,268,392700,294800,687500
260600,202107,7658,4416,3242,4858701.26,3578300,8437001.26
260610,202107,481,323,158,355300,173800,529100
260620,202107,3635,1876,1759,2064700,1936000.19,4000700.19
260630,202107,82,76,6,83600,6600,90200
260640,202107,3373,1923,1450,2117500,1596100,3713600
260650,202107,325,236,89,259600,97900,357500
260660,202107,554,353,201,388300,222200,610500
260670,202107,98,72,26,79200,28600,107800
260680,202107,3823,2105,1718,2316600,1890900,4207500
260690,202107,124,93,31,102300,34100,136400
260700,202107,306,203,103,223300,113300,336600
260710,202107,46,37,9,40700,9900,50600
260720,202107,2585,1515,1070,1667600,1177000,2844600
260730,202107,724,539,185,592900,203500,796400
260740,202107,68,57,11,62700,12100,74800
260750,202107,582,420,162,462000,178200,640200
260760,202107,679,340,339,375100.3,372900,748000.3
260765,202107,963,495,468,545600,514800,1060400
260770,202107,227,166,61,182581,67100,249681
260775,202107,775,425,350,467500,385000,852500
260780,202107,233,145,88,159500,96800,256300
260790,202107,14594,7348,7246,8088300,7979400,16067700
260795,202107,163,106,57,116600,62700,179300
260800,202107,289,239,50,262900,55000,317900
260805,202107,170,112,58,123200,63800,187000
260810,202107,776,651,125,717200,137500,854700
260820,202107,284,183,101,201300,112200,313500
260825,202107,215,147,68,161700,78100,239800
260830,202107,315,181,134,200200,156200,356400
260840,202107,247,181,66,199100,72600,271700
260845,202107,165,110,55,121000,60500,181500
260850,202107,413,309,104,339900,114400,454300
260860,202107,258,196,62,215600,68200,283800
260870,202107,352,270,82,297000,91300,388300
260875,202107,739,538,201,591800,221100,812900
260880,202107,1550,1023,527,1126400,581900,1708300
260890,202107,2326,1617,709,1779800,781000,2560800
260900,202107,982,699,283,768900,311300,1080200
260910,202107,248,196,52,216700,57200,273900
260915,202107,287,214,73,235400,80300,315700
260920,202107,195,101,94,111100,103400,214500
260930,202107,385,328,57,360800,62700,423500
260940,202107,2604,1384,1220,1523500,1344200,2867700
260950,202107,1997,1136,861,1249600,947100,2196700
260960,202107,13521,6712,6809,7388700.9,7499800.5,14888501.4
260970,202107,411,337,74,370700,81400,452100
260980,202107,200,180,20,198000,22000,220000
260990,202107,2642,2136,506,2350700,557700,2908400
261000,202107,4196,2555,1641,2811600,1805100,4616700
261010,202107,169,112,57,123200,72600,195800
261020,202107,593,444,149,488400.47,163900,652300.47
261030,202107,265,188,77,206800,85800,292600
261040,202107,378,327,51,359700,56100,415800
261050,202107,501,429,72,473000,79200,552200
261060,202107,1388,865,523,952600,575300,1527900
261070,202107,8902,4306,4596,4739900,5061100.5,9801000.5
261080,202107,370,282,88,310200,96800,407000
261090,202107,2130,1635,495,1799602.03,545600.3,2345202.33
261100,202107,1184,829,355,913000,393800,1306800
261110,202107,8861,5469,3392,6020300,3731200,9751500
261120,202107,250,214,36,235400,39600,275000
261130,202107,567,339,228,372900,250800,623700
261140,202107,211,133,78,146300,85800,232100
261150,202107,685,434,251,477400.56,276100,753500.56
261153,202107,70,65,5,71500,5500,77000
261160,202107,74014,36441,37573,40107191.94,41365502.35,81472694.29
261170,202107,471,348,123,382800,136400,519200
261180,202107,1759,1094,665,1203651,731500,1935151
261190,202107,577,400,177,440000,194700,634700
261200,202107,220,180,40,198000,44000,242000
261210,202107,35,30,5,33000,5500,38500
261220,202107,2727,1917,810,2108700.66,893200,3001900.66
261230,202107,336,245,91,269500,101200,370700
261240,202107,436,383,53,421300,58300,479600
261245,202107,245,201,44,221100,48400,269500
261247,202107,167,129,38,141900,41800,183700
261250,202107,3304,1598,1706,1757800,1876600,3634400
261255,202107,249,221,28,243100,30800,273900
261260,202107,849,735,114,808500.12,125400,933900.12
261270,202107,200,140,60,155100,66000,221100
261280,202107,181,147,34,161700,37400,199100
261290,202107,114,84,30,93500,33000,126500
261300,202107,1328,986,342,1085700.8,377300,1463000.8
261310,202107,785,526,259,578600,284900,863500
261320,202107,569,380,189,418000.22,217800,635800.22
261330,202107,941,731,210,804100,232100.63,1036200.63
261340,202107,304,167,137,183700,150700,334400
261350,202107,848,594,254,653400,280500,933900
261360,202107,1324,859,465,944900,511500,1456400
261370,202107,4791,2833,1958,3118500,2153800,5272300
261380,202107,534,410,124,451000.78,136400,587400.78
261390,202107,3584,2408,1176,2651000,1294700,3945700
261400,202107,281,251,30,276100,33000,309100
261410,202107,1112,728,384,800800,424600,1225400
261420,202107,910,566,344,622600.32,378400,1001000.32
261430,202107,317,289,28,317900,30800,348700
261440,202107,114,105,9,115500,9900,125400
261450,202107,2497,1989,508,2189000,558800,2747800
261460,202107,742,583,159,641300,174900,816200
261470,202107,233,189,44,209000,48400,257400
261480,202107,451,350,101,385000,111050.5,496050.5
261485,202107,360,216,144,237600,158400,396000
261500,202107,610,412,198,453200.59,217800,671000.59
261510,202107,54,35,19,38500,20900,59400
261520,202107,90,76,14,84700,15400,100100
261530,202107,4102,2606,1496,2871000.09,1647800,4518800.09
261540,202107,1388,819,569,900900,627000,1527900
261550,202107,251,119,132,130900,145200,276100
261560,202107,868,569,299,625900,328900,954800
261570,202107,395,310,85,341000,93500,434500
261580,202107,389,308,81,338800,89100,427900
261590,202107,191,154,37,169400,40700,210100
261600,202107,290,229,61,251900,68200,320100
261610,202107,81,72,9,79200,9900,89100
261618,202107,77,60,17,66000,18700,84700
261620,202107,193,119,74,130900,81400,212300
261630,202107,670,535,135,588500,148500,737000
261640,202107,6395,3359,3036,3694901.05,3340700,7035601.05
261650,202107,497,319,178,352000,195800,547800
270010,202107,511,452,59,498300,64900,563200
270020,202107,249,203,46,223300,50600,273900
270030,202107,8750,5637,3113,6205173.92,3428651,9633824.92
270040,202107,2051,1324,727,1460800,801900,2262700
270050,202107,180,140,40,154000,44000,198000
270060,202107,80,52,28,57200,30800,88000
270070,202107,847,621,226,683173.32,248600,931773.32
270080,202107,35,29,6,31900,6600,38500
270090,202107,24,17,7,18700,7700,26400
270100,202107,1322,907,415,998800,456500,1455300
270110,202107,80,68,12,74800,13200,88000
270120,202107,228,187,41,205700,45100,250800
270130,202107,303,220,83,242000,91300,333300
270135,202107,113,74,39,81400,44000,125400
270140,202107,1372,888,484,977900,532400,1510300
270150,202107,263,204,59,225500,64900,290400
270160,202107,496,396,100,435600,110000,545600
270170,202107,805,525,280,577500,308000,885500
270180,202107,55,43,12,47300,13200,60500
270190,202107,116,98,18,107800,19800,127600
270200,202107,113,99,14,108900,15400,124300
270210,202107,524,312,212,343200,233200,576400
270220,202107,185,141,44,155100,48400,203500
270230,202107,2138,1317,821,1449800,904200,2354000
270235,202107,675,526,149,578600,163900,742500
270240,202107,2963,2350,613,2588301.56,675400,3263701.56
270250,202107,127,92,35,101200,38500,139700
270255,202107,217,187,30,205700,33000,238700
270260,202107,364,296,68,325600,74800,400400
270270,202107,97,46,51,50600,56100,106700
270280,202107,228,130,98,143000,107800,250800
270290,202107,1141,881,260,969100,286000,1255100
270300,202107,331,236,95,259600,104500,364100
270310,202107,826,685,141,753500,155100,908600
270320,202107,807,696,111,766700.63,122100,888800.63
270330,202107,307,258,49,284900,53900,338800
270340,202107,56,44,12,48400,13200,61600
270350,202107,90,52,38,57200,41800,99000
270360,202107,66,37,29,40700,31900,72600
270370,202107,60,47,13,51700,14300,66000
270375,202107,76,46,30,50600,33000,83600
270380,202107,1054,692,362,762300,398200,1160500
270390,202107,156,89,67,97900,73700,171600
270400,202107,726,548,178,605000.2,195800,800800.2
270410,202107,633,463,170,510400,187000,697400
270420,202107,400,275,125,302500,138600,441100
270430,202107,33427,24076,9351,26512461.26,10298200,36810661.26
270440,202107,491,386,105,424600,115500,540100
270450,202107,825,483,342,531300.6,377300,908600.6
270460,202107,179,142,37,156200,40700,196900
270470,202107,1536,1065,471,1174800,520300,1695100
270480,202107,529,430,99,473000,108900,581900
270490,202107,22,17,5,18700,5500,24200
270500,202107,502,414,88,455400,97900,553300
270510,202107,843,533,310,586300,342100,928400
270520,202107,277,179,98,196900,107800,304700
270530,202107,59,51,8,56100,8800,64900
270540,202107,93,72,21,79200,23100,102300
270550,202107,1698,1306,392,1436600,431200,1867800
270560,202107,266,154,112,169400,123200,292600
270570,202107,530,374,156,411400,171600,583000
270580,202107,84,68,16,74800,17600,92400
270590,202107,62,49,13,53900,14300,68200
270600,202107,165,139,26,152900,28600,181500
270610,202107,229,183,46,202400,50600,253000
270620,202107,16,16,0,17600,0,17600
270630,202107,3718,2834,884,3121800,975700,4097500
270640,202107,863,650,213,715000,236500,951500
270642,202107,206,173,33,190300,36300,226600
270644,202107,252,169,83,185900,91300,277200
270650,202107,322,195,127,215600,139700,355300
270660,202107,201,174,27,191400,29700,221100
270670,202107,2983,2272,711,2502501.01,783200,3285701.01
270680,202107,417,255,162,280500,178200,458700
270690,202107,1197,797,400,877800,441100,1318900
270700,202107,26,21,5,23100,5500,28600
270710,202107,863,681,182,750200,201300,951500
270720,202107,231,181,50,199100,55000,254100
270730,202107,1884,1171,713,1289200,784300,2073500
270740,202107,39,26,13,29700,14300,44000
270750,202107,640,486,154,534600,169400,704000
270760,202107,299,215,84,236500,92400,328900
270770,202107,2769,1861,908,2049666.66,998800,3048466.66
270780,202107,65,42,23,46200,25300,71500
270790,202107,249,159,90,174900,99000,273900
270800,202107,2041,1629,412,1791900,458700,2250600
270810,202107,218,180,38,199100,41800,240900
270820,202107,129,92,37,101200,40700,141900
270830,202107,801,603,198,663300,217800,881100
270840,202107,1364,1045,319,1151700.4,350900,1502600.4
270850,202107,1515,968,547,1065900,601700,1667600
270860,202107,2553,1716,837,1895300.7,920700,2816000.7
270870,202107,116,65,51,71500,56100,127600
270880,202107,878,692,186,761200,204600,965800
270890,202107,278,210,68,231000,74800,305800
270895,202107,51,48,3,52800,3300,56100
270900,202107,72,59,13,64900,14300,79200
270910,202107,304,252,52,277200,57200,334400
270915,202107,1911,1246,665,1372800,731500,2104300
270920,202107,448,373,75,411400,82500,493900
270930,202107,5883,4457,1426,4907136.66,1570800.14,6477936.80
270940,202107,2222,1751,471,1928300,518100,2446400
280010,202107,39,32,7,35200,7700,42900
280020,202107,483,414,69,456500,75900,532400
280030,202107,20763,13434,7329,14787301.02,8070701.56,22858002.58
280040,202107,329,212,117,233200,128700,361900
280050,202107,408,316,92,347600,101200,448800
280060,202107,332,218,114,240900,125400,366300
280067,202107,1089,790,299,870100,328900.5,1199000.5
280070,202107,128,105,23,115500,25300,140800
280100,202107,641,495,146,544500.14,161700,706200.14
280110,202107,69,63,6,69300,6600,75900
280120,202107,661,552,109,607200,121000,728200
280130,202107,1741,1147,594,1261700,654500,1916200
280140,202107,492,406,86,446600,94600,541200
280150,202107,406,283,123,311300,135300,446600
280160,202107,129,104,25,114400,27500,141900
280170,202107,403,279,124,306900,136400,443300
280190,202107,28,23,5,25300,5500,30800
280200,202107,35,29,6,31900,6600,38500
280210,202107,2916,2103,813,2316515.65,895400,3211915.65
280220,202107,43,36,7,39600,7700,47300
280230,202107,329,269,60,295900,66000,361900
280240,202107,127,119,8,132000,8800,140800
280250,202107,18,10,8,11000,8800,19800
280260,202107,78,71,7,78100,7700,85800
280270,202107,145,112,33,123200,36300,159500
280280,202107,192,125,67,137500.5,73700,211200.5
280290,202107,3435,2493,942,2745529.5,1038400,3783929.5
280300,202107,1604,1260,344,1388200,379500,1767700
280310,202107,97,92,5,101200,5500,106700
280320,202107,653,459,194,504900,214500,719400
280330,202107,317,233,84,256300,92400,348700
280340,202107,422,338,84,371800,92400,464200
280350,202107,3705,2867,838,3159200.66,922900.08,4082100.74
280360,202107,468,320,148,352000,162800,514800
280370,202107,97,85,12,93500,13200,106700
280380,202107,48,36,12,39600,13200,52800
280390,202107,171,145,26,159500,28600,188100
280400,202107,359,243,116,267300,127600,394900
280410,202107,288,238,50,261800,55000,316800
280420,202107,141,123,18,135300,19800,155100
280430,202107,75,61,14,67100,15400,82500
280440,202107,735,588,147,647900,161700,809600
280445,202107,121,113,8,124300,8800,133100
280450,202107,1247,1072,175,1180300,192500,1372800
280460,202107,634,464,170,510400.93,187000,697400.93
280470,202107,111,101,10,111100,11000,122100
280480,202107,2768,1909,859,2102101.67,946000.5,3048102.17
280490,202107,205,195,10,214500.96,11000,225500.96
280500,202107,44,40,4,44000,4400,48400
280510,202107,134,108,26,118800,28600,147400
280520,202107,53,38,15,41800,16500,58300
280530,202107,79,51,28,56100,30800,86900
280540,202107,535,454,81,499400,89100,588500
280550,202107,734,677,57,744700.65,62700,807400.65
280560,202107,485,432,53,475200.85,58300,533500.85
280570,202107,2319,1840,479,2027300,528000,2555300
280580,202107,586,455,131,501600,144100,645700
280590,202107,210,136,74,149600,81400,231000
280600,202107,383,321,62,353151.7,68200,421351.7
280610,202107,113,83,30,91300,33000,124300
280620,202107,534,436,98,479600,107800,587400
280630,202107,157,131,26,144100,28600,172700
280640,202107,190,151,39,166100,42900,209000
280650,202107,92,60,32,66000,35200,101200
280660,202107,139,100,39,110000,42900,152900
280670,202107,1913,1202,711,1322200.76,784300.48,2106501.24
280680,202107,218,190,28,209000,31900,240900
280690,202107,82,72,10,79200,11000,90200
280700,202107,20,20,0,22000,0,22000
280710,202107,1471,1141,330,1257300.88,363000,1620300.88
280720,202107,118,79,39,86900,42900,129800
280730,202107,26,22,4,24200,4400,28600
280740,202107,2517,1886,631,2076800,694100,2770900
280750,202107,225,196,29,215600,31900,247500
280760,202107,826,565,261,621500,288200,909700
290010,202107,192,135,57,148500,62700,211200
290020,202107,193,174,19,191400,20900,212300
290030,202107,616,397,219,436700,240900,677600
290035,202107,137,112,25,123200,27500,150700
290040,202107,309,208,101,228800,111100,339900
290050,202107,83,66,17,72600,18700,91300
290060,202107,257,114,143,125400,157300,282700
290070,202107,5722,2738,2984,3014000.69,3282400,6296400.69
290080,202107,447,201,246,221100,270600,491700
290090,202107,369,166,203,182600,223300,405900
290100,202107,1666,1085,581,1196800,641300,1838100
290110,202107,834,491,343,540100.85,377300,917400.85
290115,202107,192,179,13,198000,14300,212300
290120,202107,784,527,257,579700,283800,863500
290130,202107,439,271,168,298100,184800,482900
290135,202107,301,232,69,255200,75900,331100
290140,202107,321,265,56,291500,61600,353100
290150,202107,133,90,43,100100,47300,147400
290160,202107,248,190,58,209000,63800,272800
290170,202107,95,66,29,72600,31900,104500
290180,202107,185,133,52,146300,57200,203500
290190,202107,375,298,77,327800,84700,412500
290195,202107,311,199,112,218900,123200,342100
290200,202107,267,219,48,240900,52800,293700
290205,202107,150,93,57,102300,62700,165000
290210,202107,1180,869,311,955900,342100,1298000
290220,202107,183,103,80,113300,88000,201300
290225,202107,285,115,170,126500,187000,313500
290230,202107,80,49,31,53900,34100,88000
290240,202107,359,125,234,137500,257400,394900
290250,202107,257,238,19,262900,20900,283800
290260,202107,323,266,57,292600,62700,355300
290265,202107,188,163,25,179300,27500,206800
290270,202107,1415,1183,232,1303500,255200,1558700
290280,202107,480,340,140,374000,155100,529100
290290,202107,1353,816,537,899800.94,590700,1490500.94
290300,202107,419,359,60,396000,66000,462000
290310,202107,289,137,152,150700,167200,317900
290320,202107,4088,2526,1562,2778600.11,1718200,4496800.11
290323,202107,190,165,25,181500,27500,209000
290327,202107,161,127,34,139700,37400,177100
290330,202107,116,58,58,63800,63800,127600
290340,202107,798,332,466,366300,513700,880000
290350,202107,653,399,254,440000,279400,719400
290360,202107,322,248,74,272800.99,81400,354200.99
290370,202107,910,396,514,436700,565400,1002100
290380,202107,329,210,119,231000,130900,361900
290390,202107,2414,1513,901,1665400,991100,2656500
290395,202107,239,137,102,150700,112200,262900
290400,202107,280,206,74,226600,82500,309100
290405,202107,247,213,34,234300,37400,271700
290410,202107,628,522,106,575300,116600,691900
290420,202107,259,210,49,231000,53900,284900
290430,202107,457,294,163,323400,179300,502700
290440,202107,77,68,9,75900,9900,85800
290450,202107,189,141,48,155100,52800,207900
290460,202107,1932,1158,774,1274900,851400,2126300
290470,202107,1357,598,759,657800,836000,1493800
290475,202107,557,523,34,575300.27,37400,612700.27
290480,202107,279,162,117,178200,128700,306900
290485,202107,237,217,20,238700,22000,260700
290490,202107,1249,892,357,981200,392700,1373900
290500,202107,742,382,360,420200,396000,816200
290510,202107,206,166,40,182600,44000,226600
290515,202107,160,97,63,106700,69300,176000
290520,202107,1396,911,485,1003200,533500.2,1536700.2
290530,202107,294,269,25,295900,27500,323400
290540,202107,108,56,52,61600,57200,118800
290550,202107,168,143,25,157300,27500,184800
290560,202107,3161,1381,1780,1520200,1960200,3480400
290570,202107,6258,3025,3233,3327500,3558500,6886000
290580,202107,1278,763,515,839300,566500,1405800
290590,202107,576,470,106,517000,116600,633600
290600,202107,1748,1203,545,1325500.67,599500,1925000.67
290610,202107,189,174,15,191400,16500,207900
290620,202107,366,330,36,363000,39600,402600
290630,202107,1976,848,1128,932800,1240800,2173600
290640,202107,142,114,28,125400,30800,156200
290650,202107,1791,843,948,927300.92,1043900,1971200.92
290660,202107,275,224,51,246400,56100,302500
290670,202107,945,484,461,532400,507100,1039500
290680,202107,1222,982,240,1080200,264000,1344200
290682,202107,317,238,79,261800.48,86900,348700.48
290685,202107,246,159,87,174900,95700,270600
290687,202107,1085,707,378,777879,415800,1193679
290689,202107,148,78,70,85800,77000,162800
290690,202107,602,258,344,283800,378400,662200
290700,202107,237,118,119,129800,130900,260700
290710,202107,766,523,243,575300,267300,842600
290720,202107,1038,841,197,925100,216700,1141800
290730,202107,1187,688,499,756800,548900,1305700
290740,202107,20,17,3,18700,3300,22000
290750,202107,1398,621,777,683100,854700,1537800
290755,202107,71,64,7,71500,7700,79200
290760,202107,265,231,34,254100,37400,291500
290770,202107,182,172,10,189200,11000,200200
290780,202107,1105,862,243,949300,267300,1216600
290790,202107,378,256,122,282700,134200,416900
290800,202107,2433,986,1447,1084600,1592800,2677400
290810,202107,478,329,149,361900,163900,525800
290820,202107,407,240,167,265100,183700,448800
290830,202107,421,302,119,333300,132000,465300
290840,202107,1799,1125,674,1237500,741400,1978900
290850,202107,878,451,427,497200,470800,968000
290860,202107,639,287,352,315700,387200,702900
290870,202107,617,439,178,482900,195800,678700
290880,202107,119,64,55,70400,60500,130900
290890,202107,424,272,152,299200,167200,466400
290900,202107,169,127,42,139700,46200,185900
290910,202107,389,298,91,327800,100100,427900
290920,202107,208,183,25,201300,27500,228800
290930,202107,814,622,192,685300,211200,896500
290940,202107,236,199,37,218900,40700,259600
290950,202107,160,94,66,103400,72600,176000
290960,202107,468,328,140,360800,154000,514800
290970,202107,244,216,28,237600,30800,268400
290980,202107,1676,1169,507,1288100,557700,1845800
290990,202107,400,336,64,369600,70400,440000
291000,202107,866,272,594,299200,653400,952600
291005,202107,2378,1026,1352,1129700,1488300.42,2618000.42
291010,202107,165,147,18,161700,19800,181500
291020,202107,102,80,22,88000,24200,112200
291030,202107,97,68,29,74800,31900,106700
291040,202107,617,354,263,389400,289300,678700
291050,202107,1461,795,666,874500,733700,1608200
291060,202107,1633,906,727,996600,799700,1796300
291070,202107,1966,1472,494,1620300.82,543401.3,2163702.12
291072,202107,7112,2665,4447,2933700,4895000,7828700
291075,202107,242,197,45,216700,49500,266200
291077,202107,59,40,19,44000,20900,64900
291080,202107,20368,8829,11539,9722900.75,12702801.05,22425701.80
291085,202107,273,225,48,247500,52800,300300
291090,202107,279,118,161,129800,177100,306900
291100,202107,635,196,439,215600,482900,698500
291110,202107,423,327,96,359700,105600,465300
291120,202107,2399,1229,1170,1351900,1287000,2638900
291125,202107,61,30,31,33000,34100,67100
291130,202107,196,173,23,191400,25300,216700
291140,202107,123,102,21,112200,23100,135300
291150,202107,387,148,239,162800,262900,425700
291160,202107,375,304,71,334400,79200,413600
291165,202107,48,37,11,40700,12100,52800
291170,202107,3149,1573,1576,1731400.5,1734700,3466100.5
291180,202107,1242,498,744,548900,818400,1367300
291185,202107,105,98,7,107800,7700,115500
291190,202107,1377,644,733,708400,806300,1514700
291200,202107,171,127,44,139700,48400,188100
291210,202107,2336,927,1409,1019700,1549900,2569600
291220,202107,289,218,71,239800,78100,317900
291230,202107,956,327,629,359700,693000,1052700
291240,202107,420,390,30,429000,33000,462000
291250,202107,436,353,83,388300.58,91300,479600.58
291260,202107,59,51,8,56100,8800,64900
291270,202107,1042,453,589,498300,647900,1146200
291280,202107,357,170,187,187000,205700,392700
291290,202107,1706,892,814,982300,895400,1877700
291300,202107,226,180,46,198000,50600,248600
291310,202107,228,204,24,224400,26400,250800
291320,202107,1345,950,395,1045000,434500,1479500
291330,202107,130,112,18,123200,19800,143000
291340,202107,216,128,88,140800,96800,237600
291345,202107,129,88,41,96800,45100,141900
291350,202107,1682,610,1072,671000,1179200,1850200
291360,202107,8286,3981,4305,4383500,4738800,9122300
291370,202107,1106,643,463,707300,510400,1217700
291380,202107,258,206,52,226600,57200,283800
291390,202107,3925,1751,2174,1927200,2392500,4319700
291400,202107,2077,1482,595,1630200,657801.27,2288001.27
291410,202107,192,164,28,180400,30800,211200
291420,202107,115,87,28,95700,30800,126500
291430,202107,165,94,71,103400,78100.5,181500.5
291440,202107,529,432,97,475200,106700,581900
291450,202107,934,603,331,663300,364100,1027400
291460,202107,1913,1540,373,1699500,410300,2109800
291465,202107,2207,1052,1155,1157200,1271600,2428800
291470,202107,2847,1436,1411,1579600.55,1552100,3131700.55
291480,202107,11688,5113,6575,5627601.62,7243500,12871101.62
291490,202107,616,250,366,276100,402600,678700
291500,202107,379,227,152,250800,167200,418000
291510,202107,1206,467,739,513700,812900,1326600
291520,202107,929,417,512,459800,563200,1023000
291530,202107,916,248,668,272800,734800,1007600
291535,202107,122,100,22,110000,25300,135300
291540,202107,357,117,240,128700,264000,392700
291550,202107,1281,600,681,660000,749100,1409100
291560,202107,5142,2580,2562,2839100,2820400.42,5659500.42
291570,202107,211,105,106,115500,116600,232100
291580,202107,1189,735,454,808500,499400,1307900
291590,202107,97,40,57,44000,62700,106700
291600,202107,1138,559,579,614900,636900,1251800
291610,202107,1435,702,733,772200,806300,1578500
291620,202107,561,266,295,292600,324500,617100
291630,202107,478,149,329,163900,361900,525800
291640,202107,3941,1985,1956,2185700,2153800,4339500
291650,202107,433,294,139,323400.5,152900,476300.5
291660,202107,374,151,223,166100,245300,411400
291670,202107,184,117,67,128700,73700,202400
291680,202107,631,384,247,422400,271700,694100
291685,202107,574,324,250,356400,275000,631400
291690,202107,479,305,174,335500,191400.92,526900.92
291700,202107,1003,783,220,863500,243100,1106600
291710,202107,1608,782,826,860200,909700,1769900
291720,202107,418,284,134,312400,147400,459800
291730,202107,942,549,393,605000,432300,1037300
291733,202107,290,197,93,216700,102300,319000
291735,202107,74,57,17,62700,18700,81400
291740,202107,340,257,83,282700,91300,374000
291750,202107,2234,1470,764,1618100.25,840400,2458500.25
291760,202107,2988,1657,1331,1823800,1465200,3289000
291770,202107,762,521,241,573100,265100,838200
291780,202107,64,38,26,41800,28600,70400
291790,202107,153,80,73,88000,80300,168300
291800,202107,10039,4200,5839,4621100.96,6427300,11048400.96
291810,202107,1087,815,272,896500,299200,1195700
291820,202107,279,202,77,222200,84700,306900
291830,202107,1031,416,615,457600.59,677600,1135200.59
291835,202107,554,514,40,565400,44000,609400
291840,202107,4951,2489,2462,2737900,2711500,5449400
291845,202107,262,82,180,90200,198000,288200
291850,202107,318,281,37,309100,40700,349800
291855,202107,253,104,149,114400,163900,278300
291860,202107,171,107,64,117700,70400,188100
291870,202107,81,36,45,39600,49500,89100
291875,202107,166,155,11,170500,12100,182600
291880,202107,435,349,86,383900,94600,478500
291890,202107,242,80,162,89100,179300,268400
291900,202107,57,32,25,35200,27500,62700
291905,202107,119,89,30,97900,33000,130900
291910,202107,159,127,32,139700,35200,174900
291915,202107,438,388,50,426800,55000,481800
291920,202107,5198,2586,2612,2845700,2875400,5721100
291930,202107,165,98,67,107800.27,73700,181500.27
291940,202107,359,207,152,227700,167200,394900
291950,202107,1137,905,232,995500,255200,1250700
291955,202107,1295,789,506,870100,556600,1426700
291960,202107,196,144,52,158400,57200,215600
291970,202107,750,567,183,624800,201300,826100
291980,202107,1475,1295,180,1425600.73,198000,1623600.73
291990,202107,141,130,11,143000,12100,155100
291992,202107,162,86,76,94600,83600,178200
291995,202107,191,122,69,134200,75900,210100
292000,202107,402,304,98,334400,107800,442200
292010,202107,328,225,103,247500,113300,360800
292020,202107,303,221,82,243100,90200,333300
292030,202107,144,110,34,121000,37400,158400
292040,202107,602,311,291,342100,320100,662200
292045,202107,117,105,12,115500,13200,128700
292050,202107,938,680,258,748000,283800,1031800
292060,202107,890,728,162,800800,180400,981200
292070,202107,63,23,40,25300,44000,69300
292080,202107,146,102,44,112200,48400,160600
292090,202107,522,178,344,195800,378400,574200
292100,202107,1478,639,839,702900,924000,1626900
292105,202107,189,168,21,184800,23100,207900
292110,202107,2242,813,1429,894300,1573000,2467300
292120,202107,700,547,153,601700,168300,770000
292130,202107,448,251,197,276100,216700,492800
292140,202107,216,174,42,191400,46200,237600
292145,202107,156,85,71,93500,78100,171600
292150,202107,1492,1228,264,1350800,291500,1642300
292160,202107,161,131,30,144100,33000,177100
292170,202107,1183,1024,159,1128600,174900,1303500
292180,202107,220,162,58,178200,63800,242000
292190,202107,156,103,53,113300,58300,171600
292200,202107,1365,495,870,544500,957000,1501500
292205,202107,122,105,17,115500,18700,134200
292210,202107,371,257,114,282700,125400,408100
292220,202107,33,24,9,26400,9900,36300
292225,202107,41,34,7,37400,7700,45100
292230,202107,968,751,217,826100,238700,1064800
292240,202107,619,448,171,492800,188100,680900
292250,202107,1683,1101,582,1212200,640200,1852400
292260,202107,402,242,160,266200,176000,442200
292265,202107,247,181,66,199100,72600,271700
292270,202107,725,343,382,377300,420200,797500
292273,202107,213,123,90,135300,99000,234300
292275,202107,168,84,84,92400,92400,184800
292280,202107,143,101,42,111100,46200,157300
292285,202107,83,67,16,73700,17600,91300
292290,202107,578,388,190,426800,209000,635800
292300,202107,1732,653,1079,718300,1188000,1906300
292303,202107,121,78,43,85800,47300,133100
292305,202107,118,88,30,96800,33000,129800
292310,202107,942,613,329,674300,361900,1036200
292320,202107,588,445,143,490600,157300,647900
292330,202107,177,106,71,116600,78100,194700
292335,202107,286,226,60,249700,66000,315700
292340,202107,567,396,171,436700,188100,624800
292350,202107,267,148,119,162800,130900,293700
292360,202107,708,540,168,594000,184800,778800
292370,202107,745,570,175,627000,193600,820600
292380,202107,619,508,111,558800,122100,680900
292390,202107,395,159,236,174900,259600,434500
292400,202107,3594,2245,1349,2469500,1487200,3956700
292405,202107,269,179,90,196900,99000,295900
292410,202107,130,80,50,88000,55000,143000
292420,202107,294,256,38,281600,41800,323400
292430,202107,542,405,137,445500,150700,596200
292440,202107,625,527,98,579700.56,107800,687500.56
292450,202107,242,188,54,207900,59400,267300
292460,202107,543,406,137,446600,150700,597300
292465,202107,208,177,31,194700,34100,228800
292467,202107,140,85,55,93500,60500,154000
292470,202107,297,200,97,220000,106700,326700
292480,202107,386,266,120,292600,132000,424600
292490,202107,240,173,67,190300,73700,264000
292500,202107,863,398,465,438900.32,511500,950400.32
292510,202107,3500,1638,1862,1801800,2048200,3850000
292520,202107,1105,520,585,573100,643500,1216600
292525,202107,412,294,118,323400,129800,453200
292530,202107,4536,1807,2729,1989900.65,3003000,4992900.65
292540,202107,477,272,205,299200,225500,524700
292550,202107,1099,582,517,640200,568700,1208900
292560,202107,330,306,24,336600,26400,363000
292570,202107,311,242,69,267300,75900,343200
292575,202107,501,338,163,371800,179300,551100
292580,202107,993,665,328,731500,361900,1093400
292590,202107,566,495,71,544500,78100,622600
292593,202107,142,113,29,124300,31900,156200
292595,202107,202,161,41,177100,45100,222200
292600,202107,1267,921,346,1014200.63,380600,1394800.63
292610,202107,117,93,24,102300,26400,128700
292620,202107,539,459,80,506000,88000,594000
292630,202107,1495,826,669,908600,735900,1644500
292640,202107,848,590,258,650100,284900,935000
292650,202107,189,155,34,170500.5,37400,207900.5
292660,202107,1977,1405,572,1545500.99,630300.92,2175801.91
292665,202107,143,101,42,111100,46200,157300
292670,202107,401,318,83,349800,91300,441100
292680,202107,260,195,65,214500,71500,286000
292690,202107,197,141,56,155100,61600,216700
292700,202107,979,643,336,707300,369600,1076900
292710,202107,115,100,15,110000,16500,126500
292720,202107,935,534,401,587400,442200,1029600
292730,202107,198,95,103,104500,113300,217800
292740,202107,69942,34042,35900,37467102.61,39526300.28,76993402.89
292750,202107,390,278,112,306900,123200,430100
292760,202107,337,284,53,312400,58300,370700
292770,202107,829,353,476,389400,523600,913000
292780,202107,400,152,248,167200,272800,440000
292790,202107,773,401,372,443300,409200,852500
292800,202107,1263,754,509,829400,559900,1389300
292805,202107,385,122,263,134200,289300,423500
292810,202107,1515,861,654,948200,719400,1667600
292820,202107,704,593,111,653400,122100,775500
292830,202107,115,92,23,101200,25300,126500
292840,202107,691,564,127,620400,139700,760100
292850,202107,137,91,46,100100,50600,150700
292860,202107,2136,1249,887,1375000,976800,2351800
292870,202107,3533,2348,1185,2582800,1303500,3886300
292880,202107,1472,980,492,1079100,541200,1620300
292890,202107,527,442,85,487300,93500,580800
292895,202107,147,99,48,108900,52800,161700
292900,202107,369,262,107,288200,117700,405900
292905,202107,479,239,240,262900,264000,526900
292910,202107,464,347,117,381700,128700,510400
292920,202107,530,231,299,254100,328900,583000
292925,202107,482,440,42,484000,46200,530200
292930,202107,635,384,251,422400,276100,698500
292935,202107,283,119,164,132000,180400,312400
292937,202107,223,154,69,169400,75900,245300
292940,202107,189,144,45,159500,49500,209000
292950,202107,1192,603,589,663300,647900.6,1311200.6
292960,202107,557,389,168,427900,184800,612700
292970,202107,233,164,69,180400.48,75900,256300.48
292975,202107,100,60,40,66000,44000,110000
292980,202107,303,205,98,225500.61,107800,333300.61
292990,202107,1320,982,338,1080200,371800,1452000
293000,202107,110,77,33,84700,36300,121000
293010,202107,2882,1715,1167,1889800,1283700.5,3173500.5
293015,202107,627,512,115,563200,126500,689700
293020,202107,332,271,61,299200,67100,366300
293030,202107,589,517,72,569800,79200,649000
293040,202107,367,292,75,321200,82500,403700
293050,202107,2935,1741,1194,1915100,1313400,3228500
293060,202107,252,200,52,221100.48,57200,278300.48
293070,202107,3533,1788,1745,1967900.18,1920600.6,3888500.78
293075,202107,90,61,29,67100,31900,99000
293076,202107,77,57,20,62700,22000,84700
293077,202107,555,320,235,352000,258500,610500
293080,202107,430,384,46,422400,50600,473000
293090,202107,130,118,12,129800,13200,143000
293100,202107,534,370,164,408100,181500,589600
293105,202107,341,252,89,277200,97900,375100
293110,202107,118,85,33,93500,37400,130900
293120,202107,303,208,95,228800,105600,334400
293130,202107,252,169,83,185900,91300,277200
293135,202107,8071,3132,4939,3448500,5435100,8883600
293140,202107,190,114,76,125400,83600,209000
293150,202107,311,270,41,297000,45100,342100
293160,202107,422,252,170,277200,188100,465300
293170,202107,195,128,67,140800,73700,214500
293180,202107,546,376,170,413600,187000,600600
293190,202107,1353,932,421,1025200.7,463100,1488300.7
293200,202107,553,487,66,535700,72600,608300
293210,202107,401,309,92,339900,102300,442200
293220,202107,2393,1029,1364,1133000,1502600,2635600
293230,202107,1854,691,1163,760100.1,1280400,2040500.1
293240,202107,236,216,20,237600,22000,259600
293245,202107,130,109,21,119900,23100,143000
293250,202107,745,285,460,314600.22,507100,821700.22
293260,202107,306,251,55,276100,60500,336600
293270,202107,1142,519,623,570900,685300,1256200
293280,202107,294,171,123,188100,135300,323400
293290,202107,3036,1968,1068,2164800,1175900,3340700
293300,202107,766,538,228,591800,250800,842600
293305,202107,200,157,43,172700,47300,220000
293310,202107,166,125,41,137500,45100,182600
293315,202107,166,129,37,141900,40700,182600
293317,202107,88,64,24,70400,26400,96800
293320,202107,1081,593,488,652300.5,536800,1189100.5
293325,202107,191,69,122,75900,134200,210100
293330,202107,13720,6346,7374,6988300.38,8113600,15101900.38
293340,202107,287,200,87,220000,95700,315700
293345,202107,257,209,48,229900,52800,282700
293350,202107,595,353,242,388300,266200,654500
293360,202107,1519,1092,427,1202300,469700,1672000
310010,202107,148,78,70,85800,77000,162800
310020,202107,1017,559,458,614900,503800,1118700
310030,202107,325,260,65,287100,71500,358600
310040,202107,42,27,15,29700,16500,46200
310050,202107,169,106,63,116600,70400,187000
310060,202107,262,180,82,198000,90200,288200
310070,202107,14,8,6,8800,6600,15400
310080,202107,42,26,16,28600,17600,46200
310090,202107,1045,554,491,609400,540100,1149500
310100,202107,311,221,90,243100,99000,342100
310110,202107,706,383,323,421300,355300,776600
310120,202107,385,221,164,243100,180400,423500
310130,202107,30,17,13,18700,14300,33000
310140,202107,25,10,15,11000,16500,27500
310150,202107,1162,781,381,859100,419100,1278200
310160,202107,2039,991,1048,1091200.22,1152800,2244000.22
310163,202107,86,45,41,49500,45100,94600
310170,202107,2515,1117,1398,1228700,1537800,2766500
310180,202107,154,55,99,61600,108900,170500
310190,202107,475,322,153,354200,168300,522500
310200,202107,476,303,173,333300,190300,523600
310205,202107,59,38,21,41800,23100,64900
310210,202107,274,224,50,246400,55000,301400
310220,202107,62,35,27,38500,29700,68200
310230,202107,274,189,85,207900,93500,301400
310240,202107,110,95,15,104500,16500,121000
310250,202107,100,78,22,85800,24200,110000
310260,202107,731,383,348,422400.92,382800,805200.92
310270,202107,264,166,98,182600,107800,290400
310280,202107,379,276,103,303600,113300,416900
310285,202107,208,153,55,168300,60500,228800
310290,202107,231,133,98,146300,108900,255200
310300,202107,170,137,33,152900,36300,189200
310310,202107,10,7,3,7700,3300,11000
310320,202107,28,9,19,9900,20900,30800
310330,202107,41,26,15,28600,16500,45100
310340,202107,1829,1226,603,1348600,664400,2013000
310350,202107,2749,1464,1285,1611500,1414600,3026100
310360,202107,45,38,7,41800,8800,50600
310370,202107,130,107,23,117700,25300,143000
310375,202107,105,38,67,41800,73700,115500
310380,202107,49,29,20,31900,22000,53900
310390,202107,105,66,39,72600,42900,115500
310400,202107,2373,1526,847,1680800,931700,2612500
310410,202107,123,71,52,79200,57200,136400
310420,202107,654,337,317,371800,348700,720500
310430,202107,277,168,109,184800,119900,304700
310440,202107,71,39,32,42900,35200,78100
310445,202107,77,64,13,70400,14300,84700
310450,202107,628,397,231,436700,254100,690800
310460,202107,248,172,76,189200,84700,273900
310470,202107,509,329,180,363000,199100,562100
310480,202107,87,54,33,59400,36300,95700
310490,202107,532,244,288,268400,316800,585200
310500,202107,132,51,81,56100,89100,145200
310510,202107,601,421,180,463100,198000,661100
310520,202107,141,100,41,110000,45100,155100
310530,202107,107,43,64,47300,71500,118800
310540,202107,467,269,198,295900,218900,514800
310550,202107,72,46,26,50600,28600,79200
310560,202107,2966,2020,946,2222000,1042800,3264800
310570,202107,92,58,34,63800,37400,101200
310590,202107,367,229,138,253000,151800,404800
310600,202107,150,80,70,88000,77000,165000
310610,202107,56,22,34,24200,37400,61600
310620,202107,46961,22134,24827,24374817.5,27335000,51709817.5
310630,202107,673,409,264,449900,290400,740300
310640,202107,128,95,33,104500,36300,140800
310650,202107,155,139,16,152900,17600,170500
310660,202107,104,73,31,80300,34100,114400
310665,202107,62,45,17,49500,18700,68200
310670,202107,6794,2902,3892,3194400.72,4285600,7480000.72
310680,202107,66,40,26,44000,28600,72600
310690,202107,618,436,182,479600,200200,679800
310700,202107,64,40,24,44000,26400,70400
310710,202107,1308,887,421,977113.5,464200,1441313.5
310720,202107,143,38,105,41800,115500,157300
310730,202107,1495,1020,475,1122000,522500,1644500
310740,202107,989,548,441,602800,485100,1087900
310750,202107,246,153,93,168300,102300,270600
310760,202107,71,53,18,58300,19800,78100
310770,202107,92,46,46,50600,50600,101200
310780,202107,356,283,73,311300,80300,391600
310790,202107,103,85,18,93500,19800,113300
310800,202107,457,215,242,237600,266200,503800
310810,202107,174,120,54,132000.72,59400,191400.72
310820,202107,327,260,67,286000,73700,359700
310825,202107,201,171,30,188100,33000,221100
310830,202107,470,221,249,243100,273900,517000
310840,202107,359,208,151,228800,166100,394900
310850,202107,81,68,13,74800,14300,89100
310855,202107,399,311,88,344300,96800,441100
310860,202107,1597,1177,420,1294700,463100,1757800
310870,202107,51,42,9,46200,9900,56100
310880,202107,84,67,17,73700,19800,93500
310890,202107,310,177,133,194700,146300,341000
310900,202107,634,275,359,302506.48,394911.52,697418.00
310910,202107,233,158,75,173800,82500,256300
310920,202107,448,259,189,286000,207900,493900
310925,202107,34,28,6,30800,6600,37400
310930,202107,1291,832,459,915200,507100,1422300
310940,202107,690,346,344,381700,378400,760100
310945,202107,118,75,43,83600,47300,130900
310950,202107,229,183,46,201300,50600,251900
310960,202107,74,23,51,25300,56100,81400
310970,202107,168,104,64,114400,70400,184800
310980,202107,45,29,16,31900,17600,49500
310990,202107,169,87,82,95700,91300,187000
311000,202107,813,393,420,433400.1,463100,896500.1
311010,202107,49,43,6,47300,6600,53900
311020,202107,42,22,20,24200,23100,47300
311030,202107,387,217,170,238700,187000,425700
311040,202107,41,31,10,34100,11000,45100
311050,202107,474,178,296,196900,325600,522500
311060,202107,780,431,349,474100,385000,859100
311070,202107,328,145,183,159500,201300,360800
311080,202107,107,60,47,66000,51700,117700
311090,202107,334,159,175,174900,192500,367400
311100,202107,568,333,235,367400,259600,627000
311110,202107,704,498,206,547800,226600,774400
311115,202107,75,54,21,59400,23100,82500
311120,202107,1067,568,499,624800,548900,1173700
311130,202107,309,184,125,202400,137500,339900
311140,202107,160,84,76,92400,83600,176000
311150,202107,344,220,124,242000,137500,379500
311160,202107,725,513,212,564300,233200,797500
311170,202107,89,72,17,79200,18700,97900
311180,202107,295,196,99,215600,108900,324500
311190,202107,44,18,26,19800,28600,48400
311200,202107,346,242,104,266200,114400,380600
311205,202107,33,24,9,26400,9900,36300
311210,202107,41,36,5,39600,5500,45100
311220,202107,28,24,4,27500,4400,31900
311230,202107,1626,1069,557,1177000,612700,1789700
311240,202107,196,123,73,135300,80300,215600
311250,202107,53,21,32,23100,35200,58300
311260,202107,557,355,202,392700,222200,614900
311265,202107,125,87,38,95700,41800,137500
311270,202107,292,202,90,222200,99000,321200
311280,202107,195,87,108,95700,118800,214500
311290,202107,105,87,18,95700,19800,115500
311300,202107,576,367,209,403700,229900,633600
311310,202107,19,15,4,16500,4400,20900
311320,202107,640,475,165,522500,181500,704000
311330,202107,1063,780,283,860200.9,311300,1171500.9
311340,202107,2617,1855,762,2042700,839300,2882000
311350,202107,268,208,60,228800,66000,294800
311360,202107,179,105,74,115500,81400,196900
311370,202107,1226,504,722,555500,796400,1351900
311380,202107,7,6,1,6600,1100,7700
311390,202107,250,138,112,151800,123200,275000
311400,202107,139,84,55,92400,60500,152900
311410,202107,112,55,57,60500,62700,123200
311420,202107,305,165,140,181500,154000,335500
311430,202107,823,548,275,602800,302500,905300
311440,202107,458,320,138,353100,151800,504900
311450,202107,295,178,117,195800,128700,324500
311455,202107,274,188,86,206800,94600,301400
311460,202107,135,57,78,62700,85800,148500
311470,202107,28,14,14,15400,15400,30800
311480,202107,48,24,24,26400,26400,52800
311490,202107,11,7,4,7700,4400,12100
311500,202107,26,13,13,14300,14300,28600
311510,202107,654,447,207,491700,228800,720500
311520,202107,41,32,9,35200,9900,45100
311530,202107,1809,1311,498,1442100,548900,1991000
311535,202107,64,44,20,48400,22000,70400
311540,202107,34,29,5,31900,5500,37400
311545,202107,161,119,42,130900,46200,177100
311547,202107,43,33,10,36300,11000,47300
311550,202107,664,294,370,323400,407000,730400
311560,202107,43,27,16,29700,17600,47300
311570,202107,280,188,92,207900,101200,309100
311580,202107,378,227,151,249700,166100,415800
311590,202107,30,26,4,28600,4400,33000
311600,202107,98,79,19,86900,20900,107800
311610,202107,244,209,35,229900,38500,268400
311615,202107,118,94,24,103400,26400,129800
311620,202107,25,15,10,16500,11000,27500
311630,202107,90,77,13,84700,14300,99000
311640,202107,146,70,76,77000,83600,160600
311650,202107,125,85,40,94600,44000,138600
311660,202107,399,191,208,210100,228800,438900
311670,202107,144,96,48,105600,52800,158400
311680,202107,212,161,51,177100,56100,233200
311690,202107,14,11,3,12100,3300,15400
311700,202107,192,138,54,151800,59400,211200
311710,202107,185,125,60,137500,66000,203500
311720,202107,40,30,10,33000,11000,44000
311730,202107,568,384,184,422400,202400,624800
311740,202107,26,18,8,19800,8800,28600
311750,202107,727,490,237,539000.7,260700,799700.7
311760,202107,72,31,41,34100,45100,79200
311770,202107,381,187,194,207900,213400,421300
311780,202107,184,91,93,100100,102300,202400
311783,202107,89,82,7,90200,7700,97900
311787,202107,36,13,23,14300,25300,39600
311790,202107,268,113,155,124300,170500,294800
311800,202107,681,436,245,480700,270600,751300
311810,202107,50,40,10,44000,11000,55000
311820,202107,120,99,21,108900,23100,132000
311830,202107,1881,1147,734,1263900,809600,2073500
311840,202107,1006,557,449,612700,493900,1106600
311850,202107,14,10,4,11000,4400,15400
311860,202107,9546,4091,5455,4503400,6007100,10510500
311870,202107,115,63,52,69300,57200,126500
311880,202107,934,674,260,741400,286000,1027400
311890,202107,202,98,104,107709,114876.66,222585.66
311900,202107,70,28,42,30800,46200,77000
311910,202107,1359,848,511,932800,563200,1496000
311920,202107,228,153,75,168300,82500,250800
311930,202107,905,511,394,562100,433400,995500
311940,202107,2545,1340,1205,1474000,1326600,2800600
311950,202107,63,42,21,46200,23100,69300
311960,202107,62,44,18,48400,19800,68200
311970,202107,25,14,11,15400,12100,27500
311980,202107,44,34,10,37400,11000,48400
311990,202107,35,26,9,28600,9900,38500
311995,202107,51,31,20,34100,22000,56100
312000,202107,21,16,5,17600,5500,23100
312010,202107,75,58,17,63800,18700,82500
312015,202107,72,54,18,59400,19800,79200
312020,202107,130,88,42,96800,46200,143000
312030,202107,64,48,16,52800,17600,70400
312040,202107,79,50,29,55000,31900,86900
312050,202107,202,114,88,125400,96800,222200
312060,202107,22,13,9,14300,9900,24200
312070,202107,77,49,28,53900,30800,84700
312080,202107,533,245,288,269500,316800,586300
312083,202107,59,37,22,40700,24200,64900
312087,202107,95,72,23,79200,25300,104500
312090,202107,3252,1969,1283,2168100,1416800,3584900
312100,202107,146,101,45,110847,49500,160347
312110,202107,114,67,47,73700,51700,125400
312120,202107,128,94,34,103400.63,37400,140800.63
312125,202107,88,51,37,56100,40700,96800
312130,202107,136,89,47,97900,51700,149600
312140,202107,138,107,31,117700,34100,151800
312150,202107,41,32,9,35200,9900,45100
312160,202107,1515,988,527,1086899,580800,1667699
312170,202107,10,8,2,8800,2200,11000
312180,202107,110,70,40,77000,44000,121000
312190,202107,37,33,4,36300,4400,40700
312200,202107,753,646,107,713900,117700,831600
312210,202107,119,63,56,69300,61600,130900
312220,202107,129,99,30,108900,33000,141900
312230,202107,3671,1692,1979,1863400,2181300,4044700
312235,202107,154,103,51,113300,56100,169400
312240,202107,85,59,26,64900,28600,93500
312245,202107,189,128,61,140800,67100,207900
312247,202107,76,54,22,59400,24200,83600
312250,202107,164,81,83,89100,92400,181500
312260,202107,107,73,34,80300,37400,117700
312270,202107,130,76,54,83600,59400,143000
312280,202107,30,15,15,16500,16500,33000
312290,202107,138,93,45,102300,49500,151800
312300,202107,199,130,69,143000,75900,218900
312310,202107,61,54,7,59400,7700,67100
312320,202107,427,267,160,293700,176000,469700
312330,202107,86,75,11,82500,12100,94600
312340,202107,34,15,19,16500,20900,37400
312350,202107,14,8,6,8800,6600,15400
312352,202107,95,69,26,75900,28600,104500
312360,202107,561,233,328,256300,360800,617100
312370,202107,324,183,141,201300,155100,356400
312380,202107,136,92,44,101200,49500,150700
312385,202107,156,128,28,140800,30800,171600
312390,202107,298,189,109,207900,119900,327800
312400,202107,382,282,100,310200,110000,420200
312410,202107,1076,344,732,378400,806300,1184700
312420,202107,626,472,154,519200,169400,688600
312430,202107,876,633,243,697400.5,267300,964700.5
312440,202107,39,29,10,31900,11000,42900
312450,202107,197,127,70,139700,77000,216700
312460,202107,30,15,15,16500,16500,33000
312470,202107,43,28,15,30800,16500,47300
312480,202107,177,108,69,118800,75900,194700
312490,202107,278,189,89,207900,97900,305800
312500,202107,38,23,15,25300,16500,41800
312510,202107,522,197,325,216700,357500,574200
312520,202107,29,9,20,9900,22000,31900
312530,202107,44,31,13,34100,14300,48400
312540,202107,88,78,10,85800,11000,96800
312550,202107,39,31,8,34100,8800,42900
312560,202107,201,153,48,168300,52800,221100
312570,202107,434,255,179,280500,196900,477400
312580,202107,93,49,44,53900,48400,102300
312590,202107,240,190,50,209000,55000,264000
312595,202107,128,110,18,121000,19800,140800
312600,202107,68,35,33,38500,36300,74800
312610,202107,1567,803,764,885500,840400,1725900
312620,202107,224,161,63,177100,70400,247500
312630,202107,70,57,13,62700,14300,77000
312640,202107,41,11,30,12100,33000,45100
312650,202107,147,122,25,134570.7,27500,162070.7
312660,202107,95,67,28,73700.01,30800,104500.01
312670,202107,921,592,329,652300,361900,1014200
312675,202107,31,26,5,28600,5500,34100
312680,202107,67,40,27,44000,29700,73700
312690,202107,235,117,118,129800,129800,259600
312695,202107,29,25,4,27500,4400,31900
312700,202107,227,131,96,144100,105600,249700
312705,202107,84,67,17,73700,18700,92400
312707,202107,134,95,39,104500,42900,147400
312710,202107,1847,996,851,1096700.59,936100,2032800.59
312720,202107,50,29,21,31900,23100,55000
312730,202107,275,159,116,174900,127600,302500
312733,202107,48,36,12,39600,13200,52800
312735,202107,19,13,6,14300,6600,20900
312737,202107,68,37,31,40700,34100,74800
312738,202107,62,40,22,44000,24200,68200
312740,202107,80,54,26,59400,28600,88000
312750,202107,91,63,28,69300,30800,100100
312760,202107,286,204,82,224400,91300,315700
312770,202107,8237,3781,4456,4163500,4911500,9075000
312780,202107,444,339,105,372900,116600,489500
312790,202107,24,17,7,18700,7700,26400
312800,202107,1600,1116,484,1228700,532400,1761100
312810,202107,359,238,121,262900,133100,396000
312820,202107,185,143,42,157300,46200,203500
312825,202107,31,21,10,23100,11000,34100
312830,202107,204,121,83,133100,91300,224400
312840,202107,164,110,54,121000,59400,180400
312850,202107,42,37,5,40700,5500,46200
312860,202107,150,95,55,104500,60500,165000
312870,202107,1072,553,519,608300,570900,1179200
312880,202107,124,86,38,94600,41800,136400
312890,202107,161,116,45,127600,49500,177100
312900,202107,186,137,49,151800,53900,205700
312910,202107,175,96,79,105600,88000,193600
312920,202107,131,73,58,81400,63800,145200
312930,202107,322,226,96,249700,105600,355300
312940,202107,123,85,38,93500,41800,135300
312950,202107,687,469,218,515900,239800,755700
312960,202107,153,116,37,127600,40700,168300
312965,202107,93,74,19,81400,20900,102300
312970,202107,281,231,50,255200,55000,310200
312980,202107,2481,1253,1228,1381600,1350800,2732400
312990,202107,49,24,25,26400,27500,53900
313000,202107,54,29,25,31900,27500,59400
313005,202107,180,136,44,149600,48400,198000
313010,202107,913,370,543,407000,598400,1005400
313020,202107,201,104,97,114400,106700,221100
313030,202107,196,126,70,138600,77000,215600
313040,202107,78,25,53,27500,58300,85800
313050,202107,185,134,51,147400,57200,204600
313055,202107,40,30,10,33000,11000,44000
313060,202107,132,89,43,97900,47300,145200
313065,202107,62,45,17,49500,18700,68200
313070,202107,133,70,63,77000,69300,146300
313080,202107,35,16,19,17600,20900,38500
313090,202107,672,435,237,478500,260700.15,739200.15
313100,202107,192,67,125,73700,137500,211200
313110,202107,147,75,72,82500,79200,161700
313115,202107,219,126,93,138600,102300,240900
313120,202107,839,469,370,517000,407000,924000
313130,202107,5881,3214,2667,3539800,2937000,6476800
313140,202107,131,72,59,79200,64900,144100
313150,202107,292,231,61,254100,67100,321200
313160,202107,184,137,47,150700,51700,202400
313170,202107,1384,917,467,1009800,513700,1523500
313180,202107,301,178,123,195800,135300,331100
313190,202107,730,435,295,478500,324500,803000
313200,202107,28,23,5,26400,5500,31900
313210,202107,1000,850,150,935000,165000,1100000
313220,202107,291,175,116,192500,127600,320100
313230,202107,258,200,58,220000.5,63800,283800.5
313240,202107,2161,1094,1067,1203400,1174800,2378200
313250,202107,1253,954,299,1051600,328900,1380500
313260,202107,91,45,46,49500,50600,100100
313270,202107,986,575,411,633600,453200,1086800
313280,202107,47,39,8,42900,8800,51700
313290,202107,213,172,41,189200,45100,234300
313300,202107,333,171,162,189200,178200,367400
313310,202107,248,112,136,123200,149600,272800
313320,202107,380,281,99,310200,108900,419100
313330,202107,1403,854,549,940500,603900,1544400
313340,202107,328,234,94,258500,103400,361900
313350,202107,480,315,165,346500,181500,528000
313360,202107,152,70,82,77000,90200,167200
313370,202107,225,76,149,83600,163900,247500
313375,202107,301,178,123,195800,135300,331100
313380,202107,1335,697,638,767800,701800,1469600
313390,202107,46,44,2,48400,2200,50600
313400,202107,392,267,125,293700,137500,431200
313410,202107,31,15,16,16500,17600,34100
313420,202107,4515,2420,2095,2664200,2305600,4969800
313430,202107,137,67,70,73700,77000,150700
313440,202107,1379,959,420,1057101.13,463100,1520201.13
313450,202107,66,29,37,31900,40700,72600
313460,202107,376,162,214,178200,235400,413600
313470,202107,531,252,279,277200,306900,584100
313480,202107,145,107,38,117700,41800,159500
313490,202107,521,238,283,261800,311300,573100
313500,202107,29,16,13,17600,14300,31900
313505,202107,1044,816,228,898700,250800,1149500
313507,202107,94,57,37,62700,40700,103400
313510,202107,2863,1807,1056,1990016.9,1161600,3151616.9
313520,202107,3446,2695,751,2964501.5,827200,3791701.5
313530,202107,33,22,11,24200,12100,36300
313535,202107,67,54,13,59400,14300,73700
313540,202107,69,51,18,56100,19800,75900
313545,202107,116,99,17,108900,18700,127600
313550,202107,225,188,37,206800,40700,247500
313560,202107,343,167,176,183700,193600,377300
313570,202107,67,21,46,23100,50600,73700
313580,202107,1322,739,583,812900,642400,1455300
313590,202107,66,38,28,41800.51,30800,72600.51
313600,202107,671,402,269,443300,295900,739200
313610,202107,51,42,9,46200,9900,56100
313620,202107,1375,675,700,743600,771100,1514700
313630,202107,1600,1206,394,1327700,433400,1761100
313640,202107,120,72,48,79200,52800,132000
313650,202107,230,110,120,121000,132000,253000
313652,202107,23,22,1,24200,1100,25300
313655,202107,68,42,26,46200,28600,74800
313657,202107,45,41,4,45100,4400,49500
313660,202107,127,83,44,91300,48419.8,139719.8
313665,202107,655,298,357,327800,392700,720500
313670,202107,10320,7046,3274,7760500.97,3603600,11364100.97
313680,202107,43,33,10,36300,11000,47300
313690,202107,132,98,34,107800,37400,145200
313695,202107,71,54,17,59400,18700,78100
313700,202107,315,249,66,273900,73700,347600
313710,202107,135,99,36,108900,39600,148500
313720,202107,1126,525,601,577500,661100,1238600
313730,202107,73,43,30,47300,33000,80300
313740,202107,144,116,28,127600,30800,158400
313750,202107,421,300,121,330000,133100,463100
313753,202107,226,166,60,182600,66000,248600
313760,202107,1321,478,843,526900,927300,1454200
313770,202107,386,273,113,300300,124300,424600
313780,202107,794,415,379,456500,416900,873400
313790,202107,28,27,1,29700,1100,30800
313800,202107,146,89,57,97900,62700,160600
313810,202107,81,49,32,53900,35200,89100
313820,202107,1324,620,704,682000.38,776600,1458600.38
313830,202107,55,39,16,42900,17600,60500
313835,202107,58,49,9,53900,9900,63800
313840,202107,1627,959,668,1054900,734800,1789700
313850,202107,210,82,128,90200,140800,231000
313860,202107,463,353,110,389400,121000,510400
313862,202107,165,109,56,119900,61600,181500
313865,202107,137,98,39,107800,42900,150700
313867,202107,54,44,10,48400,11000,59400
313868,202107,39,23,16,25300,17600,42900
313870,202107,105,58,47,63800,51700,115500
313880,202107,382,236,146,259600,160600,420200
313890,202107,329,171,158,188100,173800,361900
313900,202107,844,457,387,503800.66,425700,929500.66
313910,202107,146,99,47,108900,51700,160600
313920,202107,625,437,188,480700,209000.94,689700.94
313925,202107,33,28,5,30800,5500,36300
313930,202107,870,677,193,745800,212300,958100
313940,202107,1857,1131,726,1244100,800800,2044900
313950,202107,861,536,325,589600,357500,947100
313960,202107,1412,813,599,894300,660000,1554300
313970,202107,175,113,62,124300,68200,192500
313980,202107,203,132,71,145200,78100,223300
313990,202107,240,156,84,171600,92400,264000
314000,202107,868,566,302,622600,333300,955900
314010,202107,85,47,38,51700,41800,93500
314015,202107,70,19,51,20900,56100,77000
314020,202107,55,33,22,36300,24200,60500
314030,202107,71,33,38,36300,41800,78100
314040,202107,50,27,23,29700,25300,55000
314050,202107,289,172,117,189200,128700,317900
314053,202107,106,66,40,72600,44000,116600
314055,202107,294,182,112,200200,123200,323400
314060,202107,128,113,15,124300.83,16500,140800.83
314070,202107,1040,521,519,573100,570900,1144000
314080,202107,206,131,75,144100,82500,226600
314085,202107,154,104,50,115500,55000,170500
314090,202107,370,260,110,286000,121000,407000
314100,202107,514,412,102,454300,112200,566500
314110,202107,776,367,409,403700,449900,853600
314120,202107,72,41,31,45100,34100,79200
314130,202107,23,14,9,15400,9900,25300
314140,202107,1090,669,421,735900,463100,1199000
314150,202107,192,123,69,135300,75900,211200
314160,202107,321,240,81,265100,89100,354200
314170,202107,84,64,20,70400,22000,92400
314180,202107,737,648,89,712800,99000,811800
314190,202107,91,56,35,61600,38500,100100
314200,202107,503,342,161,377300,177100,554400
314210,202107,251,191,60,210100,66000,276100
314220,202107,292,210,82,231000,90200,321200
314225,202107,60,43,17,47300,18700,66000
314230,202107,111,48,63,52800,69300,122100
314240,202107,156,113,43,124300,47300,171600
314250,202107,58,35,23,38500,25300,63800
314260,202107,218,108,110,118800,121000,239800
314270,202107,397,309,88,339900,96800,436700
314280,202107,734,391,343,430050.5,378400,808450.5
314290,202107,536,423,113,466400,124300,590700
314300,202107,343,254,89,279400,97900,377300
314310,202107,1347,928,419,1022175,460900,1483075
314315,202107,38,29,9,31900,9900,41800
314320,202107,578,386,192,425700,211200,636900
314330,202107,11343,5550,5793,6110500,6377800,12488300
314340,202107,594,264,330,291500,363000,654500
314345,202107,52,37,15,40700,16500,57200
314350,202107,176,108,68,118800,74800,193600
314360,202107,58,34,24,38500,26400,64900
314370,202107,71,48,23,52800,25300,78100
314380,202107,100,61,39,67100,42900,110000
314390,202107,3314,2121,1193,2335300,1312300,3647600
314400,202107,679,480,199,528000,218900,746900
314410,202107,486,314,172,345400,189200,534600
314420,202107,16,7,9,7700,9900,17600
314430,202107,2437,899,1538,988901.51,1692900,2681801.51
314435,202107,175,103,72,113300,79200,192500
314437,202107,30,20,10,23100,11000,34100
314440,202107,95,66,29,72600,31900,104500
314450,202107,160,110,50,121000,55000,176000
314460,202107,628,300,328,331100,361900,693000
314465,202107,99,60,39,66000,42900,108900
314467,202107,74,59,15,64900,16500,81400
314470,202107,401,203,198,223300,217800,441100
314480,202107,1019,467,552,514800,607200,1122000
314490,202107,48,29,19,31900,20900,52800
314500,202107,284,199,85,218900,93500,312400
314505,202107,107,67,40,74800,44000,118800
314510,202107,247,201,46,223300,50600,273900
314520,202107,1312,702,610,775500,672100,1447600
314530,202107,725,576,149,633600.7,163900,797500.7
314535,202107,167,102,65,112200,71500,183700
314537,202107,62,37,25,40700,27500,68200
314540,202107,19,12,7,13200,7700,20900
314545,202107,56,37,19,40700,20900,61600
314550,202107,76,39,37,42900,40700,83600
314560,202107,855,463,392,510400,432300,942700
314570,202107,21,15,6,16500,6600,23100
314580,202107,13,5,8,5500,8800,14300
314585,202107,24,16,8,17600,8800,26400
314587,202107,82,70,12,77000,13200,90200
314590,202107,566,398,168,437800,184800,622600
314600,202107,946,603,343,663300,378400,1041700
314610,202107,940,484,456,532400,502700,1035100
314620,202107,143,105,38,115500,41800,157300
314625,202107,95,69,26,75900,28600,104500
314630,202107,1139,604,535,664400,588500,1252900
314640,202107,84,54,30,59400,33000,92400
314650,202107,170,93,77,102300,84700,187000
314655,202107,60,44,16,48400,17600,66000
314660,202107,16,13,3,14300,3300,17600
314670,202107,203,155,48,170500,52800,223300
314675,202107,209,127,82,139700,91300,231000
314690,202107,578,307,271,338800,301400,640200
314700,202107,2249,1198,1051,1318900,1157200,2476100
314710,202107,1760,995,765,1095600,842600,1938200
314720,202107,390,221,169,243100,187000,430100
314730,202107,503,267,236,293700,260700,554400
314740,202107,747,352,395,387200,434500,821700
314750,202107,18,15,3,16500,4400,20900
314760,202107,361,158,203,174900,223300,398200
314770,202107,106,72,34,79200,37400,116600
314780,202107,23,9,14,9900,15400,25300
314790,202107,2436,1530,906,1685200,997700,2682900
314795,202107,58,49,9,53900,9900,63800
314800,202107,2911,1680,1231,1848000.76,1355200,3203200.76
314810,202107,1473,844,629,929500,691900,1621400
314820,202107,105,60,45,66000,49500,115500
314830,202107,210,172,38,189200,41800,231000
314840,202107,89,51,38,56100,41800,97900
314850,202107,397,190,207,209000,227700,436700
314860,202107,658,507,151,557700,167200,724900
314870,202107,1538,796,742,875600,817300,1692900
314875,202107,51,46,5,50600,5500,56100
314880,202107,42,29,13,31900,14300,46200
314890,202107,49,26,23,28600,25300,53900
314900,202107,29,23,6,25300,6600,31900
314910,202107,235,154,81,169400,89100,258500
314915,202107,135,119,16,130900,17600,148500
314920,202107,93,60,33,66000,36300,102300
314930,202107,1011,478,533,525800,586300,1112100
314940,202107,43,35,8,38500,8800,47300
314950,202107,21,17,4,18700,4400,23100
314960,202107,27,19,8,20900,8800,29700
314970,202107,160,78,82,85800,90200,176000
314980,202107,311,201,110,221100,121000,342100
314990,202107,434,238,196,262900,215600,478500
314995,202107,154,63,91,69300,100100,169400
315000,202107,81,62,19,68200,20900,89100
315010,202107,39,25,14,27500,15400,42900
315015,202107,167,131,36,144100,39600,183700
315020,202107,70,59,11,64900,12100,77000
315030,202107,111,86,25,94600,27500,122100
315040,202107,75,47,28,51700,30800,82500
315050,202107,197,120,77,132000,84700,216700
315053,202107,44,32,12,35200,13200,48400
315057,202107,108,85,23,93500,25300,118800
315060,202107,72,59,13,64900,14300,79200
315070,202107,105,59,46,64900,51700,116600
315080,202107,382,303,79,333300,86900,420200
315090,202107,92,53,39,58300,42900,101200
315100,202107,79,40,39,44000,42900,86900
315110,202107,272,141,131,155100,144100,299200
315120,202107,1775,854,921,940500,1013100,1953600
315130,202107,335,244,91,268400,100100,368500
315140,202107,536,296,240,325600,264000,589600
315150,202107,991,475,516,522500,569800,1092300
315160,202107,200,102,98,112200,107800,220000
315170,202107,306,205,101,225500,111100,336600
315180,202107,3234,1352,1882,1491600,2072400,3564000
315190,202107,297,181,116,199100,127600,326700
315200,202107,1201,718,483,789800,531300,1321100
315210,202107,1616,919,697,1010900,766700,1777600
315213,202107,29,16,13,17600,14300,31900
315217,202107,198,153,45,168300,49500,217800
315220,202107,1598,1195,403,1315600,443300,1758900
315230,202107,172,127,45,139700,49500,189200
315240,202107,397,252,145,277200,159500,436700
315250,202107,2569,1243,1326,1368400,1459700,2828100
315260,202107,136,76,60,83600,66000,149600
315270,202107,132,90,42,99000,46200,145200
315280,202107,631,412,219,454300,240900,695200
315290,202107,184,114,70,125400,77000,202400
315300,202107,82,61,21,67100,23100,90200
315310,202107,80,71,9,78100,9900,88000
315320,202107,147,87,60,95700,67100,162800
315330,202107,57,46,11,50600,12100,62700
315340,202107,394,285,109,313500,119900,433400
315350,202107,152,94,58,103400,63800,167200
315360,202107,93,42,51,46200,56100,102300
315370,202107,56,36,20,39600,22000,61600
315380,202107,5,5,0,5500,0,5500
315390,202107,61,18,43,19800,47300,67100
315400,202107,802,595,207,655600,227700,883300
315410,202107,314,184,130,202400,143000,345400
315415,202107,57,43,14,47300,15400,62700
315420,202107,196,142,54,156200,59400,215600
315430,202107,645,368,277,404800,305800,710600
315440,202107,94,63,31,69300,34100,103400
315445,202107,222,187,35,205700,38500,244200
315450,202107,182,135,47,148500,51700,200200
315460,202107,4188,1974,2214,2172500,2436500,4609000
315470,202107,40,16,24,17600,26400,44000
315480,202107,69,20,49,22000,53900,75900
315490,202107,709,435,274,479600,302500,782100
315500,202107,16,13,3,14300,3300,17600
315510,202107,145,99,46,108900,50600,159500
315520,202107,76,64,12,70400,13200,83600
315530,202107,43,24,19,26400,20900,47300
315540,202107,255,180,75,198000,82500,280500
315550,202107,180,146,34,160600,37400,198000
315560,202107,729,579,150,636900,165000,801900
315570,202107,314,152,162,167200,178200,345400
315580,202107,735,495,240,545600,264000,809600
315590,202107,191,99,92,108900,101200,210100
315600,202107,313,240,73,264000,80300,344300
315610,202107,101,48,53,52800,58300,111100
315620,202107,36,28,8,30800,8800,39600
315630,202107,125,85,40,93500,44000,137500
315640,202107,67,41,26,45100,28600,73700
315645,202107,51,34,17,37400,18700,56100
315650,202107,171,124,47,136400,51700,188100
315660,202107,457,200,257,220000,282700,502700
315670,202107,2377,1119,1258,1232000,1384900,2616900
315680,202107,814,575,239,633600,262900,896500
315690,202107,670,458,212,505890,233200,739090
315700,202107,1960,1026,934,1129700.28,1028500,2158200.28
315710,202107,357,107,250,117700,275000,392700
315720,202107,479,293,186,322300,204600,526900
315725,202107,191,155,36,170500,39600,210100
315727,202107,51,25,26,27500,28600,56100
315730,202107,47,44,3,48400,3300,51700
315733,202107,92,60,32,66000,35200,101200
315737,202107,50,37,13,40700,14300,55000
315740,202107,32,24,8,26400,8800,35200
315750,202107,151,113,38,124300,41800,166100
315760,202107,38,29,9,31900,9900,41800
315765,202107,118,69,49,75900,53900,129800
315770,202107,211,129,82,141900,90200,232100
315780,202107,3617,1796,1821,1975600,2003100,3978700
315790,202107,242,188,54,207900,59400,267300
315800,202107,303,202,101,223300,111100,334400
315810,202107,91,56,35,61600,39600,101200
315820,202107,746,548,198,603900,217800,821700
315830,202107,115,74,41,81400,45100,126500
315840,202107,82,53,29,58300,33000,91300
315850,202107,259,181,78,199100,85800,284900
315860,202107,15,6,9,6600,9900,16500
315870,202107,40,31,9,34100,9900,44000
315880,202107,96,66,30,72600,33000,105600
315890,202107,96,71,25,78100,27500,105600
315895,202107,405,269,136,297000,149600,446600
315900,202107,69,34,35,37400,38500,75900
315910,202107,41,24,17,26400,18700,45100
315920,202107,153,101,52,111100,57200,168300
315930,202107,52,17,35,18700,38500,57200
315935,202107,125,100,25,110000,27500,137500
315940,202107,98,72,26,79200,28600,107800
315950,202107,38,29,9,31900,9900,41800
315960,202107,544,255,289,281600,317900,599500
315970,202107,32,25,7,27500,7700,35200
315980,202107,677,335,342,368500,376200,744700
315990,202107,256,147,109,161700,119900,281600
316000,202107,46,30,16,33000,17600,50600
316010,202107,81,67,14,73700,15400,89100
316020,202107,114,99,15,110000,16500,126500
316030,202107,380,210,170,231000,187000,418000
316040,202107,540,223,317,245300,349800,595100
316045,202107,50,45,5,50600,5500,56100
316050,202107,20,16,4,17600,4400,22000
316060,202107,96,67,29,73700,31900,105600
316070,202107,1088,709,379,779900,418000,1197900
316080,202107,90,62,28,68296.8,30800,99096.8
316090,202107,38,19,19,20900,20900,41800
316095,202107,88,73,15,80300,16500,96800
316100,202107,316,179,137,196900,150700,347600
316105,202107,40,24,16,26400,17600,44000
316110,202107,1886,1485,401,1634600.5,441100,2075700.5
316120,202107,78,53,25,58300,27500,85800
316130,202107,114,86,28,95700,30800,126500
316140,202107,36,23,13,25300,14300,39600
316150,202107,213,149,64,163900,70400,234300
316160,202107,83,46,37,50600,40700,91300
316165,202107,63,45,18,49500,19800,69300
316170,202107,181,119,62,130900,68200,199100
316180,202107,207,85,122,93500,134200,227700
316190,202107,133,94,39,103400,42900,146300
316200,202107,660,353,307,388300,337700,726000
316210,202107,773,515,258,567789.2,283800,851589.2
316220,202107,118,75,43,82500,47300,129800
316225,202107,31,18,13,19800,14300,34100
316230,202107,38,19,19,20900,20900,41800
316240,202107,662,529,133,581900,147400,729300
316245,202107,141,122,19,134200,20900,155100
316250,202107,1543,1043,500,1148400,550000,1698400
316255,202107,134,107,27,117700,29700,147400
316257,202107,176,89,87,97900,95700,193600
316260,202107,188,134,54,147400,59400,206800
316265,202107,29,21,8,23100,8800,31900
316270,202107,681,475,206,522500,226600,749100
316280,202107,548,337,211,370700.63,232100.55,602801.18
316290,202107,799,540,259,594000,284900,878900
316292,202107,537,212,325,233200,358600,591800
316294,202107,104,68,36,74800,39600,114400
316295,202107,319,138,181,151800,199100,350900
316300,202107,110,73,37,80300,40700,121000
316310,202107,29,15,14,16500,15400,31900
316320,202107,52,28,24,30800,26400,57200
316330,202107,167,114,53,125400,58300,183700
316340,202107,132,86,46,94600,50600,145200
316350,202107,188,132,56,145200,61600,206800
316360,202107,24,13,11,14300,12100,26400
316370,202107,1156,582,574,640200,633600,1273800
316380,202107,111,84,27,92400,29700,122100
316390,202107,107,75,32,82500,35200,117700
316400,202107,133,101,32,111100,35200,146300
316410,202107,307,222,85,244200,93500,337700
316420,202107,211,143,68,157300,74800,232100
316430,202107,152,80,72,88000,79200,167200
316440,202107,83,41,42,45100,46200,91300
316443,202107,41,37,4,40700,4400,45100
316447,202107,47,35,12,38500,13200,51700
316450,202107,225,174,51,191400,56100,247500
316460,202107,79,28,51,30800,57200,88000
316470,202107,1657,1205,452,1328789.65,497200,1825989.65
316480,202107,11,8,3,8800,3300,12100
316490,202107,20,6,14,6600,15400,22000
316500,202107,157,104,53,115500,58300,173800
316510,202107,149,113,36,124300,39600,163900
316520,202107,197,113,84,124300,92400,216700
316530,202107,164,106,58,116600,63800,180400
316540,202107,147,76,71,83600,78100,161700
316550,202107,144,89,55,97900,60500,158400
316553,202107,326,147,179,161700,198001.55,359701.55
316555,202107,48,42,6,46200,6600,52800
316556,202107,14,10,4,11000,4400,15400
316557,202107,27,22,5,24200,5500,29700
316560,202107,67,47,20,51700,22000,73700
316570,202107,209,189,20,207900,22000,229900
316580,202107,21,15,6,16500,6600,23100
316590,202107,96,80,16,88000,17600,105600
316600,202107,176,148,28,162800,30800,193600
316610,202107,68,51,17,56100,18700,74800
316620,202107,138,98,40,107800,44000,151800
316630,202107,41,31,10,34100,11000,45100
316640,202107,21,14,7,15400,7700,23100
316650,202107,82,67,15,73700,16500,90200
316660,202107,7,2,5,2200,5500,7700
316670,202107,440,150,290,165000,319000,484000
316680,202107,160,117,43,128700,47300,176000
316690,202107,171,104,67,114400,73700,188100
316695,202107,61,51,10,56100,11000,67100
316700,202107,18,12,6,13200,6600,19800
316710,202107,760,575,185,634700,203500,838200
316720,202107,5053,2436,2617,2681800,2879800,5561600
316730,202107,16,16,0,17600,0,17600
316740,202107,148,95,53,104500,58300,162800
316750,202107,20,13,7,14300,7700,22000
316760,202107,308,250,58,275000,63800,338800
316770,202107,172,93,79,102300,86900,189200
316780,202107,69,42,27,46200,29700,75900
316790,202107,56,39,17,42900,18700,61600
316800,202107,1762,1085,677,1193500.08,745800,1939300.08
316805,202107,25,17,8,18700,8800,27500
316810,202107,65,40,25,44000,27500,71500
316820,202107,40,21,19,23100,20900,44000
316830,202107,94,44,50,48400,55000,103400
316840,202107,515,299,216,330000,237600,567600
316850,202107,320,215,105,236500,116600,353100
316860,202107,5942,2624,3318,2887500,3649800,6537300
316870,202107,1579,1005,574,1108800,633600,1742400
316880,202107,139,67,72,73700,79200,152900
316890,202107,233,158,75,173800,82500,256300
316900,202107,412,287,125,315700,137500,453200
316905,202107,19,9,10,9900,11000,20900
316910,202107,66,28,38,30800,41800,72600
316920,202107,140,109,31,119900,34100,154000
316930,202107,1882,941,941,1037300,1036200,2073500
316935,202107,908,547,361,602800,399300,1002100
316940,202107,1081,611,470,673200,517000,1190200
316950,202107,177,88,89,96800,97900,194700
316960,202107,1088,608,480,671000,528000,1199000
316970,202107,637,504,133,555500,146300,701800
316980,202107,72,39,33,42900,36300,79200
316990,202107,2159,1438,721,1581800,793100.84,2374900.84
317000,202107,326,252,74,277200,81400,358600
317005,202107,225,160,65,176000,71500,247500
317010,202107,6435,3566,2869,3927000,3158100,7085100
317020,202107,15714,6916,8798,7620800,9692100,17312900
317030,202107,81,32,49,35200,53900,89100
317040,202107,3021,1900,1121,2095500,1233100,3328600
317043,202107,70,53,17,58300,18700,77000
317047,202107,37,19,18,20900,19800,40700
317050,202107,148,113,35,124300,39600,163900
317052,202107,142,110,32,121000,35200,156200
317057,202107,175,133,42,146300,46200,192500
317060,202107,59,36,23,39600,25300,64900
317065,202107,47,36,11,39600,12100,51700
317070,202107,1920,884,1036,976800,1140700,2117500
317075,202107,97,54,43,59400,47300,106700
317080,202107,915,466,449,512600,493900,1006500
317090,202107,704,551,153,606100,168300,774400
317100,202107,416,314,102,345400,114400,459800
317103,202107,115,94,21,103400,23100,126500
317107,202107,46,39,7,42900,7700,50600
317110,202107,112,52,60,57200,66000,123200
317115,202107,44,40,4,44000,4400,48400
317120,202107,1953,925,1028,1017500,1130800,2148300
317130,202107,1972,1305,667,1436600,733700,2170300
317140,202107,12,9,3,9900,3300,13200
317150,202107,279,167,112,183700,123200,306900
317160,202107,329,248,81,272800.95,89100,361900.95
317170,202107,228,154,74,170500,81400,251900
317180,202107,440,302,138,332200,154000,486200
317190,202107,265,190,75,209000,82500,291500
317200,202107,812,564,248,621500,272800,894300
317210,202107,183,97,86,106700,94600,201300
317220,202107,24,12,12,13200,13200,26400
320010,202107,570,411,159,452100,174900,627000
320013,202107,122,84,38,92400,41800,134200
320016,202107,267,171,96,188100,105600,293700
320020,202107,721,417,304,459800.77,334400,794200.77
320030,202107,157,109,48,121000.06,52800.08,173800.14
320035,202107,137,98,39,107800,42900,150700
320040,202107,499,253,246,278300,270600,548900
320050,202107,113,77,36,84700,39600,124300
320060,202107,1735,832,903,915200,994400,1909600
320070,202107,97,58,39,63800,42900,106700
320080,202107,805,468,337,514800,371800,886600
320090,202107,1249,829,420,914100,462000,1376100
320100,202107,335,193,142,212300,156200,368500
320110,202107,118,72,46,79200,50600,129800
320115,202107,112,91,21,100100,23100,123200
320120,202107,3607,1901,1706,2094400,1877700.74,3972100.74
320130,202107,7622,3392,4230,3732300.5,4654100.69,8386401.19
320140,202107,434,278,156,306900,171600.81,478500.81
320150,202107,2085,1156,929,1274900,1021900,2296800
320160,202107,649,288,361,317900,397100,715000
320170,202107,109,85,24,93500.1,26400.02,119900.12
320180,202107,56,34,22,37400,24200,61600
320190,202107,239,149,90,163900,99000,262900
320200,202107,62,48,14,52800,15400,68200
320210,202107,891,481,410,529100,451000,980100
320220,202107,302,108,194,118800,214500,333300
320225,202107,87,69,18,75900,19800,95700
320230,202107,662,424,238,467500,261800,729300
320240,202107,3437,1629,1808,1793000,1989900,3782900
320245,202107,492,331,161,365200,177100,542300
320250,202107,225,112,113,123200,124300,247500
320255,202107,131,102,29,112200,31900,144100
320260,202107,229,139,90,152900.2,100100.12,253000.32
320265,202107,153,116,37,127600,40700,168300
320270,202107,155,122,33,134200,36300,170500
320280,202107,1159,659,500,726000.5,550000.02,1276000.52
320290,202107,57,47,10,51700,11000,62700
320300,202107,602,412,190,453200.02,209000,662200.02
320305,202107,692,366,326,402600,358600,761200
320310,202107,201,115,86,126500,94600,221100
320313,202107,341,158,183,173800,201300,375100
320316,202107,108,83,25,91300,27500,118800
320320,202107,3411,1507,1904,1657700,2094400,3752100
320330,202107,270,199,71,218900,79200,298100
320332,202107,758,447,311,491700,342100,833800
320334,202107,263,145,118,159500.02,129800,289300.02
320335,202107,141,92,49,101200,53900,155100
320340,202107,568,397,171,436700,189200,625900
320350,202107,1037,428,609,470800.5,669900,1140700.5
320360,202107,162,82,80,90200,88000,178200
320370,202107,231,171,60,188100,67100,255200
320380,202107,289,201,88,221100,96800,317900
320390,202107,1151,678,473,745800,521400,1267200
320400,202107,319,228,91,250800,100100,350900
320405,202107,951,387,564,425700,621500,1047200
320410,202107,960,484,476,532400,523600,1056000
320420,202107,530,249,281,273900,309100,583000
320425,202107,198,111,87,122100,95700,217800
320430,202107,375,202,173,222200,190300,412500
320435,202107,162,108,54,118800,59400,178200
320440,202107,196,113,83,124300.24,91300.2,215600.44
320450,202107,128,71,57,78100,62700,140800
320455,202107,248,195,53,214500,58300,272800
320460,202107,284,177,107,194700,119900,314600
320465,202107,107,71,36,79200,39600,118800
320470,202107,699,429,270,471900,297000,768900
320480,202107,197,130,67,143000,73700,216700
320490,202107,3131,1497,1634,1647801.23,1798501.3,3446302.53
320495,202107,113,68,45,74800,49500,124300
320500,202107,9628,4703,4925,5176600,5421900,10598500
320501,202107,545,272,273,299200,300300,599500
320503,202107,301,210,91,231000.08,100100.02,331100.10
320506,202107,263,184,79,202400,86900,289300
320510,202107,1109,497,612,546700,675400,1222100
320515,202107,80,60,20,66000,22000,88000
320517,202107,213,154,59,169400,64900,234300
320520,202107,7205,3040,4165,3347300,4583700,7931000
320530,202107,6463,3135,3328,3450681.5,3661900.63,7112582.13
330010,202107,3096,1531,1565,1686300,1722600,3408900
330015,202107,182,73,109,80300,121000,201300
330020,202107,3778,1526,2252,1678600,2478300,4156900
330022,202107,261,131,130,144100,143000,287100
330023,202107,670,205,465,225500,511500,737000
330025,202107,604,113,491,125400,540100,665500
330030,202107,1814,1119,695,1233100,764500,1997600
330040,202107,2482,1250,1232,1375513.33,1356300.5,2731813.83
330045,202107,9435,2771,6664,3049200.67,7338100,10387300.67
330050,202107,863,553,310,609400,341000,950400
330060,202107,1055,620,435,682000,478500,1160500
330070,202107,3983,1389,2594,1529000,2857800,4386800
330080,202107,1598,691,907,762300,997700,1760000
330090,202107,386,219,167,240900,183700,424600
330093,202107,259,112,147,123200,161700,284900
330095,202107,75,44,31,48400,34100,82500
330100,202107,10074,4978,5096,5480200.5,5610000,11090200.5
330110,202107,466,200,266,220000,294800,514800
330115,202107,514,269,245,295900,270600,566500
330120,202107,387,193,194,212300,213400,425700
330130,202107,1576,392,1184,431200,1304600,1735800
330140,202107,623,328,295,360800,324500,685300
330150,202107,507,289,218,319000,240900,559900
330160,202107,212,122,90,134200,99000,233200
330170,202107,27076,9024,18052,9936300,19882500,29818800
330180,202107,237,133,104,146300,114400,260700
330185,202107,989,345,644,379500,708400,1087900
330187,202107,440,126,314,138600,347600,486200
330190,202107,5986,2205,3781,2425500,4163500,6589000
330200,202107,4675,1398,3277,1538900.86,3605800,5144700.86
330205,202107,441,246,195,272800,214500,487300
330210,202107,946,567,379,623700,416900,1040600
330220,202107,2706,1579,1127,1742400,1244100,2986500
330225,202107,565,283,282,311300,310200,621500
330227,202107,2398,718,1680,789800,1851300,2641100
330230,202107,263,141,122,155100,134200,289300
330240,202107,3956,1932,2024,2126300,2227500,4353800
330245,202107,150,64,86,70400,94600,165000
330250,202107,6698,3283,3415,3617900,3762000,7379900
330260,202107,659,163,496,180400,545600,726000
330270,202107,3745,1212,2533,1333200,2787400,4120600
330280,202107,442,278,164,306900,180400,487300
330285,202107,6846,2086,4760,2301200,5239300,7540500
330290,202107,682,245,437,269500,480700,750200
330300,202107,752,480,272,528675.43,299200,827875.43
330310,202107,451,247,204,271700,224400,496100
330320,202107,7994,2837,5157,3125100,5674997.9,8800097.9
330330,202107,9285,3419,5866,3762000.02,6459200.83,10221200.85
330340,202107,2686,1535,1151,1690700,1267200,2957900
330350,202107,18955,6983,11972,7686800,13182400.5,20869200.5
330360,202107,2139,1004,1135,1105500,1248500,2354000
330370,202107,1008,505,503,556600,554400,1111000
330380,202107,914,373,541,410300,596200.01,1006500.01
330385,202107,630,320,310,352000,342100,694100
330390,202107,5824,3012,2812,3317600,3099800,6417400
330395,202107,326,197,129,216700,141900,358600
330400,202107,693,352,341,387200,375100,762300
330410,202107,500,355,145,390500,159500,550000
330411,202107,273,140,133,154000,146300,300300
330412,202107,225,91,134,100100,147400,247500
330414,202107,5329,2112,3217,2323200,3542000,5865200
330415,202107,608,262,346,288200,380600,668800
330420,202107,2271,1148,1123,1262800,1237500,2500300
330430,202107,1792,773,1019,851400,1120900,1972300
330440,202107,320,145,175,159500,192500,352000
330450,202107,115,51,64,56100,70400,126500
330452,202107,2201,941,1260,1036200,1389300,2425500
330455,202107,116422,39435,76987,43412695.45,84764904,128177599.45
330460,202107,252,109,143,119900,158400,278300
330470,202107,1222,669,553,737000,608300,1345300
330475,202107,1640,446,1194,491700,1314500,1806200
330480,202107,825,446,379,491700,416900,908600
330490,202107,15268,4737,10531,5213005,11594000,16807005
330500,202107,1449,625,824,687500,906400,1593900
330510,202107,10958,3703,7255,4076600,7988200.46,12064800.46
330513,202107,99,50,49,55000,53900,108900
330515,202107,749,310,439,341000,484000,825000
330520,202107,2524,858,1666,943800,1833700,2777500
330530,202107,196,110,86,121000,95700,216700
330540,202107,347,174,173,191400,190300,381700
330550,202107,2849,960,1889,1056000,2081200,3137200
330555,202107,804,306,498,337700,547800,885500
330560,202107,703,232,471,255200,519200,774400
330570,202107,279,195,84,214500,92400,306900
330575,202107,805,282,523,310200,575300,885500
330580,202107,3363,1839,1524,2026200,1676400,3702600
330590,202107,271,142,129,156200.5,141900,298100.5
330600,202107,1243,765,478,841500,528000,1369500
330610,202107,1598,839,759,924000,834900,1758900
330615,202107,221,173,48,191400,52800,244200
330620,202107,1050,394,656,433400,721600,1155000
330630,202107,4165,2510,1655,2762101.07,1821600,4583701.07
350010,202107,580,383,197,421300.88,218900,640200.88
350020,202107,54,19,35,22000,38500,60500
350030,202107,519,323,196,355300,215600,570900
350040,202107,125,53,72,58300,79200,137500
350050,202107,326,166,160,182600,177100,359700
350055,202107,109,50,59,55000,64900,119900
350060,202107,85,28,57,30800,62700,93500
350070,202107,777,456,321,502700.2,353100,855800.2
350075,202107,75,48,27,52800,29700,82500
350080,202107,57,27,30,29700,33000,62700
350090,202107,81,47,34,51700,37400,89100
350100,202107,273,169,104,188100,114400,302500
350110,202107,52,36,16,39600,17600,57200
350115,202107,150,91,59,100100,64900,165000
350120,202107,109,70,39,78100,42900,121000
350130,202107,368,160,208,176000.56,228800,404800.56
350140,202107,41,26,15,28600,16500,45100
350150,202107,78,58,20,63800,22000,85800
350160,202107,2381,946,1435,1040600,1581800,2622400
350170,202107,385,222,163,245300,179300,424600
350180,202107,165,96,69,105600,75900,181500
350190,202107,1005,536,469,589600.63,518100,1107700.63
350200,202107,66,25,41,27500,45100,72600
350210,202107,1282,705,577,775500,636900.63,1412400.63
350220,202107,645,531,114,584100.63,125400,709500.63
350230,202107,76,52,24,57200,26400,83600
350240,202107,58,39,19,42900,20900,63800
350250,202107,1146,537,609,590700,672100,1262800
350260,202107,102,73,29,80300,31900,112200
350270,202107,903,606,297,667700,327800,995500
350275,202107,290,114,176,125400,193600,319000
350280,202107,4431,2195,2236,2418900,2462900,4881800
350290,202107,461,201,260,221100,286000,507100
350300,202107,56,28,28,30800,30800,61600
350310,202107,77,50,27,55000,29700,84700
350315,202107,63,27,36,29700,39600,69300
350320,202107,3283,1581,1702,1741300,1876600,3617900
350330,202107,1644,866,778,954801.66,856900,1811701.66
350335,202107,15,11,4,12100,4400,16500
350340,202107,124,55,69,60500,75900,136400
350350,202107,101,51,50,56100,55000,111100
350360,202107,106,70,36,77000,39600,116600
350370,202107,79,43,36,47300.63,39600,86900.63
350380,202107,783,327,456,359700,501600,861300
350390,202107,1659,598,1061,657800.5,1167100,1824900.5
350395,202107,22,18,4,19800,4400,24200
350400,202107,1675,822,853,905301.89,938300.63,1843602.52
350410,202107,2824,1202,1622,1323300,1784220.63,3107520.63
350420,202107,256,154,102,169400,112200,281600
350430,202107,78,45,33,49500,36300,85800
350440,202107,157,113,44,124300,48400,172700
350450,202107,1696,974,722,1071400.63,796400,1867800.63
350460,202107,401,137,264,150700,290400,441100
350470,202107,21,12,9,13200,9900,23100
350480,202107,185,101,84,111100,92400,203500
350490,202107,244,116,128,127600,140800,268400
350500,202107,56,25,31,27500,34100,61600
350510,202107,160,98,62,107800,68200,176000
350520,202107,428,222,206,244200,227700,471900
350530,202107,439,208,231,228800,255200,484000
350535,202107,79,61,18,67100,19800,86900
350540,202107,370,195,175,214500,192500,407000
350550,202107,2659,1522,1137,1674200,1251801.26,2926001.26
350560,202107,590,402,188,443300,206800,650100
350570,202107,4242,1737,2505,1912900.63,2756601.27,4669501.90
350580,202107,353,173,180,190300,199100,389400
350590,202107,925,497,428,546700,473000,1019700
350600,202107,6065,2876,3189,3168000,3511200,6679200
350610,202107,1466,763,703,840400,773300,1613700
350620,202107,26,16,10,17600,11000,28600
350630,202107,239,130,109,145200.63,119900,265100.63
350635,202107,1015,405,610,445500,672100,1117600
350640,202107,116,87,29,96800,31900,128700
350650,202107,1846,1231,615,1356300,676500,2032800
350660,202107,746,303,443,334400,488400,822800
350670,202107,303,150,153,165000,168300,333300
350680,202107,168,84,84,92400,92400,184800
350690,202107,193,88,105,96800,115500,212300
350700,202107,820,390,430,430100,473000,903100
350710,202107,383,143,240,158400,264000,422400
350715,202107,56,44,12,48400,13200,61600
350720,202107,17,11,6,12100,6600,18700
350730,202107,44,26,18,28600,19800,48400
350740,202107,223,123,100,136400,111100,247500
350745,202107,25,10,15,11000,16500,27500
350750,202107,2235,1344,891,1481700,980100,2461800
350760,202107,3711,1551,2160,1709400,2379300,4088700
350770,202107,56,41,15,45100,16500,61600
350775,202107,47,33,14,36300,15400,51700
350780,202107,426,217,209,238700,229900,468600
350790,202107,363,151,212,166100,233200,399300
350800,202107,493,296,197,325600,217800,543400
350810,202107,514,407,107,447700,117700,565400
350820,202107,92,51,41,56100,45100,101200
350830,202107,74,39,35,42900,38500,81400
350840,202107,765,303,462,333300,509300,842600
350850,202107,1777,952,825,1047200,908600,1955800
350860,202107,606,329,277,365200,305800,671000
350870,202107,441,292,149,321200,163900,485100
350880,202107,267,151,116,166100,127600,293700
350890,202107,38,23,15,25300,16500,41800
350900,202107,1507,464,1043,511500,1148400.63,1659900.63
350910,202107,27,17,10,18700,11000,29700
350920,202107,709,367,342,403700,376200,779900
350925,202107,1131,597,534,656700,587400.63,1244100.63
350930,202107,95,55,40,60500,44000,104500
350940,202107,736,396,340,435600,375100,810700
350945,202107,111,80,31,88000,34100,122100
350950,202107,16598,7597,9001,8367700.63,9916500,18284200.63
350960,202107,1459,601,858,662200,944900,1607100
350970,202107,1064,545,519,601581.2,572000,1173581.2
350980,202107,97,64,33,70400,36300,106700
350990,202107,374,133,241,146300,265100,411400
350995,202107,38,18,20,19800,22000,41800
351000,202107,612,410,202,451000.63,222200,673200.63
351010,202107,50,33,17,37400,18700,56100
351015,202107,45,31,14,34100,15400,49500
351020,202107,1507,905,602,998800,663300,1662100
351030,202107,339,205,134,226600,147400,374000
351040,202107,918,455,463,502700,509300.2,1012000.2
351050,202107,3307,1475,1832,1623600,2016300,3639900
351060,202107,5451,2033,3418,2237400,3764200,6001600
351070,202107,393,250,143,275000.63,157300,432300.63
351080,202107,718,519,199,572000,222200,794200
351090,202107,50,23,27,25300,29700,55000
351100,202107,419,230,189,254100,209000,463100
351110,202107,2001,941,1060,1038401.13,1166000,2204401.13
351120,202107,64,33,31,36300,34100,70400
351130,202107,181,57,124,62700,136400,199100
351140,202107,310,196,114,215600,125400,341000
351150,202107,440,230,210,253000,231000,484000
351160,202107,262,161,101,178200.4,111100,289300.4
351170,202107,190,100,90,110000,99000,209000
351190,202107,86,58,28,63800,30800,94600
351200,202107,350,221,129,243100,141900,385000
351210,202107,112,57,55,62700,60500,123200
351220,202107,532,316,216,347600.65,237600,585200.65
351230,202107,270,187,83,205700,91300,297000
351240,202107,247,116,131,127600,144100,271700
351250,202107,80,54,26,59400.5,28600,88000.5
351260,202107,154,111,43,122100,47300,169400
351270,202107,48,20,28,22000,30800,52800
351280,202107,1020,472,548,520300.63,602800.63,1123101.26
351290,202107,242,109,133,119900,146300,266200
351300,202107,3745,1636,2109,1800613.6,2322100,4122713.6
351310,202107,732,360,372,396000,409200,805200
351320,202107,115,66,49,72600,53900,126500
351330,202107,37,24,13,26400,14300,40700
351340,202107,1273,732,541,806300,596200,1402500
351350,202107,2334,1341,993,1475100.04,1092300,2567400.04
351360,202107,776,375,401,412500,443300,855800
351370,202107,379,189,190,209000,209000,418000
351380,202107,8801,3893,4908,4290000,5405400.63,9695400.63
351385,202107,28,18,10,19800,11000,30800
351390,202107,279,210,69,231000,75900,306900
351400,202107,68,45,23,49500,25300,74800
351410,202107,430,266,164,292600.55,180400,473000.55
351420,202107,67,47,20,51700,22000,73700
351430,202107,74,40,34,44000,37400,81400
351440,202107,755,510,245,561001.26,269500,830501.26
351450,202107,261,126,135,138600,148500,287100
351460,202107,121,51,70,57200,77000,134200
351470,202107,143,79,64,86900,70400,157300
351480,202107,486,288,198,317900.63,217800,535700.63
351490,202107,282,103,179,113300,196900,310200
351492,202107,25,17,8,18700,8800,27500
351495,202107,26,18,8,20900,8800,29700
351500,202107,3470,1413,2057,1554300,2262700,3817000
351510,202107,1969,728,1241,801900,1369500,2171400
351512,202107,15,12,3,13200,3300,16500
351515,202107,189,113,76,124300,83600,207900
351518,202107,694,431,263,477400,289300,766700
351519,202107,77,43,34,47300,37400,84700
351520,202107,154,91,63,100100,69319.8,169419.8
351530,202107,25,15,10,16500,11000,27500
351535,202107,128,80,48,88000,52800,140800
351540,202107,449,304,145,335500,159500,495000
351550,202107,1441,846,595,930601.26,655600,1586201.26
351560,202107,78,46,32,50600,35200,85800
351565,202107,10,6,4,6600,4400,11000
351570,202107,2674,1261,1413,1389300,1556500,2945800
351580,202107,39,34,5,37400,5500,42900
351590,202107,60,39,21,42900,23100,66000
351600,202107,185,129,56,141900,61600,203500
351610,202107,50,21,29,23100,31900,55000
351620,202107,5733,3131,2602,3448500.19,2866600,6315100.19
351630,202107,2932,1418,1514,1559800,1666500,3226300
351640,202107,2078,911,1167,1003200.55,1288100.63,2291301.18
351650,202107,29,25,4,27500,4400,31900
351660,202107,127,82,45,90200,49500,139700
351670,202107,714,441,273,485100,300300,785400
351680,202107,66,55,11,60500,12100,72600
351685,202107,11,8,3,8800,3300,12100
351690,202107,294,198,96,217800.5,105600,323400.5
351700,202107,170,115,55,126737,60500,187237
351710,202107,67,42,25,46200,27500,73700
351720,202107,126,69,57,75900,62700,138600
351730,202107,107,69,38,75900,41800,117700
351740,202107,743,465,278,511500.74,305800,817300.74
351750,202107,354,144,210,158400,231000,389400
351760,202107,736,567,169,623700,185900,809600
351770,202107,301,246,55,272800.63,60500,333300.63
351780,202107,157,92,65,102300,72600,174900
351790,202107,246,126,120,138600,132000,270600
351800,202107,41,26,15,28600,16500,45100
351810,202107,118,79,39,86900,42900,129800
351820,202107,778,552,226,607200,249700,856900
351830,202107,560,185,375,203500,412500,616000
351840,202107,1972,935,1037,1028500,1144000,2172500
351850,202107,230,164,66,180400,72600,253000
351860,202107,618,425,193,467500,213400,680900
351870,202107,5556,2567,2989,2827002.02,3293401.38,6120403.40
351880,202107,19827,7801,12026,8588800,13240700.83,21829500.83
351885,202107,85,48,37,52800,40700,93500
351890,202107,64,50,14,55000,15400,70400
351900,202107,226,131,95,144100,104500,248600
351905,202107,89,37,52,40700,57200,97900
351907,202107,3483,1418,2065,1562000.55,2279200.02,3841200.57
351910,202107,170,71,99,78100,108900,187000
351920,202107,111,61,50,67100,55000,122100
351925,202107,88,55,33,60500,36300,96800
351930,202107,390,251,139,276100,152900,429000
351940,202107,237,99,138,108900,152900,261800
351950,202107,133,70,63,77000,69300,146300
351960,202107,910,446,464,490944.93,511500,1002444.93
351970,202107,1981,984,997,1083500,1100000,2183500
351980,202107,151,67,84,73700,92400,166100
351990,202107,249,160,89,176000,97900,273900
352000,202107,324,204,120,224400,132000,356400
352010,202107,406,250,156,275071,171600,446671
352020,202107,175,67,108,73700,118800,192500
352030,202107,1086,541,545,595100,599500,1194600
352040,202107,572,236,336,259600,371800,631400
352042,202107,282,70,212,78100,234300,312400
352044,202107,346,206,140,226601.04,154000,380601.04
352050,202107,3182,1199,1983,1320000.63,2183500,3503500.63
352060,202107,103,61,42,67100,46200,113300
352070,202107,90,67,23,73701.26,25300,99001.26
352080,202107,61,41,20,45100,22000,67100
352090,202107,156,104,52,114400,57200,171600
352100,202107,280,133,147,147400,162800,310200
352110,202107,114,38,76,41800,83600,125400
352115,202107,66,22,44,24200,48400,72600
352120,202107,79,56,23,61600.63,25300,86900.63
352130,202107,217,171,46,188100,50600,238700
352140,202107,175,84,91,92400,100100,192500
352150,202107,120,62,58,68200,63800,132000
352160,202107,140,90,50,99000,55000,154000
352170,202107,380,259,121,284900,133100,418000
352180,202107,645,396,249,435600.63,273900,709500.63
352190,202107,244,98,146,107800,161700,269500
352200,202107,29,14,15,15400,16500,31900
352210,202107,4202,1692,2510,1866700.95,2764300,4631000.95
352215,202107,66,39,27,42900,29700,72600
352220,202107,6479,2410,4069,2653200,4482500.63,7135700.63
352230,202107,3349,2155,1194,2373801.13,1314501.05,3688302.18
352240,202107,2543,1454,1089,1600500,1201200,2801700
352250,202107,2895,1337,1558,1471801.89,1714900,3186701.89
352260,202107,985,525,460,578600,506000,1084600
352265,202107,61,32,29,35200,31900,67100
352270,202107,383,213,170,234300,188100,422400
352280,202107,478,287,191,315700.63,210100,525800.63
352290,202107,179,104,75,114400,82500,196900
352300,202107,92,64,28,70400,30800,101200
352310,202107,6503,2807,3696,3094301.62,4067800,7162101.62
352320,202107,1082,556,526,612700,579700,1192400
352330,202107,520,263,257,290400,282700,573100
352340,202107,1358,625,733,687500,807400,1494900
352350,202107,345,198,147,217800,161700,379500
352360,202107,219,93,126,102300,138600,240900
352370,202107,104,68,36,74800,39600,114400
352380,202107,107,74,33,82500,37400,119900
352390,202107,2520,1087,1433,1195700,1578500,2774200
352400,202107,514,223,291,245300,320100,565400
352410,202107,886,600,286,660000.63,314600,974600.63
352420,202107,93,66,27,72600,29700,102300
352430,202107,1734,783,951,861302.51,1047201.26,1908503.77
352440,202107,3240,1557,1683,1713800,1852400,3566200
352450,202107,199,159,40,174900,44000,218900
352460,202107,624,315,309,346500,341000,687500
352470,202107,650,227,423,249700,465300,715000
352480,202107,1432,787,645,865700,712800,1578500
352490,202107,45,15,30,16500,33000,49500
352500,202107,1253,523,730,576400,804100,1380500
352510,202107,702,375,327,413600.63,359700,773300.63
352520,202107,776,336,440,370847.4,484000,854847.4
352530,202107,1742,905,837,995500,920700,1916200
352540,202107,70,46,24,50600,26400,77000
352550,202107,190,113,77,124300,84700,209000
352560,202107,47,37,10,40700,11000,51700
352570,202107,694,334,360,367400.63,396000,763400.63
352580,202107,60,46,14,50600,15400,66000
352585,202107,20,6,14,6600,15400,22000
352590,202107,4267,2079,2188,2291300.63,2409097,4700397.63
352600,202107,345,241,104,266200,114400,380600
352610,202107,902,405,497,446600.5,548900,995500.5
352620,202107,1026,380,646,418000,710600,1128600
352630,202107,179,66,113,72600,124300,196900
352640,202107,520,337,183,370700,201300,572000
352650,202107,79,59,20,64900,22000,86900
352660,202107,62,38,24,41800,26400,68200
352670,202107,1661,872,789,959200.6,870100,1829300.6
352680,202107,897,553,344,608300,378400,986700
352690,202107,4479,1989,2490,2191201.44,2742300.63,4933502.07
352700,202107,91,55,36,60500,39600,100100
352710,202107,1441,750,691,825000,761200,1586200
352720,202107,1401,633,768,697400,845900,1543300
352725,202107,20,16,4,17600,4400,22000
352730,202107,382,184,198,202400,217800,420200
352740,202107,393,258,135,283800,148500.8,432300.8
352750,202107,21,14,7,15400,7700,23100
352760,202107,201,125,76,137500,83600,221100
352770,202107,84,63,21,69300,23100,92400
352780,202107,72,37,35,41800,38500,80300
352790,202107,23,17,6,19800,6600,26400
352800,202107,229,175,54,192500,59400,251900
352810,202107,155,97,58,106700,63800,170500
352820,202107,46,35,11,38500,12100,50600
352830,202107,72,48,24,52800,26400,79200
352840,202107,650,304,346,334400,380600,715000
352850,202107,1631,508,1123,559900,1236400,1796300
352860,202107,109,72,37,79200,40700,119900
352870,202107,47,30,17,33000,18700,51700
352880,202107,171,109,62,121000,69300,190300
352885,202107,31,21,10,24200,12100,36300
352890,202107,54,35,19,38500,20900,59400
352900,202107,4614,2199,2415,2420000,2658700,5078700
352910,202107,39,32,7,35200,7700,42900
352920,202107,650,379,271,418000,299200,717200
352930,202107,1184,556,628,611600,694100,1305700
352940,202107,6018,2398,3620,2640000,3993000,6633000
352950,202107,117,44,73,48400,80300,128700
352960,202107,64,37,27,40700,29700,70400
352965,202107,19,10,9,11000,9900,20900
352970,202107,502,376,126,413600,138600,552200
352980,202107,160,89,71,97900,78100,176000
352990,202107,978,457,521,502700,574200,1076900
353000,202107,57,25,32,27500,35200,62700
353010,202107,530,324,206,356400,227700,584100
353020,202107,302,217,85,238700,93500,332200
353030,202107,1259,566,693,623700,762300,1386000
353040,202107,74,38,36,41800,39600,81400
353050,202107,1271,824,447,906400.9,491700,1398100.9
353060,202107,8399,3524,4875,3878601.48,5369100,9247701.48
353070,202107,1795,1072,723,1182501.26,798404.2,1980905.46
353080,202107,1259,681,578,749100.92,635800,1384900.92
353090,202107,60,32,28,35200,30800,66000
353100,202107,44,35,9,38500,9900,48400
353110,202107,2105,666,1439,732600,1582900,2315500
353120,202107,101,51,50,56100,55000,111100
353130,202107,857,409,448,449901.55,496100,946001.55
353140,202107,540,223,317,245300.63,348700,594000.63
353150,202107,325,180,145,198000.63,160600,358600.63
353160,202107,100,78,22,85800,24200,110000
353170,202107,209,69,140,75900,154000,229900
353180,202107,1106,498,608,547800,672100,1219900
353190,202107,466,333,133,367400,146300,513700
353200,202107,232,113,119,124300,130900,255200
353205,202107,18,13,5,14300,5500,19800
353210,202107,66,37,29,40700,31900,72600
353215,202107,40,22,18,24200,19800,44000
353220,202107,77,40,37,44000,40700,84700
353230,202107,157,64,93,70400,103400,173800
353240,202107,342,162,180,178200,198000,376200
353250,202107,200,98,102,107800,112200,220000
353260,202107,456,306,150,336600,166100,502700
353270,202107,71,53,18,58300,19800,78100
353280,202107,96,47,49,51700,53900,105600
353282,202107,131,94,37,103400,40700,144100
353284,202107,26,19,7,20900,7700,28600
353286,202107,3,1,2,1100,2200,3300
353290,202107,82,48,34,52800,37400,90200
353300,202107,435,226,209,248601.26,229900,478501.26
353310,202107,44,36,8,39600,8800,48400
353320,202107,36,21,15,23100,16500,39600
353325,202107,48,28,20,30800,22000,52800
353330,202107,64,43,21,47300,23100,70400
353340,202107,626,218,408,239800,448800,688600
353350,202107,878,436,442,479600,487300,966900
353360,202107,101,79,22,86900,24200,111100
353370,202107,109,65,44,71500,48400,119900
353380,202107,27,13,14,14300,15400,29700
353390,202107,1090,517,573,568700,632500,1201200
353400,202107,46,27,19,29700,20900,50600
353410,202107,111,65,46,71500,50600,122100
353420,202107,57,21,36,23100,39600,62700
353430,202107,565,371,194,408101.13,213400,621501.13
353440,202107,11581,4934,6647,5437300.63,7323800,12761100.63
353450,202107,58,30,28,33000,30800,63800
353460,202107,605,319,286,350900,314600,665500
353470,202107,2176,1096,1080,1206700.6,1193500,2400200.6
353475,202107,247,165,82,181500,90200,271700
353480,202107,179,145,34,159500,37400,196900
353490,202107,233,137,96,150700,105600,256300
353500,202107,204,119,85,130900,94600,225500
353510,202107,90,60,30,66000,33000,99000
353520,202107,216,155,61,170500,67100,237600
353530,202107,454,235,219,259600,240900,500500
353540,202107,379,242,137,266200,150700,416900
353550,202107,695,443,252,488400.63,277200,765600.63
353560,202107,570,231,339,254100,374000,628100
353570,202107,66,38,28,41800,30800,72600
353580,202107,340,240,100,265100,110000,375100
353590,202107,79,56,23,61600,25300,86900
353600,202107,264,153,111,168300.63,122100,290400.63
353610,202107,131,67,64,73700,70400,144100
353620,202107,645,329,316,361900,347600,709500
353625,202107,52,26,26,28600,28600,57200
353630,202107,220,157,63,172700,69300,242000
353640,202107,119,77,42,84700,46200,130900
353650,202107,942,357,585,392700,644600,1037300
353657,202107,23,18,5,19800,5500,25300
353660,202107,275,145,130,159500,143000,302500
353670,202107,721,419,302,463100.63,334400,797500.63
353680,202107,113,79,34,86900,37400,124300
353690,202107,40,29,11,31900,12100,44000
353700,202107,279,193,86,213400,94600,308000
353710,202107,484,226,258,248600.66,283800,532400.66
353715,202107,50,31,19,34100,20900,55000
353720,202107,339,151,188,166100,206800,372900
353730,202107,1126,691,435,761200,479600,1240800
353740,202107,602,327,275,360800,302500,663300
353750,202107,69,41,28,45100,30800,75900
353760,202107,3083,1162,1921,1279300,2116400.9,3395700.9
353770,202107,75,61,14,67100,15400,82500
353780,202107,1254,588,666,646800.63,733700,1380500.63
353790,202107,483,291,192,321200,211200,532400
353800,202107,3488,1660,1828,1827120,2015274,3842394
353810,202107,224,120,104,132000,114400,246400
353820,202107,218,94,124,103400,136400.12,239800.12
353830,202107,54,45,9,50600,9900,60500
353850,202107,180,88,92,97900,101200,199100
353860,202107,507,216,291,237600,320100,557700
353870,202107,5453,2743,2710,3022800.26,2983200,6006000.26
353880,202107,695,462,233,510400,256300,766700
353890,202107,538,321,217,353100,240900.59,594000.59
353900,202107,128,68,60,74800,66000,140800
353910,202107,180,80,100,88000,110000,198000
353920,202107,413,225,188,247500,206800,454300
353930,202107,1042,605,437,666600,480700,1147300
353940,202107,195,100,95,111100,104500,215600
353950,202107,489,305,184,335500,202400,537900
353960,202107,76,61,15,68200,16500,84700
353970,202107,42,27,15,29700,16500,46200
353980,202107,1732,777,955,855800,1051600,1907400
353990,202107,77,45,32,49500,35200,84700
354000,202107,379,177,202,194700,222200,416900
354010,202107,94,54,40,59400,44000,103400
354020,202107,496,313,183,345400,201300,546700
354025,202107,33,29,4,31900,4400,36300
354030,202107,46,26,20,28600,22000,50600
354040,202107,93,70,23,77000,25300,102300
354050,202107,176,97,79,106700.63,88000,194700.63
354060,202107,739,351,388,386100,426800,812900
354070,202107,906,512,394,563200,435600,998800
354075,202107,179,81,98,90200,107800,198000
354080,202107,308,133,175,146300,192500,338800
354085,202107,24,14,10,15400,11000,26400
354090,202107,278,168,110,184707,122100,306807
354100,202107,5595,2284,3311,2512400.4,3653100,6165500.4
354105,202107,98,45,53,50600,59400,110000
354110,202107,45,23,22,25300,24200,49500
354120,202107,139,94,45,103400.93,49500,152900.93
354130,202107,697,428,269,470800.81,297000,767800.81
354140,202107,3157,1426,1731,1573000.55,1908500,3481500.55
354150,202107,620,363,257,401500.66,282700,684200.66
354160,202107,635,401,234,441100,258500,699600
354165,202107,15,13,2,14300,2200,16500
354170,202107,173,120,53,132000,58300,190300
354180,202107,58,35,23,38500.42,25300,63800.42
354190,202107,189,76,113,83600,124300,207900
354200,202107,107,56,51,61600,56100,117700
354210,202107,64,23,41,25300,45100,70400
354220,202107,620,394,226,433400.63,248600,682000.63
354230,202107,169,75,94,82500,103400,185900
354240,202107,323,205,118,225500.82,129800,355300.82
354250,202107,81,50,31,55000,34100,89100
354260,202107,2112,994,1118,1095600.5,1229800.85,2325401.35
354270,202107,87,63,24,69300,26400,95700
354280,202107,45,23,22,25300,24200,49500
354290,202107,144,99,45,108900,49500,158400
354300,202107,355,249,106,273900.63,116600,390500.63
354310,202107,91,68,23,74800,25300,100100
354320,202107,211,104,107,114400,117700,232100
354323,202107,10,9,1,9900,1100,11000
354325,202107,119,65,54,72600.83,59400,132000.83
354330,202107,2402,814,1588,897443,1750100,2647543
354340,202107,10189,4769,5420,5248968,5967500,11216468
354350,202107,139,89,50,97900,55000,152900
354360,202107,71,40,31,44000,34100,78100
354370,202107,237,123,114,135300,127600,262900
354380,202107,179,104,75,114400,84700,199100
354390,202107,2631,940,1691,1039500,1861200,2900700
354400,202107,293,165,128,182600,140800,323400
354410,202107,624,288,336,316800,369600,686400
354420,202107,264,169,95,185900,104500,290400
354425,202107,309,179,130,196951,143000,339951
354430,202107,186,105,81,115500,89100,204600
354440,202107,33,26,7,28600,7700,36300
354450,202107,54,36,18,39600,19800,59400
354460,202107,95,56,39,61600,42900,104500
354470,202107,27,14,13,15400,14300,29700
354480,202107,108,60,48,66000,52800,118800
354490,202107,135,84,51,92400,57200,149600
354500,202107,381,171,210,188100,231000,419100
354510,202107,93,62,31,68200,34100,102300
354515,202107,40,10,30,11000,33000,44000
354520,202107,1581,668,913,734643,1005400,1740043
354530,202107,787,393,394,433400,433400,866800
354540,202107,257,133,124,146300,136400,282700
354550,202107,38,23,15,25300,16500,41800
354560,202107,151,79,72,86900,79200,166100
354570,202107,134,92,42,102300,46200,148500
354580,202107,1798,851,947,937200,1041700,1978900
354600,202107,262,137,125,150700,137500,288200
354610,202107,68,58,10,63800,11000,74800
354620,202107,59,14,45,15400,49500,64900
354625,202107,14,9,5,9900,5500,15400
354630,202107,300,196,104,215600,114400,330000
354640,202107,811,502,309,553300.63,339900,893200.63
354650,202107,65,37,28,40700,30800,71500
354660,202107,782,572,210,630300.63,231000,861300.63
354670,202107,226,86,140,94600,155100,249700
354680,202107,1270,455,815,500500,896500,1397000
354690,202107,75,51,24,57200,26400,83600
354700,202107,75,52,23,57200,25300,82500
354710,202107,49,35,14,38500,15400,53900
354720,202107,20,20,0,22000,0,22000
354730,202107,1734,703,1031,775500,1136300,1911800
354740,202107,75,51,24,56100,26400,82500
354750,202107,417,240,177,264000,194700,458700
354760,202107,483,293,190,323400,210100,533500
354765,202107,8,3,5,3300,5500,8800
354770,202107,350,230,120,253000,132000,385000
354780,202107,8107,3112,4995,3426501.13,5503300,8929801.13
354790,202107,92,54,38,59400,41800,101200
354800,202107,442,241,201,266104.32,222200,488304.32
354805,202107,86,37,49,40700,55000,95700
354810,202107,104,62,42,69300,46200,115500
354820,202107,203,82,121,90200,133100,223300
354830,202107,44,24,20,26400,22000,48400
354840,202107,58,40,18,44000,19800,63800
354850,202107,4461,1954,2507,2150500.98,2761000.06,4911501.04
354860,202107,332,160,172,176000,189200,365200
354870,202107,11792,5175,6617,5698001.35,7283100,12981101.35
354880,202107,2674,987,1687,1087900.89,1855751.7,2943652.59
354890,202107,2858,1514,1344,1666501.52,1479500,3146001.52
354900,202107,66,44,22,48400,24200,72600
354910,202107,1261,646,615,710600,676500.05,1387100.05
354920,202107,41,33,8,36300,8800,45100
354925,202107,19,8,11,8800,12100,20900
354930,202107,36,32,4,35200.4,4400,39600.4
354940,202107,770,552,218,608300,239800,848100
354950,202107,206,126,80,138600,88000,226600
354960,202107,136,50,86,56100,94600,150700
354970,202107,996,674,322,741401.26,355300,1096701.26
354980,202107,8850,3146,5704,3463903.18,6282100.39,9746003.57
354990,202107,9575,4288,5287,4722300,5819000,10541300
354995,202107,540,168,372,184800,409200,594000
355000,202107,452,154,298,169400,327800,497200
355010,202107,581,359,222,394900,245300.63,640200.63
355020,202107,780,485,295,533500,325600,859100
355030,202107,207224,78005,129219,85896106.83,142311446.07,228207552.90
355040,202107,823,378,445,415800,489500,905300
355050,202107,156,88,68,96800,74800,171600
355060,202107,1670,808,862,892100,948200,1840300
355070,202107,1482,688,794,756800.08,873401.45,1630201.53
355080,202107,190,116,74,127600,81400,209000
355090,202107,288,169,119,185900,130900.57,316800.57
355100,202107,5060,2415,2645,2658590,2910600,5569190
355110,202107,235,157,78,172700,85800,258500
355120,202107,56,36,20,39600,22000,61600
355130,202107,48,28,20,30800,22000,52800
355140,202107,188,112,76,123200,83600,206800
355150,202107,669,392,277,432300,304700,737000
355160,202107,477,229,248,251900.63,272800,524700.63
355170,202107,2015,1040,975,1145100,1073600,2218700
355180,202107,680,277,403,304700,445500,750200
355190,202107,212,142,70,156200,77000,233200
355200,202107,105,58,47,63800,51700,115500
355210,202107,688,382,306,420200,336600,756800
355220,202107,7278,3668,3610,4038100.53,3973200,8011300.53
355230,202107,97,60,37,66000,40700,106700
355240,202107,4465,1839,2626,2024000.5,2891900,4915900.5
355250,202107,5977,2585,3392,2845721.06,3733400,6579121.06
355255,202107,49,28,21,30800,23100,53900
355260,202107,170,104,66,114400,72600,187000
355270,202107,166,108,58,118800,63800,182600
355280,202107,6561,2486,4075,2737900,4490200,7228100
355290,202107,72,59,13,64900,14300,79200
355300,202107,210,121,89,133100,97900,231000
355310,202107,110,58,52,63800,57200,121000
355320,202107,93,49,44,53900,48400,102300
355330,202107,280,157,123,172700,136400,309100
355340,202107,1444,493,951,543401.21,1050500,1593901.21
355350,202107,154,76,78,83600,85800,169400
355360,202107,173,115,58,126500,64900,191400
355365,202107,18,14,4,15400,4400,19800
355370,202107,1024,612,412,673200.63,453200,1126400.63
355380,202107,797,495,302,544500,333300,877800
355385,202107,79,53,26,58300,28600,86900
355390,202107,109,58,51,63800,56100,119900
355395,202107,187,101,86,111100.5,94600,205700.5
355400,202107,1713,995,718,1096609.81,794200.63,1890810.44
355410,202107,4910,2278,2632,2505800,2896300,5402100
355420,202107,49,36,13,39600,14300,53900
355430,202107,398,244,154,268400,169400,437800
355440,202107,81,49,32,53900,35200,89100
355450,202107,419,203,216,223300,237600,460900
355460,202107,56,44,12,48400,13200,61600
355465,202107,46,27,19,29700,20900,50600
355470,202107,183,73,110,80300,121000,201300
355475,202107,13,9,4,9900,4400,14300
355480,202107,567,230,337,253000,372900,625900
355490,202107,112,77,35,84700,38500,123200
355495,202107,67,25,42,27500,46200,73700
355500,202107,1569,858,711,943800.48,783200,1727000.48
355510,202107,263,191,72,210100.63,79200,289300.63
355520,202107,29,22,7,24200,7700,31900
355530,202107,22,11,11,12100,12100,24200
355535,202107,74,33,41,36300,45100,81400
355540,202107,2546,986,1560,1086955.1,1717100.63,2804055.73
355550,202107,59,35,24,38500,26400,64900
355560,202107,242,112,130,123200,143000,266200
355570,202107,20,13,7,14300,7700,22000
355580,202107,239,168,71,184800,78100,262900
355590,202107,17,9,8,9900,8800,18700
355600,202107,265,134,131,147400,144100,291500
355610,202107,228,148,80,163900,88000,251900
355620,202107,1289,558,731,616000,805200,1421200
355630,202107,417,310,107,341000,117700,458700
355635,202107,121,54,67,59400,73700,133100
355640,202107,532,293,239,324500,262900,587400
355645,202107,860,333,527,366300,580800,947100
355650,202107,1911,811,1100,892100,1212200,2104300
355660,202107,231,121,110,133100,121000,254100
355670,202107,580,242,338,267300,372900,640200
355680,202107,202,111,91,122100,101200,223300
355690,202107,87,43,44,47300,48400,95700
355695,202107,23,14,9,15400,9900,25300
355700,202107,1145,582,563,640200,619300,1259500
355710,202107,2201,1194,1007,1315600,1111000,2426600
355715,202107,13,11,2,12100,2200,14300
355720,202107,241,146,95,161700,104500,266200
355730,202107,101,58,43,63800,47300,111100
410010,202107,130,102,28,112200,30800,143000
410020,202107,118,88,30,96800,33000,129800
410030,202107,172,94,78,104500,85800,190300
410040,202107,1243,612,631,674300,694100,1368400
410045,202107,42,32,10,35200,11000,46200
410050,202107,493,278,215,305800,236500,542300
410060,202107,280,203,77,223300,84700,308000
410070,202107,284,238,46,262900,50600,313500
410080,202107,176,101,75,112200,82500,194700
410090,202107,71,61,10,67100,11000,78100
410100,202107,295,198,97,217800,106700,324500
410105,202107,44,25,19,27500,20900,48400
410110,202107,328,196,132,215600,145200,360800
410115,202107,41,23,18,25300,19800,45100
410120,202107,425,196,229,215600,253000,468600
410130,202107,55,31,24,34100,26400,60500
410140,202107,3121,1419,1702,1562000.03,1875500.88,3437500.91
410150,202107,2664,1027,1637,1131900,1801800,2933700
410160,202107,493,292,201,321200,221100,542300
410165,202107,48,28,20,30800,22000,52800
410170,202107,186,115,71,126500,78100,204600
410180,202107,2261,1217,1044,1338700,1148400,2487100
410185,202107,31,26,5,28600,5500,34100
410190,202107,486,305,181,335500,199100,534600
410200,202107,941,659,282,727100,310200,1037300
410210,202107,612,305,307,335500,337700,673200
410220,202107,47,21,26,23100,28600,51700
410230,202107,164,73,91,80300,100100,180400
410240,202107,735,461,274,508200,301400,809600
410250,202107,372,260,112,286000,123200,409200
410260,202107,297,163,134,179300,147400,326700
410270,202107,28,21,7,23100,7700,30800
410275,202107,57,41,16,45100,17600,62700
410280,202107,319,183,136,201300,150700,352000
410290,202107,261,147,114,161700,125400,287100
410300,202107,80,53,27,58300,29700,88000
410302,202107,24,15,9,16500,9900,26400
410304,202107,35,24,11,26400,12100,38500
410305,202107,221,118,103,129800,113300,243100
410310,202107,207,120,87,132000,95700,227700
410315,202107,44,31,13,34100,14300,48400
410320,202107,138,91,47,100100,51700,151800
410322,202107,33,20,13,22000,14300,36300
410330,202107,180,119,61,130900,67100,198000
410335,202107,101,56,45,61600,49500,111100
410337,202107,45,34,11,37400,12100,49500
410340,202107,40,33,7,36300,7700,44000
410345,202107,206,117,89,128700,97900,226600
410347,202107,45,35,10,38500,11000,49500
410350,202107,249,140,109,154000,119900,273900
410360,202107,439,273,166,301400,182600,484000
410370,202107,2309,940,1369,1034000,1507000,2541000
410380,202107,203,119,84,130900,92400,223300
410390,202107,382,257,125,282700,137500,420200
410395,202107,36,22,14,24200,15400,39600
410400,202107,851,362,489,398200.5,539000,937200.5
410405,202107,81,61,20,67100,22000,89100
410410,202107,29,19,10,20900,11000,31900
410420,202107,1710,775,935,855702.1,1029600,1885302.1
410425,202107,182,70,112,77000,123200,200200
410430,202107,2293,1219,1074,1340900,1182500,2523400
410440,202107,371,265,106,291500,116600,408100
410442,202107,364,236,128,259600,140800,400400
410445,202107,418,298,120,327800,132000,459800
410450,202107,390,189,201,207900,221100,429000
410460,202107,553,282,271,310200,299200,609400
410465,202107,236,134,102,147400,112200,259600
410470,202107,253,145,108,159500,118800,278300
410480,202107,6357,2980,3377,3286800,3716900,7003700
410490,202107,1435,835,600,918500,660000,1578500
410500,202107,269,153,116,169400,127600,297000
410510,202107,169,123,46,135300,51700,187000
410520,202107,262,190,72,209000,79200,288200
410530,202107,304,97,207,106700,227700,334400
410540,202107,332,242,90,266200,99000,365200
410550,202107,1702,692,1010,764500,1112100,1876600
410560,202107,152,103,49,113300,53900,167200
410570,202107,440,293,147,322300,161700,484000
410580,202107,3553,1477,2076,1626900.2,2286900,3913800.2
410590,202107,396,258,138,283781,151800,435581
410600,202107,192,165,27,182600,29700,212300
410610,202107,50,42,8,46200,8800,55000
410620,202107,259,168,91,184800.4,100100,284900.4
410630,202107,445,241,204,265100,226600,491700
410640,202107,1020,629,391,693000,430100,1123100
410645,202107,110,78,32,85800,35200,121000
410650,202107,364,227,137,249700,151800,401500
410655,202107,87,62,25,68200,27500,95700
410657,202107,32,11,21,12100,23100,35200
410660,202107,623,418,205,460900.5,225500,686400.5
410670,202107,73,60,13,66000,14300,80300
410680,202107,193,156,37,171600,40700,212300
410685,202107,28,17,11,18700,12100,30800
410690,202107,28538,11739,16799,12927200.17,18497600.74,31424800.91
410700,202107,322,236,86,259600,94600,354200
410710,202107,129,104,25,114400,27500,141900
410712,202107,46,32,14,35200,15400,50600
410715,202107,87,66,21,72600,23100,95700
410720,202107,680,383,297,422400.92,327800,750200.92
410725,202107,179,126,53,139700,58300,198000
410730,202107,102,49,53,53900,58300,112200
410740,202107,109,74,35,81400,38500,119900
410750,202107,284,185,99,203500,110000,313500
410752,202107,21,14,7,15400,7700,23100
410753,202107,61,23,38,25300,41800,67100
410754,202107,52,25,27,27500,29700,57200
410755,202107,80,46,34,50600,37400,88000
410760,202107,758,410,348,454300,383900,838200
410765,202107,1830,827,1003,910800,1103300,2014100
410770,202107,117,85,32,93500,35200,128700
410773,202107,61,42,19,46200,20900,67100
410775,202107,184,136,48,149600,52800,202400
410780,202107,90,49,41,53900,45100,99000
410785,202107,55,45,10,49500,12100,61600
410790,202107,87,37,50,40700,55000,95700
410800,202107,281,174,107,191400,117700,309100
410810,202107,24,13,11,14300,12100,26400
410820,202107,168,116,52,129800,57200,187000
410830,202107,8780,3660,5120,4029300.4,5637500,9666800.4
410832,202107,107,71,36,78100,39600,117700
410840,202107,1444,756,688,833800.21,757900,1591700.21
410845,202107,47,27,20,29700,22000,51700
410850,202107,178,125,53,137500,58300,195800
410855,202107,66,56,10,62700,11000,73700
410860,202107,767,386,381,425700,419100,844800
410865,202107,99,71,28,78100,30800,108900
410870,202107,148,125,23,137500,25300.99,162800.99
410880,202107,1154,562,592,618200,652300,1270500
410890,202107,88,62,26,68200,28600,96800
410895,202107,73,56,17,61600,18700,80300
410900,202107,26,17,9,18700,9900,28600
410910,202107,16,11,5,12100,5500,17600
410920,202107,37,23,14,25300,15400,40700
410930,202107,546,330,216,363000,237600,600600
410940,202107,4401,2324,2077,2557500.6,2284700,4842200.6
410950,202107,102,75,27,82500,29700,112200
410960,202107,864,335,529,368500,583000,951500
410965,202107,68,45,23,49500,25300,74800
410970,202107,617,426,191,468600,211200,679800
410975,202107,127,79,48,86900.38,52800,139700.38
410980,202107,1625,710,915,782100,1006500,1788600
410990,202107,274,191,83,210100,91300,301400
411000,202107,64,36,28,39600,30800,70400
411005,202107,27,22,5,24200,5500,29700
411007,202107,248,142,106,156200,116600,272800
411010,202107,603,391,212,431200,234300,665500
411020,202107,290,187,103,205700,113300,319000
411030,202107,22,11,11,12100,12100,24200
411040,202107,54,36,18,39600,19800,59400
411050,202107,218,159,59,174900,64900,239800
411060,202107,520,348,172,383900,189200,573100
411065,202107,51,46,5,50600,5500,56100
411070,202107,1268,734,534,809600,588500,1398100
411080,202107,244,172,72,189200,79200,268400
411090,202107,93,71,22,78100,24200,102300
411095,202107,321,114,207,125400,227700,353100
411100,202107,121,95,26,104500,28600,133100
411110,202107,131,77,54,84700,59400,144100
411120,202107,212,137,75,151800,82500,234300
411125,202107,265,116,149,127600,163900,291500
411130,202107,121,102,19,112200,20900,133100
411140,202107,215,144,71,158400,78100,236500
411150,202107,1242,801,441,882200,485100.63,1367300.63
411155,202107,123,84,39,92400,44000,136400
411160,202107,30,12,18,13200,19800,33000
411170,202107,49,43,6,47300,6600,53900
411180,202107,983,636,347,699600,381700,1081300
411190,202107,328,185,143,204600,158400,363000
411200,202107,661,387,274,426800.63,301400,728200.63
411210,202107,674,348,326,382800,358600.1,741400.1
411220,202107,163,110,53,121000,58300,179300
411230,202107,38,31,7,34100,7700,41800
411240,202107,116,71,45,78100,49500,127600
411250,202107,426,309,117,341000,129800,470800
411260,202107,14,10,4,11000,4400,15400
411270,202107,267,136,131,149600.59,144100,293700.59
411275,202107,179,154,25,170500,27500,198000
411280,202107,198,139,59,154000.63,64900,218900.63
411290,202107,62,48,14,52800,15400,68200
411295,202107,126,100,26,110000,28600,138600
411300,202107,77,32,45,35200,49500,84700
411310,202107,91,67,24,73700,26400,100100
411320,202107,794,511,283,562100,311300,873400
411325,202107,54,37,17,40700,18700,59400
411330,202107,904,584,320,643500,353100.15,996600.15
411340,202107,30,19,11,20900,12100,33000
411342,202107,58,43,15,47300,16500,63800
411345,202107,113,56,57,61600,62700,124300
411350,202107,494,367,127,405900,139700,545600
411360,202107,57,36,21,39600,23100,62700
411370,202107,14152,5579,8573,6146801.89,9442402.31,15589204.20
411373,202107,182,121,61,133100,67100,200200
411375,202107,80,64,16,70400,17600,88000
411380,202107,84,60,24,66000,26400,92400
411390,202107,126,72,54,79200,59400,138600
411400,202107,410,282,128,310200,140800,451000
411410,202107,473,214,259,235400,284900,520300
411420,202107,974,412,562,453200,619300,1072500
411430,202107,502,274,228,301400,251900,553300
411435,202107,31,18,13,19800,14300,34100
411440,202107,472,370,102,407000,113300,520300
411450,202107,415,352,63,388300,70400,458700
411460,202107,790,293,497,322300,546700,869000
411470,202107,102,70,32,77000,35200,112200
411480,202107,692,362,330,398200,363000,761200
411490,202107,290,184,106,202400,116600,319000
411500,202107,100,80,20,88000,22000,110000
411510,202107,222,174,48,191400,52800,244200
411520,202107,6088,2147,3941,2366100,4340600.7,6706700.7
411530,202107,124,83,41,92400,45100,137500
411535,202107,51,19,32,20900,35200,56100
411540,202107,360,240,120,264000,132000,396000
411545,202107,55,39,16,42900,17600,60500
411550,202107,82,61,21,67100,23100,90200
411560,202107,403,163,240,179300,264000,443300
411570,202107,907,311,596,342100,655600,997700
411573,202107,25,14,11,15400,12100,27500
411575,202107,304,185,119,203500,130900,334400
411580,202107,1256,447,809,492800,889900,1382700
411585,202107,73,34,39,37400,42900,80300
411590,202107,17,11,6,12100,6600,18700
411600,202107,23,10,13,11000,14300,25300
411605,202107,249,96,153,105600,168300,273900
411610,202107,214,135,79,148500,86900,235400
411620,202107,391,194,197,213400,217800,431200
411630,202107,51,35,16,38500,17600,56100
411640,202107,31,21,10,23100,11000,34100
411650,202107,9,6,3,6600,3300,9900
411660,202107,40,28,12,30800,13200,44000
411670,202107,235,163,72,179300,79200,258500
411680,202107,164,132,32,145200,35200,180400
411690,202107,616,321,295,353100,324500,677600
411695,202107,66,46,20,50600,22000,72600
411700,202107,144,114,30,125400,33000,158400
411705,202107,106,70,36,77000,39600,116600
411710,202107,293,193,100,212300,110000,322300
411720,202107,134,87,47,95700,51700,147400
411721,202107,78,61,17,67100,18700,85800
411722,202107,106,41,65,46200,71500,117700
411725,202107,162,117,45,128700,49500,178200
411727,202107,94,73,21,80300,23100,103400
411729,202107,41,31,10,34100,11000,45100
411730,202107,558,345,213,379500,235400,614900
411740,202107,32,19,13,20900,14300,35200
411745,202107,63,46,17,50600,18700,69300
411750,202107,841,360,481,396000,529100,925100
411760,202107,1184,862,322,948200,354200,1302400
411770,202107,445,297,148,326700,162800,489500
411780,202107,353,229,124,253000,136400,389400
411790,202107,552,302,250,333300.18,275000,608300.18
411800,202107,151,109,42,119900.65,46200,166100.65
411810,202107,180,134,46,147400,51700,199100
411820,202107,2344,988,1356,1086800,1491600,2578400
411830,202107,11,10,1,11000,1100,12100
411840,202107,2073,1215,858,1337600,944900,2282500
411845,202107,63,22,41,24200,45100,69300
411850,202107,1236,670,566,737000,622600,1359600
411860,202107,48,29,19,31900,20900,52800
411870,202107,68,41,27,45100,29700,74800
411880,202107,435,261,174,287100,191400,478500
411885,202107,101,58,43,63800,47300,111100
411890,202107,304,200,104,220000,114400,334400
411900,202107,99,69,30,75900,33000,108900
411910,202107,182,138,44,151800,48400,200200
411915,202107,2294,899,1395,990000.86,1535600,2525600.86
411920,202107,116,90,26,99000,28600,127600
411925,202107,14,9,5,9900,5500,15400
411930,202107,805,569,236,625970.4,259600,885570.4
411940,202107,583,372,211,409200,232100,641300
411950,202107,1123,512,611,563200,673200,1236400
411960,202107,1107,711,396,783200,435600,1218800
411965,202107,25,14,11,15400,12100,27500
411970,202107,93,78,15,85800,16500,102300
411980,202107,191,107,84,117700,92400,210100
411990,202107,5137,2799,2338,3081101.42,2574071.5,5655172.92
411995,202107,570,178,392,196900,432300,629200
412000,202107,322,204,118,225500,129800,355300
412010,202107,42,24,18,26400,19800,46200
412015,202107,39,30,9,33000,9900,42900
412020,202107,19,15,4,16500,4400,20900
412030,202107,42,38,4,41800,4400,46200
412033,202107,56,31,25,34100,27500,61600
412035,202107,72,45,27,49500,29700,79200
412040,202107,39,21,18,23100,19800,42900
412050,202107,211,155,56,172700,61600,234300
412060,202107,769,559,210,614900.6,231000.13,845900.73
412065,202107,50,30,20,33000,23100,56100
412070,202107,165,115,50,126500,55000,181500
412080,202107,304,145,159,159500,174900,334400
412085,202107,37,15,22,16500,24200,40700
412090,202107,830,512,318,564300,349800,914100
412100,202107,261,215,46,237600,50600,288200
412110,202107,68,52,16,57200,17600,74800
412120,202107,337,187,150,207900,165000,372900
412125,202107,74,48,26,52800,28600,81400
412130,202107,41,26,15,28600,16500,45100
412135,202107,28,16,12,17600,13200,30800
412140,202107,371,232,139,256300,152900,409200
412150,202107,243,156,87,171600,96800,268400
412160,202107,92,54,38,59400,41800,101200
412170,202107,700,476,224,523600,247500,771100
412175,202107,33,25,8,27500,8800,36300
412180,202107,189,142,47,156200,51700,207900
412190,202107,319,247,72,271700,79200,350900
412200,202107,184,115,69,126500,75900,202400
412210,202107,95,70,25,77000,27500,104500
412215,202107,237,157,80,173800,88000,261800
412217,202107,61,50,11,55000,12100,67100
412220,202107,825,559,266,614900,292600,907500
412230,202107,304,186,118,204600,132000,336600
412240,202107,1323,634,689,700700,759000,1459700
412250,202107,411,253,158,278300,174900,453200
412260,202107,113,76,37,83600,40700,124300
412265,202107,180,134,46,147400,50600,198000
412270,202107,88,59,29,64900,31900,96800
412280,202107,90,70,20,77000,22000,99000
412290,202107,90,60,30,66000,33000,99000
412300,202107,205,140,65,155100,71500,226600
412310,202107,53,42,11,46200,12100,58300
412320,202107,93,75,18,82500,19800,102300
412330,202107,182,150,32,165000,35200,200200
412340,202107,160,110,50,121000,55000,176000
412350,202107,651,299,352,330000,387200,717200
412360,202107,24,21,3,23100,3300,26400
412370,202107,155,132,23,145200,25300,170500
412380,202107,224,168,56,185900,61600,247500
412382,202107,59,33,26,36300,28600,64900
412385,202107,154,108,46,118800,50600,169400
412390,202107,300,224,76,246400,83600,330000
412395,202107,70,57,13,62700,14300,77000
412400,202107,94,63,31,69300,34100,103400
412402,202107,231,114,117,125400,128700,254100
412405,202107,921,309,612,341000,673200.5,1014200.5
412410,202107,954,568,386,624800,424600,1049400
412420,202107,20,18,2,19800,2200,22000
412430,202107,21,19,2,20900,2200,23100
412440,202107,636,331,305,364100,335500,699600
412450,202107,77,69,8,75900,8800,84700
412460,202107,93,71,22,78100,24200,102300
412470,202107,215,168,47,184800,51700,236500
412480,202107,148,106,42,116600,46200,162800
412490,202107,161,138,23,151800,25300,177100
412500,202107,412,325,87,357500.44,95700,453200.44
412510,202107,165,134,31,147400,34100,181500
412520,202107,93,60,33,66000,37400,103400
412530,202107,107,52,55,57200,60500,117700
412535,202107,89,66,23,72600,25300,97900
412540,202107,83,41,42,45100,46200,91300
412545,202107,86,59,27,64900,30800,95700
412550,202107,3980,1596,2384,1760000,2625700,4385700
412555,202107,10,6,4,6600,4400,11000
412560,202107,644,439,205,482900,225500,708400
412570,202107,791,379,412,416900,453200,870100
412575,202107,93,64,29,70400,31900,102300
412580,202107,172,116,56,127600,61600,189200
412590,202107,33,29,4,31900,4400,36300
412600,202107,175,123,52,135300,57200,192500
412610,202107,33,13,20,14300,22000,36300
412620,202107,146,122,24,134200,26400,160600
412625,202107,2122,1049,1073,1156100.63,1181400,2337500.63
412627,202107,71,52,19,57200,20900,78100
412630,202107,392,257,135,282700,148500,431200
412635,202107,74,19,55,20900,60500,81400
412640,202107,102,72,30,79200,33000,112200
412650,202107,329,216,113,237600,124300,361900
412660,202107,461,269,192,295900,212300,508200
412665,202107,42,37,5,40700,5500,46200
412667,202107,299,189,110,209000,121000,330000
412670,202107,69,56,13,61600,14300,75900
412680,202107,305,226,79,249700,86900,336600
412690,202107,117,75,42,82500,46200,128700
412700,202107,174,115,59,126500,64900,191400
412710,202107,1332,764,568,841500.62,624800,1466300.62
412720,202107,236,136,100,149600,110000,259600
412730,202107,189,159,30,174900,33000,207900
412740,202107,421,210,211,232100,232100,464200
412750,202107,434,233,201,256300,221100,477400
412760,202107,316,157,159,172700,176000,348700
412770,202107,2113,1139,974,1254000.63,1072500,2326500.63
412780,202107,143,106,37,116600,40700,157300
412785,202107,309,147,162,161700,179300,341000
412788,202107,41,25,16,27500,18700,46200
412790,202107,120,97,23,106700,25300,132000
412795,202107,151,106,45,117700,49500,167200
412796,202107,302,191,111,210100,122100,332200
412800,202107,646,381,265,419100,291500,710600
412810,202107,2991,1576,1415,1738000.59,1559800,3297800.59
412820,202107,943,566,377,622600,415800,1038400
412830,202107,13,10,3,11000,3300,14300
412840,202107,239,158,81,173800,89100,262900
412850,202107,736,457,279,502700,306900,809600
412853,202107,168,79,89,86900,97900,184800
412855,202107,191,100,91,110000.26,100100,210100.26
412860,202107,97,65,32,71500,35200,106700
412862,202107,67,43,24,47300,26400,73700
412863,202107,9,7,2,7700,2200,9900
412865,202107,43,31,12,34100,13200,47300
412870,202107,106,62,44,69300,48400,117700
412880,202107,91,65,26,72600,28600,101200
420005,202107,41,37,4,40700,4400,45100
420010,202107,370,235,135,258500,148500,407000
420020,202107,87,70,17,77000,18700,95700
420030,202107,25,21,4,23100,4400,27500
420040,202107,96,74,22,81400,24200,105600
420050,202107,58,34,24,37400,26400,63800
420055,202107,17,17,0,18700,0,18700
420060,202107,27,20,7,22000,7700,29700
420070,202107,104,87,17,97900,18700,116600
420075,202107,11,11,0,12100,0,12100
420080,202107,41,36,5,39600,5500,45100
420090,202107,38,32,6,35200,6600,41800
420100,202107,154,131,23,144100,25300,169400
420110,202107,19,19,0,20900,0,20900
420120,202107,62,43,19,48400,20900,69300
420125,202107,85,65,20,71500,22000,93500
420127,202107,32,26,6,28600,6600,35200
420130,202107,451,266,185,292600,203500,496100
420140,202107,1323,728,595,801900,654500,1456400
420150,202107,47,37,10,40700,11000,51700
420160,202107,29,27,2,29700,2200,31900
420165,202107,16,11,5,12100,5500,17600
420170,202107,66,39,27,42900,29700,72600
420180,202107,20,17,3,18700,3300,22000
420190,202107,26,23,3,25300,3300,28600
420195,202107,140,68,72,74800,79200,154000
420200,202107,1286,542,744,596200,818400,1414600
420205,202107,91,50,41,55000,45100,100100
420207,202107,131,71,60,78100,67100,145200
420208,202107,20,16,4,17600,4400,22000
420209,202107,14,12,2,13200,2200,15400
420210,202107,537,254,283,279400,311300,590700
420213,202107,47,35,12,38500,13200,51700
420215,202107,26,22,4,24200,4400,28600
420220,202107,62,38,24,41800,26400,68200
420230,202107,871,511,360,562100,397100,959200
420240,202107,2198,1419,779,1562000,861300,2423300
420243,202107,44,35,9,38500,9900,48400
420245,202107,187,94,93,103400,102300,205700
420250,202107,63,41,22,45100,24200,69300
420253,202107,26,19,7,20900,7700,28600
420257,202107,12,9,3,9900,3300,13200
420260,202107,103,83,20,91300,22000,113300
420270,202107,29,23,6,25300,6600,31900
420280,202107,287,216,71,237600,78100,315700
420285,202107,22,15,7,16500,7700,24200
420287,202107,49,32,17,35200,18700,53900
420290,202107,951,650,301,715000,331100,1046100
420300,202107,1468,1163,305,1282600,335500,1618100
420310,202107,48,32,16,35200,17600,52800
420315,202107,32,25,7,27500,7700,35200
420320,202107,979,461,518,507100,570900,1078000
420325,202107,3,1,2,1100,2200,3300
420330,202107,125,79,46,86900,50600,137500
420340,202107,167,113,54,124300,59400,183700
420350,202107,257,177,80,195800,88000,283800
420360,202107,702,538,164,592900.88,180400,773300.88
420370,202107,130,75,55,82500,60500,143000
420380,202107,1191,817,374,899800,411400,1311200
420390,202107,230,159,71,174900,78100,253000
420395,202107,188,135,53,148500,59400,207900
420400,202107,244,188,56,207900,61600,269500
420410,202107,57,44,13,48400,14300,62700
420415,202107,33,28,5,30800,5500,36300
420417,202107,54,43,11,47300,12100,59400
420419,202107,12,11,1,12100,1100,13200
420420,202107,2789,1720,1069,1895300,1175900,3071200
420425,202107,71,58,13,63800,14300,78100
420430,202107,1122,809,313,891000,344300,1235300
420435,202107,14,12,2,13200,2200,15400
420440,202107,96,69,27,75900,29700,105600
420445,202107,27,26,1,28600,1100,29700
420450,202107,80,36,44,39600,48400,88000
420455,202107,200,153,47,168300,51700,220000
420460,202107,2315,1458,857,1607100,943800,2550900
420470,202107,97,69,28,75900,30800,106700
420475,202107,9,8,1,8800,1100,9900
420480,202107,865,650,215,715000,236500,951500
420490,202107,97,70,27,77000,29700,106700
420500,202107,456,240,216,264000.26,237600,501600.26
420510,202107,20,19,1,20900,1100,22000
420515,202107,26,14,12,15400,13200,28600
420517,202107,9,9,0,9900,0,9900
420519,202107,0,,,,,0.0
420520,202107,63,49,14,53900,15400,69300
420530,202107,154,98,56,107800,61600,169400
420535,202107,19,17,2,18700,2200,20900
420540,202107,5813,3530,2283,3892075.6,2515700,6407775.6
420543,202107,29,27,2,29700,2200,31900
420545,202107,211,150,61,165000,67100,232100
420550,202107,817,673,144,740300,159500,899800
420555,202107,29,20,9,22000,9900,31900
420560,202107,61,50,11,55000,12100,67100
420570,202107,182,98,84,107800,92400,200200
420580,202107,283,134,149,147400,163900,311300
420590,202107,471,309,162,339900,178200,518100
420600,202107,139,75,64,82500,70400,152900
420610,202107,38,35,3,38500,3300,41800
420620,202107,80,60,20,66000,22000,88000
420630,202107,145,91,54,101200,59400,160600
420640,202107,79,69,10,75900,11000,86900
420650,202107,252,126,126,138600,138600,277200
420660,202107,44,36,8,39600,8800,48400
420665,202107,42,27,15,29700,16500,46200
420670,202107,280,220,60,243100,66000,309100
420675,202107,14,12,2,13200,2200,15400
420680,202107,34,24,10,26400,11000,37400
420690,202107,180,138,42,151800,46200,198000
420700,202107,693,452,241,498300.7,265100,763400.7
420710,202107,151,79,72,86900,79200,166100
420720,202107,102,81,21,90200,23100,113300
420730,202107,659,394,265,433400,291500,724900
420740,202107,54,53,1,58300,1100,59400
420750,202107,477,317,160,348700,176000,524700
420757,202107,16,14,2,15400,2200,17600
420760,202107,38,30,8,33000,8800,41800
420765,202107,82,60,22,66000,24200,90200
420768,202107,53,42,11,46200,12100,58300
420770,202107,73,60,13,66000,14300,80300
420775,202107,39,36,3,39600,3300,42900
420780,202107,204,160,44,176000,48400,224400
420785,202107,21,13,8,14300,8800,23100
420790,202107,153,126,27,138600,29700,168300
420800,202107,65,48,17,52800,18700,71500
420810,202107,261,212,49,233200,53900,287100
420820,202107,2436,1356,1080,1491600,1189100.5,2680700.5
420830,202107,635,327,308,359700,338800,698500
420840,202107,148,102,46,113300,50600,163900
420845,202107,410,169,241,185900,265100,451000
420850,202107,262,195,67,214500,73700,288200
420860,202107,56,45,11,49500,12100,61600
420870,202107,132,92,40,101200,44000,145200
420880,202107,184,118,66,129800,72600,202400
420890,202107,957,467,490,513700,540100,1053800
420895,202107,8,8,0,8800,0,8800
420900,202107,408,324,84,356400,92400,448800
420910,202107,5712,3047,2665,3355001.3,2933700,6288701.3
420915,202107,59,54,5,59400,5500,64900
420917,202107,21,15,6,16500,6600,23100
420920,202107,21,14,7,15400,7700,23100
420930,202107,2918,1836,1082,2021729,1192400.68,3214129.68
420940,202107,588,428,160,470800,176000,646800
420945,202107,10,7,3,7700,3300,11000
420950,202107,56,45,11,49500,12100,61600
420960,202107,109,90,19,99000,20900,119900
420970,202107,284,229,55,251900,60500,312400
420980,202107,23,22,1,24200,1100,25300
420985,202107,56,50,6,55000,6600,61600
420990,202107,79,58,21,63800,23100,86900
421000,202107,48,26,22,28600,24200,52800
421003,202107,45,31,14,34100,15400,49500
421005,202107,6,3,3,3300,3300,6600
421010,202107,795,514,281,569800,310200,880000
421020,202107,24,18,6,19800,6600,26400
421030,202107,116,99,17,108900,18700,127600
421040,202107,69,49,20,53900,22000,75900
421050,202107,338,234,104,258500,114400,372900
421055,202107,20,15,5,16500,5500,22000
421060,202107,94,51,43,56100,47300,103400
421070,202107,36,30,6,33000,6600,39600
421080,202107,40,33,7,36300,7700,44000
421085,202107,20,16,4,18700,4400,23100
421090,202107,33,26,7,28600,7700,36300
421100,202107,117,86,31,94600,34100,128700
421105,202107,184,148,36,163900,39600,203500
421110,202107,115,85,30,93500,33000,126500
421120,202107,175,128,47,140800.92,51700,192500.92
421125,202107,18,12,6,13200,6600,19800
421130,202107,847,519,328,570900,360800,931700
421140,202107,34,23,11,25300,12100,37400
421145,202107,47,36,11,39600,12100,51700
421150,202107,96,70,26,77000,28600,105600
421160,202107,65,42,23,46200,25300,71500
421165,202107,16,13,3,14300,3300,17600
421170,202107,180,149,31,164032,34100,198132
421175,202107,167,114,53,125400,58300,183700
421180,202107,43,29,14,31900,15400,47300
421185,202107,14,11,3,12100,3300,15400
421187,202107,1,0,1,0,1100,1100
421189,202107,44,30,14,33000,15400,48400
421190,202107,1779,1111,668,1226500.13,735900.55,1962400.68
421200,202107,93,67,26,73700,28600,102300
421205,202107,26,17,9,18700,9900,28600
421210,202107,179,125,54,137500,59400,196900
421220,202107,254,195,59,214500,66000,280500
421223,202107,46,35,11,38500,12100,50600
421225,202107,72,45,27,49500,29700,79200
421227,202107,79,63,16,69300,17600,86900
421230,202107,60,43,17,47300,18700,66000
421240,202107,17,17,0,18700,0,18700
421250,202107,370,213,157,234300,172700,407000
421260,202107,21,17,4,18700,4400,23100
421265,202107,2,2,0,2200,0,2200
421270,202107,49,43,6,47300,6600,53900
421280,202107,362,189,173,207900,190300,398200
421290,202107,325,215,110,236500,121000,357500
421300,202107,25,20,5,22000,5500,27500
421310,202107,51,34,17,37400,18700,56100
421315,202107,31,17,14,18700,15400,34100
421320,202107,126,81,45,89100.61,49500,138600.61
421330,202107,105,77,28,84700,30800,115500
421335,202107,41,30,11,33000,13200,46200
421340,202107,242,156,86,172700,94600,267300
421350,202107,187,110,77,121000.39,84700,205700.39
421360,202107,680,474,206,521400,226600,748000
421370,202107,189,138,51,151800,56100,207900
421380,202107,134,104,30,114400,33000,147400
421390,202107,17,11,6,12100,6600,18700
421400,202107,114,95,19,104500,20900,125400
421410,202107,22,19,3,20900,3300,24200
421415,202107,19,17,2,18700,2200,20900
421420,202107,105,89,16,99000,17600,116600
421430,202107,16,11,5,12100,5500,17600
421440,202107,59,52,7,58300,7700,66000
421450,202107,86,70,16,77000,17600.51,94600.51
421460,202107,58,44,14,48400,15400,63800
421470,202107,73,41,32,45100,35200,80300
421480,202107,749,565,184,622600,202400,825000
421490,202107,26,25,1,27500,1100,28600
421500,202107,486,300,186,330000,204600,534600
421505,202107,23,17,6,18700,6600,25300
421507,202107,33,26,7,28600,7700,36300
421510,202107,70,45,25,49500,27500,77000
421520,202107,54,44,10,48400,11000,59400
421530,202107,52,42,10,47300,11000,58300
421535,202107,19,18,1,19800,1100,20900
421540,202107,52,41,11,45100,12100,57200
421545,202107,87,62,25,68200,27500,95700
421550,202107,289,209,80,229900,88000,317900
421555,202107,16,15,1,16500,1100,17600
421560,202107,8,7,1,7700,1100,8800
421565,202107,117,76,41,83600,45100,128700
421567,202107,30,24,6,26400,6600,33000
421568,202107,45,40,5,44000,5500,49500
421569,202107,12,12,0,13200,0,13200
421570,202107,211,137,74,150700,81400,232100
421575,202107,25,22,3,24200,3300,27500
421580,202107,710,421,289,463172,317900,781072
421590,202107,21,20,1,22000,1100,23100
421600,202107,145,95,50,105600,55000,160600
421605,202107,110,75,35,82500,38500,121000
421610,202107,170,127,43,139700,47300,187000
421620,202107,1028,586,442,644600,486200,1130800
421625,202107,19,17,2,18700,2200,20900
421630,202107,326,199,127,220000,139700,359700
421635,202107,22,10,12,11000,13200,24200
421640,202107,100,82,18,90200,19800,110000
421650,202107,292,169,123,185900,135300,321200
421660,202107,2370,1426,944,1570800.82,1039500,2610300.82
421670,202107,174,125,49,137500,53900,191400
421680,202107,188,169,19,185900,20900,206800
421690,202107,344,241,103,265100,113300,378400
421700,202107,52,36,16,39600,17600,57200
421710,202107,25,24,1,26400,1100,27500
421715,202107,5,4,1,4400,1100,5500
421720,202107,620,426,194,468600,213400,682000
421725,202107,21,8,13,9900,14300,24200
421730,202107,27,20,7,22000,7700,29700
421740,202107,98,34,64,37400,70400,107800
421750,202107,199,145,54,159500,60500,220000
421755,202107,20,18,2,19800,2200,22000
421760,202107,101,66,35,72600,38500,111100
421770,202107,710,455,255,500500.33,280500,781000.33
421775,202107,29,18,11,19800,12100,31900
421780,202107,184,143,41,157300,45100,202400
421790,202107,145,123,22,135300,24200,159500
421795,202107,17,13,4,14300,4400,18700
421800,202107,543,336,207,369600,227700,597300
421810,202107,71,54,17,59400,18700,78100
421820,202107,300,190,110,209000,121000,330000
421825,202107,149,125,24,137500,26400,163900
421830,202107,145,89,56,97900,61600,159500
421835,202107,7,3,4,3300,4400,7700
421840,202107,47,41,6,45100,6600,51700
421850,202107,84,71,13,78100,14300,92400
421860,202107,44,31,13,34100,14300,48400
421870,202107,1041,765,276,841500,303600,1145100
421875,202107,52,43,9,47300,9900,57200
421880,202107,180,126,54,139700,59400,199100
421885,202107,24,18,6,19800,6600,26400
421890,202107,143,100,43,110000,47300.5,157300.5
421895,202107,46,41,5,45100,5500,50600
421900,202107,137,103,34,114400,37400,151800
421910,202107,61,37,24,40700,26400,67100
421915,202107,30,24,6,26400,6600,33000
421917,202107,36,26,10,28600,11000,39600
421920,202107,37,33,4,37400,4400,41800
421930,202107,631,497,134,546700,147400,694100
421935,202107,45,38,7,41800,7700,49500
421940,202107,50,42,8,46200,8800,55000
421950,202107,858,574,284,631400,312400,943800
421960,202107,40,35,5,38500,5500,44000
421970,202107,328,215,113,236500,124300,360800
421985,202107,19,12,7,13200,7700,20900
422000,202107,0,0,0,0,0,0
430003,202107,196,57,139,62700,152900,215600
430005,202107,35,26,9,28600,9900,38500
430010,202107,265,194,71,214500,78100,292600
430020,202107,149,99,50,108900,55000,163900
430030,202107,121,101,20,112200,22000,134200
430040,202107,2928,1719,1209,1892000,1331000,3223000
430045,202107,68,56,12,61600,13200,74800
430047,202107,6,5,1,5500,1100,6600
430050,202107,81,67,14,73700,15400,89100
430055,202107,11,10,1,11000,1100,12100
430057,202107,5,4,1,4400,1100,5500
430060,202107,3854,2213,1641,2435400,1810600,4246000
430063,202107,54,44,10,48400,11000,59400
430064,202107,157,123,34,135300,37400,172700
430066,202107,5,2,3,2200,3300,5500
430070,202107,40,29,11,31900,12100,44000
430080,202107,74,47,27,51700,29700,81400
430085,202107,28,11,17,12100,18700,30800
430087,202107,24,15,9,16500,9900,26400
430090,202107,67,58,9,63800,9900,73700
430100,202107,131,87,44,95700,48400,144100
430105,202107,153,85,68,93500,74800,168300
430107,202107,19,12,7,13200,7700,20900
430110,202107,492,265,227,291500,249700,541200
430120,202107,162,147,15,161700,16500,178200
430130,202107,786,473,313,520300,344300,864600
430140,202107,128,118,10,129800,11000,140800
430150,202107,106,66,40,72600,44000,116600
430155,202107,31,26,5,28600,5500,34100
430160,202107,3593,2053,1540,2259400,1696200,3955600
430163,202107,383,165,218,181500,240900,422400
430165,202107,30,20,10,23100,11000,34100
430170,202107,84,70,14,77000,15400,92400
430175,202107,73,56,17,61600,18700,80300
430180,202107,106,89,17,99000,18700,117700
430185,202107,26,17,9,18700,9900,28600
430187,202107,54,29,25,31900,28600,60500
430190,202107,233,122,111,134200,122100,256300
430192,202107,15,11,4,12100,4400,16500
430195,202107,18,12,6,13200,6600,19800
430200,202107,156,133,23,146300,25300,171600
430205,202107,20,20,0,22000,0,22000
430210,202107,704,535,169,589600,187000,776600
430215,202107,11,10,1,11000,1100,12100
430220,202107,71,47,24,51700,26400,78100
430222,202107,12,5,7,5500,7700,13200
430223,202107,15,9,6,9900,6600,16500
430225,202107,2,1,1,1100,1100,2200
430230,202107,321,193,128,212300,140800,353100
430235,202107,53,38,15,41800,16500,58300
430237,202107,24,18,6,19800,6600,26400
430240,202107,111,79,32,86900,35200,122100
430245,202107,74,58,16,63800,17600,81400
430250,202107,184,104,80,114400,88000,202400
430258,202107,8,7,1,7700,1100,8800
430260,202107,34,29,5,31900,5500,37400
430265,202107,34,29,5,31900,5500,37400
430270,202107,518,378,140,415800,154000,569800
430280,202107,1039,616,423,677600,465300,1142900
430290,202107,427,222,205,244200,225500,469700
430300,202107,2108,1141,967,1257300,1064800,2322100
430310,202107,2030,990,1040,1092300,1145100.7,2237400.7
430320,202107,55,46,9,50600,9900,60500
430330,202107,96,84,12,92400,13200,105600
430340,202107,69,55,14,60500,15400,75900
430350,202107,1638,1083,555,1191300,611600,1802900
430355,202107,19,18,1,19800,1100,20900
430360,202107,90,42,48,46200,52800,99000
430367,202107,35,26,9,28600,9900,38500
430370,202107,56,51,5,56100,5500,61600
430380,202107,122,93,29,102300,31900,134200
430390,202107,587,363,224,400400,246400,646800
430400,202107,263,188,75,206800,82500,289300
430410,202107,57,45,12,49500,13200,62700
430420,202107,505,315,190,348700,209000,557700
430430,202107,55,53,2,57567.4,2200,59767.4
430435,202107,143,107,36,117700,39600,157300
430440,202107,517,324,193,356400,213400,569800
430450,202107,1147,930,217,1024100,239800,1263900
430460,202107,5523,2832,2691,3117400.95,2963400.28,6080801.23
430461,202107,16,14,2,15400,2200,17600
430462,202107,4,2,2,2200,2200,4400
430463,202107,1127,601,526,662200,579700,1241900
430465,202107,24,13,11,14300,12100,26400
430466,202107,637,441,196,485100,215600,700700
430467,202107,114,63,51,69300,57200,126500
430468,202107,124,72,52,79200,57200,136400
430469,202107,21,16,5,17600,5500,23100
430470,202107,1141,624,517,687827.5,568700,1256527.5
430471,202107,63,38,25,41800,27500,69300
430480,202107,116,77,39,84700,42900,127600
430485,202107,8,8,0,8800,0,8800
430490,202107,74,58,16,63800,17600,81400
430495,202107,31,24,7,26400,7700,34100
430500,202107,190,130,60,144100,66000,210100
430510,202107,3585,2308,1277,2544300.67,1406900,3951200.67
430511,202107,16,16,0,17600,0,17600
430512,202107,144,97,47,107800,51700,159500
430513,202107,52,40,12,44000,13200,57200
430515,202107,24,23,1,26400,1100,27500
430517,202107,172,144,28,158400,30800,189200
430520,202107,336,237,99,261800,108900,370700
430530,202107,81,45,36,49500,39600,89100
430535,202107,444,295,149,324500,163900,488400
430537,202107,11,11,0,12100,0,12100
430540,202107,82,54,28,59400,30800,90200
430543,202107,372,114,258,125400,283800,409200
430544,202107,45,42,3,46200,3300,49500
430545,202107,373,172,201,189200,221100,410300
430550,202107,40,31,9,34100,9900,44000
430558,202107,1,1,0,1100,0,1100
430560,202107,56,31,25,34100,27500,61600
430570,202107,113,45,68,49500,74800,124300
430580,202107,127,101,26,111100,28600,139700
430583,202107,15,15,0,16500,0,16500
430585,202107,11,5,6,5500,6600,12100
430587,202107,13,8,5,8800,5500,14300
430590,202107,150,121,29,133100,31900,165000
430593,202107,2,2,0,2200,0,2200
430595,202107,18,14,4,15400,4400,19800
430597,202107,45,23,22,25300,24200,49500
430600,202107,217,164,53,180400,58300,238700
430605,202107,167,101,66,111100,72600,183700
430607,202107,29,24,5,26400,5500,31900
430610,202107,1723,797,926,876700,1019700,1896400
430613,202107,5,5,0,5500,0,5500
430620,202107,115,83,32,91300,35200,126500
430630,202107,47,39,8,42900,8800,51700
430632,202107,32,27,5,29700,5500,35200
430635,202107,38,33,5,36300,5500,41800
430637,202107,64,31,33,34100,36300,70400
430640,202107,178,96,82,105600,90200,195800
430642,202107,17,14,3,15400,3300,18700
430645,202107,30,25,5,27500,5500,33000
430650,202107,243,195,48,214500,52800,267300
430655,202107,5,3,2,3300,2200,5500
430660,202107,963,473,490,521400,540100,1061500
430670,202107,77,53,24,58300,26400,84700
430673,202107,75,46,29,50600,31900,82500
430675,202107,9,7,2,7700,2200,9900
430676,202107,559,328,231,360800,254100,614900
430680,202107,240,161,79,177100,86900,264000
430690,202107,524,321,203,353100,223300.63,576400.63
430692,202107,9,7,2,7700,2200,9900
430693,202107,141,87,54,95700,59400,155100
430695,202107,63,52,11,57200,12100,69300
430697,202107,62,37,25,40700,27500,68200
430700,202107,1448,978,470,1078000,517000.44,1595000.44
430705,202107,30,27,3,29700,3300,33000
430710,202107,253,156,97,171600,106700,278300
430720,202107,111,95,16,104500,17600,122100
430730,202107,141,121,20,133100,22000,155100
430740,202107,75,51,24,56100,26400,82500
430745,202107,29,22,7,24200,7700,31900
430750,202107,338,220,118,242000,129800,371800
430755,202107,88,47,41,52800,45100,97900
430760,202107,389,216,173,237600,191400,429000
430770,202107,1515,773,742,852500,816200,1668700
430780,202107,307,190,117,209000,128700,337700
430781,202107,25,22,3,24200,3300,27500
430783,202107,59,47,12,51700,13200,64900
430786,202107,6,4,2,4400,2200,6600
430790,202107,521,333,188,367400,206800,574200
430800,202107,156,124,32,136400.01,35200,171600.01
430805,202107,39,32,7,35200,7700,42900
430807,202107,61,34,27,37400,29700,67100
430810,202107,76,45,31,51700,34100,85800
430820,202107,146,88,58,96800,63800,160600
430825,202107,11,9,2,9900,2200,12100
430830,202107,247,229,18,251900,19800,271700
430840,202107,138,92,46,101200,50600,151800
430843,202107,7,5,2,5500,2200,7700
430845,202107,75,40,35,44000,38500,82500
430850,202107,586,418,168,459800,184800,644600
430860,202107,150,95,55,104500,60500,165000
430865,202107,78,41,37,45100,41800,86900
430870,202107,79,65,14,71500,15400,86900
430880,202107,150,108,42,118800,46200,165000
430885,202107,11,9,2,9900,2200,12100
430890,202107,337,205,132,225500,145200,370700
430900,202107,525,357,168,392700,184800,577500
430905,202107,122,52,70,57200,77000,134200
430910,202107,294,166,128,182600,140800,323400
430912,202107,4,4,0,4400,0,4400
430915,202107,36,33,3,36300,3300,39600
430920,202107,4417,2301,2116,2536600,2332000,4868600
430925,202107,5,4,1,4400,1100,5500
430930,202107,2052,1173,879,1291400,970200,2261600
430940,202107,259,167,92,183700,101200,284900
430950,202107,150,125,25,137500,27500,165000
430955,202107,26,14,12,15400,13200,28600
430957,202107,23,20,3,22000,3300,25300
430960,202107,245,159,86,174900,94600,269500
430965,202107,109,70,39,77000,42900,119900
430970,202107,94,75,19,82500,20900,103400
430975,202107,46,40,6,44000,6600,50600
430980,202107,46,29,17,31900,18700,50600
430990,202107,98,76,22,83710,24200,107910
430995,202107,113,105,8,115500,8800,124300
431000,202107,285,133,152,146300.6,167200,313500.6
431010,202107,346,193,153,212300,169400,381700
431020,202107,1873,1076,797,1184700,877800,2062500
431030,202107,37,29,8,31900,8800,40700
431033,202107,419,191,228,210100,250800,460900
431036,202107,12,7,5,7700,5500,13200
431040,202107,146,89,57,97900,62700,160600
431041,202107,39,24,15,26400,16500,42900
431043,202107,42,23,19,25300,20900,46200
431046,202107,12,9,3,9900,3300,13200
431050,202107,205,129,76,141900,83600,225500
431053,202107,66,38,28,41800,30800,72600
431055,202107,68,46,22,50600,24200,74800
431057,202107,18,18,0,19800,0,19800
431060,202107,1603,1036,567,1141800.4,623700,1765500.4
431065,202107,17,10,7,11000,7700,18700
431070,202107,63,58,5,63800,5500,69300
431075,202107,7,7,0,7700,0,7700
431080,202107,129,74,55,82500,60500,143000
431085,202107,33,30,3,33000,3300,36300
431087,202107,10,8,2,8800,2200,11000
431090,202107,53,40,13,45100,14300,59400
431100,202107,1231,722,509,796400,559900,1356300
431110,202107,220,133,87,147400,96800,244200
431112,202107,23,15,8,16500,8800,25300
431113,202107,31,23,8,25300,8800,34100
431115,202107,160,114,46,125400,50600,176000
431120,202107,606,348,258,382800,283800,666600
431123,202107,4,4,0,4400,0,4400
431125,202107,95,81,14,89100,15400,104500
431127,202107,8,5,3,5500,3300,8800
431130,202107,727,476,251,523600,276100,799700
431140,202107,782,543,239,597300,262900,860200
431142,202107,24,20,4,22000.55,4400,26400.55
431150,202107,194,144,50,158400,55000,213400
431160,202107,48,45,3,49500,3300,52800
431162,202107,3,3,0,3300,0,3300
431164,202107,5,5,0,5500,0,5500
431170,202107,115,85,30,93500,33000,126500
431171,202107,72,42,30,46200,33000,79200
431173,202107,1,1,0,1100,0,1100
431175,202107,201,101,100,111100,110000,221100
431177,202107,87,60,27,66000,29700,95700
431179,202107,16,12,4,13200,4400,17600
431180,202107,417,254,163,279400,179300,458700
431190,202107,75,55,20,60500,22000,82500
431198,202107,70,50,20,56100,22000,78100
431200,202107,22,18,4,19800,4400,24200
431205,202107,21,20,1,22000,1100,23100
431210,202107,100,63,37,69300,40700,110000
431213,202107,31,26,5,28600,5500,34100
431215,202107,22,19,3,20900,3300,24200
431217,202107,7,6,1,6600,1100,7700
431220,202107,68,58,10,63800,11000,74800
431225,202107,162,106,56,116600,61600,178200
431230,202107,96,83,13,91300,14300,105600
431235,202107,6,6,0,6600,0,6600
431237,202107,8,7,1,7700,1100,8800
431238,202107,12,9,3,9900,3300,13200
431240,202107,1044,637,407,701800,447700,1149500
431242,202107,38,37,1,40700,1100,41800
431244,202107,15,11,4,12100,4400,16500
431245,202107,52,38,14,41800,15400,57200
431247,202107,10,6,4,6600,4400,11000
431250,202107,286,141,145,155100,159500,314600
431260,202107,56,46,10,50600,11000,61600
431261,202107,17,11,6,12100,6600,18700
431262,202107,17,15,2,16500,2200,18700
431265,202107,155,83,72,91300,79200,170500
431267,202107,17,15,2,16500,2200,18700
431270,202107,326,256,70,281600,77000,358600
431275,202107,37,34,3,38500,3300,41800
431280,202107,20,16,4,17600,4400,22000
431290,202107,17,15,2,16500,2200,18700
431295,202107,2,1,1,1100,1100,2200
431300,202107,23,21,2,23100,2200,25300
431301,202107,5,5,0,5500,0,5500
431303,202107,62,39,23,42900,25300,68200
431306,202107,241,125,116,137304.2,127600,264904.2
431308,202107,8,5,3,5500,3300,8800
431310,202107,64,53,11,58300,12100,70400
431320,202107,162,92,70,101200,77000,178200
431330,202107,183,112,71,123200,78100,201300
431333,202107,28,22,6,24200,6600,30800
431335,202107,7,4,3,4400,3300,7700
431337,202107,384,170,214,188100,236500,424600
431339,202107,20,15,5,16500,5500,22000
431340,202107,3084,1657,1427,1822613.1,1570800,3393413.1
431342,202107,34,23,11,25300,12100,37400
431344,202107,17,17,0,18700,0,18700
431346,202107,4,4,0,4400,0,4400
431349,202107,36,32,4,35200,4400,39600
431350,202107,958,526,432,578600,475200,1053800
431360,202107,50,40,10,44000,11000,55000
431365,202107,347,148,199,162800,218900,381700
431370,202107,1212,692,520,762300,572000,1334300
431380,202107,97,86,11,94600,12100,106700
431390,202107,498,269,229,295900,253000,548900
431395,202107,320,133,187,146300,205700,352000
431400,202107,43,27,16,29700,17600,47300
431402,202107,107,75,32,82500,35200,117700
431403,202107,23,14,9,15400,9900,25300
431405,202107,698,382,316,421300,347600,768900
431406,202107,34,27,7,29700,7700,37400
431407,202107,55,44,11,48400,12100,60500
431410,202107,3396,2048,1348,2257200,1482800,3740000
431413,202107,15,12,3,13200,3300,16500
431415,202107,59,41,18,45100,19800,64900
431417,202107,25,12,13,13200,14300,27500
431420,202107,346,234,112,257400,123200,380600
431430,202107,56,27,29,29700,31900,61600
431440,202107,8880,6039,2841,6651700,3128450.6,9780150.6
431442,202107,29,14,15,15400,16500,31900
431445,202107,29,27,2,29700,2200,31900
431446,202107,5,4,1,4400,1100,5500
431447,202107,88,62,26,68200,28600,96800
431449,202107,51,43,8,47300,8800,56100
431450,202107,409,267,142,293700,156200,449900
431454,202107,13,7,6,7700,6600,14300
431455,202107,46,37,9,40700,9900,50600
431460,202107,496,337,159,370700,174900,545600
431470,202107,122,89,33,97900,36300,134200
431475,202107,11,9,2,11000,2200,13200
431477,202107,36,21,15,23100,16500,39600
431478,202107,10,9,1,9900,1100,11000
431480,202107,555,327,228,359700,250800,610500
431490,202107,28770,15912,12858,17529487.48,14159200,31688687.48
431500,202107,79,62,17,68200,18700,86900
431505,202107,27,17,10,18700,11000,29700
431507,202107,9,8,1,8800,1100,9900
431510,202107,239,173,66,190300,72600,262900
431513,202107,22,20,2,22000,2200,24200
431514,202107,4,3,1,3300,1100,4400
431515,202107,82,69,13,75900,14300,90200
431517,202107,6,3,3,3300,3300,6600
431520,202107,37,33,4,36300,4400,40700
431530,202107,1438,637,801,700700,881100,1581800
431531,202107,22,20,2,22000,2200,24200
431532,202107,39,29,10,31900,11000,42900
431535,202107,28,15,13,16500,14300,30800
431540,202107,143,119,24,130900,26400,157300
431545,202107,11,9,2,9900,2200,12100
431550,202107,360,192,168,212300,184800,397100
431555,202107,11,11,0,12100,0,12100
431560,202107,4611,3079,1532,3392400,1686300,5078700
431570,202107,825,427,398,469700,438900,908600
431575,202107,46,23,23,25300,25300,50600
431580,202107,91,60,31,66000,34100,100100
431590,202107,140,118,22,129800,24200,154000
431595,202107,19,16,3,17600,3300,20900
431600,202107,250,146,104,160600,114400,275000
431610,202107,115,84,31,92400,34100,126500
431620,202107,41,34,7,37400,7700,45100
431630,202107,128,104,24,114400,26400,140800
431640,202107,1338,834,504,918500,554400,1472900
431642,202107,37,34,3,37400,3300,40700
431643,202107,45,18,27,19800,29700,49500
431645,202107,310,180,130,198000,143000,341000
431647,202107,9,8,1,8800,1100,9900
431650,202107,37,23,14,25300,15400,40700
431660,202107,279,173,106,190300,116600,306900
431670,202107,232,104,128,114400,140800,255200
431673,202107,10,7,3,7700,3300,11000
431675,202107,24,19,5,20900,5500,26400
431680,202107,1122,825,297,908600,328900,1237500
431690,202107,4837,2868,1969,3160300.5,2169200,5329500.5
431695,202107,21,15,6,16500,6600,23100
431697,202107,1,0,1,0,1100,1100
431700,202107,186,137,49,150700,53900,204600
431710,202107,4063,1757,2306,1933800,2543200,4477000
431720,202107,1291,785,506,864050,556600,1420650
431725,202107,1,1,0,1100,0,1100
431730,202107,1151,768,383,844800,421300,1266100
431740,202107,1350,650,700,715000,771100,1486100
431750,202107,1833,1185,648,1304600.32,715000,2019600.32
431755,202107,6,5,1,5500,1100,6600
431760,202107,999,621,378,683100,418000,1101100
431770,202107,419,287,132,317900,145200,463100
431775,202107,27,20,7,22000,7700,29700
431780,202107,544,324,220,356400,242000,598400
431790,202107,157,119,38,132000,41800,173800
431795,202107,12,9,3,9900,3300,13200
431800,202107,3164,1636,1528,1800700.37,1680800,3481500.37
431805,202107,19,17,2,18700,2200,20900
431810,202107,603,390,213,430100,236500,666600
431820,202107,330,197,133,216700,146300,363000
431830,202107,2264,1356,908,1492700,1002100,2494800
431840,202107,476,310,166,342100,182600,524700
431842,202107,34,27,7,29700,7700,37400
431843,202107,11,8,3,8800,3300,12100
431844,202107,17,12,5,13200,5500,18700
431845,202107,26,24,2,26400,2200,28600
431846,202107,24,21,3,23100,3300,26400
431848,202107,11,9,2,9900,2200,12100
431849,202107,7,6,1,6600,1100,7700
431850,202107,762,602,160,662200,177100,839300
431860,202107,120,78,42,86900,46200,133100
431861,202107,7,3,4,3300,4400,7700
431862,202107,55,38,17,41800,18700,60500
431870,202107,3542,1989,1553,2190100,1710500,3900600
431880,202107,949,686,263,755700,289300,1045000
431890,202107,1288,751,537,827200,591800,1419000
431900,202107,181,122,59,135300,64900,200200
431910,202107,48,35,13,38500,14300,52800
431912,202107,46,28,18,30800,19800,50600
431915,202107,137,105,32,115500,35200,150700
431920,202107,154,111,43,122100,47300,169400
431930,202107,78,66,12,72600,13200,85800
431935,202107,2,2,0,2200,0,2200
431936,202107,3,3,0,3300,0,3300
431937,202107,20,15,5,16500,5500,22000
431940,202107,458,308,150,338800,165000,503800
431950,202107,483,307,176,337700,194700,532400
431960,202107,744,396,348,435600,382800,818400
431970,202107,70,64,6,70400,6600,77000
431971,202107,5,3,2,3300,2200,5500
431973,202107,18,15,3,16500,3300,19800
431975,202107,9,8,1,8800,1100,9900
431980,202107,209,125,84,138600,92400,231000
431990,202107,1110,578,532,637928.5,585200,1223128.5
432000,202107,1797,923,874,1016400,963600,1980000
432010,202107,268,185,83,204600,91300,295900
432020,202107,176,144,32,159500,35200,194700
432023,202107,15,12,3,13200,3300,16500
432026,202107,61,55,6,60500,6600,67100
432030,202107,65,30,35,33000,38500,71500
432032,202107,18,14,4,15400,4400,19800
432035,202107,56,43,13,47300,14300,61600
432040,202107,86,58,28,63800,30800,94600
432045,202107,2,2,0,2200,0,2200
432050,202107,83,51,32,56100,35200,91300
432055,202107,126,91,35,100100,38500,138600
432057,202107,7,5,2,5500,2200,7700
432060,202107,33,30,3,33000,3300,36300
432065,202107,31,28,3,30800,3300,34100
432067,202107,88,79,9,86900,11000,97900
432070,202107,385,298,87,328075,95700,423775
432080,202107,822,573,249,631400,275000,906400
432085,202107,9,5,4,5500,4400,9900
432090,202107,260,173,87,190300,95700,286000
432100,202107,168,107,61,117700,67100,184800
432110,202107,540,356,184,391600,202400,594000
432120,202107,984,553,431,608300,474100,1082400
432130,202107,489,346,143,380600,158400,539000
432132,202107,24,21,3,23100,3300,26400
432135,202107,78,63,15,70400,16500,86900
432140,202107,261,200,61,220000,67100,287100
432143,202107,216,130,86,143000,94600,237600
432145,202107,275,191,84,210100,92400,302500
432146,202107,13,12,1,13200,1100,14300
432147,202107,118,62,56,68200,61600,129800
432149,202107,15,9,6,9900,6600,16500
432150,202107,928,562,366,618200,402600,1020800
432160,202107,1575,797,778,877800.5,855800,1733600.5
432162,202107,4,2,2,2200,2200,4400
432163,202107,18,13,5,14300,5500,19800
432166,202107,126,92,34,101475,37400,138875
432170,202107,222,113,109,124300,119900,244200
432180,202107,548,339,209,372900,229900,602800
432183,202107,8,8,0,8800,0,8800
432185,202107,76,63,13,69300,14300,83600
432190,202107,495,290,205,319000,225500,544500
432195,202107,92,75,17,82500,18700,101200
432200,202107,403,248,155,272800,170500,443300
432210,202107,117,72,45,79200,49500,128700
432215,202107,35,31,4,34100,4400,38500
432218,202107,21,20,1,22000,1100,23100
432220,202107,651,336,315,369600,347600,717200
432225,202107,15,10,5,11000,5500,16500
432230,202107,128,83,45,91300,49500,140800
432232,202107,15,13,2,14300,2200,16500
432234,202107,4,2,2,2200,2200,4400
432235,202107,4,2,2,2200,2200,4400
432237,202107,23,15,8,16500,8800,25300
432240,202107,4363,2415,1948,2659800,2142800,4802600
432250,202107,1129,739,390,815100,430100,1245200
432252,202107,49,48,1,52800,1100,53900
432253,202107,60,48,12,52800,13200,66000
432254,202107,28,11,17,12100,18700,30800
432255,202107,13,11,2,12100,2200,14300
432260,202107,829,654,175,720500,193600,914100
432270,202107,227,170,57,187000,62700,249700
432280,202107,138,105,33,115500,36300,151800
432285,202107,1,1,0,1100,0,1100
432290,202107,64,55,9,60500,9900,70400
432300,202107,4756,2519,2237,2770828.5,2464000.61,5234829.11
432310,202107,130,107,23,117700,25300,143000
432320,202107,22,17,5,18700,5500,24200
432330,202107,16,10,6,11000,6600,17600
432335,202107,8,6,2,6600,2200,8800
432340,202107,37,31,6,34100,6600,40700
432345,202107,101,68,33,74800,36300,111100
432350,202107,19,18,1,19800,1100,20900
432360,202107,5,4,1,4400,1100,5500
432370,202107,25,24,1,26400,1100,27500
432375,202107,27,25,2,27500,2200,29700
432377,202107,7,7,0,7700,0,7700
432380,202107,175,75,100,83600,110000,193600
500020,202107,257,136,121,149600,133100,282700
500025,202107,141,69,72,75900,79200,155100
500060,202107,1458,909,549,999900,603900,1603800
500070,202107,752,356,396,391600,435600,827200
500080,202107,135,106,29,116600,31900,148500
500085,202107,136,108,28,118800,30800,149600
500090,202107,361,169,192,185900,212300,398200
500100,202107,715,376,339,413600,372900,786500
500110,202107,2241,1041,1200,1146200.9,1320000,2466200.9
500124,202107,267,146,121,161700,133100,294800
500150,202107,339,137,202,150700,222200,372900
500190,202107,529,353,176,388300,193600,581900
500200,202107,199,170,29,187000,31900,218900
500210,202107,1587,534,1053,588500,1158300,1746800
500215,202107,208,120,88,132000,96800,228800
500220,202107,724,463,261,509300.92,287100,796400.92
500230,202107,230,139,91,152900,100100,253000
500240,202107,648,438,210,485100,231000,716100
500260,202107,581,228,353,253000,388300,641300
500270,202107,29765,12691,17074,13977023.16,18797900.87,32774924.03
500280,202107,198,67,131,73700,145200,218900
500290,202107,1172,722,450,796400,496100,1292500
500295,202107,457,298,159,327800,174900,502700
500310,202107,92,29,63,31900,69300,101200
500315,202107,805,446,359,490600,394900,885500
500320,202107,3580,1737,1843,1911800.84,2028400,3940200.84
500325,202107,947,519,428,572000,471900,1043900
500330,202107,1489,691,798,761200,877800,1639000
500345,202107,308,230,78,253000,85800,338800
500348,202107,243,142,101,156200,111100,267300
500350,202107,112,56,56,61600,61600,123200
500370,202107,5688,2555,3133,2814900.05,3447400,6262300.05
500375,202107,339,234,105,257400,115500,372900
500380,202107,584,331,253,365200,278300,643500
500390,202107,71,34,37,37400,40700,78100
500400,202107,214,136,78,149600,85800,235400
500410,202107,525,221,304,244200,335500,579700
500430,202107,532,375,157,412500,172700,585200
500440,202107,207,110,97,121000,106700,227700
500450,202107,410,173,237,190300,261800,452100
500460,202107,269,144,125,158400,137500,295900
500470,202107,425,327,98,360800,108900,469700
500480,202107,100,60,40,66000,44000,110000
500490,202107,100,45,55,49500,60500,110000
500500,202107,1413,519,894,570900,984500,1555400
500510,202107,42,35,7,38500,7700,46200
500515,202107,99,70,29,77000,31900,108900
500520,202107,300,162,138,178200,151800,330000
500525,202107,92,50,42,55000,46200,101200
500540,202107,871,386,485,424600,534600,959200
500560,202107,935,519,416,570900,457600,1028500
500568,202107,979,542,437,596200,480700,1076900
500570,202107,1177,685,492,754600,541200,1295800
500580,202107,326,168,158,184800,173800,358600
500600,202107,335,165,170,181500,187000,368500
500620,202107,925,647,278,712800.5,305800,1018600.5
500625,202107,76,62,14,68200,15400,83600
500627,202107,18,9,9,9900,9900,19800
500630,202107,1565,885,680,973500.63,749100,1722600.63
500635,202107,529,320,209,352000.39,231000,583000.39
500640,202107,370,200,170,220000,187000,407000
500660,202107,5663,2058,3605,2269300,3969900,6239200
500690,202107,608,211,397,233200,436700,669900
500710,202107,398,195,203,214500,223300,437800
500720,202107,914,517,397,569800.3,436700,1006500.3
500730,202107,177,107,70,117700,77000,194700
500740,202107,885,358,527,393800,579700,973500
500750,202107,158,50,108,55000,118800,173800
500755,202107,117,88,29,96800,31900,128700
500769,202107,759,411,348,452100,383900,836000
500770,202107,424,232,192,255200,211200,466400
500780,202107,141,95,46,104500,50600,155100
500790,202107,1053,522,531,575300,585200,1160500
500793,202107,282,142,140,156200,154000,310200
500795,202107,166,109,57,119900,62700,182600
500797,202107,47,33,14,36300,15400,51700
500800,202107,430,192,238,212300,261800,474100
500830,202107,2195,1214,981,1336500,1083500,2420000
500840,202107,130,99,31,108900,34100,143000
510010,202107,169,89,80,97900,88000,185900
510020,202107,522,228,294,250800,324500,575300
510025,202107,1653,936,717,1029600.37,789800,1819400.37
510030,202107,673,338,335,371800.32,368500,740300.32
510035,202107,128,66,62,72600,68200,140800
510040,202107,400,182,218,200200,239800,440000
510050,202107,356,196,160,215600,176000.3,391600.3
510060,202107,120,59,61,64900,67100,132000
510080,202107,233,93,140,102300,154000,256300
510100,202107,68,28,40,30800,44000,74800
510120,202107,31,18,13,19800,14300,34100
510125,202107,376,229,147,253000,161700,414700
510130,202107,540,324,216,356400,237600,594000
510140,202107,432,135,297,148500,326700,475200
510160,202107,101,30,71,33000,78100,111100
510170,202107,758,462,296,508200.56,325600,833800.56
510180,202107,2904,1360,1544,1496000,1698400,3194400
510185,202107,21,11,10,12100,11000,23100
510190,202107,237,85,152,93500,167200,260700
510250,202107,2576,1540,1036,1696200,1139600.66,2835800.66
510260,202107,171,124,47,136400,51700,188100
510263,202107,455,252,203,279400,223300,502700
510267,202107,633,355,278,390500,305800,696300
510268,202107,63,28,35,30800,38500,69300
510269,202107,77,34,43,37400,47300,84700
510270,202107,389,192,197,211200,216700,427900
510279,202107,207,157,50,172700,55000,227700
510285,202107,180,72,108,79200,118800,198000
510300,202107,505,264,241,290400,266200,556600
510305,202107,198,87,111,95700,122100,217800
510310,202107,110,55,55,60500,60500,121000
510320,202107,830,525,305,579700,335500,915200
510325,202107,425,168,257,185900,282700,468600
510330,202107,425,235,190,259600,209000,468600
510335,202107,649,379,270,416900,297000,713900
510336,202107,54,38,16,41800,17600,59400
510337,202107,103,47,56,51700,61600,113300
510340,202107,17238,7693,9545,8470000.63,10508300,18978300.63
510343,202107,61,44,17,48400,18700,67100
510345,202107,154,96,58,105600,63800,169400
510350,202107,659,354,305,389400,335500,724900
510360,202107,208,130,78,143000,85800,228800
510370,202107,151,69,82,75900,90200,166100
510380,202107,82,62,20,68200,23100,91300
510385,202107,62,28,34,30800,37400,68200
510390,202107,108,47,61,51700,67100,118800
510395,202107,44,31,13,34100,14300,48400
510410,202107,713,456,257,503800,282700,786500
510420,202107,560,268,292,294800,321200,616000
510450,202107,48,23,25,25300,27500,52800
510452,202107,50,22,28,24200,30800,55000
510454,202107,52,23,29,25300,31900,57200
510455,202107,130,74,56,82500,61600,144100
510460,202107,179,81,98,89100,107800,196900
510480,202107,692,409,283,449900,311300,761200
510490,202107,338,166,172,182600,189200,371800
510500,202107,236,175,61,192500,67100,259600
510510,202107,785,461,324,507100,356400,863500
510515,202107,1238,638,600,704000,662200,1366200
510517,202107,261,118,143,129800,158400,288200
510520,202107,219,145,74,159500,81400,240900
510523,202107,104,81,23,89100,25300,114400
510525,202107,831,502,329,552200,363000,915200
510530,202107,22,15,7,16500,7700,24200
510550,202107,242,109,133,119900,146300,266200
510558,202107,290,142,148,156200,162800,319000
510560,202107,403,230,173,253000,190300,443300
510562,202107,630,459,171,506000,188100,694100
510590,202107,739,380,359,418000,394900,812900
510600,202107,218,111,107,122100,117700,239800
510610,202107,221,91,130,100100,143000,243100
510615,202107,192,91,101,100100,111100,211200
510617,202107,24,11,13,12100,14300,26400
510618,202107,119,57,62,62700,68200,130900
510619,202107,91,65,26,71500,28600,100100
510620,202107,160,91,69,100100,75900,176000
510621,202107,174,111,63,122100,69300,191400
510622,202107,472,277,195,304700,214500,519200
510623,202107,303,205,98,225500,107800,333300
510624,202107,89,49,40,53900,44000,97900
510625,202107,511,323,188,355300,207900.63,563200.63
510626,202107,112,65,47,71500,51700,123200
510627,202107,87,59,28,64900,30800,95700
510628,202107,156,93,63,102300,69300,171600
510629,202107,274,166,108,182600,118819.8,301419.8
510630,202107,437,217,220,238700,242000,480700
510631,202107,13,4,9,4400,9900,14300
510637,202107,345,196,149,215600,163900,379500
510642,202107,994,532,462,586300,510400,1096700
510645,202107,3,1,2,1100,2200,3300
510650,202107,1343,883,460,971300,506000,1477300
510665,202107,83,36,47,39600,51700,91300
510670,202107,58,32,26,35200,28600,63800
510675,202107,1128,720,408,796400,448800,1245200
510677,202107,342,176,166,193600,182600,376200
510680,202107,98,58,40,63800,44000,107800
510682,202107,203,103,100,113300,110000,223300
510685,202107,53,40,13,44000,14300,58300
510700,202107,562,318,244,349800,268400,618200
510704,202107,1180,610,570,672100,627000,1299100
510706,202107,145,75,70,82500,77000,159500
510710,202107,398,276,122,303600,134200,437800
510715,202107,58,41,17,45100,18700,63800
510718,202107,223,109,114,119900,125400,245300
510719,202107,44,17,27,18700,29700,48400
510720,202107,187,132,55,145200,60500,205700
510724,202107,84,33,51,36300,56100,92400
510726,202107,58,31,27,34100,29700,63800
510729,202107,53,22,31,24200,34100,58300
510730,202107,467,255,212,282700,233200,515900
510735,202107,111,44,67,48400,73700,122100
510740,202107,23,12,11,13200,12100,25300
510757,202107,24,19,5,20900,5500,26400
510760,202107,7084,3576,3508,3936900,3863200,7800100
510770,202107,672,314,358,346500,393800,740300
510774,202107,15,5,10,5500,11000,16500
510775,202107,113,85,28,93500,30800,124300
510776,202107,31,10,21,11000,23100,34100
510777,202107,199,86,113,94600,124300,218900
510779,202107,38,20,18,22000,19800,41800
510780,202107,264,147,117,162800,128700,291500
510785,202107,371,201,170,222200,187000,409200
510787,202107,182,86,96,94600,105600,200200
510788,202107,5,1,4,1100,4400,5500
510790,202107,2493,1303,1190,1434451,1310100,2744551
510792,202107,1128,633,495,696300,545600.54,1241900.54
510794,202107,111,63,48,69300,52800,122100
510795,202107,2239,1299,940,1430000.11,1035100,2465100.11
510800,202107,181,110,71,121000,78100,199100
510805,202107,196,129,67,141900,73700,215600
510810,202107,100,42,58,46200,63800,110000
510820,202107,234,116,118,127600,129800.5,257400.5
510830,202107,70,40,30,44000,33000,77000
510835,202107,14,9,5,9900,5500,15400
510840,202107,9025,4209,4816,4634300,5298700,9933000
510850,202107,215,90,125,99000,137500,236500
510860,202107,380,174,206,191400,227700,419100
510880,202107,71,50,21,55000,23100,78100
510885,202107,65,38,27,41800,29700,71500
510890,202107,60,35,25,38500,27500,66000
510895,202107,167,99,68,108900,74800,183700
520005,202107,132,55,77,60500,84700,145200
520010,202107,299,135,164,148500,180400,328900
520013,202107,728,484,244,533500,268400,801900
520015,202107,49,35,14,38500,15400,53900
520017,202107,87,51,36,56100,39600,95700
520020,202107,18,10,8,11000,8800,19800
520025,202107,2517,1306,1211,1436600,1334300,2770900
520030,202107,809,434,375,477675,412500,890175
520050,202107,68,48,20,52800,22000,74800
520055,202107,56,35,21,38500,23100,61600
520060,202107,180,117,63,128700,69300,198000
520080,202107,588,432,156,475200,171600,646800
520082,202107,16,11,5,12100,5500,17600
520085,202107,87,65,22,71500,24200,95700
520090,202107,89,62,27,68200,29700,97900
520110,202107,9185,3942,5243,4339500,5773900,10113400
520120,202107,12,6,6,6600,6600,13200
520130,202107,803,561,242,619300,266200.98,885500.98
520140,202107,11918,6620,5298,7294101.19,5832200,13126301.19
520145,202107,53,31,22,34100,24200,58300
520150,202107,161,129,32,141900,35200,177100
520160,202107,43,30,13,33000,14300,47300
520170,202107,242,136,106,149600,116600,266200
520180,202107,179,84,95,92400,104500,196900
520215,202107,204,139,65,152900,71500,224400
520235,202107,81,64,17,70400,18700,89100
520250,202107,123,70,53,77000,58300,135300
520260,202107,114,73,41,80300,45100,125400
520280,202107,43,29,14,31900,15400,47300
520310,202107,43,27,16,29700,17600,47300
520320,202107,173,108,65,118800,71500,190300
520330,202107,821,442,379,486200,416900,903100
520340,202107,362,213,149,234300,163900,398200
520350,202107,505,244,261,268400,287100,555500
520355,202107,86,47,39,51700,42900,94600
520357,202107,26,20,6,22000,6600,28600
520360,202107,3,2,1,2200,1100,3300
520380,202107,139,77,62,84700,68200,152900
520390,202107,248,104,144,114400,158400,272800
520393,202107,17,12,5,13200,5500,18700
520396,202107,74,50,24,55000,26400,81400
520400,202107,194,117,77,128700,84700,213400
520410,202107,190,95,95,104500,104500,209000
520420,202107,22,14,8,15400,8800,24200
520425,202107,276,139,137,152900,150700,303600
520430,202107,505,244,261,268501.2,287100,555601.2
520440,202107,679,489,190,537900,209000,746900
520450,202107,2019,863,1156,949300,1272700,2222000
520455,202107,60,34,26,37400,28600,66000
520460,202107,36,23,13,25300,14300,39600
520465,202107,31,25,6,27500,6600,34100
520470,202107,430,275,155,302500,170500,473000
520480,202107,80,47,33,51700,36300,88000
520485,202107,102,37,65,40700,71500,112200
520490,202107,408,310,98,342100,107800,449900
520495,202107,155,91,64,100100,70400,170500
520500,202107,193,151,42,166100,46200,212300
520505,202107,193,114,79,125400,86900,212300
520510,202107,1832,874,958,961400,1057100,2018500
520520,202107,49,34,15,37400,16500,53900
520530,202107,219,171,48,188100,52800,240900
520540,202107,606,409,197,449900,216700,666600
520545,202107,134,75,59,82500,64900,147400
520547,202107,58,34,24,37400,26400,63800
520549,202107,1287,590,697,650100,767800,1417900
520551,202107,313,166,147,182600,161700,344300
520552,202107,36,25,11,27500,12100,39600
520570,202107,15,9,6,9900,6600,16500
520580,202107,272,169,103,185900,113300,299200
520590,202107,136,79,57,86900,62700,149600
520620,202107,1126,522,604,574200,665500,1239700
520630,202107,41,24,17,26400,18700,45100
520640,202107,374,217,157,238700,172700,411400
520650,202107,67,35,32,38500,35200,73700
520660,202107,45,24,21,26400,23100,49500
520670,202107,40,32,8,35200,8800,44000
520680,202107,42,27,15,29700,16500,46200
520690,202107,39,10,29,11000,31900,42900
520710,202107,34,30,4,33000,4400,37400
520725,202107,197,146,51,160600,56100,216700
520735,202107,54,35,19,38500,20900,59400
520740,202107,437,214,223,235400,245300,480700
520750,202107,34,24,10,26400,11000,37400
520753,202107,67,44,23,48400,25300,73700
520760,202107,101,68,33,74800,36300,111100
520780,202107,269,206,63,226600,69300,295900
520790,202107,159,90,69,99000,75900,174900
520800,202107,3428,1881,1547,2070200,1706100,3776300
520810,202107,148,114,34,125400,37400,162800
520815,202107,5,4,1,4400,1100,5500
520830,202107,147,101,46,111100,50600,161700
520840,202107,378,244,134,268400,147400,415800
520850,202107,99,56,43,61600,47300,108900
520860,202107,1744,1117,627,1228700,690800,1919500
520870,202107,31683,14698,16985,16184300.75,18705500.05,34889800.80
520880,202107,1166,624,542,686400,597300,1283700
520890,202107,787,480,307,528000,337700,865700
520910,202107,984,526,458,579700.4,504900,1084600.4
520915,202107,91,70,21,78100,23100,101200
520920,202107,438,205,233,225500,256300,481800
520929,202107,18,16,2,17600,2200,19800
520940,202107,69,50,19,55000,20900,75900
520945,202107,14,10,4,11000,4400,15400
520960,202107,42,26,16,28600,17600,46200
520970,202107,364,216,148,237600,162800,400400
520980,202107,96,69,27,75900,29700,105600
520990,202107,446,316,130,347600,143000,490600
520993,202107,124,60,64,66000,70400,136400
520995,202107,252,139,113,152900,124300,277200
521000,202107,1557,894,663,985600,729300,1714900
521010,202107,681,343,338,377300,371800,749100
521015,202107,15,10,5,11000,5500,16500
521020,202107,1411,994,417,1094500,458700,1553200
521030,202107,57,36,21,39600,23100,62700
521040,202107,936,603,333,663300,366300,1029600
521056,202107,48,31,17,34100,18700,52800
521060,202107,125,81,44,89100,48400,137500
521080,202107,378,292,86,321200,94600,415800
521090,202107,555,360,195,396000,214500,610500
521100,202107,267,200,67,221100,73700,294800
521120,202107,1048,733,315,808500,346500,1155000
521130,202107,350,250,100,276100,111100,387200
521140,202107,181,100,81,110000,89100,199100
521150,202107,2591,1114,1477,1226500,1624700,2851200
521160,202107,26,12,14,13200,15400,28600
521170,202107,216,125,91,137500,100100,237600
521180,202107,1155,738,417,811800,458700,1270500
521190,202107,2498,1044,1454,1148400.9,1600500,2748900.9
521200,202107,54,40,14,44000,15400,59400
521205,202107,11,8,3,8800,3300,12100
521210,202107,120,73,47,80300,51700,132000
521220,202107,733,514,219,565400,240900,806300
521225,202107,26,19,7,20900,7700,28600
521230,202107,106,67,39,73700,42900,116600
521250,202107,6214,3509,2705,3861001.64,2976600,6837601.64
521260,202107,32,15,17,16500,18700,35200
521270,202107,134,102,32,112200,35200,147400
521280,202107,425,261,164,287100,180400,467500
521290,202107,27,17,10,18700,11000,29700
521295,202107,99,66,33,72600,36300,108900
521300,202107,223,122,101,134200,111100,245300
521305,202107,41,30,11,33000,12100,45100
521308,202107,1025,781,244,861300,268400,1129700
521310,202107,1335,759,576,834900,633600,1468500
521340,202107,20,16,4,17600,4400,22000
521350,202107,121,92,29,101200,31900,133100
521370,202107,172,123,49,135300,53900,189200
521375,202107,180,95,85,104500,93500,198000
521377,202107,52,40,12,44000,13200,57200
521380,202107,1045,648,397,712800,436700,1149500
521385,202107,13,8,5,8800,5500,14300
521390,202107,97,79,18,86900,19800,106700
521400,202107,346,233,113,256300,124300,380600
521405,202107,143,81,62,89100,68200,157300
521410,202107,70,50,20,55000,22000,77000
521440,202107,196,139,57,152900,62700,215600
521450,202107,762,421,341,463100,375100,838200
521460,202107,1116,725,391,798600,430100,1228700
521470,202107,11,8,3,8800,3300,12100
521480,202107,40,29,11,31900,12100,44000
521483,202107,315,198,117,217800,128700,346500
521486,202107,287,182,105,201300,115500,316800
521487,202107,25,11,14,12100,15400,27500
521490,202107,25,12,13,13200,14300,27500
521500,202107,127,69,58,75900,63800,139700
521520,202107,45,33,12,36300,13200,49500
521523,202107,805,477,328,524700,360800,885500
521525,202107,46,28,18,30800,19800,50600
521530,202107,237,128,109,140800,121000,261800
521540,202107,35,18,17,19800,18700,38500
521550,202107,92,40,52,44000,57200,101200
521560,202107,820,555,265,610500,291500,902000
521565,202107,64,46,18,50600,19800,70400
521570,202107,543,356,187,391600,205700,597300
521580,202107,56,32,24,35200,26400,61600
521590,202107,34,15,19,16500,20900,37400
521600,202107,25,12,13,13200,14300,27500
521630,202107,246,128,118,140800,129800,270600
521640,202107,301,166,135,182600,148500,331100
521645,202107,36,20,16,22000,17600,39600
521680,202107,248,153,95,168300,104500,272800
521690,202107,3,3,0,3300,0,3300
521710,202107,1128,541,587,595100,646800,1241900
521720,202107,551,380,171,418000,188100,606100
521730,202107,670,319,351,350900,386100,737000
521740,202107,880,377,503,414700,553300,968000
521760,202107,2125,1114,1011,1226572.45,1115400,2341972.45
521770,202107,816,509,307,559900,337700,897600
521800,202107,1965,1276,689,1404700,757900,2162600
521805,202107,31,17,14,18700,15400,34100
521810,202107,90,54,36,59400,39600,99000
521830,202107,970,687,283,756800.73,311300,1068100.73
521839,202107,84,51,33,56100,36300,92400
521850,202107,1106,568,538,624800.17,591800,1216600.17
521860,202107,333,210,123,231000,135300,366300
521870,202107,70,44,26,48400,28600,77000
521878,202107,37,16,21,17600,23100,40700
521880,202107,4752,2110,2642,2324300,2908400.3,5232700.3
521890,202107,591,410,181,451000.3,199100,650100.3
521900,202107,281,227,54,250800,59400,310200
521910,202107,166,115,51,126500,56100,182600
521920,202107,46,23,23,25300,25300,50600
521925,202107,56,33,23,36300,25300,61600
521930,202107,1157,643,514,707300,567600,1274900
521935,202107,34,23,11,25300,12100,37400
521940,202107,201,95,106,104500,116600,221100
521945,202107,17,13,4,14300,4400,18700
521950,202107,8,4,4,4400,4400,8800
521960,202107,69,52,17,57200,18700,75900
521970,202107,411,259,152,284900,167200,452100
521971,202107,106,56,50,61600,55000,116600
521973,202107,36,18,18,19800,19800,39600
521975,202107,1524,777,747,854700.75,822800.18,1677500.93
521980,202107,242,166,76,182600,83600,266200
521990,202107,74,54,20,59400,22000,81400
522000,202107,294,190,104,208616.1,115500,324116.1
522005,202107,18,10,8,11000,8800,19800
522010,202107,1124,634,490,697400,540100,1237500
522015,202107,59,35,24,38500,26400,64900
522020,202107,898,522,376,574200,414700,988900
522026,202107,24,16,8,17600,8800,26400
522028,202107,17,12,5,13200,5500,18700
522040,202107,754,312,442,343200,486200,829400
522045,202107,2448,1481,967,1632400,1064800,2697200
522050,202107,157,78,79,85800,86900,172700
522060,202107,553,348,205,382800,225500,608300
522068,202107,107,74,33,81400,36300,117700
522070,202107,10,10,0,11000,0,11000
522100,202107,34,20,14,22000,15400,37400
522108,202107,41,31,10,34100,11000,45100
522119,202107,57,33,24,36300,26400,62700
522130,202107,73,26,47,28600,52800,81400
522140,202107,4097,2123,1974,2336400,2171400,4507800
522145,202107,47,34,13,37400,14300,51700
522150,202107,98,70,28,77000,30800,107800
522155,202107,53,41,12,45100,13200,58300
522157,202107,5,3,2,3300,2200,5500
522160,202107,1671,988,683,1086800,752400,1839200
522170,202107,397,266,131,292600,144100,436700
522180,202107,36,16,20,17600,22000,39600
522185,202107,2158,887,1271,977900,1399200,2377100
522190,202107,54,30,24,33000,26400,59400
522200,202107,308,184,124,202400,136400,338800
522205,202107,145,98,47,107800,51700,159500
522220,202107,140,104,36,114400,39600,154000
522230,202107,29,23,6,25300,6600,31900
530010,202107,54213,27474,26739,30255833.85,29435076.85,59690910.70
110001,202108,506,411,95,452100,104500,556600
110002,202108,2838,1802,1036,1984400,1141800,3126200
110003,202108,80,66,14,72600,15400,88000
110004,202108,2019,1342,677,1478400,744700,2223100
110005,202108,428,340,88,374000,96800,470800
110006,202108,444,332,112,365200,123200,488400
110007,202108,70,57,13,62700,14300,77000
110008,202108,240,132,108,145200,118800,264000
110009,202108,921,688,233,757900,258500,1016400
110010,202108,1680,1011,669,1112100.19,737000,1849100.19
110011,202108,1716,1330,386,1466300,424600,1890900
110012,202108,4086,2388,1698,2629000,1867800,4496800
110013,202108,750,597,153,656700,168300,825000
110014,202108,362,318,44,351743.33,50600,402343.33
110015,202108,1371,1085,286,1193500,314600,1508100
110018,202108,1051,649,402,713900,443300,1157200
110020,202108,15730,8956,6774,9857102.29,7458000,17315102.29
110025,202108,636,466,170,514470,189200,703670
110026,202108,36,24,12,26400,13200,39600
110028,202108,1608,1147,461,1261700,507100,1768800
110029,202108,133,121,12,133100,13200,146300
110030,202108,2369,1589,780,1752124.55,859100.85,2611225.40
110032,202108,317,243,74,267300,81400,348700
110033,202108,651,469,182,515900,200200,716100
110034,202108,332,245,87,270600.5,95700,366300.5
110037,202108,92,80,12,88000,13200,101200
110040,202108,391,268,123,294800,135300,430100
110045,202108,929,642,287,706200,315700,1021900
110050,202108,88,77,11,84700,12100,96800
110060,202108,66,39,27,42900,29700,72600
110070,202108,106,66,40,72600,44000,116600
110080,202108,506,285,221,313500,243100,556600
110090,202108,23,20,3,22000,3300,25300
110092,202108,116,63,53,69300,58300,127600
110094,202108,193,139,54,152900,59400,212300
110100,202108,41,28,13,31900,14300,46200
110110,202108,98,56,42,61600,46200,107800
110120,202108,65,58,7,63800,7700,71500
110130,202108,278,224,54,246400.3,59400,305800.3
110140,202108,238,170,68,187000,74800,261800
110143,202108,52,42,10,46200,11000,57200
110145,202108,32,26,6,28600,6600,35200
110146,202108,22,11,11,12100,12100,24200
110147,202108,38,26,12,28600,13200,41800
110148,202108,36,26,10,28600,11000,39600
110149,202108,316,224,92,246400,101200,347600
110150,202108,135,102,33,112200,37400,149600
110155,202108,11,10,1,11000,1100,12100
110160,202108,67,53,14,58300,15400,73700
110170,202108,219,166,53,182600,58300,240900
110175,202108,63,49,14,53900,15400,69300
110180,202108,91,74,17,81400,18700,100100
120001,202108,190,141,49,155100.55,53900.55,209001.10
120005,202108,194,111,83,122100.41,91300,213400.41
120010,202108,1148,701,447,772200,491700,1263900
120013,202108,150,100,50,110000,55000,165000
120017,202108,112,62,50,68200,55000,123200
120020,202108,3521,2851,670,3137259.15,737010.45,3874269.60
120025,202108,548,305,243,335500.95,267300,602800.95
120030,202108,1056,908,148,999948.1,162808.25,1162756.35
120032,202108,37,33,4,36300,4400,40700
120033,202108,221,194,27,214506.6,29700.55,244207.15
120034,202108,174,126,48,138600,52800,191400
120035,202108,37,31,6,34100,6600,40700
120038,202108,418,271,147,298103.83,161701.1,459804.93
120039,202108,29,28,1,31901.65,1100,33001.65
120040,202108,13969,9476,4493,10428173.6,4944825.6,15372999.2
120042,202108,42,37,5,40700,5500.55,46200.55
120043,202108,13,3,10,3300,11000,14300
120045,202108,533,339,194,372901.1,214501.65,587402.75
120050,202108,1268,969,299,1071453.9,328912.1,1400366.0
120060,202108,1456,1201,255,1321154.45,280506.6,1601661.05
120070,202108,409,298,111,327801.15,122100,449901.15
120080,202108,179,111,68,122100.55,74800.55,196901.10
130002,202108,159,114,45,125400,49500,174900
130006,202108,101,64,37,70400,40700,111100
130008,202108,127,69,58,75900,63800,139700
130010,202108,158,96,62,105600,68200,173800
130014,202108,273,195,78,215600,85800,301400
130020,202108,101,62,39,68200,42900,111100
130030,202108,955,555,400,610500,441100,1051600
130040,202108,354,171,183,188100,201300,389400
130050,202108,548,281,267,310200,293700,603900
130060,202108,827,563,264,620400,291500,911900
130063,202108,622,373,249,410300,273900,684200
130068,202108,196,120,76,132000,84700,216700
130070,202108,1338,905,433,995500,476300,1471800
130080,202108,703,467,236,513700,260700,774400
130083,202108,68,38,30,41800,33000,74800
130090,202108,341,191,150,210100,165000,375100
130100,202108,1211,558,653,613800,718300,1332100
130110,202108,727,320,407,353100,451000,804100
130115,202108,147,66,81,72600,89100,161700
130120,202108,1618,1010,608,1111000,671000,1782000
130130,202108,617,422,195,464200,214500,678700
130140,202108,1571,1223,348,1345300,383900,1729200
130150,202108,408,361,47,397100,51700,448800
130160,202108,442,257,185,282700,203500,486200
130165,202108,45,34,11,37400,12100,49500
130170,202108,1017,712,305,783129.6,335500.9,1118630.5
130180,202108,247,180,67,198000,73700,271700
130185,202108,2208,1012,1196,1113200,1316700,2429900
130190,202108,3392,2136,1256,2352900,1382700,3735600
130195,202108,287,228,59,251900,64900,316800
130200,202108,180,86,94,94600,103400,198000
130210,202108,93,49,44,53900,48400,102300
130220,202108,197,140,57,155100,62700,217800
130230,202108,376,241,135,265100,149600,414700
130240,202108,1331,862,469,948200,515900,1464100
130250,202108,4709,3031,1678,3334100,1848000,5182100
130255,202108,416,203,213,223300,235400,458700
130260,202108,58261,27522,30739,30302711.79,33852731.41,64155443.20
130270,202108,1536,1042,494,1146299,543400,1689699
130280,202108,132,76,56,83600,61600,145200
130290,202108,2095,1426,669,1569700,738100,2307800
130300,202108,425,291,134,320100,147400,467500
130310,202108,912,491,421,540100,464200,1004300
130320,202108,530,278,252,308000,277200.55,585200.55
130330,202108,774,491,283,540100,311300,851400
130340,202108,3406,1930,1476,2123000,1626900,3749900
130350,202108,484,331,153,364100,168300,532400
130353,202108,927,410,517,451000,569800,1020800
130356,202108,794,353,441,388300,487300,875600
130360,202108,87,65,22,71500,24200,95700
130370,202108,695,535,160,588500,176000,764500
130380,202108,665,513,152,565400,167200,732600
130390,202108,462,377,85,414700,93500,508200
130395,202108,160,42,118,46200,129800,176000
130400,202108,70,47,23,51700,25300,77000
130406,202108,2069,1219,850,1340900,935000,2275900
130410,202108,458,228,230,250800,253000,503800
130420,202108,2843,2305,538,2536600,591800,3128400
130423,202108,154,78,76,85800,83600,169400
130426,202108,168,87,81,95700,89100,184800
130430,202108,412,245,167,269500,184800,454300
130440,202108,200,62,138,68200,151800,220000
140002,202108,23,5,18,5500,19800,25300
140005,202108,208,127,81,139700,91300,231000
140010,202108,11154,6940,4214,7642803.51,4640900.91,12283704.42
140015,202108,146,65,81,71500,89100,160600
140017,202108,125,71,54,78100,59400,137500
140020,202108,461,299,162,328900,178200,507100
140023,202108,39,19,20,20900,22000,42900
140028,202108,21,11,10,12100,11000,23100
140030,202108,354,237,117,262900,128700,391600
140040,202108,63,44,19,48400,20900,69300
140045,202108,275,105,170,115500,187000,302500
140047,202108,438,292,146,322300,160600,482900
140050,202108,145,89,56,97900,61600,159500
140060,202108,63,41,22,45100,24200,69300
140070,202108,31,29,2,31900,2200,34100
150010,202108,4886,2953,1933,3249400,2128500,5377900
150013,202108,164,117,47,128700,51700,180400
150020,202108,1111,604,507,665500,558800,1224300
150030,202108,711,318,393,349800.02,432300,782100.02
150034,202108,204,127,77,139700,84700,224400
150040,202108,1530,872,658,959200,723800,1683000
150050,202108,688,394,294,433400,323400,756800
150060,202108,4912,3055,1857,3360407,2043155.4,5403562.4
150070,202108,436,226,210,248600.52,231000,479600.52
150080,202108,16005,7521,8484,8277500,9333500.18,17611000.18
150085,202108,424,270,154,297000,169400,466400
150090,202108,702,593,109,652300,119900,772200
150095,202108,374,240,134,264000,147400,411400
150100,202108,64,42,22,46200,24200,70400
150110,202108,212,119,93,130900,102300,233200
150120,202108,388,282,106,310200,116600,426800
150125,202108,50,18,32,19800,35200,55000
150130,202108,2108,1081,1027,1189100,1129700,2318800
150140,202108,56784,25221,31563,27751901.19,34728100.7,62480001.89
150145,202108,235,130,105,143000,116600,259600
150150,202108,3186,1395,1791,1536700,1970100,3506800
150157,202108,377,265,112,291500,124300,415800
150160,202108,129,97,32,106700,35200,141900
150170,202108,3706,2724,982,2998600,1082400,4081000
150172,202108,344,244,100,268400,110000,378400
150175,202108,86,50,36,55000,39600,94600
150178,202108,766,507,259,557700,284900,842600
150180,202108,3202,1555,1647,1712700,1811700,3524400
150190,202108,364,235,129,258500,141900,400400
150195,202108,114,59,55,64900,60500,125400
150200,202108,195,93,102,102300,112200,214500
150210,202108,3214,2547,667,2801700,733700,3535400
150215,202108,587,369,218,405900,239800,645700
150220,202108,3561,2363,1198,2599300.82,1317800,3917100.82
150230,202108,1275,1006,269,1107700.5,295900,1403600.5
150240,202108,6663,3753,2910,4129400.6,3205400,7334800.6
150250,202108,69,38,31,41800.02,34100,75900.02
150260,202108,99,65,34,71500,37400,108900
150270,202108,2205,1422,783,1565300,862400,2427700
150275,202108,539,336,203,369600,223300,592900
150276,202108,114,42,72,46200,79200,125400
150277,202108,800,359,441,394900,485100,880000
150280,202108,374,254,120,279400,132000,411400
150285,202108,124,60,64,66000,70224,136224
150290,202108,1161,669,492,735900,541200,1277100
150293,202108,729,333,396,366300,435600,801900
150295,202108,531,244,287,268400,315700,584100
150300,202108,90,41,49,45100,53900,99000
150304,202108,181,107,74,117700,81400,199100
150307,202108,413,341,72,375100,79200,454300
150309,202108,580,406,174,446600,191400.48,638000.48
150310,202108,254,165,89,181500,97900,279400
150320,202108,1882,1312,570,1443200.5,627000,2070200.5
150330,202108,2073,1198,875,1318900,963600,2282500
150340,202108,199,131,68,144100,74800,218900
150345,202108,641,359,282,396000,311300,707300
150350,202108,402,320,82,352000,90200,442200
150360,202108,4749,2892,1857,3182300,2043800,5226100
150370,202108,836,570,266,627000,293700,920700
150375,202108,200,93,107,102300,117700,220000
150380,202108,1513,1005,508,1105500,559900,1665400
150390,202108,841,487,354,535700,390500,926200
150400,202108,113,93,20,102300,22000,124300
150405,202108,1243,780,463,858000,510400,1368400
150410,202108,123,76,47,83600,51700,135300
150420,202108,7569,4070,3499,4480479.3,3853300,8333779.3
150430,202108,626,389,237,427900,260700,688600
150440,202108,460,284,176,312400,193600,506000
150442,202108,2342,1250,1092,1375000,1201200,2576200
150445,202108,550,356,194,391600,213400,605000
150450,202108,226,125,101,137500,111100,248600
150460,202108,731,543,188,597300,206800,804100
150470,202108,1291,778,513,855800,564300,1420100
150475,202108,246,184,62,202400,68200,270600
150480,202108,1360,939,421,1034000,463100,1497100
150490,202108,658,390,268,429000,294800,723800
150495,202108,337,252,85,277200,93500,370700
150497,202108,288,199,89,218900,97900,316800
150500,202108,243,147,96,161700,105600,267300
150503,202108,1108,568,540,625900,594000,1219900
150506,202108,927,626,301,688600,331100,1019700
150510,202108,1284,698,586,768900,645700,1414600
150520,202108,318,218,100,239800,110000,349800
150530,202108,1783,982,801,1080200,881100,1961300
150540,202108,200,146,54,160600,59400,220000
150543,202108,838,425,413,467500,454300,921800
150548,202108,469,336,133,370700,147400,518100
150549,202108,69,44,25,48400,27500,75900
150550,202108,3023,1520,1503,1672000,1654400,3326400
150553,202108,3405,1901,1504,2093300,1658800,3752100
150555,202108,147,78,69,85800,75900,161700
150560,202108,43,19,24,20900,26400,47300
150563,202108,127,64,63,70400,69300,139700
150565,202108,201,125,76,138600,83600,222200
150570,202108,439,288,151,316800,166100,482900
150580,202108,1710,821,889,903100,977900,1881000
150590,202108,829,540,289,594000,317900,911900
150600,202108,511,301,210,331100,232100,563200
150610,202108,149,119,30,130900,33000,163900
150611,202108,124,82,42,90200,46200,136400
150613,202108,3308,1893,1415,2082300,1557600,3639900
150616,202108,550,305,245,335500,269500,605000
150618,202108,1380,709,671,779900,738100,1518000
150619,202108,404,304,100,335500,110000,445500
150620,202108,1249,720,529,792000,581900,1373900
150630,202108,336,213,123,234300,135300,369600
150635,202108,456,193,263,212300,289300,501600
150640,202108,46,24,22,26400,24200,50600
150650,202108,2434,1397,1037,1536700,1140700,2677400
150655,202108,249,180,69,198000,75900,273900
150658,202108,88,53,35,58300,38500,96800
150660,202108,554,357,197,392700,216700,609400
150670,202108,1131,398,733,437800,806300,1244100
150680,202108,10523,5485,5038,6036800.57,5544000,11580800.57
150690,202108,25,13,12,14300,13200,27500
150700,202108,502,324,178,356400,195800,552200
150710,202108,295,169,126,185900,138600,324500
150715,202108,844,528,316,580800,347600,928400
150720,202108,425,323,102,355300,112200,467500
150730,202108,1065,522,543,574200,597300,1171500
150740,202108,234,154,80,169400,88000,257400
150745,202108,757,420,337,462000,370700,832700
150746,202108,67,36,31,39600,34100,73700
150747,202108,229,171,58,188100,63800,251900
150750,202108,142,79,63,86900,69300,156200
150760,202108,1827,1179,648,1296900.5,713900,2010800.5
150770,202108,396,223,173,245300,190300,435600
150775,202108,107,52,55,57200,60500,117700
150780,202108,195,109,86,119900,95700,215600
150790,202108,896,510,386,561000,425700,986700
150795,202108,1600,958,642,1053800,706200,1760000
150796,202108,346,195,151,214500,166100,380600
150797,202108,363,173,190,190300,209000,399300
150800,202108,1546,875,671,962500,738100,1700600
150803,202108,534,427,107,469700,117700,587400
150805,202108,213,124,89,136400,97900,234300
150808,202108,1026,539,487,594000,535700,1129700
150810,202108,3235,2184,1051,2402400.52,1158300,3560700.52
150812,202108,480,249,231,273900,254100,528000
150815,202108,1104,683,421,752400,463100,1215500
150820,202108,1544,933,611,1026300,672100,1698400
150830,202108,714,522,192,574200,211200,785400
150835,202108,214,124,90,136400,100100,236500
150840,202108,1384,835,549,918500,603900,1522400
160005,202108,61,42,19,46200.08,20900.04,67100.12
160010,202108,198,125,73,137500.14,81400.08,218900.22
160015,202108,141,86,55,95700.08,60500,156200.08
160020,202108,141,76,65,83600.04,71500,155100.04
160021,202108,69,29,40,31900.04,44000.04,75900.08
160023,202108,67,43,24,47300.08,26400.04,73700.12
160025,202108,27,13,14,14300.04,15400.04,29700.08
160027,202108,1478,839,639,924001.96,702900.98,1626902.94
160030,202108,16471,8431,8040,9281815.79,8852810.32,18134626.11
160040,202108,302,177,125,194700.12,137500.02,332200.14
160050,202108,744,366,378,402600.2,415800.04,818400.24
160053,202108,288,172,116,189200.24,127600.14,316800.38
160055,202108,23,14,9,15400.02,9900.02,25300.04
160060,202108,6670,3542,3128,3896210.49,3441906.8,7338117.29
160070,202108,189,114,75,125400.02,82500.02,207900.04
160080,202108,119,60,59,66000,64900,130900
170025,202108,29,15,14,16500,15400,31900
170030,202108,195,159,36,174900.03,39600,214500.03
170035,202108,204,98,106,107800,117700,225500
170040,202108,177,130,47,143000,51700,194700
170070,202108,320,200,120,220000,132000,352000
170100,202108,352,258,94,283800,103400,387200
170105,202108,51,43,8,47300,8800,56100
170110,202108,117,69,48,75900,52800,128700
170130,202108,73,37,36,40700,39600,80300
170190,202108,94,57,37,62700,40700,103400
170200,202108,350,240,110,264000,121000,385000
170210,202108,6307,3326,2981,3661634.25,3281300.8,6942935.05
170215,202108,128,64,64,70400,70400,140800
170220,202108,1373,1005,368,1105500,405900,1511400
170230,202108,145,93,52,102300,57200,159500
170240,202108,508,340,168,374000,184800,558800
170255,202108,1055,858,197,943800,216700,1160500
170270,202108,47,32,15,35200,16500,51700
170290,202108,122,78,44,85800,48400,134200
170300,202108,103,64,39,70400,42900,113300
170305,202108,46,35,11,38500,12100,50600
170307,202108,58,44,14,48400,15400,63800
170310,202108,123,67,56,73700,62700,136400
170320,202108,29,16,13,17600,14300,31900
170330,202108,31,24,7,26400,7700,34100
170360,202108,31,18,13,19800,14300,34100
170370,202108,94,45,49,49500,53900,103400
170380,202108,77,59,18,64900,19800,84700
170382,202108,36,31,5,34100,5500,39600
170384,202108,142,109,33,119900,36300,156200
170386,202108,67,28,39,30800,42900,73700
170388,202108,47,19,28,20900,30800,51700
170389,202108,25,21,4,23100,4400,27500
170390,202108,72,42,30,46200,33000,79200
170410,202108,24,22,2,24200,2200,26400
170460,202108,16,10,6,11000,6600,17600
170510,202108,36,28,8,30800,8800,39600
170550,202108,1552,897,655,987800,720500,1708300
170555,202108,108,79,29,86900,31900,118800
170560,202108,105,75,30,82500,33000,115500
170600,202108,41,13,28,14300,30800,45100
170610,202108,192,101,91,111100,100100,211200
170625,202108,39,24,15,26400,16500,42900
170650,202108,93,68,25,74800,27500,102300
170700,202108,575,425,150,469700,165000,634700
170710,202108,155,98,57,107800,62700,170500
170720,202108,97,77,20,84700,22000,106700
170730,202108,94,55,39,60500,42900,103400
170740,202108,87,61,26,67100,28600,95700
170755,202108,56,30,26,33000,28600,61600
170765,202108,138,72,66,79200,72600,151800
170770,202108,194,125,69,138600,75900,214500
170820,202108,600,397,203,438900,224400,663300
170825,202108,39,20,19,22000,20900,42900
170830,202108,87,69,18,75900,19800,95700
170900,202108,172,132,40,145200,44000,189200
170930,202108,929,505,424,555500,466400,1021900
170950,202108,3160,1456,1704,1606000,1876600.4,3482600.4
170980,202108,18,12,6,13200,6600,19800
171050,202108,150,114,36,125400,39600,165000
171070,202108,49,41,8,45100,8800,53900
171090,202108,48,35,13,38500,14300,52800
171110,202108,24,18,6,19800,6600,26400
171150,202108,42,23,19,25300,20900,46200
171180,202108,28,13,15,14300,16500,30800
171190,202108,165,97,68,106700,74800,181500
171195,202108,62,51,11,56100,12100,68200
171200,202108,44,21,23,23100,25300,48400
171215,202108,7,5,2,5500,2200,7700
171240,202108,60,44,16,48400,17600,66000
171245,202108,57,49,8,53900,8800,62700
171250,202108,74,42,32,46200,35200,81400
171270,202108,15,11,4,12100,4400,16500
171280,202108,42,36,6,39600,6600,46200
171320,202108,995,564,431,621500,474100,1095600
171330,202108,417,210,207,231000,227700,458700
171360,202108,93,64,29,70400,31900,102300
171370,202108,35,17,18,18700,19800,38500
171380,202108,133,115,18,126500,19800,146300
171395,202108,48,28,20,30800,22000,52800
171420,202108,265,172,93,189200,102300,291500
171430,202108,71,57,14,62700,15400,78100
171488,202108,202,109,93,119900,102300,222200
171500,202108,66,36,30,39600,33000,72600
171510,202108,72,48,24,52800,26400,79200
171515,202108,40,32,8,35200,8800,44000
171525,202108,27,25,2,27500,2200,29700
171550,202108,15,9,6,9900,6600,16500
171570,202108,50,25,25,27500,27500,55000
171575,202108,283,185,98,203500,107800,311300
171610,202108,1754,885,869,974600,955900.34,1930500.34
171620,202108,145,99,46,108900,50600,159500
171630,202108,55,30,25,33000,28600,61600
171650,202108,323,223,100,245300,110000,355300
171660,202108,261,150,111,166100,122100,288200
171665,202108,73,45,28,49500,30800,80300
171670,202108,425,260,165,286000,181500,467500
171700,202108,64,56,8,61600,8800,70400
171720,202108,30,11,19,12100,20900,33000
171750,202108,109,55,54,60500,59400,119900
171780,202108,75,57,18,62700,19800,82500
171790,202108,84,69,15,75900,16500,92400
171800,202108,32,24,8,26400,8800,35200
171820,202108,2068,1197,871,1316700.7,960300,2277000.7
171830,202108,35,25,10,27500,11000,38500
171840,202108,63,41,22,45100,24200,69300
171845,202108,29,19,10,20900,11000,31900
171850,202108,38,32,6,35200,6600,41800
171855,202108,79,62,17,68200,18700,86900
171865,202108,7,6,1,6600,1100,7700
171870,202108,32,19,13,20900,14300,35200
171875,202108,82,59,23,64900,25300,90200
171880,202108,37,23,14,25300,15400,40700
171884,202108,49,28,21,30800,23100,53900
171886,202108,130,59,71,64900,78100,143000
171888,202108,25,19,6,20900,6600,27500
171889,202108,12,6,6,6600,6600,13200
171890,202108,55,46,9,50600,9900,60500
171900,202108,32,22,10,24200,11000,35200
172000,202108,38,31,7,34100,7700,41800
172010,202108,54,44,10,48400,11000,59400
172015,202108,23,16,7,17600,7700,25300
172020,202108,146,91,55,100100,60500,160600
172025,202108,38,25,13,27500,14300,41800
172030,202108,46,25,21,27500,23100,50600
172049,202108,85,55,30,60500,33000,93500
172065,202108,130,84,46,92400,50600,143000
172080,202108,108,68,40,74800,44000,118800
172085,202108,28,14,14,15400,15400,30800
172090,202108,432,321,111,353100.56,122100,475200.56
172093,202108,16,13,3,14300,3300,17600
172097,202108,19,11,8,12100,8800,20900
172100,202108,5316,2987,2329,3289000,2565200,5854200
172110,202108,80,51,29,56100,31900,88000
172120,202108,1725,1444,281,1589500,309100,1898600
172125,202108,13,11,2,12100,2200,14300
172130,202108,24,13,11,14300,12100,26400
172208,202108,206,122,84,134200,92400,226600
172210,202108,371,184,187,202400,205700,408100
210005,202108,2933,1841,1092,2028400.32,1201200,3229600.32
210010,202108,150,87,63,95700,69300,165000
210015,202108,39,29,10,31900,11000,42900
210020,202108,363,209,154,229900,169400,399300
210030,202108,319,212,107,234300,117700,352000
210040,202108,138,110,28,121000,30800,151800
210043,202108,252,200,52,220000,57200,277200
210047,202108,514,313,201,346500,222200,568700
210050,202108,282,211,71,232100,78100,310200
210055,202108,49,41,8,45100,8800,53900
210060,202108,539,436,103,479600,113300,592900
210070,202108,430,329,101,361900,111100,473000
210080,202108,131,120,11,132000,12100,144100
210083,202108,293,142,151,156200,166100,322300
210087,202108,2,1,1,1100,1100,2200
210090,202108,439,316,123,347600,135300,482900
210095,202108,423,324,99,356400,110000,466400
210100,202108,698,552,146,607200,160600,767800
210110,202108,120,78,42,85800,46200,132000
210120,202108,4948,3905,1043,4298800,1147300,5446100
210125,202108,183,111,72,122100,79200,201300
210130,202108,464,269,195,295900,214500,510400
210135,202108,28,22,6,24200,6600,30800
210140,202108,4391,3409,982,3752100,1082400,4834500
210150,202108,365,233,132,256300,145200,401500
210160,202108,3257,2784,473,3063500.54,520300,3583800.54
210170,202108,1194,963,231,1059300,254100,1313400
210173,202108,126,110,16,121000,17600,138600
210177,202108,339,194,145,213400,159500,372900
210180,202108,29,16,13,17600,14300,31900
210190,202108,436,288,148,316800,162800,479600
210193,202108,5,4,1,4400,1100,5500
210197,202108,75,55,20,60500,22000,82500
210200,202108,616,523,93,575300,102300,677600
210203,202108,215,150,65,165000,71500,236500
210207,202108,355,295,60,324500,66000,390500
210210,202108,729,672,57,739200,62700,801900
210215,202108,72,62,10,68200,11000,79200
210220,202108,378,318,60,349800,66000,415800
210230,202108,310,248,62,272800,68200,341000
210232,202108,1306,911,395,1002100,435600,1437700
210235,202108,176,134,42,147400,46200,193600
210237,202108,37,21,16,23100,17600,40700
210240,202108,83,69,14,75900,15400,91300
210250,202108,177,151,26,166100,28600,194700
210255,202108,363,277,86,304700,95700,400400
210260,202108,388,271,117,298100,128700,426800
210270,202108,638,434,204,478500,224400,702900
210275,202108,82,62,20,68200,22000,90200
210280,202108,1046,689,357,757900,392700,1150600
210290,202108,534,365,169,401500,185900,587400
210300,202108,5171,3295,1876,3625600.98,2064700,5690300.98
210310,202108,105,75,30,82500,33000,115500
210312,202108,119,83,36,91300,39600,130900
210315,202108,104,88,16,96800,17600,114400
210317,202108,136,102,34,112200,37400,149600
210320,202108,2308,1982,326,2180200,358600,2538800
210325,202108,140,86,54,94600,59400,154000
210330,202108,4378,2552,1826,2808300.88,2010800,4819100.88
210340,202108,1218,925,293,1017500,324500,1342000
210350,202108,656,546,110,600600,121000,721600
210355,202108,150,129,21,141900,23100,165000
210360,202108,2149,1513,636,1664300,699600,2363900
210370,202108,1227,617,610,678700,671000,1349700
210375,202108,192,98,94,107800,103400,211200
210380,202108,718,557,161,613800,177100,790900
210390,202108,192,163,29,179300,31900,211200
210400,202108,389,339,50,372900,55000,427900
210405,202108,997,709,288,781000,316800,1097800
210407,202108,60,47,13,51700,14300,66000
210408,202108,61,55,6,60500,6600,67100
210409,202108,329,289,40,317900,44000,361900
210410,202108,441,348,93,383900,102300,486200
210420,202108,200,165,35,182600,38500,221100
210430,202108,50,35,15,38500,16500,55000
210440,202108,369,251,118,276100,129800,405900
210450,202108,100,83,17,91300,18700,110000
210455,202108,237,125,112,137500,123200,260700
210460,202108,306,206,100,226600,110000,336600
210462,202108,69,58,11,63800,12100,75900
210465,202108,139,109,30,119900,34100,154000
210467,202108,506,377,129,414700,143000,557700
210470,202108,48,41,7,45100,7700,52800
210480,202108,1286,926,360,1019700,397100.5,1416800.5
210490,202108,191,130,61,143000,67100,210100
210500,202108,512,313,199,344300,218900,563200
210510,202108,534,431,103,474100,113300,587400
210515,202108,362,229,133,251900,146300,398200
210520,202108,402,365,37,401500,40700,442200
210530,202108,9316,4876,4440,5364700.48,4887300.83,10252001.31
210535,202108,129,97,32,106700,35200,141900
210540,202108,1509,1011,498,1112100,547800,1659900
210542,202108,1135,579,556,636900,613800,1250700
210545,202108,21,19,2,20900,2200,23100
210547,202108,128,114,14,125400,15400,140800
210550,202108,630,453,177,498300,194700,693000
210560,202108,154,134,20,147400,22000,169400
210565,202108,21,15,6,16500,6600,23100
210570,202108,1285,1052,233,1158300.59,256300,1414600.59
210580,202108,122,103,19,113300,20900,134200
210590,202108,722,601,121,662200,133100,795300
210592,202108,37,34,3,37400,3300,40700
210594,202108,110,93,17,102300,18700,121000
210596,202108,109,94,15,104500,16500,121000
210598,202108,139,106,33,116600,36300,152900
210600,202108,311,270,41,297000,45100,342100
210610,202108,248,233,15,256300.42,16500,272800.42
210620,202108,44,29,15,31900,16500,48400
210630,202108,75,71,4,78100,4400,82500
210632,202108,1009,720,289,792000,319000,1111000
210635,202108,22,19,3,20900,3300,24200
210637,202108,128,93,35,102300,38500,140800
210640,202108,580,515,65,566500,71500,638000
210650,202108,396,332,64,365200,70400,435600
210660,202108,365,289,76,317900,83600,401500
210663,202108,49,35,14,38500,15400,53900
210667,202108,98,39,59,42900,64900,107800
210670,202108,259,231,28,254100,30800,284900
210675,202108,514,286,228,314600,250800,565400
210680,202108,220,142,78,156200,85800,242000
210690,202108,606,505,101,555500,111100,666600
210700,202108,153,117,36,128700,39600,168300
210710,202108,239,150,89,165000,97900,262900
210720,202108,127,114,13,125400,14300,139700
210725,202108,60,52,8,57200,8800,66000
210730,202108,23,18,5,19800,5500,25300
210735,202108,289,212,77,233200,84700,317900
210740,202108,523,451,72,496100,79200,575300
210745,202108,148,111,37,122100,40700,162800
210750,202108,2447,1258,1189,1383800,1309000,2692800
210760,202108,254,198,56,217800,61600,279400
210770,202108,242,198,44,217800,48400,266200
210780,202108,425,323,102,355300,112200,467500
210790,202108,181,149,32,163900,35200,199100
210800,202108,172,133,39,146300,42900,189200
210805,202108,58,52,6,57200,6600,63800
210810,202108,464,381,83,420200,91300,511500
210820,202108,2087,1742,345,1916200,379500,2295700
210825,202108,151,86,65,94600,71500,166100
210830,202108,716,478,238,525800,261800,787600
210840,202108,193,136,57,150700,62700,213400
210845,202108,225,165,60,181500,66000,247500
210850,202108,735,506,229,556600,251900,808500
210860,202108,3415,1981,1434,2182400,1577400,3759800
210870,202108,431,339,92,372900,101200,474100
210880,202108,75,58,17,63800,18700,82500
210890,202108,317,276,41,304700,45100,349800
210900,202108,622,407,215,448800,236500,685300
210905,202108,60,34,26,37400,28600,66000
210910,202108,1918,1468,450,1614800.7,495000,2109800.7
210920,202108,153,63,90,69300,99000,168300
210923,202108,84,68,16,74800,17600,92400
210927,202108,412,200,212,220000,233200,453200
210930,202108,68,55,13,60500,14300,74800
210940,202108,83,65,18,71500,19800,91300
210945,202108,201,110,91,122100,100100,222200
210950,202108,519,382,137,420200,150700,570900
210955,202108,86,53,33,58300,36300,94600
210960,202108,2212,1141,1071,1256200,1178100,2434300
210970,202108,114,100,14,110000,15400,125400
210975,202108,83,77,6,84700,6600,91300
210980,202108,1072,530,542,583000,596200,1179200
210990,202108,3935,2638,1297,2904000,1426700,4330700
211000,202108,1315,1068,247,1175900,271700,1447600
211003,202108,975,708,267,778800,293700,1072500
211010,202108,481,431,50,474100,55000,529100
211020,202108,1385,604,781,665500,859100,1524600
211023,202108,41,36,5,39600,5500,45100
211027,202108,74,54,20,60500,22000,82500
211030,202108,367,264,103,290400,113300,403700
211040,202108,290,244,46,270600,50600,321200
211050,202108,1133,764,369,840400,405900,1246300
211060,202108,634,560,74,616000,81400.49,697400.49
211065,202108,24,21,3,23100,3300,26400
211070,202108,872,732,140,806300,155100,961400
211080,202108,87,85,2,93500,2200,95700
211085,202108,49,26,23,28600,25300,53900
211090,202108,75,63,12,69300,13200,82500
211100,202108,468,391,77,431200,84700.82,515900.82
211102,202108,240,172,68,189200,74800,264000
211105,202108,224,157,67,172700,73700,246400
211107,202108,124,79,45,86900,49500,136400
211110,202108,929,625,304,687500,334400,1021900
211120,202108,5132,2618,2514,2879800,2765400,5645200
211125,202108,28,20,8,22000,9900,31900
211130,202108,40957,19111,21846,21028700.93,24040500,45069200.93
211140,202108,390,341,49,375100,53900,429000
211150,202108,1174,813,361,894300,397100,1291400
211153,202108,168,106,62,116600,68200,184800
211157,202108,67,54,13,59400,14300,73700
211160,202108,679,583,96,641300,105600,746900
211163,202108,4,4,0,4400,0,4400
211167,202108,10,9,1,9900,1100,11000
211170,202108,421,313,108,344300,118800,463100
211172,202108,115,78,37,85800,40700,126500
211174,202108,251,159,92,174900,101200,276100
211176,202108,462,344,118,378400,129800,508200
211178,202108,86,58,28,63800,30800,94600
211180,202108,211,171,40,188100,44000,232100
211190,202108,71,64,7,70400,7700,78100
211195,202108,34,22,12,25300,13200,38500
211200,202108,151,132,19,145200,20900,166100
211210,202108,412,303,109,333300,119900,453200
211220,202108,4149,2459,1690,2706000.5,1859000,4565000.5
211223,202108,97,93,4,102300,4400,106700
211227,202108,56,45,11,49500,12100,61600
211230,202108,727,600,127,660000,139700,799700
211240,202108,388,313,75,344300,82500,426800
211245,202108,178,91,87,100100,95700,195800
211250,202108,1517,1317,200,1448700,220000,1668700
211260,202108,790,658,132,724900,145200,870100
211270,202108,1900,1568,332,1725900,366300,2092200
211280,202108,1760,1151,609,1267200,669900,1937100
211285,202108,200,126,74,138600,81400,220000
211290,202108,716,513,203,565400,223300,788700
211300,202108,746,598,148,657800,162800,820600
211400,202108,1522,950,572,1045000,629200,1674200
220005,202108,15,14,1,15400,1100,16500
220010,202108,88,71,17,78100,18700,96800
220020,202108,686,552,134,608300,147400,755700
220025,202108,107,104,3,114400,3300,117700
220027,202108,48,39,9,42900,9900,52800
220030,202108,116,93,23,102300,25300,127600
220040,202108,1258,968,290,1065900,320100,1386000
220045,202108,33,22,11,24200,12100,36300
220050,202108,702,586,116,644600.8,127600,772200.8
220060,202108,176,153,23,168300,25300,193600
220070,202108,110,98,12,107800,13200,121000
220080,202108,15,13,2,14300,2200,16500
220090,202108,35,27,8,29700,8800,38500
220095,202108,2,1,1,1100,1100,2200
220100,202108,22,19,3,20900,3300,24200
220105,202108,26,24,2,26400,2200,28600
220110,202108,231,210,21,232100,23100,255200
220115,202108,38,36,2,39600,2200,41800
220117,202108,21,20,1,22000,1100,23100
220120,202108,1475,1129,346,1243000,380600,1623600
220130,202108,29,28,1,30800,1100,31900
220140,202108,99,79,20,86900,22000,108900
220150,202108,484,368,116,404800,127600,532400
220155,202108,10,9,1,9900,1100,11000
220157,202108,20,16,4,17600,4400,22000
220160,202108,95,84,11,92400,12100,104500
220170,202108,39,35,4,38500,4400,42900
220173,202108,8,8,0,8800,0,8800
220177,202108,11,10,1,11000,1100,12100
220180,202108,66,64,2,70400,2200,72600
220190,202108,1070,940,130,1034000,143000,1177000
220191,202108,43,35,8,38500,8800,47300
220192,202108,90,86,4,94600,4400,99000
220194,202108,59,55,4,60500,4400,64900
220196,202108,98,84,14,92400,15400,107800
220198,202108,3,2,1,2200,1100,3300
220200,202108,411,345,66,379500,72600,452100
220202,202108,38,33,5,36300,5500,41800
220205,202108,59,51,8,56100,8800,64900
220207,202108,13,13,0,14300,0,14300
220208,202108,76,43,33,47300,36300,83600
220209,202108,32,27,5,29700,5500,35200
220210,202108,22,15,7,16500,7700,24200
220211,202108,27,25,2,27500,2200,29700
220213,202108,36,32,4,35200,4400,39600
220217,202108,39,31,8,34100,8800,42900
220220,202108,2216,1464,752,1611500,827200,2438700
220225,202108,9,4,5,4400,5500,9900
220230,202108,959,738,221,811800,243100,1054900
220240,202108,164,146,18,160600,19800,180400
220245,202108,35,32,3,35200.18,3300,38500.18
220250,202108,124,106,18,116600,19800,136400
220253,202108,52,45,7,49500,7700,57200
220255,202108,39,33,6,36300,6600,42900
220260,202108,701,527,174,579700,191400,771100
220265,202108,9,7,2,7700,2200,9900
220270,202108,784,708,76,782100,83600,865700
220271,202108,43,35,8,38500,8800,47300
220272,202108,22,22,0,24200,0,24200
220273,202108,17,15,2,16500,2200,18700
220275,202108,57,47,10,51700,11000,62700
220277,202108,20,14,6,15400,6600,22000
220280,202108,17,11,6,12100,6600,18700
220285,202108,40,38,2,41800,2200,44000
220290,202108,1480,1268,212,1395900,233200,1629100
220300,202108,35,34,1,37400,1100,38500
220310,202108,325,278,47,305800,51700,357500
220320,202108,451,417,34,458700,37400,496100
220323,202108,3,2,1,2200,1100,3300
220325,202108,9,8,1,8800,1100,9900
220327,202108,11,11,0,12100,0,12100
220330,202108,234,170,64,187000,70400,257400
220335,202108,137,119,18,130900,19800,150700
220340,202108,43,31,12,34100,13200,47300
220342,202108,55,47,8,51700,8800,60500
220345,202108,79,70,9,77000,9900,86900
220350,202108,453,391,62,430100,68200,498300
220360,202108,38,28,10,30800,11000,41800
220370,202108,1260,1041,219,1146200,240900,1387100
220375,202108,18,17,1,18700,1100,19800
220380,202108,24,18,6,19800,6600,26400
220385,202108,15,14,1,15400,1100,16500
220390,202108,2306,1301,1005,1431100,1105500,2536600
220400,202108,35,31,4,34100,4400,38500
220410,202108,21,19,2,20900,2200,23100
220415,202108,12,11,1,12100,1100,13200
220420,202108,126,106,20,116600,22000,138600
220430,202108,129,115,14,126500,15400,141900
220435,202108,24,17,7,18700,7700,26400
220440,202108,286,244,42,268400,46200,314600
220450,202108,335,171,164,188100,180400,368500
220455,202108,51,50,1,55000,1100,56100
220460,202108,18,17,1,18700,1100,19800
220465,202108,90,60,30,66000,33000,99000
220470,202108,247,214,33,235400,37400,272800
220480,202108,70,63,7,69300,7700,77000
220490,202108,89,75,14,82500,15400,97900
220500,202108,113,93,20,102300,22000,124300
220510,202108,398,309,89,339900,97900,437800
220515,202108,20,18,2,19800,2200,22000
220520,202108,369,328,41,360800,45100,405900
220525,202108,10,7,3,7700,3300,11000
220527,202108,17,14,3,15400,3300,18700
220530,202108,39,15,24,16500,26400,42900
220535,202108,7,5,2,5500,2200,7700
220540,202108,77,64,13,70400,14300,84700
220545,202108,37,25,12,27500,13200,40700
220550,202108,705,564,141,621500,155100,776600
220551,202108,17,13,4,14300,4400,18700
220552,202108,12,12,0,13200,0,13200
220553,202108,52,47,5,51700,5500,57200
220554,202108,12,9,3,9900,3300,13200
220555,202108,38,30,8,33000,8800,41800
220556,202108,39,36,3,39600,3300,42900
220557,202108,55,51,4,56100,4400,60500
220558,202108,7,3,4,3300,4400,7700
220559,202108,2,2,0,2200,0,2200
220560,202108,70,46,24,50600,26400,77000
220570,202108,728,456,272,503800,299200,803000
220580,202108,544,496,48,545600,52800,598400
220585,202108,10,9,1,9900,1100,11000
220590,202108,14,13,1,14300,1100,15400
220595,202108,71,55,16,60500,17600,78100
220600,202108,22,14,8,15400,8800,24200
220605,202108,25,21,4,23100,4400,27500
220610,202108,85,71,14,78100,15400,93500
220620,202108,554,463,91,509300,100100,609400
220630,202108,6,5,1,5500,1100,6600
220635,202108,40,35,5,38500,5500,44000
220640,202108,108,89,19,97900,20900,118800
220650,202108,112,106,6,116600,6600,123200
220660,202108,57,45,12,49500,13200,62700
220665,202108,7,7,0,7700,0,7700
220667,202108,18,16,2,17600,2200,19800
220669,202108,31,24,7,26400,7700,34100
220670,202108,71,58,13,63800,14300,78100
220672,202108,78,57,21,62700,23100,85800
220675,202108,34,25,9,27500,9900,37400
220680,202108,44,38,6,41800,6600,48400
220690,202108,51,48,3,52800,3300,56100
220695,202108,27,15,12,16500,13200,29700
220700,202108,1719,1329,390,1461900,429000,1890900
220710,202108,6,4,2,4400,2200,6600
220720,202108,108,92,16,101200,17600,118800
220730,202108,20,16,4,17600,4400,22000
220735,202108,4,0,4,0,4400,4400
220740,202108,49,44,5,48400,5500,53900
220750,202108,114,99,15,108900,16500,125400
220755,202108,16,15,1,16500,1100,17600
220760,202108,67,60,7,66000,7700,73700
220770,202108,5784,3226,2558,3549700,2816000,6365700
220775,202108,16,11,5,12100,5500,17600
220777,202108,21,20,1,22000,1100,23100
220779,202108,1,0,1,0,1100,1100
220780,202108,899,769,130,845900,143000,988900
220785,202108,5,1,4,1100,4400,5500
220790,202108,1114,880,234,970200,257400,1227600
220793,202108,6,6,0,6600,0,6600
220795,202108,14,12,2,13200,2200,15400
220800,202108,4022,3083,939,3392604,1034000,4426604
220810,202108,68,59,9,64900,9900,74800
220820,202108,240,217,23,238700,25300,264000
220830,202108,1274,1102,172,1213300,190300,1403600
220840,202108,2438,1714,724,1885400,798600,2684000
220850,202108,68,60,8,66000,8800,74800
220855,202108,10,6,4,6600,4400,11000
220860,202108,11,10,1,11000,1100,12100
220865,202108,28,26,2,28600,2200,30800
220870,202108,85,76,9,83600,9900,93500
220880,202108,322,257,65,282700,71500,354200
220885,202108,30,28,2,30800,2200,33000
220887,202108,10,9,1,9900,1100,11000
220890,202108,90,78,12,85800,13200,99000
220900,202108,27,16,11,17600,12100,29700
220910,202108,53,44,9,48400,9900,58300
220915,202108,12,11,1,12100,1100,13200
220920,202108,50,43,7,47300,7700,55000
220930,202108,48,46,2,50600,2200,52800
220935,202108,14,14,0,15400,0,15400
220937,202108,32,31,1,34100,1100,35200
220940,202108,54,50,4,55000,4400,59400
220945,202108,2,2,0,2200,0,2200
220950,202108,38,30,8,33000,8800,41800
220955,202108,21,20,1,22000,1100,23100
220960,202108,23,22,1,24200,1100,25300
220965,202108,39,35,4,38500,4400,42900
220970,202108,59,50,9,55000,9900,64900
220975,202108,13,12,1,13200,1100,14300
220980,202108,32,29,3,31900,3300,35200
220985,202108,60,54,6,59400,6600,66000
220987,202108,31,29,2,31900,2200,34100
220990,202108,27,26,1,28600,1100,29700
220995,202108,16,13,3,14300,3300,17600
220997,202108,59,51,8,56100,8800,64900
221000,202108,1181,1064,117,1170400,128700,1299100
221005,202108,46,43,3,47300,3300,50600
221010,202108,18,14,4,15400,4400,19800
221020,202108,35,34,1,37400,1100,38500
221030,202108,39,31,8,34100,8800,42900
221035,202108,25,25,0,27500,0,27500
221037,202108,12,8,4,8800,4400,13200
221038,202108,27,24,3,27500,3300,30800
221039,202108,25,25,0,27500,0,27500
221040,202108,263,226,37,249700,40700,290400
221050,202108,227,190,37,210100,40700,250800
221060,202108,1906,1657,249,1822700,273900,2096600
221062,202108,31,30,1,33000,1100,34100
221063,202108,14,10,4,11000,4400,15400
221065,202108,64,52,12,57200,13200,70400
221070,202108,136,121,15,133100,17600,150700
221080,202108,374,321,53,353100,58300,411400
221090,202108,23,18,5,19800,5500,25300
221093,202108,43,32,11,35200,12100,47300
221095,202108,5,5,0,5500,0,5500
221097,202108,13,11,2,12100,2200,14300
221100,202108,25735,15380,10355,16925700.89,11402600,28328300.89
221110,202108,1118,847,271,931700,298100,1229800
221120,202108,542,401,141,441100,155100,596200
221130,202108,969,783,186,863500,204600,1068100
221135,202108,32,28,4,30800,4400,35200
221140,202108,46,40,6,44000,6600,50600
221150,202108,10,8,2,8800,2200,11000
221160,202108,11,11,0,12100,0,12100
221170,202108,17,17,0,18700,0,18700
230010,202108,150,134,16,147400,17600,165000
230015,202108,138,113,25,124300,28600,152900
230020,202108,1640,1371,269,1508100,295900,1804000
230030,202108,1665,1197,468,1316700,514800,1831500
230040,202108,230,192,38,211200,41800,253000
230050,202108,232,171,61,188100,67100,255200
230060,202108,159,125,34,138600,37400,176000
230070,202108,308,265,43,291500,47300,338800
230075,202108,856,733,123,806300,135300,941600
230080,202108,195,168,27,184800,29700,214500
230090,202108,142,105,37,115500,40700,156200
230100,202108,2266,1280,986,1409100,1085700,2494800
230110,202108,2891,1847,1044,2033900,1149500,3183400
230120,202108,1047,825,222,907500,244200,1151700
230125,202108,156,126,30,138600,33000,171600
230130,202108,474,422,52,464200,57200,521400
230140,202108,218,178,40,195800,44000,239800
230150,202108,154,119,35,130900,38500,169400
230160,202108,946,792,154,873400,169400,1042800
230170,202108,609,538,71,591800,78100,669900
230180,202108,70,64,6,70400,6600,77000
230185,202108,411,351,60,386100,66000,452100
230190,202108,2385,1859,526,2047100,578600,2625700
230195,202108,503,431,72,474100,79200,553300
230200,202108,416,331,85,364100,94600,458700
230205,202108,388,258,130,283800,143000,426800
230210,202108,1382,1066,316,1173700,347600,1521300
230220,202108,1571,1073,498,1180300,548900,1729200
230230,202108,964,811,153,892100,168300,1060400
230240,202108,1830,1587,243,1747075,267300,2014375
230250,202108,1787,1466,321,1613700,353100,1966800
230260,202108,3217,1992,1225,2191200,1348600,3539800
230270,202108,1373,1090,283,1199000.05,311300,1510300.05
230280,202108,2750,2082,668,2291300,734800,3026100
230290,202108,364,324,40,356400.5,44000,400400.5
230300,202108,531,386,145,424600,159500,584100
230310,202108,429,332,97,365200,107800,473000
230320,202108,907,768,139,844800,152900,997700
230330,202108,304,243,61,267300,67100,334400
230340,202108,445,359,86,394900,94600,489500
230350,202108,3226,2008,1218,2208800,1339800,3548600
230360,202108,269,222,47,244200,51700,295900
230365,202108,128,106,22,116600,24200,140800
230370,202108,10488,5167,5321,5689200.92,5856400,11545600.92
230380,202108,495,425,70,468600,77000,545600
230390,202108,532,297,235,326700,258500,585200
230393,202108,250,204,46,224400,50600,275000
230395,202108,345,277,68,304700,74800,379500
230400,202108,635,507,128,557700,140800,698500
230410,202108,2659,1641,1018,1805100.5,1120900,2926000.5
230420,202108,6389,4233,2156,4660700.6,2374900,7035600.6
230423,202108,342,297,45,326700,49500,376200
230425,202108,451,362,89,398200,97900,496100
230426,202108,118,93,25,102300,27500,129800
230427,202108,69,65,4,71500,4400,75900
230428,202108,1551,762,789,838200,867900,1706100
230430,202108,457,368,89,404800,99000,503800
230435,202108,917,669,248,735900,272800.24,1008700.24
230440,202108,91490,41148,50342,45294705.48,55426800.88,100721506.36
230445,202108,315,214,101,235400,111100,346500
230450,202108,580,455,125,500500,137500,638000
230460,202108,76,56,20,61600,22000,83600
230465,202108,310,249,61,273900,67100,341000
230470,202108,2026,1589,437,1747900,480700,2228600
230480,202108,150,140,10,154000,11000,165000
230490,202108,322,254,68,279400,74800,354200
230495,202108,470,335,135,368500,148500,517000
230500,202108,1018,755,263,830500,290400,1120900
230510,202108,57,43,14,47300,15400,62700
230520,202108,393,306,87,336600,95700,432300
230523,202108,2389,1479,910,1628000,1002100,2630100
230526,202108,267,231,36,254100,39600,293700
230530,202108,686,507,179,558800,196900,755700
230533,202108,212,196,16,215600.56,17600,233200.56
230535,202108,369,279,90,306900,99000,405900
230540,202108,1804,1607,197,1767700,216700,1984400
230550,202108,3911,2485,1426,2734600,1568600,4303200
230560,202108,581,439,142,482900,156200,639100
230565,202108,220,162,58,178200,63800,242000
230570,202108,283,244,39,269500,42900,312400
230580,202108,1177,846,331,930600.75,364100,1294700.75
230590,202108,1007,783,224,862400,246400,1108800
230600,202108,254,230,24,253000,26400,279400
230610,202108,408,308,100,338800,110000,448800
230620,202108,167,143,24,157300,26400,183700
230625,202108,798,546,252,600600,277200,877800
230630,202108,1331,1020,311,1122000,342100,1464100
230640,202108,3815,3212,603,3534300.45,664400,4198700.45
230650,202108,499,428,71,471900,78100,550000
230655,202108,700,581,119,639100,130900,770000
230660,202108,359,295,64,324500,70400,394900
230670,202108,439,370,69,407000,75900,482900
230680,202108,204,184,20,202400,22000,224400
230690,202108,921,776,145,853600,159500,1013100
230700,202108,872,732,140,805200,154000,959200
230710,202108,698,657,41,722700,45100,767800
230720,202108,143,123,20,135300,22000,157300
230725,202108,235,175,60,192500,66000,258500
230730,202108,12437,6679,5758,7352331.32,6339300.82,13691632.14
230740,202108,671,538,133,592900,146300,739200
230750,202108,825,697,128,766700,140800,907500
230760,202108,1439,1239,200,1364000,221100,1585100
230763,202108,337,277,60,304700,66000,370700
230765,202108,7892,3681,4211,4051300.97,4636500,8687800.97
230770,202108,4977,2539,2438,2796200,2682900,5479100
230780,202108,746,658,88,726000,96800,822800
230790,202108,297,246,51,270600,56100,326700
230800,202108,1161,840,321,924000,354200,1278200
230810,202108,1368,1205,163,1325500,179300,1504800
230820,202108,365,250,115,275000,126500,401500
230830,202108,970,822,148,904115,162800,1066915
230835,202108,280,239,41,262900,45100,308000
230837,202108,173,143,30,157300,33000,190300
230840,202108,923,717,206,789800,226600,1016400
230850,202108,1439,1240,199,1364000,218900,1582900
230860,202108,306,226,80,248600,88006,336606
230870,202108,1835,1554,281,1710500,309100,2019600
230880,202108,74,57,17,63800,18700,82500
230890,202108,543,489,54,537900,59400,597300
230900,202108,283,211,72,232100,79200.7,311300.7
230910,202108,226,174,52,191400,57200,248600
230920,202108,481,381,100,419100,110000,529100
230930,202108,1017,712,305,783200,335500,1118700
230940,202108,842,648,194,712800,213400,926200
230945,202108,519,417,102,459800,112200,572000
230950,202108,420,365,55,401500,60500,462000
230960,202108,2703,1803,900,1984400,990000,2974400
230970,202108,1728,967,761,1063700,837100,1900800
230980,202108,201,162,39,179300,42900,222200
230990,202108,139,111,28,122100,30800,152900
231000,202108,194,177,17,194700,18700,213400
231010,202108,160,114,46,125400,50600,176000
231020,202108,1377,954,423,1049400,466400,1515800
231025,202108,1063,766,297,842600,327800,1170400
231030,202108,1064,887,177,976800,195800,1172600
231040,202108,150,101,49,111100,53900,165000
231050,202108,946,829,117,911900,128700,1040600
231060,202108,155,128,27,140800,29700,170500
231070,202108,1502,1041,461,1145100,508200,1653300
231080,202108,268,239,29,262900,31900,294800
231085,202108,630,381,249,421300,273900,695200
231090,202108,257,208,49,228800,53900,282700
231095,202108,165,131,34,144100,37400,181500
231100,202108,160,131,29,145200,31900,177100
231110,202108,369,310,59,342100,64900,407000
231120,202108,268,225,43,247500,47300,294800
231123,202108,154,144,10,158400,11000,169400
231126,202108,333,255,78,280500,85800,366300
231130,202108,4880,3821,1059,4204200,1164900,5369100
231135,202108,213,184,29,202400,31900,234300
231140,202108,3069,2224,845,2448600,929500,3378100
231150,202108,377,354,23,389400,25300,414700
231160,202108,1221,977,244,1075800,268400,1344200
231170,202108,515,360,155,397100,170500,567600
231180,202108,1717,1481,236,1630200,259600,1889800
231190,202108,208,174,34,192500,37400,229900
231195,202108,223,188,35,206800,39600,246400
231200,202108,809,660,149,727100,163900,891000
231210,202108,523,445,78,490600,85800,576400
231220,202108,1037,752,285,827200.85,313500,1140700.85
231230,202108,1471,1141,330,1257300,363000,1620300
231240,202108,1468,1027,441,1130800,485100,1615900
231250,202108,98,92,6,101200,6600,107800
231260,202108,266,177,89,195800,97900,293700
231270,202108,997,796,201,875600,221100,1096700
231280,202108,74,58,16,63800,17600,81400
231290,202108,7768,4370,3398,4810300,3740000.57,8550300.57
231300,202108,597,550,47,606100,51700,657800
231310,202108,746,682,64,750200,70400,820600
231320,202108,591,444,147,488400,161700,650100
231325,202108,101,88,13,96800,14300,111100
231330,202108,1939,1495,444,1644500.74,488400,2132900.74
231335,202108,256,227,29,249700,31900,281600
231340,202108,1737,1260,477,1387100,525800,1912900
231350,202108,1311,1053,258,1158300,283800,1442100
231355,202108,427,363,64,399300,70400,469700
231360,202108,530,374,156,412500.65,171600,584100.65
231370,202108,95,84,11,92400,12100,104500
231375,202108,298,216,82,237600,90200,327800
231380,202108,497,394,103,433400,113300,546700
231390,202108,211,161,50,177100,55000,232100
231395,202108,760,470,290,517000,319000,836000
231400,202108,1140,948,192,1042800,211200,1254000
231410,202108,1323,1087,236,1197900,259600,1457500
240010,202108,379,165,214,181500.97,235400,416900.97
240020,202108,2190,1780,410,1959100,451000,2410100
240030,202108,118,98,20,107800,22000,129800
240040,202108,29,29,0,31900,0,31900
240050,202108,535,456,79,501600,86900,588500
240060,202108,69,65,4,71500,4400,75900
240070,202108,232,183,49,202400,53900,256300
240080,202108,527,359,168,394900,184800.7,579700.7
240090,202108,103,92,11,101200,12100,113300
240100,202108,1477,1392,85,1531200.5,93500,1624700.5
240110,202108,1028,676,352,744700,387200,1131900
240120,202108,142,109,33,119900,36300,156200
240130,202108,272,252,20,277200,22000,299200
240140,202108,82,57,25,62700,27500,90200
240145,202108,722,637,85,700700,93500,794200
240150,202108,22,17,5,18700,5500,24200
240160,202108,42,34,8,37400,8800,46200
240165,202108,38,30,8,33000,8800,41800
240170,202108,115,79,36,86900,39600,126500
240180,202108,99,75,24,82500,26400,108900
240185,202108,44,40,4,44000,4400,48400
240190,202108,17,15,2,16500,2200,18700
240200,202108,3056,1678,1378,1848000,1516900,3364900
240210,202108,168,130,38,143000,41800,184800
240220,202108,1102,786,316,866800,347600,1214400
240230,202108,841,768,73,847000,80300,927300
240240,202108,68,48,20,52800,22000,74800
240250,202108,90,77,13,84700,14300,99000
240260,202108,1809,1314,495,1445400,544500,1989900
240270,202108,182,160,22,176000,24200,200200
240280,202108,53,40,13,44000,14300,58300
240290,202108,47,45,2,49500,2200,51700
240300,202108,172,93,79,102300,88000,190300
240310,202108,2392,1299,1093,1428900.19,1202300,2631200.19
240320,202108,185,172,13,189200,14300,203500
240325,202108,4632,2727,1905,3001902.09,2097700,5099602.09
240330,202108,71,67,4,73700,4400,78100
240340,202108,80,53,27,58300,29700,88000
240350,202108,93,79,14,86900,15400,102300
240360,202108,600,362,238,398200,261800,660000
240370,202108,53,49,4,55000,4400,59400
240375,202108,64,38,26,41800,28600,70400
240380,202108,228,187,41,205700,45100,250800
240390,202108,12,11,1,12100,1100,13200
240400,202108,82,73,9,80300,9900,90200
240410,202108,14,8,6,8800,6600,15400
240420,202108,1045,765,280,841500,308000,1149500
240430,202108,263,246,17,271700,18700,290400
240440,202108,124,67,57,74800,62700,137500
240450,202108,233,152,81,167200,89100,256300
240460,202108,76,59,17,64900,18700,83600
240470,202108,233,211,22,232100,24200,256300
240480,202108,16,14,2,15400,2200,17600
240485,202108,81,66,15,72600,16500,89100
240490,202108,48,44,4,48400,4400,52800
240500,202108,89,68,21,74800,23100,97900
240510,202108,42,30,12,33000,13200,46200
240520,202108,103,98,5,107800,5500,113300
240530,202108,57,50,7,55000,7700,62700
240540,202108,82,70,12,77000,13200,90200
240550,202108,12,11,1,12100,1100,13200
240560,202108,374,271,103,298100,114400,412500
240570,202108,436,275,161,303600,177100,480700
240580,202108,1283,996,287,1097800,315700,1413500
240590,202108,31,29,2,31900,2200,34100
240600,202108,99,95,4,104500,4400,108900
240610,202108,513,425,88,467500,96800,564300
240615,202108,15,14,1,16500,1100,17600
240620,202108,88,85,3,93500,3300,96800
240630,202108,39,34,5,37400,5500,42900
240640,202108,26,21,5,23100,5500,28600
240650,202108,239,196,43,215600,47300,262900
240660,202108,109,92,17,101200,18700,119900
240670,202108,312,174,138,192500,151800,344300
240680,202108,53,40,13,44000,14300,58300
240690,202108,47,44,3,48400,3300,51700
240700,202108,183,150,33,165000,36300,201300
240710,202108,2078,1270,808,1400300.84,888800,2289100.84
240720,202108,1067,778,289,856900,319000,1175900
240725,202108,68,63,5,69300,5500,74800
240730,202108,148,123,25,135300,27500,162800
240740,202108,230,195,35,214500,38500,253000
240750,202108,52,30,22,33000,24200,57200
240760,202108,48,44,4,48400,4400,52800
240770,202108,150,116,34,128700,37400,166100
240780,202108,707,585,122,643500,134200,777700
240790,202108,42,40,2,44000,2200,46200
240800,202108,9328,6335,2993,6972900.85,3295600,10268500.85
240810,202108,21003,11247,9756,12380500,10743700,23124200
240820,202108,250,147,103,161700,113300,275000
240830,202108,1624,1342,282,1476200,311300,1787500
240840,202108,76,67,9,73700,9900,83600
240850,202108,84,75,9,82500,9900,92400
240860,202108,107,103,4,113300,4400,117700
240870,202108,58,50,8,55000,8800,63800
240880,202108,31,28,3,30800,3300,34100
240890,202108,1143,643,500,709500,551100,1260600
240895,202108,64,47,17,51700,18700,70400
240910,202108,167,143,24,157300,26400,183700
240920,202108,13,11,2,12100,2200,14300
240930,202108,401,359,42,396000,46200,442200
240933,202108,53,34,19,37400,20900,58300
240940,202108,2325,2059,266,2266000,292600,2558600
240950,202108,46,41,5,45100,5500,50600
240960,202108,25,21,4,23100,4400,27500
240970,202108,116,86,30,94600,33000,127600
240980,202108,197,160,37,176000,40700,216700
240990,202108,136,92,44,101200,48400,149600
241000,202108,59,56,3,61600,3300,64900
241010,202108,76,57,19,62700,20900,83600
241020,202108,107,98,9,107800,9900,117700
241025,202108,14,7,7,7700,7700,15400
241030,202108,110,87,23,95700,25300,121000
241040,202108,42,29,13,31900,14300,46200
241050,202108,77,70,7,77000,7700,84700
241060,202108,27,22,5,24200,5500,29700
241070,202108,16,16,0,17600,0,17600
241080,202108,60,53,7,58300,7700,66000
241090,202108,51,40,11,44000,12100,56100
241100,202108,75,64,11,70400,12100,82500
241105,202108,12,5,7,5500,7700,13200
241110,202108,45,40,5,44000,5500,49500
241120,202108,1531,1155,376,1270500,413600,1684100
241140,202108,216,180,36,198000,39600,237600
241142,202108,47,35,12,38500,13200,51700
241150,202108,1205,1053,152,1158300,167200,1325500
241160,202108,19,17,2,18700,2200,20900
241170,202108,49,41,8,45100,8800,53900
241180,202108,43,35,8,38500,8800,47300
241190,202108,39,37,2,40700,2200,42900
241200,202108,4066,2136,1930,2349600.53,2125200,4474800.53
241210,202108,67,58,9,63800,9900,73700
241220,202108,1454,968,486,1069200.43,534600,1603800.43
241230,202108,248,207,41,227700,45100,272800
241240,202108,54,42,12,46200,13200,59400
241250,202108,1123,1028,95,1130800,104500,1235300
241255,202108,54,45,9,49500,11000,60500
241260,202108,676,520,156,572000,171600,743600
241270,202108,65,44,21,48400,23100,71500
241280,202108,97,86,11,94600,12100,106700
241290,202108,130,91,39,100100,42900,143000
241300,202108,81,56,25,61600,27500,89100
241310,202108,50,35,15,38500,16500,55000
241320,202108,30,15,15,16500,16500,33000
241330,202108,59,52,7,57200,7700,64900
241335,202108,79,72,7,79200,7700,86900
241340,202108,182,134,48,147400,52800,200200
241350,202108,62,53,9,58300,9900,68200
241355,202108,49,41,8,45100,8800,53900
241360,202108,49,48,1,52800,1100,53900
241370,202108,56,44,12,48400,13200,61600
241380,202108,34,30,4,33000,4400,37400
241390,202108,82,64,18,70400,19800,90200
241400,202108,216,168,48,184800,52800,237600
241410,202108,184,167,17,183700,18700,202400
241415,202108,102,84,18,92400,19800,112200
241420,202108,106,76,30,84700,33000,117700
241430,202108,24,22,2,24200,2200,26400
241440,202108,529,438,91,482900,100100,583000
241445,202108,39,34,5,37400,5500,42900
241450,202108,262,218,44,239800,49500,289300
241460,202108,145,132,13,145200,14300,159500
241470,202108,35,30,5,33000,5500,38500
241475,202108,53,49,4,53900,4400,58300
241480,202108,116,85,31,93500,34100,127600
241490,202108,11,10,1,11000,1100,12100
241500,202108,44,33,11,36300,12100,48400
250010,202108,100,86,14,94600,15400,110000
250020,202108,32,28,4,30800,4400,35200
250030,202108,896,668,228,737000,250800,987800
250040,202108,391,322,69,354200,75900,430100
250050,202108,257,209,48,229900,52800,282700
250053,202108,62,48,14,52800,15400,68200
250057,202108,1,1,0,1100,0,1100
250060,202108,598,432,166,475200,182600,657800
250070,202108,690,553,137,608300.22,150700,759000.22
250073,202108,7,7,0,7700,0,7700
250077,202108,179,131,48,144100,52800,196900
250080,202108,422,332,90,365200,99000,464200
250090,202108,224,144,80,158400,88000,246400
250100,202108,536,448,88,492800,96800,589600
250110,202108,648,489,159,537900,174900,712800
250115,202108,17,4,13,4400,14300,18700
250120,202108,124,89,35,97900,38500,136400
250130,202108,570,459,111,504900,122100,627000
250135,202108,20,11,9,12100,9900,22000
250140,202108,83,74,9,81400,11000,92400
250150,202108,601,431,170,474100,187000,661100
250153,202108,13,10,3,11000,3300,14300
250157,202108,29,24,5,26400,5500,31900
250160,202108,228,180,48,198000,52800,250800
250170,202108,70,45,25,49500,27500,77000
250180,202108,4518,3086,1432,3397900,1576300,4974200
250190,202108,833,556,277,611600,304700,916300
250200,202108,58,43,15,47300,16500,63800
250205,202108,23,19,4,20900,4400,25300
250210,202108,86,75,11,82500,12100,94600
250215,202108,70,54,16,59400,17600,77000
250220,202108,26,19,7,20900,7700,28600
250230,202108,78,70,8,77000,8800,85800
250240,202108,240,186,54,204600,59400,264000
250250,202108,378,325,53,357500,58300,415800
250260,202108,43,35,8,38500,8800,47300
250270,202108,75,52,23,57200,25300,82500
250280,202108,380,309,71,339900,78100,418000
250290,202108,92,85,7,93500,7700,101200
250300,202108,565,381,184,419100,202400,621500
250310,202108,44,40,4,44000,4400,48400
250320,202108,1965,1312,653,1443200,718300,2161500
250330,202108,104,89,15,97900,16500,114400
250340,202108,28,24,4,26400,4400,30800
250350,202108,186,120,66,132000,72600,204600
250355,202108,34,26,8,28600,8800,37400
250360,202108,197,163,34,179300,37400,216700
250370,202108,2380,1541,839,1695100.16,924000,2619100.16
250375,202108,12,7,5,7700,5500,13200
250380,202108,55,44,11,48400,12100,60500
250390,202108,46,36,10,39600,11000,50600
250400,202108,16479,8296,8183,9132181.02,9010100,18142281.02
250403,202108,323,255,68,280500,74800,355300
250407,202108,62,50,12,55000,13200,68200
250410,202108,30,26,4,28600,4400,33000
250415,202108,42,28,14,30800,15400,46200
250420,202108,42,36,6,39600,6600,46200
250430,202108,1433,1237,196,1362075,215600,1577675
250435,202108,22,15,7,16500,7700,24200
250440,202108,677,564,113,620400,124300,744700
250450,202108,82,63,19,69300,20900,90200
250460,202108,467,308,159,338800,174900,513700
250470,202108,98,68,30,74800,33000,107800
250480,202108,330,264,66,290400,72600,363000
250485,202108,4,4,0,4400,0,4400
250490,202108,234,190,44,209000,48400,257400
250500,202108,99,75,24,82500,26400,108900
250510,202108,784,621,163,685300,179300,864600
250520,202108,174,115,59,126500,64900,191400
250523,202108,122,98,24,107800,26400,134200
250527,202108,109,85,24,93500,26400,119900
250530,202108,7,4,3,4400,3300,7700
250535,202108,30,22,8,24200,8800,33000
250540,202108,139,110,29,121000,31900,152900
250550,202108,69,66,3,72600,3300,75900
250560,202108,55,36,19,39600,20900,60500
250570,202108,159,129,30,141900,33000,174900
250580,202108,101,78,23,85871,25300,111171
250590,202108,23,13,10,14300,11000,25300
250600,202108,1476,967,509,1063700.7,559900,1623600.7
250610,202108,161,133,28,146300,30800,177100
250620,202108,21,17,4,18700,4400,23100
250625,202108,69,52,17,57200,18700,75900
250630,202108,3122,1994,1128,2193400.62,1243000,3436400.62
250640,202108,196,158,38,173800,42900,216700
250650,202108,28,20,8,22000,8800,30800
250660,202108,58,42,16,46200,17600,63800
250670,202108,66,49,17,53900,18700,72600
250680,202108,416,333,83,366300,91300,457600
250690,202108,2109,1459,650,1604900.7,716100,2321000.7
250700,202108,932,797,135,876700,148500,1025200
250710,202108,441,347,94,382800,103400,486200
250720,202108,118,86,32,94600,35200,129800
250730,202108,411,341,70,375100,77000,452100
250740,202108,61,58,3,63800,3300,67100
250750,202108,23050,13772,9278,15165581.41,10213500,25379081.41
250760,202108,106,83,23,91300,25300,116600
250770,202108,364,238,126,261800,138600,400400
250780,202108,70,46,24,50600,26400,77000
250790,202108,456,291,165,320100,181500,501600
250800,202108,151,136,15,149600,16500,166100
250810,202108,74,59,15,64900,16500,81400
250820,202108,149,125,24,137500,26400,163900
250830,202108,441,287,154,315700,170500,486200
250840,202108,54,48,6,52800,6600,59400
250850,202108,57,48,9,52800,9900,62700
250855,202108,16,14,2,15400,2200,17600
250860,202108,234,153,81,168300,90200,258500
250870,202108,29,26,3,28600,3300,31900
250880,202108,87,63,24,69300,26400,95700
250890,202108,2997,2233,764,2459600,840400,3300000
250900,202108,56,46,10,50600,11000,61600
250905,202108,123,95,28,105600,30800,136400
250910,202108,1058,782,276,860200,303600,1163800
250915,202108,104,73,31,80300,34100,114400
250920,202108,139,101,38,111100,41800,152900
250930,202108,178,105,73,115500,80300,195800
250933,202108,7,5,2,5500,2200,7700
250937,202108,13,13,0,14300,0,14300
250939,202108,34,27,7,29700,7700,37400
250940,202108,115,85,30,93500,33000,126500
250950,202108,73,50,23,55000,25300,80300
250960,202108,92,50,42,55000,46200,101200
250970,202108,1228,869,359,955900,394900,1350800
250980,202108,107,70,37,77000,40700,117700
250990,202108,170,131,39,144100,42900,187000
251000,202108,78,67,11,73700,12100,85800
251010,202108,118,89,29,97900,31900,129800
251020,202108,72,59,13,64900,14300,79200
251030,202108,45,34,11,37400,12100,49500
251040,202108,54,36,18,39600,19800,59400
251050,202108,23,20,3,22000,3300,25300
251060,202108,49,40,9,44000,9900,53900
251065,202108,6,4,2,4400,2200,6600
251070,202108,17,13,4,14300,4400,18700
251080,202108,5105,2420,2685,2662000,2956800.1,5618800.1
251090,202108,188,157,31,172700,34100,206800
251100,202108,20,20,0,22000,0,22000
251110,202108,48,37,11,40700,12100,52800
251120,202108,1895,1162,733,1278200,808500,2086700
251130,202108,415,343,72,377300,79200,456500
251140,202108,567,362,205,398200,225500,623700
251150,202108,343,287,56,315700,61600,377300
251160,202108,96,78,18,85800,19800,105600
251170,202108,99,79,20,86900,22000,108900
251180,202108,288,174,114,191400,125400,316800
251190,202108,197,127,70,139700,78100,217800
251200,202108,275,219,56,240900,61600,302500
251203,202108,33,30,3,33000,3300,36300
251207,202108,83,69,14,75900,15400,91300
251210,202108,1488,1088,400,1196800,442200,1639000
251220,202108,47,37,10,40700,11000,51700
251230,202108,586,488,98,537900,107800,645700
251240,202108,104,74,30,81400,33000,114400
251250,202108,1440,1042,398,1147209.8,437800,1585009.8
251260,202108,12,8,4,8800,4400,13200
251270,202108,305,239,66,262900,72600,335500
251272,202108,65,58,7,63800,7700,71500
251274,202108,28,21,7,23100,7700,30800
251275,202108,34,19,15,20900,16500,37400
251276,202108,20,17,3,18700,3300,22000
251278,202108,9,7,2,7700,2200,9900
251280,202108,99,94,5,103400,5500,108900
251290,202108,913,656,257,721600,282700,1004300
251300,202108,16,12,4,13200,4400,17600
251310,202108,295,217,78,238700,85800,324500
251315,202108,38,34,4,37400,4400,41800
251320,202108,66,51,15,56100,16500,72600
251330,202108,79,71,8,78100,8800,86900
251335,202108,22,9,13,9900,14300,24200
251340,202108,759,447,312,491700,344300,836000
251350,202108,34,33,1,36300,1100,37400
251360,202108,86,74,12,81400,13200,94600
251365,202108,9,9,0,9900,0,9900
251370,202108,5649,3817,1832,4199800.32,2018500,6218300.32
251380,202108,44,34,10,37400,11000,48400
251385,202108,2,2,0,2200,0,2200
251390,202108,872,650,222,715000,244200,959200
251392,202108,26,16,10,17600,11000,28600
251394,202108,9,9,0,9900,0,9900
251396,202108,14,10,4,11000,4400,15400
251398,202108,16,14,2,15400,2200,17600
251400,202108,46,36,10,39600,11000,50600
251410,202108,40,34,6,37400,6600,44000
251420,202108,103,75,28,82500,30800,113300
251430,202108,48,44,4,48400,4400,52800
251440,202108,45,25,20,27500,22000,49500
251445,202108,57,50,7,55000,7700,62700
251450,202108,398,345,53,380600,58300,438900
251455,202108,6,5,1,5500,1100,6600
251460,202108,18,16,2,17600,2200,19800
251465,202108,7,5,2,5500,2200,7700
251470,202108,52,39,13,42900,14300,57200
251480,202108,27,22,5,24200,5500,29700
251490,202108,114,70,44,77000,48400,125400
251500,202108,123,100,23,110000,25300,135300
251510,202108,72,46,26,50600,28600,79200
251520,202108,31,28,3,30800,3300,34100
251530,202108,4371,3103,1268,3417700,1394800,4812500
251540,202108,84,68,16,75900,17600,93500
251550,202108,410,311,99,342100,108900,451000
251560,202108,24,16,8,17600,8800,26400
251570,202108,18,16,2,17600,2200,19800
251580,202108,134,107,27,117700,29700,147400
251590,202108,112,78,34,86007.9,37400,123407.9
251593,202108,25,15,10,16500,11000,27500
251597,202108,102,82,20,90200,22000,112200
251600,202108,1106,775,331,854700,364100,1218800
251610,202108,239,175,64,193600,70400,264000
251615,202108,12,11,1,12100,1100,13200
251620,202108,4192,2720,1472,2992000,1620300,4612300
251630,202108,462,344,118,378400,129800,508200
251640,202108,131,98,33,107800,36300,144100
251650,202108,286,211,75,232100,82500,314600
251660,202108,194,171,23,188100,25300,213400
251670,202108,387,299,88,328900,96800,425700
251675,202108,8,6,2,6600,2200,8800
251680,202108,103,89,14,97900,15400,113300
251690,202108,325,269,56,295900,61600,357500
251700,202108,286,247,39,271700,42900,314600
251710,202108,21,13,8,14300,8800,23100
251720,202108,24,16,8,17600,8800,26400
251740,202108,11,8,3,8800,3300,12100
260005,202108,3399,1812,1587,1992732,1746800,3739532
260010,202108,1620,1189,431,1310100.58,475200,1785300.58
260020,202108,416,358,58,393800,63800,457600
260030,202108,599,409,190,449900,209000,658900
260040,202108,809,495,314,544500,345400,889900
260050,202108,1160,832,328,915200,360800,1276000
260060,202108,377,344,33,378400,36300,414700
260070,202108,1331,813,518,895400,569800,1465200
260080,202108,716,548,168,602800,184800,787600
260090,202108,514,329,185,361900,203500,565400
260100,202108,217,151,66,166100,73700,239800
260105,202108,252,140,112,154000,123200,277200
260110,202108,2912,2134,778,2349600,856900,3206500
260120,202108,2701,1453,1248,1599692.6,1379400,2979092.6
260130,202108,176,121,55,133100,60500,193600
260140,202108,2158,1415,743,1557600,818400,2376000
260150,202108,199,128,71,140800,78100,218900
260160,202108,336,277,59,304700,64900,369600
260170,202108,3325,2000,1325,2202200,1457500,3659700
260180,202108,165,132,33,145200,36300,181500
260190,202108,2345,1568,777,1725900,854700,2580600
260200,202108,980,774,206,852500.63,226600,1079100.63
260210,202108,1410,998,412,1097800,453200,1551000
260220,202108,657,591,66,650100,72600,722700
260230,202108,1227,910,317,1002100,348700,1350800
260240,202108,210,160,50,176000,55000,231000
260250,202108,85,62,23,68200,25300,93500
260260,202108,1049,728,321,800800,353100,1153900
260270,202108,256,187,69,205700,75900,281600
260280,202108,1168,936,232,1030700,255200,1285900
260290,202108,6652,3615,3037,3977600,3340700.59,7318300.59
260300,202108,976,835,141,919600,155100,1074700
260310,202108,522,414,108,455400,118800,574200
260320,202108,859,624,235,687500,258500,946000
260330,202108,69,48,21,52800,23100,75900
260340,202108,72,54,18,59400,19800,79200
260345,202108,5542,2955,2587,3250500,2846800,6097300
260350,202108,483,339,144,372900,158400,531300
260360,202108,236,128,108,140800,118800,259600
260370,202108,751,478,273,525800,302500,828300
260380,202108,570,414,156,456500,172700.6,629200.6
260390,202108,290,246,44,270600,48400,319000
260392,202108,114,99,15,108900,16500,125400
260400,202108,4248,2429,1819,2673000.5,2003100,4676100.5
260410,202108,14736,7744,6992,8523900.63,7697800,16221700.63
260415,202108,142,121,21,133100,23100,156200
260420,202108,1718,1045,673,1149500,742500,1892000
260430,202108,173,158,15,173800.48,16500,190300.48
260440,202108,188,135,53,148500,58300,206800
260450,202108,427,318,109,349801.13,121000,470801.13
260460,202108,825,436,389,479600,427900,907500
260470,202108,339,207,132,227700,145200,372900
260480,202108,246,157,89,172700,97900,270600
260490,202108,216,173,43,190300,47300,237600
260500,202108,1118,757,361,833800,399300,1233100
260510,202108,782,617,165,678700,181500,860200
260515,202108,237,212,25,233200,27500,260700
260520,202108,3254,2017,1237,2219800,1361800,3581600
260530,202108,794,647,147,712800,161700,874500
260540,202108,528,416,112,457600,123200,580800
260545,202108,16,12,4,13200,4400,17600
260550,202108,328,208,120,228800,132000,360800
260560,202108,504,381,123,419100,135300,554400
260570,202108,981,789,192,867900,211200,1079100
260580,202108,254,219,35,242000,38500,280500
260590,202108,628,360,268,397100,294800,691900
260600,202108,7636,4410,3226,4853201.82,3553000,8406201.82
260610,202108,485,326,159,358600,174900,533500
260620,202108,3627,1871,1756,2058100.8,1933800.19,3991900.99
260630,202108,82,76,6,83600,6600,90200
260640,202108,3371,1928,1443,2123000,1593900,3716900
260650,202108,321,234,87,257400,95700,353100
260660,202108,554,351,203,386100,223300,609400
260670,202108,98,71,27,78100,29700,107800
260680,202108,3852,2117,1735,2330900,1912900,4243800
260690,202108,124,93,31,102300,34100,136400
260700,202108,303,201,102,221100,112200,333300
260710,202108,45,36,9,39600,9900,49500
260720,202108,2612,1539,1073,1692900,1180300,2873200
260730,202108,730,544,186,598400,204600,803000
260740,202108,68,58,10,63800,11000,74800
260750,202108,576,417,159,458700,174900,633600
260760,202108,682,337,345,370700.3,379500,750200.3
260765,202108,961,492,469,541200,517000,1058200
260770,202108,224,165,59,181481,64900,246381
260775,202108,780,427,353,470800,388300,859100
260780,202108,235,146,89,161700,97900,259600
260790,202108,14702,7385,7317,8127900,8054200,16182100
260795,202108,164,106,58,116600,63800,180400
260800,202108,288,238,50,261800,55000,316800
260805,202108,171,113,58,124300,63800,188100
260810,202108,778,649,129,715000,141900,856900
260820,202108,287,184,103,202400,113300,315700
260825,202108,214,144,70,158400,77000,235400
260830,202108,316,182,134,200200,148500,348700
260840,202108,251,182,69,200200,75900,276100
260845,202108,171,113,58,124300,63800,188100
260850,202108,408,305,103,335500,113300,448800
260860,202108,257,195,62,214500,68200,282700
260870,202108,350,268,82,294800,90200,385000
260875,202108,734,535,199,588500,218900,807400
260880,202108,1555,1026,529,1129700,583000,1712700
260890,202108,2342,1623,719,1785300,790900,2576200
260900,202108,982,701,281,772200,310200,1082400
260910,202108,250,198,52,217800,57200,275000
260915,202108,285,213,72,235400.03,79200,314600.03
260920,202108,198,103,95,113300,104500,217800
260930,202108,381,325,56,358600,61600,420200
260940,202108,2615,1388,1227,1529000,1351900,2880900
260950,202108,1999,1130,869,1245200,955900,2201100
260960,202108,13565,6722,6843,7396400.9,7533900.5,14930301.4
260970,202108,414,340,74,374000,81400,455400
260980,202108,202,183,19,201300,20900,222200
260990,202108,2640,2134,506,2350700,556600,2907300
261000,202108,4214,2568,1646,2827000,1816100,4643100
261010,202108,164,112,52,123200,57200,180400
261020,202108,596,446,150,490600.47,165000,655600.47
261030,202108,264,188,76,206800,84700,291500
261040,202108,378,327,51,359700,56100,415800
261050,202108,504,431,73,474100,80300,554400
261060,202108,1391,864,527,952600,579700,1532300
261070,202108,8936,4304,4632,4738800,5101800.5,9840600.5
261080,202108,369,281,88,309100,96800,405900
261090,202108,2133,1639,494,1805102.03,545600.3,2350702.33
261100,202108,1184,829,355,911900.99,391600,1303500.99
261110,202108,8878,5476,3402,6026900,3746600,9773500
261120,202108,244,209,35,229900,38500,268400
261130,202108,564,339,225,372900,247500,620400
261140,202108,216,135,81,148500,89100,237600
261150,202108,686,436,250,480700.56,275000,755700.56
261153,202108,71,66,5,72600,5500,78100
261160,202108,74193,36446,37747,40109392.2,41563501.55,81672893.75
261170,202108,469,346,123,381700,135300,517000
261180,202108,1770,1102,668,1212451,734800,1947251
261190,202108,581,403,178,444400,195800,640200
261200,202108,218,179,39,196900,42900,239800
261210,202108,36,31,5,34100,5500,39600
261220,202108,2735,1925,810,2119700.66,891000,3010700.66
261230,202108,335,243,92,267300,101200,368500
261240,202108,439,385,54,423500,59400,482900
261245,202108,243,199,44,218900,48400,267300
261247,202108,168,130,38,143000,41800,184800
261250,202108,3331,1608,1723,1771000,1896400,3667400
261255,202108,247,221,26,243100,28600,271700
261260,202108,845,732,113,805200.12,124300,929500.12
261270,202108,202,140,62,154000,68200,222200
261280,202108,184,150,34,165000,37400,202400
261290,202108,114,84,30,92400,33000,125400
261300,202108,1342,996,346,1096700,380600,1477300
261310,202108,784,523,261,575300,287100,862400
261320,202108,569,380,189,418000,209000,627000
261330,202108,928,720,208,792000,229900.63,1021900.63
261340,202108,305,168,137,184800,150700,335500
261350,202108,858,601,257,662200,282700,944900
261360,202108,1333,862,471,949300,518100,1467400
261370,202108,4805,2831,1974,3114100,2171400,5285500
261380,202108,540,414,126,455400.78,138600,594000.78
261390,202108,3610,2424,1186,2667500,1304600,3972100
261400,202108,280,251,29,276100,31900,308000
261410,202108,1111,727,384,801900,423500,1225400
261420,202108,921,570,351,627000.32,386100,1013100.32
261430,202108,315,288,27,316800,29700,346500
261440,202108,113,104,9,114400,9900,124300
261450,202108,2502,1993,509,2194500,561000,2755500
261460,202108,749,584,165,642400,181500,823900
261470,202108,232,188,44,206800,48400,255200
261480,202108,451,348,103,382800,113250.5,496050.5
261485,202108,360,216,144,237600,158400,396000
261500,202108,611,411,200,452100.59,220000,672100.59
261510,202108,54,35,19,38500,20900,59400
261520,202108,92,78,14,86900,15400,102300
261530,202108,4108,2608,1500,2869900.09,1652200,4522100.09
261540,202108,1399,819,580,902000,638000,1540000
261550,202108,258,121,137,133100,150700,283800
261560,202108,875,574,301,631400,332200,963600
261570,202108,393,308,85,338800,93500,432300
261580,202108,389,308,81,338800,89100,427900
261590,202108,191,154,37,169400,40700,210100
261600,202108,289,227,62,250800,68200,319000
261610,202108,81,72,9,79200,9900,89100
261618,202108,77,59,18,64900,19800,84700
261620,202108,192,120,72,132000,79200,211200
261630,202108,672,535,137,588500,150700,739200
261640,202108,6422,3374,3048,3712501.05,3357200,7069701.05
261650,202108,488,313,175,346500,192500,539000
270010,202108,509,451,58,496136.66,63800,559936.66
270020,202108,246,200,46,221100,50600,271700
270030,202108,8759,5641,3118,6209573.92,3434151,9643724.92
270040,202108,2058,1325,733,1460543.33,807400,2267943.33
270050,202108,185,144,41,157740,45100,202840
270060,202108,79,53,26,58300,28600,86900
270070,202108,846,621,225,684200,247500,931700
270080,202108,36,30,6,33000,6600,39600
270090,202108,24,16,8,17600,8800,26400
270100,202108,1318,904,414,994400,455400,1449800
270110,202108,79,67,12,73700,13200,86900
270120,202108,225,184,41,203500,45100,248600
270130,202108,312,230,82,253000,90200,343200
270135,202108,115,77,38,84700,41800,126500
270140,202108,1371,890,481,979000,529100,1508100
270150,202108,262,203,59,223300,64900,288200
270160,202108,496,394,102,433400,112200,545600
270170,202108,800,524,276,576400,304700,881100
270180,202108,55,43,12,47300,13200,60500
270190,202108,113,95,18,104500,19800,124300
270200,202108,111,97,14,106700,15400,122100
270210,202108,528,316,212,348700,234300,583000
270220,202108,185,141,44,155100,48400,203500
270230,202108,2143,1324,819,1456400,900900,2357300
270235,202108,673,526,147,578600,161700,740300
270240,202108,2968,2354,614,2591601.56,676500,3268101.56
270250,202108,128,93,35,102300,38500,140800
270255,202108,214,185,29,203500,31900,235400
270260,202108,366,297,69,326700,75900,402600
270270,202108,95,47,48,51700,53900,105600
270280,202108,225,127,98,139700,107800,247500
270290,202108,1128,874,254,961400,279400,1240800
270300,202108,336,240,96,264000,105600,369600
270310,202108,815,680,135,749136.66,150700,899836.66
270320,202108,807,696,111,767800.63,122100,889900.63
270330,202108,305,256,49,282700,55000,337700
270340,202108,57,45,12,49500,13200,62700
270350,202108,90,52,38,57200,41800,99000
270360,202108,67,38,29,41800,31900,73700
270370,202108,58,46,12,50600,13200,63800
270375,202108,76,45,31,49500,34100,83600
270380,202108,1057,698,359,768900,394900,1163800
270390,202108,156,88,68,96800,74800,171600
270400,202108,727,550,177,605000.2,194700,799700.2
270410,202108,632,465,167,511500,184800,696300
270420,202108,400,276,124,303600,136400,440000
270430,202108,33620,24200,9420,26632411.78,10376300.98,37008712.76
270440,202108,488,384,104,423500,114400,537900
270450,202108,832,488,344,536800,379500,916300
270460,202108,181,143,38,157300,41800,199100
270470,202108,1535,1065,470,1172600,519200,1691800
270480,202108,527,429,98,471900,107800,579700
270490,202108,22,17,5,18700,5500,24200
270500,202108,495,413,82,454300,90200,544500
270510,202108,846,536,310,589600,343200,932800
270520,202108,276,179,97,196900,106700,303600
270530,202108,59,51,8,56100,8800,64900
270540,202108,93,72,21,79200,23100,102300
270550,202108,1699,1309,390,1441000,429000,1870000
270560,202108,262,151,111,166100,122100,288200
270570,202108,528,372,156,409200,171600,580800
270580,202108,82,66,16,72600,17600,90200
270590,202108,60,47,13,51700,14300,66000
270600,202108,163,137,26,150700,28600,179300
270610,202108,238,184,54,202400,59400,261800
270620,202108,14,14,0,15400,0,15400
270630,202108,3720,2836,884,3124000,975700,4099700
270640,202108,861,646,215,710600,236500,947100
270642,202108,208,174,34,191400,37400,228800
270644,202108,254,170,84,187000,92400,279400
270650,202108,330,197,133,217800,146300,364100
270660,202108,200,173,27,190300,29700,220000
270670,202108,2976,2268,708,2495901.01,779900,3275801.01
270680,202108,415,256,159,281600,174900,456500
270690,202108,1203,801,402,883300,442200,1325500
270700,202108,26,21,5,23100,5500,28600
270710,202108,866,681,185,749100,203500,952600
270720,202108,231,182,49,200200,53900,254100
270730,202108,1893,1176,717,1293600,788700,2082300
270740,202108,40,27,13,29700,14300,44000
270750,202108,638,485,153,533500,168300,701800
270760,202108,301,216,85,237600,93500,331100
270770,202108,2762,1860,902,2048200,993300,3041500
270780,202108,63,41,22,46200,24200,70400
270790,202108,248,159,89,174900,97900,272800
270800,202108,2032,1625,407,1791900,447700,2239600
270810,202108,217,179,38,196900,41800,238700
270820,202108,129,92,37,101200,40700,141900
270830,202108,804,607,197,669900,216700,886600
270840,202108,1361,1044,317,1149500.4,349800,1499300.4
270850,202108,1507,959,548,1054936.66,602800,1657736.66
270860,202108,2553,1711,842,1882100.7,927300,2809400.7
270870,202108,116,65,51,71500,56100,127600
270880,202108,874,691,183,762300,201300,963600
270890,202108,276,209,67,229900,73700,303600
270895,202108,53,50,3,55000,3300,58300
270900,202108,71,58,13,63800,14300,78100
270910,202108,301,249,52,273900,57200,331100
270915,202108,1913,1251,662,1377200,729300,2106500
270920,202108,446,372,74,410300,81400,491700
270930,202108,5862,4455,1407,4902700,1547700.14,6450400.14
270940,202108,2220,1749,471,1923900,518100,2442000
280010,202108,38,32,6,35200,6600,41800
280020,202108,491,420,71,462000,78100,540100
280030,202108,20842,13507,7335,14870815.22,8075101.56,22945916.78
280040,202108,327,209,118,229900,129800,359700
280050,202108,414,321,93,353100,102300,455400
280060,202108,339,224,115,246400,127600,374000
280067,202108,1097,795,302,874500,332200.5,1206700.5
280070,202108,129,106,23,116600,25300,141900
280100,202108,640,494,146,543400.14,162800,706200.14
280110,202108,72,66,6,72600,6600,79200
280120,202108,658,549,109,603900,119900,723800
280130,202108,1741,1144,597,1258400,656700,1915100
280140,202108,495,411,84,452100,93500,545600
280150,202108,410,285,125,313500,137500,451000
280160,202108,131,106,25,116600,27500,144100
280170,202108,405,279,126,308000,138600,446600
280190,202108,28,23,5,25300,5500,30800
280200,202108,34,28,6,30800,6600,37400
280210,202108,2920,2108,812,2321000.5,893200,3214200.5
280220,202108,44,36,8,40700,8800,49500
280230,202108,328,269,59,297000,64900,361900
280240,202108,130,122,8,134200,8800,143000
280250,202108,20,11,9,12100,9900,22000
280260,202108,79,72,7,79200,7700,86900
280270,202108,144,111,33,122100,36300,158400
280280,202108,193,126,67,138600.5,73700,212300.5
280290,202108,3455,2504,951,2756529.5,1046100,3802629.5
280300,202108,1617,1273,344,1401400,380600,1782000
280310,202108,99,94,5,103400,5500,108900
280320,202108,651,458,193,504900,212300,717200
280330,202108,317,234,83,257400,91300,348700
280340,202108,428,344,84,378400,92400,470800
280350,202108,3737,2885,852,3176800.66,938300.08,4115100.74
280360,202108,475,327,148,359700,162800,522500
280370,202108,96,84,12,92400,13200,105600
280380,202108,49,37,12,40700,13200,53900
280390,202108,171,145,26,159500,28600,188100
280400,202108,359,245,114,269500,125400,394900
280410,202108,289,239,50,262900,55000,317900
280420,202108,142,123,19,135300,20900,156200
280430,202108,72,59,13,64900,14300,79200
280440,202108,731,584,147,642400,161700,804100
280445,202108,120,112,8,124300,8800,133100
280450,202108,1251,1076,175,1185800,192500,1378300
280460,202108,638,465,173,511500.93,190300,701800.93
280470,202108,112,102,10,112200,11000,123200
280480,202108,2794,1925,869,2118601.67,957000.5,3075602.17
280490,202108,204,194,10,213400.96,11000,224400.96
280500,202108,45,41,4,45100,4400,49500
280510,202108,134,108,26,118800,28600,147400
280520,202108,55,40,15,44000,16500,60500
280530,202108,80,50,30,56100,33000,89100
280540,202108,538,456,82,501600,90200,591800
280550,202108,733,676,57,744701.52,62700,807401.52
280560,202108,487,433,54,476300.85,59400,535700.85
280570,202108,2307,1831,476,2015200,523600,2538800
280580,202108,585,454,131,499400,144100,643500
280590,202108,212,138,74,152900,81400,234300
280600,202108,385,322,63,354251.7,70400,424651.7
280610,202108,113,83,30,91300,33000,124300
280620,202108,536,436,100,479600,110000,589600
280630,202108,157,131,26,144100,28600,172700
280640,202108,189,151,38,166100,41800,207900
280650,202108,91,59,32,64900,35200,100100
280660,202108,142,103,39,113300,42900,156200
280670,202108,1914,1200,714,1320000,785400,2105400
280680,202108,222,193,29,212300,31900,244200
280690,202108,84,72,12,79200,13200,92400
280700,202108,19,19,0,20900,0,20900
280710,202108,1477,1145,332,1259500.88,365200,1624700.88
280720,202108,119,78,41,85800,45100,130900
280730,202108,26,22,4,24200,4400,28600
280740,202108,2525,1891,634,2080100,697400,2777500
280750,202108,225,197,28,216700,30800,247500
280760,202108,832,570,262,627000,288200,915200
290010,202108,193,136,57,149600,62700,212300
290020,202108,192,174,18,191400,19800,211200
290030,202108,616,395,221,435600,243100,678700
290035,202108,135,110,25,121000,27500,148500
290040,202108,306,208,98,229900,107800,337700
290050,202108,85,68,17,74800,18700,93500
290060,202108,256,113,143,124300,157300,281600
290070,202108,5725,2734,2991,3011800.69,3293400,6305200.69
290080,202108,443,197,246,216700,272800,489500
290090,202108,369,165,204,181500,224400,405900
290100,202108,1662,1077,585,1185800,644600,1830400
290110,202108,842,496,346,546700.85,380600,927300.85
290115,202108,189,175,14,193600,15400,209000
290120,202108,778,524,254,577500,280500,858000
290130,202108,446,275,171,302500,188100,490600
290135,202108,302,232,70,255200,77000,332200
290140,202108,323,267,56,293700,61600,355300
290150,202108,133,91,42,100100,46200,146300
290160,202108,246,188,58,206800,63800,270600
290170,202108,95,66,29,72600,31900,104500
290180,202108,186,134,52,147400,57200,204600
290190,202108,377,298,79,327800,86900,414700
290195,202108,309,199,110,218900,121000,339900
290200,202108,268,221,47,243100,51700,294800
290205,202108,148,93,55,102300,62700,165000
290210,202108,1185,874,311,961400,342100,1303500
290220,202108,186,105,81,115500,89100,204600
290225,202108,284,115,169,126500,185900,312400
290230,202108,79,49,30,55000,33000,88000
290240,202108,359,124,235,136400,258500,394900
290250,202108,256,237,19,260700,20900,281600
290260,202108,321,264,57,291500,62700,354200
290265,202108,184,162,22,178200,24200,202400
290270,202108,1417,1182,235,1301300,258500,1559800
290280,202108,482,336,146,370700,160600,531300
290290,202108,1359,817,542,898700.5,596200,1494900.5
290300,202108,418,358,60,393800,66000,459800
290310,202108,287,136,151,149600,166100,315700
290320,202108,4089,2524,1565,2781900.11,1722600,4504500.11
290323,202108,191,166,25,182600,27500,210100
290327,202108,160,125,35,137500,38500,176000
290330,202108,120,61,59,67100,64900,132000
290340,202108,791,327,464,360800,510400,871200
290350,202108,657,402,255,442200,280500,722700
290360,202108,322,248,74,272800.99,81400,354200.99
290370,202108,915,402,513,442200,565400,1007600
290380,202108,328,212,116,233200,127600,360800
290390,202108,2415,1509,906,1661000,996600,2657600
290395,202108,237,136,101,149600,111100,260700
290400,202108,279,203,76,223300,83600,306900
290405,202108,247,214,33,235400,36300,271700
290410,202108,625,521,104,573100,114400,687500
290420,202108,260,211,49,232100,53900,286000
290430,202108,461,296,165,325600,181500,507100
290440,202108,78,69,9,75900,9900,85800
290450,202108,186,139,47,152900,51700,204600
290460,202108,1924,1155,769,1270500,845900,2116400
290470,202108,1355,595,760,655600,837100,1492700
290475,202108,555,522,33,574200.27,36300,610500.27
290480,202108,276,159,117,174900,128700,303600
290485,202108,237,217,20,238700,22000,260700
290490,202108,1254,895,359,986700,394900,1381600
290500,202108,744,386,358,424600,393800,818400
290510,202108,208,167,41,183700,45100,228800
290515,202108,160,96,64,105600,70400,176000
290520,202108,1403,915,488,1008700,536800.2,1545500.2
290530,202108,294,269,25,295900,27500,323400
290540,202108,111,57,54,62700,59400,122100
290550,202108,166,141,25,155100,27500,182600
290560,202108,3158,1376,1782,1514700,1960200,3474900
290570,202108,6264,3028,3236,3331900,3565100,6897000
290580,202108,1282,769,513,845900,564300,1410200
290590,202108,571,466,105,513700,115500,629200
290600,202108,1764,1217,547,1338700.67,601700,1940400.67
290610,202108,187,172,15,189200,16500,205700
290620,202108,364,328,36,361900,39600,401500
290630,202108,1978,855,1123,940500,1236400,2176900
290640,202108,140,113,27,124300,29700,154000
290650,202108,1793,843,950,928400.92,1046100,1974500.92
290660,202108,278,225,53,247500,58300,305800
290670,202108,950,488,462,537900,508200,1046100
290680,202108,1224,985,239,1083500,264000,1347500
290682,202108,318,238,80,261800.48,88000,349800.48
290685,202108,245,156,89,171600,97900,269500
290687,202108,1086,706,380,776779,418000,1194779
290689,202108,150,78,72,85800,79200,165000
290690,202108,602,256,346,282700,380600,663300
290700,202108,239,120,119,132000,130900,262900
290710,202108,773,525,248,577500,272800,850300
290720,202108,1035,836,199,920700,220000,1140700
290730,202108,1197,696,501,766700,551100,1317800
290740,202108,21,17,4,18700,4400,23100
290750,202108,1413,619,794,680900,875600,1556500
290755,202108,72,64,8,70400,8800,79200
290760,202108,264,230,34,253000,37400,290400
290770,202108,184,174,10,191400,11000,202400
290780,202108,1114,872,242,959200,266200,1225400
290790,202108,378,257,121,282700,133100,415800
290800,202108,2436,987,1449,1086800,1595000,2681800
290810,202108,479,328,151,360800,166100,526900
290820,202108,410,241,169,265100,185900,451000
290830,202108,421,301,120,331100,132000,463100
290840,202108,1799,1125,674,1238600,742500,1981100
290850,202108,894,460,434,506000,480700,986700
290860,202108,638,286,352,314600,388300,702900
290870,202108,614,437,177,480700.26,196900,677600.26
290880,202108,120,64,56,70400,61600,132000
290890,202108,424,271,153,299200,168300,467500
290900,202108,168,126,42,138600,46200,184800
290910,202108,388,296,92,325600,101200,426800
290920,202108,207,182,25,200200,27500,227700
290930,202108,524,405,119,445500,130900,576400
290940,202108,236,198,38,217800,41800,259600
290950,202108,161,95,66,104500,73700,178200
290960,202108,469,330,139,363000,154000,517000
290970,202108,245,216,29,237600,31900,269500
290980,202108,1704,1189,515,1310100,566500,1876600
290990,202108,400,336,64,370700,70400,441100
291000,202108,868,273,595,301400,655600,957000
291005,202108,2392,1034,1358,1137400,1493800.42,2631200.42
291010,202108,166,148,18,162800,19800,182600
291020,202108,104,81,23,89100,25300,114400
291030,202108,95,68,27,74800,29700,104500
291040,202108,620,354,266,389400,292600,682000
291050,202108,1466,797,669,878900,735900,1614800
291060,202108,1644,907,737,998800,814000,1812800
291070,202108,1968,1475,493,1622500.82,542301.3,2164802.12
291072,202108,7104,2649,4455,2918300,4907100,7825400
291075,202108,238,193,45,212300,49500,261800
291077,202108,59,40,19,44000,20900,64900
291080,202108,20455,8860,11595,9752600.75,12760000.55,22512601.30
291085,202108,269,222,47,245300,51700,297000
291090,202108,281,118,163,129800,179300,309100
291100,202108,635,194,441,213400,485100,698500
291110,202108,424,327,97,359700,106700,466400
291120,202108,2401,1232,1169,1356300,1285900,2642200
291125,202108,60,30,30,33000,33000,66000
291130,202108,196,173,23,190300,25300,215600
291140,202108,125,104,21,114400,23100,137500
291150,202108,386,148,238,162800,262900,425700
291160,202108,378,307,71,337700,78100,415800
291165,202108,49,38,11,41800,12100,53900
291170,202108,3168,1586,1582,1745700.5,1740200,3485900.5
291180,202108,1241,501,740,551100,814000,1365100
291185,202108,105,99,6,108900,6600,115500
291190,202108,1380,653,727,718300,799700,1518000
291200,202108,172,128,44,140800,48400,189200
291210,202108,2330,929,1401,1021900,1543300,2565200
291220,202108,288,219,69,242000,75900,317900
291230,202108,953,330,623,363000,685300,1048300
291240,202108,418,389,29,427900,31900,459800
291250,202108,433,351,82,387200,90200,477400
291260,202108,60,52,8,57200,8800,66000
291270,202108,1040,455,585,500500,645700,1146200
291280,202108,356,170,186,187000,204600,391600
291290,202108,1695,887,808,977900,888800,1866700
291300,202108,226,180,46,198000,50600,248600
291310,202108,229,205,24,225500,26400,251900
291320,202108,1344,946,398,1040600,437800,1478400
291330,202108,133,115,18,126500,19800,146300
291340,202108,221,133,88,146300,96800,243100
291345,202108,126,88,38,96800,41800,138600
291350,202108,1685,614,1071,675400,1179200,1854600
291360,202108,8305,3975,4330,4374700,4765200,9139900
291370,202108,1111,643,468,707300,514800,1222100
291380,202108,260,207,53,227700,58300,286000
291390,202108,3934,1751,2183,1926100,2402400,4328500
291400,202108,2070,1472,598,1621400,657801.27,2279201.27
291410,202108,191,163,28,179300,30800,210100
291420,202108,114,86,28,94600,30800,125400
291430,202108,166,96,70,105600,77000.5,182600.5
291440,202108,529,430,99,473000,108900,581900
291450,202108,942,611,331,672100,364100,1036200
291460,202108,1908,1533,375,1687400,412500,2099900
291465,202108,2214,1055,1159,1161600,1278200,2439800
291470,202108,2847,1432,1415,1576300.55,1559800,3136100.55
291480,202108,11718,5111,6607,5626501.62,7272100,12898601.62
291490,202108,616,248,368,273900,404800,678700
291500,202108,380,227,153,249700,168300,418000
291510,202108,1203,467,736,513700,811800,1325500
291520,202108,931,418,513,459800,564300,1024100
291530,202108,912,247,665,271700,732600,1004300
291535,202108,121,99,22,108900,24200,133100
291540,202108,360,118,242,129800,266200,396000
291550,202108,1280,600,680,660000,748000,1408000
291560,202108,5121,2570,2551,2828100,2807200,5635300
291570,202108,209,106,103,116600,113300,229900
291580,202108,1193,740,453,815100,498300,1313400
291590,202108,100,43,57,47300,62700,110000
291600,202108,1142,564,578,621500,635800,1257300
291610,202108,1428,699,729,772200,801900,1574100
291620,202108,564,265,299,291500,328900,620400
291630,202108,479,149,330,163900,363000,526900
291640,202108,3965,1989,1976,2189000,2173600,4362600
291650,202108,437,300,137,330000.5,151800,481800.5
291660,202108,372,149,223,163900,245300,409200
291670,202108,180,113,67,124300,73700,198000
291680,202108,629,385,244,423500,269500,693000
291685,202108,575,327,248,359700,272800,632500
291690,202108,482,307,175,337700,192500.92,530200.92
291700,202108,1011,788,223,866800,245300,1112100
291710,202108,1596,779,817,856900,900900,1757800
291720,202108,417,286,131,315700,144100,459800
291730,202108,945,551,394,607200,435600,1042800
291733,202108,291,197,94,216700,103400,320100
291735,202108,74,57,17,62700,18700,81400
291740,202108,340,257,83,282700,91300,374000
291750,202108,2237,1466,771,1613700.25,849200,2462900.25
291760,202108,2985,1652,1333,1818300,1467400,3285700
291770,202108,754,517,237,568700,260700,829400
291780,202108,64,38,26,41800,28600,70400
291790,202108,154,80,74,88000,81400,169400
291800,202108,10069,4219,5850,4640900.42,6439400,11080300.42
291810,202108,1087,817,270,898700,298100,1196800
291820,202108,276,199,77,220000,84700,304700
291830,202108,1032,419,613,460900.59,674300,1135200.59
291835,202108,554,514,40,565400,44000,609400
291840,202108,4970,2496,2474,2747800,2723600,5471400
291845,202108,267,83,184,91300,202400,293700
291850,202108,316,281,35,309100,38500,347600
291855,202108,253,105,148,115500,162800,278300
291860,202108,168,106,62,116600,68200,184800
291870,202108,81,36,45,39600,49500,89100
291875,202108,165,154,11,169400,12100,181500
291880,202108,434,350,84,385000,92400,477400
291890,202108,240,81,159,89100,174900,264000
291900,202108,57,32,25,35200,27500,62700
291905,202108,117,89,28,97900,30800,128700
291910,202108,159,127,32,139700,35200,174900
291915,202108,439,390,49,429000,53900,482900
291920,202108,5243,2605,2638,2867700,2904000,5771700
291930,202108,165,99,66,108900.27,72600,181500.27
291940,202108,365,211,154,232100,169400,401500
291950,202108,1140,909,231,1001000,254100,1255100
291955,202108,1308,800,508,881100,558800,1439900
291960,202108,196,145,51,159500,56100,215600
291970,202108,749,564,185,621500,203500,825000
291980,202108,1474,1291,183,1421200.73,201300,1622500.73
291990,202108,141,130,11,143000,12100,155100
291992,202108,170,90,80,99000,88000,187000
291995,202108,193,121,72,133100,79200,212300
292000,202108,403,303,100,333300,110000,443300
292010,202108,328,225,103,247500,113300,360800
292020,202108,303,222,81,244200,89100,333300
292030,202108,143,109,34,121000,37400,158400
292040,202108,607,311,296,343200,325600,668800
292045,202108,117,105,12,115500,13200,128700
292050,202108,933,673,260,743600,286000,1029600
292060,202108,887,727,160,799700,176000,975700
292070,202108,64,24,40,26400,44000,70400
292080,202108,146,102,44,112200,48400,160600
292090,202108,523,179,344,196900,378400,575300
292100,202108,1492,646,846,712800,930600,1643400
292105,202108,186,167,19,183700,20900,204600
292110,202108,2249,817,1432,899800,1575200,2475000
292120,202108,700,548,152,602800,167200,770000
292130,202108,452,254,198,279400,217800,497200
292140,202108,215,172,43,191400,47300,238700
292145,202108,155,83,72,91300,79200,170500
292150,202108,1493,1229,264,1351900,290400,1642300
292160,202108,162,132,30,145200,33000,178200
292170,202108,1174,1020,154,1123100,169400,1292500
292180,202108,225,167,58,183700,63800,247500
292190,202108,156,103,53,113300,58300,171600
292200,202108,1362,496,866,545600,954800,1500400
292205,202108,122,105,17,115500,18700,134200
292210,202108,375,260,115,286000,126500,412500
292220,202108,31,22,9,24200,9900,34100
292225,202108,43,36,7,39600,7700,47300
292230,202108,969,748,221,823900,243100,1067000
292240,202108,621,452,169,497200,185900,683100
292250,202108,1676,1093,583,1204500,641300,1845800
292260,202108,402,243,159,267300,174900,442200
292265,202108,245,181,64,199100,70400,269500
292270,202108,724,343,381,377300,419100,796400
292273,202108,209,121,88,133100,96800,229900
292275,202108,166,84,82,92400,90200,182600
292280,202108,145,102,43,112200,47300,159500
292285,202108,83,67,16,74800,17600,92400
292290,202108,578,388,190,427900,209000,636900
292300,202108,1723,647,1076,711700,1184700,1896400
292303,202108,122,78,44,85800,48400,134200
292305,202108,119,88,31,96800,34100,130900
292310,202108,948,621,327,683100,359700,1042800
292320,202108,585,442,143,486200,157300,643500
292330,202108,178,106,72,116600,79200,195800
292335,202108,288,228,60,250800,66000,316800
292340,202108,568,395,173,435600,190300,625900
292350,202108,268,149,119,163900,130900,294800
292360,202108,709,539,170,592900,187000,779900
292370,202108,743,567,176,623700,193600,817300
292380,202108,616,507,109,557700,119900,677600
292390,202108,391,158,233,173800,257400,431200
292400,202108,3596,2240,1356,2466200,1491600,3957800
292405,202108,269,179,90,196900,99000,295900
292410,202108,129,79,50,86900,55000,141900
292420,202108,291,253,38,278300,41800,320100
292430,202108,539,402,137,442200,150700,592900
292440,202108,627,529,98,581900.56,107800,689700.56
292450,202108,241,187,54,206800,59400,266200
292460,202108,541,405,136,446600,149600,596200
292465,202108,208,177,31,194700,34100,228800
292467,202108,143,87,56,95700,61600,157300
292470,202108,303,206,97,226600,106700,333300
292480,202108,388,267,121,293700,134200,427900
292490,202108,243,175,68,192500,74800,267300
292500,202108,862,398,464,437800.32,510400,948200.32
292510,202108,3502,1640,1862,1805100,2049300,3854400
292520,202108,1114,528,586,580800,645700,1226500
292525,202108,415,298,117,327800,128700,456500
292530,202108,4552,1812,2740,1996500.65,3017300,5013800.65
292540,202108,480,275,205,302500,225500,528000
292550,202108,1101,586,515,645700,568700,1214400
292560,202108,328,304,24,334400,26400,360800
292570,202108,308,241,67,265100,74800,339900
292575,202108,504,340,164,374000,180400,554400
292580,202108,999,669,330,735900,364100,1100000
292590,202108,568,498,70,547800,77000,624800
292593,202108,145,115,30,126500,33000,159500
292595,202108,201,160,41,176000,45100,221100
292600,202108,1266,919,347,1010900.63,381700,1392600.63
292610,202108,116,92,24,101200,26400,127600
292620,202108,539,459,80,504900,88000,592900
292630,202108,1506,831,675,914100,742500,1656600
292640,202108,852,590,262,649000,288200,937200
292650,202108,188,154,34,169400.5,37400,206800.5
292660,202108,1971,1396,575,1537800,634700.92,2172500.92
292665,202108,141,101,40,111100,44000,155100
292670,202108,402,317,85,348700,93500,442200
292680,202108,259,194,65,213400,71500,284900
292690,202108,200,143,57,157300,62700,220000
292700,202108,981,644,337,708400,370700,1079100
292710,202108,115,100,15,110000,16500,126500
292720,202108,937,538,399,591800,438900,1030700
292730,202108,200,96,104,105600,114400,220000
292740,202108,70366,34147,36219,37599103.04,39883800.59,77482903.63
292750,202108,393,282,111,310200,122100,432300
292760,202108,338,285,53,313500,58300,371800
292770,202108,835,357,478,392700,526900,919600
292780,202108,396,151,245,166100,269500,435600
292790,202108,776,404,372,444400,411400,855800
292800,202108,1272,757,515,832700,566500,1399200
292805,202108,385,123,262,135300,289300,424600
292810,202108,1797,1070,727,1178100,799700,1977800
292820,202108,702,592,110,651200,121000,772200
292830,202108,116,93,23,102300,25300,127600
292840,202108,688,560,128,617100,140800,757900
292850,202108,139,92,47,101200,51700,152900
292860,202108,2134,1250,884,1375000,972400,2347400
292870,202108,3557,2358,1199,2593800,1318900,3912700
292880,202108,1465,984,481,1083500,531300,1614800
292890,202108,526,441,85,485100,93500,578600
292895,202108,147,99,48,108900,52800,161700
292900,202108,365,259,106,284900,116600,401500
292905,202108,477,237,240,260700,264000,524700
292910,202108,467,350,117,386100,128700,514800
292920,202108,531,233,298,256300,327800,584100
292925,202108,480,440,40,484000,44000,528000
292930,202108,637,387,250,426800,276100,702900
292935,202108,283,120,163,132000,179300,311300
292937,202108,225,154,71,169400,78100,247500
292940,202108,188,144,44,159500,49500,209000
292950,202108,1203,604,599,664400,658900.6,1323300.6
292960,202108,554,389,165,427900,182600,610500
292970,202108,235,165,70,181500.48,77000,258500.48
292975,202108,97,57,40,62700,45100,107800
292980,202108,301,204,97,224400.61,106700,331100.61
292990,202108,1317,977,340,1075800,374000,1449800
293000,202108,111,78,33,85800,36300,122100
293010,202108,2887,1713,1174,1885400,1292500.5,3177900.5
293015,202108,624,511,113,563200,124300,687500
293020,202108,332,270,62,297000,68200,365200
293030,202108,586,516,70,568700,77000,645700
293040,202108,369,294,75,324500,82500,407000
293050,202108,2934,1744,1190,1918400,1311200,3229600
293060,202108,252,201,51,221100.48,56100,277200.48
293070,202108,3563,1804,1759,1986600.18,1936000,3922600.18
293075,202108,90,61,29,67100,31900,99000
293076,202108,76,56,20,61600,22000,83600
293077,202108,560,322,238,354200,261800,616000
293080,202108,430,385,45,423500,49500,473000
293090,202108,129,117,12,128700,13200,141900
293100,202108,536,372,164,409200,180400,589600
293105,202108,344,254,90,280500,99000,379500
293110,202108,120,85,35,93500,38500,132000
293120,202108,303,208,95,228800,104500,333300
293130,202108,250,170,80,187000,88000,275000
293135,202108,8082,3129,4953,3441900,5451600,8893500
293140,202108,189,114,75,125400,83600,209000
293150,202108,310,270,40,297000,44000,341000
293160,202108,422,254,168,279400,185900,465300
293170,202108,192,127,65,139700,71500,211200
293180,202108,555,382,173,420200,190300,610500
293190,202108,1356,935,421,1030700.7,463100,1493800.7
293200,202108,554,489,65,537900,71500,609400
293210,202108,405,314,91,345400,100100,445500
293220,202108,2401,1039,1362,1144000,1500400,2644400
293230,202108,1847,687,1160,755700.1,1279300,2035000.1
293240,202108,235,215,20,236500,22000,258500
293245,202108,129,109,20,119900,22000,141900
293250,202108,755,293,462,322300.22,508200,830500.22
293260,202108,306,251,55,276100,60500,336600
293270,202108,1142,519,623,570900,686400,1257300
293280,202108,294,173,121,190300,133100,323400
293290,202108,3043,1973,1070,2174700,1177000,3351700
293300,202108,768,541,227,595100,249700,844800
293305,202108,201,158,43,173800,47300,221100
293310,202108,168,127,41,139700,45100,184800
293315,202108,170,131,39,144100,42900,187000
293317,202108,89,64,25,70400,27500,97900
293320,202108,1087,596,491,655600,540100,1195700
293325,202108,192,70,122,77000,134200,211200
293330,202108,13771,6358,7413,6998201.18,8156500,15154701.18
293340,202108,289,201,88,221100,96800,317900
293345,202108,260,212,48,233200,52800,286000
293350,202108,593,350,243,387200,267300,654500
293360,202108,1515,1086,429,1195700,471900,1667600
310010,202108,148,77,71,84700,78100,162800
310020,202108,1022,560,462,617100,509300,1126400
310030,202108,326,262,64,288200,70400,358600
310040,202108,44,27,17,29700,18700,48400
310050,202108,170,107,63,117700,69300,187000
310060,202108,263,179,84,196900,92400,289300
310070,202108,14,8,6,8800,6600,15400
310080,202108,43,27,16,29700,17600,47300
310090,202108,1053,562,491,619300,542300,1161600
310100,202108,308,221,87,243100,95700,338800
310110,202108,708,382,326,421300,358600,779900
310120,202108,382,220,162,242000,179300,421300
310130,202108,30,17,13,18700,14300,33000
310140,202108,24,9,15,9900,16500,26400
310150,202108,1165,779,386,858000,427900,1285900
310160,202108,2051,997,1054,1097800,1161600,2259400
310163,202108,89,47,42,51700,46200,97900
310170,202108,2533,1127,1406,1239700,1547700,2787400
310180,202108,157,58,99,63800,108900,172700
310190,202108,478,323,155,355300,170500,525800
310200,202108,470,300,170,331100,187000,518100
310205,202108,61,40,21,44000,23100,67100
310210,202108,269,219,50,240900,55000,295900
310220,202108,62,34,28,37400,30800,68200
310230,202108,277,192,85,211200,93500,304700
310240,202108,111,96,15,105600,16500,122100
310250,202108,98,77,21,84700,23100,107800
310260,202108,732,386,346,424600.92,381700,806300.92
310270,202108,269,168,101,184800,111100,295900
310280,202108,382,278,104,306900,114400,421300
310285,202108,208,152,56,167200,61600,228800
310290,202108,232,131,101,144100,111100,255200
310300,202108,168,136,32,149600,35200,184800
310310,202108,10,7,3,7700,3300,11000
310320,202108,28,8,20,8800,22000,30800
310330,202108,41,26,15,28600,16500,45100
310340,202108,1838,1239,599,1366200,658900,2025100
310350,202108,2743,1456,1287,1601600,1422300,3023900
310360,202108,46,39,7,42900,7700,50600
310370,202108,130,107,23,117700,25300,143000
310375,202108,106,39,67,42900,73700,116600
310380,202108,49,29,20,31900,22000,53900
310390,202108,107,66,41,72600,45100,117700
310400,202108,2382,1528,854,1681900,939400,2621300
310410,202108,120,68,52,74800,57200,132000
310420,202108,654,335,319,369600,352000,721600
310430,202108,276,167,109,183700,119900,303600
310440,202108,73,42,31,46200,34100,80300
310445,202108,78,65,13,71500,14300,85800
310450,202108,626,397,229,436700,251900,688600
310460,202108,252,176,76,193600,83600,277200
310470,202108,509,329,180,361900,198000,559900
310480,202108,87,54,33,60500,36300,96800
310490,202108,533,245,288,269500,316800,586300
310500,202108,133,51,82,56100,90200,146300
310510,202108,597,418,179,459800,196900,656700
310520,202108,141,101,40,111100,44000,155100
310530,202108,106,43,63,47300,69300,116600
310540,202108,467,270,197,297000,217800,514800
310550,202108,72,48,24,52800,26400,79200
310560,202108,2991,2032,959,2236300,1054900,3291200
310570,202108,95,57,38,62700,41800,104500
310590,202108,365,225,140,247500,154000,401500
310600,202108,147,78,69,85800,77000,162800
310610,202108,54,21,33,24200,36300,60500
310620,202108,47124,22130,24994,24370418.61,27518700,51889118.61
310630,202108,676,408,268,449900,295900,745800
310640,202108,132,96,36,105600,39600,145200
310650,202108,157,141,16,155100,17600,172700
310660,202108,104,72,32,79200,35200,114400
310665,202108,62,45,17,49500,18700,68200
310670,202108,6861,2940,3921,3240600,4321900,7562500
310680,202108,66,41,25,45100,27500,72600
310690,202108,619,434,185,477400,203500,680900
310700,202108,65,40,25,45100,27500,72600
310710,202108,1313,890,423,978213.5,465300,1443513.5
310720,202108,145,39,106,42900,116600,159500
310730,202108,1494,1020,474,1122000,522500,1644500
310740,202108,995,550,445,606100,490600,1096700
310750,202108,247,154,93,169400,102300,271700
310760,202108,71,53,18,58300,19800,78100
310770,202108,92,47,45,51700,49500,101200
310780,202108,357,284,73,313500,80300,393800
310790,202108,107,87,20,95700,22000,117700
310800,202108,460,217,243,238700,267300,506000
310810,202108,175,120,55,132000.72,60500,192500.72
310820,202108,325,259,66,284900,72600,357500
310825,202108,204,174,30,191400,33000,224400
310830,202108,472,222,250,244200,275000,519200
310840,202108,361,207,154,227700,169400,397100
310850,202108,81,67,14,73700,15400,89100
310855,202108,401,313,88,344300,97900,442200
310860,202108,1596,1177,419,1295800,462000,1757800
310870,202108,51,43,8,47300,9900,57200
310880,202108,84,67,17,73700,18700,92400
310890,202108,310,175,135,192500,148500,341000
310900,202108,635,279,356,306906.48,391611.52,698518.00
310910,202108,235,159,76,176000,83600,259600
310920,202108,444,257,187,283800,205700,489500
310925,202108,35,27,8,29700,8800,38500
310930,202108,1292,833,459,917400,504900,1422300
310940,202108,689,342,347,377300.93,381700,759000.93
310945,202108,118,73,45,80300,49500,129800
310950,202108,227,182,45,200200,49500,249700
310960,202108,74,23,51,25300,56100,81400
310970,202108,165,102,63,112200,69300,181500
310980,202108,45,29,16,31900,17600,49500
310990,202108,168,89,79,97900,86900,184800
311000,202108,818,392,426,431200.1,469700,900900.1
311010,202108,51,43,8,47300,8800,56100
311020,202108,44,24,20,26400,22000,48400
311030,202108,386,217,169,239800,185900,425700
311040,202108,40,31,9,34100,9900,44000
311050,202108,481,180,301,198000,332200,530200
311060,202108,779,433,346,477400,380600,858000
311070,202108,329,145,184,159500,203500,363000
311080,202108,107,61,46,67100,50600,117700
311090,202108,333,158,175,173800,193600,367400
311100,202108,565,332,233,365200,256300,621500
311110,202108,705,500,205,550000,225500,775500
311115,202108,75,54,21,59400,23100,82500
311120,202108,1066,567,499,624800,550000,1174800
311130,202108,306,180,126,198000,138600,336600
311140,202108,161,83,78,91300,85800,177100
311150,202108,352,225,127,247500,139700,387200
311160,202108,730,517,213,568700,234300,803000
311170,202108,89,72,17,79200,18700,97900
311180,202108,299,200,99,220000,108900,328900
311190,202108,42,17,25,18700,27500,46200
311200,202108,349,242,107,267300,117700,385000
311205,202108,33,24,9,26400,9900,36300
311210,202108,41,36,5,39600,5500,45100
311220,202108,29,25,4,27500,4400,31900
311230,202108,1629,1069,560,1177000,617100,1794100
311240,202108,201,126,75,138600,82500,221100
311250,202108,56,21,35,23100,38500,61600
311260,202108,554,349,205,383900,225500,609400
311265,202108,126,86,40,94600,45100,139700
311270,202108,293,203,90,223300,99000,322300
311280,202108,193,85,108,93500,118800,212300
311290,202108,105,87,18,95700,19800,115500
311300,202108,578,368,210,405900,231000,636900
311310,202108,19,15,4,16500,4400,20900
311320,202108,638,472,166,520300,182600,702900
311330,202108,1086,798,288,877800,316800,1194600
311340,202108,2620,1853,767,2040500,844800,2885300
311350,202108,270,208,62,228800,68200,297000
311360,202108,178,105,73,115500,80300,195800
311370,202108,1226,506,720,556600,793100,1349700
311380,202108,7,6,1,6600,1100,7700
311390,202108,251,140,111,154000,122100,276100
311400,202108,141,84,57,92400,62700,155100
311410,202108,114,56,58,61600,63800,125400
311420,202108,315,169,146,185900,160600,346500
311430,202108,819,544,275,598400,302500,900900
311440,202108,455,315,140,346500,154000,500500
311450,202108,298,179,119,196900,130900,327800
311455,202108,274,188,86,206800,94600,301400
311460,202108,134,57,77,62700,84700,147400
311470,202108,30,15,15,16500,16500,33000
311480,202108,48,24,24,26400,27500,53900
311490,202108,11,7,4,7700,4400,12100
311500,202108,27,13,14,14300,15400,29700
311510,202108,658,451,207,496100,228800,724900
311520,202108,40,32,8,35200,8800,44000
311530,202108,1815,1308,507,1441000,558800,1999800
311535,202108,64,43,21,47300,23100,70400
311540,202108,34,29,5,31900,5500,37400
311545,202108,161,117,44,128700,48400,177100
311547,202108,43,33,10,36300,11000,47300
311550,202108,670,293,377,322300,416900,739200
311560,202108,45,27,18,29700,19800,49500
311570,202108,282,189,93,209000,102300,311300
311580,202108,383,228,155,250800,170500,421300
311590,202108,30,26,4,28600,4400,33000
311600,202108,98,79,19,86900,20900,107800
311610,202108,246,211,35,232100,38500,270600
311615,202108,118,94,24,103400,26400,129800
311620,202108,25,15,10,16500,11000,27500
311630,202108,88,75,13,82500,14300,96800
311640,202108,147,72,75,79200,82500,161700
311650,202108,125,85,40,93500,44000,137500
311660,202108,407,196,211,216700,232100,448800
311670,202108,143,96,47,105600,51700,157300
311680,202108,210,159,51,174900,56100,231000
311690,202108,14,11,3,12100,3300,15400
311700,202108,194,139,55,152900,60500,213400
311710,202108,186,125,61,137500,67100,204600
311720,202108,39,28,11,30800,12100,42900
311730,202108,568,384,184,422400,202400,624800
311740,202108,26,18,8,19800,8800,28600
311750,202108,730,491,239,541200.7,262900,804100.7
311760,202108,72,31,41,34100,45100,79200
311770,202108,381,184,197,203500,216700,420200
311780,202108,187,92,95,101200,104500,205700
311783,202108,89,82,7,90200,7700,97900
311787,202108,36,13,23,14300,25300,39600
311790,202108,266,113,153,124300,168300,292600
311800,202108,682,438,244,481800,271700,753500
311810,202108,49,39,10,42900,11000,53900
311820,202108,121,98,23,107800,25300,133100
311830,202108,1885,1145,740,1262800,814000,2076800
311840,202108,1009,559,450,614900,496100,1111000
311850,202108,15,11,4,12100,4400,16500
311860,202108,9591,4103,5488,4522100,6043400,10565500
311870,202108,113,62,51,68200,56100,124300
311880,202108,944,682,262,751300,290400,1041700
311890,202108,201,98,103,107709,113300,221009
311900,202108,68,28,40,30800,44000,74800
311910,202108,1367,852,515,937200,566500,1503700
311920,202108,228,154,74,169400,82500,251900
311930,202108,906,512,394,563200,433400,996600
311940,202108,2555,1341,1214,1476200,1336500,2812700
311950,202108,64,42,22,46200,24200,70400
311960,202108,64,44,20,48400,22000,70400
311970,202108,25,14,11,15400,12100,27500
311980,202108,43,33,10,36300,11000,47300
311990,202108,35,25,10,27500,11000,38500
311995,202108,50,30,20,33000,22000,55000
312000,202108,22,16,6,17600,6600,24200
312010,202108,75,58,17,63800,18700,82500
312015,202108,71,54,17,59400,18700,78100
312020,202108,131,89,42,97900,46200,144100
312030,202108,65,49,16,53900,17600,71500
312040,202108,77,48,29,52800,31900,84700
312050,202108,199,112,87,123200,95700,218900
312060,202108,22,13,9,14300,9900,24200
312070,202108,78,49,29,53900,31900,85800
312080,202108,536,245,291,270600,320100,590700
312083,202108,59,36,23,39600,25300,64900
312087,202108,95,72,23,79200,25300,104500
312090,202108,3276,1974,1302,2174700,1433300,3608000
312100,202108,145,101,44,110847,49500,160347
312110,202108,114,67,47,73700,51700,125400
312120,202108,128,93,35,102300.63,38500,140800.63
312125,202108,87,51,36,56100,39600,95700
312130,202108,135,88,47,96800,51700,148500
312140,202108,139,108,31,118800,34100,152900
312150,202108,41,32,9,35200,9900,45100
312160,202108,1510,984,526,1084699,578600,1663299
312170,202108,11,8,3,8800,3300,12100
312180,202108,110,70,40,77000,44000,121000
312190,202108,36,32,4,35200,4400,39600
312200,202108,747,640,107,704000,117700,821700
312210,202108,119,62,57,68200,62700,130900
312220,202108,129,98,31,107800,34100,141900
312230,202108,3694,1691,2003,1863400,2205500,4068900
312235,202108,153,102,51,112200,56100,168300
312240,202108,85,59,26,64900,28600,93500
312245,202108,190,129,61,143000,67100,210100
312247,202108,77,55,22,60500,24200,84700
312250,202108,165,80,85,88000,93500,181500
312260,202108,107,73,34,80300,37400,117700
312270,202108,133,79,54,86900,59400,146300
312280,202108,30,15,15,16500,16500,33000
312290,202108,139,93,46,102300,50600,152900
312300,202108,198,129,69,141900,75900,217800
312310,202108,61,54,7,59400,7700,67100
312320,202108,423,266,157,292600,172700,465300
312330,202108,88,76,12,83600,13200,96800
312340,202108,33,15,18,16500,19800,36300
312350,202108,14,8,6,8800,6600,15400
312352,202108,97,70,27,77000,29700,106700
312360,202108,560,232,328,255200,361900,617100
312370,202108,325,185,140,203500,154000,357500
312380,202108,141,93,48,102300,52800,155100
312385,202108,155,127,28,139700,30800,170500
312390,202108,296,189,107,207900,118800,326700
312400,202108,382,282,100,310200,110000,420200
312410,202108,1090,349,741,383900,815100,1199000
312420,202108,624,470,154,519200,170500,689700
312430,202108,879,636,243,699600.5,267300,966900.5
312440,202108,42,31,11,34100,12100,46200
312450,202108,197,126,71,138600,78100,216700
312460,202108,30,15,15,16500,16500,33000
312470,202108,42,27,15,29700,16500,46200
312480,202108,172,105,67,115500,73700,189200
312490,202108,279,188,91,206800,100100,306900
312500,202108,39,23,16,25300,17600,42900
312510,202108,521,195,326,217800,360800,578600
312520,202108,29,9,20,9900,22000,31900
312530,202108,38,28,10,30800,11000,41800
312540,202108,87,78,9,85800,9900,95700
312550,202108,39,31,8,34100,8800,42900
312560,202108,201,152,49,167200,53900,221100
312570,202108,438,260,178,286000,195800,481800
312580,202108,95,51,44,56100,48400,104500
312590,202108,235,186,49,204600,53900,258500
312595,202108,130,110,20,121000,22000,143000
312600,202108,67,34,33,37400,36300,73700
312610,202108,1569,807,762,887700,839300,1727000
312620,202108,226,161,65,178200,71500,249700
312630,202108,71,58,13,63800,14300,78100
312640,202108,42,11,31,12100,34100,46200
312650,202108,148,123,25,135670.7,27500,163170.7
312660,202108,98,68,30,74800.01,33000,107800.01
312670,202108,926,593,333,652300,367400,1019700
312675,202108,31,26,5,28600,5500,34100
312680,202108,65,39,26,42900,28600,71500
312690,202108,238,117,121,128700,133100,261800
312695,202108,26,22,4,24200,4400,28600
312700,202108,232,134,98,147400,107800,255200
312705,202108,83,66,17,72600,18700,91300
312707,202108,135,96,39,105600,42900,148500
312710,202108,1853,1002,851,1103300.59,937200,2040500.59
312720,202108,50,29,21,31900,23100,55000
312730,202108,274,158,116,173800,127600,301400
312733,202108,47,36,11,39600,12100,51700
312735,202108,19,13,6,14300,6600,20900
312737,202108,68,37,31,40700,34100,74800
312738,202108,63,41,22,45100,24200,69300
312740,202108,82,55,27,60500,29700,90200
312750,202108,90,63,27,69300,29700,99000
312760,202108,283,200,83,220000,91300,311300
312770,202108,8269,3793,4476,4178900,4932400,9111300
312780,202108,441,338,103,371800,113300,485100
312790,202108,23,16,7,17600,7700,25300
312800,202108,1595,1112,483,1227600,531300,1758900
312810,202108,353,234,119,257400,132000,389400
312820,202108,184,142,42,156200,46200,202400
312825,202108,32,22,10,24200,11000,35200
312830,202108,204,120,84,132000,92400,224400
312840,202108,167,113,54,124300,60500,184800
312850,202108,41,36,5,39600,5500,45100
312860,202108,147,95,52,104500,57200,161700
312870,202108,1080,559,521,616000,573100,1189100
312880,202108,123,85,38,93500,42900,136400
312890,202108,163,116,47,127600,51700,179300
312900,202108,186,137,49,150700,53900,204600
312910,202108,175,97,78,106700,86900,193600
312920,202108,133,73,60,80300,66000,146300
312930,202108,321,222,99,245300,108900,354200
312940,202108,124,86,38,94600,41800,136400
312950,202108,687,467,220,513700,242000,755700
312960,202108,152,114,38,126500,41800,168300
312965,202108,99,77,22,84700,24200,108900
312970,202108,280,229,51,251900,56100,308000
312980,202108,2513,1274,1239,1401400,1364000,2765400
312990,202108,51,25,26,27500,28600,56100
313000,202108,54,30,24,33000,26400,59400
313005,202108,179,135,44,148500,49500,198000
313010,202108,926,374,552,412500,607200,1019700
313020,202108,204,105,99,115500,108900,224400
313030,202108,195,125,70,137500,77000,214500
313040,202108,78,23,55,25300,60500,85800
313050,202108,189,138,51,152900,56100,209000
313055,202108,39,30,9,33000,9900,42900
313060,202108,132,89,43,97900,47300,145200
313065,202108,62,45,17,49500,18700,68200
313070,202108,132,70,62,77000,68200,145200
313080,202108,34,15,19,16500,20900,37400
313090,202108,678,437,241,480700,265100,745800
313100,202108,195,68,127,74800,139700,214500
313110,202108,148,76,72,83600,79200,162800
313115,202108,221,124,97,136400,106700,243100
313120,202108,844,472,372,519200,409200,928400
313130,202108,5901,3216,2685,3542000.48,2955700,6497700.48
313140,202108,132,72,60,79200,66000,145200
313150,202108,291,231,60,254100,66000,320100
313160,202108,185,138,47,151800,51700,203500
313170,202108,1386,914,472,1006500,519200,1525700
313180,202108,307,178,129,195800,141900,337700
313190,202108,724,429,295,471900,326700,798600
313200,202108,30,24,6,26400,6600,33000
313210,202108,1000,850,150,935000,165000,1100000
313220,202108,289,174,115,192500,126500,319000
313230,202108,256,199,57,218900.5,62700,281600.5
313240,202108,2178,1097,1081,1208900,1191300,2400200
313250,202108,1256,956,300,1052700,330000,1382700
313260,202108,94,47,47,51700,51700,103400
313270,202108,996,577,419,634700,460900,1095600
313280,202108,47,39,8,42900,8800,51700
313290,202108,215,173,42,190300,46200,236500
313300,202108,331,167,164,184800,180400,365200
313310,202108,248,112,136,124300,149600,273900
313320,202108,381,280,101,308000,111100,419100
313330,202108,1415,857,558,943800,613800,1557600
313340,202108,324,232,92,255200,101200,356400
313350,202108,475,311,164,342100,180400,522500
313360,202108,160,74,86,81400,94600,176000
313370,202108,229,78,151,85800,166100,251900
313375,202108,302,176,126,193600,138600,332200
313380,202108,1340,705,635,775500,699600,1475100
313390,202108,47,45,2,49500,2200,51700
313400,202108,394,270,124,297000,136400,433400
313410,202108,31,15,16,16500,17600,34100
313420,202108,4526,2436,2090,2681800,2301200,4983000
313430,202108,135,67,68,73700,74800,148500
313440,202108,1382,962,420,1058201.13,463100,1521301.13
313450,202108,66,29,37,31900,40700,72600
313460,202108,384,165,219,181500,240900,422400
313470,202108,533,249,284,275000,312400,587400
313480,202108,144,107,37,117700,40700,158400
313490,202108,527,238,289,261800,319000,580800
313500,202108,30,17,13,18700,14300,33000
313505,202108,1052,819,233,902000,256300,1158300
313507,202108,92,56,36,61600,39600,101200
313510,202108,2876,1812,1064,1995516.9,1172600,3168116.9
313520,202108,3451,2696,755,2968901.5,831600,3800501.5
313530,202108,34,22,12,24200,13200,37400
313535,202108,70,56,14,61600,15400,77000
313540,202108,69,51,18,56100,19800,75900
313545,202108,117,101,16,111100,17600,128700
313550,202108,224,187,37,205700,40700,246400
313560,202108,348,166,182,182600,200200,382800
313570,202108,67,20,47,22000,51700,73700
313580,202108,1319,741,578,816200,638000,1454200
313590,202108,66,38,28,41800,30800,72600
313600,202108,678,406,272,447700,299200,746900
313610,202108,51,43,8,47300,8800,56100
313620,202108,1377,675,702,742500,774400,1516900
313630,202108,1607,1206,401,1327700,441100,1768800
313640,202108,119,71,48,78100,52800,130900
313650,202108,236,113,123,124300,135300,259600
313652,202108,23,22,1,24200,1100,25300
313655,202108,69,43,26,47300,28600,75900
313657,202108,45,41,4,45100,4400,49500
313660,202108,126,83,43,91300,48419.8,139719.8
313665,202108,661,302,359,332200,396000,728200
313670,202108,10333,7043,3290,7758300,3621200,11379500
313680,202108,43,33,10,36300,11000,47300
313690,202108,132,97,35,106700,38500,145200
313695,202108,74,57,17,62700,18700,81400
313700,202108,317,251,66,276100,72600,348700
313710,202108,136,100,36,110000,39600,149600
313720,202108,1139,528,611,580800,672100.64,1252900.64
313730,202108,73,43,30,47300,33000,80300
313740,202108,146,116,30,127600,33000,160600
313750,202108,416,296,120,326700,132000,458700
313753,202108,226,166,60,182600,66000,248600
313760,202108,1337,489,848,540100,932800,1472900
313770,202108,387,270,117,297000,128700,425700
313780,202108,806,420,386,462000,424600,886600
313790,202108,28,27,1,29700,1100,30800
313800,202108,146,87,59,95700,64900,160600
313810,202108,83,49,34,53900,37400,91300
313820,202108,1332,622,710,684200,781000,1465200
313830,202108,55,39,16,44000,17600,61600
313835,202108,57,48,9,52800,9900,62700
313840,202108,1634,961,673,1058200,740300.06,1798500.06
313850,202108,209,83,126,91300,138600,229900
313860,202108,467,357,110,392700,121000,513700
313862,202108,164,108,56,118800,62700,181500
313865,202108,141,98,43,107800,47300,155100
313867,202108,54,44,10,48400,11000,59400
313868,202108,39,23,16,25300,17600,42900
313870,202108,104,58,46,63800,50600,114400
313880,202108,380,235,145,258500,160600,419100
313890,202108,329,173,156,190300,171600,361900
313900,202108,837,453,384,498300.66,422400,920700.66
313910,202108,145,99,46,108900,50600,159500
313920,202108,629,438,191,481800,210100.94,691900.94
313925,202108,32,27,5,29700,5500,35200
313930,202108,871,678,193,749100,212300,961400
313940,202108,1865,1130,735,1245200,809600,2054800
313950,202108,859,533,326,586300,358600,944900
313960,202108,1425,818,607,900900,667700,1568600
313970,202108,181,113,68,124300,74800,199100
313980,202108,203,134,69,147400,75900,223300
313990,202108,242,157,85,172700,93500,266200
314000,202108,868,565,303,623700,334400,958100
314010,202108,83,47,36,51700,39600,91300
314015,202108,69,18,51,19800,56100,75900
314020,202108,55,33,22,36300,24200,60500
314030,202108,74,35,39,38500,42900,81400
314040,202108,50,27,23,29700,25300,55000
314050,202108,288,171,117,189200,128700,317900
314053,202108,105,66,39,72600,42900,115500
314055,202108,292,181,111,199100,123200,322300
314060,202108,127,110,17,121000.83,18700,139700.83
314070,202108,1048,527,521,580800,573100,1153900
314080,202108,208,132,76,145200,83600,228800
314085,202108,159,108,51,118800,57200,176000
314090,202108,377,266,111,292600,122100,414700
314100,202108,514,409,105,449900,115500,565400
314110,202108,783,370,413,407000,454300,861300
314120,202108,72,40,32,44000,35200,79200
314130,202108,23,15,8,16500,8800,25300
314140,202108,1097,674,423,741400,466400,1207800
314150,202108,190,123,67,135300,73700,209000
314160,202108,318,238,80,262900,89100,352000
314170,202108,82,63,19,69300,20900,90200
314180,202108,742,653,89,718300,97900,816200
314190,202108,92,56,36,61600,39600,101200
314200,202108,503,342,161,376200.4,177100,553300.4
314210,202108,248,188,60,206800,66000,272800
314220,202108,295,211,84,234300,92400,326700
314225,202108,59,41,18,45100,19800,64900
314230,202108,111,49,62,53900,68200,122100
314240,202108,161,114,47,125400,51700,177100
314250,202108,59,35,24,38500,26400,64900
314260,202108,219,108,111,118800,122100,240900
314270,202108,400,312,88,343200,96800,440000
314280,202108,735,391,344,430051.41,379500,809551.41
314290,202108,536,422,114,464200,125400,589600
314300,202108,345,256,89,281600,97900,379500
314310,202108,1343,924,419,1018875,460900,1479775
314315,202108,37,28,9,30800,9900,40700
314320,202108,578,386,192,424600,212300,636900
314330,202108,11398,5576,5822,6141300,6411900.42,12553200.42
314340,202108,601,267,334,293700,367400,661100
314345,202108,52,36,16,39600,17600,57200
314350,202108,176,109,67,119900,73700,193600
314360,202108,58,34,24,37400,26400,63800
314370,202108,71,48,23,52800,25300,78100
314380,202108,102,64,38,70400,41800,112200
314390,202108,3327,2128,1199,2349600,1322200,3671800
314400,202108,679,480,199,528000,218900,746900
314410,202108,487,314,173,346500,191400,537900
314420,202108,16,7,9,7700,9900,17600
314430,202108,2436,896,1540,986701.51,1695100,2681801.51
314435,202108,175,103,72,113300,79200,192500
314437,202108,31,20,11,22000,12100,34100
314440,202108,97,65,32,72600,35200,107800
314450,202108,163,110,53,121000,58300,179300
314460,202108,628,299,329,328900,363000,691900
314465,202108,98,59,39,64900,42900,107800
314467,202108,74,59,15,64900,16500,81400
314470,202108,399,201,198,221100,217800,438900
314480,202108,1018,463,555,509300,610500,1119800
314490,202108,43,25,18,27500,19800,47300
314500,202108,284,199,85,218900,93500,312400
314505,202108,104,65,39,71500,42900,114400
314510,202108,250,202,48,222200,52800,275000
314520,202108,1346,716,630,787600,693000,1480600
314530,202108,735,582,153,642400.7,168300,810700.7
314535,202108,168,102,66,112200,72600,184800
314537,202108,62,36,26,39600,28600,68200
314540,202108,18,11,7,12100,7700,19800
314545,202108,56,37,19,40700,20900,61600
314550,202108,75,38,37,41800,40700,82500
314560,202108,855,460,395,506000,434500,940500
314570,202108,21,15,6,16500,6600,23100
314580,202108,12,5,7,5500,7700,13200
314585,202108,25,17,8,18700,8800,27500
314587,202108,84,72,12,79200,13200,92400
314590,202108,568,397,171,436700,188100,624800
314600,202108,946,599,347,658900,382800,1041700
314610,202108,944,485,459,533500,506000,1039500
314620,202108,143,105,38,115500,41800,157300
314625,202108,96,70,26,77000,28600,105600
314630,202108,1144,607,537,668800.79,590700,1259500.79
314640,202108,85,55,30,60500,33000,93500
314650,202108,172,93,79,102300,86900,189200
314655,202108,62,45,17,49500,18700,68200
314660,202108,17,13,4,14300,4400,18700
314670,202108,205,156,49,171600,53900,225500
314675,202108,208,126,82,138600,90200,228800
314690,202108,574,307,267,338800,295900,634700
314700,202108,2251,1197,1054,1320000,1160500,2480500
314710,202108,1764,991,773,1092300,850300,1942600
314720,202108,393,222,171,245300,188100,433400
314730,202108,505,266,239,292600,264000,556600
314740,202108,749,351,398,387200,438900,826100
314750,202108,18,15,3,16500,3300,19800
314760,202108,362,158,204,173800,224400,398200
314770,202108,107,72,35,79200,38500,117700
314780,202108,22,9,13,9900,14300,24200
314790,202108,2449,1537,912,1692900,1003200,2696100
314795,202108,59,49,10,53900,11000,64900
314800,202108,2913,1674,1239,1844700.76,1366200,3210900.76
314810,202108,1471,841,630,925100,694100,1619200
314820,202108,107,60,47,66000,51700,117700
314830,202108,209,171,38,188100,41800,229900
314840,202108,90,52,38,57200,41800,99000
314850,202108,400,190,210,209000,231000,440000
314860,202108,655,503,152,553300,167200,720500
314870,202108,1553,801,752,882200,828300,1710500
314875,202108,51,46,5,50600,5500,56100
314880,202108,42,30,12,33000,13200,46200
314890,202108,47,25,22,28600,24200,52800
314900,202108,28,22,6,24200,6600,30800
314910,202108,232,151,81,167200,89100,256300
314915,202108,136,120,16,132000,17600,149600
314920,202108,91,58,33,63800,36300,100100
314930,202108,1022,486,536,534600.98,589600,1124200.98
314940,202108,43,34,9,37400,9900,47300
314950,202108,20,16,4,17600,4400,22000
314960,202108,26,19,7,20900,7700,28600
314970,202108,162,78,84,85800,92400,178200
314980,202108,308,198,110,218900,121000,339900
314990,202108,435,238,197,261800,216700,478500
314995,202108,154,63,91,69300,100100,169400
315000,202108,81,62,19,68200,20900,89100
315010,202108,37,24,13,26400,14300,40700
315015,202108,161,128,33,140800,36300,177100
315020,202108,72,60,12,66000,13200,79200
315030,202108,110,84,26,92400,28600,121000
315040,202108,76,48,28,52800,30800,83600
315050,202108,197,119,78,133100,85800,218900
315053,202108,45,32,13,35200,14300,49500
315057,202108,111,87,24,95700,26400,122100
315060,202108,71,58,13,63800,14300,78100
315070,202108,105,60,45,66000,49500,115500
315080,202108,381,300,81,330000,89100,419100
315090,202108,93,54,39,59400,42900,102300
315100,202108,80,40,40,44000,44000,88000
315110,202108,271,140,131,155100,144100,299200
315120,202108,1782,857,925,942700,1018600,1961300
315130,202108,335,243,92,268400,101200,369600
315140,202108,536,292,244,322300,268400,590700
315150,202108,988,475,513,523600,564300,1087900
315160,202108,198,101,97,111100,106700,217800
315170,202108,305,205,100,225500,110000,335500
315180,202108,3256,1363,1893,1500400,2083400,3583800
315190,202108,296,181,115,199100,126500,325600
315200,202108,1201,717,484,789800,533500,1323300
315210,202108,1630,938,692,1032900,761200,1794100
315213,202108,28,16,12,17600,13200,30800
315217,202108,201,155,46,170500,50600,221100
315220,202108,1602,1193,409,1313400,449900.02,1763300.02
315230,202108,175,131,44,144100,48400,192500
315240,202108,396,253,143,278300,158400,436700
315250,202108,2581,1253,1328,1380500,1461900,2842400
315260,202108,135,75,60,82500,66000,148500
315270,202108,134,91,43,100100,47300,147400
315280,202108,630,415,215,457600,236500,694100
315290,202108,187,115,72,126500,79200,205700
315300,202108,84,62,22,68200,24200,92400
315310,202108,80,71,9,78100,9900,88000
315320,202108,149,89,60,97900,66000,163900
315330,202108,58,47,11,51700,12100,63800
315340,202108,393,284,109,312400,121000,433400
315350,202108,154,95,59,104500,64900,169400
315360,202108,93,42,51,46200,56100,102300
315370,202108,56,36,20,39600,22000,61600
315380,202108,5,5,0,5500,0,5500
315390,202108,62,17,45,18700,49500,68200
315400,202108,799,593,206,653400,226600,880000
315410,202108,314,183,131,201300,144100,345400
315415,202108,55,42,13,46200,14300,60500
315420,202108,197,143,54,157300,59400,216700
315430,202108,648,369,279,405900,306900,712800
315440,202108,92,62,30,68200,33000,101200
315445,202108,220,185,35,203500,38500,242000
315450,202108,183,133,50,147400,55000,202400
315460,202108,4234,1972,2262,2171400,2489300,4660700
315470,202108,40,15,25,16500,27500,44000
315480,202108,70,19,51,20900,56100,77000
315490,202108,709,438,271,481800,299200,781000
315500,202108,17,13,4,14300,4400,18700
315510,202108,144,99,45,108900,49500,158400
315520,202108,76,64,12,70400,13200,83600
315530,202108,41,22,19,24200,20900,45100
315540,202108,257,183,74,202400,81400,283800
315550,202108,178,145,33,159500,36300,195800
315560,202108,728,577,151,634700,166100,800800
315570,202108,313,152,161,167200,177100,344300
315580,202108,736,495,241,544500,265100,809600
315590,202108,192,99,93,108900,102300,211200
315600,202108,316,244,72,268400,79200,347600
315610,202108,101,47,54,51700,59400,111100
315620,202108,34,26,8,29700,8800,38500
315630,202108,124,85,39,93500,42900,136400
315640,202108,66,40,26,44000,28600,72600
315645,202108,51,34,17,37400,18700,56100
315650,202108,172,125,47,137500.99,51700,189200.99
315660,202108,458,200,258,221100,284900,506000
315670,202108,2381,1119,1262,1230900,1389300,2620200
315680,202108,811,572,239,629200,262900,892100
315690,202108,672,457,215,503800,237600,741400
315700,202108,1961,1020,941,1124200.28,1035100,2159300.28
315710,202108,356,109,247,119900,275000,394900
315720,202108,486,295,191,325600,210100,535700
315725,202108,186,151,35,167200,38500,205700
315727,202108,53,26,27,28600,29700,58300
315730,202108,49,43,6,47300,6600,53900
315733,202108,91,59,32,66000,35200,101200
315737,202108,50,37,13,40700,14300,55000
315740,202108,33,24,9,26400,9900,36300
315750,202108,150,112,38,123200,41800,165000
315760,202108,38,29,9,31900,9900,41800
315765,202108,122,71,51,78100,56100,134200
315770,202108,214,131,83,144100.5,91300,235400.5
315780,202108,3657,1816,1841,1998700,2028400,4027100
315790,202108,239,185,54,203500,59400,262900
315800,202108,303,200,103,220000,113300,333300
315810,202108,92,57,35,62700,38500,101200
315820,202108,748,550,198,605000,217800,822800
315830,202108,117,74,43,81400,47300,128700
315840,202108,80,51,29,57200,31900,89100
315850,202108,259,181,78,199100,85800,284900
315860,202108,14,5,9,5500,9900,15400
315870,202108,40,31,9,34100,9900,44000
315880,202108,93,65,28,71500,30800,102300
315890,202108,98,72,26,79200,28600,107800
315895,202108,404,268,136,297000,149600,446600
315900,202108,71,34,37,37400,40700,78100
315910,202108,41,24,17,26400,18700,45100
315920,202108,153,102,51,112200,56100,168300
315930,202108,52,16,36,17600,39600,57200
315935,202108,128,102,26,112200,28600,140800
315940,202108,99,72,27,79200,29700,108900
315950,202108,37,29,8,31900,8800,40700
315960,202108,541,255,286,281600,316800,598400
315970,202108,33,26,7,28600,7700,36300
315980,202108,680,335,345,368500,379500,748000
315990,202108,257,148,109,162800,119900,282700
316000,202108,45,30,15,33000,16500,49500
316010,202108,78,65,13,72600,14300,86900
316020,202108,113,98,15,108900,16500,125400
316030,202108,377,208,169,228800,185900,414700
316040,202108,546,224,322,246400,354200,600600
316045,202108,49,44,5,48400,5500,53900
316050,202108,21,16,5,17600,5500,23100
316060,202108,93,65,28,72600,30800,103400
316070,202108,1091,714,377,787600,414700,1202300
316080,202108,90,60,30,67196.8,33000,100196.8
316090,202108,38,19,19,20900,20900,41800
316095,202108,86,71,15,78100,16500,94600
316100,202108,316,179,137,196900,151800,348700
316105,202108,42,25,17,27500,18700,46200
316110,202108,1889,1481,408,1631300.5,449900,2081200.5
316120,202108,78,52,26,58300,28600,86900
316130,202108,113,84,29,92400,31900,124300
316140,202108,35,23,12,25300,13200,38500
316150,202108,210,146,64,160600,70400,231000
316160,202108,83,46,37,50600,40700,91300
316165,202108,64,45,19,49500,20900,70400
316170,202108,183,119,64,130900,70400,201300
316180,202108,215,90,125,99000,137500,236500
316190,202108,136,96,40,105600,44000,149600
316200,202108,664,359,305,394900,335500,730400
316210,202108,774,515,259,568889.2,284900,853789.2
316220,202108,117,74,43,81400,47300,128700
316225,202108,31,18,13,19800,14300,34100
316230,202108,37,18,19,19800,20900,40700
316240,202108,663,531,132,584100,145200,729300
316245,202108,142,123,19,135300,20900,156200
316250,202108,1570,1063,507,1170400,557700,1728100
316255,202108,134,107,27,117700,29700,147400
316257,202108,173,86,87,94600,95700,190300
316260,202108,189,134,55,147400,60500,207900
316265,202108,29,21,8,23100,8800,31900
316270,202108,679,474,205,522500,225500,748000
316280,202108,549,337,212,371800.63,233200,605000.63
316290,202108,798,538,260,591800,286000,877800
316292,202108,543,215,328,236500,360800,597300
316294,202108,106,70,36,77000,39600,116600
316295,202108,325,141,184,156200,202400,358600
316300,202108,109,73,36,80300,39600,119900
316310,202108,30,15,15,16500,16500,33000
316320,202108,52,28,24,30800,26400,57200
316330,202108,172,118,54,129800,59400,189200
316340,202108,134,87,47,95700,51700,147400
316350,202108,189,133,56,146300,61600,207900
316360,202108,25,14,11,15400,12100,27500
316370,202108,1166,577,589,636900,649000,1285900
316380,202108,110,83,27,91300,29700,121000
316390,202108,107,75,32,82500,35200,117700
316400,202108,131,98,33,107800,36300,144100
316410,202108,309,224,85,246400,93500,339900
316420,202108,212,143,69,157300,75900,233200
316430,202108,153,81,72,89100,79200,168300
316440,202108,81,40,41,44000,45100,89100
316443,202108,43,38,5,41800,5500,47300
316447,202108,47,34,13,37400,14300,51700
316450,202108,227,174,53,191400,58300,249700
316460,202108,82,31,51,34100,56100,90200
316470,202108,1674,1220,454,1344189.65,499400,1843589.65
316480,202108,11,8,3,8800,3300,12100
316490,202108,19,7,12,7700,13200,20900
316500,202108,160,106,54,116600,59400,176000
316510,202108,153,117,36,128700,39600,168300
316520,202108,194,112,82,124300,91300,215600
316530,202108,163,105,58,115500,63800,179300
316540,202108,148,76,72,83600,79200,162800
316550,202108,142,87,55,95700,60500,156200
316553,202108,337,150,187,165000,205700.72,370700.72
316555,202108,48,42,6,46200,6600,52800
316556,202108,14,10,4,11000,4400,15400
316557,202108,27,22,5,24200,5500,29700
316560,202108,68,48,20,52800,22000,74800
316570,202108,210,190,20,209000,22000,231000
316580,202108,21,15,6,16500,6600,23100
316590,202108,96,80,16,88000,17600,105600
316600,202108,177,148,29,162800,31900,194700
316610,202108,68,52,16,57200,17600,74800
316620,202108,141,101,40,111100,44000,155100
316630,202108,43,33,10,36300,11000,47300
316640,202108,21,14,7,15400,7700,23100
316650,202108,86,69,17,75900,18700,94600
316660,202108,7,2,5,2200,5500,7700
316670,202108,440,150,290,165000,319000,484000
316680,202108,164,121,43,133100,47300,180400
316690,202108,169,101,68,111100,74800,185900
316695,202108,61,51,10,57200,11000,68200
316700,202108,18,12,6,13200,6600,19800
316710,202108,759,574,185,632500,203500,836000
316720,202108,5075,2436,2639,2680700,2904000,5584700
316730,202108,17,17,0,18700,0,18700
316740,202108,145,92,53,101200,58300,159500
316750,202108,22,14,8,15400,8800,24200
316760,202108,310,251,59,276100,64900,341000
316770,202108,170,91,79,100100,86900,187000
316780,202108,70,43,27,47300,29700,77000
316790,202108,54,37,17,40700,18700,59400
316800,202108,1771,1084,687,1193500,755700,1949200
316805,202108,25,17,8,18700,8800,27500
316810,202108,65,40,25,44000,27500,71500
316820,202108,41,22,19,24200,20900,45100
316830,202108,97,45,52,49500,57200,106700
316840,202108,512,298,214,328900,236500,565400
316850,202108,319,214,105,235400,115500,350900
316860,202108,5988,2651,3337,2917200,3675100,6592300
316870,202108,1585,1012,573,1114300,630300,1744600
316880,202108,140,69,71,75900,78100,154000
316890,202108,234,160,74,176000,81400,257400
316900,202108,407,285,122,314600,134200,448800
316905,202108,19,9,10,9900,11000,20900
316910,202108,67,28,39,30800,42900,73700
316920,202108,143,111,32,122100,35200,157300
316930,202108,1889,942,947,1038400,1041700,2080100
316935,202108,907,545,362,599500,398200,997700
316940,202108,1074,607,467,671000,513700,1184700
316950,202108,178,86,92,95700,101200,196900
316960,202108,1094,608,486,668800,534600,1203400
316970,202108,635,502,133,552200,146300,698500
316980,202108,73,39,34,42900,37400,80300
316990,202108,2172,1451,721,1597200,795300.84,2392500.84
317000,202108,328,254,74,279400,81400,360800
317005,202108,223,158,65,173800,71500,245300
317010,202108,6467,3585,2882,3949000,3175700,7124700
317020,202108,15699,6914,8785,7610900,9678900,17289800
317030,202108,82,32,50,35200,55000,90200
317040,202108,3020,1906,1114,2098800,1225400,3324200
317043,202108,69,52,17,57200,18700,75900
317047,202108,37,19,18,20900,19800,40700
317050,202108,148,112,36,123200,39600,162800
317052,202108,145,113,32,124300,35200,159500
317057,202108,177,132,45,145200,49500,194700
317060,202108,58,36,22,39600,24200,63800
317065,202108,47,36,11,39600,12100,51700
317070,202108,1936,891,1045,980100,1151700,2131800
317075,202108,97,54,43,59400,47300,106700
317080,202108,908,463,445,509300,490600,999900
317090,202108,696,544,152,599500,167200,766700
317100,202108,417,314,103,345400,113300,458700
317103,202108,119,95,24,104500,26400,130900
317107,202108,47,40,7,44000,7700,51700
317110,202108,112,53,59,58300,64900,123200
317115,202108,43,39,4,42900,4400,47300
317120,202108,1966,924,1042,1017500.3,1148400,2165900.3
317130,202108,1987,1317,670,1450900,738100,2189000
317140,202108,12,9,3,9900,3300,13200
317150,202108,284,170,114,187000,125400,312400
317160,202108,331,249,82,273900.63,90200,364100.63
317170,202108,231,155,76,170500,83600,254100
317180,202108,442,299,143,331100,157300,488400
317190,202108,267,192,75,211200,82500,293700
317200,202108,809,563,246,619300,270600,889900
317210,202108,181,95,86,104500,94600,199100
317220,202108,24,12,12,13200,13200,26400
320010,202108,567,408,159,448800,174900,623700
320013,202108,123,84,39,92400,42900,135300
320016,202108,265,168,97,184800,106700,291500
320020,202108,723,417,306,459800.8,336600,796400.8
320030,202108,157,109,48,119900.04,52800.08,172700.12
320035,202108,138,97,41,106700,45100,151800
320040,202108,495,250,245,275000,270600,545600
320050,202108,115,77,38,84700,41800,126500
320060,202108,1753,838,915,922900,1007600.65,1930500.65
320070,202108,96,59,37,64900,40700,105600
320080,202108,802,465,337,512600,372900,885500
320090,202108,1254,832,422,915200,464200.27,1379400.27
320100,202108,333,192,141,211200,155100,366300
320110,202108,118,73,45,80300,49500,129800
320115,202108,113,93,20,102300,22000,124300
320120,202108,3651,1917,1734,2112000,1909600.74,4021600.74
320130,202108,7701,3414,4287,3758700.5,4717900,8476600.5
320140,202108,439,282,157,310200,172700.81,482900.81
320150,202108,2089,1159,930,1274900,1024100.72,2299000.72
320160,202108,654,290,364,320100,400400,720500
320170,202108,110,86,24,94600.1,26400.02,121000.12
320180,202108,55,33,22,37400,24200,61600
320190,202108,241,153,88,168300,97900,266200
320200,202108,62,48,14,52800,15400,68200
320210,202108,896,484,412,532400,454300,986700
320220,202108,303,109,194,119900,213400,333300
320225,202108,83,67,16,74800,17600,92400
320230,202108,670,428,242,470800,266200,737000
320240,202108,3478,1631,1847,1795200,2032800,3828000
320245,202108,492,330,162,363000,178200,541200
320250,202108,229,111,118,122100,129800,251900
320255,202108,132,102,30,112200,33000,145200
320260,202108,233,140,93,154000.2,102300.12,256300.32
320265,202108,154,118,36,129800,39600,169400
320270,202108,155,121,34,134200,37400,171600
320280,202108,1172,664,508,730400.5,558800.02,1289200.52
320290,202108,58,48,10,52800,11000,63800
320300,202108,599,412,187,453200.02,206800,660000.02
320305,202108,699,371,328,408100,360800,768900
320310,202108,199,114,85,125400,93500,218900
320313,202108,341,158,183,173800,201300,375100
320316,202108,108,81,27,89100,29700,118800
320320,202108,3435,1523,1912,1677500,2106500,3784000
320330,202108,271,198,73,217800,80300,298100
320332,202108,773,459,314,504900,346500,851400
320334,202108,268,148,120,162800.02,132000,294800.02
320335,202108,142,92,50,101200,55000,156200
320340,202108,570,401,169,441100,187000,628100
320350,202108,1047,429,618,473000.5,683100,1156100.5
320360,202108,166,83,83,91300,91300,182600
320370,202108,232,172,60,189200,66000,255200
320380,202108,292,204,88,224400,96800,321200
320390,202108,1156,679,477,746900,524700,1271600
320400,202108,316,227,89,249700,97900,347600
320405,202108,963,392,571,431200,629200,1060400
320410,202108,961,484,477,532400,524700,1057100
320420,202108,526,248,278,272800,306900,579700
320425,202108,198,112,86,123200,95700,218900
320430,202108,374,198,176,217800,193600,411400
320435,202108,165,109,56,121000,61600,182600
320440,202108,202,115,87,126500.24,95700.2,222200.44
320450,202108,130,73,57,80300,63800,144100
320455,202108,245,195,50,214500,56100,270600
320460,202108,286,178,108,195800,118800,314600
320465,202108,110,74,36,81400,39600,121000
320470,202108,703,432,271,475200,298100,773300
320480,202108,195,126,69,138600,75900,214500
320490,202108,3159,1505,1654,1655501.23,1819400.71,3474901.94
320495,202108,117,70,47,77000,51700,128700
320500,202108,9723,4749,4974,5228300,5473600,10701900
320501,202108,546,272,274,299200,301400,600600
320503,202108,297,209,88,229900.08,97900.02,327800.10
320506,202108,258,180,78,198000,85800,283800
320510,202108,1120,494,626,547800,688600,1236400
320515,202108,80,60,20,66000,22000,88000
320517,202108,216,156,60,171600,66000,237600
320520,202108,7269,3052,4217,3358300,4643100,8001400
320530,202108,6527,3162,3365,3479281.5,3704800.63,7184082.13
330010,202108,3148,1550,1598,1705000,1757800,3462800
330015,202108,185,73,112,80300,123200,203500
330020,202108,3810,1525,2285,1678600,2514600,4193200
330022,202108,266,132,134,145200,147400,292600
330023,202108,689,208,481,228800,530200,759000
330025,202108,614,116,498,127600,547800,675400
330030,202108,1815,1122,693,1235300,762300,1997600
330040,202108,2513,1272,1241,1405800.73,1376100.5,2781901.23
330045,202108,9589,2782,6807,3062400.5,7502000,10564400.5
330050,202108,863,551,312,606100,343200,949300
330060,202108,1065,624,441,686400,485100,1171500
330070,202108,4052,1408,2644,1549900,2911700,4461600
330080,202108,1596,687,909,755700,1005400,1761100
330090,202108,390,220,170,242000,187000,429000
330093,202108,257,111,146,122100,160600,282700
330095,202108,77,45,32,49500,35200,84700
330100,202108,10182,5016,5166,5523100.5,5690300,11213400.5
330110,202108,468,200,268,220000,294800,514800
330115,202108,518,266,252,292600,277200,569800
330120,202108,385,195,190,214500,209000,423500
330130,202108,1587,397,1190,436700,1309000,1745700
330140,202108,627,328,299,360800,328900,689700
330150,202108,506,288,218,316800,240900,557700
330160,202108,213,122,91,134200,100100,234300
330170,202108,27209,9054,18155,9969300,19990300,29959600
330180,202108,240,134,106,147400,116600,264000
330185,202108,1007,352,655,387200,720500,1107700
330187,202108,448,125,323,137500,355300,492800
330190,202108,6061,2225,3836,2448600,4222900,6671500
330200,202108,4708,1411,3297,1553200.86,3630000,5183200.86
330205,202108,444,249,195,273900,215600,489500
330210,202108,948,568,380,624800,418000,1042800
330220,202108,2711,1574,1137,1731400.01,1251800,2983200.01
330225,202108,564,284,280,312400,309100,621500
330227,202108,2422,722,1700,794200,1871100,2665300
330230,202108,263,142,121,156200,133100,289300
330240,202108,4028,1944,2084,2139500,2292400,4431900
330245,202108,152,64,88,70400,96800,167200
330250,202108,6733,3285,3448,3620100,3799400,7419500
330260,202108,665,167,498,183700,550000,733700
330270,202108,3791,1216,2575,1337600,2835800,4173400
330280,202108,447,275,172,303600,189200,492800
330285,202108,6880,2098,4782,2308900,5265700.1,7574600.1
330290,202108,687,245,442,269500,486200,755700
330300,202108,750,477,273,526475.63,300300,826775.63
330310,202108,450,246,204,270600,224400,495000
330320,202108,8015,2826,5189,3117400,5718997.9,8836397.9
330330,202108,9339,3427,5912,3773000.02,6508700.66,10281700.68
330340,202108,2687,1535,1152,1690700,1270500,2961200
330350,202108,19183,7030,12153,7737400,13385900.68,21123300.68
330360,202108,2149,1002,1147,1104400,1261700,2366100
330370,202108,1009,506,503,556600,553300,1109900
330380,202108,918,376,542,413600,598400.01,1012000.01
330385,202108,640,319,321,350900,353100,704000
330390,202108,5864,3017,2847,3322000,3133900,6455900
330395,202108,329,196,133,216700,146300,363000
330400,202108,699,353,346,389400,381700,771100
330410,202108,502,356,146,391600,160600,552200
330411,202108,276,141,135,155100,148500,303600
330412,202108,225,90,135,99000,148500,247500
330414,202108,5393,2124,3269,2338600,3599200,5937800
330415,202108,608,264,344,290400,379500,669900
330420,202108,2293,1167,1126,1284800,1241900,2526700
330430,202108,1796,776,1020,854700,1123100,1977800
330440,202108,332,150,182,165000,200200,365200
330450,202108,117,51,66,56100,72600,128700
330452,202108,2239,950,1289,1045000,1419000,2464000
330455,202108,117825,39660,78165,43692095.18,86126704.24,129818799.42
330460,202108,251,108,143,119900,157300,277200
330470,202108,1228,666,562,732600,618200,1350800
330475,202108,1678,455,1223,501600.24,1345300,1846900.24
330480,202108,823,442,381,488400,419100,907500
330490,202108,15464,4775,10689,5257005.23,11768900,17025905.23
330500,202108,1461,627,834,689700,917400,1607100
330510,202108,11039,3707,7332,4084300,8070700.95,12155000.95
330513,202108,101,52,49,57200,53900,111100
330515,202108,752,312,440,343200,484000,827200
330520,202108,2545,867,1678,953700,1846900,2800600
330530,202108,193,109,84,119900,92400,212300
330540,202108,343,171,172,188100,190300,378400
330550,202108,2851,955,1896,1050500,2086700,3137200
330555,202108,803,303,500,334400,550000,884400
330560,202108,711,235,476,258500,524700,783200
330570,202108,279,194,85,213400,94600,308000
330575,202108,803,283,520,311300,573100,884400
330580,202108,3370,1836,1534,2021800,1690700,3712500
330590,202108,268,138,130,152900.5,143000,295900.5
330600,202108,1257,765,492,841500,541200,1382700
330610,202108,1610,843,767,927300,843700,1771000
330615,202108,218,172,46,189200,50600,239800
330620,202108,1059,394,665,433400,731500,1164900
330630,202108,4211,2534,1677,2791801.07,1845800,4637601.07
350010,202108,586,385,201,423500.88,221100,644600.88
350020,202108,55,19,36,20900,39600,60500
350030,202108,531,326,205,358600,227700,586300
350040,202108,127,54,73,59400,80300,139700
350050,202108,337,171,166,188100,182600,370700
350055,202108,113,50,63,55000,69300,124300
350060,202108,84,29,55,31900,60500,92400
350070,202108,787,459,328,508200.2,363000,871200.2
350075,202108,75,48,27,52800,29700,82500
350080,202108,57,27,30,29700,33000,62700
350090,202108,83,47,36,51700,39600,91300
350100,202108,274,170,104,187000,114400,301400
350110,202108,49,33,16,37400,17600,55000
350115,202108,151,91,60,100100,66000,166100
350120,202108,109,70,39,77000,42900,119900
350130,202108,376,161,215,177100.56,237600,414700.56
350140,202108,41,26,15,28600,16500,45100
350150,202108,77,57,20,62700,22000,84700
350160,202108,2397,942,1455,1039500,1602700,2642200
350170,202108,384,218,166,239800,182600,422400
350180,202108,164,97,67,106700,73700,180400
350190,202108,1018,539,479,596200.63,526900,1123100.63
350200,202108,66,24,42,26400,47300,73700
350210,202108,1296,708,588,779900,646800.63,1426700.63
350220,202108,645,528,117,581900.63,128700,710600.63
350230,202108,76,51,25,56100,27500,83600
350240,202108,56,38,18,41800,19800,61600
350250,202108,1163,537,626,591800,689700,1281500
350260,202108,102,73,29,80300,31900,112200
350270,202108,914,604,310,664400,341000,1005400
350275,202108,303,117,186,128700,204600,333300
350280,202108,4463,2195,2268,2422200,2498100,4920300
350290,202108,468,203,265,223300,292600,515900
350300,202108,54,26,28,28600,30800,59400
350310,202108,78,50,28,56100,30800,86900
350315,202108,63,27,36,29700,39600,69300
350320,202108,3307,1573,1734,1732500,1910700,3643200
350330,202108,1671,872,799,959201.66,881100,1840301.66
350335,202108,15,11,4,12100,4400,16500
350340,202108,124,53,71,58300,78100,136400
350350,202108,104,52,52,57200,57200,114400
350360,202108,106,71,35,78100,38500,116600
350370,202108,80,43,37,47300.63,40700,88000.63
350380,202108,791,330,461,364100,507100,871200
350390,202108,1681,598,1083,657800.5,1192400,1850200.5
350395,202108,22,18,4,19800,4400,24200
350400,202108,1692,827,865,909701.89,954800.63,1864502.52
350410,202108,2873,1207,1666,1327700,1834820.63,3162520.63
350420,202108,254,149,105,165000,116600,281600
350430,202108,82,45,37,49500,40700,90200
350440,202108,158,114,44,125400,48400,173800
350450,202108,1727,978,749,1076900.63,825000,1901900.63
350460,202108,408,140,268,154000,294800,448800
350470,202108,21,12,9,13200,9900,23100
350480,202108,189,103,86,113300,94600,207900
350490,202108,246,118,128,129800,140800,270600
350500,202108,56,24,32,26400,35200,61600
350510,202108,159,98,61,107800,67100,174900
350520,202108,432,222,210,245300,231000,476300
350530,202108,447,207,240,229900,264000,493900
350535,202108,78,59,19,64900,20900,85800
350540,202108,369,194,175,213400,192500,405900
350550,202108,2708,1540,1168,1699500,1287001.26,2986501.26
350560,202108,592,403,189,443300,207900,651200
350570,202108,4302,1746,2556,1923900.63,2813801.27,4737701.90
350580,202108,357,174,183,192500,201300,393800
350590,202108,944,508,436,559900,481800,1041700
350600,202108,6160,2895,3265,3187800,3595900,6783700
350610,202108,1481,769,712,848100,784300,1632400
350620,202108,26,16,10,17600,11000,28600
350630,202108,244,127,117,140800.63,128700,269500.63
350635,202108,1046,405,641,447700,705100,1152800
350640,202108,115,86,29,94600,31900,126500
350650,202108,1861,1236,625,1360700,687500,2048200
350660,202108,756,302,454,333300,500500,833800
350670,202108,298,148,150,163900,165000,328900
350680,202108,168,83,85,91300,93500,184800
350690,202108,193,87,106,96800,116600,213400
350700,202108,836,393,443,434500,487300,921800
350710,202108,392,143,249,157300,273900,431200
350715,202108,57,44,13,48400,14300,62700
350720,202108,16,10,6,12100,6600,18700
350730,202108,44,26,18,28600,19800,48400
350740,202108,227,125,102,137500,112200,249700
350745,202108,28,11,17,12100,18700,30800
350750,202108,2295,1360,935,1498200,1028500,2526700
350760,202108,3741,1545,2196,1701700,2421100,4122800
350770,202108,57,41,16,45100,17600,62700
350775,202108,47,34,13,37400,14300,51700
350780,202108,427,216,211,238700,232100,470800
350790,202108,366,150,216,165000,238700,403700
350800,202108,499,296,203,325600,224400,550000
350810,202108,512,402,110,442200,121000,563200
350820,202108,94,52,42,57200,46200,103400
350830,202108,73,39,34,42900,38500,81400
350840,202108,784,307,477,337700,524700,862400
350850,202108,1811,957,854,1054900,939400,1994300
350860,202108,627,332,295,365200,324500,689700
350870,202108,435,288,147,316800,163900,480700
350880,202108,269,154,115,169400,126500,295900
350890,202108,38,23,15,25300,16500,41800
350900,202108,1547,465,1082,512600,1191300.63,1703900.63
350910,202108,24,14,10,15400,11000,26400
350920,202108,717,368,349,404800,383900,788700
350925,202108,1139,598,541,658900,595100.63,1254000.63
350930,202108,98,55,43,60500,47300,107800
350940,202108,744,393,351,433400,387200,820600
350945,202108,111,80,31,88000,34100,122100
350950,202108,16784,7608,9176,8379801.26,10110100.18,18489901.44
350960,202108,1501,606,895,666600,986700,1653300
350970,202108,1070,544,526,598281.2,579700,1177981.2
350980,202108,97,64,33,70400,36300,106700
350990,202108,374,135,239,148500,265100,413600
350995,202108,40,20,20,22000,22000,44000
351000,202108,615,411,204,453200.63,224400,677600.63
351010,202108,50,32,18,35200,19800,55000
351015,202108,45,31,14,34100,15400,49500
351020,202108,1509,894,615,986700,677600,1664300
351030,202108,343,205,138,225500,151800,377300
351040,202108,937,460,477,506000,524700.2,1030700.2
351050,202108,3375,1498,1877,1648900,2066900,3715800
351060,202108,5594,2038,3556,2244000,3918200,6162200
351070,202108,393,247,146,273900.63,160600,434500.63
351080,202108,722,523,199,576400,218900,795300
351090,202108,49,21,28,24200,30800,55000
351100,202108,419,227,192,250800,212300,463100
351110,202108,2024,939,1085,1035100.5,1194600,2229700.5
351120,202108,66,36,30,39600,33000,72600
351130,202108,186,60,126,66000,138600,204600
351140,202108,313,195,118,214500,129800,344300
351150,202108,452,235,217,258500,238700,497200
351160,202108,272,165,107,181500.4,117700,299200.4
351170,202108,195,102,93,112200,102300,214500
351190,202108,87,58,29,63800,31900,95700
351200,202108,352,223,129,245300,143000,388300
351210,202108,111,54,57,59400,62700,122100
351220,202108,538,319,219,350900.65,240900,591800.65
351230,202108,278,189,89,207900,97900,305800
351240,202108,247,116,131,127600,145200,272800
351250,202108,82,55,27,60500.5,29700,90200.5
351260,202108,152,109,43,121000,47300,168300
351270,202108,50,20,30,22000,33000,55000
351280,202108,1037,477,560,524700.63,618200.63,1142901.26
351290,202108,237,107,130,118800,143000,261800
351300,202108,3813,1648,2165,1814913.6,2387000,4201913.6
351310,202108,739,360,379,396000,416900,812900
351320,202108,116,67,49,73700,53900,127600
351330,202108,37,24,13,26400,14300,40700
351340,202108,1301,738,563,815100,620400,1435500
351350,202108,2368,1353,1015,1492700.04,1118700,2611400.04
351360,202108,783,375,408,412500,449900,862400
351370,202108,389,190,199,210100,218900,429000
351380,202108,8880,3878,5002,4271300,5506600.63,9777900.63
351385,202108,28,18,10,19800,11000,30800
351390,202108,281,211,70,232100,77000,309100
351400,202108,68,45,23,49500,25300,74800
351410,202108,437,270,167,297000.55,185900,482900.55
351420,202108,68,48,20,52800,22000,74800
351430,202108,77,42,35,46200,39600,85800
351440,202108,764,512,252,567601.26,277200,844801.26
351450,202108,266,128,138,140800,151800,292600
351460,202108,125,52,73,57200,80300,137500
351470,202108,144,78,66,85800,72600,158400
351480,202108,493,289,204,317900.63,224400,542300.63
351490,202108,289,105,184,115500,202400,317900
351492,202108,26,17,9,18700,9900,28600
351495,202108,28,18,10,19800,11000,30800
351500,202108,3480,1412,2068,1554300,2274800,3829100
351510,202108,2019,727,1292,799700.84,1422300,2222000.84
351512,202108,15,11,4,12100,4400,16500
351515,202108,189,110,79,121000,86900,207900
351518,202108,705,431,274,474100,302500,776600
351519,202108,79,44,35,48400,38500,86900
351520,202108,159,94,65,103400,71519.8,174919.8
351530,202108,25,15,10,16500,11000,27500
351535,202108,130,80,50,88000,56100,144100
351540,202108,453,306,147,336600,161700,498300
351550,202108,1456,846,610,932801.26,673200,1606001.26
351560,202108,78,45,33,49500,36300,85800
351565,202108,13,6,7,6600,7700,14300
351570,202108,2703,1265,1438,1391500,1582900,2974400
351580,202108,40,35,5,38500,5500,44000
351590,202108,61,39,22,42900,24200,67100
351600,202108,183,127,56,139700,61600,201300
351610,202108,51,21,30,23100,33000,56100
351620,202108,5780,3128,2652,3446300.19,2926000,6372300.19
351630,202108,3015,1436,1579,1580700,1736900,3317600
351640,202108,2127,915,1212,1006500.55,1335400.63,2341901.18
351650,202108,29,25,4,27500,4400,31900
351660,202108,128,82,46,90200,50600,140800
351670,202108,726,440,286,485100,314600,799700
351680,202108,67,55,12,60500,13200,73700
351685,202108,11,8,3,8800,3300,12100
351690,202108,298,197,101,216700.5,111100,327800.5
351700,202108,173,115,58,126737,63800,190537
351710,202108,67,42,25,46200,27500,73700
351720,202108,127,69,58,75900,63800,139700
351730,202108,110,70,40,77000,44000,121000
351740,202108,752,470,282,518100.74,311300,829400.74
351750,202108,360,144,216,158400,237600,396000
351760,202108,739,566,173,623700,190300,814000
351770,202108,303,247,56,271700.63,61600,333300.63
351780,202108,162,94,68,103400,74800,178200
351790,202108,249,127,122,139700,134200,273900
351800,202108,41,25,16,27500,17600,45100
351810,202108,119,80,39,88000,42900,130900
351820,202108,775,551,224,606100,246400,852500
351830,202108,568,184,384,202400,424600,627000
351840,202108,2012,937,1075,1032900,1183600,2216500
351850,202108,229,162,67,178200,73700,251900
351860,202108,628,426,202,469700,222200,691900
351870,202108,5635,2567,3068,2827002,3374801.38,6201803.38
351880,202108,20215,7836,12379,8629500,13632300,22261800
351885,202108,89,50,39,55000,42900,97900
351890,202108,66,49,17,53900,18700,72600
351900,202108,230,131,99,144100,111100,255200
351905,202108,93,40,53,44000,58300,102300
351907,202108,3531,1424,2107,1567500.55,2322100,3889600.55
351910,202108,170,70,100,78100,111100,189200
351920,202108,112,60,52,66000,57200,123200
351925,202108,90,56,34,61600,37400,99000
351930,202108,387,250,137,275000,151800,426800
351940,202108,241,100,141,110000,155100,265100
351950,202108,131,70,61,77000,67100,144100
351960,202108,923,449,474,494244.93,522500,1016744.93
351970,202108,2023,981,1042,1080200,1146200,2226400
351980,202108,152,67,85,73700,93500,167200
351990,202108,250,162,88,178200,96800,275000
352000,202108,326,205,121,225500,133100,358600
352010,202108,410,252,158,277271,173800,451071
352020,202108,181,65,116,71500,127600,199100
352030,202108,1109,544,565,599500,622600,1222100
352040,202108,597,243,354,267300,389400,656700
352042,202108,295,70,225,77000,247500,324500
352044,202108,354,209,145,229900.63,159500,389400.63
352050,202108,3219,1200,2019,1324400.79,2226400,3550800.79
352060,202108,104,59,45,64900,49500,114400
352070,202108,90,66,24,72601.26,26400,99001.26
352080,202108,62,42,20,46200,22000,68200
352090,202108,159,107,52,118800,58300,177100
352100,202108,286,135,151,148500,166100,314600
352110,202108,112,36,76,39600,83600,123200
352115,202108,63,19,44,20900,48400,69300
352120,202108,78,56,22,61600.63,24200,85800.63
352130,202108,219,171,48,188100,52800,240900
352140,202108,171,80,91,89100,100100,189200
352150,202108,123,64,59,70400,64900,135300
352160,202108,140,90,50,99000,55000,154000
352170,202108,380,255,125,280500,137500,418000
352180,202108,654,400,254,440000.63,280500,720500.63
352190,202108,245,98,147,107800,161700,269500
352200,202108,29,14,15,15400,16500,31900
352210,202108,4269,1697,2572,1867800.95,2831400,4699200.95
352215,202108,68,39,29,42900,31900,74800
352220,202108,6524,2413,4111,2655400,4530900.63,7186300.63
352230,202108,3387,2162,1225,2381501.13,1348601.05,3730102.18
352240,202108,2574,1459,1115,1609300.49,1226500,2835800.49
352250,202108,2997,1349,1648,1486101.26,1813900,3300001.26
352260,202108,1003,530,473,583000,522500,1105500
352265,202108,61,32,29,35200,31900,67100
352270,202108,387,215,172,236500,189200,425700
352280,202108,481,287,194,315700.63,213400,529100.63
352290,202108,180,103,77,113300,84700,198000
352300,202108,95,64,31,70400,34100,104500
352310,202108,6607,2822,3785,3107501.62,4166800,7274301.62
352320,202108,1101,559,542,614900,598400,1213300
352330,202108,526,264,262,291500,290400,581900
352340,202108,1371,624,747,686400,822800,1509200
352350,202108,347,197,150,217800,165000.64,382800.64
352360,202108,225,96,129,105600,141900,247500
352370,202108,106,68,38,74800,41800,116600
352380,202108,107,74,33,81400,36300,117700
352390,202108,2556,1097,1459,1206700,1607100,2813800
352400,202108,518,224,294,246400,324500,570900
352410,202108,907,606,301,666600.63,331100,997700.63
352420,202108,95,67,28,73700,30800,104500
352430,202108,1761,787,974,866801.89,1071401.26,1938203.15
352440,202108,3283,1551,1732,1708300,1910700,3619000
352450,202108,202,157,45,172700,49500,222200
352460,202108,630,313,317,345400,348700,694100
352470,202108,654,230,424,253000,467500,720500
352480,202108,1469,796,673,876700,740300,1617000
352490,202108,45,15,30,16500,33000,49500
352500,202108,1259,518,741,570900,815100,1386000
352510,202108,708,373,335,410300.63,370700.66,781001.29
352520,202108,807,339,468,374147.4,515900,890047.4
352530,202108,1767,914,853,1009800,940500,1950300
352540,202108,68,45,23,49500,25300,74800
352550,202108,191,112,79,123200,86900,210100
352560,202108,47,38,9,41800,9900,51700
352570,202108,706,334,372,367400.63,410300,777700.63
352580,202108,60,46,14,50600,15400,66000
352585,202108,23,5,18,5500,19800,25300
352590,202108,4319,2079,2240,2289100.63,2467397,4756497.63
352600,202108,356,244,112,269500,123200,392700
352610,202108,916,409,507,449900.5,557700,1007600.5
352620,202108,1055,383,672,421300,740300,1161600
352630,202108,186,65,121,72600,133100,205700
352640,202108,526,339,187,374000,205700,579700
352650,202108,80,60,20,66000,22000,88000
352660,202108,65,39,26,42900,28600,71500
352670,202108,1680,882,798,970200.6,880000,1850200.6
352680,202108,906,556,350,612700,387200,999900
352690,202108,4551,1998,2553,2200001.26,2813800.63,5013801.89
352700,202108,92,54,38,59400,41800,101200
352710,202108,1461,750,711,827200,783200,1610400
352720,202108,1425,634,791,697400,871200,1568600
352725,202108,22,17,5,18700,5500,24200
352730,202108,391,184,207,202400,227700,430100
352740,202108,396,260,136,286000,149600.8,435600.8
352750,202108,24,16,8,17600,8800,26400
352760,202108,204,126,78,138600,85800,224400
352770,202108,84,62,22,68200,24200,92400
352780,202108,72,37,35,40700,38500,79200
352790,202108,23,17,6,18700,6600,25300
352800,202108,230,177,53,194700,58300,253000
352810,202108,156,97,59,106700,64900,171600
352820,202108,46,35,11,38500,12100,50600
352830,202108,75,49,26,53900,28600,82500
352840,202108,656,305,351,335500,386100,721600
352850,202108,1654,509,1145,561000,1262800,1823800
352860,202108,113,73,40,80300,44000,124300
352870,202108,48,30,18,33000,19800,52800
352880,202108,173,110,63,121000,69300,190300
352885,202108,31,21,10,23100,11000,34100
352890,202108,53,35,18,38500,19800,58300
352900,202108,4647,2202,2445,2426600,2690600,5117200
352910,202108,38,31,7,34100,7700,41800
352920,202108,657,380,277,420200,304700,724900
352930,202108,1189,554,635,610500,699600,1310100
352940,202108,6100,2412,3688,2655400,4060100,6715500
352950,202108,117,44,73,48400,80300,128700
352960,202108,65,38,27,41800,29700,71500
352965,202108,17,8,9,8800,9900,18700
352970,202108,514,377,137,414700,151800,566500
352980,202108,163,91,72,100100,79200,179300
352990,202108,987,456,531,501600,587400,1089000
353000,202108,58,25,33,27500,36300,63800
353010,202108,530,324,206,358600,228800,587400
353020,202108,305,215,90,236500,99000,335500
353030,202108,1289,566,723,623700,796400,1420100
353040,202108,77,40,37,44000,41800,85800
353050,202108,1289,831,458,916300.9,503800,1420100.9
353060,202108,8497,3532,4965,3890700.71,5471400,9362100.71
353070,202108,1824,1079,745,1188001.26,820404.2,2008405.46
353080,202108,1275,685,590,755700.92,649000,1404700.92
353090,202108,59,31,28,34100,30800,64900
353100,202108,44,35,9,38500,9900,48400
353110,202108,2145,674,1471,742500,1619200,2361700
353120,202108,107,52,55,57200,60500,117700
353130,202108,861,413,448,454300.92,492800,947100.92
353140,202108,555,230,325,253000.63,357500,610500.63
353150,202108,328,181,147,199100.63,161700,360800.63
353160,202108,103,78,25,85800,27500,113300
353170,202108,212,69,143,75900,157300,233200
353180,202108,1127,508,619,559900,680900,1240800
353190,202108,473,338,135,371800,148500,520300
353200,202108,236,114,122,125400,134200,259600
353205,202108,20,13,7,14300,7700,22000
353210,202108,65,37,28,40700,31900,72600
353215,202108,40,22,18,24200,19800,44000
353220,202108,80,41,39,45100,42900,88000
353230,202108,157,62,95,68200,104500,172700
353240,202108,341,161,180,178200,198000,376200
353250,202108,201,99,102,108900,112200,221100
353260,202108,459,304,155,334400,170500,504900
353270,202108,73,53,20,58300,22000,80300
353280,202108,103,50,53,55000,58300,113300
353282,202108,132,94,38,103400,41800,145200
353284,202108,26,19,7,20900,7700,28600
353286,202108,3,1,2,1100,2200,3300
353290,202108,82,48,34,52800,37400,90200
353300,202108,440,227,213,250801.26,234300,485101.26
353310,202108,44,36,8,39600,8800,48400
353320,202108,38,22,16,24200,17600,41800
353325,202108,48,28,20,30800,22000,52800
353330,202108,64,43,21,47300,23100,70400
353340,202108,634,221,413,243100,455400,698500
353350,202108,895,437,458,481800,506000,987800
353360,202108,101,79,22,86900,24200,111100
353370,202108,110,65,45,71500,49500,121000
353380,202108,28,13,15,14300,16500,30800
353390,202108,1104,518,586,570900,646800,1217700
353400,202108,48,28,20,30800,22000,52800
353410,202108,112,65,47,71500,51700,123200
353420,202108,58,22,36,24200,39600,63800
353430,202108,577,371,206,409201.13,226600,635801.13
353440,202108,11741,4960,6781,5464800.63,7466800,12931600.63
353450,202108,57,29,28,31900,30800,62700
353460,202108,616,316,300,348700,330000,678700
353470,202108,2248,1107,1141,1222100.6,1256200,2478300.6
353475,202108,250,165,85,181500,93500,275000
353480,202108,179,145,34,159500,37400,196900
353490,202108,232,137,95,150700,105600,256300
353500,202108,209,119,90,130900,99000,229900
353510,202108,89,60,29,66000,31900,97900
353520,202108,216,155,61,171600,67100,238700
353530,202108,463,241,222,265100,246400,511500
353540,202108,386,242,144,266200,158400,424600
353550,202108,704,443,261,487300.63,287100,774400.63
353560,202108,570,230,340,253000,374000,627000
353570,202108,66,37,29,40700,31900,72600
353580,202108,344,240,104,264000,114400,378400
353590,202108,79,56,23,61600,25300,86900
353600,202108,264,151,113,167200.63,124300,291500.63
353610,202108,132,67,65,73700,71500,145200
353620,202108,657,334,323,367400,355300,722700
353625,202108,53,27,26,29700,28600,58300
353630,202108,224,159,65,174900,71500,246400
353640,202108,119,77,42,85800,46200,132000
353650,202108,956,356,600,392700,661100,1053800
353657,202108,23,18,5,19800,5500,25300
353660,202108,280,147,133,161700,146300,308000
353670,202108,726,419,307,460900.63,337700,798600.63
353680,202108,119,80,39,88000,42900,130900
353690,202108,39,29,10,31900,11000,42900
353700,202108,282,194,88,213400.8,96800,310200.8
353710,202108,494,226,268,249700,294800,544500
353715,202108,50,31,19,34100,20900,55000
353720,202108,341,151,190,166100,210100,376200
353730,202108,1139,699,440,770000,485100,1255100
353740,202108,609,332,277,365200,305800,671000
353750,202108,72,42,30,47300,33000,80300
353760,202108,3164,1182,1982,1302363.33,2183500.9,3485864.23
353770,202108,76,62,14,68200,15400,83600
353780,202108,1287,597,690,656700.63,761200,1417900.63
353790,202108,484,288,196,320100,216700,536800
353800,202108,3534,1667,1867,1834820,2055974,3890794
353810,202108,230,119,111,130900,122100,253000
353820,202108,226,95,131,104500,144100,248600
353830,202108,56,45,11,49500,12100,61600
353850,202108,185,90,95,99000,104500,203500
353860,202108,516,218,298,239800,327800,567600
353870,202108,5511,2744,2767,3028300,3050300,6078600
353880,202108,705,465,240,511500,264000,775500
353890,202108,548,320,228,352000,250800.59,602800.59
353900,202108,130,68,62,74800,68200,143000
353910,202108,187,84,103,92400,113300,205700
353920,202108,414,223,191,245300,210100,455400
353930,202108,1047,605,442,666600,486200,1152800
353940,202108,195,100,95,110000,104500,214500
353950,202108,489,305,184,336600,202400,539000
353960,202108,77,62,15,68200,16500,84700
353970,202108,43,27,16,29700,17600,47300
353980,202108,1759,783,976,861300,1073600,1934900
353990,202108,80,45,35,50600,38500,89100
354000,202108,381,176,205,193600,226600,420200
354010,202108,93,53,40,58300,44000,102300
354020,202108,497,311,186,342100,204600,546700
354025,202108,34,29,5,31900,5500,37400
354030,202108,46,25,21,27500,23100,50600
354040,202108,96,70,26,77000,28600,105600
354050,202108,176,95,81,104500.63,89100,193600.63
354060,202108,746,352,394,389400,433400,822800
354070,202108,920,518,402,573100,442200,1015300
354075,202108,184,84,100,92400,110000,202400
354080,202108,305,131,174,144100,191400,335500
354085,202108,25,14,11,15400,12100,27500
354090,202108,276,167,109,183607,119900,303507
354100,202108,5694,2311,3383,2545400.4,3730100,6275500.4
354105,202108,98,45,53,49500,59400,108900
354110,202108,44,22,22,24200,24200,48400
354120,202108,141,95,46,104500.93,51700,156200.93
354130,202108,706,428,278,470801.19,305800,776601.19
354140,202108,3181,1424,1757,1569700.55,1936000,3505700.55
354150,202108,626,360,266,397100.66,292600,689700.66
354160,202108,638,400,238,440000,262900,702900
354165,202108,15,13,2,14300,2200,16500
354170,202108,172,119,53,130900,58300,189200
354180,202108,58,34,24,37400.42,26400,63800.42
354190,202108,196,78,118,85800,129800,215600
354200,202108,108,55,53,60500,58300,118800
354210,202108,65,23,42,25300,46200,71500
354220,202108,623,394,229,434500.63,253000,687500.63
354230,202108,170,75,95,82500,104500,187000
354240,202108,327,207,120,227700.82,132000,359700.82
354250,202108,83,50,33,55000,36300,91300
354260,202108,2137,991,1146,1090100.5,1261700.85,2351801.35
354270,202108,87,63,24,69300,26400,95700
354280,202108,49,25,24,27500,26400,53900
354290,202108,141,95,46,104500,50600,155100
354300,202108,353,246,107,270600.63,117700,388300.63
354310,202108,91,66,25,72600,27500,100100
354320,202108,215,103,112,113300,123200,236500
354323,202108,9,8,1,8800,1100,9900
354325,202108,123,66,57,72600.83,62700,135300.83
354330,202108,2419,813,1606,894143,1766600,2660743
354340,202108,10291,4763,5528,5243468,6092900,11336368
354350,202108,137,87,50,95700,55000,150700
354360,202108,71,41,30,45100,33000,78100
354370,202108,239,124,115,136400,126500,262900
354380,202108,178,104,74,114400,81400,195800
354390,202108,2691,951,1740,1048300,1918400,2966700
354400,202108,294,167,127,183700,140800,324500
354410,202108,636,287,349,315700,383900,699600
354420,202108,267,169,98,187000,107800,294800
354425,202108,321,179,142,196951,156200,353151
354430,202108,191,107,84,117700,92400,210100
354440,202108,33,26,7,28600,7700,36300
354450,202108,54,35,19,38500,20900,59400
354460,202108,96,56,40,61600,44000,105600
354470,202108,27,14,13,15400,14300,29700
354480,202108,106,58,48,63800,53900,117700
354490,202108,132,82,50,90200,55000,145200
354500,202108,385,171,214,188100,236500,424600
354510,202108,94,62,32,68200,35200,103400
354515,202108,43,10,33,11000,36300,47300
354520,202108,1601,674,927,742343,1019700,1762043
354530,202108,798,400,398,440000,440000,880000
354540,202108,269,136,133,149600,146300,295900
354550,202108,39,23,16,25300,17600,42900
354560,202108,153,82,71,90200,78100,168300
354570,202108,136,91,45,100100,49500,149600
354580,202108,1826,854,972,940500,1069200,2009700
354600,202108,268,137,131,150700,144100,294800
354610,202108,70,58,12,63800,13200,77000
354620,202108,65,16,49,17600,53900,71500
354625,202108,13,8,5,8800,5500,14300
354630,202108,311,201,110,222200,121000,343200
354640,202108,814,501,313,553300,345400,898700
354650,202108,65,37,28,40700,30800,71500
354660,202108,789,579,210,636900,232100,869000
354670,202108,225,84,141,93500,155100,248600
354680,202108,1290,453,837,498300,921800,1420100
354690,202108,77,52,25,57200,27500,84700
354700,202108,75,51,24,56100,27500,83600
354710,202108,49,35,14,38500,15400,53900
354720,202108,21,20,1,22000,1100,23100
354730,202108,1755,703,1052,775500,1158300,1933800
354740,202108,76,51,25,56100,27500,83600
354750,202108,416,237,179,261800,196900,458700
354760,202108,487,297,190,326700,210100,536800
354765,202108,9,4,5,4400,5500,9900
354770,202108,350,228,122,251900,134200,386100
354780,202108,8260,3118,5142,3435301.13,5661700,9097001.13
354790,202108,91,54,37,59400,40700,100100
354800,202108,447,244,203,268304.32,223300,491604.32
354805,202108,85,38,47,41800,51700,93500
354810,202108,103,60,43,66000,47300,113300
354820,202108,202,82,120,90200,132000,222200
354830,202108,44,24,20,26400,22000,48400
354840,202108,57,39,18,42900,20900,63800
354850,202108,4453,1934,2519,2132900.08,2775300.06,4908200.14
354860,202108,338,161,177,177100,194700,371800
354870,202108,11912,5165,6747,5685901.26,7431600,13117501.26
354880,202108,2691,978,1713,1076900.89,1885451.7,2962352.59
354890,202108,2891,1517,1374,1670900.73,1513600,3184500.73
354900,202108,64,43,21,47300,23100,70400
354910,202108,1279,645,634,709500,698500,1408000
354920,202108,39,32,7,35200,7700,42900
354925,202108,19,8,11,8800,12100,20900
354930,202108,36,32,4,35200.4,4400,39600.4
354940,202108,785,559,226,616000,248600,864600
354950,202108,211,128,83,140800,91300,232100
354960,202108,134,49,85,53900,93500,147400
354970,202108,1016,686,330,754601.26,364100,1118701.26
354980,202108,8961,3158,5803,3478202.15,6392100.39,9870302.54
354990,202108,9786,4322,5464,4759700,6019200,10778900
354995,202108,555,174,381,191400,419100,610500
355000,202108,456,157,299,172700,330000,502700
355010,202108,589,359,230,396000,253000.63,649000.63
355020,202108,784,483,301,533500,332200,865700
355030,202108,210299,78092,132207,86003767.74,145591645.94,231595413.68
355040,202108,843,389,454,427900,500500,928400
355050,202108,162,93,69,102300,75900,178200
355060,202108,1690,806,884,887700,972400,1860100
355070,202108,1525,696,829,765600.08,911900.73,1677500.81
355080,202108,188,115,73,126500,81400,207900
355090,202108,289,169,120,185900,132000.57,317900.57
355100,202108,5226,2463,2763,2710290,3044800,5755090
355110,202108,241,158,83,173800,91300,265100
355120,202108,58,38,20,41800,22000,63800
355130,202108,48,28,20,30800,22000,52800
355140,202108,191,113,78,124300,85800,210100
355150,202108,676,395,281,436700,309100,745800
355160,202108,480,228,252,250800.63,277200,528000.63
355170,202108,2051,1045,1006,1150600,1106600,2257200
355180,202108,688,275,413,302500,454300,756800
355190,202108,216,146,70,160600,78100,238700
355200,202108,108,57,51,62700,56100,118800
355210,202108,702,386,316,424600,347600,772200
355220,202108,7393,3668,3725,4039200,4101900,8141100
355230,202108,93,56,37,61600,40700,102300
355240,202108,4531,1841,2690,2025100.5,2961200,4986300.5
355250,202108,6133,2615,3518,2879821.06,3872000,6751821.06
355255,202108,48,29,19,31900,20900,52800
355260,202108,175,106,69,116600,75900,192500
355270,202108,167,108,59,119900,64900,184800
355280,202108,6721,2495,4226,2748900,4650800,7399700
355290,202108,72,57,15,62700,16500,79200
355300,202108,215,121,94,134200,103400,237600
355310,202108,111,57,54,62700,59400,122100
355320,202108,94,49,45,55000,49500,104500
355330,202108,285,159,126,174900,138600,313500
355340,202108,1444,492,952,542301.18,1048300,1590601.18
355350,202108,158,76,82,83600,90200,173800
355360,202108,174,116,58,127600,63800,191400
355365,202108,17,13,4,14300,4400,18700
355370,202108,1016,609,407,669900.63,447700,1117600.63
355380,202108,805,499,306,550000,337700,887700
355385,202108,82,53,29,58300,31900,90200
355390,202108,111,58,53,63800,58300,122100
355395,202108,191,103,88,113300.5,96800,210100.5
355400,202108,1729,988,741,1088909,816200.63,1905109.63
355410,202108,4964,2272,2692,2503600,2966700,5470300
355420,202108,49,35,14,38500,15400,53900
355430,202108,398,244,154,268400,169400,437800
355440,202108,83,49,34,53900,37400,91300
355450,202108,422,207,215,227700,236500,464200
355460,202108,56,44,12,48400,13200,61600
355465,202108,48,27,21,29700,23100,52800
355470,202108,182,73,109,80300,121000,201300
355475,202108,14,9,5,9900,5500,15400
355480,202108,578,232,346,255200,380600,635800
355490,202108,113,77,36,84700,39600,124300
355495,202108,75,27,48,29700,52800,82500
355500,202108,1604,868,736,957000.48,809600,1766600.48
355510,202108,271,195,76,214500.63,83600,298100.63
355520,202108,29,22,7,24200,7700,31900
355530,202108,23,12,11,13200,12100,25300
355535,202108,75,33,42,36300,46200,82500
355540,202108,2604,1002,1602,1105655.1,1765500.63,2871155.73
355550,202108,58,34,24,37400,26400,63800
355560,202108,241,110,131,121000,144100,265100
355570,202108,20,13,7,14300,7700,22000
355580,202108,242,170,72,187000,79200,266200
355590,202108,17,9,8,9900,8800,18700
355600,202108,264,131,133,144100,147400,291500
355610,202108,232,148,84,162800,92400,255200
355620,202108,1298,558,740,616000,817300,1433300
355630,202108,414,305,109,335500,119900,455400
355635,202108,122,54,68,59400,74800,134200
355640,202108,535,293,242,323400,266200,589600
355645,202108,868,332,536,365200,592900,958100
355650,202108,1928,812,1116,894300,1229800,2124100
355660,202108,235,125,110,137500,121000,258500
355670,202108,590,243,347,267300,381700,649000
355680,202108,206,113,93,124300,102300,226600
355690,202108,90,44,46,48400,50600,99000
355695,202108,22,14,8,15400,8800,24200
355700,202108,1162,584,578,642400,636900,1279300
355710,202108,2241,1202,1039,1324400,1145100,2469500
355715,202108,13,11,2,12100,2200,14300
355720,202108,244,148,96,162800,105600,268400
355730,202108,102,60,42,66000,46200,112200
410010,202108,135,106,29,116600,31900,148500
410020,202108,117,87,30,95700,33000,128700
410030,202108,175,96,79,105600,86900,192500
410040,202108,1263,615,648,677600,712800,1390400
410045,202108,43,32,11,35200,12100,47300
410050,202108,500,283,217,311300,238700,550000
410060,202108,281,205,76,225500,83600,309100
410070,202108,287,242,45,267300,49500,316800
410080,202108,172,99,73,110000,80300,190300
410090,202108,72,62,10,68200,11000,79200
410100,202108,291,197,94,216700,103400,320100
410105,202108,43,25,18,27500,19800,47300
410110,202108,336,201,135,221100,148500,369600
410115,202108,43,26,17,28600,18700,47300
410120,202108,431,199,232,218900,255200,474100
410130,202108,56,32,24,35200,26400,61600
410140,202108,3144,1429,1715,1571900.03,1889800.88,3461700.91
410150,202108,2676,1035,1641,1139600.63,1805100,2944700.63
410160,202108,493,292,201,321200,221100,542300
410165,202108,49,28,21,30800,23100,53900
410170,202108,191,117,74,128700,81400,210100
410180,202108,2272,1221,1051,1344200,1157200,2501400
410185,202108,32,28,4,30800,4400,35200
410190,202108,491,310,181,341000,200200,541200
410200,202108,947,665,282,732600,311300,1043900
410210,202108,613,309,304,341000,334400,675400
410220,202108,47,21,26,23100,28600,51700
410230,202108,165,74,91,81400,100100,181500
410240,202108,727,458,269,504900,295900,800800
410250,202108,377,264,113,290400,124300,414700
410260,202108,299,163,136,180400,149600,330000
410270,202108,28,21,7,23100,7700,30800
410275,202108,60,44,16,48400,17600,66000
410280,202108,328,187,141,205700,155100,360800
410290,202108,271,152,119,167200,130900,298100
410300,202108,79,53,26,58300,28600,86900
410302,202108,24,15,9,16500,9900,26400
410304,202108,37,24,13,27500,14300,41800
410305,202108,221,118,103,129800,113300,243100
410310,202108,208,122,86,134200,94600,228800
410315,202108,45,31,14,34100,15400,49500
410320,202108,138,90,48,99000,52800,151800
410322,202108,35,21,14,23100,15400,38500
410330,202108,179,119,60,130900,66000,196900
410335,202108,100,56,44,61600,48400,110000
410337,202108,44,34,10,37400,11000,48400
410340,202108,40,33,7,36300,7700,44000
410345,202108,208,119,89,130900,97900,228800
410347,202108,46,36,10,39600,11000,50600
410350,202108,248,141,107,155100,117700,272800
410360,202108,434,268,166,295900,182600,478500
410370,202108,2315,949,1366,1047200,1505900,2553100
410380,202108,203,118,85,129800,93500,223300
410390,202108,388,261,127,287100,139700,426800
410395,202108,35,21,14,23100,15400,38500
410400,202108,850,361,489,398201.03,537900,936101.03
410405,202108,79,60,19,66000,20900,86900
410410,202108,27,18,9,19800,9900,29700
410420,202108,1722,778,944,855702.1,1039500,1895202.1
410425,202108,180,70,110,77000,122100,199100
410430,202108,2315,1231,1084,1355200,1193500,2548700
410440,202108,369,266,103,292600,113300,405900
410442,202108,366,236,130,260700,143000,403700
410445,202108,416,294,122,323400,134200,457600
410450,202108,395,193,202,212300,222200,434500
410460,202108,556,284,272,312400,299200,611600
410465,202108,239,135,104,148500,114400,262900
410470,202108,256,145,111,160600,122100,282700
410480,202108,6439,3044,3395,3356100,3738900,7095000
410490,202108,1427,825,602,908600,663300,1571900
410500,202108,272,153,119,168300,130900,299200
410510,202108,172,125,47,137500,51700,189200
410520,202108,262,188,74,206800,81400,288200
410530,202108,303,97,206,106700,227700,334400
410540,202108,335,244,91,268400,100100,368500
410550,202108,1695,691,1004,761200,1105500,1866700
410560,202108,152,103,49,113300,53900,167200
410570,202108,442,293,149,322300,163900,486200
410580,202108,3576,1485,2091,1634600.35,2300100,3934700.35
410590,202108,403,263,140,289281,154000,443281
410600,202108,193,167,26,185386.66,28600,213986.66
410610,202108,51,42,9,46200,9900,56100
410620,202108,262,170,92,187000.4,101200,288200.4
410630,202108,448,243,205,268400,225500,493900
410640,202108,1032,636,396,699600,435600,1135200
410645,202108,111,79,32,86900,35200,122100
410650,202108,366,225,141,247500,155100,402600
410655,202108,87,61,26,67100,28600,95700
410657,202108,34,10,24,11000,26400,37400
410660,202108,628,418,210,459800.5,231000,690800.5
410670,202108,75,61,14,67100,15400,82500
410680,202108,191,153,38,169400,41800,211200
410685,202108,29,18,11,19800,12100,31900
410690,202108,28607,11707,16900,12904100.15,18620800.74,31524900.89
410700,202108,324,236,88,260700,96800,357500
410710,202108,130,105,25,115500,27500,143000
410712,202108,45,32,13,35200,14300,49500
410715,202108,86,66,20,72600,22000,94600
410720,202108,671,377,294,416900.92,324500,741400.92
410725,202108,183,129,54,141900,59400,201300
410730,202108,104,50,54,55000,59400,114400
410740,202108,106,72,34,79200,37400,116600
410750,202108,285,186,99,206800,108900,315700
410752,202108,21,14,7,15400,7700,23100
410753,202108,60,22,38,24200,41800,66000
410754,202108,53,25,28,27500,30800,58300
410755,202108,77,44,33,48400,37400,85800
410760,202108,758,408,350,448800,385000,833800
410765,202108,1837,828,1009,910800,1109900,2020700
410770,202108,116,84,32,92400,35200,127600
410773,202108,62,43,19,47300,20900,68200
410775,202108,181,134,47,148500,52800,201300
410780,202108,91,49,42,53900,46200,100100
410785,202108,53,43,10,47300,11000,58300
410790,202108,88,38,50,41800,55000,96800
410800,202108,279,174,105,191400,115500,306900
410810,202108,25,13,12,14300,13200,27500
410820,202108,167,117,50,128700,56100,184800
410830,202108,8854,3692,5162,4065600.4,5680400,9746000.4
410832,202108,108,72,36,79200,39600,118800
410840,202108,1455,768,687,844800.21,755700,1600500.21
410845,202108,48,27,21,29700,23100,52800
410850,202108,181,130,51,143000,56100,199100
410855,202108,66,56,10,61600,11000,72600
410860,202108,768,385,383,424600,423500,848100
410865,202108,99,71,28,78100,30800,108900
410870,202108,147,125,22,138600,24200,162800
410880,202108,1154,563,591,619300,650100,1269400
410890,202108,91,64,27,70400,29700,100100
410895,202108,74,57,17,62700,18700,81400
410900,202108,26,18,8,19800,8800,28600
410910,202108,16,11,5,12100,5500,17600
410920,202108,37,23,14,25300,15400,40700
410930,202108,550,332,218,366300,239800,606100
410940,202108,4414,2326,2088,2560800.6,2297900,4858700.6
410950,202108,103,76,27,83600,29700,113300
410960,202108,870,334,536,368500,589600,958100
410965,202108,68,45,23,49500,25300,74800
410970,202108,614,423,191,465300,210100,675400
410975,202108,130,82,48,90200.38,52800,143000.38
410980,202108,1622,710,912,781000,1003200,1784200
410990,202108,267,188,79,206800,86900,293700
411000,202108,66,36,30,39600,33000,72600
411005,202108,29,24,5,26400,5500,31900
411007,202108,251,142,109,157300,119900,277200
411010,202108,600,389,211,429000,232100,661100
411020,202108,291,187,104,206800,114400,321200
411030,202108,22,11,11,12100,12100,24200
411040,202108,56,36,20,39600,22000,61600
411050,202108,216,156,60,172700,66000,238700
411060,202108,516,342,174,376200,191400,567600
411065,202108,49,44,5,48400,5500,53900
411070,202108,1267,730,537,805200,590700,1395900
411080,202108,240,168,72,184800,79200,264000
411090,202108,94,72,22,79200,24200,103400
411095,202108,324,115,209,126500,229900,356400
411100,202108,118,93,25,102300,27500,129800
411110,202108,129,77,52,84700,57200,141900
411120,202108,215,142,73,156200,80300,236500
411125,202108,276,119,157,130900,172700,303600
411130,202108,120,102,18,113300,19800,133100
411140,202108,215,144,71,158400,78100,236500
411150,202108,1246,801,445,881100,490600.63,1371700.63
411155,202108,123,84,39,92400,42900,135300
411160,202108,29,12,17,13200,18700,31900
411170,202108,50,44,6,48400,6600,55000
411180,202108,985,636,349,699600,385000,1084600
411190,202108,332,186,146,204600,160600,365200
411200,202108,656,384,272,424600.63,299200,723800.63
411210,202108,680,351,329,386100,363000.1,749100.1
411220,202108,164,111,53,122100,58300,180400
411230,202108,37,30,7,33000,7700,40700
411240,202108,116,72,44,79200,49500,128700
411250,202108,425,308,117,338800,129800,468600
411260,202108,14,10,4,11000,4400,15400
411270,202108,267,137,130,151800,144100,295900
411275,202108,181,156,25,172700,27500,200200
411280,202108,197,141,56,155100.63,61600,216700.63
411290,202108,62,48,14,52800,15400,68200
411295,202108,127,99,28,110000,30800,140800
411300,202108,77,32,45,35200,49500,84700
411310,202108,92,69,23,75900,25300,101200
411320,202108,794,511,283,562100,312400,874500
411325,202108,57,40,17,44000,18700,62700
411330,202108,912,589,323,647900,356400.15,1004300.15
411340,202108,30,19,11,20900,12100,33000
411342,202108,58,43,15,47300,16500,63800
411345,202108,113,54,59,59400,64900,124300
411350,202108,495,364,131,400400,145200,545600
411360,202108,58,35,23,38500,25300,63800
411370,202108,14123,5567,8556,6132502.47,9422601.34,15555103.81
411373,202108,181,122,59,134200,66000,200200
411375,202108,79,62,17,68200,18700,86900
411380,202108,82,58,24,63800,26400,90200
411390,202108,127,72,55,79200,60500,139700
411400,202108,413,282,131,310200,144100,454300
411410,202108,481,221,260,243100,286000,529100
411420,202108,967,409,558,449900,616000,1065900
411430,202108,504,274,230,301400,253000,554400
411435,202108,31,18,13,19800,14300,34100
411440,202108,471,370,101,407000,111100,518100
411450,202108,422,355,67,390500,73700,464200
411460,202108,798,296,502,325600,552200,877800
411470,202108,101,69,32,75900,35200,111100
411480,202108,706,376,330,413600,364100,777700
411490,202108,289,182,107,201300,118800,320100
411500,202108,100,80,20,88000,22000,110000
411510,202108,221,175,46,193600,50600,244200
411520,202108,6117,2152,3965,2369400.25,4367000.7,6736400.95
411530,202108,127,86,41,94600,45100,139700
411535,202108,54,20,34,22000,37400,59400
411540,202108,363,241,122,265100,135300,400400
411545,202108,56,40,16,44000,17600,61600
411550,202108,81,60,21,66000,23100,89100
411560,202108,401,160,241,178200,266200,444400
411570,202108,911,307,604,338800,664400,1003200
411573,202108,27,16,11,17600,12100,29700
411575,202108,309,187,122,205700,134200,339900
411580,202108,1268,453,815,498300,896500,1394800
411585,202108,72,36,36,39600,39600,79200
411590,202108,17,11,6,12100,6600,18700
411600,202108,22,9,13,9900,14300,24200
411605,202108,246,94,152,103400,167200,270600
411610,202108,218,135,83,148500,91300,239800
411620,202108,395,196,199,215600,222200,437800
411630,202108,52,35,17,38500,18700,57200
411640,202108,32,22,10,24200,11000,35200
411650,202108,9,6,3,6600,3300,9900
411660,202108,41,29,12,31900,13200,45100
411670,202108,241,166,75,183700,83600,267300
411680,202108,164,133,31,146300,34100,180400
411690,202108,622,324,298,356400,327800,684200
411695,202108,67,47,20,51700,22000,73700
411700,202108,143,114,29,126500,31900,158400
411705,202108,105,70,35,77000,38500,115500
411710,202108,291,192,99,211200,108900,320100
411720,202108,136,89,47,97900,51700,149600
411721,202108,80,63,17,69300,19800,89100
411722,202108,105,43,62,47300,68200,115500
411725,202108,161,116,45,127600,49500,177100
411727,202108,98,76,22,83600,24200,107800
411729,202108,41,31,10,34100,11000,45100
411730,202108,556,345,211,379500,233200,612700
411740,202108,33,20,13,22000,14300,36300
411745,202108,64,47,17,51700,18700,70400
411750,202108,845,360,485,396000,533500,929500
411760,202108,1209,879,330,968000,363000,1331000
411770,202108,446,297,149,326700,163900,490600
411780,202108,357,233,124,256300,137500,393800
411790,202108,565,309,256,341000.18,281600,622600.18
411800,202108,149,108,41,119900.65,45100,165000.65
411810,202108,183,136,47,149600,51700,201300
411820,202108,2373,991,1382,1090100,1522400,2612500
411830,202108,12,11,1,12100,1100,13200
411840,202108,2087,1226,861,1348600,947100,2295700
411845,202108,63,21,42,23100,46200,69300
411850,202108,1238,665,573,731500,630300,1361800
411860,202108,49,29,20,31900,22000,53900
411870,202108,68,41,27,45100,29700,74800
411880,202108,436,259,177,284900,194700,479600
411885,202108,102,59,43,64900,47300,112200
411890,202108,307,204,103,224400,113300,337700
411900,202108,97,67,30,73700,33000,106700
411910,202108,182,137,45,151800,49500,201300
411915,202108,2314,906,1408,996600,1551000,2547600
411920,202108,114,89,25,97900,27500,125400
411925,202108,16,9,7,9900,7700,17600
411930,202108,800,564,236,620470.4,259600,880070.4
411940,202108,592,376,216,413600,237600,651200
411950,202108,1140,518,622,570900,685300,1256200
411960,202108,1113,713,400,785400,442200,1227600
411965,202108,26,15,11,16500,12100,28600
411970,202108,94,79,15,86900,16500,103400
411980,202108,195,109,86,119900,94600,214500
411990,202108,5173,2802,2371,3088801.42,2611471.5,5700272.92
411995,202108,572,177,395,194700,434500,629200
412000,202108,321,203,118,223300,129800,353100
412010,202108,41,23,18,25300,19800,45100
412015,202108,39,30,9,33000,9900,42900
412020,202108,20,16,4,17600,4400,22000
412030,202108,42,38,4,41800,4400,46200
412033,202108,51,28,23,31496.66,25300,56796.66
412035,202108,71,45,26,49500,28600,78100
412040,202108,39,20,19,22000,20900,42900
412050,202108,207,152,55,167200,60500,227700
412060,202108,772,559,213,620400.57,235400.13,855800.70
412065,202108,51,30,21,33000,23100,56100
412070,202108,164,114,50,126500,55000,181500
412080,202108,309,145,164,159500,180400,339900
412085,202108,38,16,22,17600,24200,41800
412090,202108,838,520,318,573100,349800,922900
412100,202108,259,214,45,235400,49500,284900
412110,202108,69,53,16,58300,17600,75900
412120,202108,339,187,152,205700,167200,372900
412125,202108,74,47,27,51700,29700,81400
412130,202108,40,25,15,27500,16500,44000
412135,202108,30,18,12,19800,13200,33000
412140,202108,382,239,143,262900,157300,420200
412150,202108,244,158,86,173800,94600,268400
412160,202108,91,55,36,60500,39600,100100
412170,202108,710,477,233,524700,256300,781000
412175,202108,34,25,9,27500,9900,37400
412180,202108,190,141,49,155100,53900,209000
412190,202108,316,246,70,271700,77000,348700
412200,202108,186,116,70,127600,77000,204600
412210,202108,93,69,24,75900,26400,102300
412215,202108,238,157,81,172700,89100,261800
412217,202108,64,52,12,57200,13200,70400
412220,202108,835,561,274,617100,301400,918500
412230,202108,303,185,118,203500,130900,334400
412240,202108,1326,629,697,691900,766700.95,1458600.95
412250,202108,407,251,156,276100,171600,447700
412260,202108,114,76,38,83600,41800,125400
412265,202108,173,130,43,143000,47300,190300
412270,202108,89,58,31,63800,34100,97900
412280,202108,90,70,20,77000,22000,99000
412290,202108,92,60,32,66000,35200,101200
412300,202108,207,140,67,154000,73700,227700
412310,202108,52,42,10,47300,11000,58300
412320,202108,91,73,18,80300,19800,100100
412330,202108,181,148,33,163900,36300,200200
412340,202108,163,112,51,124300,56100,180400
412350,202108,648,296,352,325600,388300,713900
412360,202108,25,21,4,23100,4400,27500
412370,202108,153,130,23,143000,25300,168300
412380,202108,222,166,56,183700,61600,245300
412382,202108,62,35,27,38500,29700,68200
412385,202108,152,106,46,116600,50600,167200
412390,202108,302,226,76,248600,83600,332200
412395,202108,70,57,13,62700,14300,77000
412400,202108,97,64,33,70400,36300,106700
412402,202108,235,117,118,128700,129800,258500
412405,202108,927,309,618,339900,679800,1019700
412410,202108,960,575,385,632500,424600,1057100
412420,202108,18,17,1,18700,1100,19800
412430,202108,21,19,2,20900,2200,23100
412440,202108,638,331,307,364100,337700,701800
412450,202108,76,68,8,74800,8800,83600
412460,202108,93,70,23,77000,25300,102300
412470,202108,211,164,47,180400,51700,232100
412480,202108,149,106,43,116600,47300,163900
412490,202108,160,136,24,149600,26400,176000
412500,202108,408,321,87,353100.44,95700,448800.44
412510,202108,166,136,30,149600,33000,182600
412520,202108,93,59,34,64900,37400,102300
412530,202108,109,53,56,58300,61600,119900
412535,202108,89,67,22,73700,24200,97900
412540,202108,83,40,43,44000,47300,91300
412545,202108,83,57,26,63800,28600,92400
412550,202108,4004,1593,2411,1754500.33,2657600,4412100.33
412555,202108,10,6,4,6600,4400,11000
412560,202108,651,439,212,482900,233200,716100
412570,202108,797,384,413,423500,455400,878900
412575,202108,94,65,29,71500,31900,103400
412580,202108,172,117,55,128700,60500,189200
412590,202108,32,29,3,31900,4400,36300
412600,202108,175,123,52,135300,57200,192500
412610,202108,34,13,21,14300,23100,37400
412620,202108,146,122,24,134200,26400,160600
412625,202108,2130,1051,1079,1156100.63,1186900,2343000.63
412627,202108,70,51,19,56100,20900,77000
412630,202108,391,257,134,282700,147400,430100
412635,202108,75,20,55,22000,60500,82500
412640,202108,102,72,30,79200,33000,112200
412650,202108,326,213,113,234300,124300,358600
412660,202108,460,268,192,295900,211200,507100
412665,202108,41,37,4,40700,4400,45100
412667,202108,298,188,110,206800,121000,327800
412670,202108,73,59,14,64900,15400,80300
412680,202108,312,231,81,254100,89100,343200
412690,202108,119,76,43,83600,47300,130900
412700,202108,180,119,61,130900,67100,198000
412710,202108,1341,765,576,841500,634700,1476200
412720,202108,237,133,104,146300,114400,260700
412730,202108,192,162,30,178200,34100,212300
412740,202108,422,210,212,231000,233200,464200
412750,202108,432,231,201,254100,221100,475200
412760,202108,318,160,158,176000,173800,349800
412770,202108,2129,1136,993,1256200.63,1094500,2350700.63
412780,202108,141,104,37,114400,40700,155100
412785,202108,313,148,165,162800,181500,344300
412788,202108,44,27,17,29700,18700,48400
412790,202108,122,99,23,109523.33,25300,134823.33
412795,202108,151,105,46,115500,50600,166100
412796,202108,299,190,109,209000,119900,328900
412800,202108,648,383,265,421300,291500,712800
412810,202108,3001,1586,1415,1745700.59,1559800,3305500.59
412820,202108,949,567,382,623700,421300.11,1045000.11
412830,202108,14,11,3,12100,3300,15400
412840,202108,246,164,82,180400,90200,270600
412850,202108,731,458,273,503800,301400,805200
412853,202108,169,79,90,86900,99000,185900
412855,202108,194,102,92,112200.26,101200,213400.26
412860,202108,97,65,32,71500,35200,106700
412862,202108,69,44,25,48400,27500,75900
412863,202108,9,7,2,7700,2200,9900
412865,202108,42,31,11,34100,12100,46200
412870,202108,105,62,43,68200,47300,115500
412880,202108,95,66,29,72600,31900,104500
420005,202108,41,37,4,40700,4400,45100
420010,202108,369,235,134,258500,147400,405900
420020,202108,86,69,17,75900,18700,94600
420030,202108,24,19,5,22000,5500,27500
420040,202108,96,74,22,81400,24200,105600
420050,202108,59,35,24,38500,26400,64900
420055,202108,17,17,0,18700,0,18700
420060,202108,27,20,7,22000,7700,29700
420070,202108,104,87,17,95700,18700,114400
420075,202108,10,10,0,11000,0,11000
420080,202108,41,36,5,39600,5500,45100
420090,202108,39,32,7,35200,7700,42900
420100,202108,157,133,24,146300,26400,172700
420110,202108,21,21,0,23100,0,23100
420120,202108,65,46,19,50600,20900,71500
420125,202108,85,65,20,71500,22000,93500
420127,202108,32,26,6,28600,6600,35200
420130,202108,457,273,184,300300,204600,504900
420140,202108,1327,732,595,806300,655600,1461900
420150,202108,47,36,11,39600,12100,51700
420160,202108,29,27,2,29700,2200,31900
420165,202108,16,11,5,12100,5500,17600
420170,202108,67,40,27,44000,29700,73700
420180,202108,21,18,3,19800,3300,23100
420190,202108,25,22,3,24200,3300,27500
420195,202108,146,68,78,74800,85800,160600
420200,202108,1286,536,750,590700,825000,1415700
420205,202108,91,51,40,56100,44000,100100
420207,202108,132,71,61,78100,67100,145200
420208,202108,20,16,4,17600,4400,22000
420209,202108,13,11,2,13200,2200,15400
420210,202108,545,255,290,280500,319000,599500
420213,202108,47,35,12,38500,13200,51700
420215,202108,25,21,4,23100,4400,27500
420220,202108,63,38,25,41800,27500,69300
420230,202108,890,527,363,581900,400400,982300
420240,202108,2196,1421,775,1567500,852500,2420000
420243,202108,44,35,9,38500,9900,48400
420245,202108,186,92,94,101200,103400,204600
420250,202108,63,42,21,46200,23100,69300
420253,202108,28,21,7,23100,7700,30800
420257,202108,12,9,3,9900,3300,13200
420260,202108,105,84,21,92400,23100,115500
420270,202108,29,23,6,25300,6600,31900
420280,202108,289,217,72,238700,79200,317900
420285,202108,22,15,7,16500,7700,24200
420287,202108,51,33,18,36300,19800,56100
420290,202108,945,643,302,708400,334400,1042800
420300,202108,1481,1178,303,1295800,333300,1629100
420310,202108,48,33,15,36300,16500,52800
420315,202108,32,25,7,27500,7700,35200
420320,202108,978,459,519,504900,572000,1076900
420325,202108,3,1,2,1100,2200,3300
420330,202108,125,79,46,86900,50600,137500
420340,202108,171,117,54,128700,59400,188100
420350,202108,256,177,79,194700,86900,281600
420360,202108,700,542,158,596200.88,174900,771100.88
420370,202108,131,76,55,83600,60500,144100
420380,202108,1199,825,374,909700.99,411400,1321100.99
420390,202108,232,162,70,179300,77000,256300
420395,202108,191,139,52,152900,57200,210100
420400,202108,243,185,58,204600,63800,268400
420410,202108,57,44,13,48400,14300,62700
420415,202108,34,29,5,31900,5500,37400
420417,202108,53,42,11,47300,12100,59400
420419,202108,12,11,1,12100,1100,13200
420420,202108,2797,1722,1075,1895300,1183600,3078900
420425,202108,70,56,14,62700,15400,78100
420430,202108,1117,804,313,888800,344300,1233100
420435,202108,14,12,2,13200,2200,15400
420440,202108,98,70,28,77000,30800,107800
420445,202108,29,28,1,30800,1100,31900
420450,202108,80,36,44,40700,48400,89100
420455,202108,200,153,47,168300,51700,220000
420460,202108,2313,1447,866,1595000,955900,2550900
420470,202108,99,70,29,77000,31900,108900
420475,202108,10,9,1,9900,1100,11000
420480,202108,864,650,214,715000,236500,951500
420490,202108,98,71,27,78100,29700,107800
420500,202108,451,236,215,259600.26,236500,496100.26
420510,202108,22,20,2,22000,2200,24200
420515,202108,28,15,13,16500,14300,30800
420517,202108,8,8,0,8800,0,8800
420519,202108,0,,,,,0.0
420520,202108,63,49,14,55000,15400,70400
420530,202108,153,98,55,107800,60500,168300
420535,202108,19,17,2,18700,2200,20900
420540,202108,5912,3606,2306,3978975,2539900,6518875
420543,202108,28,26,2,28600,2200,30800
420545,202108,213,150,63,165000,69300,234300
420550,202108,812,670,142,737000,156200,893200
420555,202108,30,21,9,23100,9900,33000
420560,202108,62,50,12,55000,13200,68200
420570,202108,181,95,86,104500,94600,199100
420580,202108,285,136,149,149600,163900,313500
420590,202108,473,312,161,343200,178200,521400
420600,202108,137,73,64,80300,70400,150700
420610,202108,35,32,3,36300,3300,39600
420620,202108,81,61,20,67100,23100,90200
420630,202108,143,88,55,97900,60500,158400
420640,202108,79,69,10,75900,11000,86900
420650,202108,253,127,126,139700,138600,278300
420660,202108,43,35,8,38500,8800,47300
420665,202108,42,27,15,29700,16500,46200
420670,202108,269,211,58,235400,63800,299200
420675,202108,14,12,2,13200,2200,15400
420680,202108,33,25,8,27500,8800,36300
420690,202108,180,138,42,151800,46200,198000
420700,202108,700,454,246,500500.7,270600,771100.7
420710,202108,151,79,72,86900,79200,166100
420720,202108,101,80,21,88000,23100,111100
420730,202108,662,398,264,438900,290400,729300
420740,202108,54,53,1,58300,1100,59400
420750,202108,485,322,163,354200,179300,533500
420757,202108,16,14,2,15400,2200,17600
420760,202108,38,30,8,33000,8800,41800
420765,202108,80,59,21,64900,23100,88000
420768,202108,51,40,11,44000,12100,56100
420770,202108,71,58,13,63800,14300,78100
420775,202108,40,37,3,40700,3300,44000
420780,202108,206,162,44,178200.55,48400,226600.55
420785,202108,21,13,8,14300,8800,23100
420790,202108,154,127,27,139700,29700,169400
420800,202108,66,48,18,52800,19800,72600
420810,202108,257,207,50,227700,55000,282700
420820,202108,2448,1366,1082,1507000,1193500.5,2700500.5
420830,202108,636,328,308,361900,339900,701800
420840,202108,146,101,45,111100,49500,160600
420845,202108,413,169,244,187000,268400,455400
420850,202108,264,198,66,217800,73700,291500
420860,202108,57,47,10,51700,11000,62700
420870,202108,132,93,39,102300,42900,145200
420880,202108,184,118,66,129800,72600,202400
420890,202108,951,466,485,512600,533500,1046100
420895,202108,8,8,0,8800,0,8800
420900,202108,401,318,83,352000,91300,443300
420910,202108,5722,3056,2666,3368201.3,2939200,6307401.3
420915,202108,61,54,7,59400,7700,67100
420917,202108,20,14,6,15400,6600,22000
420920,202108,21,14,7,15400,7700,23100
420930,202108,2942,1847,1095,2034929,1207800.18,3242729.18
420940,202108,585,425,160,467500,176000,643500
420945,202108,10,7,3,7700,3300,11000
420950,202108,54,44,10,48400,11000,59400
420960,202108,110,91,19,100100,20900,121000
420970,202108,281,225,56,247500,61600,309100
420980,202108,22,21,1,23100,1100,24200
420985,202108,57,51,6,56100,6600,62700
420990,202108,80,58,22,64900,24200,89100
421000,202108,48,26,22,28600,24200,52800
421003,202108,44,31,13,34100,14300,48400
421005,202108,7,4,3,4400,3300,7700
421010,202108,801,518,283,570900,313500,884400
421020,202108,25,20,5,22000,5500,27500
421030,202108,112,96,16,105600,17600,123200
421040,202108,69,49,20,53900,22000,75900
421050,202108,336,232,104,255200,114400,369600
421055,202108,20,15,5,16500,5500,22000
421060,202108,97,53,44,58300,48400,106700
421070,202108,36,30,6,34100,6600,40700
421080,202108,39,32,7,36300,7700,44000
421085,202108,20,16,4,17600,4400,22000
421090,202108,34,27,7,29700,7700,37400
421100,202108,115,84,31,92400,34100,126500
421105,202108,182,147,35,161700,38500,200200
421110,202108,115,84,31,92400,34100,126500
421120,202108,174,127,47,139700.92,51700,191400.92
421125,202108,19,12,7,13200,7700,20900
421130,202108,844,518,326,569800,358600,928400
421140,202108,34,23,11,25300,12100,37400
421145,202108,48,37,11,40700,12100,52800
421150,202108,95,71,24,78100,26400,104500
421160,202108,65,42,23,46200,25300,71500
421165,202108,16,13,3,14300,3300,17600
421170,202108,179,149,30,165132,33000,198132
421175,202108,171,116,55,127600,60500,188100
421180,202108,44,29,15,31900,16500,48400
421185,202108,14,11,3,12100,3300,15400
421187,202108,2,1,1,1100,1100,2200
421189,202108,46,32,14,35200,15400,50600
421190,202108,1802,1128,674,1243000,742500.55,1985500.55
421200,202108,93,67,26,73700,28600,102300
421205,202108,28,19,9,20900,9900,30800
421210,202108,176,125,51,137500,57200,194700
421220,202108,251,192,59,212300,66000,278300
421223,202108,45,35,10,38500,12100,50600
421225,202108,71,44,27,48400,29700,78100
421227,202108,78,62,16,68200,17600,85800
421230,202108,62,45,17,49500,18700,68200
421240,202108,17,17,0,18700,0,18700
421250,202108,376,217,159,238700,176000,414700
421260,202108,21,17,4,18700,4400,23100
421265,202108,2,2,0,2200,0,2200
421270,202108,49,43,6,47300,6600,53900
421280,202108,360,187,173,206800,190300,397100
421290,202108,325,215,110,237600,121000,358600
421300,202108,24,19,5,20900,5500,26400
421310,202108,51,34,17,37400,18700,56100
421315,202108,32,18,14,19800,15400,35200
421320,202108,130,85,45,93500,49500,143000
421330,202108,107,79,28,86900,30800,117700
421335,202108,41,30,11,33000,12100,45100
421340,202108,242,155,87,170500,95700,266200
421350,202108,188,109,79,122100.39,86900,209000.39
421360,202108,683,475,208,522500,229900,752400
421370,202108,189,138,51,152900,56100,209000
421380,202108,134,104,30,114400,33000,147400
421390,202108,17,11,6,12100,6600,18700
421400,202108,114,94,20,103400,22000,125400
421410,202108,21,18,3,19800,3300,23100
421415,202108,21,17,4,18700,4400,23100
421420,202108,107,91,16,100100,17600,117700
421430,202108,16,11,5,12100,5500,17600
421440,202108,59,52,7,57200,7700,64900
421450,202108,90,74,16,81400,17600.51,99000.51
421460,202108,58,44,14,48400,15400,63800
421470,202108,74,41,33,45100,36300,81400
421480,202108,749,567,182,624800,201300,826100
421490,202108,26,25,1,27500,1100,28600
421500,202108,484,297,187,327800,205700,533500
421505,202108,26,19,7,20900,7700,28600
421507,202108,34,27,7,29700,7700,37400
421510,202108,69,45,24,49500,26400,75900
421520,202108,54,44,10,48400,11000,59400
421530,202108,51,42,9,46200,9900,56100
421535,202108,20,19,1,20900,1100,22000
421540,202108,53,42,11,46200,12100,58300
421545,202108,87,62,25,68200,27500,95700
421550,202108,287,204,83,226600,91300,317900
421555,202108,17,15,2,16500,2200,18700
421560,202108,8,7,1,7700,1100,8800
421565,202108,117,76,41,83600,45100,128700
421567,202108,30,23,7,25300,7700,33000
421568,202108,44,39,5,42900,5500,48400
421569,202108,12,12,0,13200,0,13200
421570,202108,214,138,76,151800,83600,235400
421575,202108,27,24,3,26400,3300,29700
421580,202108,719,427,292,471972,322300,794272
421590,202108,20,19,1,20900,1100,22000
421600,202108,148,96,52,105600,57200,162800
421605,202108,111,76,35,83600,38500,122100
421610,202108,165,124,41,137500,45100,182600
421620,202108,1025,579,446,638000,491700,1129700
421625,202108,19,17,2,18700,2200,20900
421630,202108,330,201,129,222200,141900,364100
421635,202108,22,10,12,11000,13200,24200
421640,202108,100,82,18,90200,19800,110000
421650,202108,299,171,128,188100,140800,328900
421660,202108,2402,1444,958,1590600.78,1054900,2645500.78
421670,202108,172,123,49,135300,53900,189200
421680,202108,185,167,18,183700,19800,203500
421690,202108,345,241,104,265100,114400,379500
421700,202108,52,36,16,39600,17600,57200
421710,202108,25,24,1,26400,1100,27500
421715,202108,5,4,1,4400,1100,5500
421720,202108,625,431,194,475200,213400,688600
421725,202108,22,8,14,8800,15400,24200
421730,202108,26,19,7,20900,7700,28600
421740,202108,101,36,65,39600,71500,111100
421750,202108,198,144,54,158400,59400,217800
421755,202108,20,18,2,19800,2200,22000
421760,202108,103,67,36,73700,39600,113300
421770,202108,705,450,255,496906.66,280500,777406.66
421775,202108,29,18,11,19800,12100,31900
421780,202108,180,139,41,152900,45100,198000
421790,202108,145,124,21,136400,24200,160600
421795,202108,17,13,4,14300,4400,18700
421800,202108,550,336,214,369600,235400,605000
421810,202108,71,55,16,60500,17600,78100
421820,202108,305,193,112,212300,123200,335500
421825,202108,150,126,24,138600,26400,165000
421830,202108,151,93,58,102300,63800,166100
421835,202108,8,3,5,3300,5500,8800
421840,202108,46,40,6,44000,6600,50600
421850,202108,83,70,13,78100,14300,92400
421860,202108,43,31,12,34100,13200,47300
421870,202108,1045,762,283,840400,311300,1151700
421875,202108,51,42,9,46200,9900,56100
421880,202108,180,125,55,138600,60500,199100
421885,202108,25,18,7,19800,7700,27500
421890,202108,143,102,41,112200,45100.5,157300.5
421895,202108,46,41,5,45100,5500,50600
421900,202108,137,103,34,113300,37400,150700
421910,202108,61,38,23,41800,25300,67100
421915,202108,30,24,6,26400,6600,33000
421917,202108,37,27,10,29700,11000,40700
421920,202108,38,34,4,37400,4400,41800
421930,202108,632,499,133,548900,146300,695200
421935,202108,45,38,7,41800,7700,49500
421940,202108,50,42,8,46200,8800,55000
421950,202108,853,566,287,624800,315700,940500
421960,202108,39,34,5,37400,5500,42900
421970,202108,329,215,114,236500,125400,361900
421985,202108,18,11,7,12100,7700,19800
422000,202108,1,0,1,0,1100,1100
430003,202108,192,55,137,60500,150700,211200
430005,202108,35,26,9,28600,9900,38500
430010,202108,270,197,73,216700,80300,297000
430020,202108,149,100,49,110000,53900,163900
430030,202108,120,101,19,111100,20900,132000
430040,202108,2947,1728,1219,1904100.15,1340900,3245000.15
430045,202108,68,56,12,61600,13200,74800
430047,202108,7,5,2,5500,2200,7700
430050,202108,83,69,14,77000,15400,92400
430055,202108,11,10,1,11000,1100,12100
430057,202108,5,4,1,4400,1100,5500
430060,202108,3903,2256,1647,2483800,1815000,4298800
430063,202108,56,46,10,50600,11000,61600
430064,202108,158,124,34,136400,37400,173800
430066,202108,5,2,3,2200,3300,5500
430070,202108,40,28,12,30800,13200,44000
430080,202108,74,47,27,51700,29700,81400
430085,202108,27,11,16,12100,17600,29700
430087,202108,23,15,8,16500,8800,25300
430090,202108,65,56,9,61600,9900,71500
430100,202108,131,88,43,96800,47300,144100
430105,202108,152,84,68,93500,74800,168300
430107,202108,20,14,6,15400,6600,22000
430110,202108,492,268,224,294800,247500,542300
430120,202108,163,148,15,162800,16500,179300
430130,202108,787,475,312,523600,343200,866800
430140,202108,128,117,11,129800,12100,141900
430150,202108,106,65,41,71500,45100,116600
430155,202108,31,26,5,28600,5500,34100
430160,202108,3594,2046,1548,2251700,1702800,3954500
430163,202108,387,166,221,182600,244200,426800
430165,202108,31,20,11,22000,12100,34100
430170,202108,87,73,14,80300,15400,95700
430175,202108,79,59,20,64900,22000,86900
430180,202108,107,90,17,99000,18700,117700
430185,202108,28,18,10,19800,11000,30800
430187,202108,53,28,25,30800,27500,58300
430190,202108,233,120,113,132000,124300,256300
430192,202108,14,10,4,11000,4400,15400
430195,202108,18,12,6,13200,6600,19800
430200,202108,156,132,24,145200,26400,171600
430205,202108,20,20,0,22000,0,22000
430210,202108,706,534,172,588500,189200,777700
430215,202108,11,10,1,11000,1100,12100
430220,202108,71,47,24,52800,26400,79200
430222,202108,13,5,8,5500,8800,14300
430223,202108,17,11,6,12100,6600,18700
430225,202108,2,1,1,1100,1100,2200
430230,202108,323,196,127,215600,139700,355300
430235,202108,49,36,13,39600,14300,53900
430237,202108,24,18,6,19800,6600,26400
430240,202108,110,78,32,85800,35200,121000
430245,202108,72,57,15,63800,16500,80300
430250,202108,184,104,80,114400,88000,202400
430258,202108,8,7,1,7700,1100,8800
430260,202108,33,28,5,30800,5500,36300
430265,202108,34,29,5,31900,5500,37400
430270,202108,531,387,144,425700,158400,584100
430280,202108,1050,616,434,678700,477400,1156100
430290,202108,430,221,209,243100,229900,473000
430300,202108,2112,1144,968,1261700,1067000,2328700
430310,202108,2030,987,1043,1085700,1149500.7,2235200.7
430320,202108,56,47,9,51700,9900,61600
430330,202108,96,84,12,92400,13200,105600
430340,202108,69,55,14,60500,15400,75900
430350,202108,1648,1086,562,1196800,618200,1815000
430355,202108,19,18,1,19800,1100,20900
430360,202108,91,42,49,46200,53900,100100
430367,202108,36,27,9,29700,9900,39600
430370,202108,59,53,6,58300,6600,64900
430380,202108,121,92,29,101200,31900,133100
430390,202108,583,360,223,396000,246400,642400
430400,202108,264,189,75,207900,83600,291500
430410,202108,58,46,12,50600,13200,63800
430420,202108,512,318,194,349800,213400,563200
430430,202108,55,53,2,57567.4,2200,59767.4
430435,202108,142,107,35,117700,39600,157300
430440,202108,523,327,196,361900,215600,577500
430450,202108,1165,944,221,1039500,243100,1282600
430460,202108,5569,2858,2711,3148200.75,2984300,6132500.75
430461,202108,16,14,2,15400,2200,17600
430462,202108,4,2,2,2200,2200,4400
430463,202108,1129,603,526,664400,579700,1244100
430465,202108,25,14,11,15400,12100,27500
430466,202108,644,448,196,492800,216700,709500
430467,202108,115,64,51,70400,56100,126500
430468,202108,126,71,55,78100,60500,138600
430469,202108,21,16,5,17600,5500,23100
430470,202108,1153,629,524,692227.5,577500,1269727.5
430471,202108,65,40,25,44000,27500,71500
430480,202108,118,77,41,85800,45100,130900
430485,202108,8,8,0,8800,0,8800
430490,202108,76,60,16,66000,17600,83600
430495,202108,31,24,7,26400,7700,34100
430500,202108,188,128,60,140800,66000,206800
430510,202108,3630,2347,1283,2587200.67,1415700.03,4002900.70
430511,202108,16,16,0,17600,0,17600
430512,202108,145,96,49,105600,53900,159500
430513,202108,52,40,12,45100,13200,58300
430515,202108,25,24,1,26400,1100,27500
430517,202108,172,144,28,158400,30800,189200
430520,202108,338,239,99,262900,108900,371800
430530,202108,81,44,37,48400,40700,89100
430535,202108,446,296,150,325600,165000,490600
430537,202108,11,11,0,12100,0,12100
430540,202108,81,54,27,59400,29700,89100
430543,202108,373,115,258,126500,284900,411400
430544,202108,46,43,3,47300,3300,50600
430545,202108,379,171,208,189200,228800,418000
430550,202108,40,31,9,34100,9900,44000
430558,202108,1,1,0,1100,0,1100
430560,202108,54,31,23,34100,25300,59400
430570,202108,112,45,67,49500,73700,123200
430580,202108,124,98,26,107800,28600,136400
430583,202108,15,15,0,16500,0,16500
430585,202108,13,7,6,7700,6600,14300
430587,202108,13,8,5,8800,5500,14300
430590,202108,152,122,30,134200,33000,167200
430593,202108,2,2,0,2200,0,2200
430595,202108,18,14,4,15400,4400,19800
430597,202108,45,24,21,26400,23100,49500
430600,202108,218,166,52,182600,57200,239800
430605,202108,165,99,66,108900,73700,182600
430607,202108,30,24,6,26400,6600,33000
430610,202108,1726,797,929,876700,1024100,1900800
430613,202108,5,5,0,5500,0,5500
430620,202108,112,82,30,90200,33000,123200
430630,202108,47,39,8,42900,8800,51700
430632,202108,32,27,5,29700,5500,35200
430635,202108,40,33,7,36300,7700,44000
430637,202108,67,32,35,35200,38500,73700
430640,202108,180,98,82,107800,91300,199100
430642,202108,17,14,3,15400,3300,18700
430645,202108,30,25,5,27500,5500,33000
430650,202108,246,197,49,216700,53900,270600
430655,202108,5,4,1,4400,1100,5500
430660,202108,969,474,495,523600,544500,1068100
430670,202108,76,53,23,58300,25300,83600
430673,202108,76,45,31,49500,34100,83600
430675,202108,9,7,2,7700,2200,9900
430676,202108,571,336,235,369600,260700,630300
430680,202108,238,160,78,177100,85800,262900
430690,202108,522,318,204,349800,224400.63,574200.63
430692,202108,9,7,2,7700,2200,9900
430693,202108,138,85,53,93500,58300,151800
430695,202108,64,53,11,58300,12100,70400
430697,202108,63,38,25,41800,27500,69300
430700,202108,1438,972,466,1074700,512600,1587300
430705,202108,30,27,3,29700,3300,33000
430710,202108,256,159,97,174900,106700.65,281600.65
430720,202108,107,92,15,101200,16500,117700
430730,202108,138,118,20,129800,22000,151800
430740,202108,75,51,24,56100,26400,82500
430745,202108,32,21,11,23100,12100,35200
430750,202108,335,218,117,239800,128700,368500
430755,202108,88,47,41,51700,45100,96800
430760,202108,389,215,174,236500,191400,427900
430770,202108,1529,780,749,859100,825000,1684100
430780,202108,309,191,118,211200,130900,342100
430781,202108,25,22,3,24200,3300,27500
430783,202108,62,49,13,53900,14300,68200
430786,202108,6,4,2,4400,2200,6600
430790,202108,530,339,191,372900,210100,583000
430800,202108,158,124,34,136400.01,37400,173800.01
430805,202108,39,32,7,35200,7700,42900
430807,202108,59,33,26,36300,28600,64900
430810,202108,74,46,28,50600,30800,81400
430820,202108,147,89,58,97900,63800,161700
430825,202108,11,9,2,9900,2200,12100
430830,202108,244,226,18,248600,19800,268400
430840,202108,137,92,45,101200,50600,151800
430843,202108,7,5,2,5500,2200,7700
430845,202108,74,40,34,44000,38500,82500
430850,202108,591,423,168,465300,184800,650100
430860,202108,148,93,55,102300,60500,162800
430865,202108,79,42,37,46200,40700,86900
430870,202108,79,65,14,71500,15400,86900
430880,202108,150,108,42,118800,46200,165000
430885,202108,11,9,2,9900,2200,12100
430890,202108,336,204,132,224400,145200,369600
430900,202108,529,362,167,398200,183700,581900
430905,202108,121,51,70,56100,77000,133100
430910,202108,287,160,127,176000,139700,315700
430912,202108,4,4,0,4400,0,4400
430915,202108,36,33,3,36300,3300,39600
430920,202108,4434,2307,2127,2539900,2343000,4882900
430925,202108,5,4,1,4400,1100,5500
430930,202108,2066,1183,883,1303500,973500,2277000
430940,202108,256,165,91,181500,100100,281600
430950,202108,150,124,26,136400,28600,165000
430955,202108,26,14,12,15400,13200,28600
430957,202108,24,21,3,23100,3300,26400
430960,202108,246,161,85,177100,94600,271700
430965,202108,109,69,40,75900,44000,119900
430970,202108,92,72,20,79200,22000,101200
430975,202108,45,40,5,44000,5500,49500
430980,202108,47,29,18,31900,19800,51700
430990,202108,97,75,22,82500,24200,106700
430995,202108,112,104,8,114400,8800,123200
431000,202108,286,136,150,149600.6,167200,316800.6
431010,202108,347,193,154,212300,169400,381700
431020,202108,1867,1077,790,1186900,871200,2058100
431030,202108,37,29,8,31900,8800,40700
431033,202108,426,193,233,212300,256300,468600
431036,202108,11,6,5,6600,5500,12100
431040,202108,144,88,56,96800,62700,159500
431041,202108,38,23,15,26400,16500,42900
431043,202108,42,23,19,25300,20900,46200
431046,202108,12,9,3,9900,3300,13200
431050,202108,204,129,75,141900,82500,224400
431053,202108,66,36,30,39600,33000,72600
431055,202108,69,47,22,51700,24200,75900
431057,202108,18,18,0,19800,0,19800
431060,202108,1598,1032,566,1135200.31,623700,1758900.31
431065,202108,16,9,7,9900,7700,17600
431070,202108,62,57,5,63800,5500,69300
431075,202108,7,7,0,7700,0,7700
431080,202108,126,72,54,79200,59400,138600
431085,202108,31,28,3,30800,3300,34100
431087,202108,10,8,2,8800,2200,11000
431090,202108,53,40,13,44000,14300,58300
431100,202108,1237,728,509,800800,561000,1361800
431110,202108,223,135,88,148500,96800,245300
431112,202108,24,16,8,18700,8800,27500
431113,202108,30,22,8,24200,8800,33000
431115,202108,161,115,46,126500,50600,177100
431120,202108,604,344,260,378400,289300,667700
431123,202108,5,5,0,5500,0,5500
431125,202108,97,83,14,91300,15400,106700
431127,202108,8,5,3,5500,3300,8800
431130,202108,728,476,252,524700,277200,801900
431140,202108,782,542,240,598400,264000,862400
431142,202108,23,19,4,20900.55,4400,25300.55
431150,202108,192,143,49,157300,53900,211200
431160,202108,46,43,3,47300,3300,50600
431162,202108,3,3,0,3300,0,3300
431164,202108,5,5,0,5500,0,5500
431170,202108,113,83,30,92400,33000,125400
431171,202108,74,42,32,46200,35200,81400
431173,202108,1,1,0,1100,0,1100
431175,202108,203,103,100,113300,110000,223300
431177,202108,87,60,27,66000,29700,95700
431179,202108,16,12,4,13200,4400,17600
431180,202108,413,255,158,281600,173800,455400
431190,202108,74,54,20,59400,22000,81400
431198,202108,70,50,20,55000,22000,77000
431200,202108,21,17,4,18700,4400,23100
431205,202108,23,22,1,24200,1100,25300
431210,202108,100,63,37,69300,40700,110000
431213,202108,31,25,6,27500,6600,34100
431215,202108,22,19,3,22000,3300,25300
431217,202108,6,5,1,5500,1100,6600
431220,202108,68,58,10,63800,11000,74800
431225,202108,161,104,57,115500,62700,178200
431230,202108,97,84,13,92400,14300,106700
431235,202108,6,6,0,6600,0,6600
431237,202108,9,8,1,8800,1100,9900
431238,202108,12,9,3,9900,3300,13200
431240,202108,1053,642,411,706200,453200,1159400
431242,202108,38,37,1,40700,1100,41800
431244,202108,16,12,4,13200,4400,17600
431245,202108,50,38,12,41800,13200,55000
431247,202108,10,6,4,6600,4400,11000
431250,202108,289,141,148,155100,163900,319000
431260,202108,55,45,10,49500,11000,60500
431261,202108,18,12,6,13200,6600,19800
431262,202108,17,15,2,16500,2200,18700
431265,202108,157,84,73,92400,80300,172700
431267,202108,17,15,2,16500,2200,18700
431270,202108,327,255,72,280500,79200,359700
431275,202108,39,34,5,37400,5500,42900
431280,202108,19,15,4,16500,4400,20900
431290,202108,17,15,2,16500,2200,18700
431295,202108,2,1,1,1100,1100,2200
431300,202108,23,21,2,23100,2200,25300
431301,202108,6,6,0,6600,0,6600
431303,202108,62,38,24,41800,26400,68200
431306,202108,238,124,114,136204.2,126500,262704.2
431308,202108,8,5,3,5500,3300,8800
431310,202108,64,53,11,58300,12100,70400
431320,202108,160,93,67,102300,73700,176000
431330,202108,185,113,72,124300,79200,203500
431333,202108,29,23,6,25300,6600,31900
431335,202108,7,4,3,4400,3300,7700
431337,202108,388,176,212,193600,234300,427900
431339,202108,21,16,5,17600,5500,23100
431340,202108,3098,1656,1442,1823713.1,1587300,3411013.1
431342,202108,35,24,11,26400,12100,38500
431344,202108,18,18,0,19800,0,19800
431346,202108,4,4,0,4400,0,4400
431349,202108,37,33,4,36300,4400,40700
431350,202108,966,528,438,583000,481800,1064800
431360,202108,52,40,12,44000,13200,57200
431365,202108,351,146,205,160600,225500,386100
431370,202108,1216,699,517,768900,568700,1337600
431380,202108,97,86,11,94600,12100,106700
431390,202108,499,271,228,298100,250800,548900
431395,202108,322,134,188,147400,206800,354200
431400,202108,42,26,16,28600,17600,46200
431402,202108,106,75,31,82500,34100,116600
431403,202108,23,14,9,15400,9900,25300
431405,202108,700,380,320,418000,352000,770000
431406,202108,34,27,7,29700,7700,37400
431407,202108,55,44,11,48400,12100,60500
431410,202108,3409,2059,1350,2268200,1487200,3755400
431413,202108,15,12,3,13200,3300,16500
431415,202108,61,41,20,45100,22000,67100
431417,202108,27,12,15,13200,16500,29700
431420,202108,349,237,112,260700,123200,383900
431430,202108,55,27,28,29700,30800,60500
431440,202108,8960,6099,2861,6713813.33,3150450.6,9864263.93
431442,202108,28,14,14,15400,15400,30800
431445,202108,31,29,2,31900,2200,34100
431446,202108,5,4,1,4400,1100,5500
431447,202108,87,62,25,68200,27500,95700
431449,202108,52,43,9,47300,9900,57200
431450,202108,409,267,142,293700,156200,449900
431454,202108,13,7,6,7700,6600,14300
431455,202108,47,37,10,40700,11000,51700
431460,202108,497,339,158,372900,173800,546700
431470,202108,123,89,34,99000,37400,136400
431475,202108,11,9,2,9900,2200,12100
431477,202108,37,22,15,24200,16500,40700
431478,202108,10,9,1,9900,1100,11000
431480,202108,563,333,230,367400,253000,620400
431490,202108,28950,16005,12945,17627387.65,14256000,31883387.65
431500,202108,78,61,17,68200,18700,86900
431505,202108,27,17,10,18700,11000,29700
431507,202108,8,7,1,7700,1100,8800
431510,202108,239,173,66,190300,72600,262900
431513,202108,22,20,2,22000,2200,24200
431514,202108,4,3,1,3300,1100,4400
431515,202108,80,67,13,73700,14300,88000
431517,202108,7,3,4,3300,4400,7700
431520,202108,37,33,4,36300,4400,40700
431530,202108,1431,633,798,696300,880000,1576300
431531,202108,21,19,2,20900,2200,23100
431532,202108,39,29,10,31900,11000,42900
431535,202108,28,15,13,16500,14300,30800
431540,202108,143,119,24,132000,26400,158400
431545,202108,11,9,2,9900,2200,12100
431550,202108,358,193,165,212300,182600,394900
431555,202108,11,11,0,12100,0,12100
431560,202108,4635,3089,1546,3400100,1701700,5101800
431570,202108,835,427,408,469700,448800,918500
431575,202108,46,24,22,26400,25300,51700
431580,202108,90,59,31,66000,34100,100100
431590,202108,138,115,23,128700,25300,154000
431595,202108,19,16,3,17600,3300,20900
431600,202108,253,147,106,161700,116600,278300
431610,202108,112,82,30,90200,33000,123200
431620,202108,42,35,7,38500,7700,46200
431630,202108,128,104,24,114400,26400,140800
431640,202108,1338,834,504,918500,556600,1475100
431642,202108,37,34,3,37400,3300,40700
431643,202108,45,18,27,19800,29700,49500
431645,202108,314,181,133,199100,146300,345400
431647,202108,9,8,1,8800,1100,9900
431650,202108,32,18,14,22000,15400,37400
431660,202108,275,171,104,190300,115500,305800
431670,202108,230,102,128,112200,140800,253000
431673,202108,10,7,3,7700,3300,11000
431675,202108,25,20,5,22000,5500,27500
431680,202108,1140,838,302,921800,332200,1254000
431690,202108,4843,2861,1982,3153700.5,2183500,5337200.5
431695,202108,21,15,6,16500,6600,23100
431697,202108,1,0,1,0,1100,1100
431700,202108,186,138,48,151800,52800,204600
431710,202108,4056,1748,2308,1925000,2539900,4464900
431720,202108,1288,785,503,864526.66,554400,1418926.66
431725,202108,1,1,0,1100,0,1100
431730,202108,1151,769,382,847000,421300,1268300
431740,202108,1341,643,698,707300,768900,1476200
431750,202108,1838,1192,646,1313400.32,711700,2025100.32
431755,202108,6,5,1,5500,1100,6600
431760,202108,997,616,381,677600,420200,1097800
431770,202108,423,291,132,320100,145200,465300
431775,202108,28,21,7,23100,7700,30800
431780,202108,548,324,224,356400,246400,602800
431790,202108,161,123,38,135300,41800,177100
431795,202108,12,9,3,9900,3300,13200
431800,202108,3163,1642,1521,1808400.37,1673100,3481500.37
431805,202108,19,17,2,18700,2200,20900
431810,202108,604,394,210,433400,231000,664400
431820,202108,333,198,135,217800,149600,367400
431830,202108,2273,1359,914,1497100,1006500,2503600
431840,202108,482,312,170,344300,187000,531300
431842,202108,34,27,7,29700,7700,37400
431843,202108,11,8,3,8800,3300,12100
431844,202108,17,12,5,13200,5500,18700
431845,202108,25,23,2,25300,2200,27500
431846,202108,24,21,3,23100,3300,26400
431848,202108,11,9,2,9900,2200,12100
431849,202108,6,5,1,5500,1100,6600
431850,202108,765,600,165,660000,181500,841500
431860,202108,120,78,42,85800,46200,132000
431861,202108,6,2,4,2200,4400,6600
431862,202108,55,38,17,41800,18700,60500
431870,202108,3564,2006,1558,2207700,1714900,3922600
431880,202108,948,680,268,750200,294800,1045000
431890,202108,1285,746,539,822800,592900,1415700
431900,202108,184,124,60,136400,66000,202400
431910,202108,49,36,13,39600,14300,53900
431912,202108,47,28,19,30800,20900,51700
431915,202108,140,107,33,117700,36300,154000
431920,202108,153,111,42,122100,46200,168300
431930,202108,81,69,12,75900,13200,89100
431935,202108,2,2,0,2200,0,2200
431936,202108,3,3,0,3300,0,3300
431937,202108,20,15,5,16500,5500,22000
431940,202108,459,310,149,341000,163900,504900
431950,202108,474,300,174,330000,191400,521400
431960,202108,746,399,347,438900,385000,823900
431970,202108,71,65,6,71500,6600,78100
431971,202108,5,3,2,3300,2200,5500
431973,202108,18,15,3,16500,3300,19800
431975,202108,9,8,1,8800,1100,9900
431980,202108,209,125,84,137500,92400,229900
431990,202108,1115,585,530,644528.5,583000,1227528.5
432000,202108,1821,937,884,1031800,972400,2004200
432010,202108,267,182,85,200200,93500,293700
432020,202108,178,146,32,160600,35200,195800
432023,202108,15,12,3,13200,3300,16500
432026,202108,61,55,6,60500,6600,67100
432030,202108,63,30,33,33000,36300,69300
432032,202108,16,12,4,13200,4400,17600
432035,202108,59,45,14,49500,15400,64900
432040,202108,87,59,28,64900,30800,95700
432045,202108,2,2,0,2200,0,2200
432050,202108,82,50,32,55000,35200,90200
432055,202108,124,90,34,99000,37400,136400
432057,202108,7,5,2,5500,2200,7700
432060,202108,34,30,4,33000,4400,37400
432065,202108,31,28,3,30800,3300,34100
432067,202108,86,78,8,85800,8800,94600
432070,202108,390,302,88,332475,96800,429275
432080,202108,827,577,250,634700,275000,909700
432085,202108,8,5,3,5500,3300,8800
432090,202108,260,172,88,189200,97900,287100
432100,202108,169,109,60,119900,66000,185900
432110,202108,547,360,187,396000,205700,601700
432120,202108,991,557,434,616000,477400,1093400
432130,202108,491,347,144,381700,158400,540100
432132,202108,24,21,3,23100,3300,26400
432135,202108,79,64,15,70400,16500,86900
432140,202108,263,200,63,220000,69300,289300
432143,202108,215,130,85,143000,93500,236500
432145,202108,273,189,84,207900,92400,300300
432146,202108,13,12,1,13200,1100,14300
432147,202108,114,61,53,67100,58300,125400
432149,202108,15,9,6,9900,6600,16500
432150,202108,953,586,367,644600,405900,1050500
432160,202108,1586,811,775,894300.5,854700,1749000.5
432162,202108,4,2,2,2200,2200,4400
432163,202108,17,12,5,13200,5500,18700
432166,202108,128,95,33,104775,36300,141075
432170,202108,225,113,112,124300,123200,247500
432180,202108,548,338,210,371800,231000,602800
432183,202108,9,8,1,8800,1100,9900
432185,202108,77,63,14,69300,15400,84700
432190,202108,500,295,205,324500,225500,550000
432195,202108,92,76,16,83600,17600,101200
432200,202108,401,249,152,273900,167200,441100
432210,202108,116,72,44,79200,48400,127600
432215,202108,37,33,4,36300,4400,40700
432218,202108,20,20,0,22000,0,22000
432220,202108,653,337,316,370700,348700,719400
432225,202108,15,10,5,11000,5500,16500
432230,202108,130,84,46,92400,50600,143000
432232,202108,18,15,3,16500,3300,19800
432234,202108,4,2,2,2200,2200,4400
432235,202108,4,2,2,2200,2200,4400
432237,202108,23,15,8,16500,8800,25300
432240,202108,4384,2430,1954,2674100,2150500,4824600
432250,202108,1132,743,389,819500,429000,1248500
432252,202108,48,47,1,51700,1100,52800
432253,202108,60,48,12,52800,13200,66000
432254,202108,28,11,17,12100,18700,30800
432255,202108,13,11,2,12100,2200,14300
432260,202108,837,661,176,727100,193600,920700
432270,202108,227,171,56,189200,61600,250800
432280,202108,145,108,37,118800,40700,159500
432285,202108,1,1,0,1100,0,1100
432290,202108,64,55,9,60500,9900,70400
432300,202108,4801,2537,2264,2793928.5,2493700.61,5287629.11
432310,202108,130,107,23,117700,25300,143000
432320,202108,22,17,5,18700,5500,24200
432330,202108,17,10,7,11000,7700,18700
432335,202108,8,6,2,6600,2200,8800
432340,202108,39,31,8,34100,8800,42900
432345,202108,101,67,34,73700,37400,111100
432350,202108,20,19,1,20900,1100,22000
432360,202108,5,4,1,4400,1100,5500
432370,202108,26,25,1,27500,1100,28600
432375,202108,28,26,2,28600,2200,30800
432377,202108,7,7,0,7700,0,7700
432380,202108,180,77,103,84700,113300,198000
500020,202108,261,136,125,149600,138600,288200
500025,202108,145,72,73,79200,80300,159500
500060,202108,1469,921,548,1013100,602800,1615900
500070,202108,755,354,401,389400,442200,831600
500080,202108,137,107,30,117700,33000,150700
500085,202108,139,109,30,119900,33000,152900
500090,202108,364,170,194,187000,214500,401500
500100,202108,714,374,340,411400,374000,785400
500110,202108,2259,1051,1208,1156100,1328800,2484900
500124,202108,271,147,124,161700,136400,298100
500150,202108,342,139,203,152900,223300,376200
500190,202108,525,350,175,385000,193600,578600
500200,202108,201,170,31,188100,34100,222200
500210,202108,1602,539,1063,594000,1169300,1763300
500215,202108,209,121,88,133100,96800,229900
500220,202108,726,464,262,510400.92,288200,798600.92
500230,202108,234,139,95,152900,104500,257400
500240,202108,648,438,210,481800,231000,712800
500260,202108,582,227,355,249700,390500,640200
500270,202108,29967,12780,17187,14078809.1,18936500,33015309.1
500280,202108,198,68,130,74800,143000,217800
500290,202108,1169,720,449,792000,493900,1285900
500295,202108,458,297,161,326700,178200,504900
500310,202108,99,30,69,33000,75900,108900
500315,202108,810,450,360,496100,397100,893200
500320,202108,3614,1749,1865,1923900.84,2053700,3977600.84
500325,202108,948,518,430,569800,473000,1042800
500330,202108,1502,698,804,767780.2,884400,1652180.2
500345,202108,307,228,79,250800,86900,337700
500348,202108,243,144,99,159500,108900,268400
500350,202108,110,55,55,60500,60500,121000
500370,202108,5711,2559,3152,2820400.32,3472700,6293100.32
500375,202108,344,236,108,259600,119900,379500
500380,202108,594,335,259,368500,284900,653400
500390,202108,71,34,37,37400,40700,78100
500400,202108,214,138,76,151800,85800,237600
500410,202108,522,219,303,240900,334400,575300
500430,202108,533,376,157,413600,172700,586300
500440,202108,209,110,99,121000,108900,229900
500450,202108,410,172,238,189200,261800,451000
500460,202108,270,145,125,159500,137500,297000
500470,202108,429,327,102,359700,112200,471900
500480,202108,103,62,41,68200,45100,113300
500490,202108,101,45,56,49500,61600,111100
500500,202108,1423,527,896,579700,986700,1566400
500510,202108,42,35,7,38500,7700,46200
500515,202108,98,69,29,75900,31900,107800
500520,202108,300,160,140,176000,154000,330000
500525,202108,94,50,44,55000,48400,103400
500540,202108,881,387,494,425700,543400,969100
500560,202108,928,519,409,570900,449900,1020800
500568,202108,997,546,451,600600,497200,1097800
500570,202108,1187,689,498,761200,550000,1311200
500580,202108,325,169,156,187000,171600,358600
500600,202108,336,167,169,183700,187000,370700
500620,202108,929,650,279,715000.5,306900,1021900.5
500625,202108,77,61,16,67100,17600,84700
500627,202108,20,11,9,12100,9900,22000
500630,202108,1563,886,677,975700.63,746900,1722600.63
500635,202108,532,320,212,352000,233200,585200
500640,202108,378,207,171,227700,188100,415800
500660,202108,5693,2051,3642,2257200,4007300,6264500
500690,202108,613,213,400,235400,442200,677600
500710,202108,399,196,203,215600,224400,440000
500720,202108,914,513,401,565400.3,442200,1007600.3
500730,202108,177,105,72,115500.38,79200,194700.38
500740,202108,898,362,536,398200,589600,987800
500750,202108,159,51,108,56100,118800,174900
500755,202108,116,88,28,96800,30800,127600
500769,202108,761,412,349,453200,385000,838200
500770,202108,430,236,194,259600,213400,473000
500780,202108,139,95,44,104500,48400,152900
500790,202108,1054,520,534,573100,589600,1162700
500793,202108,286,146,140,160600,155100,315700
500795,202108,170,111,59,122100,64900,187000
500797,202108,48,33,15,36300,16500,52800
500800,202108,430,190,240,209000,265100,474100
500830,202108,2209,1208,1001,1329900,1102200,2432100
500840,202108,126,96,30,105600,33000,138600
510010,202108,169,90,79,99000,86900,185900
510020,202108,515,225,290,247500,321200,568700
510025,202108,1662,931,731,1026337.03,804100,1830437.03
510030,202108,678,337,341,371800,375100,746900
510035,202108,129,68,61,74800,67100,141900
510040,202108,405,186,219,204600,240900,445500
510050,202108,358,195,163,214500,179300.3,393800.3
510060,202108,123,60,63,66000,69300,135300
510080,202108,237,93,144,102300,158400,260700
510100,202108,68,28,40,30800,44000,74800
510120,202108,31,18,13,19800,14300,34100
510125,202108,377,228,149,251900,163900,415800
510130,202108,538,323,215,355300,236500,591800
510140,202108,438,138,300,151800,330000,481800
510160,202108,104,32,72,35200,79200,114400
510170,202108,756,460,296,506000.56,325600,831600.56
510180,202108,2924,1361,1563,1499300,1722600,3221900
510185,202108,21,11,10,12100,11000,23100
510190,202108,237,83,154,94600,169400,264000
510250,202108,2568,1537,1031,1692900.65,1137400,2830300.65
510260,202108,174,126,48,138600,52800,191400
510263,202108,458,253,205,278300,225500,503800
510267,202108,638,354,284,390500,312400,702900
510268,202108,63,28,35,30800,38500,69300
510269,202108,77,34,43,37400,47300,84700
510270,202108,392,193,199,212300,218900,431200
510279,202108,209,157,52,172700,57200,229900
510285,202108,180,72,108,79200,118800,198000
510300,202108,509,265,244,292600,268400,561000
510305,202108,200,87,113,95700,124300,220000
510310,202108,110,55,55,60500,61600,122100
510320,202108,830,518,312,572000,343200,915200
510325,202108,423,168,255,184800,280500,465300
510330,202108,427,233,194,257400,213400,470800
510335,202108,651,380,271,418000,298100,716100
510336,202108,55,38,17,41800,18700,60500
510337,202108,102,46,56,50600,61600,112200
510340,202108,17386,7727,9659,8508501.08,10649100,19157601.08
510343,202108,61,44,17,48400,18700,67100
510345,202108,154,96,58,105600,63800,169400
510350,202108,660,355,305,390500,336600,727100
510360,202108,212,133,79,146300,88000,234300
510370,202108,153,70,83,77000,91300,168300
510380,202108,82,62,20,68200,22000,90200
510385,202108,61,28,33,30800,36300,67100
510390,202108,107,47,60,51700,66000,117700
510395,202108,45,31,14,34100,15400,49500
510410,202108,719,458,261,503800,287100,790900
510420,202108,560,267,293,293700,322300,616000
510450,202108,50,25,25,27500,27500,55000
510452,202108,52,22,30,24200,33000,57200
510454,202108,52,24,28,26400,30800,57200
510455,202108,129,73,56,80300,61600,141900
510460,202108,181,82,99,90200,108900,199100
510480,202108,701,419,282,462000,312400,774400
510490,202108,342,170,172,187000,191400,378400
510500,202108,235,174,61,191400,67100,258500
510510,202108,789,461,328,508200,361900,870100
510515,202108,1243,637,606,700700,667700,1368400
510517,202108,261,117,144,129800,158400,288200
510520,202108,216,143,73,157300,80300,237600
510523,202108,106,82,24,90200,26400,116600
510525,202108,837,498,339,547800,372900,920700
510530,202108,22,15,7,16500,7700,24200
510550,202108,241,109,132,119900,145200,265100
510558,202108,296,145,151,159500,167200,326700
510560,202108,403,226,177,249700,194700,444400
510562,202108,633,459,174,504900,192500,697400
510590,202108,739,376,363,413600,399300,812900
510600,202108,218,110,108,121000,118800,239800
510610,202108,223,90,133,99000,146300,245300
510615,202108,193,89,104,99000,114400,213400
510617,202108,26,12,14,13200,15400,28600
510618,202108,120,58,62,63800,68200,132000
510619,202108,90,64,26,71500,28600,100100
510620,202108,162,91,71,100100,78100,178200
510621,202108,173,110,63,121000,69300,190300
510622,202108,481,275,206,303600,227700,531300
510623,202108,302,204,98,224400,107800,332200
510624,202108,87,48,39,52800,42900,95700
510625,202108,512,323,189,355300,207900.63,563200.63
510626,202108,113,65,48,71500,52800,124300
510627,202108,89,61,28,67100,30800,97900
510628,202108,157,94,63,103400,69300,172700
510629,202108,275,166,109,182600,121019.8,303619.8
510630,202108,440,217,223,238700,245300,484000
510631,202108,13,4,9,4400,9900,14300
510637,202108,350,198,152,218900,167200,386100
510642,202108,1014,536,478,589600,525800,1115400
510645,202108,6,1,5,1100,5500,6600
510650,202108,1348,882,466,970200,512600,1482800
510665,202108,82,34,48,37400,52800,90200
510670,202108,57,31,26,34100,28600,62700
510675,202108,1130,717,413,789800,456500,1246300
510677,202108,345,178,167,195800,184800,380600
510680,202108,99,57,42,63800,46200,110000
510682,202108,198,101,97,111100,106700,217800
510685,202108,54,40,14,44000,15400,59400
510700,202108,555,318,237,349800,260700,610500
510704,202108,1183,617,566,678700,624800,1303500
510706,202108,145,74,71,81400,78100,159500
510710,202108,400,275,125,303600,137500,441100
510715,202108,56,40,16,44000,17600,61600
510718,202108,228,111,117,122100,128700,250800
510719,202108,44,17,27,19800,29700,49500
510720,202108,188,133,55,146300,60500,206800
510724,202108,85,33,52,36300,57200,93500
510726,202108,60,32,28,35200,30800,66000
510729,202108,53,21,32,23100,35200,58300
510730,202108,468,255,213,281600,235400,517000
510735,202108,111,44,67,48400,74800,123200
510740,202108,24,12,12,13200,13200,26400
510757,202108,26,21,5,23100,5500,28600
510760,202108,7121,3585,3536,3945700,3896200.41,7841900.41
510770,202108,678,317,361,348700,398200,746900
510774,202108,15,5,10,5500,11000,16500
510775,202108,112,84,28,92400,30800,123200
510776,202108,30,10,20,11000,22000,33000
510777,202108,198,85,113,93500,124300,217800
510779,202108,37,19,18,20900,19800,40700
510780,202108,265,147,118,161700,129800,291500
510785,202108,363,198,165,217800,181500,399300
510787,202108,183,85,98,93500,107800,201300
510788,202108,6,1,5,1100,5500,6600
510790,202108,2524,1303,1221,1435551,1343100,2778651
510792,202108,1129,634,495,697400,544500.54,1241900.54
510794,202108,110,62,48,68200,52800,121000
510795,202108,2253,1300,953,1430000.11,1048300,2478300.11
510800,202108,185,112,73,123200,80300,203500
510805,202108,194,128,66,140800,72600,213400
510810,202108,99,41,58,45100,63800,108900
510820,202108,235,117,118,128700,129800.5,258500.5
510830,202108,72,41,31,45100,34100,79200
510835,202108,14,9,5,9900,5500,15400
510840,202108,9093,4236,4857,4661800,5348200,10010000
510850,202108,210,89,121,97900,133100,231000
510860,202108,386,177,209,194700,229900,424600
510880,202108,71,51,20,56100,23100,79200
510885,202108,64,37,27,40700,29700,70400
510890,202108,59,34,25,37400,27500,64900
510895,202108,165,97,68,106700,74800,181500
520005,202108,128,52,76,57200,83600,140800
520010,202108,303,136,167,149600,183700,333300
520013,202108,724,481,243,531300,269500,800800
520015,202108,49,35,14,38500,15400,53900
520017,202108,86,50,36,55000,39600,94600
520020,202108,18,10,8,11000,8800,19800
520025,202108,2541,1315,1226,1449800,1349700,2799500
520030,202108,820,438,382,482075,420200,902275
520050,202108,67,47,20,51700,22000,73700
520055,202108,56,35,21,38500,23100,61600
520060,202108,181,115,66,126500,72600,199100
520080,202108,589,430,159,474100,174900,649000
520082,202108,17,11,6,12100,6600,18700
520085,202108,87,66,21,72600,23100,95700
520090,202108,88,62,26,68200,28600,96800
520110,202108,9187,3927,5260,4328500,5795900,10124400
520120,202108,11,6,5,6600,5500,12100
520130,202108,803,565,238,621500,261800,883300
520140,202108,11947,6628,5319,7295200,5856400,13151600
520145,202108,54,32,22,35200,24200,59400
520150,202108,157,126,31,138600,35200,173800
520160,202108,45,31,14,34100,15400,49500
520170,202108,240,136,104,149600,114400,264000
520180,202108,183,85,98,93500,107800,201300
520215,202108,206,139,67,152900,73700,226600
520235,202108,83,65,18,71500,19800,91300
520250,202108,124,72,52,79200,57200,136400
520260,202108,113,72,41,79200,45100,124300
520280,202108,44,30,14,33000,15400,48400
520310,202108,44,27,17,29700,18700,48400
520320,202108,170,107,63,117700,69300,187000
520330,202108,820,442,378,486200,416900,903100
520340,202108,362,212,150,233200,166100,399300
520350,202108,504,243,261,267300,287100,554400
520355,202108,87,48,39,52800,42900,95700
520357,202108,26,20,6,22000,6600,28600
520360,202108,3,2,1,2200,1100,3300
520380,202108,139,77,62,84700,68200,152900
520390,202108,248,104,144,114400,158400,272800
520393,202108,17,13,4,14300,4400,18700
520396,202108,74,50,24,55000,26400,81400
520400,202108,196,118,78,130900,86900,217800
520410,202108,188,93,95,102300,104500,206800
520420,202108,22,14,8,15400,8800,24200
520425,202108,272,137,135,151800,148500,300300
520430,202108,512,248,264,272901.2,290400,563301.2
520440,202108,680,489,191,537900,211200,749100
520450,202108,2039,868,1171,954800,1289200,2244000
520455,202108,60,35,25,38500,27500,66000
520460,202108,38,23,15,25300,16500,41800
520465,202108,31,26,5,28600,5500,34100
520470,202108,434,277,157,304700,172700,477400
520480,202108,80,47,33,51700,36300,88000
520485,202108,101,37,64,40700,70400,111100
520490,202108,414,312,102,343200,112200,455400
520495,202108,157,92,65,101200,71500,172700
520500,202108,192,151,41,166100,45100,211200
520505,202108,194,115,79,126500,86900,213400
520510,202108,1841,881,960,970200,1057100,2027300
520520,202108,50,34,16,37400,17600,55000
520530,202108,219,171,48,188100,52800,240900
520540,202108,617,414,203,455400,223300,678700
520545,202108,135,74,61,82500,67100,149600
520547,202108,58,34,24,37400,26400,63800
520549,202108,1299,594,705,653400.55,777700,1431100.55
520551,202108,314,167,147,183700,161700,345400
520552,202108,36,25,11,27500,12100,39600
520570,202108,16,9,7,9900,7700,17600
520580,202108,273,169,104,185900,114400,300300
520590,202108,139,81,58,89100,63800,152900
520620,202108,1131,525,606,577500,667700,1245200
520630,202108,45,24,21,26400,23100,49500
520640,202108,374,216,158,237600,174900,412500
520650,202108,67,34,33,37400,36300,73700
520660,202108,46,25,21,27500,23100,50600
520670,202108,39,32,7,35200,7700,42900
520680,202108,42,27,15,29700,16500,46200
520690,202108,40,10,30,11000,33000,44000
520710,202108,33,29,4,31900,4400,36300
520725,202108,198,146,52,160600,57200,217800
520735,202108,55,34,21,37400,23100,60500
520740,202108,443,215,228,236500,250800,487300
520750,202108,35,25,10,27500,11000,38500
520753,202108,65,43,22,47300,24200,71500
520760,202108,99,66,33,72600,36300,108900
520780,202108,272,207,65,227700,71500,299200
520790,202108,162,92,70,101200,77000,178200
520800,202108,3417,1873,1544,2064700,1698400,3763100
520810,202108,147,114,33,125400,36300,161700
520815,202108,5,4,1,4400,1100,5500
520830,202108,148,101,47,111100,51700,162800
520840,202108,380,246,134,270600,147400,418000
520850,202108,99,56,43,61600,47300,108900
520860,202108,1752,1118,634,1230900,698500,1929400
520870,202108,31773,14714,17059,16196400.65,18784700.3,34981100.95
520880,202108,1172,625,547,688600,602800,1291400
520890,202108,790,481,309,529100,339900,869000
520910,202108,976,524,452,576400.4,497200,1073600.4
520915,202108,89,68,21,74800,23100,97900
520920,202108,443,208,235,228800,258500,487300
520929,202108,19,17,2,18700,2200,20900
520940,202108,69,50,19,55000,20900,75900
520945,202108,14,10,4,11000,4400,15400
520960,202108,39,25,14,27500,15400,42900
520970,202108,367,216,151,237600,166100,403700
520980,202108,95,68,27,74800,29700,104500
520990,202108,451,320,131,352000,144100,496100
520993,202108,125,61,64,67100,70400,137500
520995,202108,256,141,115,155100,126500,281600
521000,202108,1554,893,661,982300,727100,1709400
521010,202108,684,347,337,381700,372900,754600
521015,202108,15,10,5,11000,5500,16500
521020,202108,1408,989,419,1087900,460900,1548800
521030,202108,57,36,21,39600,23100,62700
521040,202108,944,610,334,671000,367400,1038400
521056,202108,51,32,19,35200,20900,56100
521060,202108,126,82,44,90200,48400,138600
521080,202108,376,290,86,319000,94600,413600
521090,202108,559,363,196,399300,215600,614900
521100,202108,268,200,68,220000,74800,294800
521120,202108,1050,734,316,807400,348700,1156100
521130,202108,353,253,100,278300,110000,388300
521140,202108,181,99,82,108900,90200,199100
521150,202108,2580,1102,1478,1214400,1630200,2844600
521160,202108,28,12,16,13200,17600,30800
521170,202108,216,127,89,139700,97900,237600
521180,202108,1169,747,422,822800,465300,1288100
521190,202108,2518,1046,1472,1151700.28,1619200,2770900.28
521200,202108,53,40,13,44000,14300,58300
521205,202108,12,8,4,8800,4400,13200
521210,202108,122,74,48,81400,52800,134200
521220,202108,732,515,217,566500,238700,805200
521225,202108,26,19,7,20900,7700,28600
521230,202108,105,66,39,72600,42900,115500
521250,202108,6258,3531,2727,3885200.9,3003000,6888200.9
521260,202108,32,15,17,16500,18700,35200
521270,202108,135,102,33,112200,36300,148500
521280,202108,422,260,162,287100,178200,465300
521290,202108,27,18,9,19800,9900,29700
521295,202108,100,66,34,72600,37400,110000
521300,202108,223,123,100,135300,110000,245300
521305,202108,41,30,11,33000,12100,45100
521308,202108,1023,782,241,861300,265100,1126400
521310,202108,1341,758,583,833715,643500,1477215
521340,202108,20,16,4,17600,4400,22000
521350,202108,121,92,29,101200,31900,133100
521370,202108,170,120,50,132000,55000,187000
521375,202108,182,95,87,104500,95700,200200
521377,202108,52,40,12,44000,13200,57200
521380,202108,1051,648,403,712800,444400,1157200
521385,202108,13,8,5,8800,5500,14300
521390,202108,95,78,17,85800,18700,104500
521400,202108,344,233,111,257400,122100,379500
521405,202108,143,81,62,89100,68200,157300
521410,202108,74,52,22,57200,24200,81400
521440,202108,195,136,59,149600,64900,214500
521450,202108,764,418,346,460900,380600,841500
521460,202108,1110,723,387,797500,425700,1223200
521470,202108,11,8,3,8800,3300,12100
521480,202108,39,28,11,30800,12100,42900
521483,202108,314,197,117,216700,128700,345400
521486,202108,291,185,106,203500,117700,321200
521487,202108,25,11,14,12100,15400,27500
521490,202108,24,12,12,13200,13200,26400
521500,202108,131,68,63,74800,69300,144100
521520,202108,45,34,11,37400,12100,49500
521523,202108,820,486,334,534600,367400,902000
521525,202108,45,27,18,29700,19800,49500
521530,202108,238,128,110,140800,122100,262900
521540,202108,37,19,18,20900,19800,40700
521550,202108,93,40,53,44000,58300,102300
521560,202108,828,558,270,613800,297000,910800
521565,202108,66,48,18,52800,19800,72600
521570,202108,545,355,190,390500,210100,600600
521580,202108,54,31,23,34100,25300,59400
521590,202108,34,15,19,16500,20900,37400
521600,202108,25,12,13,13200,14300,27500
521630,202108,243,127,116,139700,127600,267300
521640,202108,303,166,137,183700,150700,334400
521645,202108,37,20,17,22000,18700,40700
521680,202108,246,151,95,166100,104500,270600
521690,202108,4,3,1,3300,1100,4400
521710,202108,1133,543,590,597300,650100,1247400
521720,202108,549,379,170,416900,188100,605000
521730,202108,671,316,355,349800,390500,740300
521740,202108,880,379,501,418000,552200,970200
521760,202108,2172,1128,1044,1241972.45,1148400,2390372.45
521770,202108,818,509,309,559900,339900,899800
521800,202108,1963,1275,688,1402500,757900,2160400
521805,202108,32,17,15,18700,16500,35200
521810,202108,91,54,37,59400,40700,100100
521830,202108,976,693,283,762300.73,311300,1073600.73
521839,202108,86,51,35,56100,38500,94600
521850,202108,1111,565,546,621500.17,600600,1222100.17
521860,202108,327,208,119,229900,130900,360800
521870,202108,71,44,27,48400,29700,78100
521878,202108,37,15,22,16500,24200,40700
521880,202108,4772,2104,2668,2315500,2938100,5253600
521890,202108,592,410,182,451000,200200,651200
521900,202108,282,225,57,247500,62700,310200
521910,202108,165,114,51,126500,56100,182600
521920,202108,46,23,23,25300,25300,50600
521925,202108,55,32,23,35200,26400,61600
521930,202108,1156,641,515,705100,566500,1271600
521935,202108,34,24,10,26400,11000,37400
521940,202108,200,94,106,103400,116600,220000
521945,202108,17,13,4,14300,4400,18700
521950,202108,9,5,4,5500,4400,9900
521960,202108,70,52,18,57200,19800,77000
521970,202108,411,259,152,284900,167200,452100
521971,202108,106,56,50,61600,55000,116600
521973,202108,38,20,18,22000,19800,41800
521975,202108,1547,786,761,864600.75,837100.44,1701701.19
521980,202108,245,168,77,184800,84700,269500
521990,202108,74,54,20,59400,22000,81400
522000,202108,292,189,103,207516.1,113300,320816.1
522005,202108,18,10,8,11000,8800,19800
522010,202108,1127,635,492,698500,544500,1243000
522015,202108,61,35,26,38500,28600,67100
522020,202108,897,523,374,576400,411400,987800
522026,202108,25,17,8,18700,8800,27500
522028,202108,17,13,4,14300,4400,18700
522040,202108,758,314,444,345400,488400,833800
522045,202108,2467,1483,984,1633500,1084600,2718100
522050,202108,157,78,79,85800,86900,172700
522060,202108,551,347,204,381700,224400,606100
522068,202108,105,74,31,81400,35200,116600
522070,202108,10,10,0,11000,0,11000
522100,202108,35,21,14,23100,15400,38500
522108,202108,44,33,11,36300,12100,48400
522119,202108,57,32,25,35200,27500,62700
522130,202108,73,26,47,28600,51700,80300
522140,202108,4100,2119,1981,2330900,2183500,4514400
522145,202108,47,34,13,37400,14300,51700
522150,202108,98,70,28,77000,30800,107800
522155,202108,55,43,12,47300,13200,60500
522157,202108,6,4,2,4400,2200,6600
522160,202108,1665,991,674,1091200,741400,1832600
522170,202108,397,266,131,292600,144100,436700
522180,202108,36,16,20,17600,22000,39600
522185,202108,2186,892,1294,982300,1425600,2407900
522190,202108,56,30,26,33000,28600,61600
522200,202108,309,184,125,202400,137500,339900
522205,202108,150,100,50,110000,55000,165000
522220,202108,142,106,36,116600,39600,156200
522230,202108,32,24,8,26400,8800,35200
530010,202108,54456,27521,26935,30300932.64,29661970.18,59962902.82
110001,202109,507,410,97,452100,106700,558800
110002,202109,2840,1798,1042,1981100,1147300,3128400
110003,202109,81,66,15,72600,16500,89100
110004,202109,2010,1340,670,1476200,738100,2214300
110005,202109,427,340,87,374000,95700,469700
110006,202109,440,330,110,363000,121000,484000
110007,202109,69,56,13,61600,14300,75900
110008,202109,245,134,111,147400,122100,269500
110009,202109,916,683,233,752400,256300,1008700
110010,202109,1687,1007,680,1107700.19,750200,1857900.19
110011,202109,1711,1326,385,1458600,423500,1882100
110012,202109,4094,2380,1714,2619100,1887600,4506700
110013,202109,748,596,152,655600,167200,822800
110014,202109,365,319,46,350900,50600,401500
110015,202109,1370,1078,292,1188000,322300,1510300
110018,202109,1043,640,403,706200,443300,1149500
110020,202109,15776,8951,6825,9862601.6,7518500,17381101.6
110025,202109,639,466,173,512600,190300,702900
110026,202109,36,24,12,26400,13200,39600
110028,202109,1608,1142,466,1256200,512600,1768800
110029,202109,132,121,11,133100,13200,146300
110030,202109,2388,1590,798,1753224.55,878900.85,2632125.40
110032,202109,318,243,75,267300,82500,349800
110033,202109,646,465,181,511500,199100,710600
110034,202109,329,243,86,267300.5,94600,361900.5
110037,202109,90,80,10,88000,11000,99000
110040,202109,387,265,122,293700,135300,429000
110045,202109,930,644,286,709500,314600,1024100
110050,202109,86,75,11,82500,12100,94600
110060,202109,64,38,26,41800,28600,70400
110070,202109,106,67,39,73700,42900,116600
110080,202109,508,286,222,315700,244200,559900
110090,202109,22,18,4,19800,4400,24200
110092,202109,115,62,53,68200,58300,126500
110094,202109,192,136,56,149600,61600,211200
110100,202109,46,30,16,33000,17600,50600
110110,202109,96,54,42,59400,46200,105600
110120,202109,66,59,7,64900,7700,72600
110130,202109,275,223,52,245300.3,57200,302500.3
110140,202109,239,172,67,189200,73700,262900
110143,202109,51,42,9,46200,9900,56100
110145,202109,34,27,7,29700,7700,37400
110146,202109,23,11,12,12100,13200,25300
110147,202109,39,27,12,29700,13200,42900
110148,202109,35,26,9,28600,9900,38500
110149,202109,315,223,92,245300,101200,346500
110150,202109,134,102,32,112200,35200,147400
110155,202109,11,10,1,11000,1100,12100
110160,202109,67,53,14,58300,15400,73700
110170,202109,219,166,53,182600,58300,240900
110175,202109,62,48,14,52800,15400,68200
110180,202109,94,77,17,85800,18700,104500
120001,202109,194,145,49,159500.55,53901.1,213401.65
120005,202109,195,112,83,123200.41,91300,214500.41
120010,202109,1139,695,444,764500,489500,1254000
120013,202109,151,100,51,110000,56100,166100
120017,202109,114,63,51,69300,56100,125400
120020,202109,3513,2843,670,3127379.5,738113.2,3865492.7
120025,202109,551,306,245,336600.95,269500,606100.95
120030,202109,1056,907,149,997753.05,163909.9,1161662.95
120032,202109,37,33,4,36300,4400,40700
120033,202109,221,194,27,213407.7,29700.55,243108.25
120034,202109,175,127,48,139700,52800,192500
120035,202109,37,31,6,34100,6600,40700
120038,202109,417,269,148,295903.3,162801.1,458704.4
120039,202109,29,28,1,30801.65,1100,31901.65
120040,202109,13975,9441,4534,10390841.21,4992164.65,15383005.86
120042,202109,42,37,5,40700,5500.55,46200.55
120043,202109,12,3,9,3300,9900,13200
120045,202109,532,336,196,369601.1,215601.65,585202.75
120050,202109,1272,970,302,1067058.2,332214.16,1399272.36
120060,202109,1450,1196,254,1315657.75,279406.6,1595064.35
120070,202109,409,296,113,325601.15,124300,449901.15
120080,202109,178,110,68,121001.1,74800.55,195801.65
130002,202109,161,116,45,127600,49500,177100
130006,202109,99,64,35,70400,38500,108900
130008,202109,129,70,59,77000,64900,141900
130010,202109,157,95,62,104500,68200,172700
130014,202109,275,195,80,214500,88000,302500
130020,202109,106,63,43,69300,47300,116600
130030,202109,951,548,403,602800,443300,1046100
130040,202109,352,170,182,187000,200200,387200
130050,202109,543,277,266,304700,292600,597300
130060,202109,826,562,264,618200,290400,908600
130063,202109,618,372,246,409200,270600,679800
130068,202109,197,120,77,132000,84700,216700
130070,202109,1336,900,436,990000,479600,1469600
130080,202109,700,465,235,511500,258500,770000
130083,202109,68,38,30,41800,33000,74800
130090,202109,339,191,148,210100,162800,372900
130100,202109,1208,553,655,608300,722700,1331000
130110,202109,716,317,399,349800,440000,789800
130115,202109,144,65,79,71500,86900,158400
130120,202109,1615,1002,613,1104400,675400,1779800
130130,202109,611,421,190,463100,209000,672100
130140,202109,1562,1214,348,1335400,382800,1718200
130150,202109,406,359,47,394900,51700,446600
130160,202109,441,257,184,282700,203500,486200
130165,202109,44,34,10,37400,11000,48400
130170,202109,1025,714,311,785329.6,342100.9,1127430.5
130180,202109,245,179,66,196900,72600,269500
130185,202109,2216,1014,1202,1115400,1322200.18,2437600.18
130190,202109,3385,2132,1253,2347400,1378300,3725700
130195,202109,283,226,57,249700,63800,313500
130200,202109,176,83,93,91300,102300,193600
130210,202109,93,49,44,53900,48400,102300
130220,202109,191,135,56,148500,61600,210100
130230,202109,373,239,134,262900,147400,410300
130240,202109,1335,861,474,947100,522500,1469600
130250,202109,4678,3000,1678,3304400,1846900,5151300
130255,202109,421,204,217,224400,238700,463100
130260,202109,58628,27559,31069,30346710.03,34204731.42,64551441.45
130270,202109,1541,1050,491,1155099,540100,1695199
130280,202109,132,76,56,83600,61600,145200
130290,202109,2104,1423,681,1566400,749100,2315500
130300,202109,421,289,132,317900,146300,464200
130310,202109,900,485,415,533500,459800,993300
130320,202109,527,277,250,304700,275000.55,579700.55
130330,202109,773,489,284,537900,312400,850300
130340,202109,3414,1925,1489,2117500,1637900,3755400
130350,202109,482,330,152,363000,167200,530200
130353,202109,927,407,520,448800,573100,1021900
130356,202109,797,354,443,389400,487300,876700
130360,202109,87,66,21,72600,23100,95700
130370,202109,687,529,158,583000,173800,756800
130380,202109,652,507,145,558800,159500,718300
130390,202109,458,372,86,410300,94600,504900
130395,202109,160,42,118,46200,130900,177100
130400,202109,69,47,22,51700,25300,77000
130406,202109,2068,1213,855,1334300,941600,2275900
130410,202109,453,225,228,247500,250800,498300
130420,202109,2823,2289,534,2517900,587400,3105300
130423,202109,156,80,76,88000,83600,171600
130426,202109,173,88,85,96800,93500,190300
130430,202109,410,242,168,266200,184800,451000
130440,202109,200,64,136,70400,149600,220000
140002,202109,24,5,19,5500,20900,26400
140005,202109,208,126,82,138600,90200,228800
140010,202109,11198,6915,4283,7613103.73,4715701.3,12328805.03
140015,202109,143,63,80,69300,88000,157300
140017,202109,121,68,53,74800,58300,133100
140020,202109,456,296,160,325600,176000,501600
140023,202109,38,18,20,19800,22000,41800
140028,202109,22,11,11,12100,12100,24200
140030,202109,354,235,119,258500,130900,389400
140040,202109,63,44,19,48400,20900,69300
140045,202109,278,105,173,115500,190300,305800
140047,202109,437,291,146,320100,160600,480700
140050,202109,145,89,56,97900,61600,159500
140060,202109,63,40,23,44000,25300,69300
140070,202109,31,29,2,31900,2200,34100
150010,202109,4897,2945,1952,3240600,2147200,5387800
150013,202109,164,117,47,128700,51700,180400
150020,202109,1114,604,510,664400,561000,1225400
150030,202109,708,318,390,349800.02,429000,778800.02
150034,202109,208,129,79,141900,86900,228800
150040,202109,1539,870,669,957000,735900,1692900
150050,202109,689,394,295,433400,324500,757900
150060,202109,4833,3037,1796,3341708.07,1979355.4,5321063.47
150070,202109,436,225,211,247500,232100,479600
150080,202109,16103,7503,8600,8258103.81,9466600,17724703.81
150085,202109,421,269,152,297000,167200,464200
150090,202109,703,595,108,654500,118800,773300
150095,202109,48,32,16,36300,17600,53900
150100,202109,65,42,23,46200,25300,71500
150110,202109,212,118,94,129800,103400,233200
150120,202109,389,283,106,311300,116600,427900
150125,202109,49,18,31,19800,34100,53900
150130,202109,2122,1084,1038,1194600,1141800,2336400
150140,202109,57545,25443,32102,28000500.94,35324814.03,63325314.97
150145,202109,234,129,105,141900,115500,257400
150150,202109,3192,1394,1798,1533400,1978900,3512300
150157,202109,376,264,112,290400,123200,413600
150160,202109,130,98,32,107800,35200,143000
150170,202109,3853,2821,1032,3104200,1136300,4240500
150172,202109,347,246,101,271700,111100,382800
150175,202109,87,50,37,55000,40700,95700
150178,202109,764,510,254,561000,279400,840400
150180,202109,3212,1556,1656,1711600,1821600,3533200
150190,202109,362,234,128,257400,140800,398200
150195,202109,115,59,56,64900,61600,126500
150200,202109,190,89,101,97900,111100,209000
150210,202109,3216,2539,677,2794000,744700,3538700
150215,202109,591,368,223,404800,245300,650100
150220,202109,3555,2350,1205,2586100.82,1325500,3911600.82
150230,202109,1277,1012,265,1114300.5,291500,1405800.5
150240,202109,6735,3776,2959,4156901,3258200,7415101
150250,202109,69,38,31,41800,34100,75900
150260,202109,100,65,35,73700,38500,112200
150270,202109,2206,1423,783,1566400,862400,2428800
150275,202109,536,335,201,368500,221100,589600
150276,202109,115,41,74,46200,81400,127600
150277,202109,810,362,448,398200,493900,892100
150280,202109,370,250,120,275000,132000,407000
150285,202109,122,59,63,64900,70224,135124
150290,202109,1170,674,496,741400,545600,1287000
150293,202109,728,334,394,367400,433400,800800
150295,202109,544,249,295,273900,324500,598400
150300,202109,88,40,48,44000,52800,96800
150304,202109,184,106,78,116600,85800,202400
150307,202109,417,347,70,381700,78100,459800
150309,202109,581,407,174,447700,191400.48,639100.48
150310,202109,253,165,88,181500,96800,278300
150320,202109,1879,1307,572,1438800.5,629200,2068000.5
150330,202109,2068,1197,871,1316700,958100,2274800
150340,202109,200,132,68,145200,75900,221100
150345,202109,641,358,283,393800,311300,705100
150350,202109,403,320,83,352000,91300,443300
150360,202109,4768,2877,1891,3166900,2082300,5249200
150370,202109,831,565,266,621500,292600,914100
150375,202109,198,92,106,101200,116600,217800
150380,202109,1516,999,517,1100000,569800,1669800
150390,202109,837,485,352,533500,387200,920700
150400,202109,112,91,21,100100,23100,123200
150405,202109,1578,993,585,1092300,644600,1736900
150410,202109,124,77,47,84700,51700,136400
150420,202109,7610,4072,3538,4481579.3,3894000,8375579.3
150430,202109,633,393,240,432300,264000,696300
150440,202109,454,281,173,309100,190300,499400
150442,202109,2336,1249,1087,1376100,1196800,2572900
150445,202109,553,357,196,392700,215600,608300
150450,202109,224,124,100,136400,110000,246400
150460,202109,729,541,188,595100,206800,801900
150470,202109,1291,772,519,850300,570900,1421200
150475,202109,244,183,61,202400,67100,269500
150480,202109,1365,942,423,1037300,465300,1502600
150490,202109,660,388,272,426800,299200,726000
150495,202109,336,250,86,276100,94600,370700
150497,202109,287,198,89,217800,97900,315700
150500,202109,242,147,95,161700,104500,266200
150503,202109,1246,614,632,675400,695200,1370600
150506,202109,927,625,302,687500,333300,1020800
150510,202109,1305,703,602,773300,663300,1436600
150520,202109,321,220,101,242000,111100,353100
150530,202109,1806,994,812,1095600,893200,1988800
150540,202109,198,145,53,159500,58300,217800
150543,202109,847,427,420,469700,463100,932800
150548,202109,467,334,133,367400,146300,513700
150549,202109,70,44,26,48400,28600,77000
150550,202109,3049,1523,1526,1677500,1678600,3356100
150553,202109,3428,1909,1519,2101000,1673100.62,3774100.62
150555,202109,144,77,67,84700,73700,158400
150560,202109,46,21,25,23100,27500,50600
150563,202109,127,64,63,70400,69300,139700
150565,202109,205,129,76,141900,83600,225500
150570,202109,438,286,152,315700,167200,482900
150580,202109,1708,823,885,905300,974600,1879900
150590,202109,831,538,293,591800,322300,914100
150600,202109,511,300,211,330000.65,233200,563200.65
150610,202109,149,120,29,132000,33000,165000
150611,202109,125,82,43,90200,47300,137500
150613,202109,3300,1874,1426,2064700,1568600,3633300
150616,202109,551,303,248,333300,272800,606100
150618,202109,1388,709,679,781000,749100,1530100
150619,202109,401,302,99,332200,108900,441100
150620,202109,1241,714,527,787600,580800,1368400
150630,202109,139,91,48,100100,52800,152900
150635,202109,455,190,265,209000,291500,500500
150640,202109,42,21,21,23100,23100,46200
150650,202109,2448,1398,1050,1538900,1155000,2693900
150655,202109,248,181,67,199100,73700,272800
150658,202109,86,52,34,57200,37400,94600
150660,202109,562,363,199,399300,220000,619300
150670,202109,1126,395,731,434500,804100,1238600
150680,202109,10591,5498,5093,6053300.57,5605600,11658900.57
150690,202109,26,13,13,14300,14300,28600
150700,202109,495,321,174,353100,192500,545600
150710,202109,295,170,125,187000,138600,325600
150715,202109,843,529,314,581900,345400,927300
150720,202109,423,322,101,354200,111100,465300
150730,202109,1077,525,552,577500,607200,1184700
150740,202109,234,154,80,169400,88000,257400
150745,202109,751,418,333,459800,366300,826100
150746,202109,69,35,34,38500,37400,75900
150747,202109,230,170,60,187000,66000,253000
150750,202109,140,78,62,85800,68200,154000
150760,202109,1831,1179,652,1296900.5,717200,2014100.5
150770,202109,399,225,174,247500,191400,438900
150775,202109,108,53,55,58300,61600,119900
150780,202109,194,110,84,121000,93500,214500
150790,202109,667,368,299,404800,328900,733700
150795,202109,1609,959,650,1057100,715000,1772100
150796,202109,348,196,152,215600,167200,382800
150797,202109,368,176,192,193600,212300,405900
150800,202109,1557,870,687,958100,755700,1713800
150803,202109,536,426,110,468600,121000,589600
150805,202109,213,124,89,136400,97900,234300
150808,202109,1038,538,500,594000,550000,1144000
150810,202109,3240,2187,1053,2407900.52,1158300,3566200.52
150812,202109,482,247,235,271700,258500,530200
150815,202109,1118,688,430,756800,473000,1229800
150820,202109,1545,931,614,1025200,675400,1700600
150830,202109,565,418,147,459800,161700,621500
150835,202109,220,128,92,140800,101200.15,242000.15
150840,202109,1394,838,556,921800,612700,1534500
160005,202109,61,42,19,46200.08,20900.04,67100.12
160010,202109,198,123,75,135300.14,82500.08,217800.22
160015,202109,139,84,55,92400.08,60500,152900.08
160020,202109,141,76,65,83600.04,71500,155100.04
160021,202109,68,27,41,29700.04,45100.02,74800.06
160023,202109,67,43,24,47300.08,26400.04,73700.12
160025,202109,26,13,13,14300.04,14300.04,28600.08
160027,202109,1486,836,650,920701.96,715000.98,1635702.94
160030,202109,16491,8431,8060,9280715.15,8879210.56,18159925.71
160040,202109,301,177,124,194700.14,136400.02,331100.16
160050,202109,743,364,379,400400.2,416900.06,817300.26
160053,202109,285,169,116,185900.24,127600.14,313500.38
160055,202109,23,14,9,15400.02,9900.02,25300.04
160060,202109,6671,3530,3141,3884110.37,3460607.24,7344717.61
160070,202109,189,114,75,125400.02,82500.02,207900.04
160080,202109,122,61,61,67100,67100,134200
170025,202109,28,14,14,15400,15400,30800
170030,202109,194,158,36,173800.03,39600,213400.03
170035,202109,200,97,103,106700,113300,220000
170040,202109,176,129,47,141900,52800,194700
170070,202109,319,200,119,220000,130900,350900
170100,202109,351,258,93,283800,102300,386100
170105,202109,50,42,8,46200,8800,55000
170110,202109,118,70,48,77000,52800,129800
170130,202109,71,36,35,39600,39600,79200
170190,202109,95,56,39,61600,42900,104500
170200,202109,348,239,109,262900,119900,382800
170210,202109,6321,3334,2987,3671534.25,3293400.8,6964935.05
170215,202109,128,60,68,66000,74800,140800
170220,202109,1362,995,367,1096700,403700,1500400
170230,202109,148,94,54,103400,59400,162800
170240,202109,511,340,171,374000,188100,562100
170255,202109,1048,850,198,936100,217800,1153900
170270,202109,47,33,14,36300,15400,51700
170290,202109,120,75,45,83600,49500,133100
170300,202109,107,67,40,73700,44000,117700
170305,202109,47,35,12,38500,13200,51700
170307,202109,60,46,14,50600,15400,66000
170310,202109,123,68,55,74800,60500,135300
170320,202109,28,16,12,17600,14300,31900
170330,202109,29,22,7,24200,7700,31900
170360,202109,31,18,13,19800,14300,34100
170370,202109,93,46,47,50600,51700,102300
170380,202109,75,58,17,63800,18700,82500
170382,202109,36,31,5,34100,5500,39600
170384,202109,143,110,33,121000,36300,157300
170386,202109,68,28,40,30800,44000,74800
170388,202109,49,20,29,22000,31900,53900
170389,202109,26,22,4,24200,4400,28600
170390,202109,73,43,30,47300,33000,80300
170410,202109,24,22,2,24200,2200,26400
170460,202109,17,10,7,11000,7700,18700
170510,202109,36,28,8,30800,8800,39600
170550,202109,1560,896,664,986700,730400,1717100
170555,202109,105,77,28,84700,30800,115500
170560,202109,103,73,30,80300,33000,113300
170600,202109,41,13,28,14300,30800,45100
170610,202109,193,100,93,110000,102300,212300
170625,202109,39,24,15,26400,16500,42900
170650,202109,95,69,26,75900,28600,104500
170700,202109,572,420,152,463100,167200,630300
170710,202109,153,97,56,106700,61600,168300
170720,202109,99,77,22,84700,24200,108900
170730,202109,95,56,39,61600,42900,104500
170740,202109,85,60,25,66000,27500,93500
170755,202109,56,30,26,33000,28600,61600
170765,202109,139,73,66,80300,72600,152900
170770,202109,195,125,70,137500,78100,215600
170820,202109,595,391,204,431200,225500,656700
170825,202109,39,20,19,22000,20900,42900
170830,202109,87,70,17,77000,18700,95700
170900,202109,172,132,40,145200,44000,189200
170930,202109,930,504,426,555206.66,469700,1024906.66
170950,202109,3166,1453,1713,1598300,1885400.4,3483700.4
170980,202109,17,11,6,12100,6600,18700
171050,202109,149,113,36,125400,39600,165000
171070,202109,49,42,7,46200,7700,53900
171090,202109,47,34,13,37400,14300,51700
171110,202109,23,17,6,18700,6600,25300
171150,202109,42,23,19,25300,20900,46200
171180,202109,28,13,15,14300,16500,30800
171190,202109,164,97,67,106700,73700,180400
171195,202109,63,51,12,56100,13200,69300
171200,202109,44,21,23,23100,25300,48400
171215,202109,7,5,2,5500,2200,7700
171240,202109,63,45,18,49500,19800,69300
171245,202109,56,48,8,52800,8800,61600
171250,202109,73,41,32,45100,36300,81400
171270,202109,16,12,4,13200,4400,17600
171280,202109,43,35,8,38500,8800,47300
171320,202109,1006,568,438,624800,481800,1106600
171330,202109,418,209,209,229900,229900,459800
171360,202109,95,65,30,71500,34100,105600
171370,202109,36,18,18,19800,19800,39600
171380,202109,132,115,17,126500,18700,145200
171395,202109,48,28,20,30800,22000,52800
171420,202109,262,171,91,189200,100100,289300
171430,202109,71,57,14,62700,15400,78100
171488,202109,203,110,93,122100,102300,224400
171500,202109,64,35,29,38500,31900,70400
171510,202109,72,48,24,53900,26400,80300
171515,202109,39,32,7,35200,7700,42900
171525,202109,27,24,3,26400,3300,29700
171550,202109,16,9,7,9900,7700,17600
171570,202109,50,25,25,27500,27500,55000
171575,202109,280,184,96,202400,106700,309100
171610,202109,1770,891,879,980100,966900,1947000
171620,202109,143,97,46,107800,50600,158400
171630,202109,54,30,24,33000,26400,59400
171650,202109,325,223,102,245300,113300,358600
171660,202109,259,148,111,162800,122100,284900
171665,202109,74,45,29,49500,31900,81400
171670,202109,430,261,169,287100,185900,473000
171700,202109,64,56,8,61600,8800,70400
171720,202109,29,10,19,11000,20900,31900
171750,202109,109,54,55,59400,60500,119900
171780,202109,77,59,18,64900,19800,84700
171790,202109,85,70,15,77000,16500,93500
171800,202109,33,25,8,27500,8800,36300
171820,202109,2071,1194,877,1316700.7,964700,2281400.7
171830,202109,35,25,10,27500,11000,38500
171840,202109,62,40,22,44000,24200,68200
171845,202109,30,19,11,20900,12100,33000
171850,202109,39,33,6,36300,6600,42900
171855,202109,80,63,17,69300,18700,88000
171865,202109,7,6,1,6600,1100,7700
171870,202109,30,18,12,19800,14300,34100
171875,202109,82,59,23,64900,25300,90200
171880,202109,38,24,14,26400,15400,41800
171884,202109,49,28,21,30800,23100,53900
171886,202109,130,59,71,64900,78100,143000
171888,202109,24,19,5,20900,5500,26400
171889,202109,12,6,6,6600,6600,13200
171890,202109,55,46,9,50600,9900,60500
171900,202109,31,22,9,24200,9900,34100
172000,202109,38,31,7,34100,7700,41800
172010,202109,54,44,10,48400,11000,59400
172015,202109,23,16,7,17600,7700,25300
172020,202109,149,94,55,103400,60500,163900
172025,202109,38,25,13,27500,14300,41800
172030,202109,45,26,19,28600,20900,49500
172049,202109,82,54,28,59400,30800,90200
172065,202109,127,83,44,92400,48400,140800
172080,202109,111,69,42,75900,46200,122100
172085,202109,28,14,14,15400,15400,30800
172090,202109,430,316,114,347600,125400,473000
172093,202109,16,13,3,14300,3300,17600
172097,202109,19,11,8,12100,8800,20900
172100,202109,5337,2991,2346,3295600,2583900,5879500
172110,202109,82,51,31,56100,34100,90200
172120,202109,1728,1441,287,1586200,315700,1901900
172125,202109,11,10,1,11000,1100,12100
172130,202109,24,13,11,14300,12100,26400
172208,202109,210,124,86,136400,94600,231000
172210,202109,370,185,185,203500,204600,408100
210005,202109,2951,1847,1104,2033900.32,1215500,3249400.32
210010,202109,148,88,60,96800,66000,162800
210015,202109,40,29,11,31900,12100,44000
210020,202109,363,210,153,231000,168300,399300
210030,202109,318,212,106,233200,116600,349800
210040,202109,135,108,27,118800,29700,148500
210043,202109,249,197,52,216700,57200,273900
210047,202109,508,311,197,343200,216700,559900
210050,202109,278,207,71,227700,79200,306900
210055,202109,50,42,8,46200,8800,55000
210060,202109,541,439,102,482900,112200,595100
210070,202109,431,333,98,366300,107800,474100
210080,202109,134,122,12,134200,13200,147400
210083,202109,290,142,148,156200,162800,319000
210087,202109,4,3,1,3300,1100,4400
210090,202109,436,314,122,345400,134200,479600
210095,202109,419,321,98,353100,107800,460900
210100,202109,693,551,142,606100,156200,762300
210110,202109,120,77,43,84700,47300,132000
210120,202109,4953,3914,1039,4306500,1144000,5450500
210125,202109,183,113,70,124300,77000,201300
210130,202109,462,268,194,294800,213400,508200
210135,202109,28,22,6,24200,6600,30800
210140,202109,4401,3408,993,3749900,1092300,4842200
210150,202109,363,231,132,254100,145200,399300
210160,202109,3275,2796,479,3075600.54,526900,3602500.54
210170,202109,1204,970,234,1068100,257400,1325500
210173,202109,123,108,15,118800,16500,135300
210177,202109,333,191,142,210100,156200,366300
210180,202109,29,16,13,17600,14300,31900
210190,202109,434,286,148,314600,162800,477400
210193,202109,5,4,1,4400,1100,5500
210197,202109,73,54,19,60500,20900,81400
210200,202109,612,520,92,573100,101200,674300
210203,202109,215,150,65,165000,71500,236500
210207,202109,355,299,56,328900,61600,390500
210210,202109,728,673,55,740300,60500,800800
210215,202109,72,63,9,69300,9900,79200
210220,202109,375,316,59,347600,64900,412500
210230,202109,306,245,61,269500,67100,336600
210232,202109,1307,909,398,999900,437800,1437700
210235,202109,180,138,42,151800,46200,198000
210237,202109,35,19,16,20900,17600,38500
210240,202109,80,67,13,73700,14300,88000
210250,202109,175,148,27,162800,29700,192500
210255,202109,366,280,86,308000,94600,402600
210260,202109,391,273,118,300300,129800,430100
210270,202109,630,430,200,473000,220000,693000
210275,202109,83,62,21,68200,23100,91300
210280,202109,1043,687,356,755700,391600,1147300
210290,202109,533,365,168,401500,184800,586300
210300,202109,5147,3286,1861,3617900.98,2048200,5666100.98
210310,202109,108,78,30,85800,33000,118800
210312,202109,116,82,34,90200,37400,127600
210315,202109,102,86,16,95700,17600,113300
210317,202109,138,104,34,114400,37400,151800
210320,202109,2307,1983,324,2181300,356400,2537700
210325,202109,140,84,56,92400,61600,154000
210330,202109,4350,2545,1805,2799500.09,1985500,4785000.09
210340,202109,1210,915,295,1007600,324500,1332100
210350,202109,655,544,111,598400,122100,720500
210355,202109,150,128,22,140800,24200,165000
210360,202109,2132,1503,629,1654400,691900,2346300
210370,202109,1226,617,609,678700,669900,1348600
210375,202109,188,96,92,105600,101200,206800
210380,202109,721,559,162,614900,178200,793100
210390,202109,193,164,29,180400,31900,212300
210400,202109,392,341,51,375100,56100,431200
210405,202109,1000,708,292,778800,324500,1103300
210407,202109,62,49,13,53900,14300,68200
210408,202109,44,39,5,42900,5500,48400
210409,202109,327,287,40,315700,44000,359700
210410,202109,436,344,92,378400,101200,479600
210420,202109,201,167,34,183700,38500,222200
210430,202109,52,36,16,39600,17600,57200
210440,202109,370,252,118,277200,129800,407000
210450,202109,100,83,17,91300,18700,110000
210455,202109,234,124,110,136400,121000,257400
210460,202109,302,207,95,227700,104500,332200
210462,202109,65,55,10,60500,11000,71500
210465,202109,139,110,29,121000,31900,152900
210467,202109,508,379,129,416900,141900,558800
210470,202109,47,40,7,44000,7700,51700
210480,202109,1286,928,358,1021900,394900.5,1416800.5
210490,202109,188,129,59,141900,64900,206800
210500,202109,505,309,196,339900,215600,555500
210510,202109,529,426,103,468600,113300,581900
210515,202109,354,225,129,247500,141900,389400
210520,202109,402,366,36,402600,39600,442200
210530,202109,9373,4898,4475,5388900.48,4924700.83,10313601.31
210535,202109,128,97,31,106700,34100,140800
210540,202109,1501,1015,486,1116500,534600,1651100
210542,202109,1133,578,555,635800,610500,1246300
210545,202109,20,18,2,19800,2200,22000
210547,202109,126,112,14,123200,15400,138600
210550,202109,624,448,176,492800,193600,686400
210560,202109,154,134,20,147400,22000,169400
210565,202109,21,15,6,16500,6600,23100
210570,202109,1287,1056,231,1161600.59,254100,1415700.59
210580,202109,122,102,20,112200,22000,134200
210590,202109,724,603,121,663300,133100,796400
210592,202109,39,36,3,39600,3300,42900
210594,202109,108,91,17,100100,18700,118800
210596,202109,111,96,15,105600,16500,122100
210598,202109,139,106,33,116600,36300,152900
210600,202109,310,269,41,295900,45100,341000
210610,202109,249,234,15,257400,16500,273900
210620,202109,44,28,16,30800,17600,48400
210630,202109,74,69,5,75900,5500,81400
210632,202109,1001,718,283,789800,311300,1101100
210635,202109,22,19,3,20900,3300,24200
210637,202109,129,94,35,103400,38500,141900
210640,202109,577,513,64,564300,70400,634700
210650,202109,393,332,61,365200,67100,432300
210660,202109,367,289,78,317900,85800,403700
210663,202109,49,35,14,38500,15400,53900
210667,202109,98,39,59,42900,64900,107800
210670,202109,258,230,28,253000,30800,283800
210675,202109,508,280,228,308000,250800,558800
210680,202109,221,142,79,156200,86900,243100
210690,202109,602,502,100,552200,110000,662200
210700,202109,149,114,35,126500,38500,165000
210710,202109,230,148,82,162800,90200,253000
210720,202109,127,115,12,126500,13200,139700
210725,202109,62,53,9,58300,9900,68200
210730,202109,23,18,5,19800,5500,25300
210735,202109,287,211,76,232100,83600,315700
210740,202109,520,450,70,495000,77000,572000
210745,202109,146,109,37,121000,40700,161700
210750,202109,2456,1263,1193,1390400,1313400,2703800
210760,202109,253,198,55,217800,60500,278300
210770,202109,245,199,46,218900,50600,269500
210780,202109,430,327,103,359700,113300,473000
210790,202109,182,150,32,165000,35200,200200
210800,202109,172,133,39,146300,42900,189200
210805,202109,57,51,6,56100,6600,62700
210810,202109,467,383,84,421300,92400,513700
210820,202109,2069,1734,335,1908500,369600,2278100
210825,202109,150,85,65,93500,71500,165000
210830,202109,715,478,237,525800,260700,786500
210840,202109,191,136,55,149600,60500,210100
210845,202109,229,172,57,189200,62700,251900
210850,202109,726,500,226,550000,248600,798600
210860,202109,3417,1982,1435,2180200,1578500,3758700
210870,202109,429,339,90,372900,99000,471900
210880,202109,77,60,17,66000,18700,84700
210890,202109,315,274,41,301400,45100,346500
210900,202109,628,413,215,454300,236500,690800
210905,202109,60,34,26,37400,28600,66000
210910,202109,1930,1479,451,1626900.7,496100,2123000.7
210920,202109,150,61,89,67100,97900,165000
210923,202109,84,68,16,74800,17600,92400
210927,202109,410,200,210,220000,231000,451000
210930,202109,66,53,13,58300,14300,72600
210940,202109,81,63,18,70400,19800,90200
210945,202109,199,111,88,122100,96800,218900
210950,202109,518,381,137,419100,150700,569800
210955,202109,89,56,33,61600,36300,97900
210960,202109,2207,1140,1067,1254000,1174800,2428800
210970,202109,113,99,14,108900,15400,124300
210975,202109,77,72,5,79200,5500,84700
210980,202109,1069,535,534,588500,587400,1175900
210990,202109,3944,2648,1296,2913900,1425600,4339500
211000,202109,1297,1058,239,1164900,262900,1427800
211003,202109,967,702,265,772200,291500,1063700
211010,202109,479,431,48,474100,53900,528000
211020,202109,1371,602,769,663300,845900,1509200
211023,202109,41,36,5,39600,5500,45100
211027,202109,74,54,20,59400,22000,81400
211030,202109,363,264,99,290400,108900,399300
211040,202109,290,244,46,268400,50600,319000
211050,202109,1125,760,365,836000,401500,1237500
211060,202109,627,558,69,613800,77000.49,690800.49
211065,202109,22,19,3,20900,3300,24200
211070,202109,861,724,137,796400,150700,947100
211080,202109,85,83,2,91300,2200,93500
211085,202109,50,27,23,29700,25300,55000
211090,202109,75,63,12,69300,13200,82500
211100,202109,462,388,74,426800,81400,508200
211102,202109,240,171,69,188100,75900,264000
211105,202109,220,154,66,169400,72600,242000
211107,202109,125,79,46,86900,50600,137500
211110,202109,931,627,304,690800,334400,1025200
211120,202109,5109,2620,2489,2883100,2737900,5621000
211125,202109,23,16,7,17600,7700,25300
211130,202109,40779,19076,21703,20996800.55,23882100,44878900.55
211140,202109,394,346,48,380600,52800,433400
211150,202109,1181,821,360,903100,396000,1299100
211153,202109,168,107,61,117700,67100,184800
211157,202109,69,55,14,60500,15400,75900
211160,202109,677,584,93,642400,102300,744700
211163,202109,3,3,0,3300,0,3300
211167,202109,10,9,1,9900,1100,11000
211170,202109,417,310,107,341000,117700,458700
211172,202109,112,77,35,84700,38500,123200
211174,202109,250,158,92,173800,101200,275000
211176,202109,459,342,117,376200,128700,504900
211178,202109,86,58,28,63800,30800,94600
211180,202109,208,168,40,184800,44000,228800
211190,202109,70,64,6,70400,6600,77000
211195,202109,33,20,13,22000,14300,36300
211200,202109,149,130,19,143000,20900,163900
211210,202109,406,303,103,333300,113300,446600
211220,202109,4147,2457,1690,2704900.5,1860100,4565000.5
211223,202109,97,93,4,102300,4400,106700
211227,202109,54,44,10,48400,11000,59400
211230,202109,723,597,126,656700,138600,795300
211240,202109,381,310,71,341000,78100,419100
211245,202109,175,91,84,100100,92400,192500
211250,202109,1513,1312,201,1443200,221100,1664300
211260,202109,789,658,131,723800,144100,867900
211270,202109,1890,1559,331,1714900,364100,2079000
211280,202109,1769,1158,611,1273800,672100,1945900
211285,202109,204,129,75,141900,82500,224400
211290,202109,714,510,204,561000,224400,785400
211300,202109,745,596,149,655600,163900,819500
211400,202109,1512,946,566,1040600,622600,1663200
220005,202109,15,14,1,15400,1100,16500
220010,202109,87,70,17,77000,18700,95700
220020,202109,691,558,133,614900,146300,761200
220025,202109,106,103,3,114400,3300,117700
220027,202109,48,39,9,42900,9900,52800
220030,202109,116,94,22,103400,24200,127600
220040,202109,1260,970,290,1067000,319000,1386000
220045,202109,32,21,11,23100,12100,35200
220050,202109,693,578,115,635800.8,126500,762300.8
220060,202109,175,152,23,168300,25300,193600
220070,202109,112,99,13,110000,14300,124300
220080,202109,15,13,2,14300,2200,16500
220090,202109,36,27,9,29700,9900,39600
220095,202109,2,1,1,1100,1100,2200
220100,202109,21,18,3,19800,3300,23100
220105,202109,27,25,2,27500,2200,29700
220110,202109,233,212,21,233200,23100,256300
220115,202109,39,36,3,39600,3300,42900
220117,202109,21,20,1,22000,1100,23100
220120,202109,1475,1132,343,1246300,377300,1623600
220130,202109,29,28,1,30800,1100,31900
220140,202109,101,81,20,89100,22000,111100
220150,202109,485,369,116,405900,127600,533500
220155,202109,11,10,1,11000,1100,12100
220157,202109,19,16,3,17600,3300,20900
220160,202109,95,84,11,92400,12100,104500
220170,202109,38,34,4,37400,4400,41800
220173,202109,7,7,0,7700,0,7700
220177,202109,11,10,1,11000,1100,12100
220180,202109,66,64,2,70400,2200,72600
220190,202109,1074,943,131,1038400,144100,1182500
220191,202109,39,32,7,35200,7700,42900
220192,202109,89,85,4,93500,4400,97900
220194,202109,58,53,5,58300,5500,63800
220196,202109,91,77,14,85800,15400,101200
220198,202109,1,1,0,1100,0,1100
220200,202109,416,349,67,383900,73700,457600
220202,202109,37,32,5,35200,5500,40700
220205,202109,57,50,7,55000,7700,62700
220207,202109,13,13,0,14300,0,14300
220208,202109,77,45,32,49500,35200,84700
220209,202109,31,26,5,28600,5500,34100
220210,202109,23,15,8,16500,8800,25300
220211,202109,28,26,2,28600,2200,30800
220213,202109,32,28,4,30800,4400,35200
220217,202109,40,32,8,35200,8800,44000
220220,202109,2228,1468,760,1615900,836000,2451900
220225,202109,7,1,6,1100,6600,7700
220230,202109,956,739,217,812900,239800,1052700
220240,202109,163,144,19,158400,20900,179300
220245,202109,35,32,3,35200.18,3300,38500.18
220250,202109,121,103,18,113300,19800,133100
220253,202109,52,45,7,49500,7700,57200
220255,202109,38,33,5,36300.41,5500,41800.41
220260,202109,704,529,175,583000,192500,775500
220265,202109,6,5,1,5500,1100,6600
220270,202109,799,723,76,795300,83600,878900
220271,202109,41,33,8,37400,8800,46200
220272,202109,10,10,0,11000,0,11000
220273,202109,17,15,2,16500,2200,18700
220275,202109,58,48,10,52800,11000,63800
220277,202109,21,13,8,14300,8800,23100
220280,202109,17,11,6,12100,6600,18700
220285,202109,40,38,2,41800,2200,44000
220290,202109,1484,1272,212,1401400,233200,1634600
220300,202109,35,34,1,37400,1100,38500
220310,202109,325,278,47,305800,51700,357500
220320,202109,450,416,34,457600,37400,495000
220323,202109,2,1,1,1100,1100,2200
220325,202109,9,8,1,8800,1100,9900
220327,202109,12,12,0,13200,0,13200
220330,202109,235,170,65,187000,71500,258500
220335,202109,138,117,21,128700,23100,151800
220340,202109,43,31,12,34100,13200,47300
220342,202109,54,46,8,50600,8800,59400
220345,202109,76,67,9,73700,9900,83600
220350,202109,455,394,61,433400,67100,500500
220360,202109,38,28,10,30800,11000,41800
220370,202109,1266,1051,215,1157200,236500,1393700
220375,202109,14,14,0,15400,0,15400
220380,202109,24,18,6,19800,6600,26400
220385,202109,14,13,1,14300,1100,15400
220390,202109,2313,1295,1018,1424500,1119800,2544300
220400,202109,35,31,4,34100,4400,38500
220410,202109,21,19,2,20900,2200,23100
220415,202109,12,11,1,12100,1100,13200
220420,202109,125,105,20,115500,22000,137500
220430,202109,128,115,13,126500,14300,140800
220435,202109,24,17,7,18700,7700,26400
220440,202109,283,242,41,267300,45100,312400
220450,202109,335,171,164,188100,180400,368500
220455,202109,51,50,1,55000,1100,56100
220460,202109,19,17,2,18700,2200,20900
220465,202109,82,56,26,61600,28600,90200
220470,202109,243,211,32,232100,35200,267300
220480,202109,71,64,7,70400,7700,78100
220490,202109,91,77,14,84700,15400,100100
220500,202109,112,92,20,101200,22000,123200
220510,202109,390,302,88,332200,96800,429000
220515,202109,20,18,2,19800,2200,22000
220520,202109,370,329,41,361900,45100,407000
220525,202109,10,7,3,7700,3300,11000
220527,202109,17,14,3,15400,3300,18700
220530,202109,40,17,23,18700,25300,44000
220535,202109,7,5,2,5500,2200,7700
220540,202109,78,65,13,71500,14300,85800
220545,202109,30,21,9,23100,9900,33000
220550,202109,704,561,143,617100,157300,774400
220551,202109,16,13,3,14300,3300,17600
220552,202109,12,12,0,13200,0,13200
220553,202109,50,45,5,49500,5500,55000
220554,202109,11,8,3,8800,3300,12100
220555,202109,39,31,8,34100,8800,42900
220556,202109,39,36,3,39600,3300,42900
220557,202109,53,49,4,53900,4400,58300
220558,202109,7,3,4,3300,4400,7700
220559,202109,2,2,0,2200,0,2200
220560,202109,69,46,23,50600,25300,75900
220570,202109,730,457,273,502700,300300,803000
220580,202109,537,488,49,536800,53900,590700
220585,202109,10,9,1,9900,1100,11000
220590,202109,13,12,1,13200,1100,14300
220595,202109,70,54,16,59400,17600,77000
220600,202109,21,13,8,14300,8800,23100
220605,202109,24,21,3,23100,3300,26400
220610,202109,85,71,14,78100,15400,93500
220620,202109,554,463,91,509300,100100,609400
220630,202109,6,5,1,5500,1100,6600
220635,202109,35,31,4,34100,4400,38500
220640,202109,107,88,19,96800,20900,117700
220650,202109,112,106,6,116600,6600,123200
220660,202109,59,47,12,51700,13200,64900
220665,202109,6,6,0,6600,0,6600
220667,202109,15,13,2,14300,2200,16500
220669,202109,31,24,7,26400,7700,34100
220670,202109,66,53,13,58300,14300,72600
220672,202109,78,58,20,63800,22000,85800
220675,202109,34,26,8,28600,8800,37400
220680,202109,46,40,6,44000,6600,50600
220690,202109,51,48,3,52800,3300,56100
220695,202109,27,15,12,16500,13200,29700
220700,202109,1731,1342,389,1476200,429000,1905200
220710,202109,6,4,2,4400,2200,6600
220720,202109,106,90,16,99000,17600,116600
220730,202109,18,15,3,16500,3300,19800
220735,202109,3,0,3,0,3300,3300
220740,202109,49,44,5,48400,5500,53900
220750,202109,113,98,15,107800,16500,124300
220755,202109,17,16,1,17600,1100,18700
220760,202109,67,60,7,66000,7700,73700
220770,202109,5795,3247,2548,3575000,2805000,6380000
220775,202109,14,10,4,11000,4400,15400
220777,202109,20,19,1,20900,1100,22000
220779,202109,1,0,1,0,1100,1100
220780,202109,903,772,131,850300,144100,994400
220785,202109,5,1,4,1100,4400,5500
220790,202109,1127,890,237,979000,261800,1240800
220793,202109,5,5,0,5500,0,5500
220795,202109,14,12,2,13200,2200,15400
220800,202109,4010,3075,935,3384904,1029600,4414504
220810,202109,68,59,9,64900,9900,74800
220820,202109,237,214,23,235400,25300,260700
220830,202109,1289,1118,171,1229800,188100,1417900
220840,202109,2449,1723,726,1895300,799700,2695000
220850,202109,68,60,8,66000,8800,74800
220855,202109,8,4,4,4400,4400,8800
220860,202109,10,9,1,9900,1100,11000
220865,202109,28,26,2,28600,2200,30800
220870,202109,85,76,9,83600,9900,93500
220880,202109,325,261,64,287100,70400,357500
220885,202109,27,26,1,28600,1100,29700
220887,202109,10,9,1,9900,1100,11000
220890,202109,90,78,12,85800,13200,99000
220900,202109,27,16,11,17600,12100,29700
220910,202109,48,39,9,42900,9900,52800
220915,202109,12,11,1,12100,1100,13200
220920,202109,53,45,8,49500,8800,58300
220930,202109,48,46,2,50600,2200,52800
220935,202109,14,14,0,15400,0,15400
220937,202109,29,28,1,30800,1100,31900
220940,202109,54,50,4,55000,4400,59400
220945,202109,2,2,0,2200,0,2200
220950,202109,37,29,8,31900,8800,40700
220955,202109,15,15,0,16500,0,16500
220960,202109,23,22,1,24200,1100,25300
220965,202109,39,35,4,38500,4400,42900
220970,202109,59,50,9,55000,9900,64900
220975,202109,11,10,1,11000,1100,12100
220980,202109,30,27,3,29700,3300,33000
220985,202109,60,54,6,59400,6600,66000
220987,202109,31,29,2,31900,2200,34100
220990,202109,25,25,0,27500,0,27500
220995,202109,13,11,2,12100,2200,14300
220997,202109,59,51,8,56100,8800,64900
221000,202109,1186,1069,117,1177000,128700,1305700
221005,202109,36,33,3,36300,3300,39600
221010,202109,18,14,4,15400,4400,19800
221020,202109,34,33,1,36300,1100,37400
221030,202109,39,31,8,34100,8800,42900
221035,202109,21,21,0,23100,0,23100
221037,202109,12,8,4,8800,4400,13200
221038,202109,27,24,3,26400,3300,29700
221039,202109,26,25,1,27500,1100,28600
221040,202109,266,229,37,251900,40700,292600
221050,202109,227,189,38,207900,41800,249700
221060,202109,1931,1677,254,1846900,279400,2126300
221062,202109,31,30,1,33000,1100,34100
221063,202109,14,10,4,11000,4400,15400
221065,202109,64,52,12,57200,13200,70400
221070,202109,138,122,16,134200,17600,151800
221080,202109,377,322,55,354200,60500,414700
221090,202109,20,15,5,16500,5500,22000
221093,202109,42,31,11,34100,12100,46200
221095,202109,4,4,0,4400,0,4400
221097,202109,11,9,2,9900,2200,12100
221100,202109,25761,15412,10349,16971900.63,11391600,28363500.63
221110,202109,1117,843,274,927300,301400,1228700
221120,202109,535,394,141,434500,155100,589600
221130,202109,967,781,186,859100,204600,1063700
221135,202109,30,26,4,28600,4400,33000
221140,202109,47,40,7,44000,7700,51700
221150,202109,9,7,2,7700,2200,9900
221160,202109,11,11,0,12100,0,12100
221170,202109,17,17,0,18700,0,18700
230010,202109,150,133,17,146300,18700,165000
230015,202109,137,112,25,124300,27500,151800
230020,202109,1638,1371,267,1508100,293700,1801800
230030,202109,1675,1204,471,1325500,518100,1843600
230040,202109,229,191,38,210100,41800,251900
230050,202109,235,171,64,188100,70400,258500
230060,202109,162,125,37,138600,40700,179300
230070,202109,310,267,43,293700,47300,341000
230075,202109,854,730,124,804100,136400,940500
230080,202109,201,171,30,188100,33000,221100
230090,202109,142,106,36,116600,39600,156200
230100,202109,2302,1301,1001,1431100.16,1101100,2532200.16
230110,202109,2895,1842,1053,2026200,1159400,3185600
230120,202109,1048,826,222,908600,244200,1152800
230125,202109,155,126,29,138600,31900,170500
230130,202109,477,422,55,464200,60500,524700
230140,202109,216,177,39,194700,42900,237600
230150,202109,153,118,35,129800,38500,168300
230160,202109,943,788,155,867900,170500,1038400
230170,202109,614,543,71,597300,78100,675400
230180,202109,70,64,6,70400,6600,77000
230185,202109,405,345,60,379500,66000,445500
230190,202109,2406,1875,531,2065800,584100,2649900
230195,202109,499,430,69,473000,75900,548900
230200,202109,415,330,85,364100,93500,457600
230205,202109,388,257,131,283800,145200,429000
230210,202109,1379,1063,316,1171500,347600,1519100
230220,202109,1575,1071,504,1180300,555500,1735800
230230,202109,968,814,154,895400,169400,1064800
230240,202109,1831,1589,242,1752575,266200,2018775
230250,202109,1782,1462,320,1608200,353100,1961300
230260,202109,3221,1999,1222,2198900,1344200,3543100
230270,202109,1363,1080,283,1189100.05,311300,1500400.05
230280,202109,2759,2088,671,2296800,738100,3034900
230290,202109,358,318,40,350900.5,44000,394900.5
230300,202109,533,387,146,425700,161700,587400
230310,202109,428,330,98,363000,107800,470800
230320,202109,908,767,141,843700,155100,998800
230330,202109,300,239,61,262900,67100,330000
230340,202109,443,356,87,392700,95700,488400
230350,202109,3239,2009,1230,2209900,1354100,3564000
230360,202109,268,224,44,246400,48400,294800
230365,202109,128,106,22,116600,24200,140800
230370,202109,10575,5208,5367,5731000.92,5911400,11642400.92
230380,202109,494,424,70,466400,77000,543400
230390,202109,536,298,238,327800,262900,590700
230393,202109,251,205,46,225500,50600,276100
230395,202109,346,279,67,306900,74800,381700
230400,202109,632,504,128,555500,140800,696300
230410,202109,2670,1646,1024,1810600.5,1127500,2938100.5
230420,202109,6430,4247,2183,4678300.6,2401300,7079600.6
230423,202109,339,295,44,325600,48400,374000
230425,202109,454,363,91,400400,100100,500500
230426,202109,117,92,25,101200,27500,128700
230427,202109,69,65,4,71500,4400,75900
230428,202109,1565,769,796,845900,875600,1721500
230430,202109,459,371,88,408100,96800,504900
230435,202109,919,669,250,735900,275000.24,1010900.24
230440,202109,92095,41370,50725,45540003.29,55847000.55,101387003.84
230445,202109,313,213,100,235400,111100,346500
230450,202109,583,456,127,501600,139700,641300
230460,202109,79,57,22,62700,24200,86900
230465,202109,314,252,62,277200,69300,346500
230470,202109,2028,1588,440,1746800,484000,2230800
230480,202109,152,142,10,156200,11000,167200
230490,202109,322,254,68,279400,74800,354200
230495,202109,468,332,136,366300,149600,515900
230500,202109,1022,759,263,836000,289300,1125300
230510,202109,57,43,14,47300,15400,62700
230520,202109,394,307,87,337700,95700,433400
230523,202109,2406,1487,919,1635700,1013100,2648800
230526,202109,269,232,37,255200,40700,295900
230530,202109,689,508,181,558800,199100,757900
230533,202109,217,197,20,216700,22000,238700
230535,202109,369,277,92,304700,101200,405900
230540,202109,1804,1607,197,1767700,217800,1985500
230550,202109,3941,2500,1441,2752200,1585100,4337300
230560,202109,582,440,142,484000,156200,640200
230565,202109,220,161,59,177100,64900,242000
230570,202109,284,244,40,268400,44000,312400
230580,202109,1180,844,336,928400,369600,1298000
230590,202109,1004,781,223,860200,245300,1105500
230600,202109,252,227,25,249700,27500,277200
230610,202109,410,308,102,338800,112200,451000
230620,202109,167,143,24,157300,26400,183700
230625,202109,811,555,256,610500,281600,892100
230630,202109,1333,1017,316,1118700,347600,1466300
230640,202109,3802,3195,607,3517800.53,667700,4185500.53
230650,202109,499,428,71,470800,78100,548900
230655,202109,699,579,120,638000,132000,770000
230660,202109,358,293,65,323400,71500,394900
230670,202109,446,369,77,405900,84700,490600
230680,202109,206,184,22,202400,24200,226600
230690,202109,925,779,146,856900,160600,1017500
230700,202109,878,733,145,806300,160600,966900
230710,202109,694,652,42,717200,46200,763400
230720,202109,144,124,20,136400,22000,158400
230725,202109,237,177,60,194700,66000,260700
230730,202109,12494,6690,5804,7364431.32,6386600.82,13751032.14
230740,202109,668,534,134,587400,147400,734800
230750,202109,824,695,129,764500,141900,906400
230760,202109,1441,1241,200,1367300,220000,1587300
230763,202109,338,278,60,305800,66000,371800
230765,202109,7921,3681,4240,4053500.6,4666200,8719700.6
230770,202109,4986,2539,2447,2794000,2691700,5485700
230780,202109,752,662,90,729300,99000,828300
230790,202109,297,246,51,270600,57200,327800
230800,202109,1154,833,321,918500,353100,1271600
230810,202109,1377,1210,167,1332100,183700,1515800
230820,202109,365,249,116,273900,127600,401500
230830,202109,969,818,151,900815,166100,1066915
230835,202109,278,238,40,261800,44000,305800
230837,202109,175,143,32,157300,35200,192500
230840,202109,922,715,207,787600,227700,1015300
230850,202109,1425,1226,199,1348600,220000,1568600
230860,202109,303,225,78,247500,85806,333306
230870,202109,1823,1542,281,1697300,309100,2006400
230880,202109,75,57,18,62700,19800,82500
230890,202109,543,488,55,536800,60500,597300
230900,202109,284,211,73,232100,80300.7,312400.7
230910,202109,224,172,52,189200,57200,246400
230920,202109,482,382,100,421300,110000,531300
230930,202109,1020,710,310,781000,341000,1122000
230940,202109,839,645,194,709500,214500,924000
230945,202109,518,414,104,455400,114400,569800
230950,202109,427,369,58,405900,63800,469700
230960,202109,2721,1812,909,1994300,999900,2994200
230970,202109,1729,967,762,1065900,838200,1904100
230980,202109,201,161,40,177100,44000,221100
230990,202109,139,111,28,122100,30800,152900
231000,202109,200,183,17,201300,18700,220000
231010,202109,161,114,47,125400,51700,177100
231020,202109,1382,948,434,1045000,477400,1522400
231025,202109,1071,765,306,841500,336600,1178100
231030,202109,1064,885,179,973500,198000,1171500
231040,202109,150,101,49,111100,53900,165000
231050,202109,944,824,120,906400,132000,1038400
231060,202109,157,129,28,141900,30800,172700
231070,202109,1505,1037,468,1141800,515900,1657700
231080,202109,265,237,28,260700,30800,291500
231085,202109,635,385,250,423500,275000,698500
231090,202109,257,206,51,226600,56100,282700
231095,202109,162,129,33,141900,36300,178200
231100,202109,160,132,28,145200,30800,176000
231110,202109,369,312,57,343200,62700,405900
231120,202109,265,222,43,244200,47300,291500
231123,202109,155,145,10,159500,11000,170500
231126,202109,335,255,80,280500,88000,368500
231130,202109,4898,3823,1075,4210800,1182500,5393300
231135,202109,215,184,31,202400,34100,236500
231140,202109,3085,2236,849,2460700,933900,3394600
231150,202109,372,348,24,382800,26400,409200
231160,202109,1221,979,242,1076900,266200,1343100
231170,202109,516,358,158,393800,173800,567600
231180,202109,1727,1485,242,1634600,266200,1900800
231190,202109,208,171,37,188100,40700,228800
231195,202109,226,190,36,209000,39600,248600
231200,202109,810,659,151,724900,166100,891000
231210,202109,520,441,79,485100,86900,572000
231220,202109,1043,756,287,831600.85,315700,1147300.85
231230,202109,1475,1138,337,1251800,370700,1622500
231240,202109,1476,1027,449,1133000,493900,1626900
231250,202109,95,89,6,97900,6600,104500
231260,202109,264,176,88,193600,96800,290400
231270,202109,997,794,203,873400,223300,1096700
231280,202109,74,57,17,62700,18700,81400
231290,202109,7800,4365,3435,4802600,3780700.57,8583300.57
231300,202109,591,543,48,599500,52800,652300
231310,202109,751,688,63,756800,69300,826100
231320,202109,586,441,145,485100,159500,644600
231325,202109,102,88,14,96800,15400,112200
231330,202109,1936,1489,447,1639000.74,491700,2130700.74
231335,202109,254,226,28,248600,30800,279400
231340,202109,1739,1248,491,1377200,540100,1917300
231350,202109,1319,1056,263,1163800,289300,1453100
231355,202109,425,362,63,398200,69300,467500
231360,202109,531,374,157,411400.65,172700,584100.65
231370,202109,94,82,12,90200,13200,103400
231375,202109,296,217,79,238700,88000,326700
231380,202109,494,392,102,431200,112200,543400
231390,202109,209,158,51,176000,56100,232100
231395,202109,767,473,294,521400,323400,844800
231400,202109,1142,949,193,1045000,213400,1258400
231410,202109,1336,1096,240,1205600,264000,1469600
240010,202109,377,164,213,181500.97,234300,415800.97
240020,202109,2190,1780,410,1958000,452100,2410100
240030,202109,119,99,20,108900,22000,130900
240040,202109,30,30,0,33000,0,33000
240050,202109,534,456,78,501600,85800,587400
240060,202109,69,65,4,71500,4400,75900
240070,202109,234,184,50,202400,55000,257400
240080,202109,525,356,169,392700,185900.7,578600.7
240090,202109,104,93,11,102300,12100,114400
240100,202109,1470,1384,86,1523500.5,94600,1618100.5
240110,202109,1028,679,349,746900,383900,1130800
240120,202109,141,106,35,116600,38500,155100
240130,202109,274,253,21,278300,23100,301400
240140,202109,82,56,26,61600,28600,90200
240145,202109,726,640,86,704000,94600,798600
240150,202109,22,17,5,18700,5500,24200
240160,202109,41,33,8,36300,8800,45100
240165,202109,38,30,8,33000,8800,41800
240170,202109,119,81,38,89100,41800,130900
240180,202109,99,75,24,82500,26400,108900
240185,202109,43,39,4,42900,4400,47300
240190,202109,16,14,2,15400,2200,17600
240200,202109,3068,1677,1391,1844700,1533400,3378100
240210,202109,168,130,38,144100,41800,185900
240220,202109,1100,783,317,862400,348700,1211100
240230,202109,832,758,74,834900,81400,916300
240240,202109,69,48,21,52800,23100,75900
240250,202109,90,77,13,84700,14300,99000
240260,202109,1810,1308,502,1441000,552200,1993200
240270,202109,181,159,22,176000,24200,200200
240280,202109,53,41,12,45100,13200,58300
240290,202109,47,45,2,49500,2200,51700
240300,202109,172,93,79,102300,86900,189200
240310,202109,2406,1300,1106,1430000.83,1217700,2647700.83
240320,202109,185,172,13,189200,14300,203500
240325,202109,4659,2726,1933,2998601.3,2130700.51,5129301.81
240330,202109,70,66,4,73700,4400,78100
240340,202109,81,54,27,59400,29700,89100
240350,202109,91,77,14,84700,15400,100100
240360,202109,601,361,240,399300,265100,664400
240370,202109,52,47,5,51700,5500,57200
240375,202109,64,38,26,41800,28600,70400
240380,202109,227,186,41,204600,45100,249700
240390,202109,12,11,1,12100,1100,13200
240400,202109,83,74,9,81400,9900,91300
240410,202109,14,8,6,8800,6600,15400
240420,202109,1052,769,283,845900,312400,1158300
240430,202109,261,244,17,268400,18700,287100
240440,202109,125,66,59,73700,64900,138600
240450,202109,236,154,82,169400,90200,259600
240460,202109,76,59,17,64900,18700,83600
240470,202109,228,206,22,226600,24200,250800
240480,202109,16,14,2,15400,2200,17600
240485,202109,79,64,15,70400,16500,86900
240490,202109,47,43,4,47300,4400,51700
240500,202109,89,68,21,74800,23100,97900
240510,202109,42,30,12,33000,13200,46200
240520,202109,101,96,5,105600,5500,111100
240530,202109,59,51,8,56100,8800,64900
240540,202109,82,70,12,77000,13200,90200
240550,202109,13,12,1,13200,1100,14300
240560,202109,375,271,104,298100,114400,412500
240570,202109,438,276,162,303600,178200,481800
240580,202109,1276,989,287,1090100,316800,1406900
240590,202109,32,30,2,33000,2200,35200
240600,202109,96,92,4,101200,4400,105600
240610,202109,512,423,89,465300,99000,564300
240615,202109,16,15,1,16500,1100,17600
240620,202109,86,83,3,91300,3300,94600
240630,202109,39,34,5,37400,5500,42900
240640,202109,25,20,5,22000,5500,27500
240650,202109,240,197,43,216700,47300,264000
240660,202109,108,91,17,100100,18700,118800
240670,202109,312,171,141,188100,155100,343200
240680,202109,53,40,13,44000,14300,58300
240690,202109,47,44,3,48400,3300,51700
240700,202109,182,149,33,163900,36300,200200
240710,202109,2102,1279,823,1408000,905300,2313300
240720,202109,1065,775,290,853600,319000,1172600
240725,202109,68,63,5,69300,5500,74800
240730,202109,148,123,25,135300,27500,162800
240740,202109,230,195,35,214500,38500,253000
240750,202109,50,28,22,31900,24200,56100
240760,202109,48,44,4,48400,4400,52800
240770,202109,148,114,34,125400,37400,162800
240780,202109,707,585,122,644600,134200,778800
240790,202109,42,40,2,44000,2200,46200
240800,202109,9334,6330,3004,6967400.85,3305500,10272900.85
240810,202109,21095,11251,9844,12382700.12,10831700,23214400.12
240820,202109,251,146,105,160600,115500,276100
240830,202109,1615,1335,280,1469600,308000,1777600
240840,202109,75,66,9,72600,9900,82500
240850,202109,84,75,9,82500,9900,92400
240860,202109,107,103,4,113300,4400,117700
240870,202109,59,51,8,56100,8800,64900
240880,202109,31,28,3,30800,3300,34100
240890,202109,1140,636,504,699600,554400,1254000
240895,202109,64,47,17,51700,18700,70400
240910,202109,167,143,24,157300,26400,183700
240920,202109,13,11,2,12100,2200,14300
240930,202109,401,359,42,394900,46200,441100
240933,202109,56,35,21,38500,23100,61600
240940,202109,2317,2053,264,2260500,290400,2550900
240950,202109,47,41,6,45100,6600,51700
240960,202109,25,21,4,23100,4400,27500
240970,202109,115,85,30,93500,33000,126500
240980,202109,198,159,39,174900,42900,217800
240990,202109,136,92,44,101200,49500,150700
241000,202109,59,56,3,61600,3300,64900
241010,202109,75,57,18,62700,19800,82500
241020,202109,106,98,8,107800,8800,116600
241025,202109,15,7,8,7700,8800,16500
241030,202109,108,86,22,94600,24200,118800
241040,202109,42,30,12,33000,13200,46200
241050,202109,76,69,7,75900,7700,83600
241060,202109,27,22,5,24200,5500,29700
241070,202109,16,16,0,17600,0,17600
241080,202109,60,53,7,58300,7700,66000
241090,202109,48,38,10,41800,11000,52800
241100,202109,74,63,11,69300,12100,81400
241105,202109,12,5,7,5500,7700,13200
241110,202109,45,40,5,44000,5500,49500
241120,202109,1533,1156,377,1271600,415800,1687400
241140,202109,215,179,36,196900,39600,236500
241142,202109,46,34,12,37400,13200,50600
241150,202109,1200,1048,152,1152800,169400,1322200
241160,202109,19,17,2,18700,2200,20900
241170,202109,49,41,8,45100,8800,53900
241180,202109,43,34,9,37400,9900,47300
241190,202109,38,36,2,39600,2200,41800
241200,202109,4093,2139,1954,2352900.53,2151600,4504500.53
241210,202109,69,59,10,64900,11000,75900
241220,202109,1448,960,488,1057100.43,536800,1593900.43
241230,202109,248,206,42,226600,46200,272800
241240,202109,55,42,13,46200,14300,60500
241250,202109,1126,1029,97,1133000,106700,1239700
241255,202109,54,45,9,49500,9900,59400
241260,202109,677,517,160,568700,176000,744700
241270,202109,66,44,22,48400,24200,72600
241280,202109,95,84,11,92400,12100,104500
241290,202109,131,91,40,101200,44000,145200
241300,202109,82,56,26,61600,28600,90200
241310,202109,50,35,15,38500,16500,55000
241320,202109,31,15,16,16500,17600,34100
241330,202109,58,51,7,56100,7700,63800
241335,202109,79,71,8,78100,8800,86900
241340,202109,182,135,47,148500,51700,200200
241350,202109,62,53,9,58300,9900,68200
241355,202109,49,41,8,45100,8800,53900
241360,202109,48,47,1,51700,1100,52800
241370,202109,56,44,12,48400,13200,61600
241380,202109,34,30,4,33000,4400,37400
241390,202109,81,63,18,69300,19800,89100
241400,202109,219,169,50,185900,55000,240900
241410,202109,182,166,16,182600,17600,200200
241415,202109,101,83,18,91300,19800,111100
241420,202109,104,75,29,82500,31900,114400
241430,202109,22,21,1,23100,1100,24200
241440,202109,522,434,88,478500,96800,575300
241445,202109,39,34,5,37400,5500,42900
241450,202109,259,215,44,236500,48400,284900
241460,202109,143,129,14,141900,15400,157300
241470,202109,35,30,5,33000,5500,38500
241475,202109,54,49,5,53900,5500,59400
241480,202109,118,87,31,95700,34100,129800
241490,202109,11,10,1,11000,1100,12100
241500,202109,42,31,11,34100,12100,46200
250010,202109,100,86,14,94600,15400,110000
250020,202109,32,28,4,30800,4400,35200
250030,202109,897,664,233,731500,256300,987800
250040,202109,386,319,67,350900,73700,424600
250050,202109,259,211,48,232100,52800,284900
250053,202109,61,47,14,51700,15400,67100
250057,202109,2,1,1,1100,1100,2200
250060,202109,600,434,166,477400,182600,660000
250070,202109,683,546,137,601700.22,150700,752400.22
250073,202109,7,7,0,7700,0,7700
250077,202109,177,129,48,141900,52800,194700
250080,202109,424,335,89,368500,97900,466400
250090,202109,223,144,79,158400,86900,245300
250100,202109,536,447,89,491700,97900,589600
250110,202109,650,488,162,536800,178200,715000
250115,202109,16,3,13,3300,14300,17600
250120,202109,122,89,33,97900,36300,134200
250130,202109,566,456,110,501600,121000,622600
250135,202109,20,11,9,12100,9900,22000
250140,202109,83,74,9,81400,9900,91300
250150,202109,602,429,173,473000,190300,663300
250153,202109,13,10,3,11000,3300,14300
250157,202109,29,24,5,26400,5500,31900
250160,202109,230,182,48,200200,52800,253000
250170,202109,70,45,25,49500,27500,77000
250180,202109,4559,3115,1444,3427600,1589500,5017100
250190,202109,835,556,279,612700,306900,919600
250200,202109,59,43,16,47300,17600,64900
250205,202109,24,20,4,22000,4400,26400
250210,202109,87,75,12,82500,13200,95700
250215,202109,69,53,16,58300,17600,75900
250220,202109,26,18,8,19800,8800,28600
250230,202109,79,71,8,78100,8800,86900
250240,202109,238,185,53,204600,58300,262900
250250,202109,374,323,51,355300,56100,411400
250260,202109,43,35,8,38500,8800,47300
250270,202109,75,52,23,57200,25300,82500
250280,202109,376,306,70,336600,77000,413600
250290,202109,92,85,7,93500,7700,101200
250300,202109,568,383,185,421300,203500,624800
250310,202109,44,40,4,44000,4400,48400
250320,202109,1967,1309,658,1439900,726000,2165900
250330,202109,105,89,16,97900,17600,115500
250340,202109,28,24,4,26400,4400,30800
250350,202109,190,123,67,135300,73700,209000
250355,202109,31,23,8,25300,8800,34100
250360,202109,196,162,34,178200,37400,215600
250370,202109,2373,1538,835,1692900,920700,2613600
250375,202109,14,8,6,8800,6600,15400
250380,202109,55,44,11,48400,12100,60500
250390,202109,47,37,10,40700,11000,51700
250400,202109,16500,8296,8204,9134381.02,9029900,18164281.02
250403,202109,322,253,69,278300,75900,354200
250407,202109,62,50,12,55000,13200,68200
250410,202109,29,25,4,27500,4400,31900
250415,202109,42,28,14,30800,15400,46200
250420,202109,42,36,6,39600,6600,46200
250430,202109,1429,1229,200,1353275,220000,1573275
250435,202109,22,15,7,16500,7700,24200
250440,202109,679,564,115,620400,126500,746900
250450,202109,83,63,20,69300,22000,91300
250460,202109,472,312,160,343200,177100,520300
250470,202109,97,67,30,73700,33000,106700
250480,202109,329,263,66,289300,73700,363000
250485,202109,4,4,0,4400,0,4400
250490,202109,235,191,44,210100,48400,258500
250500,202109,95,73,22,80300,24200,104500
250510,202109,787,617,170,678700,187000,865700
250520,202109,172,114,58,125400,63800,189200
250523,202109,124,100,24,110000,26400,136400
250527,202109,112,87,25,95700,27500,123200
250530,202109,7,4,3,4400,3300,7700
250535,202109,30,22,8,24200,8800,33000
250540,202109,141,112,29,123200,31900,155100
250550,202109,70,65,5,71500,5500,77000
250560,202109,56,35,21,38500,23100,61600
250570,202109,158,127,31,139700,34100,173800
250580,202109,98,75,23,82571,25300,107871
250590,202109,23,13,10,14300,11000,25300
250600,202109,1477,969,508,1065900.7,559900,1625800.7
250610,202109,161,133,28,146300,30800,177100
250620,202109,21,17,4,18700,4400,23100
250625,202109,69,52,17,57200,18700,75900
250630,202109,3116,1985,1131,2185700.62,1244100,3429800.62
250640,202109,195,156,39,172700,42900,215600
250650,202109,26,18,8,19800,8800,28600
250660,202109,58,42,16,46200,17600,63800
250670,202109,63,47,16,51700,18700,70400
250680,202109,417,335,82,368500,90200,458700
250690,202109,2116,1462,654,1608200.7,719400,2327600.7
250700,202109,924,790,134,869000,147400,1016400
250710,202109,441,346,95,380600,104500,485100
250720,202109,117,85,32,93500,35200,128700
250730,202109,417,347,70,381700,77000,458700
250740,202109,61,59,2,64900,2200,67100
250750,202109,23154,13803,9351,15197481.41,10299300,25496781.41
250760,202109,106,84,22,92400,25300,117700
250770,202109,361,237,124,260700,138600,399300
250780,202109,69,46,23,50600,25300,75900
250790,202109,456,289,167,317900,183700,501600
250800,202109,151,135,16,148500,17600,166100
250810,202109,77,62,15,68200,16500,84700
250820,202109,145,122,23,134200,25300,159500
250830,202109,439,287,152,315700,167200,482900
250840,202109,54,48,6,52800,6600,59400
250850,202109,58,49,9,53900,9900,63800
250855,202109,16,14,2,15400,2200,17600
250860,202109,239,155,84,170500,92400,262900
250870,202109,29,26,3,28600,3300,31900
250880,202109,87,63,24,69300,26400,95700
250890,202109,3010,2240,770,2465100,847000,3312100
250900,202109,57,47,10,51700,11000,62700
250905,202109,123,95,28,104500,30800,135300
250910,202109,1057,778,279,858000,306900,1164900
250915,202109,105,73,32,80300,35200,115500
250920,202109,137,99,38,108900,41800,150700
250930,202109,180,106,74,116600,81400,198000
250933,202109,7,5,2,5500,2200,7700
250937,202109,14,14,0,15400,0,15400
250939,202109,31,26,5,28600,5500,34100
250940,202109,116,85,31,93500,34100,127600
250950,202109,73,50,23,55000,25300,80300
250960,202109,90,49,41,53900,45100,99000
250970,202109,1233,871,362,959200,398200,1357400
250980,202109,105,70,35,77000,38500,115500
250990,202109,170,131,39,144100,42900,187000
251000,202109,78,67,11,73700,12100,85800
251010,202109,119,90,29,99000,31900,130900
251020,202109,72,58,14,63800,15400,79200
251030,202109,46,35,11,38500,12100,50600
251040,202109,54,36,18,39600,19800,59400
251050,202109,23,20,3,22000,3300,25300
251060,202109,49,40,9,44000,9900,53900
251065,202109,7,4,3,4400,3300,7700
251070,202109,17,13,4,14300,4400,18700
251080,202109,5157,2434,2723,2677400,2995300.1,5672700.1
251090,202109,186,156,30,171600,33000,204600
251100,202109,20,20,0,22000,0,22000
251110,202109,49,35,14,40700,15400,56100
251120,202109,1895,1164,731,1280400,804100,2084500
251130,202109,416,343,73,377300,80300,457600
251140,202109,573,370,203,407000,223300,630300
251150,202109,347,289,58,317900,63800,381700
251160,202109,95,77,18,84700,19800,104500
251170,202109,97,77,20,84700,22000,106700
251180,202109,286,171,115,188100,126500,314600
251190,202109,195,126,69,138600,75900,214500
251200,202109,275,219,56,240900,61600,302500
251203,202109,34,31,3,34100,3300,37400
251207,202109,85,71,14,78100,15400,93500
251210,202109,1491,1092,399,1201200,438900,1640100
251220,202109,45,36,9,39600,11000,50600
251230,202109,581,483,98,531300,107800,639100
251240,202109,103,73,30,80300,33000,113300
251250,202109,1443,1036,407,1141709.8,447700,1589409.8
251260,202109,12,8,4,8800,4400,13200
251270,202109,304,238,66,261800,72600,334400
251272,202109,65,58,7,63800,7700,71500
251274,202109,28,22,6,24200,6600,30800
251275,202109,35,20,15,22000,16500,38500
251276,202109,21,17,4,18700,4400,23100
251278,202109,10,8,2,8800,2200,11000
251280,202109,99,94,5,103400,5500,108900
251290,202109,930,666,264,732600,290400,1023000
251300,202109,16,12,4,13200,4400,17600
251310,202109,295,216,79,237600,86900,324500
251315,202109,38,34,4,37400,4400,41800
251320,202109,67,51,16,56100,17600,73700
251330,202109,80,72,8,79200,8800,88000
251335,202109,20,9,11,9900,12100,22000
251340,202109,760,444,316,490600,347600,838200
251350,202109,35,34,1,37400,1100,38500
251360,202109,85,73,12,80300,13200,93500
251365,202109,9,9,0,9900,0,9900
251370,202109,5660,3829,1831,4215200.32,2016300,6231500.32
251380,202109,46,36,10,39600,11000,50600
251385,202109,2,2,0,2200,0,2200
251390,202109,883,659,224,724900,248600,973500
251392,202109,25,15,10,16500,11000,27500
251394,202109,9,9,0,9900,0,9900
251396,202109,14,10,4,11000,4400,15400
251398,202109,15,13,2,14300,2200,16500
251400,202109,47,37,10,40700,11000,51700
251410,202109,40,34,6,37400,6600,44000
251420,202109,104,76,28,83600,30800,114400
251430,202109,46,42,4,46200,4400,50600
251440,202109,47,25,22,27500,24200,51700
251445,202109,57,50,7,55000,7700,62700
251450,202109,396,343,53,377300,58300,435600
251455,202109,6,5,1,5500,1100,6600
251460,202109,18,16,2,17600,2200,19800
251465,202109,7,5,2,5500,2200,7700
251470,202109,51,39,12,42900,13200,56100
251480,202109,27,22,5,24200,5500,29700
251490,202109,114,71,43,78100,47300,125400
251500,202109,123,101,22,111100,24200,135300
251510,202109,74,48,26,52800,28600,81400
251520,202109,31,28,3,30800,3300,34100
251530,202109,4350,3084,1266,3394600,1392600,4787200
251540,202109,83,67,16,73700,17600,91300
251550,202109,409,309,100,339900,110000,449900
251560,202109,25,17,8,18700,8800,27500
251570,202109,18,16,2,17600,2200,19800
251580,202109,135,108,27,118800,29700,148500
251590,202109,110,77,33,84907.9,36300,121207.9
251593,202109,25,16,9,17600,9900,27500
251597,202109,103,81,22,89100,24200,113300
251600,202109,1098,768,330,844800.65,363000,1207800.65
251610,202109,237,177,60,194700,67100,261800
251615,202109,12,11,1,12100,1100,13200
251620,202109,4195,2717,1478,2989800,1628000,4617800
251630,202109,465,345,120,379500,132000,511500
251640,202109,132,99,33,108900,36300,145200
251650,202109,286,213,73,234300,80300,314600
251660,202109,197,174,23,191400,25300,216700
251670,202109,385,297,88,326700,96800,423500
251675,202109,8,6,2,6600,2200,8800
251680,202109,104,89,15,97900,16500,114400
251690,202109,325,268,57,294800,62700,357500
251700,202109,284,245,39,269500,42900,312400
251710,202109,21,13,8,14300,8800,23100
251720,202109,21,13,8,14300,8800,23100
251740,202109,12,9,3,9900,3300,13200
260005,202109,3396,1806,1590,1986132,1750100,3736232
260010,202109,1619,1188,431,1306800.58,475200,1782000.58
260020,202109,416,358,58,393800,63800,457600
260030,202109,601,410,191,451000,210100,661100
260040,202109,807,492,315,543400,346500,889900
260050,202109,1163,830,333,914100,366300,1280400
260060,202109,377,344,33,378400,36300,414700
260070,202109,1325,807,518,889900,572000,1461900
260080,202109,713,543,170,599500,189200,788700
260090,202109,509,328,181,360800,199100,559900
260100,202109,213,148,65,163900,71500,235400
260105,202109,252,140,112,154000,125400,279400
260110,202109,2921,2139,782,2354000,864600,3218600
260120,202109,2698,1455,1243,1602992.6,1368400,2971392.6
260130,202109,178,120,58,132000,63800,195800
260140,202109,2172,1424,748,1566400,823900,2390300
260150,202109,198,127,71,139700,78100,217800
260160,202109,336,277,59,304700,64900,369600
260170,202109,3326,1996,1330,2198900,1464100,3663000
260180,202109,167,133,34,146300,37400,183700
260190,202109,2351,1566,785,1723700,863500,2587200
260200,202109,984,777,207,854700.63,227700,1082400.63
260210,202109,1405,995,410,1096700,451000,1547700
260220,202109,658,593,65,652300,71500,723800
260230,202109,1229,910,319,1001000,352000,1353000
260240,202109,210,160,50,176000,55000,231000
260250,202109,84,62,22,68200,24200,92400
260260,202109,1054,730,324,803000,356400,1159400
260270,202109,260,191,69,210100,75900,286000
260280,202109,1165,931,234,1024100,257400,1281500
260290,202109,6686,3626,3060,3989700.65,3369300.59,7359001.24
260300,202109,976,831,145,914100,159500,1073600
260310,202109,522,414,108,455400,119900,575300
260320,202109,843,612,231,673200,254100.5,927300.5
260330,202109,68,48,20,52800,22000,74800
260340,202109,76,57,19,62700,20900,83600
260345,202109,5560,2950,2610,3246100,2872100,6118200
260350,202109,488,343,145,377300,159500,536800
260360,202109,237,128,109,140800,119900,260700
260370,202109,746,471,275,519200,303600,822800
260380,202109,568,414,154,455400,170500.6,625900.6
260390,202109,289,244,45,269500,49500,319000
260392,202109,111,96,15,105600,16500,122100
260400,202109,4272,2436,1836,2679600.5,2019600,4699200.5
260410,202109,14780,7733,7047,8511800.63,7757200,16269000.63
260415,202109,142,121,21,133100,23100,156200
260420,202109,1718,1044,674,1149500,741400,1890900
260430,202109,175,159,16,174900.48,17600,192500.48
260440,202109,188,134,54,147400,59400,206800
260450,202109,426,316,110,347600.63,121000,468600.63
260460,202109,823,434,389,477400,430100,907500
260470,202109,337,205,132,225500,145200,370700
260480,202109,249,157,92,173800,101200,275000
260490,202109,220,173,47,190300,51700,242000
260500,202109,1118,755,363,830500,400400,1230900
260510,202109,782,617,165,678700,181500,860200
260515,202109,232,209,23,229900,25300,255200
260520,202109,3252,2010,1242,2213200,1368400,3581600
260530,202109,795,648,147,713900,161700,875600
260540,202109,525,412,113,453200,124300,577500
260545,202109,15,12,3,13200,3300,16500
260550,202109,328,208,120,229900,132000,361900
260560,202109,506,382,124,420200,136400,556600
260570,202109,994,793,201,873400,221100,1094500
260580,202109,254,218,36,239800,39600,279400
260590,202109,625,356,269,391600,295900,687500
260600,202109,7664,4409,3255,4855402.21,3587100,8442502.21
260610,202109,488,329,159,361900,174900,536800
260620,202109,3626,1867,1759,2054800.8,1939300.19,3994100.99
260630,202109,81,75,6,82500,6600,89100
260640,202109,3378,1929,1449,2121900,1595000,3716900
260650,202109,318,231,87,255200,95700,350900
260660,202109,556,351,205,386100,225500,611600
260670,202109,99,72,27,79200,29700,108900
260680,202109,3882,2129,1753,2345200,1929400,4274600
260690,202109,125,93,32,102300,35200,137500
260700,202109,307,203,104,223300,114400,337700
260710,202109,42,33,9,36300,9900,46200
260720,202109,2633,1540,1093,1695100,1202300,2897400
260730,202109,736,544,192,598400,211200,809600
260740,202109,71,59,12,64900,13200,78100
260750,202109,566,409,157,449900,172700,622600
260760,202109,690,340,350,375100.3,385000,760100.3
260765,202109,970,497,473,546700,521400,1068100
260770,202109,222,163,59,179281,64900,244181
260775,202109,782,423,359,466400,394900,861300
260780,202109,230,142,88,156200,97900,254100
260790,202109,14785,7388,7397,8127900.75,8142200,16270100.75
260795,202109,162,105,57,115500,62700,178200
260800,202109,285,235,50,259600,55000,314600
260805,202109,171,112,59,124300,64900,189200
260810,202109,789,652,137,717200,150700,867900
260820,202109,289,185,104,203500,114400,317900
260825,202109,211,142,69,157300,77000,234300
260830,202109,309,182,127,200200,140800,341000
260840,202109,251,182,69,200200,75900,276100
260845,202109,170,110,60,121000,66000,187000
260850,202109,409,305,104,335500,114400,449900
260860,202109,253,193,60,213400,66000,279400
260870,202109,349,267,82,293700,90200,383900
260875,202109,732,530,202,585200,222200,807400
260880,202109,1547,1024,523,1126400,575300,1701700
260890,202109,2339,1618,721,1782000,793100,2575100
260900,202109,983,701,282,771100,310200,1081300
260910,202109,249,196,53,215600,58300,273900
260915,202109,284,212,72,233200,79200,312400
260920,202109,195,101,94,111100,103400,214500
260930,202109,375,319,56,352000,61600,413600
260940,202109,2604,1382,1222,1521300,1344200,2865500
260950,202109,2009,1139,870,1252900,959200,2212100
260960,202109,13575,6686,6889,7359000.9,7582300.5,14941301.4
260970,202109,418,342,76,377300,83600,460900
260980,202109,201,181,20,199100,22000,221100
260990,202109,2641,2126,515,2338600,566500,2905100
261000,202109,4214,2567,1647,2825900,1813900,4639800
261010,202109,159,111,48,122100,52800,174900
261020,202109,590,441,149,485100.47,163900,649000.47
261030,202109,261,188,73,206800,80300,287100
261040,202109,377,325,52,357500,57200,414700
261050,202109,504,429,75,473000,82500,555500
261060,202109,1402,867,535,953700,588500,1542200
261070,202109,9007,4331,4676,4768500,5146900.5,9915400.5
261080,202109,370,282,88,310200,97900,408100
261090,202109,2114,1620,494,1783102.03,543400,2326502.03
261100,202109,1191,834,357,917400,392700,1310100
261110,202109,8908,5483,3425,6035700,3767500,9803200
261120,202109,243,208,35,228800,38500,267300
261130,202109,563,337,226,370700,248600,619300
261140,202109,212,133,79,147400,86900,234300
261150,202109,679,432,247,475200.56,271700,746900.56
261153,202109,71,66,5,72600,5500,78100
261160,202109,74341,36467,37874,40131391.7,41697701.55,81829093.25
261170,202109,470,343,127,377300,139700,517000
261180,202109,1779,1103,676,1215751,743600,1959351
261190,202109,576,397,179,436700,196900,633600
261200,202109,218,180,38,198000,41800,239800
261210,202109,35,30,5,33000,5500,38500
261220,202109,2744,1932,812,2127400.66,894300,3021700.66
261230,202109,333,244,89,268400,97900,366300
261240,202109,439,385,54,423500,59400,482900
261245,202109,252,207,45,227700,49500,277200
261247,202109,165,129,36,141900,39600,181500
261250,202109,3361,1609,1752,1773200,1927200,3700400
261255,202109,246,220,26,242000,28600,270600
261260,202109,838,728,110,800800.12,121000,921800.12
261270,202109,203,141,62,155100,68200,223300
261280,202109,184,150,34,165000,37400,202400
261290,202109,115,85,30,93500,33000,126500
261300,202109,1339,990,349,1090100,385000,1475100
261310,202109,779,520,259,572000,284900,856900
261320,202109,559,376,183,414700,201300,616000
261330,202109,920,712,208,783200,228800.63,1012000.63
261340,202109,307,168,139,184800,152900,337700
261350,202109,858,599,259,660000,284900,944900
261360,202109,1342,868,474,954800,522500,1477300
261370,202109,4809,2833,1976,3117400,2174700,5292100
261380,202109,537,411,126,452100.78,138600,590700.78
261390,202109,3623,2431,1192,2675200,1311200,3986400
261400,202109,278,250,28,275000,30800,305800
261410,202109,1110,727,383,799700,421300,1221000
261420,202109,929,578,351,635800.32,386100,1021900.32
261430,202109,312,284,28,313500,30800,344300
261440,202109,113,105,8,115500,8800,124300
261450,202109,2495,1983,512,2183500,565400,2748900
261460,202109,750,586,164,644600,180400,825000
261470,202109,231,188,43,207900,47300,255200
261480,202109,449,344,105,380600,115450.5,496050.5
261485,202109,359,214,145,235400,159500,394900
261500,202109,606,407,199,448800.59,218900,667700.59
261510,202109,53,34,19,37400,20900,58300
261520,202109,88,74,14,81400,15400,96800
261530,202109,4101,2599,1502,2860000.09,1653300,4513300.09
261540,202109,1407,822,585,906400,644600,1551000
261550,202109,259,123,136,135300,149600,284900
261560,202109,882,579,303,636900,334400,971300
261570,202109,392,308,84,338800,92400,431200
261580,202109,388,307,81,337700,89100,426800
261590,202109,191,155,36,170500,39600,210100
261600,202109,286,226,60,250800,66000,316800
261610,202109,82,72,10,79200,11000,90200
261618,202109,75,57,18,62700,19800,82500
261620,202109,194,119,75,130900,82500,213400
261630,202109,671,533,138,586300,152900,739200
261640,202109,6445,3380,3065,3718001.05,3378100,7096101.05
261650,202109,481,306,175,336600,192500,529100
270010,202109,505,447,58,492800,63800,556600
270020,202109,246,200,46,220000,50600,270600
270030,202109,8768,5636,3132,6201140.59,3447351,9648491.59
270040,202109,2067,1331,736,1464100,810700,2274800
270050,202109,191,149,42,165000,46200,211200
270060,202109,76,50,26,55000,28600,83600
270070,202109,846,618,228,679800,250800,930600
270080,202109,37,30,7,33000,7700,40700
270090,202109,23,16,7,17600,7700,25300
270100,202109,1316,898,418,987800,460900,1448700
270110,202109,77,66,11,72600,12100,84700
270120,202109,227,185,42,203500,46200,249700
270130,202109,313,230,83,253000,91300,344300
270135,202109,116,78,38,85800,41800,127600
270140,202109,1371,890,481,980100,529100,1509200
270150,202109,260,201,59,221100,64900,286000
270160,202109,492,391,101,430100,111100,541200
270170,202109,796,523,273,575300,300300,875600
270180,202109,55,43,12,47300,13200,60500
270190,202109,114,96,18,105600,19800,125400
270200,202109,111,98,13,107800,14300,122100
270210,202109,534,322,212,354200,233200,587400
270220,202109,185,139,46,152900,50600,203500
270230,202109,2143,1330,813,1463000,894300,2357300
270235,202109,672,524,148,576400,162800,739200
270240,202109,2971,2355,616,2591601.25,677600,3269201.25
270250,202109,127,93,34,102300,37400,139700
270255,202109,213,183,30,201300,33000,234300
270260,202109,369,301,68,332200,74800,407000
270270,202109,94,47,47,52800,51700,104500
270280,202109,226,131,95,144100,104500,248600
270290,202109,1124,876,248,964700,273900,1238600
270300,202109,340,246,94,270600,103400,374000
270310,202109,814,680,134,748000,147400,895400
270320,202109,804,692,112,761200.63,123200,884400.63
270330,202109,304,255,49,280500,53900,334400
270340,202109,57,45,12,49500,13200,62700
270350,202109,91,52,39,57200,42900,100100
270360,202109,65,37,28,40700,30800,71500
270370,202109,58,46,12,50600,13200,63800
270375,202109,75,44,31,48400,34100,82500
270380,202109,1057,697,360,767800,396000,1163800
270390,202109,155,88,67,96800,73700,170500
270400,202109,731,551,180,606100.2,198000,804100.2
270410,202109,633,466,167,512600,183700,696300
270420,202109,403,278,125,305800,137500,443300
270430,202109,33723,24250,9473,26701748.44,10428000,37129748.44
270440,202109,483,380,103,419100,113300,532400
270450,202109,829,486,343,534600,378400,913000
270460,202109,181,142,39,156200,42900,199100
270470,202109,1537,1064,473,1171500,520300,1691800
270480,202109,528,431,97,474100,106700,580800
270490,202109,20,15,5,16500,5500,22000
270500,202109,486,408,78,449900,85800,535700
270510,202109,845,537,308,592900,339900,932800
270520,202109,275,179,96,196900,105600,302500
270530,202109,59,51,8,56100,8800,64900
270540,202109,94,72,22,79200,24200,103400
270550,202109,1684,1294,390,1425600,431200,1856800
270560,202109,260,151,109,166100,119900,286000
270570,202109,528,372,156,410300,172700,583000
270580,202109,82,66,16,72600,17600,90200
270590,202109,60,47,13,51700,14300,66000
270600,202109,160,135,25,148500,27500,176000
270610,202109,235,184,51,202400,56100,258500
270620,202109,13,13,0,14300,0,14300
270630,202109,3710,2830,880,3114210,969100,4083310
270640,202109,863,647,216,712800.44,237600,950400.44
270642,202109,209,175,34,192500,37400,229900
270644,202109,248,166,82,182600,90200,272800
270650,202109,335,201,134,221100,147400,368500
270660,202109,201,174,27,191400,29700,221100
270670,202109,2969,2265,704,2491611.01,775500,3267111.01
270680,202109,414,256,158,281600,173800,455400
270690,202109,1210,807,403,888800,443300,1332100
270700,202109,25,20,5,22000,5500,27500
270710,202109,868,683,185,751300,203500,954800
270720,202109,232,183,49,202400,53900,256300
270730,202109,1890,1177,713,1295800,785400,2081200
270740,202109,38,25,13,27500,14300,41800
270750,202109,639,487,152,536800,167200,704000
270760,202109,302,217,85,238700,93500,332200
270770,202109,2758,1860,898,2046000,990000,3036000
270780,202109,65,42,23,46200,25300,71500
270790,202109,243,156,87,171600,95700,267300
270800,202109,2041,1627,414,1790800.35,455400,2246200.35
270810,202109,217,179,38,196900,41800,238700
270820,202109,130,92,38,101200,41800,143000
270830,202109,803,607,196,669900,215600,885500
270840,202109,1354,1042,312,1146200.4,344300,1490500.4
270850,202109,1505,962,543,1059300,598400,1657700
270860,202109,2538,1702,836,1872787.36,919600,2792387.36
270870,202109,116,65,51,71500,56100,127600
270880,202109,867,687,180,755700,199100,954800
270890,202109,273,207,66,227700,72600,300300
270895,202109,54,51,3,56100,3300,59400
270900,202109,68,57,11,62700,13200,75900
270910,202109,299,248,51,272800,56100,328900
270915,202109,1907,1249,658,1375000,723800,2098800
270920,202109,444,370,74,408100,81400,489500
270930,202109,5856,4456,1400,4902700,1540000.14,6442700.14
270940,202109,2218,1749,469,1923900,515900,2439800
280010,202109,38,32,6,35200,6600,41800
280020,202109,485,416,69,457600,77000,534600
280030,202109,20899,13534,7365,14895016.02,8104801.56,22999817.58
280040,202109,328,211,117,232100,128700,360800
280050,202109,417,321,96,353100,105600,458700
280060,202109,345,228,117,250800,128700,379500
280067,202109,1101,794,307,873400,337700.5,1211100.5
280070,202109,128,105,23,115500,25300,140800
280100,202109,646,499,147,548900.55,162800,711700.55
280110,202109,72,66,6,72600,6600,79200
280120,202109,662,552,110,607200,121000,728200
280130,202109,1742,1144,598,1259500,658900,1918400
280140,202109,490,408,82,449900,90200,540100
280150,202109,411,287,124,315700,136400,452100
280160,202109,130,105,25,115500,27500,143000
280170,202109,411,283,128,311300,140800,452100
280190,202109,28,23,5,25300,5500,30800
280200,202109,34,28,6,30800,6600,37400
280210,202109,2922,2110,812,2324300.5,893200,3217500.5
280220,202109,46,37,9,40700,9900,50600
280230,202109,328,268,60,294800,66000,360800
280240,202109,130,122,8,134200,8800,143000
280250,202109,20,11,9,13200,9900,23100
280260,202109,78,71,7,78100,7700,85800
280270,202109,143,110,33,121000,36300,157300
280280,202109,190,124,66,136400.5,72600,209000.5
280290,202109,3462,2508,954,2758729.5,1050500,3809229.5
280300,202109,1606,1269,337,1397000,370700,1767700
280310,202109,99,94,5,103400,5500,108900
280320,202109,650,455,195,500500,214500,715000
280330,202109,318,235,83,259600,91300,350900
280340,202109,435,350,85,385000,93500,478500
280350,202109,3734,2878,856,3165800.66,941600.08,4107400.74
280360,202109,475,323,152,356400,167200,523600
280370,202109,97,85,12,93500,13200,106700
280380,202109,49,37,12,40700,13200,53900
280390,202109,174,146,28,160600,30800,191400
280400,202109,366,248,118,272800,129800,402600
280410,202109,286,238,48,262900,52800,315700
280420,202109,141,121,20,134200,22000,156200
280430,202109,75,61,14,67100,15400,82500
280440,202109,732,586,146,644600,160600,805200
280445,202109,121,113,8,124300,8800,133100
280450,202109,1248,1075,173,1186900,190300,1377200
280460,202109,646,470,176,518100.93,193600,711700.93
280470,202109,113,102,11,112200,12100,124300
280480,202109,2828,1938,890,2134001.67,979000.5,3113002.17
280490,202109,205,195,10,214500.96,11000,225500.96
280500,202109,44,40,4,44000,4400,48400
280510,202109,130,104,26,114400,28600,143000
280520,202109,52,38,14,41800,15400,57200
280530,202109,81,52,29,57200,31900,89100
280540,202109,536,456,80,501600,88000,589600
280550,202109,730,673,57,740300.65,63800,804100.65
280560,202109,488,434,54,477400,59400,536800
280570,202109,2314,1829,485,2014100,534600,2548700
280580,202109,582,451,131,496100,144100,640200
280590,202109,217,139,78,152900,85800,238700
280600,202109,391,325,66,357551.7,72600,430151.7
280610,202109,111,81,30,89100,33000,122100
280620,202109,537,438,99,481800.6,108900,590700.6
280630,202109,152,127,25,140800,27500,168300
280640,202109,188,151,37,167200,40700,207900
280650,202109,89,57,32,62700,35200,97900
280660,202109,140,102,38,112200,41800,154000
280670,202109,1924,1210,714,1331000,786500.48,2117500.48
280680,202109,222,192,30,212300,33000,245300
280690,202109,86,73,13,80300,14300,94600
280700,202109,18,18,0,19800,0,19800
280710,202109,1487,1152,335,1267200.88,368500,1635700.88
280720,202109,121,80,41,88000,45100,133100
280730,202109,26,22,4,24200,4400,28600
280740,202109,2540,1898,642,2087800,706200,2794000
280750,202109,226,197,29,216700,31900,248600
280760,202109,831,565,266,623700,292600,916300
290010,202109,194,137,57,150700,62700,213400
290020,202109,192,174,18,191400,19800,211200
290030,202109,617,395,222,435600,244200,679800
290035,202109,134,110,24,121000,26400,147400
290040,202109,303,204,99,225500,108900,334400
290050,202109,85,68,17,74800,18700,93500
290060,202109,256,114,142,125400,156200,281600
290070,202109,5742,2736,3006,3014000.69,3309900,6323900.69
290080,202109,443,195,248,214500,272800,487300
290090,202109,367,164,203,180400,223300,403700
290100,202109,1661,1074,587,1185800,646800,1832600
290110,202109,841,492,349,541200.85,383900,925100.85
290115,202109,191,176,15,193600,16500,210100
290120,202109,779,520,259,573100,284900,858000
290130,202109,446,273,173,300300,190300,490600
290135,202109,299,230,69,253000,75900,328900
290140,202109,322,266,56,292600,61600,354200
290150,202109,132,90,42,99000,46200,145200
290160,202109,244,186,58,204600,63800,268400
290170,202109,95,66,29,72600,31900,104500
290180,202109,187,135,52,148500,57200,205700
290190,202109,370,294,76,323400,83600,407000
290195,202109,312,202,110,222200,121000,343200
290200,202109,265,218,47,239800,51700,291500
290205,202109,145,93,52,102300,57200,159500
290210,202109,1189,877,312,965800,343200,1309000
290220,202109,187,106,81,116600,89100,205700
290225,202109,288,117,171,128700,188100,316800
290230,202109,80,49,31,53900,34100,88000
290240,202109,359,123,236,135300,259600,394900
290250,202109,251,234,17,257400,18700,276100
290260,202109,323,264,59,290400,64900,355300
290265,202109,185,163,22,179300,24200,203500
290270,202109,1415,1180,235,1298000,259600.74,1557600.74
290280,202109,478,337,141,370700,155100,525800
290290,202109,1361,816,545,897600.5,600600,1498200.5
290300,202109,412,352,60,387200,66000,453200
290310,202109,289,137,152,150700,167200,317900
290320,202109,4100,2517,1583,2770900.22,1744600,4515500.22
290323,202109,190,165,25,182600,27500,210100
290327,202109,159,124,35,136400,38500,174900
290330,202109,122,60,62,66000,68200,134200
290340,202109,787,322,465,354200,512600,866800
290350,202109,667,410,257,451000,282700,733700
290360,202109,322,246,76,271700.99,83600,355300.99
290370,202109,918,404,514,445500,565400,1010900
290380,202109,328,212,116,233200,127600,360800
290390,202109,2407,1500,907,1650000,997700,2647700
290395,202109,238,136,102,150700,112200,262900
290400,202109,276,201,75,221100,82500,303600
290405,202109,245,212,33,233200,36300,269500
290410,202109,621,517,104,568700,114400,683100
290420,202109,261,212,49,234300,53900,288200
290430,202109,465,295,170,324500,187000,511500
290440,202109,78,70,8,77000,8800,85800
290450,202109,185,138,47,151800,51700,203500
290460,202109,1934,1154,780,1272700,858000,2130700
290470,202109,1355,592,763,652300,839300,1491600
290475,202109,555,521,34,573100.27,37400,610500.27
290480,202109,274,159,115,174900,126500,301400
290485,202109,241,220,21,242000,23100,265100
290490,202109,1260,898,362,987800,398200,1386000
290500,202109,748,389,359,427900,394900,822800
290510,202109,205,164,41,180400,45100,225500
290515,202109,161,97,64,106700,70400,177100
290520,202109,1396,911,485,1002100,533500.2,1535600.2
290530,202109,294,267,27,293700,29700,323400
290540,202109,112,58,54,63800,59400,123200
290550,202109,165,141,24,155100,27500,182600
290560,202109,3168,1379,1789,1516900,1969000,3485900
290570,202109,6300,3047,3253,3351700,3583800,6935500
290580,202109,1273,761,512,838200,564300,1402500
290590,202109,571,466,105,512600,115500,628100
290600,202109,1754,1206,548,1327700,602800,1930500
290610,202109,185,170,15,187000,16500,203500
290620,202109,365,329,36,361900,39600,401500
290630,202109,1979,850,1129,936100,1241900,2178000
290640,202109,139,112,27,124300,29700,154000
290650,202109,1804,841,963,925100.92,1062600,1987700.92
290660,202109,270,221,49,243100,53900,297000
290670,202109,944,484,460,532400,506000,1038400
290680,202109,1230,988,242,1087900,266200,1354100
290682,202109,318,237,81,261800.48,89100,350900.48
290685,202109,247,156,91,171600,100100,271700
290687,202109,1094,708,386,780079,424600,1204679
290689,202109,148,77,71,84700,78100,162800
290690,202109,595,255,340,280500,375100,655600
290700,202109,239,118,121,129800,133100,262900
290710,202109,763,516,247,567600,271700,839300
290720,202109,1032,831,201,914100,221100,1135200
290730,202109,1199,694,505,763400,555500,1318900
290740,202109,21,17,4,18700,4400,23100
290750,202109,1422,614,808,675400,888800,1564200
290755,202109,71,63,8,69300,8800,78100
290760,202109,261,229,32,251900,35200,287100
290770,202109,186,176,10,193600,11000,204600
290780,202109,1119,874,245,961400,269500,1230900
290790,202109,378,257,121,282700,133100,415800
290800,202109,2431,979,1452,1078000,1598300,2676300
290810,202109,479,327,152,359700,168300,528000
290820,202109,408,238,170,262900,187000,449900
290830,202109,422,301,121,331100,133100,464200
290840,202109,1803,1124,679,1236400,746900,1983300
290850,202109,898,460,438,507100,482900,990000
290860,202109,636,285,351,313500,387200,700700
290870,202109,614,434,180,478500,199100,677600
290880,202109,119,64,55,70400,61600,132000
290890,202109,426,268,158,294800,173800,468600
290900,202109,167,125,42,137500,46200,183700
290910,202109,387,295,92,324500,101200,425700
290920,202109,208,183,25,201300,27500,228800
290930,202109,515,398,117,437800,128700,566500
290940,202109,234,196,38,215600,41800,257400
290950,202109,160,94,66,103400,72600,176000
290960,202109,472,329,143,361900,157300,519200
290970,202109,242,212,30,233200,33000,266200
290980,202109,1717,1189,528,1310100,581900,1892000
290990,202109,404,338,66,372900,72600,445500
291000,202109,866,272,594,299200,654500,953700
291005,202109,2413,1037,1376,1141800,1513600.42,2655400.42
291010,202109,166,148,18,162800,19800,182600
291020,202109,98,78,20,85800,22000,107800
291030,202109,94,67,27,74800,29700,104500
291040,202109,626,355,271,391600,298100,689700
291050,202109,1478,801,677,882200,745800,1628000
291060,202109,1644,913,731,1004300,804100,1808400
291070,202109,1958,1465,493,1612600.93,543401.3,2156002.23
291072,202109,7105,2638,4467,2905100,4919200,7824300
291075,202109,240,193,47,212300,51700,264000
291077,202109,59,40,19,44000,20900,64900
291080,202109,20509,8855,11654,9746000.75,12834800,22580800.75
291085,202109,269,224,45,247500,49500,297000
291090,202109,278,115,163,126500,179300,305800
291100,202109,1005,331,674,364100,742500,1106600
291110,202109,423,325,98,357500,107800,465300
291120,202109,2414,1241,1173,1365100,1290300,2655400
291125,202109,60,31,29,34100,31900,66000
291130,202109,193,170,23,188100,25300,213400
291140,202109,125,104,21,114400,23100,137500
291150,202109,382,146,236,160600,259600,420200
291160,202109,379,306,73,336600,80300,416900
291165,202109,49,38,11,41800,12100,53900
291170,202109,3199,1593,1606,1752300.8,1768800,3521100.8
291180,202109,1237,500,737,550000,811800,1361800
291185,202109,105,99,6,108900,6600,115500
291190,202109,1384,654,730,720500,803000,1523500
291200,202109,173,127,46,140800,50600,191400
291210,202109,2339,935,1404,1028500,1546600,2575100
291220,202109,286,219,67,240900,73700,314600
291230,202109,962,332,630,365200,693000,1058200
291240,202109,418,389,29,427900,31900,459800
291250,202109,433,349,84,383900,92400,476300
291260,202109,58,50,8,55000,8800,63800
291270,202109,1037,454,583,499400,641300,1140700
291280,202109,353,169,184,185900,202400,388300
291290,202109,1694,887,807,976800,887700,1864500
291300,202109,227,180,47,198000,51700,249700
291310,202109,227,202,25,222200,27500,249700
291320,202109,1334,938,396,1031800,435600,1467400
291330,202109,136,116,20,127600,22000,149600
291340,202109,219,131,88,144100,96800,240900
291345,202109,125,87,38,95700,41800,137500
291350,202109,1711,624,1087,687500,1195700,1883200
291360,202109,8331,3972,4359,4373600,4796000,9169600
291370,202109,1107,640,467,704000,514800,1218800
291380,202109,259,206,53,226600,58300,284900
291390,202109,3956,1758,2198,1933800,2417800,4351600
291400,202109,2078,1475,603,1623600,663301.27,2286901.27
291410,202109,189,161,28,177100,30800,207900
291420,202109,114,86,28,94600,30800,125400
291430,202109,166,96,70,105600,77000.5,182600.5
291440,202109,523,428,95,470800,105600,576400
291450,202109,935,609,326,669900,358600,1028500
291460,202109,1909,1531,378,1684100,416900,2101000
291465,202109,2221,1053,1168,1161600,1284800,2446400
291470,202109,2860,1437,1423,1581800.55,1566400,3148200.55
291480,202109,11766,5103,6663,5625401.62,7333700,12959101.62
291490,202109,622,251,371,277200,408100,685300
291500,202109,377,224,153,248600,168300,416900
291510,202109,1198,465,733,512600,807400,1320000
291520,202109,932,419,513,460900,564300,1025200
291530,202109,906,245,661,269500,729300,998800
291535,202109,119,98,21,107800,23100,130900
291540,202109,362,120,242,132000,266200,398200
291550,202109,1279,597,682,656700,751300,1408000
291560,202109,5123,2558,2565,2813800,2823700,5637500
291570,202109,215,109,106,119900,116600,236500
291580,202109,1198,740,458,814000,503800,1317800
291590,202109,101,43,58,47300,63800,111100
291600,202109,1139,563,576,619300,633600,1252900
291610,202109,1432,698,734,767800,807400,1575200
291620,202109,568,267,301,293700,331100,624800
291630,202109,479,150,329,165000,363000,528000
291640,202109,3976,1989,1987,2190100,2189000,4379100
291650,202109,436,300,136,330000.5,149600,479600.5
291660,202109,373,148,225,162800,247500,410300
291670,202109,179,112,67,124300,73700,198000
291680,202109,633,387,246,425700,271700,697400
291685,202109,575,326,249,358600,273900,632500
291690,202109,473,298,175,327800,192500.92,520300.92
291700,202109,1010,783,227,861300,250800,1112100
291710,202109,1584,773,811,850300,893200,1743500
291720,202109,420,288,132,316800,145200,462000
291730,202109,945,554,391,609400,431200,1040600
291733,202109,290,197,93,216700,103400,320100
291735,202109,74,56,18,61600,19800,81400
291740,202109,341,258,83,284900,91300,376200
291750,202109,2228,1456,772,1601600.25,852500,2454100.25
291760,202109,2988,1649,1339,1813900,1474000,3287900
291770,202109,751,515,236,566500,259600,826100
291780,202109,62,36,26,39600,28600,68200
291790,202109,154,79,75,86900,82500,169400
291800,202109,10104,4223,5881,4650800,6476800,11127600
291810,202109,1085,814,271,895400,298100,1193500
291820,202109,278,200,78,220000,85800,305800
291830,202109,1031,418,613,460900.59,675400,1136300.59
291835,202109,552,511,41,562100,45100,607200
291840,202109,5001,2499,2502,2753300.74,2755500,5508800.74
291845,202109,265,82,183,90200,201300,291500
291850,202109,316,281,35,309100,38500,347600
291855,202109,253,104,149,115500,163900,279400
291860,202109,164,102,62,112200,68200,180400
291870,202109,80,35,45,38500,49500,88000
291875,202109,164,153,11,168300,12100,180400
291880,202109,429,345,84,380600,92400,473000
291890,202109,239,81,158,89100,173800,262900
291900,202109,55,32,23,35200,25300,60500
291905,202109,114,87,27,96800,29700,126500
291910,202109,159,127,32,139700,35200,174900
291915,202109,435,387,48,425700,52800,478500
291920,202109,5254,2595,2659,2856700,2927100,5783800
291930,202109,163,98,65,107800.27,71500,179300.27
291940,202109,360,208,152,228800,167200,396000
291950,202109,1141,908,233,998800,258500,1257300
291955,202109,1311,799,512,878900,564300,1443200
291960,202109,199,148,51,162800,56100,218900
291970,202109,755,564,191,620400,210100,830500
291980,202109,1471,1286,185,1415700.73,203500,1619200.73
291990,202109,141,130,11,143000,12100,155100
291992,202109,172,90,82,99000,90200,189200
291995,202109,189,120,69,132000,77000,209000
292000,202109,401,301,100,332200,110000,442200
292010,202109,324,223,101,245300,111100,356400
292020,202109,305,223,82,246400,90200,336600
292030,202109,143,110,33,122100,36300,158400
292040,202109,602,308,294,338800,323400,662200
292045,202109,117,105,12,115500,13200,128700
292050,202109,932,671,261,740300,287100,1027400
292060,202109,885,723,162,795300,178200,973500
292070,202109,62,23,39,25300,42900,68200
292080,202109,145,101,44,111100,48400,159500
292090,202109,518,178,340,195800,374000,569800
292100,202109,1494,645,849,711700,933900,1645600
292105,202109,186,166,20,182600,22000,204600
292110,202109,2245,816,1429,897600,1574100,2471700
292120,202109,704,548,156,602800,171600,774400
292130,202109,452,253,199,278300,218900,497200
292140,202109,215,172,43,189200,47300,236500
292145,202109,158,84,74,92400,81400,173800
292150,202109,1495,1229,266,1351900,292600,1644500
292160,202109,162,132,30,145200,33000,178200
292170,202109,1176,1022,154,1125300,169400,1294700
292180,202109,230,170,60,187000,67100,254100
292190,202109,156,102,54,112200,59400,171600
292200,202109,1377,500,877,551100,964700,1515800
292205,202109,120,103,17,114400,18700,133100
292210,202109,376,260,116,286000,127600,413600
292220,202109,30,22,8,24200,8800,33000
292225,202109,43,36,7,39600,7700,47300
292230,202109,962,738,224,811800,246400,1058200
292240,202109,615,446,169,490600,185900,676500
292250,202109,1682,1097,585,1206700,644600,1851300
292260,202109,400,241,159,266200,174900,441100
292265,202109,247,182,65,201300,71500,272800
292270,202109,720,338,382,371800,420200,792000
292273,202109,207,118,89,129800,97900,227700
292275,202109,165,83,82,91300,90200,181500
292280,202109,143,101,42,111100,46200,157300
292285,202109,83,66,17,72600,18700,91300
292290,202109,583,393,190,432300,209000,641300
292300,202109,1727,648,1079,712800,1186900,1899700
292303,202109,123,78,45,85800,49500,135300
292305,202109,119,88,31,96800,34100,130900
292310,202109,953,619,334,680900,367400,1048300
292320,202109,585,439,146,484000,160600,644600
292330,202109,178,106,72,116600,80300,196900
292335,202109,287,227,60,249700,66000,315700
292340,202109,565,390,175,430100,192500,622600
292350,202109,268,147,121,161700,133100,294800
292360,202109,708,533,175,587400,192500,779900
292370,202109,736,561,175,619300,192500,811800
292380,202109,616,506,110,557700,121000,678700
292390,202109,393,161,232,177100,255200,432300
292400,202109,3602,2238,1364,2465100.31,1505900,3971000.31
292405,202109,274,183,91,201300,100100,301400
292410,202109,127,78,49,85800,53900,139700
292420,202109,288,249,39,275000,42900,317900
292430,202109,542,397,145,436700,159500,596200
292440,202109,630,530,100,584100.56,110000,694100.56
292450,202109,241,186,55,204600,60500,265100
292460,202109,537,401,136,442200,149600,591800
292465,202109,206,175,31,192500,34100,226600
292467,202109,143,88,55,96800,60500,157300
292470,202109,300,205,95,225500,104500,330000
292480,202109,395,267,128,293700,140800,434500
292490,202109,242,176,66,193600,72600,266200
292500,202109,870,400,470,440000.32,517000,957000.32
292510,202109,3514,1651,1863,1816100,2050400,3866500
292520,202109,1108,521,587,575300,646800,1222100
292525,202109,418,299,119,328900,130900,459800
292530,202109,4584,1820,2764,2003100.65,3040400,5043500.65
292540,202109,481,275,206,302500,226600,529100
292550,202109,1107,588,519,646800,570900,1217700
292560,202109,327,302,25,333300,27500,360800
292570,202109,309,241,68,266200,74800,341000
292575,202109,514,347,167,381700,183700,565400
292580,202109,994,668,326,734800,358600,1093400
292590,202109,566,496,70,545600,77000,622600
292593,202109,143,113,30,124300,33000,157300
292595,202109,201,160,41,176000,45100,221100
292600,202109,1265,914,351,1006500.63,387200,1393700.63
292610,202109,115,92,23,101200,25300,126500
292620,202109,536,456,80,501600,88000,589600
292630,202109,1500,824,676,906400,743600,1650000
292640,202109,857,592,265,651200,292600,943800
292650,202109,189,155,34,170500.5,38500,209000.5
292660,202109,1965,1387,578,1525700,636900.92,2162600.92
292665,202109,140,100,40,110000,44000,154000
292670,202109,396,314,82,345400,90200,435600
292680,202109,260,196,64,215600,70400,286000
292690,202109,204,145,59,159500,64900,224400
292700,202109,985,648,337,712800,370700,1083500
292710,202109,114,100,14,110000,15400,125400
292720,202109,944,536,408,591800,448800,1040600
292730,202109,198,95,103,104500,113300,217800
292740,202109,70623,34181,36442,37626602.91,40133500.28,77760103.19
292750,202109,393,281,112,309100,123200,432300
292760,202109,338,284,54,312400,59400,371800
292770,202109,839,361,478,397100,525800,922900
292780,202109,23,12,11,13200,12100,25300
292790,202109,782,407,375,448800,413600,862400
292800,202109,1277,757,520,832700,572000,1404700
292805,202109,385,123,262,135300,288200,423500
292810,202109,1806,1074,732,1181400,805200,1986600
292820,202109,700,591,109,650100,119900,770000
292830,202109,121,97,24,106700,26400,133100
292840,202109,687,558,129,613800,141900,755700
292850,202109,139,91,48,100100,52800,152900
292860,202109,2127,1242,885,1368400,975700,2344100
292870,202109,3557,2355,1202,2592700,1322200,3914900
292880,202109,1454,970,484,1067000,532400,1599400
292890,202109,527,441,86,485100,94600,579700
292895,202109,146,97,49,106700,53900,160600
292900,202109,362,259,103,284900,113300,398200
292905,202109,479,234,245,257400,269500,526900
292910,202109,467,350,117,385000,128700,513700
292920,202109,529,228,301,250800,331100,581900
292925,202109,477,436,41,479600,45100,524700
292930,202109,639,387,252,425700,277200,702900
292935,202109,282,120,162,132000,179300,311300
292937,202109,224,152,72,168300,79200,247500
292940,202109,188,144,44,158400,48400,206800
292950,202109,1211,601,610,662200,671000.6,1333200.6
292960,202109,549,388,161,426800,177100,603900
292970,202109,232,165,67,181500.48,73700,255200.48
292975,202109,97,57,40,62700,44000,106700
292980,202109,305,208,97,228800.61,106700,335500.61
292990,202109,1322,981,341,1080200,375100,1455300
293000,202109,112,79,33,86900,36300,123200
293010,202109,2899,1716,1183,1892000,1302400.5,3194400.5
293015,202109,620,508,112,558800,123200,682000
293020,202109,327,267,60,294800,66000,360800
293030,202109,586,515,71,566500,78100,644600
293040,202109,367,292,75,321200,82500,403700
293050,202109,2936,1738,1198,1915100,1318900,3234000
293060,202109,251,200,51,220000.48,56100,276100.48
293070,202109,3586,1809,1777,1993200,1955800,3949000
293075,202109,91,62,29,68200,31900,100100
293076,202109,76,56,20,61600,22000,83600
293077,202109,563,322,241,354200,265100,619300
293080,202109,426,381,45,420200,49500,469700
293090,202109,129,117,12,128700,13200,141900
293100,202109,534,370,164,407000,181500,588500
293105,202109,346,254,92,280500,101200,381700
293110,202109,122,85,37,93500,40700,134200
293120,202109,299,205,94,225500,103400,328900
293130,202109,250,169,81,185900,89100,275000
293135,202109,8114,3134,4980,3448500,5479100,8927600
293140,202109,190,114,76,125400,83600,209000
293150,202109,308,268,40,295900,44000,339900
293160,202109,424,258,166,283800,182600,466400
293170,202109,197,128,69,140800,75900,216700
293180,202109,555,379,176,416900,194700,611600
293190,202109,1357,931,426,1026300.7,468600,1494900.7
293200,202109,556,490,66,539000,72600,611600
293210,202109,407,317,90,348700,99000,447700
293220,202109,2394,1034,1360,1140700,1496000,2636700
293230,202109,1851,686,1165,755700.1,1282600,2038300.1
293240,202109,237,217,20,238700,22000,260700
293245,202109,129,109,20,119900,22000,141900
293250,202109,753,294,459,324500.22,506000,830500.22
293260,202109,304,249,55,275000,60500,335500
293270,202109,1146,520,626,572000,688600,1260600
293280,202109,293,172,121,190300,133100,323400
293290,202109,3036,1972,1064,2172500,1171500,3344000
293300,202109,774,547,227,601700,251900,853600
293305,202109,202,159,43,174900,47300,222200
293310,202109,170,128,42,140800,46200,187000
293315,202109,165,128,37,140800,40700,181500
293317,202109,88,64,24,70400,26400,96800
293320,202109,1088,591,497,651200,547800,1199000
293325,202109,188,69,119,75900,130900,206800
293330,202109,13855,6346,7509,6989401.01,8267600,15257001.01
293340,202109,284,198,86,217800,94600,312400
293345,202109,258,209,49,229900,53900,283800
293350,202109,587,347,240,382800,264000,646800
293360,202109,1516,1085,431,1196800,474100,1670900
310010,202109,142,75,67,84700,73700,158400
310020,202109,1023,562,461,618200,507100,1125300
310030,202109,321,258,63,283800,69300,353100
310040,202109,45,29,16,31900,17600,49500
310050,202109,167,106,61,116600,67100,183700
310060,202109,258,174,84,191400,92400,283800
310070,202109,15,9,6,9900,6600,16500
310080,202109,42,27,15,29700,16500,46200
310090,202109,1049,557,492,613800,541200,1155000
310100,202109,313,222,91,244200,100100,344300
310110,202109,704,384,320,422400,352000,774400
310120,202109,385,223,162,245300,178200,423500
310130,202109,30,17,13,18700,14300,33000
310140,202109,21,7,14,7700,15400,23100
310150,202109,1165,776,389,853600.72,427900,1281500.72
310160,202109,2051,993,1058,1093253.33,1166000,2259253.33
310163,202109,90,47,43,51700,47300,99000
310170,202109,2524,1126,1398,1240800,1543300,2784100
310180,202109,156,57,99,62700,108900,171600
310190,202109,473,320,153,352000,168300,520300
310200,202109,463,296,167,326700,183700,510400
310205,202109,62,41,21,45100,23100,68200
310210,202109,272,221,51,243100,56100,299200
310220,202109,61,34,27,37400,29700,67100
310230,202109,281,197,84,216700,92400,309100
310240,202109,111,95,16,104500,17600,122100
310250,202109,100,79,21,86900,23100,110000
310260,202109,727,383,344,421300.92,378400,799700.92
310270,202109,268,169,99,185900,110000,295900
310280,202109,381,277,104,304700,114400,419100
310285,202109,198,148,50,162800,55000,217800
310290,202109,231,131,100,144100,111100,255200
310300,202109,170,138,32,151800,35200,187000
310310,202109,10,7,3,7700,3300,11000
310320,202109,30,9,21,9900,23100,33000
310330,202109,42,27,15,29700,16500,46200
310340,202109,1841,1240,601,1365100,662200,2027300
310350,202109,2748,1454,1294,1599400,1423400,3022800
310360,202109,46,39,7,42900,7700,50600
310370,202109,129,107,22,117700,24200,141900
310375,202109,106,38,68,41800,74800,116600
310380,202109,51,29,22,31900,24200,56100
310390,202109,107,67,40,73700,44000,117700
310400,202109,2393,1536,857,1691800,942700,2634500
310410,202109,120,67,53,74800,58300,133100
310420,202109,658,338,320,371800,352000,723800
310430,202109,272,165,107,181500,117700,299200
310440,202109,75,43,32,47300,35200,82500
310445,202109,79,65,14,71500,15400,86900
310450,202109,628,400,228,440000,250800,690800
310460,202109,252,177,75,195800,82500,278300
310470,202109,506,326,180,358600,199100,557700
310480,202109,87,53,34,58300,37400,95700
310490,202109,531,244,287,268400,317900,586300
310500,202109,131,50,81,55000,89100,144100
310510,202109,601,418,183,462000,201300,663300
310520,202109,142,101,41,111100,45100,156200
310530,202109,103,41,62,45100,68200,113300
310540,202109,471,267,204,293700,224400,518100
310550,202109,74,49,25,53900,27500,81400
310560,202109,3005,2041,964,2245100,1061500,3306600
310570,202109,97,58,39,63800,42900,106700
310590,202109,363,224,139,247500,154000,401500
310600,202109,144,76,68,83600,74800,158400
310610,202109,54,21,33,23100,36300,59400
310620,202109,47249,22102,25147,24338518.81,27689200,52027718.81
310630,202109,676,406,270,446600,297000,743600
310640,202109,130,95,35,107800,38500,146300
310650,202109,153,137,16,150700,17600,168300
310660,202109,107,73,34,80300,37400,117700
310665,202109,62,45,17,49500,18700,68200
310670,202109,6909,2957,3952,3256000,4348300,7604300
310680,202109,66,41,25,45100,27500,72600
310690,202109,619,434,185,477400,203500,680900
310700,202109,65,40,25,44000,27500,71500
310710,202109,1304,883,421,970513.5,464200,1434713.5
310720,202109,144,37,107,41800,117700,159500
310730,202109,1498,1016,482,1117600,530200,1647800
310740,202109,1006,556,450,611600,495000,1106600
310750,202109,248,154,94,169400,103400,272800
310760,202109,70,53,17,58300,18700,77000
310770,202109,92,46,46,50600,50600,101200
310780,202109,356,285,71,313500,79200,392700
310790,202109,109,88,21,96800,23100,119900
310800,202109,477,221,256,243100,281600,524700
310810,202109,175,119,56,130900.72,61600,192500.72
310820,202109,323,258,65,283800,71500,355300
310825,202109,207,177,30,194700,33000,227700
310830,202109,475,222,253,244200,278300,522500
310840,202109,363,208,155,228800,170500,399300
310850,202109,80,65,15,71500,16500,88000
310855,202109,399,311,88,342100,96800,438900
310860,202109,1601,1176,425,1293600,468600,1762200
310870,202109,51,43,8,47300,8800,56100
310880,202109,82,65,17,71500,18700,90200
310890,202109,308,173,135,190300,148500,338800
310900,202109,628,279,349,306906.48,386111.52,693018.00
310910,202109,235,159,76,174900,83600,258500
310920,202109,443,256,187,281600,205700,487300
310925,202109,35,27,8,29700,8800,38500
310930,202109,1290,831,459,914100,504900,1419000
310940,202109,680,334,346,367400,380600,748000
310945,202109,119,74,45,81400,49500,130900
310950,202109,227,182,45,200200,49500,249700
310960,202109,73,23,50,25300,55000,80300
310970,202109,167,101,66,111100,72600,183700
310980,202109,45,29,16,31900,17600,49500
310990,202109,167,88,79,96800,86900,183700
311000,202109,814,387,427,427900.1,470800,898700.1
311010,202109,51,43,8,47300,8800,56100
311020,202109,44,24,20,26400,22000,48400
311030,202109,383,215,168,237600,185900,423500
311040,202109,39,30,9,33000,9900,42900
311050,202109,483,181,302,199100,332200,531300
311060,202109,782,430,352,473000,387200,860200
311070,202109,333,144,189,158400,207900,366300
311080,202109,110,63,47,69300,51700,121000
311090,202109,337,160,177,176000,194700,370700
311100,202109,567,334,233,368500,256300,624800
311110,202109,703,498,205,547800.15,225500,773300.15
311115,202109,73,52,21,57200,23100,80300
311120,202109,1052,559,493,616000,546700,1162700
311130,202109,301,177,124,194700,136400,331100
311140,202109,158,82,76,90200,83600,173800
311150,202109,351,225,126,247500,138600,386100
311160,202109,735,519,216,572000,237600,809600
311170,202109,89,72,17,79200,18700,97900
311180,202109,297,198,99,217800,108900,326700
311190,202109,43,18,25,19800,27500,47300
311200,202109,348,240,108,264000,118800,382800
311205,202109,33,24,9,26400,9900,36300
311210,202109,41,36,5,39600,5500,45100
311220,202109,30,26,4,28600,4400,33000
311230,202109,1655,1087,568,1195700,624800,1820500
311240,202109,199,126,73,138600,80300,218900
311250,202109,57,21,36,23100,39600,62700
311260,202109,550,343,207,378400,227700,606100
311265,202109,123,83,40,91300,44000,135300
311270,202109,294,202,92,222200,101200,323400
311280,202109,196,86,110,94600,121000,215600
311290,202109,107,88,19,96800,20900,117700
311300,202109,577,366,211,402600,232100,634700
311310,202109,19,16,3,17600,3300,20900
311320,202109,637,472,165,520300,181500,701800
311330,202109,1093,801,292,881100,321200,1202300
311340,202109,2620,1855,765,2040500,841500,2882000
311350,202109,269,208,61,228800,67100,295900
311360,202109,177,105,72,115500,79200,194700
311370,202109,1227,508,719,558800,790900,1349700
311380,202109,8,6,2,6600,2200,8800
311390,202109,250,140,110,154000,121000,275000
311400,202109,143,85,58,93500,63800,157300
311410,202109,118,57,61,62700,67100,129800
311420,202109,309,163,146,179300,161700,341000
311430,202109,822,545,277,599500,304700,904200
311440,202109,456,314,142,345400,156200,501600
311450,202109,298,178,120,195800,132000,327800
311455,202109,272,188,84,206800,92400,299200
311460,202109,133,57,76,62700,83600,146300
311470,202109,31,15,16,16500,17600,34100
311480,202109,49,24,25,26400,27500,53900
311490,202109,11,7,4,7700,4400,12100
311500,202109,28,13,15,14300,16500,30800
311510,202109,657,449,208,493900,228800,722700
311520,202109,40,32,8,35200,8800,44000
311530,202109,1816,1310,506,1443200,558800,2002000
311535,202109,66,45,21,49500,23100,72600
311540,202109,34,29,5,31900,5500,37400
311545,202109,160,116,44,127600,48400,176000
311547,202109,43,33,10,36300,11000,47300
311550,202109,667,289,378,317900,415800,733700
311560,202109,44,26,18,28600,19800,48400
311570,202109,283,188,95,206800,104500,311300
311580,202109,384,229,155,251900,171600,423500
311590,202109,30,26,4,28600,4400,33000
311600,202109,97,78,19,85800,20900,106700
311610,202109,247,211,36,232100,39600,271700
311615,202109,119,95,24,104500,26400,130900
311620,202109,26,15,11,16500,12100,28600
311630,202109,89,76,13,83600,14300,97900
311640,202109,146,70,76,78100,83600,161700
311650,202109,127,85,42,93500,46200,139700
311660,202109,410,197,213,217800,235400,453200
311670,202109,144,95,49,104500,53900,158400
311680,202109,212,161,51,177100,56100,233200
311690,202109,15,12,3,13200,3300,16500
311700,202109,193,139,54,152900,59400,212300
311710,202109,185,125,60,137500,66000,203500
311720,202109,38,28,10,30800,11000,41800
311730,202109,558,380,178,420200,196900,617100
311740,202109,26,18,8,19800,8800,28600
311750,202109,730,492,238,541200.7,261800,803000.7
311760,202109,76,33,43,36300,47300,83600
311770,202109,381,181,200,200200,220000,420200
311780,202109,186,91,95,101200,104500,205700
311783,202109,89,82,7,90200,7700,97900
311787,202109,37,13,24,14300,26400,40700
311790,202109,266,112,154,124300,169400,293700
311800,202109,681,433,248,476300,272800,749100
311810,202109,49,39,10,42900,11000,53900
311820,202109,122,97,25,106700,27500,134200
311830,202109,1890,1143,747,1259500,822800,2082300
311840,202109,1013,561,452,617100,497200,1114300
311850,202109,15,11,4,12100,4400,16500
311860,202109,9635,4116,5519,4532000,6079700,10611700
311870,202109,113,62,51,68200,56100,124300
311880,202109,944,680,264,748000,290400,1038400
311890,202109,203,98,105,107709,115500,223209
311900,202109,64,26,38,28600,41800,70400
311910,202109,1369,849,520,935000,572000,1507000
311920,202109,228,154,74,169400,81400,250800
311930,202109,906,510,396,562100,436700,998800
311940,202109,2552,1337,1215,1472900.62,1337600,2810500.62
311950,202109,65,42,23,46200,25300,71500
311960,202109,62,43,19,47300,22000,69300
311970,202109,24,14,10,15400,11000,26400
311980,202109,42,32,10,35200,11000,46200
311990,202109,35,25,10,27500,11000,38500
311995,202109,49,29,20,31900,22000,53900
312000,202109,22,16,6,17600,6600,24200
312010,202109,74,58,16,63800,17600,81400
312015,202109,70,54,16,59400,17600,77000
312020,202109,133,92,41,101200,45100,146300
312030,202109,66,50,16,55000,17600,72600
312040,202109,77,48,29,52800,31900,84700
312050,202109,200,111,89,122100,97900,220000
312060,202109,22,13,9,14300,9900,24200
312070,202109,77,49,28,53900,30800,84700
312080,202109,538,245,293,270600,322300,592900
312083,202109,59,36,23,39600,25300,64900
312087,202109,97,73,24,80300,26400,106700
312090,202109,3265,1970,1295,2169200,1425600,3594800
312100,202109,147,103,44,113047,48400,161447
312110,202109,112,67,45,73700,50600,124300
312120,202109,130,95,35,104500.63,38500,143000.63
312125,202109,83,51,32,56100,35200,91300
312130,202109,135,88,47,96800,51700,148500
312140,202109,140,108,32,118800,35200,154000
312150,202109,41,32,9,35200,9900,45100
312160,202109,1505,982,523,1080299,577500,1657799
312170,202109,12,8,4,8800,4400,13200
312180,202109,109,69,40,75900,44000,119900
312190,202109,36,32,4,35200,4400,39600
312200,202109,746,639,107,705100,117700,822800
312210,202109,121,63,58,69300,63800,133100
312220,202109,131,99,32,108900,35200,144100
312230,202109,3711,1689,2022,1860100,2225300,4085400
312235,202109,153,102,51,113300,56100,169400
312240,202109,82,57,25,63800,27500,91300
312245,202109,192,131,61,144100,67100,211200
312247,202109,78,57,21,62700,23100,85800
312250,202109,164,80,84,88000,92400,180400
312260,202109,102,69,33,75900,36300,112200
312270,202109,134,80,54,88000,59400,147400
312280,202109,29,14,15,15400,16500,31900
312290,202109,137,93,44,102300,49500,151800
312300,202109,197,128,69,140800,75900,216700
312310,202109,59,52,7,58300,7700,66000
312320,202109,421,264,157,290400,172700,463100
312330,202109,88,76,12,83600,13200,96800
312340,202109,32,15,17,16500,18700,35200
312350,202109,14,8,6,8800,6600,15400
312352,202109,96,68,28,75900,30800,106700
312360,202109,558,232,326,255200,359700,614900
312370,202109,324,183,141,202400,156200,358600
312380,202109,139,93,46,102300,51700,154000
312385,202109,156,128,28,141900,30800,172700
312390,202109,297,189,108,207900,118800,326700
312400,202109,379,280,99,308000,110000,418000
312410,202109,1104,354,750,390500,826100,1216600
312420,202109,632,470,162,517000,179300,696300
312430,202109,883,636,247,699600.5,271700,971300.5
312440,202109,41,31,10,34100,11000,45100
312450,202109,192,121,71,133100,78100,211200
312460,202109,30,15,15,16500,16500,33000
312470,202109,44,28,16,30800,17600,48400
312480,202109,169,102,67,112200,73700,185900
312490,202109,284,191,93,210100,102300,312400
312500,202109,39,23,16,25300,17600,42900
312510,202109,533,199,334,218900,367400,586300
312520,202109,28,8,20,8800,22000,30800
312530,202109,38,28,10,30800,11000,41800
312540,202109,88,79,9,86900,9900,96800
312550,202109,39,31,8,34100,8800,42900
312560,202109,201,152,49,167200,53900,221100
312570,202109,443,262,181,288200,199100,487300
312580,202109,93,49,44,53900,48400,102300
312590,202109,227,179,48,196900,52800,249700
312595,202109,124,103,21,113300,23100,136400
312600,202109,67,33,34,36300,37400,73700
312610,202109,1560,806,754,886600,830500,1717100
312620,202109,227,162,65,178200,71500,249700
312630,202109,70,57,13,62700,14300,77000
312640,202109,42,11,31,12100,34100,46200
312650,202109,147,122,25,134570.7,27500,162070.7
312660,202109,99,69,30,75900.01,33000,108900.01
312670,202109,925,592,333,651200,366300,1017500
312675,202109,32,26,6,28600,6600,35200
312680,202109,65,39,26,42900,28600,71500
312690,202109,234,114,120,126500,133100,259600
312695,202109,24,20,4,22000,4400,26400
312700,202109,232,133,99,146300,108900,255200
312705,202109,82,65,17,71500,18700,90200
312707,202109,134,95,39,104500,44000,148500
312710,202109,1845,1001,844,1102200.59,929500,2031700.59
312720,202109,51,29,22,31900,24200,56100
312730,202109,275,156,119,171600,130900,302500
312733,202109,47,36,11,39600,12100,51700
312735,202109,20,13,7,14300,7700,22000
312737,202109,68,37,31,40700,34100,74800
312738,202109,63,41,22,45100,24200,69300
312740,202109,81,55,26,60500,28600,89100
312750,202109,93,64,29,70400,31900,102300
312760,202109,279,196,83,216700,91300,308000
312770,202109,8312,3806,4506,4194300,4961000,9155300
312780,202109,444,341,103,375100,113300,488400
312790,202109,23,16,7,17600,7700,25300
312800,202109,1607,1120,487,1232000,535700,1767700
312810,202109,348,231,117,254100,128700,382800
312820,202109,186,143,43,157300,47300,204600
312825,202109,34,24,10,26400,11000,37400
312830,202109,205,117,88,128700,97900,226600
312840,202109,171,116,55,127600,60500,188100
312850,202109,42,37,5,40700,5500,46200
312860,202109,148,94,54,103400,59400,162800
312870,202109,1068,554,514,610500,567600,1178100
312880,202109,122,86,36,94600,39600,134200
312890,202109,161,114,47,125400,51700,177100
312900,202109,183,136,47,149600,51700,201300
312910,202109,177,100,77,110000,84700,194700
312920,202109,134,73,61,80300,67100,147400
312930,202109,319,220,99,242000,108900,350900
312940,202109,123,85,38,93500,41800,135300
312950,202109,684,464,220,510400,242000,752400
312960,202109,147,111,36,122100,39600,161700
312965,202109,101,78,23,85800,25300,111100
312970,202109,280,229,51,251900,56100,308000
312980,202109,2539,1284,1255,1413500,1386000,2799500
312990,202109,48,23,25,25300,27500,52800
313000,202109,53,30,23,33000,25300,58300
313005,202109,178,134,44,147400,48400,195800
313010,202109,935,379,556,416900,611600,1028500
313020,202109,200,103,97,113300,106700,220000
313030,202109,197,128,69,140800,75900,216700
313040,202109,81,23,58,25300,63800,89100
313050,202109,193,139,54,152900,59400,212300
313055,202109,40,31,9,34100,9900,44000
313060,202109,132,88,44,97900,48400,146300
313065,202109,62,45,17,49500,18700,68200
313070,202109,131,70,61,77000,67100,144100
313080,202109,35,16,19,17600,20900,38500
313090,202109,672,434,238,478500,261800,740300
313100,202109,198,69,129,75900,141900,217800
313110,202109,151,80,71,88000,78100,166100
313115,202109,222,125,97,137500,106700,244200
313120,202109,843,473,370,520300,409200,929500
313130,202109,5899,3211,2688,3538700,2957900,6496600
313140,202109,129,72,57,79200,62700,141900
313150,202109,292,231,61,254100,67100,321200
313160,202109,185,137,48,150700,52800,203500
313170,202109,1392,916,476,1007600,524700,1532300
313180,202109,309,178,131,195800,144100,339900
313190,202109,725,426,299,468600,331100,799700
313200,202109,29,24,5,26400,5500,31900
313210,202109,995,844,151,928400,166100,1094500
313220,202109,285,170,115,187000,126500,313500
313230,202109,261,201,60,221100.5,66000,287100.5
313240,202109,2165,1089,1076,1197900,1183600,2381500
313250,202109,1257,955,302,1052700,333300,1386000
313260,202109,96,48,48,52800,52800,105600
313270,202109,995,571,424,628100,468600,1096700
313280,202109,47,39,8,42900,8800,51700
313290,202109,213,171,42,188100,46200,234300
313300,202109,330,166,164,182600,180400,363000
313310,202109,247,111,136,122100,150700,272800
313320,202109,380,277,103,305800,113300,419100
313330,202109,1420,863,557,949300,612700,1562000
313340,202109,329,236,93,259600,103400,363000
313350,202109,471,304,167,337700,183700,521400
313360,202109,161,73,88,80300,96800,177100
313370,202109,233,78,155,85800,170500,256300
313375,202109,301,174,127,191400,139700,331100
313380,202109,1339,702,637,773300,701800,1475100
313390,202109,44,42,2,46200,2200,48400
313400,202109,397,271,126,298100,138600,436700
313410,202109,32,15,17,16500,18700,35200
313420,202109,4552,2460,2092,2707100,2302300,5009400
313430,202109,135,67,68,73700,74800,148500
313440,202109,1378,959,419,1056001.13,462000,1518001.13
313450,202109,66,29,37,31900,40700,72600
313460,202109,383,162,221,178200,243100,421300
313470,202109,532,249,283,273900,312400,586300
313480,202109,143,106,37,116600,40700,157300
313490,202109,534,239,295,262900,324500,587400
313500,202109,30,17,13,18700,14300,33000
313505,202109,1057,819,238,900900,261800,1162700
313507,202109,93,57,36,62700,39600,102300
313510,202109,2877,1801,1076,1982316.9,1184700,3167016.9
313520,202109,3446,2686,760,2957901.5,836000,3793901.5
313530,202109,32,20,12,22000,13200,35200
313535,202109,66,53,13,59400,14300,73700
313540,202109,69,51,18,56100,19800,75900
313545,202109,116,100,16,110000,17600,127600
313550,202109,223,187,36,206800,39600,246400
313560,202109,346,163,183,180400,202400,382800
313570,202109,68,21,47,23100,51700,74800
313580,202109,1319,740,579,814000,638000,1452000
313590,202109,66,38,28,41800,30800,72600
313600,202109,678,403,275,443300,302500,745800
313610,202109,49,41,8,45100,8800,53900
313620,202109,1383,677,706,748000,778800,1526800
313630,202109,1616,1213,403,1334300,443300,1777600
313640,202109,120,71,49,78100,53900,132000
313650,202109,233,110,123,121000,135300,256300
313652,202109,23,22,1,24200,1100,25300
313655,202109,70,44,26,48400,28600,77000
313657,202109,44,40,4,44000,4400,48400
313660,202109,127,81,46,89100,50619.8,139719.8
313665,202109,661,302,359,332200,394900,727100
313670,202109,10326,7013,3313,7726400,3645400.06,11371800.06
313680,202109,42,32,10,35200,11000,46200
313690,202109,129,95,34,105600,37400,143000
313695,202109,75,58,17,63800,18700,82500
313700,202109,321,253,68,279400,74800,354200
313710,202109,131,96,35,105600,38500,144100
313720,202109,1134,524,610,577500,671000,1248500
313730,202109,71,41,30,45100,33000,78100
313740,202109,147,115,32,126500,35200,161700
313750,202109,413,293,120,322300,132000,454300
313753,202109,222,163,59,180400,64900,245300
313760,202109,1349,495,854,544500,939400,1483900
313770,202109,389,270,119,297000,130900,427900
313780,202109,805,418,387,459800,425700,885500
313790,202109,28,27,1,29700,1100,30800
313800,202109,146,86,60,94600,66000,160600
313810,202109,83,48,35,52800,38500,91300
313820,202109,1333,622,711,684200,782100,1466300
313830,202109,53,38,15,41800,16500,58300
313835,202109,58,49,9,53900,9900,63800
313840,202109,1633,956,677,1056000,745800,1801800
313850,202109,210,84,126,92400,139700,232100
313860,202109,464,355,109,391600,119900,511500
313862,202109,166,110,56,121000,61600,182600
313865,202109,144,99,45,108900,49500,158400
313867,202109,54,44,10,48400,11000,59400
313868,202109,39,23,16,25300,17600,42900
313870,202109,104,58,46,63800,50600,114400
313880,202109,379,233,146,257400,160600,418000
313890,202109,329,175,154,192500,169400,361900
313900,202109,836,451,385,496100.66,423500,919600.66
313910,202109,143,98,45,108900,49500,158400
313920,202109,632,441,191,485100,210100.94,695200.94
313925,202109,33,27,6,29700,6600,36300
313930,202109,869,671,198,739200,218900,958100
313940,202109,1877,1129,748,1241900,823900,2065800
313950,202109,854,529,325,581900,357500,939400
313960,202109,1433,820,613,903100,674300,1577400
313970,202109,182,112,70,123200,77000,200200
313980,202109,204,135,69,148500,75900,224400
313990,202109,242,157,85,172700,93500,266200
314000,202109,867,567,300,623700,331100,954800
314010,202109,86,49,37,53900,40700,94600
314015,202109,69,19,50,20900,55000,75900
314020,202109,56,35,21,38500,23100,61600
314030,202109,75,36,39,39600,42900,82500
314040,202109,46,25,21,27500,23100,50600
314050,202109,289,170,119,187000,130900,317900
314053,202109,105,66,39,72600,42900,115500
314055,202109,293,181,112,199100,124300,323400
314060,202109,127,110,17,121000.83,18700,139700.83
314070,202109,1048,525,523,577500,576400,1153900
314080,202109,211,132,79,145200,86900,232100
314085,202109,162,109,53,119900,59400,179300
314090,202109,379,265,114,291500,125400,416900
314100,202109,521,411,110,452100,121000,573100
314110,202109,776,364,412,400400,454300,854700
314120,202109,72,40,32,44000,35200,79200
314130,202109,23,15,8,16500,8800,25300
314140,202109,1102,676,426,743600,468600,1212200
314150,202109,193,125,68,137500,74800,212300
314160,202109,322,240,82,264000,90200,354200
314170,202109,83,63,20,69300,22000,91300
314180,202109,735,646,89,711700,97900,809600
314190,202109,92,56,36,61600,39600,101200
314200,202109,502,338,164,372900,180400,553300
314210,202109,248,188,60,206800,67100,273900
314220,202109,299,213,86,235400,94600,330000
314225,202109,61,42,19,46200,20900,67100
314230,202109,113,50,63,55000,69300,124300
314240,202109,162,115,47,126500,51700,178200
314250,202109,58,34,24,37400,26400,63800
314260,202109,221,109,112,121000,123200,244200
314270,202109,400,308,92,338800,101200,440000
314280,202109,727,385,342,424550.5,376200,800750.5
314290,202109,533,418,115,459800,126500,586300
314300,202109,340,253,87,278300,95700,374000
314310,202109,1341,917,424,1008975.72,466400,1475375.72
314315,202109,36,27,9,29700,9900,39600
314320,202109,579,385,194,424600,213400,638000
314330,202109,11429,5568,5861,6131400,6453700,12585100
314340,202109,604,265,339,291500,372900,664400
314345,202109,53,37,16,40700,17600,58300
314350,202109,174,109,65,119900,71500,191400
314360,202109,57,33,24,36300,26400,62700
314370,202109,71,48,23,52800,25300,78100
314380,202109,100,63,37,69300,40700,110000
314390,202109,3343,2140,1203,2354000,1324400,3678400
314400,202109,683,479,204,526900,224400,751300
314410,202109,489,312,177,343200,194700,537900
314420,202109,16,7,9,7700,9900,17600
314430,202109,2436,891,1545,980101.51,1700600,2680701.51
314435,202109,174,103,71,113300,79200,192500
314437,202109,31,20,11,22000,12100,34100
314440,202109,96,64,32,71500,35200,106700
314450,202109,164,109,55,119900,60500,180400
314460,202109,631,298,333,327800,366300,694100
314465,202109,98,59,39,64900,42900,107800
314467,202109,73,59,14,64900,15400,80300
314470,202109,398,200,198,220000,217800,437800
314480,202109,1020,462,558,508200,613800,1122000
314490,202109,43,25,18,27500,19800,47300
314500,202109,283,196,87,215600,95700,311300
314505,202109,105,65,40,71500,44000,115500
314510,202109,247,201,46,221100,50600,271700
314520,202109,1352,718,634,790900.52,698500,1489400.52
314530,202109,744,586,158,645700.7,173800,819500.7
314535,202109,166,101,65,111100,71500,182600
314537,202109,63,36,27,39600,29700,69300
314540,202109,20,13,7,14300,7700,22000
314545,202109,55,37,18,40700,19800,60500
314550,202109,70,37,33,40700,36300,77000
314560,202109,859,463,396,509300,435600,944900
314570,202109,21,15,6,16500,6600,23100
314580,202109,12,5,7,5500,7700,13200
314585,202109,26,18,8,19800,8800,28600
314587,202109,84,72,12,79200,13200,92400
314590,202109,561,389,172,427900,189200,617100
314600,202109,946,598,348,658900,383900,1042800
314610,202109,943,483,460,531300,506000,1037300
314620,202109,141,103,38,114400,41800,156200
314625,202109,97,71,26,78100,28600,106700
314630,202109,1141,605,536,665500,590700,1256200
314640,202109,85,55,30,60500,33000,93500
314650,202109,170,93,77,102300,85800,188100
314655,202109,61,44,17,49500,18700,68200
314660,202109,16,13,3,14300,3300,17600
314670,202109,205,158,47,173800,51700,225500
314675,202109,211,127,84,139700,92400,232100
314690,202109,573,307,266,338800,292600,631400
314700,202109,2252,1194,1058,1315600,1166000,2481600
314710,202109,1764,984,780,1082400,860200,1942600
314720,202109,390,221,169,243100,187000,430100
314730,202109,512,270,242,297000,266200,563200
314740,202109,751,353,398,388300,437800,826100
314750,202109,18,15,3,16500,3300,19800
314760,202109,362,157,205,172700,225500,398200
314770,202109,107,72,35,79200,38500,117700
314780,202109,23,9,14,9900,15400,25300
314790,202109,2444,1531,913,1687400,1004300,2691700
314795,202109,57,49,8,53900,8800,62700
314800,202109,2919,1676,1243,1845800.76,1367300,3213100.76
314810,202109,1469,836,633,920700,696300,1617000
314820,202109,109,63,46,69300,50600,119900
314830,202109,208,170,38,187000,41800,228800
314840,202109,88,50,38,55000,41800,96800
314850,202109,402,190,212,209000,233200,442200
314860,202109,657,505,152,555500,167200,722700
314870,202109,1561,800,761,882200,837100,1719300
314875,202109,52,46,6,50600,6600,57200
314880,202109,42,30,12,33000,13200,46200
314890,202109,47,25,22,27500,24200,51700
314900,202109,27,21,6,23100,6600,29700
314910,202109,230,151,79,166100,88000,254100
314915,202109,136,119,17,130900,18700,149600
314920,202109,91,58,33,63800,36300,100100
314930,202109,1022,482,540,530200,595100,1125300
314940,202109,43,34,9,37400,9900,47300
314950,202109,20,16,4,17600,4400,22000
314960,202109,25,19,6,20900,6600,27500
314970,202109,161,77,84,84700,92400,177100
314980,202109,309,196,113,215600,124300,339900
314990,202109,440,240,200,264000,220000,484000
314995,202109,154,66,88,72600,96800,169400
315000,202109,82,63,19,69300,20900,90200
315010,202109,35,22,13,24200,14300,38500
315015,202109,162,129,33,141900,36300,178200
315020,202109,73,61,12,67100,13200,80300
315030,202109,108,82,26,90200,28600,118800
315040,202109,77,49,28,53900,30800,84700
315050,202109,199,120,79,132000,86900,218900
315053,202109,45,31,14,34100,15400,49500
315057,202109,111,88,23,96800,25300,122100
315060,202109,70,57,13,62700,14300,77000
315070,202109,101,56,45,61600,49500,111100
315080,202109,378,299,79,328900,89100,418000
315090,202109,97,56,41,61600,45100,106700
315100,202109,81,40,41,44000,45100,89100
315110,202109,270,138,132,151800,146300,298100
315120,202109,1800,867,933,954800,1026300.6,1981100.6
315130,202109,336,243,93,267300,102300,369600
315140,202109,537,293,244,322300,270600,592900
315150,202109,987,474,513,521400,564300,1085700
315160,202109,198,101,97,112200,106700,218900
315170,202109,306,205,101,225500,111100,336600
315180,202109,3256,1358,1898,1494900,2088900,3583800
315190,202109,299,181,118,199100,129800,328900
315200,202109,1194,710,484,782100,533500,1315600
315210,202109,1644,942,702,1037300,772200,1809500
315213,202109,27,15,12,16500,13200,29700
315217,202109,203,156,47,171600,51700.5,223300.5
315220,202109,1599,1187,412,1305700,453200.02,1758900.02
315230,202109,173,129,44,141900,48400,190300
315240,202109,394,252,142,277200,156200,433400
315250,202109,2584,1247,1337,1372800,1471800,2844600
315260,202109,133,73,60,80300,66000,146300
315270,202109,134,91,43,100100,47300,147400
315280,202109,630,416,214,457600.44,235400,693000.44
315290,202109,188,117,71,128700,79200,207900
315300,202109,83,61,22,67100,24200,91300
315310,202109,84,75,9,82500,9900,92400
315320,202109,151,89,62,97900.62,68200,166100.62
315330,202109,58,46,12,50600,13200,63800
315340,202109,392,287,105,315700,115500,431200
315350,202109,151,93,58,102300,63800,166100
315360,202109,91,41,50,45100,55000,100100
315370,202109,55,35,20,38500,22000,60500
315380,202109,5,5,0,5500,0,5500
315390,202109,64,19,45,20900,49500,70400
315400,202109,792,586,206,645700,228800,874500
315410,202109,313,182,131,200200,144100,344300
315415,202109,55,41,14,45100,15400,60500
315420,202109,195,141,54,156200,59400,215600
315430,202109,650,368,282,404800,310200,715000
315440,202109,92,62,30,68200,33000,101200
315445,202109,219,183,36,202400,39600,242000
315450,202109,182,131,51,144100,56100,200200
315460,202109,4254,1973,2281,2173600,2509100,4682700
315470,202109,40,15,25,16500,27500,44000
315480,202109,73,21,52,23100,57200,80300
315490,202109,701,432,269,477400.77,295900,773300.77
315500,202109,19,14,5,15400,5500,20900
315510,202109,144,98,46,107800,50600,158400
315520,202109,75,64,11,70400,12100,82500
315530,202109,41,22,19,24200,20900,45100
315540,202109,258,182,76,201300,83600,284900
315550,202109,174,142,32,156200,35200,191400
315560,202109,725,573,152,630300,167200,797500
315570,202109,309,149,160,163900,177100,341000
315580,202109,737,497,240,546700,264000,810700
315590,202109,194,100,94,110000,103400,213400
315600,202109,316,243,73,267300,80300,347600
315610,202109,101,47,54,51700,59400,111100
315620,202109,34,26,8,28600,8800,37400
315630,202109,123,85,38,93500,41800,135300
315640,202109,66,40,26,44000,28600,72600
315645,202109,49,33,16,36300,17600,53900
315650,202109,170,124,46,136400,50600,187000
315660,202109,457,198,259,218900,284900,503800
315670,202109,2390,1115,1275,1226500,1402500,2629000
315680,202109,799,566,233,622600,258500,881100
315690,202109,672,455,217,500500,238700,739200
315700,202109,1968,1020,948,1123100.28,1042800,2165900.28
315710,202109,357,110,247,121000,271700,392700
315720,202109,480,290,190,319000,210100,529100
315725,202109,189,153,36,168300,39600,207900
315727,202109,55,28,27,30800,29700,60500
315730,202109,48,42,6,46200,6600,52800
315733,202109,88,57,31,62700,34100,96800
315737,202109,49,37,12,40700,13200,53900
315740,202109,32,24,8,26400,8800,35200
315750,202109,151,111,40,122100,44000,166100
315760,202109,38,29,9,31900,9900,41800
315765,202109,122,71,51,78100,56100,134200
315770,202109,217,133,84,146300.5,92400,238700.5
315780,202109,3671,1809,1862,1991000,2051500,4042500
315790,202109,237,183,54,201300,59400,260700
315800,202109,303,200,103,220000,113300,333300
315810,202109,90,56,34,62700,37400,100100
315820,202109,754,551,203,606100,223300,829400
315830,202109,115,74,41,81400,45100,126500
315840,202109,80,52,28,57200,30800,88000
315850,202109,258,179,79,196900,86900,283800
315860,202109,15,5,10,5500,11000,16500
315870,202109,39,30,9,33000,9900,42900
315880,202109,92,65,27,71500,30800,102300
315890,202109,100,73,27,80300,29700,110000
315895,202109,404,268,136,294800,149600,444400
315900,202109,71,33,38,37400,41800,79200
315910,202109,42,24,18,26400,19800,46200
315920,202109,154,102,52,112200,57200,169400
315930,202109,54,17,37,18700,40700,59400
315935,202109,126,100,26,111100,28600,139700
315940,202109,97,71,26,79200,28600,107800
315950,202109,37,29,8,31900,8800,40700
315960,202109,538,252,286,277200,314600,591800
315970,202109,32,25,7,27500,7700,35200
315980,202109,677,333,344,367400,379500,746900
315990,202109,259,147,112,161700,123200,284900
316000,202109,45,30,15,33000,16500,49500
316010,202109,78,65,13,71500,14300,85800
316020,202109,114,98,16,107800,17600,125400
316030,202109,378,208,170,228800,187000,415800
316040,202109,541,219,322,240900,355300,596200
316045,202109,51,46,5,50600,5500,56100
316050,202109,21,16,5,17600,5500,23100
316060,202109,95,66,29,72600,31900,104500
316070,202109,1097,720,377,792000,416900,1208900
316080,202109,90,59,31,66096.8,34100,100196.8
316090,202109,39,19,20,20900,22000,42900
316095,202109,86,71,15,78100,16500,94600
316100,202109,315,176,139,194700,152900,347600
316105,202109,43,25,18,27500,19800,47300
316110,202109,1885,1469,416,1618100.5,457600,2075700.5
316120,202109,78,51,27,56100,29700,85800
316130,202109,113,84,29,93500,31900,125400
316140,202109,34,23,11,25300,12100,37400
316150,202109,213,147,66,161700,72600,234300
316160,202109,82,46,36,50600,39600,90200
316165,202109,65,46,19,50600,20900,71500
316170,202109,186,119,67,130900,73700,204600
316180,202109,216,90,126,99000,139700,238700
316190,202109,139,100,39,110000,42900,152900
316200,202109,659,356,303,392700,333300,726000
316210,202109,773,512,261,563389.2,287100,850489.2
316220,202109,116,74,42,81400,46200,127600
316225,202109,32,18,14,19800,15400,35200
316230,202109,39,19,20,20900,22000,42900
316240,202109,665,530,135,583000,148500,731500
316245,202109,142,123,19,135300,20900,156200
316250,202109,1578,1069,509,1177000,563200,1740200
316255,202109,134,107,27,117700,29700,147400
316257,202109,171,85,86,93500,94600,188100
316260,202109,188,133,55,146300,60500,206800
316265,202109,29,20,9,22000,9900,31900
316270,202109,682,476,206,524700,226600,751300
316280,202109,547,336,211,369600.63,232100,601700.63
316290,202109,794,535,259,589600,286000,875600
316292,202109,543,214,329,235400,364100,599500
316294,202109,106,69,37,75900,40700,116600
316295,202109,328,141,187,155100,205700,360800
316300,202109,110,74,36,81400,39600,121000
316310,202109,28,14,14,15400,15400,30800
316320,202109,53,28,25,30800,27500,58300
316330,202109,169,117,52,128700,57200,185900
316340,202109,133,87,46,95700,50600,146300
316350,202109,188,132,56,145200,61600,206800
316360,202109,25,14,11,15400,12100,27500
316370,202109,1167,578,589,635800,650100,1285900
316380,202109,111,85,26,93500,28600,122100
316390,202109,105,74,31,81400,34100,115500
316400,202109,135,101,34,111100,37400,148500
316410,202109,308,223,85,245300,93500,338800
316420,202109,214,143,71,158400,78100,236500
316430,202109,154,82,72,90200,80300,170500
316440,202109,81,39,42,42900,46200,89100
316443,202109,44,39,5,42900,5500,48400
316447,202109,45,33,12,36300,13200,49500
316450,202109,225,173,52,190300,57200,247500
316460,202109,84,32,52,35200,58300,93500
316470,202109,1665,1211,454,1335389.65,500500,1835889.65
316480,202109,11,8,3,8800,3300,12100
316490,202109,19,6,13,6600,14300,20900
316500,202109,156,103,53,113300,58300,171600
316510,202109,152,117,35,128700,38500,167200
316520,202109,197,114,83,125400,91300,216700
316530,202109,165,105,60,115500,66000,181500
316540,202109,150,76,74,83600,81400,165000
316550,202109,140,86,54,94600,59400,154000
316553,202109,348,155,193,170500,213400.72,383900.72
316555,202109,47,41,6,45100,6600,51700
316556,202109,14,10,4,11000,4400,15400
316557,202109,27,22,5,24200,5500,29700
316560,202109,69,49,20,53900,22000,75900
316570,202109,210,190,20,209000,22000,231000
316580,202109,22,16,6,17600,6600,24200
316590,202109,95,80,15,88000,16500,104500
316600,202109,178,149,29,163900,31900,195800
316610,202109,67,50,17,55000,18700,73700
316620,202109,144,104,40,114400,44000,158400
316630,202109,43,33,10,36300,11000,47300
316640,202109,21,14,7,15400,7700,23100
316650,202109,87,70,17,77000,18700,95700
316660,202109,7,2,5,2200,5500,7700
316670,202109,440,150,290,165000,319000,484000
316680,202109,164,121,43,133100,47300,180400
316690,202109,168,99,69,110000,75900,185900
316695,202109,61,51,10,56100,11000,67100
316700,202109,18,12,6,13200,6600,19800
316710,202109,762,576,186,633600,204600,838200
316720,202109,5064,2418,2646,2660900,2912800,5573700
316730,202109,16,16,0,17600,0,17600
316740,202109,145,91,54,100100,59400,159500
316750,202109,23,15,8,16500,8800,25300
316760,202109,310,248,62,272800,68200,341000
316770,202109,171,91,80,100100,88000,188100
316780,202109,70,43,27,47300.71,29700,77000.71
316790,202109,56,39,17,42900,18700,61600
316800,202109,1784,1087,697,1199000,766700,1965700
316805,202109,24,16,8,17600,8800,26400
316810,202109,64,39,25,42900,27500,70400
316820,202109,39,21,18,23100,19800,42900
316830,202109,96,44,52,48400,57200,105600
316840,202109,513,297,216,326700,237600,564300
316850,202109,317,214,103,236500,113300,349800
316860,202109,6013,2662,3351,2929300,3692700,6622000
316870,202109,1599,1016,583,1119800,641300,1761100
316880,202109,145,72,73,79200,80300,159500
316890,202109,234,160,74,176000,81400,257400
316900,202109,410,286,124,314600,136400,451000
316905,202109,19,9,10,9900,11000,20900
316910,202109,67,28,39,30800,42900,73700
316920,202109,142,111,31,122100,34100,156200
316930,202109,1899,945,954,1041700,1050500,2092200
316935,202109,912,544,368,599500,404800,1004300
316940,202109,1082,611,471,672100,518100,1190200
316950,202109,176,84,92,92400,101200,193600
316960,202109,1098,604,494,666600,544500,1211100
316970,202109,635,500,135,550000,148500,698500
316980,202109,74,39,35,42900,38500,81400
316990,202109,2191,1467,724,1615900,798600.84,2414500.84
317000,202109,329,252,77,277200,84700,361900
317005,202109,222,158,64,173800,70400,244200
317010,202109,6473,3587,2886,3952300,3176800,7129100
317020,202109,15697,6886,8811,7585600,9704200.7,17289800.7
317030,202109,82,32,50,35200,55000,90200
317040,202109,3016,1902,1114,2093300,1226500,3319800
317043,202109,69,53,16,58300,17600,75900
317047,202109,40,22,18,24200,19800,44000
317050,202109,148,112,36,124300,39600,163900
317052,202109,144,112,32,123200,35200,158400
317057,202109,178,133,45,146300,49500,195800
317060,202109,58,35,23,38500,25300,63800
317065,202109,50,38,12,41800,13200,55000
317070,202109,1935,886,1049,976800,1153900,2130700
317075,202109,95,54,41,59400,46200,105600
317080,202109,911,465,446,511500,490600,1002100
317090,202109,690,538,152,591800,167200,759000
317100,202109,420,316,104,348700,115500,464200
317103,202109,118,95,23,104500,25300,129800
317107,202109,47,40,7,44000,7700,51700
317110,202109,104,51,53,56100,58300,114400
317115,202109,39,35,4,38500,4400,42900
317120,202109,1973,928,1045,1023000,1151700,2174700
317130,202109,1989,1320,669,1452000,738100,2190100
317140,202109,13,9,4,9900,4400,14300
317150,202109,285,170,115,187000,126500,313500
317160,202109,332,249,83,273900.63,91300,365200.63
317170,202109,236,159,77,174900,84700,259600
317180,202109,439,297,142,326700,156200,482900
317190,202109,262,190,72,210100,79200,289300
317200,202109,807,562,245,618200,270600,888800
317210,202109,181,95,86,104500,94600,199100
317220,202109,24,12,12,13200,13200,26400
320010,202109,573,411,162,453200,178200,631400
320013,202109,123,84,39,92400,44000,136400
320016,202109,262,165,97,182600.03,108900,291500.03
320020,202109,719,415,304,459800.8,335500,795300.8
320030,202109,159,110,49,121000.04,53900.08,174900.12
320035,202109,139,98,41,108900,45100,154000
320040,202109,497,251,246,276100,270600,546700
320050,202109,120,79,41,86900,45100,132000
320060,202109,1757,834,923,920700,1016400,1937100
320070,202109,99,60,39,66000,42900,108900
320080,202109,808,464,344,510400,378400,888800
320090,202109,1264,832,432,916300,475200,1391500
320100,202109,334,190,144,209000,158400,367400
320110,202109,118,74,44,81400,48400,129800
320115,202109,113,92,21,101200,23100,124300
320120,202109,3657,1904,1753,2096600,1930500.74,4027100.74
320130,202109,7751,3424,4327,3767500.5,4761900.16,8529400.66
320140,202109,443,282,161,310200,177100.81,487300.81
320150,202109,2097,1157,940,1276000,1034000,2310000
320160,202109,656,288,368,317900,407000,724900
320170,202109,112,87,25,95700.1,27500.02,123200.12
320180,202109,54,33,21,36300,23100,59400
320190,202109,240,152,88,167200,96800,264000
320200,202109,63,49,14,53900,15400,69300
320210,202109,896,484,412,532400,453200,985600
320220,202109,305,108,197,119900,216700,336600
320225,202109,81,65,16,71500,17600,89100
320230,202109,671,429,242,471900,267300,739200
320240,202109,3498,1636,1862,1800700,2048200,3848900
320245,202109,493,331,162,364100,178200,542300
320250,202109,230,110,120,121000,132000,253000
320255,202109,132,101,31,111100,34100,145200
320260,202109,242,142,100,156200.2,111100.12,267300.32
320265,202109,146,113,33,124300,36300,160600
320270,202109,156,121,35,133100,38500,171600
320280,202109,1175,665,510,734800.5,561000.02,1295800.52
320290,202109,58,48,10,52800,11000,63800
320300,202109,609,414,195,455400.02,214500,669900.02
320305,202109,710,374,336,412500,369600,782100
320310,202109,198,113,85,124300,93500,217800
320313,202109,339,156,183,171600,201300,372900
320316,202109,104,79,25,86900,27500,114400
320320,202109,3434,1514,1920,1665400,2116400,3781800
320330,202109,269,196,73,215600,80300,295900
320332,202109,773,460,313,507100,344300,851400
320334,202109,272,152,120,167200.02,132000,299200.02
320335,202109,142,89,53,99000,58300,157300
320340,202109,567,398,169,437800,185900,623700
320350,202109,1046,424,622,467500.5,684200,1151700.5
320360,202109,167,84,83,92400,91300,183700
320370,202109,231,171,60,188100,66000,254100
320380,202109,286,201,85,221100,94600,315700
320390,202109,1158,679,479,748000,529100,1277100
320400,202109,321,229,92,251900,101200,353100
320405,202109,955,390,565,429000,622600,1051600
320410,202109,959,481,478,529100,525800,1054900
320420,202109,528,250,278,275000,306900,581900
320425,202109,194,108,86,118800,95700,214500
320430,202109,375,196,179,215600,196900,412500
320435,202109,165,109,56,119900,61600,181500
320440,202109,203,114,89,125400.24,97900.2,223300.44
320450,202109,131,73,58,80300,63800,144100
320455,202109,242,193,49,212300,53900,266200
320460,202109,284,177,107,194700,117700,312400
320465,202109,111,75,36,82500,39600,122100
320470,202109,709,431,278,475200,305800,781000
320480,202109,199,128,71,140800,78100,218900
320490,202109,3181,1510,1671,1664301.23,1840300.71,3504601.94
320495,202109,119,71,48,79200,52800,132000
320500,202109,9763,4756,5007,5236000.57,5509900,10745900.57
320501,202109,548,273,275,300300,302500,602800
320503,202109,294,207,87,228800.08,95700.02,324500.10
320506,202109,257,179,78,196900,85800,282700
320510,202109,1128,500,628,550000,690800,1240800
320515,202109,79,60,19,66000,20900,86900
320517,202109,217,155,62,170500,68200,238700
320520,202109,7326,3059,4267,3367100,4695900.27,8063000.27
320530,202109,6586,3174,3412,3496881.5,3756500.63,7253382.13
330010,202109,3185,1577,1608,1734700,1769900,3504600
330015,202109,195,78,117,85800,128700,214500
330020,202109,3852,1547,2305,1702800,2538800,4241600
330022,202109,269,133,136,146300,149600,295900
330023,202109,697,207,490,228800,540100,768900
330025,202109,626,119,507,132000,558800,690800
330030,202109,1829,1128,701,1240800,772200,2013000
330040,202109,2521,1275,1246,1404700,1370600.5,2775300.5
330045,202109,9685,2790,6895,3072300.5,7595500,10667800.5
330050,202109,860,545,315,599500,346500,946000
330060,202109,1072,628,444,690800,488400,1179200
330070,202109,4093,1410,2683,1553200,2956800,4510000
330080,202109,1597,688,909,756800,1001000,1757800
330090,202109,391,219,172,240900,189200,430100
330093,202109,256,109,147,121000,161700,282700
330095,202109,73,44,29,48400,31900,80300
330100,202109,10248,5036,5212,5541801.38,5742000,11283801.38
330110,202109,472,202,270,223300,297000,520300
330115,202109,516,265,251,291500,276100,567600
330120,202109,389,199,190,218900,209000,427900
330130,202109,1596,396,1200,435600,1322200,1757800
330140,202109,629,327,302,359700,332200,691900
330150,202109,512,291,221,322300,244200,566500
330160,202109,209,120,89,132000,99000,231000
330170,202109,27297,9064,18233,9981400.33,20089520,30070920.33
330180,202109,241,131,110,144100,121000,265100
330185,202109,1030,356,674,391600,741400,1133000
330187,202109,457,127,330,139700,363000,502700
330190,202109,6112,2230,3882,2454100,4274600,6728700
330200,202109,4717,1408,3309,1551001.73,3644300,5195301.73
330205,202109,449,251,198,276100,217800,493900
330210,202109,946,566,380,622600,418000,1040600
330220,202109,2715,1580,1135,1740200,1248500,2988700
330225,202109,567,285,282,313500,310200,623700
330227,202109,2434,727,1707,799700,1883200,2682900
330230,202109,267,142,125,156200,137500,293700
330240,202109,4058,1944,2114,2140600,2328700,4469300
330245,202109,148,62,86,69300,94600,163900
330250,202109,6773,3290,3483,3621200,3834600,7455800
330260,202109,679,174,505,191400,555500,746900
330270,202109,3816,1211,2605,1333200,2865500,4198700
330280,202109,448,275,173,302500,190300,492800
330285,202109,6899,2094,4805,2305600,5289900,7595500
330290,202109,692,246,446,270600,491700,762300
330300,202109,748,475,273,524275.4,300300,824575.4
330310,202109,446,242,204,266200,224400,490600
330320,202109,8036,2836,5200,3122900,5731097.9,8853997.9
330330,202109,9376,3427,5949,3774100.02,6554900,10329000.02
330340,202109,2697,1533,1164,1687400,1284800,2972200
330350,202109,19311,7020,12291,7726400.35,13539900.67,21266301.02
330360,202109,2141,997,1144,1096700,1262800,2359500
330370,202109,993,492,501,542300,552200,1094500
330380,202109,928,381,547,419100,601700.01,1020800.01
330385,202109,637,318,319,350900,352000,702900
330390,202109,5897,3021,2876,3330800,3166900,6497700
330395,202109,327,196,131,215600,145200,360800
330400,202109,708,356,352,392700,387200,779900
330410,202109,503,357,146,392700,160600,553300
330411,202109,280,142,138,156200,151800,308000
330412,202109,224,90,134,99000,147400,246400
330414,202109,5420,2126,3294,2340800,3624500,5965300
330415,202109,604,263,341,289300,376200,665500
330420,202109,2308,1164,1144,1282600,1259500,2542100
330430,202109,1800,774,1026,852500,1129700,1982200
330440,202109,336,155,181,170500,199100,369600
330450,202109,117,51,66,56100,72600,128700
330452,202109,2254,957,1297,1052700,1426700.14,2479400.14
330455,202109,118820,39895,78925,43920895.3,86940705.36,130861600.66
330460,202109,252,108,144,118800,158400,277200
330470,202109,1239,669,570,735900,627000,1362900
330475,202109,1697,462,1235,508200,1360700,1868900
330480,202109,820,442,378,488400,416900,905300
330490,202109,15605,4806,10799,5288905,11892100,17181005
330500,202109,1470,625,845,690800,930600,1621400
330510,202109,11085,3702,7383,4082100,8126800,12208900
330513,202109,100,51,49,56100,53900,110000
330515,202109,748,310,438,341000,481800,822800
330520,202109,2544,865,1679,952600,1853500,2806100
330530,202109,196,110,86,121000,94600,215600
330540,202109,343,170,173,187000,190300,377300
330550,202109,2857,955,1902,1050500,2093300,3143800
330555,202109,804,306,498,336600,550000,886600
330560,202109,712,234,478,257400,529100,786500
330570,202109,285,197,88,216700,96800,313500
330575,202109,812,283,529,311300,583000,894300
330580,202109,3381,1826,1555,2014100,1711600,3725700
330590,202109,266,136,130,149600.5,144100,293700.5
330600,202109,1261,762,499,839300,550000,1389300
330610,202109,1623,847,776,931700,853600,1785300
330615,202109,218,173,45,190300.81,50600,240900.81
330620,202109,1053,393,660,432300,729300,1161600
330630,202109,4258,2549,1709,2807201.64,1882100,4689301.64
350010,202109,585,384,201,422400.88,221100,643500.88
350020,202109,54,19,35,20900,38500,59400
350030,202109,521,322,199,354200,218900,573100
350040,202109,126,52,74,57200,81400,138600
350050,202109,336,171,165,188100,181500,369600
350055,202109,117,52,65,57200,71500,128700
350060,202109,86,31,55,34100,60500,94600
350070,202109,787,459,328,507100.2,360800,867900.2
350075,202109,75,48,27,52800,30800,83600
350080,202109,59,27,32,29700,35200,64900
350090,202109,82,46,36,50600,39600,90200
350100,202109,272,169,103,187000,114400,301400
350110,202109,49,33,16,36300,17600,53900
350115,202109,154,91,63,100100,69300,169400
350120,202109,106,68,38,74800,41800,116600
350130,202109,379,161,218,177100.56,239800,416900.56
350140,202109,41,26,15,28600,16500,45100
350150,202109,75,55,20,60500,22000,82500
350160,202109,2391,937,1454,1031800,1600500,2632300
350170,202109,382,215,167,236500,183700,420200
350180,202109,165,96,69,106700,75900,182600
350190,202109,1019,537,482,592900.63,530200,1123100.63
350200,202109,65,24,41,26400,45100,71500
350210,202109,1290,705,585,777700,645700.63,1423400.63
350220,202109,645,527,118,580800.63,129800,710600.63
350230,202109,75,50,25,55000,27500,82500
350240,202109,58,38,20,41800,22000,63800
350250,202109,1161,533,628,587400,691900,1279300
350260,202109,102,73,29,80300,31900,112200
350270,202109,915,605,310,665500,341000,1006500
350275,202109,303,117,186,128700,204600,333300
350280,202109,4465,2186,2279,2405700,2510200,4915900
350290,202109,467,202,265,222200,292600,514800
350300,202109,53,26,27,28600,29700,58300
350310,202109,79,50,29,55000,31900,86900
350315,202109,64,28,36,30800,39600,70400
350320,202109,3305,1572,1733,1731400,1908500,3639900
350330,202109,1663,868,795,955901.66,875600,1831501.66
350335,202109,16,10,6,11000,6600,17600
350340,202109,125,53,72,58300,79200,137500
350350,202109,104,52,52,57200,57200,114400
350360,202109,107,71,36,78100,39600,117700
350370,202109,80,43,37,47300.63,40700,88000.63
350380,202109,779,322,457,355300,502700,858000
350390,202109,1696,605,1091,665500.5,1201200,1866700.5
350395,202109,20,16,4,17600,4400,22000
350400,202109,1696,824,872,908601.89,959200.63,1867802.52
350410,202109,2901,1215,1686,1338700,1855700.63,3194400.63
350420,202109,253,150,103,165000,113300,278300
350430,202109,82,44,38,48400,41800,90200
350440,202109,152,109,43,119900,47300,167200
350450,202109,1723,973,750,1071400.63,825000,1896400.63
350460,202109,405,139,266,154000,293700,447700
350470,202109,20,12,8,13200,8800,22000
350480,202109,188,100,88,110000,96800,206800
350490,202109,247,117,130,128700,143000,271700
350500,202109,57,25,32,27500,35200,62700
350510,202109,159,98,61,107800,67100,174900
350520,202109,434,223,211,245300,232100,477400
350530,202109,451,207,244,229900,268400,498300
350535,202109,82,60,22,66000,24200,90200
350540,202109,366,192,174,212300,191400,403700
350550,202109,2705,1534,1171,1687400,1290301.26,2977701.26
350560,202109,595,402,193,443300,212300,655600
350570,202109,4338,1754,2584,1930500.63,2842401.27,4772901.90
350580,202109,356,175,181,193600,199100,392700
350590,202109,941,507,434,559900,478500,1038400
350600,202109,6166,2889,3277,3181200.25,3613500,6794700.25
350610,202109,1490,770,720,848100,793100,1641200
350620,202109,26,15,11,16500,12100,28600
350630,202109,248,125,123,138600.63,136400,275000.63
350635,202109,1050,405,645,445500,709500,1155000
350640,202109,116,87,29,95700,31900,127600
350650,202109,1871,1235,636,1359600,699600,2059200
350660,202109,754,301,453,331100,498300,829400
350670,202109,293,145,148,159500,163900,323400
350680,202109,170,84,86,92400,94600,187000
350690,202109,193,88,105,96800,115500,212300
350700,202109,838,392,446,431200,490600,921800
350710,202109,394,142,252,156200,278300,434500
350715,202109,53,41,12,46200,13200,59400
350720,202109,16,10,6,11000,6600,17600
350730,202109,44,26,18,28600,19800,48400
350740,202109,231,127,104,139700,114400,254100
350745,202109,26,10,16,11000,17600,28600
350750,202109,2294,1358,936,1494900,1030700,2525600
350760,202109,3745,1541,2204,1698400,2425500,4123900
350770,202109,57,40,17,44000,18700,62700
350775,202109,47,34,13,37400,14300,51700
350780,202109,425,217,208,238700,229900,468600
350790,202109,362,149,213,163900,234300,398200
350800,202109,506,300,206,330000,227700,557700
350810,202109,512,401,111,441100,122100,563200
350820,202109,91,51,40,56100,44000,100100
350830,202109,74,39,35,42900,38500,81400
350840,202109,778,307,471,337700,519200,856900
350850,202109,1819,955,864,1051600,951500,2003100
350860,202109,636,336,300,369600,331100,700700
350870,202109,431,282,149,310200,163900,474100
350880,202109,266,152,114,167200,125400,292600
350890,202109,38,23,15,25300,16500,41800
350900,202109,1566,468,1098,515900,1208900.63,1724800.63
350910,202109,24,14,10,15400,11000,26400
350920,202109,724,374,350,412500,385000,797500
350925,202109,1137,597,540,656700,594000.63,1250700.63
350930,202109,103,55,48,60500,52800,113300
350940,202109,744,392,352,431200,388300,819500
350945,202109,110,79,31,86900,34100,121000
350950,202109,16785,7591,9194,8361101.84,10124400,18485501.84
350960,202109,1504,604,900,667700,991100.94,1658800.94
350970,202109,1070,545,525,599381.2,577500,1176881.2
350980,202109,97,64,33,70400,36300,106700
350990,202109,374,134,240,147400,264000,411400
350995,202109,38,18,20,20900,23100,44000
351000,202109,610,409,201,449900.63,222200,672100.63
351010,202109,50,31,19,34100,20900,55000
351015,202109,47,32,15,35200,16500,51700
351020,202109,1506,890,616,980100,678700,1658800
351030,202109,347,207,140,227700,154000,381700
351040,202109,943,467,476,513700,525800.2,1039500.2
351050,202109,3389,1504,1885,1657700,2073500,3731200
351060,202109,5641,2049,3592,2257200.82,3955600,6212800.82
351070,202109,391,245,146,270600.63,160600,431200.63
351080,202109,710,511,199,562100,218900,781000
351090,202109,48,21,27,23100,29700,52800
351100,202109,418,227,191,249700,211200,460900
351110,202109,2028,935,1093,1029600.5,1202300,2231900.5
351120,202109,67,37,30,40700,33000,73700
351130,202109,187,60,127,66000,139700,205700
351140,202109,313,194,119,214500,130900,345400
351150,202109,456,236,220,259600,243100,502700
351160,202109,269,164,105,181500.4,115500,297000.4
351170,202109,195,101,94,111100,103400,214500
351190,202109,88,58,30,63800,33000,96800
351200,202109,350,222,128,244200,140800,385000
351210,202109,111,55,56,60500,61600,122100
351220,202109,538,317,221,348700,244200,592900
351230,202109,282,188,94,207900,103400,311300
351240,202109,241,114,127,125400,140800,266200
351250,202109,82,54,28,59400.5,30800,90200.5
351260,202109,150,107,43,117700,47300,165000
351270,202109,49,20,29,22000,31900,53900
351280,202109,1036,475,561,524700.63,617100.63,1141801.26
351290,202109,242,109,133,119900,146300,266200
351300,202109,3843,1660,2183,1828113.1,2401300,4229413.1
351310,202109,736,360,376,396000,413600,809600
351320,202109,115,66,49,72600,53900,126500
351330,202109,37,23,14,25300,15400,40700
351340,202109,1307,740,567,817300,623700,1441000
351350,202109,2371,1354,1017,1491600.04,1118700,2610300.04
351360,202109,786,375,411,412500,453200,865700
351370,202109,385,187,198,206800,218900,425700
351380,202109,8862,3857,5005,4249300,5507700.63,9757000.63
351385,202109,29,18,11,19800,12100,31900
351390,202109,278,208,70,228800,77000,305800
351400,202109,68,45,23,49500,25300,74800
351410,202109,436,268,168,295900.55,187000,482900.55
351420,202109,67,47,20,51700,22000,73700
351430,202109,74,40,34,45100,37400,82500
351440,202109,759,505,254,556601.26,279400,836001.26
351450,202109,267,128,139,140800,152900,293700
351460,202109,125,53,72,58300,79200,137500
351470,202109,144,78,66,85800,72600,158400
351480,202109,489,286,203,314600.63,223300,537900.63
351490,202109,288,103,185,113300,204600,317900
351492,202109,26,17,9,18700,9900,28600
351495,202109,27,18,9,19800,9900,29700
351500,202109,3487,1406,2081,1547443.33,2290200,3837643.33
351510,202109,2026,728,1298,801900.63,1432200,2234100.63
351512,202109,15,11,4,12100,4400,16500
351515,202109,191,112,79,123200,86900,210100
351518,202109,701,428,273,470800,300300,771100
351519,202109,79,44,35,48400,38500,86900
351520,202109,162,95,67,104500,73719.8,178219.8
351530,202109,25,15,10,16500,11000,27500
351535,202109,130,80,50,88000,55000,143000
351540,202109,456,307,149,337700,163900,501600
351550,202109,1455,844,611,929501.26,674300,1603801.26
351560,202109,79,47,32,51700,35200,86900
351565,202109,13,6,7,6600,7700,14300
351570,202109,2713,1265,1448,1391500,1597200,2988700
351580,202109,40,34,6,37400,6600,44000
351590,202109,62,40,22,44000,24200,68200
351600,202109,181,127,54,139700,60500,200200
351610,202109,50,21,29,23100,31900,55000
351620,202109,5775,3113,2662,3434200.19,2929300,6363500.19
351630,202109,3053,1451,1602,1597200,1765500,3362700
351640,202109,2151,919,1232,1010900.55,1356300.63,2367201.18
351650,202109,29,25,4,27500,4400,31900
351660,202109,131,83,48,91300,52800,144100
351670,202109,720,434,286,479600,314600,794200
351680,202109,68,55,13,61600,14300,75900
351685,202109,12,8,4,8800,4400,13200
351690,202109,300,199,101,218900.5,111100,330000.5
351700,202109,174,114,60,125637,66000,191637
351710,202109,66,42,24,46200,26400,72600
351720,202109,126,68,58,74800,63800,138600
351730,202109,111,71,40,78100,45100,123200
351740,202109,752,474,278,521400.74,305800,827200.74
351750,202109,360,143,217,157300,238700,396000
351760,202109,739,564,175,620400,192500,812900
351770,202109,304,246,58,270600.63,63800,334400.63
351780,202109,159,93,66,102300,73700,176000
351790,202109,250,127,123,139700,135300,275000
351800,202109,39,25,14,27500,16500,44000
351810,202109,119,79,40,86900,44000,130900
351820,202109,772,548,224,602800,246400,849200
351830,202109,571,184,387,202400,425700,628100
351840,202109,2025,932,1093,1026300,1203400,2229700
351850,202109,229,162,67,178200,73700,251900
351860,202109,624,423,201,465300,223300,688600
351870,202109,5645,2556,3089,2817102,3405601.38,6222703.38
351880,202109,20358,7891,12467,8686700.85,13734600.45,22421301.30
351885,202109,86,48,38,52800,41800,94600
351890,202109,66,49,17,53900,18700,72600
351900,202109,226,128,98,143000,108900,251900
351905,202109,96,42,54,46200,59400,105600
351907,202109,3540,1431,2109,1575200,2323200,3898400
351910,202109,170,70,100,77000,111100,188100
351920,202109,114,62,52,68200,57200,125400
351925,202109,90,56,34,61600,37400,99000
351930,202109,393,253,140,278300,154000,432300
351940,202109,241,98,143,107800,157300,265100
351950,202109,132,69,63,77000,69300,146300
351960,202109,926,449,477,494354.93,524700,1019054.93
351970,202109,2018,975,1043,1073600,1148400,2222000
351980,202109,152,67,85,73700,93500,167200
351990,202109,252,162,90,178200,99000,277200
352000,202109,324,203,121,225500,133100,358600
352010,202109,416,258,158,284971,173800,458771
352020,202109,179,64,115,70400,126500,196900
352030,202109,1110,543,567,598400,624800,1223200
352040,202109,602,242,360,266200,396000,662200
352042,202109,295,69,226,75900,248600,324500
352044,202109,354,207,147,227700.63,161700,389400.63
352050,202109,3222,1192,2030,1314500.63,2238500,3553000.63
352060,202109,102,58,44,63800,48400,112200
352070,202109,90,66,24,72601.26,26400,99001.26
352080,202109,62,42,20,46200,22000,68200
352090,202109,157,104,53,115500,58300,173800
352100,202109,290,136,154,150700,169400,320100
352110,202109,112,36,76,39600,83600,123200
352115,202109,62,18,44,19800,48400,68200
352120,202109,76,54,22,59400.63,24200,83600.63
352130,202109,218,170,48,187000,52800,239800
352140,202109,171,80,91,88000,101200,189200
352150,202109,123,64,59,70400,64900,135300
352160,202109,140,91,49,100100,53900,154000
352170,202109,387,262,125,288200,137500,425700
352180,202109,659,402,257,443300.63,282700,726000.63
352190,202109,243,98,145,107800,159500,267300
352200,202109,30,14,16,15400,17600,33000
352210,202109,4281,1695,2586,1866700.95,2845700,4712400.95
352215,202109,68,39,29,42900,31900,74800
352220,202109,6515,2404,4111,2648800,4528700.63,7177500.63
352230,202109,3395,2164,1231,2382601.13,1355201.05,3737802.18
352240,202109,2574,1452,1122,1599400,1236400,2835800
352250,202109,3031,1372,1659,1509201.26,1828200,3337401.26
352260,202109,1001,529,472,584100,521400,1105500
352265,202109,60,32,28,35200,30800,66000
352270,202109,379,209,170,232100,188100,420200
352280,202109,481,287,194,315700.63,215600,531300.63
352290,202109,181,103,78,113300,85800,199100
352300,202109,96,65,31,71500,34100,105600
352310,202109,6635,2818,3817,3103101.62,4204200,7307301.62
352320,202109,1108,561,547,618200.93,603900,1222100.93
352330,202109,527,264,263,290400,289300,579700
352340,202109,1371,622,749,686400,825000,1511400
352350,202109,354,198,156,217800,171600,389400
352360,202109,224,97,127,106700,139700,246400
352370,202109,112,72,40,79200,44000,123200
352380,202109,106,73,33,80300,36300,116600
352390,202109,2573,1099,1474,1208900,1624700,2833600
352400,202109,519,225,294,247500,324500,572000
352410,202109,908,605,303,666600.63,333300,999900.63
352420,202109,93,68,25,74800,27500,102300
352430,202109,1762,786,976,867901.89,1073601.26,1941503.15
352440,202109,3286,1546,1740,1701700,1915100,3616800
352450,202109,206,157,49,172700,53900,226600
352460,202109,627,313,314,344300,346500,690800
352470,202109,649,225,424,247500,466400,713900
352480,202109,1481,800,681,881100,749100,1630200
352490,202109,44,15,29,16500,31900,48400
352500,202109,1267,518,749,569800,825000,1394800
352510,202109,710,375,335,412500,369600,782100
352520,202109,816,337,479,371800,526900,898700
352530,202109,1771,911,860,1003200,946000,1949200
352540,202109,68,45,23,49500,25300,74800
352550,202109,188,110,78,121000,85800,206800
352560,202109,47,38,9,41800,9900,51700
352570,202109,707,334,373,368500.63,411400,779900.63
352580,202109,59,45,14,50600,15400,66000
352585,202109,22,5,17,5500,18700,24200
352590,202109,4306,2071,2235,2280300.63,2462997,4743297.63
352600,202109,355,244,111,269500,122100,391600
352610,202109,911,406,505,446600,556600,1003200
352620,202109,1066,391,675,430100,742500,1172600
352630,202109,184,65,119,71500,130900,202400
352640,202109,521,335,186,368500,204600,573100
352650,202109,80,60,20,66000,22000,88000
352660,202109,66,39,27,42900,29700,72600
352670,202109,1678,876,802,965801.32,882200,1848001.32
352680,202109,912,557,355,616000,390500.63,1006500.63
352690,202109,4537,1992,2545,2192301.26,2800600.63,4992901.89
352700,202109,93,55,38,60500,41800,102300
352710,202109,1470,752,718,830500,790900,1621400
352720,202109,1440,634,806,697400,886600,1584000
352725,202109,22,17,5,18700,5500,24200
352730,202109,390,184,206,203500,226600,430100
352740,202109,399,260,139,287100,152900.8,440000.8
352750,202109,23,15,8,17600,8800,26400
352760,202109,206,128,78,140800,85800,226600
352770,202109,83,62,21,68200,23100,91300
352780,202109,72,38,34,41800,37400,79200
352790,202109,23,17,6,18700,6600,25300
352800,202109,230,177,53,194700,60500,255200
352810,202109,156,97,59,106700,64900,171600
352820,202109,45,34,11,37400,12100,49500
352830,202109,74,48,26,52800,28600,81400
352840,202109,655,301,354,331100,389400,720500
352850,202109,1667,513,1154,565400,1271600,1837000
352860,202109,111,71,40,79200,44000,123200
352870,202109,48,30,18,33000,19800,52800
352880,202109,175,111,64,122100,70400,192500
352885,202109,32,22,10,24200,11000,35200
352890,202109,53,35,18,38500,19800,58300
352900,202109,4648,2187,2461,2413400,2711500,5124900
352910,202109,37,30,7,33000,7700,40700
352920,202109,647,374,273,413600,300300,713900
352930,202109,1184,553,631,608300,696300,1304600
352940,202109,6121,2393,3728,2637800,4105200,6743000
352950,202109,113,42,71,46200,78100,124300
352960,202109,63,38,25,41800,27500,69300
352965,202109,15,8,7,8800,7700,16500
352970,202109,513,376,137,413600,150700,564300
352980,202109,164,93,71,102300,78100,180400
352990,202109,986,457,529,502700,581900,1084600
353000,202109,56,24,32,26400,35200,61600
353010,202109,521,320,201,352000,221100,573100
353020,202109,302,210,92,231000,101200,332200
353030,202109,1286,567,719,623700,793100,1416800
353040,202109,78,40,38,44000,41800,85800
353050,202109,1289,829,460,913000.9,506000,1419000.9
353060,202109,8554,3547,5007,3903901.19,5508800,9412701.19
353070,202109,1839,1084,755,1192400.63,831404.2,2023804.83
353080,202109,1270,682,588,751300.92,649000,1400300.92
353090,202109,58,31,27,34100,29700,63800
353100,202109,44,35,9,38500,9900,48400
353110,202109,2138,672,1466,743600,1613700,2357300
353120,202109,109,57,52,62700,57200,119900
353130,202109,858,412,446,453200.92,490600,943800.92
353140,202109,558,233,325,256300.63,358600,614900.63
353150,202109,329,181,148,199100.63,162800,361900.63
353160,202109,105,80,25,88000,27500,115500
353170,202109,210,68,142,74800,156200,231000
353180,202109,1124,509,615,559900,678700,1238600
353190,202109,466,331,135,367400,148500,515900
353200,202109,236,113,123,124300,136400,260700
353205,202109,20,13,7,14300,7700,22000
353210,202109,64,36,28,39600,30800,70400
353215,202109,40,22,18,24200,19800,44000
353220,202109,82,42,40,46200,44000,90200
353230,202109,155,63,92,69300,101200,170500
353240,202109,340,161,179,177100,198000,375100
353250,202109,200,98,102,107800,112200,220000
353260,202109,455,300,155,330000,170500,500500
353270,202109,73,53,20,58300,22000,80300
353280,202109,102,49,53,53900,58300,112200
353282,202109,129,88,41,96800,45100,141900
353284,202109,25,18,7,19800,7700,27500
353286,202109,3,1,2,1100,2200,3300
353290,202109,83,48,35,52800,38500,91300
353300,202109,442,226,216,248600.63,237600,486200.63
353310,202109,43,36,7,39600,7700,47300
353320,202109,37,21,16,23100,17600,40700
353325,202109,48,28,20,30800,22000,52800
353330,202109,64,42,22,46200,24200,70400
353340,202109,628,216,412,237600,454300,691900
353350,202109,887,430,457,475200,502700,977900
353360,202109,99,78,21,85800,23100,108900
353370,202109,111,66,45,72600,49500,122100
353380,202109,27,13,14,14300,15400,29700
353390,202109,1104,518,586,570900,644600,1215500
353400,202109,48,28,20,30800,22000,52800
353410,202109,112,64,48,70400,52800,123200
353420,202109,57,22,35,24200,38500,62700
353430,202109,576,372,204,410301.13,224400,634701.13
353440,202109,11791,4996,6795,5502200.63,7482200,12984400.63
353450,202109,57,28,29,30800,31900,62700
353460,202109,619,320,299,352000,328900,680900
353470,202109,2250,1099,1151,1210000.6,1266100,2476100.6
353475,202109,253,167,86,183700,94600,278300
353480,202109,178,144,34,160600,37400,198000
353490,202109,229,135,94,148500,103400,251900
353500,202109,209,119,90,130900,99000,229900
353510,202109,87,59,28,64900,30800,95700
353520,202109,219,157,62,172700,68200,240900
353530,202109,461,241,220,265100,242000,507100
353540,202109,391,241,150,266200,165000,431200
353550,202109,709,443,266,489500.63,292600,782100.63
353560,202109,570,228,342,250800,376200,627000
353570,202109,65,36,29,39600,31900,71500
353580,202109,341,237,104,261800,114400,376200
353590,202109,80,57,23,62700,25300,88000
353600,202109,265,152,113,168300.63,125400,293700.63
353610,202109,132,67,65,73700,71500,145200
353620,202109,665,335,330,368500,363000,731500
353625,202109,55,29,26,31900,28600,60500
353630,202109,220,157,63,172700,69300,242000
353640,202109,121,78,43,85800,47300,133100
353650,202109,958,358,600,393800.5,662200,1056000.5
353657,202109,22,17,5,18700,5500,24200
353660,202109,282,148,134,163900,147400,311300
353670,202109,719,415,304,458700.63,336600,795300.63
353680,202109,120,81,39,89100,42900,132000
353690,202109,41,29,12,31900,13200,45100
353700,202109,281,192,89,211200.8,97900,309100.8
353710,202109,497,232,265,256300,291500,547800
353715,202109,49,31,18,34100,19800,53900
353720,202109,343,150,193,165000,212300,377300
353730,202109,1144,704,440,774400,484000,1258400
353740,202109,614,335,279,371800,308000,679800
353750,202109,71,41,30,45100,33000,78100
353760,202109,3181,1183,1998,1301300.98,2200000.9,3501301.88
353770,202109,77,63,14,69300,15400,84700
353780,202109,1298,598,700,658900.63,770000,1428900.63
353790,202109,489,288,201,316800,221100,537900
353800,202109,3535,1662,1873,1832620,2062574,3895194
353810,202109,230,119,111,132000,122100,254100
353820,202109,220,90,130,99000,143000,242000
353830,202109,58,47,11,51700,12100,63800
353850,202109,186,90,96,99000,105600,204600
353860,202109,522,223,299,245300,331100,576400
353870,202109,5516,2746,2770,3023900,3050300,6074200
353880,202109,708,465,243,512600,267300,779900
353890,202109,548,318,230,349800,253000.59,602800.59
353900,202109,132,69,63,75900,69300,145200
353910,202109,193,85,108,93500,118800,212300
353920,202109,417,223,194,245300,213400,458700
353930,202109,1050,604,446,665500,492800,1158300
353940,202109,194,99,95,108900,104500,213400
353950,202109,487,305,182,335500,200200,535700
353960,202109,77,62,15,68200,16500,84700
353970,202109,42,27,15,29700,16500,46200
353980,202109,1773,784,989,862400,1091200,1953600
353990,202109,78,44,34,48400,38500,86900
354000,202109,382,174,208,193600,228800,422400
354010,202109,91,52,39,57200,42900,100100
354020,202109,496,311,185,342100,204600,546700
354025,202109,33,29,4,31900,4400,36300
354030,202109,46,26,20,28600,22000,50600
354040,202109,98,73,25,80300,27500,107800
354050,202109,178,95,83,104500.63,91300,195800.63
354060,202109,749,354,395,390500,435600,826100
354070,202109,915,513,402,566500,442200,1008700
354075,202109,183,85,98,93500,107800,201300
354080,202109,304,131,173,144100,190300,334400
354085,202109,23,13,10,14300,11000,25300
354090,202109,272,165,107,182507,117700,300207
354100,202109,5705,2313,3392,2544300.4,3738900,6283200.4
354105,202109,96,46,50,50600,55000,105600
354110,202109,43,21,22,23100,24200,47300
354120,202109,146,96,50,105600.93,55000,160600.93
354130,202109,705,427,278,470800.81,306900,777700.81
354140,202109,3195,1431,1764,1575200.55,1940400,3515600.55
354150,202109,635,365,270,401500.66,298100,699600.66
354160,202109,641,400,241,440000,265100,705100
354165,202109,15,13,2,14300,2200,16500
354170,202109,171,118,53,129800,58300,188100
354180,202109,60,36,24,39600.42,26400,66000.42
354190,202109,198,78,120,85800,133100,218900
354200,202109,109,54,55,60500,60500,121000
354210,202109,66,23,43,25300,47300,72600
354220,202109,628,396,232,435600.63,255200,690800.63
354230,202109,171,75,96,82500,105600,188100
354240,202109,330,209,121,229900.82,133100,363000.82
354250,202109,82,49,33,55000,36300,91300
354260,202109,2134,989,1145,1089000.5,1262800.85,2351801.35
354270,202109,88,63,25,69300,27500,96800
354280,202109,49,25,24,27500,26400,53900
354290,202109,141,95,46,104500,50600,155100
354300,202109,356,244,112,268400.63,123200,391600.63
354310,202109,92,66,26,72600,28600,101200
354320,202109,217,103,114,113300,125400,238700
354323,202109,9,8,1,8800,1100,9900
354325,202109,123,66,57,72600.83,62700,135300.83
354330,202109,2427,812,1615,893043,1776500,2669543
354340,202109,10260,4733,5527,5209368,6087400,11296768
354350,202109,139,89,50,97900,55000,152900
354360,202109,71,41,30,45100,33000,78100
354370,202109,238,121,117,133100,128700,261800
354380,202109,170,98,72,107800,79200,187000
354390,202109,2690,950,1740,1047200,1916200,2963400
354400,202109,289,162,127,179300,139700,319000
354410,202109,637,284,353,312400,388300,700700
354420,202109,270,169,101,185900,111100,297000
354425,202109,320,177,143,195851,157300,353151
354430,202109,192,107,85,117700,94600,212300
354440,202109,32,25,7,27500,7700,35200
354450,202109,54,34,20,37400,22000,59400
354460,202109,95,55,40,60500,44000,104500
354470,202109,27,14,13,15400,14300,29700
354480,202109,105,56,49,61600,53900,115500
354490,202109,137,83,54,91300,59400,150700
354500,202109,388,174,214,191400,235400,426800
354510,202109,94,62,32,68200,35200,103400
354515,202109,43,11,32,12100,35200,47300
354520,202109,1605,673,932,741243,1025200,1766443
354530,202109,799,399,400,438900,442200,881100
354540,202109,269,137,132,150700,145200,295900
354550,202109,39,23,16,25300,17600,42900
354560,202109,151,80,71,88000,78100,166100
354570,202109,135,90,45,99000,49500,148500
354580,202109,1816,849,967,935000,1064800,1999800
354600,202109,266,135,131,149600,144100,293700
354610,202109,69,57,12,62700,13200,75900
354620,202109,67,17,50,18700,55000,73700
354625,202109,12,8,4,8800,4400,13200
354630,202109,312,199,113,218900,124300,343200
354640,202109,813,500,313,551100,344300,895400
354650,202109,67,38,29,41800,31900,73700
354660,202109,791,580,211,638000,233200,871200
354670,202109,225,83,142,91300,156200,247500
354680,202109,1302,453,849,498300,935000,1433300
354690,202109,74,50,24,56100,26400,82500
354700,202109,72,50,22,55000,25300,80300
354710,202109,47,34,13,37400,14300,51700
354720,202109,21,20,1,22000,1100,23100
354730,202109,1761,708,1053,778800.86,1161600,1940400.86
354740,202109,74,51,23,56100,25300,81400
354750,202109,413,237,176,260700,195800,456500
354760,202109,485,297,188,327800,209000,536800
354765,202109,9,4,5,4400,5500,9900
354770,202109,347,228,119,250800,132000,382800
354780,202109,8266,3105,5161,3416601.13,5685900,9102501.13
354790,202109,90,54,36,59400,39600,99000
354800,202109,442,240,202,265055.32,222200,487255.32
354805,202109,81,38,43,41800,47300,89100
354810,202109,100,57,43,62700,47300,110000
354820,202109,204,83,121,91300,133100,224400
354830,202109,44,23,21,25300,23100,48400
354840,202109,57,39,18,42900,19800,62700
354850,202109,4466,1930,2536,2123000.08,2792900.06,4915900.14
354860,202109,338,159,179,174900,196900,371800
354870,202109,11934,5151,6783,5668301.26,7470100.97,13138402.23
354880,202109,2691,968,1723,1064800.89,1897551.7,2962352.59
354890,202109,2889,1511,1378,1663200.63,1520200,3183400.63
354900,202109,64,42,22,46200,24200,70400
354910,202109,1279,643,636,709500,699600,1409100
354920,202109,39,32,7,35200,7700,42900
354925,202109,17,8,9,8800,9900,18700
354930,202109,37,32,5,35200.4,5500,40700.4
354940,202109,784,555,229,610500,251900,862400
354950,202109,210,127,83,139700,91300,231000
354960,202109,133,50,83,55000,92400,147400
354970,202109,1032,696,336,765601.26,369600,1135201.26
354980,202109,8987,3174,5813,3493602.15,6400900.39,9894502.54
354990,202109,9835,4329,5506,4764100,6059900,10824000
354995,202109,552,174,378,191400,415800,607200
355000,202109,460,159,301,174900,331100,506000
355010,202109,590,356,234,392700,257400.63,650100.63
355020,202109,777,476,301,523600,331100,854700
355030,202109,210737,77945,132792,85831556.59,146231845.49,232063402.08
355040,202109,856,394,462,433400,508200,941600
355050,202109,163,93,70,102300,77000,179300
355060,202109,1695,808,887,891000,976800,1867800
355070,202109,1535,696,839,765600.08,924000.73,1689600.81
355080,202109,189,114,75,125400,82500,207900
355090,202109,282,165,117,182600,128700.57,311300.57
355100,202109,5224,2445,2779,2693790,3064600,5758390
355110,202109,240,157,83,174900,91300,266200
355120,202109,58,38,20,41800,22000,63800
355130,202109,49,28,21,30800,23100,53900
355140,202109,192,114,78,125400,86900,212300
355150,202109,677,395,282,435600,310200,745800
355160,202109,478,226,252,248600.63,277200,525800.63
355170,202109,2058,1049,1009,1153900,1111000,2264900
355180,202109,690,276,414,303600,455400,759000
355190,202109,214,146,68,160600,74800,235400
355200,202109,108,57,51,62700,56100,118800
355210,202109,710,389,321,427900,353100,781000
355220,202109,7410,3661,3749,4028200,4134900,8163100
355230,202109,94,55,39,60500,42900,103400
355240,202109,4541,1846,2695,2032800.5,2966700,4999500.5
355250,202109,6159,2606,3553,2872121.06,3911600,6783721.06
355255,202109,48,29,19,31900,20900,52800
355260,202109,177,107,70,117700,77000,194700
355270,202109,168,109,59,119900,64900,184800
355280,202109,6731,2486,4245,2741200,4677200.53,7418400.53
355290,202109,70,57,13,62700,14300,77000
355300,202109,220,125,95,137500,104500,242000
355310,202109,110,55,55,60500,60500,121000
355320,202109,95,49,46,53900,50600,104500
355330,202109,289,163,126,179300,138600,317900
355340,202109,1432,487,945,536801.18,1043900,1580701.18
355350,202109,157,75,82,82500,90200,172700
355360,202109,173,114,59,125400,64900,190300
355365,202109,17,13,4,14300,4400,18700
355370,202109,1021,616,405,677600.63,446600,1124200.63
355380,202109,809,502,307,552200.63,337700,889900.63
355385,202109,82,53,29,58300,31900,90200
355390,202109,112,58,54,63800,59400,123200
355395,202109,192,102,90,112200.5,99000,211200.5
355400,202109,1734,994,740,1093309,815100.63,1908409.63
355410,202109,4978,2279,2699,2511300,2972200,5483500
355420,202109,49,35,14,38500,15400,53900
355430,202109,401,247,154,271700,169400,441100
355440,202109,84,50,34,55000,37400,92400
355450,202109,429,211,218,232100,239800,471900
355460,202109,56,44,12,48400,13200,61600
355465,202109,48,27,21,29700,23100,52800
355470,202109,181,71,110,78100,121000,199100
355475,202109,12,8,4,8800,4400,13200
355480,202109,585,231,354,255200,390500,645700
355490,202109,110,74,36,81400,39600,121000
355495,202109,76,27,49,29700,53900,83600
355500,202109,1585,855,730,942700.48,809600,1752300.48
355510,202109,272,194,78,213400.63,85800,299200.63
355520,202109,28,21,7,23100,7700,30800
355530,202109,23,12,11,13200,12100,25300
355535,202109,73,34,39,37400,42900,80300
355540,202109,2593,1002,1591,1104555.1,1753400.82,2857955.92
355550,202109,59,35,24,38500,26400,64900
355560,202109,239,107,132,117700,145200,262900
355570,202109,20,13,7,14300,7700,22000
355580,202109,242,169,73,187000,80300,267300
355590,202109,17,9,8,9900,8800,18700
355600,202109,267,130,137,143000,150700,293700
355610,202109,231,145,86,160600,94600,255200
355620,202109,1297,558,739,613800,814000,1427800
355630,202109,411,303,108,333300,118800,452100
355635,202109,122,54,68,59400,74800,134200
355640,202109,535,290,245,319000,269500,588500
355645,202109,879,334,545,368500,599500,968000
355650,202109,1929,814,1115,895400,1226500,2121900
355660,202109,233,123,110,135300,121000,256300
355670,202109,599,244,355,269500,390500,660000
355680,202109,206,114,92,125400,101200,226600
355690,202109,89,44,45,48400,49500,97900
355695,202109,23,14,9,15400,9900,25300
355700,202109,1174,587,587,645700,646800,1292500
355710,202109,2223,1196,1027,1316700,1134100,2450800
355715,202109,13,11,2,12100,2200,14300
355720,202109,243,148,95,162800,104500,267300
355730,202109,103,61,42,69300,46200,115500
410010,202109,135,107,28,117700,30800,148500
410020,202109,117,87,30,95700,33000,128700
410030,202109,173,96,77,105600,85800,191400
410040,202109,1270,618,652,679800,718300,1398100
410045,202109,45,34,11,37400,12100,49500
410050,202109,503,287,216,316800,237600,554400
410060,202109,284,207,77,228800,84700,313500
410070,202109,289,244,45,268400,49500,317900
410080,202109,177,104,73,114400,80300,194700
410090,202109,72,61,11,67100,12100,79200
410100,202109,255,169,86,185900,94600,280500
410105,202109,43,25,18,27500,19800,47300
410110,202109,334,199,135,218900,148500,367400
410115,202109,44,27,17,29700,18700,48400
410120,202109,432,201,231,221100,255200,476300
410130,202109,54,30,24,33000,26400,59400
410140,202109,3146,1428,1718,1570800.03,1889800.88,3460600.91
410150,202109,2674,1039,1635,1144000,1801800,2945800
410160,202109,490,288,202,316800,222200,539000
410165,202109,50,28,22,30800,24200,55000
410170,202109,190,116,74,128700,82500,211200
410180,202109,2282,1225,1057,1348600,1167100,2515700
410185,202109,31,27,4,29700,4400,34100
410190,202109,485,307,178,337700,195800,533500
410200,202109,962,677,285,744700,313500,1058200
410210,202109,615,314,301,345400,332200,677600
410220,202109,47,21,26,23100,28600,51700
410230,202109,167,77,90,84700,99000,183700
410240,202109,732,463,269,509300,295900,805200
410250,202109,378,265,113,291500,124300,415800
410260,202109,301,162,139,178200,152900,331100
410270,202109,28,21,7,23100,7700,30800
410275,202109,61,45,16,49500,17600,67100
410280,202109,323,183,140,201300,154000,355300
410290,202109,271,153,118,168300,129800,298100
410300,202109,82,53,29,58300,31900,90200
410302,202109,24,15,9,16500,9900,26400
410304,202109,37,24,13,26400,14300,40700
410305,202109,223,120,103,132000,113300,245300
410310,202109,206,122,84,134200,92400,226600
410315,202109,45,31,14,34100,15400,49500
410320,202109,141,92,49,101200,53900,155100
410322,202109,33,20,13,22000,14300,36300
410330,202109,179,119,60,130900,67100,198000
410335,202109,102,57,45,62700,49500,112200
410337,202109,42,32,10,35200,11000,46200
410340,202109,41,34,7,37400,7700,45100
410345,202109,205,120,85,132000,94600,226600
410347,202109,46,36,10,39600,11000,50600
410350,202109,256,147,109,161700,119900,281600
410360,202109,428,265,163,294800,179300,474100
410370,202109,2320,945,1375,1039500,1513600,2553100
410380,202109,196,114,82,125400,90200,215600
410390,202109,385,257,128,283800,140800,424600
410395,202109,34,21,13,23100,14300,37400
410400,202109,842,357,485,392700.5,533500,926200.5
410405,202109,81,62,19,68200,20900,89100
410410,202109,25,16,9,17600,9900,27500
410420,202109,1723,779,944,856802.1,1040600,1897402.1
410425,202109,185,72,113,79200,124300,203500
410430,202109,2304,1218,1086,1340900,1196800,2537700
410440,202109,371,267,104,293700,114400,408100
410442,202109,364,233,131,256300,144100,400400
410445,202109,418,295,123,324500,135300,459800
410450,202109,388,186,202,206286.66,222200,428486.66
410460,202109,555,281,274,309100,301400,610500
410465,202109,245,137,108,150700,118800,269500
410470,202109,261,144,117,158400,128700,287100
410480,202109,6463,3058,3405,3371536.66,3748800,7120336.66
410490,202109,1413,817,596,898700,655600,1554300
410500,202109,270,155,115,170500,126500,297000
410510,202109,174,128,46,140800,50600,191400
410520,202109,263,189,74,207900,81400,289300
410530,202109,300,97,203,106700,224400,331100
410540,202109,334,244,90,269500,99000,368500
410550,202109,1695,691,1004,761200,1105500,1866700
410560,202109,152,102,50,113300,55000,168300
410570,202109,445,293,152,322300,167200,489500
410580,202109,3603,1500,2103,1652200.2,2314400,3966600.2
410590,202109,412,268,144,294781,158400,453181
410600,202109,192,168,24,185900,26400,212300
410610,202109,51,42,9,46200,9900,56100
410620,202109,262,171,91,188100.4,100100,288200.4
410630,202109,446,243,203,267300,223300,490600
410640,202109,1038,637,401,700700,442200,1142900
410645,202109,113,81,32,89100,35200,124300
410650,202109,362,224,138,247500,152900,400400
410655,202109,88,61,27,67100,29700,96800
410657,202109,34,10,24,11000,26400,37400
410660,202109,626,416,210,458700.5,231000,689700.5
410670,202109,78,64,14,70400,15400,85800
410680,202109,189,152,37,167200,40700,207900
410685,202109,29,18,11,19800,12100,31900
410690,202109,28596,11691,16905,12875500,18631800.74,31507300.74
410700,202109,322,233,89,257400,97900,355300
410710,202109,131,106,25,116600,27500,144100
410712,202109,46,33,13,36300,14300,50600
410715,202109,88,68,20,74800,22000,96800
410720,202109,669,378,291,415800,323400,739200
410725,202109,180,128,52,140800,57200,198000
410730,202109,104,48,56,52800,61600,114400
410740,202109,104,73,31,80300,34100,114400
410750,202109,288,189,99,207900,108900,316800
410752,202109,21,14,7,15400,7700,23100
410753,202109,60,22,38,24200,41800,66000
410754,202109,53,25,28,27500,30800,58300
410755,202109,77,44,33,48400,36300,84700
410760,202109,757,405,352,447700,388300,836000
410765,202109,1850,831,1019,915200.93,1120900,2036100.93
410770,202109,113,81,32,89100,35200,124300
410773,202109,63,44,19,48400,20900,69300
410775,202109,180,134,46,147400,50600,198000
410780,202109,89,48,41,52800,45100,97900
410785,202109,52,42,10,46200,11000,57200
410790,202109,89,37,52,40700,57200,97900
410800,202109,283,178,105,196900,117700,314600
410810,202109,27,15,12,16500,13200,29700
410820,202109,164,116,48,128700,52800,181500
410830,202109,8876,3714,5162,4088700.4,5680400,9769100.4
410832,202109,110,71,39,78100,42900,121000
410840,202109,1455,768,687,845900.21,755700,1601600.21
410845,202109,48,27,21,29700,23100,52800
410850,202109,180,128,52,140800,58300,199100
410855,202109,69,59,10,64900,11000,75900
410860,202109,773,391,382,430100,420200,850300
410865,202109,100,72,28,80300,30800,111100
410870,202109,148,126,22,138600,24200,162800
410880,202109,1151,558,593,616000,653400,1269400
410890,202109,90,63,27,69300,29700,99000
410895,202109,75,58,17,63800,18700,82500
410900,202109,26,18,8,19800,8800,28600
410910,202109,16,11,5,12100,5500,17600
410920,202109,38,23,15,25300,16500,41800
410930,202109,548,334,214,367400,235400,602800
410940,202109,4434,2336,2098,2572900.6,2313300,4886200.6
410950,202109,102,76,26,83600,28600,112200
410960,202109,871,338,533,371800,586300,958100
410965,202109,69,44,25,48400,27500,75900
410970,202109,615,425,190,468600,210100,678700
410975,202109,126,78,48,85800.38,52800,138600.38
410980,202109,1630,713,917,785400,1009800,1795200
410990,202109,269,188,81,206800,89100,295900
411000,202109,65,36,29,39600,31900,71500
411005,202109,28,23,5,25300,5500,30800
411007,202109,248,141,107,155100,117700,272800
411010,202109,599,389,210,430100,232100,662200
411020,202109,289,184,105,202400,115500,317900
411030,202109,22,11,11,12100,12100,24200
411040,202109,56,36,20,39600,22000,61600
411050,202109,218,157,61,172700,67100,239800
411060,202109,517,343,174,377300,191400,568700
411065,202109,48,43,5,47300,5500,52800
411070,202109,1274,730,544,804100,599500,1403600
411080,202109,238,165,73,181500,80300,261800
411090,202109,88,68,20,75900,22000,97900
411095,202109,327,115,212,126500,233200,359700
411100,202109,120,94,26,103400,28600,132000
411110,202109,132,80,52,88000,57200,145200
411120,202109,218,145,73,159500,81400,240900
411125,202109,279,122,157,134200,172700,306900
411130,202109,122,104,18,114400,19800,134200
411140,202109,215,144,71,158400,78100,236500
411150,202109,1250,803,447,884400,491700.63,1376100.63
411155,202109,120,83,37,92400,41800,134200
411160,202109,29,12,17,13200,18700,31900
411170,202109,52,46,6,50600,6600,57200
411180,202109,983,635,348,698500,382800,1081300
411190,202109,329,182,147,200200,161700,361900
411200,202109,661,385,276,423500.63,303600,727100.63
411210,202109,691,357,334,392700,367400.1,760100.1
411220,202109,163,110,53,121000,58300,179300
411230,202109,37,30,7,33000,7700,40700
411240,202109,113,70,43,77000,47300,124300
411250,202109,428,309,119,339900,130900,470800
411260,202109,14,10,4,11000,4400,15400
411270,202109,265,135,130,150700,143000,293700
411275,202109,181,157,24,172700,26400,199100
411280,202109,199,142,57,156200.63,62700,218900.63
411290,202109,63,49,14,53900,15400,69300
411295,202109,126,98,28,107800,30800,138600
411300,202109,77,32,45,35200,49500,84700
411310,202109,92,68,24,75900,26400,102300
411320,202109,796,509,287,562100,315700,877800
411325,202109,61,44,17,48400,18700,67100
411330,202109,912,588,324,646800.41,356400.15,1003200.56
411340,202109,30,19,11,20900,12100,33000
411342,202109,57,42,15,46200,16500,62700
411345,202109,116,57,59,62700,64900,127600
411350,202109,493,365,128,401500,140800,542300
411360,202109,58,36,22,39600,24200,63800
411370,202109,14062,5548,8514,6109401.89,9378602.19,15488004.08
411373,202109,184,125,59,137500,64900,202400
411375,202109,80,63,17,69300,18700,88000
411380,202109,80,57,23,62700,25300,88000
411390,202109,127,72,55,79200,60500,139700
411400,202109,419,285,134,313500,147400,460900
411410,202109,487,225,262,247500,288200,535700
411420,202109,967,405,562,445500,618200,1063700
411430,202109,501,271,230,298100.59,254100,552200.59
411435,202109,33,20,13,22000,14300,36300
411440,202109,470,369,101,405900,111100,517000
411450,202109,416,352,64,388300,70400,458700
411460,202109,801,303,498,333300,548900,882200
411470,202109,103,71,32,78100,35200,113300
411480,202109,704,374,330,413600,364100,777700
411490,202109,290,182,108,201300,118800,320100
411500,202109,100,80,20,88000,22000,110000
411510,202109,221,175,46,192500,50600,243100
411520,202109,6100,2134,3966,2350700,4368100.7,6718800.7
411530,202109,124,83,41,91300,45100,136400
411535,202109,54,20,34,22000,37400,59400
411540,202109,368,245,123,269500,135300,404800
411545,202109,56,40,16,44000,17600,61600
411550,202109,82,61,21,67100,23100,90200
411560,202109,403,163,240,179300,265100,444400
411570,202109,909,305,604,335500,666600,1002100
411573,202109,27,17,10,18700,11000,29700
411575,202109,306,185,121,203500,133100,336600
411580,202109,1260,448,812,492800,895400,1388200
411585,202109,74,37,37,40700,40700,81400
411590,202109,18,12,6,13200,6600,19800
411600,202109,22,10,12,11000,13200,24200
411605,202109,246,95,151,105600,166100,271700
411610,202109,224,139,85,152900,93500,246400
411620,202109,396,197,199,216700,218900,435600
411630,202109,53,36,17,39600,18700,58300
411640,202109,33,23,10,25300,11000,36300
411650,202109,10,7,3,7700,3300,11000
411660,202109,39,27,12,29700,13200,42900
411670,202109,241,166,75,182600,82500,265100
411680,202109,159,128,31,140800,34100,174900
411690,202109,621,322,299,354200,328900,683100
411695,202109,66,46,20,50600,22000,72600
411700,202109,144,115,29,126500,31900,158400
411705,202109,105,70,35,77000,38500,115500
411710,202109,294,194,100,213400,110000,323400
411720,202109,135,89,46,97900,51700,149600
411721,202109,82,65,17,71500,18700,90200
411722,202109,107,44,63,48400,69300,117700
411725,202109,165,119,46,130900,50600,181500
411727,202109,98,77,21,85800,23100,108900
411729,202109,41,31,10,34100,11000,45100
411730,202109,556,344,212,379500,233200,612700
411740,202109,33,20,13,22000,14300,36300
411745,202109,64,48,16,52800,17600,70400
411750,202109,844,357,487,392700,535700,928400
411760,202109,1212,875,337,963600,370700,1334300
411770,202109,438,290,148,319000,162800,481800
411780,202109,359,232,127,255200,139700,394900
411790,202109,565,312,253,343200.18,278300,621500.18
411800,202109,151,109,42,119900.65,46200,166100.65
411810,202109,183,136,47,150700,51700,202400
411820,202109,2386,992,1394,1091200,1536700,2627900
411830,202109,14,13,1,14300,1100,15400
411840,202109,2093,1233,860,1357400,948200,2305600
411845,202109,65,22,43,24200,47300,71500
411850,202109,1227,655,572,722700,629200,1351900
411860,202109,49,29,20,31900,22000,53900
411870,202109,67,40,27,44000,29700,73700
411880,202109,437,260,177,286000,194700,480700
411885,202109,104,60,44,66000,48400,114400
411890,202109,308,206,102,227700,112200,339900
411900,202109,97,68,29,74800,33000,107800
411910,202109,183,138,45,151800,49500,201300
411915,202109,2327,910,1417,1003200,1562000,2565200
411920,202109,112,87,25,95700,27500,123200
411925,202109,16,10,6,11000,6600,17600
411930,202109,799,558,241,616070.4,265100,881170.4
411940,202109,594,376,218,413600,239800,653400
411950,202109,1141,519,622,573100,687500,1260600
411960,202109,1111,708,403,778800,443300,1222100
411965,202109,25,14,11,15400,12100,27500
411970,202109,95,80,15,88000,16500,104500
411980,202109,199,112,87,123200,96800,220000
411990,202109,5171,2792,2379,3075601.84,2616971.5,5692573.34
411995,202109,580,179,401,198000,442200,640200
412000,202109,320,202,118,222200,129800,352000
412010,202109,41,23,18,25300,19800,45100
412015,202109,39,30,9,33000,9900,42900
412020,202109,20,16,4,17600,4400,22000
412030,202109,40,36,4,39600,4400,44000
412033,202109,52,29,23,31900,25300,57200
412035,202109,73,45,28,49500,30800,80300
412040,202109,40,20,20,22000,22000,44000
412050,202109,210,154,56,169400,61600,231000
412060,202109,768,554,214,610500.6,235400.13,845900.73
412065,202109,50,30,20,33000,22000,55000
412070,202109,164,114,50,125400,55000,180400
412080,202109,307,143,164,161700,181500,343200
412085,202109,36,15,21,16500,23100,39600
412090,202109,841,520,321,572000,354200,926200
412100,202109,261,215,46,236500,50600,287100
412110,202109,69,53,16,58300,17600,75900
412120,202109,336,184,152,204600,167200,371800
412125,202109,74,47,27,51700,29700,81400
412130,202109,40,25,15,27500,16500,44000
412135,202109,30,18,12,19800,13200,33000
412140,202109,414,262,152,288200,167200,455400
412150,202109,242,158,84,173800,92400,266200
412160,202109,89,54,35,59400,38500,97900
412170,202109,708,476,232,523600,255200,778800
412175,202109,35,25,10,27500,11000,38500
412180,202109,189,141,48,155100,52800,207900
412190,202109,315,244,71,269500,79200,348700
412200,202109,188,117,71,128700,78100,206800
412210,202109,95,70,25,77000,27500,104500
412215,202109,237,157,80,172700,88000,260700
412217,202109,63,52,11,57200,12100,69300
412220,202109,832,557,275,612700,302500,915200
412230,202109,300,184,116,202400,127600,330000
412240,202109,1315,624,691,687500,763400,1450900
412250,202109,405,250,155,275000,170500,445500
412260,202109,115,77,38,84700,41800,126500
412265,202109,172,129,43,141900,47300,189200
412270,202109,88,57,31,63800,34100,97900
412280,202109,88,68,20,75900,22000,97900
412290,202109,92,59,33,66000,36300,102300
412300,202109,207,141,66,156200,73700,229900
412310,202109,51,41,10,45100,11000,56100
412320,202109,90,72,18,79200,19800,99000
412330,202109,179,146,33,160600,36300,196900
412340,202109,163,111,52,122100,57200,179300
412350,202109,644,296,348,325600,385000,710600
412360,202109,24,21,3,23100,3300,26400
412370,202109,152,129,23,143000,25300,168300
412380,202109,221,165,56,181500,62700,244200
412382,202109,63,36,27,39600,29700,69300
412385,202109,154,108,46,118800,50600.06,169400.06
412390,202109,305,227,78,249700,85800,335500
412395,202109,67,53,14,58300,15400,73700
412400,202109,97,64,33,70400,36300,106700
412402,202109,233,116,117,127600,128700,256300
412405,202109,940,316,624,347600,686400,1034000
412410,202109,964,580,384,638000,422400,1060400
412420,202109,18,17,1,18700,1100,19800
412430,202109,22,20,2,22000,2200,24200
412440,202109,646,332,314,365200,345400,710600
412450,202109,75,66,9,72600,9900,82500
412460,202109,94,71,23,78100,25300,103400
412470,202109,210,164,46,180400,50600,231000
412480,202109,147,103,44,113300,48400,161700
412490,202109,159,134,25,147400,27500,174900
412500,202109,406,320,86,352000.44,95700,447700.44
412510,202109,168,138,30,151800,33000,184800
412520,202109,92,58,34,63800,37400,101200
412530,202109,109,54,55,59400,60500,119900
412535,202109,89,67,22,73700,24200,97900
412540,202109,82,40,42,44000,46200,90200
412545,202109,84,57,27,62700,29700,92400
412550,202109,3997,1582,2415,1744600,2657600,4402200
412555,202109,10,6,4,6600,4400,11000
412560,202109,650,439,211,482900,232100,715000
412570,202109,797,382,415,420200,456500,876700
412575,202109,95,65,30,71500,33000,104500
412580,202109,171,116,55,127600,60500,188100
412590,202109,32,29,3,31900,3300,35200
412600,202109,175,122,53,134200,58300,192500
412610,202109,34,13,21,14300,23100,37400
412620,202109,144,120,24,132000,26400,158400
412625,202109,2120,1046,1074,1151700.63,1185800,2337500.63
412627,202109,68,49,19,53900,20900,74800
412630,202109,388,255,133,280500,146300,426800
412635,202109,74,20,54,22000,59400,81400
412640,202109,103,72,31,79200,34100,113300
412650,202109,322,213,109,234300,121000,355300
412660,202109,455,263,192,289300,212300,501600
412665,202109,42,38,4,41800,4400,46200
412667,202109,298,190,108,209000,119900,328900
412670,202109,74,59,15,65450,16500,81950
412680,202109,316,235,81,258500,89100,347600
412690,202109,122,77,45,84700,49500,134200
412700,202109,179,119,60,130900,66000,196900
412710,202109,1342,762,580,839300.48,638000,1477300.48
412720,202109,233,128,105,141900,115500,257400
412730,202109,198,166,32,182600,35200,217800
412740,202109,416,208,208,228800,228800,457600
412750,202109,434,231,203,254100,223300,477400
412760,202109,323,162,161,178200,177100,355300
412770,202109,2119,1133,986,1247400.63,1085700,2333100.63
412780,202109,142,104,38,114400,41800,156200
412785,202109,316,150,166,165000,182600,347600
412788,202109,44,27,17,29700,18700,48400
412790,202109,124,100,24,110000,26400,136400
412795,202109,151,105,46,115500,50600,166100
412796,202109,303,191,112,210100,123200,333300
412800,202109,651,387,264,426800,291500,718300
412810,202109,3007,1590,1417,1751200.59,1560900,3312100.59
412820,202109,943,565,378,622600,415800,1038400
412830,202109,13,10,3,11000,3300,14300
412840,202109,251,167,84,183700,93500,277200
412850,202109,731,457,274,502700,301400,804100
412853,202109,167,77,90,84700,99000,183700
412855,202109,193,100,93,110000.26,102300,212300.26
412860,202109,98,65,33,71500,36300,107800
412862,202109,72,46,26,50600,28600,79200
412863,202109,9,7,2,7700,2200,9900
412865,202109,42,31,11,34100,12100,46200
412870,202109,106,63,43,69300,47300,116600
412880,202109,95,66,29,72600,31900,104500
420005,202109,40,36,4,39600,4400,44000
420010,202109,370,236,134,259600,147400,407000
420020,202109,86,69,17,75900,18700,94600
420030,202109,26,21,5,23100,5500,28600
420040,202109,96,73,23,80300,25300,105600
420050,202109,59,36,23,39600,25300,64900
420055,202109,17,17,0,18700,0,18700
420060,202109,28,21,7,23100,7700,30800
420070,202109,103,86,17,94600,18700,113300
420075,202109,10,10,0,11000,0,11000
420080,202109,41,36,5,39600,5500,45100
420090,202109,39,31,8,35200,8800,44000
420100,202109,155,130,25,143000,27500,170500
420110,202109,20,20,0,23100,0,23100
420120,202109,62,43,19,48400,20900,69300
420125,202109,86,66,20,72600,22000,94600
420127,202109,33,27,6,29700,6600,36300
420130,202109,460,272,188,299200,206800,506000
420140,202109,1328,734,594,807400,653400,1460800
420150,202109,46,35,11,38500,12100,50600
420160,202109,30,28,2,30800,2200,33000
420165,202109,15,10,5,11000,5500,16500
420170,202109,64,38,26,41800,28600,70400
420180,202109,23,20,3,22000,3300,25300
420190,202109,25,22,3,24200,3300,27500
420195,202109,148,67,81,73700,89100,162800
420200,202109,1281,531,750,586300,825000,1411300
420205,202109,96,56,40,61600,44000,105600
420207,202109,130,69,61,75900,67100,143000
420208,202109,19,15,4,16500,4400,20900
420209,202109,14,12,2,13200,2200,15400
420210,202109,546,254,292,279400,322300,601700
420213,202109,48,35,13,38500,14300,52800
420215,202109,26,22,4,24200,4400,28600
420220,202109,61,36,25,39600,27500,67100
420230,202109,896,531,365,586300,402600,988900
420240,202109,2200,1426,774,1570800.75,851400,2422200.75
420243,202109,45,36,9,39600,9900,49500
420245,202109,188,94,94,103400,103400,206800
420250,202109,62,41,21,46200,23100,69300
420253,202109,28,22,6,24200,6600,30800
420257,202109,12,9,3,9900,3300,13200
420260,202109,108,86,22,94600,24200,118800
420270,202109,28,22,6,24200,6600,30800
420280,202109,288,216,72,237600,79200,316800
420285,202109,22,15,7,16500,7700,24200
420287,202109,52,34,18,37400,19800,57200
420290,202109,936,636,300,699600,331100,1030700
420300,202109,1480,1175,305,1294700,335500,1630200
420310,202109,48,32,16,35200,17600,52800
420315,202109,33,26,7,28600,7700,36300
420320,202109,979,464,515,510400,566500,1076900
420325,202109,3,1,2,1100,2200,3300
420330,202109,123,79,44,86900,48400,135300
420340,202109,174,119,55,130900,60500,191400
420350,202109,256,178,78,195800,85800,281600
420360,202109,697,538,159,591800.88,174900,766700.88
420370,202109,128,74,54,81400,59400,140800
420380,202109,1198,822,376,905300,414700,1320000
420390,202109,230,159,71,174900,78100,253000
420395,202109,191,139,52,152900,57200,210100
420400,202109,242,184,58,202400,63800,266200
420410,202109,55,42,13,47300,14300,61600
420415,202109,34,29,5,31900,5500,37400
420417,202109,55,44,11,48400,12100,60500
420419,202109,12,11,1,12100,1100,13200
420420,202109,2798,1723,1075,1897500,1184700,3082200
420425,202109,70,56,14,61600,15400,77000
420430,202109,1108,802,306,883300,337700,1221000
420435,202109,13,11,2,12100,2200,14300
420440,202109,96,68,28,74800,30800,105600
420445,202109,29,28,1,30800,1100,31900
420450,202109,80,36,44,39600,48400,88000
420455,202109,199,154,45,169400,49500,218900
420460,202109,2317,1445,872,1593900,960300,2554200
420470,202109,99,70,29,77000,31900,108900
420475,202109,9,8,1,8800,1100,9900
420480,202109,854,642,212,707300,236500,943800
420490,202109,98,72,26,79200,28600,107800
420500,202109,446,235,211,258500.26,232100,490600.26
420510,202109,23,20,3,22000,3300,25300
420515,202109,28,15,13,16500,14300,30800
420517,202109,9,9,0,9900,0,9900
420519,202109,0,,,,,0.0
420520,202109,61,47,14,52800,15400,68200
420530,202109,152,97,55,107800,60500,168300
420535,202109,19,17,2,18700,2200,20900
420540,202109,5943,3632,2311,4005375.26,2545400,6550775.26
420543,202109,29,27,2,29700,2200,31900
420545,202109,217,151,66,166100,72600,238700
420550,202109,808,668,140,734800,154000,888800
420555,202109,29,20,9,22000,9900,31900
420560,202109,60,49,11,53900,12100,66000
420570,202109,177,93,84,102300,92400,194700
420580,202109,287,137,150,150700,165000,315700
420590,202109,474,312,162,343200,178200,521400
420600,202109,136,72,64,79200,70400,149600
420610,202109,35,32,3,35200,3300,38500
420620,202109,81,60,21,66000,23100,89100
420630,202109,141,87,54,95700,59400,155100
420640,202109,77,67,10,73700,11000,84700
420650,202109,253,127,126,139700,138600,278300
420660,202109,41,33,8,38500,8800,47300
420665,202109,41,26,15,28600,16500,45100
420670,202109,263,206,57,226600,62700,289300
420675,202109,14,12,2,13200,2200,15400
420680,202109,33,25,8,27500,8800,36300
420690,202109,181,139,42,152900,46200,199100
420700,202109,702,456,246,503800.7,270600,774400.7
420710,202109,148,77,71,84700,78100,162800
420720,202109,100,79,21,86900,23100,110000
420730,202109,669,399,270,438900,297000,735900
420740,202109,55,54,1,59400,1100,60500
420750,202109,485,324,161,357500,178200,535700
420757,202109,16,14,2,15400,2200,17600
420760,202109,39,30,9,33000,9900,42900
420765,202109,81,59,22,64900,24200,89100
420768,202109,53,42,11,46200,12100,58300
420770,202109,71,58,13,63800,14300,78100
420775,202109,38,35,3,39600,3300,42900
420780,202109,203,160,43,176000,47300,223300
420785,202109,22,14,8,15400,8800,24200
420790,202109,152,125,27,138600,29700,168300
420800,202109,64,46,18,50600,19800,70400
420810,202109,257,207,50,227700,55000,282700
420820,202109,2437,1357,1080,1494900,1189100.5,2684000.5
420830,202109,642,330,312,364100,345400,709500
420840,202109,141,97,44,106700,48400,155100
420845,202109,419,174,245,191400,269500,460900
420850,202109,265,200,65,220000,71500,291500
420860,202109,57,47,10,51700,11000,62700
420870,202109,131,92,39,101200,42900,144100
420880,202109,186,121,65,133100,71500,204600
420890,202109,936,453,483,500500,531300,1031800
420895,202109,8,8,0,8800,0,8800
420900,202109,403,321,82,354200,91300,445500
420910,202109,5712,3055,2657,3364901.3,2934800,6299701.3
420915,202109,61,54,7,59400,7700,67100
420917,202109,20,14,6,15400,6600,22000
420920,202109,21,14,7,15400,7700,23100
420930,202109,2982,1882,1100,2073429,1210000.18,3283429.18
420940,202109,586,425,161,467500,177100,644600
420945,202109,10,7,3,7700,3300,11000
420950,202109,55,45,10,49500,11000,60500
420960,202109,110,90,20,99000,22000,121000
420970,202109,282,226,56,248600,61600,310200
420980,202109,21,20,1,22000,1100,23100
420985,202109,55,48,7,52800,7700,60500
420990,202109,79,58,21,63800,23100,86900
421000,202109,49,26,23,28600,25300,53900
421003,202109,42,29,13,31900,14300,46200
421005,202109,7,4,3,4400,3300,7700
421010,202109,808,525,283,578600,311300,889900
421020,202109,24,19,5,20900,5500,26400
421030,202109,110,94,16,103400,17600,121000
421040,202109,70,49,21,53900,23100,77000
421050,202109,332,228,104,250800,114400,365200
421055,202109,20,15,5,16500,5500,22000
421060,202109,97,53,44,58300,48400,106700
421070,202109,37,31,6,34100,6600,40700
421080,202109,38,33,5,36300,6600,42900
421085,202109,19,15,4,16500,4400,20900
421090,202109,34,27,7,29700,7700,37400
421100,202109,116,85,31,93500,34100,127600
421105,202109,179,144,35,158400,38500,196900
421110,202109,114,84,30,92400,33000,125400
421120,202109,174,126,48,138600.92,52800,191400.92
421125,202109,19,12,7,13200,7700,20900
421130,202109,837,511,326,563200,358600,921800
421140,202109,33,22,11,24200,12100,36300
421145,202109,48,37,11,40700,12100,52800
421150,202109,93,71,22,78100,24200,102300
421160,202109,66,43,23,47300,25300,72600
421165,202109,16,13,3,14300,3300,17600
421170,202109,179,149,30,164032,33000,197032
421175,202109,171,115,56,127600,61600,189200
421180,202109,44,30,14,33000,16500,49500
421185,202109,14,11,3,12100,3300,15400
421187,202109,3,1,2,1100,2200,3300
421189,202109,45,31,14,34100,15400,49500
421190,202109,1811,1133,678,1250700,745800.55,1996500.55
421200,202109,92,66,26,72600,28600,101200
421205,202109,27,19,8,20900,8800,29700
421210,202109,175,125,50,137500,55000,192500
421220,202109,250,192,58,212300,63800,276100
421223,202109,46,36,10,39600,11000,50600
421225,202109,70,44,26,48400,29700,78100
421227,202109,76,61,15,67100,16500,83600
421230,202109,61,43,18,47300,19800,67100
421240,202109,16,16,0,17600,0,17600
421250,202109,376,220,156,242000,171600,413600
421260,202109,21,17,4,18700,4400,23100
421265,202109,2,2,0,2200,0,2200
421270,202109,50,44,6,48400,6600,55000
421280,202109,362,186,176,205700,193600,399300
421290,202109,323,213,110,234300,121000,355300
421300,202109,25,20,5,22000,5500,27500
421310,202109,50,33,17,37400,18700,56100
421315,202109,32,18,14,19800,15400,35200
421320,202109,131,86,45,94600,49500,144100
421330,202109,106,78,28,85800,30800,116600
421335,202109,41,30,11,33000,12100,45100
421340,202109,244,157,87,172700,95700,268400
421350,202109,185,107,78,117700.39,85800,203500.39
421360,202109,686,477,209,525800,229900,755700
421370,202109,195,144,51,158400,56100,214500
421380,202109,135,105,30,115500,33000,148500
421390,202109,16,10,6,11000,6600,17600
421400,202109,112,92,20,101200,22000,123200
421410,202109,21,18,3,19800,3300,23100
421415,202109,21,18,3,19800,3300,23100
421420,202109,108,93,15,102300,17600,119900
421430,202109,16,11,5,12100,5500,17600
421440,202109,58,51,7,56100,7700,63800
421450,202109,91,75,16,82500.35,17600.51,100100.86
421460,202109,58,44,14,48400,15400,63800
421470,202109,72,39,33,44000,37400,81400
421480,202109,751,567,184,624800,203500,828300
421490,202109,25,24,1,26400,1100,27500
421500,202109,483,293,190,322300,209000,531300
421505,202109,25,18,7,20900,7700,28600
421507,202109,33,27,6,29700,6600,36300
421510,202109,69,45,24,49500,26400,75900
421520,202109,53,43,10,47300,11000,58300
421530,202109,50,41,9,45100,9900,55000
421535,202109,20,19,1,20900,1100,22000
421540,202109,52,41,11,45100,12100,57200
421545,202109,86,61,25,67100,27500,94600
421550,202109,289,208,81,228800,89100,317900
421555,202109,18,15,3,16500,3300,19800
421560,202109,9,8,1,8800,1100,9900
421565,202109,117,76,41,83600,45100,128700
421567,202109,31,24,7,26400,7700,34100
421568,202109,44,39,5,42900,5500,48400
421569,202109,12,12,0,13200,0,13200
421570,202109,215,139,76,152900,83600,236500
421575,202109,26,23,3,25300,3300,28600
421580,202109,715,423,292,465372,323400,788772
421590,202109,19,18,1,19800,1100,20900
421600,202109,149,97,52,106700,57200,163900
421605,202109,111,76,35,84700,38500,123200
421610,202109,164,123,41,135300,45100,180400
421620,202109,1021,576,445,635800,490600,1126400
421625,202109,20,18,2,19800,2200,22000
421630,202109,333,202,131,224400,144100,368500
421635,202109,22,10,12,11000,13200,24200
421640,202109,101,82,19,90200,20900,111100
421650,202109,295,170,125,187000,138600,325600
421660,202109,2417,1449,968,1596100,1064800,2660900
421670,202109,173,122,51,134200,56100,190300
421680,202109,184,166,18,182600,19800,202400
421690,202109,347,241,106,266200,116600,382800
421700,202109,52,36,16,39600,17600,57200
421710,202109,24,23,1,25300,1100,26400
421715,202109,5,4,1,4400,1100,5500
421720,202109,632,435,197,478500,216700,695200
421725,202109,22,8,14,8800,15400,24200
421730,202109,26,19,7,20900,7700,28600
421740,202109,100,35,65,38500,71500,110000
421750,202109,197,142,55,156200,60500,216700
421755,202109,20,18,2,19800,2200,22000
421760,202109,103,68,35,74800,38500,113300
421770,202109,704,447,257,492836.66,282700,775536.66
421775,202109,28,18,10,19800,11000,30800
421780,202109,179,141,38,155100,41800,196900
421790,202109,144,123,21,135300,23100,158400
421795,202109,17,13,4,14300,4400,18700
421800,202109,549,333,216,366300,238700,605000
421810,202109,70,54,16,59400,17600,77000
421820,202109,305,196,109,215600,119900,335500
421825,202109,151,125,26,137500,28600,166100
421830,202109,148,91,57,100100,62700,162800
421835,202109,7,2,5,2200,5500,7700
421840,202109,46,40,6,44000,6600,50600
421850,202109,83,70,13,77000,14300,91300
421860,202109,42,30,12,33000,13200,46200
421870,202109,1040,757,283,836000,311300,1147300
421875,202109,51,41,10,45100,11000,56100
421880,202109,181,125,56,137500,61600,199100
421885,202109,27,19,8,20900,8800,29700
421890,202109,142,102,40,112200,44000.5,156200.5
421895,202109,45,40,5,44000,5500,49500
421900,202109,134,100,34,110000,37400,147400
421910,202109,63,39,24,42900,26400,69300
421915,202109,30,24,6,26400,6600,33000
421917,202109,39,29,10,31900,11000,42900
421920,202109,37,33,4,36300,4400,40700
421930,202109,624,491,133,541200,146300,687500
421935,202109,45,38,7,41800,7700,49500
421940,202109,50,42,8,46200,8800,55000
421950,202109,853,566,287,622600,316800,939400
421960,202109,39,34,5,37400,5500,42900
421970,202109,330,216,114,237600,125400,363000
421985,202109,18,11,7,12100,7700,19800
422000,202109,0,0,0,0,0,0
430003,202109,193,55,138,60500,151800,212300
430005,202109,34,25,9,27500,9900,37400
430010,202109,270,196,74,215600,81400,297000
430020,202109,149,100,49,110000,53900,163900
430030,202109,122,103,19,113300,20900,134200
430040,202109,2941,1729,1212,1901900,1337600,3239500
430045,202109,72,60,12,66000,13200,79200
430047,202109,6,4,2,4400,2200,6600
430050,202109,85,71,14,78100,15400,93500
430055,202109,12,11,1,12100,1100,13200
430057,202109,5,4,1,4400,1100,5500
430060,202109,3900,2260,1640,2489300,1806200,4295500
430063,202109,56,46,10,50600,11000,61600
430064,202109,159,125,34,137500,37400,174900
430066,202109,5,2,3,2200,3300,5500
430070,202109,41,29,12,31900,13200,45100
430080,202109,72,45,27,49500,29700,79200
430085,202109,27,11,16,12100,17600,29700
430087,202109,24,16,8,17600,8800,26400
430090,202109,63,54,9,59400,9900,69300
430100,202109,130,87,43,95700,47300,143000
430105,202109,148,82,66,90200,73700,163900
430107,202109,19,13,6,14300,6600,20900
430110,202109,493,269,224,295900,246400,542300
430120,202109,163,147,16,161700,17600,179300
430130,202109,785,473,312,521400,345400,866800
430140,202109,129,118,11,129800,12100,141900
430150,202109,106,65,41,71500,45100,116600
430155,202109,30,26,4,28600,4400,33000
430160,202109,3592,2049,1543,2256100,1698400,3954500
430163,202109,392,172,220,189200,242000,431200
430165,202109,30,19,11,22000,12100,34100
430170,202109,87,73,14,80300,15400,95700
430175,202109,80,61,19,68200,20900,89100
430180,202109,106,89,17,97900,18700,116600
430185,202109,27,17,10,18700,11000,29700
430187,202109,54,28,26,30800,28600,59400
430190,202109,227,117,110,128700,121000,249700
430192,202109,16,12,4,13200,4400,17600
430195,202109,17,11,6,12100,6600,18700
430200,202109,155,132,23,145200,25300,170500
430205,202109,20,20,0,22000,0,22000
430210,202109,696,524,172,577500,189200,766700
430215,202109,11,10,1,11000,1100,12100
430220,202109,71,47,24,51700,26400,78100
430222,202109,12,4,8,4400,8800,13200
430223,202109,18,12,6,13200,6600,19800
430225,202109,2,1,1,1100,1100,2200
430230,202109,325,198,127,217800,140800,358600
430235,202109,49,36,13,39600,14300,53900
430237,202109,24,18,6,19800,6600,26400
430240,202109,110,77,33,85800,36300,122100
430245,202109,70,55,15,60500,16500,77000
430250,202109,185,105,80,115500,88000,203500
430258,202109,8,7,1,7700,1100,8800
430260,202109,33,28,5,30800,5500,36300
430265,202109,34,29,5,31900,5500,37400
430270,202109,530,385,145,424600,161700,586300
430280,202109,1054,618,436,679800,479600,1159400
430290,202109,429,220,209,243100,229900,473000
430300,202109,2103,1129,974,1243000,1073600.93,2316600.93
430310,202109,2031,984,1047,1085700.71,1151700.7,2237401.41
430320,202109,55,47,8,51700,9900,61600
430330,202109,98,85,13,93500,14300,107800
430340,202109,67,54,13,59400,14300,73700
430350,202109,1653,1085,568,1193500,625900,1819400
430355,202109,19,18,1,19800,1100,20900
430360,202109,90,42,48,46200,52800,99000
430367,202109,37,28,9,30800,9900,40700
430370,202109,58,53,5,58300,5500,63800
430380,202109,121,92,29,101200,31900,133100
430390,202109,580,357,223,394900,245300,640200
430400,202109,261,184,77,203500,84700,288200
430410,202109,59,47,12,51700,13200,64900
430420,202109,507,312,195,343200,215600,558800
430430,202109,57,55,2,59767.4,2200,61967.4
430435,202109,140,106,34,116600,38500,155100
430440,202109,525,327,198,359700,217800,577500
430450,202109,1160,940,220,1036200,242000,1278200
430460,202109,5575,2862,2713,3148200.9,2988700,6136900.9
430461,202109,16,14,2,15400,2200,17600
430462,202109,4,2,2,2200,2200,4400
430463,202109,1134,608,526,669900,578600,1248500
430465,202109,25,14,11,15400,12100,27500
430466,202109,645,451,194,497200,213400,710600
430467,202109,117,66,51,72600,56100,128700
430468,202109,128,73,55,80300,61600,141900
430469,202109,21,16,5,17600,5500,23100
430470,202109,1147,631,516,694427.5,569800,1264227.5
430471,202109,64,40,24,44000,26400,70400
430480,202109,117,77,40,84700,44000,128700
430485,202109,8,8,0,8800,0,8800
430490,202109,77,61,16,67100,17600,84700
430495,202109,33,25,8,27500,8800,36300
430500,202109,189,128,61,140800,67100,207900
430510,202109,3650,2359,1291,2600400.67,1423400,4023800.67
430511,202109,16,16,0,17600,0,17600
430512,202109,145,98,47,107800,51700,159500
430513,202109,52,40,12,44000,13200,57200
430515,202109,26,25,1,27500,1100,28600
430517,202109,171,143,28,157300,30800,188100
430520,202109,336,237,99,260700,108900,369600
430530,202109,81,44,37,48400,40700,89100
430535,202109,444,297,147,327800,161700,489500
430537,202109,11,11,0,12100,0,12100
430540,202109,81,54,27,59400,29700,89100
430543,202109,376,116,260,127600,286000,413600
430544,202109,46,43,3,47300,3300,50600
430545,202109,384,175,209,192500,229900,422400
430550,202109,40,31,9,34100,9900,44000
430558,202109,1,1,0,1100,0,1100
430560,202109,54,31,23,34100,25300,59400
430570,202109,113,47,66,51700,72600,124300
430580,202109,123,97,26,106700,28600,135300
430583,202109,15,15,0,16500,0,16500
430585,202109,13,7,6,7700,6600,14300
430587,202109,13,8,5,8800,5500,14300
430590,202109,154,123,31,135300,34100,169400
430593,202109,2,2,0,2200,0,2200
430595,202109,18,14,4,15400,4400,19800
430597,202109,44,23,21,25300,23100,48400
430600,202109,219,167,52,183700,57200,240900
430605,202109,168,99,69,108900,75900,184800
430607,202109,30,24,6,26400,6600,33000
430610,202109,1721,802,919,883300,1012000,1895300
430613,202109,5,5,0,5500,0,5500
430620,202109,111,81,30,89100,33000,122100
430630,202109,46,39,7,42900,8800,51700
430632,202109,32,27,5,29700,5500,35200
430635,202109,40,33,7,36300,7700,44000
430637,202109,67,32,35,35200,38500,73700
430640,202109,177,97,80,107800,88000,195800
430642,202109,17,14,3,15400,3300,18700
430645,202109,30,25,5,27500,5500,33000
430650,202109,244,195,49,214500,53900,268400
430655,202109,5,4,1,4400,1100,5500
430660,202109,970,474,496,521400,545600,1067000
430670,202109,76,53,23,58300,25300,83600
430673,202109,76,45,31,49500,34100,83600
430675,202109,9,7,2,7700,2200,9900
430676,202109,576,338,238,371800,261800,633600
430680,202109,235,156,79,172700,86900,259600
430690,202109,521,316,205,348700,225500.63,574200.63
430692,202109,9,7,2,7700,2200,9900
430693,202109,137,85,52,93500,57200,150700
430695,202109,64,53,11,58300,12100,70400
430697,202109,63,38,25,41800,27500,69300
430700,202109,1426,965,461,1064800,507100,1571900
430705,202109,30,27,3,29700,3300,33000
430710,202109,258,160,98,176000,107800,283800
430720,202109,107,92,15,101200,16500,117700
430730,202109,137,117,20,128700,22000,150700
430740,202109,75,50,25,55000,27500,82500
430745,202109,32,21,11,23100,12100,35200
430750,202109,337,219,118,240900,129800,370700
430755,202109,89,47,42,51700,46200,97900
430760,202109,387,212,175,233200,192500,425700
430770,202109,1548,785,763,863500,839300,1702800
430780,202109,313,193,120,212300,132000,344300
430781,202109,24,22,2,24200,2200,26400
430783,202109,64,49,15,53900,16500,70400
430786,202109,6,4,2,4400,2200,6600
430790,202109,529,336,193,369600,213400,583000
430800,202109,156,122,34,134200.01,37400,171600.01
430805,202109,39,32,7,35200,7700,42900
430807,202109,59,34,25,37400,27500,64900
430810,202109,73,46,27,50600,29700,80300
430820,202109,148,89,59,97900,64900,162800
430825,202109,11,9,2,9900,2200,12100
430830,202109,243,225,18,247500,19800,267300
430840,202109,138,92,46,101200,50600,151800
430843,202109,7,5,2,5500,2200,7700
430845,202109,74,40,34,44000,37400,81400
430850,202109,589,421,168,464200,184800,649000
430860,202109,150,95,55,104500,60500,165000
430865,202109,78,42,36,46200,39600,85800
430870,202109,79,65,14,71500,15400,86900
430880,202109,151,110,41,121000,45100,166100
430885,202109,11,9,2,9900,2200,12100
430890,202109,338,204,134,225500,147400,372900
430900,202109,529,361,168,397100,184800,581900
430905,202109,120,51,69,56100,75900,132000
430910,202109,280,156,124,173800,136400,310200
430912,202109,4,4,0,4400,0,4400
430915,202109,36,33,3,36300,3300,39600
430920,202109,4428,2310,2118,2543200,2330900,4874100
430925,202109,5,4,1,4400,1100,5500
430930,202109,2059,1180,879,1300200,969100,2269300
430940,202109,254,163,91,179300,100100,279400
430950,202109,152,126,26,138600,28600,167200
430955,202109,26,14,12,15400,13200,28600
430957,202109,23,20,3,22000,3300,25300
430960,202109,248,161,87,177100,95700,272800
430965,202109,107,70,37,77000,40700,117700
430970,202109,93,73,20,80300,22000,102300
430975,202109,44,38,6,41800,6600,48400
430980,202109,47,29,18,31900,19800,51700
430990,202109,97,75,22,82500,24200,106700
430995,202109,112,104,8,114400,8800,123200
431000,202109,287,140,147,154000.6,161700,315700.6
431010,202109,351,196,155,215600,170500,386100
431020,202109,1874,1087,787,1196800,865700,2062500
431030,202109,37,29,8,31900,8800,40700
431033,202109,423,191,232,211200,255200,466400
431036,202109,12,6,6,6600,6600,13200
431040,202109,144,91,53,100100,58300,158400
431041,202109,38,23,15,25300,16500,41800
431043,202109,42,23,19,25300,20900,46200
431046,202109,12,9,3,9900,3300,13200
431050,202109,205,130,75,143000,82500,225500
431053,202109,67,37,30,40700,33000,73700
431055,202109,69,47,22,51700,24200,75900
431057,202109,18,18,0,19800,0,19800
431060,202109,1596,1029,567,1133000.31,623700,1756700.31
431065,202109,16,9,7,9900,7700,17600
431070,202109,62,57,5,62700,5500,68200
431075,202109,7,7,0,7700,0,7700
431080,202109,126,73,53,80300,58300,138600
431085,202109,31,28,3,30800,3300,34100
431087,202109,10,8,2,8800,2200,11000
431090,202109,53,40,13,44000,14300,58300
431100,202109,1236,727,509,799700,559900,1359600
431110,202109,223,136,87,149600,95700,245300
431112,202109,22,15,7,17600,7700,25300
431113,202109,30,22,8,24200,8800,33000
431115,202109,158,112,46,123200,50600,173800
431120,202109,602,344,258,378400,287100,665500
431123,202109,5,5,0,5500,0,5500
431125,202109,96,82,14,90200,15400,105600
431127,202109,8,5,3,5500,3300,8800
431130,202109,721,472,249,521400,273900,795300
431140,202109,778,539,239,594000,265100,859100
431142,202109,22,19,3,20900.55,3300,24200.55
431150,202109,194,144,50,158400,56100,214500
431160,202109,46,43,3,47300,3300,50600
431162,202109,3,3,0,3300,0,3300
431164,202109,5,5,0,5500,0,5500
431170,202109,113,83,30,91300,33000,124300
431171,202109,73,41,32,45100,35200,80300
431173,202109,1,1,0,1100,0,1100
431175,202109,203,103,100,113300,110000,223300
431177,202109,90,63,27,69300,29700,99000
431179,202109,16,12,4,13200,4400,17600
431180,202109,413,257,156,283800,171600,455400
431190,202109,75,55,20,60500,22000,82500
431198,202109,69,49,20,53900,22000,75900
431200,202109,21,17,4,18700,4400,23100
431205,202109,22,20,2,22000,2200,24200
431210,202109,97,62,35,68200,38500,106700
431213,202109,31,25,6,27500,6600,34100
431215,202109,21,18,3,19800,3300,23100
431217,202109,6,5,1,5500,1100,6600
431220,202109,67,57,10,63800,11000,74800
431225,202109,162,104,58,114400,63800,178200
431230,202109,97,85,12,93500,13200,106700
431235,202109,6,6,0,6600,0,6600
431237,202109,8,7,1,7700,1100,8800
431238,202109,12,9,3,9900,3300,13200
431240,202109,1063,649,414,715000,455400,1170400
431242,202109,39,38,1,41800,1100,42900
431244,202109,16,12,4,13200,4400,17600
431245,202109,51,38,13,41800,14300,56100
431247,202109,10,6,4,6600,4400,11000
431250,202109,287,139,148,152900,163900,316800
431260,202109,54,45,9,49500,9900,59400
431261,202109,18,12,6,13200,6600,19800
431262,202109,17,15,2,16500,2200,18700
431265,202109,154,82,72,90200,79200,169400
431267,202109,18,16,2,17600,2200,19800
431270,202109,330,257,73,282700,80300,363000
431275,202109,39,34,5,37400,5500,42900
431280,202109,19,15,4,16500,4400,20900
431290,202109,17,15,2,16500,2200,18700
431295,202109,2,1,1,1100,1100,2200
431300,202109,22,20,2,22000,2200,24200
431301,202109,6,6,0,6600,0,6600
431303,202109,62,38,24,41800,26400,68200
431306,202109,239,124,115,136204.2,126500,262704.2
431308,202109,8,5,3,5500,3300,8800
431310,202109,64,53,11,58300,12100,70400
431320,202109,161,93,68,102300,74800,177100
431330,202109,188,115,73,126500,80300,206800
431333,202109,29,23,6,25300,6600,31900
431335,202109,6,3,3,3300,3300,6600
431337,202109,393,181,212,199100,233200,432300
431339,202109,22,16,6,17600,6600,24200
431340,202109,3101,1659,1442,1828113.1,1588400,3416513.1
431342,202109,36,24,12,26400,13200,39600
431344,202109,18,18,0,19800,0,19800
431346,202109,4,4,0,4400,0,4400
431349,202109,37,33,4,36300,4400,40700
431350,202109,966,529,437,584100,480700,1064800
431360,202109,52,40,12,44000,13200,57200
431365,202109,352,146,206,160600,226600,387200
431370,202109,1210,695,515,765600,566500,1332100
431380,202109,98,87,11,95700,12100,107800
431390,202109,497,270,227,297000,250800,547800
431395,202109,318,133,185,146300,203500,349800
431400,202109,41,26,15,28600,16500,45100
431402,202109,105,74,31,81400,34100,115500
431403,202109,23,14,9,15400,9900,25300
431405,202109,707,385,322,423500,354200,777700
431406,202109,34,26,8,29700,8800,38500
431407,202109,55,44,11,48400,12100,60500
431410,202109,3408,2066,1342,2273700.53,1478400,3752100.53
431413,202109,16,13,3,14300,3300,17600
431415,202109,65,44,21,48400,23100,71500
431417,202109,27,11,16,12100,17600,29700
431420,202109,349,235,114,258500,125400,383900
431430,202109,58,29,29,31900,31900,63800
431440,202109,8974,6105,2869,6723200.45,3157050.6,9880251.05
431442,202109,28,14,14,15400,15400,30800
431445,202109,31,29,2,31900,2200,34100
431446,202109,5,4,1,4400,1100,5500
431447,202109,85,60,25,66000,27500,93500
431449,202109,51,42,9,46200,9900,56100
431450,202109,407,266,141,292600,155100,447700
431454,202109,14,7,7,7700,7700,15400
431455,202109,47,37,10,41800,11000,52800
431460,202109,500,342,158,376200,173800,550000
431470,202109,120,87,33,95700,36300,132000
431475,202109,10,8,2,8800,2200,11000
431477,202109,37,22,15,24200,16500,40700
431478,202109,9,8,1,9900,1100,11000
431480,202109,564,330,234,365200,257400,622600
431490,202109,29001,16037,12964,17664786,14275800,31940586
431500,202109,80,63,17,69300,18700,88000
431505,202109,29,19,10,20900,11000,31900
431507,202109,8,7,1,7700,1100,8800
431510,202109,238,172,66,189200,72600,261800
431513,202109,21,19,2,20900,2200,23100
431514,202109,4,3,1,3300,1100,4400
431515,202109,80,67,13,73700,14300,88000
431517,202109,7,3,4,3300,4400,7700
431520,202109,38,34,4,38500,4400,42900
431530,202109,1433,637,796,700700,875600,1576300
431531,202109,21,19,2,20900,2200,23100
431532,202109,37,28,9,30800,9900,40700
431535,202109,28,15,13,16500,14300,30800
431540,202109,142,117,25,128700,27500,156200
431545,202109,11,9,2,9900,2200,12100
431550,202109,360,194,166,213400,182600,396000
431555,202109,10,10,0,12100,0,12100
431560,202109,4647,3100,1547,3414400,1703900,5118300
431570,202109,836,426,410,468600,451000,919600
431575,202109,44,25,19,27500,22000,49500
431580,202109,88,57,31,62700,34100,96800
431590,202109,140,116,24,127600,26400,154000
431595,202109,19,16,3,17600,3300,20900
431600,202109,254,148,106,162800,116600,279400
431610,202109,112,82,30,90200,33000,123200
431620,202109,42,35,7,38500,7700,46200
431630,202109,129,105,24,115500,26400,141900
431640,202109,1332,827,505,910800,555500,1466300
431642,202109,37,34,3,37400,3300,40700
431643,202109,45,18,27,19800,29700,49500
431645,202109,312,180,132,199100,145200,344300
431647,202109,9,8,1,8800,1100,9900
431650,202109,32,18,14,19800,15400,35200
431660,202109,274,170,104,187000,114400,301400
431670,202109,224,99,125,110000,137500,247500
431673,202109,11,8,3,8800,3300,12100
431675,202109,25,20,5,22000,5500,27500
431680,202109,1135,834,301,921800,332200,1254000
431690,202109,4822,2850,1972,3137200.5,2172500,5309700.5
431695,202109,20,14,6,15400,6600,22000
431697,202109,1,0,1,0,1100,1100
431700,202109,187,138,49,151800,53900,205700
431710,202109,4059,1745,2314,1920600,2545400,4466000
431720,202109,1286,787,499,865150,550000,1415150
431725,202109,1,1,0,1100,0,1100
431730,202109,1150,766,384,845900,422400,1268300
431740,202109,1340,645,695,709500,767800,1477300
431750,202109,1829,1181,648,1299100.32,712800,2011900.32
431755,202109,6,5,1,5500,1100,6600
431760,202109,985,608,377,669900,418000,1087900
431770,202109,421,288,133,316800,146300,463100
431775,202109,28,21,7,23100,7700,30800
431780,202109,543,322,221,355300,244200,599500
431790,202109,160,124,36,136400,39600,176000
431795,202109,13,10,3,11000,3300,14300
431800,202109,3171,1644,1527,1809500.37,1679700,3489200.37
431805,202109,19,17,2,18700,2200,20900
431810,202109,605,395,210,434500,231000,665500
431820,202109,335,199,136,218900,149600,368500
431830,202109,2275,1363,912,1499300,1004300,2503600
431840,202109,475,308,167,339900,183700,523600
431842,202109,35,28,7,30800,7700,38500
431843,202109,11,8,3,8800,3300,12100
431844,202109,17,12,5,13200,5500,18700
431845,202109,25,23,2,25300,2200,27500
431846,202109,24,21,3,23100,3300,26400
431848,202109,12,10,2,11000,2200,13200
431849,202109,6,5,1,5500,1100,6600
431850,202109,759,595,164,655600,180400,836000
431860,202109,121,78,43,85800,47300,133100
431861,202109,6,2,4,2200,4400,6600
431862,202109,56,39,17,42900,18700,61600
431870,202109,3562,2006,1556,2209900,1714900,3924800
431880,202109,950,679,271,748000,299200,1047200
431890,202109,1285,745,540,819500,594000,1413500
431900,202109,189,128,61,140800,67100,207900
431910,202109,49,36,13,39600,14300,53900
431912,202109,49,30,19,33000,20900,53900
431915,202109,141,108,33,118800,36300,155100
431920,202109,153,111,42,122100,46200,168300
431930,202109,81,69,12,75900,13200,89100
431935,202109,2,2,0,2200,0,2200
431936,202109,3,3,0,3300,0,3300
431937,202109,20,15,5,16500,5500,22000
431940,202109,460,312,148,343200,162800,506000
431950,202109,478,304,174,334400,192500,526900
431960,202109,738,397,341,436700,377300,814000
431970,202109,68,62,6,68200,6600,74800
431971,202109,5,3,2,3300,2200,5500
431973,202109,18,15,3,16500,3300,19800
431975,202109,9,8,1,8800,1100,9900
431980,202109,206,122,84,135300,92400,227700
431990,202109,1119,589,530,647828.5,584100,1231928.5
432000,202109,1827,938,889,1032900,977900,2010800
432010,202109,263,179,84,196900,92400,289300
432020,202109,180,148,32,162800,35200,198000
432023,202109,14,12,2,13200,2200,15400
432026,202109,59,53,6,59400,6600,66000
432030,202109,61,29,32,31900,35200,67100
432032,202109,15,11,4,12100,4400,16500
432035,202109,59,45,14,49500,15400,64900
432040,202109,88,59,29,64900,31900,96800
432045,202109,2,2,0,2200,0,2200
432050,202109,82,49,33,55000,36300,91300
432055,202109,127,93,34,102300,37400,139700
432057,202109,7,5,2,5500,2200,7700
432060,202109,35,31,4,34100,4400,38500
432065,202109,31,28,3,30800,3300,34100
432067,202109,86,78,8,85800,8800,94600
432070,202109,386,301,85,332475,93500,425975
432080,202109,830,579,251,636900,276100,913000
432085,202109,7,5,2,5500,2200,7700
432090,202109,265,176,89,193600,97900,291500
432100,202109,172,113,59,124300,64900,189200
432110,202109,545,359,186,396000,205700,601700
432120,202109,996,562,434,618200,477400,1095600
432130,202109,487,344,143,380600,157300,537900
432132,202109,24,21,3,23100,3300,26400
432135,202109,80,65,15,71500,16500,88000
432140,202109,263,200,63,220000,69300,289300
432143,202109,216,131,85,145200,94600,239800
432145,202109,272,190,82,209000,90200,299200
432146,202109,13,12,1,13200,1100,14300
432147,202109,112,58,54,63800,59400,123200
432149,202109,15,9,6,9900,6600,16500
432150,202109,968,592,376,651200,413600,1064800
432160,202109,1586,805,781,885500.5,859100,1744600.5
432162,202109,4,2,2,2200,2200,4400
432163,202109,17,12,5,13200,5500,18700
432166,202109,127,94,33,104775,36300,141075
432170,202109,225,113,112,124300,123200,247500
432180,202109,549,337,212,371800,233200,605000
432183,202109,9,8,1,8800,1100,9900
432185,202109,78,64,14,70400,15400,85800
432190,202109,495,291,204,320100,225500,545600
432195,202109,93,77,16,84700,17600,102300
432200,202109,400,249,151,273900,167200,441100
432210,202109,114,71,43,78100,47300,125400
432215,202109,36,32,4,35200,4400,39600
432218,202109,20,20,0,22000,0,22000
432220,202109,653,335,318,368500,349800,718300
432225,202109,16,11,5,12100,5500,17600
432230,202109,128,82,46,90200,50600,140800
432232,202109,18,15,3,16500,3300,19800
432234,202109,4,2,2,2200,2200,4400
432235,202109,3,2,1,2200,1100,3300
432237,202109,24,15,9,16500,9900,26400
432240,202109,4408,2441,1967,2686200,2163700,4849900
432250,202109,1134,744,390,820600,430100,1250700
432252,202109,49,48,1,52800,1100,53900
432253,202109,59,47,12,51700,13200,64900
432254,202109,28,11,17,12100,18700,30800
432255,202109,13,11,2,12100,2200,14300
432260,202109,837,663,174,729300,191400,920700
432270,202109,223,168,55,184800,60500,245300
432280,202109,144,108,36,118800,39600,158400
432285,202109,1,1,0,1100,0,1100
432290,202109,61,53,8,58300,8800,67100
432300,202109,4802,2537,2265,2795028.5,2493700.4,5288728.9
432310,202109,131,108,23,118800,25300,144100
432320,202109,21,17,4,18700,5500,24200
432330,202109,17,10,7,11000,7700,18700
432335,202109,8,6,2,6600,2200,8800
432340,202109,39,31,8,34100,8800,42900
432345,202109,103,68,35,74800,38500,113300
432350,202109,20,19,1,20900,1100,22000
432360,202109,5,4,1,4400,1100,5500
432370,202109,26,25,1,27500,1100,28600
432375,202109,28,26,2,28600,2200,30800
432377,202109,7,7,0,7700,0,7700
432380,202109,180,77,103,84700,113300,198000
500020,202109,256,133,123,147400,136400,283800
500025,202109,141,71,70,78100,78100,156200
500060,202109,1472,923,549,1015300,605000,1620300
500070,202109,757,363,394,399300,434500,833800
500080,202109,137,107,30,117700,33000,150700
500085,202109,139,109,30,119900,33000,152900
500090,202109,367,171,196,188100,215600,403700
500100,202109,709,369,340,405900,375100,781000
500110,202109,2275,1060,1215,1166000,1336500,2502500
500124,202109,268,145,123,159500,135300,294800
500150,202109,343,138,205,151800,225500,377300
500190,202109,518,346,172,381700,190300,572000
500200,202109,198,167,31,183700,34100,217800
500210,202109,1614,542,1072,596200,1181400,1777600
500215,202109,212,124,88,136400,96800,233200
500220,202109,730,467,263,514800.92,289300,804100.92
500230,202109,237,142,95,156200,104500,260700
500240,202109,642,435,207,478500,227700,706200
500260,202109,581,225,356,247500,391600,639100
500270,202109,30066,12795,17271,14095822.58,19017900,33113722.58
500280,202109,198,67,131,74800,145200,220000
500290,202109,1174,723,451,797500,496100,1293600
500295,202109,457,295,162,324500,178200,502700
500310,202109,94,30,64,33000,71500,104500
500315,202109,813,450,363,495000,400400,895400
500320,202109,3648,1755,1893,1931600.92,2082300.35,4013901.27
500325,202109,949,516,433,569800,476300,1046100
500330,202109,1505,694,811,764480.2,893200,1657680.2
500345,202109,310,232,78,255200,86900,342100
500348,202109,247,148,99,162800,108900,271700
500350,202109,109,54,55,59400,60500,119900
500370,202109,5720,2550,3170,2812701.26,3493600,6306301.26
500375,202109,347,234,113,257400,124300,381700
500380,202109,595,336,259,369600,286000,655600
500390,202109,71,34,37,37400,40700,78100
500400,202109,212,136,76,149600,83600,233200
500410,202109,523,220,303,243100,334400,577500
500430,202109,538,377,161,414700,177100,591800
500440,202109,212,113,99,124300,108900,233200
500450,202109,413,174,239,191400,262900,454300
500460,202109,268,143,125,158400,138600,297000
500470,202109,429,325,104,358600,114400,473000
500480,202109,101,60,41,66000,45100,111100
500490,202109,100,44,56,48400,61600,110000
500500,202109,1430,530,900,584100,993300,1577400
500510,202109,42,35,7,38500,7700,46200
500515,202109,96,67,29,73700,31900,105600
500520,202109,298,157,141,173800,155100,328900
500525,202109,93,50,43,55000,47300,102300
500540,202109,888,388,500,426800,550000,976800
500560,202109,925,516,409,567600,449900,1017500
500568,202109,1003,539,464,596200,510400,1106600
500570,202109,1184,681,503,749100,553300,1302400
500580,202109,326,169,157,185900,172700,358600
500600,202109,339,165,174,181500,191400,372900
500620,202109,936,647,289,716100.5,317900,1034000.5
500625,202109,77,60,17,66000,18700,84700
500627,202109,18,10,8,11000,8800,19800
500630,202109,1567,888,679,977900.63,746900,1724800.63
500635,202109,531,317,214,348700,235400,584100
500640,202109,372,204,168,224400,188100,412500
500660,202109,5726,2047,3679,2255000,4051300,6306300
500690,202109,617,216,401,237600,441100,678700
500710,202109,400,196,204,215600,224400,440000
500720,202109,930,514,416,565400,457600,1023000
500730,202109,175,106,69,116600,75900,192500
500740,202109,904,363,541,399300,595100,994400
500750,202109,161,52,109,57200,121000,178200
500755,202109,117,89,28,97900,30800,128700
500769,202109,762,411,351,453200,386100,839300
500770,202109,430,236,194,259600,214500,474100
500780,202109,140,95,45,104500,49500,154000
500790,202109,1048,511,537,563200,591800,1155000
500793,202109,292,148,144,162800,158400,321200
500795,202109,171,113,58,124300,63800,188100
500797,202109,46,31,15,34100,16500,50600
500800,202109,429,185,244,203500,268400,471900
500830,202109,2209,1202,1007,1324400,1109900,2434300
500840,202109,126,96,30,105600,33000,138600
510010,202109,169,91,78,100100,85800,185900
510020,202109,524,229,295,251900.05,327800,579700.05
510025,202109,1653,923,730,1016400.37,807400,1823800.37
510030,202109,685,338,347,372900,381700,754600
510035,202109,129,67,62,73700,68200,141900
510040,202109,410,190,220,209000,242000,451000
510050,202109,357,192,165,211200,181500.3,392700.3
510060,202109,124,61,63,67100,69300,136400
510080,202109,239,92,147,102300,161700,264000
510100,202109,69,28,41,30800,45100,75900
510120,202109,32,18,14,19800,15400,35200
510125,202109,376,227,149,249700,163900,413600
510130,202109,536,321,215,353100,236500,589600
510140,202109,447,140,307,154000,338800,492800
510160,202109,100,32,68,35200,74800,110000
510170,202109,760,461,299,507100,328900,836000
510180,202109,2923,1351,1572,1486100,1732500,3218600
510185,202109,22,11,11,12100,12100,24200
510190,202109,239,84,155,92400,170500,262900
510250,202109,2594,1562,1032,1720400.08,1136300,2856700.08
510260,202109,174,125,49,137500,53900,191400
510263,202109,458,250,208,275000,228800,503800
510267,202109,642,355,287,390500,315700,706200
510268,202109,63,28,35,30800,38500,69300
510269,202109,77,34,43,37400,47300,84700
510270,202109,392,192,200,211200,220000,431200
510279,202109,210,158,52,174900,57200,232100
510285,202109,178,72,106,79200,116600,195800
510300,202109,510,265,245,291500,269500,561000
510305,202109,202,91,111,100100,123200,223300
510310,202109,109,54,55,59400,60500,119900
510320,202109,829,515,314,567600,345400,913000
510325,202109,424,170,254,187000,279400,466400
510330,202109,428,234,194,257400,215600,473000
510335,202109,651,378,273,415800,302500,718300
510336,202109,55,38,17,41800,18700,60500
510337,202109,101,45,56,49500,61600,111100
510340,202109,17448,7729,9719,8512900.63,10707400,19220300.63
510343,202109,60,43,17,47300,18700,66000
510345,202109,150,93,57,102300,62700,165000
510350,202109,659,352,307,388300,337700,726000
510360,202109,212,133,79,146300,86900,233200
510370,202109,154,70,84,77000,92400,169400
510380,202109,79,60,19,66000,20900,86900
510385,202109,60,28,32,30800,35200,66000
510390,202109,107,47,60,51700,66000,117700
510395,202109,46,32,14,35200,15400,50600
510410,202109,740,465,275,511500,302500,814000
510420,202109,560,265,295,291500,324500,616000
510450,202109,49,24,25,26400,27500,53900
510452,202109,52,22,30,24200,33000,57200
510454,202109,52,24,28,26400,30800,57200
510455,202109,130,75,55,82500,61600,144100
510460,202109,183,83,100,91300,110000,201300
510480,202109,703,417,286,459800,314600,774400
510490,202109,346,174,172,191400,189200,380600
510500,202109,233,173,60,190300,67100,257400
510510,202109,798,461,337,508200,370700,878900
510515,202109,1247,642,605,707300,666600,1373900
510517,202109,265,116,149,127600,163900,291500
510520,202109,214,141,73,155100,80300,235400
510523,202109,106,82,24,90200,26400,116600
510525,202109,845,501,344,553300,378400,931700
510530,202109,21,14,7,15400,7700,23100
510550,202109,239,108,131,118800,144100,262900
510558,202109,294,144,150,159500,165000,324500
510560,202109,400,226,174,248600,191400,440000
510562,202109,633,458,175,503800,192500,696300
510590,202109,739,376,363,413600,400400,814000
510600,202109,218,112,106,123200,116600,239800
510610,202109,231,92,139,101200,152900,254100
510615,202109,191,88,103,96800,113300,210100
510617,202109,26,12,14,13200,15400,28600
510618,202109,120,58,62,63800,68200,132000
510619,202109,91,65,26,71500,28600,100100
510620,202109,161,90,71,99000,78100,177100
510621,202109,176,111,65,122100,71500,193600
510622,202109,482,272,210,299200,231000,530200
510623,202109,300,203,97,223300,106700,330000
510624,202109,89,49,40,53900,44000,97900
510625,202109,508,319,189,352000,207900.63,559900.63
510626,202109,116,67,49,73700,53900,127600
510627,202109,90,62,28,68200,30800,99000
510628,202109,159,94,65,103400,71500,174900
510629,202109,276,165,111,181500,122119.8,303619.8
510630,202109,443,218,225,239800,247500,487300
510631,202109,13,4,9,4400,9900,14300
510637,202109,349,199,150,218900,165000,383900
510642,202109,1029,542,487,596200,535700,1131900
510645,202109,8,2,6,2200,6600,8800
510650,202109,1341,873,468,961400,514800,1476200
510665,202109,79,32,47,36300,52800,89100
510670,202109,57,31,26,34100,28600,62700
510675,202109,1132,718,414,789800,455400,1245200
510677,202109,346,181,165,199100,182600,381700
510680,202109,97,57,40,62700,44000,106700
510682,202109,196,100,96,110000,105600,215600
510685,202109,53,39,14,42900,15400,58300
510700,202109,556,316,240,347600,264000,611600
510704,202109,1181,612,569,673200,628100,1301300
510706,202109,144,74,70,81400,77000,158400
510710,202109,406,278,128,305800,140800,446600
510715,202109,56,40,16,44000,17600,61600
510718,202109,228,111,117,122100,128700,250800
510719,202109,45,17,28,18700,30800,49500
510720,202109,186,131,55,144100,60500,204600
510724,202109,84,32,52,35200,57200,92400
510726,202109,57,29,28,31900,30800,62700
510729,202109,21,8,13,8800,14300,23100
510730,202109,468,255,213,281600,234300,515900
510735,202109,112,44,68,48400,74800,123200
510740,202109,22,11,11,12100,12100,24200
510757,202109,26,21,5,23100,5500,28600
510760,202109,7200,3612,3588,3976500.65,3953400,7929900.65
510770,202109,676,316,360,347600,396000,743600
510774,202109,16,6,10,6600,11000,17600
510775,202109,113,86,27,94600,29700,124300
510776,202109,33,10,23,11000,25300,36300
510777,202109,198,82,116,91300,127600,218900
510779,202109,38,20,18,22000,19800,41800
510780,202109,265,148,117,162800,128700,291500
510785,202109,366,201,165,222200,181500,403700
510787,202109,183,85,98,94600,107800,202400
510788,202109,6,1,5,1100,5500,6600
510790,202109,2533,1307,1226,1438851,1351900,2790751
510792,202109,1139,632,507,695200,557700.54,1252900.54
510794,202109,109,61,48,67100,52800,119900
510795,202109,2249,1294,955,1424500.11,1051600,2476100.11
510800,202109,187,113,74,124300,81400,205700
510805,202109,196,129,67,141900,73700,215600
510810,202109,100,40,60,44000,66000,110000
510820,202109,233,116,117,127600,128700.5,256300.5
510830,202109,75,41,34,45100,37400,82500
510835,202109,15,10,5,11000,5500,16500
510840,202109,9112,4238,4874,4662900,5363600,10026500
510850,202109,211,88,123,96800,135300,232100
510860,202109,393,180,213,198000,234300,432300
510880,202109,73,52,21,57200,23100,80300
510885,202109,65,38,27,41800,29700,71500
510890,202109,59,33,26,36300,28600,64900
510895,202109,166,96,70,105600,77000,182600
520005,202109,136,56,80,61600,88000,149600
520010,202109,302,134,168,147400,184800,332200
520013,202109,724,480,244,528000,268400,796400
520015,202109,50,35,15,38500,16500,55000
520017,202109,85,50,35,55000,38500,93500
520020,202109,18,10,8,11000,8800,19800
520025,202109,2571,1325,1246,1458600,1371700,2830300
520030,202109,822,442,380,486475,418000,904475
520050,202109,67,47,20,51700,22000,73700
520055,202109,57,37,20,40700,22000,62700
520060,202109,181,117,64,128700,70400,199100
520080,202109,591,430,161,473000,177100,650100
520082,202109,17,11,6,12100,6600,18700
520085,202109,87,66,21,72600,23100,95700
520090,202109,87,61,26,67100,28600,95700
520110,202109,9214,3932,5282,4329600,5817900,10147500
520120,202109,10,5,5,5500,5500,11000
520130,202109,811,568,243,624800,267300,892100
520140,202109,11981,6629,5352,7302900,5898200,13201100
520145,202109,56,34,22,37400,24200,61600
520150,202109,156,124,32,136400,35200,171600
520160,202109,45,31,14,34100,15400,49500
520170,202109,238,136,102,149600,112200,261800
520180,202109,177,81,96,89100,106700,195800
520215,202109,205,138,67,151800,73700,225500
520235,202109,82,64,18,70400,19800,90200
520250,202109,128,75,53,82500,58300,140800
520260,202109,113,72,41,79200,45100,124300
520280,202109,44,30,14,33000,15400,48400
520310,202109,44,26,18,28600,19800,48400
520320,202109,172,107,65,117700,71500,189200
520330,202109,817,440,377,484000,414700,898700
520340,202109,362,208,154,228800,169400,398200
520350,202109,501,240,261,265100,287100,552200
520355,202109,89,48,41,52800,45100,97900
520357,202109,26,19,7,20900,7700,28600
520360,202109,4,2,2,2200,2200,4400
520380,202109,140,77,63,84700,69300,154000
520390,202109,249,103,146,113300,160600,273900
520393,202109,17,13,4,14300,4400,18700
520396,202109,74,50,24,55000,27500,82500
520400,202109,197,117,80,128700,88000,216700
520410,202109,189,94,95,103400,104500,207900
520420,202109,21,13,8,14300,8800,23100
520425,202109,268,137,131,150700,145200,295900
520430,202109,513,245,268,269601.2,294800,564401.2
520440,202109,679,489,190,539000,209000,748000
520450,202109,2058,866,1192,952600,1311200,2263800
520455,202109,59,34,25,37400,27500,64900
520460,202109,35,21,14,23100,15400,38500
520465,202109,31,25,6,27500,6600,34100
520470,202109,435,275,160,303600,176000,479600
520480,202109,82,47,35,51700,38500,90200
520485,202109,104,39,65,42900,71500,114400
520490,202109,419,314,105,346500,115500,462000
520495,202109,156,92,64,101200,70400,171600
520500,202109,192,151,41,166100,45100,211200
520505,202109,193,115,78,126500,85800,212300
520510,202109,1862,882,980,971300,1079100,2050400
520520,202109,51,35,16,38500,17600,56100
520530,202109,217,170,47,187000,51700,238700
520540,202109,631,426,205,469700,225500,695200
520545,202109,134,74,60,82500,66000,148500
520547,202109,59,34,25,37400,27500,64900
520549,202109,1309,592,717,654500,788700,1443200
520551,202109,318,165,153,181500,168300,349800
520552,202109,34,24,10,26400,11000,37400
520570,202109,15,9,6,9900,6600,16500
520580,202109,273,169,104,185900,114400,300300
520590,202109,139,81,58,89100,63800,152900
520620,202109,1132,526,606,579700,667700,1247400
520630,202109,42,21,21,23100,23100,46200
520640,202109,374,215,159,236500,174900,411400
520650,202109,67,34,33,37400,36300,73700
520660,202109,43,23,20,25300,22000,47300
520670,202109,38,31,7,34100,7700,41800
520680,202109,44,27,17,29700,18700,48400
520690,202109,39,10,29,11000,31900,42900
520710,202109,35,30,5,33000,5500,38500
520725,202109,197,146,51,160600,56100,216700
520735,202109,56,35,21,38500,23100,61600
520740,202109,448,218,230,239800,253000,492800
520750,202109,33,24,9,26400,9900,36300
520753,202109,69,46,23,50600,25300,75900
520760,202109,106,71,35,78100,38500,116600
520780,202109,272,206,66,226600,72600,299200
520790,202109,163,92,71,101200,78100,179300
520800,202109,3426,1882,1544,2072400,1700600,3773000
520810,202109,148,113,35,124300,38500,162800
520815,202109,4,3,1,3300,1100,4400
520830,202109,147,101,46,111100,50600,161700
520840,202109,375,245,130,270600,145200,415800
520850,202109,103,58,45,63800,49500,113300
520860,202109,1764,1121,643,1234200,708400,1942600
520870,202109,31929,14729,17200,16219500.5,18933200,35152700.5
520880,202109,1179,628,551,693000,606100,1299100
520890,202109,794,485,309,533500,339900,873400
520910,202109,974,521,453,575300.4,499400,1074700.4
520915,202109,88,69,19,75900,20900,96800
520920,202109,443,208,235,228800,258500,487300
520929,202109,19,17,2,18700,2200,20900
520940,202109,69,50,19,56100,20900,77000
520945,202109,14,10,4,11000,4400,15400
520960,202109,39,25,14,27500,15400,42900
520970,202109,365,213,152,234300,167200.3,401500.3
520980,202109,91,66,25,72600,27500,100100
520990,202109,448,317,131,348700,144100,492800
520993,202109,126,62,64,68200,70400,138600
520995,202109,253,140,113,154000,124300,278300
521000,202109,1547,899,648,990000,715000,1705000
521010,202109,676,348,328,382800,360800,743600
521015,202109,15,10,5,11000,5500,16500
521020,202109,1408,983,425,1083500,469700,1553200
521030,202109,57,36,21,39600,23100,62700
521040,202109,941,610,331,671000,365200,1036200
521056,202109,51,33,18,36300,19800,56100
521060,202109,126,82,44,90200,48400,138600
521080,202109,373,288,85,316800,93500,410300
521090,202109,559,361,198,398200,217800,616000
521100,202109,263,196,67,215600,73700,289300
521120,202109,1055,736,319,809600,352000,1161600
521130,202109,348,251,97,276100,106700,382800
521140,202109,182,100,82,110000,90200,200200
521150,202109,2582,1100,1482,1212200,1631300,2843500
521160,202109,24,10,14,11000,15400,26400
521170,202109,219,128,91,140800,100100,240900
521180,202109,1178,754,424,829400,467500,1296900
521190,202109,2522,1050,1472,1156100,1622500,2778600
521200,202109,53,40,13,44000,14300,58300
521205,202109,10,7,3,7700,3300,11000
521210,202109,122,74,48,81400,52800,134200
521220,202109,733,516,217,567600,238700,806300
521225,202109,26,19,7,20900,7700,28600
521230,202109,110,68,42,74800,46200,121000
521250,202109,6292,3528,2764,3884100.9,3040400,6924500.9
521260,202109,33,15,18,16500,19800,36300
521270,202109,134,102,32,112200,35200,147400
521280,202109,423,261,162,287100,178200,465300
521290,202109,27,18,9,19800,9900,29700
521295,202109,99,65,34,71500,37400,108900
521300,202109,223,123,100,135300,110000,245300
521305,202109,38,28,10,30800,11000,41800
521308,202109,1022,780,242,859100,266200,1125300
521310,202109,1342,757,585,832615,643500,1476115
521340,202109,20,16,4,17600,4400,22000
521350,202109,118,91,27,100100,29700,129800
521370,202109,168,116,52,127600,57200,184800
521375,202109,181,92,89,101200,97900,199100
521377,202109,51,40,11,44000,13200,57200
521380,202109,1055,647,408,711700,448800,1160500
521385,202109,12,7,5,7700,5500,13200
521390,202109,99,82,17,90200,18700,108900
521400,202109,347,236,111,260700,123200,383900
521405,202109,144,81,63,89100,69300,158400
521410,202109,75,53,22,58300,24200,82500
521440,202109,196,135,61,149600,67100,216700
521450,202109,765,422,343,464200,377300,841500
521460,202109,1103,718,385,790900,424600,1215500
521470,202109,11,8,3,8800,3300,12100
521480,202109,39,28,11,30800,12100,42900
521483,202109,314,195,119,215600,130900,346500
521486,202109,294,187,107,205700,117700,323400
521487,202109,24,11,13,12100,14300,26400
521490,202109,22,11,11,12100,12100,24200
521500,202109,134,67,67,73700,73700,147400
521520,202109,45,35,10,38500,11000,49500
521523,202109,827,491,336,540100,370700,910800
521525,202109,44,27,17,29700,18700,48400
521530,202109,238,128,110,140800,122100,262900
521540,202109,39,19,20,20900,22000,42900
521550,202109,94,40,54,44000,59400,103400
521560,202109,832,559,273,616000,301400,917400
521565,202109,66,48,18,52800,19800,72600
521570,202109,548,352,196,387200,215600,602800
521580,202109,56,32,24,35200,26400,61600
521590,202109,35,16,19,17600,20900,38500
521600,202109,23,12,11,13200,12100,25300
521630,202109,242,126,116,138600,127600,266200
521640,202109,305,165,140,181500,155100,336600
521645,202109,38,21,17,23100,18700,41800
521680,202109,244,150,94,165000,103400,268400
521690,202109,3,3,0,3300,0,3300
521710,202109,1132,542,590,596200,649000,1245200
521720,202109,548,379,169,416900,185900,602800
521730,202109,671,314,357,345400,392700,738100
521740,202109,879,381,498,419100,547800,966900
521760,202109,2183,1139,1044,1252972.45,1150600,2403572.45
521770,202109,817,508,309,558800,341000,899800
521800,202109,1954,1269,685,1397000,754600,2151600
521805,202109,33,17,16,18700,17600,36300
521810,202109,92,55,37,60500,40700,101200
521830,202109,968,684,284,753500.73,312400,1065900.73
521839,202109,87,50,37,55000,40700,95700
521850,202109,1120,563,557,620400.17,612700,1233100.17
521860,202109,327,208,119,228800,130900,359700
521870,202109,74,45,29,49500,31900,81400
521878,202109,37,15,22,16500,24200,40700
521880,202109,4811,2119,2692,2332000,2967800,5299800
521890,202109,595,415,180,456500,198000,654500
521900,202109,284,225,59,247500,64900,312400
521910,202109,167,114,53,125400,58300,183700
521920,202109,45,23,22,25300,24200,49500
521925,202109,56,33,23,36300,25300,61600
521930,202109,1170,648,522,712800,574200,1287000
521935,202109,33,23,10,25300,11000,36300
521940,202109,203,93,110,102300,121000,223300
521945,202109,18,14,4,15400,4400,19800
521950,202109,10,6,4,6600,4400,11000
521960,202109,69,51,18,56613.33,19800,76413.33
521970,202109,410,259,151,284900,166100,451000
521971,202109,107,56,51,61600,56100,117700
521973,202109,36,19,17,20900,19800,40700
521975,202109,1552,789,763,870100.75,840400.18,1710500.93
521980,202109,246,166,80,182600,88000,270600
521990,202109,74,54,20,59400,22000,81400
522000,202109,291,189,102,207516.1,112200,319716.1
522005,202109,18,10,8,11000,8800,19800
522010,202109,1127,635,492,698500,542300,1240800
522015,202109,62,36,26,39600,28600,68200
522020,202109,895,519,376,571303.33,414700,986003.33
522026,202109,26,17,9,18700,9900,28600
522028,202109,16,12,4,13200,4400,17600
522040,202109,774,321,453,353100,498300,851400
522045,202109,2493,1487,1006,1639000,1107700,2746700
522050,202109,157,76,81,83600,89100,172700
522060,202109,545,345,200,379500,220000,599500
522068,202109,105,74,31,81400,34100,115500
522070,202109,10,10,0,11000,0,11000
522100,202109,34,21,13,23100,14300,37400
522108,202109,44,33,11,36300,12100,48400
522119,202109,56,31,25,34100,27500,61600
522130,202109,73,26,47,28600,51700,80300
522140,202109,4098,2118,1980,2332000.71,2183500,4515500.71
522145,202109,47,34,13,37400,14300,51700
522150,202109,99,69,30,75900,33000,108900
522155,202109,55,43,12,47300,13200,60500
522157,202109,6,4,2,4400,2200,6600
522160,202109,1672,993,679,1092300,750200,1842500
522170,202109,400,268,132,294800,146300,441100
522180,202109,35,14,21,15400,23100,38500
522185,202109,2210,904,1306,994400,1439900,2434300
522190,202109,58,31,27,34100,29700,63800
522200,202109,304,182,122,200200,134200,334400
522205,202109,148,99,49,108900,53900,162800
522220,202109,142,106,36,116600,39600,156200
522230,202109,29,24,5,26400,5500,31900
530010,202109,54580,27493,27087,30271181.82,29821176.85,60092358.67
110001,202110,501,406,95,447700,104500,552200
110002,202110,2835,1793,1042,1973400.89,1146200,3119600.89
110003,202110,81,66,15,72600,16500,89100
110004,202110,2007,1338,669,1475100,735900,2211000
110005,202110,428,342,86,376200,94600,470800
110006,202110,438,328,110,360836.66,121000,481836.66
110007,202110,69,56,13,61600,14300,75900
110008,202110,246,136,110,149600,121000,270600
110009,202110,911,684,227,752400,250800,1003200
110010,202110,1676,996,680,1095600.19,749100,1844700.19
110011,202110,1698,1313,385,1446500,423500,1870000
110012,202110,4079,2367,1712,2605900,1884300,4490200
110013,202110,744,591,153,650100,168300,818400
110014,202110,365,320,45,352000,49500,401500
110015,202110,1363,1077,286,1184700,315700,1500400
110018,202110,1046,639,407,702900,447700,1150600
110020,202110,15704,8893,6811,9788901.45,7498700,17287601.45
110025,202110,640,465,175,511500,192500,704000
110026,202110,36,24,12,26400,13200,39600
110028,202110,1586,1123,463,1236400,510400,1746800
110029,202110,132,120,12,132000,13200,145200
110030,202110,2378,1581,797,1740024.55,877800.85,2617825.40
110032,202110,313,239,74,264000,81400,345400
110033,202110,646,465,181,511500,199100,710600
110034,202110,330,242,88,266200.5,96800,363000.5
110037,202110,87,78,9,86900,9900,96800
110040,202110,389,266,123,292600,136400,429000
110045,202110,928,641,287,706163.33,315700,1021863.33
110050,202110,84,73,11,80300,12100,92400
110060,202110,62,37,25,40700,27500,68200
110070,202110,105,66,39,72600,42900,115500
110080,202110,511,291,220,320100,243100,563200
110090,202110,24,20,4,22000,4400,26400
110092,202110,115,61,54,67100,59400,126500
110094,202110,193,137,56,150700,61600,212300
110100,202110,45,30,15,33000,16500,49500
110110,202110,94,52,42,57200,46200,103400
110120,202110,66,58,8,63800,8800,72600
110130,202110,272,220,52,242000.3,57200,299200.3
110140,202110,238,171,67,188100,73700,261800
110143,202110,51,42,9,46200,9900,56100
110145,202110,35,28,7,30800,7700,38500
110146,202110,23,11,12,12100,13200,25300
110147,202110,38,26,12,28600,13200,41800
110148,202110,36,27,9,29700,9900,39600
110149,202110,318,225,93,247500,102300,349800
110150,202110,134,102,32,112200,35200,147400
110155,202110,12,11,1,12100,1100,13200
110160,202110,66,52,14,57200,15400,72600
110170,202110,216,164,52,180400,57200,237600
110175,202110,63,49,14,53900,15400,69300
110180,202110,92,75,17,82500,18700,101200
120001,202110,195,147,48,161700.55,52800.55,214501.10
120005,202110,191,106,85,116600.41,93500,210100.41
120010,202110,1132,692,440,761200,484000,1245200
120013,202110,151,102,49,112200,53900,166100
120017,202110,115,64,51,70400,56100,126500
120020,202110,3487,2820,667,3106478.95,735913.2,3842392.15
120025,202110,551,305,246,335501.03,270600,606101.03
120030,202110,1054,904,150,996651.95,165009.9,1161661.85
120032,202110,38,34,4,37400,4400,41800
120033,202110,220,193,27,212307.7,29700.55,242008.25
120034,202110,175,128,47,140800,51700,192500
120035,202110,37,31,6,34100,6600,40700
120038,202110,415,267,148,293703.3,162801.1,456504.4
120039,202110,28,28,0,30801.65,,30801.65
120040,202110,13909,9378,4531,10325924.83,4986654.75,15312579.58
120042,202110,43,38,5,41800.55,5500.55,47301.10
120043,202110,13,3,10,3300,11000,14300
120045,202110,534,338,196,372901.1,215601.65,588502.75
120050,202110,1253,958,295,1053857.3,324513.2,1378370.5
120060,202110,1433,1182,251,1301356.1,276106.6,1577462.7
120070,202110,405,293,112,322301.15,123200,445501.15
120080,202110,177,109,68,119901.1,74800.55,194701.65
130002,202110,163,119,44,130900,48400,179300
130006,202110,99,64,35,70400,38500,108900
130008,202110,126,69,57,75900,63800,139700
130010,202110,156,94,62,103400,68200,171600
130014,202110,273,195,78,214500,85800,300300
130020,202110,113,68,45,74800,49500,124300
130030,202110,937,535,402,588500,442200,1030700
130040,202110,350,167,183,183700,201300,385000
130050,202110,539,275,264,302500,290400,592900
130060,202110,843,576,267,633600,293700,927300
130063,202110,609,366,243,403700,268400,672100
130068,202110,198,120,78,132000,85800,217800
130070,202110,1328,892,436,981200,479600,1460800
130080,202110,692,456,236,501600,259600,761200
130083,202110,68,38,30,41800,33000,74800
130090,202110,336,191,145,210100,159500,369600
130100,202110,1197,547,650,601700,715000,1316700
130110,202110,717,315,402,346500,442200,788700
130115,202110,142,65,77,71500,84700,156200
130120,202110,1599,993,606,1093400,666600,1760000
130130,202110,609,419,190,460900,209000,669900
130140,202110,1560,1210,350,1331000,385000,1716000
130150,202110,402,356,46,392700,50600,443300
130160,202110,430,252,178,277200,196900,474100
130165,202110,44,34,10,37400,11000,48400
130170,202110,1024,711,313,782029.6,344300.9,1126330.5
130180,202110,244,178,66,195800,72600,268400
130185,202110,2199,1015,1184,1116500,1302400,2418900
130190,202110,3374,2119,1255,2332000,1382700,3714700
130195,202110,281,224,57,246400,62700,309100
130200,202110,172,81,91,89100,101200,190300
130210,202110,92,48,44,52800,48400,101200
130220,202110,193,137,56,150700,61600,212300
130230,202110,364,236,128,259600,140800,400400
130240,202110,1331,857,474,942700,522500,1465200
130250,202110,4994,3123,1871,3437500,2059200,5496700
130255,202110,419,206,213,226600,234300,460900
130260,202110,58408,27435,30973,30204812.06,34092531,64297343.06
130270,202110,1533,1043,490,1147399,539000,1686399
130280,202110,131,76,55,83600,60500,144100
130290,202110,2094,1407,687,1547700,755700,2303400
130300,202110,418,284,134,312400,147400,459800
130310,202110,888,478,410,525800,451000,976800
130320,202110,529,279,250,306900,276100,583000
130330,202110,769,487,282,535700,311300,847000
130340,202110,3393,1902,1491,2092200,1640100,3732300
130350,202110,482,330,152,363000,167200,530200
130353,202110,922,402,520,442200,572000,1014200
130356,202110,783,345,438,379500,481800,861300
130360,202110,85,65,20,71500,22000,93500
130370,202110,670,517,153,568700,168300,737000
130380,202110,648,504,144,554400,158400,712800
130390,202110,458,371,87,408100,96800,504900
130395,202110,158,43,115,47300,126500,173800
130400,202110,69,47,22,51700,24200,75900
130406,202110,2133,1230,903,1353000,994400,2347400
130410,202110,452,225,227,247500,249700,497200
130420,202110,2812,2282,530,2511300,583000,3094300
130423,202110,153,79,74,86900,81400,168300
130426,202110,178,94,84,103400,92400,195800
130430,202110,407,239,168,262900,184800,447700
130440,202110,200,64,136,70400,149600,220000
140002,202110,24,5,19,5500,20900,26400
140005,202110,208,124,84,137500,92400,229900
140010,202110,11187,6884,4303,7577902.67,4735500.91,12313403.58
140015,202110,144,64,80,70400,88000,158400
140017,202110,121,66,55,72600,60500,133100
140020,202110,451,291,160,321200,176000,497200
140023,202110,37,17,20,18700,22000,40700
140028,202110,22,11,11,12100,12100,24200
140030,202110,357,237,120,260700,132000,392700
140040,202110,64,44,20,48400,22000,70400
140045,202110,272,103,169,113300,187000,300300
140047,202110,435,290,145,319000,159500,478500
140050,202110,140,86,54,94600,59400,154000
140060,202110,63,38,25,41800,27500,69300
140070,202110,31,29,2,31900,2200,34100
150010,202110,4882,2928,1954,3223000,2149400,5372400
150013,202110,166,117,49,128700,53900,182600
150020,202110,1100,596,504,656700,555500,1212200
150030,202110,708,317,391,348700.02,430100,778800.02
150034,202110,204,125,79,137500,86900,224400
150040,202110,1530,862,668,949300,735900,1685200
150050,202110,686,390,296,429000,325600,754600
150060,202110,4809,3020,1789,3323007,1968355.4,5291362.4
150070,202110,432,221,211,243100,232100,475200
150080,202110,16082,7449,8633,8200500,9499600.9,17700100.9
150085,202110,418,267,151,293700,166100,459800
150090,202110,689,583,106,641300,116600,757900
150095,202110,44,29,15,31900,16500,48400
150100,202110,67,42,25,46200,27500,73700
150110,202110,213,120,93,132000,102300,234300
150120,202110,392,282,110,310200,121000,431200
150125,202110,48,17,31,18700,34100,52800
150130,202110,2118,1078,1040,1185800,1146200,2332000
150140,202110,57543,25332,32211,27879500.82,35457401.82,63336902.64
150145,202110,238,132,106,145200,116600,261800
150150,202110,3208,1402,1806,1542200,1986600,3528800
150157,202110,369,258,111,283800,122100,405900
150160,202110,130,97,33,106700,36300,143000
150170,202110,3844,2801,1043,3084400,1149500,4233900
150172,202110,343,240,103,264000,113300,377300
150175,202110,85,49,36,53900,39600,93500
150178,202110,762,507,255,557700,280500,838200
150180,202110,3190,1551,1639,1706100,1802900,3509000
150190,202110,357,231,126,254100,138600,392700
150195,202110,113,60,53,66000,58300,124300
150200,202110,188,90,98,99000,107800,206800
150210,202110,3209,2530,679,2784100,748000,3532100
150215,202110,597,374,223,411400,245300,656700
150220,202110,3531,2334,1197,2568500.82,1323300,3891800.82
150230,202110,1276,1009,267,1109900.5,293700,1403600.5
150240,202110,6754,3774,2980,4153600.6,3278000,7431600.6
150250,202110,70,38,32,41800,35200,77000
150260,202110,104,68,36,74800,39600,114400
150270,202110,2183,1406,777,1546600,854700,2401300
150275,202110,529,332,197,365200,216700,581900
150276,202110,113,41,72,45100,79200,124300
150277,202110,818,364,454,401500,499400,900900
150280,202110,368,249,119,273900,130900,404800
150285,202110,124,62,62,68200,68024,136224
150290,202110,1171,673,498,740300,547800,1288100
150293,202110,735,338,397,371800,436700,808500
150295,202110,535,243,292,267300.2,322300,589600.2
150300,202110,92,44,48,48400,52800,101200
150304,202110,185,105,80,115500,88000,203500
150307,202110,420,349,71,383900,78100,462000
150309,202110,575,405,170,445500,187000.48,632500.48
150310,202110,253,165,88,181500,96800,278300
150320,202110,1873,1300,573,1430000.5,630300,2060300.5
150330,202110,2058,1183,875,1301300,962500,2263800
150340,202110,199,133,66,146300,73700,220000
150345,202110,634,354,280,390500,308000,698500
150350,202110,396,314,82,346500,90200,436700
150360,202110,4750,2856,1894,3141600,2085600,5227200
150370,202110,826,565,261,623700,287100,910800
150375,202110,199,93,106,102300,116600,218900
150380,202110,1520,1000,520,1103300,572000,1675300
150390,202110,855,490,365,539000,401500,940500
150400,202110,111,91,20,100100,22000,122100
150405,202110,1581,995,586,1094500,644600,1739100
150410,202110,122,74,48,81400,52800,134200
150420,202110,7606,4065,3541,4476079.3,3897300,8373379.3
150430,202110,631,393,238,432300,261800,694100
150440,202110,453,280,173,308000,190300,498300
150442,202110,2314,1222,1092,1344200,1201200,2545400
150445,202110,550,354,196,389400,215600,605000
150450,202110,223,122,101,134200,111100,245300
150460,202110,718,535,183,588500,201300,789800
150470,202110,1293,772,521,849200,573100,1422300
150475,202110,243,184,59,203500,64900,268400
150480,202110,1364,943,421,1037300,463100,1500400
150490,202110,611,358,253,393800,278300,672100
150495,202110,335,249,86,273900,94600,368500
150497,202110,286,198,88,217800,96800,314600
150500,202110,241,146,95,160600,104500,265100
150503,202110,1267,623,644,685300,709500,1394800
150506,202110,916,621,295,683100,324500,1007600
150510,202110,1301,698,603,767800,663300,1431100
150520,202110,317,218,99,239800,108900,348700
150530,202110,1834,1004,830,1104400,914100,2018500
150540,202110,200,145,55,159500,60500,220000
150543,202110,841,423,418,466400,460900,927300
150548,202110,466,334,132,367400,145200,512600
150549,202110,74,46,28,50600,30800.95,81400.95
150550,202110,3039,1509,1530,1661000,1684100,3345100
150553,202110,3433,1917,1516,2109800,1668700,3778500
150555,202110,144,77,67,84700,73700,158400
150560,202110,47,22,25,24200,27500,51700
150563,202110,128,63,65,69300,71500,140800
150565,202110,206,129,77,141900,85800,227700
150570,202110,435,284,151,312400,166100,478500
150580,202110,1702,817,885,898700,973500,1872200
150590,202110,823,530,293,584100,322300,906400
150600,202110,513,300,213,330000,234300,564300
150610,202110,150,121,29,133100,31900,165000
150611,202110,127,83,44,91300,48400,139700
150613,202110,3287,1863,1424,2050400,1567500,3617900
150616,202110,549,302,247,332200,271700,603900
150618,202110,1381,711,670,782100,738100,1520200
150619,202110,400,301,99,331100,108900,440000
150620,202110,1230,714,516,785400,567600,1353000
150630,202110,138,90,48,99000,52800,151800
150635,202110,449,191,258,210100,283800,493900
150640,202110,41,21,20,23100,22000,45100
150650,202110,2422,1388,1034,1526800,1137400,2664200
150655,202110,246,179,67,196900,73700,270600
150658,202110,87,52,35,57200,38500,95700
150660,202110,563,363,200,399300,220000,619300
150670,202110,1123,390,733,429000,806300,1235300
150680,202110,10588,5492,5096,6044502.03,5610000,11654502.03
150690,202110,27,14,13,15400,14300,29700
150700,202110,503,326,177,358600,194700,553300
150710,202110,295,168,127,184800,139700,324500
150715,202110,839,526,313,578600,345400,924000
150720,202110,420,319,101,352000,111100,463100
150730,202110,1068,524,544,576400,599500,1175900
150740,202110,238,155,83,170500,91300,261800
150745,202110,752,420,332,462000,365200,827200
150746,202110,69,35,34,38500,37400,75900
150747,202110,228,169,59,185900,64900,250800
150750,202110,140,79,61,86900,67100,154000
150760,202110,1817,1168,649,1284800.5,715000,1999800.5
150770,202110,396,223,173,245300,190300,435600
150775,202110,102,54,48,59400,52800,112200
150780,202110,195,113,82,124300,90200,214500
150790,202110,665,369,296,405900,325600,731500
150795,202110,1607,962,645,1059300,710600,1769900
150796,202110,343,194,149,213400,163900,377300
150797,202110,377,177,200,194700,220000,414700
150800,202110,1557,868,689,954800,757900,1712700
150803,202110,525,416,109,457600,119900,577500
150805,202110,211,122,89,134200,97900,232100
150808,202110,1042,535,507,588500,559900,1148400
150810,202110,3231,2186,1045,2404600.52,1149500,3554100.52
150812,202110,485,247,238,271700,261800,533500
150815,202110,1130,696,434,766700,478500,1245200
150820,202110,1545,934,611,1027400,672100,1699500
150830,202110,553,409,144,449900,158400,608300
150835,202110,220,127,93,139700,103400,243100
150840,202110,1398,835,563,919600,619300,1538900
160005,202110,62,43,19,47300.08,20900.04,68200.12
160010,202110,196,121,75,133100.12,82500.08,215600.20
160015,202110,141,85,56,93500.06,61600,155100.06
160020,202110,141,75,66,82500.04,72600,155100.04
160021,202110,67,27,40,29700.04,44000.02,73700.06
160023,202110,66,42,24,47300.08,26400.04,73700.12
160025,202110,25,12,13,13200.02,14300.04,27500.06
160027,202110,1477,831,646,914101.92,712800.98,1626902.90
160030,202110,16472,8404,8068,9247714.59,8882509.94,18130224.53
160040,202110,298,175,123,192500.12,135300.02,327800.14
160050,202110,745,364,381,400400.22,420200.04,820600.26
160053,202110,286,168,118,184800.26,129800.14,314600.40
160055,202110,22,14,8,15400.02,8800.02,24200.04
160060,202110,6649,3524,3125,3876410.11,3439707.1,7316117.21
160070,202110,188,111,77,122100.02,84700.02,206800.04
160080,202110,122,61,61,67100,67100,134200
170025,202110,28,14,14,15400,15400,30800
170030,202110,193,156,37,171600.03,40700,212300.03
170035,202110,200,97,103,106700,113300,220000
170040,202110,174,129,45,141900,49500,191400
170070,202110,320,202,118,222200,129800,352000
170100,202110,348,256,92,281600,101200,382800
170105,202110,50,42,8,46200,8800,55000
170110,202110,118,70,48,77000,52800,129800
170130,202110,71,36,35,39600,38500,78100
170190,202110,95,56,39,61600,42900,104500
170200,202110,345,239,106,262900,116600,379500
170210,202110,6320,3327,2993,3662734.25,3294500.8,6957235.05
170215,202110,137,68,69,74800,75900,150700
170220,202110,1355,988,367,1086800,404800,1491600
170230,202110,146,94,52,104500,57200,161700
170240,202110,509,340,169,374000,185900,559900
170255,202110,1046,847,199,931700,218900,1150600
170270,202110,48,34,14,37400,15400,52800
170290,202110,121,75,46,82500,50600,133100
170300,202110,106,66,40,72600,44000,116600
170305,202110,47,35,12,38500,13200,51700
170307,202110,57,43,14,47300,15400,62700
170310,202110,122,68,54,75423.33,59400,134823.33
170320,202110,29,17,12,18700,13200,31900
170330,202110,29,22,7,24200,7700,31900
170360,202110,31,18,13,19800,14300,34100
170370,202110,90,45,45,49500,49500,99000
170380,202110,73,56,17,61600,18700,80300
170382,202110,36,31,5,34100,5500,39600
170384,202110,146,113,33,124300,36300,160600
170386,202110,67,28,39,30800,42900,73700
170388,202110,47,19,28,20900,30800,51700
170389,202110,25,21,4,23100,4400,27500
170390,202110,75,45,30,49500,33000,82500
170410,202110,24,22,2,24200,2200,26400
170460,202110,15,9,6,9900,6600,16500
170510,202110,35,27,8,29700,8800,38500
170550,202110,1550,890,660,979000,726000,1705000
170555,202110,105,78,27,85800,29700,115500
170560,202110,104,74,30,81400,33000,114400
170600,202110,40,11,29,12100,31900,44000
170610,202110,191,100,91,110000,100100,210100
170625,202110,37,22,15,24200,16500,40700
170650,202110,95,68,27,74800,29700,104500
170700,202110,572,422,150,464200,165000,629200
170710,202110,149,94,55,103400,60500,163900
170720,202110,99,77,22,84700,24200,108900
170730,202110,96,56,40,61600,44000,105600
170740,202110,85,60,25,66000,27500,93500
170755,202110,54,29,25,31900,27500,59400
170765,202110,136,73,63,80300,69300,149600
170770,202110,194,124,70,136400,77000,213400
170820,202110,587,385,202,423500,222200,645700
170825,202110,40,21,19,23100,20900,44000
170830,202110,87,70,17,77000,18700,95700
170900,202110,173,133,40,146300,44000,190300
170930,202110,930,504,426,555500,469700,1025200
170950,202110,3150,1450,1700,1597200,1874400.4,3471600.4
170980,202110,17,11,6,12100,6600,18700
171050,202110,145,109,36,119900,39600,159500
171070,202110,51,43,8,47300,8800,56100
171090,202110,47,34,13,37400,14300,51700
171110,202110,23,17,6,18700,6600,25300
171150,202110,42,23,19,25300,20900,46200
171180,202110,28,13,15,14300,16500,30800
171190,202110,167,96,71,106700,79200,185900
171195,202110,61,50,11,55000,13200,68200
171200,202110,40,19,21,20900,23100,44000
171215,202110,7,5,2,5500,2200,7700
171240,202110,63,45,18,49500,19800,69300
171245,202110,57,48,9,52800,9900,62700
171250,202110,74,42,32,46200,35200,81400
171270,202110,15,11,4,12100,4400,16500
171280,202110,43,35,8,38500,8800,47300
171320,202110,1001,565,436,621500,479600,1101100
171330,202110,421,212,209,233310,229900,463210
171360,202110,96,66,30,72600,33000,105600
171370,202110,35,17,18,18700,19800,38500
171380,202110,130,113,17,124300,18700,143000
171395,202110,47,27,20,29700,22000,51700
171420,202110,262,172,90,189200,99000,288200
171430,202110,72,58,14,63800,15400,79200
171488,202110,203,111,92,122100,101200,223300
171500,202110,64,35,29,38500,31900,70400
171510,202110,73,49,24,53900,26400,80300
171515,202110,38,31,7,34100,7700,41800
171525,202110,27,24,3,26400,3300,29700
171550,202110,15,9,6,9900,6600,16500
171570,202110,50,25,25,27500,27500,55000
171575,202110,275,181,94,199100,103400,302500
171610,202110,1767,888,879,976800,966900,1943700
171620,202110,142,97,45,106700,49500,156200
171630,202110,54,30,24,33000,26400,59400
171650,202110,323,221,102,243100,112200,355300
171660,202110,257,146,111,160600,122100,282700
171665,202110,76,47,29,51700,31900,83600
171670,202110,428,260,168,286000,184800,470800
171700,202110,65,57,8,62700,8800,71500
171720,202110,29,10,19,11000,20900,31900
171750,202110,110,55,55,60500,60500,121000
171780,202110,76,58,18,63800,19800,83600
171790,202110,83,68,15,74800,16500,91300
171800,202110,33,25,8,27500,8800,36300
171820,202110,2056,1188,868,1307900.7,954800,2262700.7
171830,202110,35,25,10,27500,11000,38500
171840,202110,61,39,22,42900,24200,67100
171845,202110,32,21,11,23100,12100,35200
171850,202110,37,31,6,34100,6600,40700
171855,202110,78,61,17,68200,18700,86900
171865,202110,6,5,1,5500,1100,6600
171870,202110,30,18,12,19800,13200,33000
171875,202110,80,57,23,62736.66,25300,88036.66
171880,202110,36,22,14,24200,15400,39600
171884,202110,48,27,21,29700,23100,52800
171886,202110,133,60,73,66000,80300,146300
171888,202110,24,19,5,20900,5500,26400
171889,202110,11,5,6,5500,6600,12100
171890,202110,54,45,9,49500,9900,59400
171900,202110,32,23,9,25300,9900,35200
172000,202110,37,31,6,34100,6600,40700
172010,202110,55,44,11,48400,12100,60500
172015,202110,23,16,7,17600,7700,25300
172020,202110,148,93,55,102300,60500,162800
172025,202110,38,25,13,27500,14300,41800
172030,202110,44,25,19,27500,20900,48400
172049,202110,82,53,29,58300,31900,90200
172065,202110,125,81,44,89100,48400,137500
172080,202110,116,70,46,77000,50600,127600
172085,202110,29,14,15,15400,16500,31900
172090,202110,434,319,115,350900.88,126500,477400.88
172093,202110,16,13,3,14300,3300,17600
172097,202110,19,11,8,12100,8800,20900
172100,202110,5331,2989,2342,3291200,2579500,5870700
172110,202110,84,52,32,57200,35200,92400
172120,202110,1713,1426,287,1568600,315700,1884300
172125,202110,11,10,1,11000,1100,12100
172130,202110,24,13,11,14300,12100,26400
172208,202110,205,123,82,135300,90200,225500
172210,202110,369,183,186,201300,204600,405900
210005,202110,2930,1838,1092,2022900.32,1201200,3224100.32
210010,202110,147,88,59,97900,64900,162800
210015,202110,40,29,11,31900,12100,44000
210020,202110,359,207,152,227700,167200,394900
210030,202110,317,212,105,233200,115500,348700
210040,202110,132,107,25,117700,27500,145200
210043,202110,251,198,53,217800,58300,276100
210047,202110,506,310,196,341000,216700,557700
210050,202110,279,208,71,228800,78100,306900
210055,202110,50,42,8,46200,8800,55000
210060,202110,535,435,100,478500,110000,588500
210070,202110,429,334,95,367400,104500,471900
210080,202110,136,124,12,136400,13200,149600
210083,202110,284,141,143,155100,157300,312400
210087,202110,4,3,1,3300,1100,4400
210090,202110,433,314,119,345400,130900,476300
210095,202110,416,321,95,354200,104500,458700
210100,202110,681,541,140,595100,154000,749100
210110,202110,118,76,42,83600,46200,129800
210120,202110,4904,3874,1030,4262500,1133000,5395500
210125,202110,184,113,71,124300,78100,202400
210130,202110,452,267,185,293700,203500,497200
210135,202110,29,22,7,24200,7700,31900
210140,202110,4418,3413,1005,3755400,1105500,4860900
210150,202110,359,227,132,249700,145200,394900
210160,202110,3252,2778,474,3055800.54,521400,3577200.54
210170,202110,1192,958,234,1053800,257400,1311200
210173,202110,122,107,15,117700,16500,134200
210177,202110,331,190,141,209000,155100,364100
210180,202110,28,15,13,16500,14300,30800
210190,202110,433,285,148,313500,162800,476300
210193,202110,6,5,1,5500,1100,6600
210197,202110,69,51,18,56100,19800,75900
210200,202110,609,516,93,568700,102300,671000
210203,202110,211,149,62,163900,68200,232100
210207,202110,363,303,60,333300,66000,399300
210210,202110,726,671,55,738100,60500,798600
210215,202110,71,62,9,68200,9900,78100
210220,202110,378,320,58,352000,64900,416900
210230,202110,306,245,61,269500,67100,336600
210232,202110,1291,898,393,987800,432300,1420100
210235,202110,182,140,42,154000,46200,200200
210237,202110,34,19,15,20900,16500,37400
210240,202110,79,66,13,72600,14300,86900
210250,202110,175,148,27,162800,29700,192500
210255,202110,363,277,86,304700,94600,399300
210260,202110,391,272,119,300300,130900,431200
210270,202110,627,426,201,468600,221100,689700
210275,202110,83,62,21,68200,23100,91300
210280,202110,1045,689,356,757900,391600,1149500
210290,202110,525,360,165,396000,181500,577500
210300,202110,5073,3238,1835,3564000.98,2018500,5582500.98
210310,202110,107,77,30,84700,33000,117700
210312,202110,116,82,34,90200,37400,127600
210315,202110,104,87,17,95700,18700,114400
210317,202110,138,103,35,113300,38500,151800
210320,202110,2288,1972,316,2172500,347600,2520100
210325,202110,139,84,55,92400,60500,152900
210330,202110,4305,2530,1775,2784100.09,1953600,4737700.09
210340,202110,1200,913,287,1004300,316800,1321100
210350,202110,649,537,112,590700,123200,713900
210355,202110,146,124,22,136400,24200,160600
210360,202110,2108,1486,622,1635700,684200,2319900
210370,202110,1219,614,605,675400,665500,1340900
210375,202110,187,94,93,103400,102300,205700
210380,202110,722,560,162,617100,178200,795300
210390,202110,192,163,29,179300,31900,211200
210400,202110,391,339,52,372900,57200,430100
210405,202110,1000,707,293,778800,322300,1101100
210407,202110,61,48,13,52800,14300,67100
210408,202110,38,33,5,36300,5500,41800
210409,202110,325,285,40,313500,44000,357500
210410,202110,431,341,90,376200,99000,475200
210420,202110,205,170,35,187000,38500,225500
210430,202110,52,36,16,39600,17600,57200
210440,202110,367,248,119,272800,130900,403700
210450,202110,99,81,18,89100,19800,108900
210455,202110,238,126,112,138600,123200,261800
210460,202110,302,207,95,227700,104500,332200
210462,202110,62,52,10,57200,11000,68200
210465,202110,136,109,27,119900,29700,149600
210467,202110,506,381,125,419100,137500,556600
210470,202110,47,40,7,44000,7700,51700
210480,202110,1273,914,359,1006500,394900,1401400
210490,202110,186,129,57,141900,62700,204600
210500,202110,501,310,191,341000,210100,551100
210510,202110,525,420,105,462000,115500,577500
210515,202110,352,223,129,245300,141900,387200
210520,202110,404,367,37,403700,40700,444400
210530,202110,9374,4876,4498,5368000.48,4950000.83,10318001.31
210535,202110,126,96,30,105600,33000,138600
210540,202110,1491,1008,483,1109900,531300,1641200
210542,202110,1128,574,554,631400,613800,1245200
210545,202110,19,17,2,18700,2200,20900
210547,202110,123,109,14,119900,15400,135300
210550,202110,618,445,173,489500,190300,679800
210560,202110,150,132,18,145200,19800,165000
210565,202110,21,15,6,16500,6600,23100
210570,202110,1271,1048,223,1152800.59,246400,1399200.59
210580,202110,119,101,18,112200,19800,132000
210590,202110,721,603,118,665500,129800,795300
210592,202110,39,36,3,39600,3300,42900
210594,202110,105,88,17,96800,18700,115500
210596,202110,110,96,14,105600,16500,122100
210598,202110,139,105,34,115500,37400,152900
210600,202110,303,263,40,289300,44000,333300
210610,202110,246,231,15,254100,16500,270600
210620,202110,44,27,17,29700,18700,48400
210630,202110,71,66,5,73700,5500,79200
210632,202110,995,714,281,785400,309100,1094500
210635,202110,22,19,3,20900,3300,24200
210637,202110,129,93,36,102300,39600,141900
210640,202110,574,509,65,561000,71500,632500
210650,202110,391,329,62,361900,68200,430100
210660,202110,364,285,79,313500,86900,400400
210663,202110,48,35,13,38500,14300,52800
210667,202110,99,41,58,45100,63800,108900
210670,202110,259,231,28,254100,30800,284900
210675,202110,501,282,219,310200,240900,551100
210680,202110,221,142,79,156200,86900,243100
210690,202110,598,501,97,552200,106700,658900
210700,202110,150,115,35,126500,38500,165000
210710,202110,227,147,80,162800,88000,250800
210720,202110,124,111,13,123200,14300,137500
210725,202110,61,52,9,57200,9900,67100
210730,202110,23,18,5,19800,5500,25300
210735,202110,282,208,74,228800,81400,310200
210740,202110,518,447,71,492800,78100,570900
210745,202110,147,110,37,121000,40700,161700
210750,202110,2451,1267,1184,1393700,1302400,2696100
210760,202110,245,192,53,211200,58300,269500
210770,202110,241,196,45,215600,49500,265100
210780,202110,422,323,99,356400,108900,465300
210790,202110,181,150,31,165000,34100,199100
210800,202110,172,133,39,146300,42900,189200
210805,202110,56,50,6,55000,6600,61600
210810,202110,454,373,81,410300,89100,499400
210820,202110,2043,1716,327,1887600,359700,2247300
210825,202110,150,85,65,93500,71500,165000
210830,202110,714,481,233,529100,256300,785400
210840,202110,190,136,54,149600,59400,209000
210845,202110,229,172,57,189200,62700,251900
210850,202110,721,495,226,544500,248600,793100
210860,202110,3375,1973,1402,2171400,1542200,3713600
210870,202110,421,334,87,367400,95700,463100
210880,202110,74,59,15,64900,16500,81400
210890,202110,316,275,41,303600,45100,348700
210900,202110,631,414,217,456500,238700,695200
210905,202110,60,34,26,37400,28600,66000
210910,202110,1918,1471,447,1618100.7,491700,2109800.7
210920,202110,147,60,87,66000,95700,161700
210923,202110,80,64,16,70400,17600,88000
210927,202110,403,198,205,217800,226600,444400
210930,202110,66,54,12,59400,13200,72600
210940,202110,81,62,19,68200,20900,89100
210945,202110,197,109,88,119900,96800,216700
210950,202110,519,380,139,418000,152900,570900
210955,202110,89,57,32,62700,35200,97900
210960,202110,2202,1135,1067,1248500,1174800,2423300
210970,202110,106,93,13,103400,14300,117700
210975,202110,77,72,5,79200,5500,84700
210980,202110,1061,529,532,583000,585200,1168200
210990,202110,3917,2644,1273,2911700,1403600,4315300
211000,202110,1284,1045,239,1150600,262900,1413500
211003,202110,955,696,259,765600,286000,1051600
211010,202110,474,426,48,468600,52800,521400
211020,202110,1344,596,748,656700,822800,1479500
211023,202110,42,37,5,40700,5500,46200
211027,202110,75,54,21,59400,23100,82500
211030,202110,362,264,98,290400,107800,398200
211040,202110,289,243,46,267300,50600,317900
211050,202110,1105,745,360,820600,396000,1216600
211060,202110,620,551,69,607200,75900.49,683100.49
211065,202110,25,20,5,22000,5500,27500
211070,202110,852,717,135,788700,149600,938300
211080,202110,85,83,2,91300,2200,93500
211085,202110,49,27,22,29700,24200,53900
211090,202110,75,64,11,70400,12100,82500
211100,202110,458,388,70,426800,77000,503800
211102,202110,234,167,67,183700,73700,257400
211105,202110,219,155,64,170500,70400,240900
211107,202110,123,77,46,84700,50600,135300
211110,202110,931,626,305,688600,335500,1024100
211120,202110,5062,2599,2463,2864400,2710400,5574800
211125,202110,22,15,7,16500,7700,24200
211130,202110,40523,18979,21544,20890100.74,23705000,44595100.74
211140,202110,395,349,46,383900,50600,434500
211150,202110,1172,812,360,894300,396000,1290300
211153,202110,162,104,58,114400,63800,178200
211157,202110,70,57,13,62700,14300,77000
211160,202110,676,582,94,642400,103400,745800
211163,202110,3,3,0,3300,,3300.0
211167,202110,10,9,1,9900,1100,11000
211170,202110,415,310,105,341000,115500,456500
211172,202110,111,77,34,84700,37400,122100
211174,202110,250,158,92,173800,101200,275000
211176,202110,460,344,116,378400,127600,506000
211178,202110,86,58,28,63800,30800,94600
211180,202110,208,166,42,182600,46200,228800
211190,202110,71,64,7,70400,7700,78100
211195,202110,34,20,14,22000,15400,37400
211200,202110,149,130,19,143000,20900,163900
211210,202110,411,303,108,333300,119900,453200
211220,202110,4135,2448,1687,2695000.5,1855700,4550700.5
211223,202110,96,91,5,100100,5500,105600
211227,202110,53,43,10,47300,12100,59400
211230,202110,714,589,125,647900,137500,785400
211240,202110,375,305,70,335500,77000,412500
211245,202110,177,91,86,100100,94600,194700
211250,202110,1490,1295,195,1424500,215600,1640100
211260,202110,785,655,130,720500,143000,863500
211270,202110,1873,1543,330,1698400,363000,2061400
211280,202110,1753,1146,607,1260600,667700,1928300
211285,202110,205,130,75,143000,82500,225500
211290,202110,715,511,204,562100,224400,786500
211300,202110,740,594,146,653400,160600,814000
211400,202110,1500,942,558,1036200,613800,1650000
220005,202110,15,14,1,15400,1100,16500
220010,202110,85,70,15,77000,16500,93500
220020,202110,685,554,131,609400,144100,753500
220025,202110,105,102,3,112200,3300,115500
220027,202110,49,40,9,44000,9900,53900
220030,202110,115,93,22,102300,24200,126500
220040,202110,1261,968,293,1065900,322300,1388200
220045,202110,31,20,11,22000,12100,34100
220050,202110,690,575,115,632500.8,126500,759000.8
220060,202110,173,150,23,165000,25300,190300
220070,202110,112,99,13,108900,14300,123200
220080,202110,16,14,2,15400,2200,17600
220090,202110,36,27,9,29700,9900,39600
220095,202110,2,1,1,1100,1100,2200
220100,202110,20,17,3,18700,3300,22000
220105,202110,27,25,2,27500,2200,29700
220110,202110,233,212,21,233200,23100,256300
220115,202110,40,35,5,38500,5500,44000
220117,202110,22,20,2,22000,2200,24200
220120,202110,1470,1126,344,1239700,378400,1618100
220130,202110,28,28,0,30800,,30800.0
220140,202110,95,77,18,84700,19800,104500
220150,202110,478,363,115,400400,126500,526900
220155,202110,12,11,1,12100,1100,13200
220157,202110,19,16,3,17600,3300,20900
220160,202110,95,84,11,92400,12100,104500
220170,202110,37,33,4,36300,4400,40700
220173,202110,7,7,0,7700,,7700.0
220177,202110,13,12,1,13200,1100,14300
220180,202110,66,64,2,70400,2200,72600
220190,202110,1070,933,137,1026300,150700,1177000
220191,202110,36,30,6,33000,6600,39600
220192,202110,88,84,4,92400,4400,96800
220194,202110,59,53,6,58300,6600,64900
220196,202110,87,73,14,80300,15400,95700
220198,202110,1,1,0,1100,,1100.0
220200,202110,413,347,66,381700,72600,454300
220202,202110,36,31,5,34100,5500,39600
220205,202110,58,51,7,56100,7700,63800
220207,202110,13,13,0,14300,,14300.0
220208,202110,77,45,32,49500,35200,84700
220209,202110,31,26,5,28600,5500,34100
220210,202110,22,15,7,16500,7700,24200
220211,202110,29,27,2,29700,2200,31900
220213,202110,32,28,4,30800,4400,35200
220217,202110,39,32,7,35200,7700,42900
220220,202110,2233,1469,764,1615900,840400,2456300
220225,202110,6,1,5,1100,5500,6600
220230,202110,950,734,216,807400,237600,1045000
220240,202110,161,142,19,156200,20900,177100
220245,202110,35,32,3,35200.18,3300,38500.18
220250,202110,122,104,18,114400,19800,134200
220253,202110,51,45,6,49500,6600,56100
220255,202110,38,32,6,35200,6600,41800
220260,202110,698,527,171,580800,188100,768900
220265,202110,6,5,1,5500,1100,6600
220270,202110,800,721,79,793100,86900,880000
220271,202110,41,33,8,36300,8800,45100
220272,202110,10,10,0,11000,,11000.0
220273,202110,16,14,2,15400,2200,17600
220275,202110,59,49,10,53900,11000,64900
220277,202110,20,14,6,15400,6600,22000
220280,202110,18,12,6,13200,6600,19800
220285,202110,40,38,2,41800,2200,44000
220290,202110,1484,1269,215,1395900,236500,1632400
220300,202110,33,33,0,36300,,36300.0
220310,202110,329,280,49,308000,53900,361900
220320,202110,441,408,33,451000,37400,488400
220323,202110,2,1,1,1100,1100,2200
220325,202110,9,8,1,8800,1100,9900
220327,202110,12,12,0,13200,,13200.0
220330,202110,233,168,65,184800,71500,256300
220335,202110,138,117,21,128700,23100,151800
220340,202110,44,31,13,34100,14300,48400
220342,202110,54,46,8,50600,8800,59400
220345,202110,77,67,10,73700,11000,84700
220350,202110,455,393,62,432300,68200,500500
220360,202110,39,29,10,31900,11000,42900
220370,202110,1267,1051,216,1156100,237600,1393700
220375,202110,14,14,0,15400,,15400.0
220380,202110,26,19,7,20900,7700,28600
220385,202110,14,13,1,14300,1100,15400
220390,202110,2319,1291,1028,1420100,1130800,2550900
220400,202110,34,30,4,33000,4400,37400
220410,202110,23,21,2,23100,2200,25300
220415,202110,12,11,1,12100,1100,13200
220420,202110,124,104,20,114400,22000,136400
220430,202110,126,113,13,126500,14300,140800
220435,202110,25,17,8,18700,8800,27500
220440,202110,271,232,39,255200,42900,298100
220450,202110,335,170,165,187000,182600,369600
220455,202110,51,50,1,55000,1100,56100
220460,202110,20,17,3,18700,3300,22000
220465,202110,80,54,26,59400,28600,88000
220470,202110,240,209,31,229900,34100,264000
220480,202110,72,65,7,71500,7700,79200
220490,202110,90,76,14,83600,15400,99000
220500,202110,114,94,20,103400,22000,125400
220510,202110,385,298,87,327800,95700,423500
220515,202110,19,17,2,18700,2200,20900
220520,202110,369,327,42,359700,46200,405900
220525,202110,11,7,4,7700,4400,12100
220527,202110,16,13,3,14300,3300,17600
220530,202110,40,17,23,18700,25300,44000
220535,202110,7,4,3,4400,3300,7700
220540,202110,78,65,13,71500,14300,85800
220545,202110,27,19,8,20900,8800,29700
220550,202110,701,557,144,613800,158400,772200
220551,202110,17,14,3,15400,3300,18700
220552,202110,10,10,0,11000,,11000.0
220553,202110,48,43,5,47300,5500,52800
220554,202110,11,8,3,8800,3300,12100
220555,202110,40,31,9,34100,9900,44000
220556,202110,38,36,2,39600,2200,41800
220557,202110,54,49,5,53900,5500,59400
220558,202110,7,3,4,3300,4400,7700
220559,202110,2,2,0,2200,,2200.0
220560,202110,70,45,25,49500,27500,77000
220570,202110,724,452,272,499400,300300,799700
220580,202110,534,485,49,533500,53900,587400
220585,202110,10,9,1,9900,1100,11000
220590,202110,13,12,1,13200,1100,14300
220595,202110,70,54,16,59400,17600,77000
220600,202110,19,12,7,13200,7700,20900
220605,202110,24,21,3,23100,3300,26400
220610,202110,84,70,14,77000,15400,92400
220620,202110,545,456,89,501600,97900,599500
220630,202110,6,5,1,5500,1100,6600
220635,202110,32,28,4,30800,4400,35200
220640,202110,107,88,19,96800,20900,117700
220650,202110,112,106,6,116600,6600,123200
220660,202110,60,47,13,51700,14300,66000
220665,202110,8,8,0,8800,,8800.0
220667,202110,17,14,3,15400,3300,18700
220669,202110,30,24,6,26400,6600,33000
220670,202110,67,54,13,59400,14300,73700
220672,202110,80,59,21,64900,23100,88000
220675,202110,32,25,7,27500,7700,35200
220680,202110,46,40,6,44000,6600,50600
220690,202110,51,48,3,52800,3300,56100
220695,202110,26,14,12,15400,13200,28600
220700,202110,1734,1336,398,1470700,437800,1908500
220710,202110,6,4,2,4400,2200,6600
220720,202110,108,91,17,100100,18700,118800
220730,202110,17,15,2,16500,2200,18700
220735,202110,3,0,3,,3300,3300.0
220740,202110,49,44,5,48400,5500,53900
220750,202110,113,97,16,106700,17600,124300
220755,202110,18,17,1,18700,1100,19800
220760,202110,67,60,7,66000,7700,73700
220770,202110,5789,3239,2550,3567300.79,2806100,6373400.79
220775,202110,14,10,4,11000,4400,15400
220777,202110,20,19,1,20900,1100,22000
220779,202110,1,0,1,,1100,1100.0
220780,202110,900,770,130,847000,143000,990000
220785,202110,5,1,4,1100,4400,5500
220790,202110,1126,889,237,977900,260700,1238600
220793,202110,5,5,0,5500,,5500.0
220795,202110,16,14,2,15400,2200,17600
220800,202110,3999,3059,940,3366204,1034000,4400204
220810,202110,66,57,9,62700,9900,72600
220820,202110,235,213,22,234300,24200,258500
220830,202110,1282,1112,170,1223200,187000,1410200
220840,202110,2441,1722,719,1894200,792000,2686200
220850,202110,67,60,7,66000,7700,73700
220855,202110,8,4,4,4400,4400,8800
220860,202110,11,9,2,9900,2200,12100
220865,202110,29,26,3,28600,3300,31900
220870,202110,85,76,9,83600,9900,93500
220880,202110,322,260,62,286000,68200,354200
220885,202110,26,25,1,27500,1100,28600
220887,202110,10,9,1,9900,1100,11000
220890,202110,91,78,13,85800,14300,100100
220900,202110,26,15,11,16500,12100,28600
220910,202110,47,38,9,41800,9900,51700
220915,202110,11,10,1,11000,1100,12100
220920,202110,52,45,7,49500,7700,57200
220930,202110,46,44,2,48400,2200,50600
220935,202110,14,14,0,15400,,15400.0
220937,202110,30,28,2,30800,2200,33000
220940,202110,56,52,4,57200,4400,61600
220945,202110,2,2,0,2200,,2200.0
220950,202110,36,29,7,31900,7700,39600
220955,202110,14,14,0,15400,,15400.0
220960,202110,24,23,1,25300,1100,26400
220965,202110,38,34,4,37400,4400,41800
220970,202110,59,50,9,55000,9900,64900
220975,202110,11,10,1,11000,1100,12100
220980,202110,31,28,3,30800,3300,34100
220985,202110,59,53,6,58300,6600,64900
220987,202110,31,29,2,31900,2200,34100
220990,202110,26,26,0,28600,,28600.0
220995,202110,12,10,2,11000,2200,13200
220997,202110,59,51,8,56100,8800,64900
221000,202110,1181,1061,120,1168200,132000,1300200
221005,202110,34,31,3,34100,3300,37400
221010,202110,18,14,4,15400,4400,19800
221020,202110,33,32,1,35200,1100,36300
221030,202110,39,31,8,34100,8800,42900
221035,202110,20,20,0,22000,,22000.0
221037,202110,12,8,4,8800,4400,13200
221038,202110,28,25,3,27500,3300,30800
221039,202110,26,25,1,27500,1100,28600
221040,202110,264,227,37,249700,40700,290400
221050,202110,225,188,37,206800,40700,247500
221060,202110,1923,1666,257,1833700,282700,2116400
221062,202110,30,29,1,31900,1100,33000
221063,202110,14,10,4,11000,4400,15400
221065,202110,63,51,12,56100,13200,69300
221070,202110,136,119,17,132000,18700,150700
221080,202110,378,321,57,353100,62700,415800
221090,202110,21,16,5,17600,5500,23100
221093,202110,42,30,12,33000,13200,46200
221095,202110,4,4,0,4400,,4400.0
221097,202110,11,9,2,9900,2200,12100
221100,202110,25715,15333,10382,16876200.63,11430100.98,28306301.61
221110,202110,1109,838,271,921800,298100,1219900
221120,202110,533,391,142,431200,156200,587400
221130,202110,967,780,187,858000,205700,1063700
221135,202110,31,26,5,28600,5500,34100
221140,202110,46,40,6,44000,6600,50600
221150,202110,9,7,2,7700,2200,9900
221160,202110,11,11,0,12100,,12100.0
221170,202110,17,17,0,18700,,18700.0
230010,202110,149,133,16,146300,17600,163900
230015,202110,140,113,27,124300,29700,154000
230020,202110,1633,1363,270,1501500,297000,1798500
230030,202110,1668,1202,466,1324400,512600,1837000
230040,202110,226,187,39,205700,42900,248600
230050,202110,230,165,65,181500,71500,253000
230060,202110,158,122,36,134200,39600,173800
230070,202110,306,264,42,290400,46200,336600
230075,202110,863,732,131,805200,144100,949300
230080,202110,202,171,31,188100,34100,222200
230090,202110,146,108,38,118800,41800,160600
230100,202110,2320,1307,1013,1437700,1114300,2552000
230110,202110,2884,1819,1065,2002000,1171500,3173500
230120,202110,1054,828,226,911900,248600,1160500
230125,202110,155,125,30,137500,33000,170500
230130,202110,471,417,54,458700,59400,518100
230140,202110,211,173,38,191400,41800,233200
230150,202110,149,114,35,125400,38500,163900
230160,202110,934,778,156,856900,172700,1029600
230170,202110,607,535,72,588500,79200,667700
230180,202110,66,60,6,66000,6600,72600
230185,202110,402,342,60,376200,66000,442200
230190,202110,2416,1877,539,2065800,592900,2658700
230195,202110,501,433,68,476300,74800,551100
230200,202110,419,331,88,364100,96800,460900
230205,202110,387,258,129,283800,141900,425700
230210,202110,1386,1066,320,1172600,352000,1524600
230220,202110,1578,1073,505,1180300,555500,1735800
230230,202110,969,810,159,891000,174900,1065900
230240,202110,1818,1574,244,1732775,268400,2001175
230250,202110,1774,1447,327,1591700,359700,1951400
230260,202110,3208,1985,1223,2183500,1346400,3529900
230270,202110,1361,1075,286,1182500.05,314600,1497100.05
230280,202110,2748,2070,678,2278100,746900,3025000
230290,202110,352,311,41,342100.5,45100,387200.5
230300,202110,527,382,145,420200,159500,579700
230310,202110,427,327,100,359700,110000,469700
230320,202110,906,767,139,843700,152900,996600
230330,202110,303,241,62,266200,68200,334400
230340,202110,436,351,85,388300,93500,481800
230350,202110,3250,2004,1246,2204400,1370600,3575000
230360,202110,271,224,47,246400,51700,298100
230365,202110,126,104,22,114400,24200,138600
230370,202110,10632,5209,5423,5737600.92,5966400.31,11704001.23
230380,202110,490,420,70,463100,77000,540100
230390,202110,534,298,236,327800,259600,587400
230393,202110,250,206,44,226600,48400,275000
230395,202110,343,276,67,303600,73700,377300
230400,202110,629,499,130,548900,143000,691900
230410,202110,2657,1634,1023,1799600.5,1125300,2924900.5
230420,202110,6429,4232,2197,4658500.6,2422200,7080700.6
230423,202110,333,291,42,320100,46200,366300
230425,202110,451,359,92,394900,101200,496100
230426,202110,117,91,26,100100,28600,128700
230427,202110,70,65,5,71500,5500,77000
230428,202110,1576,774,802,851400,882200,1733600
230430,202110,454,366,88,403700,96800,500500
230435,202110,901,650,251,716100,276100,992200
230440,202110,92539,41460,51079,45632403.39,56227601.04,101860004.43
230445,202110,315,215,100,236500,110000,346500
230450,202110,578,450,128,495000,140800,635800
230460,202110,78,57,21,62700,23100,85800
230465,202110,311,250,61,275000,68200,343200
230470,202110,2012,1575,437,1734700,480700,2215400
230480,202110,153,141,12,155100,13200,168300
230490,202110,320,251,69,276100,75900,352000
230495,202110,469,330,139,363000,152900,515900
230500,202110,1020,755,265,830500,291500,1122000
230510,202110,60,44,16,48400,17600,66000
230520,202110,391,305,86,335500,94600,430100
230523,202110,2415,1491,924,1642300,1017500,2659800
230526,202110,267,229,38,251900,41800,293700
230530,202110,687,507,180,557700,198000,755700
230533,202110,215,196,19,215600,20900,236500
230535,202110,368,276,92,303600,101200,404800
230540,202110,1799,1603,196,1764400,216700,1981100
230550,202110,3941,2498,1443,2751100,1589500,4340600
230560,202110,583,441,142,485100,156200,641300
230565,202110,219,161,58,178200,63800,242000
230570,202110,281,241,40,265100,44000,309100
230580,202110,1177,836,341,921800,376200,1298000
230590,202110,1000,778,222,856900,245300,1102200
230600,202110,250,226,24,248600,26400,275000
230610,202110,415,309,106,339900,116600,456500
230620,202110,165,142,23,156200,25300,181500
230625,202110,811,553,258,608300,283800,892100
230630,202110,1319,1003,316,1103300,348700,1452000
230640,202110,3780,3167,613,3483700,677600,4161300
230650,202110,499,427,72,470800,79200,550000
230655,202110,694,572,122,630300,134200,764500
230660,202110,356,293,63,322300,69300,391600
230670,202110,443,362,81,398200,89100,487300
230680,202110,205,182,23,201300,25300,226600
230690,202110,926,777,149,854700,165000,1019700
230700,202110,882,735,147,810700,161700,972400
230710,202110,687,643,44,709500,48400,757900
230720,202110,146,124,22,136400,24200,160600
230725,202110,235,176,59,193600,64900,258500
230730,202110,12533,6660,5873,7332531.32,6463600.82,13796132.14
230740,202110,671,533,138,587400,151800,739200
230750,202110,818,686,132,756800,145200,902000
230760,202110,1446,1244,202,1369500,222200,1591700
230763,202110,341,279,62,306900,68200,375100
230765,202110,7965,3675,4290,4044700.6,4723400,8768100.6
230770,202110,4963,2513,2450,2765400,2695000,5460400
230780,202110,749,655,94,720500,103400,823900
230790,202110,298,245,53,269500,58300,327800
230800,202110,1150,826,324,908600,357500,1266100
230810,202110,1378,1206,172,1326600,189200,1515800
230820,202110,363,248,115,272800,126500,399300
230830,202110,963,812,151,896415,166100,1062515
230835,202110,274,234,40,257400,44000,301400
230837,202110,171,140,31,154000,34100,188100
230840,202110,915,705,210,776600,231000,1007600
230850,202110,1416,1213,203,1338700,223300,1562000
230860,202110,303,225,78,247500,85806,333306
230870,202110,1810,1520,290,1672000,320100,1992100
230880,202110,75,57,18,62700,19800,82500
230890,202110,533,478,55,525800,60500,586300
230900,202110,288,213,75,235400,82500.7,317900.7
230910,202110,223,172,51,189200,56100,245300
230920,202110,484,382,102,420200,112200,532400
230930,202110,1011,702,309,772200,341000,1113200
230940,202110,836,640,196,704000,215600,919600
230945,202110,520,414,106,455400,116600,572000
230950,202110,423,367,56,403700,61600,465300
230960,202110,2732,1806,926,1986600,1018600,3005200
230970,202110,1742,971,771,1068100,850300,1918400
230980,202110,200,160,40,176000,44000,220000
230990,202110,140,110,30,121000,33000,154000
231000,202110,201,184,17,202400,18700,221100
231010,202110,160,112,48,123200,52800,176000
231020,202110,1373,936,437,1029600,480700,1510300
231025,202110,1071,757,314,833800,345400,1179200
231030,202110,1057,878,179,968000,196900,1164900
231040,202110,151,101,50,111100,55000,166100
231050,202110,936,815,121,896500,133100,1029600
231060,202110,158,129,29,141900,31900,173800
231070,202110,1494,1026,468,1128600,514800,1643400
231080,202110,268,240,28,264000,30800,294800
231085,202110,635,384,251,422400,276100,698500
231090,202110,257,205,52,225500,57200,282700
231095,202110,160,127,33,139700,36300,176000
231100,202110,157,129,28,141900,30800,172700
231110,202110,369,311,58,343200,63800,407000
231120,202110,265,221,44,243100,48400,291500
231123,202110,156,146,10,160600,11000,171600
231126,202110,332,251,81,276100,89100,365200
231130,202110,4898,3811,1087,4195400,1196800,5392200
231135,202110,214,184,30,202400,33000,235400
231140,202110,3072,2227,845,2449700,929500,3379200
231150,202110,372,350,22,385000,24200,409200
231160,202110,1220,974,246,1071400,270600,1342000
231170,202110,509,350,159,385000,174900,559900
231180,202110,1739,1498,241,1648900,265100,1914000
231190,202110,209,172,37,190300,40700,231000
231195,202110,224,189,35,207900,38500,246400
231200,202110,804,650,154,717200,169400,886600
231210,202110,518,438,80,481800,88000,569800
231220,202110,1032,743,289,817300,320100,1137400
231230,202110,1471,1122,349,1235300,383900,1619200
231240,202110,1488,1027,461,1129700,507100,1636800
231250,202110,95,89,6,97900,6600,104500
231260,202110,264,174,90,192500,99000,291500
231270,202110,1000,794,206,874500,226600,1101100
231280,202110,72,57,15,62700,16500,79200
231290,202110,7779,4339,3440,4778400.96,3786200.57,8564601.53
231300,202110,579,532,47,587400,52800,640200
231310,202110,751,688,63,756800,69300,826100
231320,202110,582,436,146,480700,160600,641300
231325,202110,101,87,14,95700,15400,111100
231330,202110,1933,1483,450,1631301.32,495000,2126301.32
231335,202110,253,225,28,247500,30800,278300
231340,202110,1742,1246,496,1371700,545600,1917300
231350,202110,1319,1051,268,1156100,294800,1450900
231355,202110,418,352,66,388300,72600,460900
231360,202110,524,367,157,403700.65,172700,576400.65
231370,202110,92,80,12,88000,13200,101200
231375,202110,291,214,77,235400,84700,320100
231380,202110,488,388,100,426800,110000,536800
231390,202110,207,154,53,170500,58300,228800
231395,202110,762,466,296,512600,325600,838200
231400,202110,1138,946,192,1041700,211200,1252900
231410,202110,1332,1089,243,1197900,268400,1466300
240010,202110,374,162,212,179300.97,233200,412500.97
240020,202110,2188,1776,412,1954700,454300,2409000
240030,202110,118,99,19,108900,20900,129800
240040,202110,32,32,0,35200,,35200.0
240050,202110,530,452,78,498300,85800,584100
240060,202110,69,65,4,71500,4400,75900
240070,202110,231,181,50,200200,55000,255200
240080,202110,526,356,170,391600,187000.7,578600.7
240090,202110,102,91,11,100100,12100,112200
240100,202110,1455,1369,86,1505900.5,94600,1600500.5
240110,202110,1014,664,350,730400,386100,1116500
240120,202110,146,110,36,121000,39600,160600
240130,202110,274,254,20,279400,22000,301400
240140,202110,78,54,24,60500,26400,86900
240145,202110,720,632,88,697400,96800,794200
240150,202110,24,17,7,18700,7700,26400
240160,202110,41,33,8,36300,8800,45100
240165,202110,38,30,8,33000,8800,41800
240170,202110,123,82,41,90200,45100,135300
240180,202110,99,75,24,82500,26400,108900
240185,202110,45,41,4,45100,4400,49500
240190,202110,15,13,2,14300,2200,16500
240200,202110,3058,1660,1398,1828200.28,1537800,3366000.28
240210,202110,164,126,38,139700,41800,181500
240220,202110,1100,782,318,860200,349800,1210000
240230,202110,826,754,72,830500,79200,909700
240240,202110,68,47,21,51700,23100,74800
240250,202110,91,77,14,85800,15400,101200
240260,202110,1798,1292,506,1423400,556600,1980000
240270,202110,180,158,22,173800,24200,198000
240280,202110,52,41,11,45100,12100,57200
240290,202110,42,40,2,44000,2200,46200
240300,202110,171,91,80,100100,88000,188100
240310,202110,2410,1294,1116,1424500,1229800,2654300
240320,202110,182,169,13,185900,14300,200200
240325,202110,4657,2716,1941,2988701.3,2137300,5126001.3
240330,202110,70,66,4,72600,4400,77000
240340,202110,81,53,28,58300,30800,89100
240350,202110,90,76,14,83600,15400,99000
240360,202110,604,360,244,396000,268400,664400
240370,202110,51,46,5,50600,5500,56100
240375,202110,62,37,25,40700,27500,68200
240380,202110,226,185,41,203500,45100,248600
240390,202110,12,11,1,12100,1100,13200
240400,202110,82,73,9,80300,9900,90200
240410,202110,13,7,6,7700,6600,14300
240420,202110,1050,765,285,842600,313500,1156100
240430,202110,258,241,17,265100,18700,283800
240440,202110,123,65,58,71500,63800,135300
240450,202110,239,154,85,169400,93500,262900
240460,202110,73,58,15,63800,16500,80300
240470,202110,223,201,22,221100,24200,245300
240480,202110,15,13,2,14300,2200,16500
240485,202110,80,63,17,69300,18700,88000
240490,202110,46,42,4,46200,4400,50600
240500,202110,89,67,22,73700,24200,97900
240510,202110,42,30,12,33000,13200,46200
240520,202110,101,96,5,105600,5500,111100
240530,202110,57,48,9,52800,9900,62700
240540,202110,84,71,13,78100,14300,92400
240550,202110,12,11,1,12100,1100,13200
240560,202110,377,270,107,297000,117700,414700
240570,202110,436,274,162,301400,178200,479600
240580,202110,1278,983,295,1081300,324500,1405800
240590,202110,31,29,2,31900,2200,34100
240600,202110,96,90,6,99000,6600,105600
240610,202110,509,422,87,464200,95700,559900
240615,202110,16,15,1,16500,1100,17600
240620,202110,87,84,3,92400,3300,95700
240630,202110,40,33,7,36300,7700,44000
240640,202110,24,20,4,22000,4400,26400
240650,202110,239,194,45,213400,49500,262900
240660,202110,108,91,17,100100,18700,118800
240670,202110,313,170,143,188100,157300,345400
240680,202110,53,40,13,44000,14300,58300
240690,202110,46,43,3,47300,3300,50600
240700,202110,181,148,33,162800,36300,199100
240710,202110,2115,1277,838,1405800.64,921800,2327600.64
240720,202110,1056,763,293,839300,322300,1161600
240725,202110,65,60,5,66000,5500,71500
240730,202110,149,124,25,136400,27500,163900
240740,202110,231,195,36,214500,39600,254100
240750,202110,52,30,22,33000,24200,57200
240760,202110,51,45,6,49500,6600,56100
240770,202110,146,112,34,123200,37400,160600
240780,202110,703,584,119,642400,130900,773300
240790,202110,41,39,2,42900,2200,45100
240800,202110,9348,6322,3026,6956400.85,3330800,10287200.85
240810,202110,21126,11215,9911,12353000.98,10909800,23262800.98
240820,202110,245,143,102,157300,112200,269500
240830,202110,1591,1313,278,1446500,305800,1752300
240840,202110,75,66,9,73700,9900,83600
240850,202110,81,72,9,80300,9900,90200
240860,202110,107,102,5,112200,5500,117700
240870,202110,59,51,8,56100,8800,64900
240880,202110,33,28,5,30800,5500,36300
240890,202110,1133,627,506,690800,556600,1247400
240895,202110,66,50,16,55000,17600,72600
240910,202110,168,143,25,157300,27500,184800
240920,202110,13,11,2,12100,2200,14300
240930,202110,403,360,43,396000,47300,443300
240933,202110,56,35,21,38500,23100,61600
240940,202110,2291,2023,268,2228600,294800,2523400
240950,202110,47,41,6,45100,6600,51700
240960,202110,25,21,4,23100,4400,27500
240970,202110,113,84,29,92400,33000,125400
240980,202110,196,158,38,174900,41800,216700
240990,202110,134,91,43,100100,47300,147400
241000,202110,58,54,4,59400,4400,63800
241010,202110,76,58,18,63800,19800,83600
241020,202110,105,97,8,106700,8800,115500
241025,202110,15,7,8,7700,8800,16500
241030,202110,107,85,22,93500,24200,117700
241040,202110,42,30,12,33000,13200,46200
241050,202110,77,68,9,74800,9900,84700
241060,202110,27,22,5,24200,5500,29700
241070,202110,17,16,1,17600,1100,18700
241080,202110,59,52,7,57200,7700,64900
241090,202110,48,38,10,41800,11000,52800
241100,202110,73,62,11,68200,12100,80300
241105,202110,13,5,8,5500,8800,14300
241110,202110,44,39,5,42900,5500,48400
241120,202110,1531,1153,378,1268300,416900,1685200
241140,202110,213,177,36,194700,39600,234300
241142,202110,47,34,13,37400,14300,51700
241150,202110,1205,1050,155,1155000,170500,1325500
241160,202110,20,16,4,17600,4400,22000
241170,202110,46,39,7,44000,8800,52800
241180,202110,43,33,10,36300,11000,47300
241190,202110,38,36,2,39600,2200,41800
241200,202110,4111,2152,1959,2369400.53,2156000,4525400.53
241210,202110,69,59,10,64900,11000,75900
241220,202110,1447,951,496,1046100.33,545600,1591700.33
241230,202110,249,206,43,226600,47300,273900
241240,202110,58,44,14,48400,15400,63800
241250,202110,1117,1018,99,1120900,108900,1229800
241255,202110,54,45,9,49500,9900,59400
241260,202110,680,518,162,569800,178200,748000
241270,202110,63,43,20,47300,22000,69300
241280,202110,94,83,11,91300,12100,103400
241290,202110,129,90,39,99000,42900,141900
241300,202110,82,56,26,61600,28600,90200
241310,202110,51,35,16,38500,17600,56100
241320,202110,30,15,15,16500,16500,33000
241330,202110,58,51,7,56100,7700,63800
241335,202110,80,71,9,78100,9900,88000
241340,202110,184,137,47,150700,51700,202400
241350,202110,61,52,9,57200,9900,67100
241355,202110,49,41,8,45100,8800,53900
241360,202110,50,49,1,53900,1100,55000
241370,202110,59,45,14,49500,15400,64900
241380,202110,34,30,4,33000,4400,37400
241390,202110,82,63,19,69300,20900,90200
241400,202110,214,164,50,180400,55000,235400
241410,202110,180,164,16,180400,17600,198000
241415,202110,101,81,20,89100,22000,111100
241420,202110,105,76,29,83600,31900,115500
241430,202110,23,21,2,23100,2200,25300
241440,202110,518,430,88,473000.82,96800,569800.82
241445,202110,40,35,5,38500,5500,44000
241450,202110,260,216,44,237600,48400,286000
241460,202110,139,125,14,137500,15400,152900
241470,202110,33,29,4,31900,4400,36300
241475,202110,54,48,6,52800,6600,59400
241480,202110,115,86,29,94600,31900,126500
241490,202110,11,10,1,11000,1100,12100
241500,202110,42,32,10,35200,11000,46200
250010,202110,98,84,14,92400,15400,107800
250020,202110,31,27,4,29700,4400,34100
250030,202110,887,654,233,719400,256300,975700
250040,202110,388,317,71,348700,78100,426800
250050,202110,259,212,47,233200,51700,284900
250053,202110,63,48,15,52800,16500,69300
250057,202110,3,2,1,2200,1100,3300
250060,202110,595,430,165,473000,181500,654500
250070,202110,681,542,139,597300.22,152900,750200.22
250073,202110,7,7,0,7700,,7700.0
250077,202110,174,127,47,139700,51700,191400
250080,202110,425,335,90,368500,99000,467500
250090,202110,223,145,78,159500,85800,245300
250100,202110,538,448,90,492800,99000,591800
250110,202110,658,486,172,534600,189200,723800
250115,202110,16,3,13,3300,14300,17600
250120,202110,122,89,33,97900,36300,134200
250130,202110,559,448,111,492800,122100,614900
250135,202110,21,11,10,12100,11000,23100
250140,202110,80,71,9,78100,9900,88000
250150,202110,604,425,179,467500,196900,664400
250153,202110,13,10,3,11000,3300,14300
250157,202110,29,24,5,26400,5500,31900
250160,202110,230,181,49,199100,53900,253000
250170,202110,71,46,25,50600,27500,78100
250180,202110,4579,3129,1450,3444100,1596100,5040200
250190,202110,822,550,272,605000,300300,905300
250200,202110,60,44,16,48400,17600,66000
250205,202110,23,19,4,20900,4400,25300
250210,202110,88,76,12,83600,14300,97900
250215,202110,69,53,16,58300,17600,75900
250220,202110,26,18,8,19800,8800,28600
250230,202110,78,70,8,77000,8800,85800
250240,202110,234,181,53,199100,58300,257400
250250,202110,369,319,50,353100,55000,408100
250260,202110,43,35,8,38500,8800,47300
250270,202110,75,52,23,57200,25300,82500
250280,202110,373,301,72,332200,79200,411400
250290,202110,91,82,9,90200,9900,100100
250300,202110,566,380,186,419100,205700,624800
250310,202110,45,41,4,45100,4400,49500
250320,202110,1973,1302,671,1433300,738100,2171400
250330,202110,102,87,15,95700,16500,112200
250340,202110,29,24,5,26400,5500,31900
250350,202110,189,124,65,136400,71500,207900
250355,202110,31,23,8,25300,8800,34100
250360,202110,192,158,34,173800,37400,211200
250370,202110,2364,1524,840,1677500,925100,2602600
250375,202110,13,7,6,7700,6600,14300
250380,202110,53,42,11,46200,12100,58300
250390,202110,44,34,10,37400,11000,48400
250400,202110,16503,8250,8253,9082681.02,9087100,18169781.02
250403,202110,319,250,69,275000,75900,350900
250407,202110,62,50,12,55000,13200,68200
250410,202110,30,26,4,28600,4400,33000
250415,202110,44,28,16,30800,17600,48400
250420,202110,39,33,6,37400,6600,44000
250430,202110,1419,1221,198,1344475,217800,1562275
250435,202110,24,16,8,17600,8800,26400
250440,202110,674,559,115,616000,126500,742500
250450,202110,81,62,19,68200,20900,89100
250460,202110,469,306,163,336600,179300,515900
250470,202110,96,65,31,71500,34100,105600
250480,202110,329,262,67,288200,73700,361900
250485,202110,4,4,0,4400,,4400.0
250490,202110,232,190,42,209000,46200,255200
250500,202110,94,71,23,78100,25300,103400
250510,202110,790,615,175,677600,192500,870100
250520,202110,171,113,58,124300,63800,188100
250523,202110,125,101,24,111100,26400,137500
250527,202110,113,87,26,95700,28600,124300
250530,202110,7,4,3,4400,3300,7700
250535,202110,31,22,9,24200,9900,34100
250540,202110,138,109,29,119900,31900,151800
250550,202110,69,65,4,71500,4400,75900
250560,202110,54,34,20,37400,22000,59400
250570,202110,156,126,30,138600,33000,171600
250580,202110,97,74,23,81471,25300,106771
250590,202110,22,12,10,13200,11000,24200
250600,202110,1469,958,511,1054900.7,563200,1618100.7
250610,202110,159,131,28,144100,30800,174900
250620,202110,21,17,4,18700,4400,23100
250625,202110,73,55,18,60500,19800,80300
250630,202110,3114,1972,1142,2170300.62,1256200,3426500.62
250640,202110,195,155,40,170500,44000,214500
250650,202110,26,18,8,19800,8800,28600
250660,202110,59,43,16,47300,17600,64900
250670,202110,64,47,17,51700,18700,70400
250680,202110,416,332,84,366300,92400,458700
250690,202110,2101,1442,659,1587300.7,726000,2313300.7
250700,202110,918,782,136,863500,149600,1013100
250710,202110,439,345,94,379500,103400,482900
250720,202110,116,84,32,92400,35200,127600
250730,202110,415,345,70,379500,77000,456500
250740,202110,60,58,2,63800,2200,66000
250750,202110,23229,13794,9435,15185381.41,10389500,25574881.41
250760,202110,105,84,21,92400,23100,115500
250770,202110,358,232,126,256300,138600,394900
250780,202110,69,45,24,49500,26400,75900
250790,202110,455,288,167,316800,183700,500500
250800,202110,148,132,16,145200,17600,162800
250810,202110,77,62,15,68200,16500,84700
250820,202110,148,125,23,137500,25300,162800
250830,202110,439,281,158,309100,173800,482900
250840,202110,57,51,6,56100,6600,62700
250850,202110,54,46,8,50600,8800,59400
250855,202110,16,14,2,15400,2200,17600
250860,202110,242,155,87,170500,96800,267300
250870,202110,29,26,3,28600,3300,31900
250880,202110,85,63,22,69300,25300,94600
250890,202110,3002,2225,777,2448600,855800,3304400
250900,202110,57,48,9,52800,9900,62700
250905,202110,119,90,29,100100,31900,132000
250910,202110,1046,766,280,842600,308000,1150600
250915,202110,107,74,33,81400,36300,117700
250920,202110,136,97,39,106700,42900,149600
250930,202110,176,103,73,113300,80300,193600
250933,202110,8,5,3,5500,3300,8800
250937,202110,16,16,0,17600,,17600.0
250939,202110,30,25,5,27500,5500,33000
250940,202110,116,83,33,91300,36300,127600
250950,202110,73,50,23,55000,25300,80300
250960,202110,90,48,42,52800,46200,99000
250970,202110,1234,869,365,955900,401500,1357400
250980,202110,104,68,36,74800,39600,114400
250990,202110,170,131,39,144100,42900,187000
251000,202110,77,66,11,72600,12100,84700
251010,202110,120,90,30,99000,33000,132000
251020,202110,73,59,14,64900,15400,80300
251030,202110,46,34,12,37400,13200,50600
251040,202110,53,35,18,38500,19800,58300
251050,202110,24,21,3,23100,3300,26400
251060,202110,49,40,9,44000,9900,53900
251065,202110,7,4,3,4400,3300,7700
251070,202110,17,13,4,14300,4400,18700
251080,202110,5201,2437,2764,2680700,3040400.1,5721100.1
251090,202110,186,155,31,170500,34100,204600
251100,202110,21,19,2,20900,2200,23100
251110,202110,48,33,15,37400,16500,53900
251120,202110,1896,1158,738,1273800,811800,2085600
251130,202110,422,350,72,385000,79200,464200
251140,202110,576,369,207,407000,227700,634700
251150,202110,346,285,61,313500,67100,380600
251160,202110,96,76,20,83600,22000,105600
251170,202110,96,76,20,83600,22000,105600
251180,202110,286,169,117,185900,128700,314600
251190,202110,195,127,68,139700,74800,214500
251200,202110,273,216,57,237600,62700,300300
251203,202110,35,32,3,35200,3300,38500
251207,202110,85,71,14,78100,15400,93500
251210,202110,1474,1078,396,1185800,435600,1621400
251220,202110,44,35,9,38500,9900,48400
251230,202110,575,476,99,523600,108900,632500
251240,202110,105,73,32,80300,35200,115500
251250,202110,1424,1019,405,1123009.8,445500,1568509.8
251260,202110,12,8,4,8800,4400,13200
251270,202110,299,233,66,256300,72600,328900
251272,202110,66,58,8,63800,8800,72600
251274,202110,28,22,6,24200,6600,30800
251275,202110,36,21,15,23100,16500,39600
251276,202110,21,18,3,19800,3300,23100
251278,202110,11,9,2,9900,2200,12100
251280,202110,99,94,5,103400,5500,108900
251290,202110,937,666,271,733700,298100,1031800
251300,202110,15,11,4,12100,4400,16500
251310,202110,291,211,80,233200,88000,321200
251315,202110,38,34,4,37400,4400,41800
251320,202110,66,50,16,55000,17600,72600
251330,202110,83,72,11,79200,12100,91300
251335,202110,20,9,11,9900,12100,22000
251340,202110,761,444,317,488400,349800,838200
251350,202110,35,34,1,37400,1100,38500
251360,202110,84,72,12,79200,13200,92400
251365,202110,8,8,0,8800,,8800.0
251370,202110,5679,3825,1854,4208600.32,2039400,6248000.32
251380,202110,45,35,10,38500,11000,49500
251385,202110,2,2,0,2200,,2200.0
251390,202110,889,655,234,721600,257400,979000
251392,202110,26,16,10,17600,11000,28600
251394,202110,9,9,0,9900,,9900.0
251396,202110,15,10,5,11000,5500,16500
251398,202110,15,12,3,13200,3300,16500
251400,202110,46,37,9,40700,9900,50600
251410,202110,40,34,6,37400,6600,44000
251420,202110,102,75,27,82500,29700,112200
251430,202110,46,41,5,45100,5500,50600
251440,202110,49,26,23,28600,25300,53900
251445,202110,58,50,8,55000,8800,63800
251450,202110,386,333,53,368500,58300,426800
251455,202110,6,5,1,5500,1100,6600
251460,202110,18,15,3,16500,3300,19800
251465,202110,7,5,2,5500,2200,7700
251470,202110,50,38,12,41800,13200,55000
251480,202110,28,23,5,25300,5500,30800
251490,202110,113,70,43,77000,47300,124300
251500,202110,124,102,22,112200,24200,136400
251510,202110,77,49,28,53900,30800,84700
251520,202110,31,29,2,31900,2200,34100
251530,202110,4320,3050,1270,3355000,1399200,4754200
251540,202110,82,67,15,74800,16500,91300
251550,202110,405,305,100,336600,111100,447700
251560,202110,25,17,8,18700,8800,27500
251570,202110,18,16,2,17600,2200,19800
251580,202110,136,108,28,118800,30800,149600
251590,202110,109,75,34,82707.9,37400,120107.9
251593,202110,26,17,9,18700,9900,28600
251597,202110,101,79,22,86900,24200,111100
251600,202110,1094,763,331,841500,364100,1205600
251610,202110,237,175,62,192500,68200,260700
251615,202110,13,12,1,13200,1100,14300
251620,202110,4183,2689,1494,2961200.64,1643400,4604600.64
251630,202110,462,342,120,376200,132000,508200
251640,202110,127,94,33,103400,36300,139700
251650,202110,289,211,78,232100,85800,317900
251660,202110,193,170,23,187000,25300,212300
251670,202110,383,293,90,322300,99000,421300
251675,202110,9,7,2,7700,2200,9900
251680,202110,102,88,14,96800,15400,112200
251690,202110,324,267,57,293700,62700,356400
251700,202110,280,240,40,264000,44000,308000
251710,202110,22,13,9,14300,9900,24200
251720,202110,22,14,8,15400,8800,24200
251740,202110,12,9,3,9900,3300,13200
260005,202110,3425,1815,1610,1996032,1775400,3771432
260010,202110,1629,1199,430,1321100.14,473000,1794100.14
260020,202110,413,354,59,389400,64900,454300
260030,202110,599,407,192,447700,211200,658900
260040,202110,804,487,317,535700,349800,885500
260050,202110,1164,827,337,909700,370700,1280400
260060,202110,373,341,32,375100,35200,410300
260070,202110,1312,796,516,878900,567600,1446500
260080,202110,714,546,168,600600,184800,785400
260090,202110,493,321,172,353100,189200,542300
260100,202110,210,146,64,160600,70400,231000
260105,202110,256,140,116,154000,127600,281600
260110,202110,2912,2128,784,2343000,863500,3206500
260120,202110,2700,1452,1248,1598592.6,1372800,2971392.6
260130,202110,181,121,60,133100,66000,199100
260140,202110,2167,1413,754,1554300,830500,2384800
260150,202110,198,127,71,139700,78100,217800
260160,202110,338,278,60,305800,66000,371800
260170,202110,3320,1989,1331,2189000,1466300,3655300
260180,202110,170,136,34,149600,37400,187000
260190,202110,2339,1549,790,1705000,869000,2574000
260200,202110,973,767,206,843700.63,226600,1070300.63
260210,202110,1392,979,413,1078000,454300,1532300
260220,202110,660,595,65,654500,71500,726000
260230,202110,1227,906,321,997700,353100,1350800
260240,202110,206,155,51,170500,56100,226600
260250,202110,82,60,22,66000,24200,90200
260260,202110,1056,729,327,801900,359700,1161600
260270,202110,259,188,71,206800,78100,284900
260280,202110,1147,915,232,1006500,255200,1261700
260290,202110,6711,3629,3082,3991900,3392400.59,7384300.59
260300,202110,974,829,145,911900,159500,1071400
260310,202110,520,414,106,455400,116600,572000
260320,202110,835,607,228,667700,251900.5,919600.5
260330,202110,68,48,20,52800,22000,74800
260340,202110,74,56,18,61600,19800,81400
260345,202110,5538,2916,2622,3210900,2886400,6097300
260350,202110,489,345,144,379500,158400,537900
260360,202110,236,128,108,140800,118800,259600
260370,202110,750,467,283,514800,311300,826100
260380,202110,567,411,156,452100,171600.6,623700.6
260390,202110,286,241,45,265100,49500,314600
260392,202110,110,95,15,104500,17600,122100
260400,202110,4280,2430,1850,2673000.5,2035000,4708000.5
260410,202110,14823,7705,7118,8477700.63,7832000,16309700.63
260415,202110,141,120,21,132000,23100,155100
260420,202110,1716,1040,676,1144000,743600,1887600
260430,202110,174,157,17,172700.48,18700,191400.48
260440,202110,188,130,58,143000,63800,206800
260450,202110,427,316,111,347600.63,122100,469700.63
260460,202110,831,437,394,480700,433400,914100
260470,202110,334,203,131,223300,144100,367400
260480,202110,248,155,93,170500,102300,272800
260490,202110,222,174,48,191400,52800,244200
260500,202110,1118,752,366,827200,402600,1229800
260510,202110,779,615,164,676500,180400,856900
260515,202110,228,205,23,226600,25300,251900
260520,202110,3236,1995,1241,2194500,1368400,3562900
260530,202110,799,648,151,712800,166100,878900
260540,202110,522,410,112,451000,123200,574200
260545,202110,14,11,3,12100,3300,15400
260550,202110,327,207,120,227700,132000,359700
260560,202110,501,381,120,420200,132000,552200
260570,202110,985,784,201,862400,221100,1083500
260580,202110,253,217,36,238700,39600,278300
260590,202110,618,352,266,388300,293700,682000
260600,202110,7648,4379,3269,4818001.26,3595900,8413901.26
260610,202110,494,331,163,364100,179300,543400
260620,202110,3638,1871,1767,2060300.8,1943700.19,4004000.99
260630,202110,82,76,6,83600,6600,90200
260640,202110,3369,1920,1449,2113100,1593900,3707000
260650,202110,318,228,90,250800,99000,349800
260660,202110,561,355,206,390500,226600,617100
260670,202110,99,71,28,78100,30800,108900
260680,202110,3918,2147,1771,2362800,1949200,4312000
260690,202110,123,91,32,100100,35200,135300
260700,202110,307,204,103,224400,113300,337700
260710,202110,44,35,9,38500,9900,48400
260720,202110,2634,1543,1091,1698400,1200100,2898500
260730,202110,738,546,192,600600,211200,811800
260740,202110,69,57,12,63800,13200,77000
260750,202110,562,405,157,446600,172700,619300
260760,202110,688,338,350,372900.3,385000,757900.3
260765,202110,973,494,479,544500,526900,1071400
260770,202110,222,162,60,178181,66000,244181
260775,202110,774,419,355,460900,390500,851400
260780,202110,233,144,89,158400,97900,256300
260790,202110,14920,7402,7518,8149900,8273100.22,16423000.22
260795,202110,160,102,58,112200,63800,176000
260800,202110,285,233,52,257400,57200,314600
260805,202110,170,110,60,121000,66000,187000
260810,202110,788,650,138,715000,151800,866800
260820,202110,289,186,103,204600,113300,317900
260825,202110,208,139,69,152900,75900,228800
260830,202110,297,177,120,194700,133100,327800
260840,202110,253,183,70,201300,77000,278300
260845,202110,169,107,62,117700,68200,185900
260850,202110,407,304,103,335500,114400,449900
260860,202110,250,187,63,207900,69300,277200
260870,202110,346,265,81,291500,89100,380600
260875,202110,726,527,199,579700,218900,798600
260880,202110,1539,1009,530,1109900,584100,1694000
260890,202110,2339,1613,726,1775400,800800,2576200
260900,202110,990,702,288,773300,316800,1090100
260910,202110,247,194,53,213400,58300,271700
260915,202110,281,212,69,233200,75900,309100
260920,202110,194,101,93,111100,102300,213400
260930,202110,372,313,59,345400,64900,410300
260940,202110,2604,1385,1219,1526800,1342000,2868800
260950,202110,1997,1133,864,1247400,951500,2198900
260960,202110,13578,6640,6938,7311700.9,7641700.5,14953401.4
260970,202110,418,342,76,376200,83600,459800
260980,202110,199,179,20,196900,22000,218900
260990,202110,2655,2126,529,2339700,583000,2922700
261000,202110,4208,2564,1644,2821500,1808400,4629900
261010,202110,155,109,46,119900,50600,170500
261020,202110,584,435,149,479600.47,163900,643500.47
261030,202110,261,187,74,205700,81400,287100
261040,202110,376,324,52,356400,57200,413600
261050,202110,497,422,75,465300,82500,547800
261060,202110,1414,870,544,957000,598400,1555400
261070,202110,9074,4327,4747,4763000,5227200.5,9990200.5
261080,202110,368,281,87,309100,95700,404800
261090,202110,2107,1617,490,1779802.03,539000,2318802.03
261100,202110,1200,840,360,924000,396000,1320000
261110,202110,8932,5475,3457,6026900.18,3806000,9832900.18
261120,202110,240,205,35,225500,38500,264000
261130,202110,563,335,228,368500,250800,619300
261140,202110,214,133,81,146300,89100,235400
261150,202110,678,432,246,475200.56,270600,745800.56
261153,202110,69,64,5,71500,5500,77000
261160,202110,74457,36408,38049,40074192.62,41884958.21,81959150.83
261170,202110,473,344,129,379500,141900,521400
261180,202110,1777,1105,672,1216851,739200,1956051
261190,202110,572,397,175,436700,192500,629200
261200,202110,218,179,39,196900,42900,239800
261210,202110,39,31,8,34100,8800,42900
261220,202110,2729,1912,817,2108700,898700,3007400
261230,202110,339,249,90,273900,99000,372900
261240,202110,441,384,57,422400,62700,485100
261245,202110,247,203,44,223300,48400,271700
261247,202110,166,129,37,141900,40700,182600
261250,202110,3393,1614,1779,1775400,1956900,3732300
261255,202110,245,219,26,240900,28600,269500
261260,202110,837,725,112,797500.12,123200,920700.12
261270,202110,198,137,61,150700,67100,217800
261280,202110,186,149,37,163900,40700,204600
261290,202110,113,83,30,91300,33000,124300
261300,202110,1330,982,348,1080200,382800,1463000
261310,202110,781,519,262,570900,288200,859100
261320,202110,564,377,187,414700,205700,620400
261330,202110,908,702,206,772200,226600.63,998800.63
261340,202110,308,168,140,184800,154000,338800
261350,202110,855,597,258,658900,283800,942700
261360,202110,1342,857,485,942700,533500,1476200
261370,202110,4814,2819,1995,3102000,2196700,5298700
261380,202110,534,411,123,452100.78,135300,587400.78
261390,202110,3622,2432,1190,2675200,1310100,3985300
261400,202110,277,250,27,275000,29700,304700
261410,202110,1111,724,387,796400,426800,1223200
261420,202110,929,576,353,634700.32,388300,1023000.32
261430,202110,317,288,29,316800,31900,348700
261440,202110,109,103,6,113300,6600,119900
261450,202110,2486,1971,515,2168100,567600,2735700
261460,202110,747,583,164,641300,180400,821700
261470,202110,230,186,44,204600,48400,253000
261480,202110,453,346,107,380600,117650.5,498250.5
261485,202110,360,213,147,234300,162800,397100
261500,202110,606,406,200,446600.59,220000,666600.59
261510,202110,52,33,19,36300,20900,57200
261520,202110,88,73,15,80300,16500,96800
261530,202110,4073,2569,1504,2825900.09,1654400,4480300.09
261540,202110,1422,830,592,914100,651200,1565300
261550,202110,258,124,134,136400,147400,283800
261560,202110,892,581,311,640200,342100,982300
261570,202110,393,308,85,338800,93500,432300
261580,202110,388,307,81,337700,89100,426800
261590,202110,191,155,36,170500,39600,210100
261600,202110,284,223,61,245300,67100,312400
261610,202110,81,70,11,77000,12100,89100
261618,202110,75,56,19,61600,20900,82500
261620,202110,193,121,72,133100,79200,212300
261630,202110,666,530,136,583000,149600,732600
261640,202110,6463,3380,3083,3722401.05,3393500,7115901.05
261650,202110,474,303,171,333300,188100,521400
270010,202110,502,444,58,489500,63800,553300
270020,202110,243,198,45,217800,49500,267300
270030,202110,8754,5614,3140,6179727.25,3458351,9638078.25
270040,202110,2053,1325,728,1458600,800800,2259400
270050,202110,191,148,43,163900,47300,211200
270060,202110,75,50,25,55000,27500,82500
270070,202110,842,616,226,677600,248600,926200
270080,202110,39,32,7,35200,7700,42900
270090,202110,23,16,7,17600,8800,26400
270100,202110,1319,900,419,991100,460900,1452000
270110,202110,76,65,11,71500,12100,83600
270120,202110,228,187,41,205700,45100,250800
270130,202110,317,233,84,256300,92400,348700
270135,202110,118,80,38,88000,41800,129800
270140,202110,1365,886,479,975700,526900,1502600
270150,202110,256,199,57,218900,62700,281600
270160,202110,486,385,101,424600,111100,535700
270170,202110,791,517,274,568700,301400,870100
270180,202110,56,44,12,48400,13200,61600
270190,202110,114,96,18,105600,19800,125400
270200,202110,112,99,13,108900,14300,123200
270210,202110,534,323,211,356400,232100,588500
270220,202110,182,138,44,151800,48400,200200
270230,202110,2142,1324,818,1459700,902000,2361700
270235,202110,668,519,149,572000,165000,737000
270240,202110,2963,2350,613,2587201.25,675400,3262601.25
270250,202110,125,91,34,100100,37400,137500
270255,202110,213,181,32,199100,35200,234300
270260,202110,363,295,68,325600,74800,400400
270270,202110,95,49,46,53900,50600,104500
270280,202110,221,128,93,140800,102300,243100
270290,202110,1110,868,242,954800,266200,1221000
270300,202110,341,250,91,275000,100100,375100
270310,202110,810,674,136,742500,149600,892100
270320,202110,793,684,109,753500.63,119900,873400.63
270330,202110,303,253,50,278300,55000,333300
270340,202110,56,45,11,49500,12100,61600
270350,202110,91,54,37,59400,40700,100100
270360,202110,64,36,28,39600,30800,70400
270370,202110,58,45,13,49500,14300,63800
270375,202110,76,45,31,49500,34100,83600
270380,202110,1058,702,356,772200,391600,1163800
270390,202110,150,85,65,93500,71500,165000
270400,202110,732,551,181,607200.2,199100,806300.2
270410,202110,626,463,163,510400,179300,689700
270420,202110,400,275,125,303343.33,137500,440843.33
270430,202110,33745,24207,9538,26662458.82,10498400,37160858.82
270440,202110,478,378,100,415800,111100,526900
270450,202110,827,490,337,539000,370700,909700
270460,202110,179,141,38,155100,41800,196900
270470,202110,1533,1061,472,1168603.33,522500,1691103.33
270480,202110,529,430,99,473000,108900,581900
270490,202110,20,15,5,16500,5500,22000
270500,202110,480,402,78,442200,85800,528000
270510,202110,844,536,308,589600,338800,928400
270520,202110,274,179,95,196900,104500,301400
270530,202110,60,51,9,56100,11000,67100
270540,202110,93,70,23,77000,25300,102300
270550,202110,1692,1303,389,1433300,427900,1861200
270560,202110,261,152,109,167200,119900,287100
270570,202110,528,373,155,410300,170500,580800
270580,202110,81,64,17,71500,18700,90200
270590,202110,59,46,13,50600,14300,64900
270600,202110,159,134,25,147400,27500,174900
270610,202110,234,186,48,204600,52800,257400
270620,202110,13,13,0,14300,,14300.0
270630,202110,3681,2795,886,3077800,974600,4052400
270640,202110,860,643,217,707300.44,238700,946000.44
270642,202110,209,175,34,192500,37400,229900
270644,202110,248,165,83,181500,91300,272800
270650,202110,334,198,136,217800,149600,367400
270660,202110,197,171,26,188100,29700,217800
270670,202110,2928,2232,696,2457401.01,766700,3224101.01
270680,202110,407,248,159,272800,174900,447700
270690,202110,1217,811,406,892100,446600,1338700
270700,202110,25,20,5,22000,5500,27500
270710,202110,860,677,183,744700,201300,946000
270720,202110,230,181,49,199100,53900,253000
270730,202110,1881,1171,710,1288100,781000,2069100
270740,202110,39,25,14,27500,15400,42900
270750,202110,633,482,151,530200,166100,696300
270760,202110,300,214,86,235400,94600,330000
270770,202110,2756,1855,901,2041233.33,991100,3032333.33
270780,202110,63,41,22,46200,24200,70400
270790,202110,241,156,85,171600,93500,265100
270800,202110,2029,1620,409,1782000,449900,2231900
270810,202110,220,182,38,200200,41800,242000
270820,202110,130,91,39,100100,42900,143000
270830,202110,803,606,197,667700,216700,884400
270840,202110,1337,1026,311,1128600.4,342100,1470700.4
270850,202110,1508,971,537,1068100,591800,1659900
270860,202110,2528,1691,837,1861200.7,920700,2781900.7
270870,202110,114,65,49,71500,53900,125400
270880,202110,859,681,178,749100,198000,947100
270890,202110,273,206,67,226600,73700,300300
270895,202110,56,52,4,57200,4400,61600
270900,202110,65,55,10,60500,11000,71500
270910,202110,296,244,52,268400,57200,325600
270915,202110,1897,1237,660,1362900,726000,2088900
270920,202110,434,361,73,398200,80300,478500
270930,202110,5802,4418,1384,4860900,1522400.14,6383300.14
270940,202110,2205,1737,468,1911800,514800,2426600
280010,202110,39,33,6,36300,6600,42900
280020,202110,482,412,70,453200,77000,530200
280030,202110,20934,13524,7410,14885116.13,8155401.87,23040518.00
280040,202110,328,212,116,233200,127600,360800
280050,202110,421,323,98,355300,108900,464200
280060,202110,350,229,121,253000,133100,386100
280067,202110,1111,800,311,880000,342100.5,1222100.5
280070,202110,129,105,24,115500,26400,141900
280100,202110,645,495,150,545600,165000,710600
280110,202110,74,67,7,73700,7700,81400
280120,202110,665,553,112,608300,123200,731500
280130,202110,1736,1138,598,1251800,658900,1910700
280140,202110,488,406,82,446600,90200,536800
280150,202110,414,288,126,316800,138600,455400
280160,202110,132,106,26,117700,28600,146300
280170,202110,414,286,128,314600,140800,455400
280190,202110,28,23,5,25300,5500,30800
280200,202110,34,28,6,30800,6600,37400
280210,202110,2928,2100,828,2310000.5,911900,3221900.5
280220,202110,47,37,10,40700,11000,51700
280230,202110,333,272,61,299200,67100,366300
280240,202110,125,116,9,127600,9900,137500
280250,202110,20,12,8,13200,8800,22000
280260,202110,77,70,7,77000,7700,84700
280270,202110,143,110,33,121000,36300,157300
280280,202110,188,121,67,133100.5,73700,206800.5
280290,202110,3472,2505,967,2756529.5,1064800.72,3821330.22
280300,202110,1597,1263,334,1389300,367400,1756700
280310,202110,98,93,5,102300,5500,107800
280320,202110,652,456,196,501600,215600,717200
280330,202110,319,235,84,258500,92400,350900
280340,202110,443,355,88,390500,96800,487300
280350,202110,3720,2862,858,3149300.66,943800.08,4093100.74
280360,202110,469,317,152,349800,167200,517000
280370,202110,94,82,12,90200,13200,103400
280380,202110,52,38,14,41800,15400,57200
280390,202110,173,146,27,160600,29700,190300
280400,202110,371,249,122,273900,134200,408100
280410,202110,285,236,49,259600,53900,313500
280420,202110,137,118,19,129800,20900,150700
280430,202110,83,66,17,72600,18700,91300
280440,202110,731,586,145,644600.86,159500,804100.86
280445,202110,121,112,9,123200,9900,133100
280450,202110,1245,1073,172,1181400,189200,1370600
280460,202110,650,471,179,518100.93,196900,715000.93
280470,202110,110,99,11,108900,12100,121000
280480,202110,2841,1938,903,2131801.67,993300.5,3125102.17
280490,202110,200,190,10,209000.96,11000,220000.96
280500,202110,43,40,3,44000,3300,47300
280510,202110,133,105,28,115500,30800,146300
280520,202110,52,37,15,40700,16500,57200
280530,202110,78,50,28,55000,30800,85800
280540,202110,535,457,78,502700,85800,588500
280550,202110,733,675,58,742500.65,63800,806300.65
280560,202110,485,432,53,475200.06,58300,533500.06
280570,202110,2312,1823,489,2006400,539000,2545400
280580,202110,579,448,131,492800,144100,636900
280590,202110,218,139,79,152900,86900,239800
280600,202110,390,324,66,356451.7,72600,429051.7
280610,202110,109,79,30,86900,33000,119900
280620,202110,530,432,98,475200,107800,583000
280630,202110,151,126,25,138600,27500,166100
280640,202110,187,151,36,166100,39600,205700
280650,202110,90,57,33,62700,36300,99000
280660,202110,135,99,36,110000,39600,149600
280670,202110,1927,1215,712,1336500.58,784300.43,2120801.01
280680,202110,228,197,31,216700,34100,250800
280690,202110,83,72,11,79200,12100,91300
280700,202110,19,19,0,20900,,20900.0
280710,202110,1491,1151,340,1266100.88,374000,1640100.88
280720,202110,118,79,39,86900,42900,129800
280730,202110,28,24,4,26400,4400,30800
280740,202110,2547,1901,646,2091100,710600,2801700
280750,202110,225,195,30,214500,33000,247500
280760,202110,833,563,270,619300,297000,916300
290010,202110,196,135,61,148500,67100,215600
290020,202110,187,169,18,185900,19800,205700
290030,202110,622,397,225,436700,247500,684200
290035,202110,135,111,24,122100,27500,149600
290040,202110,303,204,99,224400,110000,334400
290050,202110,86,69,17,75900,18700,94600
290060,202110,256,113,143,124300,157300,281600
290070,202110,5767,2736,3031,3011800.69,3334100,6345900.69
290080,202110,440,189,251,207900,276100,484000
290090,202110,366,163,203,179300,223300,402600
290100,202110,1660,1064,596,1173700,655600,1829300
290110,202110,845,489,356,537900.85,391600,929500.85
290115,202110,193,177,16,194700,17600,212300
290120,202110,785,520,265,572000,292600,864600
290130,202110,446,273,173,300300,190300,490600
290135,202110,300,232,68,255200,74800,330000
290140,202110,317,262,55,288200,60500,348700
290150,202110,131,89,42,97900,46200,144100
290160,202110,247,189,58,207900.44,63800,271700.44
290170,202110,95,66,29,72600,31900,104500
290180,202110,188,136,52,149600,57200,206800
290190,202110,370,295,75,324500,82500,407000
290195,202110,303,196,107,216700,117700,334400
290200,202110,264,216,48,237600,52800,290400
290205,202110,145,92,53,101200,58300,159500
290210,202110,1184,868,316,957000,347600,1304600
290220,202110,189,106,83,116600,91300,207900
290225,202110,298,122,176,134200,193600,327800
290230,202110,77,47,30,51700,33000,84700
290240,202110,360,122,238,134200,261800,396000
290250,202110,248,231,17,255200,18700,273900
290260,202110,323,262,61,288200,67100,355300
290265,202110,184,162,22,178200,24200,202400
290270,202110,1404,1170,234,1287000,257400,1544400
290280,202110,473,334,139,367400,152900,520300
290290,202110,1356,809,547,892100.5,601700,1493800.5
290300,202110,404,345,59,379500,64900,444400
290310,202110,291,138,153,151800,168300,320100
290320,202110,4108,2507,1601,2762100.11,1762200,4524300.11
290323,202110,190,166,24,182600,26400,209000
290327,202110,159,124,35,136400,38500,174900
290330,202110,118,58,60,63800,67100,130900
290340,202110,784,322,462,354200,510400,864600
290350,202110,664,409,255,449900,284900,734800
290360,202110,320,246,74,270600.99,81400,352000.99
290370,202110,921,404,517,444400,568700,1013100
290380,202110,328,211,117,233200,128700,361900
290390,202110,2405,1489,916,1640100,1008700,2648800
290395,202110,236,133,103,146300,113300,259600
290400,202110,280,203,77,223300,84700,308000
290405,202110,245,212,33,233200,36300,269500
290410,202110,621,516,105,567600,115500,683100
290420,202110,265,212,53,233200,58300,291500
290430,202110,469,297,172,326700,189200,515900
290440,202110,76,68,8,74800,8800,83600
290450,202110,186,140,46,154000,50600,204600
290460,202110,1932,1144,788,1259500,866800,2126300
290470,202110,1355,591,764,652300,840400,1492700
290475,202110,557,521,36,573100.27,39600,612700.27
290480,202110,275,158,117,174900,128700,303600
290485,202110,240,219,21,240900,23100,264000
290490,202110,1244,883,361,972400,397100,1369500
290500,202110,758,394,364,433400,400400,833800
290510,202110,202,161,41,177100,45100,222200
290515,202110,159,94,65,103400,71500,174900
290520,202110,1388,901,487,991100,535700.2,1526800.2
290530,202110,294,268,26,294800,28600,323400
290540,202110,111,56,55,61600,60500,122100
290550,202110,164,139,25,152900,27500,180400
290560,202110,3164,1369,1795,1508100,1976700,3484800
290570,202110,6313,3042,3271,3347300,3602500,6949800
290580,202110,1266,752,514,827200,565400,1392600
290590,202110,570,462,108,508200,118800,627000
290600,202110,1745,1195,550,1315600,605000,1920600
290610,202110,183,167,16,183700,17600,201300
290620,202110,363,329,34,361900,38500,400400
290630,202110,1968,840,1128,924000,1243000,2167000
290640,202110,141,113,28,124300,30800,155100
290650,202110,1809,840,969,925100.92,1065900,1991000.92
290660,202110,266,219,47,240900,52800,293700
290670,202110,949,480,469,528000,515900,1043900
290680,202110,1230,984,246,1083500,270600,1354100
290682,202110,316,233,83,256300.48,91300,347600.48
290685,202110,246,156,90,171600,99000,270600
290687,202110,1094,707,387,777879,425700,1203579
290689,202110,150,78,72,85800,79200,165000
290690,202110,594,253,341,278300,375100,653400
290700,202110,239,118,121,129800,133100,262900
290710,202110,760,511,249,562100,273900,836000
290720,202110,1022,819,203,900900,224400,1125300
290730,202110,1205,701,504,771100,554400,1325500
290740,202110,22,18,4,19800,4400,24200
290750,202110,1421,612,809,674300,889900,1564200
290755,202110,69,62,7,68200,7700,75900
290760,202110,255,225,30,247500,33000,280500
290770,202110,183,173,10,190300,11000,201300
290780,202110,1104,863,241,949300,265100,1214400
290790,202110,371,252,119,278300,130900,409200
290800,202110,2433,975,1458,1072500,1607100,2679600
290810,202110,479,325,154,358600,169400,528000
290820,202110,403,235,168,259600,184800,444400
290830,202110,419,295,124,325600,136400,462000
290840,202110,1798,1114,684,1225400,752400,1977800
290850,202110,901,460,441,506000,485100,991100
290860,202110,634,283,351,311300,386100,697400
290870,202110,620,437,183,480700,201300,682000
290880,202110,118,64,54,71500,59400,130900
290890,202110,428,264,164,290400,180400,470800
290900,202110,165,124,41,136400,46200,182600
290910,202110,390,295,95,324500,104500,429000
290920,202110,202,177,25,194700,27500,222200
290930,202110,509,387,122,425700,135300,561000
290940,202110,232,194,38,213400,41800,255200
290950,202110,159,92,67,101200,73700,174900
290960,202110,462,321,141,354200,156200,510400
290970,202110,241,212,29,233200,31900,265100
290980,202110,1740,1192,548,1312300,602800,1915100
290990,202110,395,332,63,367400,69300,436700
291000,202110,874,272,602,299200,663300,962500
291005,202110,2436,1043,1393,1148400,1534500,2682900
291010,202110,161,143,18,157300,19800,177100
291020,202110,96,76,20,83600,22000,105600
291030,202110,93,66,27,72600,29700,102300
291040,202110,620,351,269,386100,297000,683100
291050,202110,1492,798,694,877800,764500,1642300
291060,202110,1646,910,736,1001000,809600,1810600
291070,202110,1953,1461,492,1608200,541201.3,2149401.3
291072,202110,7111,2621,4490,2886400,4941200,7827600
291075,202110,237,191,46,210100,50600,260700
291077,202110,56,38,18,41800,19800,61600
291080,202110,20529,8790,11739,9677800.75,12918400,22596200.75
291085,202110,270,222,48,244200,52800,297000
291090,202110,282,116,166,127600,182600,310200
291100,202110,1000,331,669,365200,737000,1102200
291110,202110,425,326,99,358600,108900,467500
291120,202110,2414,1235,1179,1359600,1296900,2656500
291125,202110,60,31,29,34100,31900,66000
291130,202110,192,168,24,184800,26400,211200
291140,202110,124,103,21,113300,23100,136400
291150,202110,383,146,237,160600,260700,421300
291160,202110,378,304,74,334400,81400,415800
291165,202110,48,37,11,41800,12100,53900
291170,202110,3206,1580,1626,1739100.8,1789700,3528800.8
291180,202110,1238,497,741,546700,816200,1362900
291185,202110,106,99,7,108900,7700,116600
291190,202110,1380,653,727,720500,799700,1520200
291200,202110,169,123,46,136400,50600,187000
291210,202110,2347,930,1417,1024100,1558700,2582800
291220,202110,287,221,66,243100,72600,315700
291230,202110,963,332,631,366300,694100,1060400
291240,202110,416,388,28,426800,30800,457600
291250,202110,426,343,83,378400,91300,469700
291260,202110,59,51,8,56100,8800,64900
291270,202110,1041,454,587,499400,645700,1145100
291280,202110,354,168,186,184800,204600,389400
291290,202110,1686,879,807,968000,887700,1855700
291300,202110,228,178,50,195800,55000,250800
291310,202110,227,201,26,221100,28600,249700
291320,202110,1327,933,394,1026300,433400,1459700
291330,202110,135,116,19,127600,20900,148500
291340,202110,226,135,91,148500,100100,248600
291345,202110,125,86,39,94600,42900,137500
291350,202110,1722,629,1093,691900,1203400,1895300
291360,202110,8334,3955,4379,4353800,4819100,9172900
291370,202110,1101,638,463,701800,511500,1213300
291380,202110,257,204,53,225500,58300,283800
291390,202110,3965,1756,2209,1931600,2432100,4363700
291400,202110,2076,1469,607,1618100,667701.27,2285801.27
291410,202110,189,160,29,176000,31900,207900
291420,202110,114,87,27,95700,29700,125400
291430,202110,165,96,69,105600,75900.5,181500.5
291440,202110,521,427,94,469700,103400,573100
291450,202110,932,604,328,666600,361900,1028500
291460,202110,1920,1539,381,1694000,420200,2114200
291465,202110,2231,1059,1172,1166000,1289200,2455200
291470,202110,2863,1436,1427,1579600.55,1569700,3149300.55
291480,202110,11794,5087,6707,5597902.09,7378800,12976702.09
291490,202110,630,254,376,279400,413600,693000
291500,202110,373,221,152,243100,167200,410300
291510,202110,1198,463,735,509300,808500,1317800
291520,202110,932,418,514,459800,565400,1025200
291530,202110,903,245,658,269500,724900,994400
291535,202110,119,99,20,108900,23100,132000
291540,202110,363,120,243,132000,267300,399300
291550,202110,1279,597,682,656700,750200,1406900
291560,202110,5122,2542,2580,2802800,2839100,5641900
291570,202110,217,112,105,123200,115500,238700
291580,202110,1192,732,460,805200,506000,1311200
291590,202110,99,43,56,47300,61600,108900
291600,202110,1131,561,570,618200,627000,1245200
291610,202110,1417,685,732,755700,806300,1562000
291620,202110,568,267,301,293700,331100,624800
291630,202110,479,150,329,165000,361900,526900
291640,202110,3999,1994,2005,2193400,2206600,4400000
291650,202110,432,296,136,325600.5,149600,475200.5
291660,202110,367,148,219,162800,240900,403700
291670,202110,178,110,68,121000,74800,195800
291680,202110,635,387,248,425700,272800,698500
291685,202110,574,323,251,355300,276100,631400
291690,202110,469,293,176,322300,193600.92,515900.92
291700,202110,999,771,228,849200,250800,1100000
291710,202110,1582,768,814,845900,895400,1741300
291720,202110,420,284,136,313500,149600,463100
291730,202110,929,540,389,595100,427900,1023000
291733,202110,286,194,92,213400,101200,314600
291735,202110,75,57,18,62700,19800,82500
291740,202110,340,259,81,284900,89100,374000
291750,202110,2230,1446,784,1591700.25,862400,2454100.25
291760,202110,2995,1647,1348,1812800,1483900,3296700
291770,202110,745,511,234,562100,257400,819500
291780,202110,63,37,26,40700,28600,69300
291790,202110,156,81,75,89100,82500,171600
291800,202110,10125,4209,5916,4631000.42,6513100,11144100.42
291810,202110,1072,805,267,888800,293700,1182500
291820,202110,279,199,80,218900,88000,306900
291830,202110,1028,416,612,457600.59,674300,1131900.59
291835,202110,549,508,41,558800,45100,603900
291840,202110,5025,2496,2529,2747800,2785200,5533000
291845,202110,265,81,184,89100,202400,291500
291850,202110,312,277,35,306900,38500,345400
291855,202110,253,105,148,115500,162800,278300
291860,202110,162,101,61,111100,67100,178200
291870,202110,80,34,46,38500,50600,89100
291875,202110,161,150,11,165000,12100,177100
291880,202110,423,342,81,376200,89100,465300
291890,202110,238,81,157,89100,172700,261800
291900,202110,55,32,23,35200,25300,60500
291905,202110,112,85,27,94600,29700,124300
291910,202110,159,126,33,138600,36300,174900
291915,202110,430,380,50,418000,55000,473000
291920,202110,5267,2586,2681,2846800,2953500,5800300
291930,202110,163,97,66,106700.27,72600,179300.27
291940,202110,365,209,156,229900,171600,401500
291950,202110,1139,901,238,991100,261800,1252900
291955,202110,1319,796,523,875600,575300,1450900
291960,202110,200,147,53,161700,58300,220000
291970,202110,757,563,194,619300,213400,832700
291980,202110,1466,1281,185,1409100.73,203500,1612600.73
291990,202110,142,131,11,144100,12100,156200
291992,202110,176,90,86,99000,94600,193600
291995,202110,189,120,69,132000,75900,207900
292000,202110,406,303,103,333300,113300,446600
292010,202110,322,221,101,243100,111100,354200
292020,202110,301,219,82,240900,90200,331100
292030,202110,142,108,34,119900,37400,157300
292040,202110,594,306,288,336600,316800,653400
292045,202110,114,101,13,112603.33,14300,126903.33
292050,202110,928,670,258,738100,283800,1021900
292060,202110,882,717,165,790900,181500,972400
292070,202110,63,25,38,27500,41800,69300
292080,202110,147,102,45,112200,49500,161700
292090,202110,518,179,339,198000,372900,570900
292100,202110,1503,644,859,708400,946000,1654400
292105,202110,182,163,19,180400,20900,201300
292110,202110,2245,819,1426,900900,1569700,2470600
292120,202110,700,542,158,597300,173800,771100
292130,202110,456,255,201,280500,221100,501600
292140,202110,218,173,45,190300,49500,239800
292145,202110,161,84,77,92400,84700,177100
292150,202110,1488,1221,267,1343100,293700,1636800
292160,202110,158,128,30,140800,33000,173800
292170,202110,1175,1017,158,1118700,173800,1292500
292180,202110,230,170,60,187000,66000,253000
292190,202110,156,103,53,113300,58300,171600
292200,202110,1380,496,884,545600,974600,1520200
292205,202110,120,102,18,112200,19800,132000
292210,202110,375,258,117,283800,128700,412500
292220,202110,30,21,9,23100,9900,33000
292225,202110,44,35,9,39600,9900,49500
292230,202110,961,732,229,807400,251900,1059300
292240,202110,612,443,169,487300,185900,673200
292250,202110,1668,1082,586,1192400,644600,1837000
292260,202110,399,239,160,264000,176000,440000
292265,202110,248,183,65,201300,71500,272800
292270,202110,717,334,383,368500,421300,789800
292273,202110,208,117,91,128700,100100,228800
292275,202110,164,81,83,89100,91300,180400
292280,202110,144,100,44,110000,48400,158400
292285,202110,83,66,17,72600,18700,91300
292290,202110,576,385,191,423500,210100,633600
292300,202110,1733,649,1084,715000,1193500,1908500
292303,202110,122,78,44,85800,48400,134200
292305,202110,116,87,29,95700,31900,127600
292310,202110,964,624,340,686400,374000,1060400
292320,202110,581,434,147,478500,161700,640200
292330,202110,176,108,68,118800,74800,193600
292335,202110,288,228,60,250800,66000,316800
292340,202110,560,385,175,424600,192500,617100
292350,202110,270,148,122,162800,134200,297000
292360,202110,708,530,178,583000,195800,778800
292370,202110,727,551,176,607200,193600,800800
292380,202110,620,509,111,559900,122100,682000
292390,202110,394,161,233,177100,256300,433400
292400,202110,3624,2244,1380,2471700.31,1520200,3991900.31
292405,202110,272,181,91,199100,100100,299200
292410,202110,126,78,48,85800,52800,138600
292420,202110,289,250,39,275000,42900,317900
292430,202110,538,393,145,434500,160600,595100
292440,202110,631,531,100,584100.56,110000,694100.56
292450,202110,241,185,56,203500,61600,265100
292460,202110,528,390,138,429000,151800,580800
292465,202110,204,174,30,191400,33000,224400
292467,202110,142,86,56,94600,61600,156200
292470,202110,299,203,96,223300,105600,328900
292480,202110,392,262,130,288200,143000,431200
292490,202110,238,172,66,189200,72600,261800
292500,202110,875,399,476,438900.32,523600,962500.32
292510,202110,3524,1647,1877,1812800,2065800,3878600
292520,202110,1116,520,596,572000,655600,1227600
292525,202110,417,300,117,331100,128700,459800
292530,202110,4608,1821,2787,2003100.65,3067900,5071000.65
292540,202110,480,272,208,299200,228800,528000
292550,202110,1112,592,520,651200,572000,1223200
292560,202110,323,298,25,328900,27500,356400
292570,202110,308,237,71,260700,78100,338800
292575,202110,522,354,168,389400,184800,574200
292580,202110,991,667,324,733700,356400,1090100
292590,202110,561,492,69,541200,75900,617100
292593,202110,143,113,30,124300,33000,157300
292595,202110,203,161,42,177100,46200,223300
292600,202110,1255,903,352,994400.63,387200,1381600.63
292610,202110,114,91,23,100100,25300,125400
292620,202110,532,450,82,495000,90200,585200
292630,202110,1507,826,681,908600,749100,1657700
292640,202110,864,597,267,656700,293700,950400
292650,202110,188,152,36,169400.5,39600,209000.5
292660,202110,1953,1375,578,1512500,635800.92,2148300.92
292665,202110,140,100,40,110000,44000,154000
292670,202110,389,307,82,337700,90200,427900
292680,202110,261,194,67,213400,73700,287100
292690,202110,203,143,60,157300,66000,223300
292700,202110,990,647,343,711700,378400,1090100
292710,202110,113,99,14,108900,15400,124300
292720,202110,945,538,407,591800,448800,1040600
292730,202110,198,95,103,104500,113300,217800
292740,202110,70778,34130,36648,37582601.88,40346900.89,77929502.77
292750,202110,388,278,110,306900,121000,427900
292760,202110,336,281,55,309100,60500,369600
292770,202110,834,353,481,388300,530200,918500
292780,202110,21,12,9,13200,9900,23100
292790,202110,785,408,377,448800,414700,863500
292800,202110,1256,746,510,820600,561000,1381600
292805,202110,385,122,263,134200,289300,423500
292810,202110,1808,1072,736,1180300,809600,1989900
292820,202110,692,585,107,643500,117700,761200
292830,202110,121,97,24,106700,26400,133100
292840,202110,690,561,129,618200,141900,760100
292850,202110,136,88,48,96800,52800,149600
292860,202110,2120,1232,888,1358500,977900,2336400
292870,202110,3560,2342,1218,2577300,1339800,3917100
292880,202110,1440,954,486,1050500,534600,1585100
292890,202110,532,442,90,486200,99000,585200
292895,202110,145,96,49,105600,53900,159500
292900,202110,355,249,106,276100,116600,392700
292905,202110,480,233,247,256300,271700,528000
292910,202110,464,348,116,383900,127600,511500
292920,202110,522,224,298,246400,327800,574200
292925,202110,478,437,41,480700,45100,525800
292930,202110,652,391,261,430100,287100,717200
292935,202110,284,121,163,133100,179300,312400
292937,202110,225,153,72,168300,79200,247500
292940,202110,187,142,45,157300,49500,206800
292950,202110,1218,597,621,656700,684200.6,1340900.6
292960,202110,542,383,159,422400,176000,598400
292970,202110,230,166,64,182600.48,70400,253000.48
292975,202110,93,55,38,60500,41800,102300
292980,202110,316,215,101,236500.61,111100,347600.61
292990,202110,1308,969,339,1067000,372900,1439900
293000,202110,113,80,33,88000,36300,124300
293010,202110,2886,1695,1191,1864500,1310100.5,3174600.5
293015,202110,616,503,113,553300,124300,677600
293020,202110,322,263,59,290400,64900,355300
293030,202110,578,508,70,558800,77000,635800
293040,202110,365,290,75,320100,82500,402600
293050,202110,2931,1729,1202,1903000,1323300,3226300
293060,202110,249,197,52,217800.48,57200,275000.48
293070,202110,3612,1814,1798,1996500.93,1978900,3975400.93
293075,202110,94,64,30,70400,33000,103400
293076,202110,74,55,19,60500,20900,81400
293077,202110,565,321,244,354200,268400,622600
293080,202110,416,372,44,410300.62,48400,458700.62
293090,202110,126,114,12,125400,13200,138600
293100,202110,530,367,163,403700,179300,583000
293105,202110,344,251,93,276100,102300,378400
293110,202110,123,84,39,92400,42900,135300
293120,202110,300,206,94,226600,103400,330000
293130,202110,248,168,80,185900,88000,273900
293135,202110,8124,3116,5008,3428700,5511000,8939700
293140,202110,190,113,77,124300,84700,209000
293150,202110,308,267,41,293700,45100,338800
293160,202110,420,258,162,283800,178200,462000
293170,202110,200,128,72,140800,79200,220000
293180,202110,556,376,180,413600,198000,611600
293190,202110,1347,920,427,1012000.7,469700,1481700.7
293200,202110,551,486,65,534600,71500,606100
293210,202110,411,317,94,348700,103400,452100
293220,202110,2401,1034,1367,1139600,1504800,2644400
293230,202110,1853,689,1164,759000.1,1280400,2039400.1
293240,202110,233,215,18,236500,19800,256300
293245,202110,127,106,21,116600,23100,139700
293250,202110,766,305,461,335500,507100,842600
293260,202110,303,249,54,273900,59400,333300
293270,202110,1151,515,636,566500,700700,1267200
293280,202110,296,173,123,190300,135300,325600
293290,202110,3033,1967,1066,2165900,1172600,3338500
293300,202110,775,546,229,601700,251900,853600
293305,202110,196,154,42,169400,46200,215600
293310,202110,172,128,44,140800,48400,189200
293315,202110,166,129,37,141900,40700,182600
293317,202110,88,64,24,70400,26400,96800
293320,202110,1091,588,503,646800,553300,1200100
293325,202110,191,70,121,77000,133100,210100
293330,202110,13911,6310,7601,6949801.95,8368800.32,15318602.27
293340,202110,287,200,87,220000,95700,315700
293345,202110,260,210,50,231000,55000,286000
293350,202110,584,348,236,383900,259600,643500
293360,202110,1506,1074,432,1181400,475200,1656600
310010,202110,141,74,67,81400,74800,156200
310020,202110,1014,559,455,616000,502700,1118700
310030,202110,316,254,62,280500,68200,348700
310040,202110,46,29,17,31900,18700,50600
310050,202110,164,103,61,113300,67100,180400
310060,202110,263,180,83,198000.26,92400,290400.26
310070,202110,16,9,7,9900,7700,17600
310080,202110,44,29,15,31900,16500,48400
310090,202110,1045,555,490,610500,539000,1149500
310100,202110,309,220,89,242000,97900,339900
310110,202110,691,369,322,407000,354200,761200
310120,202110,381,220,161,242000,177100,419100
310130,202110,30,17,13,18700,14300,33000
310140,202110,22,7,15,7700,16500,24200
310150,202110,1165,774,391,852500,430100,1282600
310160,202110,2052,994,1058,1094500.22,1163800,2258300.22
310163,202110,89,46,43,50600,47300,97900
310170,202110,2507,1121,1386,1234200,1524600,2758800
310180,202110,159,58,101,63800,111100,174900
310190,202110,474,321,153,353100,168300,521400
310200,202110,458,293,165,322300,181500,503800
310205,202110,64,43,21,47300,23100,70400
310210,202110,270,219,51,240900,56100,297000
310220,202110,62,33,29,36300,31900,68200
310230,202110,281,197,84,217800,92400,310200
310240,202110,108,92,16,101200,17600,118800
310250,202110,99,78,21,85800,23100,108900
310260,202110,720,379,341,416900.92,376200,793100.92
310270,202110,265,168,97,184800,106700,291500
310280,202110,382,277,105,304700,115500,420200
310285,202110,200,150,50,165000,55000,220000
310290,202110,233,132,101,145200,111100,256300
310300,202110,171,138,33,151800,36300,188100
310310,202110,10,7,3,7700,3300,11000
310320,202110,28,9,19,9900,20900,30800
310330,202110,43,28,15,30800,16500,47300
310340,202110,1834,1235,599,1358500,658900,2017400
310350,202110,2744,1451,1293,1598300,1423400,3021700
310360,202110,46,39,7,42900,7700,50600
310370,202110,129,108,21,118800,23100,141900
310375,202110,107,39,68,42900,74800,117700
310380,202110,50,28,22,30800,24200,55000
310390,202110,106,67,39,73700,42900,116600
310400,202110,2388,1531,857,1685200,944900,2630100
310410,202110,116,63,53,69300,58300,127600
310420,202110,651,332,319,365200,352000,717200
310430,202110,272,166,106,182600,116600,299200
310440,202110,75,43,32,47300,35200,82500
310445,202110,79,66,13,72600,14300,86900
310450,202110,623,397,226,436700,248600,685300
310460,202110,247,173,74,190300,81400,271700
310470,202110,507,325,182,357500,200200,557700
310480,202110,86,53,33,58300,36300,94600
310490,202110,533,244,289,268400,317900,586300
310500,202110,130,50,80,55000,88000,143000
310510,202110,592,414,178,456500,195800,652300
310520,202110,141,100,41,110000.97,45100,155100.97
310530,202110,105,41,64,45100,70400,115500
310540,202110,460,258,202,283800,223300,507100
310550,202110,71,48,23,52800,25300,78100
310560,202110,2994,2027,967,2233000,1063700,3296700
310570,202110,98,59,39,64900,42900,107800
310590,202110,360,223,137,246400,150700,397100
310600,202110,142,74,68,81400,74800,156200
310610,202110,54,21,33,23100,36300,59400
310620,202110,47063,21956,25107,24173517.5,27644100,51817617.5
310630,202110,673,404,269,444400,295900,740300
310640,202110,128,92,36,101200,39600,140800
310650,202110,154,138,16,151800,17600,169400
310660,202110,107,73,34,80300,37400,117700
310665,202110,63,45,18,49500,19800,69300
310670,202110,6904,2946,3958,3242800,4356000,7598800
310680,202110,66,41,25,45100,27500,72600
310690,202110,617,432,185,476300,203500,679800
310700,202110,63,38,25,41800,27500,69300
310710,202110,1288,868,420,954013.5,462000,1416013.5
310720,202110,148,39,109,42900,119900,162800
310730,202110,1494,1013,481,1115400,530200,1645600
310740,202110,990,545,445,601700,491700,1093400
310750,202110,249,153,96,169400,105600,275000
310760,202110,70,54,16,59400,17600,77000
310770,202110,92,46,46,50600,50600,101200
310780,202110,354,282,72,310200,79200,389400
310790,202110,108,86,22,94600,24200,118800
310800,202110,469,215,254,236500,279400,515900
310810,202110,172,117,55,128700.72,60500,189200.72
310820,202110,324,259,65,284900,71500,356400
310825,202110,207,177,30,194700,33000,227700
310830,202110,470,217,253,240900,278300,519200
310840,202110,363,211,152,233200,169400,402600
310850,202110,79,65,14,71500,15400,86900
310855,202110,396,309,87,339900,95700,435600
310860,202110,1597,1172,425,1290300,469700,1760000
310870,202110,51,43,8,47300,8800,56100
310880,202110,81,66,15,72600,16500,89100
310890,202110,305,170,135,187000,148500,335500
310900,202110,624,273,351,301405.76,386111.52,687517.28
310910,202110,236,159,77,174900,84700,259600
310920,202110,439,252,187,278300,206800,485100
310925,202110,35,26,9,28600,9900,38500
310930,202110,1279,824,455,907500,500500,1408000
310940,202110,680,336,344,369600,378400,748000
310945,202110,119,73,46,80300,50600,130900
310950,202110,226,181,45,199100,49500,248600
310960,202110,75,24,51,26400,56100,82500
310970,202110,166,101,65,111100,71500,182600
310980,202110,45,29,16,31900,17600,49500
310990,202110,169,88,81,96800,89100,185900
311000,202110,812,385,427,423500.1,469700,893200.1
311010,202110,49,41,8,45100,8800,53900
311020,202110,42,24,18,26400,19800,46200
311030,202110,383,216,167,237600,183700,421300
311040,202110,39,30,9,33000,9900,42900
311050,202110,476,175,301,193600,331100,524700
311060,202110,789,437,352,480700,388300,869000
311070,202110,329,144,185,158400,204600,363000
311080,202110,110,63,47,69300,51700,121000
311090,202110,332,158,174,173800,191400,365200
311100,202110,560,331,229,364100,251900,616000
311110,202110,703,499,204,548900,225500,774400
311115,202110,74,52,22,57200,24200,81400
311120,202110,1047,557,490,613800,542300,1156100
311130,202110,299,174,125,191400,137500,328900
311140,202110,158,82,76,91300,83600,174900
311150,202110,349,221,128,243100,140800,383900
311160,202110,732,515,217,566500,238700,805200
311170,202110,88,71,17,79200,18700,97900
311180,202110,297,199,98,218900,107800,326700
311190,202110,41,16,25,17600,27500,45100
311200,202110,351,242,109,267300,119900,387200
311205,202110,32,23,9,25300,9900,35200
311210,202110,42,36,6,39600,6600,46200
311220,202110,31,27,4,29700,4400,34100
311230,202110,1647,1076,571,1183600,628100,1811700
311240,202110,196,124,72,136400,79200,215600
311250,202110,58,21,37,23100,40700,63800
311260,202110,546,344,202,379500,222200,601700
311265,202110,121,81,40,89100,44000,133100
311270,202110,289,200,89,220000,97900,317900
311280,202110,197,85,112,93500,123200,216700
311290,202110,103,85,18,93500,19800,113300
311300,202110,583,369,214,405900,235400,641300
311310,202110,18,15,3,16500,3300,19800
311320,202110,634,467,167,513700,183700,697400
311330,202110,1097,796,301,875600,331100,1206700
311340,202110,2599,1835,764,2021800,841500,2863300
311350,202110,268,206,62,226600,68200,294800
311360,202110,173,103,70,113300,78100,191400
311370,202110,1225,506,719,557700,790900,1348600
311380,202110,7,6,1,6600,1100,7700
311390,202110,251,139,112,154000,123200,277200
311400,202110,139,83,56,91300,61600,152900
311410,202110,117,57,60,62700,66000,128700
311420,202110,308,163,145,180400,160600,341000
311430,202110,828,549,279,603900,306900,910800
311440,202110,455,313,142,344300,156200,500500
311450,202110,293,176,117,193600,128700,322300
311455,202110,269,184,85,203500,93500,297000
311460,202110,131,55,76,60500,83600,144100
311470,202110,31,15,16,16500,17600,34100
311480,202110,47,23,24,25300,26400,51700
311490,202110,10,6,4,6600,4400,11000
311500,202110,28,13,15,14300,16500,30800
311510,202110,655,443,212,489500,233200,722700
311520,202110,40,32,8,35200,8800,44000
311530,202110,1805,1299,506,1428900,556600,1985500
311535,202110,66,46,20,50600,22000,72600
311540,202110,34,29,5,31900,5500,37400
311545,202110,161,118,43,129800,47300,177100
311547,202110,43,33,10,36300,11000,47300
311550,202110,648,282,366,311300,404800,716100
311560,202110,43,26,17,28600,18700,47300
311570,202110,280,187,93,205700,102300,308000
311580,202110,390,235,155,258500,170500,429000
311590,202110,29,25,4,27500,4400,31900
311600,202110,98,78,20,85800,22000,107800
311610,202110,244,208,36,228800,39600,268400
311615,202110,122,98,24,107800,26400,134200
311620,202110,27,15,12,16500,13200,29700
311630,202110,90,77,13,84700,14300,99000
311640,202110,144,69,75,75900,82500,158400
311650,202110,126,85,41,93500,45100,138600
311660,202110,414,196,218,215600,239800,455400
311670,202110,139,91,48,101200,52800,154000
311680,202110,211,159,52,174900,57200,232100
311690,202110,14,11,3,12100,3300,15400
311700,202110,193,138,55,151800,60500,212300
311710,202110,184,126,58,138600,64900,203500
311720,202110,39,29,10,31900,11000,42900
311730,202110,556,381,175,420200,192500,612700
311740,202110,26,18,8,19800,8800,28600
311750,202110,724,485,239,533500.7,262900,796400.7
311760,202110,76,33,43,36300,47300,83600
311770,202110,380,178,202,195800,222200,418000
311780,202110,185,91,94,100100,103400,203500
311783,202110,88,81,7,89100,7700,96800
311787,202110,38,14,24,15400,26400,41800
311790,202110,269,115,154,126500,169400,295900
311800,202110,678,431,247,474100,271700,745800
311810,202110,49,39,10,42900,11000,53900
311820,202110,121,95,26,104500,28600,133100
311830,202110,1891,1141,750,1257300,827200,2084500
311840,202110,1014,558,456,613800,502700,1116500
311850,202110,15,11,4,12100,4400,16500
311860,202110,9613,4083,5530,4494600,6086300,10580900
311870,202110,109,58,51,63800,56100,119900
311880,202110,934,673,261,740300,287100,1027400
311890,202110,201,96,105,105509,115500,221009
311900,202110,64,26,38,28600,41800,70400
311910,202110,1358,838,520,922900,573100,1496000
311920,202110,227,153,74,168300,81400,249700
311930,202110,897,503,394,553300,433400,986700
311940,202110,2560,1348,1212,1483900,1337600,2821500
311950,202110,66,43,23,47300,25300,72600
311960,202110,63,44,19,48400,20900,69300
311970,202110,22,12,10,13200,11000,24200
311980,202110,43,33,10,36300,11000,47300
311990,202110,35,25,10,27500,11000,38500
311995,202110,49,30,19,33000,20900,53900
312000,202110,22,16,6,17600,6600,24200
312010,202110,72,56,16,61600,17600,79200
312015,202110,73,57,16,62700,17600,80300
312020,202110,132,91,41,100100,45100,145200
312030,202110,68,51,17,56100,18700,74800
312040,202110,79,48,31,52800,34100,86900
312050,202110,197,109,88,119900,96800,216700
312060,202110,23,14,9,15400,9900,25300
312070,202110,76,47,29,51700,31900,83600
312080,202110,535,241,294,265100,324500,589600
312083,202110,59,36,23,39600,25300,64900
312087,202110,97,73,24,80300,26400,106700
312090,202110,3263,1971,1292,2168100,1421200,3589300
312100,202110,143,99,44,108647,48400,157047
312110,202110,111,66,45,72600,49500,122100
312120,202110,125,91,34,100100.63,37400,137500.63
312125,202110,84,52,32,57200,35200,92400
312130,202110,135,88,47,97900,51700,149600
312140,202110,142,110,32,121000,35200,156200
312150,202110,41,32,9,35200,9900,45100
312160,202110,1488,966,522,1062699,574200,1636899
312170,202110,11,8,3,8800,3300,12100
312180,202110,110,70,40,77000,44000,121000
312190,202110,36,32,4,35200,4400,39600
312200,202110,740,635,105,699600,115500,815100
312210,202110,121,62,59,68200,64900,133100
312220,202110,130,98,32,107800,35200,143000
312230,202110,3687,1662,2025,1829300,2229700,4059000
312235,202110,152,101,51,111100,56100,167200
312240,202110,83,57,26,62700,28600,91300
312245,202110,193,132,61,145200,67100,212300
312247,202110,77,56,21,61600,23100,84700
312250,202110,165,80,85,88000,93500,181500
312260,202110,102,69,33,75900,36300,112200
312270,202110,133,79,54,88000,59400,147400
312280,202110,30,14,16,15400,17600,33000
312290,202110,134,91,43,100100,47300,147400
312300,202110,199,130,69,143000,75900,218900
312310,202110,58,52,6,57200,7700,64900
312320,202110,416,257,159,283800,174900,458700
312330,202110,89,75,14,82500,15400,97900
312340,202110,33,16,17,17600,18700,36300
312350,202110,14,8,6,8800,6600,15400
312352,202110,95,67,28,73700,30800,104500
312360,202110,559,235,324,258500,356400,614900
312370,202110,323,182,141,200200,155100,355300
312380,202110,145,95,50,104500,55000,159500
312385,202110,152,126,26,138600,28600,167200
312390,202110,300,192,108,211200,118800,330000
312400,202110,380,282,98,310200,107800,418000
312410,202110,1100,352,748,388300,823900,1212200
312420,202110,638,476,162,523600,179300,702900
312430,202110,883,635,248,698500.5,272800,971300.5
312440,202110,40,31,9,34100,9900,44000
312450,202110,191,120,71,132000,78100,210100
312460,202110,30,15,15,16500,16500,33000
312470,202110,43,28,15,30800,16500,47300
312480,202110,168,101,67,111100,73700,184800
312490,202110,286,192,94,211200,103400,314600
312500,202110,36,21,15,23100,16500,39600
312510,202110,532,195,337,214500,370700,585200
312520,202110,31,9,22,9900,24200,34100
312530,202110,38,28,10,30800,11000,41800
312540,202110,87,78,9,85800,9900,95700
312550,202110,38,30,8,33000,8800,41800
312560,202110,198,152,46,167200,51700,218900
312570,202110,445,261,184,288200,202400,490600
312580,202110,93,49,44,53900,48400,102300
312590,202110,227,181,46,199100,50600,249700
312595,202110,127,104,23,114400,25300,139700
312600,202110,70,33,37,36300,40700,77000
312610,202110,1541,798,743,877800,818400,1696200
312620,202110,225,161,64,177100,70400,247500
312630,202110,68,56,12,62700,13200,75900
312640,202110,41,11,30,12100,33000,45100
312650,202110,146,120,26,132370.7,28600,160970.7
312660,202110,100,70,30,77000.01,33000,110000.01
312670,202110,926,591,335,651200,368500,1019700
312675,202110,33,27,6,29700,6600,36300
312680,202110,67,40,27,44000,29700,73700
312690,202110,233,115,118,126500,129800,256300
312695,202110,24,20,4,22000,4400,26400
312700,202110,233,134,99,147400,108900,256300
312705,202110,80,64,16,70400,17600,88000
312707,202110,134,95,39,104500,42900,147400
312710,202110,1841,999,842,1098900.59,926200,2025100.59
312720,202110,50,27,23,29700,25300,55000
312730,202110,271,156,115,171600,127600,299200
312733,202110,48,36,12,39600,13200,52800
312735,202110,21,13,8,14300,8800,23100
312737,202110,69,38,31,41800,34100,75900
312738,202110,62,40,22,44000,24200,68200
312740,202110,81,55,26,60500,28600,89100
312750,202110,90,61,29,67100,31900,99000
312760,202110,276,193,83,213400,91300,304700
312770,202110,8311,3795,4516,4180000,4969800,9149800
312780,202110,443,340,103,374000,113300,487300
312790,202110,22,16,6,17600,6600,24200
312800,202110,1585,1099,486,1210000,534600,1744600
312810,202110,350,234,116,257400,127600,385000
312820,202110,185,141,44,155100,48400,203500
312825,202110,33,23,10,25300,11000,36300
312830,202110,202,116,86,127600,94600,222200
312840,202110,171,115,56,126500,61600,188100
312850,202110,42,37,5,40700,5500,46200
312860,202110,146,95,51,104500,56100,160600
312870,202110,1073,552,521,608300,573100,1181400
312880,202110,122,86,36,94600,39600,134200
312890,202110,157,111,46,122100,50600,172700
312900,202110,181,134,47,147400,51700,199100
312910,202110,178,99,79,110000,86900,196900
312920,202110,133,73,60,80300,66000,146300
312930,202110,320,220,100,242000,110000,352000
312940,202110,123,85,38,93500,41800,135300
312950,202110,685,464,221,514800,243100,757900
312960,202110,148,112,36,123200,39600,162800
312965,202110,104,80,24,88000,26400,114400
312970,202110,277,226,51,248600,56100,304700
312980,202110,2509,1253,1256,1379400,1382700,2762100
312990,202110,49,23,26,25300,28600,53900
313000,202110,52,30,22,33000,24200,57200
313005,202110,174,132,42,145200,46200,191400
313010,202110,938,385,553,423500.4,608300,1031800.4
313020,202110,197,99,98,108900,107800,216700
313030,202110,192,125,67,138600,73700,212300
313040,202110,81,23,58,25300,63800,89100
313050,202110,190,138,52,151800,58300,210100
313055,202110,40,31,9,34100,9900,44000
313060,202110,132,88,44,96800,48400,145200
313065,202110,62,45,17,49500,18700,68200
313070,202110,133,71,62,78100,68200,146300
313080,202110,37,17,20,18700,22000,40700
313090,202110,667,431,236,474100,260700,734800
313100,202110,196,68,128,74800,141900,216700
313110,202110,153,81,72,89100,79200,168300
313115,202110,220,121,99,133100,108900,242000
313120,202110,845,471,374,519200,411400,930600
313130,202110,5889,3195,2694,3517800,2964500,6482300
313140,202110,132,73,59,80300,64900,145200
313150,202110,293,232,61,255200,67100,322300
313160,202110,183,135,48,148500,52800,201300
313170,202110,1370,896,474,985600.05,522500,1508100.05
313180,202110,306,178,128,195800,140800,336600
313190,202110,720,422,298,465300,327800,793100
313200,202110,30,25,5,27500,5500,33000
313210,202110,995,844,151,928400,167200,1095600
313220,202110,287,171,116,189200,127600,316800
313230,202110,259,200,59,220000.5,64900,284900.5
313240,202110,2159,1080,1079,1189100,1186900,2376000
313250,202110,1247,946,301,1040600,331100,1371700
313260,202110,96,48,48,52800,52800,105600
313270,202110,991,569,422,625900,466400,1092300
313280,202110,45,38,7,41800,7700,49500
313290,202110,210,168,42,187000,46200,233200
313300,202110,327,164,163,181500,180400,361900
313310,202110,245,111,134,122100,147400,269500
313320,202110,381,277,104,304700,114400,419100
313330,202110,1416,860,556,947100,612700,1559800
313340,202110,329,235,94,258500,104500,363000
313350,202110,470,302,168,332200,184800,517000
313360,202110,166,76,90,83600,99000,182600
313370,202110,234,78,156,85800,171600,257400
313375,202110,298,173,125,190300,137500,327800
313380,202110,1333,702,631,772200,696300,1468500
313390,202110,45,43,2,47300,2200,49500
313400,202110,396,269,127,295900,139700,435600
313410,202110,33,15,18,16500,19800,36300
313420,202110,4534,2449,2085,2698300,2293500,4991800
313430,202110,133,65,68,71500,74800,146300
313440,202110,1368,955,413,1050501.13,455400,1505901.13
313450,202110,67,32,35,35200,39600,74800
313460,202110,383,162,221,179300,243100,422400
313470,202110,529,246,283,270600,311300,581900
313480,202110,143,105,38,115500,41800,157300
313490,202110,535,238,297,262900,326700,589600
313500,202110,30,17,13,18700,14300,33000
313505,202110,1058,820,238,902000,262900,1164900
313507,202110,93,57,36,62700,39600,102300
313510,202110,2871,1798,1073,1979016.9,1181400,3160416.9
313520,202110,3422,2665,757,2933701.5,832700,3766401.5
313530,202110,32,20,12,22000,13200,35200
313535,202110,66,53,13,58300,14300,72600
313540,202110,70,51,19,56100,20900,77000
313545,202110,112,96,16,105600,17600,123200
313550,202110,224,188,36,207900,39600,247500
313560,202110,343,161,182,177100,201300,378400
313570,202110,68,21,47,23100,51700,74800
313580,202110,1310,735,575,808500,632500,1441000
313590,202110,67,39,28,42900,30800,73700
313600,202110,675,400,275,440000,302500,742500
313610,202110,48,40,8,44000,8800,52800
313620,202110,1357,661,696,728200,767800,1496000
313630,202110,1611,1201,410,1322200,451000,1773200
313640,202110,118,70,48,77000,52800,129800
313650,202110,237,112,125,123200,137500,260700
313652,202110,23,22,1,24200,1100,25300
313655,202110,72,45,27,49500,29700,79200
313657,202110,45,41,4,45100,4400,49500
313660,202110,125,79,46,86900,50619.8,137519.8
313665,202110,658,300,358,331100,393800,724900
313670,202110,10274,6971,3303,7683500,3639900,11323400
313680,202110,43,33,10,36300,11000,47300
313690,202110,127,93,34,102300,37400,139700
313695,202110,77,58,19,63800,20900,84700
313700,202110,327,257,70,282700,77000,359700
313710,202110,131,96,35,105600,38500,144100
313720,202110,1140,522,618,574200,679800,1254000
313730,202110,71,41,30,45100,33000,78100
313740,202110,146,114,32,126500,35200,161700
313750,202110,412,292,120,321200,132000,453200
313753,202110,220,162,58,178200,63800,242000
313760,202110,1340,492,848,541200,933900,1475100
313770,202110,390,271,119,298100,130900,429000
313780,202110,802,416,386,457600,424600,882200
313790,202110,28,27,1,29700,1100,30800
313800,202110,149,88,61,96800,67100,163900
313810,202110,84,49,35,53900,38500,92400
313820,202110,1333,621,712,685300,783200,1468500
313830,202110,51,36,15,39600,16500,56100
313835,202110,58,48,10,52800,11000,63800
313840,202110,1646,966,680,1063700,749100,1812800
313850,202110,210,85,125,93500,137500,231000
313860,202110,460,351,109,386100,119900,506000
313862,202110,168,112,56,123200,61600,184800
313865,202110,146,99,47,108900,51700,160600
313867,202110,55,44,11,48400,12100,60500
313868,202110,40,24,16,26400,17600,44000
313870,202110,102,56,46,61600,50600,112200
313880,202110,377,231,146,254100,160600,414700
313890,202110,328,174,154,191400,169400,360800
313900,202110,827,443,384,487300.66,422400,909700.66
313910,202110,144,99,45,108900,49500,158400
313920,202110,625,435,190,478500,209000.94,687500.94
313925,202110,32,26,6,28600,6600,35200
313930,202110,864,665,199,731500,218900,950400
313940,202110,1870,1125,745,1237500,819500,2057000
313950,202110,839,516,323,568700,355300,924000
313960,202110,1430,816,614,897600,675400,1573000
313970,202110,182,112,70,123200,77000,200200
313980,202110,207,135,72,148500,79200,227700
313990,202110,243,155,88,171600,96800,268400
314000,202110,866,566,300,623700,331100,954800
314010,202110,87,49,38,53900,41800,95700
314015,202110,67,18,49,19800,53900,73700
314020,202110,54,35,19,38500,20900,59400
314030,202110,73,36,37,39600,40700,80300
314040,202110,45,24,21,26400,23100,49500
314050,202110,288,169,119,185900,130900,316800
314053,202110,103,65,38,71500,41800,113300
314055,202110,290,181,109,199100,119900,319000
314060,202110,125,108,17,118800.83,18700,137500.83
314070,202110,1045,519,526,570900,579700,1150600
314080,202110,210,130,80,143000,88000,231000
314085,202110,162,108,54,118800,59400,178200
314090,202110,380,267,113,293700,124300,418000
314100,202110,518,409,109,449900,119900,569800
314110,202110,769,357,412,392700,453200,845900
314120,202110,72,40,32,44000,35200,79200
314130,202110,22,14,8,15400,8800,24200
314140,202110,1105,681,424,750200,466400,1216600
314150,202110,195,126,69,138600,75900,214500
314160,202110,323,240,83,264000,91300,355300
314170,202110,83,62,21,68200,23100,91300
314180,202110,733,643,90,707300,99000,806300
314190,202110,91,55,36,60500,39600,100100
314200,202110,496,333,163,367400,179300,546700
314210,202110,251,190,61,210100,67100,277200
314220,202110,300,214,86,235400,94600,330000
314225,202110,57,38,19,42900,20900,63800
314230,202110,114,52,62,57200,68200,125400
314240,202110,163,117,46,128700,50600,179300
314250,202110,59,35,24,38500,26400,64900
314260,202110,223,109,114,119900,125400,245300
314270,202110,399,307,92,337700,101200,438900
314280,202110,727,385,342,424550.5,376200,800750.5
314290,202110,531,417,114,458700,125400,584100
314300,202110,340,254,86,279400,94600,374000
314310,202110,1330,908,422,1000175,465300,1465475
314315,202110,36,27,9,29700,9900,39600
314320,202110,577,382,195,420200,214500,634700
314330,202110,11395,5546,5849,6105000,6438300,12543300
314340,202110,603,265,338,292600,371800,664400
314345,202110,53,37,16,40700,17600,58300
314350,202110,175,110,65,121000,71500,192500
314360,202110,55,30,25,34100,27500,61600
314370,202110,71,48,23,52800,25300,78100
314380,202110,101,63,38,69300,41800,111100
314390,202110,3332,2136,1196,2351800,1315600,3667400
314400,202110,680,477,203,524700.61,223300,748000.61
314410,202110,489,311,178,344300,196900,541200
314420,202110,16,7,9,7700,9900,17600
314430,202110,2431,884,1547,972401.51,1705000,2677401.51
314435,202110,173,100,73,110000,80300,190300
314437,202110,29,19,10,20900,11000,31900
314440,202110,89,57,32,62700,35200,97900
314450,202110,163,109,54,119900,59400,179300
314460,202110,627,296,331,327800,365200,693000
314465,202110,95,58,37,63800,40700,104500
314467,202110,74,60,14,66000,15400,81400
314470,202110,397,199,198,218900,217800,436700
314480,202110,1019,455,564,501600,620400,1122000
314490,202110,42,24,18,26400,19800,46200
314500,202110,279,194,85,213400,93500,306900
314505,202110,105,65,40,71500,44000,115500
314510,202110,246,200,46,220000,50600,270600
314520,202110,1355,716,639,787600,702900,1490500
314530,202110,738,581,157,640200.7,172700,812900.7
314535,202110,166,101,65,111540,71500,183040
314537,202110,64,36,28,39600,30800,70400
314540,202110,18,12,6,13200,6600,19800
314545,202110,55,37,18,40700,19800,60500
314550,202110,69,36,33,39600,36300,75900
314560,202110,858,464,394,510400,434500,944900
314570,202110,20,15,5,16500,5500,22000
314580,202110,12,5,7,5500,7700,13200
314585,202110,25,18,7,19800,7700,27500
314587,202110,83,71,12,78100,13200,91300
314590,202110,562,388,174,427900,191400,619300
314600,202110,939,595,344,655600,378400,1034000
314610,202110,941,480,461,529100,507100,1036200
314620,202110,140,103,37,113300,40700,154000
314625,202110,98,72,26,79200,28600,107800
314630,202110,1131,596,535,656700,588500,1245200
314640,202110,84,54,30,59400,33000,92400
314650,202110,170,94,76,103400,83600,187000
314655,202110,62,45,17,49500,18700,68200
314660,202110,16,13,3,14300,3300,17600
314670,202110,205,158,47,173800,51700,225500
314675,202110,208,125,83,137500,91300,228800
314690,202110,564,298,266,328900,292600,621500
314700,202110,2235,1182,1053,1302400,1158300,2460700
314710,202110,1766,988,778,1086800,856900,1943700
314720,202110,386,217,169,239800,185900,425700
314730,202110,507,266,241,292600,265100,557700
314740,202110,748,350,398,385000,437800,822800
314750,202110,18,15,3,16500,3300,19800
314760,202110,362,158,204,173800,225500,399300
314770,202110,105,70,35,77000,38500,115500
314780,202110,22,9,13,9900,14300,24200
314790,202110,2437,1525,912,1679700,1003200,2682900
314795,202110,57,49,8,53900,8800,62700
314800,202110,2897,1659,1238,1827100.76,1364000,3191100.76
314810,202110,1460,833,627,916300,690800,1607100
314820,202110,110,63,47,69300,51700,121000
314830,202110,206,168,38,185900,41800,227700
314840,202110,87,49,38,53900,41800,95700
314850,202110,404,190,214,209000,235400,444400
314860,202110,658,507,151,557700,166100,723800
314870,202110,1566,799,767,880000,843700,1723700
314875,202110,51,45,6,49500,6600,56100
314880,202110,43,31,12,34100,13200,47300
314890,202110,49,26,23,28600,25300,53900
314900,202110,27,21,6,23100,6600,29700
314910,202110,233,153,80,169400,88000,257400
314915,202110,136,119,17,130900,18700,149600
314920,202110,90,58,32,63800,35200,99000
314930,202110,1017,481,536,529100,590700,1119800
314940,202110,41,32,9,35200,9900,45100
314950,202110,20,16,4,17600,4400,22000
314960,202110,24,17,7,18700,7700,26400
314970,202110,164,79,85,86900,93500,180400
314980,202110,303,190,113,210100,124300,334400
314990,202110,441,240,201,264000.93,221100,485100.93
314995,202110,151,64,87,70400,95700,166100
315000,202110,83,64,19,70400,20900,91300
315010,202110,34,21,13,23100,14300,37400
315015,202110,159,125,34,137500,37400,174900
315020,202110,69,58,11,63800,12100,75900
315030,202110,108,82,26,90200,28600,118800
315040,202110,77,49,28,53900,30800,84700
315050,202110,200,121,79,133100,86900,220000
315053,202110,48,34,14,37400,15400,52800
315057,202110,114,90,24,99000,26400,125400
315060,202110,69,56,13,61600,14300,75900
315070,202110,103,57,46,62700,50600,113300
315080,202110,375,296,79,325600,86900,412500
315090,202110,97,58,39,63800,42900,106700
315100,202110,80,39,41,42900,45100,88000
315110,202110,271,137,134,150700,147400,298100
315120,202110,1792,853,939,940500,1034000,1974500
315130,202110,335,241,94,265100,103400,368500
315140,202110,534,291,243,320100,267300,587400
315150,202110,975,465,510,511500,561000,1072500
315160,202110,197,100,97,110000,106700,216700
315170,202110,304,203,101,225500,111100,336600
315180,202110,3219,1338,1881,1474000,2072400,3546400
315190,202110,297,179,118,196900,129800,326700
315200,202110,1194,711,483,782100,532400,1314500
315210,202110,1630,933,697,1028500.11,766700,1795200.11
315213,202110,28,16,12,17600,13200,30800
315217,202110,200,156,44,171600,48400,220000
315220,202110,1589,1183,406,1303500,447700.02,1751200.02
315230,202110,173,129,44,141900,48400,190300
315240,202110,394,253,141,278300,155100,433400
315250,202110,2561,1233,1328,1359600,1461900,2821500
315260,202110,131,71,60,78100,67100,145200
315270,202110,133,91,42,100100,46200,146300
315280,202110,626,414,212,455400,233200,688600
315290,202110,184,114,70,125400,78100,203500
315300,202110,82,61,21,67100,23100,90200
315310,202110,82,73,9,80300,9900,90200
315320,202110,148,88,60,96800,66000,162800
315330,202110,57,45,12,49500,13200,62700
315340,202110,387,282,105,310200,115500,425700
315350,202110,152,94,58,103400,63800,167200
315360,202110,91,40,51,44000,56100,100100
315370,202110,54,34,20,37400,22000,59400
315380,202110,5,5,0,5500,,5500.0
315390,202110,62,19,43,20900,47300,68200
315400,202110,785,579,206,636900.36,226600,863500.36
315410,202110,313,182,131,200200,144100,344300
315415,202110,57,42,15,46200,16500,62700
315420,202110,191,139,52,154000,57200,211200
315430,202110,646,366,280,402600,308000,710600
315440,202110,91,61,30,67100,33000,100100
315445,202110,219,182,37,200200,40700,240900
315450,202110,180,131,49,144100,53900,198000
315460,202110,4254,1972,2282,2174700,2512400,4687100
315470,202110,41,16,25,17600,27500,45100
315480,202110,73,21,52,23100,57200,80300
315490,202110,700,429,271,473000,299200,772200
315500,202110,19,14,5,15400,5500,20900
315510,202110,144,98,46,107800,50600,158400
315520,202110,76,65,11,71500,12100,83600
315530,202110,41,22,19,24200,20900,45100
315540,202110,260,184,76,202400,83600,286000
315550,202110,177,142,35,156200,38500,194700
315560,202110,721,571,150,629200,165000,794200
315570,202110,308,149,159,163900,174900,338800
315580,202110,733,496,237,545600,260700,806300
315590,202110,193,100,93,110000,102300,212300
315600,202110,313,240,73,265100,80300,345400
315610,202110,102,47,55,51700,60500,112200
315620,202110,34,26,8,28600,8800,37400
315630,202110,123,87,36,95700,39600,135300
315640,202110,66,40,26,44000,28600,72600
315645,202110,47,32,15,35200,16500,51700
315650,202110,170,124,46,136400,50600,187000
315660,202110,456,198,258,217800,283800,501600
315670,202110,2370,1102,1268,1213300.83,1399200,2612500.83
315680,202110,803,569,234,627000,257400,884400
315690,202110,670,450,220,495000,242000,737000
315700,202110,1957,1013,944,1115400.28,1038400,2153800.28
315710,202110,359,111,248,122100,272800,394900
315720,202110,476,286,190,314600,209000,523600
315725,202110,191,153,38,170500,41800,212300
315727,202110,55,28,27,30800,29700,60500
315730,202110,48,42,6,46200,6600,52800
315733,202110,87,55,32,60500,35200,95700
315737,202110,49,37,12,40700,13200,53900
315740,202110,33,25,8,27500,8800,36300
315750,202110,150,111,39,122100,42900,165000
315760,202110,39,30,9,33000,9900,42900
315765,202110,124,72,52,79200,57200,136400
315770,202110,215,133,82,146300.5,90200,236500.5
315780,202110,3696,1816,1880,1999800,2068000,4067800
315790,202110,237,181,56,199100,61600,260700
315800,202110,302,199,103,218900,113300,332200
315810,202110,91,56,35,61600,38500,100100
315820,202110,746,544,202,598400,222200,820600
315830,202110,114,73,41,80300,45100,125400
315840,202110,79,52,27,57200,29700,86900
315850,202110,260,179,81,196900.07,89100,286000.07
315860,202110,15,5,10,5500,11000,16500
315870,202110,40,31,9,34100,9900,44000
315880,202110,94,65,29,71500,31900,103400
315890,202110,101,74,27,81400,29700,111100
315895,202110,412,271,141,298100,155100,453200
315900,202110,72,34,38,37400,41800,79200
315910,202110,42,24,18,26400,19800,46200
315920,202110,153,101,52,111100,57200,168300
315930,202110,54,17,37,18700,40700,59400
315935,202110,125,100,25,110000,27500,137500
315940,202110,96,70,26,78100,28600,106700
315950,202110,37,29,8,31900,8800,40700
315960,202110,539,253,286,278300,314600,592900
315970,202110,33,26,7,28600,7700,36300
315980,202110,673,332,341,365200,375100,740300
315990,202110,260,149,111,163900,122100,286000
316000,202110,46,31,15,34100,16500,50600
316010,202110,79,66,13,72600,14300,86900
316020,202110,113,97,16,106700,17600,124300
316030,202110,377,208,169,229900,187000,416900
316040,202110,540,217,323,238700,355300,594000
316045,202110,51,46,5,50600,5500,56100
316050,202110,21,16,5,17600,5500,23100
316060,202110,98,66,32,72600,35200,107800
316070,202110,1098,723,375,795300,412500,1207800
316080,202110,91,58,33,63896.8,36300,100196.8
316090,202110,39,19,20,20900,22000,42900
316095,202110,87,72,15,79200,16500,95700
316100,202110,317,176,141,193600,155100,348700
316105,202110,43,25,18,27500.52,19800,47300.52
316110,202110,1871,1451,420,1596100.5,462000,2058100.5
316120,202110,79,51,28,56100,30800,86900
316130,202110,114,85,29,93500,31900,125400
316140,202110,35,24,11,26400,12100,38500
316150,202110,214,147,67,161700,73700,235400
316160,202110,82,46,36,50600,39600,90200
316165,202110,64,45,19,50600,20900,71500
316170,202110,187,120,67,132000,73700,205700
316180,202110,212,86,126,94600,138600,233200
316190,202110,137,98,39,107800,42900,150700
316200,202110,657,354,303,389400,333300,722700
316210,202110,768,508,260,560089.2,286000,846089.2
316220,202110,115,72,43,80300,47300,127600
316225,202110,35,20,15,22000,16500,38500
316230,202110,39,19,20,20900,22000,42900
316240,202110,664,529,135,583000,148500,731500
316245,202110,142,123,19,135300,20900,156200
316250,202110,1584,1072,512,1179200.53,563200,1742400.53
316255,202110,135,108,27,118800,29700,148500
316257,202110,172,87,85,95700,93500,189200
316260,202110,186,130,56,143000,61600,204600
316265,202110,29,20,9,22000,9900,31900
316270,202110,677,477,200,524700,221100,745800
316280,202110,538,330,208,363000.63,228800,591800.63
316290,202110,793,532,261,587400,287100,874500
316292,202110,548,217,331,238700,364100,602800
316294,202110,104,68,36,74800,39600,114400
316295,202110,328,140,188,154000,206800,360800
316300,202110,110,73,37,80300,40700,121000
316310,202110,27,14,13,15400,14300,29700
316320,202110,53,28,25,30800,27500,58300
316330,202110,167,115,52,126500,57200,183700
316340,202110,132,87,45,95700,49500,145200
316350,202110,190,132,58,145200.5,63800,209000.5
316360,202110,26,14,12,15400,13200,28600
316370,202110,1164,573,591,630300,650100,1280400
316380,202110,110,84,26,92400,28600,121000
316390,202110,103,73,30,80300,33000,113300
316400,202110,138,104,34,114400,37400,151800
316410,202110,305,221,84,243100,92400,335500
316420,202110,215,143,72,157300,79200,236500
316430,202110,155,81,74,89100,81400,170500
316440,202110,79,40,39,44000,42900,86900
316443,202110,42,38,4,41800,4400,46200
316447,202110,44,33,11,36300,12100,48400
316450,202110,227,174,53,191400,58300,249700
316460,202110,85,33,52,36300,57200,93500
316470,202110,1651,1197,454,1318889.65,499400,1818289.65
316480,202110,11,8,3,8800,3300,12100
316490,202110,19,6,13,6600,14300,20900
316500,202110,158,103,55,113300,60500,173800
316510,202110,149,116,33,127600,36300,163900
316520,202110,195,113,82,124300,90200,214500
316530,202110,164,104,60,114400,66000,180400
316540,202110,150,76,74,83600,81400,165000
316550,202110,139,85,54,93500,59400,152900
316553,202110,351,155,196,170500,215600.72,386100.72
316555,202110,49,43,6,47300,6600,53900
316556,202110,13,9,4,9900,4400,14300
316557,202110,26,21,5,23100,5500,28600
316560,202110,70,50,20,55000,22000,77000
316570,202110,209,190,19,209000,20900,229900
316580,202110,22,16,6,17600,6600,24200
316590,202110,95,80,15,88000,16500,104500
316600,202110,178,148,30,162800,33000,195800
316610,202110,68,52,16,57200,17600,74800
316620,202110,144,103,41,113300,45100,158400
316630,202110,42,32,10,35200,11000,46200
316640,202110,21,14,7,15400,7700,23100
316650,202110,87,70,17,77000,18700,95700
316660,202110,7,2,5,2200,5500,7700
316670,202110,438,149,289,163900,319000,482900
316680,202110,168,125,43,137500,47300,184800
316690,202110,167,98,69,107800,75900,183700
316695,202110,59,49,10,53900,11000,64900
316700,202110,17,12,5,13200,5500,18700
316710,202110,756,568,188,625900,206800,832700
316720,202110,5038,2394,2644,2636700,2908400,5545100
316730,202110,15,15,0,16500,,16500.0
316740,202110,148,93,55,102300,60500,162800
316750,202110,22,14,8,15400,8800,24200
316760,202110,309,250,59,275000,64900,339900
316770,202110,171,90,81,99000,89100,188100
316780,202110,70,43,27,47300,29700,77000
316790,202110,56,39,17,42900,18700,61600
316800,202110,1780,1083,697,1191300,767800,1959100
316805,202110,23,17,6,18700,6600,25300
316810,202110,64,40,24,44000,26400,70400
316820,202110,38,21,17,23100,18700,41800
316830,202110,96,44,52,48400,57200,105600
316840,202110,512,297,215,326700,236500,563200
316850,202110,312,209,103,231000,113300,344300
316860,202110,6001,2653,3348,2918300,3685000,6603300
316870,202110,1589,1011,578,1113200,636900,1750100
316880,202110,146,72,74,79200,81400,160600
316890,202110,234,160,74,176000,81400,257400
316900,202110,404,279,125,308000,137500,445500
316905,202110,20,9,11,9900,12100,22000
316910,202110,65,27,38,29700,41800,71500
316920,202110,137,106,31,116600,34100,150700
316930,202110,1901,941,960,1037300,1056000,2093300
316935,202110,908,535,373,588500,410300,998800
316940,202110,1078,605,473,666600,520300,1186900
316950,202110,176,84,92,92400,101200,193600
316960,202110,1089,593,496,652300,545600,1197900
316970,202110,627,493,134,542300,147400,689700
316980,202110,73,39,34,42900,37400,80300
316990,202110,2172,1461,711,1607100,786500.84,2393600.84
317000,202110,326,249,77,273900,84700,358600
317005,202110,223,159,64,174900,70400,245300
317010,202110,6445,3576,2869,3941300,3158100,7099400
317020,202110,15598,6795,8803,7493200,9695400,17188600
317030,202110,81,31,50,34100,55000,89100
317040,202110,3011,1899,1112,2091100.1,1225400,3316500.1
317043,202110,69,53,16,58300,17600,75900
317047,202110,39,21,18,23100,19800,42900
317050,202110,146,111,35,123200,39600,162800
317052,202110,142,111,31,122100,34100,156200
317057,202110,172,131,41,144100,46200,190300
317060,202110,57,34,23,37400,25300,62700
317065,202110,50,37,13,40700,14300,55000
317070,202110,1925,873,1052,962500,1159400,2121900
317075,202110,92,51,41,56100,45100,101200
317080,202110,915,466,449,512600,493900,1006500
317090,202110,689,537,152,590700,167200,757900
317100,202110,413,309,104,339900,114400,454300
317103,202110,113,91,22,100100,24200,124300
317107,202110,47,40,7,44000,7700,51700
317110,202110,99,49,50,53900,55000,108900
317115,202110,41,37,4,40700,4400,45100
317120,202110,1968,924,1044,1017500,1148400,2165900
317130,202110,1980,1315,665,1448700,732600,2181300
317140,202110,13,9,4,9900,4400,14300
317150,202110,283,169,114,185900,125400,311300
317160,202110,332,248,84,272800.63,92400,365200.63
317170,202110,235,159,76,174900,83600,258500
317180,202110,430,291,139,320100,152900,473000
317190,202110,259,188,71,206800,78100,284900
317200,202110,800,556,244,614900,268400,883300
317210,202110,179,94,85,103400,93500,196900
317220,202110,23,11,12,13200,13200,26400
320010,202110,563,403,160,444400,177100,621500
320013,202110,122,83,39,91300,42900,134200
320016,202110,260,164,96,180400,105600,286000
320020,202110,716,412,304,454300.8,335500,789800.8
320030,202110,163,111,52,122100.04,57200.08,179300.12
320035,202110,138,97,41,106700,45100,151800
320040,202110,496,253,243,278300,267300,545600
320050,202110,118,80,38,88000,41800,129800
320060,202110,1736,823,913,906400,1004300,1910700
320070,202110,98,60,38,66000,42900,108900
320080,202110,798,453,345,498300,379500,877800
320090,202110,1256,823,433,906400,476300,1382700
320100,202110,333,189,144,207900,158400,366300
320110,202110,119,74,45,81400,49500,130900
320115,202110,112,91,21,100100,23100,123200
320120,202110,3633,1887,1746,2082300,1921701.08,4004001.08
320130,202110,7736,3404,4332,3751000.5,4771800,8522800.5
320140,202110,444,282,162,310200,178200.81,488400.81
320150,202110,2099,1156,943,1273800,1038400,2312200
320160,202110,647,282,365,310200,402600,712800
320170,202110,110,85,25,93500.1,27500.02,121000.12
320180,202110,54,33,21,36300,23100,59400
320190,202110,238,151,87,166100,95700,261800
320200,202110,62,48,14,52800,15400,68200
320210,202110,892,477,415,524700,456500,981200
320220,202110,303,107,196,117700,216700,334400
320225,202110,80,63,17,69300,18700,88000
320230,202110,671,427,244,469700,268400,738100
320240,202110,3484,1616,1868,1779800,2059200,3839000
320245,202110,492,331,161,364100,177100,541200
320250,202110,232,110,122,121000,134200,255200
320255,202110,130,100,30,110000,33000,143000
320260,202110,241,137,104,151800.2,114400.12,266200.32
320265,202110,146,113,33,124300,36300,160600
320270,202110,152,117,35,128700,38500,167200
320280,202110,1181,665,516,732600.5,567600.02,1300200.52
320290,202110,60,49,11,53900,12100,66000
320300,202110,605,409,196,451000.02,215600,666600.02
320305,202110,713,376,337,413600,371800,785400
320310,202110,196,112,84,123200,92400,215600
320313,202110,340,157,183,172700,201300,374000
320316,202110,107,80,27,88000,29700,117700
320320,202110,3435,1514,1921,1666500,2114200,3780700
320330,202110,265,194,71,213400.87,78100,291500.87
320332,202110,775,456,319,501600,350900,852500
320334,202110,272,151,121,166100.02,133100,299200.02
320335,202110,143,89,54,97900,59400,157300
320340,202110,564,395,169,434500,185900,620400
320350,202110,1046,425,621,468600.5,685300,1153900.5
320360,202110,167,83,84,91300,92400,183700
320370,202110,231,171,60,188100,66000,254100
320380,202110,287,199,88,220000,96800,316800
320390,202110,1156,678,478,746900,525800,1272700
320400,202110,322,228,94,250800,103400,354200
320405,202110,954,393,561,432300,619300,1051600
320410,202110,961,480,481,528000,530200,1058200
320420,202110,530,252,278,277200,305800,583000
320425,202110,191,106,85,117700,93500,211200
320430,202110,375,197,178,216700,195800,412500
320435,202110,164,109,55,119900,60500,180400
320440,202110,203,113,90,124300.24,99000.2,223300.44
320450,202110,132,72,60,79200,66000,145200
320455,202110,240,191,49,210100,53900,264000
320460,202110,282,177,105,194700,115500,310200
320465,202110,112,74,38,82500,41800,124300
320470,202110,707,426,281,469700,309100,778800
320480,202110,198,128,70,140800,77000,217800
320490,202110,3189,1502,1687,1654400.75,1856800.71,3511201.46
320495,202110,116,68,48,74800,52800,127600
320500,202110,9749,4718,5031,5196400,5540700,10737100
320501,202110,549,273,276,300300,303600,603900
320503,202110,294,205,89,226600.08,97900.02,324500.10
320506,202110,256,179,77,196900,84700,281600
320510,202110,1128,494,634,543400,700700,1244100
320515,202110,79,60,19,66000,20900,86900
320517,202110,218,155,63,170500,69300,239800
320520,202110,7347,3066,4281,3380300.75,4710200,8090500.75
320530,202110,6603,3159,3444,3481481.5,3793900.63,7275382.13
330010,202110,3207,1587,1620,1749000,1784200,3533200
330015,202110,196,81,115,89100,127600,216700
330020,202110,3840,1528,2312,1683000,2546500,4229500
330022,202110,269,134,135,147400,148500,295900
330023,202110,694,204,490,224400,541200,765600
330025,202110,631,114,517,125400,568700,694100
330030,202110,1835,1134,701,1248500,772200,2020700
330040,202110,2521,1268,1253,1395900,1379400.5,2775300.5
330045,202110,9689,2788,6901,3072300.5,7606500,10678800.5
330050,202110,859,541,318,595100,349800,944900
330060,202110,1075,629,446,691900,490600,1182500
330070,202110,4095,1398,2697,1537800,2968900,4506700
330080,202110,1595,687,908,755700,999900,1755600
330090,202110,391,220,171,242000,188100,430100
330093,202110,253,108,145,118800,159500,278300
330095,202110,69,42,27,46200,29700,75900
330100,202110,10257,5028,5229,5537400.5,5756300,11293700.5
330110,202110,469,200,269,220000,295900,515900
330115,202110,519,264,255,290400,280500,570900
330120,202110,393,199,194,218900,213400,432300
330130,202110,1606,399,1207,438900,1328800,1767700
330140,202110,635,326,309,359700,339900,699600
330150,202110,514,292,222,321200,244200,565400
330160,202110,209,120,89,132000,97900,229900
330170,202110,27301,9041,18260,9956100,20106900,30063000
330180,202110,239,125,114,137500,126500,264000
330185,202110,1045,361,684,399300,753500,1152800
330187,202110,469,135,334,148500,367400,515900
330190,202110,6145,2223,3922,2449700,4317500,6767200
330200,202110,4699,1395,3304,1535600.86,3637700,5173300.86
330205,202110,446,246,200,271700,220000,491700
330210,202110,941,562,379,619300,416900,1036200
330220,202110,2706,1571,1135,1729200,1248500,2977700
330225,202110,567,285,282,313500,310200,623700
330227,202110,2422,722,1700,794200,1871100,2665300
330230,202110,266,142,124,156200,137500,293700
330240,202110,4059,1935,2124,2129600,2340800,4470400
330245,202110,152,63,89,69300,97900,167200
330250,202110,6766,3268,3498,3600300,3850000,7450300
330260,202110,686,176,510,193600,561000,754600
330270,202110,3802,1201,2601,1321100,2866600,4187700
330280,202110,449,272,177,299200,194700,493900
330285,202110,6889,2086,4803,2297900,5293200,7591100
330290,202110,690,242,448,266200,492800,759000
330300,202110,747,472,275,519875.4,302500,822375.4
330310,202110,446,243,203,267300,223300,490600
330320,202110,8023,2812,5211,3098700,5736597.9,8835297.9
330330,202110,9403,3444,5959,3790600.02,6567000,10357600.02
330340,202110,2683,1516,1167,1669800,1285900,2955700
330350,202110,19341,6980,12361,7685700,13609200.5,21294900.5
330360,202110,2120,987,1133,1085700,1248500,2334200
330370,202110,987,489,498,537900,547800,1085700
330380,202110,926,377,549,415800.01,603900.01,1019700.02
330385,202110,627,312,315,343200,347600,690800
330390,202110,5880,2997,2883,3301100,3177900,6479000
330395,202110,336,202,134,222200,147400,369600
330400,202110,708,351,357,388300,392700,781000
330410,202110,508,362,146,398200,160600,558800
330411,202110,272,135,137,150700,151800,302500
330412,202110,222,91,131,100100,144100,244200
330414,202110,5374,2096,3278,2305600,3606900,5912500
330415,202110,608,262,346,288200,381700,669900
330420,202110,2300,1157,1143,1273800,1258400,2532200
330430,202110,1787,761,1026,839300,1129700,1969000
330440,202110,334,157,177,172700,194700,367400
330450,202110,113,49,64,53900,70400,124300
330452,202110,2271,957,1314,1056000,1446500.16,2502500.16
330455,202110,119054,39899,79155,43919866.02,87160703.24,131080569.26
330460,202110,253,110,143,121000,157300,278300
330470,202110,1236,664,572,730400,629200,1359600
330475,202110,1711,470,1241,517000,1365100,1882100
330480,202110,826,446,380,491700,418000,909700
330490,202110,15644,4786,10858,5268005,11952600,17220605
330500,202110,1472,626,846,688600,930600,1619200
330510,202110,11092,3696,7396,4067800.87,8147700,12215500.87
330513,202110,98,49,49,53900,53900,107800
330515,202110,741,306,435,337700,478500,816200
330520,202110,2531,858,1673,946000,1842500,2788500
330530,202110,195,108,87,118800,95700,214500
330540,202110,336,169,167,185900,183700,369600
330550,202110,2844,949,1895,1045000,2088900,3133900
330555,202110,817,307,510,337700,561000,898700
330560,202110,717,233,484,256300,532400,788700
330570,202110,286,198,88,218900,96800,315700
330575,202110,802,281,521,310200,574200,884400
330580,202110,3367,1820,1547,2003100,1702800,3705900
330590,202110,266,136,130,149600.5,143000,292600.5
330600,202110,1265,756,509,833800,559900,1393700
330610,202110,1621,843,778,927300,855800,1783100
330615,202110,216,173,43,190300,47300,237600
330620,202110,1051,397,654,437800,720500,1158300
330630,202110,4284,2562,1722,2822601.07,1894200,4716801.07
350010,202110,584,383,201,422400.88,221100,643500.88
350020,202110,54,18,36,20900,39600,60500
350030,202110,524,326,198,359700,217800,577500
350040,202110,125,51,74,56100.8,81400,137500.8
350050,202110,339,172,167,189200,184800,374000
350055,202110,114,52,62,57200,68200,125400
350060,202110,85,32,53,35200,58300,93500
350070,202110,775,446,329,491700.2,365200,856900.2
350075,202110,73,47,26,51700,28600,80300
350080,202110,59,27,32,29700,35200,64900
350090,202110,83,47,36,51700,39600,91300
350100,202110,269,167,102,183700,112200,295900
350110,202110,48,32,16,35200,17600,52800
350115,202110,156,90,66,99000,72600,171600
350120,202110,104,66,38,72600,41800,114400
350130,202110,375,157,218,172700.56,239800,412500.56
350140,202110,40,25,15,28600,16500,45100
350150,202110,74,54,20,59400,22000,81400
350160,202110,2381,935,1446,1028500,1591700,2620200
350170,202110,389,221,168,243100,184800,427900
350180,202110,163,94,69,104500,75900,180400
350190,202110,1014,536,478,592900.63,528000.93,1120901.56
350200,202110,63,23,40,25300,44000,69300
350210,202110,1296,707,589,778800,647900.63,1426700.63
350220,202110,639,523,116,575300.63,127600,702900.63
350230,202110,76,51,25,56100,27500,83600
350240,202110,57,37,20,40700,22000,62700
350250,202110,1151,525,626,578600,688600,1267200
350260,202110,98,69,29,75900,31900,107800
350270,202110,921,611,310,672100,341000,1013100
350275,202110,301,116,185,127600,204600,332200
350280,202110,4454,2176,2278,2395800,2505800,4901600
350290,202110,466,203,263,223300,289300,512600
350300,202110,52,26,26,28600,28600,57200
350310,202110,77,49,28,55000,30800,85800
350315,202110,64,27,37,29700,40700,70400
350320,202110,3326,1587,1739,1745700,1914000,3659700
350330,202110,1672,867,805,953701.66,886600,1840301.66
350335,202110,16,10,6,11000,6600,17600
350340,202110,122,51,71,57200,78100,135300
350350,202110,102,51,51,56100,56100,112200
350360,202110,105,69,36,75900,39600,115500
350370,202110,79,42,37,46200.63,40700,86900.63
350380,202110,778,325,453,357500,498300,855800
350390,202110,1692,604,1088,664400.5,1197900,1862300.5
350395,202110,20,16,4,17600,4400,22000
350400,202110,1679,811,868,892101.89,959200.63,1851302.52
350410,202110,2888,1206,1682,1326600,1851300.63,3177900.63
350420,202110,256,149,107,163900,117700,281600
350430,202110,82,44,38,48400,41800,90200
350440,202110,150,107,43,117700,47300,165000
350450,202110,1708,961,747,1057100.63,821700,1878800.63
350460,202110,396,137,259,150700,286000,436700
350470,202110,21,13,8,14300,8800,23100
350480,202110,190,101,89,111100,99000,210100
350490,202110,243,115,128,126500,140800,267300
350500,202110,57,26,31,28600,34100,62700
350510,202110,154,94,60,103400,66000,169400
350520,202110,433,223,210,245300,232100,477400
350530,202110,447,209,238,229900,261800,491700
350535,202110,85,61,24,67100,26400,93500
350540,202110,362,190,172,209000,189200,398200
350550,202110,2694,1521,1173,1674200,1291401.26,2965601.26
350560,202110,584,395,189,434500,207900,642400
350570,202110,4342,1753,2589,1933800.63,2849001.27,4782801.90
350580,202110,351,172,179,190300,196900,387200
350590,202110,938,505,433,555500,476300.16,1031800.16
350600,202110,6177,2880,3297,3174600.87,3631100,6805700.87
350610,202110,1487,762,725,838200,797500,1635700
350620,202110,25,15,10,16500,11000,27500
350630,202110,245,123,122,135300,134200,269500
350635,202110,1047,407,640,447700,705100,1152800
350640,202110,115,87,28,95700,30800,126500
350650,202110,1861,1225,636,1347500,699600,2047100
350660,202110,749,300,449,330000,493900,823900
350670,202110,295,143,152,157300,167200,324500
350680,202110,169,86,83,94600,91300,185900
350690,202110,195,88,107,96800,117700,214500
350700,202110,830,385,445,423500,489500,913000
350710,202110,396,145,251,159500,276100,435600
350715,202110,55,43,12,47300,13200,60500
350720,202110,16,10,6,11000,6600,17600
350730,202110,43,25,18,27500,19800,47300
350740,202110,233,127,106,139700,116600,256300
350745,202110,27,11,16,12100,17600,29700
350750,202110,2295,1355,940,1491600.93,1034000,2525600.93
350760,202110,3740,1535,2205,1688500,2425500,4114000
350770,202110,57,39,18,42900,19800,62700
350775,202110,46,33,13,36300,14300,50600
350780,202110,424,217,207,238700,227700,466400
350790,202110,362,148,214,162800,235400,398200
350800,202110,502,295,207,324500.58,227700,552200.58
350810,202110,503,394,109,435600,121000,556600
350820,202110,90,51,39,56100,42900,99000
350830,202110,73,39,34,42900,37400,80300
350840,202110,775,308,467,338800,513700,852500
350850,202110,1818,954,864,1052700,950400,2003100
350860,202110,636,335,301,369600,331100,700700
350870,202110,432,284,148,313500,163900,477400
350880,202110,263,150,113,166100,124300,290400
350890,202110,38,23,15,25300,16500,41800
350900,202110,1565,467,1098,513700,1208900.63,1722600.63
350910,202110,23,13,10,14300,11000,25300
350920,202110,718,370,348,409200,383900,793100
350925,202110,1128,590,538,650100,592900.63,1243000.63
350930,202110,105,55,50,60500,55000,115500
350940,202110,729,383,346,421300,380600,801900
350945,202110,109,79,30,86900,33000,119900
350950,202110,16828,7628,9200,8405101.88,10134300,18539401.88
350960,202110,1515,605,910,666600,1001000,1667600
350970,202110,1067,542,525,596081.2,578600,1174681.2
350980,202110,97,64,33,70400,36300,106700
350990,202110,370,132,238,145200,265100,410300
350995,202110,38,18,20,19800,22000,41800
351000,202110,607,403,204,443300.63,224400,667700.63
351010,202110,53,32,21,35200,23100,58300
351015,202110,47,32,15,35200,16500,51700
351020,202110,1495,881,614,970200,676500,1646700
351030,202110,346,206,140,226600,154000,380600
351040,202110,947,472,475,520300,524700.2,1045000.2
351050,202110,3399,1506,1893,1657700,2083400,3741100
351060,202110,5642,2038,3604,2242900.85,3966600,6209500.85
351070,202110,392,245,147,269500,161700,431200
351080,202110,701,503,198,553300,217800,771100
351090,202110,47,21,26,23100,28600,51700
351100,202110,424,231,193,254100,212300,466400
351110,202110,2036,943,1093,1038400.5,1203400,2241800.5
351120,202110,66,34,32,37400,35200,72600
351130,202110,186,61,125,67100,137500,204600
351140,202110,312,191,121,210100,133100,343200
351150,202110,466,241,225,265100,248600,513700
351160,202110,274,166,108,182600.8,118800,301400.8
351170,202110,201,103,98,113300,107800,221100
351190,202110,86,55,31,60500,34100,94600
351200,202110,349,221,128,243100,140800,383900
351210,202110,116,58,58,63800,63800,127600
351220,202110,539,316,223,347600,245300,592900
351230,202110,279,187,92,205700,101200,306900
351240,202110,236,112,124,123200,136400,259600
351250,202110,83,53,30,58300.5,33000,91300.5
351260,202110,148,106,42,116600,46200,162800
351270,202110,49,20,29,22000,31900,53900
351280,202110,1033,475,558,522500.63,613800.63,1136301.26
351290,202110,242,110,132,121000,145200,266200
351300,202110,3826,1650,2176,1817113.1,2396900,4214013.1
351310,202110,738,357,381,392700,419100,811800
351320,202110,115,66,49,72600,53900,126500
351330,202110,37,23,14,25300,15400,40700
351340,202110,1310,734,576,807400,633600,1441000
351350,202110,2360,1345,1015,1482800.04,1116500,2599300.04
351360,202110,777,369,408,408100,448800,856900
351370,202110,382,184,198,203500,217800,421300
351380,202110,8829,3827,5002,4211900,5512100.63,9724000.63
351385,202110,28,17,11,18700,12100,30800
351390,202110,280,211,69,232100,75900,308000
351400,202110,67,45,22,49500,24200,73700
351410,202110,435,270,165,297000.55,181500,478500.55
351420,202110,67,47,20,51700,22000,73700
351430,202110,73,39,34,42900,37400,80300
351440,202110,754,505,249,556601.26,275000,831601.26
351450,202110,265,123,142,135300,156200,291500
351460,202110,124,56,68,61600,75900,137500
351470,202110,144,77,67,84700,73700,158400
351480,202110,483,279,204,308000.63,224400,532400.63
351490,202110,289,103,186,113300,204600,317900
351492,202110,26,17,9,18700,9900,28600
351495,202110,26,18,8,20900,8800,29700
351500,202110,3480,1402,2078,1543300,2286900,3830200
351510,202110,2031,735,1296,808500,1425600,2234100
351512,202110,16,11,5,12100,5500,17600
351515,202110,192,113,79,124300,88000,212300
351518,202110,698,422,276,465300,303600,768900
351519,202110,79,44,35,48400,38500,86900
351520,202110,164,97,67,106700,73719.8,180419.8
351530,202110,24,14,10,15400,11000,26400
351535,202110,129,79,50,86900,55000,141900
351540,202110,453,304,149,336600,163900,500500
351550,202110,1447,844,603,928401.26,663300,1591701.26
351560,202110,77,45,32,49500,35200,84700
351565,202110,12,6,6,6600,6600,13200
351570,202110,2715,1263,1452,1391500,1599400.89,2990900.89
351580,202110,39,33,6,36300,6600,42900
351590,202110,61,39,22,42900,24200,67100
351600,202110,176,124,52,136400,57200,193600
351610,202110,51,22,29,24200,31900,56100
351620,202110,5740,3092,2648,3402301.12,2917200,6319501.12
351630,202110,3072,1449,1623,1596100,1786400,3382500
351640,202110,2154,909,1245,1001000.55,1370600.63,2371601.18
351650,202110,28,24,4,26400,4400,30800
351660,202110,131,81,50,89100,55000,144100
351670,202110,706,420,286,462000,314600,776600
351680,202110,68,55,13,60500,14300,74800
351685,202110,11,8,3,8800,3300,12100
351690,202110,299,198,101,217800.5,111100,328900.5
351700,202110,174,113,61,125637,67100,192737
351710,202110,66,41,25,45100,27500,72600
351720,202110,127,70,57,77000,62700,139700
351730,202110,111,71,40,78100,44000,122100
351740,202110,756,475,281,522500.74,309100,831600.74
351750,202110,357,139,218,154000,239800,393800
351760,202110,732,558,174,614900,191400,806300
351770,202110,301,243,58,267300.63,63800,331100.63
351780,202110,157,93,64,102300,70400,172700
351790,202110,256,132,124,145200,136400,281600
351800,202110,39,25,14,27500,15400,42900
351810,202110,119,78,41,85800,45100,130900
351820,202110,768,546,222,601700,245300,847000
351830,202110,580,185,395,203500,434500,638000
351840,202110,2051,945,1106,1039500,1218800,2258300
351850,202110,227,160,67,176000,73700,249700
351860,202110,630,425,205,467500,225500,693000
351870,202110,5641,2553,3088,2813801.98,3401201.36,6215003.34
351880,202110,20405,7876,12529,8673500.56,13802800,22476300.56
351885,202110,84,46,38,50600,41800,92400
351890,202110,65,48,17,52800,18700,71500
351900,202110,220,124,96,136400,106700,243100
351905,202110,98,44,54,48400,59400,107800
351907,202110,3539,1429,2110,1573000.5,2323200,3896200.5
351910,202110,171,73,98,80300,108900,189200
351920,202110,112,60,52,66000,57200,123200
351925,202110,89,55,34,60500,37400,97900
351930,202110,399,258,141,283800,155100,438900
351940,202110,238,95,143,104500,157300,261800
351950,202110,135,71,64,78100,70400,148500
351960,202110,921,449,472,493900.63,519200,1013100.63
351970,202110,2012,969,1043,1067000,1148400,2215400
351980,202110,153,68,85,74800,93500,168300
351990,202110,249,159,90,174900,99000,273900
352000,202110,323,203,120,223300,132000,355300
352010,202110,417,260,157,286071,172700,458771
352020,202110,182,64,118,70400,129800,200200
352030,202110,1118,545,573,599500,631400,1230900
352040,202110,593,236,357,259600,392700,652300
352042,202110,293,68,225,74800,247500,322300
352044,202110,351,203,148,224400.63,162800,387200.63
352050,202110,3216,1184,2032,1304600.63,2236300,3540900.63
352060,202110,102,57,45,62700,49500,112200
352070,202110,91,66,25,72601.26,27500,100101.26
352080,202110,64,42,22,46200,24200,70400
352090,202110,159,106,53,116600,58300,174900
352100,202110,285,135,150,148500,165000,313500
352110,202110,114,36,78,39600,85800,125400
352115,202110,63,19,44,20900,48400,69300
352120,202110,77,54,23,59400.63,25300,84700.63
352130,202110,220,172,48,189200,52800,242000
352140,202110,175,82,93,90200,102300,192500
352150,202110,124,64,60,71500,66000,137500
352160,202110,140,90,50,100100,55000,155100
352170,202110,389,264,125,290400,137500,427900
352180,202110,665,403,262,443300.63,288200,731500.63
352190,202110,241,96,145,105600,159500,265100
352200,202110,29,12,17,13200,18700,31900
352210,202110,4278,1693,2585,1863950.98,2847900,4711850.98
352215,202110,68,39,29,42900,31900,74800
352220,202110,6466,2390,4076,2631200,4488000.63,7119200.63
352230,202110,3392,2161,1231,2381501.76,1356301.05,3737802.81
352240,202110,2575,1448,1127,1595000,1240800,2835800
352250,202110,3038,1371,1667,1509201.26,1833700.04,3342901.30
352260,202110,1005,529,476,581900,523600,1105500
352265,202110,58,30,28,33000,30800,63800
352270,202110,381,210,171,231000,188100,419100
352280,202110,487,292,195,321200.63,214500,535700.63
352290,202110,179,101,78,111100,85800,196900
352300,202110,95,65,30,71500,33000,104500
352310,202110,6649,2826,3823,3109701.62,4208600,7318301.62
352320,202110,1108,560,548,616000,602800,1218800
352330,202110,520,255,265,281600,291500,573100
352340,202110,1364,618,746,679800,822800,1502600
352350,202110,356,196,160,215600,176000,391600
352360,202110,224,98,126,107800,138600,246400
352370,202110,111,71,40,79200,44000,123200
352380,202110,106,74,32,81400,35200,116600
352390,202110,2577,1104,1473,1214400,1623600,2838000
352400,202110,517,221,296,243100,325600,568700
352410,202110,903,598,305,657801.32,335500,993301.32
352420,202110,94,69,25,75900,27500,103400
352430,202110,1756,778,978,855801.89,1075801.26,1931603.15
352440,202110,3278,1538,1740,1691800,1914000,3605800
352450,202110,202,153,49,168300,53900,222200
352460,202110,624,311,313,342100,344300,686400
352470,202110,646,221,425,243100,469700,712800
352480,202110,1483,803,680,883300,748000,1631300
352490,202110,46,15,31,16500,34100,50600
352500,202110,1271,520,751,573100,827200,1400300
352510,202110,701,366,335,402600,368500,771100
352520,202110,804,334,470,367400,517000,884400
352530,202110,1777,916,861,1008700,947100,1955800
352540,202110,67,44,23,49500,25300,74800
352550,202110,188,107,81,117700,89100,206800
352560,202110,47,38,9,41800,9900,51700
352570,202110,711,335,376,368500.63,413600,782100.63
352580,202110,56,43,13,47300,14300,61600
352585,202110,22,5,17,5500,18700,24200
352590,202110,4290,2055,2235,2267100.63,2459697,4726797.63
352600,202110,355,243,112,267300,123200,390500
352610,202110,908,402,506,442200,556600,998800
352620,202110,1064,396,668,435600,735900,1171500
352630,202110,184,67,117,73700,128700,202400
352640,202110,521,335,186,369600,204600,574200
352650,202110,79,60,19,66000,20900,86900
352660,202110,65,38,27,41800,29700,71500
352670,202110,1680,874,806,962500.6,887700,1850200.6
352680,202110,908,555,353,610500,388300.63,998800.63
352690,202110,4536,1986,2550,2187901.26,2809400.63,4997301.89
352700,202110,93,55,38,60500,41800,102300
352710,202110,1468,748,720,823900,792000.51,1615900.51
352720,202110,1447,636,811,700700,893200,1593900
352725,202110,22,17,5,18700,5500,24200
352730,202110,381,179,202,198000,222200,420200
352740,202110,395,258,137,283800,150700.8,434500.8
352750,202110,23,15,8,16500,8800,25300
352760,202110,203,127,76,139700,83600,223300
352770,202110,83,62,21,68200,23100,91300
352780,202110,71,37,34,40700,37400,78100
352790,202110,23,17,6,18700,6600,25300
352800,202110,230,175,55,193600,60500,254100
352810,202110,157,97,60,106700,66000,172700
352820,202110,44,34,10,37400,11000,48400
352830,202110,76,50,26,55000,28600,83600
352840,202110,661,303,358,334400,393800,728200
352850,202110,1678,513,1165,565400,1282600,1848000
352860,202110,111,71,40,78100,44000,122100
352870,202110,47,30,17,33000,18700,51700
352880,202110,175,109,66,119900,72600,192500
352885,202110,33,22,11,24200,12100,36300
352890,202110,54,36,18,39600,19800,59400
352900,202110,4633,2176,2457,2398000,2706000,5104000
352910,202110,36,29,7,31900,7700,39600
352920,202110,639,368,271,405900,299200,705100
352930,202110,1185,552,633,607200,698500,1305700
352940,202110,6097,2367,3730,2608100,4106300,6714400
352950,202110,111,42,69,46200,77000,123200
352960,202110,64,38,26,41800,28600,70400
352965,202110,15,8,7,8800,7700,16500
352970,202110,514,377,137,414700,150700,565400
352980,202110,161,91,70,100100,77000,177100
352990,202110,979,454,525,499400,577500,1076900
353000,202110,53,22,31,24200,34100,58300
353010,202110,514,315,199,347600,221100,568700
353020,202110,300,209,91,229900,100100,330000
353030,202110,1293,569,724,625900,798600,1424500
353040,202110,75,38,37,41800,40700,82500
353050,202110,1285,832,453,915200.9,502700,1417900.9
353060,202110,8540,3539,5001,3898400.71,5502200,9400600.71
353070,202110,1839,1085,754,1195700.93,832504.2,2028205.13
353080,202110,1272,683,589,753500.92,647900,1401400.92
353090,202110,57,30,27,33000,29700,62700
353100,202110,44,35,9,38500,9900,48400
353110,202110,2147,667,1480,734800,1628000,2362800
353120,202110,111,59,52,66000,57200,123200
353130,202110,858,412,446,453200.92,490600,943800.92
353140,202110,557,234,323,257400.63,355300,612700.63
353150,202110,332,180,152,198000.63,167200,365200.63
353160,202110,104,79,25,86900,27500,114400
353170,202110,208,68,140,74800,154000,228800
353180,202110,1120,500,620,551100,683100,1234200
353190,202110,473,334,139,367400,152900,520300
353200,202110,236,113,123,124300,135300,259600
353205,202110,20,13,7,14300,7700,22000
353210,202110,65,37,28,40700,30800,71500
353215,202110,40,22,18,24200,19800,44000
353220,202110,83,43,40,47300,44000,91300
353230,202110,155,64,91,70400,100100,170500
353240,202110,348,161,187,177100,205700,382800
353250,202110,197,96,101,105600,111100,216700
353260,202110,455,298,157,330000,172700,502700
353270,202110,74,53,21,58300,23100,81400
353280,202110,103,49,54,53900,59400,113300
353282,202110,126,86,40,94600,44000,138600
353284,202110,25,18,7,19800,7700,27500
353286,202110,3,1,2,1100,2200,3300
353290,202110,81,44,37,48400,40700,89100
353300,202110,443,226,217,248600.63,238700,487300.63
353310,202110,43,36,7,39600,7700,47300
353320,202110,38,22,16,24200,17600,41800
353325,202110,47,27,20,29700,22000,51700
353330,202110,61,41,20,45100,22000,67100
353340,202110,632,215,417,236500,458700,695200
353350,202110,882,428,454,470800,499400,970200
353360,202110,101,78,23,85800,25300,111100
353370,202110,112,66,46,72600,50600,123200
353380,202110,27,13,14,14300,15400,29700
353390,202110,1101,512,589,564300,647900,1212200
353400,202110,48,28,20,30800,22000,52800
353410,202110,112,64,48,70400,52800,123200
353420,202110,57,21,36,23100,39600,62700
353430,202110,575,373,202,411401.13,224400,635801.13
353440,202110,11851,5025,6826,5534100.63,7518500,13052600.63
353450,202110,57,28,29,30800,31900,62700
353460,202110,616,319,297,350900,327800,678700
353470,202110,2234,1088,1146,1196800.6,1265000,2461800.6
353475,202110,254,166,88,182600,96800,279400
353480,202110,174,140,34,154000,37400,191400
353490,202110,225,132,93,145200,102300,247500
353500,202110,210,120,90,132000,99000,231000
353510,202110,85,57,28,62700,30800,93500
353520,202110,217,156,61,171600,67100,238700
353530,202110,455,235,220,258500,242000,500500
353540,202110,389,238,151,262900,166100,429000
353550,202110,709,445,264,489500.63,290400,779900.63
353560,202110,566,227,339,249700,372900,622600
353570,202110,65,36,29,39600,31900,71500
353580,202110,339,235,104,258500,114400,372900
353590,202110,80,57,23,62700,25300,88000
353600,202110,275,160,115,176000.63,127600,303600.63
353610,202110,133,69,64,75900,71500,147400
353620,202110,668,336,332,369600,365200,734800
353625,202110,56,30,26,33000,28600,61600
353630,202110,218,155,63,170500,69300,239800
353640,202110,125,79,46,86900,50600,137500
353650,202110,963,360,603,396000,664400,1060400
353657,202110,21,17,4,18700,4400,23100
353660,202110,283,148,135,162800,148500,311300
353670,202110,715,409,306,451000.63,336600,787600.63
353680,202110,120,81,39,89100,42900,132000
353690,202110,43,31,12,34100,13200,47300
353700,202110,276,190,86,209000.8,95700,304700.8
353710,202110,492,230,262,253000,288200,541200
353715,202110,49,31,18,34100,19800,53900
353720,202110,345,153,192,168300,211200,379500
353730,202110,1146,707,439,777700,484000,1261700
353740,202110,613,334,279,367400,306900,674300
353750,202110,70,40,30,44000,33000,77000
353760,202110,3184,1184,2000,1303500,2201100.9,3504600.9
353770,202110,79,64,15,70400,16500,86900
353780,202110,1302,601,701,661100.63,772200,1433300.63
353790,202110,488,289,199,317900,218900,536800
353800,202110,3534,1656,1878,1824920,2068074,3892994
353810,202110,226,115,111,126500,123200,249700
353820,202110,224,93,131,102300,144100,246400
353830,202110,56,45,11,49500,12100,61600
353850,202110,186,88,98,96800,107800,204600
353860,202110,524,224,300,247500,330000,577500
353870,202110,5500,2746,2754,3026100,3038200.47,6064300.47
353880,202110,706,464,242,510400,267300,777700
353890,202110,552,318,234,349800,257400.59,607200.59
353900,202110,128,69,59,75900,66000,141900
353910,202110,191,82,109,93500,119900,213400
353920,202110,419,222,197,244200,216700,460900
353930,202110,1054,607,447,667700,491700,1159400
353940,202110,192,95,97,105600,106700,212300
353950,202110,484,304,180,335500,198000,533500
353960,202110,74,60,14,67100,15400,82500
353970,202110,41,27,14,29700,15400,45100
353980,202110,1766,784,982,862400,1082400,1944800
353990,202110,78,44,34,48400,37400,85800
354000,202110,378,171,207,188100,228800,416900
354010,202110,91,52,39,57200,42900,100100
354020,202110,498,316,182,347600,200200,547800
354025,202110,33,29,4,31900,4400,36300
354030,202110,45,26,19,28600,20900,49500
354040,202110,99,74,25,81400,27500,108900
354050,202110,173,92,81,101200.63,89100,190300.63
354060,202110,755,360,395,396000,435600,831600
354070,202110,913,512,401,564300,442200,1006500
354075,202110,181,83,98,91300,107800,199100
354080,202110,306,133,173,146300,190300,336600
354085,202110,23,12,11,13200,12100,25300
354090,202110,266,159,107,174807,117700,292507
354100,202110,5707,2307,3400,2539900.4,3741100,6281000.4
354105,202110,99,47,52,51700,57200,108900
354110,202110,42,20,22,22000,24200,46200
354120,202110,147,97,50,106700.93,55000,161700.93
354130,202110,707,429,278,471900.81,305800,777700.81
354140,202110,3179,1416,1763,1557600.55,1939300,3496900.55
354150,202110,637,367,270,404800.66,297000,701800.66
354160,202110,642,398,244,437800,268400,706200
354165,202110,15,13,2,14300,2200,16500
354170,202110,172,121,51,133100,57200,190300
354180,202110,60,36,24,39600.42,26400,66000.42
354190,202110,199,79,120,86900,132000,218900
354200,202110,107,54,53,59400,58300,117700
354210,202110,66,25,41,27500,45100,72600
354220,202110,630,393,237,432300.63,260700,693000.63
354230,202110,169,74,95,81400,104500,185900
354240,202110,328,207,121,227700.82,133100,360800.82
354250,202110,81,48,33,52800,36300,89100
354260,202110,2137,988,1149,1086800.52,1266100.85,2352901.37
354270,202110,86,61,25,67100,27500,94600
354280,202110,51,27,24,29700,26400,56100
354290,202110,137,91,46,100100,50600,150700
354300,202110,357,246,111,270600.63,122100,392700.63
354310,202110,92,66,26,72600,28600,101200
354320,202110,221,106,115,116600,126500,243100
354323,202110,9,8,1,8800,1100,9900
354325,202110,120,64,56,70400.83,62700,133100.83
354330,202110,2411,806,1605,886443,1766600,2653043
354340,202110,10251,4704,5547,5182968,6105000,11287968
354350,202110,139,89,50,97900,55000,152900
354360,202110,71,41,30,45100,33000,78100
354370,202110,238,122,116,134200,127600,261800
354380,202110,169,96,73,105600,80300,185900
354390,202110,2691,949,1742,1045000,1917300,2962300
354400,202110,292,163,129,179300,141900,321200
354410,202110,639,285,354,313500,389400,702900
354420,202110,272,170,102,187000,112200,299200
354425,202110,321,176,145,194751,159500,354251
354430,202110,189,105,84,115500,92400,207900
354440,202110,32,25,7,27500,7700,35200
354450,202110,55,35,20,38500,22000,60500
354460,202110,95,55,40,60500,44000,104500
354470,202110,26,13,13,14300,14300,28600
354480,202110,105,55,50,60500,55000,115500
354490,202110,133,80,53,89100,58300,147400
354500,202110,389,174,215,192500,236500,429000
354510,202110,92,62,30,68200,33000,101200
354515,202110,42,11,31,12100,34100,46200
354520,202110,1596,669,927,736843,1021900,1758743
354530,202110,807,398,409,438900,451000,889900
354540,202110,271,136,135,149600,148500,298100
354550,202110,36,20,16,22000,17600,39600
354560,202110,150,80,70,88000,77000,165000
354570,202110,134,90,44,99000,48400,147400
354580,202110,1808,844,964,929500.35,1061500,1991000.35
354600,202110,267,134,133,147400,146300,293700
354610,202110,69,57,12,62700,13200,75900
354620,202110,67,18,49,19800,53900,73700
354625,202110,12,8,4,8800,4400,13200
354630,202110,314,203,111,223300,122100,345400
354640,202110,810,494,316,543400,347600,891000
354650,202110,68,39,29,42900,31900,74800
354660,202110,796,585,211,644600.63,232100,876700.63
354670,202110,224,83,141,91300,155100,246400
354680,202110,1299,455,844,500500,929500,1430000
354690,202110,71,48,23,53900,25300,79200
354700,202110,73,50,23,55000,25300,80300
354710,202110,47,34,13,37400,14300,51700
354720,202110,21,20,1,22000,1100,23100
354730,202110,1760,706,1054,779900,1161600,1941500
354740,202110,74,51,23,56100,25300,81400
354750,202110,411,231,180,254100,198000,452100
354760,202110,486,298,188,327800,206800,534600
354765,202110,8,3,5,3300,5500,8800
354770,202110,349,230,119,254100,130900,385000
354780,202110,8243,3094,5149,3408900.5,5666100,9075000.5
354790,202110,90,55,35,60500,38500,99000
354800,202110,434,236,198,260656.12,217800,478456.12
354805,202110,80,37,43,40700,47300,88000
354810,202110,100,57,43,62700,47300,110000
354820,202110,204,83,121,91300,134200,225500
354830,202110,43,23,20,25300,22000,47300
354840,202110,56,39,17,42900,18700,61600
354850,202110,4455,1918,2537,2113100.08,2791800.06,4904900.14
354860,202110,340,158,182,173800,200200,374000
354870,202110,11911,5136,6775,5651801.26,7460200,13112001.26
354880,202110,2682,969,1713,1067000.89,1887651.96,2954652.85
354890,202110,2876,1502,1374,1654400.63,1513600,3168000.63
354900,202110,63,42,21,46200,23100,69300
354910,202110,1272,642,630,707300,694100,1401400
354920,202110,39,32,7,35200,7700,42900
354925,202110,18,9,9,9900,9900,19800
354930,202110,35,30,5,33000.4,5500,38500.4
354940,202110,784,557,227,614900,249700,864600
354950,202110,211,128,83,140800,91300,232100
354960,202110,133,51,82,56100,90200,146300
354970,202110,1040,704,336,774400.63,369600,1144000.63
354980,202110,8988,3178,5810,3501302.15,6396500.39,9897802.54
354990,202110,9848,4309,5539,4747600,6095100,10842700
354995,202110,556,173,383,190300,421300,611600
355000,202110,457,156,301,171600,331100,502700
355010,202110,599,361,238,397100,261800.63,658900.63
355020,202110,771,474,297,522500,326700,849200
355030,202110,210475,77725,132750,85589967.54,146190044.4,231780011.94
355040,202110,850,394,456,433400,503800,937200
355050,202110,170,96,74,105600,81400,187000
355060,202110,1696,806,890,887700,981200,1868900
355070,202110,1539,697,842,767800.08,927300.73,1695100.81
355080,202110,192,117,75,128700,82500,211200
355090,202110,282,167,115,183700,126500.57,310200.57
355100,202110,5206,2425,2781,2671790,3061300,5733090
355110,202110,234,151,83,166100,91300,257400
355120,202110,59,39,20,42900,22000,64900
355130,202110,49,28,21,30800,23100,53900
355140,202110,192,112,80,124300,88000,212300
355150,202110,674,394,280,433400,308000,741400
355160,202110,474,223,251,246400.63,277200,523600.63
355170,202110,2059,1049,1010,1153900,1111000,2264900
355180,202110,686,274,412,301400,454300,755700
355190,202110,214,146,68,160600,75900,236500
355200,202110,107,57,50,62700,55000,117700
355210,202110,712,388,324,427900,356400,784300
355220,202110,7402,3635,3767,3999600,4147000,8146600
355230,202110,96,57,39,62700,42900,105600
355240,202110,4523,1844,2679,2032800.92,2949100,4981900.92
355250,202110,6170,2613,3557,2877621.06,3918200,6795821.06
355255,202110,48,30,18,33000,19800,52800
355260,202110,177,106,71,116600,78100,194700
355270,202110,168,109,59,119900,64900,184800
355280,202110,6728,2491,4237,2745600,4665100,7410700
355290,202110,71,58,13,63800,14300,78100
355300,202110,220,126,94,138600,103400,242000
355310,202110,109,55,54,60500,59400,119900
355320,202110,93,49,44,53900,48400,102300
355330,202110,294,168,126,184800,138600,323400
355340,202110,1423,488,935,539001.18,1029600,1568601.18
355350,202110,159,77,82,84700,90200,174900
355360,202110,171,114,57,125400,62700,188100
355365,202110,17,13,4,14300,4400,18700
355370,202110,1020,613,407,674300.63,447700,1122000.63
355380,202110,813,504,309,556600,342100,898700
355385,202110,83,54,29,59400,31900,91300
355390,202110,111,58,53,63800,58300,122100
355395,202110,192,101,91,111100.5,100100,211200.5
355400,202110,1724,988,736,1087809,809600.63,1897409.63
355410,202110,4979,2280,2699,2512400,2974400,5486800
355420,202110,48,34,14,37400,15400,52800
355430,202110,398,242,156,268400,171600,440000
355440,202110,84,49,35,53900,38500,92400
355450,202110,431,211,220,232100,242000,474100
355460,202110,56,43,13,47300,14300,61600
355465,202110,49,28,21,30800,23100,53900
355470,202110,182,71,111,78100,123200,201300
355475,202110,11,8,3,8800,3300,12100
355480,202110,583,229,354,251900,389400,641300
355490,202110,109,73,36,80300,40700,121000
355495,202110,76,26,50,28600,55000,83600
355500,202110,1582,851,731,938301.46,805200,1743501.46
355510,202110,271,193,78,212300.63,85800,298100.63
355520,202110,29,22,7,24200,7700,31900
355530,202110,22,11,11,12100,12100,24200
355535,202110,72,33,39,36300,42900,79200
355540,202110,2605,1011,1594,1112255.1,1753400,2865655.1
355550,202110,61,36,25,39600,27500,67100
355560,202110,235,107,128,117700,140800,258500
355570,202110,20,13,7,14300,7700,22000
355580,202110,243,166,77,182600,84700,267300
355590,202110,17,9,8,9900,8800,18700
355600,202110,268,130,138,143000,151800,294800
355610,202110,227,142,85,156200,93500,249700
355620,202110,1298,564,734,620400,808500,1428900
355630,202110,410,301,109,332200,121000,453200
355635,202110,121,54,67,59400,73700,133100
355640,202110,530,283,247,312400,271700,584100
355645,202110,879,332,547,365200,601700,966900
355650,202110,1912,804,1108,885500,1221000,2106500
355660,202110,235,122,113,134200,124300,258500
355670,202110,603,246,357,270600,392700,663300
355680,202110,207,115,92,126500,101200,227700
355690,202110,87,44,43,48400,47300,95700
355695,202110,23,14,9,15400,9900,25300
355700,202110,1183,592,591,651200,651200,1302400
355710,202110,2213,1189,1024,1310100.98,1129700,2439800.98
355715,202110,13,11,2,12100,2200,14300
355720,202110,248,152,96,167200,105600,272800
355730,202110,105,61,44,67100,48400,115500
410010,202110,133,106,27,116600,29700,146300
410020,202110,117,86,31,94600,34100,128700
410030,202110,175,98,77,107800,84700,192500
410040,202110,1277,624,653,686400,718300,1404700
410045,202110,47,36,11,39600,12100,51700
410050,202110,500,283,217,312400,238700,551100
410060,202110,289,211,78,232100,85800,317900
410070,202110,290,246,44,270600,48400,319000
410080,202110,178,105,73,115500,80300,195800
410090,202110,73,62,11,68200,12100,80300
410100,202110,251,165,86,181500,94600,276100
410105,202110,43,24,19,26400,20900,47300
410110,202110,340,205,135,225500,148500,374000
410115,202110,44,27,17,29700,18700,48400
410120,202110,429,199,230,218900,254100,473000
410130,202110,53,30,23,33000,25300,58300
410140,202110,3128,1411,1717,1552100.03,1889800,3441900.03
410150,202110,2666,1033,1633,1136300,1796300,2932600
410160,202110,485,283,202,312400,222200,534600
410165,202110,49,28,21,30800,24200,55000
410170,202110,191,118,73,129800,80300,210100
410180,202110,2277,1222,1055,1344200,1162700,2506900
410185,202110,31,27,4,29700,4400,34100
410190,202110,485,309,176,339900,194700,534600
410200,202110,958,671,287,739200,315700,1054900
410210,202110,616,316,300,347600,330000,677600
410220,202110,47,21,26,23100,28600,51700
410230,202110,167,76,91,83600,100100,183700
410240,202110,726,460,266,506000,292600,798600
410250,202110,376,264,112,290400,123200,413600
410260,202110,297,159,138,176000,151800,327800
410270,202110,28,21,7,23100,7700,30800
410275,202110,60,45,15,49500,16500,66000
410280,202110,323,183,140,201300,154000,355300
410290,202110,271,151,120,167200,132000,299200
410300,202110,86,54,32,59400,35200,94600
410302,202110,24,14,10,15400,11000,26400
410304,202110,37,24,13,26400,14300,40700
410305,202110,222,120,102,134200,112200,246400
410310,202110,199,117,82,128700,90200,218900
410315,202110,43,30,13,33000,14300,47300
410320,202110,140,92,48,101200,52800,154000
410322,202110,33,20,13,22000,14300,36300
410330,202110,174,115,59,126500,64900,191400
410335,202110,99,54,45,59400,49500,108900
410337,202110,41,31,10,34100,11000,45100
410340,202110,40,33,7,36300,7700,44000
410345,202110,203,117,86,128700,94600,223300
410347,202110,46,36,10,39600,11000,50600
410350,202110,258,147,111,161700,122100,283800
410360,202110,426,264,162,290400,178200,468600
410370,202110,2311,951,1360,1047200,1499300,2546500
410380,202110,194,115,79,126500,88000,214500
410390,202110,388,261,127,288200,139700,427900
410395,202110,36,22,14,24200,15400,39600
410400,202110,844,362,482,398200.5,532400,930600.5
410405,202110,82,62,20,68200,22000,90200
410410,202110,25,16,9,17600,9900,27500
410420,202110,1698,756,942,833702.1,1037300,1871002.1
410425,202110,182,71,111,78100,122100,200200
410430,202110,2298,1217,1081,1338700,1191300,2530000
410440,202110,367,264,103,290400,113300,403700
410442,202110,359,227,132,249700,145200,394900
410445,202110,416,294,122,323400,134200,457600
410450,202110,381,183,198,202400,217800,420200
410460,202110,551,279,272,308000,299200,607200
410465,202110,245,136,109,149600,119900,269500
410470,202110,258,142,116,156200,128700,284900
410480,202110,6424,3036,3388,3341800,3732300,7074100
410490,202110,1409,810,599,891000,658900,1549900
410500,202110,270,155,115,170500,126500,297000
410510,202110,175,129,46,141900,50600,192500
410520,202110,263,189,74,207900,81400,289300
410530,202110,301,98,203,107800,223300,331100
410540,202110,336,244,92,268400,101200,369600
410550,202110,1690,684,1006,753500,1106600,1860100
410560,202110,154,103,51,113300,56100,169400
410570,202110,442,290,152,321200,167200,488400
410580,202110,3604,1501,2103,1651100.2,2317700,3968800.2
410590,202110,411,266,145,292581,159500,452081
410600,202110,189,165,24,181500,26400,207900
410610,202110,50,41,9,45100,9900,55000
410620,202110,260,171,89,188100.4,99000,287100.4
410630,202110,446,240,206,264000,226600,490600
410640,202110,1036,636,400,700700,441100,1141800
410645,202110,112,80,32,88000,35200,123200
410650,202110,361,222,139,245300,152900,398200
410655,202110,89,61,28,67100,30800,97900
410657,202110,33,10,23,11000,25300,36300
410660,202110,622,412,210,453200.5,231000,684200.5
410670,202110,76,62,14,68200,15400,83600
410680,202110,188,152,36,167200,39600,206800
410685,202110,28,17,11,18700,12100,30800
410690,202110,28443,11607,16836,12783100.64,18541601.21,31324701.85
410700,202110,319,231,88,254100,96800,350900
410710,202110,130,105,25,115500,27500,143000
410712,202110,46,33,13,36300,14300,50600
410715,202110,89,67,22,75900,24200,100100
410720,202110,665,377,288,414700,316800,731500
410725,202110,182,129,53,141900,58300,200200
410730,202110,103,48,55,52800,60500,113300
410740,202110,103,72,31,79200,34100,113300
410750,202110,289,188,101,206800,111100,317900
410752,202110,20,14,6,15400,6600,22000
410753,202110,58,21,37,23100,40700,63800
410754,202110,54,26,28,28600,30800,59400
410755,202110,77,44,33,48400,36300,84700
410760,202110,752,401,351,443300,388300,831600
410765,202110,1843,821,1022,903100,1124200,2027300
410770,202110,112,81,31,89100,34100,123200
410773,202110,62,43,19,47300,20900,68200
410775,202110,179,134,45,147400,49500,196900
410780,202110,92,50,42,55000,46200,101200
410785,202110,50,40,10,44000,11000,55000
410790,202110,85,36,49,39600,53900,93500
410800,202110,282,174,108,191400,118800,310200
410810,202110,27,14,13,15400,14300,29700
410820,202110,163,116,47,127600,51700,179300
410830,202110,8852,3701,5151,4076600.4,5668300,9744900.4
410832,202110,108,68,40,74800,44000,118800
410840,202110,1430,757,673,833800.21,742500,1576300.21
410845,202110,50,27,23,29700,25300,55000
410850,202110,179,128,51,140800,56100,196900
410855,202110,71,61,10,67100,11000,78100
410860,202110,772,389,383,427900,422400,850300
410865,202110,101,72,29,79200,31900,111100
410870,202110,148,126,22,138600,24200,162800
410880,202110,1144,557,587,614900,645700,1260600
410890,202110,92,64,28,70400,30800,101200
410895,202110,73,56,17,61600,18700,80300
410900,202110,26,18,8,19800,8800,28600
410910,202110,15,10,5,11000,5500,16500
410920,202110,38,23,15,25300,16500,41800
410930,202110,547,330,217,364100,238700,602800
410940,202110,4405,2321,2084,2555300.78,2295700,4851000.78
410950,202110,100,74,26,81400,28600,110000
410960,202110,874,336,538,369600,592900,962500
410965,202110,67,44,23,48400,25300,73700
410970,202110,612,422,190,466400,209000,675400
410975,202110,125,79,46,86900.38,50600,137500.38
410980,202110,1621,707,914,777700,1006500,1784200
410990,202110,268,188,80,206800,88000,294800
411000,202110,61,35,26,38500,28600,67100
411005,202110,27,22,5,24200,5500,29700
411007,202110,252,141,111,155100,122100,277200
411010,202110,595,386,209,425700,229900,655600
411020,202110,286,183,103,201300,114400,315700
411030,202110,22,11,11,12100,12100,24200
411040,202110,55,35,20,38500,22000,60500
411050,202110,211,152,59,168300,64900,233200
411060,202110,517,343,174,378400,191400,569800
411065,202110,47,42,5,46750,5500,52250
411070,202110,1273,734,539,807400,592900,1400300
411080,202110,240,168,72,184800,80300,265100
411090,202110,87,67,20,73700,22000,95700
411095,202110,332,116,216,127600,237600,365200
411100,202110,115,91,24,101200,26400,127600
411110,202110,134,80,54,88000,59400,147400
411120,202110,215,143,72,158400,79200,237600
411125,202110,276,121,155,133100,170500,303600
411130,202110,122,103,19,113300,20900,134200
411140,202110,213,144,69,158400,75900,234300
411150,202110,1242,797,445,876700,489500.63,1366200.63
411155,202110,118,81,37,89100,40700,129800
411160,202110,30,13,17,14300,18700,33000
411170,202110,52,46,6,50600,6600,57200
411180,202110,990,642,348,706200,382800,1089000
411190,202110,334,183,151,201300,166100,367400
411200,202110,661,384,277,422400.63,304700,727100.63
411210,202110,689,355,334,390500,367400.1,757900.1
411220,202110,160,109,51,119900,56100,176000
411230,202110,38,30,8,33000,8800,41800
411240,202110,114,71,43,78100,47300,125400
411250,202110,420,307,113,337700,124300,462000
411260,202110,14,10,4,11000,4400,15400
411270,202110,264,132,132,145200,145200,290400
411275,202110,183,157,26,172700,28600,201300
411280,202110,199,142,57,156200.63,62700,218900.63
411290,202110,63,49,14,53900,15400,69300
411295,202110,125,98,27,107800,29700,137500
411300,202110,77,33,44,36300,49500,85800
411310,202110,90,66,24,72600,26400,99000
411320,202110,794,505,289,555500.9,317900,873400.9
411325,202110,63,45,18,49500,19800,69300
411330,202110,909,587,322,645700,354200,999900
411340,202110,31,20,11,22000,12100,34100
411342,202110,54,40,14,44000,15400,59400
411345,202110,114,56,58,61600,63800,125400
411350,202110,496,366,130,402600,143000,545600
411360,202110,57,36,21,39600,23100,62700
411370,202110,13967,5520,8447,6078602.59,9304901.34,15383503.93
411373,202110,181,121,60,133100,66000,199100
411375,202110,80,63,17,69300,18700,88000
411380,202110,78,56,22,61600,24200,85800
411390,202110,127,72,55,79200,60500,139700
411400,202110,415,282,133,310200,146300,456500
411410,202110,489,227,262,249700,288200,537900
411420,202110,957,402,555,442200,610500,1052700
411430,202110,498,271,227,298100,250800,548900
411435,202110,33,20,13,22000,14300,36300
411440,202110,469,369,100,405900,110000,515900
411450,202110,416,353,63,390500,69300,459800
411460,202110,791,297,494,327800,543400,871200
411470,202110,102,69,33,75900,36300,112200
411480,202110,704,372,332,409200,366300,775500
411490,202110,290,180,110,199100,121000,320100
411500,202110,99,79,20,86900,22000,108900
411510,202110,222,176,46,193600,50600,244200
411520,202110,6047,2105,3942,2316966.66,4341700.7,6658667.36
411530,202110,125,84,41,92400,45100,137500
411535,202110,49,18,31,19800,35200,55000
411540,202110,366,245,121,270600,134200,404800
411545,202110,56,40,16,44000,17600,61600
411550,202110,84,63,21,69300,23100,92400
411560,202110,400,163,237,179300,260700,440000
411570,202110,908,303,605,334400,665500,999900
411573,202110,26,16,10,17600,11000,28600
411575,202110,304,182,122,200200,134200,334400
411580,202110,1247,441,806,485100,886600,1371700
411585,202110,72,36,36,39600,39600,79200
411590,202110,17,11,6,12100,6600,18700
411600,202110,23,11,12,12100,13200,25300
411605,202110,242,93,149,102300,163900,266200
411610,202110,223,139,84,154000,92400,246400
411620,202110,389,188,201,207900,221100,429000
411630,202110,50,35,15,38500,16500,55000
411640,202110,33,23,10,25300,11000,36300
411650,202110,10,7,3,7700,3300,11000
411660,202110,40,28,12,30800,13200,44000
411670,202110,240,166,74,182600,81400,264000
411680,202110,158,126,32,138600,35200,173800
411690,202110,621,322,299,356400,328900,685300
411695,202110,66,46,20,50600,22000,72600
411700,202110,144,114,30,126500,33000,159500
411705,202110,104,69,35,75900,38500,114400
411710,202110,296,197,99,216700,110000,326700
411720,202110,135,91,44,100100,48400,148500
411721,202110,80,64,16,70400,17600,88000
411722,202110,107,45,62,49500,68200,117700
411725,202110,165,119,46,130900,50600,181500
411727,202110,96,75,21,82500,23100,105600
411729,202110,42,32,10,35200,11000,46200
411730,202110,559,345,214,379500,235400,614900
411740,202110,32,20,12,22000,13200,35200
411745,202110,63,47,16,51700,17600,69300
411750,202110,840,351,489,386100,537900,924000
411760,202110,1202,865,337,953590,370700,1324290
411770,202110,434,287,147,316800,161700,478500
411780,202110,361,234,127,258500,139700,398200
411790,202110,567,315,252,346500.18,277200,623700.18
411800,202110,147,105,42,115500.65,46200,161700.65
411810,202110,181,137,44,151800,48400,200200
411820,202110,2386,983,1403,1082400,1544400,2626800
411830,202110,14,13,1,14300,1100,15400
411840,202110,2100,1242,858,1366200,944900,2311100
411845,202110,66,22,44,24200,48400,72600
411850,202110,1222,650,572,717200,629200,1346400
411860,202110,50,31,19,34100,20900,55000
411870,202110,68,41,27,45100,29700,74800
411880,202110,427,251,176,277200,193600,470800
411885,202110,104,60,44,66000,48400,114400
411890,202110,308,209,99,231000,110000,341000
411900,202110,97,68,29,74800,31900,106700
411910,202110,184,140,44,154000.25,48400,202400.25
411915,202110,2328,908,1420,999900,1563100,2563000
411920,202110,112,87,25,95700,27500,123200
411925,202110,16,10,6,11000,6600,17600
411930,202110,791,551,240,607270.4,264000,871270.4
411940,202110,590,374,216,411400,237600,649000
411950,202110,1142,520,622,573100,684200,1257300
411960,202110,1111,704,407,775500,447700,1223200
411965,202110,24,13,11,14300,12100,26400
411970,202110,94,79,15,86900,16500,103400
411980,202110,199,110,89,121000,97900,218900
411990,202110,5146,2768,2378,3048101.42,2618071.5,5666172.92
411995,202110,583,174,409,191400,451000,642400
412000,202110,317,202,115,223300,126500,349800
412010,202110,45,24,21,26400,23100,49500
412015,202110,39,30,9,33000,9900,42900
412020,202110,22,17,5,18700,5500,24200
412030,202110,39,35,4,38500,4400,42900
412033,202110,50,29,21,31900,23100,55000
412035,202110,73,46,27,50600,29700,80300
412040,202110,38,19,19,20900,20900,41800
412050,202110,213,156,57,171600,62700,234300
412060,202110,763,551,212,607200.6,233200.13,840400.73
412065,202110,51,29,22,31900,24200,56100
412070,202110,165,114,51,125400,56100,181500
412080,202110,311,145,166,159500,182600,342100
412085,202110,35,14,21,15400,23100,38500
412090,202110,836,516,320,568700,352000,920700
412100,202110,264,220,44,242000,48400,290400
412110,202110,70,54,16,59400,17600,77000
412120,202110,336,184,152,203500,167200,370700
412125,202110,72,44,28,48400,30800,79200
412130,202110,44,29,15,31900,16500,48400
412135,202110,30,18,12,19800,13200,33000
412140,202110,415,262,153,288200,168300,456500
412150,202110,237,155,82,171600,90200,261800
412160,202110,86,53,33,58300,36300,94600
412170,202110,706,475,231,522500,254100,776600
412175,202110,36,26,10,28600,11000,39600
412180,202110,185,137,48,150700,52800,203500
412190,202110,314,244,70,268400,77000,345400
412200,202110,187,117,70,128700,77000,205700
412210,202110,95,70,25,77000,27500,104500
412215,202110,236,156,80,171600,88000,259600
412217,202110,64,53,11,58300,12100,70400
412220,202110,834,556,278,611600,305800,917400
412230,202110,299,182,117,200200,128700,328900
412240,202110,1311,624,687,686400,756800,1443200
412250,202110,401,247,154,271700,169400,441100
412260,202110,118,79,39,86900,42900,129800
412265,202110,173,128,45,140800,49500,190300
412270,202110,90,57,33,62700,36300,99000
412280,202110,88,68,20,74800,22000,96800
412290,202110,91,57,34,62700,37400,100100
412300,202110,209,143,66,158400,72600,231000
412310,202110,52,42,10,46200,11000,57200
412320,202110,91,72,19,79200,20900,100100
412330,202110,180,147,33,161700,36300,198000
412340,202110,165,112,53,123200,58300,181500
412350,202110,647,299,348,328900,382800,711700
412360,202110,23,20,3,22000,3300,25300
412370,202110,152,129,23,141900,25300,167200
412380,202110,218,163,55,179300,60500,239800
412382,202110,63,35,28,39600,30800,70400
412385,202110,154,109,45,119900,50600,170500
412390,202110,303,226,77,248600,84700,333300
412395,202110,66,52,14,57200,15400,72600
412400,202110,97,64,33,70400,36300,106700
412402,202110,235,116,119,127600,130900,258500
412405,202110,940,316,624,347600,687500,1035100
412410,202110,953,572,381,630300,420200,1050500
412420,202110,18,17,1,18700,1100,19800
412430,202110,23,21,2,23100,2200,25300
412440,202110,640,328,312,361900,343200,705100
412450,202110,74,65,9,71500,9900,81400
412460,202110,92,70,22,79200,24200,103400
412470,202110,207,161,46,178200,50600,228800
412480,202110,145,101,44,111100,48400,159500
412490,202110,158,132,26,145200,28600,173800
412500,202110,403,318,85,349800.44,93500,443300.44
412510,202110,164,135,29,148500,31900,180400
412520,202110,92,57,35,62700,38500,101200
412530,202110,108,53,55,58300,60500,118800
412535,202110,91,69,22,75900,24200,100100
412540,202110,84,40,44,44000,48400,92400
412545,202110,84,57,27,62700,29700,92400
412550,202110,3981,1578,2403,1738000,2649900,4387900
412555,202110,10,6,4,6600,4400,11000
412560,202110,651,437,214,480700,235400,716100
412570,202110,802,384,418,422400,459800,882200
412575,202110,94,65,29,71500,33000,104500
412580,202110,173,117,56,129800,61600,191400
412590,202110,31,28,3,30800,3300,34100
412600,202110,173,120,53,132000,58300,190300
412610,202110,35,14,21,15400,23100,38500
412620,202110,142,118,24,129800,26400,156200
412625,202110,2121,1041,1080,1146200.84,1190200,2336400.84
412627,202110,67,48,19,52800,20900,73700
412630,202110,387,254,133,279400,146300,425700
412635,202110,73,20,53,22000,58300,80300
412640,202110,104,72,32,79200,35200,114400
412650,202110,323,214,109,235400,119900,355300
412660,202110,455,263,192,289300,211200,500500
412665,202110,43,39,4,42900,4400,47300
412667,202110,293,188,105,206800,116600,323400
412670,202110,73,58,15,63800,16500,80300
412680,202110,317,237,80,261800,88000,349800
412690,202110,125,79,46,86900,50600,137500
412700,202110,181,121,60,133100,66000,199100
412710,202110,1333,756,577,832700,634700,1467400
412720,202110,228,125,103,138600,113300,251900
412730,202110,202,170,32,187000,35200,222200
412740,202110,415,209,206,229900,226600,456500
412750,202110,435,233,202,256300,222200,478500
412760,202110,324,161,163,177100,180400,357500
412770,202110,2102,1121,981,1233100.63,1080200,2313300.63
412780,202110,140,103,37,114400,40700,155100
412785,202110,316,151,165,166100,181500,347600
412788,202110,42,24,18,26400,19800,46200
412790,202110,124,100,24,110000,26400,136400
412795,202110,149,103,46,113300,50600,163900
412796,202110,301,189,112,209000,123200,332200
412800,202110,649,385,264,424600,291500,716100
412810,202110,2974,1580,1394,1738000.59,1538900,3276900.59
412820,202110,936,563,373,619300,410300,1029600
412830,202110,13,10,3,11000,3300,14300
412840,202110,254,167,87,183700,95700,279400
412850,202110,727,454,273,499400,300300,799700
412853,202110,166,77,89,84700,99000,183700
412855,202110,195,101,94,111100.26,103400,214500.26
412860,202110,96,63,33,69300,36300,105600
412862,202110,72,47,25,52800,27500,80300
412863,202110,8,6,2,6600,2200,8800
412865,202110,43,32,11,35200,12100,47300
412870,202110,107,63,44,69300,48400,117700
412880,202110,94,66,28,72600,30800,103400
420005,202110,41,37,4,40700,4400,45100
420010,202110,374,241,133,265100,146300,411400
420020,202110,86,70,16,77000,18700,95700
420030,202110,26,21,5,23100,5500,28600
420040,202110,96,73,23,80300,25300,105600
420050,202110,59,36,23,39600,25300,64900
420055,202110,16,16,0,17600,,17600.0
420060,202110,26,19,7,20900,7700,28600
420070,202110,101,85,16,93500,18700,112200
420075,202110,10,10,0,11000,,11000.0
420080,202110,39,34,5,37400,5500,42900
420090,202110,39,31,8,34100,8800,42900
420100,202110,154,129,25,141900,27500,169400
420110,202110,21,21,0,23100,,23100.0
420120,202110,58,40,18,44000,19800,63800
420125,202110,86,68,18,74800,19800,94600
420127,202110,33,27,6,29700,6600,36300
420130,202110,451,266,185,292600,203500,496100
420140,202110,1316,725,591,799700,650100,1449800
420150,202110,47,37,10,40700,11000,51700
420160,202110,30,28,2,30800,2200,33000
420165,202110,15,10,5,11000,5500,16500
420170,202110,65,39,26,42900,28600,71500
420180,202110,21,18,3,19800,3300,23100
420190,202110,25,22,3,24200,3300,27500
420195,202110,151,69,82,75900,90200,166100
420200,202110,1274,526,748,579700,823900,1403600
420205,202110,99,58,41,63800,45100,108900
420207,202110,129,68,61,74800,67100,141900
420208,202110,19,15,4,16500,4400,20900
420209,202110,14,12,2,13200,2200,15400
420210,202110,545,256,289,282700,319000,601700
420213,202110,49,36,13,39600,14300,53900
420215,202110,26,22,4,24200,4400,28600
420220,202110,58,35,23,38500,25300,63800
420230,202110,895,530,365,584100,401500,985600
420240,202110,2190,1419,771,1564676.66,850300,2414976.66
420243,202110,45,36,9,39600,9900,49500
420245,202110,190,95,95,104500,104500,209000
420250,202110,62,41,21,45100,23100,68200
420253,202110,28,22,6,24200,6600,30800
420257,202110,12,9,3,9900,3300,13200
420260,202110,112,89,23,97900,25300,123200
420270,202110,30,23,7,25300,7700,33000
420280,202110,283,211,72,233200,79200,312400
420285,202110,21,14,7,15400,7700,23100
420287,202110,52,34,18,37400,19800,57200
420290,202110,909,617,292,680900,322300,1003200
420300,202110,1475,1167,308,1283700,338800,1622500
420310,202110,48,33,15,36300,16500,52800
420315,202110,34,27,7,29700,7700,37400
420320,202110,968,458,510,504900,561000,1065900
420325,202110,3,1,2,1100,2200,3300
420330,202110,122,80,42,88000,46200,134200
420340,202110,177,119,58,130900,63800,194700
420350,202110,253,175,78,193600,85800,279400
420360,202110,688,530,158,583000.88,174900,757900.88
420370,202110,130,74,56,81400,61600,143000
420380,202110,1199,824,375,906400,412500,1318900
420390,202110,228,158,70,173800,78100,251900
420395,202110,192,140,52,155100,57200,212300
420400,202110,239,182,57,200200,62700,262900
420410,202110,53,40,13,44000,14300,58300
420415,202110,34,29,5,31900,5500,37400
420417,202110,54,43,11,47300,12100,59400
420419,202110,10,9,1,9900,1100,11000
420420,202110,2774,1713,1061,1886500,1167100,3053600
420425,202110,69,54,15,59400,16500,75900
420430,202110,1100,792,308,872300,338800,1211100
420435,202110,13,11,2,12100,2200,14300
420440,202110,94,67,27,73700,29700,103400
420445,202110,28,27,1,29700,1100,30800
420450,202110,83,41,42,45100,47300,92400
420455,202110,195,150,45,165000,49500,214500
420460,202110,2310,1441,869,1587300,957000,2544300
420470,202110,98,69,29,75900,31900,107800
420475,202110,9,8,1,8800,1100,9900
420480,202110,856,647,209,712800,231000,943800
420490,202110,96,70,26,77000,28600,105600
420500,202110,438,236,202,259600.26,223300,482900.26
420510,202110,23,20,3,22000,3300,25300
420515,202110,29,16,13,17600,14300,31900
420517,202110,8,8,0,8800,,8800.0
420519,202110,0,,,,,0.0
420520,202110,60,47,13,51700,14300,66000
420530,202110,150,98,52,107800,57200,165000
420535,202110,18,16,2,17600,2200,19800
420540,202110,5970,3658,2312,4030675.17,2544300,6574975.17
420543,202110,30,28,2,30800,2200,33000
420545,202110,213,146,67,160600,73700,234300
420550,202110,799,658,141,724900,155100,880000
420555,202110,29,20,9,22000,9900,31900
420560,202110,61,49,12,53900,13200,67100
420570,202110,179,94,85,103400,93500,196900
420580,202110,285,138,147,151800,161700,313500
420590,202110,469,305,164,336600,180400,517000
420600,202110,139,74,65,81400,71500,152900
420610,202110,35,32,3,35200,3300,38500
420620,202110,81,59,22,64900,24200,89100
420630,202110,144,90,54,99000,59400,158400
420640,202110,74,64,10,70400,11000,81400
420650,202110,259,132,127,145200,139700,284900
420660,202110,40,32,8,35200,8800,44000
420665,202110,42,27,15,29700,16500,46200
420670,202110,258,203,55,224400,60500,284900
420675,202110,14,12,2,13200,2200,15400
420680,202110,33,26,7,28600,7700,36300
420690,202110,181,139,42,152900,46200,199100
420700,202110,693,448,245,492800.7,269500,762300.7
420710,202110,147,76,71,83600,78100,161700
420720,202110,100,79,21,86900,23100,110000
420730,202110,665,395,270,436700,297000,733700
420740,202110,53,53,0,58300,,58300.0
420750,202110,483,319,164,352000,180400,532400
420757,202110,17,15,2,16500,2200,18700
420760,202110,38,30,8,33000,8800,41800
420765,202110,80,58,22,63800,24200,88000
420768,202110,55,43,12,47300,13200,60500
420770,202110,72,59,13,64900,14300,79200
420775,202110,36,33,3,36300,3300,39600
420780,202110,201,158,43,173800,47300,221100
420785,202110,21,13,8,14300,8800,23100
420790,202110,150,124,26,136400,28600,165000
420800,202110,64,46,18,50600,19800,70400
420810,202110,259,210,49,232100,53900,286000
420820,202110,2427,1352,1075,1488300.25,1182500.5,2670800.75
420830,202110,638,326,312,359700,343200,702900
420840,202110,142,98,44,107800,48400,156200
420845,202110,420,175,245,192500,269500,462000
420850,202110,265,199,66,218900,72600,291500
420860,202110,57,47,10,51700,11000,62700
420870,202110,129,91,38,100100,41800,141900
420880,202110,185,120,65,132000,71500,203500
420890,202110,930,447,483,491700,531300,1023000
420895,202110,8,8,0,8800,,8800.0
420900,202110,400,319,81,350900,89100,440000
420910,202110,5678,3043,2635,3356101.3,2902900,6259001.3
420915,202110,62,54,8,60500,8800,69300
420917,202110,19,14,5,15400,5500,20900
420920,202110,21,14,7,15400,7700,23100
420930,202110,2995,1897,1098,2088829,1207800.18,3296629.18
420940,202110,582,423,159,468600,174900,643500
420945,202110,10,7,3,7700,3300,11000
420950,202110,52,42,10,46200,11000,57200
420960,202110,109,88,21,96800,23100,119900
420970,202110,279,223,56,245300,61600,306900
420980,202110,21,20,1,22000,1100,23100
420985,202110,54,48,6,52800,6600,59400
420990,202110,81,61,20,67100,22000,89100
421000,202110,49,26,23,28600,25300,53900
421003,202110,40,27,13,29700,14300,44000
421005,202110,8,5,3,5500,3300,8800
421010,202110,801,521,280,574200,309100,883300
421020,202110,24,19,5,20900,5500,26400
421030,202110,108,92,16,101200,17600,118800
421040,202110,66,45,21,49500,23100,72600
421050,202110,335,232,103,256300,113300,369600
421055,202110,19,14,5,15400,5500,20900
421060,202110,99,54,45,59400,49500,108900
421070,202110,38,32,6,35200,6600,41800
421080,202110,38,33,5,36300,5500,41800
421085,202110,19,15,4,16500,4400,20900
421090,202110,34,27,7,29700,7700,37400
421100,202110,116,85,31,93500,34100,127600
421105,202110,172,137,35,150700,38500,189200
421110,202110,113,83,30,91300,33000,124300
421120,202110,172,124,48,136400.92,52800,189200.92
421125,202110,19,12,7,13200,7700,20900
421130,202110,830,503,327,554400,359700,914100
421140,202110,35,24,11,26400,12100,38500
421145,202110,49,38,11,41800,12100,53900
421150,202110,92,71,21,78100,23100,101200
421160,202110,65,41,24,46200,26400,72600
421165,202110,16,13,3,14300,3300,17600
421170,202110,174,146,28,160732,30800,191532
421175,202110,174,117,57,128700,62700,191400
421180,202110,43,30,13,33000,14300,47300
421185,202110,14,11,3,12100,3300,15400
421187,202110,3,1,2,1100,2200,3300
421189,202110,44,31,13,34100,14300,48400
421190,202110,1823,1140,683,1254000,751300.55,2005300.55
421200,202110,93,67,26,73700,28600,102300
421205,202110,27,19,8,20900,8800,29700
421210,202110,176,128,48,140800,53900,194700
421220,202110,250,192,58,211200,63800,275000
421223,202110,46,36,10,40700,11000,51700
421225,202110,70,44,26,48400,28600,77000
421227,202110,77,61,16,67100,17600,84700
421230,202110,63,45,18,49500,19800,69300
421240,202110,16,16,0,17600,,17600.0
421250,202110,377,219,158,240900,173800,414700
421260,202110,21,17,4,18700,4400,23100
421265,202110,2,2,0,2200,,2200.0
421270,202110,51,45,6,49500,6600,56100
421280,202110,360,184,176,203500,194700,398200
421290,202110,324,215,109,236500,119900,356400
421300,202110,25,20,5,22000,5500,27500
421310,202110,52,35,17,38500,18700,57200
421315,202110,33,19,14,20900,15400,36300
421320,202110,132,87,45,95700,49500,145200
421330,202110,108,80,28,88000,30800,118800
421335,202110,41,30,11,33000,12100,45100
421340,202110,238,153,85,168300,93500,261800
421350,202110,186,109,77,119900.39,84700,204600.39
421360,202110,683,480,203,528000,223300,751300
421370,202110,191,139,52,152900,57200,210100
421380,202110,133,104,29,115500,31900,147400
421390,202110,15,9,6,9900,6600,16500
421400,202110,115,95,20,104500,22000,126500
421410,202110,22,19,3,20900,3300,24200
421415,202110,21,18,3,19800,3300,23100
421420,202110,108,94,14,103400,15400,118800
421430,202110,18,13,5,14300,5500,19800
421440,202110,59,52,7,57200,7700,64900
421450,202110,91,75,16,82500,18700.51,101200.51
421460,202110,58,44,14,48400,15400,63800
421470,202110,71,39,32,42900,35200,78100
421480,202110,745,562,183,620400,201300,821700
421490,202110,24,23,1,25300,1100,26400
421500,202110,477,288,189,316800.89,207900,524700.89
421505,202110,26,18,8,19800,8800,28600
421507,202110,32,26,6,28600,6600,35200
421510,202110,71,45,26,49500,28600,78100
421520,202110,53,43,10,47300,11000,58300
421530,202110,49,40,9,44000,9900,53900
421535,202110,18,17,1,18700,1100,19800
421540,202110,52,40,12,44000,13200,57200
421545,202110,85,60,25,66000,27500,93500
421550,202110,285,205,80,225500,88000,313500
421555,202110,18,15,3,16500,3300,19800
421560,202110,8,7,1,7700,1100,8800
421565,202110,118,76,42,83600,46200,129800
421567,202110,31,24,7,26400,7700,34100
421568,202110,45,40,5,44000,5500,49500
421569,202110,12,12,0,13200,,13200.0
421570,202110,214,139,75,152900,82500,235400
421575,202110,26,23,3,25300,3300,28600
421580,202110,708,417,291,458772,320100,778872
421590,202110,19,18,1,19800,1100,20900
421600,202110,151,99,52,108900,57200,166100
421605,202110,112,76,36,83600,39600,123200
421610,202110,163,124,39,136400,42900,179300
421620,202110,1013,573,440,630300,486200,1116500
421625,202110,20,18,2,19800,2200,22000
421630,202110,336,202,134,222200,147400,369600
421635,202110,22,10,12,11000,13200,24200
421640,202110,100,82,18,90200,19800,110000
421650,202110,293,169,124,187000,136400,323400
421660,202110,2414,1450,964,1599400,1062600,2662000
421670,202110,171,121,50,133100,55000,188100
421680,202110,189,171,18,189200,19800,209000
421690,202110,347,240,107,264000,117700,381700
421700,202110,51,35,16,38500,17600,56100
421710,202110,22,21,1,23100,1100,24200
421715,202110,5,4,1,4400,1100,5500
421720,202110,630,432,198,476300,217800,694100
421725,202110,22,8,14,8800,15400,24200
421730,202110,26,19,7,20900,7700,28600
421740,202110,99,36,63,39600,69300,108900
421750,202110,197,143,54,157300,59400,216700
421755,202110,20,18,2,19800,2200,22000
421760,202110,103,69,34,75900,37400,113300
421770,202110,695,441,254,486200,281600,767800
421775,202110,27,17,10,18700,11000,29700
421780,202110,179,142,37,156200,40700,196900
421790,202110,148,126,22,138600,24200,162800
421795,202110,17,13,4,14300,4400,18700
421800,202110,544,331,213,365200,234300,599500
421810,202110,72,56,16,61600,17600,79200
421820,202110,306,195,111,214500.87,122100,336600.87
421825,202110,149,123,26,135300,28600,163900
421830,202110,151,92,59,101200,64900,166100
421835,202110,7,2,5,2200,5500,7700
421840,202110,46,40,6,44000,6600,50600
421850,202110,82,69,13,77000,14300,91300
421860,202110,43,31,12,34100,13200,47300
421870,202110,1033,749,284,825000,312400,1137400
421875,202110,52,42,10,46200,11000,57200
421880,202110,176,121,55,133100,60500,193600
421885,202110,27,19,8,20900,8800,29700
421890,202110,135,96,39,105600,42900.5,148500.5
421895,202110,44,39,5,44000,5500,49500
421900,202110,133,100,33,110000,36300,146300
421910,202110,60,37,23,40700,25300,66000
421915,202110,30,24,6,26400,6600,33000
421917,202110,38,28,10,30800,11000,41800
421920,202110,36,32,4,35200,4400,39600
421930,202110,619,485,134,534600,147400,682000
421935,202110,44,36,8,39600,8800,48400
421940,202110,49,41,8,46200,8800,55000
421950,202110,853,562,291,618200,320100,938300
421960,202110,40,34,6,37400,6600,44000
421970,202110,323,211,112,232100,123200,355300
421985,202110,19,12,7,13200,7700,20900
422000,202110,1,0,1,,1100,1100.0
430003,202110,190,54,136,59400,149600,209000
430005,202110,36,26,10,28600,11000,39600
430010,202110,262,189,73,207900,80300,288200
430020,202110,147,98,49,107800,53900,161700
430030,202110,121,101,20,111100,22000,133100
430040,202110,2926,1721,1205,1897500,1325500,3223000
430045,202110,70,59,11,64900,12100,77000
430047,202110,6,5,1,5500,1100,6600
430050,202110,88,74,14,81400,15400,96800
430055,202110,12,11,1,12100,1100,13200
430057,202110,5,4,1,4400,1100,5500
430060,202110,3891,2255,1636,2482700,1799600,4282300
430063,202110,57,46,11,50600,12100,62700
430064,202110,160,125,35,137500,38500,176000
430066,202110,5,2,3,2200,3300,5500
430070,202110,41,30,11,33000,12100,45100
430080,202110,73,46,27,50600,29700,80300
430085,202110,28,12,16,13200,17600,30800
430087,202110,23,16,7,17600,7700,25300
430090,202110,60,51,9,56100,9900,66000
430100,202110,131,87,44,95700,48400,144100
430105,202110,148,83,65,91300,71500,162800
430107,202110,19,13,6,14300,6600,20900
430110,202110,492,268,224,294800,246400,541200
430120,202110,165,149,16,163900,17600,181500
430130,202110,785,476,309,523600,341000,864600
430140,202110,131,120,11,132000,12100,144100
430150,202110,105,65,40,71500,44000,115500
430155,202110,28,24,4,26400,4400,30800
430160,202110,3586,2046,1540,2251700,1696200,3947900
430163,202110,394,173,221,190300,243100,433400
430165,202110,30,19,11,20900,12100,33000
430170,202110,86,72,14,79200,15400,94600
430175,202110,82,62,20,68200,22000,90200
430180,202110,106,89,17,97900,18700,116600
430185,202110,27,17,10,18700,11000,29700
430187,202110,53,28,25,30800,27500,58300
430190,202110,225,116,109,127600,119900,247500
430192,202110,16,12,4,13200,4400,17600
430195,202110,17,11,6,12100,6600,18700
430200,202110,154,130,24,143000,26400,169400
430205,202110,20,20,0,22000,,22000.0
430210,202110,685,514,171,566500,188100,754600
430215,202110,10,9,1,9900,1100,11000
430220,202110,73,49,24,53900,26400,80300
430222,202110,12,4,8,4400,8800,13200
430223,202110,18,12,6,13200,6600,19800
430225,202110,2,1,1,1100,1100,2200
430230,202110,322,197,125,216700,137500,354200
430235,202110,47,34,13,37400,14300,51700
430237,202110,22,16,6,17600,6600,24200
430240,202110,109,76,33,83600,36300,119900
430245,202110,69,55,14,60500,15400,75900
430250,202110,185,105,80,115500,88000,203500
430258,202110,8,7,1,7700,1100,8800
430260,202110,33,28,5,30800,5500,36300
430265,202110,34,29,5,31900,5500,37400
430270,202110,522,379,143,416900,157300,574200
430280,202110,1052,616,436,678700,479600,1158300
430290,202110,423,217,206,238700,227700,466400
430300,202110,2097,1124,973,1238600.77,1072500,2311100.77
430310,202110,2025,977,1048,1079100,1153900.7,2233000.7
430320,202110,55,47,8,51700,8800,60500
430330,202110,96,83,13,92400,14300,106700
430340,202110,67,53,14,58300,15400,73700
430350,202110,1656,1087,569,1195700.9,625900,1821600.9
430355,202110,18,17,1,18700,1100,19800
430360,202110,90,42,48,46200,52800,99000
430367,202110,36,27,9,29700,9900,39600
430370,202110,56,51,5,56100,5500,61600
430380,202110,119,90,29,99000,31900,130900
430390,202110,574,354,220,390500,243100,633600
430400,202110,262,185,77,203500,84700,288200
430410,202110,59,47,12,51700,13200,64900
430420,202110,508,311,197,342100,216700,558800
430430,202110,56,54,2,58667.4,2200,60867.4
430435,202110,138,105,33,115500,36300,151800
430440,202110,520,323,197,355300,216700,572000
430450,202110,1151,936,215,1031800,238700,1270500
430460,202110,5568,2864,2704,3151500,2975501.63,6127001.63
430461,202110,16,14,2,15400,2200,17600
430462,202110,4,2,2,2200,2200,4400
430463,202110,1136,613,523,677600,575300,1252900
430465,202110,24,13,11,14300,12100,26400
430466,202110,641,447,194,492800,214500,707300
430467,202110,116,67,49,73700,55000,128700
430468,202110,129,74,55,81400,60500,141900
430469,202110,20,15,5,16500,5500,22000
430470,202110,1129,619,510,681227.5,562100,1243327.5
430471,202110,66,42,24,46200,26400,72600
430480,202110,117,78,39,85800,42900,128700
430485,202110,8,8,0,8800,,8800.0
430490,202110,75,59,16,64900,17600,82500
430495,202110,33,25,8,27500,8800,36300
430500,202110,187,125,62,138600,68200,206800
430510,202110,3632,2348,1284,2587200.67,1414600,4001800.67
430511,202110,16,16,0,17600,,17600.0
430512,202110,144,97,47,106700,51700,158400
430513,202110,51,40,11,44000,12100,56100
430515,202110,26,25,1,27500,1100,28600
430517,202110,173,145,28,159500,30800,190300
430520,202110,331,233,98,256300,107800,364100
430530,202110,81,44,37,48400,40700,89100
430535,202110,446,297,149,326700,163900,490600
430537,202110,11,11,0,12100,,12100.0
430540,202110,78,52,26,57200,28600,85800
430543,202110,376,116,260,127600,286000,413600
430544,202110,46,43,3,47300,3300,50600
430545,202110,382,173,209,190300,229900,420200
430550,202110,40,31,9,34100,9900,44000
430558,202110,1,1,0,1100,,1100.0
430560,202110,54,31,23,34100,25300,59400
430570,202110,113,47,66,51700,72600,124300
430580,202110,123,97,26,106700,28600,135300
430583,202110,15,15,0,16500,,16500.0
430585,202110,13,7,6,8800,6600,15400
430587,202110,14,8,6,8800,6600,15400
430590,202110,154,123,31,135300,34100,169400
430593,202110,2,2,0,2200,,2200.0
430595,202110,17,13,4,14300,4400,18700
430597,202110,42,22,20,24200,22000,46200
430600,202110,219,167,52,183700,57200,240900
430605,202110,167,98,69,107800,75900,183700
430607,202110,30,24,6,26400,6600,33000
430610,202110,1718,799,919,878900,1013100,1892000
430613,202110,5,5,0,5500,,5500.0
430620,202110,110,81,29,89100,31900,121000
430630,202110,46,39,7,42900,7700,50600
430632,202110,32,27,5,29700,5500,35200
430635,202110,39,33,6,36300,6600,42900
430637,202110,67,33,34,36300,37400,73700
430640,202110,174,96,78,105600,85800,191400
430642,202110,17,15,2,16500,2200,18700
430645,202110,29,25,4,27500,4400,31900
430650,202110,247,196,51,215600,56100,271700
430655,202110,5,4,1,4400,1100,5500
430660,202110,963,468,495,515900,544500,1060400
430670,202110,74,51,23,56100,25300,81400
430673,202110,77,46,31,50600,34100,84700
430675,202110,8,6,2,6600,2200,8800
430676,202110,578,342,236,377300,259600,636900
430680,202110,235,155,80,171600,88000,259600
430690,202110,516,310,206,342100,226600.63,568700.63
430692,202110,9,7,2,7700,2200,9900
430693,202110,136,85,51,93500,56100,149600
430695,202110,64,53,11,58300,12100,70400
430697,202110,63,38,25,41800,27500,69300
430700,202110,1418,959,459,1054900,504900,1559800
430705,202110,30,27,3,29700,3300,33000
430710,202110,259,161,98,177100,107800,284900
430720,202110,109,92,17,101200,18700,119900
430730,202110,140,118,22,129800,24200,154000
430740,202110,76,49,27,55000,29700,84700
430745,202110,32,21,11,23100,12100,35200
430750,202110,335,217,118,238700,129800,368500
430755,202110,89,47,42,51700,46200,97900
430760,202110,385,210,175,231000,192500,423500
430770,202110,1547,792,755,871200,831600,1702800
430780,202110,314,194,120,213400,133100,346500
430781,202110,24,22,2,24200,2200,26400
430783,202110,64,50,14,55000,15400,70400
430786,202110,5,3,2,3300,2200,5500
430790,202110,529,336,193,371800,212300,584100
430800,202110,152,119,33,130900.01,36300,167200.01
430805,202110,38,31,7,34100,7700,41800
430807,202110,56,32,24,35200,27500,62700
430810,202110,72,46,26,50600,28600,79200
430820,202110,145,87,58,95700,63800,159500
430825,202110,11,9,2,9900,2200,12100
430830,202110,241,223,18,246400,19800,266200
430840,202110,137,93,44,102300,48400,150700
430843,202110,7,5,2,5500,2200,7700
430845,202110,74,40,34,44000,37400,81400
430850,202110,589,419,170,460900,188100,649000
430860,202110,149,93,56,102300,61600,163900
430865,202110,77,42,35,46200,39600,85800
430870,202110,77,62,15,68200,16500,84700
430880,202110,150,109,41,119900,45100,165000
430885,202110,10,9,1,9900,2200,12100
430890,202110,333,200,133,220000,146300,366300
430900,202110,524,356,168,392700,185900,578600
430905,202110,117,50,67,55000,73700,128700
430910,202110,277,152,125,167200,137500,304700
430912,202110,4,4,0,4400,,4400.0
430915,202110,35,32,3,35200,3300,38500
430920,202110,4398,2295,2103,2530000,2316600,4846600
430925,202110,5,4,1,4400,1100,5500
430930,202110,2048,1172,876,1290300,965800,2256100
430940,202110,252,162,90,178200,99000,277200
430950,202110,149,123,26,135300,28600,163900
430955,202110,26,15,11,16500,12100,28600
430957,202110,23,20,3,22000,3300,25300
430960,202110,243,158,85,174900,93500,268400
430965,202110,108,71,37,78100,40700,118800
430970,202110,92,72,20,80300,22000,102300
430975,202110,44,38,6,41800,6600,48400
430980,202110,49,30,19,33000,20900,53900
430990,202110,99,75,24,82500,26400,108900
430995,202110,111,103,8,113300,8800,122100
431000,202110,286,142,144,156200.6,158400,314600.6
431010,202110,353,197,156,216700,171600,388300
431020,202110,1857,1075,782,1182500,861300,2043800
431030,202110,37,29,8,31900,8800,40700
431033,202110,427,193,234,213400,258500,471900
431036,202110,12,6,6,6600,6600,13200
431040,202110,142,91,51,100100,56100,156200
431041,202110,38,23,15,25300,16500,41800
431043,202110,40,22,18,24200,19800,44000
431046,202110,13,10,3,11000,3300,14300
431050,202110,205,130,75,143000,82500,225500
431053,202110,69,37,32,40700,35200,75900
431055,202110,68,46,22,50600,24200,74800
431057,202110,18,18,0,19800,,19800.0
431060,202110,1584,1017,567,1122000.31,624800,1746800.31
431065,202110,16,9,7,9900,7700,17600
431070,202110,60,55,5,60500,5500,66000
431075,202110,7,7,0,7700,,7700.0
431080,202110,127,75,52,82500,57200,139700
431085,202110,33,30,3,33000,3300,36300
431087,202110,12,10,2,11000,2200,13200
431090,202110,51,38,13,41800,14300,56100
431100,202110,1231,724,507,799700,559900,1359600
431110,202110,224,137,87,151800,95700,247500
431112,202110,23,16,7,17600,7700,25300
431113,202110,30,22,8,24200,8800,33000
431115,202110,159,113,46,124300,50600,174900
431120,202110,595,341,254,375100,279400,654500
431123,202110,5,5,0,5500,,5500.0
431125,202110,97,83,14,91300,15400,106700
431127,202110,8,5,3,5500,3300,8800
431130,202110,712,467,245,513700.53,269500,783200.53
431140,202110,776,539,237,592900,261800,854700
431142,202110,20,18,2,20900.55,2200,23100.55
431150,202110,196,146,50,160600,55000,215600
431160,202110,45,42,3,46200,3300,49500
431162,202110,2,2,0,2200,,2200.0
431164,202110,5,5,0,5500,,5500.0
431170,202110,113,84,29,92400,31900,124300
431171,202110,73,41,32,45100,35200,80300
431173,202110,1,1,0,1100,,1100.0
431175,202110,204,104,100,114400,110000,224400
431177,202110,91,64,27,70400,29700,100100
431179,202110,16,12,4,13200,4400,17600
431180,202110,410,257,153,282700,170500,453200
431190,202110,75,55,20,60500,22000,82500
431198,202110,68,47,21,51700,23100,74800
431200,202110,21,17,4,18700,4400,23100
431205,202110,22,20,2,22000,2200,24200
431210,202110,99,62,37,68200,40700,108900
431213,202110,31,25,6,27500,6600,34100
431215,202110,22,19,3,20900,3300,24200
431217,202110,7,6,1,6600,1100,7700
431220,202110,67,57,10,62700,11000,73700
431225,202110,164,106,58,116600,63800,180400
431230,202110,98,86,12,94600,13200,107800
431235,202110,5,5,0,5500,,5500.0
431237,202110,8,7,1,7700,1100,8800
431238,202110,12,9,3,9900,3300,13200
431240,202110,1060,648,412,712800,453200,1166000
431242,202110,39,38,1,41800,1100,42900
431244,202110,17,13,4,14300,4400,18700
431245,202110,50,37,13,40700,14300,55000
431247,202110,10,6,4,6600,4400,11000
431250,202110,285,140,145,154000,160600,314600
431260,202110,54,45,9,49500,9900,59400
431261,202110,18,12,6,13200,6600,19800
431262,202110,16,14,2,15400,2200,17600
431265,202110,155,83,72,91300,79200,170500
431267,202110,18,16,2,17600,2200,19800
431270,202110,330,257,73,282700,80300,363000
431275,202110,40,35,5,38500,5500,44000
431280,202110,18,14,4,15400,4400,19800
431290,202110,17,15,2,16500,2200,18700
431295,202110,2,1,1,1100,1100,2200
431300,202110,20,18,2,20900,2200,23100
431301,202110,6,6,0,6600,,6600.0
431303,202110,61,38,23,41800,25300,67100
431306,202110,238,124,114,137304.2,126500,263804.2
431308,202110,7,5,2,5500,2200,7700
431310,202110,64,53,11,58300,12100,70400
431320,202110,161,94,67,103400,73700,177100
431330,202110,185,115,70,126500,79200,205700
431333,202110,29,23,6,25300,6600,31900
431335,202110,6,3,3,3300,3300,6600
431337,202110,391,182,209,200200,229900,430100
431339,202110,21,16,5,17600,5500,23100
431340,202110,3088,1663,1425,1832513.1,1571900,3404413.1
431342,202110,36,25,11,27500,12100,39600
431344,202110,18,18,0,19800,,19800.0
431346,202110,4,4,0,4400,,4400.0
431349,202110,35,31,4,34100,4400,38500
431350,202110,964,525,439,577500,482900,1060400
431360,202110,52,40,12,44000,13200,57200
431365,202110,346,145,201,159500,221100,380600
431370,202110,1195,683,512,751300,564300,1315600
431380,202110,97,86,11,94600,12100,106700
431390,202110,499,269,230,295900,253000,548900
431395,202110,319,134,185,147400,203500,350900
431400,202110,40,25,15,27500,16500,44000
431402,202110,103,73,30,80300,33000,113300
431403,202110,23,14,9,15400,9900,25300
431405,202110,708,390,318,429000,349800,778800
431406,202110,33,26,7,28600,7700,36300
431407,202110,51,40,11,44000,12100,56100
431410,202110,3385,2045,1340,2250600,1475100,3725700
431413,202110,16,13,3,14300,3300,17600
431415,202110,65,44,21,48400,23100,71500
431417,202110,26,11,15,12100,16500,28600
431420,202110,347,235,112,258500,124300,382800
431430,202110,58,29,29,31900,31900,63800
431440,202110,8973,6106,2867,6725400,3159250.6,9884650.6
431442,202110,27,14,13,15400,14300,29700
431445,202110,30,28,2,30800,2200,33000
431446,202110,4,3,1,3300,1100,4400
431447,202110,82,58,24,63800,26400,90200
431449,202110,50,41,9,45100,9900,55000
431450,202110,406,267,139,293700,152900,446600
431454,202110,13,7,6,7700,6600,14300
431455,202110,46,36,10,39600,11000,50600
431460,202110,498,341,157,375100,172700,547800
431470,202110,123,91,32,100100,35200,135300
431475,202110,10,8,2,8800,2200,11000
431477,202110,35,20,15,22000,16500,38500
431478,202110,9,8,1,8800,1100,9900
431480,202110,560,328,232,360800,256300,617100
431490,202110,28878,15969,12909,17589986,14216400.38,31806386.38
431500,202110,80,63,17,69300,18700,88000
431505,202110,28,18,10,19800,11000,30800
431507,202110,8,7,1,7700,1100,8800
431510,202110,231,169,62,185900,68200,254100
431513,202110,21,19,2,20900,2200,23100
431514,202110,4,3,1,3300,1100,4400
431515,202110,79,66,13,72600,14300,86900
431517,202110,6,3,3,3300,3300,6600
431520,202110,38,34,4,37400,4400,41800
431530,202110,1418,626,792,690800,871200,1562000
431531,202110,20,18,2,19800,2200,22000
431532,202110,37,28,9,30800,9900,40700
431535,202110,28,15,13,16500,14300,30800
431540,202110,139,114,25,126500,27500,154000
431545,202110,11,9,2,9900,2200,12100
431550,202110,360,195,165,214500,181500,396000
431555,202110,10,10,0,11000,,11000.0
431560,202110,4636,3087,1549,3397900,1705000,5102900
431570,202110,833,428,405,470800,445500,916300
431575,202110,45,25,20,27500,22000,49500
431580,202110,88,58,30,63800,33000,96800
431590,202110,137,113,24,124300,26400,150700
431595,202110,19,16,3,17600,3300,20900
431600,202110,254,148,106,162800,116600,279400
431610,202110,113,83,30,91300,33000,124300
431620,202110,42,35,7,38500,7700,46200
431630,202110,127,103,24,114400,26400,140800
431640,202110,1316,815,501,896500,552200,1448700
431642,202110,35,32,3,35200,3300,38500
431643,202110,45,18,27,19800,29700,49500
431645,202110,313,181,132,199100,145200,344300
431647,202110,9,8,1,8800,1100,9900
431650,202110,31,17,14,18700,15400,34100
431660,202110,270,167,103,183700,113300,297000
431670,202110,225,100,125,110000,137500,247500
431673,202110,10,8,2,8800,2200,11000
431675,202110,25,20,5,22000,5500,27500
431680,202110,1120,820,300,903100,330000,1233100
431690,202110,4826,2858,1968,3146001.93,2165900,5311901.93
431695,202110,20,14,6,15400,6600,22000
431697,202110,2,1,1,1100,1100,2200
431700,202110,187,139,48,152900,52800,205700
431710,202110,4038,1740,2298,1915100,2530000,4445100
431720,202110,1298,795,503,875050,553300,1428350
431725,202110,1,1,0,1100,,1100.0
431730,202110,1146,764,382,840400.36,420200,1260600.36
431740,202110,1331,641,690,705100,761200,1466300
431750,202110,1819,1176,643,1294700.32,707300,2002000.32
431755,202110,6,5,1,5500,1100,6600
431760,202110,987,610,377,671000,415800,1086800
431770,202110,420,288,132,316800,145200,462000
431775,202110,28,21,7,23100,7700,30800
431780,202110,548,327,221,359700,243100,602800
431790,202110,156,124,32,136400,37400,173800
431795,202110,13,10,3,11000,3300,14300
431800,202110,3142,1632,1510,1796300.37,1663200,3459500.37
431805,202110,19,17,2,18700,2200,20900
431810,202110,602,392,210,432300,232100,664400
431820,202110,334,196,138,216700,151800,368500
431830,202110,2268,1364,904,1502600,997700,2500300
431840,202110,472,305,167,335500,183700,519200
431842,202110,35,28,7,30800,7700,38500
431843,202110,11,8,3,8800,3300,12100
431844,202110,17,12,5,13200,5500,18700
431845,202110,25,23,2,25300,2200,27500
431846,202110,25,22,3,24200,3300,27500
431848,202110,14,12,2,13200,2200,15400
431849,202110,4,4,0,4400,,4400.0
431850,202110,754,591,163,651200,179300,830500
431860,202110,122,79,43,86900,47300,134200
431861,202110,6,2,4,2200,4400,6600
431862,202110,56,39,17,42900,18700,61600
431870,202110,3551,1995,1556,2194500,1713800,3908300
431880,202110,947,674,273,741400,300300,1041700
431890,202110,1273,737,536,811800,591800,1403600
431900,202110,191,130,61,144100,67100,211200
431910,202110,50,37,13,40700,14300,55000
431912,202110,50,31,19,34100,20900,55000
431915,202110,141,108,33,118800,36300,155100
431920,202110,154,112,42,123200,46200,169400
431930,202110,81,69,12,75900,13200,89100
431935,202110,2,2,0,2200,,2200.0
431936,202110,3,3,0,3300,,3300.0
431937,202110,20,15,5,16500,5500,22000
431940,202110,462,313,149,344300,165000,509300
431950,202110,473,301,172,331100,189200,520300
431960,202110,733,393,340,432300,374000,806300
431970,202110,68,63,5,69300,5500,74800
431971,202110,5,3,2,3300,2200,5500
431973,202110,18,15,3,16500,3300,19800
431975,202110,9,8,1,8800,1100,9900
431980,202110,204,121,83,134200,91300,225500
431990,202110,1111,584,527,643428.5,581900,1225328.5
432000,202110,1817,937,880,1032900,969100,2002000
432010,202110,263,179,84,196900,92400,289300
432020,202110,180,148,32,162800,35200,198000
432023,202110,15,13,2,14300,2200,16500
432026,202110,58,52,6,57200,6600,63800
432030,202110,61,29,32,31900,35200,67100
432032,202110,15,11,4,12100,4400,16500
432035,202110,59,45,14,49500,15400,64900
432040,202110,85,56,29,62700,31900,94600
432045,202110,2,2,0,2200,,2200.0
432050,202110,82,49,33,53900,36300,90200
432055,202110,127,93,34,102300,37400,139700
432057,202110,6,4,2,4400,2200,6600
432060,202110,34,30,4,33000,4400,37400
432065,202110,31,28,3,30800,3300,34100
432067,202110,85,78,7,85800,8800,94600
432070,202110,381,296,85,325875,93500,419375
432080,202110,827,578,249,635800,273900,909700
432085,202110,7,5,2,5500,2200,7700
432090,202110,261,175,86,192500,94600,287100
432100,202110,171,111,60,122100,66000,188100
432110,202110,543,358,185,393800,203500,597300
432120,202110,990,559,431,614900,475200,1090100
432130,202110,486,342,144,377593.33,158400,535993.33
432132,202110,24,21,3,23100,3300,26400
432135,202110,79,64,15,70400,16500,86900
432140,202110,263,200,63,220000,69300,289300
432143,202110,214,128,86,140800,94600,235400
432145,202110,272,190,82,210100,90200,300300
432146,202110,13,12,1,13200,1100,14300
432147,202110,111,57,54,62700,59400,122100
432149,202110,15,9,6,9900,6600,16500
432150,202110,966,595,371,654500,409200,1063700
432160,202110,1594,812,782,893200.5,860200,1753400.5
432162,202110,4,2,2,2200,2200,4400
432163,202110,17,12,5,13200,5500,18700
432166,202110,128,95,33,104775,36300,141075
432170,202110,223,113,110,124300,121000,245300
432180,202110,552,338,214,371800,235400,607200
432183,202110,10,8,2,8800,2200,11000
432185,202110,75,62,13,68200,14300,82500
432190,202110,501,295,206,324500,226600,551100
432195,202110,93,77,16,84700,17600,102300
432200,202110,401,248,153,272800,168300,441100
432210,202110,112,69,43,78100,47300,125400
432215,202110,36,32,4,35200,4400,39600
432218,202110,20,20,0,22000,,22000.0
432220,202110,650,333,317,367400,348700,716100
432225,202110,18,13,5,14300,5500,19800
432230,202110,129,83,46,91300,50600,141900
432232,202110,20,17,3,18700,3300,22000
432234,202110,4,2,2,2200,2200,4400
432235,202110,3,2,1,2200,1100,3300
432237,202110,24,15,9,16500,9900,26400
432240,202110,4403,2450,1953,2696100,2153800,4849900
432250,202110,1119,731,388,805200,426800,1232000
432252,202110,49,48,1,52800,1100,53900
432253,202110,57,45,12,49500,13200,62700
432254,202110,29,12,17,13200,18700,31900
432255,202110,13,11,2,12100,2200,14300
432260,202110,837,666,171,734800,188100,922900
432270,202110,218,163,55,179300,60500,239800
432280,202110,141,105,36,115500,39600,155100
432285,202110,1,1,0,1100,,1100.0
432290,202110,59,51,8,56100,8800,64900
432300,202110,4819,2553,2266,2808228.5,2493700.61,5301929.11
432310,202110,127,104,23,116600,25300,141900
432320,202110,22,17,5,18700,5500,24200
432330,202110,16,10,6,11000,7700,18700
432335,202110,8,6,2,6600,2200,8800
432340,202110,38,31,7,34100,7700,41800
432345,202110,107,72,35,79200,38500,117700
432350,202110,20,19,1,20900,1100,22000
432360,202110,5,4,1,4400,1100,5500
432370,202110,26,25,1,27500,1100,28600
432375,202110,27,25,2,27500,2200,29700
432377,202110,6,6,0,6600,,6600.0
432380,202110,180,75,105,82500,115500,198000
500020,202110,259,134,125,147400,137500,284900
500025,202110,138,69,69,77000,75900,152900
500060,202110,1460,915,545,1006500,599500,1606000
500070,202110,750,353,397,389400,436700,826100
500080,202110,137,107,30,117700,33000,150700
500085,202110,132,104,28,114400,30800,145200
500090,202110,368,168,200,185900,220000,405900
500100,202110,708,371,337,408100,370700,778800
500110,202110,2269,1060,1209,1167100,1331000,2498100
500124,202110,269,146,123,160600,135300,295900
500150,202110,337,136,201,149600,221100,370700
500190,202110,514,342,172,378400,189200,567600
500200,202110,199,168,31,184800,34100,218900
500210,202110,1619,539,1080,592900,1188000,1780900
500215,202110,207,120,87,132000,96800,228800
500220,202110,722,463,259,510400.92,284900,795300.92
500230,202110,235,141,94,155100,103400,258500
500240,202110,642,430,212,473000,233200,706200
500260,202110,581,220,361,242000,397100,639100
500270,202110,29957,12743,17214,14039722.3,18947500,32987222.3
500280,202110,197,65,132,71500,145200,216700
500290,202110,1168,719,449,790900,496100,1287000
500295,202110,455,292,163,321200,179300,500500
500310,202110,95,33,62,36300,68200,104500
500315,202110,813,448,365,492800,402600,895400
500320,202110,3642,1742,1900,1916200.84,2090000,4006200.84
500325,202110,922,508,414,558800,455400.72,1014200.72
500330,202110,1503,698,805,767780.2,887700,1655480.2
500345,202110,311,233,78,256300,85800,342100
500348,202110,248,148,100,162800,110000,272800
500350,202110,107,51,56,56100,61600,117700
500370,202110,5698,2540,3158,2795100,3476000,6271100
500375,202110,351,236,115,259600,127600,387200
500380,202110,593,335,258,368500,284900,653400
500390,202110,71,34,37,37400,40700,78100
500400,202110,209,134,75,148500,82500,231000
500410,202110,518,217,301,238700,334400,573100
500430,202110,536,375,161,412500,177100,589600
500440,202110,209,111,98,123200,107800,231000
500450,202110,418,174,244,191400.26,268400,459800.26
500460,202110,265,144,121,158400,134200,292600
500470,202110,428,325,103,358600,113300,471900
500480,202110,103,60,43,66000,47300,113300
500490,202110,98,44,54,49500,59400,108900
500500,202110,1427,531,896,584100,987800,1571900
500510,202110,43,36,7,39600,7700,47300
500515,202110,96,67,29,73700,31900,105600
500520,202110,301,157,144,172700,158400,331100
500525,202110,93,50,43,55000,47300,102300
500540,202110,887,388,499,427900,551100,979000
500560,202110,922,514,408,565400,448800,1014200
500568,202110,1005,539,466,592900,512600,1105500
500570,202110,1172,672,500,739200,551100,1290300
500580,202110,325,168,157,184800,172700,357500
500600,202110,340,163,177,179300,194700,374000
500620,202110,938,648,290,713900.5,319000,1032900.5
500625,202110,78,60,18,66000,19800,85800
500627,202110,40,18,22,19800,24200,44000
500630,202110,1560,883,677,973500.63,744700,1718200.63
500635,202110,526,314,212,345400,233200,578600
500640,202110,365,202,163,222200,180400,402600
500660,202110,5719,2040,3679,2246200,4046900,6293100
500690,202110,615,215,400,236500,441100,677600
500710,202110,398,195,203,216700,224400,441100
500720,202110,924,509,415,559900,456500,1016400
500730,202110,169,102,67,112200,73700,185900
500740,202110,909,365,544,401500,598400,999900
500750,202110,163,53,110,58300,122100,180400
500755,202110,114,87,27,95700,29700,125400
500769,202110,753,408,345,449900,379500,829400
500770,202110,431,236,195,259600,214500,474100
500780,202110,136,91,45,101200,49500,150700
500790,202110,1040,509,531,561000,586300,1147300
500793,202110,295,149,146,165000,160600,325600
500795,202110,169,110,59,121000,64900,185900
500797,202110,49,32,17,35200,18700,53900
500800,202110,429,185,244,203500,268400,471900
500830,202110,2219,1205,1014,1328800,1117600,2446400
500840,202110,125,95,30,104500,33000,137500
510010,202110,166,90,76,100100,83600,183700
510020,202110,528,230,298,253000,330000,583000
510025,202110,1644,908,736,1001000.67,809600,1810600.67
510030,202110,680,337,343,371800,378400,750200
510035,202110,130,70,60,77000,66000,143000
510040,202110,412,193,219,212300,240900,453200
510050,202110,356,193,163,212300,179300.3,391600.3
510060,202110,123,60,63,66000,69300,135300
510080,202110,240,91,149,101200,163900,265100
510100,202110,66,28,38,30800,41800,72600
510120,202110,31,18,13,19800,14300,34100
510125,202110,374,224,150,247500,165000,412500
510130,202110,541,326,215,358600,236500,595100
510140,202110,442,139,303,154000,333300,487300
510160,202110,97,32,65,35200,71500,106700
510170,202110,749,454,295,499400,324500,823900
510180,202110,2911,1346,1565,1481700,1721500,3203200
510185,202110,22,12,10,13200,11000,24200
510190,202110,238,82,156,90200,171600,261800
510250,202110,2593,1562,1031,1721500,1136300,2857800
510260,202110,173,125,48,137500,53900,191400
510263,202110,466,255,211,280500,232100,512600
510267,202110,637,352,285,387200,314600,701800
510268,202110,61,27,34,29700,38500,68200
510269,202110,81,35,46,38500,50600,89100
510270,202110,383,185,198,204600,218900,423500
510279,202110,205,156,49,171600,53900,225500
510285,202110,178,72,106,79200,116600,195800
510300,202110,511,265,246,291500,270600,562100
510305,202110,202,89,113,97900,124300,222200
510310,202110,109,54,55,59400,60500,119900
510320,202110,821,508,313,558800,344300,903100
510325,202110,422,170,252,187000,277200,464200
510330,202110,429,234,195,257400,214500,471900
510335,202110,650,381,269,419100,298100,717200
510336,202110,54,37,17,40700,18700,59400
510337,202110,101,45,56,49500,61600,111100
510340,202110,17464,7745,9719,8523900.63,10698600.1,19222500.73
510343,202110,61,44,17,48400,18700,67100
510345,202110,150,93,57,102300,62700,165000
510350,202110,654,346,308,380600,338800,719400
510360,202110,211,132,79,145200,86900,232100
510370,202110,153,69,84,77000,92400,169400
510380,202110,78,59,19,64900,20900,85800
510385,202110,59,27,32,29700,35200,64900
510390,202110,102,44,58,48400,63800,112200
510395,202110,47,33,14,36300,15400,51700
510410,202110,733,462,271,508200,298100,806300
510420,202110,556,263,293,289300,322300,611600
510450,202110,48,24,24,26400,26400,52800
510452,202110,53,22,31,24200,34100,58300
510454,202110,50,23,27,25300,29700,55000
510455,202110,131,76,55,83600,60500,144100
510460,202110,183,84,99,92400,110000,202400
510480,202110,705,421,284,463100,312400,775500
510490,202110,340,168,172,187000,189200,376200
510500,202110,231,172,59,190300,66000,256300
510510,202110,794,454,340,499400,374000,873400
510515,202110,1242,637,605,701800,666600,1368400
510517,202110,272,123,149,135300,165000,300300
510520,202110,213,141,72,155100,79200,234300
510523,202110,104,81,23,90126.66,25300,115426.66
510525,202110,836,493,343,542300,378400,920700
510530,202110,19,12,7,13200,7700,20900
510550,202110,238,107,131,117700,144100,261800
510558,202110,298,145,153,159500,168300,327800
510560,202110,399,224,175,246400,192500,438900
510562,202110,634,454,180,500500,198000,698500
510590,202110,732,372,360,409200,396000,805200
510600,202110,216,112,104,123200,115500,238700
510610,202110,228,91,137,100100,150700,250800
510615,202110,187,87,100,95700,110000,205700
510617,202110,26,12,14,13200,15400,28600
510618,202110,121,59,62,64900,68200,133100
510619,202110,89,64,25,70400,27500,97900
510620,202110,160,89,71,97900,78100,176000
510621,202110,174,111,63,122100,70400,192500
510622,202110,477,265,212,293700,233200,526900
510623,202110,294,197,97,216700,107800,324500
510624,202110,88,48,40,53900,44000,97900
510625,202110,511,322,189,354200,207900.63,562100.63
510626,202110,114,66,48,72600,52800,125400
510627,202110,90,62,28,68200,30800,99000
510628,202110,156,93,63,102300,69300,171600
510629,202110,275,166,109,182600,121019.8,303619.8
510630,202110,444,218,226,239800,248600,488400
510631,202110,13,5,8,5500,8800,14300
510637,202110,351,198,153,217800,168300,386100
510642,202110,1035,547,488,601700,536800,1138500
510645,202110,7,1,6,1100,6600,7700
510650,202110,1344,875,469,962500,515900,1478400
510665,202110,80,32,48,35200,52800,88000
510670,202110,58,31,27,34100,29700,63800
510675,202110,1119,709,410,781000,451000,1232000
510677,202110,346,181,165,199100,181500,380600
510680,202110,98,57,41,62700,45100,107800
510682,202110,191,96,95,105600,104500,210100
510685,202110,54,40,14,44000,15400,59400
510700,202110,560,316,244,348700,268400,617100
510704,202110,1174,604,570,665500,627000,1292500
510706,202110,142,72,70,79200,77000,156200
510710,202110,409,281,128,309100,140800,449900
510715,202110,56,40,16,44000,17600,61600
510718,202110,229,112,117,123200,128700,251900
510719,202110,45,17,28,18700,30800,49500
510720,202110,185,130,55,143550,60500,204050
510724,202110,83,31,52,34100,57200,91300
510726,202110,61,30,31,33000,34100,67100
510729,202110,19,8,11,8800,12100,20900
510730,202110,467,256,211,281600,232100,513700
510735,202110,114,45,69,50600,75900,126500
510740,202110,21,11,10,12100,11000,23100
510757,202110,26,20,6,22000,6600,28600
510760,202110,7224,3632,3592,4000700,3956700,7957400
510770,202110,677,317,360,348700,396000,744700
510774,202110,18,6,12,6600,13200,19800
510775,202110,112,86,26,94600,28600,123200
510776,202110,34,11,23,12100,25300,37400
510777,202110,196,83,113,91300,124300,215600
510779,202110,37,20,17,22000,18700,40700
510780,202110,264,147,117,161700,128700,290400
510785,202110,368,202,166,222200,182600,404800
510787,202110,183,85,98,93500,107800,201300
510788,202110,6,1,5,1100,5500,6600
510790,202110,2532,1303,1229,1435551,1353000,2788551
510792,202110,1126,621,505,685300,555500.54,1240800.54
510794,202110,111,60,51,67100,56100,123200
510795,202110,2234,1285,949,1416800.11,1046100,2462900.11
510800,202110,188,112,76,123200,83600,206800
510805,202110,195,129,66,141900,72600,214500
510810,202110,101,41,60,45100,66000,111100
510820,202110,236,116,120,127600,132000.5,259600.5
510830,202110,75,41,34,45100,37400,82500
510835,202110,16,11,5,12100,5500,17600
510840,202110,9088,4238,4850,4661800,5337200,9999000
510850,202110,210,87,123,95700,135300,231000
510860,202110,404,187,217,205700,238700,444400
510880,202110,74,52,22,57200,24200,81400
510885,202110,64,37,27,40700,29700,70400
510890,202110,59,33,26,36300,28600,64900
510895,202110,168,98,70,107800,77000,184800
520005,202110,135,55,80,60500,88000,148500
520010,202110,295,132,163,145200,179300,324500
520013,202110,723,479,244,526900,268400,795300
520015,202110,48,34,14,37400,15400,52800
520017,202110,85,50,35,55000,38500,93500
520020,202110,18,10,8,11000,8800,19800
520025,202110,2584,1338,1246,1471800.76,1370600,2842400.76
520030,202110,813,435,378,478775,415800,894575
520050,202110,66,46,20,50600,22000,72600
520055,202110,58,38,20,41800,22000,63800
520060,202110,181,117,64,128700,70400,199100
520080,202110,582,421,161,464200,177100,641300
520082,202110,17,11,6,12100,6600,18700
520085,202110,85,63,22,69300,24200,93500
520090,202110,87,61,26,67100,28600,95700
520110,202110,9168,3900,5268,4296600,5802500,10099100
520120,202110,10,5,5,5500,5500,11000
520130,202110,804,560,244,616000,268400,884400
520140,202110,11941,6595,5346,7257800.83,5886100.84,13143901.67
520145,202110,55,33,22,36300,24200,60500
520150,202110,156,124,32,136400,35200,171600
520160,202110,45,31,14,34100,15400,49500
520170,202110,237,135,102,148500,112200,260700
520180,202110,178,82,96,90200,105600,195800
520215,202110,201,135,66,148500,72600,221100
520235,202110,81,64,17,70400,18700,89100
520250,202110,127,73,54,80300,59400,139700
520260,202110,115,71,44,78100,48400,126500
520280,202110,42,29,13,31900,14300,46200
520310,202110,44,26,18,28600,19800,48400
520320,202110,169,104,65,114400,71500,185900
520330,202110,812,437,375,480700,413600,894300
520340,202110,362,209,153,231000,169400,400400
520350,202110,501,240,261,264000,288200,552200
520355,202110,87,48,39,52800,42900,95700
520357,202110,26,19,7,20900,7700,28600
520360,202110,4,2,2,2200,2200,4400
520380,202110,140,77,63,84700,69300,154000
520390,202110,248,104,144,114400,158400,272800
520393,202110,17,14,3,15400,3300,18700
520396,202110,74,50,24,55000,26400,81400
520400,202110,196,116,80,128700,88000,216700
520410,202110,188,93,95,103400,104500,207900
520420,202110,21,13,8,14300,8800,23100
520425,202110,263,133,130,146300,143000,289300
520430,202110,516,247,269,271801.2,295900,567701.2
520440,202110,669,479,190,526900,209000,735900
520450,202110,2061,865,1196,953700,1315600,2269300
520455,202110,60,35,25,38500,27500,66000
520460,202110,35,20,15,22000,16500,38500
520465,202110,31,25,6,27500,6600,34100
520470,202110,433,273,160,300300,176000,476300
520480,202110,83,47,36,51700,39600,91300
520485,202110,103,38,65,41800,71500,113300
520490,202110,425,317,108,348700,118800,467500
520495,202110,158,93,65,102300,71500,173800
520500,202110,191,149,42,163900,46200,210100
520505,202110,195,116,79,127600,86900,214500
520510,202110,1863,875,988,965800,1086800,2052600
520520,202110,49,33,16,36300,17600,53900
520530,202110,212,166,46,182600,50600,233200
520540,202110,625,422,203,465300,223300,688600
520545,202110,133,74,59,81400,64900,146300
520547,202110,59,34,25,37400,27500,64900
520549,202110,1314,592,722,651200,795300,1446500
520551,202110,318,163,155,179300,170500,349800
520552,202110,34,24,10,26400,11000,37400
520570,202110,13,8,5,8800,6600,15400
520580,202110,272,168,104,187000,114400,301400
520590,202110,139,79,60,86900,66000,152900
520620,202110,1124,516,608,570900,668800,1239700
520630,202110,42,22,20,24200,22000,46200
520640,202110,376,217,159,238700,176000,414700
520650,202110,66,33,33,37400,36300,73700
520660,202110,41,21,20,24200,22000,46200
520670,202110,39,31,8,34100,8800,42900
520680,202110,44,27,17,29700,18700,48400
520690,202110,39,10,29,11000,31900,42900
520710,202110,35,30,5,33000,5500,38500
520725,202110,199,147,52,161700,57200,218900
520735,202110,55,35,20,38500,22000,60500
520740,202110,453,221,232,243100,255200,498300
520750,202110,34,25,9,27500,9900,37400
520753,202110,72,49,23,53900,25300,79200
520760,202110,107,72,35,79200,38500,117700
520780,202110,272,207,65,227700,71500,299200
520790,202110,161,91,70,100100,77000,177100
520800,202110,3403,1869,1534,2055900,1690700,3746600
520810,202110,146,112,34,123200,37400,160600
520815,202110,4,3,1,3300,1100,4400
520830,202110,147,101,46,111100,50600,161700
520840,202110,380,244,136,268400,149600,418000
520850,202110,102,58,44,63800,48400,112200
520860,202110,1759,1120,639,1232000,704000,1936000
520870,202110,31811,14617,17194,16096300.32,18923300,35019600.32
520880,202110,1179,627,552,691790,607200,1298990
520890,202110,784,474,310,521400,341000,862400
520910,202110,966,511,455,564300.4,500500,1064800.4
520915,202110,87,69,18,75900,19800,95700
520920,202110,443,208,235,228800,258500,487300
520929,202110,18,16,2,18700,2200,20900
520940,202110,67,47,20,51920,22000,73920
520945,202110,14,10,4,11000,4400,15400
520960,202110,40,26,14,28600,15400,44000
520970,202110,363,211,152,232100,167200,399300
520980,202110,91,66,25,72600,27500,100100
520990,202110,442,311,131,342320,144100,486420
520993,202110,127,64,63,70400,69300,139700
520995,202110,252,139,113,152900,124300,277200
521000,202110,1542,898,644,987800,710600,1698400
521010,202110,674,344,330,378400,363000,741400
521015,202110,15,10,5,11000,5500,16500
521020,202110,1384,959,425,1056000,467500,1523500
521030,202110,57,36,21,39600,23100,62700
521040,202110,933,607,326,671000,359700,1030700
521056,202110,49,32,17,35200,18700,53900
521060,202110,127,82,45,90200,49500,139700
521080,202110,365,282,83,311300,91300,402600
521090,202110,559,362,197,399300,216700,616000
521100,202110,261,194,67,213400,73700,287100
521120,202110,1052,732,320,805200,352000,1157200
521130,202110,343,248,95,272800,104500,377300
521140,202110,181,99,82,108900,90200,199100
521150,202110,2575,1094,1481,1204500,1629100,2833600
521160,202110,24,10,14,11000,15400,26400
521170,202110,222,130,92,143000,101200,244200
521180,202110,1176,752,424,828300,466400,1294700
521190,202110,2516,1049,1467,1153900,1618100,2772000
521200,202110,55,40,15,44000,16500,60500
521205,202110,10,7,3,7700,3300,11000
521210,202110,124,76,48,83600,52800,136400
521220,202110,732,514,218,565400,239800,805200
521225,202110,26,19,7,20900,7700,28600
521230,202110,112,67,45,73700,49500,123200
521250,202110,6256,3496,2760,3852201.35,3038200,6890401.35
521260,202110,33,15,18,16500,19800,36300
521270,202110,136,103,33,113300,36300,149600
521280,202110,416,256,160,281600,176000,457600
521290,202110,26,18,8,19800,8800,28600
521295,202110,100,66,34,72600,37400,110000
521300,202110,223,122,101,134200,111100,245300
521305,202110,38,29,9,31900,9900,41800
521308,202110,1010,773,237,850300,260700,1111000
521310,202110,1333,751,582,826100,640200,1466300
521340,202110,20,16,4,17600,4400,22000
521350,202110,118,91,27,100100,29700,129800
521370,202110,164,114,50,125400,55000,180400
521375,202110,181,92,89,101200,97900,199100
521377,202110,50,39,11,42900,12100,55000
521380,202110,1055,643,412,708400,453200,1161600
521385,202110,12,7,5,7700,5500,13200
521390,202110,101,83,18,91300,19800,111100
521400,202110,343,233,110,256300,121000,377300
521405,202110,148,83,65,91300,71500,162800
521410,202110,76,54,22,59400,24200,83600
521440,202110,197,134,63,147400,69300,216700
521450,202110,752,417,335,458700,369600,828300
521460,202110,1097,718,379,790900,416900,1207800
521470,202110,11,8,3,8800,3300,12100
521480,202110,39,28,11,30800,12100,42900
521483,202110,312,192,120,211200,133100,344300
521486,202110,290,184,106,202400,116600,319000
521487,202110,24,11,13,12100,14300,26400
521490,202110,23,12,11,13200,12100,25300
521500,202110,138,67,71,73700,78100,151800
521520,202110,46,35,11,38500,12100,50600
521523,202110,824,489,335,539000,369600,908600
521525,202110,44,28,16,30800,17600,48400
521530,202110,234,126,108,138600,118800,257400
521540,202110,38,19,19,20900,20900,41800
521550,202110,96,40,56,44000,61600,105600
521560,202110,830,557,273,613800,301400,915200
521565,202110,65,47,18,51700,19800,71500
521570,202110,546,349,197,386100,216700,602800
521580,202110,53,32,21,35200,23100,58300
521590,202110,34,15,19,16500,20900,37400
521600,202110,23,12,11,13200,12100,25300
521630,202110,240,125,115,137500,126500,264000
521640,202110,300,162,138,178200,151800,330000
521645,202110,38,21,17,23100,18700,41800
521680,202110,241,150,91,165000,101200,266200
521690,202110,4,4,0,4400,,4400.0
521710,202110,1133,539,594,592900,653400,1246300
521720,202110,538,375,163,413600,179300,592900
521730,202110,659,312,347,344300,386100,730400
521740,202110,879,381,498,420200,547800,968000
521760,202110,2177,1136,1041,1250772.45,1145100,2395872.45
521770,202110,811,507,304,557700,335500,893200
521800,202110,1932,1256,676,1382700,744700,2127400
521805,202110,32,17,15,18700,16500,35200
521810,202110,92,54,38,60500,41800,102300
521830,202110,965,681,284,751300.73,312400,1063700.73
521839,202110,84,48,36,53900,39600,93500
521850,202110,1114,555,559,610500.17,614900,1225400.17
521860,202110,322,204,118,224400,129800,354200
521870,202110,75,47,28,51700,30800,82500
521878,202110,36,14,22,15400,24200,39600
521880,202110,4814,2118,2696,2329800,2967800,5297600
521890,202110,597,411,186,452100,205700,657800
521900,202110,279,222,57,244200,62700,306900
521910,202110,168,115,53,126500,58300,184800
521920,202110,44,23,21,25300,23100,48400
521925,202110,54,32,22,35200,24200,59400
521930,202110,1161,641,520,706200,572000,1278200
521935,202110,32,22,10,24200,11000,35200
521940,202110,204,94,110,103400,121000,224400
521945,202110,16,13,3,14300,3300,17600
521950,202110,10,6,4,6600,4400,11000
521960,202110,71,53,18,58300,19800,78100
521970,202110,408,259,149,284900,165000,449900
521971,202110,108,56,52,62700,57200,119900
521973,202110,37,19,18,20900,19800,40700
521975,202110,1560,790,770,871200.75,848100.18,1719300.93
521980,202110,246,165,81,181500,89100,270600
521990,202110,72,52,20,57200,22000,79200
522000,202110,287,186,101,204216.1,111100,315316.1
522005,202110,20,12,8,13200,8800,22000
522010,202110,1124,633,491,696300,540100,1236400
522015,202110,61,36,25,39600,27500,67100
522020,202110,890,517,373,569800,411400,981200
522026,202110,26,17,9,18700,9900,28600
522028,202110,16,12,4,13200,4400,17600
522040,202110,779,324,455,356400,500500,856900
522045,202110,2487,1481,1006,1630200,1106600,2736800
522050,202110,156,75,81,82500,89100,171600
522060,202110,543,343,200,377300,221100,598400
522068,202110,105,73,32,80300,35200,115500
522070,202110,10,10,0,11000,,11000.0
522100,202110,34,21,13,23100,14300,37400
522108,202110,45,34,11,37400,12100,49500
522119,202110,57,32,25,35200,27500,62700
522130,202110,74,27,47,29700,51700,81400
522140,202110,4050,2081,1969,2291300,2167000,4458300
522145,202110,45,34,11,37400,12100,49500
522150,202110,102,69,33,75900,36300,112200
522155,202110,51,39,12,44000,13200,57200
522157,202110,7,5,2,5500,2200,7700
522160,202110,1667,994,673,1094500,741400,1835900
522170,202110,398,267,131,293700,144100,437800
522180,202110,35,14,21,15400,23100,38500
522185,202110,2223,916,1307,1007600,1438800,2446400
522190,202110,60,32,28,35200,30800,66000
522200,202110,301,177,124,194700,136400,331100
522205,202110,148,100,48,110000,52800,162800
522220,202110,141,104,37,114400,40700,155100
522230,202110,29,25,4,27500,4400,31900
530010,202110,54480,27421,27059,30188682.25,29803577.31,59992259.56
110001,202111,503,406,97,446678.6,106716.69,553395.29
110002,202111,2831,1790,1041,1969283.75,1145311.21,3114594.96
110003,202111,83,68,15,74818.25,16503.91,91322.16
110004,202111,2000,1336,664,1470940.28,731647.75,2202588.03
110005,202111,425,340,85,374053.22,94608.38,468661.60
110006,202111,433,326,107,358649.49,118817.24,477466.73
110007,202111,70,56,14,61609.91,15402.13,77012.04
110008,202111,246,137,109,150721.86,119912.42,270634.28
110009,202111,914,686,228,755761.83,250830.82,1006592.65
110010,202111,1667,988,679,1088050.91,746994.79,1835045.70
110011,202111,1690,1313,377,1444559.43,415882.86,1860442.29
110012,202111,4054,2354,1700,2592965.17,1871304.68,4464269.85
110013,202111,741,587,154,645811.53,169428.58,815240.11
110014,202111,366,322,44,354282.5,48410.18,402692.68
110015,202111,1358,1074,284,1181591.12,312447.83,1494038.95
110018,202111,1047,643,404,707411.18,444478.96,1151890.14
110020,202111,15697,8896,6801,9796381.18,7484617.25,17280998.43
110025,202111,649,470,179,517062.41,196919.73,713982.14
110026,202111,38,24,14,26402.27,15402.34,41804.61
110028,202111,1580,1120,460,1234414.05,506099.05,1740513.10
110029,202111,131,119,12,130928.61,13202.52,144131.13
110030,202111,2374,1578,796,1738100.82,875742.89,2613843.71
110032,202111,306,233,73,257448.61,80313.26,337761.87
110033,202111,648,468,180,514915.05,198034.61,712949.66
110034,202111,331,244,87,268443.2,95714.48,364157.68
110037,202111,87,78,9,85805.8,9900.79,95706.59
110040,202111,386,266,120,292632.97,132011.08,424644.05
110045,202111,924,639,285,705205.25,313559.17,1018764.42
110050,202111,85,74,11,81423.91,12102.82,93526.73
110060,202111,60,35,25,38515.27,27505.06,66020.33
110070,202111,105,66,39,72607.04,42904.16,115511.20
110080,202111,505,286,219,314610.68,240912.93,555523.61
110090,202111,23,19,4,20900,4400,25300
110092,202111,113,60,53,66002.99,58303.84,124306.83
110094,202111,195,139,56,152914.05,61606.32,214520.37
110100,202111,46,31,15,34105.94,16501.97,50607.91
110110,202111,93,51,42,56108.62,46205.81,102314.43
110120,202111,67,59,8,64912.2,8801.96,73714.16
110130,202111,269,217,52,238766.94,58309.95,297076.89
110140,202111,240,172,68,189217.15,74806.91,264024.06
110143,202111,51,42,9,46201.01,9900.67,56101.68
110145,202111,36,28,8,30803.54,8801.75,39605.29
110146,202111,23,11,12,12100.34,13201.56,25301.90
110147,202111,39,27,12,29704.93,13202.53,42907.46
110148,202111,36,27,9,29702.3,9900.5,39602.8
110149,202111,315,224,91,246412.33,100104.82,346517.15
110150,202111,134,102,32,112205.56,35201.56,147407.12
110155,202111,11,10,1,11001.4,1100,12101.4
110160,202111,64,51,13,57201.5,14301.76,71503.26
110170,202111,212,162,50,178240.44,56105.35,234345.79
110175,202111,61,47,14,51701.16,15400,67101.16
110180,202111,93,76,17,83604.53,18700.44,102304.97
120001,202111,194,146,48,160630.11,52812.45,213442.56
120005,202111,194,110,84,121015.81,92408.53,213424.34
120010,202111,1124,688,436,756875.79,479649.21,1236525.00
120013,202111,150,101,49,111104.49,53903.5,165007.99
120017,202111,115,64,51,70403.92,56101.27,126505.19
120020,202111,3458,2798,660,3083475.01,731545.24,3815020.25
120025,202111,544,304,240,334496.21,264083.02,598579.23
120030,202111,1046,899,147,990074.91,161718.84,1151793.75
120032,202111,38,34,4,37401.13,4400.17,41801.30
120033,202111,216,190,26,210110.77,28601.07,238711.84
120034,202111,172,126,46,138602.99,50601.28,189204.27
120035,202111,37,31,6,34101.64,6601.76,40703.40
120038,202111,412,264,148,290437.63,162812.95,453250.58
120039,202111,28,28,0,30801.88,,30801.88
120040,202111,13860,9339,4521,10287361.13,4977382.63,15264743.76
120042,202111,44,39,5,42901.08,5500.31,48401.39
120043,202111,13,3,10,3300.34,11000.44,14300.78
120045,202111,529,338,191,371860.85,211226.46,583087.31
120050,202111,1244,951,293,1046201.84,322322.09,1368523.93
120060,202111,1432,1184,248,1302473.94,273915.1,1576389.04
120070,202111,407,295,112,325639.01,123216.02,448855.03
120080,202111,177,110,67,121005.16,73702.79,194707.95
130002,202111,168,124,44,136402.66,48401.3,184803.96
130006,202111,101,65,36,71501.12,39600,111101.12
130008,202111,128,70,58,77001.38,63801.71,140803.09
130010,202111,156,93,63,102301.85,69301.56,171603.41
130014,202111,271,194,77,213404.35,84704.34,298108.69
130020,202111,119,74,45,81401.56,49500,130901.56
130030,202111,943,537,406,591804.21,446603.55,1038407.76
130040,202111,349,168,181,184809.2,199107.81,383917.01
130050,202111,538,274,264,301420.03,290429.84,591849.87
130060,202111,860,593,267,653413.35,294808.32,948221.67
130063,202111,602,365,237,401500.78,261800,663300.78
130068,202111,196,120,76,132003.89,84701.15,216705.04
130070,202111,1330,894,436,983483.59,479654.13,1463137.72
130080,202111,690,454,236,499406.33,259605.58,759011.91
130083,202111,69,39,30,42902.62,33001.68,75904.30
130090,202111,334,190,144,209001.11,158400.78,367401.89
130100,202111,1193,546,647,600647.48,711775.58,1312423.06
130110,202111,715,314,401,345410.81,441108.41,786519.22
130115,202111,141,65,76,71504.14,83605.88,155110.02
130120,202111,1594,992,602,1091275.02,662226.91,1753501.93
130130,202111,601,415,186,457603.3,204601.11,662204.41
130140,202111,1551,1203,348,1323363.11,382836.51,1706199.62
130150,202111,400,355,45,390500.58,49500,440000.58
130160,202111,424,247,177,271715.44,194703.42,466418.86
130165,202111,49,38,11,41804.23,12101.14,53905.37
130170,202111,1015,706,309,776586.26,339923.51,1116509.77
130180,202111,244,178,66,195802.06,72601.79,268403.85
130185,202111,2181,1006,1175,1106698.59,1292713.43,2399412.02
130190,202111,3361,2111,1250,2322284.61,1376255.31,3698539.92
130195,202111,280,224,56,246400.78,61600.67,308001.45
130200,202111,171,80,91,88002.27,100103.7,188105.97
130210,202111,91,48,43,52800.34,47300,100100.34
130220,202111,196,140,56,154002.09,61602.15,215604.24
130230,202111,364,236,128,259600,141900,401500
130240,202111,1326,857,469,942738.86,518128.06,1460866.92
130250,202111,4985,3131,1854,3446705.65,2041914.94,5488620.59
130255,202111,412,204,208,224400.97,229916.79,454317.76
130260,202111,58550,27547,31003,30329405.75,34128190.15,64457595.90
130270,202111,1532,1042,490,1146329.26,539027.63,1685356.89
130280,202111,129,75,54,82502.65,59400.01,141902.66
130290,202111,2086,1401,685,1542293.47,753551.29,2295844.76
130300,202111,418,284,134,312404.71,147405.93,459810.64
130310,202111,901,477,424,524703.45,466409.81,991113.26
130320,202111,522,274,248,301403.39,272802.71,574206.10
130330,202111,761,479,282,526913.82,310207.52,837121.34
130340,202111,3360,1886,1474,2074758.81,1621505.63,3696264.44
130350,202111,475,329,146,361900.34,160600,522500.34
130353,202111,928,408,520,448852.48,572070.14,1020922.62
130356,202111,777,343,434,378412.34,478523.21,856935.55
130360,202111,84,65,19,71500,20900.89,92400.89
130370,202111,667,516,151,567600.95,167200,734800.95
130380,202111,641,499,142,548917.45,156203,705120.45
130390,202111,473,387,86,426805.46,94601.12,521406.58
130395,202111,158,43,115,47300,126500.84,173800.84
130400,202111,69,47,22,51701.12,24200.84,75901.96
130406,202111,2174,1272,902,1400377.13,992285.42,2392662.55
130410,202111,442,223,219,245300.76,240900.34,486201.10
130420,202111,2798,2273,525,2500534.82,577550.15,3078084.97
130423,202111,152,78,74,85800.34,81400.67,167201.01
130426,202111,182,98,84,107802.31,92403.25,200205.56
130430,202111,407,239,168,264002.16,184800.84,448803.00
130440,202111,208,67,141,73702.94,155105.66,228808.60
140002,202111,23,4,19,4401.22,20901.97,25303.19
140005,202111,212,126,86,138609.29,94609.15,233218.44
140010,202111,11205,6910,4295,7612290.62,4730884.65,12343175.27
140015,202111,146,67,79,73705,88005.79,161710.79
140017,202111,121,66,55,72616.15,60509.73,133125.88
140020,202111,446,289,157,317930.55,173828.03,491758.58
140023,202111,36,17,19,18702.29,20902.5,39604.79
140028,202111,23,12,11,13203.21,12102.68,25305.89
140030,202111,359,238,121,261843.77,133119.16,394962.93
140040,202111,62,44,18,48400,19800.79,68200.79
140045,202111,267,102,165,112210.55,181516.64,293727.19
140047,202111,446,295,151,324548.46,166118.88,490667.34
140050,202111,141,87,54,95721.2,59412.69,155133.89
140060,202111,65,40,25,44004.87,27501.52,71506.39
140070,202111,31,29,2,31903.65,2200.44,34104.09
150010,202111,4878,2923,1955,3215632.08,2150725.52,5366357.60
150013,202111,165,116,49,127604.81,53904.52,181509.33
150020,202111,1099,601,498,662253.46,547836.83,1210090.29
150030,202111,709,319,390,350938.32,429060.39,779998.71
150034,202111,204,125,79,137507.8,86903.96,224411.76
150040,202111,1529,869,660,956047.41,727194.98,1683242.39
150050,202111,685,388,297,426821.67,326709.23,753530.90
150060,202111,4821,3029,1792,3332293.36,1973071.86,5305365.22
150070,202111,436,225,211,248622.41,232112.89,480735.30
150080,202111,16066,7464,8602,8217556.42,9466307.87,17683864.29
150085,202111,418,267,151,294846.35,166124.2,460970.55
150090,202111,687,579,108,639166.9,118810.26,757977.16
150095,202111,44,29,15,31910.29,16504.19,48414.48
150100,202111,67,42,25,46201.02,27502.93,73703.95
150110,202111,214,121,93,133100.44,102300.34,235400.78
150120,202111,388,279,109,306938.29,119908,426846.29
150125,202111,49,18,31,19803.02,34103.23,53906.25
150130,202111,2111,1076,1035,1183742.29,1138603.82,2322346.11
150140,202111,57521,25325,32196,27873143.72,35435350.58,63308494.30
150145,202111,236,130,106,143012.21,116606.79,259619.00
150150,202111,3216,1412,1804,1553443.81,1984727.72,3538171.53
150157,202111,367,258,109,283845.11,119918.7,403763.81
150160,202111,132,99,33,108906.62,36302.12,145208.74
150170,202111,3837,2799,1038,3082452.94,1141893.36,4224346.30
150172,202111,346,244,102,268438.37,112215.05,380653.42
150175,202111,82,46,36,50603.68,39604.43,90208.11
150178,202111,752,503,249,554468.04,273931.51,828399.55
150180,202111,3193,1556,1637,1714042.25,1802031.34,3516073.59
150190,202111,361,234,127,257437.58,139717.3,397154.88
150195,202111,111,60,51,66002.69,56101.06,122103.75
150200,202111,186,91,95,100102.66,104503.77,204606.43
150210,202111,3201,2524,677,2780085.97,744780.49,3524866.46
150215,202111,599,376,223,414778.89,245337.17,660116.06
150220,202111,3524,2333,1191,2567720.52,1312461.36,3880181.88
150230,202111,1288,1021,267,1123233.32,293734.63,1416967.95
150240,202111,6786,3806,2980,4192746.35,3282933.42,7475679.77
150250,202111,71,39,32,42904.79,35202.81,78107.60
150260,202111,106,70,36,77006.08,39602.08,116608.16
150270,202111,2167,1400,767,1543568.13,846026.79,2389594.92
150275,202111,530,333,197,366353.1,216723.53,583076.63
150276,202111,111,41,70,45104.3,77004.67,122108.97
150277,202111,820,366,454,402665.17,499485.26,902150.43
150280,202111,372,250,122,275002.48,134202.5,409204.98
150285,202111,126,64,62,70404.39,68026.27,138430.66
150290,202111,1171,672,499,740377.11,548950.16,1289327.27
150293,202111,735,341,394,375158.6,433456.35,808614.95
150295,202111,532,243,289,267348.22,317960.6,585308.82
150300,202111,93,44,49,48402.89,53902.83,102305.72
150304,202111,188,108,80,118809.94,88008.23,206818.17
150307,202111,418,349,69,383940.73,75906.93,459847.66
150309,202111,579,408,171,451082.39,188131.01,639213.40
150310,202111,253,165,88,181501.54,96800,278301.54
150320,202111,1861,1293,568,1424583.95,624850.56,2049434.51
150330,202111,2048,1178,870,1296985.55,957073.22,2254058.77
150340,202111,200,134,66,147406.43,72602.15,220008.58
150345,202111,631,351,280,386123.67,308013.74,694137.41
150350,202111,400,317,83,349881.57,91315.13,441196.70
150360,202111,4749,2857,1892,3144365.43,2082621.64,5226987.07
150370,202111,822,564,258,620541.59,283843.45,904385.04
150375,202111,199,93,106,102305.09,116604.36,218909.45
150380,202111,1522,1006,516,1106797.01,567710.79,1674507.80
150390,202111,857,491,366,541282.64,402651.68,943934.32
150400,202111,112,92,20,101202.85,22000.53,123203.38
150405,202111,1586,1000,586,1101208.42,644641.63,1745850.05
150410,202111,118,72,46,80305.56,50602.36,130907.92
150420,202111,7575,4059,3516,4468226.47,3871675.19,8339901.66
150430,202111,633,397,236,436758.39,259622.71,696381.10
150440,202111,453,280,173,309151.25,190324.48,499475.73
150442,202111,2315,1217,1098,1342184.17,1207955.33,2550139.50
150445,202111,543,352,191,387278.13,211230.36,598508.49
150450,202111,219,122,97,134201.07,106700.74,240901.81
150460,202111,716,535,181,588570.09,199117.1,787687.19
150470,202111,1295,772,523,850427.86,575370.34,1425798.20
150475,202111,245,185,60,203541.66,66014.52,269556.18
150480,202111,1370,947,423,1041835.41,466448.62,1508284.03
150490,202111,609,358,251,393801.58,276101.01,669902.59
150495,202111,337,252,85,277200.97,93500,370700.97
150497,202111,283,194,89,213419.42,97907.03,311326.45
150500,202111,246,148,98,162814.44,107804.78,270619.22
150503,202111,1259,620,639,682070.92,704076.1,1386147.02
150506,202111,916,620,296,683194.55,325636.19,1008830.74
150510,202111,1306,702,604,772281.01,664475.55,1436756.56
150520,202111,318,219,99,240901.9,108900,349801.9
150530,202111,1840,1012,828,1113455.5,911009.81,2024465.31
150540,202111,202,147,55,161729.34,60512.42,222241.76
150543,202111,843,426,417,468697.35,458785.24,927482.59
150548,202111,460,329,131,361923.69,144108,506031.69
150549,202111,72,46,26,50602,28602.01,79204.01
150550,202111,3033,1499,1534,1652377.49,1688663.3,3341040.79
150553,202111,3437,1929,1508,2124501.55,1662431.41,3786932.96
150555,202111,142,76,66,84708.48,72606.33,157314.81
150560,202111,47,21,26,23101.78,28601.78,51703.56
150563,202111,126,62,64,68211.48,70412.43,138623.91
150565,202111,207,130,77,143003.38,84702.97,227706.35
150570,202111,431,285,146,313506.2,160602.3,474108.5
150580,202111,1688,812,876,893260.96,964776.85,1858037.81
150590,202111,824,536,288,589633.37,319027.5,908660.87
150600,202111,513,302,211,332218.14,232117.66,564335.80
150610,202111,151,122,29,134203.76,31901.68,166105.44
150611,202111,129,85,44,93505.19,48401.79,141906.98
150613,202111,3284,1856,1428,2043113.78,1572260.38,3615374.16
150616,202111,555,306,249,336641.99,273923.88,610565.87
150618,202111,1366,703,663,773360.57,730782.72,1504143.29
150619,202111,396,300,96,330032.84,105613.24,435646.08
150620,202111,1238,721,517,793159.63,568741.18,1361900.81
150630,202111,138,91,47,100119.7,51708.97,151828.67
150635,202111,451,194,257,213415.35,282718.67,496134.02
150640,202111,40,21,19,23103.18,20902.17,44005.35
150650,202111,2414,1379,1035,1518251.98,1139802.84,2658054.82
150655,202111,249,182,67,200216.74,73703.9,273920.64
150658,202111,85,51,34,56110.16,37408.38,93518.54
150660,202111,566,365,201,401561.38,221121.79,622683.17
150670,202111,1127,393,734,432377.96,807548.05,1239926.01
150680,202111,10580,5492,5088,6045568.92,5601053,11646621.92
150690,202111,26,13,13,14302.67,14300.34,28603.01
150700,202111,498,324,174,358649.17,191433.64,550082.81
150710,202111,298,173,125,190322.59,137510.49,327833.08
150715,202111,838,526,312,578659.23,343238.42,921897.65
150720,202111,418,317,101,348732.84,111105.49,459838.33
150730,202111,1066,523,543,575408.35,597401.58,1172809.93
150740,202111,235,153,82,168316.28,90206.84,258523.12
150745,202111,751,420,331,462090.52,365272.71,827363.23
150746,202111,68,35,33,38502.39,36302.01,74804.40
150747,202111,231,172,59,189211.32,64908.69,254120.01
150750,202111,137,76,61,83615.32,67107.15,150722.47
150760,202111,1813,1168,645,1285999.17,710640.19,1996639.36
150770,202111,392,224,168,246403.27,184802.88,431206.15
150775,202111,103,54,49,59411.39,53909.07,113320.46
150780,202111,193,112,81,123209.24,89102.83,212312.07
150790,202111,665,372,293,409225.75,322318.8,731544.55
150795,202111,1612,967,645,1066032.11,710661.29,1776693.40
150796,202111,332,189,143,207901.38,157302.77,365204.15
150797,202111,381,178,203,195827.59,223316.45,419144.04
150800,202111,1545,864,681,950459.47,750229.28,1700688.75
150803,202111,526,413,113,455420.75,124310.59,579731.34
150805,202111,209,122,87,134210.39,95709.06,229919.45
150808,202111,1040,535,505,588564.16,555555.35,1144119.51
150810,202111,3223,2190,1033,2411439.74,1137482.15,3548921.89
150812,202111,486,248,238,273927.31,262929.25,536856.56
150815,202111,1125,693,432,762379.18,475225.56,1237604.74
150820,202111,1544,938,606,1031961.69,667810.35,1699772.04
150830,202111,550,405,145,445553.24,159517.17,605070.41
150835,202111,221,128,93,140808.08,102306.14,243114.22
150840,202111,1395,834,561,917567.68,617204.15,1534771.83
160005,202111,61,42,19,46204.25,20904,67108.25
160010,202111,192,119,73,132020.81,80309.07,212329.88
160015,202111,143,85,58,93503.47,63803.03,157306.50
160020,202111,141,76,65,83604.88,71503.23,155108.11
160021,202111,66,27,39,29704.74,42905.79,72610.53
160023,202111,67,43,24,47304.59,26401.66,73706.25
160025,202111,25,12,13,13201.32,14301.58,27502.90
160027,202111,1472,827,645,910933.43,709589.79,1620523.22
160030,202111,16450,8424,8026,9272316.78,8831265.33,18103582.11
160040,202111,294,175,119,192508.09,130911.96,323420.05
160050,202111,741,360,381,396040.76,419137.97,815178.73
160053,202111,286,169,117,185934.29,128718.95,314653.24
160055,202111,22,14,8,15404.21,8801.89,24206.10
160060,202111,6621,3514,3107,3867117.43,3418253.16,7285370.59
160070,202111,190,112,78,123206.8,85801.57,209008.37
160080,202111,122,61,61,67101.16,67100,134201.16
170025,202111,28,14,14,15402.11,15402.81,30804.92
170030,202111,194,157,37,172721.19,40703.11,213424.30
170035,202111,202,98,104,107833.79,114430.97,222264.76
170040,202111,174,128,46,140800.2,50600.49,191400.69
170070,202111,321,203,118,224453.38,129816.5,354269.88
170100,202111,348,256,92,281640.89,101217.77,382858.66
170105,202111,49,41,8,45105.32,8801.6,53906.92
170110,202111,118,70,48,77003.08,52800.07,129803.15
170130,202111,71,36,35,39600.9,38500.82,78101.72
170190,202111,95,56,39,61601.2,42901.14,104502.34
170200,202111,347,239,108,262934.22,118810.02,381744.24
170210,202111,6321,3331,2990,3668643.59,3293820.53,6962464.12
170215,202111,140,71,69,78104.71,75907.6,154012.31
170220,202111,1349,984,365,1083611.59,401541.02,1485152.61
170230,202111,148,96,52,105624.64,57213.76,162838.40
170240,202111,507,340,167,374069.75,183740.53,557810.28
170255,202111,1047,848,199,932868.72,218913.78,1151782.50
170270,202111,48,34,14,37400,15400.02,52800.02
170290,202111,122,76,46,83604.28,50600.87,134205.15
170300,202111,104,66,38,72605.74,41801.23,114406.97
170305,202111,46,35,11,38501.85,12101.12,50602.97
170307,202111,57,43,14,47308.95,15403.38,62712.33
170310,202111,122,69,53,75908.64,59404.69,135313.33
170320,202111,31,19,12,20902.77,13202.16,34104.93
170330,202111,28,22,6,24203.53,6601.3,30804.83
170360,202111,31,18,13,19803.6,14302.95,34106.55
170370,202111,90,46,44,50611.92,48412.09,99024.01
170380,202111,71,56,15,61604.19,16500.34,78104.53
170382,202111,36,31,5,34100.34,5502.55,39602.89
170384,202111,145,112,33,123201.83,36300,159501.83
170386,202111,68,29,39,31901.7,42903.36,74805.06
170388,202111,49,21,28,23102.54,30803.31,53905.85
170389,202111,24,20,4,22002.39,4401.36,26403.75
170390,202111,74,45,29,49505.13,31901.8,81406.93
170410,202111,24,22,2,24205.45,2201.1,26406.55
170460,202111,15,9,6,9902.93,6601.71,16504.64
170510,202111,34,27,7,29705.72,7700.84,37406.56
170550,202111,1541,891,650,981350.85,715114.6,1696465.45
170555,202111,104,77,27,84720.47,29707.03,114427.50
170560,202111,105,75,30,82500.04,33000.85,115500.89
170600,202111,39,11,28,12101.1,30800.46,42901.56
170610,202111,190,99,91,108925.96,100123.01,209048.97
170625,202111,33,19,14,20901.13,15403.26,36304.39
170650,202111,90,63,27,69302.97,29702.28,99005.25
170700,202111,575,425,150,467545.97,165010.94,632556.91
170710,202111,147,94,53,103430.76,58316.32,161747.08
170720,202111,98,76,22,83602.73,24202.03,107804.76
170730,202111,96,56,40,61606.82,44004.83,105611.65
170740,202111,86,60,26,66000.31,28600.38,94600.69
170755,202111,53,28,25,30803.65,27510.55,58314.20
170765,202111,133,72,61,79220.5,67112.62,146333.12
170770,202111,189,122,67,135311.47,73704.23,209015.70
170820,202111,589,388,201,426860.65,221132.67,647993.32
170825,202111,40,21,19,23101.91,20901.8,44003.71
170830,202111,88,71,17,78106.34,18700.67,96807.01
170900,202111,169,130,39,143006.84,42902.52,185909.36
170930,202111,929,504,425,555444.58,467576.58,1023021.16
170950,202111,3150,1455,1695,1600767.56,1865937.59,3466705.15
170980,202111,17,11,6,12102.6,6600.69,18703.29
171050,202111,145,108,37,118801.91,40700.71,159502.62
171070,202111,51,43,8,47301.67,8800,56101.67
171090,202111,48,35,13,38501.96,14301.22,52803.18
171110,202111,23,17,6,18703,6600.19,25303.19
171150,202111,43,24,19,26400,20900,47300
171180,202111,28,13,15,14304.11,16504.01,30808.12
171190,202111,168,97,71,106712.43,78109.76,184822.19
171195,202111,60,50,10,55010.72,11002.6,66013.32
171200,202111,40,20,20,22002.76,22001.4,44004.16
171215,202111,7,5,2,5500.07,2200.89,7700.96
171240,202111,62,45,17,49500,18701.9,68201.9
171245,202111,57,48,9,52814.77,9903.39,62718.16
171250,202111,74,42,32,46201.28,35202.31,81403.59
171270,202111,14,10,4,11002.62,4401.63,15404.25
171280,202111,41,33,8,37408.7,8800.38,46209.08
171320,202111,994,564,430,621349.71,473034.54,1094384.25
171330,202111,419,211,208,232116.61,228821.66,460938.27
171360,202111,94,65,29,71502.78,31902.35,103405.13
171370,202111,37,19,18,20903.67,19806.79,40710.46
171380,202111,130,113,17,124301.24,18700.25,143001.49
171395,202111,46,27,19,29701.09,20900.74,50601.83
171420,202111,262,172,90,189208.5,100106.17,289314.67
171430,202111,74,60,14,66007.79,15400.62,81408.41
171488,202111,203,110,93,121007.4,102302.97,223310.37
171500,202111,64,35,29,38503.87,31902.62,70406.49
171510,202111,72,48,24,52801.47,26401.92,79203.39
171515,202111,38,31,7,34105.38,7701.93,41807.31
171525,202111,26,23,3,25304.33,3300.4,28604.73
171550,202111,15,9,6,9902.16,6600.72,16502.88
171570,202111,51,25,26,27500.73,28601.32,56102.05
171575,202111,274,180,94,198016.84,103405.11,301421.95
171610,202111,1753,879,874,967050.12,961550.27,1928600.39
171620,202111,144,97,47,106709.54,51703.64,158413.18
171630,202111,54,30,24,33000.8,26400,59400.8
171650,202111,330,226,104,248642.16,115515,364157.16
171660,202111,254,145,109,159542.04,121029.57,280571.61
171665,202111,75,46,29,50603.62,31903.23,82506.85
171670,202111,424,256,168,282739.77,184817.43,467557.20
171700,202111,64,56,8,61605.86,8802.39,70408.25
171720,202111,28,10,18,11002.08,19802.67,30804.75
171750,202111,109,55,54,60504.99,59407.13,119912.12
171780,202111,76,58,18,63805.91,19800.6,83606.51
171790,202111,83,68,15,74802.84,16500,91302.84
171800,202111,33,25,8,27500.97,8800,36300.97
171820,202111,2038,1182,856,1301506.12,945033.34,2246539.46
171830,202111,34,24,10,26401.74,11000,37401.74
171840,202111,60,39,21,42906.65,24201.12,67107.77
171845,202111,33,22,11,24201.92,12101.42,36303.34
171850,202111,36,30,6,33405.47,6601.44,40006.91
171855,202111,77,60,17,66002.07,18700.32,84702.39
171865,202111,6,5,1,5500.44,1100.34,6600.78
171870,202111,31,19,12,20904.3,13201.56,34105.86
171875,202111,80,57,23,62701.25,25300.84,88002.09
171880,202111,36,22,14,24202.05,15402.76,39604.81
171884,202111,48,28,20,30800.63,22000.6,52801.23
171886,202111,133,60,73,66002.27,80305.33,146307.60
171888,202111,24,19,5,20906.91,5501.63,26408.54
171889,202111,11,5,6,5501.62,6602.08,12103.70
171890,202111,54,45,9,49504.65,9900,59404.65
171900,202111,32,23,9,25307.61,9901.62,35209.23
172000,202111,36,30,6,33006.48,6600.59,39607.07
172010,202111,55,45,10,49503.5,11001.2,60504.7
172015,202111,23,16,7,17605.96,7703.32,25309.28
172020,202111,149,94,55,103407.76,60505.17,163912.93
172025,202111,38,25,13,27501.82,14300.25,41802.07
172030,202111,45,26,19,28600.91,20900.89,49501.80
172049,202111,82,53,29,58303.33,31900.98,90204.31
172065,202111,123,79,44,86925.47,48413.99,135339.46
172080,202111,117,71,46,78104.23,50603.68,128707.91
172085,202111,29,14,15,15400.5,16500.47,31900.97
172090,202111,429,317,112,348754.11,123217.59,471971.70
172093,202111,16,13,3,14300.12,3300,17600.12
172097,202111,19,11,8,13201.16,8800.63,22001.79
172100,202111,5325,2986,2339,3288490.12,2577743.17,5866233.29
172110,202111,85,54,31,59408.8,35203.54,94612.34
172120,202111,1707,1422,285,1564465.81,313539.59,1878005.40
172125,202111,11,10,1,11001.55,1100.17,12101.72
172130,202111,24,13,11,14300.87,12103.37,26404.24
172208,202111,203,122,81,134205.75,90204.84,224410.59
172210,202111,370,184,186,202440.51,204637.13,407077.64
210005,202111,2935,1842,1093,2026580.83,1203651.75,3230232.58
210010,202111,144,88,56,96801.74,62700.6,159502.34
210015,202111,41,29,12,31903.03,13200,45103.03
210020,202111,352,205,147,225520.32,161714.78,387235.10
210030,202111,319,213,106,234347.43,116621.74,350969.17
210040,202111,131,107,24,117708.1,26402.42,144110.52
210043,202111,251,197,54,216715.32,59404.97,276120.29
210047,202111,501,308,193,341002.02,212300.8,553302.82
210050,202111,278,208,70,228801.53,77001.13,305802.66
210055,202111,50,42,8,46204.55,8801.42,55005.97
210060,202111,533,435,98,478566.85,107817.5,586384.35
210070,202111,431,336,95,369604.8,104501.83,474106.63
210080,202111,134,123,11,135305.81,12100.88,147406.69
210083,202111,284,142,142,156202.71,156200.92,312403.63
210087,202111,4,3,1,3300,1100,4400
210090,202111,429,310,119,341057.34,130921.18,471978.52
210095,202111,410,319,91,350939.66,100115.06,451054.72
210100,202111,684,544,140,598456.93,154019.98,752476.91
210110,202111,117,78,39,85802.67,42901.18,128703.85
210120,202111,4868,3847,1021,4233602.99,1123302.58,5356905.57
210125,202111,178,109,69,121010.26,75905.99,196916.25
210130,202111,448,267,181,293741.22,199126.94,492868.16
210135,202111,30,22,8,24208.95,8801.72,33010.67
210140,202111,4448,3434,1014,3781270.56,1116678.8,4897949.36
210150,202111,362,229,133,251963.22,146331.93,398295.15
210160,202111,3231,2759,472,3035327.92,519283.38,3554611.30
210170,202111,1186,952,234,1047354.91,257423.29,1304778.20
210173,202111,122,107,15,117701.72,16502,134203.72
210177,202111,327,186,141,204610.51,155119.23,359729.74
210180,202111,28,15,13,16500,14300.54,30800.54
210190,202111,436,289,147,317914.22,161703.49,479617.71
210193,202111,6,5,1,5500,1100,6600
210197,202111,70,52,18,57201.46,19801.84,77003.30
210200,202111,599,510,89,561079.05,97920.87,658999.92
210203,202111,210,149,61,163916.84,67104.86,231021.70
210207,202111,363,303,60,333340.43,66015.42,399355.85
210210,202111,723,667,56,733735.64,61606.91,795342.55
210215,202111,68,60,8,66011.7,8800,74811.7
210220,202111,376,319,57,350968.82,62712.31,413681.13
210230,202111,305,245,60,270626.08,68202.95,338829.03
210232,202111,1286,893,393,985700.1,432341.75,1418041.85
210235,202111,181,139,42,154021.07,46204.71,200225.78
210237,202111,34,19,15,20901.85,16501.53,37403.38
210240,202111,77,65,12,71501.14,13200.87,84702.01
210250,202111,175,148,27,162802.63,29702.83,192505.46
210255,202111,364,277,87,304740.92,95704.25,400445.17
210260,202111,390,270,120,297004.68,132000.58,429005.26
210270,202111,629,427,202,469722.17,222217.46,691939.63
210275,202111,84,63,21,69303.21,23102.44,92405.65
210280,202111,1039,681,358,750257.65,393823.24,1144080.89
210290,202111,521,356,165,391621.32,181506.81,573128.13
210300,202111,4999,3206,1793,3528051.53,1973619.43,5501670.96
210310,202111,105,76,29,83601.97,31900.88,115502.85
210312,202111,113,79,34,88003.51,37401.08,125404.59
210315,202111,105,89,16,97904.08,17601.22,115505.30
210317,202111,136,104,32,114402.39,35202.35,149604.74
210320,202111,2286,1968,318,2167281.83,349832.43,2517114.26
210325,202111,143,85,58,93509.98,63808.15,157318.13
210330,202111,4280,2530,1750,2783206.97,1925142.24,4708349.21
210340,202111,1196,908,288,1000027.52,316843.49,1316871.01
210350,202111,646,534,112,587467.63,123214.49,710682.12
210355,202111,144,124,20,137506.93,22004.38,159511.31
210360,202111,2095,1482,613,1633650.79,674371.88,2308022.67
210370,202111,1213,614,599,675464.94,658976.09,1334441.03
210375,202111,186,94,92,103418.48,101220.3,204638.78
210380,202111,716,559,157,616058.45,172720.15,788778.60
210390,202111,191,162,29,178204.4,31900.44,210104.84
210400,202111,390,338,52,371859.35,57208.68,429068.03
210405,202111,1001,708,293,778846.02,322318.07,1101164.09
210407,202111,60,47,13,51701.1,14301.22,66002.32
210408,202111,38,33,5,36306.96,5501.01,41807.97
210409,202111,325,285,40,313528.57,44003.75,357532.32
210410,202111,435,341,94,375110.28,103404.7,478514.98
210420,202111,206,172,34,189207.99,37400.61,226608.60
210430,202111,52,36,16,39600.55,17600.44,57200.99
210440,202111,365,248,117,272838.23,128715.42,401553.65
210450,202111,101,83,18,91313.54,19802.56,111116.10
210455,202111,234,123,111,135321.24,122115.99,257437.23
210460,202111,301,207,94,227736.46,103419.48,331155.94
210462,202111,61,52,9,57205.08,9900.97,67106.05
210465,202111,136,108,28,118806.13,30801.39,149607.52
210467,202111,507,381,126,420236.04,138610.42,558846.46
210470,202111,47,40,7,44000.52,7700,51700.52
210480,202111,1274,917,357,1008820.09,392759.37,1401579.46
210490,202111,185,128,57,140811.06,62705.06,203516.12
210500,202111,493,307,186,338846.87,204623.57,543470.44
210510,202111,522,423,99,465303.4,108902.59,574205.99
210515,202111,350,220,130,242015.3,143023.56,385038.86
210520,202111,402,366,36,402640.54,39604.55,442245.09
210530,202111,9410,4888,4522,5382311.8,4979711.08,10362022.88
210535,202111,125,95,30,104504.01,33004.25,137508.26
210540,202111,1481,1002,479,1103428.09,526948.39,1630376.48
210542,202111,1130,574,556,632585.87,611703.88,1244289.75
210545,202111,19,17,2,18701.5,2200,20901.5
210547,202111,122,109,13,119909.53,14301.74,134211.27
210550,202111,612,440,172,484100.67,189227.15,673327.82
210560,202111,146,127,19,139701.6,20900.77,160602.37
210565,202111,21,15,6,16505.4,6602.46,23107.86
210570,202111,1273,1051,222,1156259.41,244247.25,1400506.66
210580,202111,119,101,18,111102.52,19800.47,130902.99
210590,202111,713,597,116,657819.55,127601.76,785421.31
210592,202111,41,38,3,41800.89,3300,45100.89
210594,202111,106,88,18,96807.02,19803.7,116610.72
210596,202111,110,96,14,105605.44,15400.44,121005.88
210598,202111,140,106,34,116606.77,37404.08,154010.85
210600,202111,303,263,40,290454.82,45112.41,335567.23
210610,202111,247,232,15,255234.44,16501.11,271735.55
210620,202111,44,27,17,29700.99,18701.31,48402.30
210630,202111,71,65,6,72602.67,6600.34,79203.01
210632,202111,986,709,277,779922.66,304707.15,1084629.81
210635,202111,22,19,3,20908.47,3300.99,24209.46
210637,202111,130,94,36,103403.37,39600.34,143003.71
210640,202111,574,511,63,562107.73,69300.44,631408.17
210650,202111,388,326,62,358610.59,68204.21,426814.80
210660,202111,360,281,79,309162.07,86915.07,396077.14
210663,202111,49,36,13,39601.66,14300.44,53902.10
210667,202111,96,40,56,44003.28,62707.68,106710.96
210670,202111,259,231,28,254134.08,30805.59,284939.67
210675,202111,491,274,217,301421.12,238729.84,540150.96
210680,202111,221,143,78,157315.59,86907.36,244222.95
210690,202111,57,50,7,55002.22,7701.72,62703.94
210700,202111,148,113,35,124304.71,38502.85,162807.56
210710,202111,229,147,82,161709.78,90202.17,251911.95
210720,202111,123,111,12,122102.75,13200,135302.75
210725,202111,59,50,9,55018.93,9903.08,64922.01
210730,202111,23,18,5,19802.76,5500.6,25303.36
210735,202111,280,206,74,226603.39,81401.02,308004.41
210740,202111,517,447,70,491803.6,77017.24,568820.84
210745,202111,148,111,37,122107.07,40701.47,162808.54
210750,202111,2449,1266,1183,1393898.56,1303700.11,2697598.67
210760,202111,246,195,51,214513.93,57203.07,271717.00
210770,202111,242,196,46,216762.81,50614.82,267377.63
210780,202111,421,324,97,357545.77,106711.63,464257.40
210790,202111,175,145,30,160628.84,33006.12,193634.96
210800,202111,170,133,37,146328.36,40706.7,187035.06
210805,202111,56,50,6,55000.94,6600,61600.94
210810,202111,456,373,83,410370.63,91316.07,501686.70
210820,202111,2029,1699,330,1871455.12,363071.41,2234526.53
210825,202111,151,86,65,94618.11,71516.74,166134.85
210830,202111,708,477,231,524717.11,254110.92,778828.03
210840,202111,188,135,53,148506.09,58301.97,206808.06
210845,202111,226,172,54,189208.02,59401.13,248609.15
210850,202111,714,491,223,540174.39,245324.67,785499.06
210860,202111,3374,1980,1394,2180425.74,1534655.54,3715081.28
210870,202111,410,327,83,359792.1,91323.03,451115.13
210880,202111,75,61,14,67103.65,15400.78,82504.43
210890,202111,313,272,41,299266.65,45111.43,344378.08
210900,202111,631,416,215,457684.22,236542.25,694226.47
210905,202111,60,34,26,37402.3,28601.32,66003.62
210910,202111,1920,1472,448,1619438.07,492867.25,2112305.32
210920,202111,147,61,86,67106.05,94601.47,161707.52
210923,202111,78,63,15,69301.58,16500,85801.58
210927,202111,403,200,203,220004.42,223317.61,443322.03
210930,202111,66,54,12,59401.76,13201.95,72603.71
210940,202111,80,62,18,68202.35,19800,88002.35
210945,202111,197,110,87,121011.01,95705.83,216716.84
210950,202111,514,375,139,413635.83,152917.14,566552.97
210955,202111,89,57,32,62704.33,35201.11,97905.44
210960,202111,2186,1124,1062,1237564.35,1169377.89,2406942.24
210970,202111,107,94,13,103403.86,14300.11,117703.97
210975,202111,77,72,5,79211.28,5501.98,84713.26
210980,202111,1061,526,535,578689.49,589662.05,1168351.54
210990,202111,4437,3100,1337,3413729.14,1470874.48,4884603.62
211000,202111,1272,1037,235,1141952.91,258537.56,1400490.47
211003,202111,953,694,259,763444.87,284920.46,1048365.33
211010,202111,472,426,46,468623.17,51703.58,520326.75
211020,202111,1330,590,740,651260.37,814104.82,1465365.19
211023,202111,44,39,5,42901.48,5500,48401.48
211027,202111,74,54,20,59401.83,22000.57,81402.40
211030,202111,359,260,99,286025.82,108914.21,394940.03
211040,202111,284,240,44,264005.6,48401.04,312406.64
211050,202111,1101,745,356,820729.45,391645.3,1212374.75
211060,202111,619,549,70,603990.96,77009.06,681000.02
211065,202111,24,19,5,20904.13,5500.21,26404.34
211070,202111,852,715,137,786649.92,150727.38,937377.30
211080,202111,85,83,2,91302.9,2200,93502.9
211085,202111,50,28,22,30802.51,24203.11,55005.62
211090,202111,75,64,11,70416.07,12103.9,82519.97
211100,202111,460,387,73,425768.3,80317.02,506085.32
211102,202111,237,169,68,185900,74800.34,260700.34
211105,202111,218,154,64,169410.79,70404.79,239815.58
211107,202111,123,77,46,84700.83,50600.3,135301.13
211110,202111,926,623,303,685400.43,333356.39,1018756.82
211120,202111,5035,2600,2435,2863925.82,2678945.66,5542871.48
211125,202111,23,16,7,17604.28,7700.7,25304.98
211130,202111,40368,18924,21444,20839128.82,23611923.65,44451052.47
211140,202111,398,351,47,387275.39,52810.12,440085.51
211150,202111,1167,809,358,891117.2,394947.94,1286065.14
211153,202111,164,104,60,114400.86,66001.9,180402.76
211157,202111,69,56,13,61605.18,14301.19,75906.37
211160,202111,675,580,95,639154.74,104512.13,743666.87
211163,202111,2,2,0,2200,,2200.0
211167,202111,10,9,1,9900.97,1100.94,11001.91
211170,202111,409,306,103,337727.07,114416.73,452143.80
211172,202111,111,77,34,84702.26,37403.3,122105.56
211174,202111,250,161,89,177100,97900,275000
211176,202111,457,341,116,375137.71,127609.06,502746.77
211178,202111,84,58,26,63805.9,28602.19,92408.09
211180,202111,207,166,41,182613.76,45106.81,227720.57
211190,202111,69,62,7,68202.55,7700,75902.55
211195,202111,33,20,13,22006.22,14304.66,36310.88
211200,202111,149,130,19,144126.13,20903.56,165029.69
211210,202111,411,304,107,334439.36,117720.81,452160.17
211220,202111,4133,2442,1691,2687769.11,1860441.08,4548210.19
211223,202111,96,91,5,100112.01,5500.18,105612.19
211227,202111,53,43,10,47302.72,11001.01,58303.73
211230,202111,703,581,122,640303.33,134223.74,774527.07
211240,202111,373,306,67,336619.35,73702.5,410321.85
211245,202111,177,92,85,101207.05,93509.28,194716.33
211250,202111,1486,1291,195,1420295.15,214532.02,1634827.17
211260,202111,779,656,123,721611.28,135300.54,856911.82
211270,202111,1852,1529,323,1681978.6,355313.2,2037291.8
211280,202111,1748,1145,603,1259642.06,663380.13,1923022.19
211285,202111,206,130,76,144105.89,83600.84,227706.73
211290,202111,704,503,201,553326.54,221112.66,774439.20
211300,202111,736,592,144,651307.48,158421.18,809728.66
211400,202111,1491,940,551,1035218.7,606153.57,1641372.27
220005,202111,15,14,1,15405.23,1100.5,16505.73
220010,202111,84,69,15,75900.25,16500,92400.25
220020,202111,682,553,129,608344.74,143016.27,751361.01
220025,202111,104,101,3,111101.94,3300,114401.94
220027,202111,49,40,9,44001.18,9900,53901.18
220030,202111,116,95,21,104503.41,23100,127603.41
220040,202111,1255,961,294,1059383.69,323427.97,1382811.66
220045,202111,31,20,11,22005.76,12102.51,34108.27
220050,202111,692,576,116,633662.41,127610.45,761272.86
220060,202111,169,148,21,163928.63,23103.15,187031.78
220070,202111,111,97,14,106709.54,15401.4,122110.94
220080,202111,15,13,2,14301.83,2200,16501.83
220090,202111,36,27,9,29700,9900,39600
220095,202111,2,1,1,1100.79,1100,2200.79
220100,202111,21,18,3,19801.99,3300.8,23102.79
220105,202111,27,25,2,27505.2,2200.54,29705.74
220110,202111,232,213,19,234307.35,20900.38,255207.73
220115,202111,40,35,5,39602.71,5500,45102.71
220117,202111,23,21,2,23101.7,2200,25301.7
220120,202111,1481,1135,346,1248599.19,380631.73,1629230.92
220130,202111,28,27,1,29701.85,1100,30801.85
220140,202111,98,79,19,86901.54,20902.39,107803.93
220150,202111,476,360,116,397194.22,127626.11,524820.33
220155,202111,12,11,1,12100,1100,13200
220157,202111,19,16,3,17605.28,3301.07,20906.35
220160,202111,96,86,10,94604.31,11001.22,105605.53
220170,202111,37,33,4,36303.32,4400,40703.32
220173,202111,8,8,0,8800.67,,8800.67
220177,202111,14,13,1,14300.84,1100,15400.84
220180,202111,66,64,2,70403.57,2200,72603.57
220190,202111,1068,931,137,1024194.62,150711.85,1174906.47
220191,202111,35,29,6,31909.37,6601.76,38511.13
220192,202111,89,84,5,92402.24,5500,97902.24
220194,202111,60,54,6,59403.64,6600,66003.64
220196,202111,85,71,14,78113.41,15402.43,93515.84
220198,202111,1,1,0,1100,,1100.0
220200,202111,411,345,66,380696.49,72611.85,453308.34
220202,202111,36,31,5,34109.59,5501.01,39610.60
220205,202111,58,51,7,56101.35,7700,63801.35
220207,202111,12,12,0,13202.82,,13202.82
220208,202111,76,45,31,49504.94,34102.38,83607.32
220209,202111,33,27,6,29703.03,6601.3,36304.33
220210,202111,22,16,6,17602.04,6600.28,24202.32
220211,202111,29,27,2,29703.36,2200.6,31903.96
220213,202111,32,28,4,30808.63,4400.5,35209.13
220217,202111,38,31,7,34101.96,7700,41801.96
220220,202111,2234,1467,767,1613844.81,844894.16,2458738.97
220225,202111,7,2,5,2200,5502.48,7702.48
220230,202111,947,733,214,806374,236528.52,1042902.52
220240,202111,161,142,19,156208.09,20902.38,177110.47
220245,202111,35,32,3,35202.68,3300.26,38502.94
220250,202111,123,105,18,115513.26,19800.87,135314.13
220253,202111,52,46,6,50602.32,6600.5,57202.82
220255,202111,40,34,6,37401.9,6600.4,44002.3
220260,202111,695,526,169,578663.52,185926.35,764589.87
220265,202111,6,5,1,5500,1100.61,6600.61
220270,202111,802,723,79,795369.13,86907.39,882276.52
220271,202111,42,34,8,37405.81,8801.15,46206.96
220272,202111,10,10,0,11000.59,,11000.59
220273,202111,16,14,2,15403.82,2200.89,17604.71
220275,202111,60,49,11,53900.55,12100,66000.55
220277,202111,21,15,6,16501.65,6600.92,23102.57
220280,202111,17,11,6,12101.56,6600,18701.56
220285,202111,40,38,2,41809.01,2200,44009.01
220290,202111,1476,1261,215,1387262.32,236533.73,1623796.05
220300,202111,34,34,0,37408.85,,37408.85
220310,202111,329,281,48,309166.51,52809.16,361975.67
220320,202111,439,405,34,445570.95,37407.21,482978.16
220323,202111,2,1,1,1100,1100,2200
220325,202111,9,8,1,8801.35,1100.34,9901.69
220327,202111,11,11,0,12102.54,,12102.54
220330,202111,237,170,67,187008.65,73704.47,260713.12
220335,202111,138,117,21,128701.04,23100.17,151801.21
220340,202111,44,31,13,34103.28,14301.98,48405.26
220342,202111,54,46,8,50612.66,8803.13,59415.79
220345,202111,77,67,10,73704.65,11000.1,84704.75
220350,202111,457,394,63,434521.66,69305.8,503827.46
220360,202111,39,29,10,31901.24,11000.6,42901.84
220370,202111,1264,1050,214,1155131.41,235423.95,1390555.36
220375,202111,14,14,0,15402.13,,15402.13
220380,202111,26,19,7,20902.71,7700,28602.71
220385,202111,14,13,1,14302.65,1100.27,15402.92
220390,202111,2323,1286,1037,1414805.95,1141969.31,2556775.26
220400,202111,34,30,4,33000.44,4400.95,37401.39
220410,202111,24,22,2,24204.9,2201.66,26406.56
220415,202111,12,11,1,12103.93,1100.97,13204.90
220420,202111,125,105,20,115520.31,22004.54,137524.85
220430,202111,126,112,14,123221.57,15401.37,138622.94
220435,202111,25,17,8,18704.66,8803.14,27507.80
220440,202111,277,237,40,260747.92,44007.55,304755.47
220450,202111,339,171,168,188136,184838.84,372974.84
220455,202111,51,49,2,53906.79,2200,56106.79
220460,202111,19,17,2,18704.14,2200.41,20904.55
220465,202111,79,53,26,58315.03,28607.27,86922.30
220470,202111,240,209,31,231043.51,34107.29,265150.80
220480,202111,72,65,7,71500.8,7700.34,79201.14
220490,202111,89,75,14,82500,15400,97900
220500,202111,113,94,19,103404.8,20901.05,124305.85
220510,202111,383,296,87,325651.95,95711.14,421363.09
220515,202111,20,18,2,19805.14,2200.44,22005.58
220520,202111,368,326,42,358672.88,46210.42,404883.30
220525,202111,9,5,4,5501.18,4401.41,9902.59
220527,202111,15,12,3,13204.7,3300.84,16505.54
220530,202111,42,19,23,20902.2,25301.82,46204.02
220535,202111,7,4,3,4401.14,3301.34,7702.48
220540,202111,77,64,13,70402.43,14300.6,84703.03
220545,202111,27,19,8,20904.33,8801.91,29706.24
220550,202111,699,557,142,612793.59,156225.11,769018.70
220551,202111,18,15,3,16502.72,3300.98,19803.70
220552,202111,9,9,0,9901.52,,9901.52
220553,202111,49,44,5,48407.02,5500.13,53907.15
220554,202111,11,8,3,8801.51,3300.47,12101.98
220555,202111,40,31,9,34106.73,9902.15,44008.88
220556,202111,37,35,2,38504.65,2200.1,40704.75
220557,202111,54,49,5,53913.85,5500.7,59414.55
220558,202111,7,3,4,3300.78,4400.44,7701.22
220559,202111,2,2,0,2201.31,,2201.31
220560,202111,70,45,25,49502.53,27500,77002.53
220570,202111,719,450,269,496148.11,295918.05,792066.16
220580,202111,534,486,48,534735.99,52810.01,587546.00
220585,202111,10,9,1,9901.35,1100.74,11002.09
220590,202111,13,12,1,13202.75,1100,14302.75
220595,202111,70,53,17,58304.71,18702.2,77006.91
220600,202111,19,12,7,13200.48,7701.4,20901.88
220605,202111,24,21,3,23103.11,3300,26403.11
220610,202111,83,70,13,77000.8,14300.6,91301.4
220620,202111,540,453,87,498378.04,95713.57,594091.61
220630,202111,6,5,1,5500.45,1100,6600.45
220635,202111,32,28,4,30809.28,4400.34,35209.62
220640,202111,108,89,19,97900.75,20900,118800.75
220650,202111,112,106,6,116605.56,6600,123205.56
220660,202111,62,47,15,51703.96,16502.67,68206.63
220665,202111,8,8,0,8801.22,,8801.22
220667,202111,16,13,3,14304.43,3300.4,17604.83
220669,202111,31,25,6,27503.05,6600,34103.05
220670,202111,63,50,13,55006.72,14300.44,69307.16
220672,202111,80,59,21,64907.23,23104.1,88011.33
220675,202111,32,25,7,27508.65,7701.48,35210.13
220680,202111,47,40,7,44000,7700,51700
220690,202111,51,48,3,52800.93,3300.6,56101.53
220695,202111,26,14,12,15402.92,13203.15,28606.07
220700,202111,1740,1337,403,1473027.71,445535.6,1918563.31
220710,202111,6,4,2,4400.81,2200.77,6601.58
220720,202111,110,92,18,101202.39,19800,121002.39
220730,202111,17,15,2,16502.84,2200,18702.84
220735,202111,3,0,3,,3300,3300.0
220740,202111,50,45,5,49504.54,5500,55004.54
220750,202111,113,97,16,106705.3,17601.91,124307.21
220755,202111,18,17,1,18707.06,1100.6,19807.66
220760,202111,67,60,7,66004.97,7700,73704.97
220770,202111,5783,3241,2542,3566880.08,2798898.41,6365778.49
220775,202111,15,11,4,12104.67,4400.64,16505.31
220777,202111,20,19,1,20900.72,1100,22000.72
220779,202111,1,0,1,,1100,1100.0
220780,202111,899,767,132,844894.64,145212.54,990107.18
220785,202111,5,1,4,1100.8,4401.82,5502.62
220790,202111,1139,901,238,991262.95,261841.8,1253104.75
220793,202111,6,5,1,5501.61,1100,6601.61
220795,202111,15,13,2,14302.18,2200,16502.18
220800,202111,4003,3058,945,3365538.64,1039640.87,4405179.51
220810,202111,68,59,9,64907.32,9900.44,74807.76
220820,202111,236,214,22,235439.28,24206.53,259645.81
220830,202111,1290,1121,169,1234340.37,187023.1,1421363.47
220840,202111,2446,1724,722,1896676.2,794321.21,2690997.41
220850,202111,67,60,7,66000.6,7700,73700.6
220855,202111,8,4,4,4400.8,4401.2,8802.0
220860,202111,9,8,1,8805.03,1100.92,9905.95
220865,202111,29,26,3,28602.5,3300,31902.5
220870,202111,85,76,9,83606.3,9900.52,93506.82
220880,202111,321,258,63,283842.48,69311.76,353154.24
220885,202111,26,25,1,27502.78,1100.34,28603.12
220887,202111,8,7,1,7702.11,1100,8802.11
220890,202111,91,78,13,85819.77,14302.03,100121.80
220900,202111,26,14,12,15403.55,13203.13,28606.68
220910,202111,47,38,9,41806.83,9901.07,51707.90
220915,202111,11,10,1,11000.15,1100,12100.15
220920,202111,52,45,7,49507.87,7701.61,57209.48
220930,202111,44,42,2,46204.59,2200,48404.59
220935,202111,13,13,0,14307.88,,14307.88
220937,202111,32,29,3,31907.14,3300,35207.14
220940,202111,56,52,4,57202.12,4400,61602.12
220945,202111,2,2,0,2200.34,,2200.34
220950,202111,36,29,7,31905.56,7700.84,39606.40
220955,202111,14,14,0,15403.41,,15403.41
220960,202111,26,23,3,25300.44,3300.34,28600.78
220965,202111,39,35,4,38500,4400,42900
220970,202111,59,50,9,55000.32,9900,64900.32
220975,202111,11,10,1,11005.36,1100,12105.36
220980,202111,30,28,2,30801.22,2200.86,33002.08
220985,202111,55,49,6,53901.97,6600.24,60502.21
220987,202111,31,29,2,31907.92,2200.89,34108.81
220990,202111,27,27,0,29700.25,,29700.25
220995,202111,11,10,1,11001.77,1100.78,12102.55
220997,202111,58,50,8,55011.42,8801.58,63813.00
221000,202111,1187,1065,122,1173831.7,134211.92,1308043.62
221005,202111,35,32,3,35202.6,3300.44,38503.04
221010,202111,18,14,4,15401.13,4400,19801.13
221020,202111,34,33,1,36309.09,1100.78,37409.87
221030,202111,39,31,8,34105.05,8800.78,42905.83
221035,202111,21,20,1,22005.72,1100,23105.72
221037,202111,14,9,5,9902.53,5500.47,15403.00
221038,202111,28,25,3,27500,3300,30800
221039,202111,26,25,1,27500.96,1100.67,28601.63
221040,202111,262,225,37,247549.83,40705.57,288255.40
221050,202111,227,189,38,210141.36,41804.56,251945.92
221060,202111,1924,1664,260,1832754.17,287124.56,2119878.73
221062,202111,30,29,1,31907.32,1100.67,33007.99
221063,202111,15,10,5,11000,5501.01,16501.01
221065,202111,65,53,12,58309.01,13200.49,71509.50
221070,202111,136,118,18,130926.8,19803.17,150729.97
221080,202111,378,320,58,353154.54,63804.22,416958.76
221090,202111,21,16,5,17603.34,5500.72,23104.06
221093,202111,42,30,12,33010.49,13200.77,46211.26
221095,202111,4,4,0,4402.46,,4402.46
221097,202111,12,10,2,11001.86,2201.2,13203.06
221100,202111,25787,15356,10431,16905922.75,11490553.4,28396476.15
221110,202111,1109,837,272,921941.31,299245,1221186.31
221120,202111,533,388,145,426837.55,159512.34,586349.89
221130,202111,963,776,187,854779.81,205718.54,1060498.35
221135,202111,30,26,4,28605.99,4400.89,33006.88
221140,202111,46,40,6,44005.17,6600.51,50605.68
221150,202111,9,7,2,7701.57,2200.17,9901.74
221160,202111,12,12,0,13204.82,,13204.82
221170,202111,17,17,0,18702.64,,18702.64
230010,202111,149,133,16,146302.68,17600.54,163903.22
230015,202111,142,115,27,126503.65,29700,156203.65
230020,202111,1640,1357,283,1493929.86,312432.23,1806362.09
230030,202111,1663,1197,466,1316866.87,512658.1,1829524.97
230040,202111,226,186,40,204604.83,44000.34,248605.17
230050,202111,232,167,65,183704.39,71501.37,255205.76
230060,202111,159,123,36,135300.97,39600.47,174901.44
230070,202111,311,267,44,293705.83,48400.84,342106.67
230075,202111,869,735,134,808599.21,147410.11,956009.32
230080,202111,202,170,32,187013.36,35201.09,222214.45
230090,202111,146,109,37,119905.12,40701.1,160606.22
230100,202111,2349,1321,1028,1454458.04,1132095.64,2586553.68
230110,202111,2895,1824,1071,2006581.9,1180419.03,3187000.93
230120,202111,1071,837,234,920789.22,257431.63,1178220.85
230125,202111,155,125,30,137504.25,33001.19,170505.44
230130,202111,471,415,56,457626.58,61603.9,519230.48
230140,202111,213,172,41,189205.57,45101.21,234306.78
230150,202111,150,115,35,126502.88,38503.32,165006.20
230160,202111,941,782,159,860236.17,176005.37,1036241.54
230170,202111,605,535,70,589688.15,77006.24,666694.39
230180,202111,64,59,5,64900,5500,70400
230185,202111,399,340,59,374041.22,64905.7,438946.92
230190,202111,2429,1881,548,2070383.85,602863.2,2673247.05
230195,202111,503,435,68,478561.18,74809.48,553370.66
230200,202111,420,331,89,365241.72,97904.77,463146.49
230205,202111,388,259,129,287103.43,141902.85,429006.28
230210,202111,1386,1063,323,1169391.13,355324.54,1524715.67
230220,202111,1576,1064,512,1171661.91,563278.56,1734940.47
230230,202111,969,810,159,891085.06,174913.02,1065998.08
230240,202111,1831,1587,244,1746140.43,268426.52,2014566.95
230250,202111,1776,1444,332,1588554.81,365241.87,1953796.68
230260,202111,3219,1986,1233,2187982.5,1358555.53,3546538.03
230270,202111,1359,1072,287,1179307.1,316829.99,1496137.09
230280,202111,2765,2087,678,2295867.72,746959.01,3042826.73
230290,202111,353,314,39,345449.49,42905.96,388355.45
230300,202111,531,388,143,426810.48,157305.37,584115.85
230310,202111,422,325,97,357523.65,106702.96,464226.61
230320,202111,901,762,139,840473.02,152910.8,993383.82
230330,202111,304,242,62,266214.17,68207.16,334421.33
230340,202111,434,347,87,381758.14,95709.79,477467.93
230350,202111,3291,2026,1265,2228835.32,1391650.24,3620485.56
230360,202111,272,225,47,247528.63,51703.9,299232.53
230365,202111,129,105,24,116603.09,26400,143003.09
230370,202111,10712,5245,5467,5774848.17,6018207.97,11793056.14
230380,202111,485,415,70,457650.38,77005.03,534655.41
230390,202111,527,296,231,325616.83,255212.15,580828.98
230393,202111,246,203,43,223301.23,47300,270601.23
230395,202111,346,279,67,306964.49,73714.33,380678.82
230400,202111,631,502,129,552244,141912.66,694156.66
230410,202111,2662,1633,1029,1797609.03,1132075.89,2929684.92
230420,202111,6450,4243,2207,4669013.1,2429178.2,7098191.3
230423,202111,337,295,42,324523.89,46204.45,370728.34
230425,202111,462,367,95,403735.58,104511.09,508246.67
230426,202111,116,91,25,100100.79,27500,127600.79
230427,202111,71,65,6,71509.62,6600,78109.62
230428,202111,1585,777,808,854814.66,889984.73,1744799.39
230430,202111,452,365,87,401540.16,95714.02,497254.18
230435,202111,917,663,254,730444.22,279417.26,1009861.48
230440,202111,93309,41727,51582,45932101.32,56794264.11,102726365.43
230445,202111,315,215,100,236530.2,110009.47,346539.67
230450,202111,580,452,128,497223.28,140802.61,638025.89
230460,202111,79,58,21,63801.58,23101.72,86903.30
230465,202111,312,251,61,276120.52,67108.12,343228.64
230470,202111,2013,1577,436,1737003.25,484031,2221034.25
230480,202111,153,141,12,155104.67,13201.59,168306.26
230490,202111,323,254,69,279410.27,75900.88,355311.15
230495,202111,472,331,141,365247.27,155120.85,520368.12
230500,202111,1033,760,273,836050.08,300320.32,1136370.40
230510,202111,59,43,16,47300.98,17600,64900.98
230520,202111,397,308,89,339926.39,97907.4,437833.79
230523,202111,2437,1504,933,1654568.56,1028615.38,2683183.94
230526,202111,265,226,39,248602,42900.34,291502.34
230530,202111,690,509,181,559975.41,199129.44,759104.85
230533,202111,217,198,19,217808.86,20900.94,238709.80
230535,202111,371,277,94,305844.57,103405.19,409249.76
230540,202111,1798,1600,198,1761283.52,217821.13,1979104.65
230550,202111,3952,2498,1454,2751496.72,1600789.1,4352285.82
230560,202111,580,440,140,485154.54,154017.7,639172.24
230565,202111,217,160,57,176006.81,62704.83,238711.64
230570,202111,284,243,41,267313.67,45104.75,312418.42
230580,202111,1192,847,345,932856.16,379524.55,1312380.71
230590,202111,1004,778,226,855849.47,248621.17,1104470.64
230600,202111,251,227,24,250836.07,26404.17,277240.24
230610,202111,417,311,106,342132.05,116609.78,458741.83
230620,202111,165,142,23,156214.68,25304.13,181518.81
230625,202111,817,553,264,610550.37,290421.92,900972.29
230630,202111,1328,1007,321,1107799.46,354240.42,1462039.88
230640,202111,3773,3149,624,3465364.05,686503.67,4151867.72
230650,202111,501,429,72,471924.86,79207.41,551132.27
230655,202111,693,569,124,625964.12,137514.93,763479.05
230660,202111,361,297,64,326712.35,70406.53,397118.88
230670,202111,450,367,83,403754.68,91303.82,495058.50
230680,202111,207,183,24,201326.17,26401.99,227728.16
230690,202111,926,776,150,855869.66,165008.72,1020878.38
230700,202111,886,736,150,809660.28,165012.87,974673.15
230710,202111,682,639,43,702985.24,47305.9,750291.14
230720,202111,146,124,22,136404.69,24202.38,160607.07
230725,202111,236,177,59,194720,64903.75,259623.75
230730,202111,12578,6655,5923,7322356.85,6519601.11,13841957.96
230740,202111,673,537,136,591877.51,149613.45,741490.96
230750,202111,819,686,133,755768.94,146314.7,902083.64
230760,202111,1451,1247,204,1371882.27,224425.29,1596307.56
230763,202111,337,276,61,303620.76,67104.11,370724.87
230765,202111,8020,3692,4328,4065191.47,4762812.54,8828004.01
230770,202111,4998,2528,2470,2781138.83,2717346.2,5498485.03
230780,202111,754,660,94,726063.41,103405.55,829468.96
230790,202111,297,246,51,270602.21,56100,326702.21
230800,202111,1154,823,331,905364.54,365217.26,1270581.80
230810,202111,1382,1208,174,1328968.95,192529.23,1521498.18
230820,202111,368,250,118,275020.56,129810.07,404830.63
230830,202111,963,811,152,893190.4,167217.61,1060408.01
230835,202111,272,232,40,255234.62,44005.08,299239.70
230837,202111,169,138,31,151809.03,34101.86,185910.89
230840,202111,920,707,213,777758.27,234319.4,1012077.67
230850,202111,1408,1205,203,1327855.29,223325.06,1551180.35
230860,202111,305,224,81,246421.7,89113.18,335534.88
230870,202111,1823,1532,291,1685368.02,321234.35,2006602.37
230880,202111,75,57,18,62702.77,19800.44,82503.21
230890,202111,535,477,58,525848.72,63803.74,589652.46
230900,202111,290,211,79,232118.81,86906.78,319025.59
230910,202111,225,174,51,191414.29,56103.22,247517.51
230920,202111,481,378,103,415826.81,113307.83,529134.64
230930,202111,1025,714,311,785469.22,342133.37,1127602.59
230940,202111,839,641,198,706270.61,217816.02,924086.63
230945,202111,518,414,104,455465.18,114418.94,569884.12
230950,202111,426,366,60,403761.08,66010.44,469771.52
230960,202111,2749,1817,932,2002247.52,1026468.35,3028715.87
230970,202111,1752,972,780,1070441,859224.45,1929665.45
230980,202111,203,162,41,178219.07,45104.45,223323.52
230990,202111,139,108,31,118808.13,34102.89,152911.02
231000,202111,200,183,17,202415.2,18700.34,221115.54
231010,202111,160,111,49,122102.2,53902.97,176005.17
231020,202111,1377,938,439,1033047.52,485179.08,1518226.60
231025,202111,1067,751,316,826211.02,347639.63,1173850.65
231030,202111,1058,877,181,965900.31,199124.74,1165025.05
231040,202111,152,102,50,112206.62,55001.42,167208.04
231050,202111,940,817,123,901327.24,135324.84,1036652.08
231060,202111,159,131,28,144110.88,30804.75,174915.63
231070,202111,1495,1028,467,1130962.52,513749.75,1644712.27
231080,202111,263,236,27,260742.38,29701.96,290444.34
231085,202111,643,389,254,429039.69,279418.6,708458.29
231090,202111,257,205,52,225512.45,57204.32,282716.77
231095,202111,162,130,32,143002.02,35200.14,178202.16
231100,202111,158,126,32,138601.09,35200.81,173801.90
231110,202111,368,309,59,339940.27,64907.02,404847.29
231120,202111,265,221,44,243115.81,48402.79,291518.60
231123,202111,156,146,10,160606.51,11000.84,171607.35
231126,202111,329,248,81,273909.48,89108.79,363018.27
231130,202111,4904,3812,1092,4196811.17,1201347.57,5398158.74
231135,202111,212,183,29,201309.46,31901.73,233211.19
231140,202111,3075,2230,845,2455446.39,930684.58,3386130.97
231150,202111,372,351,21,386137.13,23103.16,409240.29
231160,202111,1221,978,243,1075904.75,268423.08,1344327.83
231170,202111,509,351,158,386138.26,173814.27,559952.53
231180,202111,1751,1508,243,1658988.48,267329.44,1926317.92
231190,202111,209,172,37,189201.45,40701.1,229902.55
231195,202111,225,189,36,209002.68,39601.69,248604.37
231200,202111,806,650,156,715079.85,171622.2,886702.05
231210,202111,522,443,79,487326.82,86904.16,574230.98
231220,202111,1033,739,294,814097.41,323441.1,1137538.51
231230,202111,1482,1129,353,1243088.34,388321.4,1631409.74
231240,202111,1497,1032,465,1136396.03,511545.9,1647941.93
231250,202111,95,90,5,99015.08,5500.08,104515.16
231260,202111,264,174,90,191407.53,99007.76,290415.29
231270,202111,996,789,207,867979.98,227713.56,1095693.54
231280,202111,74,58,16,63800.95,17601.26,81402.21
231290,202111,7851,4362,3489,4801974.36,3840607.29,8642581.65
231300,202111,580,532,48,585263.07,52802.83,638065.90
231310,202111,750,687,63,755766.02,69306.29,825072.31
231320,202111,576,432,144,475238.73,158411.38,633650.11
231325,202111,101,88,13,96807.03,14300,111107.03
231330,202111,1929,1479,450,1627954.34,498359.96,2126314.30
231335,202111,250,222,28,244209.09,30800.68,275009.77
231340,202111,1747,1242,505,1367441.1,555567.32,1923008.42
231350,202111,1323,1053,270,1158435.17,297039.68,1455474.85
231355,202111,423,357,66,392727.67,72602.7,465330.37
231360,202111,533,368,165,405972.19,181522.04,587494.23
231370,202111,93,81,12,89103.73,13200.16,102303.89
231375,202111,293,215,78,237626.59,85809.25,323435.84
231380,202111,487,387,100,425724.33,111103.74,536828.07
231390,202111,209,156,53,171610.88,58302.56,229913.44
231395,202111,763,468,295,514827.48,324517.03,839344.51
231400,202111,1141,948,193,1042886.62,212321.48,1255208.10
231410,202111,1341,1090,251,1200221.74,276135.37,1476357.11
240010,202111,375,164,211,180429.32,232148.75,412578.07
240020,202111,2199,1785,414,1963745.29,456563.02,2420308.31
240030,202111,118,98,20,107801.35,22000.55,129801.90
240040,202111,32,32,0,35201.34,,35201.34
240050,202111,527,449,78,493967.57,85814.38,579781.95
240060,202111,68,64,4,70403.48,4400.44,74803.92
240070,202111,234,181,53,199109.32,58301.48,257410.80
240080,202111,529,356,173,392740.23,190323,583063.23
240090,202111,102,91,11,100100.8,12100.21,112201.01
240100,202111,1460,1376,84,1513769.16,93509.59,1607278.75
240110,202111,1024,673,351,740418.17,386184.62,1126602.79
240120,202111,146,109,37,119904.28,40701.85,160606.13
240130,202111,273,254,19,279442.9,20901.82,300344.72
240140,202111,78,54,24,59408.27,26402.01,85810.28
240145,202111,716,627,89,689738.06,97903.92,787641.98
240150,202111,24,17,7,18701.1,7700.13,26401.23
240160,202111,41,33,8,36301.11,8800.69,45101.80
240165,202111,40,32,8,35204.46,8802.62,44007.08
240170,202111,128,83,45,91304.95,49501.46,140806.41
240180,202111,100,76,24,83604.15,26401.07,110005.22
240185,202111,45,40,5,44000.16,6600.34,50600.50
240190,202111,15,13,2,14300.88,2200.34,16501.22
240200,202111,3060,1655,1405,1820721.7,1547915.49,3368637.19
240210,202111,164,125,39,138601.94,42900.74,181502.68
240220,202111,1105,781,324,859175.93,356436.8,1215612.73
240230,202111,828,755,73,831729.69,80311.66,912041.35
240240,202111,69,48,21,52801.78,23100.08,75901.86
240250,202111,90,77,13,84709.91,14301.66,99011.57
240260,202111,1811,1291,520,1420262.97,572066.36,1992329.33
240270,202111,179,156,23,171606.79,25300,196906.79
240280,202111,54,42,12,46200,13200,59400
240290,202111,40,38,2,41801.72,2200,44001.72
240300,202111,170,90,80,99003.05,88002.9,187005.95
240310,202111,2413,1292,1121,1421347.4,1233247.57,2654594.97
240320,202111,178,165,13,182601.02,14300.5,196901.52
240325,202111,4681,2707,1974,2979257.7,2175065.18,5154322.88
240330,202111,71,67,4,73700.98,4400,78100.98
240340,202111,83,55,28,60504.84,30801.75,91306.59
240350,202111,92,75,17,82502.89,18700.2,101203.09
240360,202111,608,363,245,399362.9,270632.88,669995.78
240370,202111,53,46,7,50601.43,7700,58301.43
240375,202111,61,37,24,40706.35,26404.65,67111.00
240380,202111,225,184,41,202423.7,45104.21,247527.91
240390,202111,14,12,2,13201.08,2200.34,15401.42
240400,202111,84,75,9,82503.28,9902.51,92405.79
240410,202111,13,7,6,7700,6600.6,14300.6
240420,202111,1046,762,284,838258.56,313520.73,1151779.29
240430,202111,260,242,18,266243.82,19801.1,286044.92
240440,202111,121,63,58,69303.98,63803.37,133107.35
240450,202111,241,153,88,169415.19,96811.85,266227.04
240460,202111,73,58,15,63800.96,16500,80300.96
240470,202111,215,193,22,213436.85,24204.31,237641.16
240480,202111,15,13,2,14300.17,2201.44,16501.61
240485,202111,83,66,17,72603.35,18701.38,91304.73
240490,202111,46,42,4,46202.09,4400.95,50603.04
240500,202111,90,68,22,75900.84,24200,100100.84
240510,202111,42,30,12,33000.44,13200,46200.44
240520,202111,100,95,5,104516.73,5500.2,110016.93
240530,202111,56,47,9,51700.77,9900.88,61601.65
240540,202111,83,70,13,77000,14300.51,91300.51
240550,202111,12,11,1,12100.44,1100,13200.44
240560,202111,378,270,108,297022.18,118804.16,415826.34
240570,202111,435,274,161,301446.85,177137.38,478584.23
240580,202111,1277,982,295,1080299.71,324522.82,1404822.53
240590,202111,31,29,2,31900.55,2200,34100.55
240600,202111,96,90,6,99000.65,6600.5,105601.15
240610,202111,508,420,88,462081.49,96815.77,558897.26
240615,202111,15,14,1,15403.94,1100.5,16504.44
240620,202111,89,85,4,93502.94,4400,97902.94
240630,202111,40,33,7,36307.25,7700.82,44008.07
240640,202111,24,20,4,22002.48,4400.23,26402.71
240650,202111,240,195,45,214512.7,49501.53,264014.23
240660,202111,108,91,17,100103.47,18700.54,118804.01
240670,202111,311,168,143,184826.19,157329.83,342156.02
240680,202111,54,41,13,45102.13,14300.77,59402.90
240690,202111,46,43,3,47308.57,3301.59,50610.16
240700,202111,181,148,33,162800,36300.87,199100.87
240710,202111,2126,1275,851,1404838.25,936183.38,2341021.63
240720,202111,1046,753,293,829460.9,322327.1,1151788.0
240725,202111,64,59,5,64902.48,5500.37,70402.85
240730,202111,150,125,25,137503.41,27500,165003.41
240740,202111,231,195,36,214531.85,39609.35,254141.20
240750,202111,53,31,22,34100,24202.77,58302.77
240760,202111,52,45,7,49500.98,7700,57200.98
240770,202111,144,110,34,121002.03,37400.9,158402.93
240780,202111,699,579,120,639162.59,132017.48,771180.07
240790,202111,42,40,2,44006.09,2200.88,46206.97
240800,202111,9408,6345,3063,6981612.51,3371021.94,10352634.45
240810,202111,21248,11237,10011,12370440.17,11025011.12,23395451.29
240820,202111,248,146,102,160615.73,112218.03,272833.76
240830,202111,1591,1313,278,1444420.77,305827.54,1750248.31
240840,202111,76,67,9,73707.79,9901.81,83609.60
240850,202111,82,73,9,80301.88,9900.78,90202.66
240860,202111,107,101,6,111103.32,6600,117703.32
240870,202111,60,51,9,56108.53,9901.78,66010.31
240880,202111,33,28,5,30801.78,5500,36301.78
240890,202111,1130,617,513,678792.42,564368.17,1243160.59
240895,202111,64,49,15,55001.73,16500.59,71502.32
240910,202111,171,144,27,158404.74,29701.18,188105.92
240920,202111,13,11,2,12102.33,2200.4,14302.73
240930,202111,407,361,46,397162.11,50609.18,447771.29
240933,202111,57,36,21,39601.79,23101.92,62703.71
240940,202111,2286,2013,273,2216678,300338.39,2517016.39
240950,202111,46,41,5,45103.91,5500,50603.91
240960,202111,25,21,4,23103.46,4401.14,27504.60
240970,202111,111,83,28,91301.09,30801.33,122102.42
240980,202111,196,158,38,173804.99,41802.61,215607.60
240990,202111,135,90,45,99003.1,49502.25,148505.35
241000,202111,59,55,4,60505.7,4400.34,64906.04
241010,202111,75,57,18,62700,19800,82500
241020,202111,105,97,8,106705.83,8802.21,115508.04
241025,202111,15,7,8,7700.53,8802.38,16502.91
241030,202111,106,85,21,93501.32,24200,117701.32
241040,202111,43,31,12,34100,13200.67,47300.67
241050,202111,78,69,9,75900.32,9900,85800.32
241060,202111,27,22,5,24201.74,5500.84,29702.58
241070,202111,17,16,1,17603.77,1100,18703.77
241080,202111,58,51,7,56103.54,7700.98,63804.52
241090,202111,52,39,13,42908.27,14300.57,57208.84
241100,202111,73,62,11,68207.11,12101.25,80308.36
241105,202111,13,5,8,5500,8801.1,14301.1
241110,202111,45,39,6,42900.67,6600.5,49501.17
241120,202111,1533,1153,380,1269472.65,419132.2,1688604.85
241140,202111,210,174,36,191417.44,39603.4,231020.84
241142,202111,44,32,12,35202.91,13202.45,48405.36
241150,202111,1200,1043,157,1148517.8,172720.33,1321238.13
241160,202111,22,16,6,17600,6600,24200
241170,202111,45,38,7,41800,7700,49500
241180,202111,43,32,11,35207.04,12102.74,47309.78
241190,202111,39,37,2,40705.49,2200.34,42905.83
241200,202111,4123,2149,1974,2369794.65,2172874.47,4542669.12
241210,202111,69,59,10,64902.22,11001.11,75903.33
241220,202111,1455,946,509,1040724.57,559968.54,1600693.11
241230,202111,249,205,44,225518.63,48407.35,273925.98
241240,202111,59,45,14,49502.1,15400.78,64902.88
241250,202111,1129,1029,100,1133137.68,110013.43,1243151.11
241255,202111,53,44,9,48402.09,9900.5,58302.59
241260,202111,674,515,159,566542.02,174915.96,741457.98
241270,202111,62,43,19,47302.21,20900.67,68202.88
241280,202111,95,83,12,91307.02,13201.31,104508.33
241290,202111,123,86,37,94611.43,40703.98,135315.41
241300,202111,82,56,26,61601.68,28601.18,90202.86
241310,202111,48,34,14,37401.05,15400.07,52801.12
241320,202111,27,14,13,15403.31,14302.06,29705.37
241330,202111,59,51,8,56102.31,8800,64902.31
241335,202111,79,70,9,77001.95,9900,86901.95
241340,202111,183,135,48,148506.85,52801.97,201308.82
241350,202111,60,51,9,56101.96,9900,66001.96
241355,202111,48,40,8,44005.21,8802.87,52808.08
241360,202111,50,49,1,53901.87,1100,55001.87
241370,202111,59,45,14,49500,15400,64900
241380,202111,35,31,4,34103.89,4400.53,38504.42
241390,202111,83,64,19,70400.17,20900,91300.17
241400,202111,216,165,51,181500.94,56100.54,237601.48
241410,202111,176,160,16,177106.88,17600.6,194707.48
241415,202111,103,82,21,90201.07,23101,113302.07
241420,202111,109,75,34,82503.83,37403.87,119907.70
241430,202111,22,20,2,22003.12,2200,24203.12
241440,202111,515,428,87,470876.04,95716.29,566592.33
241445,202111,40,35,5,38501.5,5500.84,44002.34
241450,202111,257,213,44,235422.94,48409.22,283832.16
241460,202111,142,129,13,141906.2,14300.87,156207.07
241470,202111,35,30,5,33002.27,5501.13,38503.40
241475,202111,53,47,6,51701.84,6600.81,58302.65
241480,202111,114,85,29,93503.81,31902.2,125406.01
241490,202111,10,9,1,9900.74,1100.07,11000.81
241500,202111,42,33,9,36303.26,9901.67,46204.93
250010,202111,99,84,15,92402.96,16500.46,108903.42
250020,202111,33,28,5,30801.18,5500.4,36301.58
250030,202111,891,654,237,719463.04,260729.81,980192.85
250040,202111,387,315,72,346553.77,80310.02,426863.79
250050,202111,261,212,49,233205.45,53903.77,287109.22
250053,202111,62,48,14,52808.09,16501.92,69310.01
250057,202111,2,1,1,1100,1100,2200
250060,202111,595,430,165,474156.71,181529.8,655686.51
250070,202111,680,542,138,596292.54,151829.28,748121.82
250073,202111,7,7,0,7700.87,,7700.87
250077,202111,173,127,46,139707.28,50603.31,190310.59
250080,202111,421,332,89,366349.58,97912.71,464262.29
250090,202111,221,142,79,156201.6,86900.54,243102.14
250100,202111,536,443,93,487361.27,102311.93,589673.20
250110,202111,657,485,172,533540.04,190307.87,723847.91
250115,202111,16,3,13,3301.65,14306.83,17608.48
250120,202111,123,89,34,99001.77,37404.33,136406.10
250130,202111,558,445,113,489583.9,124323.37,613907.27
250135,202111,22,11,11,12100,12100.18,24200.18
250140,202111,81,72,9,79207.2,9900,89107.2
250150,202111,604,426,178,468640.35,195816.38,664456.73
250153,202111,12,9,3,9901.39,3300,13201.39
250157,202111,29,24,5,26400.48,5500,31900.48
250160,202111,234,183,51,201324.29,56105.52,257429.81
250170,202111,72,47,25,51702.54,27500.73,79203.27
250180,202111,4594,3134,1460,3450004.26,1606254.06,5056258.32
250190,202111,826,549,277,603932.91,304726.18,908659.09
250200,202111,58,43,15,47303.1,16501.17,63804.27
250205,202111,24,20,4,22001.24,4400.94,26402.18
250210,202111,87,75,12,82500.44,13200,95700.44
250215,202111,70,54,16,59406.68,17600.79,77007.47
250220,202111,26,18,8,19801.55,8800.94,28602.49
250230,202111,77,69,8,75905.49,8801.13,84706.62
250240,202111,235,181,54,199118.54,59406.21,258524.75
250250,202111,370,318,52,349867.02,57207.64,407074.66
250260,202111,43,35,8,38500,8800.4,47300.4
250270,202111,75,52,23,57200,25300,82500
250280,202111,370,298,72,327818.24,79205.07,407023.31
250290,202111,91,82,9,90204.09,9900.57,100104.66
250300,202111,569,380,189,418039.43,207917.18,625956.61
250310,202111,44,40,4,44004.25,4400.34,48404.59
250320,202111,1979,1302,677,1433485.77,744808.72,2178294.49
250330,202111,103,88,15,96806,16500.71,113306.71
250340,202111,29,24,5,26401.51,5500.27,31901.78
250350,202111,189,123,66,135307.15,72603.17,207910.32
250355,202111,31,23,8,25301.51,8801.06,34102.57
250360,202111,190,157,33,172717.51,36306,209023.51
250370,202111,2372,1524,848,1676616.26,932945.5,2609561.76
250375,202111,14,8,6,8802.41,6600.11,15402.52
250380,202111,55,43,12,47303.57,13202.73,60506.30
250390,202111,46,35,11,39604.83,12102.06,51706.89
250400,202111,16559,8242,8317,9075193.69,9154631.01,18229824.70
250403,202111,317,248,69,272810.76,75902.96,348713.72
250407,202111,63,51,12,56100,13201.49,69301.49
250410,202111,29,25,4,27505.57,4400.67,31906.24
250415,202111,44,28,16,30800.31,17600,48400.31
250420,202111,38,32,6,35201.69,6600.44,41802.13
250430,202111,1417,1219,198,1341294.52,218922.71,1560217.23
250435,202111,24,17,7,18702.16,7700.34,26402.50
250440,202111,673,558,115,613858.13,126513.26,740371.39
250450,202111,83,64,19,70405.08,20900.5,91305.58
250460,202111,471,306,165,337716.97,181513.21,519230.18
250470,202111,95,64,31,70401,34100.14,104501.14
250480,202111,329,260,69,286052.78,75921.88,361974.66
250485,202111,4,4,0,4400,,4400.0
250490,202111,237,192,45,211201.16,49501.65,260702.81
250500,202111,92,70,22,77003.31,24200,101203.31
250510,202111,790,617,173,678754.41,190312.08,869066.49
250520,202111,170,112,58,124303.23,63804.06,188107.29
250523,202111,121,99,22,110001.84,24201.46,134203.30
250527,202111,114,87,27,95702.06,29700,125402.06
250530,202111,6,3,3,3300,3300.34,6600.34
250535,202111,30,22,8,24201.62,8801.11,33002.73
250540,202111,138,109,29,119904.84,31901.04,151805.88
250550,202111,67,65,2,71501.9,2200,73701.9
250560,202111,56,36,20,39600,22000.44,61600.44
250570,202111,155,126,29,138602.67,31900.98,170503.65
250580,202111,98,74,24,81472.88,26400,107872.88
250590,202111,22,12,10,13200.44,11003.33,24203.77
250600,202111,1475,958,517,1053911.05,569850.73,1623761.78
250610,202111,156,128,28,140829.33,30803.93,171633.26
250620,202111,21,17,4,18701.6,4400.44,23102.04
250625,202111,72,54,18,59419.72,19807.37,79227.09
250630,202111,3126,1974,1152,2173791.37,1267398.25,3441189.62
250640,202111,194,154,40,169422.47,44006.23,213428.70
250650,202111,26,18,8,19800.86,8800.98,28601.84
250660,202111,60,44,16,48400,17600.77,66000.77
250670,202111,64,47,17,51701.94,18700.59,70402.53
250680,202111,413,329,84,361951.19,92411.2,454362.39
250690,202111,2115,1441,674,1586316.1,745876.56,2332192.66
250700,202111,915,778,137,855862.85,150709.84,1006572.69
250710,202111,446,351,95,386153.86,104520.11,490673.97
250720,202111,120,87,33,95702.68,36300.67,132003.35
250730,202111,414,345,69,379536.79,75911.47,455448.26
250740,202111,63,61,2,67102.26,2200,69302.26
250750,202111,23399,13854,9545,15249945,10511034.88,25760979.88
250760,202111,104,83,21,91300.83,23100,114400.83
250770,202111,360,232,128,256328.78,140810.96,397139.74
250780,202111,70,44,26,48400.42,28600.06,77000.48
250790,202111,458,289,169,317922.35,185914.01,503836.36
250800,202111,149,132,17,145201.64,18700.67,163902.31
250810,202111,77,62,15,68200.94,16500.44,84701.38
250820,202111,148,125,23,137514.17,25302.04,162816.21
250830,202111,444,286,158,314662.38,173821.56,488483.94
250840,202111,57,51,6,56104.75,6601.47,62706.22
250850,202111,53,44,9,48400.96,9900,58300.96
250855,202111,16,14,2,15404.19,2201.14,17605.33
250860,202111,245,156,89,171603.49,97907.99,269511.48
250870,202111,29,26,3,28601.68,3300,31901.68
250880,202111,86,65,21,71501.1,23100,94601.1
250890,202111,3029,2241,788,2465264.91,866873.46,3332138.37
250900,202111,59,49,10,53901.71,11000,64901.71
250905,202111,119,89,30,97901.7,33000.67,130902.37
250910,202111,1044,767,277,843775.4,304733.99,1148509.39
250915,202111,108,75,33,82507.63,36302.55,118810.18
250920,202111,134,96,38,106702.45,41800.67,148503.12
250930,202111,180,104,76,114400.44,83602.76,198003.20
250933,202111,8,5,3,5500,3300.88,8800.88
250937,202111,16,16,0,17600.5,,17600.5
250939,202111,30,25,5,27502.46,5500,33002.46
250940,202111,116,85,31,93505.7,34102.87,127608.57
250950,202111,72,50,22,55003.13,24201.72,79204.85
250960,202111,92,50,42,55002.19,46200,101202.19
250970,202111,1241,871,370,959307.22,407032.25,1366339.47
250980,202111,103,69,34,75905.63,38500,114405.63
250990,202111,170,130,40,143000,44000,187000
251000,202111,78,67,11,73700.92,12100.87,85801.79
251010,202111,120,90,30,99001.78,33002.52,132004.30
251020,202111,76,62,14,68201.26,15400,83601.26
251030,202111,46,34,12,37402.55,13200.49,50603.04
251040,202111,53,36,17,39600.13,18700,58300.13
251050,202111,24,21,3,23100,3300,26400
251060,202111,50,40,10,44005.57,11000.4,55005.97
251065,202111,7,4,3,4400,3301.34,7701.34
251070,202111,17,13,4,14301.68,4401.15,18702.83
251080,202111,5233,2441,2792,2685356.84,3076003.57,5761360.41
251090,202111,187,157,30,172708.53,33005.78,205714.31
251100,202111,20,19,1,20902.5,1100,22002.5
251110,202111,51,34,17,37400,18700.44,56100.44
251120,202111,1911,1166,745,1283895.63,819625.14,2103520.77
251130,202111,425,350,75,385037.14,82504.92,467542.06
251140,202111,575,367,208,403737.66,228815.04,632552.70
251150,202111,342,283,59,311349.23,66006.75,377355.98
251160,202111,98,77,21,84702.43,23100,107802.43
251170,202111,95,76,19,83603.26,20900.54,104503.80
251180,202111,287,167,120,183723.9,132017.42,315741.32
251190,202111,195,127,68,139706.75,74807.81,214514.56
251200,202111,276,217,59,238734.88,64907.19,303642.07
251203,202111,36,33,3,36303.64,3300,39603.64
251207,202111,85,71,14,78101.78,15400,93501.78
251210,202111,1487,1083,404,1191402.19,444466.2,1635868.39
251220,202111,44,34,10,37403.24,11001.55,48404.79
251230,202111,579,478,101,525867.53,112214.18,638081.71
251240,202111,106,73,33,80300.81,36300.98,116601.79
251250,202111,1432,1017,415,1119841.88,456549.47,1576391.35
251260,202111,12,8,4,8803.25,4400.34,13203.59
251270,202111,303,237,66,260737.59,72608.33,333345.92
251272,202111,66,58,8,63801.46,8800.2,72601.66
251274,202111,27,21,6,23102.24,6602.18,29704.42
251275,202111,36,21,15,23102.71,16501.83,39604.54
251276,202111,23,19,4,20900.2,4400,25300.2
251278,202111,11,9,2,9901.85,2200.98,12102.83
251280,202111,101,96,5,105602.67,5500,111102.67
251290,202111,943,670,273,737061.07,301432.01,1038493.08
251300,202111,16,11,5,12100.88,5501.04,17601.92
251310,202111,295,213,82,234325.52,90209.7,324535.22
251315,202111,39,35,4,38500,4400,42900
251320,202111,71,54,17,59404.74,18702.83,78107.57
251330,202111,82,71,11,78103.17,12101.28,90204.45
251335,202111,23,9,14,9900,15401.8,25301.8
251340,202111,769,445,324,489537.72,356429.49,845967.21
251350,202111,35,34,1,37400.39,1100,38500.39
251360,202111,84,73,11,80301.38,13200,93501.38
251365,202111,8,7,1,7701.75,1100,8801.75
251370,202111,5723,3863,1860,4252880.37,2050566.71,6303447.08
251380,202111,46,35,11,38504.51,12101.56,50606.07
251385,202111,2,2,0,2200.5,,2200.5
251390,202111,902,666,236,732715.66,259643.25,992358.91
251392,202111,26,16,10,17601.49,11000.94,28602.43
251394,202111,9,9,0,9901.22,,9901.22
251396,202111,15,10,5,11000.47,5502.06,16502.53
251398,202111,15,12,3,13200.81,3300.6,16501.41
251400,202111,46,37,9,40703.4,9900.34,50603.74
251410,202111,40,34,6,37401.81,6601,44002.81
251420,202111,102,75,27,82504.42,29704.11,112208.53
251430,202111,47,42,5,46200,5500.44,51700.44
251440,202111,50,27,23,29700.94,25300,55000.94
251445,202111,59,50,9,55006.55,9901.18,64907.73
251450,202111,388,336,52,370776.43,58310.81,429087.24
251455,202111,6,5,1,5500.94,1100.5,6601.44
251460,202111,21,16,5,17600.72,5500,23100.72
251465,202111,7,5,2,5500.44,2201.11,7701.55
251470,202111,52,40,12,44000.84,13200.67,57201.51
251480,202111,28,23,5,25300.88,5500.96,30801.84
251490,202111,112,70,42,77022.39,46213.24,123235.63
251500,202111,122,100,22,110004.58,24200.26,134204.84
251510,202111,75,46,29,50603.12,31902.01,82505.13
251520,202111,32,29,3,31901.04,3300,35201.04
251530,202111,4330,3052,1278,3357387.04,1409232.43,4766619.47
251540,202111,82,68,14,74801.39,15402.57,90203.96
251550,202111,405,305,100,335548.35,111120.59,446668.94
251560,202111,25,17,8,18702.81,8801.58,27504.39
251570,202111,18,16,2,17600,2200,19800
251580,202111,136,106,30,117702.05,33000,150702.05
251590,202111,110,75,35,82708.34,38500.67,121209.01
251593,202111,27,17,10,18701.32,11000.85,29702.17
251597,202111,100,77,23,84702.34,25302.34,110004.68
251600,202111,1096,761,335,838288.85,368522.8,1206811.65
251610,202111,236,174,62,192516.81,68203.81,260720.62
251615,202111,12,11,1,12100.4,1100,13200.4
251620,202111,4188,2683,1505,2951592.42,1655683.3,4607275.72
251630,202111,462,341,121,375161.63,133121.16,508282.79
251640,202111,128,94,34,104515.37,37410.32,141925.69
251650,202111,283,206,77,226632.36,84709.99,311342.35
251660,202111,191,168,23,184833.82,25304.25,210138.07
251670,202111,387,297,90,326751.77,99014.43,425766.20
251675,202111,10,8,2,8800,2201.27,11001.27
251680,202111,101,88,13,96802.71,14300.89,111103.60
251690,202111,320,263,57,289342.29,62706.68,352048.97
251700,202111,279,241,38,265144.72,42909.27,308053.99
251710,202111,20,12,8,13200.44,8801.77,22002.21
251720,202111,24,16,8,17603.69,8801.93,26405.62
251740,202111,13,10,3,11002.32,3300,14302.32
260005,202111,3441,1823,1618,2007304.13,1782265.96,3789570.09
260010,202111,1639,1203,436,1323390.38,480739.53,1804129.91
260020,202111,411,354,57,389461.53,63808.75,453270.28
260030,202111,596,401,195,442270.17,214523.61,656793.78
260040,202111,806,488,318,536900.24,349836.18,886736.42
260050,202111,1164,828,336,910893.78,369634.38,1280528.16
260060,202111,372,339,33,372940.19,36304.8,409244.99
260070,202111,1311,794,517,875769.31,568822.87,1444592.18
260080,202111,712,545,167,599616.11,183726.72,783342.83
260090,202111,486,320,166,353134.43,182626.15,535760.58
260100,202111,208,145,63,159506.84,69301.68,228808.52
260105,202111,256,142,114,156203.71,125401.94,281605.65
260110,202111,2915,2122,793,2337830.29,872399.04,3210229.33
260120,202111,2700,1449,1251,1595443.76,1377359.21,2972802.97
260130,202111,179,119,60,130905.68,67103.1,198008.78
260140,202111,2182,1420,762,1563285.46,838289.65,2401575.11
260150,202111,196,125,71,137524.42,78112.61,215637.03
260160,202111,337,276,61,303632.33,67105.84,370738.17
260170,202111,3339,1995,1344,2198101.4,1479692.05,3677793.45
260180,202111,176,140,36,154009.93,39603.61,193613.54
260190,202111,2345,1547,798,1701900.88,877912.88,2579813.76
260200,202111,972,765,207,841589.66,228815.09,1070404.75
260210,202111,1390,975,415,1074818.8,456555.99,1531374.79
260220,202111,662,594,68,653481.98,74809.27,728291.25
260230,202111,1228,910,318,1002185.11,349833.98,1352019.09
260240,202111,205,152,53,167223.96,58306.3,225530.26
260250,202111,86,63,23,69308.73,25302.16,94610.89
260260,202111,1061,728,333,800881.43,366335.55,1167216.98
260270,202111,261,189,72,207914.34,79205.15,287119.49
260280,202111,1142,907,235,1001103.95,258522.74,1259626.69
260290,202111,6743,3637,3106,4004480.45,3418211.41,7422691.86
260300,202111,980,830,150,913100.7,165013.11,1078113.81
260310,202111,517,413,104,454357.48,114416.18,568773.66
260320,202111,830,602,228,663322,250809.02,914131.02
260330,202111,69,49,20,53900.91,22001.31,75902.22
260340,202111,74,56,18,61607.34,19800.91,81408.25
260345,202111,5572,2921,2651,3213591.97,2918798.89,6132390.86
260350,202111,487,345,142,379555.42,156217.39,535772.81
260360,202111,240,131,109,144104.69,121001.71,265106.40
260370,202111,750,467,283,513769.11,311349.48,825118.59
260380,202111,564,407,157,448868.14,172724.37,621592.51
260390,202111,289,244,45,268436.59,49508.71,317945.30
260392,202111,112,95,17,104505.2,18700.6,123205.8
260400,202111,4325,2445,1880,2691847.24,2069257.22,4761104.46
260410,202111,14922,7707,7215,8484254.21,7941876.55,16426130.76
260415,202111,141,120,21,132006.35,23100.34,155106.69
260420,202111,1728,1049,679,1153980.3,746956.71,1900937.01
260430,202111,172,156,16,171636.77,17602.04,189238.81
260440,202111,192,131,61,144115.2,67111.49,211226.69
260450,202111,429,319,110,352041.93,121021.42,473063.35
260460,202111,826,430,396,473059.41,435649.5,908708.91
260470,202111,332,201,131,222236.59,144118.9,366355.49
260480,202111,254,157,97,172702.95,106702.33,279405.28
260490,202111,220,174,46,191419,50603.28,242022.28
260500,202111,1122,752,370,827320.32,407064.92,1234385.24
260510,202111,787,620,167,682045.1,183712.35,865757.45
260515,202111,230,207,23,227709.13,25304.53,253013.66
260520,202111,3238,1989,1249,2188116.96,1374055.18,3562172.14
260530,202111,803,652,151,717297.79,166120.91,883418.70
260540,202111,522,410,112,451054.42,123216.65,574271.07
260545,202111,15,11,4,12102.37,4400.61,16502.98
260550,202111,328,208,120,228807.6,132002.39,360809.99
260560,202111,502,378,124,415871.7,136420.5,552292.2
260570,202111,987,780,207,858127.76,228817.8,1086945.56
260580,202111,262,226,36,248620.64,39602.06,288222.70
260590,202111,621,354,267,389410.41,293710.63,683121.04
260600,202111,7656,4386,3270,4829417.32,3599600.84,8429018.16
260610,202111,496,329,167,361953.89,184824.23,546778.12
260620,202111,3652,1873,1779,2060481.24,1959312.4,4019793.64
260630,202111,81,75,6,82500,6600,89100
260640,202111,3372,1928,1444,2120997.71,1588588.84,3709586.55
260650,202111,316,225,91,247538.99,100115.21,347654.20
260660,202111,565,357,208,392747.15,228819.13,621566.28
260670,202111,101,72,29,79200.51,31900.58,111101.09
260680,202111,3919,2149,1770,2365378.21,1949610.01,4314988.22
260690,202111,125,93,32,103409.42,35203.77,138613.19
260700,202111,308,205,103,225534.66,113325.51,338860.17
260710,202111,44,35,9,38501.02,9900.85,48401.87
260720,202111,2648,1550,1098,1707358.13,1208991.32,2916349.45
260730,202111,750,550,200,605037.33,220013.17,825050.50
260740,202111,69,57,12,62702.12,13200,75902.12
260750,202111,559,405,154,445571.84,169429.08,615000.92
260760,202111,684,333,351,366345.36,386147.65,752493.01
260765,202111,971,496,475,545643.92,522561.59,1068205.51
260770,202111,224,162,62,178207,68209.16,246416.16
260775,202111,776,417,359,458749.05,394956.74,853705.79
260780,202111,239,147,92,161700.76,101202.49,262903.25
260790,202111,15053,7425,7628,8173102.65,8394165.1,16567267.75
260795,202111,160,102,58,112201.4,63800.11,176001.51
260800,202111,288,234,54,257428.23,59403.77,316832.00
260805,202111,172,112,60,123206.48,66005.63,189212.11
260810,202111,794,650,144,715083.49,158411.13,873494.62
260820,202111,291,188,103,206808.26,113305.34,320113.60
260825,202111,208,139,69,152901.54,75900.93,228802.47
260830,202111,298,181,117,199102.62,128702.66,327805.28
260840,202111,254,184,70,202422.42,77005.37,279427.79
260845,202111,173,109,64,119901.48,71503.32,191404.80
260850,202111,410,305,105,335541.22,115507.68,451048.90
260860,202111,251,186,65,204608.14,71504.52,276112.66
260870,202111,346,263,83,290446.3,91312.56,381758.86
260875,202111,727,530,197,583083.12,218924.59,802007.71
260880,202111,1539,1005,534,1105561,587423.34,1692984.34
260890,202111,2348,1616,732,1777777.72,805289.7,2583067.42
260900,202111,990,703,287,773373.38,315747.87,1089121.25
260910,202111,251,196,55,215619.58,60507.51,276127.09
260915,202111,277,208,69,228800.61,75900,304700.61
260920,202111,197,101,96,111100.51,105601.39,216701.90
260930,202111,373,314,59,345452.11,64905.91,410358.02
260940,202111,2599,1369,1230,1506137.3,1353247.51,2859384.81
260950,202111,1996,1125,871,1237628.83,959342.65,2196971.48
260960,202111,13633,6640,6993,7309696.6,7699241.87,15008938.47
260970,202111,416,341,75,375158.34,82507.35,457665.69
260980,202111,199,180,19,198014.05,22000.88,220014.93
260990,202111,2648,2119,529,2332294.34,583066.36,2915360.70
261000,202111,4199,2552,1647,2810694.07,1811842.08,4622536.15
261010,202111,153,108,45,118804.09,49507.88,168311.97
261020,202111,583,434,149,477476.57,163917.44,641394.01
261030,202111,259,187,72,205701.63,79206.96,284908.59
261040,202111,377,324,53,357551.77,58306.84,415858.61
261050,202111,498,425,73,467567.13,80310.67,547877.80
261060,202111,1430,878,552,965894.02,607253.92,1573147.94
261070,202111,9145,4347,4798,4785759.12,5284304.15,10070063.27
261080,202111,367,281,86,309155.52,95711.01,404866.53
261090,202111,2099,1610,489,1771189.96,537952.12,2309142.08
261100,202111,1207,843,364,927404.59,400436.3,1327840.89
261110,202111,8952,5460,3492,6013441.41,3843901.91,9857343.32
261120,202111,241,206,35,226604.2,38502.47,265106.67
261130,202111,565,333,232,366380.76,255248.12,621628.88
261140,202111,218,133,85,146304.08,93501.64,239805.72
261150,202111,681,432,249,476340.68,273919.95,750260.63
261153,202111,69,64,5,70404.28,5500,75904.28
261160,202111,74801,36440,38361,40112627.14,42236407.71,82349034.85
261170,202111,470,344,126,378409.95,138606.87,517016.82
261180,202111,1773,1100,673,1211484.35,741478.57,1952962.92
261190,202111,569,396,173,436752.96,191414.67,628167.63
261200,202111,219,180,39,198027.46,42904.94,240932.40
261210,202111,40,31,9,34101.12,9900.28,44001.40
261220,202111,2722,1897,825,2089066.28,908700.42,2997766.70
261230,202111,342,248,94,272821.62,103407.09,376228.71
261240,202111,439,381,58,419128.14,63802.97,482931.11
261245,202111,248,202,46,222202.86,50601.88,272804.74
261247,202111,167,129,38,141915.7,41805.03,183720.73
261250,202111,3423,1621,1802,1783345.05,1982475.59,3765820.64
261255,202111,249,222,27,244205.59,29701.57,273907.16
261260,202111,836,721,115,793234.76,126519.41,919754.17
261270,202111,197,135,62,149611.28,68202.67,217813.95
261280,202111,188,151,37,166127.91,40701.63,206829.54
261290,202111,112,83,29,91300.66,31901.88,123202.54
261300,202111,1323,972,351,1069293.27,386138.22,1455431.49
261310,202111,786,523,263,575382.49,289341.39,864723.88
261320,202111,565,378,187,415848.67,205733.26,621581.93
261330,202111,910,703,207,773443.85,227749.9,1001193.75
261340,202111,306,167,139,183717.81,152910.97,336628.78
261350,202111,857,592,265,654611.5,291546.24,946157.74
261360,202111,1355,864,491,950448.24,540142.04,1490590.28
261370,202111,4833,2823,2010,3107806.65,2211257.92,5319064.57
261380,202111,535,410,125,451031.29,137523.5,588554.79
261390,202111,3629,2436,1193,2683305.55,1313626.25,3996931.80
261400,202111,274,248,26,272836.15,28600.78,301436.93
261410,202111,1109,723,386,795382.32,426829.36,1222211.68
261420,202111,940,581,359,639171.57,394932.15,1034103.72
261430,202111,318,289,29,319032.85,31902.38,350935.23
261440,202111,110,104,6,114410.44,6600,121010.44
261450,202111,2499,1974,525,2172730.26,578660.45,2751390.71
261460,202111,750,582,168,640304.45,185922.72,826227.17
261470,202111,230,186,44,204607.97,49501.78,254109.75
261480,202111,452,346,106,380647.42,116562.97,497210.39
261485,202111,365,217,148,239824.92,162817.34,402642.26
261500,202111,602,401,201,442288.37,221137.15,663425.52
261510,202111,51,32,19,35202.36,20900.78,56103.14
261520,202111,89,73,16,80309.68,17602.6,97912.28
261530,202111,4059,2549,1510,2807411.92,1661156.52,4468568.44
261540,202111,1433,828,605,911971.85,665559.19,1577531.04
261550,202111,257,125,132,137503.01,146305.42,283808.43
261560,202111,898,582,316,640290.91,347653.5,987944.41
261570,202111,393,310,83,341062.93,91319.61,432382.54
261580,202111,390,309,81,341053.7,89108.76,430162.46
261590,202111,190,155,35,170523.74,38503.71,209027.45
261600,202111,284,223,61,245340.58,67104.37,312444.95
261610,202111,83,71,12,78105.82,13201.64,91307.46
261618,202111,76,57,19,62704.49,20901.22,83605.71
261620,202111,194,121,73,133108.63,80303.36,213411.99
261630,202111,670,531,139,585257.92,152919.44,738177.36
261640,202111,6512,3391,3121,3731746.58,3434794.43,7166541.01
261650,202111,476,302,174,332214.68,191407.2,523621.88
270010,202111,503,445,58,489581.16,63814.02,553395.18
270020,202111,244,199,45,219559.25,49508.91,269068.16
270030,202111,8759,5599,3160,6164151.87,3478538.55,9642690.42
270040,202111,2061,1328,733,1461986.36,806374.86,2268361.22
270050,202111,198,152,46,167210.69,50603.27,217813.96
270060,202111,74,49,25,55013.44,27508.27,82521.71
270070,202111,838,614,224,675457.43,246420.19,921877.62
270080,202111,39,32,7,35202.5,7700.29,42902.79
270090,202111,23,16,7,17600,7700,25300
270100,202111,1320,901,419,992256.96,460952.99,1453209.95
270110,202111,74,63,11,69305.4,12100.78,81406.18
270120,202111,232,190,42,209025.69,46207.16,255232.85
270130,202111,320,236,84,259619.42,93513.09,353132.51
270135,202111,122,84,38,92403.14,41800,134203.14
270140,202111,1366,886,480,975767.27,529190.11,1504957.38
270150,202111,253,195,58,215632.09,63807.06,279439.15
270160,202111,482,381,101,419144.94,111119.36,530264.30
270170,202111,790,514,276,565419.01,303611.43,869030.44
270180,202111,57,46,11,50602.23,12100.54,62702.77
270190,202111,113,95,18,104508.36,19801.49,124309.85
270200,202111,113,100,13,110005.69,14300.44,124306.13
270210,202111,535,325,210,358624.07,231021.39,589645.46
270220,202111,182,138,44,151806.11,48404.94,200211.05
270230,202111,2151,1335,816,1468591.86,898763.14,2367355.00
270235,202111,664,515,149,566552.66,163917.21,730469.87
270240,202111,2948,2341,607,2575298.57,667779.97,3243078.54
270250,202111,123,90,33,99021.67,36310.37,135332.04
270255,202111,209,178,31,195801.11,34100,229901.11
270260,202111,361,292,69,321250.12,77014.15,398264.27
270270,202111,98,52,46,57203.06,50603.23,107806.29
270280,202111,225,132,93,145200,102300.23,247500.23
270290,202111,1103,865,238,951591.28,261833.32,1213424.60
270300,202111,349,257,92,282702.25,101201.54,383903.79
270310,202111,811,675,136,742580.03,149614.24,892194.27
270320,202111,787,678,109,748091.12,119916.52,868007.64
270330,202111,302,254,48,279404.46,52800.99,332205.45
270340,202111,57,46,11,50602.94,12100.04,62702.98
270350,202111,91,54,37,59404.46,40705.57,100110.03
270360,202111,66,38,28,41803.93,30800.78,72604.71
270370,202111,60,46,14,51700,15400,67100
270375,202111,75,45,30,49504.66,33003.14,82507.80
270380,202111,1061,706,355,778806.51,390506.71,1169313.22
270390,202111,151,86,65,94601.82,71501.52,166103.34
270400,202111,730,552,178,607590.15,195818.98,803409.13
270410,202111,621,460,161,506034.36,177113.75,683148.11
270420,202111,401,279,122,306925.94,134219.72,441145.66
270430,202111,33959,24325,9634,26781085.99,10614622.48,37395708.47
270440,202111,474,376,98,413646.88,107812.4,521459.28
270450,202111,835,494,341,543453.07,375140.1,918593.17
270460,202111,179,141,38,155124.31,41812.43,196936.74
270470,202111,1538,1063,475,1170516.58,522565.08,1693081.66
270480,202111,528,429,99,471932.57,108909.85,580842.42
270490,202111,20,15,5,16500.88,5500.44,22001.32
270500,202111,484,405,79,445563.79,86910,532473.79
270510,202111,848,540,308,594079.02,338839.26,932918.28
270520,202111,271,177,94,195801.96,103403.76,299205.72
270530,202111,60,51,9,56101.23,9900,66001.23
270540,202111,91,67,24,73700.81,26400.44,100101.25
270550,202111,1700,1310,390,1441111.75,429038.94,1870150.69
270560,202111,258,152,106,168323.74,116626.04,284949.78
270570,202111,538,379,159,416921.11,174916.9,591838.01
270580,202111,80,63,17,69300,18700.67,88000.67
270590,202111,59,46,13,50605.53,14302.26,64907.79
270600,202111,159,135,24,148533.42,26405.44,174938.86
270610,202111,235,186,49,204611.68,53904.7,258516.38
270620,202111,13,13,0,14300.88,,14300.88
270630,202111,3690,2799,891,3081166.32,980200.98,4061367.30
270640,202111,854,638,216,701871.91,237631.83,939503.74
270642,202111,211,177,34,194713.93,37405.51,232119.44
270644,202111,252,171,81,188107.48,89113.31,277220.79
270650,202111,333,200,133,221115.46,146307.78,367423.24
270660,202111,197,172,25,189225.67,27505.55,216731.22
270670,202111,2922,2228,694,2454292.09,763469.59,3217761.68
270680,202111,405,248,157,272837.84,172724.97,445562.81
270690,202111,1212,808,404,889961.26,444439.63,1334400.89
270700,202111,25,20,5,22000.88,5500,27500.88
270710,202111,856,675,181,744779.7,199128.38,943908.08
270720,202111,231,183,48,201320.25,52808.08,254128.33
270730,202111,1886,1170,716,1287132.97,787693.03,2074826.00
270740,202111,37,24,13,26400.39,14300.5,40700.89
270750,202111,631,481,150,529118.61,165011.66,694130.27
270760,202111,295,209,86,231031.64,94610.99,325642.63
270770,202111,2770,1866,904,2054961.29,994532.78,3049494.07
270780,202111,64,41,23,45101.17,25301.63,70402.80
270790,202111,237,153,84,168320.72,92416.62,260737.34
270800,202111,2023,1616,407,1779974.96,447745.89,2227720.85
270810,202111,222,184,38,202407.25,41804.55,244211.80
270820,202111,130,91,39,100108.58,42907.35,143015.93
270830,202111,813,617,196,678818.46,215644.35,894462.81
270840,202111,1336,1025,311,1127579.64,342125.45,1469705.09
270850,202111,1508,976,532,1073659.28,586350.45,1660009.73
270860,202111,2543,1707,836,1877822.1,919709.79,2797531.89
270870,202111,114,65,49,71503.67,53904.43,125408.10
270880,202111,860,683,177,752476.3,194719.67,947195.97
270890,202111,272,206,66,226608.86,72604.31,299213.17
270895,202111,54,52,2,57201.58,2200,59401.58
270900,202111,64,54,10,59407.6,11001.28,70408.88
270910,202111,293,241,52,265152.21,57207.54,322359.75
270915,202111,1914,1250,664,1375093.32,730483.58,2105576.90
270920,202111,435,363,72,400443.79,79210.71,479654.50
270930,202111,5788,4414,1374,4858016.67,1513813.66,6371830.33
270940,202111,2203,1737,466,1911948.16,513751.1,2425699.26
280010,202111,38,32,6,35203.33,6600.11,41803.44
280020,202111,482,412,70,453235.88,77004.54,530240.42
280030,202111,21009,13545,7464,14907562.84,8215195.17,23122758.01
280040,202111,327,211,116,232120.47,127616.07,359736.54
280050,202111,423,325,98,357531.9,107813.04,465344.94
280060,202111,354,233,121,256323.14,134215.28,390538.42
280067,202111,1109,799,310,880058.5,342131.85,1222190.35
280070,202111,130,107,23,117705.25,25300.88,143006.13
280100,202111,649,498,151,547853.44,166119.21,713972.65
280110,202111,74,67,7,73706.84,7701.22,81408.06
280120,202111,663,551,112,606139.49,123209.22,729348.71
280130,202111,1745,1142,603,1256273.67,663336.12,1919609.79
280140,202111,486,405,81,446634.5,89105.24,535739.74
280150,202111,415,287,128,315724.22,140808.92,456533.14
280160,202111,130,104,26,114406.67,28600.94,143007.61
280170,202111,420,292,128,321236.42,140810.97,462047.39
280190,202111,28,23,5,25301.5,5501.07,30802.57
280200,202111,37,30,7,33007.2,7702.22,40709.42
280210,202111,2932,2098,834,2307929.77,918578.67,3226508.44
280220,202111,47,37,10,40705.65,11001.01,51706.66
280230,202111,332,269,63,295938.33,69309.05,365247.38
280240,202111,127,119,8,130920.9,8801.38,139722.28
280250,202111,20,12,8,13200.59,8801.54,22002.13
280260,202111,76,69,7,75909.18,7701.01,83610.19
280270,202111,141,109,32,119903.6,35202.95,155106.55
280280,202111,188,121,67,133113.5,73705.37,206818.87
280290,202111,3482,2503,979,2755740.77,1079244.26,3834985.03
280300,202111,1597,1263,334,1389465.46,368552.27,1758017.73
280310,202111,96,91,5,100109.18,5500,105609.18
280320,202111,647,455,192,500582.2,211231.09,711813.29
280330,202111,319,235,84,258544.2,92413.25,350957.45
280340,202111,445,355,90,390538.68,100112.9,490651.58
280350,202111,3726,2861,865,3147536.03,951624.17,4099160.20
280360,202111,468,318,150,349836.48,165021.73,514858.21
280370,202111,94,82,12,90211.89,13202.76,103414.65
280380,202111,52,39,13,42900.78,14302.12,57202.90
280390,202111,172,145,27,159508.6,29701.11,189209.71
280400,202111,376,253,123,278326.11,135310.02,413636.13
280410,202111,286,236,50,259640.24,55010.25,314650.49
280420,202111,135,116,19,127617.75,22001.79,149619.54
280430,202111,86,68,18,74805.21,19803.17,94608.38
280440,202111,731,588,143,646854.61,157317.93,804172.54
280445,202111,121,112,9,123212.48,9902.33,133114.81
280450,202111,1248,1074,174,1181523.72,191422.01,1372945.73
280460,202111,647,468,179,514875.27,196935.39,711810.66
280470,202111,110,99,11,108930.32,12103.43,121033.75
280480,202111,2867,1945,922,2140885.61,1014350.47,3155236.08
280490,202111,201,189,12,207955.65,13201.93,221157.58
280500,202111,42,39,3,42906.58,3301.39,46207.97
280510,202111,133,104,29,114411.18,31904.75,146315.93
280520,202111,51,37,14,40702.29,15401.33,56103.62
280530,202111,79,49,30,53905.4,33009.89,86915.29
280540,202111,536,458,78,503834.6,85803.48,589638.08
280550,202111,732,674,58,741488.8,63807.33,805296.13
280560,202111,482,429,53,471957.19,58309.16,530266.35
280570,202111,2323,1822,501,2005418.64,551141.08,2556559.72
280580,202111,580,449,131,493971.24,144122.32,638093.56
280590,202111,222,142,80,156219.4,88011.49,244230.89
280600,202111,392,324,68,358692.71,74804.94,433497.65
280610,202111,110,79,31,86921.27,34103.33,121024.60
280620,202111,534,433,101,476326.17,111102.58,587428.75
280630,202111,150,125,25,137511.08,27500.51,165011.59
280640,202111,189,152,37,167208.44,40701.51,207909.95
280650,202111,91,57,34,62704.69,37402.25,100106.94
280660,202111,138,102,36,112214.77,39607.18,151821.95
280670,202111,1929,1214,715,1336677.37,786611.75,2123289.12
280680,202111,230,198,32,217809.82,35200.99,253010.81
280690,202111,83,72,11,79202.54,12100.55,91303.09
280700,202111,19,19,0,20901.13,,20901.13
280710,202111,1497,1154,343,1269523.66,377346.22,1646869.88
280720,202111,121,82,39,90209.67,42903.68,133113.35
280730,202111,29,24,5,26402.53,5500.34,31902.87
280740,202111,2546,1897,649,2088010.85,713954.39,2801965.24
280750,202111,231,200,31,220059.72,34105.88,254165.60
280760,202111,840,569,271,625968.09,298132.66,924100.75
290010,202111,194,135,59,148519.81,64906.25,213426.06
290020,202111,189,171,18,188117.67,19802.79,207920.46
290030,202111,624,400,224,440046.68,246425.24,686471.92
290035,202111,132,108,24,118812.17,26401.49,145213.66
290040,202111,302,204,98,224420.54,107807.39,332227.93
290050,202111,87,70,17,77001.62,18700,95701.62
290060,202111,255,112,143,123204.34,157302.77,280507.11
290070,202111,5781,2735,3046,3012367.93,3353446.16,6365814.09
290080,202111,446,194,252,213424.63,278326.51,491751.14
290090,202111,366,164,202,180404.98,222204.38,402609.36
290100,202111,1672,1071,601,1178266.96,662299.64,1840566.60
290110,202111,846,488,358,539096.64,393852.47,932949.11
290115,202111,194,178,16,195824.39,17600.99,213425.38
290120,202111,782,521,261,573197.78,288229.24,861427.02
290130,202111,449,276,173,303643.36,190318.22,493961.58
290135,202111,297,229,68,253036.04,74808.88,327844.92
290140,202111,318,262,56,288259.12,61610.79,349869.91
290150,202111,131,88,43,96802.08,47301.04,144103.12
290160,202111,245,188,57,206838.12,62709.03,269547.15
290170,202111,94,65,29,71511.97,31904.65,103416.62
290180,202111,186,134,52,147418.17,57203.13,204621.30
290190,202111,370,292,78,321272.41,85814.94,407087.35
290195,202111,300,193,107,212314.19,117700.44,330014.63
290200,202111,259,211,48,232111.8,52803.1,284914.9
290205,202111,145,91,54,101214.32,59406.48,160620.80
290210,202111,1184,867,317,954957.5,348743.06,1303700.56
290220,202111,192,106,86,116632.76,94623.79,211256.55
290225,202111,299,122,177,134202.74,194708.06,328910.80
290230,202111,77,47,30,51704.59,33003.46,84708.05
290240,202111,362,123,239,135311.35,262910.6,398221.95
290250,202111,247,229,18,251953.05,19801.02,271754.07
290260,202111,326,263,63,289370.39,69318.71,358689.10
290265,202111,183,161,22,178232.03,24203.52,202435.55
290270,202111,1399,1167,232,1283949.55,255243.88,1539193.43
290280,202111,471,331,140,365274.45,154026.77,519301.22
290290,202111,1363,812,551,893266.29,606139.55,1499405.84
290300,202111,401,343,58,377380.9,63812.46,441193.36
290310,202111,289,137,152,150704.25,167208.19,317912.44
290320,202111,4125,2511,1614,2762563.67,1776772.65,4539336.32
290323,202111,192,168,24,184837.67,26406.25,211243.92
290327,202111,158,123,35,136427.3,38504.5,174931.8
290330,202111,118,59,59,64904.01,64903.82,129807.83
290340,202111,782,320,462,352068.76,508287.76,860356.52
290350,202111,666,411,255,453266.94,280532.76,733799.70
290360,202111,317,244,73,268445.06,80312.39,348757.45
290370,202111,911,401,510,441119.79,561017.17,1002136.96
290380,202111,325,208,117,228833.12,128720.74,357553.86
290390,202111,2416,1495,921,1644779.39,1013265.38,2658044.77
290395,202111,235,134,101,147413.75,111109.48,258523.23
290400,202111,282,203,79,223343.5,86914.16,310257.66
290405,202111,249,212,37,233213.03,40700.8,273913.83
290410,202111,620,513,107,565471.85,117711.27,683183.12
290420,202111,263,212,51,233220.86,56105.34,289326.20
290430,202111,472,296,176,325616.47,193611.13,519227.60
290440,202111,77,68,9,74801.22,9900,84701.22
290450,202111,184,138,46,151816.56,50607.95,202424.51
290460,202111,1923,1138,785,1254227.2,864707.19,2118934.39
290470,202111,1361,592,769,652392.32,847133.36,1499525.68
290475,202111,559,521,38,573149.41,41801.92,614951.33
290480,202111,277,160,117,176010.21,128707.99,304718.20
290485,202111,237,216,21,237609.89,23100,260709.89
290490,202111,1242,880,362,969183.84,398247.9,1367431.74
290500,202111,761,396,365,435668.71,401551.37,837220.08
290510,202111,201,159,42,174939.78,46209.92,221149.70
290515,202111,159,95,64,104510.74,70404.16,174914.90
290520,202111,1387,900,487,991252.5,535765.45,1527017.95
290530,202111,290,264,26,290452.16,28607.95,319060.11
290540,202111,111,56,55,61606.92,60507.45,122114.37
290550,202111,160,136,24,151803.46,26400.94,178204.40
290560,202111,3177,1375,1802,1513754.08,1983476.96,3497231.04
290570,202111,6371,3060,3311,3367784.8,3643918.47,7011703.27
290580,202111,1267,755,512,830592.18,563257.96,1393850.14
290590,202111,567,458,109,503868.22,119920.92,623789.14
290600,202111,1745,1193,552,1312551.56,608396.45,1920948.01
290610,202111,181,165,16,181548.04,17605.61,199153.65
290620,202111,365,329,36,361957.7,39603.72,401561.42
290630,202111,1967,841,1126,925208.87,1238727.56,2163936.43
290640,202111,142,113,29,124330.39,31907.67,156238.06
290650,202111,1821,842,979,928575.3,1077092.59,2005667.89
290660,202111,263,216,47,237648.15,51704.14,289352.29
290670,202111,947,479,468,529214.06,516002.93,1045216.99
290680,202111,1235,987,248,1086909.42,272828.69,1359738.11
290682,202111,315,232,83,255220.54,91312.16,346532.70
290685,202111,244,154,90,170519.07,99005.78,269524.85
290687,202111,1099,709,390,780212.14,430171.64,1210383.78
290689,202111,151,79,72,86908.67,79202.96,166111.63
290690,202111,588,252,336,277248.75,369673.24,646921.99
290700,202111,238,119,119,130928.02,130931.4,261859.42
290710,202111,759,511,248,562176.84,272838.46,835015.30
290720,202111,1025,823,202,906521.49,222228.67,1128750.16
290730,202111,1207,703,504,773373.66,554451.27,1327824.93
290740,202111,22,18,4,19801.11,4400,24201.11
290750,202111,1425,614,811,675556.88,894496.02,1570052.90
290755,202111,71,63,8,69308.31,8800,78108.31
290760,202111,259,229,30,251963.12,33007.77,284970.89
290770,202111,179,170,9,187020.17,9900.03,196920.20
290780,202111,1105,867,238,953818.56,261835.36,1215653.92
290790,202111,373,253,120,278337.74,132022.32,410360.06
290800,202111,2424,970,1454,1069303.17,1601800.5,2671103.67
290810,202111,477,324,153,356461.99,168320.32,524782.31
290820,202111,403,233,170,256353.66,187032.17,443385.83
290830,202111,424,300,124,330029.45,136411.34,466440.79
290840,202111,1801,1115,686,1227770.62,755786.38,1983557.00
290850,202111,912,460,452,506083.44,497278.82,1003362.26
290860,202111,639,287,352,315756.61,387259.29,703015.90
290870,202111,617,433,184,476366.69,202421.95,678788.64
290880,202111,117,63,54,69303.57,59402,128705.57
290890,202111,429,262,167,289318.62,183716.33,473034.95
290900,202111,165,124,41,136407.27,45102.49,181509.76
290910,202111,384,290,94,319014.44,103404.51,422418.95
290920,202111,198,174,24,191435.03,27503.99,218939.02
290930,202111,508,386,122,424695.24,134229.89,558925.13
290940,202111,228,192,36,213410.89,39604.61,253015.50
290950,202111,159,92,67,101203.32,73700.23,174903.55
290960,202111,465,323,142,356447.4,156223.64,512671.04
290970,202111,241,212,29,233215.71,31903,265118.71
290980,202111,1742,1190,552,1310238.23,607263.72,1917501.95
290990,202111,400,337,63,370769.51,69312.53,440082.04
291000,202111,885,276,609,303611.19,669909.43,973520.62
291005,202111,2463,1051,1412,1157395.69,1555632.92,2713028.61
291010,202111,161,143,18,157324.99,19801.39,177126.38
291020,202111,94,74,20,82500.62,22001.04,104501.66
291030,202111,92,65,27,71502.06,29705.95,101208.01
291040,202111,616,350,266,385008.52,292602.15,677610.67
291050,202111,1500,797,703,876811.98,773385.03,1650197.01
291060,202111,1647,910,737,1001118.44,811891.31,1813009.75
291070,202111,1950,1457,493,1605135.31,542379,2147514.31
291072,202111,7142,2635,4507,2898950,4961806.22,7860756.22
291075,202111,238,191,47,210109.05,51702.87,261811.92
291077,202111,57,39,18,42902.72,19800.89,62703.61
291080,202111,20591,8780,11811,9668614.8,13005434.34,22674049.14
291085,202111,272,222,50,245327.68,55007.1,300334.78
291090,202111,280,115,165,126505.93,181512.47,308018.40
291100,202111,1008,335,673,368500,740300.88,1108800.88
291110,202111,424,325,99,357575.17,108915.75,466490.92
291120,202111,2411,1233,1178,1356493.23,1297052.48,2653545.71
291125,202111,59,30,29,33004.4,31905.61,64910.01
291130,202111,193,169,24,185944.08,26406.31,212350.39
291140,202111,126,105,21,115518.68,23103.57,138622.25
291150,202111,381,144,237,158402.73,260703.71,419106.44
291160,202111,378,305,73,335560.06,80311.09,415871.15
291165,202111,47,36,11,39601.63,12101.41,51703.04
291170,202111,3219,1584,1635,1742614.82,1798702.17,3541316.99
291180,202111,1238,495,743,544599.94,817445.66,1362045.60
291185,202111,105,99,6,108906.55,6600.78,115507.33
291190,202111,1382,654,728,720613.61,800930.66,1521544.27
291200,202111,167,121,46,133122.58,50605.69,183728.27
291210,202111,2364,936,1428,1029718.41,1572036.4,2601754.81
291220,202111,287,221,66,243117.11,72603.12,315720.23
291230,202111,958,329,629,361976.92,692016.69,1053993.61
291240,202111,412,385,27,423536.38,29701.84,453238.22
291250,202111,423,340,83,375127.44,91304.96,466432.40
291260,202111,60,52,8,57201.7,8800.39,66002.09
291270,202111,1047,455,592,500632.97,651363.6,1151996.57
291280,202111,355,166,189,182629.93,207920.5,390550.43
291290,202111,1683,876,807,963800.54,890089.7,1853890.24
291300,202111,228,180,48,199145.8,52809.93,251955.73
291310,202111,226,200,26,220024.57,28601.14,248625.71
291320,202111,1320,925,395,1019890,434572.12,1454462.12
291330,202111,135,114,21,125422.92,23103.92,148526.84
291340,202111,224,134,90,147416.17,99016.67,246432.84
291345,202111,124,85,39,93508.92,42902.44,136411.36
291350,202111,1727,629,1098,691926.95,1207867.34,1899794.29
291360,202111,8352,3955,4397,4354541.59,4840737.18,9195278.77
291370,202111,1108,642,466,706333.86,512696.28,1219030.14
291380,202111,257,204,53,224407.68,58303.21,282710.89
291390,202111,3988,1764,2224,1940709.57,2451207.65,4391917.22
291400,202111,2075,1456,619,1605273.01,681021.85,2286294.86
291410,202111,189,160,29,176025.4,31901.22,207926.62
291420,202111,112,86,26,94600.7,28600.34,123201.04
291430,202111,166,97,69,106713.44,75909.14,182622.58
291440,202111,521,423,98,465362.54,107815.22,573177.76
291450,202111,929,602,327,664502.88,359751.15,1024254.03
291460,202111,1927,1544,383,1698706.82,421382.2,2120089.02
291465,202111,2240,1064,1176,1171671.5,1293769.53,2465441.03
291470,202111,2867,1439,1428,1583131.27,1571037.36,3154168.63
291480,202111,11835,5091,6744,5602054,7431537.33,13033591.33
291490,202111,635,255,380,280526.67,418027.12,698553.79
291500,202111,371,219,152,240932.86,167239.85,408172.71
291510,202111,1198,464,734,510406.42,807415.66,1317822.08
291520,202111,933,415,518,456572.7,570981.12,1027553.82
291530,202111,906,243,663,267310.55,729319.13,996629.68
291535,202111,117,97,20,106701.16,22000.84,128702.00
291540,202111,363,119,244,130913.89,268424.77,399338.66
291550,202111,1282,598,684,657875.25,753572.02,1411447.27
291560,202111,5123,2546,2577,2800912.27,2837214.6,5638126.87
291570,202111,214,109,105,119905.27,115504.93,235410.20
291580,202111,1198,737,461,811913.69,507166.69,1319080.38
291590,202111,99,43,56,47302.77,61607.82,108910.59
291600,202111,1124,559,565,616135.59,622725.75,1238861.34
291610,202111,1408,678,730,745962.31,803171.22,1549133.53
291620,202111,571,269,302,295957.84,332262.21,628220.05
291630,202111,485,152,333,167206.42,366307.27,533513.69
291640,202111,3996,1993,2003,2192608.19,2208006.47,4400614.66
291650,202111,435,298,137,327862.55,150728.59,478591.14
291660,202111,367,149,218,163924.26,239839.5,403763.76
291670,202111,176,109,67,119914.35,73706.59,193620.94
291680,202111,636,386,250,424682.65,275046.83,699729.48
291685,202111,573,326,247,358647.84,271740.52,630388.36
291690,202111,461,289,172,319035.82,189242.32,508278.14
291700,202111,999,770,229,848242.55,251926.02,1100168.57
291710,202111,1582,767,815,843811.94,897740.23,1741552.17
291720,202111,422,286,136,314613.65,149605.04,464218.69
291730,202111,920,530,390,585303.07,429067.27,1014370.34
291733,202111,289,192,97,211229.39,106710.39,317939.78
291735,202111,75,57,18,62702.45,19801.99,82504.44
291740,202111,345,263,82,289356,90215.08,379571.08
291750,202111,2246,1450,796,1596421.65,877973.33,2474394.98
291760,202111,3006,1644,1362,1810693.96,1498284.44,3308978.40
291770,202111,744,510,234,561128.82,257452.54,818581.36
291780,202111,65,38,27,41808.95,29706.35,71515.30
291790,202111,156,81,75,89103.02,82500.62,171603.64
291800,202111,10175,4225,5950,4651382.42,6546974.49,11198356.91
291810,202111,1073,806,267,887830.99,293748.86,1181579.85
291820,202111,281,200,81,220016.2,89102.39,309118.59
291830,202111,1033,419,614,460983.28,675510.79,1136494.07
291835,202111,549,508,41,559949.83,45105,605054.83
291840,202111,5046,2496,2550,2749370.17,2807620.11,5556990.28
291845,202111,267,83,184,91301.76,202405.94,293707.70
291850,202111,310,275,35,302549.42,38505.67,341055.09
291855,202111,256,107,149,117704.02,163903.29,281607.31
291860,202111,160,99,61,108903.18,67102.07,176005.25
291870,202111,80,35,45,38500.44,49501.26,88001.70
291875,202111,162,151,11,166136.76,12103.7,178240.46
291880,202111,419,338,81,371878.06,89121.93,460999.99
291890,202111,240,81,159,89100.6,174904.91,264005.51
291900,202111,55,32,23,35200,25300,60500
291905,202111,112,86,26,94619.24,28607.95,123227.19
291910,202111,157,124,33,136406.18,36304.3,172710.48
291915,202111,433,384,49,423583.18,53905.96,477489.14
291920,202111,5303,2591,2712,2850714.55,2987087.29,5837801.84
291930,202111,166,100,66,111120.1,72608.62,183728.72
291940,202111,367,211,156,232136.44,171625.39,403761.83
291950,202111,1133,898,235,989031.42,258520.17,1247551.59
291955,202111,1331,802,529,882335.99,583099.81,1465435.80
291960,202111,201,147,54,161717.39,59402.28,221119.67
291970,202111,762,566,196,622688.65,215617.75,838306.40
291980,202111,1461,1274,187,1402838.36,205730.16,1608568.52
291990,202111,141,131,10,144110.7,11000.21,155110.91
291992,202111,176,90,86,99021.5,94615.54,193637.04
291995,202111,188,120,68,132008.99,74804.14,206813.13
292000,202111,403,300,103,332229.29,113310.76,445540.05
292010,202111,323,222,101,244214.82,111109.03,355323.85
292020,202111,300,221,79,243131.86,86909.76,330041.62
292030,202111,142,108,34,118811.2,37401.88,156213.08
292040,202111,598,307,291,337702.62,320105.36,657807.98
292045,202111,116,103,13,113303.96,14300.68,127604.64
292050,202111,928,671,257,738198.55,283842.79,1022041.34
292060,202111,877,712,165,783316.66,181520.33,964836.99
292070,202111,62,24,38,26402.52,41802.65,68205.17
292080,202111,148,102,46,112200.9,50601.11,162802.01
292090,202111,521,178,343,195809.2,377322.63,573131.83
292100,202111,1506,651,855,716259.62,940740.89,1657000.51
292105,202111,185,165,20,181502.35,22000.14,203502.49
292110,202111,2246,819,1427,901024.72,1569885.88,2470910.60
292120,202111,700,541,159,595238.77,174927.29,770166.06
292130,202111,459,256,203,281635.93,223331.3,504967.23
292140,202111,214,170,44,187044.21,48406.28,235450.49
292145,202111,162,84,78,92405.76,85806.21,178211.97
292150,202111,1487,1223,264,1346628.92,290450.13,1637079.05
292160,202111,158,126,32,138610.84,35202.52,173813.36
292170,202111,1181,1017,164,1118874.19,180422.26,1299296.45
292180,202111,228,167,61,183728.29,67107.57,250835.86
292190,202111,156,102,54,112223.42,59409.55,171632.97
292200,202111,1389,506,883,557759.4,972488.46,1530247.86
292205,202111,117,99,18,110006.05,19800.68,129806.73
292210,202111,378,259,119,284928.85,130910.18,415839.03
292220,202111,32,21,11,23104.6,12100.34,35204.94
292225,202111,44,35,9,38506.93,9900,48406.93
292230,202111,964,731,233,805315.67,257424.04,1062739.71
292240,202111,615,444,171,488493.85,188132.81,676626.66
292250,202111,1663,1071,592,1180494.82,652386.89,1832881.71
292260,202111,402,240,162,264032.92,178217.78,442250.70
292265,202111,245,180,65,198028.71,71510.9,269539.61
292270,202111,715,336,379,369647.18,416953.82,786601.00
292273,202111,208,119,89,132011.08,97906.96,229918.04
292275,202111,166,83,83,91303.24,91306.06,182609.30
292280,202111,144,100,44,110002.18,48400.81,158402.99
292285,202111,84,66,18,72600.83,19800,92400.83
292290,202111,578,384,194,422457.94,213423.02,635880.96
292300,202111,1736,648,1088,713986.76,1196933.3,1910920.06
292303,202111,123,80,43,88002.61,47302.62,135305.23
292305,202111,114,86,28,95711.38,30803.48,126514.86
292310,202111,961,623,338,686512.84,371843.28,1058356.12
292320,202111,580,433,147,476387.89,161716.34,638104.23
292330,202111,179,111,68,122109.11,74801.82,196910.93
292335,202111,288,228,60,250815.26,66004.28,316819.54
292340,202111,557,379,178,418027.81,195815.19,613843.00
292350,202111,267,146,121,160609.78,133110.59,293720.37
292360,202111,711,535,176,588604.87,193628.14,782233.01
292370,202111,726,550,176,605080.94,193618.09,798699.03
292380,202111,618,506,112,556700.75,124329.2,681029.95
292390,202111,396,160,236,176025.57,259630.14,435655.71
292400,202111,3627,2245,1382,2469873.65,1520449.49,3990323.14
292405,202111,271,181,90,199105.63,99001.12,298106.75
292410,202111,124,76,48,83604.38,52803.99,136408.37
292420,202111,288,248,40,272830.53,44004.25,316834.78
292430,202111,540,393,147,432328.77,161709.21,594037.98
292440,202111,625,526,99,579756.05,108911.76,688667.81
292450,202111,243,185,58,203522.6,63805.42,267328.02
292460,202111,520,384,136,423538.63,149608.78,573147.41
292465,202111,203,174,29,191409.96,31900.5,223310.46
292467,202111,142,87,55,95703.28,60500.88,156204.16
292470,202111,301,205,96,225508.96,105604.84,331113.80
292480,202111,390,261,129,287147.92,141922.15,429070.07
292490,202111,238,173,65,190315.68,71505.6,261821.28
292500,202111,881,404,477,445591.13,524812.95,970404.08
292510,202111,3524,1651,1873,1817433.01,2063854.02,3881287.03
292520,202111,1115,515,600,567712.86,660123.69,1227836.55
292525,202111,422,302,120,333348.17,132010.84,465359.01
292530,202111,4630,1821,2809,2007793.94,3091462.5,5099256.44
292540,202111,482,275,207,302510.97,227706.72,530217.69
292550,202111,1117,594,523,653474.01,576455.98,1229929.99
292560,202111,323,298,25,327874.34,27503.92,355378.26
292570,202111,308,236,72,260739.07,79209.1,339948.17
292575,202111,524,356,168,391666.86,184832.05,576498.91
292580,202111,991,666,325,733768.8,357530.13,1091298.93
292590,202111,555,488,67,537938.74,73703,611641.74
292593,202111,144,113,31,124309.69,34101.64,158411.33
292595,202111,205,163,42,179329.23,46206.32,225535.55
292600,202111,1254,903,351,993500.96,386153.51,1379654.47
292610,202111,114,91,23,100121.24,25307.03,125428.27
292620,202111,531,447,84,493998.05,92416.5,586414.55
292630,202111,1516,833,683,916435.77,752480.68,1668916.45
292640,202111,865,596,269,656787.13,295936.68,952723.81
292650,202111,185,148,37,163937.77,40705.44,204643.21
292660,202111,1945,1370,575,1508373.83,632626.79,2141000.62
292665,202111,139,99,40,108900.47,44001,152901.47
292670,202111,386,303,83,333372.7,91305.44,424678.14
292680,202111,262,194,68,213430.29,74814.9,288245.19
292690,202111,202,142,60,156208.99,66002.01,222211.00
292700,202111,998,649,349,714008.59,383959.3,1097967.89
292710,202111,115,101,14,111109.08,15402.21,126511.29
292720,202111,951,542,409,596275.3,449938.88,1046214.18
292730,202111,199,96,103,105614.17,113313.38,218927.55
292740,202111,71048,34097,36951,37540124.37,40681921.14,78222045.51
292750,202111,382,276,106,303650.15,116622.33,420272.48
292760,202111,336,280,56,308022.06,61606.37,369628.43
292770,202111,842,355,487,390564.85,536875.95,927440.80
292780,202111,20,11,9,12103.5,9901,22004.5
292790,202111,781,407,374,447720.02,411410.46,859130.48
292800,202111,1251,744,507,818484.36,557743.56,1376227.92
292805,202111,384,123,261,135307.34,287115.88,422423.22
292810,202111,1804,1072,732,1181530.81,806374.05,1987904.86
292820,202111,691,583,108,642493.34,118815.46,761308.80
292830,202111,123,98,25,107817.83,27503.63,135321.46
292840,202111,691,563,128,619401.83,140813.02,760214.85
292850,202111,134,87,47,95719.39,51713.17,147432.56
292860,202111,2115,1223,892,1345615.45,982519.18,2328134.63
292870,202111,3580,2351,1229,2588686.55,1353213.06,3941899.61
292880,202111,1436,956,480,1053943.19,528070.92,1582014.11
292890,202111,530,441,89,485188.68,99013.13,584201.81
292895,202111,148,99,49,108913.59,53905.12,162818.71
292900,202111,354,249,105,273957.71,115524.38,389482.09
292905,202111,484,232,252,255245.5,278343.16,533588.66
292910,202111,465,348,117,382844.19,128714.33,511558.52
292920,202111,517,219,298,240945.73,327850.37,568796.10
292925,202111,475,434,41,477411.77,45102.43,522514.20
292930,202111,661,394,267,433454.76,293738.21,727192.97
292935,202111,281,119,162,132008.56,178212.64,310221.20
292937,202111,226,154,72,169419.11,79208.94,248628.05
292940,202111,187,142,45,156237.12,49509.64,205746.76
292950,202111,1223,592,631,652439.94,694235.2,1346675.14
292960,202111,533,375,158,412573.59,173829.32,586402.91
292970,202111,233,170,63,187036.45,69317.92,256354.37
292975,202111,95,56,39,61612.69,42907.84,104520.53
292980,202111,315,214,101,235419.81,111107.87,346527.68
292990,202111,1312,973,339,1070451.19,372943.63,1443394.82
293000,202111,114,81,33,89107.93,36306.67,125414.60
293010,202111,2889,1691,1198,1861528.25,1319094.36,3180622.61
293015,202111,611,497,114,547890.97,125412.55,673303.52
293020,202111,323,263,60,289354.11,66012.64,355366.75
293030,202111,581,510,71,561069.06,78110.21,639179.27
293040,202111,368,293,75,322323.1,82504.22,404827.32
293050,202111,2930,1732,1198,1905437.85,1319069.99,3224507.84
293060,202111,247,195,52,214549.41,57213.86,271763.27
293070,202111,3619,1808,1811,1990265.69,1995766.98,3986032.67
293075,202111,94,64,30,70405.39,33001.32,103406.71
293076,202111,76,57,19,62705.46,20900.67,83606.13
293077,202111,568,319,249,350950.53,273936.74,624887.27
293080,202111,421,376,45,414732.49,49503.52,464236.01
293090,202111,127,114,13,125410.51,14300.66,139711.17
293100,202111,526,363,163,401577.31,179319.24,580896.55
293105,202111,347,252,95,277213.27,104508.77,381722.04
293110,202111,123,84,39,92426.32,42907.24,135333.56
293120,202111,302,207,95,227744.32,104520.16,332264.48
293130,202111,250,166,84,182614.68,92411.86,275026.54
293135,202111,8153,3124,5029,3436930.61,5534753.05,8971683.66
293140,202111,190,113,77,124334.11,84719.66,209053.77
293150,202111,309,267,42,293733.97,46201.61,339935.58
293160,202111,423,260,163,286018.49,179309.75,465328.24
293170,202111,201,128,73,140827.3,80314.17,221141.47
293180,202111,560,379,181,418040.83,199114.05,617154.88
293190,202111,1341,916,425,1007793.63,467599.66,1475393.29
293200,202111,547,480,67,529196.39,73712.45,602908.84
293210,202111,415,319,96,350939.61,105606.55,456546.16
293220,202111,2397,1026,1371,1129912.71,1510543.9,2640456.61
293230,202111,1854,688,1166,756872.5,1283813.76,2040686.26
293240,202111,229,211,18,232157.98,19804.01,251961.99
293245,202111,129,107,22,117708.26,24202.31,141910.57
293250,202111,772,310,462,341068.11,508314.65,849382.76
293260,202111,303,249,54,273953.43,59409.22,333362.65
293270,202111,1171,521,650,573171.96,716170.52,1289342.48
293280,202111,298,174,124,191412.69,136417.37,327830.06
293290,202111,3035,1965,1070,2161797.97,1180457.24,3342255.21
293300,202111,779,549,230,603980.27,253023.57,857003.84
293305,202111,196,153,43,168310.27,47302.23,215612.50
293310,202111,171,127,44,139715.92,48405.1,188121.02
293315,202111,163,126,37,138633.33,41809.03,180442.36
293317,202111,90,65,25,71507.76,27501.68,99009.44
293320,202111,1096,589,507,650248.95,557826.42,1208075.37
293325,202111,194,72,122,79205.11,134203.08,213408.19
293330,202111,13947,6324,7623,6967505.18,8390985.26,15358490.44
293340,202111,289,203,86,224405.77,94603.35,319009.12
293345,202111,257,207,50,231045.12,55004.92,286050.04
293350,202111,585,350,235,385076.44,258542.18,643618.62
293360,202111,1499,1065,434,1171679.7,477473.98,1649153.68
310010,202111,142,73,69,80311.02,75906.88,156217.90
310020,202111,1007,551,456,608379.88,501639.74,1110019.62
310030,202111,316,252,64,277260.31,70413.68,347673.99
310040,202111,46,29,17,31900.94,18700,50600.94
310050,202111,158,98,60,107804.8,66008.24,173813.04
310060,202111,263,180,83,198026.73,91311.3,289338.03
310070,202111,16,9,7,9901.01,7700.67,17601.68
310080,202111,43,29,14,31901.35,15402.23,47303.58
310090,202111,1039,553,486,608355.56,536858.31,1145213.87
310100,202111,309,219,90,240953.44,99018.88,339972.32
310110,202111,686,368,318,404860.28,350947.04,755807.32
310120,202111,381,220,161,242015.31,177119.42,419134.73
310130,202111,30,17,13,18706.42,14304.31,33010.73
310140,202111,22,7,15,7701.66,16503.78,24205.44
310150,202111,1161,769,392,847122.98,432375.28,1279498.26
310160,202111,2043,989,1054,1090250.58,1160569.22,2250819.80
310163,202111,90,47,43,51702.08,47301.09,99003.17
310170,202111,2506,1128,1378,1240922.4,1517063.19,2757985.59
310180,202111,159,58,101,63802.83,111108.4,174911.23
310190,202111,473,320,153,352050.56,168322.64,520373.20
310200,202111,453,286,167,314654.56,183729.76,498384.32
310205,202111,65,44,21,48401.97,23100.06,71502.03
310210,202111,270,219,51,240937.67,56113.78,297051.45
310220,202111,61,32,29,35206.38,31904.83,67111.21
310230,202111,279,196,83,215633.32,91309.65,306942.97
310240,202111,109,93,16,102303.99,17600.71,119904.70
310250,202111,97,76,21,83611.34,23102.54,106713.88
310260,202111,720,378,342,416957.34,376251.75,793209.09
310270,202111,266,170,96,187032.19,105619.33,292651.52
310280,202111,382,277,105,304740.84,115508.05,420248.89
310285,202111,199,150,49,166111.3,53905.66,220016.96
310290,202111,231,129,102,141918.07,112205.41,254123.48
310300,202111,169,136,33,150723.52,36305.33,187028.85
310310,202111,10,7,3,7700.44,3300.97,11001.41
310320,202111,29,9,20,9901.04,22000,31901.04
310330,202111,40,26,14,28602.65,16501.89,45104.54
310340,202111,1836,1235,601,1359758.75,661185.12,2020943.87
310350,202111,2732,1442,1290,1587554.85,1420243.88,3007798.73
310360,202111,44,37,7,40700,7700,48400
310370,202111,128,107,21,117707.4,23101.08,140808.48
310375,202111,106,38,68,41801.74,74804.31,116606.05
310380,202111,49,28,21,30804.46,23104.74,53909.20
310390,202111,107,68,39,74813.49,42906.1,117719.59
310400,202111,2390,1535,855,1690985.93,940679.37,2631665.30
310410,202111,116,63,53,69315.98,58308.49,127624.47
310420,202111,652,331,321,365245.81,353145.81,718391.62
310430,202111,270,164,106,180413.36,116601.58,297014.94
310440,202111,74,42,32,46200.14,35201.32,81401.46
310445,202111,77,64,13,70405.17,14301.87,84707.04
310450,202111,628,403,225,443398.28,247548.88,690947.16
310460,202111,246,171,75,189223.88,82506.85,271730.73
310470,202111,509,326,183,358637.12,201324.2,559961.32
310480,202111,87,54,33,59405.97,36301.44,95707.41
310490,202111,530,243,287,267362.53,315728.85,583091.38
310500,202111,130,49,81,53900.53,89101.2,143001.73
310510,202111,588,409,179,451059.66,198030.91,649090.57
310520,202111,141,101,40,111125.21,44006.04,155131.25
310530,202111,104,40,64,44001.78,70401.89,114403.67
310540,202111,461,261,200,288237.81,220032.97,508270.78
310550,202111,68,46,22,50605.81,24203.39,74809.20
310560,202111,3005,2039,966,2245479.87,1063799.08,3309278.95
310570,202111,98,59,39,64903.38,42902.26,107805.64
310590,202111,358,220,138,242038.77,151821.61,393860.38
310600,202111,142,73,69,80309.89,75907.88,156217.77
310610,202111,53,21,32,23104.86,35205.32,58310.18
310620,202111,47041,21945,25096,24167817.11,27626928.11,51794745.22
310630,202111,672,403,269,443345.79,295924.58,739270.37
310640,202111,129,92,37,101205.09,40701.69,141906.78
310650,202111,149,133,16,146338.81,17603.64,163942.45
310660,202111,108,74,34,81403.01,37401.66,118804.67
310665,202111,63,45,18,49500.31,19802.02,69302.33
310670,202111,6934,2965,3969,3266450.05,4368536.99,7634987.04
310680,202111,64,40,24,44001.03,26401.24,70402.27
310690,202111,616,431,185,475240.08,203514.19,678754.27
310700,202111,63,38,25,41805.59,27500.78,69306.37
310710,202111,1276,863,413,951912.42,454344,1406256.42
310720,202111,148,39,109,42903.01,119914.75,162817.76
310730,202111,1491,1013,478,1115563.73,528086.32,1643650.05
310740,202111,985,544,441,598503.59,487385.18,1085888.77
310750,202111,248,154,94,169423.44,103408.96,272832.40
310760,202111,68,52,16,57213.85,17603.59,74817.44
310770,202111,90,44,46,48400.51,50603.83,99004.34
310780,202111,348,280,68,308052.83,74813.5,382866.33
310790,202111,108,86,22,94615.71,24202.5,118818.21
310800,202111,469,216,253,237633.73,278330.49,515964.22
310810,202111,172,117,55,128721.89,60511.57,189233.46
310820,202111,327,263,64,289359.57,70414.28,359773.85
310825,202111,206,176,30,193622.5,33003.93,226626.43
310830,202111,465,216,249,238731.15,275017.69,513748.84
310840,202111,362,211,151,233223.37,166125.28,399348.65
310850,202111,78,64,14,70405.04,15400,85805.04
310855,202111,398,310,88,341060.72,96811.76,437872.48
310860,202111,1595,1169,426,1287255.47,468696.82,1755952.29
310870,202111,50,42,8,46205.1,8801.64,55006.74
310880,202111,80,65,15,71500.93,16501.22,88002.15
310890,202111,294,171,123,188128.37,135306.83,323435.20
310900,202111,625,275,350,303637.99,385065.65,688703.64
310910,202111,237,159,78,174931.61,85812.28,260743.89
310920,202111,437,251,186,276160.13,204650.87,480811.00
310925,202111,36,26,10,28604.23,11000,39604.23
310930,202111,1278,825,453,907622.77,498379.88,1406002.65
310940,202111,673,333,340,366362.5,375166.96,741529.46
310945,202111,125,79,46,86903.71,50604.76,137508.47
310950,202111,224,179,45,196936.47,49505.82,246442.29
310960,202111,75,24,51,26403.4,56111.77,82515.17
310970,202111,164,99,65,108925.6,71508.21,180433.81
310980,202111,45,29,16,31901.75,17602.29,49504.04
310990,202111,166,87,79,95706.43,86904,182610.43
311000,202111,806,381,425,419180.16,467582.34,886762.50
311010,202111,52,44,8,48404.55,8801.14,57205.69
311020,202111,42,24,18,26405.79,19804.43,46210.22
311030,202111,383,214,169,235424.72,185912.3,421337.02
311040,202111,40,31,9,34100.11,9900,44000.11
311050,202111,476,177,299,194719.78,328919.42,523639.20
311060,202111,783,435,348,478554.79,382843.56,861398.35
311070,202111,327,143,184,158409.51,202404.36,360813.87
311080,202111,109,63,46,69308.6,50614.29,119922.89
311090,202111,332,159,173,174931.18,190324.8,365255.98
311100,202111,556,329,227,361952.82,249728.85,611681.67
311110,202111,705,501,204,551155.64,224432.51,775588.15
311115,202111,73,51,22,56102.06,24205.72,80307.78
311120,202111,1051,562,489,618293.08,537968.49,1156261.57
311130,202111,295,172,123,189243.19,135318.48,324561.67
311140,202111,158,84,74,92413.57,81415.01,173828.58
311150,202111,344,215,129,236535.42,143024.69,379560.11
311160,202111,736,518,218,569885.77,239832.42,809718.19
311170,202111,89,72,17,79201.4,18701.14,97902.54
311180,202111,297,200,97,220019.75,106711.31,326731.06
311190,202111,43,17,26,18700.78,28601.96,47302.74
311200,202111,347,240,107,264033.86,117713.05,381746.91
311205,202111,32,23,9,25301.66,9900,35201.66
311210,202111,40,35,5,38503.11,5500.94,44004.05
311220,202111,31,27,4,29700,4400,34100
311230,202111,1642,1071,571,1179447.5,630411.64,1809859.14
311240,202111,198,122,76,134200.17,83602.91,217803.08
311250,202111,57,21,36,23102.28,39601.77,62704.05
311260,202111,545,345,200,379533.8,220024.82,599558.62
311265,202111,123,82,41,90210.01,45104.98,135314.99
311270,202111,285,197,88,216730.58,96811.54,313542.12
311280,202111,198,86,112,94605.02,123208.16,217813.18
311290,202111,102,84,18,93511.71,19800.55,113312.26
311300,202111,579,371,208,408173.24,228827.9,637001.14
311310,202111,18,15,3,16500.78,3301.56,19802.34
311320,202111,629,465,164,513768.46,182618.01,696386.47
311330,202111,1098,798,300,877920.34,331150.38,1209070.72
311340,202111,2616,1849,767,2034232.89,843749.41,2877982.30
311350,202111,268,207,61,227736.11,67109.51,294845.62
311360,202111,172,102,70,112212.36,78106.33,190318.69
311370,202111,1221,504,717,554477.87,788803.8,1343281.67
311380,202111,7,6,1,6601.67,1100,7701.67
311390,202111,249,138,111,152918.89,123219.01,276137.90
311400,202111,137,83,54,91308.45,59405.63,150714.08
311410,202111,117,57,60,62708.63,66006.64,128715.27
311420,202111,307,161,146,177122.3,160613.37,337735.67
311430,202111,821,546,275,601791.06,303651.61,905442.67
311440,202111,451,310,141,341065.93,155128.85,496194.78
311450,202111,293,176,117,193646.1,128719.97,322366.07
311455,202111,265,182,83,201327.47,92416.21,293743.68
311460,202111,129,55,74,60508.23,81410.38,141918.61
311470,202111,31,15,16,16500,17600.51,34100.51
311480,202111,47,23,24,25301.73,26400.87,51702.60
311490,202111,10,6,4,6600.51,4400.87,11001.38
311500,202111,28,13,15,14300.5,16501.28,30801.78
311510,202111,652,440,212,484056.21,233225.62,717281.83
311520,202111,40,32,8,35200,8800.87,44000.87
311530,202111,1804,1300,504,1431353.74,556629.21,1987982.95
311535,202111,64,44,20,48410.46,22005.21,70415.67
311540,202111,35,30,5,33004.4,5500,38504.4
311545,202111,157,114,43,126502.42,47300.2,173802.62
311547,202111,43,33,10,36300.9,11001.4,47302.3
311550,202111,641,282,359,310239.69,394942.26,705181.95
311560,202111,43,26,17,28602.31,18700.34,47302.65
311570,202111,281,188,93,206833.38,102317.82,309151.20
311580,202111,389,234,155,257419.54,170510.25,427929.79
311590,202111,29,25,4,27504.34,4401.41,31905.75
311600,202111,97,78,19,86924.37,20901.73,107826.10
311610,202111,242,206,36,226631.64,39606.09,266237.73
311615,202111,121,98,23,107801.48,25302.7,133104.18
311620,202111,27,15,12,16500.67,13200.91,29701.58
311630,202111,91,78,13,85803.11,14300,100103.11
311640,202111,141,68,73,74813.74,80320.12,155133.86
311650,202111,127,86,41,94602.76,45104.12,139706.88
311660,202111,420,200,220,221125.79,242018.15,463143.94
311670,202111,141,94,47,103420.26,51707.44,155127.70
311680,202111,209,157,52,172721.76,57209.38,229931.14
311690,202111,13,11,2,12101.84,2200,14301.84
311700,202111,191,137,54,150723.72,59409.09,210132.81
311710,202111,182,125,57,138630.74,62710.02,201340.76
311720,202111,39,29,10,31904.46,11001.1,42905.56
311730,202111,554,380,174,419154.5,192523,611677.5
311740,202111,26,18,8,19800.88,8800.74,28601.62
311750,202111,721,484,237,532447.68,261830.12,794277.80
311760,202111,75,33,42,36305.39,46206.71,82512.10
311770,202111,380,179,201,196917.24,221113.51,418030.75
311780,202111,187,91,96,100113.99,105609.98,205723.97
311783,202111,87,80,7,88010.23,7701.14,95711.37
311787,202111,38,14,24,15401.67,26402.18,41803.85
311790,202111,271,114,157,125415.78,172721.32,298137.10
311800,202111,686,433,253,476393.61,279423.7,755817.31
311810,202111,49,39,10,42901.64,11000,53901.64
311820,202111,120,94,26,103408.94,28606.37,132015.31
311830,202111,1891,1140,751,1255283.97,828348.76,2083632.73
311840,202111,1009,553,456,609478.31,502771.92,1112250.23
311850,202111,14,10,4,11001.97,4401.87,15403.84
311860,202111,9622,4084,5538,4496542.68,6100263.05,10596805.73
311870,202111,111,61,50,67110.48,55008.12,122118.60
311880,202111,939,675,264,742655.43,290451.3,1033106.73
311890,202111,200,95,105,105528.76,116627.58,222156.34
311900,202111,64,26,38,28605.52,41807.04,70412.56
311910,202111,1355,834,521,917489.96,573153.33,1490643.29
311920,202111,226,150,76,166126.43,83611.06,249737.49
311930,202111,903,507,396,557776.7,435655.78,993432.48
311940,202111,2559,1348,1211,1484164.66,1332255.81,2816420.47
311950,202111,66,44,22,48411.53,24202.88,72614.41
311960,202111,63,45,18,49510.02,19802.06,69312.08
311970,202111,23,12,11,13200,12100.67,25300.67
311980,202111,43,33,10,36302.55,11001.44,47303.99
311990,202111,35,25,10,27506.41,11002.3,38508.71
311995,202111,47,28,19,30806.48,20904.23,51710.71
312000,202111,21,15,6,16501.54,6600,23101.54
312010,202111,73,57,16,62712.57,17602.63,80315.20
312015,202111,73,57,16,62701.88,17600,80301.88
312020,202111,130,90,40,100115.6,44010.19,144125.79
312030,202111,67,51,16,56101.04,17600,73701.04
312040,202111,79,48,31,52802.68,34100.64,86903.32
312050,202111,196,108,88,118817.21,96807.94,215625.15
312060,202111,23,14,9,15401.66,9901.22,25302.88
312070,202111,76,48,28,52809.5,30802.84,83612.34
312080,202111,535,242,293,266223.68,322325.94,588549.62
312083,202111,59,36,23,39602.96,25301.58,64904.54
312087,202111,94,70,24,77007.63,26403.3,103410.93
312090,202111,3274,1983,1291,2184994.12,1421366.54,3606360.66
312100,202111,146,102,44,111968.37,48407.81,160376.18
312110,202111,110,65,45,71518.45,49509.27,121027.72
312120,202111,125,92,33,101211,36308.39,137519.39
312125,202111,84,51,33,56105.27,36307.59,92412.86
312130,202111,133,86,47,94612.58,51706.58,146319.16
312140,202111,141,110,31,121018.5,34102.19,155120.69
312150,202111,40,32,8,35201.14,8800,44001.14
312160,202111,1486,967,519,1063939.67,570994.76,1634934.43
312170,202111,11,8,3,8800.26,3300.51,12100.77
312180,202111,107,70,37,77006.99,40703.37,117710.36
312190,202111,38,34,4,37403.63,4400.44,41804.07
312200,202111,739,634,105,698642.92,115520.83,814163.75
312210,202111,119,60,59,66005.68,64912.24,130917.92
312220,202111,128,97,31,106708.16,34101.81,140809.97
312230,202111,3699,1666,2033,1836270.37,2238681.39,4074951.76
312235,202111,154,103,51,113302.95,56104.67,169407.62
312240,202111,82,57,25,62712.82,27503.79,90216.61
312245,202111,193,132,61,145226.2,67114.8,212341.0
312247,202111,79,57,22,62705.56,24204.63,86910.19
312250,202111,170,84,86,92412.26,94611.97,187024.23
312260,202111,101,67,34,73700.99,37400.55,111101.54
312270,202111,134,80,54,88015.66,59410.46,147426.12
312280,202111,30,14,16,15400.71,17602.21,33002.92
312290,202111,134,90,44,99010.3,48403.06,147413.36
312300,202111,198,130,68,143013,74806.22,217819.22
312310,202111,58,52,6,57202.23,6600,63802.23
312320,202111,414,254,160,280523.53,176017.13,456540.66
312330,202111,89,75,14,82500.44,15400,97900.44
312340,202111,33,16,17,17602.99,18701.05,36304.04
312350,202111,13,7,6,7700.34,6600,14300.34
312352,202111,96,68,28,74802.84,30801,105603.84
312360,202111,561,236,325,259643.11,357532.66,617175.77
312370,202111,325,182,143,200205.86,158404.53,358610.39
312380,202111,144,94,50,104517.06,55010.75,159527.81
312385,202111,151,125,26,137523.14,28603.7,166126.84
312390,202111,300,192,108,211228.58,118819.25,330047.83
312400,202111,379,282,97,310258.53,106720.53,416979.06
312410,202111,1102,353,749,388359.56,824019.32,1212378.88
312420,202111,642,481,161,529189.16,177119.55,706308.71
312430,202111,881,633,248,696428.59,273952.94,970381.53
312440,202111,40,31,9,34100,9900,44000
312450,202111,190,120,70,132022.08,78112.92,210135.00
312460,202111,29,14,15,15401.62,16500.74,31902.36
312470,202111,45,30,15,33002.56,16500,49502.56
312480,202111,168,102,66,112225.93,72619.52,184845.45
312490,202111,284,191,93,210143.03,102316.53,312459.56
312500,202111,36,21,15,23103.62,16505.67,39609.29
312510,202111,537,198,339,217835.13,372966.33,590801.46
312520,202111,31,9,22,9901.41,24206.51,34107.92
312530,202111,38,28,10,30806.36,11000.84,41807.20
312540,202111,87,78,9,85809.65,9900.2,95709.85
312550,202111,38,30,8,33008.04,8800.37,41808.41
312560,202111,200,154,46,169415.79,50607.07,220022.86
312570,202111,444,260,184,286061.06,202435.37,488496.43
312580,202111,93,49,44,53903.91,48405.84,102309.75
312590,202111,227,180,47,199131.77,51710.89,250842.66
312595,202111,129,106,23,116617.45,25303.49,141920.94
312600,202111,70,33,37,36302.55,40702.33,77004.88
312610,202111,1538,796,742,875790.34,817397.96,1693188.30
312620,202111,225,161,64,177117.19,70406.24,247523.43
312630,202111,68,56,12,61602.27,13200,74802.27
312640,202111,40,10,30,12100,33001.88,45101.88
312650,202111,147,122,25,134608.93,27506.79,162115.72
312660,202111,103,73,30,80310.39,33003.53,113313.92
312670,202111,931,598,333,658962.83,368538.74,1027501.57
312675,202111,35,27,8,29702.85,8800.78,38503.63
312680,202111,66,39,27,42900.47,29700,72600.47
312690,202111,231,114,117,125416.2,128708.81,254125.01
312695,202111,25,21,4,23102.82,4400.78,27503.60
312700,202111,235,135,100,148516.01,110011.92,258527.93
312705,202111,81,64,17,70400.17,18702.49,89102.66
312707,202111,134,95,39,104503.27,42901.01,147404.28
312710,202111,1855,1009,846,1110023.56,930724.52,2040748.08
312720,202111,52,27,25,29706.02,27504.76,57210.78
312730,202111,271,155,116,170529.09,127620.23,298149.32
312733,202111,47,36,11,39601.3,12101.5,51702.8
312735,202111,22,14,8,15403.82,8802.23,24206.05
312737,202111,69,38,31,41802.91,34101.84,75904.75
312738,202111,62,40,22,44003.83,24201.29,68205.12
312740,202111,79,53,26,58308.6,28604.01,86912.61
312750,202111,90,61,29,67101.38,31900.34,99001.72
312760,202111,276,193,83,212330.66,91315.44,303646.10
312770,202111,8412,3876,4536,4268667.29,5002016.36,9270683.65
312780,202111,445,341,104,375182.99,114420.83,489603.82
312790,202111,22,16,6,17600.44,6600.21,24200.65
312800,202111,1579,1096,483,1206836.99,532469.85,1739306.84
312810,202111,347,232,115,256302.36,126503.69,382806.05
312820,202111,184,141,43,156216.07,47306.53,203522.60
312825,202111,34,24,10,26403.62,11000.4,37404.02
312830,202111,200,114,86,126531.5,94616.87,221148.37
312840,202111,171,114,57,126511.86,62705.45,189217.31
312850,202111,42,37,5,40703.3,5500.44,46203.74
312860,202111,145,94,51,103408.41,56103.95,159512.36
312870,202111,1080,556,524,613890.9,577529.77,1191420.67
312880,202111,120,84,36,92414.1,39604.86,132018.96
312890,202111,158,112,46,123230.7,50609.78,173840.48
312900,202111,180,133,47,146337.96,51713.79,198051.75
312910,202111,177,99,78,108922.53,85822.91,194745.44
312920,202111,134,73,61,80314.42,67107.52,147421.94
312930,202111,321,220,101,242053.83,111121.69,353175.52
312940,202111,122,84,38,92403.91,41801.31,134205.22
312950,202111,693,471,222,518172.68,245343.06,763515.74
312960,202111,145,109,36,119923.03,39607.03,159530.06
312965,202111,104,80,24,88006.79,26400.78,114407.57
312970,202111,274,226,48,248643.64,53908.25,302551.89
312980,202111,2507,1248,1259,1375235.46,1386178.18,2761413.64
312990,202111,50,24,26,26402.18,29700.73,56102.91
313000,202111,52,30,22,33003.17,24200.84,57204.01
313005,202111,172,131,41,144110.79,45105.03,189215.82
313010,202111,938,387,551,425745.58,606164.67,1031910.25
313020,202111,195,97,98,106701.06,107800,214501.06
313030,202111,194,127,67,139715.57,73705.13,213420.70
313040,202111,82,24,58,26402.71,63802.25,90204.96
313050,202111,193,140,53,154006.39,58304.99,212311.38
313055,202111,39,30,9,34100,9900.78,44000.78
313060,202111,134,90,44,99004.76,48401.69,147406.45
313065,202111,62,45,17,49501.67,18704.01,68205.68
313070,202111,132,71,61,78113.38,67112.82,145226.20
313080,202111,38,18,20,19802.6,22001.51,41804.11
313090,202111,662,426,236,468672.89,259639.21,728312.10
313100,202111,197,69,128,75903.26,140806.68,216709.94
313110,202111,152,80,72,88006.61,79209.23,167215.84
313115,202111,217,119,98,130926.91,107816.71,238743.62
313120,202111,846,471,375,518177.34,412542.12,930719.46
313130,202111,5870,3185,2685,3509555.86,2956021.66,6465577.52
313140,202111,131,74,57,81403.66,62705.49,144109.15
313150,202111,291,231,60,256349.3,66009.13,322358.43
313160,202111,181,134,47,147441.26,51716.45,199157.71
313170,202111,1358,886,472,978076.79,520336.75,1498413.54
313180,202111,305,179,126,196945.4,138629.12,335574.52
313190,202111,725,425,300,467586.18,330055.59,797641.77
313200,202111,30,25,5,27503.51,5500.27,33003.78
313210,202111,994,844,150,929662.21,165027.68,1094689.89
313220,202111,288,171,117,188130.76,128707.11,316837.87
313230,202111,260,200,60,220023.43,66005.12,286028.55
313240,202111,2182,1088,1094,1198059.69,1204575.53,2402635.22
313250,202111,1248,947,301,1041924.03,331164.22,1373088.25
313260,202111,94,47,47,51704.37,51702.29,103406.66
313270,202111,1002,580,422,638086.6,464255.44,1102342.04
313280,202111,45,38,7,41800.84,7700.67,49501.51
313290,202111,210,168,42,184816.6,46203.46,231020.06
313300,202111,324,162,162,178223,178213.85,356436.85
313310,202111,246,111,135,122112.96,148508.74,270621.70
313320,202111,384,279,105,306968.31,115522.43,422490.74
313330,202111,1409,856,553,941726.91,608383.37,1550110.28
313340,202111,326,232,94,255238.62,103419.98,358658.60
313350,202111,465,299,166,328933.65,183718.63,512652.28
313360,202111,166,76,90,83610.08,99010.87,182620.95
313370,202111,234,79,155,86905.88,170510.68,257416.56
313375,202111,302,178,124,195815.85,137512.4,333328.25
313380,202111,1329,703,626,774549.11,688651.32,1463200.43
313390,202111,46,44,2,48401.04,2200,50601.04
313400,202111,395,269,126,295978.45,138633.07,434611.52
313410,202111,34,16,18,17600.67,19800.87,37401.54
313420,202111,4526,2447,2079,2694300.01,2288227.61,4982527.62
313430,202111,132,65,67,71514.36,73712.1,145226.46
313440,202111,1374,963,411,1059491.57,452188.34,1511679.91
313450,202111,70,34,36,37400.34,39600,77000.34
313460,202111,386,163,223,179341.97,245343.5,424685.47
313470,202111,526,244,282,268463.51,310276.57,578740.08
313480,202111,145,107,38,117716.95,41805.54,159522.49
313490,202111,533,238,295,262941.12,324557.94,587499.06
313500,202111,28,15,13,17600.11,14301.01,31901.12
313505,202111,1059,819,240,902140.11,264037.57,1166177.68
313507,202111,92,56,36,61607.27,39605.44,101212.71
313510,202111,2861,1788,1073,1970497.88,1180491.35,3150989.23
313520,202111,3418,2661,757,2929807.72,833917.13,3763724.85
313530,202111,32,20,12,22005.25,13200.78,35206.03
313535,202111,66,52,14,57208.23,15402.24,72610.47
313540,202111,69,51,18,56105.4,19801.39,75906.79
313545,202111,110,94,16,103421.37,17601.31,121022.68
313550,202111,223,186,37,204647.74,40706.57,245354.31
313560,202111,344,160,184,176042.62,202451.31,378493.93
313570,202111,68,21,47,23102.47,51702.82,74805.29
313580,202111,1308,739,569,814088.36,625987.65,1440076.01
313590,202111,67,39,28,42909.1,30806.95,73716.05
313600,202111,670,397,273,438946.34,300332.85,739279.19
313610,202111,49,40,9,44003.48,9901.41,53904.89
313620,202111,1344,656,688,721737.81,756858.91,1478596.72
313630,202111,1618,1217,401,1338988.47,441156.4,1780144.87
313640,202111,117,70,47,77004.69,51703.89,128708.58
313650,202111,233,109,124,119916.36,136424.83,256341.19
313652,202111,23,22,1,24200.67,1100,25300.67
313655,202111,71,45,26,49504.9,28602.86,78107.76
313657,202111,45,41,4,45110.56,4400.94,49511.50
313660,202111,126,80,46,88018.5,50626.66,138645.16
313665,202111,655,297,358,326758.42,393870.43,720628.85
313670,202111,10273,6982,3291,7687019.39,3623906.24,11310925.63
313680,202111,44,34,10,37404.33,11001.16,48405.49
313690,202111,128,94,34,103419.51,37402.66,140822.17
313695,202111,78,59,19,64905.73,20902.06,85807.79
313700,202111,330,260,70,286059.08,77007.45,363066.53
313710,202111,132,96,36,105620.35,39607.02,145227.37
313720,202111,1136,513,623,567700.96,686508.01,1254208.97
313730,202111,70,40,30,44005.23,33007.11,77012.34
313740,202111,148,115,33,126522.33,36303.47,162825.80
313750,202111,410,289,121,317950.01,133114.3,451064.31
313753,202111,220,162,58,179319.72,63811.96,243131.68
313760,202111,1342,495,847,545688.25,932970.42,1478658.67
313770,202111,390,271,119,298142.84,130920.85,429063.69
313780,202111,800,412,388,455439.89,426828.1,882267.99
313790,202111,29,28,1,30801.5,1100,31901.5
313800,202111,153,93,60,102316.11,66013.52,168329.63
313810,202111,82,48,34,53902.41,37400.86,91303.27
313820,202111,1334,625,709,688725.18,779956.26,1468681.44
313830,202111,52,36,16,39604.76,17602.99,57207.75
313835,202111,60,50,10,55000,11000.8,66000.8
313840,202111,1647,971,676,1069333.02,744772.91,1814105.93
313850,202111,210,86,124,94606.38,136421.62,231028.00
313860,202111,462,353,109,388371.22,119915.79,508287.01
313862,202111,170,113,57,124327.37,62714.68,187042.05
313865,202111,146,99,47,108900.99,51700.74,160601.73
313867,202111,57,45,12,49502.24,13200,62702.24
313868,202111,41,25,16,27502.45,17600.11,45102.56
313870,202111,99,53,46,58316.38,50611.63,108928.01
313880,202111,376,233,143,256331.64,158419.56,414751.20
313890,202111,330,175,155,192519.09,170515.45,363034.54
313900,202111,823,439,384,482967.61,422447.19,905414.80
313910,202111,143,98,45,107812.52,49502.79,157315.31
313920,202111,623,434,189,477469.48,207937.84,685407.32
313925,202111,32,26,6,28601.85,6600.03,35201.88
313930,202111,861,663,198,729454.71,217839.12,947293.83
313940,202111,1867,1129,738,1242080.84,814096.65,2056177.49
313950,202111,854,528,326,581967.94,358631.1,940599.04
313960,202111,1432,818,614,902103.69,677687.28,1579790.97
313970,202111,180,109,71,119901.68,78100.4,198002.08
313980,202111,209,136,73,149614.37,80313.92,229928.29
313990,202111,241,154,87,170524.04,95706.11,266230.15
314000,202111,862,567,295,623805.44,325653.49,949458.93
314010,202111,87,49,38,53904.71,41805.11,95709.82
314015,202111,71,19,52,20902.59,57216.03,78118.62
314020,202111,56,37,19,40706.58,20902.52,61609.10
314030,202111,73,36,37,39601.56,40700,80301.56
314040,202111,44,24,20,26405.69,22000.11,48405.80
314050,202111,289,169,120,185922.12,132008.85,317930.97
314053,202111,104,66,38,72610.01,42902.65,115512.66
314055,202111,290,181,109,199121.12,119918.52,319039.64
314060,202111,123,106,17,116608.18,18701.14,135309.32
314070,202111,1038,512,526,563279.1,578689.2,1141968.3
314080,202111,208,129,79,141928.92,86909.75,228838.67
314085,202111,159,108,51,118802.98,56100.67,174903.65
314090,202111,379,267,112,293735.44,123217.6,416953.04
314100,202111,523,415,108,456561.32,118814.93,575376.25
314110,202111,768,357,411,393852.66,452167.48,846020.14
314120,202111,71,40,31,44001.74,34100.83,78102.57
314130,202111,22,14,8,15400.06,8800,24200.06
314140,202111,1102,681,421,749209.8,463161.54,1212371.34
314150,202111,194,125,69,137515.68,75914.64,213430.32
314160,202111,326,243,83,267336.41,91312.12,358648.53
314170,202111,82,61,21,67113.45,23103.24,90216.69
314180,202111,731,641,90,705275.27,99021.04,804296.31
314190,202111,92,56,36,61614.21,39605.75,101219.96
314200,202111,491,332,159,366375.11,174934.55,541309.66
314210,202111,254,192,62,212333.71,68212.16,280545.87
314220,202111,301,214,87,235441.53,95712.15,331153.68
314225,202111,59,40,19,44011.1,20907.17,64918.27
314230,202111,115,53,62,58306.32,68204.16,126510.48
314240,202111,164,117,47,128721.19,51707.13,180428.32
314250,202111,59,35,24,38504.09,26402.58,64906.67
314260,202111,226,112,114,123210.77,125406.3,248617.07
314270,202111,400,308,92,339975.78,101215.07,441190.85
314280,202111,724,385,339,425706.24,372950.81,798657.05
314290,202111,527,415,112,457693.29,123219.17,580912.46
314300,202111,335,252,83,277257.84,91317.37,368575.21
314310,202111,1324,907,417,998185.66,458740.22,1456925.88
314315,202111,37,27,10,29700.2,11000,40700.2
314320,202111,576,381,195,420274.87,214534.02,634808.89
314330,202111,11415,5552,5863,6111725.45,6451112.14,12562837.59
314340,202111,599,264,335,290441.58,369641.19,660082.77
314345,202111,54,37,17,40703.98,18700,59403.98
314350,202111,175,110,65,121019.95,71504.45,192524.40
314360,202111,56,32,24,35209.11,26406.16,61615.27
314370,202111,71,48,23,52801.2,25301.17,78102.37
314380,202111,104,63,41,69302.34,45101.42,114403.76
314390,202111,3330,2141,1189,2359875.65,1308001.94,3667877.59
314400,202111,673,474,199,521514.27,218955.63,740469.90
314410,202111,489,310,179,342138.43,196914.57,539053.00
314420,202111,16,7,9,7700.84,9902.18,17603.02
314430,202111,2423,883,1540,971430.92,1696445.76,2667876.68
314435,202111,172,101,71,112209.75,78107.02,190316.77
314437,202111,32,21,11,23101.99,12100.43,35202.42
314440,202111,93,59,34,64907.07,37403.72,102310.79
314450,202111,163,109,54,119919.1,59409.1,179328.2
314460,202111,623,295,328,324544.67,360841.61,685386.28
314465,202111,99,61,38,67104.31,41802.88,108907.19
314467,202111,73,60,13,66003.7,14301.82,80305.52
314470,202111,401,201,200,221137.58,220035.73,441173.31
314480,202111,1019,455,564,500596.53,620468.34,1121064.87
314490,202111,41,24,17,26402.24,18702.91,45105.15
314500,202111,279,194,85,214532.8,93519.76,308052.56
314505,202111,103,65,38,71509.51,41801.32,113310.83
314510,202111,247,201,46,221154.37,50604.36,271758.73
314520,202111,1351,717,634,788833.6,699735.25,1488568.85
314530,202111,735,580,155,639257.43,170537.67,809795.10
314535,202111,164,99,65,108901.06,71500.34,180401.40
314537,202111,63,37,26,40707.15,28604.13,69311.28
314540,202111,19,12,7,13200.2,7701.15,20901.35
314545,202111,56,38,18,41802.43,19802.38,61604.81
314550,202111,68,35,33,38507.32,36308.93,74816.25
314560,202111,848,457,391,503853.83,430156.39,934010.22
314570,202111,18,15,3,16504.13,3300,19804.13
314580,202111,12,5,7,5500,7701.28,13201.28
314585,202111,26,19,7,20903.87,7700.11,28603.98
314587,202111,82,71,11,78108.8,12100.67,90209.47
314590,202111,556,383,173,422459.56,190327.23,612786.79
314600,202111,935,590,345,650192.58,379553.85,1029746.43
314610,202111,939,482,457,530279.43,502786.29,1033065.72
314620,202111,141,103,38,113300.77,41801.58,155102.35
314625,202111,98,72,26,79206.83,28601.68,107808.51
314630,202111,1132,598,534,657939.97,588611.25,1246551.22
314640,202111,84,54,30,59410.11,33004.08,92414.19
314650,202111,168,93,75,102319.92,82513.56,184833.48
314655,202111,61,44,17,48401.62,18701.78,67103.40
314660,202111,16,13,3,14302.1,3301.12,17603.22
314670,202111,207,160,47,176032.86,51711.14,227744.00
314675,202111,209,125,84,137524.45,92415.82,229940.27
314690,202111,564,299,265,328927.27,291527.92,620455.19
314700,202111,2222,1175,1047,1294970.55,1151922.11,2446892.66
314710,202111,1764,990,774,1090258.4,851443.16,1941701.56
314720,202111,385,216,169,238736.33,185918.08,424654.41
314730,202111,505,268,237,294830.69,261822.47,556653.16
314740,202111,746,347,399,382844.75,438954.98,821799.73
314750,202111,19,15,4,16500.83,4400,20900.83
314760,202111,360,157,203,172724.36,223328.01,396052.37
314770,202111,104,69,35,75920.2,38509.67,114429.87
314780,202111,22,9,13,9901.73,14302.88,24204.61
314790,202111,2429,1516,913,1668938.82,1004340.6,2673279.42
314795,202111,58,50,8,55000.29,8800.67,63800.96
314800,202111,2892,1659,1233,1825232.6,1357531.72,3182764.32
314810,202111,1464,834,630,917585.39,693079.93,1610665.32
314820,202111,109,63,46,69306.15,51704.52,121010.67
314830,202111,208,170,38,187035.15,41808.26,228843.41
314840,202111,85,47,38,51702.95,41803.94,93506.89
314850,202111,404,188,216,206805.49,237603.9,444409.39
314860,202111,661,509,152,561081.47,167220.49,728301.96
314870,202111,1568,800,768,881214.95,844930.56,1726145.51
314875,202111,49,44,5,48400.55,5500.62,53901.17
314880,202111,43,31,12,34103.25,13202.1,47305.35
314890,202111,50,27,23,29704.29,25304.41,55008.70
314900,202111,26,20,6,22002.53,6601.27,28603.80
314910,202111,231,150,81,165027.78,89106.04,254133.82
314915,202111,136,120,16,132015.23,17602.1,149617.33
314920,202111,86,55,31,61612.78,34108.43,95721.21
314930,202111,1023,487,536,535816.68,589674.34,1125491.02
314940,202111,41,32,9,35204.17,9901.24,45105.41
314950,202111,21,17,4,18703.62,4400.85,23104.47
314960,202111,24,17,7,18703.71,7700.44,26404.15
314970,202111,164,79,85,86916.72,93517.68,180434.40
314980,202111,304,193,111,212332.06,122116.77,334448.83
314990,202111,437,240,197,264034.07,217818.87,481852.94
314995,202111,153,64,89,70401.8,97901.65,168303.45
315000,202111,82,63,19,69315.88,20903.97,90219.85
315010,202111,35,22,13,24202.15,14302.82,38504.97
315015,202111,161,127,34,139704.01,37401.38,177105.39
315020,202111,68,57,11,62700.61,12100.56,74801.17
315030,202111,109,82,27,90210.23,29701.68,119911.91
315040,202111,79,49,30,53902.1,33001.01,86903.11
315050,202111,200,121,79,133111.61,86906.03,220017.64
315053,202111,49,33,16,36300.51,17600,53900.51
315057,202111,112,89,23,97901.35,26400.34,124301.69
315060,202111,69,56,13,61616.84,14302.44,75919.28
315070,202111,103,56,47,61604.42,51703.14,113307.56
315080,202111,374,294,80,323485.11,88012.88,411497.99
315090,202111,97,58,39,63810.39,42901.82,106712.21
315100,202111,78,37,41,40704.82,45104.65,85809.47
315110,202111,270,138,132,151816.49,145212.53,297029.02
315120,202111,1792,854,938,940644.04,1031958.37,1972602.41
315130,202111,337,244,93,268439.45,102317.66,370757.11
315140,202111,533,292,241,321241.28,265131.01,586372.29
315150,202111,972,463,509,511574.43,559975.96,1071550.39
315160,202111,196,100,96,110026.86,105623.27,215650.13
315170,202111,305,203,102,223331.97,112221.53,335553.50
315180,202111,3210,1335,1875,1470933.77,2065965.02,3536898.79
315190,202111,297,179,118,196945.98,129825.14,326771.12
315200,202111,1187,707,480,778892.05,531386.13,1310278.18
315210,202111,1625,932,693,1026452.7,762361.93,1788814.63
315213,202111,27,15,12,16502.86,13205.08,29707.94
315217,202111,198,154,44,169406.28,48403.51,217809.79
315220,202111,1587,1179,408,1298231.41,448884.01,1747115.42
315230,202111,173,130,43,144114.87,47305.11,191419.98
315240,202111,390,250,140,275069.89,154040.23,429110.12
315250,202111,2566,1235,1331,1358693.27,1466401.19,2825094.46
315260,202111,131,71,60,78105.38,66002.57,144107.95
315270,202111,134,91,43,100107.84,47300.78,147408.62
315280,202111,616,410,206,451096.43,226664.02,677760.45
315290,202111,185,115,70,126503.15,77000.44,203503.59
315300,202111,83,63,20,69303.55,22002.36,91305.91
315310,202111,83,74,9,81400.52,9900.67,91301.19
315320,202111,145,86,59,94628.08,64911.87,159539.95
315330,202111,58,46,12,50600.71,13200.11,63800.82
315340,202111,389,284,105,312446.34,115514.98,427961.32
315350,202111,152,95,57,104510.54,62711.96,167222.50
315360,202111,91,40,51,44003.25,56103.04,100106.29
315370,202111,54,34,20,37404.18,22001.32,59405.50
315380,202111,5,5,0,5500,,5500.0
315390,202111,62,19,43,20903.13,47314.82,68217.95
315400,202111,786,582,204,640282.31,224428.25,864710.56
315410,202111,312,182,130,200240.48,143026.72,343267.20
315415,202111,56,41,15,45108.85,16502.5,61611.35
315420,202111,190,138,52,151824.5,57203.84,209028.34
315430,202111,640,364,276,400474.68,303640.41,704115.09
315440,202111,91,61,30,67104.32,33000.6,100104.92
315445,202111,219,182,37,200255.61,40710.99,240966.60
315450,202111,180,131,49,144100,53901.66,198001.66
315460,202111,4268,1979,2289,2180612.63,2520483.01,4701095.64
315470,202111,41,16,25,17601.82,27501.57,45103.39
315480,202111,74,21,53,23103.56,58310.31,81413.87
315490,202111,701,431,270,474129.12,298127.25,772256.37
315500,202111,18,13,5,14302.36,5500.44,19802.80
315510,202111,144,98,46,107811.34,50605.9,158417.24
315520,202111,77,66,11,72602.45,12100,84702.45
315530,202111,41,22,19,24200.76,20900.67,45101.43
315540,202111,259,181,78,199120.67,85803.39,284924.06
315550,202111,178,143,35,157324.75,38504.52,195829.27
315560,202111,720,570,150,627148.18,165042.21,792190.39
315570,202111,309,150,159,165034.74,174932.58,339967.32
315580,202111,726,490,236,540150.39,259632.49,799782.88
315590,202111,192,99,93,108930.44,102323.51,211253.95
315600,202111,315,242,73,266242.3,80319.46,346561.76
315610,202111,101,48,53,52800.93,58300.56,111101.49
315620,202111,36,28,8,30805.37,8802.75,39608.12
315630,202111,121,86,35,94614.3,38502.88,133117.18
315640,202111,67,41,26,45100.94,28601.54,73702.48
315645,202111,47,32,15,35204.5,16501.95,51706.45
315650,202111,167,123,44,135319.14,48409.71,183728.85
315660,202111,453,197,256,216747.95,281643.78,498391.73
315670,202111,2361,1092,1269,1201477.79,1397285.29,2598763.08
315680,202111,796,566,230,622665.18,253026.62,875691.80
315690,202111,672,451,221,496179,243138.25,739317.25
315700,202111,1958,1017,941,1118930.39,1037542.1,2156472.49
315710,202111,359,110,249,122103.24,273912.53,396015.77
315720,202111,472,285,187,313539.45,205723.6,519263.05
315725,202111,189,151,38,166118.47,41803.69,207922.16
315727,202111,52,25,27,27506.19,29709.18,57215.37
315730,202111,48,43,5,47303.36,5500.4,52803.76
315733,202111,84,54,30,59406.39,33000.62,92407.01
315737,202111,50,37,13,40708.99,14301.73,55010.72
315740,202111,33,25,8,27501.33,8800.11,36301.44
315750,202111,148,111,37,122126.05,40707.96,162834.01
315760,202111,40,31,9,34101.98,9900,44001.98
315765,202111,122,72,50,79215.17,55009.82,134224.99
315770,202111,215,133,82,146316.27,90208,236524.27
315780,202111,3708,1827,1881,2012219.4,2070379.44,4082598.84
315790,202111,241,185,56,203528.41,61605.45,265133.86
315800,202111,299,196,103,215636.76,113317.06,328953.82
315810,202111,91,56,35,61607.4,38504.03,100111.43
315820,202111,741,540,201,595229.9,221142.25,816372.15
315830,202111,114,73,41,80312.47,45108.62,125421.09
315840,202111,80,53,27,58300.72,29701.04,88001.76
315850,202111,260,181,79,199144.16,86923.29,286067.45
315860,202111,15,5,10,5500.88,11000,16500.88
315870,202111,41,32,9,35204.58,9902.01,45106.59
315880,202111,92,64,28,70409.31,30804.54,101213.85
315890,202111,102,74,28,81405.05,30802.16,112207.21
315895,202111,411,269,142,295966.07,156228.57,452194.64
315900,202111,74,36,38,39602.85,41802.86,81405.71
315910,202111,43,25,18,27500,19800,47300
315920,202111,149,99,50,108923.36,55006.06,163929.42
315930,202111,54,18,36,19800.14,40707.03,60507.17
315935,202111,122,98,24,107816.26,26402.66,134218.92
315940,202111,97,71,26,78105.95,28601.6,106707.55
315950,202111,37,29,8,31903.79,8801.23,40705.02
315960,202111,536,252,284,278333.08,312441.12,590774.20
315970,202111,33,26,7,28603.8,7700,36303.8
315980,202111,670,332,338,365250.66,371847.9,737098.56
315990,202111,258,147,111,161730.02,122120.18,283850.20
316000,202111,46,30,16,33004.73,17601.14,50605.87
316010,202111,79,66,13,72612.14,14304.01,86916.15
316020,202111,112,97,15,106700.99,16500.34,123201.33
316030,202111,374,207,167,227755.43,183733.12,411488.55
316040,202111,535,213,322,234329.23,354237.85,588567.08
316045,202111,50,45,5,49501.27,5500.8,55002.07
316050,202111,21,16,5,17600.8,5500,23100.8
316060,202111,98,66,32,72606.44,35203.78,107810.22
316070,202111,1103,727,376,799779.63,413650.82,1213430.45
316080,202111,88,56,32,61700.34,36300.47,98000.81
316090,202111,39,19,20,20900.11,22002.14,42902.25
316095,202111,87,72,15,79208.3,16501.41,95709.71
316100,202111,319,176,143,193619.44,158411.89,352031.33
316105,202111,43,25,18,27505.14,19802.39,47307.53
316110,202111,1870,1446,424,1590871.87,466480.77,2057352.64
316120,202111,79,51,28,56107.25,30800.34,86907.59
316130,202111,114,85,29,93521.37,31906.41,125427.78
316140,202111,34,23,11,25300.2,12100,37400.2
316150,202111,213,147,66,161716.58,72608.85,234325.43
316160,202111,84,48,36,52810.52,39609.54,92420.06
316165,202111,64,45,19,49505.98,20902.81,70408.79
316170,202111,187,119,68,130923.53,74813.16,205736.69
316180,202111,211,85,126,93516.09,138619.26,232135.35
316190,202111,141,102,39,112209.53,42902.2,155111.73
316200,202111,652,351,301,386147.78,331130.76,717278.54
316210,202111,767,508,259,560174.28,284950.25,845124.53
316220,202111,114,72,42,79201.99,46201.83,125403.82
316225,202111,35,20,15,22002.27,16502.54,38504.81
316230,202111,39,19,20,20902,22000,42902
316240,202111,659,524,135,576505.2,148524.48,725029.68
316245,202111,140,122,18,134220.79,19801.93,154022.72
316250,202111,1580,1067,513,1177184.28,565439.43,1742623.71
316255,202111,138,110,28,121016.22,30803.13,151819.35
316257,202111,171,86,85,94612.35,93521.87,188134.22
316260,202111,186,129,57,141928.52,62711.47,204639.99
316265,202111,30,21,9,23104.23,9903.59,33007.82
316270,202111,677,478,199,525915.83,218954.27,744870.10
316280,202111,533,327,206,359774.52,227743.4,587517.92
316290,202111,791,533,258,586354.49,283832.06,870186.55
316292,202111,548,217,331,238740.36,365260.97,604001.33
316294,202111,104,68,36,74811.94,39607.78,114419.72
316295,202111,328,144,184,158419.44,202431.53,360850.97
316300,202111,8,6,2,6601.9,2200.2,8802.1
316310,202111,27,14,13,15400.34,14300.11,29700.45
316320,202111,53,28,25,30801.3,27501.29,58302.59
316330,202111,168,116,52,127617.84,57207.34,184825.18
316340,202111,130,87,43,95702.23,47304.16,143006.39
316350,202111,189,132,57,145221.31,62707.31,207928.62
316360,202111,26,14,12,15401.51,13200.84,28602.35
316370,202111,1171,577,594,635879.97,654570.2,1290450.17
316380,202111,110,83,27,91312.53,29705.6,121018.13
316390,202111,102,73,29,80315.01,33004.8,113319.81
316400,202111,139,105,34,115525.62,37407.86,152933.48
316410,202111,309,223,86,245312.92,94603.63,339916.55
316420,202111,212,143,69,157321,75911.93,233232.93
316430,202111,153,81,72,89107.01,80301.69,169408.70
316440,202111,79,40,39,44011.32,42907.97,86919.29
316443,202111,42,38,4,41806.12,4400,46206.12
316447,202111,44,34,10,37402.57,11000.32,48402.89
316450,202111,224,171,53,188118.47,58307.82,246426.29
316460,202111,85,33,52,36302.36,57204.44,93506.80
316470,202111,1650,1196,454,1316908.74,499434.66,1816343.40
316480,202111,11,8,3,8800.4,3300,12100.4
316490,202111,20,7,13,7700.2,14300.44,22000.64
316500,202111,159,104,55,114420.45,60505.28,174925.73
316510,202111,147,114,33,125415.17,36303.65,161718.82
316520,202111,189,108,81,118808.86,89113.01,207921.87
316530,202111,161,101,60,112230.99,66015.3,178246.29
316540,202111,149,75,74,82518.01,81406.28,163924.29
316550,202111,140,85,55,93512.46,60503.27,154015.73
316553,202111,353,155,198,170513.37,217821.48,388334.85
316555,202111,49,44,5,48403.31,5500.44,53903.75
316556,202111,13,9,4,9901.88,4400.44,14302.32
316557,202111,26,21,5,23100.77,5500,28600.77
316560,202111,69,49,20,53901.83,22001.46,75903.29
316570,202111,205,186,19,204642.64,20905,225547.64
316580,202111,22,16,6,17601.81,6600.44,24202.25
316590,202111,95,80,15,88011.98,16503.2,104515.18
316600,202111,180,150,30,165014.78,33002.62,198017.40
316610,202111,67,51,16,56103.67,17600,73703.67
316620,202111,141,100,41,111107.26,45103.02,156210.28
316630,202111,42,33,9,36303.98,9900.55,46204.53
316640,202111,21,14,7,15400,7700,23100
316650,202111,87,70,17,77000,18700,95700
316660,202111,7,2,5,2200,5501.14,7701.14
316670,202111,433,147,286,161721.49,314643.64,476365.13
316680,202111,165,124,41,136414.3,45106.75,181521.05
316690,202111,170,101,69,111108.64,75902.35,187010.99
316695,202111,59,49,10,53900,11000,64900
316700,202111,18,13,5,14300.57,5500.11,19800.68
316710,202111,757,568,189,625990.66,209033.98,835024.64
316720,202111,5028,2392,2636,2634902.09,2900905.76,5535807.85
316730,202111,15,15,0,17605.79,,17605.79
316740,202111,149,94,55,103406.62,60503.62,163910.24
316750,202111,23,15,8,16502.5,8801.63,25304.13
316760,202111,308,250,58,275059.58,63810.75,338870.33
316770,202111,168,88,80,96803.64,88003.85,184807.49
316780,202111,68,42,26,46205.08,28602.49,74807.57
316790,202111,54,37,17,40702.11,18700.92,59403.03
316800,202111,1772,1078,694,1188197.97,764649.61,1952847.58
316805,202111,23,17,6,18701.81,6600.67,25302.48
316810,202111,63,40,23,44011.18,25306.19,69317.37
316820,202111,40,22,18,24200.78,19800.78,44001.56
316830,202111,96,44,52,48409.67,57214.24,105623.91
316840,202111,505,297,208,326757.26,228836.11,555593.37
316850,202111,309,208,101,229936.25,112216.27,342152.52
316860,202111,5986,2643,3343,2910051.61,3680995.64,6591047.25
316870,202111,1598,1016,582,1117805.9,640253.53,1758059.43
316880,202111,145,72,73,79209.61,81408.51,160618.12
316890,202111,232,158,74,173830.41,81418.84,255249.25
316900,202111,403,277,126,304724.74,138612.4,443337.14
316905,202111,20,9,11,9901.87,12100.94,22002.81
316910,202111,63,25,38,27502.17,41802.79,69304.96
316920,202111,138,107,31,117714.32,34103.16,151817.48
316930,202111,1889,937,952,1033009.68,1047276.16,2080285.84
316935,202111,903,532,371,588571.38,409253.25,997824.63
316940,202111,1078,609,469,669978.04,517062.11,1187040.15
316950,202111,175,83,92,91316.04,102318.8,193634.84
316960,202111,1085,594,491,654595.74,540187.39,1194783.13
316970,202111,622,489,133,538000.8,146333.29,684334.09
316980,202111,73,39,34,42902.98,37403.1,80306.08
316990,202111,2179,1464,715,1611671.84,786590.82,2398262.66
317000,202111,325,249,76,273958.83,83615.23,357574.06
317005,202111,219,157,62,172731.64,68209.91,240941.55
317010,202111,6447,3585,2862,3946404.03,3154142.31,7100546.34
317020,202111,15546,6760,8786,7446077.51,9674467.54,17120545.05
317030,202111,81,31,50,34103.95,55002.72,89106.67
317040,202111,3017,1910,1107,2103516.51,1219021.47,3322537.98
317043,202111,69,53,16,58316.82,17605.65,75922.47
317047,202111,39,21,18,23101.87,19800.74,42902.61
317050,202111,148,113,35,124317.71,38505.97,162823.68
317052,202111,142,111,31,122114.02,34101.56,156215.58
317057,202111,172,131,41,144109.05,45102.19,189211.24
317060,202111,58,35,23,38501.19,25301.98,63803.17
317065,202111,50,37,13,40703.01,14300,55003.01
317070,202111,1916,869,1047,956077.74,1153983.33,2110061.07
317075,202111,93,50,43,55007.16,47304.25,102311.41
317080,202111,911,462,449,508294.3,495041.33,1003335.63
317090,202111,692,540,152,594104.84,167221.93,761326.77
317100,202111,415,307,108,338837.84,118817.15,457654.99
317103,202111,112,89,23,97905.63,25301.76,123207.39
317107,202111,47,40,7,44000,7700,51700
317110,202111,100,49,51,53912.34,56113.72,110026.06
317115,202111,40,36,4,39603.2,4400.34,44003.54
317120,202111,1978,930,1048,1024291.62,1153009.58,2177301.20
317130,202111,1981,1318,663,1452223.26,729357.75,2181581.01
317140,202111,11,9,2,9900.7,2200,12100.7
317150,202111,282,169,113,185916.33,125405.12,311321.45
317160,202111,332,248,84,272849.09,92416.23,365265.32
317170,202111,234,160,74,177125.62,81404.2,258529.82
317180,202111,427,289,138,319048.34,151816.23,470864.57
317190,202111,259,187,72,205717.16,79205.72,284922.88
317200,202111,798,553,245,610592.12,269554.79,880146.91
317210,202111,180,94,86,103414.14,94607.89,198022.03
317220,202111,23,11,12,12101.33,13201.01,25302.34
320010,202111,562,405,157,447819.1,173843.27,621662.37
320013,202111,121,84,37,92420.37,40709.16,133129.53
320016,202111,263,167,96,183744.12,105619.71,289363.83
320020,202111,713,412,301,453292.56,331178.26,784470.82
320030,202111,164,112,52,123224.01,57207.42,180431.43
320035,202111,136,96,40,105613.03,44006.4,149619.43
320040,202111,496,255,241,280553.43,265158.34,545711.77
320050,202111,119,80,39,88027.17,42911.77,130938.94
320060,202111,1737,815,922,897793.96,1016627.82,1914421.78
320070,202111,98,60,38,66013.73,41803.88,107817.61
320080,202111,793,451,342,497331.68,376292.7,873624.38
320090,202111,1243,810,433,893372.12,476390.49,1369762.61
320100,202111,336,194,142,213452.05,156240.56,369692.61
320110,202111,121,76,45,83621.52,49513.07,133134.59
320115,202111,110,89,21,99022.68,23103.85,122126.53
320120,202111,3627,1880,1747,2069432.71,1923109.67,3992542.38
320130,202111,7751,3418,4333,3761697.3,4773897.92,8535595.22
320140,202111,440,278,162,305862.08,178234.35,484096.43
320150,202111,2097,1156,941,1272924.38,1035313.02,2308237.40
320160,202111,647,282,365,310255.08,402656.47,712911.55
320170,202111,110,85,25,93522.51,27506.95,121029.46
320180,202111,57,35,22,38506.33,24206.79,62713.12
320190,202111,234,148,86,163942.13,94618.45,258560.58
320200,202111,63,49,14,53909.88,15402.72,69312.60
320210,202111,894,479,415,527013.12,456597.94,983611.06
320220,202111,301,107,194,117714.57,213415.64,331130.21
320225,202111,80,63,17,69316.92,18703.88,88020.80
320230,202111,674,428,246,470923.13,270653.46,741576.59
320240,202111,3495,1611,1884,1775678.96,2073849.81,3849528.77
320245,202111,489,329,160,363078.39,176034.78,539113.17
320250,202111,229,106,123,116630.26,135330.72,251960.98
320255,202111,128,98,30,107823.13,33008.85,140831.98
320260,202111,239,135,104,148525.94,115513.92,264039.86
320265,202111,148,114,34,125422.51,37405.67,162828.18
320270,202111,150,115,35,126535.18,38508.54,165043.72
320280,202111,1173,660,513,727226.19,564389.03,1291615.22
320290,202111,59,48,11,52814.69,12102.86,64917.55
320300,202111,606,408,198,448891.53,217839.24,666730.77
320305,202111,709,375,334,412597.58,367480.67,780078.25
320310,202111,199,114,85,125426.87,93517.09,218943.96
320313,202111,337,155,182,170536.32,200245.28,370781.60
320316,202111,108,80,28,88025.77,30806.58,118832.35
320320,202111,3437,1511,1926,1664640.26,2119020.58,3783660.84
320330,202111,269,195,74,214512.51,81407.04,295919.55
320332,202111,777,458,319,503937.94,350986.37,854924.31
320334,202111,270,148,122,162833.78,134220.99,297054.77
320335,202111,143,89,54,97931.46,59417.68,157349.14
320340,202111,565,394,171,433502.6,188143.06,621645.66
320350,202111,1045,422,623,464289.37,686532.91,1150822.28
320360,202111,168,83,85,91312.28,93508.57,184820.85
320370,202111,231,171,60,188137.73,66009.97,254147.70
320380,202111,293,204,89,224439.98,97909.37,322349.35
320390,202111,1154,676,478,743769.05,525912.97,1269682.02
320400,202111,320,227,93,249768.42,102322.72,352091.14
320405,202111,952,391,561,430197.68,619430.43,1049628.11
320410,202111,966,482,484,530325.8,532502.49,1062828.29
320420,202111,532,252,280,277261.43,308064.34,585325.77
320425,202111,190,106,84,116615.44,92408.74,209024.18
320430,202111,375,194,181,213449.99,199147.86,412597.85
320435,202111,164,109,55,119926.86,60512.62,180439.48
320440,202111,201,111,90,122136.3,99025.69,221161.99
320450,202111,136,73,63,81423.71,69314.46,150738.17
320455,202111,236,187,49,205756.38,53915.17,259671.55
320460,202111,281,179,102,196933.95,113321.08,310255.03
320465,202111,112,75,37,82516.14,40709.65,123225.79
320470,202111,705,425,280,467592.97,308075.48,775668.45
320480,202111,197,127,70,139724.92,77015.01,216739.93
320490,202111,3185,1495,1690,1644824.48,1860489.41,3505313.89
320495,202111,115,66,49,72613.54,53913.79,126527.33
320500,202111,9739,4709,5030,5187695.72,5538705.91,10726401.63
320501,202111,545,272,273,299269.99,302574.13,601844.12
320503,202111,294,204,90,225556.14,99019.07,324575.21
320506,202111,252,176,76,193628.18,83610.08,277238.26
320510,202111,1137,498,639,547924.19,703045.89,1250970.08
320515,202111,78,59,19,64916.39,20905.73,85822.12
320517,202111,215,152,63,169448.92,69315.41,238764.33
320520,202111,7370,3077,4293,3390824.43,4726514.61,8117339.04
320530,202111,6628,3159,3469,3477643.86,3819872.49,7297516.35
330010,202111,3221,1604,1617,1764723.33,1778995.77,3543719.10
330015,202111,195,81,114,89109.18,125408.34,214517.52
330020,202111,3840,1520,2320,1672315,2554668.53,4226983.53
330022,202111,267,132,135,145221.3,148522.83,293744.13
330023,202111,695,199,496,218929.73,545671.74,764601.47
330025,202111,637,114,523,125412.25,578702.4,704114.65
330030,202111,1820,1123,697,1236583.73,766826.45,2003410.18
330040,202111,2523,1273,1250,1402720.96,1377432.47,2780153.43
330045,202111,9735,2800,6935,3081536.68,7636339.38,10717876.06
330050,202111,865,541,324,595195.66,356455.63,951651.29
330060,202111,1082,635,447,698618.92,491765.06,1190383.98
330070,202111,4116,1404,2712,1546837.85,2986998.31,4533836.16
330080,202111,1586,680,906,749228.47,1000062.88,1749291.35
330090,202111,397,224,173,246448.59,190333.38,436781.97
330093,202111,254,108,146,118819.23,160620.33,279439.56
330095,202111,69,42,27,46208.43,29702.29,75910.72
330100,202111,10260,5019,5241,5522906.25,5771545.37,11294451.62
330110,202111,465,201,264,221131.16,291545.5,512676.66
330115,202111,518,264,254,291547.89,279441.38,570989.27
330120,202111,393,203,190,223338.17,210138.99,433477.16
330130,202111,1593,395,1198,434576.83,1321435.64,1756012.47
330140,202111,637,329,308,361943.73,338835.29,700779.02
330150,202111,515,292,223,322339.36,246439.4,568778.76
330160,202111,206,118,88,129817.83,96811.92,226629.75
330170,202111,27259,9049,18210,9975626.55,20071267.92,30046894.47
330180,202111,244,126,118,138614.83,129815.51,268430.34
330185,202111,1045,358,687,393855.87,756987.24,1150843.11
330187,202111,475,138,337,151817.93,371846.89,523664.82
330190,202111,6143,2230,3913,2454517.39,4312721.86,6767239.25
330200,202111,4684,1394,3290,1534818.78,3624183.49,5159002.27
330205,202111,447,247,200,271739.24,220037.67,491776.91
330210,202111,950,568,382,624896.42,420282.6,1045179.02
330220,202111,2700,1563,1137,1719638.67,1252021.33,2971660.00
330225,202111,570,287,283,315740.41,312449.28,628189.69
330227,202111,2427,725,1702,797618.68,1873670.1,2671288.78
330230,202111,268,144,124,158420.31,136414.64,294834.95
330240,202111,4073,1937,2136,2134402.62,2351122.22,4485524.84
330245,202111,153,64,89,70407.16,97911.77,168318.93
330250,202111,6752,3260,3492,3591136.12,3846250.51,7437386.63
330260,202111,701,184,517,203525.23,568770.58,772295.81
330270,202111,3801,1201,2600,1322466.67,2866043.45,4188510.12
330280,202111,446,274,172,302553.48,189231.24,491784.72
330285,202111,6878,2092,4786,2301760.79,5273604.75,7575365.54
330290,202111,695,245,450,269533.08,495063.84,764596.92
330300,202111,748,474,274,522163.65,302553.51,824717.16
330310,202111,450,244,206,268441.99,226638.53,495080.52
330320,202111,8017,2816,5201,3103810.99,5726732.85,8830543.84
330330,202111,9392,3436,5956,3784630.63,6559235.93,10343866.56
330340,202111,2677,1508,1169,1660184.4,1287170.77,2947355.17
330350,202111,19432,7018,12414,7727811.41,13670946.68,21398758.09
330360,202111,2104,983,1121,1081549.01,1234481.26,2316030.27
330370,202111,977,485,492,534697.9,541321.15,1076019.05
330380,202111,928,378,550,415859.91,605089.06,1020948.97
330385,202111,629,311,318,342144.62,353142.03,695286.65
330390,202111,5881,2994,2887,3299447.21,3178420.15,6477867.36
330395,202111,340,207,133,227730.98,146313.88,374044.86
330400,202111,704,348,356,383968.72,391653.47,775622.19
330410,202111,504,358,146,396082.7,160634.99,556717.69
330411,202111,277,138,139,151816.28,152914.81,304731.09
330412,202111,223,91,132,100112.72,145216.51,245329.23
330414,202111,5382,2104,3278,2314883.49,3608631.32,5923514.81
330415,202111,607,260,347,286054.24,381767.88,667822.12
330420,202111,2311,1163,1148,1281656.12,1262974,2544630.12
330430,202111,1780,756,1024,832883.07,1128762.47,1961645.54
330440,202111,335,157,178,172715.36,195820.06,368535.42
330450,202111,112,48,64,52805.67,70409.29,123214.96
330452,202111,2282,961,1321,1058360.76,1454398.24,2512759.00
330455,202111,119475,40073,79402,44135659.78,87437486.91,131573146.69
330460,202111,251,110,141,121021.21,155130.21,276151.42
330470,202111,1238,666,572,733807.85,629297.27,1363105.12
330475,202111,1715,474,1241,521482.89,1365348.22,1886831.11
330480,202111,818,443,375,488465.1,412576.4,901041.5
330490,202111,15666,4787,10879,5275370.11,11975202.14,17250572.25
330500,202111,1482,636,846,699727.1,931861.23,1631588.33
330510,202111,11110,3715,7395,4092791.55,8145838.62,12238630.17
330513,202111,101,51,50,56102.83,55002.89,111105.72
330515,202111,745,307,438,337771.7,481926.88,819698.58
330520,202111,2536,861,1675,949494.01,1845084.06,2794578.07
330530,202111,195,108,87,118819.07,95716.34,214535.41
330540,202111,335,168,167,184829.84,183735.95,368565.79
330550,202111,2839,952,1887,1047406.59,2077202.29,3124608.88
330555,202111,821,308,513,338844.64,566583.24,905427.88
330560,202111,715,234,481,257458.01,529208.48,786666.49
330570,202111,291,201,90,221138.41,99013.43,320151.84
330575,202111,803,279,524,308070.09,579817.17,887887.26
330580,202111,3370,1820,1550,2005619.38,1707475.32,3713094.70
330590,202111,266,138,128,151828.74,140825.7,292654.44
330600,202111,1273,761,512,837227.21,564383.57,1401610.78
330610,202111,1612,838,774,924166.93,851514.63,1775681.56
330615,202111,217,174,43,191431.08,47307.96,238739.04
330620,202111,1046,397,649,436792.23,714074.93,1150867.16
330630,202111,4291,2567,1724,2829563.69,1899911.22,4729474.91
350010,202111,586,385,201,423570.99,222232.61,645803.60
350020,202111,55,17,38,18702.77,41805.36,60508.13
350030,202111,523,327,196,359761.88,216733.23,576495.11
350040,202111,124,51,73,56108.53,80310.97,136419.50
350050,202111,341,173,168,190321.36,184816.19,375137.55
350055,202111,117,53,64,58308.39,70404.06,128712.45
350060,202111,89,35,54,38504.2,59402.7,97906.9
350070,202111,781,447,334,491794.62,367475.98,859270.60
350075,202111,69,43,26,47306.94,28601.4,75908.34
350080,202111,57,24,33,26406.16,36304.8,62710.96
350090,202111,82,46,36,50608.12,39603.34,90211.46
350100,202111,269,166,103,182617.89,113311.77,295929.66
350110,202111,49,33,16,36309.5,17601.75,53911.25
350115,202111,156,88,68,97913.55,74811.77,172725.32
350120,202111,105,67,38,73712.75,41809.65,115522.40
350130,202111,378,160,218,176043.13,239848.18,415891.31
350140,202111,40,25,15,27502.89,16502.33,44005.22
350150,202111,72,51,21,56105.67,23102.35,79208.02
350160,202111,2378,928,1450,1024272.08,1596242.26,2620514.34
350170,202111,387,219,168,240934.77,184825.94,425760.71
350180,202111,167,94,73,103408.71,80307.44,183716.15
350190,202111,1007,534,473,587538.04,520347.48,1107885.52
350200,202111,62,23,39,25300.74,42902.41,68203.15
350210,202111,1297,704,593,775622.87,654609.31,1430232.18
350220,202111,629,513,116,565480.9,127616.21,693097.11
350230,202111,75,50,25,55004.72,27502.94,82507.66
350240,202111,58,38,20,41806.52,22004.94,63811.46
350250,202111,1146,522,624,574318.12,687635.61,1261953.73
350260,202111,99,70,29,77009.28,31901.76,108911.04
350270,202111,927,614,313,676583.5,344349.86,1020933.36
350275,202111,301,117,184,128724.04,203541.36,332265.40
350280,202111,4459,2164,2295,2383012.93,2524716.08,4907729.01
350290,202111,462,199,263,218938.23,289346.34,508284.57
350300,202111,51,25,26,27505.84,28603.23,56109.07
350310,202111,77,49,28,53907.65,30801.59,84709.24
350315,202111,66,28,38,30801.37,41800.8,72602.17
350320,202111,3339,1590,1749,1752589.74,1925206.72,3677796.46
350330,202111,1652,855,797,940643.29,877896.68,1818539.97
350335,202111,16,10,6,11000.67,6601.45,17602.12
350340,202111,123,52,71,57214.12,78117.26,135331.38
350350,202111,103,52,51,57211.98,56105.57,113317.55
350360,202111,107,71,36,78118.09,39605.91,117724.00
350370,202111,80,41,39,45111.19,42905.04,88016.23
350380,202111,780,325,455,358657.84,501657.91,860315.75
350390,202111,1710,617,1093,678814.7,1203583.53,1882398.23
350395,202111,21,16,5,17605.8,5500.37,23106.17
350400,202111,1688,817,871,898843.33,960372.48,1859215.81
350410,202111,2911,1205,1706,1326604.55,1877907.94,3204512.49
350420,202111,257,149,108,163921.98,118815.43,282737.41
350430,202111,83,44,39,48407.32,42907.36,91314.68
350440,202111,148,107,41,117721.04,45107.04,162828.08
350450,202111,1710,956,754,1051766.44,830550.24,1882316.68
350460,202111,393,133,260,146336.06,286065.29,432401.35
350470,202111,20,12,8,13200,8801.23,22001.23
350480,202111,196,104,92,114418.35,101215.47,215633.82
350490,202111,241,113,128,124326.97,140825.53,265152.50
350500,202111,57,25,32,27501.28,35201.57,62702.85
350510,202111,154,94,60,103414.39,66008.43,169422.82
350520,202111,431,222,209,245352.27,231034.15,476386.42
350530,202111,445,210,235,231039.64,258547.37,489587.01
350535,202111,85,62,23,68216.24,25305.6,93521.84
350540,202111,362,191,171,210133.99,188134.78,398268.77
350550,202111,2716,1532,1184,1685520.32,1304715.8,2990236.12
350560,202111,580,391,189,432358.81,207926.07,640284.88
350570,202111,4387,1773,2614,1955057.29,2876919.31,4831976.60
350580,202111,351,173,178,190329.28,195825.2,386154.48
350590,202111,941,506,435,557760.31,478559.97,1036320.28
350600,202111,6199,2889,3310,3180625.87,3643509.32,6824135.19
350610,202111,1485,757,728,833928.09,803074.76,1637002.85
350620,202111,26,15,11,16500.91,12100.94,28601.85
350630,202111,245,121,124,134217.89,137514.62,271732.51
350635,202111,1064,414,650,456573.42,716207.69,1172781.11
350640,202111,112,83,29,92408.63,31902.4,124311.03
350650,202111,1851,1218,633,1342235.92,696367.16,2038603.08
350660,202111,748,296,452,325656.41,498378.88,824035.29
350670,202111,296,145,151,159506.49,166102.79,325609.28
350680,202111,170,83,87,91318.2,95716.43,187034.63
350690,202111,198,90,108,99016.29,118811.05,217827.34
350700,202111,837,386,451,425761.28,496167.98,921929.26
350710,202111,395,144,251,158425.69,276139.74,434565.43
350715,202111,57,45,12,49503.31,13202.12,62705.43
350720,202111,16,10,6,11002.56,6602.97,17605.53
350730,202111,43,25,18,27501.74,19800.11,47301.85
350740,202111,234,128,106,141914.39,117714.09,259628.48
350745,202111,28,12,16,13202.61,17603.1,30805.71
350750,202111,2311,1355,956,1494049.03,1051686.15,2545735.18
350760,202111,3758,1540,2218,1694386.06,2442262.57,4136648.63
350770,202111,59,39,20,42903.45,22000.22,64903.67
350775,202111,46,33,13,36305.55,14301.89,50607.44
350780,202111,427,219,208,242031.26,229940.76,471972.02
350790,202111,359,146,213,161726.06,234338.81,396064.87
350800,202111,505,299,206,328947.17,226626.51,555573.68
350810,202111,500,391,109,430177.14,119917.02,550094.16
350820,202111,94,53,41,58301.3,45101.45,103402.75
350830,202111,74,39,35,42905.55,38503.66,81409.21
350840,202111,771,305,466,337757.82,512685.59,850443.41
350850,202111,1827,957,870,1053975.91,957112.32,2011088.23
350860,202111,639,334,305,368574.92,335565.61,704140.53
350870,202111,433,284,149,312436.65,163917.48,476354.13
350880,202111,268,154,114,169435.29,125430.53,294865.82
350890,202111,38,23,15,25304.92,16504.19,41809.11
350900,202111,1567,462,1105,508283.71,1215708.97,1723992.68
350910,202111,22,13,9,14302.74,9901.31,24204.05
350920,202111,727,375,352,412550.42,388344.75,800895.17
350925,202111,1135,590,545,651310.45,599608.73,1250919.18
350930,202111,105,55,50,60511.16,55004.34,115515.50
350940,202111,729,382,347,420278.47,381765.78,802044.25
350945,202111,107,77,30,84713.33,33008.71,117722.04
350950,202111,16925,7682,9243,8466905.52,10180393.97,18647299.49
350960,202111,1528,612,916,673307.49,1007744.41,1681051.90
350970,202111,1071,539,532,593987.07,585337.07,1179324.14
350980,202111,95,63,32,69309.58,35205.89,104515.47
350990,202111,377,134,243,147418.71,268427.5,415846.21
350995,202111,38,18,20,19801.24,22004.02,41805.26
351000,202111,610,402,208,443366.04,228842.02,672208.06
351010,202111,52,32,20,35203.45,22002.26,57205.71
351015,202111,46,32,14,35207.33,15400.44,50607.77
351020,202111,1487,879,608,968115.8,668893.04,1637008.84
351030,202111,341,203,138,223321.3,152904.73,376226.03
351040,202111,948,469,479,518165.01,528068.24,1046233.25
351050,202111,3397,1500,1897,1651420.46,2091335.34,3742755.80
351060,202111,5695,2053,3642,2259875.69,4010935.96,6270811.65
351070,202111,393,246,147,270659.48,162837.18,433496.66
351080,202111,708,508,200,559966.77,220025.75,779992.52
351090,202111,47,21,26,23102.75,28603.58,51706.33
351100,202111,419,228,191,251954.71,211239.87,463194.58
351110,202111,2035,937,1098,1031972.82,1211211.11,2243183.93
351120,202111,65,33,32,36305.71,35201.16,71506.87
351130,202111,189,61,128,67109.39,140824.49,207933.88
351140,202111,312,191,121,210134.19,133115.74,343249.93
351150,202111,467,242,225,266234.05,247524.18,513758.23
351160,202111,272,164,108,180430.27,118809.41,299239.68
351170,202111,198,102,96,112208.13,105607.48,217815.61
351190,202111,89,57,32,62705.5,35201.46,97906.96
351200,202111,344,216,128,238731.26,140821.76,379553.02
351210,202111,114,56,58,61611.76,63806.76,125418.52
351220,202111,547,318,229,349850.24,251926.68,601776.92
351230,202111,283,190,93,209024.58,102311.1,311335.68
351240,202111,236,111,125,123212.37,137518.34,260730.71
351250,202111,84,54,30,59410.2,33005.74,92415.94
351260,202111,150,107,43,117701.78,47301.61,165003.39
351270,202111,48,20,28,22002.11,31902.5,53904.61
351280,202111,1034,472,562,519263.96,618283.7,1137547.66
351290,202111,243,110,133,121008.4,146311.69,267320.09
351300,202111,3843,1651,2192,1816377.39,2413828.58,4230205.97
351310,202111,737,357,380,392759.72,418099.6,810859.32
351320,202111,114,63,51,69310.61,56110.24,125420.85
351330,202111,37,23,14,25302.92,15401.24,40704.16
351340,202111,1329,744,585,819632.25,644654.45,1464286.70
351350,202111,2347,1333,1014,1469947.73,1116636.78,2586584.51
351360,202111,788,368,420,404879.48,462095.95,866975.43
351370,202111,384,185,199,204629.34,218918.39,423547.73
351380,202111,8834,3815,5019,4200689.45,5522678.03,9723367.48
351385,202111,28,17,11,18706.59,12103.29,30809.88
351390,202111,278,210,68,231037.49,74808.02,305845.51
351400,202111,66,43,23,47300.63,25303.7,72604.33
351410,202111,432,266,166,293749.81,182626.01,476375.82
351420,202111,67,47,20,51703.1,22000.78,73703.88
351430,202111,71,39,32,42906.21,35203.35,78109.56
351440,202111,764,509,255,561076.61,280535.16,841611.77
351450,202111,268,123,145,136423.12,159525.12,295948.24
351460,202111,124,56,68,61611.75,74810.52,136422.27
351470,202111,146,77,69,84711.21,75909.27,160620.48
351480,202111,481,280,201,308027.73,221118.5,529146.23
351490,202111,288,103,185,113304.64,203515.26,316819.90
351492,202111,26,17,9,18703.54,9900.5,28604.04
351495,202111,25,17,8,18702.41,8800.99,27503.40
351500,202111,3479,1394,2085,1535856.81,2297129.6,3832986.41
351510,202111,2041,739,1302,813015.78,1433465.32,2246481.10
351512,202111,15,11,4,12100.44,4400,16500.44
351515,202111,193,112,81,124322.03,89113.14,213435.17
351518,202111,698,420,278,462126.12,305860.46,767986.58
351519,202111,79,44,35,48407.27,38505.78,86913.05
351520,202111,160,94,66,103415.71,72625.89,176041.60
351530,202111,23,14,9,15400.4,9900,25300.4
351535,202111,130,79,51,86913.52,56113.51,143027.03
351540,202111,451,303,148,333357.97,162823.15,496181.12
351550,202111,1456,846,610,934037.25,672154.54,1606191.79
351560,202111,76,45,31,49503.36,34101.97,83605.33
351565,202111,13,6,7,6600.96,7700.94,14301.90
351570,202111,2707,1254,1453,1380802.37,1600825.44,2981627.81
351580,202111,38,32,6,35203.15,6600.44,41803.59
351590,202111,62,40,22,44008.63,24202.59,68211.22
351600,202111,174,123,51,136418.36,56109.81,192528.17
351610,202111,52,22,30,24202.39,33005.71,57208.10
351620,202111,5791,3105,2686,3418230.81,2958181.48,6376412.29
351630,202111,3092,1456,1636,1602991.18,1800985.66,3403976.84
351640,202111,2166,919,1247,1012159.19,1372994.74,2385153.93
351650,202111,28,24,4,26405.4,4400.74,30806.14
351660,202111,131,82,49,90209.55,53904.22,144113.77
351670,202111,708,421,287,464269.51,315734.44,780003.95
351680,202111,71,56,15,61602.08,16501.85,78103.93
351685,202111,11,8,3,8800.6,3300,12100.6
351690,202111,300,199,101,218940.48,111116.54,330057.02
351700,202111,175,114,61,125652.74,67103.57,192756.31
351710,202111,67,42,25,46210.1,27504.93,73715.03
351720,202111,127,70,57,77007.13,62702.97,139710.10
351730,202111,110,69,41,75902.68,45100,121002.68
351740,202111,754,471,283,518161.28,311347.43,829508.71
351750,202111,363,141,222,155130.02,244241.96,399371.98
351760,202111,729,558,171,613904.91,189223.91,803128.82
351770,202111,296,239,57,265128.81,62712.73,327841.54
351780,202111,157,94,63,103411.54,69304.17,172715.71
351790,202111,257,133,124,146317.94,136419.93,282737.87
351800,202111,40,25,15,27501.59,16501.11,44002.70
351810,202111,120,79,41,86916.21,45107.45,132023.66
351820,202111,771,544,227,598495.22,250842.13,849337.35
351830,202111,586,187,399,205730.77,438966.26,644697.03
351840,202111,2064,942,1122,1038569.18,1235402.93,2273972.11
351850,202111,225,158,67,173835.06,73708.65,247543.71
351860,202111,627,422,205,464276.38,226634.8,690911.18
351870,202111,5665,2550,3115,2808791.2,3429275.25,6238066.45
351880,202111,20555,7881,12674,8689157.33,13949503.4,22638660.73
351885,202111,86,47,39,51708.63,42904.33,94612.96
351890,202111,67,48,19,52804.49,20901.07,73705.56
351900,202111,219,122,97,134222.83,106711.95,240934.78
351905,202111,97,44,53,48402.41,59404.55,107806.96
351907,202111,3560,1432,2128,1576569.06,2343255.77,3919824.83
351910,202111,168,71,97,78118.11,107825.67,185943.78
351920,202111,111,59,52,64905.97,57205.22,122111.19
351925,202111,90,55,35,60511.66,38508.42,99020.08
351930,202111,401,261,140,287150.71,154028.19,441178.90
351940,202111,239,95,144,104510.44,158416.15,262926.59
351950,202111,137,71,66,78110.78,72613.82,150724.60
351960,202111,926,447,479,491768.36,526988.83,1018757.19
351970,202111,2018,968,1050,1064973.02,1156282.67,2221255.69
351980,202111,153,67,86,73711.86,94618.38,168330.24
351990,202111,251,160,91,176017.56,100114.09,276131.65
352000,202111,325,202,123,222237.6,135325.09,357562.69
352010,202111,417,263,154,289409.22,169437.77,458846.99
352020,202111,183,65,118,71504.76,129805.03,201309.79
352030,202111,1121,540,581,596287.33,640283.67,1236571.00
352040,202111,594,236,358,259642.02,394966.02,654608.04
352042,202111,295,69,226,75911.43,248643.49,324554.92
352044,202111,351,204,147,224449.84,161729.12,386178.96
352050,202111,3223,1183,2040,1301523.54,2246441.39,3547964.93
352060,202111,101,57,44,62705,48404.25,111109.25
352070,202111,92,67,25,73712.62,27501.96,101214.58
352080,202111,63,42,21,46205.16,23106.04,69311.20
352090,202111,163,107,56,117713.6,61603.66,179317.26
352100,202111,283,130,153,143020.78,168320.36,311341.14
352110,202111,114,36,78,39604.6,85806.74,125411.34
352115,202111,63,19,44,20902.25,48404.23,69306.48
352120,202111,75,52,23,57205.44,25304.98,82510.42
352130,202111,213,165,48,181527.37,52803.33,234330.70
352140,202111,174,80,94,89107.25,103413.19,192520.44
352150,202111,124,64,60,70414.28,66014.34,136428.62
352160,202111,140,90,50,99010.09,55005.38,154015.47
352170,202111,389,265,124,291534.25,136413.21,427947.46
352180,202111,668,401,267,441176.18,293750.65,734926.83
352190,202111,242,95,147,104517.53,162816.95,267334.48
352200,202111,29,12,17,13202.44,18703.5,31905.94
352210,202111,4295,1692,2603,1862620.12,2866934.35,4729554.47
352215,202111,70,39,31,42903.12,34101.31,77004.43
352220,202111,6455,2381,4074,2624079.94,4484642.69,7108722.63
352230,202111,3393,2157,1236,2379723.74,1363007.3,3742731.04
352240,202111,2582,1445,1137,1589713.94,1253083.49,2842797.43
352250,202111,3103,1393,1710,1532582.34,1881175.91,3413758.25
352260,202111,1003,529,474,582001.85,521505.6,1103507.45
352265,202111,59,31,28,34103.61,30802.11,64905.72
352270,202111,375,206,169,227736.25,185933.98,413670.23
352280,202111,484,291,193,320127.76,212312.07,532439.83
352290,202111,175,98,77,107823.29,84713.12,192536.41
352300,202111,95,64,31,70408.64,34104.22,104512.86
352310,202111,6708,2849,3859,3136785.23,4246276.32,7383061.55
352320,202111,1122,565,557,622693.97,612775.07,1235469.04
352330,202111,527,262,265,288214.76,291511.5,579726.26
352340,202111,1356,616,740,681023.65,816335.65,1497359.30
352350,202111,354,196,158,215640.66,173839.14,389479.80
352360,202111,224,99,125,108908,138609.28,247517.28
352370,202111,110,68,42,74812.56,46207.34,121019.90
352380,202111,106,74,32,81413.76,35205.4,116619.16
352390,202111,2586,1102,1484,1213521.11,1633669.23,2847190.34
352400,202111,520,220,300,242025.5,330036.98,572062.48
352410,202111,900,595,305,654588.02,338851.13,993439.15
352420,202111,91,68,23,74805.26,25303.52,100108.78
352430,202111,1749,771,978,849308.48,1079232.38,1928540.86
352440,202111,3302,1543,1759,1698656.47,1935086.87,3633743.34
352450,202111,202,152,50,167212.97,55010.5,222223.47
352460,202111,624,311,313,342152.92,344353.7,686506.62
352470,202111,651,226,425,248633.72,468656.98,717290.70
352480,202111,1507,816,691,898823.29,761302.84,1660126.13
352490,202111,45,15,30,16504.29,33005.06,49509.35
352500,202111,1278,517,761,568799.13,839420.91,1408220.04
352510,202111,697,365,332,401567.06,366362.64,767929.70
352520,202111,817,341,476,375171.05,523676.02,898847.07
352530,202111,1791,916,875,1008897.32,962596.54,1971493.86
352540,202111,67,44,23,48407.34,25305.3,73712.64
352550,202111,194,112,82,123217.42,90207.49,213424.91
352560,202111,47,38,9,41805.32,9901.32,51706.64
352570,202111,718,341,377,375158.47,415863.01,791021.48
352580,202111,55,42,13,46206.62,14303.19,60509.81
352585,202111,22,5,17,5500.58,18703.52,24204.10
352590,202111,4312,2069,2243,2281860.08,2469914.8,4751774.88
352600,202111,356,244,112,268443.82,123221.48,391665.30
352610,202111,913,404,509,444466.22,559990.97,1004457.19
352620,202111,1069,394,675,435690.35,743734.35,1179424.70
352630,202111,183,68,115,74810.43,127617.98,202428.41
352640,202111,519,333,186,366360.85,205736.53,572097.38
352650,202111,81,61,20,67105.26,22002.69,89107.95
352660,202111,65,37,28,40707.03,30803.08,71510.11
352670,202111,1688,878,810,967066.06,893257.07,1860323.13
352680,202111,912,554,358,609506.6,394982.94,1004489.54
352690,202111,4563,1987,2576,2188321.16,2839404.01,5027725.17
352700,202111,92,54,38,59414.85,41806.51,101221.36
352710,202111,1465,747,718,822914.36,790935.15,1613849.51
352720,202111,1469,640,829,705225.5,912060.56,1617286.06
352725,202111,23,18,5,19805.08,5500.5,25305.58
352730,202111,376,176,200,194732.97,221135.83,415868.80
352740,202111,391,253,138,278342.4,151830.06,430172.46
352750,202111,23,15,8,16504.43,8800.93,25305.36
352760,202111,206,131,75,144115.59,82507.37,226622.96
352770,202111,83,62,21,68209.25,23101.68,91310.93
352780,202111,73,37,36,40702.82,39602.68,80305.50
352790,202111,23,17,6,18703.61,6601.53,25305.14
352800,202111,228,172,56,189227.83,61609.26,250837.09
352810,202111,157,98,59,107826.8,64913.02,172739.82
352820,202111,44,34,10,37402.32,11002.13,48404.45
352830,202111,76,50,26,55011.61,28603.87,83615.48
352840,202111,668,303,365,333374.7,401582.4,734957.1
352850,202111,1691,511,1180,563262.24,1301433.33,1864695.57
352860,202111,110,70,40,77014.04,44009.19,121023.23
352870,202111,48,30,18,33006.49,19805.02,52811.51
352880,202111,176,110,66,121017.9,72613.94,193631.84
352885,202111,32,22,10,24206.37,11000.75,35207.12
352890,202111,52,34,18,37406.36,19805.12,57211.48
352900,202111,4631,2174,2457,2395103.06,2704069.88,5099172.94
352910,202111,36,29,7,31902.34,7700.44,39602.78
352920,202111,641,370,271,408176.16,298153.63,706329.79
352930,202111,1185,552,633,607287.37,696378.92,1303666.29
352940,202111,6131,2358,3773,2596402.46,4154170.28,6750572.74
352950,202111,110,41,69,45103.95,75907.13,121011.08
352960,202111,64,38,26,41802.97,28601.56,70404.53
352965,202111,15,8,7,8801.43,7700.5,16501.93
352970,202111,514,377,137,414772.43,150730.58,565503.01
352980,202111,161,91,70,100122.76,78111.55,178234.31
352990,202111,974,451,523,496172.47,575424.4,1071596.87
353000,202111,54,23,31,25303.87,34106.61,59410.48
353010,202111,511,314,197,346566.74,216737.52,563304.26
353020,202111,305,211,94,232131.9,103417.1,335549.0
353030,202111,1310,575,735,633683.8,808622.65,1442306.45
353040,202111,77,40,37,44007.95,40704.68,84712.63
353050,202111,1286,835,451,918659.75,496146.48,1414806.23
353060,202111,8609,3582,5027,3945464.93,5531319.17,9476784.10
353070,202111,1848,1085,763,1198099.47,839168.67,2037268.14
353080,202111,1275,683,592,751423.4,654563.91,1405987.31
353090,202111,58,30,28,33000.71,30801.15,63801.86
353100,202111,44,35,9,38504.8,9901.32,48406.12
353110,202111,2148,672,1476,741506.87,1623935.62,2365442.49
353120,202111,115,62,53,68207,59404.64,127611.64
353130,202111,864,411,453,453258.73,499452.71,952711.44
353140,202111,556,236,320,260735.93,352055.34,612791.27
353150,202111,329,178,151,195821.71,166122.04,361943.75
353160,202111,104,78,26,85813.78,28604.92,114418.70
353170,202111,208,66,142,72611.93,156226.81,228838.74
353180,202111,1129,498,631,550067.65,694188.13,1244255.78
353190,202111,476,337,139,370753.52,154017.54,524771.06
353200,202111,239,112,127,123215.91,139709.66,262925.57
353205,202111,20,13,7,14301.12,7700,22001.12
353210,202111,65,37,28,40704.77,30803.08,71507.85
353215,202111,40,22,18,24202.93,19801.22,44004.15
353220,202111,84,44,40,48405.04,44003.11,92408.15
353230,202111,157,65,92,71506.1,101212.18,172718.28
353240,202111,350,161,189,177117.59,207916.42,385034.01
353250,202111,201,97,104,106715.15,114425.11,221140.26
353260,202111,457,298,159,327886.21,174932.42,502818.63
353270,202111,74,53,21,58310.13,23102.05,81412.18
353280,202111,104,49,55,53907.32,60511.15,114418.47
353282,202111,126,86,40,94609.14,44002.86,138612.00
353284,202111,26,18,8,19802.19,8800.85,28603.04
353286,202111,5,1,4,1100,4400,5500
353290,202111,81,45,36,49506.32,39602.83,89109.15
353300,202111,442,224,218,246437.24,239840.29,486277.53
353310,202111,41,34,7,37403.1,7700.4,45103.5
353320,202111,38,22,16,24203.76,17600.99,41804.75
353325,202111,46,27,19,29703.29,20902.56,50605.85
353330,202111,62,42,20,46206.11,22000,68206.11
353340,202111,640,214,426,235437.97,468684.1,704122.07
353350,202111,874,422,452,464268.92,498391.62,962660.54
353360,202111,101,78,23,85808.28,25305.54,111113.82
353370,202111,113,66,47,72611.87,51709.19,124321.06
353380,202111,27,13,14,14301.56,15400.11,29701.67
353390,202111,1109,516,593,568785.83,653505.07,1222290.90
353400,202111,49,28,21,30804.16,23102.36,53906.52
353410,202111,110,62,48,68204.98,52805.09,121010.07
353420,202111,56,22,34,24200.44,38500.72,62701.16
353430,202111,569,368,201,404852.33,221128.15,625980.48
353440,202111,11979,5057,6922,5570185.62,7622641.47,13192827.09
353450,202111,56,28,28,30807.62,31907.53,62715.15
353460,202111,618,320,298,352034.48,327835.19,679869.67
353470,202111,2247,1088,1159,1200305.19,1275005.42,2475310.61
353475,202111,256,166,90,182615.84,99016.16,281632.00
353480,202111,174,140,34,154015.4,37403.13,191418.53
353490,202111,223,134,89,147418.43,97912.48,245330.91
353500,202111,207,117,90,128717.48,99014.98,227732.46
353510,202111,83,56,27,61607.37,30801.9,92409.27
353520,202111,219,158,61,173818.63,67106.33,240924.96
353530,202111,455,232,223,255248.02,245353.3,500601.32
353540,202111,390,238,152,261834.28,167232.69,429066.97
353550,202111,707,439,268,482976.02,294849.98,777826.00
353560,202111,566,225,341,247545.32,375166.35,622711.67
353570,202111,63,37,26,40705.55,28606.09,69311.64
353580,202111,341,235,106,258533.39,116610.37,375143.76
353590,202111,81,58,23,63805.78,25302.23,89108.01
353600,202111,272,158,114,173814.68,125410.45,299225.13
353610,202111,130,70,60,77007.72,67110.45,144118.17
353620,202111,664,332,332,365254.02,365253.47,730507.49
353625,202111,56,30,26,33004.07,28602.82,61606.89
353630,202111,223,158,65,173822,71505.9,245327.9
353640,202111,121,76,45,83608.36,49506.55,133114.91
353650,202111,970,365,605,402641.85,665565.69,1068207.54
353657,202111,21,17,4,18701.31,4401.01,23102.32
353660,202111,287,150,137,165018.59,150715.66,315734.25
353670,202111,720,413,307,455471.06,337752.5,793223.56
353680,202111,122,83,39,91307.19,42900.71,134207.90
353690,202111,41,29,12,31905.46,13203.16,45108.62
353700,202111,276,190,86,209033.07,94609.85,303642.92
353710,202111,484,229,255,251948.46,281648.07,533596.53
353715,202111,49,31,18,34107.97,19803.31,53911.28
353720,202111,341,150,191,165035.59,210145.14,375180.73
353730,202111,1160,706,454,779993.52,500554.2,1280547.72
353740,202111,617,337,280,370745.77,308043.96,678789.73
353750,202111,72,40,32,44007.97,35203.99,79211.96
353760,202111,3187,1175,2012,1292712.23,2214623.59,3507335.82
353770,202111,79,64,15,70411.3,16500.96,86912.26
353780,202111,1314,599,715,661182.11,786610.46,1447792.57
353790,202111,481,284,197,313556.51,216734.74,530291.25
353800,202111,3551,1655,1896,1820824.55,2085816.75,3906641.30
353810,202111,219,111,108,123225.42,119919.32,243144.74
353820,202111,228,94,134,103409.94,147405.83,250815.77
353830,202111,59,47,12,51707.29,13201.21,64908.50
353850,202111,189,87,102,96814,112216.44,209030.44
353860,202111,523,224,299,246433.47,330029.03,576462.50
353870,202111,5528,2750,2778,3026565.28,3057165.78,6083731.06
353880,202111,709,462,247,508279.46,271727.91,780007.37
353890,202111,556,321,235,354288.26,258558.2,612846.46
353900,202111,127,67,60,73711.43,66007.09,139718.52
353910,202111,194,81,113,89113.57,124313.15,213426.72
353920,202111,419,223,196,245330.49,215626.23,460956.72
353930,202111,1051,604,447,665588.69,492846.32,1158435.01
353940,202111,192,94,98,103413.76,107813.55,211227.31
353950,202111,482,301,181,331137,199127.86,530264.86
353960,202111,73,60,13,66006.72,14302.39,80309.11
353970,202111,41,27,14,29707.44,15406.21,45113.65
353980,202111,1792,799,993,879054.54,1096877.73,1975932.27
353990,202111,76,43,33,47309.74,36304.74,83614.48
354000,202111,374,169,205,185920.15,225525.44,411445.59
354010,202111,91,52,39,57215.58,42909.42,100125.00
354020,202111,501,317,184,348756.42,202437.86,551194.28
354025,202111,32,28,4,30805.01,4400.44,35205.45
354030,202111,46,27,19,29705.63,20903,50608.63
354040,202111,99,74,25,81410.34,27502.13,108912.47
354050,202111,173,92,81,101211.17,89108.97,190320.14
354060,202111,764,361,403,398253.81,443370.25,841624.06
354070,202111,924,520,404,572075.57,444463.31,1016538.88
354075,202111,180,83,97,91315.09,106721.62,198036.71
354080,202111,306,132,174,145221.53,191430.93,336652.46
354085,202111,23,12,11,13203,12101.3,25304.3
354090,202111,267,161,106,177037.17,116614.13,293651.30
354100,202111,5734,2307,3427,2541389.98,3773505.04,6314895.02
354105,202111,97,46,51,50603.49,56102.95,106706.44
354110,202111,43,20,23,22006.26,25308.14,47314.40
354120,202111,147,96,51,105618.79,56106.03,161724.82
354130,202111,708,427,281,470876.38,309150.78,780027.16
354140,202111,3174,1401,1773,1542436.42,1953777.24,3496213.66
354150,202111,635,367,268,404867.8,294835.26,699703.06
354160,202111,638,396,242,435674.31,266240,701914.31
354165,202111,15,13,2,14303.13,2200,16503.13
354170,202111,173,121,52,133115.4,57207.79,190323.19
354180,202111,59,35,24,38504.23,26404.37,64908.60
354190,202111,195,76,119,84708.3,132011.34,216719.64
354200,202111,106,55,51,60509.99,56117.42,116627.41
354210,202111,67,26,41,28605.27,45101.97,73707.24
354220,202111,625,390,235,429067.41,258536.6,687604.01
354230,202111,170,74,96,81412.06,105621.26,187033.32
354240,202111,328,205,123,225524.67,135318.91,360843.58
354250,202111,79,48,31,52809.68,34103.17,86912.85
354260,202111,2151,995,1156,1096874.93,1274001.92,2370876.85
354270,202111,90,62,28,68202.99,30801.11,99004.10
354280,202111,51,27,24,29704.32,26403.23,56107.55
354290,202111,138,93,45,102316.43,49506.95,151823.38
354300,202111,354,245,109,269564.31,119922.63,389486.94
354310,202111,91,64,27,70414.09,29703.93,100118.02
354320,202111,222,107,115,117716.77,126511.18,244227.95
354323,202111,9,8,1,8802.15,1100.27,9902.42
354325,202111,120,64,56,70402.86,61601.92,132004.78
354330,202111,2404,800,1604,883343.7,1765744.24,2649087.94
354340,202111,10316,4708,5608,5188262.47,6171726.26,11359988.73
354350,202111,141,90,51,99003.09,56102.23,155105.32
354360,202111,71,41,30,45103.95,33002.77,78106.72
354370,202111,233,119,114,130919.81,125418.11,256337.92
354380,202111,170,97,73,106717.28,80311.95,187029.23
354390,202111,2701,953,1748,1049554.17,1923037.39,2972591.56
354400,202111,296,163,133,179325.45,146319.87,325645.32
354410,202111,638,283,355,311357.17,390564.48,701921.65
354420,202111,271,171,100,188134.49,110019.31,298153.80
354425,202111,320,175,145,192576.92,159525.01,352101.93
354430,202111,188,103,85,113314.45,93510.22,206824.67
354440,202111,33,26,7,28606.14,7700,36306.14
354450,202111,53,35,18,38503.39,19801.8,58305.19
354460,202111,94,55,39,60509.02,42907.11,103416.13
354470,202111,26,13,13,14303.66,14307.37,28611.03
354480,202111,106,56,50,61608.78,55001.96,116610.74
354490,202111,137,81,56,89110.34,61607.18,150717.52
354500,202111,393,177,216,194717.5,237617.99,432335.49
354510,202111,91,61,30,67107.06,33004.73,100111.79
354515,202111,43,12,31,13201.88,34103.86,47305.74
354520,202111,1606,670,936,736976.48,1029678.71,1766655.19
354530,202111,817,402,415,444461.18,456552.21,901013.39
354540,202111,269,134,135,147428.68,148522.73,295951.41
354550,202111,35,21,14,23101.32,15401.01,38502.33
354560,202111,150,80,70,88006.04,77002.97,165009.01
354570,202111,136,91,45,100108.62,49503.4,149612.02
354580,202111,1808,845,963,930753.8,1059437.21,1990191.01
354600,202111,269,132,137,145229.93,150719.34,295949.27
354610,202111,68,56,12,61610.93,13203.81,74814.74
354620,202111,65,17,48,18702.24,52803.51,71505.75
354625,202111,12,8,4,8801.1,4401.81,13202.91
354630,202111,318,206,112,227735.89,123221.92,350957.81
354640,202111,815,493,322,543469.75,354246.39,897716.14
354650,202111,65,36,29,39603.67,31902.04,71505.71
354660,202111,793,584,209,642507.73,231042.84,873550.57
354670,202111,224,83,141,91312.91,155116.54,246429.45
354680,202111,1300,458,842,504973.81,930720.09,1435693.90
354690,202111,72,48,24,52808.38,26402.45,79210.83
354700,202111,73,50,23,55003.85,25300.76,80304.61
354710,202111,46,33,13,36302.26,14301.58,50603.84
354720,202111,21,20,1,22001.75,1100,23101.75
354730,202111,1772,709,1063,781159.41,1170640.67,1951800.08
354740,202111,75,51,24,56102.41,26401.15,82503.56
354750,202111,410,231,179,254120.17,198021.87,452142.04
354760,202111,490,302,188,333363.56,206837.83,540201.39
354765,202111,8,3,5,3300.85,5502.6,8803.45
354770,202111,343,225,118,248631.48,129818.45,378449.93
354780,202111,8294,3089,5205,3400668.23,5729376.38,9130044.61
354790,202111,88,54,34,59405.01,37401.78,96806.79
354800,202111,434,234,200,258493.35,220042.47,478535.82
354805,202111,81,38,43,41803.5,47312.07,89115.57
354810,202111,102,58,44,63804.69,48403.44,112208.13
354820,202111,205,83,122,91320.1,134229.22,225549.32
354830,202111,43,23,20,25300.4,22004.01,47304.41
354840,202111,56,38,18,41803.33,19800.88,61604.21
354850,202111,4433,1905,2528,2099159.51,2787714.18,4886873.69
354860,202111,340,157,183,172718.82,201330.95,374049.77
354870,202111,11898,5106,6792,5626465.34,7477652.34,13104117.68
354880,202111,2670,966,1704,1063923.16,1876953.99,2940877.15
354890,202111,2894,1509,1385,1661266.62,1524733.24,3185999.86
354900,202111,63,42,21,46206.19,23101.81,69308.00
354910,202111,1275,641,634,706340.3,697429.32,1403769.62
354920,202111,39,32,7,35203.5,7700.61,42904.11
354925,202111,18,9,9,9900,9901.41,19801.41
354930,202111,34,29,5,31907.88,5500.88,37408.76
354940,202111,778,547,231,603988.03,254148.16,858136.19
354950,202111,215,131,84,144115.41,92410.89,236526.30
354960,202111,134,51,83,56113.3,91322.3,147435.6
354970,202111,1055,714,341,787712.07,375125.68,1162837.75
354980,202111,9061,3190,5871,3511730.15,6465327.87,9977058.02
354990,202111,9875,4292,5583,4728516.48,6143002.54,10871519.02
354995,202111,563,176,387,193636.73,425786.24,619422.97
355000,202111,454,157,297,172724.21,326761.42,499485.63
355010,202111,598,362,236,399372.48,260751.41,660123.89
355020,202111,765,470,295,518181.65,324545.72,842727.37
355030,202111,211555,77827,133728,85721497.27,147245451.18,232966948.45
355040,202111,858,395,463,434542.47,509343.83,943886.30
355050,202111,173,97,76,106707.54,83606.74,190314.28
355060,202111,1701,797,904,879081.52,995585.9,1874667.42
355070,202111,1546,695,851,765714.57,937346.19,1703060.76
355080,202111,190,114,76,125416.82,83610.45,209027.27
355090,202111,284,166,118,183727.03,129823.4,313550.43
355100,202111,5227,2430,2797,2674426.37,3079250.26,5753676.63
355110,202111,236,152,84,167223.53,92411.09,259634.62
355120,202111,56,36,20,39605.54,22002.21,61607.75
355130,202111,50,29,21,31907.71,23104.25,55011.96
355140,202111,191,111,80,122110.6,88005.15,210115.75
355150,202111,680,395,285,434579.22,313548.23,748127.45
355160,202111,477,223,254,246443.5,280537.94,526981.44
355170,202111,2052,1039,1013,1144187.43,1114412.1,2258599.53
355180,202111,684,269,415,295947.88,456572.22,752520.10
355190,202111,212,143,69,157314.94,77011.71,234326.65
355200,202111,107,55,52,60502.52,57202.82,117705.34
355210,202111,712,388,324,426875.31,356456.99,783332.30
355220,202111,7447,3640,3807,4010236.36,4191472.18,8201708.54
355230,202111,95,57,38,62707.89,41805.22,104513.11
355240,202111,4556,1841,2715,2027653.15,2987853.07,5015506.22
355250,202111,6257,2672,3585,2940896.97,3951495.47,6892392.44
355255,202111,47,30,17,33002.86,18700.91,51703.77
355260,202111,177,104,73,114418.2,80312.61,194730.81
355270,202111,168,107,61,117717.1,67108.82,184825.92
355280,202111,6777,2504,4273,2758255.35,4707839.43,7466094.78
355290,202111,71,57,14,62703.67,15402.79,78106.46
355300,202111,222,128,94,140818.76,103405.49,244224.25
355310,202111,110,56,54,61604.46,59406.15,121010.61
355320,202111,92,48,44,52807.06,48405.39,101212.45
355330,202111,295,167,128,183725.42,140818.23,324543.65
355340,202111,1422,489,933,539085.46,1028790.45,1567875.91
355350,202111,161,78,83,85804.41,92402.52,178206.93
355360,202111,171,113,58,124322.2,63814.69,188136.89
355365,202111,17,13,4,14303.04,4400.88,18703.92
355370,202111,1025,611,414,673302.96,455433.75,1128736.71
355380,202111,810,502,308,555598.3,338873.82,894472.12
355385,202111,84,55,29,60505.34,31903.77,92409.11
355390,202111,110,57,53,62709.01,58309.99,121019.00
355395,202111,190,102,88,112219.18,96819.03,209038.21
355400,202111,1725,983,742,1084687.03,816245.9,1900932.93
355410,202111,4997,2279,2718,2508394.19,2991124.21,5499518.40
355420,202111,47,33,14,36303.08,15402.81,51705.89
355430,202111,398,239,159,262933.2,174934.14,437867.34
355440,202111,86,51,35,56104,38502.59,94606.59
355450,202111,437,212,225,233226.19,247527.49,480753.68
355460,202111,56,43,13,47307.61,14301.65,61609.26
355465,202111,51,29,22,31902.53,24200.94,56103.47
355470,202111,184,71,113,78110.62,124313.95,202424.57
355475,202111,10,7,3,7700.77,3300,11000.77
355480,202111,583,233,350,256338.14,386152.09,642490.23
355490,202111,107,72,35,79216.45,38509.01,117725.46
355495,202111,75,27,48,29702.06,52802.28,82504.34
355500,202111,1592,856,736,941718.85,809694.15,1751413.00
355510,202111,271,191,80,210136.85,88013.4,298150.25
355520,202111,29,22,7,24202.48,7700.32,31902.80
355530,202111,21,10,11,12100.09,12100,24200.09
355535,202111,71,32,39,35206.52,42907.84,78114.36
355540,202111,2628,1010,1618,1111364.53,1784559.07,2895923.60
355550,202111,62,36,26,39602.39,28604.42,68206.81
355560,202111,235,106,129,117718.42,141928.02,259646.44
355570,202111,19,12,7,14303.34,7700.34,22003.68
355580,202111,242,164,78,180436.84,85814.17,266251.01
355590,202111,17,9,8,9902.54,8801.89,18704.43
355600,202111,270,131,139,144131.77,152917.03,297048.80
355610,202111,229,144,85,158426.07,93515.49,251941.56
355620,202111,1303,565,738,621615.2,811878.2,1433493.4
355630,202111,408,297,111,326749.28,122116.93,448866.21
355635,202111,125,55,70,61608.12,77009.08,138617.20
355640,202111,531,280,251,309139.85,276140.22,585280.07
355645,202111,885,328,557,363063.01,612795.59,975858.60
355650,202111,1909,800,1109,882401.03,1220010.63,2102411.66
355660,202111,234,120,114,132015.09,125419.94,257435.03
355670,202111,605,244,361,269523.52,398233.29,667756.81
355680,202111,208,117,91,128722.58,100117.73,228840.31
355690,202111,87,44,43,49509.33,47312.94,96822.27
355695,202111,23,14,9,15400.72,9900,25300.72
355700,202111,1194,600,594,662293.98,653454.53,1315748.51
355710,202111,2223,1197,1026,1316907.13,1133091.41,2449998.54
355715,202111,13,11,2,12101.97,2200.4,14302.37
355720,202111,251,152,99,167220.35,108912.43,276132.78
355730,202111,104,61,43,67108.48,47309.28,114417.76
410010,202111,132,105,27,115524.44,29707.24,145231.68
410020,202111,119,86,33,94629.65,36307.65,130937.30
410030,202111,172,95,77,104519.87,84719.6,189239.47
410040,202111,1278,625,653,687562.76,718371.77,1405934.53
410045,202111,48,36,12,39605.87,13201.37,52807.24
410050,202111,504,286,218,314636.81,239828.56,554465.37
410060,202111,286,208,78,228827.14,85806.16,314633.30
410070,202111,289,245,44,269535.69,50607.5,320143.19
410080,202111,176,104,72,114415.41,79208.02,193623.43
410090,202111,70,60,10,66012.16,11002.32,77014.48
410100,202111,255,167,88,183714.22,96804.18,280518.40
410105,202111,44,25,19,27501.93,20900.87,48402.80
410110,202111,344,208,136,229920.24,149621.77,379542.01
410115,202111,46,29,17,31900.65,18700.67,50601.32
410120,202111,430,201,229,221131.52,253027.66,474159.18
410130,202111,53,30,23,33006.73,25302.72,58309.45
410140,202111,3118,1404,1714,1547882.66,1887851.2,3435733.86
410150,202111,2667,1043,1624,1147420.08,1786605.48,2934025.56
410160,202111,484,283,201,311339.58,221120.08,532459.66
410165,202111,51,29,22,31902.86,24202.48,56105.34
410170,202111,191,120,71,133111.29,78107.37,211218.66
410180,202111,2278,1222,1056,1345515.51,1163960.25,2509475.76
410185,202111,32,28,4,30805.79,4400.44,35206.23
410190,202111,481,308,173,339924.82,191416.13,531340.95
410200,202111,965,680,285,749187.98,313527,1062714.98
410210,202111,616,316,300,348736.9,330037.33,678774.23
410220,202111,48,21,27,23100.48,29700,52800.48
410230,202111,165,75,90,82508.52,99005.67,181514.19
410240,202111,724,457,267,503892.71,294842.09,798734.80
410250,202111,375,263,112,289336.85,123214.21,412551.06
410260,202111,302,164,138,180433.41,151833.36,332266.77
410270,202111,28,21,7,23100.34,7700,30800.34
410275,202111,60,45,15,49504.16,16501.22,66005.38
410280,202111,325,185,140,203528.6,154022.76,357551.36
410290,202111,274,153,121,168315.25,134210.27,302525.52
410300,202111,85,53,32,58310.29,35204.73,93515.02
410302,202111,24,14,10,15401.31,11000,26401.31
410304,202111,38,25,13,27503.15,14300.8,41803.95
410305,202111,225,123,102,135307.66,112207.48,247515.14
410310,202111,198,115,83,127618.15,91309.11,218927.26
410315,202111,42,29,13,31903.94,14301.54,46205.48
410320,202111,138,91,47,100106.78,51703.11,151809.89
410322,202111,33,20,13,22001.35,14300.26,36301.61
410330,202111,170,112,58,124332.38,63813.07,188145.45
410335,202111,95,53,42,58302.67,46200.84,104503.51
410337,202111,44,34,10,37401.96,11000.2,48402.16
410340,202111,40,32,8,35201.88,8800.46,44002.34
410345,202111,198,114,84,126516.18,92407.77,218923.95
410347,202111,45,35,10,39606.92,11000.85,50607.77
410350,202111,257,146,111,160621.25,122111.42,282732.67
410360,202111,423,261,162,287142.6,179321.09,466463.69
410370,202111,2319,961,1358,1057236.49,1495132.85,2552369.34
410380,202111,190,113,77,124324.65,84715.1,209039.75
410390,202111,387,261,126,287132.19,138605.71,425737.90
410395,202111,35,22,13,24203.57,14307.54,38511.11
410400,202111,843,365,478,401564.44,527003.06,928567.50
410405,202111,81,61,20,67111.26,22004.32,89115.58
410410,202111,25,16,9,17603.18,9902.65,27505.83
410420,202111,1690,756,934,831615.38,1029742.59,1861357.97
410425,202111,182,71,111,78118.46,122120.9,200239.36
410430,202111,2297,1219,1078,1343255.92,1188151.29,2531407.21
410440,202111,364,260,104,286042.3,114416.66,400458.96
410442,202111,358,227,131,249732.99,144118.31,393851.30
410445,202111,416,293,123,322325.97,135312.48,457638.45
410450,202111,378,181,197,200218.56,216716.79,416935.35
410460,202111,553,282,271,310220.66,298121.89,608342.55
410465,202111,246,135,111,148512.6,122109.98,270622.58
410470,202111,258,141,117,155125.08,128705.77,283830.85
410480,202111,6435,3047,3388,3354326.45,3729583.17,7083909.62
410490,202111,1396,805,591,885670.76,650211.34,1535882.10
410500,202111,268,154,114,169418.26,125409.12,294827.38
410510,202111,175,129,46,141916.08,50610.39,192526.47
410520,202111,266,190,76,209029.23,83615.06,292644.29
410530,202111,299,98,201,107808.03,221111.07,328919.10
410540,202111,335,243,92,268422.37,101209.35,369631.72
410550,202111,1687,687,1000,755793.51,1100134.42,1855927.93
410560,202111,153,103,50,113310.7,55003.99,168314.69
410570,202111,440,292,148,322326.65,162815.25,485141.90
410580,202111,3601,1504,2097,1660176.53,2311459.9,3971636.43
410590,202111,412,267,145,293712.49,159516.89,453229.38
410600,202111,190,166,24,182608.81,26401.01,209009.82
410610,202111,50,40,10,44001.97,11000,55001.97
410620,202111,261,171,90,188131.28,99012.67,287143.95
410630,202111,446,241,205,265114.42,225518.49,490632.91
410640,202111,1041,643,398,708469.68,437846.36,1146316.04
410645,202111,112,80,32,88015.94,35206.09,123222.03
410650,202111,362,223,139,245326.77,152911.28,398238.05
410655,202111,90,62,28,68203.09,30802.66,99005.75
410657,202111,32,9,23,9902.27,25300.74,35203.01
410660,202111,629,419,210,460944.76,231024.6,691969.36
410670,202111,77,63,14,69313.2,15401.74,84714.94
410680,202111,190,154,36,169425.44,39608.28,209033.72
410685,202111,28,17,11,18702,12101.15,30803.15
410690,202111,28387,11613,16774,12795133.91,18471665.57,31266799.48
410700,202111,320,232,88,255245.16,96815.96,352061.12
410710,202111,131,107,24,117708.78,26403.14,144111.92
410712,202111,46,34,12,37401.73,13201.99,50603.72
410715,202111,92,70,22,77008.09,24201.28,101209.37
410720,202111,657,372,285,409236.43,313518.64,722755.07
410725,202111,184,132,52,145215.1,57202.97,202418.07
410730,202111,102,48,54,52804.39,59405.2,112209.59
410740,202111,103,72,31,79206.57,34105.5,113312.07
410750,202111,289,189,100,207918.88,110007.27,317926.15
410752,202111,20,14,6,15403.18,6600.4,22003.58
410753,202111,58,22,36,24204.57,39604.99,63809.56
410754,202111,52,24,28,26403.81,30800.31,57204.12
410755,202111,78,45,33,49504.32,36301.17,85805.49
410760,202111,753,403,350,443354.9,385056.87,828411.77
410765,202111,1840,816,1024,898857.45,1127725.68,2026583.13
410770,202111,110,80,30,88010.77,33004.25,121015.02
410773,202111,62,43,19,47303.36,20901.28,68204.64
410775,202111,178,133,45,146329.53,49507.52,195837.05
410780,202111,91,47,44,51703.2,48401.28,100104.48
410785,202111,50,40,10,44003.97,11001.07,55005.04
410790,202111,87,37,50,40703.96,55003.36,95707.32
410800,202111,285,175,110,192528.11,121020.71,313548.82
410810,202111,27,14,13,15400.9,14301.6,29702.5
410820,202111,163,117,46,128719.26,50609.65,179328.91
410830,202111,8872,3702,5170,4073870.77,5690106.66,9763977.43
410832,202111,111,70,41,77006.51,45106.5,122113.01
410840,202111,1417,747,670,822896.54,737064.44,1559960.98
410845,202111,51,28,23,30802.44,25303.35,56105.79
410850,202111,176,126,50,138632.1,55010.06,193642.16
410855,202111,72,62,10,68209.14,11002.49,79211.63
410860,202111,775,392,383,431236.02,421331.22,852567.24
410865,202111,101,72,29,80320.09,31903.5,112223.59
410870,202111,148,126,22,140829.31,24203.93,165033.24
410880,202111,1140,558,582,613877.26,640295.91,1254173.17
410890,202111,93,63,30,69306.36,33000.14,102306.50
410895,202111,74,57,17,62707.21,18704.41,81411.62
410900,202111,26,18,8,19804.74,8800.44,28605.18
410910,202111,15,10,5,11001.79,5500.17,16501.96
410920,202111,40,25,15,27505.07,16501.51,44006.58
410930,202111,551,334,217,367437.55,238718.51,606156.06
410940,202111,4402,2322,2080,2556791.65,2291630.31,4848421.96
410950,202111,101,74,27,82516.3,29707.94,112224.24
410960,202111,869,332,537,365254.99,592974.8,958229.79
410965,202111,66,43,23,47305.26,25302.78,72608.04
410970,202111,607,418,189,462073.08,207929.22,670002.30
410975,202111,125,78,47,86905.79,51706.1,138611.89
410980,202111,1630,710,920,782184.74,1012140.8,1794325.54
410990,202111,269,189,80,207915.15,88011.31,295926.46
411000,202111,62,36,26,39604.36,28606.52,68210.88
411005,202111,28,22,6,24201.63,6600.44,30802.07
411007,202111,250,140,110,155105.32,121003.94,276109.26
411010,202111,592,384,208,422463.36,228826.54,651289.90
411020,202111,287,182,105,200231.77,115517.98,315749.75
411030,202111,22,11,11,12101.73,12102.19,24203.92
411040,202111,55,36,19,39603.49,20902.53,60506.02
411050,202111,215,155,60,170535.36,66011.96,236547.32
411060,202111,523,349,174,385046.4,191421.83,576468.23
411065,202111,48,43,5,47303.34,5500,52803.34
411070,202111,1278,739,539,813002.37,592972.27,1405974.64
411080,202111,241,169,72,185917.91,79204.23,265122.14
411090,202111,87,67,20,73714.63,22003.94,95718.57
411095,202111,335,117,218,128715.61,239828.32,368543.93
411100,202111,114,90,24,99012.74,26400.59,125413.33
411110,202111,132,80,52,88008.57,57205.39,145213.96
411120,202111,212,140,72,154015.47,80306.96,234322.43
411125,202111,275,123,152,135309.99,167232.69,302542.68
411130,202111,121,103,18,114414.31,19800.8,134215.11
411140,202111,210,144,66,159505.9,72601.18,232107.08
411150,202111,1243,796,447,876779.83,491732.93,1368512.76
411155,202111,121,83,38,91303.13,41801.86,133104.99
411160,202111,30,13,17,14300.05,18701.14,33001.19
411170,202111,51,46,5,50602.18,5500.73,56102.91
411180,202111,988,647,341,711778.21,375143.94,1086922.15
411190,202111,334,182,152,200220.23,167215.63,367435.86
411200,202111,662,384,278,423573.87,305831.63,729405.50
411210,202111,688,356,332,391631.94,365225.9,756857.84
411220,202111,161,110,51,121019.88,56108.34,177128.22
411230,202111,37,29,8,31902.35,8802.09,40704.44
411240,202111,114,70,44,77013.8,48407.62,125421.42
411250,202111,420,307,113,337721.85,124307.51,462029.36
411260,202111,14,10,4,11001.73,4401.24,15402.97
411270,202111,265,132,133,145230.23,146330.88,291561.11
411275,202111,182,156,26,171625.51,28602.3,200227.81
411280,202111,201,147,54,161719.01,59406.91,221125.92
411290,202111,63,49,14,53903.52,15402.3,69305.82
411295,202111,125,99,26,108920.16,28602.91,137523.07
411300,202111,78,35,43,38502.29,47304.06,85806.35
411310,202111,92,67,25,73708.24,27501.2,101209.44
411320,202111,796,505,291,557776.85,320128.5,877905.35
411325,202111,64,46,18,50603.97,19800.84,70404.81
411330,202111,904,583,321,641372.56,354232.83,995605.39
411340,202111,31,20,11,22004.61,12101.44,34106.05
411342,202111,56,41,15,45106.8,16502.12,61608.92
411345,202111,110,54,56,61609.77,61608.24,123218.01
411350,202111,497,370,127,407062.84,139718.85,546781.69
411360,202111,58,37,21,40708.33,23103.86,63812.19
411370,202111,13923,5516,8407,6070615.04,9263296.46,15333911.50
411373,202111,182,123,59,135314.47,64906.02,200220.49
411375,202111,80,63,17,69306.98,18700.87,88007.85
411380,202111,76,55,21,60517.69,23107.47,83625.16
411390,202111,131,75,56,82510.4,61605.07,144115.47
411400,202111,417,283,134,311338.94,147407.49,458746.43
411410,202111,488,224,264,246429.75,290425.55,536855.30
411420,202111,956,400,556,440059.85,611693.62,1051753.47
411430,202111,496,269,227,295969,249750.48,545719.48
411435,202111,31,20,11,22002.84,12102.7,34105.54
411440,202111,467,368,99,404825.08,108911.14,513736.22
411450,202111,411,348,63,382843.08,69306.64,452149.72
411460,202111,785,293,492,322341.56,541276.31,863617.87
411470,202111,108,74,34,81405.04,37400.11,118805.15
411480,202111,705,370,335,407053.97,368543.91,775597.88
411490,202111,286,177,109,194727.08,119919.83,314646.91
411500,202111,99,80,19,88008.42,20901.91,108910.33
411510,202111,224,178,46,195808.55,50602.1,246410.65
411520,202111,6031,2095,3936,2308492.65,4334554.5,6643047.15
411530,202111,124,83,41,91302.68,45100.73,136403.41
411535,202111,46,15,31,16504.1,34105.22,50609.32
411540,202111,365,244,121,268415.56,133101.42,401516.98
411545,202111,57,41,16,45101.66,17600.44,62702.10
411550,202111,88,66,22,72604.51,24203.06,96807.57
411560,202111,400,162,238,178215.68,261814.64,440030.32
411570,202111,912,308,604,338856.61,665587.99,1004444.60
411573,202111,25,16,9,17603.74,9900.6,27504.34
411575,202111,306,184,122,202415.69,135305.61,337721.30
411580,202111,1237,440,797,484049.02,876787.77,1360836.79
411585,202111,71,35,36,38508.38,39606.56,78114.94
411590,202111,16,11,5,12101.27,5500.98,17602.25
411600,202111,22,10,12,11003.57,13204.09,24207.66
411605,202111,241,92,149,101213.81,163919.67,265133.48
411610,202111,224,140,84,154022.74,92412.7,246435.44
411620,202111,389,189,200,207930.52,220017.87,427948.39
411630,202111,48,34,14,37401.56,15400.4,52801.96
411640,202111,33,23,10,25300,11000.07,36300.07
411650,202111,9,6,3,6600.67,3300.96,9901.63
411660,202111,41,29,12,31900.6,13201.6,45102.2
411670,202111,238,165,73,181519.75,80311.37,261831.12
411680,202111,156,126,30,138613.26,33002.97,171616.23
411690,202111,616,326,290,358638.62,319030.27,677668.89
411695,202111,64,45,19,49504.05,20900.91,70404.96
411700,202111,145,115,30,126520.58,33006.01,159526.59
411705,202111,102,68,34,74813.69,37406.97,112220.66
411710,202111,292,194,98,213414.34,107807.47,321221.81
411720,202111,138,93,45,102307.98,49503.41,151811.39
411721,202111,82,67,15,73704.14,16500.13,90204.27
411722,202111,105,45,60,49504.82,66012.22,115517.04
411725,202111,168,122,46,134209,50603.62,184812.62
411727,202111,98,77,21,84704.44,23102.07,107806.51
411729,202111,42,31,11,34102.06,12100.84,46202.90
411730,202111,557,343,214,378448.52,235427.8,613876.32
411740,202111,33,21,12,23101.2,13200,36301.2
411745,202111,64,48,16,52800.86,17600.8,70401.66
411750,202111,845,353,492,388355.98,541272.92,929628.90
411760,202111,1204,866,338,952719.54,371852.77,1324572.31
411770,202111,430,283,147,311354.72,161729.78,473084.50
411780,202111,362,236,126,260727.41,138613.79,399341.20
411790,202111,567,315,252,347648.34,277233.72,624882.06
411800,202111,146,104,42,114426.87,46204.75,160631.62
411810,202111,183,139,44,152918.11,48405.38,201323.49
411820,202111,2376,979,1397,1080375.76,1536921.18,2617296.94
411830,202111,14,13,1,14300.34,1100,15400.34
411840,202111,2104,1248,856,1375144.34,942797.11,2317941.45
411845,202111,65,22,43,24200.86,47301.12,71501.98
411850,202111,1222,652,570,717276.16,629290.64,1346566.80
411860,202111,49,30,19,33007.52,20902.51,53910.03
411870,202111,68,41,27,45102.06,29701.48,74803.54
411880,202111,428,253,175,279435.01,193616.28,473051.29
411885,202111,103,59,44,64904.81,48406.56,113311.37
411890,202111,310,211,99,232125.62,108913.37,341038.99
411900,202111,98,69,29,75913.55,31902.14,107815.69
411910,202111,184,139,45,152928.11,49505.76,202433.87
411915,202111,2323,908,1415,998942.54,1556731.77,2555674.31
411920,202111,113,88,25,96821.83,27503.83,124325.66
411925,202111,16,10,6,11001.55,6602.04,17603.59
411930,202111,785,546,239,600779.47,262947.6,863727.07
411940,202111,592,375,217,412568.21,239824.07,652392.28
411950,202111,1142,519,623,570995.62,685413.24,1256408.86
411960,202111,1115,711,404,782149.71,444419.86,1226569.57
411965,202111,23,13,10,14303.72,11001.92,25305.64
411970,202111,94,79,15,86907.61,16500.94,103408.55
411980,202111,200,110,90,121018.34,99009.64,220027.98
411990,202111,5123,2757,2366,3036513.09,2607474.15,5643987.24
411995,202111,572,167,405,183732.3,445554.03,629286.33
412000,202111,323,207,116,227724.15,127618.58,355342.73
412010,202111,45,24,21,26403.83,23104.7,49508.53
412015,202111,38,29,9,33006.95,9901.11,42908.06
412020,202111,22,17,5,18705.99,5501.81,24207.80
412030,202111,38,34,4,37408.01,4400.61,41808.62
412033,202111,50,29,21,31903.03,23101.17,55004.20
412035,202111,73,47,26,51705.22,28602.09,80307.31
412040,202111,37,18,19,19801.6,20901.18,40702.78
412050,202111,212,155,57,170517.07,62702.65,233219.72
412060,202111,763,551,212,607318.35,233229.43,840547.78
412065,202111,52,30,22,33001.76,24202.59,57204.35
412070,202111,165,115,50,126516.77,55009.14,181525.91
412080,202111,310,142,168,156214.44,184826.2,341040.64
412085,202111,35,14,21,15400.95,23102.65,38503.60
412090,202111,832,513,319,564354.19,350933.41,915287.60
412100,202111,265,221,44,243135.59,48409.51,291545.10
412110,202111,71,55,16,60504.53,17602.44,78106.97
412120,202111,335,181,154,199130.16,169415.84,368546.00
412125,202111,72,44,28,48400.72,30801.08,79201.80
412130,202111,45,29,16,31903.89,17600,49503.89
412135,202111,29,17,12,18702.44,13202.28,31904.72
412140,202111,415,262,153,288219.19,168314.16,456533.35
412150,202111,233,152,81,168326.56,89111.05,257437.61
412160,202111,89,55,34,60505.51,37401.95,97907.46
412170,202111,709,475,234,522916.43,257425.07,780341.50
412175,202111,38,28,10,30805.09,11002.72,41807.81
412180,202111,184,136,48,149616,52804.87,202420.87
412190,202111,313,244,69,268452.35,75908.78,344361.13
412200,202111,186,116,70,128706.88,77004.3,205711.18
412210,202111,94,69,25,75905.62,27505.09,103410.71
412215,202111,237,157,80,172717.09,88006.79,260723.88
412217,202111,66,54,12,59405.57,13201.58,72607.15
412220,202111,827,552,275,608423.02,302547.32,910970.34
412230,202111,296,181,115,200227.7,126525.97,326753.67
412240,202111,1313,631,682,694197.69,750319.91,1444517.60
412250,202111,405,250,155,275037.41,170517.58,445554.99
412260,202111,117,77,40,84710.39,44001.05,128711.44
412265,202111,171,128,43,140809.41,47301.11,188110.52
412270,202111,91,57,34,62709.59,37402.81,100112.40
412280,202111,88,68,20,74800.9,22001.45,96802.35
412290,202111,90,56,34,61608.41,37401.72,99010.13
412300,202111,206,142,64,157311.69,70405.1,227716.79
412310,202111,53,43,10,47307.47,11000.28,58307.75
412320,202111,88,69,19,77018.22,20903.43,97921.65
412330,202111,186,151,35,166120.96,38503.39,204624.35
412340,202111,167,113,54,124309.82,60503.5,184813.32
412350,202111,646,301,345,331118.21,380628.87,711747.08
412360,202111,23,20,3,22001.01,3300,25301.01
412370,202111,151,128,23,140822.16,25300.98,166123.14
412380,202111,217,162,55,178229.31,60506.75,238736.06
412382,202111,63,35,28,38502.99,30802.41,69305.40
412385,202111,152,107,45,117710.11,49504.26,167214.37
412390,202111,307,230,77,253028,84708.75,337736.75
412395,202111,67,53,14,58301.51,15400.68,73702.19
412400,202111,96,63,33,69307.33,36301.44,105608.77
412402,202111,233,114,119,125409.43,130916.94,256326.37
412405,202111,937,315,622,346523.02,685333.55,1031856.57
412410,202111,961,577,384,634264.12,422454.15,1056718.27
412420,202111,17,16,1,17601.8,1100,18701.8
412430,202111,23,21,2,23104.2,2200.68,25304.88
412440,202111,638,327,311,359732.06,342123.45,701855.51
412450,202111,72,63,9,69309.58,9901.24,79210.82
412460,202111,91,69,22,75908.59,24201.53,100110.12
412470,202111,208,164,44,180431.73,48407.14,228838.87
412480,202111,145,102,43,112210.42,47303.54,159513.96
412490,202111,158,132,26,145213.93,28600.88,173814.81
412500,202111,406,320,86,353153.17,94609.44,447762.61
412510,202111,165,136,29,149636.24,31907.47,181543.71
412520,202111,90,56,34,62710.45,37402.82,100113.27
412530,202111,109,54,55,59406.3,60501.43,119907.73
412535,202111,90,68,22,74813.98,24201.48,99015.46
412540,202111,83,39,44,42901.32,48402.28,91303.60
412545,202111,85,58,27,63809.48,29702.32,93511.80
412550,202111,3960,1575,2385,1733866.64,2626133.4,4360000.04
412555,202111,10,6,4,6600.4,4400.91,11001.31
412560,202111,648,433,215,478565.64,236524.01,715089.65
412570,202111,800,386,414,424648.71,455431.61,880080.32
412575,202111,93,65,28,71510.84,30805.45,102316.29
412580,202111,174,119,55,130930.7,60509.79,191440.49
412590,202111,31,28,3,30804.75,3300.81,34105.56
412600,202111,173,119,54,130910.76,59407.69,190318.45
412610,202111,35,14,21,15400.63,23100.91,38501.54
412620,202111,140,116,24,127629.95,26406.02,154035.97
412625,202111,2120,1037,1083,1140861.84,1192546.38,2333408.22
412627,202111,66,48,18,52808.92,20902.56,73711.48
412630,202111,386,255,131,280563.57,145233.6,425797.17
412635,202111,72,19,53,20901.62,58302.1,79203.72
412640,202111,103,71,32,78112.48,35203.59,113316.07
412650,202111,322,214,108,235435.43,118809.87,354245.30
412660,202111,453,261,192,287135.51,211221.57,498357.08
412665,202111,43,39,4,42903.46,4400,47303.46
412667,202111,292,188,104,206836.96,114411.15,321248.11
412670,202111,73,59,14,64904.15,15400.5,80304.65
412680,202111,321,241,80,265137.41,88013.69,353151.10
412690,202111,127,81,46,89108.54,50603.84,139712.38
412700,202111,181,121,60,133109.11,66003.32,199112.43
412710,202111,1332,755,577,831734.77,634778.86,1466513.63
412720,202111,228,124,104,136416.48,114412.64,250829.12
412730,202111,202,170,32,187012.94,35201.79,222214.73
412740,202111,420,214,206,235432.3,226632.06,462064.36
412750,202111,431,231,200,254145.54,220023.39,474168.93
412760,202111,321,160,161,176027.08,178226.36,354253.44
412770,202111,2087,1113,974,1226646.95,1072624.28,2299271.23
412780,202111,142,105,37,115521.82,40707.5,156229.32
412785,202111,314,151,163,166114.3,179309.79,345424.09
412788,202111,44,24,20,26405.23,22003.21,48408.44
412790,202111,122,100,22,110022.66,25306.15,135328.81
412795,202111,148,102,46,112218.72,50611.43,162830.15
412796,202111,301,189,112,209006.93,123202.61,332209.54
412800,202111,654,388,266,427939.94,292623.17,720563.11
412810,202111,3011,1621,1390,1783294.95,1529173.91,3312468.86
412820,202111,941,566,375,622713.14,413661.1,1036374.24
412830,202111,13,10,3,11001.89,3300.96,14302.85
412840,202111,251,166,85,182617.01,94604.9,277221.91
412850,202111,716,448,268,493973.08,295927.32,789900.40
412853,202111,164,76,88,83607.95,96805.6,180413.55
412855,202111,196,103,93,113318.53,102313.36,215631.89
412860,202111,94,61,33,67117.94,36305.07,103423.01
412862,202111,75,49,26,53904.61,28600.78,82505.39
412863,202111,8,6,2,6601.5,2200.96,8802.46
412865,202111,43,32,11,35204.28,12101.15,47305.43
412870,202111,107,63,44,69308.52,48409.17,117717.69
412880,202111,94,66,28,72611.96,30802.82,103414.78
420005,202111,39,35,4,38502.77,4400,42902.77
420010,202111,371,239,132,262921.68,145207.64,408129.32
420020,202111,88,72,16,79208.74,17600.67,96809.41
420030,202111,26,21,5,23103.87,5500,28603.87
420040,202111,97,74,23,81414.92,25304.85,106719.77
420050,202111,60,37,23,40706.18,25303.16,66009.34
420055,202111,17,17,0,18704,,18704.0
420060,202111,25,18,7,19807.06,7702.79,27509.85
420070,202111,101,85,16,94613.78,17602.95,112216.73
420075,202111,10,10,0,11000.47,,11000.47
420080,202111,39,34,5,37405.98,5500.54,42906.52
420090,202111,39,32,7,35204.04,8801.36,44005.40
420100,202111,153,128,25,140827.77,27505.44,168333.21
420110,202111,22,21,1,23102.4,1100.67,24203.07
420120,202111,57,38,19,42908.16,20903.38,63811.54
420125,202111,85,67,18,73707.02,19800.94,93507.96
420127,202111,32,26,6,28601.3,6600,35201.3
420130,202111,451,266,185,293732.86,203521.4,497254.26
420140,202111,1316,725,591,797612.03,650216.03,1447828.06
420150,202111,45,36,9,39605.76,9900.74,49506.50
420160,202111,31,29,2,31904.85,2200.84,34105.69
420165,202111,14,9,5,9901.14,5500.61,15401.75
420170,202111,68,42,26,46204.7,28600.63,74805.33
420180,202111,22,19,3,20901.24,3300.8,24202.04
420190,202111,25,22,3,24206.29,3300.63,27506.92
420195,202111,149,68,81,74821.26,89120.95,163942.21
420200,202111,1281,532,749,585283.73,825127.07,1410410.80
420205,202111,101,59,42,64909,46204,111113
420207,202111,129,68,61,75914.99,67114.34,143029.33
420208,202111,19,15,4,16500.72,4400.4,20901.12
420209,202111,14,12,2,13200.56,2200.07,15400.63
420210,202111,551,260,291,288226.32,320130.03,608356.35
420213,202111,49,36,13,39605.3,14300.8,53906.1
420215,202111,26,22,4,24204.79,4401.59,28606.38
420220,202111,60,37,23,40705.69,25304.94,66010.63
420230,202111,899,536,363,589691.9,399384.91,989076.81
420240,202111,2215,1433,782,1576442.3,860272.93,2436715.23
420243,202111,45,36,9,39604.5,9902.43,49506.93
420245,202111,188,93,95,102310.17,104511.71,206821.88
420250,202111,62,42,20,46209.76,22004.59,68214.35
420253,202111,28,22,6,24203.87,6601.44,30805.31
420257,202111,12,9,3,9900.87,3300.4,13201.27
420260,202111,113,90,23,99012.56,25304.59,124317.15
420270,202111,30,23,7,25301.98,7700.5,33002.48
420280,202111,281,210,71,231046.2,78112.81,309159.01
420285,202111,23,16,7,17601.69,7701.1,25302.79
420287,202111,51,34,17,37406.89,18702.64,56109.53
420290,202111,914,624,290,686460.87,320130.61,1006591.48
420300,202111,1476,1171,305,1288302.79,335541.43,1623844.22
420310,202111,48,33,15,36302.51,16501.54,52804.05
420315,202111,34,27,7,29707.43,7701.89,37409.32
420320,202111,966,460,506,506080.44,558882.08,1064962.52
420325,202111,3,1,2,1100,2200,3300
420330,202111,120,79,41,86919.34,46207.65,133126.99
420340,202111,178,119,59,130920.66,64907.33,195827.99
420350,202111,255,175,80,192523.71,88008.39,280532.10
420360,202111,693,533,160,587500.86,176030.91,763531.77
420370,202111,130,73,57,80309.27,62708.88,143018.15
420380,202111,1200,827,373,910926.12,412559.88,1323486.00
420390,202111,225,156,69,172718.96,75907.59,248626.55
420395,202111,189,137,52,150724.81,57210.79,207935.60
420400,202111,236,179,57,196925.34,62705.37,259630.71
420410,202111,53,40,13,44007.54,14301.32,58308.86
420415,202111,33,28,5,30801.67,5500.86,36302.53
420417,202111,54,43,11,47307.46,12103.39,59410.85
420419,202111,10,9,1,9902.39,1100,11002.39
420420,202111,2776,1720,1056,1895532.03,1162852.57,3058384.60
420425,202111,69,54,15,59408.99,16502.63,75911.62
420430,202111,1083,778,305,856964.81,336621,1193585.81
420435,202111,13,11,2,12104.11,2200.11,14304.22
420440,202111,92,65,27,71511.67,29704,101215.67
420445,202111,28,27,1,29705.41,1100,30805.41
420450,202111,79,39,40,42903.07,44003.37,86906.44
420455,202111,194,149,45,163924.77,49510.47,213435.24
420460,202111,2303,1441,862,1588604.98,951625.92,2540230.90
420470,202111,97,68,29,74811.37,31905.01,106716.38
420475,202111,9,8,1,8800,1100,9900
420480,202111,854,645,209,710688.93,229927.63,940616.56
420490,202111,94,68,26,74811.55,28604.09,103415.64
420500,202111,432,232,200,255233.46,220024.33,475257.79
420510,202111,22,19,3,20901.9,3300.34,24202.24
420515,202111,29,16,13,17602.97,14300.54,31903.51
420517,202111,8,8,0,8802.25,,8802.25
420519,202111,0,,,,,0.0
420520,202111,61,47,14,52812.37,15405.88,68218.25
420530,202111,144,94,50,104505.89,55003.47,159509.36
420535,202111,18,16,2,17601.3,2200,19801.3
420540,202111,6012,3697,2315,4073069.19,2547996.47,6621065.66
420543,202111,30,28,2,30803.4,2200.99,33004.39
420545,202111,209,145,64,160620.64,70410.7,231031.34
420550,202111,793,656,137,721694.31,150718.23,872412.54
420555,202111,29,20,9,22004.47,9904.38,31908.85
420560,202111,60,48,12,52806.99,13201.46,66008.45
420570,202111,180,95,85,105619.09,93516.94,199136.03
420580,202111,287,139,148,152924.51,162832.59,315757.10
420590,202111,464,302,162,333321.47,178207.97,511529.44
420600,202111,138,74,64,81410.32,70407.37,151817.69
420610,202111,34,31,3,34106,3301.01,37407.01
420620,202111,81,59,22,64911.84,24203.61,89115.45
420630,202111,143,91,52,101211.2,57206.28,158417.48
420640,202111,74,64,10,70405.81,11001.38,81407.19
420650,202111,259,133,126,147417.75,138620.97,286038.72
420660,202111,40,32,8,35202.81,8802.1,44004.91
420665,202111,43,27,16,29703.81,17601.69,47305.50
420670,202111,253,199,54,218947.31,59410.88,278358.19
420675,202111,14,12,2,13200,2200,15400
420680,202111,32,26,6,28603.2,6601.47,35204.67
420690,202111,181,139,42,152917.51,46204.36,199121.87
420700,202111,696,450,246,495070.62,270641.58,765712.20
420710,202111,146,75,71,82509.1,78109.45,160618.55
420720,202111,99,79,20,86913.95,22002.35,108916.30
420730,202111,670,401,269,441176.14,295949.09,737125.23
420740,202111,53,53,0,58304.7,,58304.7
420750,202111,483,317,166,349833.9,182614.08,532447.98
420757,202111,17,15,2,16500,2200,18700
420760,202111,37,29,8,31905.77,8800.88,40706.65
420765,202111,79,57,22,62704.12,24201.42,86905.54
420768,202111,52,42,10,46210.46,11000.47,57210.93
420770,202111,73,60,13,66007.89,14300.11,80308.00
420775,202111,36,33,3,36303.35,3300,39603.35
420780,202111,200,157,43,172733.09,47304.72,220037.81
420785,202111,21,13,8,14302.06,8800,23102.06
420790,202111,145,120,25,132018.41,27505.45,159523.86
420800,202111,62,46,16,50605.66,17600.34,68206.00
420810,202111,261,212,49,233236.89,53905,287141.89
420820,202111,2423,1348,1075,1485160.4,1182653.21,2667813.61
420830,202111,640,328,312,361955.88,344349.4,706305.28
420840,202111,143,98,45,107808.14,49503,157311.14
420845,202111,422,179,243,196921.44,267340.35,464261.79
420850,202111,261,197,64,216715.74,71505.56,288221.30
420860,202111,57,47,10,51706.36,11000.21,62706.57
420870,202111,129,91,38,100111.89,41805.56,141917.45
420880,202111,183,119,64,132020.68,70405.42,202426.10
420890,202111,930,444,486,489555.7,534640.47,1024196.17
420895,202111,8,8,0,8801.83,,8801.83
420900,202111,404,321,83,354251.01,91308.85,445559.86
420910,202111,5676,3053,2623,3362031,2887841.64,6249872.64
420915,202111,62,54,8,59413.87,8800.5,68214.37
420917,202111,20,15,5,16502.41,5500.78,22003.19
420920,202111,19,13,6,14302.58,6600.61,20903.19
420930,202111,2989,1901,1088,2093498.03,1199200.94,3292698.97
420940,202111,584,425,159,469789.35,174941.78,644731.13
420945,202111,10,7,3,7701.06,3300,11001.06
420950,202111,51,41,10,46205.58,11001.32,57206.90
420960,202111,109,88,21,96815.96,23105.19,119921.15
420970,202111,280,224,56,246460.92,61612.66,308073.58
420980,202111,20,19,1,22002.5,1100,23102.5
420985,202111,53,47,6,51704.65,6600.32,58304.97
420990,202111,79,59,20,64907.4,22004.9,86912.3
421000,202111,50,27,23,29701.79,25301.58,55003.37
421003,202111,40,27,13,29707.09,14302.67,44009.76
421005,202111,8,5,3,5502.08,3301.34,8803.42
421010,202111,804,523,281,576491.86,309149.9,885641.76
421020,202111,22,17,5,19805.45,5500.56,25306.01
421030,202111,110,94,16,103428.69,17602.26,121030.95
421040,202111,66,45,21,49509.59,23107.5,72617.09
421050,202111,335,233,102,256313.8,112204.83,368518.63
421055,202111,18,14,4,15402.41,4400.44,19802.85
421060,202111,98,54,44,60504.85,48402.4,108907.25
421070,202111,38,32,6,35205.62,6601.59,41807.21
421080,202111,38,33,5,36307.62,5501.36,41808.98
421085,202111,18,15,3,16503.67,3301.14,19804.81
421090,202111,34,27,7,29704.51,7701.01,37405.52
421100,202111,115,84,31,93514.66,34104.52,127619.18
421105,202111,175,140,35,154019.61,38505.86,192525.47
421110,202111,112,83,29,91318.3,31904.81,123223.11
421120,202111,170,122,48,135309.56,52809.83,188119.39
421125,202111,19,12,7,13201.18,7700.46,20901.64
421130,202111,823,497,326,547865.1,358645.75,906510.85
421140,202111,35,24,11,26402.58,12103.02,38505.60
421145,202111,49,38,11,41803.37,12100.42,53903.79
421150,202111,91,71,20,78117.46,23106.06,101223.52
421160,202111,63,40,23,44004.21,26402.48,70406.69
421165,202111,16,13,3,14300.88,3300,17600.88
421170,202111,173,145,28,159663.31,30806.21,190469.52
421175,202111,177,119,58,130919.74,63810.1,194729.84
421180,202111,42,29,13,31905.76,14303.17,46208.93
421185,202111,14,11,3,12102.91,3300,15402.91
421187,202111,3,1,2,1100,2200.67,3300.67
421189,202111,45,32,13,35203.88,14300.68,49504.56
421190,202111,1821,1141,680,1255305.61,749231.37,2004536.98
421200,202111,94,67,27,73708.76,29703.37,103412.13
421205,202111,27,19,8,20904.58,8800.85,29705.43
421210,202111,177,129,48,141917.93,52809.74,194727.67
421220,202111,248,192,56,211224.73,61609.72,272834.45
421223,202111,47,36,11,39605.67,12100.78,51706.45
421225,202111,71,45,26,49508.99,28608.55,78117.54
421227,202111,77,61,16,67103.89,17600.8,84704.69
421230,202111,62,43,19,47305.95,20904.3,68210.25
421240,202111,15,15,0,16504.34,,16504.34
421250,202111,379,223,156,245333.54,171626.42,416959.96
421260,202111,20,16,4,17603.36,4400.49,22003.85
421265,202111,2,2,0,2200.56,,2200.56
421270,202111,49,43,6,47306.71,6600.11,53906.82
421280,202111,355,180,175,198030.47,192536.45,390566.92
421290,202111,323,216,107,237621.29,117708.87,355330.16
421300,202111,23,18,5,20902.76,5500,26402.76
421310,202111,53,36,17,39605.32,18703.51,58308.83
421315,202111,31,19,12,20903.92,14301.2,35205.12
421320,202111,130,85,45,93508.99,49505.71,143014.70
421330,202111,110,82,28,91309.43,30803.77,122113.20
421335,202111,42,31,11,34103.04,12100.74,46203.78
421340,202111,243,157,86,172724.18,94609.71,267333.89
421350,202111,184,107,77,117724.95,84714.26,202439.21
421360,202111,686,484,202,532474.48,222231.63,754706.11
421370,202111,187,136,51,150723.21,56104.37,206827.58
421380,202111,136,106,30,116625,33007.77,149632.77
421390,202111,15,9,6,9900,6600,16500
421400,202111,114,94,20,103405.13,22000.62,125405.75
421410,202111,22,19,3,20902.72,3300,24202.72
421415,202111,21,18,3,19803.73,3300,23103.73
421420,202111,104,90,14,99007.06,15401.08,114408.14
421430,202111,17,12,5,13204.53,5500,18704.53
421440,202111,57,50,7,55007.9,7701.93,62709.83
421450,202111,90,74,16,81411.65,17602.61,99014.26
421460,202111,56,42,14,46210.91,15402.22,61613.13
421470,202111,69,39,30,42909.45,33005.43,75914.88
421480,202111,740,559,181,617136.11,199110.7,816246.81
421490,202111,25,24,1,26404.18,1100,27504.18
421500,202111,473,283,190,311349.84,209023.17,520373.01
421505,202111,27,19,8,20903.47,8801.55,29705.02
421507,202111,32,26,6,28604.39,6600.11,35204.50
421510,202111,70,45,25,49512.35,27503.33,77015.68
421520,202111,52,43,9,47307.92,9902.57,57210.49
421530,202111,49,39,10,42907.5,11000.68,53908.18
421535,202111,19,18,1,19807.38,1100,20907.38
421540,202111,53,41,12,45106.15,13200.07,58306.22
421545,202111,83,60,23,66015.06,25301.83,91316.89
421550,202111,287,206,81,227744.11,89117.35,316861.46
421555,202111,18,15,3,16506.08,3300.87,19806.95
421560,202111,9,8,1,8801.07,1100.4,9901.47
421565,202111,117,75,42,82516.5,46208.83,128725.33
421567,202111,31,24,7,26404.05,7700.67,34104.72
421568,202111,45,40,5,44001.93,5500.67,49502.60
421569,202111,12,12,0,13201.87,,13201.87
421570,202111,215,140,75,154027.88,82509.33,236537.21
421575,202111,26,23,3,25302.03,3300.44,28602.47
421580,202111,702,411,291,455522.8,321235.72,776758.52
421590,202111,19,18,1,19803.25,1100,20903.25
421600,202111,155,101,54,111106.09,59401.89,170507.98
421605,202111,110,75,35,82506.26,38503.37,121009.63
421610,202111,164,126,38,138613.23,41805.82,180419.05
421620,202111,1015,576,439,633690.77,484071.46,1117762.23
421625,202111,20,18,2,19802.2,2200.23,22002.43
421630,202111,332,199,133,220036.04,146321.02,366357.06
421635,202111,21,10,11,11001.95,12102.02,23103.97
421640,202111,101,83,18,91323.54,19803.86,111127.40
421650,202111,294,171,123,188136.46,135323.52,323459.98
421660,202111,2415,1452,963,1597433.4,1060588.61,2658022.01
421670,202111,169,120,49,132007.96,53901.49,185909.45
421680,202111,185,168,17,184824.14,18702.25,203526.39
421690,202111,348,239,109,262932.85,119917.92,382850.77
421700,202111,52,36,16,39604.72,17601.92,57206.64
421710,202111,21,20,1,22002.33,1100,23102.33
421715,202111,5,4,1,4400.44,1100,5500.44
421720,202111,628,431,197,476337.99,216716.15,693054.14
421725,202111,20,6,14,7702.03,15402.23,23104.26
421730,202111,25,19,6,20903.97,6602.24,27506.21
421740,202111,101,37,64,40704.23,70402.88,111107.11
421750,202111,197,143,54,157313.61,59405.28,216718.89
421755,202111,20,18,2,19802.84,2200.44,22003.28
421760,202111,100,66,34,72608.42,37405.97,110014.39
421770,202111,699,445,254,489577.01,279445.48,769022.49
421775,202111,28,18,10,19803.97,11002.66,30806.63
421780,202111,174,138,36,152913.21,39601.59,192514.80
421790,202111,149,127,22,139715.63,24202.78,163918.41
421795,202111,17,13,4,14303.02,4400,18703.02
421800,202111,545,335,210,369680.22,231037.28,600717.50
421810,202111,71,57,14,63809.73,15402.82,79212.55
421820,202111,302,190,112,209026.27,123211.1,332237.37
421825,202111,149,122,27,134223.94,29704.62,163928.56
421830,202111,148,90,58,99020.02,63807.49,162827.51
421835,202111,7,2,5,2200.19,5500,7700.19
421840,202111,46,40,6,44007.76,6602.37,50610.13
421850,202111,82,69,13,75911.9,14303.39,90215.29
421860,202111,43,31,12,34106.72,13200.31,47307.03
421870,202111,1032,748,284,824037.36,313549.03,1137586.39
421875,202111,52,42,10,46207.24,11000.89,57208.13
421880,202111,177,119,58,130910.65,63803.66,194714.31
421885,202111,27,19,8,20901.04,8800.34,29701.38
421890,202111,136,96,40,105616.85,44009.07,149625.92
421895,202111,43,38,5,41806.79,5501.41,47308.20
421900,202111,134,101,33,111129.72,36309.4,147439.12
421910,202111,60,38,22,41806.85,24203.88,66010.73
421915,202111,31,25,6,27503.54,6600.8,34104.34
421917,202111,39,29,10,31901.84,11000.44,42902.28
421920,202111,36,32,4,35207.34,4400,39607.34
421930,202111,612,480,132,528073.68,145221.36,673295.04
421935,202111,41,36,5,39604.07,5501.04,45105.11
421940,202111,49,41,8,45102.71,8800.44,53903.15
421950,202111,856,563,293,620458.9,322341.16,942800.06
421960,202111,39,33,6,36305.05,6600,42905.05
421970,202111,322,208,114,228822.38,125410.73,354233.11
421985,202111,19,12,7,13202.86,7703.28,20906.14
422000,202111,0,0,0,,,0.0
430003,202111,192,55,137,60500.67,150700.11,211200.78
430005,202111,36,26,10,28602.34,11000,39602.34
430010,202111,260,187,73,205709.92,80302.44,286012.36
430020,202111,146,98,48,107812.55,53905.3,161717.85
430030,202111,120,100,20,110009.03,22001.21,132010.24
430040,202111,2920,1721,1199,1896499.97,1320081.33,3216581.30
430045,202111,71,60,11,66000,12100.74,78100.74
430047,202111,6,5,1,5500,1100,6600
430050,202111,87,73,14,80304.61,15400,95704.61
430055,202111,12,11,1,12100,1100,13200
430057,202111,5,4,1,4400,1100,5500
430060,202111,3873,2238,1635,2466490.44,1802010.85,4268501.29
430063,202111,57,47,10,51701.3,11000.57,62701.87
430064,202111,158,123,35,135302.47,38500.34,173802.81
430066,202111,5,2,3,2200.4,3300.6,5501.0
430070,202111,42,31,11,34101.27,12100,46201.27
430080,202111,74,47,27,51703.15,29700.75,81403.90
430085,202111,29,13,16,14300.8,17601.56,31902.36
430087,202111,23,16,7,17603.84,7703.06,25306.90
430090,202111,61,51,10,56103.12,11000,67103.12
430100,202111,130,87,43,96807.01,47302.79,144109.80
430105,202111,148,83,65,91316.45,71512.28,162828.73
430107,202111,19,13,6,14303.7,6601.96,20905.66
430110,202111,494,269,225,295914.33,247507.25,543421.58
430120,202111,166,150,16,165006.11,17602.08,182608.19
430130,202111,782,473,309,521430.28,339913.2,861343.48
430140,202111,130,119,11,130909.73,12100.74,143010.47
430150,202111,101,63,38,70406.78,41800,112206.78
430155,202111,28,24,4,26403.15,4400,30803.15
430160,202111,3603,2061,1542,2267296.52,1697427.24,3964723.76
430163,202111,395,177,218,194713.11,239813.86,434526.97
430165,202111,30,19,11,20900.81,12100,33000.81
430170,202111,83,69,14,77001.88,15400,92401.88
430175,202111,82,62,20,68200.79,22001.35,90202.14
430180,202111,105,87,18,95704.64,19800,115504.64
430185,202111,28,18,10,19800,11000,30800
430187,202111,51,28,23,30801.63,25300.48,56102.11
430190,202111,226,117,109,128707.85,119906.88,248614.73
430192,202111,16,12,4,13200.95,4400.31,17601.26
430195,202111,17,11,6,12100,6600,18700
430200,202111,153,129,24,141914.54,26404.39,168318.93
430205,202111,19,19,0,22000.67,,22000.67
430210,202111,696,524,172,576427.11,190307.02,766734.13
430215,202111,10,9,1,9900,1100,11000
430220,202111,74,50,24,56102.56,26400,82502.56
430222,202111,12,4,8,4400,8800.67,13200.67
430223,202111,17,11,6,12100,6600,18700
430225,202111,2,1,1,1100,1100,2200
430230,202111,318,193,125,212315.35,137505.22,349820.57
430235,202111,46,33,13,36302.72,14300,50602.72
430237,202111,20,15,5,16501.15,5500,22001.15
430240,202111,110,77,33,84702.49,36300.46,121002.95
430245,202111,69,55,14,60503.05,15400.8,75903.85
430250,202111,186,106,80,116607.1,88000.67,204607.77
430258,202111,8,7,1,7701.37,1100,8801.37
430260,202111,32,28,4,30802.13,4400,35202.13
430265,202111,34,29,5,31901.91,5500.17,37402.08
430270,202111,516,375,141,413636.38,156209.97,569846.35
430280,202111,1061,623,438,685328.85,481815.84,1167144.69
430290,202111,421,215,206,236512.57,226609,463121.57
430300,202111,2101,1127,974,1240921.14,1072599.01,2313520.15
430310,202111,2025,984,1041,1083618.11,1148528.61,2232146.72
430320,202111,55,46,9,50600,9900.67,60500.67
430330,202111,95,83,12,91305.43,13200,104505.43
430340,202111,65,52,13,57204.65,14300.34,71504.99
430350,202111,1655,1089,566,1197972.51,623733.84,1821706.35
430355,202111,18,17,1,18701.04,1100,19801.04
430360,202111,88,41,47,45100.8,51700,96800.8
430367,202111,36,27,9,29701.38,9900.84,39602.22
430370,202111,58,51,7,56101.03,7700,63801.03
430380,202111,117,89,28,97906.44,30800,128706.44
430390,202111,570,350,220,386141.76,242031.99,628173.75
430400,202111,261,184,77,202405.11,84701.05,287106.16
430410,202111,59,47,12,51700.67,13200.44,64901.11
430420,202111,505,312,193,343223.66,212311.05,555534.71
430430,202111,54,52,2,56472.36,2200,58672.36
430435,202111,139,106,33,116604.19,36301.36,152905.55
430440,202111,519,323,196,355327.5,215609.42,570936.92
430450,202111,1155,940,215,1034087.44,236520.33,1270607.77
430460,202111,5589,2872,2717,3160570.91,2991127.51,6151698.42
430461,202111,16,14,2,15400,2200,17600
430462,202111,5,3,2,3300.89,2200.99,5501.88
430463,202111,1139,616,523,677663.76,575356.65,1253020.41
430465,202111,24,13,11,14301.43,12100.08,26401.51
430466,202111,642,445,197,489540.77,216715.24,706256.01
430467,202111,117,68,49,74802.57,53901.59,128704.16
430468,202111,129,75,54,82505.09,59402.07,141907.16
430469,202111,19,15,4,16505.68,4401.01,20906.69
430470,202111,1125,621,504,684567.32,555531.93,1240099.25
430471,202111,66,42,24,46204.81,26403.2,72608.01
430480,202111,118,81,37,89100.91,40701.35,129802.26
430485,202111,8,8,0,8800.47,,8800.47
430490,202111,74,58,16,63803.65,17600.45,81404.10
430495,202111,32,24,8,26401.27,8800,35201.27
430500,202111,185,124,61,136404.05,67101.82,203505.87
430510,202111,3630,2352,1278,2590644.48,1410264.74,4000909.22
430511,202111,16,16,0,17601.49,,17601.49
430512,202111,145,98,47,107808.59,51705.15,159513.74
430513,202111,51,40,11,44002.94,12100,56102.94
430515,202111,25,24,1,27500.34,1100,28600.34
430517,202111,173,145,28,159506.26,30801.17,190307.43
430520,202111,335,236,99,259613.18,108906.48,368519.66
430530,202111,81,44,37,48401.32,40702.73,89104.05
430535,202111,446,298,148,327825.52,162812.52,490638.04
430537,202111,11,11,0,12101.07,,12101.07
430540,202111,78,52,26,57200.34,28600,85800.34
430543,202111,374,116,258,128704.2,283825.12,412529.32
430544,202111,45,42,3,46211.1,3301.07,49512.17
430545,202111,386,179,207,196917.85,227723.58,424641.43
430550,202111,39,31,8,34102.29,8801.11,42903.40
430558,202111,1,1,0,1100,,1100.0
430560,202111,54,31,23,34100,25300,59400
430570,202111,113,47,66,52805.17,72600,125405.17
430580,202111,127,101,26,111104.31,28600,139704.31
430583,202111,15,15,0,16500.62,,16500.62
430585,202111,13,7,6,7700,6600,14300
430587,202111,13,8,5,8800,5500,14300
430590,202111,156,125,31,137504.19,34102.9,171607.09
430593,202111,2,2,0,2200,,2200.0
430595,202111,17,13,4,14300,4400,18700
430597,202111,44,24,20,26401.56,22002.75,48404.31
430600,202111,215,164,51,180406.16,56100,236506.16
430605,202111,167,97,70,107802.14,77000,184802.14
430607,202111,28,23,5,25302.26,5500.5,30802.76
430610,202111,1708,797,911,880670.66,1005435.63,1886106.29
430613,202111,5,5,0,5500.67,,5500.67
430620,202111,108,80,28,88000.44,33001.76,121002.20
430630,202111,46,39,7,42903.33,7700,50603.33
430632,202111,30,25,5,27500,5500,33000
430635,202111,38,32,6,35200.68,6600,41800.68
430637,202111,68,34,34,37400.74,37400,74800.74
430640,202111,173,95,78,104506.21,85807.28,190313.49
430642,202111,17,15,2,16500.17,2200,18700.17
430645,202111,28,24,4,26400,4400,30800
430650,202111,249,198,51,217831.5,56103.3,273934.8
430655,202111,5,4,1,4400.26,1100.34,5500.60
430660,202111,964,470,494,517046.3,543442.91,1060489.21
430670,202111,75,52,23,57200.78,25300,82500.78
430673,202111,79,48,31,52802.61,34100.27,86902.88
430675,202111,8,6,2,6600.79,2200,8800.79
430676,202111,577,340,237,375128.5,260721.73,635850.23
430680,202111,237,157,80,172716.68,88004.21,260720.89
430690,202111,521,316,205,347633.92,225516.12,573150.04
430692,202111,9,7,2,7701.18,2200.54,9901.72
430693,202111,133,83,50,92404.75,55004.16,147408.91
430695,202111,64,53,11,58300.12,12100,70400.12
430697,202111,62,37,25,40701.16,27500.71,68201.87
430700,202111,1401,944,457,1041778.76,502740.76,1544519.52
430705,202111,30,27,3,29700.11,3300,33000.11
430710,202111,256,160,96,176004.82,105600.15,281604.97
430720,202111,109,92,17,101201.66,18700,119901.66
430730,202111,141,119,22,130904.03,24200,155104.03
430740,202111,75,49,26,53903.14,28600.12,82503.26
430745,202111,31,20,11,22000.93,12100,34100.93
430750,202111,334,217,117,238705.41,129801.56,368506.97
430755,202111,90,49,41,53903.32,45102.93,99006.25
430760,202111,386,212,174,233224.29,191421.6,424645.89
430770,202111,1547,797,750,876793.96,827283.88,1704077.84
430780,202111,310,191,119,210103.29,130901.74,341005.03
430781,202111,24,22,2,24204.22,2200,26404.22
430783,202111,64,50,14,55000,15400,70400
430786,202111,5,3,2,3300,2200,5500
430790,202111,526,334,192,367419.46,211212.04,578631.50
430800,202111,151,118,33,129806.58,36300.67,166107.25
430805,202111,38,31,7,34102.89,7700,41802.89
430807,202111,56,32,24,35200.61,26400,61600.61
430810,202111,72,47,25,51701.34,27500.54,79201.88
430820,202111,146,89,57,97904.99,62700.64,160605.63
430825,202111,11,9,2,9900.59,2200,12100.59
430830,202111,244,226,18,248612.3,19800.95,268413.25
430840,202111,137,93,44,102307.1,48401.6,150708.7
430843,202111,7,5,2,5500.44,2200,7700.44
430845,202111,73,40,33,44001.37,36300,80301.37
430850,202111,586,418,168,459819.48,185904.46,645723.94
430860,202111,148,92,56,101202.26,61602.38,162804.64
430865,202111,78,41,37,45100.55,40700.64,85801.19
430870,202111,78,63,15,69305.89,16500.45,85806.34
430880,202111,155,114,41,125405.64,45102.8,170508.44
430885,202111,10,9,1,9900.45,1100,11000.45
430890,202111,333,197,136,217804.99,149601.79,367406.78
430900,202111,519,356,163,391613.44,180402.32,572015.76
430905,202111,120,51,69,56100.37,77001.76,133102.13
430910,202111,281,156,125,171615.86,137509.83,309125.69
430912,202111,4,4,0,4400,,4400.0
430915,202111,35,32,3,35200.34,3300,38500.34
430920,202111,4428,2317,2111,2552301.7,2324587.69,4876889.39
430925,202111,5,4,1,4400,1100,5500
430930,202111,2051,1181,870,1300325,960388.35,2260713.35
430940,202111,250,160,90,177112.16,99005.19,276117.35
430950,202111,149,122,27,134205.46,29700.55,163906.01
430955,202111,26,15,11,16500.34,12100,28600.34
430957,202111,23,20,3,22002.03,3300,25302.03
430960,202111,244,161,83,177104.34,91301.85,268406.19
430965,202111,105,68,37,74801.65,40700.34,115501.99
430970,202111,92,73,19,80300.85,20900,101200.85
430975,202111,44,38,6,41801.55,6600,48401.55
430980,202111,48,29,19,31902.57,20900.44,52803.01
430990,202111,96,72,24,79202.23,26400,105602.23
430995,202111,113,105,8,115503.92,8800.4,124304.32
431000,202111,285,143,142,157312.05,157303.71,314615.76
431010,202111,352,199,153,218920.73,169420.59,388341.32
431020,202111,1862,1076,786,1185883.34,864647.32,2050530.66
431030,202111,37,29,8,31900.65,8800,40700.65
431033,202111,440,201,239,221124.39,262929.4,484053.79
431036,202111,13,7,6,7700.73,6600,14300.73
431040,202111,142,91,51,100102.85,56102.38,156205.23
431041,202111,37,22,15,25300.34,16500.87,41801.21
431043,202111,40,22,18,24202.1,19800.39,44002.49
431046,202111,13,10,3,11000.78,3300.44,14301.22
431050,202111,203,128,75,140807.26,82500.88,223308.14
431053,202111,69,38,31,41803.19,34104.75,75907.94
431055,202111,68,46,22,50600.84,24200.08,74800.92
431057,202111,18,18,0,19800.09,,19800.09
431060,202111,1578,1016,562,1117636.6,620417.92,1738054.52
431065,202111,15,8,7,9900.81,7700,17600.81
431070,202111,59,53,6,58301.44,6600,64901.44
431075,202111,7,7,0,7702.75,,7702.75
431080,202111,126,74,52,81406.62,58302.21,139708.83
431085,202111,34,30,4,33001.5,4400,37401.5
431087,202111,12,10,2,11000.27,2200,13200.27
431090,202111,51,38,13,41800,14300,56100
431100,202111,1225,725,500,797549.72,550038.61,1347588.33
431110,202111,224,136,88,149611.26,96804.28,246415.54
431112,202111,24,17,7,18703.18,7701.66,26404.84
431113,202111,30,22,8,24201.41,8800,33001.41
431115,202111,160,114,46,125407.41,50600,176007.41
431120,202111,591,340,251,374020.3,278313.73,652334.03
431123,202111,4,4,0,5500.74,,5500.74
431125,202111,99,85,14,93500.34,15400,108900.34
431127,202111,8,5,3,5500,3300,8800
431130,202111,715,470,245,517020.16,269508.85,786529.01
431140,202111,779,540,239,594032.81,262911.55,856944.36
431142,202111,20,18,2,19804.28,2200,22004.28
431150,202111,198,148,50,162811.58,55001.51,217813.09
431160,202111,45,42,3,46201.94,3300,49501.94
431162,202111,3,3,0,3300.77,,3300.77
431164,202111,5,5,0,5500,,5500.0
431170,202111,110,81,29,90204.6,31900,122104.6
431171,202111,71,41,30,45100.66,33000,78100.66
431173,202111,1,1,0,1100.93,,1100.93
431175,202111,205,107,98,117704.02,110004.65,227708.67
431177,202111,90,64,26,70409.67,28602.05,99011.72
431179,202111,16,12,4,13201.06,4400,17601.06
431180,202111,402,252,150,279409.55,165003.34,444412.89
431190,202111,75,55,20,60503.48,22000,82503.48
431198,202111,67,47,20,51702,22000.67,73702.67
431200,202111,20,16,4,17600,4400,22000
431205,202111,23,20,3,22000.67,3300,25300.67
431210,202111,101,64,37,70403.91,40703.16,111107.07
431213,202111,31,25,6,27504.48,6602.52,34107.00
431215,202111,22,19,3,20900,3300,24200
431217,202111,7,6,1,6601.53,1100,7701.53
431220,202111,67,57,10,62701.85,11000.34,73702.19
431225,202111,164,106,58,116600,63800,180400
431230,202111,96,85,11,93502.23,13200,106702.23
431235,202111,5,5,0,5500,,5500.0
431237,202111,8,7,1,7701.02,1100.2,8801.22
431238,202111,12,9,3,9900.86,3300.34,13201.20
431240,202111,1063,653,410,718368.5,452140.28,1170508.78
431242,202111,40,39,1,42902.26,1100,44002.26
431244,202111,18,14,4,15403.27,4400.27,19803.54
431245,202111,50,37,13,40701.43,14300.67,55002.10
431247,202111,10,6,4,6600,4400.5,11000.5
431250,202111,285,139,146,154014.78,160613.35,314628.13
431260,202111,54,45,9,49500.46,9900,59400.46
431261,202111,18,12,6,13200,6600.34,19800.34
431262,202111,16,14,2,15400.07,2200,17600.07
431265,202111,154,81,73,89101.32,80300.78,169402.10
431267,202111,18,16,2,17602.42,2200.5,19802.92
431270,202111,330,258,72,283815.58,79203.34,363018.92
431275,202111,40,35,5,38502.76,5500,44002.76
431280,202111,19,15,4,16500.97,4400,20900.97
431290,202111,16,14,2,15401.18,2200,17601.18
431295,202111,2,1,1,1100,1100,2200
431300,202111,20,18,2,19800,2200,22000
431301,202111,6,6,0,6600.34,,6600.34
431303,202111,60,37,23,40702.77,25300,66002.77
431306,202111,237,124,113,136211.36,124302.74,260514.10
431308,202111,7,5,2,5500,2200,7700
431310,202111,64,53,11,58302.64,12100,70402.64
431320,202111,163,96,67,105603.53,73700.83,179304.36
431330,202111,189,118,71,129806.62,78102.97,207909.59
431333,202111,29,23,6,25302.41,6600.33,31902.74
431335,202111,6,3,3,3300,3300.44,6600.44
431337,202111,384,179,205,196908.03,225510.19,422418.22
431339,202111,21,16,5,17601.18,5500,23101.18
431340,202111,3089,1668,1421,1834860.68,1564311.67,3399172.35
431342,202111,35,24,11,26402.23,12100.6,38502.83
431344,202111,18,18,0,19800,,19800.0
431346,202111,4,4,0,4400,,4400.0
431349,202111,34,30,4,33000,4400,37400
431350,202111,976,532,444,585270.55,488454.12,1073724.67
431360,202111,52,40,12,44000,13200.67,57200.67
431365,202111,351,149,202,163920.05,222209.93,386129.98
431370,202111,1189,679,510,746935.11,563218.76,1310153.87
431380,202111,98,88,10,96806.07,11000,107806.07
431390,202111,504,272,232,301414.88,255206.1,556620.98
431395,202111,322,136,186,149611.24,204614.93,354226.17
431400,202111,40,25,15,27501.35,16500,44001.35
431402,202111,102,72,30,79204.89,33001.11,112206.00
431403,202111,22,14,8,15400,8801.51,24201.51
431405,202111,700,390,310,430131.25,342129.36,772260.61
431406,202111,34,27,7,29703.35,7700,37403.35
431407,202111,51,40,11,44000.55,12100.44,56100.99
431410,202111,3368,2028,1340,2234293.76,1476314.39,3710608.15
431413,202111,16,13,3,14301.78,3300.36,17602.14
431415,202111,65,44,21,48407.61,23103.16,71510.77
431417,202111,25,11,14,12100,15400,27500
431420,202111,345,233,112,256321.34,123207.96,379529.30
431430,202111,58,29,29,31900.11,31900.44,63800.55
431440,202111,8989,6128,2861,6750246.61,3150754,9901000.61
431442,202111,27,14,13,15400.72,14300.43,29701.15
431445,202111,29,27,2,29700,2200,31900
431446,202111,4,3,1,3300.33,1100,4400.33
431447,202111,83,59,24,64903.17,26400,91303.17
431449,202111,50,41,9,45100.07,9900.67,55000.74
431450,202111,410,271,139,298110.05,152901.38,451011.43
431454,202111,14,8,6,8800,6601.87,15401.87
431455,202111,45,36,9,39606.84,9901.15,49507.99
431460,202111,500,344,156,378441.68,171611.41,550053.09
431470,202111,125,93,32,102305.35,35201.56,137506.91
431475,202111,9,7,2,7700.47,2200.79,9901.26
431477,202111,35,20,15,22000.14,16500,38500.14
431478,202111,9,8,1,8800.96,1100,9900.96
431480,202111,567,333,234,366328.18,259618.15,625946.33
431490,202111,28860,16013,12847,17634819.46,14146507.4,31781326.86
431500,202111,79,62,17,69303.33,18700.88,88004.21
431505,202111,28,18,10,19800.54,11000.77,30801.31
431507,202111,8,7,1,7702.53,1100,8802.53
431510,202111,228,167,61,183706.54,67100.99,250807.53
431513,202111,21,19,2,20902.3,2200.11,23102.41
431514,202111,4,3,1,3300,1100,4400
431515,202111,79,66,13,72602.5,14300,86902.5
431517,202111,6,3,3,3300.84,3300,6600.84
431520,202111,38,34,4,37401.18,4400,41801.18
431530,202111,1415,629,786,693029.11,866833.87,1559862.98
431531,202111,20,18,2,19801.31,2200,22001.31
431532,202111,37,28,9,30800.55,9900,40700.55
431535,202111,28,15,13,16503.26,14300.4,30803.66
431540,202111,139,114,25,125401.85,27501.75,152903.60
431545,202111,11,9,2,9902.07,2200,12102.07
431550,202111,360,193,167,212319.23,183712.52,396031.75
431555,202111,10,10,0,11000,,11000.0
431560,202111,4641,3095,1546,3408104.75,1701863.98,5109968.73
431570,202111,830,429,401,471936.33,441134.19,913070.52
431575,202111,45,25,20,27501.41,22000.88,49502.29
431580,202111,89,59,30,66000.82,33000.14,99000.96
431590,202111,137,113,24,124301.27,26400.5,150701.77
431595,202111,19,16,3,17603.65,3300.96,20904.61
431600,202111,252,147,105,161712.58,115506.48,277219.06
431610,202111,113,84,29,92406.38,31900.67,124307.05
431620,202111,40,33,7,36301.88,7700,44001.88
431630,202111,127,103,24,113303.05,26400,139703.05
431640,202111,1323,822,501,904243.68,551122.6,1455366.28
431642,202111,35,32,3,35200,3300,38500
431643,202111,44,17,27,18700.71,29705.64,48406.35
431645,202111,313,183,130,201304.13,143002.68,344306.81
431647,202111,9,8,1,8800.34,1100,9900.34
431650,202111,30,16,14,17600.44,15401.6,33002.04
431660,202111,273,169,104,185905.39,114401.38,300306.77
431670,202111,221,98,123,107804.9,135301.78,243106.68
431673,202111,12,10,2,11000.95,2200,13200.95
431675,202111,25,20,5,22001.28,5500,27501.28
431680,202111,1124,823,301,906477.7,331127.14,1237604.84
431690,202111,4847,2873,1974,3162777.2,2173776.91,5336554.11
431695,202111,21,15,6,16501.01,6600,23101.01
431697,202111,2,1,1,1100,1100.44,2200.44
431700,202111,186,139,47,152903.33,51700.58,204603.91
431710,202111,4034,1745,2289,1921867.97,2520336.96,4442204.93
431720,202111,1297,798,499,879489.03,548928.54,1428417.57
431725,202111,1,1,0,1100,,1100.0
431730,202111,1146,762,384,839393.82,422447.25,1261841.07
431740,202111,1322,639,683,704043.84,752445.58,1456489.42
431750,202111,1819,1185,634,1303601,699649.88,2003250.88
431755,202111,6,5,1,5500.4,1100.49,6600.89
431760,202111,983,609,374,669987.7,412560.61,1082548.31
431770,202111,419,288,131,316808.71,145201.29,462010.00
431775,202111,26,19,7,20903.7,7700.34,28604.04
431780,202111,544,327,217,359702.84,239800.46,599503.30
431790,202111,154,122,32,134206.37,35201.23,169407.60
431795,202111,13,10,3,11000,3300,14300
431800,202111,3156,1642,1514,1808540.89,1667760.96,3476301.85
431805,202111,19,17,2,18700,2200,20900
431810,202111,599,392,207,431231.72,227706.9,658938.62
431820,202111,334,198,136,217807.33,150701.7,368509.03
431830,202111,2267,1368,899,1505966.66,988955.21,2494921.87
431840,202111,472,307,165,337727.16,181511.73,519238.89
431842,202111,36,29,7,31900,7700,39600
431843,202111,11,8,3,8800.06,3300.47,12100.53
431844,202111,17,12,5,13200,5500.67,18700.67
431845,202111,24,22,2,24200,2200.44,26400.44
431846,202111,25,22,3,24201.18,3300,27501.18
431848,202111,14,12,2,13200.57,2200,15400.57
431849,202111,4,4,0,4400.8,,4400.8
431850,202111,754,590,164,649062.79,180415.74,829478.53
431860,202111,119,78,41,85803.89,45100.44,130904.33
431861,202111,6,2,4,2200.36,4400.78,6601.14
431862,202111,56,39,17,42901.51,18701.3,61602.81
431870,202111,3557,2002,1555,2203543.91,1715083.69,3918627.60
431880,202111,950,678,272,745835.6,299208.37,1045043.97
431890,202111,1272,737,535,811836.83,589615.01,1401451.84
431900,202111,187,129,58,141903.92,64900,206803.92
431910,202111,50,36,14,39600.8,15401.55,55002.35
431912,202111,50,31,19,34101.19,20901.27,55002.46
431915,202111,142,107,35,117700.44,38500.8,156201.24
431920,202111,153,111,42,123207.15,46200.44,169407.59
431930,202111,81,69,12,75903.07,13200,89103.07
431935,202111,2,2,0,2200,,2200.0
431936,202111,3,3,0,3300.5,,3300.5
431937,202111,20,15,5,16500.8,5500.17,22000.97
431940,202111,462,312,150,343220.58,165008.47,508229.05
431950,202111,475,302,173,333343.88,190324.71,523668.59
431960,202111,734,394,340,433435.34,374008.8,807444.14
431970,202111,69,63,6,69305.54,6600.44,75905.98
431971,202111,5,3,2,3300,2200,5500
431973,202111,17,14,3,15401.91,3300,18701.91
431975,202111,9,8,1,8800,1100,9900
431980,202111,204,121,83,133104.95,91302.7,224407.65
431990,202111,1112,589,523,649012.18,576487.32,1225499.50
432000,202111,1818,935,883,1029719.45,972523.8,2002243.25
432010,202111,259,175,84,192504.21,92402.06,284906.27
432020,202111,180,149,31,163907.63,34100,198007.63
432023,202111,15,13,2,14300,2200,16500
432026,202111,55,49,6,53902.23,6600,60502.23
432030,202111,61,29,32,31900,35200,67100
432032,202111,15,11,4,12100.47,4400.67,16501.14
432035,202111,62,48,14,52802.22,15400.4,68202.62
432040,202111,86,56,30,61604.12,33000.78,94604.90
432045,202111,2,2,0,2200.34,,2200.34
432050,202111,81,49,32,53905.15,35200.17,89105.32
432055,202111,127,92,35,101205.68,38501.43,139707.11
432057,202111,6,4,2,4401,2200,6601
432060,202111,35,31,4,34101.87,4400,38501.87
432065,202111,30,27,3,29700,3300,33000
432067,202111,86,79,7,86901.8,7700,94601.8
432070,202111,380,297,83,326998.6,91305.14,418303.74
432080,202111,823,575,248,632558.58,273916.76,906475.34
432085,202111,7,5,2,5500.21,2200,7700.21
432090,202111,263,176,87,193608.42,95703.05,289311.47
432100,202111,169,109,60,121002.27,66002.34,187004.61
432110,202111,543,360,183,397125.37,201306.87,598432.24
432120,202111,987,555,432,613834.94,476332.03,1090166.97
432130,202111,491,345,146,379524.92,160607.61,540132.53
432132,202111,24,21,3,23100.17,3300,26400.17
432135,202111,78,63,15,69304.54,16500.67,85805.21
432140,202111,262,198,64,217805.93,70401.77,288207.70
432143,202111,216,130,86,143010.16,94606.1,237616.26
432145,202111,271,187,84,205709.97,92400.67,298110.64
432146,202111,13,12,1,13201.55,1100,14301.55
432147,202111,108,57,51,62700,56100.67,118800.67
432149,202111,15,9,6,9900.86,6600.27,16501.13
432150,202111,972,598,374,660068.18,411443.42,1071511.60
432160,202111,1606,824,782,908676.64,861369.85,1770046.49
432162,202111,3,2,1,2200,1100,3300
432163,202111,17,12,5,13200,5500,18700
432166,202111,127,94,33,103694.54,36305.55,140000.09
432170,202111,229,115,114,126510.34,125407.38,251917.72
432180,202111,556,343,213,377306.56,235404.18,612710.74
432183,202111,9,8,1,8802.69,1100.34,9903.03
432185,202111,75,62,13,68205.11,14301.31,82506.42
432190,202111,507,299,208,328905.81,228803.7,557709.51
432195,202111,92,78,14,85801.01,16500.44,102301.45
432200,202111,405,253,152,278318.76,167207.69,445526.45
432210,202111,112,69,43,75902.86,47301.11,123203.97
432215,202111,34,31,3,34102.7,3300,37402.7
432218,202111,20,20,0,22001.97,,22001.97
432220,202111,635,324,311,357522.81,344312.85,701835.66
432225,202111,18,13,5,14302.21,5500,19802.21
432230,202111,130,84,46,92406.13,50600.44,143006.57
432232,202111,23,19,4,20900,4400,25300
432234,202111,3,1,2,1100,2200.8,3300.8
432235,202111,2,2,0,2200,,2200.0
432237,202111,24,15,9,16502.57,9900,26402.57
432240,202111,4403,2452,1951,2700723.73,2149593,4850316.73
432250,202111,1115,726,389,803025.76,427908.11,1230933.87
432252,202111,49,48,1,52800.94,1100,53900.94
432253,202111,58,46,12,50604.68,13201.99,63806.67
432254,202111,29,12,17,13200.4,18700,31900.4
432255,202111,13,11,2,12100,2200.67,14300.67
432260,202111,832,666,166,733725.93,183705.72,917431.65
432270,202111,220,165,55,181525.91,60511.18,242037.09
432280,202111,145,108,37,118808.7,40702.84,159511.54
432285,202111,1,1,0,1100,,1100.0
432290,202111,56,49,7,53901.66,7700,61601.66
432300,202111,4821,2569,2252,2828326.32,2479658.87,5307985.19
432310,202111,127,105,22,115504.4,24200.44,139704.84
432320,202111,22,17,5,18700,5500,24200
432330,202111,16,10,6,11000,6600,17600
432335,202111,8,6,2,6600.67,2200,8800.67
432340,202111,38,31,7,34101.04,7700,41801.04
432345,202111,108,73,35,80301.78,38500.34,118802.12
432350,202111,21,20,1,22000,1100,23100
432360,202111,5,4,1,4401.04,1100,5501.04
432370,202111,26,25,1,27502.05,1100,28602.05
432375,202111,27,25,2,27501.73,2200,29701.73
432377,202111,6,6,0,6600.02,,6600.02
432380,202111,180,76,104,83608.19,114406.54,198014.73
500020,202111,256,132,124,145218.44,136415.74,281634.18
500025,202111,138,69,69,75907.37,75903.23,151810.60
500060,202111,1447,909,538,1000034.83,594086.66,1594121.49
500070,202111,744,354,390,389448.18,429053.81,818501.99
500080,202111,136,106,30,116615.37,33005.54,149620.91
500085,202111,134,107,27,117710.19,29701.41,147411.60
500090,202111,366,167,199,183721.01,218918.26,402639.27
500100,202111,700,364,336,403756.69,369645.06,773401.75
500110,202111,2269,1063,1206,1170558.24,1326822.64,2497380.88
500124,202111,271,148,123,162819.29,135311.2,298130.49
500150,202111,335,135,200,148522.6,220047.37,368569.97
500190,202111,517,344,173,379558.28,190328.4,569886.68
500200,202111,200,170,30,187030.35,33002.39,220032.74
500210,202111,1613,538,1075,591867.48,1183747.02,1775614.50
500215,202111,206,119,87,130927.25,95718.61,226645.86
500220,202111,723,464,259,511573.58,284946.08,796519.66
500230,202111,230,139,91,152928.4,100116.3,253044.7
500240,202111,640,429,211,473065.37,232133.65,705199.02
500260,202111,580,220,360,242036.43,396047.01,638083.44
500270,202111,29890,12729,17161,14016620.89,18902245.59,32918866.48
500280,202111,197,65,132,71504.03,145202.09,216706.12
500290,202111,1164,715,449,788810.88,495064.28,1283875.16
500295,202111,461,297,164,326744.73,180423.44,507168.17
500310,202111,97,34,63,37401.52,69303.36,106704.88
500315,202111,812,448,364,492805.22,400410.94,893216.16
500320,202111,3650,1745,1905,1921980.72,2095781.94,4017762.66
500325,202111,918,505,413,555603.13,454392.46,1009995.59
500330,202111,1503,702,801,772300.34,882337.54,1654637.88
500345,202111,309,231,78,255236.15,85811.66,341047.81
500348,202111,249,149,100,163915.96,110011.18,273927.14
500350,202111,105,48,57,52810.38,62710.96,115521.34
500370,202111,5705,2560,3145,2816430.75,3464459.55,6280890.30
500375,202111,349,234,115,258537.55,126517.19,385054.74
500380,202111,597,336,261,369662.08,287135.6,656797.68
500390,202111,71,34,37,37401.97,40703.05,78105.02
500400,202111,208,135,73,148518.15,80312.4,228830.55
500410,202111,517,219,298,240936.67,327859.98,568796.65
500430,202111,539,376,163,413637.41,179322.75,592960.16
500440,202111,213,115,98,126509.91,108913.47,235423.38
500450,202111,416,178,238,195820.42,262920.78,458741.20
500460,202111,261,144,117,158424.24,128718.7,287142.94
500470,202111,424,319,105,350950.79,115512.53,466463.32
500480,202111,104,61,43,67105.48,47307.64,114413.12
500490,202111,100,43,57,47306.59,62704.96,110011.55
500500,202111,1428,529,899,581976.52,989049.55,1571026.07
500510,202111,42,35,7,38509.72,7702.88,46212.60
500515,202111,98,67,31,73712.29,34107.92,107820.21
500520,202111,302,159,143,176024.26,157318.04,333342.30
500525,202111,93,50,43,55007.94,47304.23,102312.17
500540,202111,890,388,502,427978.95,552298.86,980277.81
500560,202111,922,515,407,567679.7,447759.8,1015439.5
500568,202111,1005,537,468,590782.29,514875.87,1105658.16
500570,202111,1167,669,498,737079.64,547869.24,1284948.88
500580,202111,322,167,155,183735.22,170532.45,354267.67
500600,202111,350,172,178,189239.03,195827.98,385067.01
500620,202111,941,652,289,717299.87,317951.8,1035251.67
500625,202111,78,60,18,66002.55,19800.8,85803.35
500627,202111,42,20,22,22003.28,24203.33,46206.61
500630,202111,1558,886,672,975867.93,739327.92,1715195.85
500635,202111,521,311,210,342108.24,231002.13,573110.37
500640,202111,363,200,163,220039.29,179336.28,399375.57
500660,202111,5701,2041,3660,2246507.29,4028889.08,6275396.37
500690,202111,614,217,397,238732.13,437841.21,676573.34
500710,202111,398,196,202,215628.3,222235.98,437864.28
500720,202111,929,509,420,559975.76,463148.52,1023124.28
500730,202111,167,102,65,112238.79,71521.45,183760.24
500740,202111,916,373,543,411466.31,597381.03,1008847.34
500750,202111,161,51,110,56104.52,121006.57,177111.09
500755,202111,114,87,27,95724.73,29706.58,125431.31
500769,202111,742,405,337,445562.35,371847.94,817410.29
500770,202111,435,239,196,262930.98,215624.95,478555.93
500780,202111,136,92,44,101227.92,48408.58,149636.50
500790,202111,1038,509,529,560006.11,583099.4,1143105.51
500793,202111,294,149,145,163925.83,159528.52,323454.35
500795,202111,167,108,59,118811.21,64907.31,183718.52
500797,202111,49,32,17,35201.71,18700.05,53901.76
500800,202111,427,183,244,201323.97,268420.82,469744.79
500830,202111,2225,1208,1017,1331209.54,1118875.04,2450084.58
500840,202111,122,92,30,101224.25,33006.37,134230.62
510010,202111,171,93,78,102302.25,85801.53,188103.78
510020,202111,527,232,295,255238.95,327838.54,583077.49
510025,202111,1649,911,738,1003351.98,811918.54,1815270.52
510030,202111,672,338,334,371883.22,370785.56,742668.78
510035,202111,130,70,60,77003.02,66005.4,143008.42
510040,202111,413,198,215,217822.01,237621.75,455443.76
510050,202111,361,195,166,214544.22,182631.21,397175.43
510060,202111,124,60,64,66006.43,70404.03,136410.46
510080,202111,243,92,151,101207.71,166105.47,267313.18
510100,202111,67,29,38,31902.77,41804.99,73707.76
510120,202111,31,18,13,19805.21,14301.31,34106.52
510125,202111,372,225,147,247529.23,161718.47,409247.70
510130,202111,541,329,212,361929.97,233220.93,595150.90
510140,202111,441,139,302,152926.21,332244.55,485170.76
510160,202111,98,33,65,36303.47,71515.33,107818.80
510170,202111,748,454,294,499464.66,323449.07,822913.73
510180,202111,2894,1343,1551,1477520.22,1709610.86,3187131.08
510185,202111,23,12,11,13203.05,12101.05,25304.10
510190,202111,237,81,156,89105.96,171612.73,260718.69
510250,202111,2611,1588,1023,1750287.95,1127617.97,2877905.92
510260,202111,171,123,48,135337.79,52812.43,188150.22
510263,202111,470,258,212,286044.66,233229.73,519274.39
510267,202111,629,347,282,382863.17,310249.38,693112.55
510268,202111,61,27,34,29704.04,37403.82,67107.86
510269,202111,79,35,44,38502.38,48402.43,86904.81
510270,202111,382,185,197,203523.73,216716.72,420240.45
510279,202111,203,156,47,171618.19,52804.4,224422.59
510285,202111,178,72,106,79206.87,116610.95,195817.82
510300,202111,517,270,247,297055.76,272851.47,569907.23
510305,202111,201,90,111,99006.78,122105.95,221112.73
510310,202111,108,55,53,60502.93,58302.41,118805.34
510320,202111,812,504,308,555603.91,341064.66,896668.57
510325,202111,421,169,252,187011.32,278316.68,465328.00
510330,202111,428,235,193,259643.73,213424.83,473068.56
510335,202111,646,377,269,414760.13,295939.37,710699.50
510336,202111,55,38,17,41801.74,18701.8,60503.54
510337,202111,102,46,56,50602.24,61602.78,112205.02
510340,202111,17511,7804,9707,8594778.64,10690552.36,19285331.00
510343,202111,63,46,17,50600.05,18700,69300.05
510345,202111,151,94,57,103413.98,62706.94,166120.92
510350,202111,658,349,309,385052.42,339933.95,724986.37
510360,202111,215,136,79,149622.59,86913.56,236536.15
510370,202111,153,69,84,75900.47,92403.1,168303.57
510380,202111,80,60,20,66000.67,22000,88000.67
510385,202111,58,26,32,29701.48,35200.33,64901.81
510390,202111,100,44,56,48404.02,61604.07,110008.09
510395,202111,46,32,14,35201.03,15400.2,50601.23
510410,202111,732,460,272,506087.03,299248.72,805335.75
510420,202111,563,269,294,295927.56,324521.01,620448.57
510450,202111,47,23,24,25300.44,26400.44,51700.88
510452,202111,52,22,30,24201.68,34103.61,58305.29
510454,202111,50,23,27,25301.17,29701.14,55002.31
510455,202111,129,75,54,83609.3,59404.82,143014.12
510460,202111,180,82,98,90217.65,107812.59,198030.24
510480,202111,705,420,285,462076.36,313554.01,775630.37
510490,202111,341,168,173,184813.77,190312.68,375126.45
510500,202111,232,174,58,191411.92,63805.77,255217.69
510510,202111,796,456,340,502782.29,374050.86,876833.15
510515,202111,1246,642,604,706281.25,665582.78,1371864.03
510517,202111,274,126,148,138611.15,162813.04,301424.19
510520,202111,213,140,73,154026.69,80311.44,234338.13
510523,202111,106,82,24,90201.53,26400,116601.53
510525,202111,842,501,341,551161.47,375149.63,926311.10
510530,202111,19,12,7,13200.6,7700.84,20901.44
510550,202111,239,109,130,119925.49,143026.37,262951.86
510558,202111,292,141,151,155110.52,166105.21,321215.73
510560,202111,394,220,174,243141.33,191429.49,434570.82
510562,202111,641,463,178,509399.25,195827.6,705226.85
510590,202111,731,373,358,410342.73,393849.52,804192.25
510600,202111,216,111,105,122118.15,115513.78,237631.93
510610,202111,228,93,135,102306.19,149617.9,251924.09
510615,202111,187,86,101,95709.96,112210.05,207920.01
510617,202111,26,12,14,13200.27,15401.48,28601.75
510618,202111,123,61,62,67104.63,69306.69,136411.32
510619,202111,88,63,25,69308.24,27502.69,96810.93
510620,202111,159,90,69,99002.8,75901.42,174904.22
510621,202111,174,111,63,122111.41,69302.16,191413.57
510622,202111,475,265,210,292657.79,231031.9,523689.69
510623,202111,294,197,97,216723.68,106708.46,323432.14
510624,202111,86,46,40,52806.16,44004.32,96810.48
510625,202111,511,322,189,354278.92,207941.46,562220.38
510626,202111,112,64,48,70408.69,52803.01,123211.70
510627,202111,91,62,29,68204.52,31902.88,100107.40
510628,202111,156,95,61,104511.67,67100.2,171611.87
510629,202111,273,164,109,180406.61,119922.57,300329.18
510630,202111,442,220,222,242032.52,244228.84,486261.36
510631,202111,14,6,8,6601.04,8801.16,15402.20
510637,202111,350,198,152,217826.56,167224.21,385050.77
510642,202111,1049,560,489,616086.62,539073.76,1155160.38
510645,202111,7,1,6,1100,6600.67,7700.67
510650,202111,1338,873,465,960522.19,511583.38,1472105.57
510665,202111,80,32,48,35209.78,52807.3,88017.08
510670,202111,57,30,27,33003.43,29700.56,62703.99
510675,202111,1111,708,403,780043.52,444483.42,1224526.94
510677,202111,348,184,164,202428.59,180417.49,382846.08
510680,202111,96,57,39,62716.45,42909.35,105625.80
510682,202111,190,96,94,105603.24,104503.6,210106.84
510685,202111,55,40,15,44004.92,16501.66,60506.58
510700,202111,558,313,245,344389.71,269562.73,613952.44
510704,202111,1170,603,567,664553.11,623813.89,1288367.00
510706,202111,142,72,70,79206.42,77009.63,156216.05
510710,202111,410,283,127,311349.25,139714.89,451064.14
510715,202111,56,40,16,44003.16,17600.67,61603.83
510718,202111,228,111,117,122117.16,128717.59,250834.75
510719,202111,44,17,27,18701.27,29705.32,48406.59
510720,202111,185,130,55,143021.36,60511.09,203532.45
510724,202111,84,31,53,34100.61,58300.95,92401.56
510726,202111,62,30,32,33001.92,35206,68207.92
510729,202111,20,8,12,8802.83,13202.18,22005.01
510730,202111,466,255,211,280524.53,232123.68,512648.21
510735,202111,114,46,68,50602.16,74803.46,125405.62
510740,202111,22,11,11,12103.99,12101.63,24205.62
510757,202111,25,19,6,20901.83,6600.34,27502.17
510760,202111,7253,3665,3588,4033208.82,3952902.85,7986111.67
510770,202111,673,316,357,348748.58,393854.51,742603.09
510774,202111,19,6,13,6601.21,14301.77,20902.98
510775,202111,112,86,26,94603.69,28600,123203.69
510776,202111,34,11,23,12100.62,25303.44,37404.06
510777,202111,193,81,112,89100,123200,212300
510779,202111,35,19,16,20904.82,17603.43,38508.25
510780,202111,267,150,117,165037.36,128720.31,293757.67
510785,202111,364,200,164,220028.94,180414.27,400443.21
510787,202111,184,85,99,93516.51,110014.29,203530.80
510788,202111,6,1,5,1100,5500.58,6600.58
510790,202111,2532,1308,1224,1440147.02,1346557.95,2786704.97
510792,202111,1122,623,499,687606.9,550078.39,1237685.29
510794,202111,113,61,52,67108.49,57207.16,124315.65
510795,202111,2260,1311,949,1442211.99,1045091.43,2487303.42
510800,202111,188,113,75,124312.84,82506.17,206819.01
510805,202111,197,131,66,144110.23,72604.5,216714.73
510810,202111,101,42,59,46203.96,64905.4,111109.36
510820,202111,235,115,120,126532.88,132028.56,258561.44
510830,202111,73,40,33,44002.31,36300,80302.31
510835,202111,15,10,5,11000,5500.61,16500.61
510840,202111,9085,4240,4845,4672621.76,5334905.01,10007526.77
510850,202111,209,86,123,94604.88,135308.54,229913.42
510860,202111,404,189,215,207911.26,236512.16,444423.42
510880,202111,74,53,21,59402.02,23100,82502.02
510885,202111,64,37,27,40702.35,29701.6,70403.95
510890,202111,59,32,27,35203.23,29701.33,64904.56
510895,202111,167,98,69,107816.82,75906.98,183723.80
520005,202111,132,56,76,61604.15,83609.4,145213.55
520010,202111,294,131,163,144125.73,179341.54,323467.27
520013,202111,720,475,245,522572.74,269535.4,792108.14
520015,202111,47,33,14,36301.84,15401,51702.84
520017,202111,86,51,35,56109.03,38505.81,94614.84
520020,202111,19,10,9,11002.8,9901.33,20904.13
520025,202111,2606,1361,1245,1498479.92,1370894.42,2869374.34
520030,202111,814,440,374,484362.57,411466.52,895829.09
520050,202111,66,46,20,50601.79,22003.66,72605.45
520055,202111,59,39,20,42901.36,22001.58,64902.94
520060,202111,179,114,65,125425.08,71513.96,196939.04
520080,202111,579,419,160,460946.24,176019.1,636965.34
520082,202111,17,11,6,12101.47,6601.22,18702.69
520085,202111,87,65,22,71503.73,24201.95,95705.68
520090,202111,86,61,25,67103.41,27503.39,94606.80
520110,202111,9153,3899,5254,4292989.33,5787040.34,10080029.67
520120,202111,10,5,5,5500.6,5500.68,11001.28
520130,202111,805,562,243,618261.39,267334.89,885596.28
520140,202111,11939,6595,5344,7263709.35,5882855.67,13146565.02
520145,202111,54,32,22,35203.6,24201.67,59405.27
520150,202111,156,124,32,137522.79,35208.29,172731.08
520160,202111,46,32,14,35204.43,15401.46,50605.89
520170,202111,234,132,102,145242.47,112230.68,257473.15
520180,202111,177,80,97,88004.41,106710.72,194715.13
520215,202111,199,132,67,146313.9,73704.69,220018.59
520235,202111,80,63,17,69303,18700,88003
520250,202111,127,73,54,80308.49,59404.75,139713.24
520260,202111,115,71,44,78114.82,48411.07,126525.89
520280,202111,43,30,13,33001.42,14302.24,47303.66
520310,202111,45,27,18,29701.87,19800.65,49502.52
520320,202111,169,104,65,115441.85,71506.68,186948.53
520330,202111,810,435,375,478584.38,412605.75,891190.13
520340,202111,357,206,151,226640.57,166124.37,392764.94
520350,202111,499,240,259,264032.49,284946.45,548978.94
520355,202111,88,48,40,52806.96,44007.69,96814.65
520357,202111,26,20,6,22000.43,6600.34,28600.77
520360,202111,4,2,2,2200.29,2200,4400.29
520380,202111,140,77,63,84702.77,69301.88,154004.65
520390,202111,246,103,143,113332.94,157334.88,270667.82
520393,202111,16,13,3,14301.49,3300.67,17602.16
520396,202111,73,49,24,53900.56,26400.88,80301.44
520400,202111,197,119,78,130922.83,85815.55,216738.38
520410,202111,189,94,95,103416.39,104510.16,207926.55
520420,202111,20,12,8,14300.74,8800.64,23101.38
520425,202111,259,131,128,144128.72,141929.44,286058.16
520430,202111,513,245,268,270727.41,294814.12,565541.53
520440,202111,662,475,187,522583.35,206831.26,729414.61
520450,202111,2040,860,1180,948334.6,1298184.48,2246519.08
520455,202111,56,33,23,36307.84,25308.35,61616.19
520460,202111,34,20,14,22004.52,15402.47,37406.99
520465,202111,30,25,5,27501.31,5500,33001.31
520470,202111,433,274,159,301445.51,174922.26,476367.77
520480,202111,83,47,36,51714.05,39610.69,91324.74
520485,202111,102,37,65,40705.97,71510.27,112216.24
520490,202111,427,318,109,349854.04,119923.62,469777.66
520495,202111,157,91,66,100105.79,72601.9,172707.69
520500,202111,188,147,41,162823.37,45104.67,207928.04
520505,202111,196,116,80,127605.41,88002.32,215607.73
520510,202111,1860,878,982,965955.01,1081465.37,2047420.38
520520,202111,48,33,15,36302.53,16500.44,52802.97
520530,202111,210,165,45,181551.14,49511.33,231062.47
520540,202111,625,419,206,462057.16,226627.44,688684.60
520545,202111,136,75,61,82519.53,67115.66,149635.19
520547,202111,59,34,25,37406.25,27508.33,64914.58
520549,202111,1318,601,717,662291.38,788825.35,1451116.73
520551,202111,324,165,159,181525.22,174922.48,356447.70
520552,202111,33,23,10,25303.71,11002.07,36305.78
520570,202111,13,8,5,8800,5500,14300
520580,202111,271,168,103,184834.31,113318.54,298152.85
520590,202111,137,77,60,84712.09,66007.13,150719.22
520620,202111,1123,517,606,568794.66,667811.51,1236606.17
520630,202111,45,23,22,25300.78,24200,49500.78
520640,202111,372,217,155,239835.92,170517.94,410353.86
520650,202111,66,33,33,36300.88,36301.55,72602.43
520660,202111,41,21,20,23101.28,22002.27,45103.55
520670,202111,38,30,8,33001.66,8800,41801.66
520680,202111,43,26,17,28608.56,18704.75,47313.31
520690,202111,39,10,29,11002.17,31902.82,42904.99
520710,202111,36,31,5,34100.59,5500.44,39601.03
520725,202111,194,144,50,158429.41,55010.52,213439.93
520735,202111,54,35,19,38500.77,20901.95,59402.72
520740,202111,453,223,230,245329.25,253030.44,498359.69
520750,202111,34,25,9,27500.48,9900,37400.48
520753,202111,72,50,22,55002.56,24201.17,79203.73
520760,202111,104,68,36,74809.46,39607.38,114416.84
520780,202111,270,206,64,226636.76,70408.29,297045.05
520790,202111,158,91,67,101201.3,74801.24,176002.54
520800,202111,3395,1867,1528,2056277.34,1684395.46,3740672.80
520810,202111,147,113,34,124314.86,37405.99,161720.85
520815,202111,4,3,1,3301.38,1100,4401.38
520830,202111,148,101,47,111121.04,51711.97,162833.01
520840,202111,382,246,136,270609.03,149604.13,420213.16
520850,202111,101,58,43,64916.56,47307.68,112224.24
520860,202111,1754,1117,637,1228863.43,700789.96,1929653.39
520870,202111,31800,14631,17169,16110034.54,18905525.19,35015559.73
520880,202111,1179,631,548,695308.97,605101.43,1300410.40
520890,202111,782,478,304,529160.95,336648.62,865809.57
520910,202111,964,509,455,559997.17,500603.01,1060600.18
520915,202111,86,68,18,74821.7,19804.02,94625.72
520920,202111,440,208,232,228839.02,255244.87,484083.89
520929,202111,18,16,2,17603.31,2200.44,19803.75
520940,202111,67,47,20,51703.23,22004.03,73707.26
520945,202111,13,9,4,9900,4400.84,14300.84
520960,202111,39,25,14,27502.28,15400.05,42902.33
520970,202111,368,215,153,236530.37,168326.3,404856.67
520980,202111,91,66,25,72600.6,27500,100100.6
520990,202111,440,308,132,338827.79,145209.1,484036.89
520993,202111,128,65,63,71515.49,69321.27,140836.76
520995,202111,253,140,113,154027.84,124321.72,278349.56
521000,202111,1546,903,643,995658.91,707414.3,1703073.21
521010,202111,672,345,327,379546.76,359765.4,739312.16
521015,202111,14,9,5,9901.97,5500.66,15402.63
521020,202111,1374,954,420,1049559.87,463177.08,1512736.95
521030,202111,57,36,21,39601.7,23100.44,62702.14
521040,202111,928,607,321,668875.16,353154.91,1022030.07
521056,202111,49,32,17,35202.69,18700.22,53902.91
521060,202111,127,83,44,91317.59,48408.12,139725.71
521080,202111,360,278,82,305866.73,90221.82,396088.55
521090,202111,559,363,196,399338.97,215630.37,614969.34
521100,202111,256,190,66,210123.25,72609.46,282732.71
521120,202111,1052,734,318,807498.34,349837.31,1157335.65
521130,202111,345,250,95,275044.66,104523.74,379568.40
521140,202111,181,97,84,106718.47,92413.52,199131.99
521150,202111,2574,1093,1481,1204685.98,1629378.25,2834064.23
521160,202111,24,10,14,11000.99,15403.13,26404.12
521170,202111,221,129,92,141908,101209.7,243117.7
521180,202111,1175,749,426,824045.57,468701.73,1292747.30
521190,202111,2515,1057,1458,1163983.47,1604052.6,2768036.07
521200,202111,55,40,15,44000.98,16500,60500.98
521205,202111,10,7,3,7700,3300.34,11000.34
521210,202111,121,75,46,82518.7,50615.72,133134.42
521220,202111,727,512,215,563268.51,237625.02,800893.53
521225,202111,26,19,7,20908.61,7701.71,28610.32
521230,202111,111,67,44,73717.83,48409.16,122126.99
521250,202111,6241,3496,2745,3848658.52,3022373.79,6871032.31
521260,202111,33,15,18,16500.2,19800.5,36300.7
521270,202111,136,103,33,113302.12,36300.89,149603.01
521280,202111,415,256,159,282734.2,174928.77,457662.97
521290,202111,26,18,8,19801.87,8801.05,28602.92
521295,202111,98,65,33,71511.44,36304.69,107816.13
521300,202111,221,122,99,134221.52,108914,243135.52
521305,202111,37,29,8,31906.34,8801.62,40707.96
521308,202111,1011,773,238,850424.18,261838.61,1112262.79
521310,202111,1329,747,582,822992.97,640327.45,1463320.42
521340,202111,20,16,4,17601.32,4400.44,22001.76
521350,202111,115,88,27,96813.63,29706.27,126519.90
521370,202111,162,112,50,123212.49,55004.22,178216.71
521375,202111,183,95,88,104518.71,96818.45,201337.16
521377,202111,50,39,11,42906.53,12102.11,55008.64
521380,202111,1051,638,413,702878.97,455476.9,1158355.87
521385,202111,12,7,5,7700,5500.47,13200.47
521390,202111,99,82,17,91310.09,18701.58,110011.67
521400,202111,349,238,111,261826.07,122111.36,383937.43
521405,202111,144,82,62,90208.91,68207.19,158416.10
521410,202111,75,53,22,58303.2,24201.55,82504.75
521440,202111,198,136,62,149630.31,68216.93,217847.24
521450,202111,751,413,338,455459.09,371856.75,827315.84
521460,202111,1097,722,375,795430.27,414773.96,1210204.23
521470,202111,11,8,3,8801.38,3300.44,12101.82
521480,202111,39,28,11,30807.85,12104.43,42912.28
521483,202111,316,194,122,213422.83,134218.73,347641.56
521486,202111,291,186,105,204608.96,115505.72,320114.68
521487,202111,25,12,13,13202.07,14301.04,27503.11
521490,202111,23,12,11,13200.44,12100.51,25300.95
521500,202111,139,67,72,73713.12,79212.81,152925.93
521520,202111,45,35,10,38500,11000,49500
521523,202111,829,489,340,539050.71,374025.91,913076.62
521525,202111,43,27,16,29700,17600.34,47300.34
521530,202111,237,128,109,140821.55,121015.82,261837.37
521540,202111,39,19,20,20901.43,22001.48,42902.91
521550,202111,97,41,56,45107.15,61607.47,106714.62
521560,202111,831,560,271,619408.06,298144.36,917552.42
521565,202111,66,48,18,52801.08,19800,72601.08
521570,202111,540,343,197,377366.86,217830.04,595196.90
521580,202111,51,32,19,35204.05,22001.18,57205.23
521590,202111,34,15,19,16500.03,20901.68,37401.71
521600,202111,23,12,11,13200,12100.78,25300.78
521630,202111,239,125,114,137529.44,125430.6,262960.04
521640,202111,301,163,138,179318.15,152916.87,332235.02
521645,202111,38,20,18,22002.83,19802.09,41804.92
521680,202111,240,149,91,163920.45,100113.15,264033.60
521690,202111,7,6,1,6600,1100.85,7700.85
521710,202111,1128,535,593,589665.59,652385.81,1242051.40
521720,202111,528,367,161,403749.52,177122.86,580872.38
521730,202111,656,310,346,341043.77,380650.22,721693.99
521740,202111,885,387,498,427947.47,548979.66,976927.13
521760,202111,2192,1146,1046,1261958.93,1151908.78,2413867.71
521770,202111,808,506,302,556655.28,332237.63,888892.91
521800,202111,1920,1248,672,1372958.54,739293.33,2112251.87
521805,202111,31,17,14,18702.44,15401.57,34104.01
521810,202111,92,54,38,59414.74,42909.16,102323.90
521830,202111,967,685,282,753607.58,310255.41,1063862.99
521839,202111,83,48,35,52805.23,38503.72,91308.95
521850,202111,1112,557,555,612831,610624.69,1223455.69
521860,202111,321,204,117,225532.72,128720.09,354252.81
521870,202111,74,46,28,50601.76,30800.71,81402.47
521878,202111,37,14,23,15400.88,25301,40701.88
521880,202111,4816,2126,2690,2342321.11,2959541.31,5301862.42
521890,202111,596,409,187,449958.24,205719.54,655677.78
521900,202111,278,221,57,243117.84,62705.15,305822.99
521910,202111,167,115,52,126530.82,57215.25,183746.07
521920,202111,44,23,21,25300.99,23106.92,48407.91
521925,202111,53,32,21,35201.61,23100,58301.61
521930,202111,1163,647,516,712921.91,569892.49,1282814.40
521935,202111,30,21,9,23107.07,9900.92,33007.99
521940,202111,209,94,115,103417.76,126518.35,229936.11
521945,202111,16,13,3,14302.1,3300.5,17602.6
521950,202111,10,6,4,6600,4400,11000
521960,202111,69,52,17,57200,18700.44,75900.44
521970,202111,405,259,146,284926.51,161711.69,446638.20
521971,202111,109,57,52,62703.96,57204.56,119908.52
521973,202111,37,19,18,20902.31,19801.32,40703.63
521975,202111,1569,795,774,874646.15,851553.1,1726199.25
521980,202111,243,162,81,178225.68,89111.74,267337.42
521990,202111,76,55,21,60510.46,23103.06,83613.52
522000,202111,287,186,101,204249.47,111122.76,315372.23
522005,202111,19,12,7,13201.05,7700.61,20901.66
522010,202111,1117,633,484,696399.55,534685.92,1231085.47
522015,202111,62,37,25,40703.17,27500.89,68204.06
522020,202111,881,512,369,565461.75,405937.95,971399.70
522026,202111,27,18,9,19800.91,9900.44,29701.35
522028,202111,16,12,4,13201.84,4400.44,17602.28
522040,202111,780,326,454,358669.13,499511.34,858180.47
522045,202111,2489,1490,999,1640385.6,1099115.76,2739501.36
522050,202111,154,74,80,81417.66,88015.19,169432.85
522060,202111,540,342,198,377344.27,217828.21,595172.48
522068,202111,105,72,33,79201.3,36300,115501.3
522070,202111,10,10,0,11000,,11000.0
522100,202111,33,21,12,23100.44,13200,36300.44
522108,202111,45,34,11,37404.83,12101.63,49506.46
522119,202111,58,33,25,36300.81,27500.67,63801.48
522130,202111,74,27,47,29709.56,51714.74,81424.30
522140,202111,4039,2076,1963,2283925.22,2161801.14,4445726.36
522145,202111,45,34,11,37401.65,12103.5,49505.15
522150,202111,104,69,35,75904.55,38502.02,114406.57
522155,202111,51,39,12,42902.06,13201.62,56103.68
522157,202111,7,5,2,5500.21,2200,7700.21
522160,202111,1670,996,674,1095764.79,741525.6,1837290.39
522170,202111,395,264,131,290434.69,144123.41,434558.10
522180,202111,33,12,21,14303.64,23102.62,37406.26
522185,202111,2223,920,1303,1012154.41,1435808.01,2447962.42
522190,202111,60,33,27,36304.03,29702.66,66006.69
522200,202111,301,178,123,195821.17,136413.39,332234.56
522205,202111,146,99,47,108920.72,52811.05,161731.77
522220,202111,136,100,36,110007.1,39601.3,149608.4
522230,202111,29,25,4,27503.57,4401.13,31904.70
530010,202111,54478,27491,26987,30275687.84,29719852.56,59995540.40
110001,202112,501,404,97,445500,106700,552200
110002,202112,2822,1786,1036,1966800.49,1142900,3109700.49
110003,202112,79,64,15,70400,16500,86900
110004,202112,1998,1336,662,1470700,729300,2200000
110005,202112,422,338,84,371800,92400,464200
110006,202112,434,328,106,360800,116600,477400
110007,202112,70,56,14,61600,15400,77000
110008,202112,246,137,109,151800,119900,271700
110009,202112,908,683,225,752400,250800,1003200
110010,202112,1657,981,676,1080200.19,745800,1826000.19
110011,202112,1683,1310,373,1442100,410300,1852400
110012,202112,4041,2350,1691,2587200,1863400.44,4450600.44
110013,202112,734,580,154,638000,169400,807400
110014,202112,364,320,44,353100,48400,401500
110015,202112,1341,1058,283,1166000,311300,1477300
110018,202112,1039,637,402,704000,443300,1147300
110020,202112,15668,8870,6798,9780101.6,7503100,17283201.6
110025,202112,647,469,178,515900,195800,711700
110026,202112,37,24,13,26400,14300,40700
110028,202112,1572,1118,454,1229800,499400,1729200
110029,202112,129,117,12,128700,13200,141900
110030,202112,2373,1572,801,1729024.55,881101.77,2610126.32
110032,202112,304,231,73,256300,80300,336600
110033,202112,644,464,180,511500,198000,709500
110034,202112,329,241,88,265100.5,96800,361900.5
110037,202112,88,79,9,86900,9900,96800
110040,202112,386,268,118,295900,130900,426800
110045,202112,920,638,282,702900,311300,1014200
110050,202112,86,75,11,82500,12100,94600
110060,202112,60,35,25,38500,27500,66000
110070,202112,105,67,38,73700,41800,115500
110080,202112,509,286,223,314600,245300,559900
110090,202112,25,21,4,23100,4400,27500
110092,202112,109,58,51,64900,56100,121000
110094,202112,194,138,56,154000,61600,215600
110100,202112,45,30,15,33000,16500,49500
110110,202112,94,53,41,58300,45100,103400
110120,202112,66,58,8,63800,8800,72600
110130,202112,270,218,52,239800,57200,297000
110140,202112,240,172,68,189200,74800,264000
110143,202112,51,42,9,46200,9900,56100
110145,202112,37,29,8,31900,8800,40700
110146,202112,23,11,12,12100,13200,25300
110147,202112,39,27,12,29700,13200,42900
110148,202112,36,27,9,29700,9900,39600
110149,202112,313,222,91,244200,101200,345400
110150,202112,133,101,32,111100,35200,146300
110155,202112,11,10,1,11000,1100,12100
110160,202112,65,51,14,56100,15400,71500
110170,202112,213,163,50,180400,55000,235400
110175,202112,61,47,14,51700,15400,67100
110180,202112,95,77,18,84700,19800,104500
120001,202112,191,144,47,158400.55,51700,210100.55
120005,202112,197,113,84,124300.41,92400,216700.41
120010,202112,1121,687,434,755700,477400,1233100
120013,202112,149,101,48,111100,52800,163900
120017,202112,114,63,51,69300,56100,125400
120020,202112,3448,2792,656,3073477.85,721613.2,3795091.05
120025,202112,542,303,239,333300.95,262900,596200.95
120030,202112,1042,896,146,986750.85,160609.35,1147360.20
120032,202112,37,33,4,36300,4400,40700
120033,202112,215,188,27,206807.7,29700.55,236508.25
120034,202112,173,127,46,139700,50600,190300
120035,202112,38,32,6,35200,6600,41800
120038,202112,405,260,145,286003.3,159500.55,445503.85
120039,202112,28,28,0,30801.65,,30801.65
120040,202112,13830,9325,4505,10268692.53,4961344.85,15230037.38
120042,202112,43,38,5,41800,5500.55,47300.55
120043,202112,14,3,11,3300,12100,15400
120045,202112,533,341,192,375101.1,211201.65,586302.75
120050,202112,1240,948,292,1043955.1,321213.2,1365168.3
120060,202112,1437,1191,246,1311256.65,272806.6,1584063.25
120070,202112,407,294,113,323401.15,124300,447701.15
120080,202112,179,112,67,123201.1,73700.55,196901.65
130002,202112,163,119,44,130900,48400,179300
130006,202112,106,70,36,77000,39600,116600
130008,202112,127,70,57,77000,62700,139700
130010,202112,155,93,62,102300,68200,170500
130014,202112,270,193,77,212300,84700,297000
130020,202112,122,78,44,85800,48400,134200
130030,202112,940,534,406,587400,446600,1034000
130040,202112,346,164,182,180400,200200,380600
130050,202112,550,287,263,315700,289300,605000
130060,202112,861,594,267,653400,294800,948200
130063,202112,601,361,240,398200,264000,662200
130068,202112,196,120,76,132000,83600,215600
130070,202112,1330,894,436,984500.55,481800,1466300.55
130080,202112,689,457,232,502700,255200,757900
130083,202112,70,40,30,44000,33000,77000
130090,202112,330,187,143,205700,157300,363000
130100,202112,1190,544,646,598400,710600,1309000
130110,202112,717,314,403,345400,443300,788700
130115,202112,140,65,75,71500,82500,154000
130120,202112,1598,998,600,1098900,660000,1758900
130130,202112,601,413,188,454300,206800,661100
130140,202112,1540,1195,345,1314500,379500,1694000
130150,202112,398,354,44,389400,48400,437800
130160,202112,421,244,177,268400,194700,463100
130165,202112,51,40,11,44000,12100,56100
130170,202112,1010,699,311,769929.6,342100.9,1112030.5
130180,202112,244,177,67,194700,73700,268400
130185,202112,2189,1013,1176,1115400,1293600,2409000
130190,202112,3343,2102,1241,2313300,1370600,3683900
130195,202112,280,224,56,246400,61600,308000
130200,202112,170,80,90,88000,99000,187000
130210,202112,91,47,44,51700,48400,100100
130220,202112,197,141,56,155100,61600,216700
130230,202112,365,236,129,259600,141900,401500
130240,202112,1318,854,464,940500,511500,1452000
130250,202112,4974,3132,1842,3447400,2026200,5473600
130255,202112,411,205,206,225500,226600,452100
130260,202112,58593,27570,31023,30345612.29,34145331,64490943.29
130270,202112,1521,1035,486,1139699,534600,1674299
130280,202112,129,75,54,83600,59400,143000
130290,202112,2087,1405,682,1545500,750200,2295700
130300,202112,419,284,135,312400,148500,460900
130310,202112,903,481,422,529100,464200,993300
130320,202112,522,274,248,301400,272800,574200
130330,202112,760,478,282,525800,310200,836000
130340,202112,3359,1886,1473,2075700,1621400,3697100
130350,202112,472,326,146,358600,160600,519200
130353,202112,923,407,516,451000,570900,1021900
130356,202112,772,339,433,374000,476300,850300
130360,202112,85,66,19,72600,20900,93500
130370,202112,678,524,154,576400,169400,745800
130380,202112,644,503,141,553300,155100,708400
130390,202112,469,383,86,421300,94600,515900
130395,202112,158,43,115,47300,126500,173800
130400,202112,69,48,21,52800,23100,75900
130406,202112,2187,1285,902,1413500,992200,2405700
130410,202112,440,222,218,244200,239800,484000
130420,202112,2785,2262,523,2489300,576400,3065700
130423,202112,161,87,74,95700,81400,177100
130426,202112,183,99,84,108900,92400,201300
130430,202112,404,238,166,261800,182600,444400
130440,202112,205,65,140,71500,154000,225500
140002,202112,24,4,20,4400,22000,26400
140005,202112,210,126,84,138600,92400,231000
140010,202112,11257,6942,4315,7641703.42,4752000.91,12393704.33
140015,202112,145,65,80,71500,88000,159500
140017,202112,126,70,56,77000,61600,138600
140020,202112,444,288,156,316800,171600,488400
140023,202112,40,21,19,23100,20900,44000
140028,202112,22,11,11,12100,12100,24200
140030,202112,359,239,120,262900,133100,396000
140040,202112,62,44,18,48400,19800,68200
140045,202112,261,101,160,111100,176000,287100
140047,202112,459,301,158,331100,173800,504900
140050,202112,138,84,54,92400,59400,151800
140060,202112,64,40,24,45100,26400,71500
140070,202112,31,29,2,31900,2200,34100
150010,202112,4867,2925,1942,3217500,2136200,5353700
150013,202112,164,116,48,127600,52800,180400
150020,202112,1097,600,497,660000,546700,1206700
150030,202112,695,310,385,341000.02,423500,764500.02
150034,202112,203,127,76,139700,84700,224400
150040,202112,1531,873,658,962500,723800,1686300
150050,202112,684,388,296,426800,325600,752400
150060,202112,4831,3038,1793,3345007,1976055.4,5321062.4
150070,202112,439,228,211,250800,232100,482900
150080,202112,16137,7502,8635,8255500.2,9506200,17761700.2
150085,202112,419,269,150,295900,166100,462000
150090,202112,687,577,110,634700,121000,755700
150095,202112,42,28,14,30800,15400,46200
150100,202112,69,43,26,47300,28600,75900
150110,202112,213,119,94,132000,103400,235400
150120,202112,390,282,108,311300,118800,430100
150125,202112,48,17,31,18700,34100,52800
150130,202112,2110,1075,1035,1184700,1140700,2325400
150140,202112,57665,25351,32314,27908100.13,35576200.7,63484300.83
150145,202112,236,128,108,140800,118800,259600
150150,202112,3236,1419,1817,1563100,1998700,3561800
150157,202112,367,258,109,283800,119900,403700
150160,202112,131,99,32,108900,35200,144100
150170,202112,3864,2816,1048,3100900,1153900,4254800
150172,202112,347,242,105,266200,115500,381700
150175,202112,80,44,36,48400,40700,89100
150178,202112,751,505,246,555500.33,270600,826100.33
150180,202112,3208,1568,1640,1724800,1806200,3531000
150190,202112,363,234,129,257400,141900,399300
150195,202112,113,61,52,67100,57200,124300
150200,202112,186,92,94,101200,103400,204600
150210,202112,3213,2533,680,2787400,748000,3535400
150215,202112,604,376,228,413600,250800,664400
150220,202112,3521,2332,1189,2568500.82,1309000,3877500.82
150230,202112,1307,1036,271,1139600.5,298100,1437700.5
150240,202112,6807,3821,2986,4206400.6,3290100,7496500.6
150250,202112,69,38,31,41800,34100,75900
150260,202112,106,70,36,77000,39600,116600
150270,202112,2158,1388,770,1529000,848100,2377100
150275,202112,532,335,197,368500,216700,585200
150276,202112,112,41,71,45100,78100,123200
150277,202112,818,366,452,403700,497200,900900
150280,202112,368,249,119,273900,130900,404800
150285,202112,125,64,61,70400,66924,137324
150290,202112,1183,680,503,748000,553300,1301300
150293,202112,742,342,400,376200,440000,816200
150295,202112,536,245,291,270600,321200,591800
150300,202112,93,44,49,48400,53900,102300
150304,202112,191,110,81,121000,89100,210100
150307,202112,418,348,70,382800,77000,459800
150309,202112,585,411,174,453200,192500.34,645700.34
150310,202112,264,173,91,190300,100100,290400
150320,202112,1856,1290,566,1420100.5,622600,2042700.5
150330,202112,2057,1185,872,1303500,959200,2262700
150340,202112,198,133,65,146300,71500,217800
150345,202112,633,352,281,387200,309100,696300
150350,202112,400,318,82,349800,90200,440000
150360,202112,4757,2860,1897,3148200,2091100,5239300
150370,202112,827,566,261,622600,288200,910800
150375,202112,199,93,106,102300,116600,218900
150380,202112,1525,1009,516,1109900,567600,1677500
150390,202112,854,487,367,536800,403700,940500
150400,202112,110,91,19,100100,22000,122100
150405,202112,1584,999,585,1100000,644600,1744600
150410,202112,117,73,44,80300,48400,128700
150420,202112,7601,4088,3513,4499179.3,3870900,8370079.3
150430,202112,631,395,236,434500,259600,694100
150440,202112,452,280,172,308000,189200,497200
150442,202112,2320,1220,1100,1343100,1210000,2553100
150445,202112,541,350,191,385000,211200,596200
150450,202112,216,121,95,133100,104500,237600
150460,202112,715,535,180,588500,198000,786500
150470,202112,1295,771,524,848100,576400,1424500
150475,202112,241,185,56,203500,61600,265100
150480,202112,1368,943,425,1037300,467500,1504800
150490,202112,609,357,252,392700,277200,669900
150495,202112,338,254,84,279400,92400,371800
150497,202112,284,194,90,214500,99000,313500
150500,202112,249,149,100,163900,112200,276100
150503,202112,1270,625,645,688600,710600,1399200
150506,202112,915,620,295,682000,325600,1007600
150510,202112,1306,702,604,774400,668800,1443200
150520,202112,317,218,99,239800,108900,348700
150530,202112,1849,1020,829,1122000,911900,2033900
150540,202112,200,147,53,161700,58300,220000
150543,202112,845,429,416,473000,458700,931700
150548,202112,456,327,129,359700,144100,503800
150549,202112,72,46,26,50600,28600,79200
150550,202112,3042,1503,1539,1654400,1692900,3347300
150553,202112,3442,1934,1508,2128500,1661000,3789500
150555,202112,142,77,65,84700,71500,156200
150560,202112,48,22,26,24200,28600,52800
150563,202112,126,63,63,69300,69300,138600
150565,202112,206,129,77,143000,84700,227700
150570,202112,431,285,146,313500,160600,474100
150580,202112,1704,819,885,900900,973500,1874400
150590,202112,823,537,286,590700,314600,905300
150600,202112,518,308,210,338800,231000,569800
150610,202112,154,124,30,136400,33000,169400
150611,202112,127,84,43,92400,47300,139700
150613,202112,3284,1861,1423,2047100,1566451,3613551
150616,202112,560,308,252,339900,277200,617100
150618,202112,1372,702,670,772200,739200,1511400
150619,202112,390,296,94,326700,103400,430100
150620,202112,1245,724,521,796400,573100,1369500
150630,202112,139,92,47,101200,51700,152900
150635,202112,447,194,253,213400,278300,491700
150640,202112,41,22,19,24200,20900,45100
150650,202112,2415,1384,1031,1522400,1135200,2657600
150655,202112,248,181,67,199100,73700,272800
150658,202112,83,50,33,55000,36300,91300
150660,202112,568,367,201,404800,222200,627000
150670,202112,1130,393,737,433400,811800,1245200
150680,202112,10563,5490,5073,6043401.48,5586900.26,11630301.74
150690,202112,26,13,13,14300,14300,28600
150700,202112,498,323,175,355300,192500,547800
150710,202112,295,172,123,189200,135300,324500
150715,202112,841,528,313,581900,344300,926200
150720,202112,417,315,102,347600,112200,459800
150730,202112,1068,522,546,574200,601700,1175900
150740,202112,234,153,81,168300,90200,258500
150745,202112,752,420,332,462000,365200,827200
150746,202112,67,34,33,37400,36300,73700
150747,202112,241,177,64,194700,70400,265100
150750,202112,136,74,62,81400,68200,149600
150760,202112,1814,1167,647,1283700.5,711700,1995400.5
150770,202112,392,223,169,245300,185900,431200
150775,202112,105,55,50,60500,55000,115500
150780,202112,192,111,81,122100,89100,211200
150790,202112,661,373,288,410300,320100,730400
150795,202112,1616,970,646,1067000,710600,1777600
150796,202112,329,187,142,205700,157300,363000
150797,202112,380,178,202,195800,222200,418000
150800,202112,1547,862,685,949300,753500,1702800
150803,202112,524,414,110,455400,121000,576400
150805,202112,209,122,87,134200,95700,229900
150808,202112,1044,537,507,591800,558800,1150600
150810,202112,3222,2189,1033,2409000.5,1138500,3547500.5
150812,202112,487,250,237,275000,260700,535700
150815,202112,1137,704,433,774400,477400,1251800
150820,202112,1545,939,606,1032900,666600,1699500
150830,202112,551,407,144,447700,159500,607200
150835,202112,226,131,95,144100,104500,248600
150840,202112,1404,840,564,924000,621500,1545500
160005,202112,62,43,19,47300.06,20900.04,68200.10
160010,202112,196,124,72,136400.12,79200.08,215600.20
160015,202112,142,86,56,95700.06,61600,157300.06
160020,202112,137,73,64,80300.06,70400,150700.06
160021,202112,69,29,40,31900.04,44000.02,75900.06
160023,202112,67,43,24,47300.08,26400.04,73700.12
160025,202112,24,11,13,12100.02,14300.04,26400.06
160027,202112,1472,829,643,911901.88,707300.98,1619202.86
160030,202112,16430,8425,8005,9274113.61,8808809.68,18082923.29
160040,202112,291,173,118,190300.12,129800.02,320100.14
160050,202112,731,358,373,393800.22,410300.04,804100.26
160053,202112,286,170,116,187000.26,127600.14,314600.40
160055,202112,22,14,8,15400.02,8800.02,24200.04
160060,202112,6609,3509,3100,3861009.77,3415506.48,7276516.25
160070,202112,186,111,75,122100.02,83600.02,205700.04
160080,202112,121,61,60,67100,67100,134200
170025,202112,28,14,14,15400,15400,30800
170030,202112,193,157,36,172700.03,39600,212300.03
170035,202112,201,95,106,105600,116600,222200
170040,202112,174,128,46,141900,50600,192500
170070,202112,318,201,117,221173.33,128700,349873.33
170100,202112,345,254,91,279400,100100,379500
170105,202112,48,40,8,44000,8800,52800
170110,202112,117,69,48,75900,52800,128700
170130,202112,72,37,35,40700,38500,79200
170190,202112,97,56,41,61600,45100,106700
170200,202112,346,239,107,262900,117700,380600
170210,202112,6334,3346,2988,3681434.25,3293400.8,6974835.05
170215,202112,136,71,65,79200,71500,150700
170220,202112,1349,983,366,1081300,402600,1483900
170230,202112,143,94,49,103400,53900,157300
170240,202112,504,337,167,370700,183700,554400
170255,202112,1040,846,194,930600,213400,1144000
170270,202112,48,34,14,37400,15400,52800
170290,202112,125,79,46,86900,50600,137500
170300,202112,106,67,39,73700,42900,116600
170305,202112,47,36,11,39600,12100,51700
170307,202112,57,43,14,47300,15400,62700
170310,202112,121,70,51,77000,56100,133100
170320,202112,31,19,12,20900,13200,34100
170330,202112,29,22,7,24200,7700,31900
170360,202112,32,18,14,19800,15400,35200
170370,202112,89,45,44,49500,48400,97900
170380,202112,71,55,16,60500,17600,78100
170382,202112,36,31,5,34100,5500,39600
170384,202112,141,108,33,118800,36300,155100
170386,202112,70,30,40,33000,44000,77000
170388,202112,48,20,28,22000,30800,52800
170389,202112,24,20,4,22000,4400,26400
170390,202112,74,46,28,50600,30800,81400
170410,202112,24,22,2,24200,2200,26400
170460,202112,15,9,6,9900,6600,16500
170510,202112,32,24,8,26400,8800,35200
170550,202112,1535,885,650,975700,716100,1691800
170555,202112,105,78,27,85800,29700,115500
170560,202112,105,75,30,82500,33000,115500
170600,202112,39,11,28,12100,30800,42900
170610,202112,188,99,89,108900,97900,206800
170625,202112,33,19,14,20900,15400,36300
170650,202112,87,61,26,67100,28600,95700
170700,202112,578,429,149,471900,163900,635800
170710,202112,147,95,52,104500,57200,161700
170720,202112,98,76,22,83600,24200,107800
170730,202112,96,56,40,61600,44000,105600
170740,202112,87,61,26,67100,28600,95700
170755,202112,53,28,25,30800,27500,58300
170765,202112,135,74,61,81400,67100,148500
170770,202112,191,122,69,135300,75900,211200
170820,202112,591,389,202,427900,222200,650100
170825,202112,41,22,19,24200,20900,45100
170830,202112,89,72,17,79200,18700,97900
170900,202112,169,130,39,143000,42900,185900
170930,202112,924,505,419,555500,462000,1017500
170950,202112,3158,1468,1690,1615900,1863400.4,3479300.4
170980,202112,17,10,7,11000,7700,18700
171050,202112,146,108,38,118800,41800,160600
171070,202112,50,43,7,47300,7700,55000
171090,202112,48,35,13,38500,14300,52800
171110,202112,23,17,6,18700,6600,25300
171150,202112,43,24,19,26400,20900,47300
171180,202112,26,11,15,12100,16500,28600
171190,202112,168,96,72,105600,79200,184800
171195,202112,60,50,10,55000,11000,66000
171200,202112,40,19,21,20900,23100,44000
171215,202112,7,5,2,5500,2200,7700
171240,202112,62,45,17,49500,18700,68200
171245,202112,58,49,9,53900,9900,63800
171250,202112,74,42,32,46200,35200,81400
171270,202112,14,10,4,11000,4400,15400
171280,202112,43,35,8,38500,8800,47300
171320,202112,985,559,426,614900,469700,1084600
171330,202112,414,208,206,228800,227700,456500
171360,202112,95,66,29,72600,31900,104500
171370,202112,38,20,18,22000,19800,41800
171380,202112,130,112,18,124300,19800,144100
171395,202112,43,24,19,26400,20900,47300
171420,202112,266,175,91,192500,100100,292600
171430,202112,74,60,14,66000,15400,81400
171488,202112,205,113,92,124300,101200,225500
171500,202112,65,35,30,38500,33000,71500
171510,202112,74,48,26,52800,28600,81400
171515,202112,38,31,7,34100,7700,41800
171525,202112,26,23,3,25300,3300,28600
171550,202112,15,9,6,9900,6600,16500
171570,202112,51,25,26,27500,28600,56100
171575,202112,272,180,92,198000,101200,299200
171610,202112,1757,880,877,971300,964700,1936000
171620,202112,144,97,47,107800,51700,159500
171630,202112,53,30,23,33000,25300,58300
171650,202112,331,227,104,249700,114400,364100
171660,202112,251,145,106,159500,116600,276100
171665,202112,77,48,29,52800,31900,84700
171670,202112,423,254,169,280500,185900,466400
171700,202112,65,56,9,62700,9900,72600
171720,202112,29,11,18,12100,19800,31900
171750,202112,109,55,54,60500,60500,121000
171780,202112,75,57,18,62700,19800,82500
171790,202112,83,68,15,74800,16500,91300
171800,202112,34,26,8,28600,8800,37400
171820,202112,2040,1177,863,1296900.7,951500,2248400.7
171830,202112,34,24,10,26400,11000,37400
171840,202112,60,40,20,44000,23100,67100
171845,202112,31,20,11,23100,12100,35200
171850,202112,36,30,6,33000,6600,39600
171855,202112,76,58,18,63800,19800,83600
171865,202112,7,6,1,6600,1100,7700
171870,202112,31,19,12,20900,13200,34100
171875,202112,80,57,23,62700,25300,88000
171880,202112,35,21,14,24200,15400,39600
171884,202112,49,28,21,30800,23100,53900
171886,202112,134,60,74,66000,81400,147400
171888,202112,25,20,5,22000,5500,27500
171889,202112,11,5,6,5500,6600,12100
171890,202112,54,45,9,49500,9900,59400
171900,202112,31,22,9,24200,9900,34100
172000,202112,35,29,6,31900,6600,38500
172010,202112,55,45,10,49500,11000,60500
172015,202112,21,15,6,16500,6600,23100
172020,202112,146,93,53,102300,59400,161700
172025,202112,38,25,13,27500,14300,41800
172030,202112,44,25,19,27500,20900,48400
172049,202112,82,52,30,57200,33000,90200
172065,202112,121,79,42,86900,47300,134200
172080,202112,116,70,46,77000,50600,127600
172085,202112,29,14,15,15400,16500,31900
172090,202112,428,316,112,347600.56,123200,470800.56
172093,202112,16,13,3,14300,3300,17600
172097,202112,19,11,8,12100,8800,20900
172100,202112,5342,2994,2348,3298900,2587200,5886100
172110,202112,86,54,32,59400,35200,94600
172120,202112,1707,1426,281,1568600,309100,1877700
172125,202112,12,10,2,11000,2200,13200
172130,202112,24,13,11,14300,12100,26400
172208,202112,202,123,79,135300,86900,222200
172210,202112,373,187,186,205700,204600,410300
210005,202112,2941,1845,1096,2029500.32,1206700,3236200.32
210010,202112,143,88,55,96800,60500,157300
210015,202112,41,29,12,31900,13200,45100
210020,202112,356,206,150,227700,165000,392700
210030,202112,315,208,107,229900,117700,347600
210040,202112,134,110,24,121000,26400,147400
210043,202112,251,197,54,216700,59400,276100
210047,202112,498,305,193,336600,212300,548900
210050,202112,278,208,70,228800,77000,305800
210055,202112,51,43,8,47300,8800,56100
210060,202112,536,437,99,481800,108900,590700
210070,202112,434,338,96,371800,105600,477400
210080,202112,134,123,11,135300,12100,147400
210083,202112,284,142,142,156200,156200,312400
210087,202112,4,3,1,3300,1100,4400
210090,202112,430,308,122,338800,134200,473000
210095,202112,409,317,92,348700,101200,449900
210100,202112,689,546,143,600600,157300,757900
210110,202112,119,80,39,88000,42900,130900
210120,202112,4881,3856,1025,4244900,1128600,5373500
210125,202112,182,109,73,119900,80300,200200
210130,202112,451,268,183,294800,201300,496100
210135,202112,28,21,7,23100,7700,30800
210140,202112,4458,3449,1009,3796100,1109900,4906000
210150,202112,359,227,132,249700,145200,394900
210160,202112,3232,2761,471,3038200.54,519200,3557400.54
210170,202112,1182,953,229,1049400,253000,1302400
210173,202112,123,108,15,118800,16500,135300
210177,202112,331,189,142,207900,156200,364100
210180,202112,29,16,13,17600,14300,31900
210190,202112,435,289,146,317900,160600,478500
210193,202112,7,5,2,5500,2200,7700
210197,202112,70,52,18,57200,19800,77000
210200,202112,602,511,91,563200,100100,663300
210203,202112,210,149,61,163900,67100,231000
210207,202112,359,299,60,328900,66000,394900
210210,202112,716,660,56,728200,61600,789800
210215,202112,68,60,8,66000,8800,74800
210220,202112,373,318,55,349800,60500,410300
210230,202112,303,244,59,268400,64900,333300
210232,202112,1276,886,390,976800,430100,1406900
210235,202112,181,140,41,154000,45100,199100
210237,202112,35,20,15,22000,16500,38500
210240,202112,78,66,12,72600,13200,85800
210250,202112,173,146,27,160600,29700,190300
210255,202112,358,273,85,301400,93500,394900
210260,202112,394,273,121,300300,133100,433400
210270,202112,626,425,201,467500,221100,688600
210275,202112,84,65,19,71500,20900,92400
210280,202112,1045,688,357,756800,392700,1149500
210290,202112,518,354,164,389400,180400,569800
210300,202112,4989,3202,1787,3524400.98,1965700,5490100.98
210310,202112,105,75,30,82500,33000,115500
210312,202112,115,80,35,88000,38500,126500
210315,202112,108,92,16,101200,17600,118800
210317,202112,137,104,33,114400,36300,150700
210320,202112,2291,1973,318,2170300,349800,2520100
210325,202112,143,85,58,93500,63800,157300
210330,202112,4296,2532,1764,2786300,1941500,4727800
210340,202112,1203,916,287,1007600,315700,1323300
210350,202112,645,531,114,585200,125400,710600
210355,202112,143,123,20,135300,22000,157300
210360,202112,2093,1480,613,1630200,676500,2306700
210370,202112,1214,612,602,674300,662200,1336500
210375,202112,189,95,94,104500,103400,207900
210380,202112,719,559,160,616000,176000,792000
210390,202112,193,164,29,181500,31900,213400
210400,202112,392,340,52,374000,57200,431200
210405,202112,1009,710,299,782100,330000,1112100
210407,202112,62,49,13,55000,14300,69300
210408,202112,39,34,5,37400,5500,42900
210409,202112,325,285,40,313500,44000,357500
210410,202112,437,344,93,378400,102300,480700
210420,202112,207,173,34,190300,37400,227700
210430,202112,52,36,16,39600,17600,57200
210440,202112,368,251,117,276100,128700,404800
210450,202112,101,83,18,91300,19800,111100
210455,202112,235,125,110,137500,122100,259600
210460,202112,300,206,94,226600,103400,330000
210462,202112,61,52,9,57200,9900,67100
210465,202112,136,108,28,119900,30800,150700
210467,202112,506,379,127,416900,139700,556600
210470,202112,46,39,7,42900,7700,50600
210480,202112,1278,916,362,1008700,398200,1406900
210490,202112,185,127,58,139700,63800,203500
210500,202112,488,303,185,333300,203500,536800
210510,202112,519,422,97,465300,106700,572000
210515,202112,348,221,127,243100,139700,382800
210520,202112,401,364,37,400400,40700,441100
210530,202112,9446,4910,4536,5405401.38,4989600.83,10395002.21
210535,202112,123,93,30,102300,33000,135300
210540,202112,1476,999,477,1100000,524700,1624700
210542,202112,1126,572,554,629200,610500,1239700
210545,202112,19,17,2,18700,2200,20900
210547,202112,120,107,13,117700,14300,132000
210550,202112,606,434,172,477400,189200,666600
210560,202112,147,128,19,140800,20900,161700
210565,202112,21,15,6,16500,6600,23100
210570,202112,1277,1056,221,1161600.59,243100,1404700.59
210580,202112,119,101,18,111100,19800,130900
210590,202112,713,598,115,658900,126500,785400
210592,202112,41,38,3,41800,3300,45100
210594,202112,105,89,16,97900,17600,115500
210596,202112,112,96,16,105600,17600,123200
210598,202112,140,106,34,116600,37400,154000
210600,202112,306,264,42,290400,46200,336600
210610,202112,248,233,15,256300,16500,272800
210620,202112,43,26,17,28600,18700,47300
210630,202112,71,65,6,71500,6600,78100
210632,202112,984,706,278,776600,305800,1082400
210635,202112,21,18,3,19800,3300,23100
210637,202112,130,94,36,103400,39600,143000
210640,202112,573,509,64,559900,70400,630300
210650,202112,385,323,62,355300,68200,423500
210660,202112,357,279,78,306900,85800,392700
210663,202112,51,36,15,39600,16500,56100
210667,202112,94,40,54,44000,59400,103400
210670,202112,257,228,29,250800,31900,282700
210675,202112,496,278,218,305800,239800,545600
210680,202112,220,142,78,157300,85800,243100
210690,202112,59,52,7,57200,7700,64900
210700,202112,150,114,36,125400,39600,165000
210710,202112,226,144,82,158400,90200,248600
210720,202112,122,110,12,121000,13200,134200
210725,202112,58,49,9,53900,9900,63800
210730,202112,23,18,5,19800,5500,25300
210735,202112,281,207,74,227700,81400,309100
210740,202112,512,442,70,486200,77000,563200
210745,202112,147,110,37,121000,40700,161700
210750,202112,2464,1266,1198,1392600,1318900,2711500
210760,202112,247,194,53,213400,58300,271700
210770,202112,244,198,46,217800,50600,268400
210780,202112,422,324,98,356400,108900,465300
210790,202112,177,147,30,161700,33000,194700
210800,202112,169,132,37,145200,40700,185900
210805,202112,58,52,6,57200,6600,63800
210810,202112,458,373,85,410300,93500,503800
210820,202112,2023,1696,327,1866700,360800,2227500
210825,202112,150,86,64,94600,70400,165000
210830,202112,711,481,230,529100,253000,782100
210840,202112,186,134,52,147400,57200,204600
210845,202112,225,171,54,188100,59400,247500
210850,202112,713,490,223,539000,245300,784300
210860,202112,3374,1981,1393,2179100,1532300,3711400
210870,202112,407,325,82,357500,90200,447700
210880,202112,76,62,14,68200,15400,83600
210890,202112,315,273,42,300300,46200,346500
210900,202112,632,416,216,458700,237600,696300
210905,202112,60,34,26,37400,28600,66000
210910,202112,1917,1465,452,1613700.7,497200,2110900.7
210920,202112,145,61,84,67100,92400,159500
210923,202112,78,63,15,69300,16500,85800
210927,202112,406,201,205,221100,225500,446600
210930,202112,66,54,12,59400,13200,72600
210940,202112,80,62,18,68200,19800,88000
210945,202112,194,107,87,117700,95700,213400
210950,202112,511,375,136,412500,151800,564300
210955,202112,89,57,32,62700,35200,97900
210960,202112,2194,1129,1065,1241900,1172600,2414500
210970,202112,107,93,14,102300,15400,117700
210975,202112,77,72,5,79200,5500,84700
210980,202112,1060,521,539,574200,592900,1167100
210990,202112,4444,3099,1345,3411100,1480600,4891700
211000,202112,1267,1034,233,1137400,256300,1393700
211003,202112,955,693,262,762300,288200,1050500
211010,202112,472,426,46,468600,50600,519200
211020,202112,1352,601,751,661100,826100.46,1487200.46
211023,202112,45,40,5,44000,5500,49500
211027,202112,75,55,20,60500,22000,82500
211030,202112,357,258,99,283800,108900,392700
211040,202112,284,240,44,264000,48400,312400
211050,202112,1101,748,353,822800,388300,1211100
211060,202112,616,544,72,598400,79200.49,677600.49
211065,202112,24,19,5,20900,5500,26400
211070,202112,846,711,135,782100,148500,930600
211080,202112,86,84,2,92400,2200,94600
211085,202112,51,29,22,31900,24200,56100
211090,202112,76,65,11,71500,12100,83600
211100,202112,459,386,73,424600,80300,504900
211102,202112,237,171,66,188100,73700,261800
211105,202112,217,154,63,169400,70400,239800
211107,202112,124,78,46,85800,50600,136400
211110,202112,931,624,307,686400,337700,1024100
211120,202112,5013,2585,2428,2845700,2673000,5518700
211125,202112,23,16,7,17600,7700,25300
211130,202112,40495,18960,21535,20872500,23702800.48,44575300.48
211140,202112,397,349,48,383900,52800,436700
211150,202112,1170,814,356,895400,391600,1287000
211153,202112,165,105,60,115500,66000,181500
211157,202112,72,58,14,63800,15400,79200
211160,202112,678,582,96,640200,105600,745800
211163,202112,2,2,0,2200,,2200.0
211167,202112,10,9,1,9900,1100,11000
211170,202112,405,303,102,333300,112200,445500
211172,202112,109,76,33,83600,36300,119900
211174,202112,249,160,89,176000,97900,273900
211176,202112,456,338,118,372900,129800,502700
211178,202112,84,58,26,63800,28600,92400
211180,202112,207,167,40,183700,45100,228800
211190,202112,68,61,7,67100,7700,74800
211195,202112,32,20,12,22000,13200,35200
211200,202112,149,130,19,143000,20900,163900
211210,202112,413,306,107,336600,117700,454300
211220,202112,4145,2450,1695,2698300.5,1867800,4566100.5
211223,202112,98,91,7,100100,7700,107800
211227,202112,53,43,10,47300,11000,58300
211230,202112,703,581,122,640200,134200,774400
211240,202112,373,307,66,337700,72600,410300
211245,202112,179,94,85,103400,93500,196900
211250,202112,1485,1290,195,1420100,214500,1634600
211260,202112,783,662,121,728200,133100,861300
211270,202112,1854,1529,325,1681900,357500,2039400
211280,202112,1756,1151,605,1267200,665500,1932700
211285,202112,205,130,75,143000,83600,226600
211290,202112,702,499,203,548900,223300,772200
211300,202112,740,595,145,654500,159500,814000
211400,202112,1490,943,547,1037300.02,601700,1639000.02
220005,202112,15,14,1,15400,1100,16500
220010,202112,84,69,15,75900,16500,92400
220020,202112,680,551,129,606100,141900,748000
220025,202112,104,101,3,111100,3300,114400
220027,202112,49,40,9,44000,9900,53900
220030,202112,117,96,21,105600,23100,128700
220040,202112,1254,961,293,1058200,322300,1380500
220045,202112,31,20,11,22000,12100,34100
220050,202112,696,576,120,633600.8,132000,765600.8
220060,202112,170,149,21,163900,23100,187000
220070,202112,112,98,14,107800,15400,123200
220080,202112,14,12,2,13200,2200,15400
220090,202112,36,27,9,29700,9900,39600
220095,202112,2,1,1,1100,1100,2200
220100,202112,21,17,4,18700,4400,23100
220105,202112,29,26,3,28600,3300,31900
220110,202112,237,218,19,240900,20900,261800
220115,202112,40,35,5,38500,5500,44000
220117,202112,23,21,2,23100,2200,25300
220120,202112,1479,1135,344,1248500,379500,1628000
220130,202112,28,27,1,29700,1100,30800
220140,202112,98,79,19,86900,20900,107800
220150,202112,474,358,116,394900,127600,522500
220155,202112,12,11,1,12100,1100,13200
220157,202112,19,16,3,17600,3300,20900
220160,202112,96,86,10,94600,11000,105600
220170,202112,39,35,4,38500,4400,42900
220173,202112,8,7,1,7700,1100,8800
220177,202112,14,13,1,14300,1100,15400
220180,202112,66,64,2,70400,2200,72600
220190,202112,1079,940,139,1035100,152900,1188000
220191,202112,35,29,6,31900,6600,38500
220192,202112,89,84,5,92400,5500,97900
220194,202112,60,54,6,59400,6600,66000
220196,202112,84,70,14,77000,15400,92400
220198,202112,1,1,0,1100,,1100.0
220200,202112,410,345,65,379500,71500,451000
220202,202112,37,32,5,35200,5500,40700
220205,202112,60,52,8,57200,8800,66000
220207,202112,12,12,0,13200,,13200.0
220208,202112,77,46,31,50600,34100,84700
220209,202112,33,27,6,29700,6600,36300
220210,202112,22,16,6,17600,6600,24200
220211,202112,29,27,2,29700,2200,31900
220213,202112,32,28,4,30800,4400,35200
220217,202112,38,31,7,34100,7700,41800
220220,202112,2237,1465,772,1611500,849200,2460700
220225,202112,8,3,5,3300,5500,8800
220230,202112,952,739,213,812900,234300,1047200
220240,202112,163,143,20,157300,22000,179300
220245,202112,35,32,3,35200.18,3300,38500.18
220250,202112,122,104,18,114400,19800,134200
220253,202112,52,46,6,50600,6600,57200
220255,202112,40,34,6,37400,6600,44000
220260,202112,691,524,167,576400,183700,760100
220265,202112,6,5,1,5500,1100,6600
220270,202112,803,724,79,797500,86900,884400
220271,202112,40,32,8,35200,8800,44000
220272,202112,12,11,1,12100,1100,13200
220273,202112,16,14,2,15400,2200,17600
220275,202112,62,51,11,56100,12100,68200
220277,202112,21,15,6,16500,6600,23100
220280,202112,17,11,6,12100,6600,18700
220285,202112,39,37,2,40700,2200,42900
220290,202112,1484,1269,215,1397000,236500,1633500
220300,202112,33,33,0,36300,,36300.0
220310,202112,325,277,48,304700,52800,357500
220320,202112,438,404,34,445500,37400,482900
220323,202112,3,1,2,1100,2200,3300
220325,202112,9,8,1,8800,1100,9900
220327,202112,11,11,0,12100,,12100.0
220330,202112,233,165,68,181500,74800,256300
220335,202112,138,117,21,128700,23100,151800
220340,202112,44,31,13,34100,14300,48400
220342,202112,52,44,8,48400,8800,57200
220345,202112,78,67,11,73700,12100,85800
220350,202112,462,398,64,437800,70400,508200
220360,202112,41,31,10,34100,11000,45100
220370,202112,1266,1053,213,1158300,235400,1393700
220375,202112,14,14,0,15400,,15400.0
220380,202112,27,20,7,22000,7700,29700
220385,202112,15,14,1,15400,1100,16500
220390,202112,2326,1292,1034,1421200,1139600,2560800
220400,202112,35,31,4,34100,4400,38500
220410,202112,24,22,2,24200,2200,26400
220415,202112,12,11,1,12100,1100,13200
220420,202112,127,107,20,117700,22000,139700
220430,202112,126,112,14,123200,15400,138600
220435,202112,25,17,8,18700,8800,27500
220440,202112,277,237,40,260700,44000,304700
220450,202112,338,169,169,185900,185900,371800
220455,202112,49,48,1,52800,1100,53900
220460,202112,19,17,2,18700,2200,20900
220465,202112,78,52,26,57200,28600,85800
220470,202112,239,208,31,228800,34100,262900
220480,202112,72,65,7,71500,7700,79200
220490,202112,89,75,14,82500,15400,97900
220500,202112,114,95,19,104500,20900,125400
220510,202112,379,292,87,321200,95700,416900
220515,202112,20,18,2,19800,2200,22000
220520,202112,368,326,42,358600,46200,404800
220525,202112,10,5,5,5500,5500,11000
220527,202112,16,13,3,14300,3300,17600
220530,202112,44,21,23,23100,25300,48400
220535,202112,6,4,2,4400,2200,6600
220540,202112,80,67,13,73700,14300,88000
220545,202112,28,19,9,20900,9900,30800
220550,202112,702,558,144,613800,158400,772200
220551,202112,18,15,3,16500,3300,19800
220552,202112,11,11,0,12100,,12100.0
220553,202112,49,44,5,48400,5500,53900
220554,202112,11,8,3,8800,3300,12100
220555,202112,39,30,9,33000,9900,42900
220556,202112,37,35,2,38500,2200,40700
220557,202112,53,48,5,52800,5500,58300
220558,202112,7,3,4,3300,4400,7700
220559,202112,2,2,0,2200,,2200.0
220560,202112,71,46,25,51700,27500,79200
220570,202112,718,447,271,492800,298100,790900
220580,202112,533,485,48,535700,52800,588500
220585,202112,10,9,1,9900,1100,11000
220590,202112,13,12,1,13200,1100,14300
220595,202112,72,55,17,60500,18700,79200
220600,202112,19,12,7,13200,7700,20900
220605,202112,24,21,3,23100,3300,26400
220610,202112,86,73,13,80300,14300,94600
220620,202112,542,456,86,501600,94600,596200
220630,202112,6,5,1,5500,1100,6600
220635,202112,32,28,4,30800,4400,35200
220640,202112,108,89,19,97900,20900,118800
220650,202112,113,107,6,117700,6600,124300
220660,202112,63,49,14,53900,15400,69300
220665,202112,8,8,0,8800,,8800.0
220667,202112,17,14,3,15400,3300,18700
220669,202112,31,25,6,27500,6600,34100
220670,202112,64,51,13,56100,14300,70400
220672,202112,79,59,20,64900,22000,86900
220675,202112,32,25,7,27500,7700,35200
220680,202112,47,40,7,44000,7700,51700
220690,202112,50,47,3,52800,3300,56100
220695,202112,26,14,12,15400,13200,28600
220700,202112,1748,1343,405,1477300,446600,1923900
220710,202112,6,4,2,4400,2200,6600
220720,202112,110,93,17,102300,18700,121000
220730,202112,18,16,2,17600,2200,19800
220735,202112,3,0,3,,3300,3300.0
220740,202112,49,44,5,48400,5500,53900
220750,202112,113,97,16,106700,17600,124300
220755,202112,18,17,1,18700,1100,19800
220760,202112,66,59,7,64900,7700,72600
220770,202112,5807,3258,2549,3587100,2805000,6392100
220775,202112,15,11,4,12100,4400,16500
220777,202112,20,19,1,20900,1100,22000
220779,202112,1,0,1,,1100,1100.0
220780,202112,900,768,132,845900,145200,991100
220785,202112,5,1,4,1100,4400,5500
220790,202112,1138,901,237,991100,260700,1251800
220793,202112,6,5,1,5500,1100,6600
220795,202112,16,14,2,15400,2200,17600
220800,202112,3995,3047,948,3356304,1042800,4399104
220810,202112,67,58,9,63800,9900,73700
220820,202112,234,212,22,233200,24200,257400
220830,202112,1284,1115,169,1229800,185900,1415700
220840,202112,2445,1719,726,1892000,800800,2692800
220850,202112,67,60,7,66000,7700,73700
220855,202112,8,4,4,4400,4400,8800
220860,202112,10,9,1,9900,1100,11000
220865,202112,29,26,3,28600,3300,31900
220870,202112,85,77,8,84700,8800,93500
220880,202112,323,259,64,284900,70400,355300
220885,202112,26,25,1,27500,1100,28600
220887,202112,8,7,1,7700,1100,8800
220890,202112,91,78,13,85800,14300,100100
220900,202112,27,14,13,15400,14300,29700
220910,202112,47,38,9,41800,9900,51700
220915,202112,11,10,1,11000,1100,12100
220920,202112,52,45,7,49500,7700,57200
220930,202112,44,42,2,46200,2200,48400
220935,202112,13,13,0,14300,,14300.0
220937,202112,32,29,3,31900,3300,35200
220940,202112,55,51,4,56100,4400,60500
220945,202112,2,2,0,2200,,2200.0
220950,202112,36,29,7,31900,7700,39600
220955,202112,14,14,0,15400,,15400.0
220960,202112,25,23,2,25300,2200,27500
220965,202112,39,36,3,39600,3300,42900
220970,202112,61,52,9,57200,9900,67100
220975,202112,11,10,1,11000,1100,12100
220980,202112,30,28,2,30800,2200,33000
220985,202112,55,49,6,53900,6600,60500
220987,202112,32,29,3,31900,3300,35200
220990,202112,26,26,0,28600,,28600.0
220995,202112,11,10,1,11000,1100,12100
220997,202112,58,50,8,55000,8800,63800
221000,202112,1192,1067,125,1174800,137500,1312300
221005,202112,35,32,3,35200,3300,38500
221010,202112,18,14,4,15400,4400,19800
221020,202112,35,34,1,37400,1100,38500
221030,202112,39,31,8,34100,8800,42900
221035,202112,23,21,2,23100,2200,25300
221037,202112,13,8,5,8800,5500,14300
221038,202112,28,25,3,27500,3300,30800
221039,202112,26,25,1,27500,1100,28600
221040,202112,263,226,37,248600,40700,289300
221050,202112,223,187,36,205700,39600,245300
221060,202112,1928,1664,264,1830400,290400,2120800
221062,202112,30,29,1,31900,1100,33000
221063,202112,15,10,5,11000,5500,16500
221065,202112,65,53,12,58300,13200,71500
221070,202112,136,118,18,129800,19800,149600
221080,202112,378,320,58,352000,63800,415800
221090,202112,20,15,5,16500,5500,22000
221093,202112,41,30,11,33000,12100,45100
221095,202112,4,4,0,4400,,4400.0
221097,202112,12,10,2,11000,2200,13200
221100,202112,25855,15401,10454,16951000.39,11515900,28466900.39
221110,202112,1115,839,276,922900,304700,1227600
221120,202112,535,388,147,426800,161700,588500
221130,202112,958,772,186,849200,204600,1053800
221135,202112,30,26,4,28600,4400,33000
221140,202112,45,38,7,41800,7700,49500
221150,202112,9,7,2,7700,2200,9900
221160,202112,12,12,0,13200,,13200.0
221170,202112,17,17,0,18700,,18700.0
230010,202112,150,133,17,146300,18700,165000
230015,202112,142,115,27,126500,29700,156200
230020,202112,1641,1353,288,1490500,317900,1808400
230030,202112,1663,1199,464,1318900,511500,1830400
230040,202112,227,185,42,205700,46200,251900
230050,202112,230,167,63,183700,69300,253000
230060,202112,159,125,34,137500,37400,174900
230070,202112,308,264,44,290400,48400,338800
230075,202112,870,734,136,807400,149600,957000
230080,202112,205,173,32,190300,35200,225500
230090,202112,148,110,38,121000,41800,162800
230100,202112,2374,1337,1037,1470700,1141800,2612500
230110,202112,2905,1830,1075,2014100,1184700,3198800
230120,202112,1079,842,237,927300,260700,1188000
230125,202112,161,129,32,141900,35200,177100
230130,202112,473,416,57,457600,63800,521400
230140,202112,213,173,40,190300,44000,234300
230150,202112,150,115,35,126500,38500,165000
230160,202112,942,781,161,860200,177100,1037300
230170,202112,605,536,69,589600,75900,665500
230180,202112,64,59,5,64900,5500,70400
230185,202112,402,341,61,375100,67100,442200
230190,202112,2430,1877,553,2065800,609400,2675200
230195,202112,508,440,68,484000,74800,558800
230200,202112,417,329,88,361900,96800,458700
230205,202112,391,261,130,287100,143000,430100
230210,202112,1386,1062,324,1168200,356400,1524600
230220,202112,1580,1066,514,1172600,565400,1738000
230230,202112,966,807,159,887700,174900,1062600
230240,202112,1840,1598,242,1760275,266200,2026475
230250,202112,1777,1445,332,1592800,366300,1959100
230260,202112,3238,1997,1241,2197800,1366200,3564000
230270,202112,1359,1073,286,1180300.05,314600,1494900.05
230280,202112,2768,2091,677,2301200,745800,3047000
230290,202112,350,312,38,343200.5,42900,386100.5
230300,202112,533,388,145,427900,159500,587400
230310,202112,420,323,97,355300,107800,463100
230320,202112,903,765,138,841500,151800,993300
230330,202112,306,244,62,268400,68200,336600
230340,202112,438,350,88,385000,96800,481800
230350,202112,3284,2023,1261,2228600,1389300,3617900
230360,202112,272,225,47,247500,51700,299200
230365,202112,129,105,24,115500,26400,141900
230370,202112,10771,5285,5486,5816800.92,6043400,11860200.92
230380,202112,481,411,70,452100,77000,529100
230390,202112,527,299,228,328900,250800,579700
230393,202112,244,200,44,221100,48400,269500
230395,202112,346,280,66,308000,72600,380600
230400,202112,635,505,130,555500,143000,698500
230410,202112,2683,1661,1022,1829300.5,1126400,2955700.5
230420,202112,6456,4248,2208,4678300.6,2431000,7109300.6
230423,202112,338,294,44,323400,48400,371800
230425,202112,462,366,96,402600,106700,509300
230426,202112,116,91,25,100100,27500,127600
230427,202112,70,64,6,70400,6600,77000
230428,202112,1586,775,811,855800,893200,1749000
230430,202112,452,365,87,401500,95700,497200
230435,202112,927,671,256,740300,281600,1021900
230440,202112,93852,42062,51790,46299003.94,57017401.3,103316405.24
230445,202112,317,215,102,236500,112200,348700
230450,202112,577,452,125,497200,137500,634700
230460,202112,81,60,21,66000,23100,89100
230465,202112,312,249,63,275000,69300,344300
230470,202112,2010,1577,433,1735800,476300,2212100
230480,202112,153,141,12,155100,13200,168300
230490,202112,322,252,70,278300,77000,355300
230495,202112,480,336,144,369600,158400,528000
230500,202112,1038,768,270,844800,300300,1145100
230510,202112,60,44,16,48400,17600,66000
230520,202112,395,305,90,335500,99000,434500
230523,202112,2454,1508,946,1663200,1040600,2703800
230526,202112,263,226,37,248600,40700,289300
230530,202112,687,506,181,556600,199100,755700
230533,202112,216,197,19,216700,20900,237600
230535,202112,371,277,94,304700,103400,408100
230540,202112,1796,1598,198,1761100,217800,1978900
230550,202112,3956,2500,1456,2750000,1602700,4352700
230560,202112,579,441,138,485100,151800,636900
230565,202112,217,161,56,178200,61600,239800
230570,202112,285,244,41,268400,45100,313500
230580,202112,1201,853,348,938300,382800,1321100
230590,202112,1011,785,226,864600,248600,1113200
230600,202112,253,229,24,251900,26400,278300
230610,202112,418,310,108,341000,118800,459800
230620,202112,167,145,22,159500,25300,184800
230625,202112,823,556,267,612700,293700,906400
230630,202112,1335,1011,324,1112100,357500,1469600
230640,202112,3795,3163,632,3482600.53,695200,4177800.53
230650,202112,501,427,74,469700,81400,551100
230655,202112,699,574,125,631400,137500,768900
230660,202112,363,299,64,328900,70400,399300
230670,202112,455,370,85,407000,93500,500500
230680,202112,207,183,24,202400,26400,228800
230690,202112,932,783,149,861300,163900,1025200
230700,202112,890,739,151,814000,166100,980100
230710,202112,682,638,44,704000,48400,752400
230720,202112,148,126,22,138600,24200,162800
230725,202112,238,175,63,192500,69300,261800
230730,202112,12617,6665,5952,7335831.32,6549400.82,13885232.14
230740,202112,676,536,140,590700,154000,744700
230750,202112,820,687,133,756800,146300,903100
230760,202112,1460,1257,203,1383800,223300,1607100
230763,202112,334,273,61,301400,67100,368500
230765,202112,8100,3746,4354,4126100.6,4794900.39,8921000.99
230770,202112,5006,2515,2491,2766500,2742300,5508800
230780,202112,760,665,95,732600,104500,837100
230790,202112,299,248,51,272800,56100,328900
230800,202112,1151,819,332,902000,366300,1268300
230810,202112,1392,1214,178,1335400.55,195800,1531200.55
230820,202112,369,249,120,273900,132000,405900
230830,202112,958,808,150,890915,165000,1055915
230835,202112,276,234,42,257400,46200,303600
230837,202112,170,138,32,151800,35200,187000
230840,202112,926,713,213,784300,234300,1018600
230850,202112,1403,1199,204,1318900,224400,1543300
230860,202112,308,228,80,250800,88006,338806
230870,202112,1831,1541,290,1699500,319000,2018500
230880,202112,75,57,18,62700,19800,82500
230890,202112,536,477,59,524700,64900,589600
230900,202112,294,214,80,235400,88000.7,323400.7
230910,202112,224,172,52,189200,57200,246400
230920,202112,481,377,104,414700,114400,529100
230930,202112,1034,718,316,789800,347600,1137400
230940,202112,843,648,195,712800,214500,927300
230945,202112,523,415,108,456500,118800,575300
230950,202112,425,367,58,403700,63800,467500
230960,202112,2765,1837,928,2022900,1023000,3045900
230970,202112,1761,977,784,1074700,862400,1937100
230980,202112,205,163,42,179300,46200,225500
230990,202112,138,108,30,118800,33000,151800
231000,202112,202,185,17,203500,18700,222200
231010,202112,160,110,50,121000,55000,176000
231020,202112,1387,945,442,1039500,486200,1525700
231025,202112,1078,756,322,831600,355300,1186900
231030,202112,1055,876,179,964700,196900,1161600
231040,202112,152,102,50,112200,55000,167200
231050,202112,939,814,125,895400,137500,1032900
231060,202112,161,131,30,144100,33000,177100
231070,202112,1500,1028,472,1130800,519200,1650000
231080,202112,261,234,27,257400,29700,287100
231085,202112,650,393,257,433400,282700,716100
231090,202112,260,206,54,226600,59400,286000
231095,202112,161,130,31,143000,34100,177100
231100,202112,160,128,32,141900,35200,177100
231110,202112,370,310,60,341000,66000,407000
231120,202112,270,225,45,247500,49500,297000
231123,202112,157,147,10,161700,11000,172700
231126,202112,326,246,80,271700,88000,359700
231130,202112,4940,3839,1101,4224000,1211136.66,5435136.66
231135,202112,212,183,29,202400,31900,234300
231140,202112,3089,2241,848,2466200,932800,3399000
231150,202112,375,353,22,388300,24200,412500
231160,202112,1221,978,243,1075800,267300,1343100
231170,202112,515,357,158,393800,173800,567600
231180,202112,1756,1514,242,1665400,267300,1932700
231190,202112,207,170,37,188100,40700,228800
231195,202112,225,189,36,207900,40700,248600
231200,202112,810,653,157,718300,172700,891000
231210,202112,522,442,80,487300,88000,575300
231220,202112,1034,739,295,812900.85,325600,1138500.85
231230,202112,1480,1125,355,1239700,391600,1631300
231240,202112,1509,1032,477,1137400,524700,1662100
231250,202112,97,91,6,100100,6600,106700
231260,202112,262,174,88,191400,96800,288200
231270,202112,994,786,208,866800,228800,1095600
231280,202112,76,59,17,64900,18700,83600
231290,202112,7880,4388,3492,4830100.47,3845600.57,8675701.04
231300,202112,584,533,51,586300,57200,643500
231310,202112,752,689,63,757900,69300,827200
231320,202112,582,437,145,480700,159500,640200
231325,202112,103,88,15,96800,16500,113300
231330,202112,1926,1479,447,1626900.74,492800,2119700.74
231335,202112,251,223,28,245300,30800,276100
231340,202112,1759,1245,514,1371700,565400,1937100
231350,202112,1329,1058,271,1164900,298100,1463000
231355,202112,422,355,67,390500,73700,464200
231360,202112,547,378,169,415800.65,185900,601700.65
231370,202112,93,81,12,89100,13200,102300
231375,202112,293,215,78,236500,85800,322300
231380,202112,484,385,99,423500,110000,533500
231390,202112,208,156,52,171600,57200,228800
231395,202112,765,467,298,513700,327800,841500
231400,202112,1148,953,195,1048300,214500,1262800
231410,202112,1348,1096,252,1206700,278300,1485000
240010,202112,379,167,212,183700.13,233200,416900.13
240020,202112,2204,1787,417,1966800.75,458700,2425500.75
240030,202112,119,98,21,107800,23100,130900
240040,202112,33,32,1,35200,1100,36300
240050,202112,527,447,80,491700,88000,579700
240060,202112,67,63,4,69300,4400,73700
240070,202112,236,181,55,199100,60500,259600
240080,202112,532,356,176,391600,193600.7,585200.7
240090,202112,103,92,11,101200,12100,113300
240100,202112,1468,1382,86,1522400.5,94600,1617000.5
240110,202112,1029,680,349,748000,385000,1133000
240120,202112,147,110,37,121000,40700,161700
240130,202112,273,254,19,279400,20900,300300
240140,202112,79,55,24,60500,26400,86900
240145,202112,716,627,89,689700,97900,787600
240150,202112,23,17,6,18700,6600,25300
240160,202112,41,33,8,36300,8800,45100
240165,202112,41,32,9,35200,9900,45100
240170,202112,130,86,44,95700,48400,144100
240180,202112,100,76,24,83600,26400,110000
240185,202112,46,41,5,45100,5500,50600
240190,202112,14,12,2,13200,2200,15400
240200,202112,3060,1658,1402,1826000,1545500,3371500
240210,202112,163,124,39,136400,42900,179300
240220,202112,1104,778,326,855800,358600,1214400
240230,202112,823,751,72,827200,79200,906400
240240,202112,67,46,21,51700,23100,74800
240250,202112,91,78,13,85800,14300,100100
240260,202112,1810,1288,522,1416800,574200,1991000
240270,202112,178,155,23,170500,25300,195800
240280,202112,55,42,13,46200,14300,60500
240290,202112,40,38,2,41800,2200,44000
240300,202112,172,90,82,99000,90200,189200
240310,202112,2417,1292,1125,1423400,1241900,2665300
240320,202112,176,163,13,179300,14300,193600
240325,202112,4691,2711,1980,2984301.3,2179100,5163401.3
240330,202112,70,66,4,72600,4400,77000
240340,202112,84,55,29,60500,31900,92400
240350,202112,94,77,17,84700,18700,103400
240360,202112,601,361,240,397100,264000,661100
240370,202112,52,45,7,49500,7700,57200
240375,202112,62,37,25,40700,27500,68200
240380,202112,228,187,41,205700,45100,250800
240390,202112,14,12,2,13200,2200,15400
240400,202112,84,75,9,82500,9900,92400
240410,202112,13,7,6,7700,6600,14300
240420,202112,1053,769,284,847000,312400,1159400
240430,202112,260,242,18,266200,19800,286000
240440,202112,121,64,57,70400,62700,133100
240450,202112,241,152,89,167200,97900,265100
240460,202112,73,58,15,63800,16500,80300
240470,202112,212,190,22,210100,24200,234300
240480,202112,16,14,2,15400,2200,17600
240485,202112,85,68,17,74800,18700,93500
240490,202112,47,43,4,47300,4400,51700
240500,202112,89,67,22,74800,24200,99000
240510,202112,42,30,12,33000,13200,46200
240520,202112,100,95,5,104500,5500,110000
240530,202112,57,47,10,51700,11000,62700
240540,202112,83,70,13,77000,14300,91300
240550,202112,12,10,2,11000,2200,13200
240560,202112,379,271,108,298100,118800,416900
240570,202112,428,269,159,295900,174900,470800
240580,202112,1289,990,299,1091200,330000,1421200
240590,202112,31,29,2,31900,2200,34100
240600,202112,96,90,6,99000,6600,105600
240610,202112,496,410,86,453200,96800,550000
240615,202112,15,14,1,15400,1100,16500
240620,202112,88,84,4,93500,4400,97900
240630,202112,41,33,8,36300,8800,45100
240640,202112,25,21,4,23100,4400,27500
240650,202112,242,196,46,215600,50600,266200
240660,202112,109,92,17,101200,18700,119900
240670,202112,309,167,142,183700,156200,339900
240680,202112,54,41,13,45100,14300,59400
240690,202112,46,43,3,47300,3300,50600
240700,202112,180,146,34,160600,37400,198000
240710,202112,2133,1278,855,1408000,941600,2349600
240720,202112,1045,749,296,823900,325600,1149500
240725,202112,64,59,5,64900,5500,70400
240730,202112,152,127,25,139700,27500,167200
240740,202112,231,195,36,214500,39600,254100
240750,202112,53,31,22,34100,24200,58300
240760,202112,51,44,7,48400,7700,56100
240770,202112,144,110,34,121000,37400,158400
240780,202112,701,581,120,640200,132000,772200
240790,202112,42,40,2,44000,2200,46200
240800,202112,9429,6350,3079,6991600.85,3391300,10382900.85
240810,202112,21319,11240,10079,12375000.19,11104500,23479500.19
240820,202112,244,144,100,159500,110000,269500
240830,202112,1592,1313,279,1445400,306900,1752300
240840,202112,76,67,9,73700,9900,83600
240850,202112,83,74,9,81400,9900,91300
240860,202112,107,102,5,112200,5500,117700
240870,202112,58,49,9,53900,9900,63800
240880,202112,32,28,4,30800,4400,35200
240890,202112,1135,624,511,686400,563200,1249600
240895,202112,65,49,16,53900,17600,71500
240910,202112,171,144,27,158400,29700,188100
240920,202112,13,11,2,12100,2200,14300
240930,202112,410,364,46,400400,50600,451000
240933,202112,56,36,20,39600,22000,61600
240940,202112,2294,2020,274,2224200,301400,2525600
240950,202112,46,40,6,44000,6600,50600
240960,202112,24,20,4,22000,4400,26400
240970,202112,111,81,30,89100,33000,122100
240980,202112,199,161,38,177100,41800,218900
240990,202112,134,89,45,97900,49500,147400
241000,202112,59,55,4,60500,4400,64900
241010,202112,75,57,18,62700,19800,82500
241020,202112,105,97,8,106700,8800,115500
241025,202112,15,7,8,7700,8800,16500
241030,202112,103,84,19,92400,20900,113300
241040,202112,44,31,13,34100,14300,48400
241050,202112,78,69,9,75900,9900,85800
241060,202112,27,22,5,24200,5500,29700
241070,202112,17,16,1,17600,1100,18700
241080,202112,57,50,7,55000,7700,62700
241090,202112,52,39,13,42900,14300,57200
241100,202112,74,63,11,69300,12100,81400
241105,202112,13,5,8,5500,8800,14300
241110,202112,45,39,6,42900,6600,49500
241120,202112,1542,1159,383,1276000,421300,1697300
241140,202112,213,177,36,194700,39600,234300
241142,202112,45,33,12,36300,13200,49500
241150,202112,1200,1045,155,1149500,170500,1320000
241160,202112,21,16,5,17600,5500,23100
241170,202112,45,38,7,41800,7700,49500
241180,202112,41,30,11,33000,12100,45100
241190,202112,38,36,2,39600,2200,41800
241200,202112,4137,2165,1972,2387000.53,2171400,4558400.53
241210,202112,69,59,10,64900,11000,75900
241220,202112,1452,940,512,1035100.33,564300,1599400.33
241230,202112,248,204,44,224400,48400,272800
241240,202112,57,43,14,47300,15400,62700
241250,202112,1136,1037,99,1140700,108900,1249600
241255,202112,53,44,9,48400,9900,58300
241260,202112,682,519,163,570900,179300,750200
241270,202112,63,44,19,48400,20900,69300
241280,202112,97,85,12,93500,13200,106700
241290,202112,126,88,38,96800,41800,138600
241300,202112,82,56,26,61600,28600,90200
241310,202112,46,32,14,35200,15400,50600
241320,202112,28,14,14,15400,15400,30800
241330,202112,58,50,8,55000,8800,63800
241335,202112,78,69,9,75900,9900,85800
241340,202112,184,135,49,148500,53900,202400
241350,202112,60,51,9,56100,9900,66000
241355,202112,47,40,7,44000,7700,51700
241360,202112,49,48,1,52800,1100,53900
241370,202112,57,44,13,48400,14300,62700
241380,202112,35,31,4,34100,4400,38500
241390,202112,84,64,20,70400,22000,92400
241400,202112,217,165,52,181500,57200,238700
241410,202112,176,160,16,176000,17600,193600
241415,202112,102,81,21,89100,23100,112200
241420,202112,110,76,34,83600,37400,121000
241430,202112,22,20,2,22000,2200,24200
241440,202112,515,429,86,471900,94600,566500
241445,202112,39,34,5,37400,5500,42900
241450,202112,254,211,43,233200,47300,280500
241460,202112,142,129,13,141900,14300,156200
241470,202112,32,27,5,29700,5500,35200
241475,202112,53,47,6,51700,6600,58300
241480,202112,118,85,33,93500,36300,129800
241490,202112,12,11,1,12100,1100,13200
241500,202112,42,32,10,35200,11000,46200
250010,202112,99,85,14,93500,15400,108900
250020,202112,32,27,5,30800,5500,36300
250030,202112,894,656,238,721600,261800,983400
250040,202112,387,312,75,344300,83600,427900
250050,202112,263,213,50,234300,55000,289300
250053,202112,62,48,14,52800,15400,68200
250057,202112,1,1,0,1100,,1100.0
250060,202112,599,432,167,475200,183700,658900
250070,202112,684,544,140,599500.22,154000,753500.22
250073,202112,8,8,0,8800,,8800.0
250077,202112,172,127,45,139700,49500,189200
250080,202112,423,334,89,367400,97900,465300
250090,202112,223,142,81,156200,89100,245300
250100,202112,536,442,94,486200,104500,590700
250110,202112,661,488,173,536800,190300,727100
250115,202112,15,3,12,3300,13200,16500
250120,202112,121,87,34,95700,37400,133100
250130,202112,552,441,111,485100,123200,608300
250135,202112,22,11,11,12100,12100,24200
250140,202112,81,72,9,79200,9900,89100
250150,202112,608,428,180,470800,198000,668800
250153,202112,11,9,2,9900,2200,12100
250157,202112,29,24,5,26400,5500,31900
250160,202112,235,184,51,202400,56100,258500
250170,202112,71,46,25,50600,27500,78100
250180,202112,4618,3145,1473,3463900,1623600,5087500
250190,202112,829,553,276,608300,303600,911900
250200,202112,59,44,15,48400,16500,64900
250205,202112,23,19,4,22000,4400,26400
250210,202112,88,76,12,83600,13200,96800
250215,202112,69,53,16,58300,17600,75900
250220,202112,26,18,8,19800,8800,28600
250230,202112,77,69,8,75900,8800,84700
250240,202112,239,184,55,202400,60500,262900
250250,202112,371,319,52,350900,58300,409200
250260,202112,44,36,8,39600,8800,48400
250270,202112,75,52,23,57200,25300,82500
250280,202112,373,301,72,331100,79200,410300
250290,202112,91,82,9,90200,9900,100100
250300,202112,570,380,190,418000,209000,627000
250310,202112,45,41,4,45100,4400,49500
250320,202112,1992,1312,680,1443200,751300,2194500
250330,202112,107,91,16,100100,17600,117700
250340,202112,29,24,5,26400,5500,31900
250350,202112,189,124,65,136400,71500,207900
250355,202112,32,24,8,26400,8800,35200
250360,202112,189,156,33,172700,36300,209000
250370,202112,2369,1522,847,1674200,931700,2605900
250375,202112,14,8,6,8800,6600,15400
250380,202112,57,45,12,49500,13200,62700
250390,202112,45,34,11,37400,12100,49500
250400,202112,16578,8256,8322,9087081.02,9165200,18252281.02
250403,202112,324,256,68,281600,74800,356400
250407,202112,65,52,13,57200,14300,71500
250410,202112,29,25,4,27500,4400,31900
250415,202112,44,28,16,30800,17600,48400
250420,202112,37,31,6,34100,6600,40700
250430,202112,1421,1223,198,1347775,217800,1565575
250435,202112,24,17,7,18700,7700,26400
250440,202112,672,556,116,611600,127600,739200
250450,202112,83,63,20,69300,22000,91300
250460,202112,471,305,166,336600,182600,519200
250470,202112,95,64,31,70400,34100,104500
250480,202112,330,260,70,286000,77000,363000
250485,202112,4,4,0,4400,,4400.0
250490,202112,236,190,46,209000,50600,259600
250500,202112,93,71,22,78100,24200,102300
250510,202112,791,618,173,680900,190300,871200
250520,202112,167,111,56,122100,61600,183700
250523,202112,120,98,22,107800,24200,132000
250527,202112,115,87,28,95700,30800,126500
250530,202112,6,3,3,3300,3300,6600
250535,202112,30,22,8,24200,8800,33000
250540,202112,138,109,29,119900,33000,152900
250550,202112,66,64,2,70400,2200,72600
250560,202112,60,38,22,41800,24200,66000
250570,202112,155,126,29,138600,31900,170500
250580,202112,98,74,24,81471,26400,107871
250590,202112,22,12,10,13200,11000,24200
250600,202112,1482,966,516,1065900.7,570900,1636800.7
250610,202112,155,127,28,139700,30800,170500
250620,202112,21,17,4,18700,4400,23100
250625,202112,71,54,17,59400,18700,78100
250630,202112,3131,1973,1158,2172500.94,1273800,3446300.94
250640,202112,194,154,40,169400,44000,213400
250650,202112,26,18,8,19800,8800,28600
250660,202112,58,42,16,46200,17600,63800
250670,202112,64,47,17,51700,18700,70400
250680,202112,412,328,84,360800,92400,453200
250690,202112,2118,1450,668,1595000.7,734800,2329800.7
250700,202112,917,780,137,858000.28,150700,1008700.28
250710,202112,446,352,94,387200,104500,491700
250720,202112,123,89,34,97900,37400,135300
250730,202112,413,344,69,378400,75900,454300
250740,202112,64,61,3,67100,3300,70400
250750,202112,23516,13909,9607,15311882.03,10576500,25888382.03
250760,202112,106,85,21,93500,24200,117700
250770,202112,363,235,128,258500,140800,399300
250780,202112,71,45,26,49500,28600,78100
250790,202112,459,290,169,319000,187000,506000
250800,202112,149,132,17,145200,18700,163900
250810,202112,78,62,16,68200,17600,85800
250820,202112,146,123,23,136400,25300,161700
250830,202112,445,288,157,316800,172700,489500
250840,202112,58,52,6,57200,6600,63800
250850,202112,54,45,9,49500,9900,59400
250855,202112,16,14,2,15400,2200,17600
250860,202112,243,158,85,173800,94600,268400
250870,202112,29,26,3,28600,3300,31900
250880,202112,88,67,21,73700,23100,96800
250890,202112,3058,2269,789,2495900,869000,3364900
250900,202112,57,47,10,51700,11000,62700
250905,202112,124,94,30,103400,33000,136400
250910,202112,1034,762,272,839300,299200,1138500
250915,202112,109,75,34,82500,37400,119900
250920,202112,134,96,38,105600,41800,147400
250930,202112,181,105,76,115500,83600,199100
250933,202112,8,5,3,5500,3300,8800
250937,202112,16,16,0,17600,,17600.0
250939,202112,31,25,6,27500,6600,34100
250940,202112,118,86,32,94600,35200,129800
250950,202112,73,51,22,56100,24200,80300
250960,202112,91,49,42,53900,46200,100100
250970,202112,1243,874,369,962500,405900,1368400
250980,202112,101,68,33,74800,36300,111100
250990,202112,171,131,40,144100,44000,188100
251000,202112,77,67,10,73700,11000,84700
251010,202112,120,90,30,99000,33000,132000
251020,202112,77,62,15,68200,16500,84700
251030,202112,47,34,13,37400,14300,51700
251040,202112,55,37,18,40700,19800,60500
251050,202112,25,21,4,23100,4400,27500
251060,202112,50,40,10,44000,11000,55000
251065,202112,7,4,3,4400,3300,7700
251070,202112,18,14,4,15400,4400,19800
251080,202112,5249,2451,2798,2697200,3082200,5779400
251090,202112,189,158,31,173800,34100,207900
251100,202112,20,19,1,20900,1100,22000
251110,202112,54,36,18,39600,19800,59400
251120,202112,1923,1174,749,1292500,823900,2116400
251130,202112,427,351,76,386100,83600,469700
251140,202112,581,369,212,405900,234300,640200
251150,202112,344,285,59,313500,66000,379500
251160,202112,96,76,20,83600,22000,105600
251170,202112,94,76,18,83600,19800,103400
251180,202112,289,168,121,184800,133100,317900
251190,202112,194,127,67,139700,73700,213400
251200,202112,278,218,60,239800,66000,305800
251203,202112,36,33,3,36300,3300,39600
251207,202112,85,71,14,78100,15400,93500
251210,202112,1498,1091,407,1201200,447700,1648900
251220,202112,44,34,10,37400,11000,48400
251230,202112,579,478,101,525800,111100,636900
251240,202112,107,75,32,82500,35200,117700
251250,202112,1439,1023,416,1125209.8,458700,1583909.8
251260,202112,12,8,4,8800,4400,13200
251270,202112,302,238,64,261800,70400,332200
251272,202112,66,58,8,64900,8800,73700
251274,202112,27,21,6,23100,6600,29700
251275,202112,34,20,14,22000,15400,37400
251276,202112,25,20,5,22000,5500,27500
251278,202112,11,9,2,9900,2200,12100
251280,202112,102,97,5,106700,5500,112200
251290,202112,952,679,273,746900,300300,1047200
251300,202112,15,10,5,11000,5500,16500
251310,202112,299,217,82,239800,90200,330000
251315,202112,39,35,4,38500,4400,42900
251320,202112,72,55,17,60500,18700,79200
251330,202112,83,72,11,79200,12100,91300
251335,202112,23,9,14,9900,15400,25300
251340,202112,771,444,327,489500,359700,849200
251350,202112,35,34,1,37400,1100,38500
251360,202112,84,73,11,80300,12100,92400
251365,202112,8,7,1,7700,1100,8800
251370,202112,5754,3884,1870,4279000.32,2058100,6337100.32
251380,202112,47,36,11,39600,12100,51700
251385,202112,2,2,0,2200,,2200.0
251390,202112,902,666,236,733700,259600,993300
251392,202112,26,16,10,17600,11000,28600
251394,202112,9,9,0,9900,,9900.0
251396,202112,14,9,5,9900,5500,15400
251398,202112,15,12,3,13200,3300,16500
251400,202112,47,37,10,40700,11000,51700
251410,202112,40,34,6,37400,6600,44000
251420,202112,104,77,27,84700,29700,114400
251430,202112,47,42,5,46200,5500,51700
251440,202112,48,25,23,27500,25300,52800
251445,202112,63,52,11,57200,12100,69300
251450,202112,387,335,52,368500,57200,425700
251455,202112,7,5,2,5500,2200,7700
251460,202112,20,16,4,17600,4400,22000
251465,202112,7,5,2,5500,2200,7700
251470,202112,54,40,14,44000,15400,59400
251480,202112,28,23,5,25300,5500,30800
251490,202112,108,67,41,73700,45100,118800
251500,202112,122,99,23,108900,25300,134200
251510,202112,78,49,29,53900,31900,85800
251520,202112,34,30,4,33000,4400,37400
251530,202112,4318,3046,1272,3352800,1402500,4755300
251540,202112,82,68,14,75900,15400,91300
251550,202112,410,309,101,341000,111100,452100
251560,202112,25,17,8,18700,8800,27500
251570,202112,17,15,2,16500,2200,18700
251580,202112,135,107,28,117700,30800,148500
251590,202112,110,75,35,82707.9,38500,121207.9
251593,202112,26,17,9,18700,9900,28600
251597,202112,104,78,26,85800,28600,114400
251600,202112,1092,759,333,834900,367400,1202300
251610,202112,234,173,61,190300,67100,257400
251615,202112,12,11,1,12100,1100,13200
251620,202112,4185,2678,1507,2945800,1658800,4604600
251630,202112,460,339,121,372900,133100,506000
251640,202112,129,94,35,103400,38500,141900
251650,202112,287,209,78,231000,85800,316800
251660,202112,198,175,23,192500,25300,217800
251670,202112,387,299,88,328900,97900,426800
251675,202112,10,8,2,8800,2200,11000
251680,202112,101,88,13,96800,14300,111100
251690,202112,322,265,57,291500,62700,354200
251700,202112,279,241,38,265100,42900,308000
251710,202112,20,12,8,13200,8800,22000
251720,202112,24,16,8,17600,8800,26400
251740,202112,13,10,3,11000,3300,14300
260005,202112,3460,1831,1629,2013632,1791900,3805532
260010,202112,1650,1215,435,1337600.58,479600,1817200.58
260020,202112,408,352,56,387200,61600,448800
260030,202112,594,398,196,437800,216700,654500
260040,202112,804,486,318,534600,349800,884400
260050,202112,1163,825,338,909700,371800,1281500
260060,202112,370,337,33,370700,36300,407000
260070,202112,1316,797,519,877800,570900,1448700
260080,202112,717,546,171,600600,188100,788700
260090,202112,484,315,169,346500,185900,532400
260100,202112,210,146,64,160600,70400,231000
260105,202112,254,143,111,157300,122100,279400
260110,202112,2920,2121,799,2335300,878900,3214200
260120,202112,2701,1450,1251,1595292.6,1377200,2972492.6
260130,202112,179,118,61,129800,67100,196900
260140,202112,2188,1421,767,1566400,843700,2410100
260150,202112,195,125,70,137500,77000,214500
260160,202112,339,278,61,305800,67100,372900
260170,202112,3339,1989,1350,2189000,1487200,3676200
260180,202112,177,141,36,155100,39600,194700
260190,202112,2359,1554,805,1712700,886600,2599300
260200,202112,975,763,212,840400.63,233200,1073600.63
260210,202112,1385,974,411,1071400,454300,1525700
260220,202112,659,593,66,652300,72600,724900
260230,202112,1232,912,320,1003200,353100,1356300
260240,202112,204,152,52,167200,57200,224400
260250,202112,87,63,24,69300,26400,95700
260260,202112,1067,731,336,804100,370700,1174800
260270,202112,260,187,73,205700,80300,286000
260280,202112,1144,907,237,998800,261800,1260600
260290,202112,6769,3636,3133,4001800,3449600.59,7451400.59
260300,202112,979,827,152,909700,167200,1076900
260310,202112,518,415,103,456500,113300,569800
260320,202112,831,602,229,662200,251900,914100
260330,202112,68,49,19,53900,20900,74800
260340,202112,76,56,20,61600,22000,83600
260345,202112,5584,2923,2661,3216400,2927100,6143500
260350,202112,481,341,140,375100,154000,529100
260360,202112,242,133,109,146300,119900,266200
260370,202112,751,469,282,517000,311300,828300
260380,202112,563,404,159,445500,174900.6,620400.6
260390,202112,288,243,45,267300,49500,316800
260392,202112,112,95,17,104500,18700,123200
260400,202112,4339,2457,1882,2706000.5,2072400,4778400.5
260410,202112,14966,7719,7247,8503000.63,7977200,16480200.63
260415,202112,143,121,22,134200,24200,158400
260420,202112,1741,1057,684,1163800,752400,1916200
260430,202112,172,155,17,170500.48,18700,189200.48
260440,202112,188,128,60,140800,66000,206800
260450,202112,427,318,109,350900.63,119900,470800.63
260460,202112,826,429,397,473000,436700,909700
260470,202112,332,202,130,222200,143000,365200
260480,202112,254,157,97,172700,106700,279400
260490,202112,218,172,46,189200,50600,239800
260500,202112,1128,751,377,826100,414700,1240800
260510,202112,786,620,166,682000,182600,864600
260515,202112,233,210,23,231000,25300,256300
260520,202112,3237,1991,1246,2193400,1372800,3566200
260530,202112,804,652,152,718300,167200,885500
260540,202112,525,414,111,456500,123200,579700
260545,202112,17,11,6,12100,6600,18700
260550,202112,330,209,121,229900,133100,363000
260560,202112,505,381,124,419100,136400,555500
260570,202112,995,785,210,863500,231000,1094500
260580,202112,273,234,39,257400,42900,300300
260590,202112,616,351,265,386100,291500,677600
260600,202112,7668,4390,3278,4834501.78,3608000,8442501.78
260610,202112,494,328,166,360800,182600,543400
260620,202112,3662,1875,1787,2064700,1970100.19,4034800.19
260630,202112,81,75,6,82500,6600,89100
260640,202112,3380,1931,1449,2126300,1599400,3725700
260650,202112,316,225,91,247500,100100,347600
260660,202112,566,357,209,392700,229900,622600
260670,202112,102,72,30,79200,33000,112200
260680,202112,3944,2154,1790,2369400,1971200,4340600
260690,202112,125,93,32,103400,35200,138600
260700,202112,308,205,103,225500,113300,338800
260710,202112,46,36,10,39600,11000,50600
260720,202112,2658,1558,1100,1714900,1211100,2926000
260730,202112,745,548,197,603900,216700,820600
260740,202112,69,57,12,62700,13200,75900
260750,202112,561,406,155,447700,170500,618200
260760,202112,696,341,355,376200.3,390500,766700.3
260765,202112,971,495,476,544500,523600,1068100
260770,202112,219,160,59,175981,64900,240881
260775,202112,777,417,360,458700,396000,854700
260780,202112,241,147,94,161700,103400,265100
260790,202112,15082,7410,7672,8156500,8443600,16600100
260795,202112,161,103,58,113300,63800,177100
260800,202112,284,230,54,253000,59400,312400
260805,202112,172,113,59,124300,64900,189200
260810,202112,803,656,147,721600,161700,883300
260820,202112,289,186,103,205700,113300,319000
260825,202112,207,138,69,151800,75900,227700
260830,202112,298,182,116,200200,127600,327800
260840,202112,253,182,71,200200,78100,278300
260845,202112,174,111,63,122100,69300,191400
260850,202112,410,304,106,336600,116600,453200
260860,202112,253,188,65,206800,71500,278300
260870,202112,346,264,82,290400,90200,380600
260875,202112,734,533,201,586300,221100,807400
260880,202112,1542,1005,537,1106600,590700,1697300
260890,202112,2362,1625,737,1788600,810700,2599300
260900,202112,994,709,285,779900,313500,1093400
260910,202112,250,197,53,216700,58300,275000
260915,202112,278,207,71,227700,79200,306900
260920,202112,195,100,95,110000,104500,214500
260930,202112,369,311,58,342100,63800,405900
260940,202112,2590,1366,1224,1505900,1348600,2854500
260950,202112,1995,1122,873,1237500,961400,2198900
260960,202112,13644,6643,7001,7312800.9,7712100.5,15024901.4
260970,202112,419,342,77,376200,84700,460900
260980,202112,198,178,20,196900,22000,218900
260990,202112,2654,2118,536,2333100,589600,2922700
261000,202112,4195,2548,1647,2803900,1811700,4615600
261010,202112,154,109,45,119900,49500,169400
261020,202112,584,434,150,477400,165000,642400
261030,202112,256,185,71,203500,78100,281600
261040,202112,375,322,53,354200,58300,412500
261050,202112,500,423,77,465300,84700,550000
261060,202112,1442,886,556,974600,611600,1586200
261070,202112,9226,4375,4851,4816900.92,5340500.5,10157401.42
261080,202112,366,279,87,308000,95700,403700
261090,202112,2102,1611,491,1775402.03,543400,2318802.03
261100,202112,1208,840,368,925100,405900,1331000
261110,202112,9004,5498,3506,6055500.84,3857700,9913200.84
261120,202112,239,204,35,224400,38500,262900
261130,202112,566,330,236,363000,259600,622600
261140,202112,217,134,83,147400,91300,238700
261150,202112,679,431,248,475200.56,272800,748000.56
261153,202112,70,65,5,71500,5500,77000
261160,202112,75008,36513,38495,40195193.53,42388501.55,82583695.08
261170,202112,468,343,125,378400,137500,515900
261180,202112,1774,1100,674,1211351,741400,1952751
261190,202112,567,394,173,433400,190300,623700
261200,202112,221,180,41,198000,45100,243100
261210,202112,40,31,9,34100,9900,44000
261220,202112,2712,1887,825,2075700,908600,2984300
261230,202112,339,246,93,270600,102300,372900
261240,202112,444,385,59,423500,64900,488400
261245,202112,244,199,45,218900,49500,268400
261247,202112,169,131,38,144100,41800,185900
261250,202112,3443,1627,1816,1790800,1997600,3788400
261255,202112,248,221,27,243100,29700,272800
261260,202112,833,717,116,788700.12,127600,916300.12
261270,202112,199,137,62,150700,68200,218900
261280,202112,187,150,37,165000,40700,205700
261290,202112,112,83,29,91300,31900,123200
261300,202112,1323,972,351,1069200,386100,1455300
261310,202112,787,525,262,578600,288200,866800
261320,202112,561,378,183,415800,201300,617100
261330,202112,909,706,203,776600,223300.63,999900.63
261340,202112,310,169,141,185900,155100,341000
261350,202112,859,593,266,652300.4,292600,944900.4
261360,202112,1362,868,494,954800,543400,1498200
261370,202112,4841,2825,2016,3109700,2217600,5327300
261380,202112,546,418,128,459800.78,140800,600600.78
261390,202112,3633,2439,1194,2682900,1315600,3998500
261400,202112,273,246,27,270600,29700,300300
261410,202112,1104,718,386,792000,425700,1217700
261420,202112,949,585,364,643500.32,400400,1043900.32
261430,202112,318,289,29,317900,31900,349800
261440,202112,107,102,5,112200,5500,117700
261450,202112,2499,1973,526,2171400,579700,2751100
261460,202112,756,590,166,649000,182600,831600
261470,202112,228,185,43,203500,47300,250800
261480,202112,453,346,107,380600,117650.5,498250.5
261485,202112,368,220,148,243100,162800,405900
261500,202112,611,405,206,445500.59,226600,672100.59
261510,202112,51,32,19,35200,20900,56100
261520,202112,88,71,17,78100,18700,96800
261530,202112,4073,2560,1513,2817100.09,1665400,4482500.09
261540,202112,1437,826,611,909700,672100,1581800
261550,202112,258,125,133,137500,146300,283800
261560,202112,912,592,320,652300,352000,1004300
261570,202112,395,309,86,339900,94600,434500
261580,202112,393,311,82,342100,90200,432300
261590,202112,191,156,35,171600,38500,210100
261600,202112,287,225,62,247500,68200,315700
261610,202112,83,71,12,78100,13200,91300
261618,202112,75,56,19,61600,20900,82500
261620,202112,195,122,73,134200,81400,215600
261630,202112,669,529,140,581900,154000,735900
261640,202112,6504,3383,3121,3726801.05,3437500,7164301.05
261650,202112,472,301,171,332200,188100,520300
270010,202112,507,449,58,493900,63800,557700
270020,202112,243,198,45,217836.66,49500,267336.66
270030,202112,8753,5603,3150,6172613.93,3474851,9647464.93
270040,202112,2065,1339,726,1474000,798600,2272600
270050,202112,199,153,46,168300,50600,218900
270060,202112,74,49,25,53900,27500,81400
270070,202112,836,611,225,672100,247500,919600
270080,202112,40,32,8,35200,8800,44000
270090,202112,23,16,7,17600,7700,25300
270100,202112,1317,898,419,990000,460900,1450900
270110,202112,74,63,11,69300,12100,81400
270120,202112,233,188,45,206800,49500,256300
270130,202112,321,236,85,259600,93500,353100
270135,202112,120,82,38,91300,41800,133100
270140,202112,1365,888,477,977900,525800,1503700
270150,202112,253,194,59,213400,66000,279400
270160,202112,483,382,101,420200,111100,531300
270170,202112,789,513,276,565400,303600,869000
270180,202112,60,49,11,53900,12100,66000
270190,202112,114,96,18,105600,19800,125400
270200,202112,115,102,13,112200,14300,126500
270210,202112,537,327,210,359700,232100,591800
270220,202112,183,139,44,152900,49500,202400
270230,202112,2160,1346,814,1482800,895400,2378200
270235,202112,661,513,148,564300,162800,727100
270240,202112,2960,2351,609,2586101.25,671000,3257101.25
270250,202112,125,91,34,100100,37400,137500
270255,202112,209,178,31,195800,34100,229900
270260,202112,361,292,69,321200,77000,398200
270270,202112,96,51,45,56100,49500,105600
270280,202112,224,134,90,147400,99000,246400
270290,202112,1103,865,238,952600,261800,1214400
270300,202112,354,259,95,284900,104500,389400
270310,202112,810,675,135,742500,148500,891000
270320,202112,789,680,109,748000.63,119900,867900.63
270330,202112,300,253,47,279400,51700,331100
270340,202112,57,46,11,50600,12100,62700
270350,202112,90,53,37,58300,40700,99000
270360,202112,68,37,31,40700,34100,74800
270370,202112,59,46,13,50600,14300,64900
270375,202112,75,45,30,49500,33000,82500
270380,202112,1065,713,352,784300,388300,1172600
270390,202112,151,85,66,93500,72600,166100
270400,202112,729,552,177,607200.2,194700,801900.2
270410,202112,620,459,161,504900,177100,682000
270420,202112,399,280,119,308036.66,132000,440036.66
270430,202112,34130,24437,9693,26901268.73,10678800,37580068.73
270440,202112,477,379,98,416900,107800,524700
270450,202112,842,501,341,551100,377300,928400
270460,202112,180,144,36,158400,39600,198000
270470,202112,1550,1073,477,1181583.32,524700,1706283.32
270480,202112,533,434,99,477400,108900,586300
270490,202112,20,15,5,16500,5500,22000
270500,202112,480,402,78,442200,85800,528000
270510,202112,849,540,309,594000,339900,933900
270520,202112,271,177,94,194700,104500,299200
270530,202112,59,50,9,55000,9900,64900
270540,202112,92,67,25,73700,27500,101200
270550,202112,1697,1310,387,1442100,425700,1867800
270560,202112,260,154,106,169400,116600,286000
270570,202112,546,384,162,422400,178200,600600
270580,202112,79,62,17,69300,18700,88000
270590,202112,59,46,13,50600,14300,64900
270600,202112,156,133,23,146300,25300,171600
270610,202112,234,184,50,202400,55000,257400
270620,202112,14,14,0,15400,,15400.0
270630,202112,3686,2796,890,3075856.66,979000,4054856.66
270640,202112,852,635,217,698500.44,238700,937200.44
270642,202112,213,179,34,196900,37400,234300
270644,202112,254,173,81,190850,89100,279950
270650,202112,334,200,134,220000,147400,367400
270660,202112,198,173,25,190300,27500,217800
270670,202112,2932,2236,696,2460701.01,765600,3226301.01
270680,202112,405,252,153,277200,168300,445500
270690,202112,1220,813,407,894300,448800,1343100
270700,202112,25,20,5,22000,5500,27500
270710,202112,860,679,181,748000,199100,947100
270720,202112,230,181,49,199100,53900,253000
270730,202112,1880,1166,714,1283700.92,785400,2069100.92
270740,202112,37,23,14,26400,15400,41800
270750,202112,629,478,151,525800,166100,691900
270760,202112,295,210,85,231000,93500,324500
270770,202112,2777,1873,904,2061766.66,995500,3057266.66
270780,202112,66,42,24,46200,26400,72600
270790,202112,235,151,84,167200,92400,259600
270800,202112,2031,1625,406,1789700,446600,2236300
270810,202112,223,184,39,202400,42900,245300
270820,202112,127,89,38,97900,41800,139700
270830,202112,816,620,196,682000,216700,898700
270840,202112,1341,1028,313,1131900.4,345400,1477300.4
270850,202112,1502,972,530,1072500,584100,1656600
270860,202112,2545,1716,829,1887600.7,915200,2802800.7
270870,202112,116,64,52,70400,57200,127600
270880,202112,860,683,177,751300.85,194700,946000.85
270890,202112,270,205,65,225500,71500,297000
270895,202112,54,52,2,57200,2200,59400
270900,202112,64,54,10,59400,11000,70400
270910,202112,296,243,53,267300,58300,325600
270915,202112,1913,1250,663,1375000,729300,2104300
270920,202112,434,362,72,399300,79200,478500
270930,202112,5780,4412,1368,4858700,1504800.14,6363500.14
270940,202112,2203,1740,463,1916200,509300,2425500
280010,202112,37,31,6,34100,6600,40700
280020,202112,484,415,69,456500,75900,532400
280030,202112,21110,13598,7512,14967701.68,8267601.56,23235303.24
280040,202112,325,209,116,229900,127600,357500
280050,202112,419,322,97,354566.66,106700,461266.66
280060,202112,361,238,123,261800,135300,397100
280067,202112,1115,800,315,881100,346500.5,1227600.5
280070,202112,130,107,23,117700,25300,143000
280100,202112,652,504,148,554400.83,165000,719400.83
280110,202112,74,68,6,74800,6600,81400
280120,202112,666,554,112,609400,123200,732600
280130,202112,1751,1141,610,1257300,672100,1929400
280140,202112,492,411,81,452100,89100,541200
280150,202112,414,287,127,315700,140800,456500
280160,202112,131,105,26,115500,28600,144100
280170,202112,420,292,128,322300,140800,463100
280190,202112,27,22,5,24200,5500,29700
280200,202112,38,31,7,34100,7700,41800
280210,202112,2934,2100,834,2311014.7,917400,3228414.7
280220,202112,48,39,9,42900,9900,52800
280230,202112,333,270,63,297000,69300,366300
280240,202112,131,123,8,135300,8800,144100
280250,202112,20,12,8,13200,8800,22000
280260,202112,77,70,7,77000,7700,84700
280270,202112,141,109,32,119900,35200,155100
280280,202112,189,121,68,133100.5,74800,207900.5
280290,202112,3494,2518,976,2771929.5,1074700,3846629.5
280300,202112,1605,1271,334,1399200,367400,1766600
280310,202112,96,91,5,100100,5500,105600
280320,202112,645,453,192,498300,211200,709500
280330,202112,320,236,84,259600,92400,352000
280340,202112,448,359,89,394900,97900,492800
280350,202112,3732,2863,869,3149300.66,957000.08,4106300.74
280360,202112,462,312,150,343200,165000,508200
280370,202112,97,84,13,92400,14300,106700
280380,202112,51,39,12,42900,14300,57200
280390,202112,171,144,27,159500,29700,189200
280400,202112,375,254,121,279400,133100,412500
280410,202112,286,236,50,259600,55000,314600
280420,202112,135,116,19,127600,20900,148500
280430,202112,87,69,18,75900,19800,95700
280440,202112,734,591,143,651200,157300,808500
280445,202112,121,114,7,125400,7700,133100
280450,202112,1249,1076,173,1185800,190300,1376100
280460,202112,649,469,180,517000.93,198000,715000.93
280470,202112,107,96,11,105600,12100,117700
280480,202112,2891,1950,941,2146101.67,1036200.5,3182302.17
280490,202112,200,188,12,206800.96,13200,220000.96
280500,202112,42,39,3,42900,3300,46200
280510,202112,135,107,28,117700,30800,148500
280520,202112,51,37,14,40700,15400,56100
280530,202112,80,50,30,55000,33000,88000
280540,202112,536,457,79,502700,86900,589600
280550,202112,733,674,59,742500.65,64900,807400.65
280560,202112,481,429,52,471900.85,57200,529100.85
280570,202112,2327,1822,505,2004200,555500,2559700
280580,202112,578,448,130,493900.07,143000,636900.07
280590,202112,219,140,79,154000,86900,240900
280600,202112,396,326,70,358651.7,77000,435651.7
280610,202112,111,81,30,89100,33000,122100
280620,202112,533,433,100,476300,110000,586300
280630,202112,150,125,25,137500,27500,165000
280640,202112,188,151,37,166100,40700,206800
280650,202112,89,56,33,61600,36300,97900
280660,202112,138,102,36,112200,39600,151800
280670,202112,1939,1221,718,1345300,789800.48,2135100.48
280680,202112,230,198,32,217800,36300,254100
280690,202112,80,69,11,77000,12100,89100
280700,202112,19,19,0,20900,,20900.0
280710,202112,1494,1153,341,1268300.88,375100,1643400.88
280720,202112,122,82,40,90200,44000,134200
280730,202112,29,24,5,26400,5500,31900
280740,202112,2554,1907,647,2097700,712800,2810500
280750,202112,230,199,31,218900,34100,253000
280760,202112,847,572,275,629200,302500,931700
290010,202112,195,137,58,150700,63800,214500
290020,202112,187,169,18,185900,19800,205700
290030,202112,623,400,223,441100,245300,686400
290035,202112,131,107,24,117700,26400,144100
290040,202112,299,201,98,221100,107800,328900
290050,202112,88,71,17,78100,18700,96800
290060,202112,255,113,142,124300,156200,280500
290070,202112,5777,2737,3040,3012901.66,3348400,6361301.66
290080,202112,449,193,256,212300,281600,493900
290090,202112,364,164,200,180400,220000,400400
290100,202112,1674,1071,603,1180300,664400,1844700
290110,202112,854,492,362,541200.85,398200,939400.85
290115,202112,193,177,16,194700,17600,212300
290120,202112,779,519,260,570900,287100,858000
290130,202112,447,273,174,302500,191400,493900
290135,202112,296,228,68,250800,74800,325600
290140,202112,320,264,56,290400,61600,352000
290150,202112,134,90,44,99000,48400,147400
290160,202112,247,190,57,209000.44,62700,271700.44
290170,202112,93,65,28,71500,30800,102300
290180,202112,187,135,52,148500,57200,205700
290190,202112,368,288,80,316800,88000,404800
290195,202112,299,193,106,212300,117700,330000
290200,202112,261,213,48,234300,52800,287100
290205,202112,144,91,53,100100,58300,158400
290210,202112,1184,864,320,951500,352000,1303500
290220,202112,192,106,86,116600,94600,211200
290225,202112,301,122,179,135300,196900,332200
290230,202112,77,47,30,51700,33000,84700
290240,202112,361,124,237,136400,261800,398200
290250,202112,246,228,18,250800,19800,270600
290260,202112,323,261,62,288200,68200,356400
290265,202112,182,160,22,176000,24200,200200
290270,202112,1394,1160,234,1278200.83,257400,1535600.83
290280,202112,475,333,142,366300,157300,523600
290290,202112,1360,810,550,893200.5,605000,1498200.5
290300,202112,401,342,59,377300,64900,442200
290310,202112,288,137,151,151800,166100,317900
290320,202112,4130,2511,1619,2762100.11,1782000,4544100.11
290323,202112,193,170,23,188100,25300,213400
290327,202112,157,122,35,134200,38500,172700
290330,202112,121,59,62,64900,68200,133100
290340,202112,782,322,460,354200,506000,860200
290350,202112,663,406,257,447700,282700,730400
290360,202112,318,245,73,269500.99,80300,349800.99
290370,202112,907,398,509,437800,559900,997700
290380,202112,326,208,118,228800,129800,358600
290390,202112,2411,1492,919,1641200,1012000,2653200
290395,202112,236,133,103,146300,113300,259600
290400,202112,281,202,79,222200,88000,310200
290405,202112,243,207,36,227700,39600,267300
290410,202112,621,515,106,566500,117700,684200
290420,202112,266,215,51,236500,56100,292600
290430,202112,474,299,175,328900,193600,522500
290440,202112,79,70,9,77000,9900,86900
290450,202112,188,142,46,156200,50600,206800
290460,202112,1926,1141,785,1256200,863500,2119700
290470,202112,1371,597,774,657800,852500,1510300
290475,202112,555,517,38,569800.27,41800,611600.27
290480,202112,275,159,116,174900,127600,302500
290485,202112,233,213,20,234300,22000,256300
290490,202112,1237,876,361,966900,397100,1364000
290500,202112,763,397,366,437800,402600,840400
290510,202112,203,161,42,177100,46200,223300
290515,202112,162,97,65,106700,71500,178200
290520,202112,1384,901,483,992200,532400.2,1524600.2
290530,202112,288,261,27,288200,29700,317900
290540,202112,112,56,56,61600,61600,123200
290550,202112,163,137,26,150700,28600,179300
290560,202112,3179,1384,1795,1522400,1974500,3496900
290570,202112,6388,3060,3328,3368200,3661900,7030100
290580,202112,1263,757,506,833800,557700,1391500
290590,202112,566,454,112,499400,123200,622600
290600,202112,1751,1197,554,1317800,609400,1927200
290610,202112,180,165,15,181500,16500,198000
290620,202112,364,330,34,363000,37400,400400
290630,202112,1973,839,1134,924000,1247400,2171400
290640,202112,142,113,29,124300,31900,156200
290650,202112,1826,840,986,926200.92,1084600,2010800.92
290660,202112,266,220,46,242000,50600,292600
290670,202112,948,479,469,526900,517000,1043900
290680,202112,1238,990,248,1089000,272800,1361800
290682,202112,314,231,83,254100.48,91300,345400.48
290685,202112,243,153,90,168300,99000,267300
290687,202112,1106,717,389,789979,429000,1218979
290689,202112,149,78,71,85800,78100,163900
290690,202112,589,255,334,280500,367400,647900
290700,202112,237,120,117,132000,129800,261800
290710,202112,763,514,249,566500,273900,840400
290720,202112,1027,821,206,904200,226600,1130800
290730,202112,1205,704,501,774400,551100,1325500
290740,202112,22,18,4,19800,4400,24200
290750,202112,1432,618,814,679800,899800,1579600
290755,202112,71,63,8,69300,8800,78100
290760,202112,261,232,29,255200,33000,288200
290770,202112,181,172,9,189200,9900,199100
290780,202112,1108,869,239,955900,262900,1218800
290790,202112,377,256,121,281600,133100,414700
290800,202112,2424,968,1456,1065900,1604900,2670800
290810,202112,476,323,153,355300,168300,523600
290820,202112,406,235,171,258500,188100,446600
290830,202112,425,302,123,332200,135300,467500
290840,202112,1802,1117,685,1228700,753500,1982200
290850,202112,918,462,456,508200,502700,1010900
290860,202112,634,285,349,313500,386100,699600
290870,202112,610,427,183,470800,201300,672100
290880,202112,118,64,54,70400,59400,129800
290890,202112,428,262,166,288200,182600,470800
290900,202112,165,123,42,135300,46200,181500
290910,202112,384,290,94,319000,103400,422400
290920,202112,199,174,25,191400,27500,218900
290930,202112,510,387,123,425700,135300,561000
290940,202112,229,193,36,212300,39600,251900
290950,202112,159,92,67,101200,73700,174900
290960,202112,471,328,143,360800,157300,518100
290970,202112,240,211,29,232100,31900,264000
290980,202112,1768,1199,569,1318900,628100,1947000
290990,202112,399,337,62,370700,69300,440000
291000,202112,880,274,606,301400,667700,969100
291005,202112,2461,1047,1414,1156100,1555400,2711500
291010,202112,161,143,18,157300,19800,177100
291020,202112,92,73,19,80300,20900,101200
291030,202112,94,66,28,72600,30800,103400
291040,202112,617,348,269,382800,298100,680900
291050,202112,1509,799,710,878900,782100,1661000
291060,202112,1644,906,738,998800,812900,1811700
291070,202112,1948,1453,495,1600500,544501.3,2145001.3
291072,202112,7156,2640,4516,2909500.1,4972000,7881500.1
291075,202112,241,193,48,212300,52800,265100
291077,202112,59,41,18,45100,19800,64900
291080,202112,20635,8798,11837,9683300.75,13035000,22718300.75
291085,202112,271,221,50,243100,55000,298100
291090,202112,278,113,165,124300,181500,305800
291100,202112,1009,335,674,368500,741400,1109900
291110,202112,425,324,101,356400,111100,467500
291120,202112,2415,1236,1179,1359600,1296900,2656500
291125,202112,60,30,30,33000,33000,66000
291130,202112,191,167,24,183700,26400,210100
291140,202112,127,105,22,115500,24200,139700
291150,202112,382,145,237,159500,260700,420200
291160,202112,378,304,74,334400,81400,415800
291165,202112,48,36,12,39600,13200,52800
291170,202112,3229,1586,1643,1746800.5,1810600,3557400.5
291180,202112,1242,495,747,544500,822800,1367300
291185,202112,108,101,7,111100,7700,118800
291190,202112,1386,657,729,722700,803000,1525700
291200,202112,169,123,46,135300,50600,185900
291210,202112,2373,944,1429,1038400,1571900,2610300
291220,202112,289,222,67,244200,73700,317900
291230,202112,967,336,631,369600,694100,1063700
291240,202112,410,381,29,419100,31900,451000
291250,202112,423,340,83,374000,91300,465300
291260,202112,59,52,7,57200,8800,66000
291270,202112,1046,451,595,496100,654500,1150600
291280,202112,358,167,191,183700,210100,393800
291290,202112,1690,886,804,975700,885500,1861200
291300,202112,229,180,49,198000,53900,251900
291310,202112,224,198,26,217800,28600,246400
291320,202112,1317,921,396,1014200,436700,1450900
291330,202112,137,116,21,127600,23100,150700
291340,202112,220,131,89,145200,97900,243100
291345,202112,123,83,40,91300,44000,135300
291350,202112,1731,630,1101,693000,1212200,1905200
291360,202112,8381,3961,4420,4359300,4864200,9223500
291370,202112,1110,643,467,707300,513700,1221000
291380,202112,253,201,52,221100,57200,278300
291390,202112,3992,1771,2221,1949200,2445300,4394500
291400,202112,2077,1454,623,1599400,685300.42,2284700.42
291410,202112,192,163,29,179300,31900,211200
291420,202112,110,83,27,91300,29700,121000
291430,202112,166,97,69,106700,75900.5,182600.5
291440,202112,520,421,99,464200.57,108900,573100.57
291450,202112,929,604,325,664400,358600,1023000
291460,202112,1932,1542,390,1696200,429000,2125200
291465,202112,2248,1066,1182,1173700,1300200,2473900
291470,202112,2878,1445,1433,1590600.55,1577400,3168000.55
291480,202112,11862,5101,6761,5617701.62,7449200,13066901.62
291490,202112,635,255,380,280500,420200,700700
291500,202112,370,218,152,239800,167200,407000
291510,202112,1198,458,740,506000,814000,1320000
291520,202112,937,418,519,459800,570900,1030700
291530,202112,911,248,663,272800,731500,1004300
291535,202112,117,97,20,106700,22000,128700
291540,202112,363,120,243,132000,268400,400400
291550,202112,1286,601,685,661100,753500,1414600
291560,202112,5111,2538,2573,2797300,2833600,5630900
291570,202112,217,110,107,121000,117700,238700
291580,202112,1195,739,456,815100,501600,1316700
291590,202112,100,43,57,47300,62700,110000
291600,202112,1123,562,561,618200,617100,1235300
291610,202112,1408,679,729,746900,801900,1548800
291620,202112,563,265,298,291500,327800,619300
291630,202112,484,151,333,166100,367400,533500
291640,202112,4002,1994,2008,2194500.47,2212100,4406600.47
291650,202112,432,296,136,325600.5,149600,475200.5
291660,202112,367,148,219,162800,240900,403700
291670,202112,175,107,68,117700,74800,192500
291680,202112,638,387,251,425700,276100,701800
291685,202112,576,330,246,363000,271700,634700
291690,202112,452,287,165,315700,182600.92,498300.92
291700,202112,1002,775,227,853600,249700,1103300
291710,202112,1579,764,815,841500,896500,1738000
291720,202112,425,287,138,316800,151800,468600
291730,202112,919,530,389,583000,427900,1010900
291733,202112,287,190,97,209000,106700,315700
291735,202112,76,59,17,64900,18700,83600
291740,202112,345,261,84,287100,92400,379500
291750,202112,2246,1447,799,1593900.25,878900,2472800.25
291760,202112,3012,1645,1367,1809500,1504800,3314300
291770,202112,734,502,232,555500,255200,810700
291780,202112,66,39,27,42900,29700,72600
291790,202112,158,82,76,90200,83600,173800
291800,202112,10206,4246,5960,4671700.42,6562600,11234300.42
291810,202112,1075,806,269,886600,295900,1182500
291820,202112,283,202,81,222200,89100,311300
291830,202112,1024,417,607,460900.59,669900,1130800.59
291835,202112,550,509,41,559900,45100,605000
291840,202112,5065,2511,2554,2764300,2812700,5577000
291845,202112,267,83,184,91300,202400,293700
291850,202112,313,277,36,304700,39600,344300
291855,202112,261,108,153,118800,168300,287100
291860,202112,161,100,61,110000,67100,177100
291870,202112,80,36,44,39600,49500,89100
291875,202112,160,149,11,165000,12100,177100
291880,202112,419,340,79,374000,86900,460900
291890,202112,237,80,157,88000,172700,260700
291900,202112,55,32,23,35200,25300,60500
291905,202112,114,88,26,96800,28600,125400
291910,202112,157,124,33,136400,36300,172700
291915,202112,437,388,49,427900,53900,481800
291920,202112,5333,2598,2735,2858900,3011800,5870700
291930,202112,166,100,66,110000.27,72600,182600.27
291940,202112,363,209,154,229900,169400,399300
291950,202112,1139,902,237,993300,260700,1254000
291955,202112,1337,805,532,886600,586300,1472900
291960,202112,201,148,53,162800,58300,221100
291970,202112,758,564,194,620400,213400,833800
291980,202112,1455,1269,186,1397000.73,205700,1602700.73
291990,202112,140,129,11,141900,12100,154000
291992,202112,175,89,86,97900,94600,192500
291995,202112,184,117,67,129800,73700,203500
292000,202112,403,299,104,328900,114400,443300
292010,202112,323,221,102,243100,112200,355300
292020,202112,300,221,79,243100,86900,330000
292030,202112,141,107,34,117700,37400,155100
292040,202112,597,309,288,339900,319000,658900
292045,202112,115,103,12,113300,13200,126500
292050,202112,922,666,256,733700,281600,1015300
292060,202112,875,710,165,782100,181500,963600
292070,202112,61,23,38,25300,41800,67100
292080,202112,148,102,46,112200,50600,162800
292090,202112,524,177,347,194700,381700,576400
292100,202112,1514,655,859,720500,944900,1665400
292105,202112,180,163,17,179300,18700,198000
292110,202112,2252,822,1430,906400,1574100,2480500
292120,202112,698,539,159,594000,174900,768900
292130,202112,462,256,206,281600,226600,508200
292140,202112,216,173,43,190300,47300,237600
292145,202112,162,84,78,92400,85800,178200
292150,202112,1491,1226,265,1348600,291500,1640100
292160,202112,159,125,34,137500,37400,174900
292170,202112,1191,1022,169,1124200,185900,1310100
292180,202112,225,163,62,181500,69300,250800
292190,202112,157,103,54,113300,59400,172700
292200,202112,1397,508,889,558800,980100,1538900
292205,202112,116,98,18,107800,19800,127600
292210,202112,377,258,119,284900,130900,415800
292220,202112,31,20,11,22000,12100,34100
292225,202112,45,36,9,39600,9900,49500
292230,202112,969,734,235,808500,258500,1067000
292240,202112,620,447,173,492800,190300,683100
292250,202112,1653,1067,586,1173700,644600,1818300
292260,202112,400,239,161,262900,177100,440000
292265,202112,246,181,65,199100,71500,270600
292270,202112,713,335,378,368500,415800,784300
292273,202112,206,118,88,129800,96800,226600
292275,202112,170,86,84,94600,92400,187000
292280,202112,143,98,45,107800,49500,157300
292285,202112,84,66,18,72600,19800,92400
292290,202112,579,380,199,419100,218900,638000
292300,202112,1747,655,1092,721600,1202300,1923900
292303,202112,123,79,44,86900,48400,135300
292305,202112,116,87,29,95700,31900,127600
292310,202112,957,623,334,686400,368500,1054900
292320,202112,583,434,149,477400,163900,641300
292330,202112,180,111,69,122100,75900,198000
292335,202112,290,230,60,253000,66000,319000
292340,202112,561,382,179,420200,198000,618200
292350,202112,268,146,122,160600,134200,294800
292360,202112,707,532,175,587400,192500,779900
292370,202112,727,549,178,603900,195800,799700
292380,202112,618,506,112,556600,123200,679800
292390,202112,393,157,236,172700,260700,433400
292400,202112,3637,2248,1389,2473900.41,1529000,4002900.41
292405,202112,271,182,89,200200,97900,298100
292410,202112,122,74,48,82500,52800,135300
292420,202112,289,249,40,275000,44000,319000
292430,202112,544,397,147,436700,161700,598400
292440,202112,623,522,101,574200.56,111100,685300.56
292450,202112,240,183,57,201300,62700,264000
292460,202112,520,385,135,423500,149600,573100
292465,202112,204,174,30,191400,33000,224400
292467,202112,145,90,55,99000,60500,159500
292470,202112,304,209,95,229900,104500,334400
292480,202112,386,260,126,286000,140800,426800
292490,202112,239,174,65,191400,71500,262900
292500,202112,878,402,476,442200.32,523600,965800.32
292510,202112,3526,1653,1873,1818300,2061400,3879700
292520,202112,1109,510,599,562100,661100,1223200
292525,202112,422,302,120,332200,132000,464200
292530,202112,4652,1821,2831,2006400.65,3116300,5122700.65
292540,202112,484,275,209,302500,229900,532400
292550,202112,1121,596,525,656700,578600,1235300
292560,202112,324,299,25,328900,27500,356400
292570,202112,310,239,71,262900,79200,342100
292575,202112,526,358,168,393800,184800,578600
292580,202112,997,667,330,733700,364100,1097800
292590,202112,552,485,67,533500,73700,607200
292593,202112,142,111,31,123200,34100,157300
292595,202112,205,163,42,179300,46200,225500
292600,202112,1256,902,354,993300.63,389400,1382700.63
292610,202112,114,91,23,100100,25300,125400
292620,202112,533,449,84,495000,92400,587400
292630,202112,1512,831,681,914100,752400,1666500
292640,202112,868,598,270,657800,297000,954800
292650,202112,186,149,37,163900.5,40700,204600.5
292660,202112,1933,1363,570,1501500,630300.92,2131800.92
292665,202112,139,98,41,107800,45100,152900
292670,202112,385,303,82,333300,91300,424600
292680,202112,264,194,70,213400,77000,290400
292690,202112,203,143,60,157300,66000,223300
292700,202112,1002,653,349,718300,383900,1102200
292710,202112,115,101,14,111100,15400,126500
292720,202112,950,541,409,596200,449900,1046100
292730,202112,199,97,102,107800,112200,220000
292740,202112,71363,34150,37213,37609001.7,40983800.28,78592801.98
292750,202112,382,278,104,306900,114400,421300
292760,202112,334,279,55,306900,60500,367400
292770,202112,852,364,488,400400,537900,938300
292780,202112,19,10,9,11000,9900,20900
292790,202112,784,407,377,447700,414700,862400
292800,202112,1252,741,511,815100,562100,1377200
292805,202112,384,124,260,136400,286000,422400
292810,202112,1795,1072,723,1179200,797500,1976700
292820,202112,696,587,109,645700,119900,765600
292830,202112,123,98,25,107800,27500,135300
292840,202112,690,562,128,618200,141900,760100
292850,202112,136,87,49,95700,53900,149600
292860,202112,2113,1221,892,1345300,982300,2327600
292870,202112,3588,2353,1235,2591600,1358500,3950100
292880,202112,1433,950,483,1045000,531300,1576300
292890,202112,527,438,89,484000,97900,581900
292895,202112,149,99,50,108900,55000,163900
292900,202112,347,246,101,270600,112200,382800
292905,202112,486,233,253,257400,278300,535700
292910,202112,467,348,119,382800,130900,513700
292920,202112,522,222,300,245300,330000,575300
292925,202112,472,432,40,475200,44000,519200
292930,202112,659,394,265,433400,294800,728200
292935,202112,278,118,160,129800,176000,305800
292937,202112,227,155,72,170500,79200,249700
292940,202112,186,142,44,156200,48400,204600
292950,202112,1231,595,636,654500,700700.6,1355200.6
292960,202112,529,371,158,409200,173800,583000
292970,202112,233,171,62,188100.48,69300,257400.48
292975,202112,93,55,38,60500,41800,102300
292980,202112,315,214,101,235400.61,111100,346500.61
292990,202112,1312,977,335,1074700,368500,1443200
293000,202112,113,79,34,86900,37400,124300
293010,202112,2906,1700,1206,1870000,1327700.5,3197700.5
293015,202112,612,497,115,546700,126500,673200
293020,202112,323,263,60,289300,66000,355300
293030,202112,580,509,71,559900,78100,638000
293040,202112,367,293,74,322300,81400,403700
293050,202112,2937,1728,1209,1903000,1331000,3234000
293060,202112,248,195,53,214500.48,58300,272800.48
293070,202112,3649,1818,1831,2000900,2016300,4017200
293075,202112,92,63,29,69300,31900,101200
293076,202112,75,56,19,61600,20900,82500
293077,202112,567,317,250,348700,275000,623700
293080,202112,421,376,45,414700,49500,464200
293090,202112,128,115,13,126500,14300,140800
293100,202112,525,361,164,397100,180400,577500
293105,202112,348,252,96,277200,105600,382800
293110,202112,121,81,40,89100,44000,133100
293120,202112,300,206,94,226600,103400,330000
293130,202112,249,166,83,182600,91300,273900
293135,202112,8184,3151,5033,3466100,5539600,9005700
293140,202112,191,113,78,124300,85800,210100
293150,202112,307,264,43,290400,47300,337700
293160,202112,422,258,164,283800,181500,465300
293170,202112,203,129,74,141900,81400,223300
293180,202112,559,382,177,420200,195800,616000
293190,202112,1345,920,425,1012000.7,467500,1479500.7
293200,202112,544,479,65,526900,73700,600600
293210,202112,416,320,96,352000,105600,457600
293220,202112,2396,1027,1369,1129700,1509200,2638900
293230,202112,1848,688,1160,756800.1,1277100,2033900.1
293240,202112,231,213,18,234300,19800,254100
293245,202112,129,107,22,117700,24200,141900
293250,202112,774,311,463,342100,509300,851400
293260,202112,305,248,57,272800,62700,335500
293270,202112,1170,526,644,579700,708400,1288100
293280,202112,298,175,123,192500,135300,327800
293290,202112,3031,1968,1063,2167000,1170400,3337400
293300,202112,781,550,231,605000,254100,859100
293305,202112,192,149,43,163900,47300,211200
293310,202112,169,126,43,138600,47300,185900
293315,202112,163,126,37,138600,40700,179300
293317,202112,89,64,25,70400,27500,97900
293320,202112,1095,588,507,646800,557700,1204500
293325,202112,193,71,122,79200,134200,213400
293330,202112,13982,6328,7654,6967400.38,8427100,15394500.38
293340,202112,289,203,86,223300,94600,317900
293345,202112,257,207,50,227700,55000,282700
293350,202112,583,350,233,386100,257400,643500
293360,202112,1497,1063,434,1169300,477400,1646700
310010,202112,142,73,69,80300,75900,156200
310020,202112,1005,549,456,606100,504900,1111000
310030,202112,313,249,64,273900,70400,344300
310040,202112,46,28,18,30800,19800,50600
310050,202112,157,98,59,107800,64900,172700
310060,202112,265,182,83,200200,91300,291500
310070,202112,15,9,6,9900,6600,16500
310080,202112,42,28,14,30800,15400,46200
310090,202112,1041,557,484,613800.8,532400,1146200.8
310100,202112,313,220,93,242000,102300,344300
310110,202112,685,367,318,403700,349800,753500
310120,202112,380,219,161,242000,177100,419100
310130,202112,30,17,13,18700,14300,33000
310140,202112,22,7,15,7700,16500,24200
310150,202112,1153,766,387,843700,426800,1270500
310160,202112,2040,986,1054,1084600.86,1162700,2247300.86
310163,202112,90,47,43,51700,48400,100100
310170,202112,2510,1133,1377,1246300,1515800,2762100
310180,202112,157,59,98,64900,107800,172700
310190,202112,474,321,153,353100,168300,521400
310200,202112,450,285,165,314600,181500,496100
310205,202112,66,44,22,48400,24200,72600
310210,202112,268,218,50,239800,55000,294800
310220,202112,62,33,29,36300,31900,68200
310230,202112,272,190,82,211200,90200,301400
310240,202112,108,92,16,101200,17600,118800
310250,202112,97,76,21,83600,23100,106700
310260,202112,721,377,344,414700.92,378400,793100.92
310270,202112,266,171,95,188100,104500,292600
310280,202112,379,273,106,300300,116600,416900
310285,202112,198,149,49,165000,53900,218900
310290,202112,230,128,102,140800,112200,253000
310300,202112,170,137,33,151800,36300,188100
310310,202112,10,7,3,7700,3300,11000
310320,202112,30,10,20,11000,22000,33000
310330,202112,40,26,14,28600,15400,44000
310340,202112,1833,1239,594,1362900,654500,2017400
310350,202112,2731,1438,1293,1581800,1425600,3007400
310360,202112,44,37,7,40700,7700,48400
310370,202112,127,106,21,116600,23100,139700
310375,202112,107,38,69,41800,75900,117700
310380,202112,49,28,21,30800,23100,53900
310390,202112,107,68,39,74800,42900,117700
310400,202112,2394,1537,857,1691800.1,943800,2635600.1
310410,202112,113,62,51,68200,56100,124300
310420,202112,655,331,324,364100,356400,720500
310430,202112,271,166,105,182600,115500,298100
310440,202112,71,41,30,45100,34100,79200
310445,202112,76,63,13,69300,14300,83600
310450,202112,626,402,224,442200,247500,689700
310460,202112,249,171,78,188100,85800,273900
310470,202112,513,330,183,363000,201300,564300
310480,202112,88,55,33,60500,36300,96800
310490,202112,536,245,291,269500,320100,589600
310500,202112,129,49,80,53900,88000,141900
310510,202112,596,415,181,456500,199100,655600
310520,202112,141,101,40,111100,44000,155100
310530,202112,105,41,64,45100,70400,115500
310540,202112,463,261,202,288200,222200,510400
310550,202112,67,46,21,50600,23100,73700
310560,202112,3016,2051,965,2259400,1063700,3323100
310570,202112,98,59,39,64900,42900,107800
310590,202112,361,221,140,243100,154000,397100
310600,202112,140,70,70,78100,77000,155100
310610,202112,53,21,32,23100,35200,58300
310620,202112,47212,22016,25196,24247218.85,27750800,51998018.85
310630,202112,677,405,272,446600,299200.62,745800.62
310640,202112,132,93,39,102300,42900,145200
310650,202112,150,133,17,146300,18700,165000
310660,202112,108,74,34,81400,37400,118800
310665,202112,63,45,18,49500,19800,69300
310670,202112,6954,2966,3988,3269200.12,4391200,7660400.12
310680,202112,66,41,25,45100,27500,72600
310690,202112,614,430,184,473000,202400,675400
310700,202112,63,38,25,41800,27500,69300
310710,202112,1277,864,413,950713.5,455400,1406113.5
310720,202112,149,39,110,42900,121000,163900
310730,202112,1496,1016,480,1118700,529100,1647800
310740,202112,981,542,439,597300,482900,1080200
310750,202112,249,155,94,170500,103400,273900
310760,202112,67,52,15,57200,16500,73700
310770,202112,90,44,46,48400,50600,99000
310780,202112,352,285,67,313500.52,73700,387200.52
310790,202112,110,88,22,96800,24200,121000
310800,202112,467,217,250,238700,276100,514800
310810,202112,170,116,54,127600.72,59400,187000.72
310820,202112,323,261,62,287100,68200,355300
310825,202112,206,175,31,192500,34100,226600
310830,202112,462,214,248,235400,272800,508200
310840,202112,365,213,152,234300,168300,402600
310850,202112,78,64,14,70400,15400,85800
310855,202112,402,312,90,343200,99000,442200
310860,202112,1589,1165,424,1284800,467500,1752300
310870,202112,50,42,8,46200,8800,55000
310880,202112,81,66,15,72600,16500,89100
310890,202112,293,170,123,187000,135300,322300
310900,202112,625,272,353,299205.76,388311.52,687517.28
310910,202112,238,160,78,176000,85800,261800
310920,202112,434,249,185,273900,203500,477400
310925,202112,35,26,9,28600,9900,38500
310930,202112,1282,827,455,910800,503800,1414600
310940,202112,673,333,340,366300.19,374000,740300.19
310945,202112,124,77,47,84700,51700,136400
310950,202112,222,177,45,194700,49500,244200
310960,202112,77,24,53,26400,58300,84700
310970,202112,165,99,66,108900,72600,181500
310980,202112,45,29,16,31900,17600,49500
310990,202112,164,86,78,94600,85800,180400
311000,202112,802,380,422,420200.1,465300,885500.1
311010,202112,50,42,8,46200,8800,55000
311020,202112,42,24,18,26400,19800,46200
311030,202112,384,216,168,237600,184800,422400
311040,202112,41,32,9,35200,9900,45100
311050,202112,479,178,301,195800,331100,526900
311060,202112,785,436,349,479600,385000.87,864600.87
311070,202112,329,143,186,157300,204600,361900
311080,202112,105,60,45,67100,49500,116600
311090,202112,333,160,173,177100,190300,367400
311100,202112,556,329,227,361900,249700,611600
311110,202112,707,502,205,553300,225500,778800
311115,202112,73,51,22,56100,24200,80300
311120,202112,1047,558,489,616000,539000,1155000
311130,202112,292,170,122,187000,134200,321200
311140,202112,159,85,74,93500,81400,174900
311150,202112,348,217,131,238700,144100,382800
311160,202112,742,523,219,575300,240900,816200
311170,202112,87,71,16,78100,18700,96800
311180,202112,298,201,97,221100,106700,327800
311190,202112,42,16,26,17600,28600,46200
311200,202112,343,237,106,261800,116600,378400
311205,202112,34,25,9,27500,9900,37400
311210,202112,40,35,5,38500,5500,44000
311220,202112,31,27,4,29700,4400,34100
311230,202112,1646,1076,570,1183600,628100,1811700
311240,202112,201,123,78,135300,85800,221100
311250,202112,60,21,39,23100,42900,66000
311260,202112,547,345,202,379500,222200,601700
311265,202112,122,81,41,89100,45100,134200
311270,202112,286,199,87,218900,95700,314600
311280,202112,198,86,112,94600,123200,217800
311290,202112,100,82,18,90200,19800,110000
311300,202112,582,373,209,410300,229900,640200
311310,202112,18,15,3,16500,3300,19800
311320,202112,625,462,163,508200,180400,688600
311330,202112,1098,800,298,880000,328900,1208900
311340,202112,2610,1841,769,2025100,845900,2871000
311350,202112,270,209,61,229900,67100,297000
311360,202112,177,104,73,114400,80300,194700
311370,202112,1226,507,719,557700,793100,1350800
311380,202112,7,6,1,6600,1100,7700
311390,202112,248,137,111,150700,122100,272800
311400,202112,136,82,54,90200,59400,149600
311410,202112,116,55,61,60500,67100,127600
311420,202112,306,161,145,177100,159500,336600
311430,202112,824,547,277,602800,304700,907500
311440,202112,454,310,144,341000,158400,499400
311450,202112,292,175,117,193600,128700,322300
311455,202112,264,180,84,198000,92400,290400
311460,202112,130,55,75,60500,82500,143000
311470,202112,30,15,15,16500,16500,33000
311480,202112,52,26,26,28600,28600,57200
311490,202112,10,6,4,6600,4400,11000
311500,202112,30,14,16,15400,17600,33000
311510,202112,649,438,211,481800,232100,713900
311520,202112,39,31,8,34100,8800,42900
311530,202112,1794,1291,503,1421200,554400,1975600
311535,202112,65,44,21,48400,23100,71500
311540,202112,34,29,5,31900,5500,37400
311545,202112,155,113,42,124300,46200,170500
311547,202112,44,33,11,36300,12100,48400
311550,202112,642,283,359,312400,394900,707300
311560,202112,43,26,17,28600,18700,47300
311570,202112,283,190,93,209000,102300,311300
311580,202112,391,237,154,260700,169400,430100
311590,202112,30,26,4,28600,4400,33000
311600,202112,97,78,19,85800,20900,106700
311610,202112,247,209,38,229900,41800,271700
311615,202112,124,101,23,111100,25300,136400
311620,202112,27,15,12,16500,13200,29700
311630,202112,92,78,14,85800,15400,101200
311640,202112,140,67,73,73700,80300,154000
311650,202112,127,87,40,95700,44000,139700
311660,202112,421,201,220,221100,242000,463100
311670,202112,139,92,47,101200,51700,152900
311680,202112,208,157,51,172700,56100,228800
311690,202112,14,12,2,13200,2200,15400
311700,202112,192,139,53,152900,58300,211200
311710,202112,180,123,57,135300,62700,198000
311720,202112,39,29,10,31900,11000,42900
311730,202112,555,383,172,421300,189200,610500
311740,202112,25,18,7,19800,7700,27500
311750,202112,725,487,238,536800.7,264000,800800.7
311760,202112,75,33,42,36300,46200,82500
311770,202112,377,177,200,195800,220000,415800
311780,202112,189,93,96,102300,105600,207900
311783,202112,87,80,7,88000,7700,95700
311787,202112,39,15,24,16500,26400,42900
311790,202112,272,116,156,127600,171600,299200
311800,202112,684,432,252,475200,279400,754600
311810,202112,49,39,10,42900,11000,53900
311820,202112,121,95,26,104500,28600,133100
311830,202112,1881,1134,747,1247400,823900,2071300
311840,202112,1006,553,453,608300,498300,1106600
311850,202112,14,10,4,11000,4400,15400
311860,202112,9629,4077,5552,4491300,6112700,10604000
311870,202112,111,61,50,67100,55000,122100
311880,202112,944,681,263,749100,290400,1039500
311890,202112,198,93,105,102209,115500,217709
311900,202112,64,27,37,29700,40700,70400
311910,202112,1359,837,522,921800,574200,1496000
311920,202112,223,147,76,163900,83600,247500
311930,202112,909,512,397,563200,436700,999900
311940,202112,2555,1347,1208,1482800.89,1333200,2816000.89
311950,202112,66,44,22,48400,24200,72600
311960,202112,64,46,18,50600,19800,70400
311970,202112,23,12,11,13200,12100,25300
311980,202112,43,33,10,36300,11000,47300
311990,202112,36,26,10,28600,11000,39600
311995,202112,47,28,19,30800,20900,51700
312000,202112,20,14,6,15400,6600,22000
312010,202112,73,57,16,62700,17600,80300
312015,202112,73,57,16,62700,17600,80300
312020,202112,130,91,39,100100,42900,143000
312030,202112,67,50,17,55000,18700,73700
312040,202112,78,48,30,52800,33000,85800
312050,202112,197,110,87,121000,95700,216700
312060,202112,23,14,9,15400,9900,25300
312070,202112,76,48,28,52800,30800,83600
312080,202112,540,244,296,268400,325600,594000
312083,202112,59,36,23,39600,25300,64900
312087,202112,96,72,24,79200,26400,105600
312090,202112,3275,1982,1293,2183500.85,1423400,3606900.85
312100,202112,145,101,44,110847,48400,159247
312110,202112,113,67,46,73700,50600,124300
312120,202112,126,92,34,101200.63,37400,138600.63
312125,202112,84,50,34,56100,37400,93500
312130,202112,134,88,46,96800,51700,148500
312140,202112,141,111,30,122100,33000,155100
312150,202112,40,32,8,35200,8800,44000
312160,202112,1478,962,516,1062699,567600,1630299
312170,202112,11,8,3,8800,3300,12100
312180,202112,104,68,36,74800,39600,114400
312190,202112,37,33,4,36300,4400,40700
312200,202112,734,630,104,693000,114400,807400
312210,202112,119,60,59,66000,64900,130900
312220,202112,129,99,30,108900,33000,141900
312230,202112,3699,1666,2033,1835900,2240700,4076600
312235,202112,155,104,51,114400,56100,170500
312240,202112,82,57,25,62700,27500,90200
312245,202112,195,134,61,147400,67100,214500
312247,202112,83,60,23,66000,25300,91300
312250,202112,172,85,87,93500,95700,189200
312260,202112,99,66,33,72600,36300,108900
312270,202112,136,81,55,90200,60500,150700
312280,202112,31,14,17,15400,18700,34100
312290,202112,135,91,44,100100,48400,148500
312300,202112,198,130,68,143000,74800,217800
312310,202112,58,52,6,57200,6600,63800
312320,202112,418,257,161,282700,177100,459800
312330,202112,90,76,14,83600,15400,99000
312340,202112,33,16,17,17600,18700,36300
312350,202112,12,6,6,6600,6600,13200
312352,202112,96,68,28,74800,30800,105600
312360,202112,566,239,327,264000,359700,623700
312370,202112,327,183,144,201300,158400,359700
312380,202112,144,94,50,103400,55000,158400
312385,202112,151,125,26,137500.61,29700,167200.61
312390,202112,299,192,107,211200,117700,328900
312400,202112,379,283,96,311300,105600,416900
312410,202112,1109,362,747,399300,825000,1224300
312420,202112,648,484,164,532400,181500,713900
312430,202112,882,632,250,697400.5,275000,972400.5
312440,202112,39,30,9,33000,9900,42900
312450,202112,188,120,68,133100,74800,207900
312460,202112,29,14,15,15400,16500,31900
312470,202112,46,31,15,34100,16500,50600
312480,202112,169,103,66,113300,72600,185900
312490,202112,287,194,93,213400,102300,315700
312500,202112,35,21,14,23100,15400,38500
312510,202112,544,203,341,223300,375100,598400
312520,202112,31,10,21,11000,23100,34100
312530,202112,38,28,10,30800,11000,41800
312540,202112,86,77,9,84700,9900,94600
312550,202112,37,29,8,31900,8800,40700
312560,202112,200,154,46,169400,50600,220000
312570,202112,445,261,184,287100,202400,489500
312580,202112,93,48,45,53900,49500,103400
312590,202112,228,181,47,199100,51700,250800
312595,202112,129,106,23,116600,25300,141900
312600,202112,69,33,36,36300,39600,75900
312610,202112,1528,788,740,869000,815100,1684100
312620,202112,225,161,64,177100,70400,247500
312630,202112,69,56,13,61600,14300,75900
312640,202112,40,10,30,11000,33000,44000
312650,202112,145,121,24,133470.7,26400,159870.7
312660,202112,102,73,29,80300.01,31900,112200.01
312670,202112,928,595,333,655600,367400,1023000
312675,202112,34,26,8,28600,8800,37400
312680,202112,66,40,26,44000,29700,73700
312690,202112,232,114,118,125400,130900,256300
312695,202112,25,21,4,23100,4400,27500
312700,202112,238,137,101,150700,111100,261800
312705,202112,82,65,17,71500,18700,90200
312707,202112,134,95,39,104500,42900,147400
312710,202112,1866,1015,851,1116500.59,937200,2053700.59
312720,202112,53,28,25,30800,27500,58300
312730,202112,268,156,112,171600,124300,295900
312733,202112,47,36,11,39600,12100,51700
312735,202112,21,14,7,15400,7700,23100
312737,202112,70,38,32,41800,35200,77000
312738,202112,64,42,22,46200,24200,70400
312740,202112,79,53,26,58300,28600,86900
312750,202112,92,61,31,67100,34100,101200
312760,202112,276,192,84,211200,92400,303600
312770,202112,8449,3902,4547,4293300,5009400,9302700
312780,202112,443,339,104,372900,114400,487300
312790,202112,22,16,6,17600,6600,24200
312800,202112,1583,1099,484,1210000,532400,1742400
312810,202112,342,230,112,254100,124300,378400
312820,202112,183,139,44,152900,48400,201300
312825,202112,35,25,10,27500,11000,38500
312830,202112,199,114,85,125400,93500,218900
312840,202112,175,117,58,128700,64900,193600
312850,202112,40,36,4,39600,4400,44000
312860,202112,144,94,50,103400,55000,158400
312870,202112,1084,560,524,616000,576400,1192400
312880,202112,117,82,35,90200,38500,128700
312890,202112,159,112,47,123200,51700,174900
312900,202112,181,134,47,147400,51700,199100
312910,202112,177,99,78,108900,85800,194700
312920,202112,131,71,60,78100,66000,144100
312930,202112,322,219,103,240900,113300,354200
312940,202112,123,85,38,93500,41800,135300
312950,202112,694,472,222,520300,244200,764500
312960,202112,146,109,37,119900,40700,160600
312965,202112,105,81,24,89100,26400,115500
312970,202112,274,226,48,248600,52800,301400
312980,202112,2515,1254,1261,1381600,1389300,2770900
312990,202112,49,24,25,26400,27500,53900
313000,202112,52,30,22,33000,24200,57200
313005,202112,171,130,41,143000,45100,188100
313010,202112,946,390,556,429000,611600,1040600
313020,202112,193,96,97,105600,106700,212300
313030,202112,194,127,67,139700,73700,213400
313040,202112,83,24,59,26400,64900,91300
313050,202112,196,142,54,156200,59400,215600
313055,202112,39,30,9,33000,9900,42900
313060,202112,135,90,45,99000,49500,148500
313065,202112,62,45,17,49500,18700,68200
313070,202112,131,70,61,77000,67100,144100
313080,202112,37,17,20,18700,22000,40700
313090,202112,666,428,238,470800,261800,732600
313100,202112,199,71,128,78100,140800,218900
313110,202112,152,81,71,89100,78100,167200
313115,202112,214,118,96,129800,105600,235400
313120,202112,844,468,376,514800,413600,928400
313130,202112,5873,3178,2695,3499100,2965600,6464700
313140,202112,132,77,55,84700,60500,145200
313150,202112,294,233,61,256300,67100,323400
313160,202112,181,134,47,147400,51700,199100
313170,202112,1357,882,475,971300,522500,1493800
313180,202112,308,182,126,200200,138600,338800
313190,202112,726,426,300,469700,331100,800800
313200,202112,30,25,5,27500,5500,33000
313210,202112,998,846,152,930600,167200,1097800
313220,202112,297,175,122,193600,134200,327800
313230,202112,258,197,61,216700.5,67100,283800.5
313240,202112,2192,1091,1101,1200100,1212200,2412300
313250,202112,1241,941,300,1035100,330000,1365100
313260,202112,94,47,47,51700,51700,103400
313270,202112,1001,580,421,639100,464200,1103300
313280,202112,45,38,7,41800,7700,49500
313290,202112,213,169,44,187000,48400,235400
313300,202112,325,163,162,179300,179300,358600
313310,202112,243,109,134,121000,147400,268400
313320,202112,383,279,104,306900,114400,421300
313330,202112,1412,858,554,944900,610500,1555400
313340,202112,325,232,93,255200,102300,357500
313350,202112,463,297,166,326700,182600,509300
313360,202112,172,78,94,85800,103400,189200
313370,202112,232,78,154,85800,169400,255200
313375,202112,302,178,124,195800,136400,332200
313380,202112,1324,701,623,771100,687500,1458600
313390,202112,48,46,2,50600,2200,52800
313400,202112,395,269,126,295900,138600,434500
313410,202112,35,17,18,18700,19800,38500
313420,202112,4542,2459,2083,2707100,2293500,5000600
313430,202112,132,65,67,71500,73700,145200
313440,202112,1375,964,411,1061501.13,452100,1513601.13
313450,202112,70,34,36,37400,39600,77000
313460,202112,384,162,222,178200,244200,422400
313470,202112,525,241,284,265100,312400,577500
313480,202112,146,108,38,118800,41800,160600
313490,202112,541,242,299,266200,328900,595100
313500,202112,28,15,13,16500,14300,30800
313505,202112,1059,819,240,900900,264000,1164900
313507,202112,90,55,35,60500,38500,99000
313510,202112,2859,1783,1076,1965816.9,1184700,3150516.9
313520,202112,3429,2665,764,2933701.5,840400,3774101.5
313530,202112,32,20,12,22000,13200,35200
313535,202112,70,55,15,60500,16500,77000
313540,202112,68,50,18,55000,19800,74800
313545,202112,110,94,16,103400,17600,121000
313550,202112,221,185,36,203500,39600,243100
313560,202112,343,160,183,176000,201300,377300
313570,202112,69,21,48,23100,52800,75900
313580,202112,1317,745,572,821700,630300,1452000
313590,202112,68,40,28,44000,30800,74800
313600,202112,672,399,273,438900,300300,739200
313610,202112,50,42,8,46200,8800,55000
313620,202112,1344,654,690,720500,760100,1480600
313630,202112,1615,1217,398,1338700,437800,1776500
313640,202112,117,70,47,77000,51700,128700
313650,202112,233,109,124,119900,137500,257400
313652,202112,23,22,1,24200,1100,25300
313655,202112,73,46,27,50600,29700,80300
313657,202112,45,41,4,45100,4400,49500
313660,202112,125,80,45,88000,49519.8,137519.8
313665,202112,659,300,359,330000,394900,724900
313670,202112,10272,6983,3289,7690100.85,3622300,11312400.85
313680,202112,43,32,11,35200,12100,47300
313690,202112,130,94,36,103400,39600,143000
313695,202112,77,58,19,63800,20900,84700
313700,202112,332,262,70,288200,77000,365200
313710,202112,130,96,34,105600,37400,143000
313720,202112,1137,513,624,564300,687500,1251800
313730,202112,69,41,28,45100,30800,75900
313740,202112,146,114,32,125400,35200,160600
313750,202112,411,289,122,317900,134200,452100
313753,202112,221,162,59,178200,64900,243100
313760,202112,1348,497,851,546700,936100.95,1482800.95
313770,202112,395,273,122,300300,134200,434500
313780,202112,805,419,386,460900,425700,886600
313790,202112,29,28,1,30800,1100,31900
313800,202112,155,92,63,101200,69300,170500
313810,202112,84,50,34,55000,37400,92400
313820,202112,1336,627,709,690800,781000,1471800
313830,202112,52,36,16,39600,17600,57200
313835,202112,61,51,10,56100,11000,67100
313840,202112,1654,977,677,1076900,744700,1821600
313850,202112,211,87,124,95700,136400,232100
313860,202112,462,353,109,388300,119900,508200
313862,202112,173,117,56,128700,62700,191400
313865,202112,145,97,48,106700,52800,159500
313867,202112,56,44,12,48400,13200,61600
313868,202112,41,25,16,27500,18700,46200
313870,202112,98,52,46,57200,50600,107800
313880,202112,376,234,142,258500,156200,414700
313890,202112,331,175,156,193600,171600,365200
313900,202112,821,437,384,480700,423500,904200
313910,202112,143,97,46,106700,50600,157300
313920,202112,623,432,191,475200,210100.94,685300.94
313925,202112,35,29,6,31900,6600,38500
313930,202112,867,671,196,738100,215600,953700
313940,202112,1876,1135,741,1250700,816200,2066900
313950,202112,856,527,329,579700,361900,941600
313960,202112,1436,817,619,899800.87,680900,1580700.87
313970,202112,180,107,73,117700,80300,198000
313980,202112,207,136,71,149600,78100,227700
313990,202112,244,156,88,172700,97900,270600
314000,202112,869,574,295,631400,324500,955900
314010,202112,89,51,38,56100,41800,97900
314015,202112,73,19,54,20900,59400,80300
314020,202112,57,38,19,41800,20900,62700
314030,202112,73,36,37,39600,40700,80300
314040,202112,45,25,20,27500,22000,49500
314050,202112,291,169,122,185900,134200,320100
314053,202112,102,64,38,70400,41800,112200
314055,202112,290,181,109,199100,119900,319000
314060,202112,124,108,16,118800.83,17600,136400.83
314070,202112,1041,513,528,564300,580800,1145100
314080,202112,209,129,80,141900,88000,229900
314085,202112,162,110,52,121000,57200,178200
314090,202112,379,266,113,293700,124300,418000
314100,202112,523,414,109,455400,119900,575300
314110,202112,765,354,411,389400,452100,841500
314120,202112,70,40,30,44000,33000,77000
314130,202112,24,16,8,17600,8800,26400
314140,202112,1105,684,421,753500,463100,1216600
314150,202112,195,125,70,137500,77000,214500
314160,202112,325,244,81,268400,89100,357500
314170,202112,81,61,20,67100,22000,89100
314180,202112,731,642,89,706200,97900,804100
314190,202112,91,55,36,60500,39600,100100
314200,202112,490,330,160,363000,176000,539000
314210,202112,255,193,62,212300,68200,280500
314220,202112,302,215,87,236500,95700,332200
314225,202112,58,39,19,42900,20900,63800
314230,202112,115,52,63,57200,69300,126500
314240,202112,163,116,47,127600,51700,179300
314250,202112,59,35,24,38500,26400,64900
314260,202112,226,111,115,122100,126500,248600
314270,202112,401,310,91,341000,100100,441100
314280,202112,723,385,338,423450.5,372900,796350.5
314290,202112,528,415,113,456500,124300,580800
314300,202112,338,253,85,278300,93500,371800
314310,202112,1314,900,414,990275,455400,1445675
314315,202112,37,27,10,29700,11000,40700
314320,202112,575,381,194,420200,213400,633600
314330,202112,11395,5548,5847,6112700,6438300,12551000
314340,202112,603,267,336,293700,369600,663300
314345,202112,53,36,17,39600,18700,58300
314350,202112,175,110,65,121000,71500,192500
314360,202112,53,29,24,31900,26400,58300
314370,202112,71,48,23,52800,25300,78100
314380,202112,105,62,43,68200,47300,115500
314390,202112,3324,2136,1188,2352900,1307900,3660800
314400,202112,676,476,200,523600,220000,743600
314410,202112,489,312,177,344300,194700,539000
314420,202112,17,8,9,8800,9900,18700
314430,202112,2423,880,1543,968001.51,1699500,2667501.51
314435,202112,171,101,70,111100,77000,188100
314437,202112,32,22,10,24200,11000,35200
314440,202112,95,61,34,67100,38500,105600
314450,202112,165,111,54,122100,59400,181500
314460,202112,621,294,327,323400,359700,683100
314465,202112,100,62,38,68200,41800,110000
314467,202112,73,60,13,66000,14300,80300
314470,202112,401,200,201,220000,221100,441100
314480,202112,1022,458,564,503800,620400,1124200
314490,202112,43,25,18,27500,19800,47300
314500,202112,280,196,84,215600,92400,308000
314505,202112,104,64,40,70400,44000,114400
314510,202112,245,199,46,220000,50600,270600
314520,202112,1349,715,634,786500,698500,1485000
314530,202112,743,585,158,643500.7,173800,817300.7
314535,202112,165,100,65,110000,71500,181500
314537,202112,64,38,26,41800,28600,70400
314540,202112,19,12,7,13200,7700,20900
314545,202112,56,38,18,41800,19800,61600
314550,202112,68,35,33,38500,36300,74800
314560,202112,850,458,392,504900,433400,938300
314570,202112,18,15,3,16500,3300,19800
314580,202112,13,5,8,5500,8800,14300
314585,202112,26,19,7,20900,7700,28600
314587,202112,82,70,12,77000,13200,90200
314590,202112,550,377,173,414700,190300,605000
314600,202112,936,593,343,652300,378400,1030700
314610,202112,944,485,459,534600,504900,1039500
314620,202112,141,104,37,115500,40700,156200
314625,202112,98,72,26,79200,28600,107800
314630,202112,1131,596,535,656700,588500,1245200
314640,202112,83,53,30,58300,33000,91300
314650,202112,167,93,74,102300,81400,183700
314655,202112,62,45,17,49500,18700,68200
314660,202112,16,13,3,14300,3300,17600
314670,202112,207,160,47,176000,51700,227700
314675,202112,207,123,84,135300,92400,227700
314690,202112,563,300,263,330000,290400,620400
314700,202112,2219,1174,1045,1292500,1151700,2444200
314710,202112,1771,993,778,1093400.77,856900,1950300.77
314720,202112,383,215,168,237600,184800,422400
314730,202112,508,270,238,297000,261800,558800
314740,202112,752,350,402,385000,444400,829400
314750,202112,19,15,4,16500,4400,20900
314760,202112,360,156,204,171600,224400,396000
314770,202112,103,69,34,75900,37400,113300
314780,202112,22,9,13,9900,14300,24200
314790,202112,2429,1515,914,1668700,1005400,2674100
314795,202112,57,48,9,53900,11000,64900
314800,202112,2902,1668,1234,1835900.76,1357400,3193300.76
314810,202112,1466,836,630,919600,693000,1612600
314820,202112,109,62,47,68200,51700,119900
314830,202112,208,170,38,187000,41800,228800
314840,202112,85,47,38,51700,41800,93500
314850,202112,405,190,215,209000,236500,445500
314860,202112,660,508,152,558800,168300,727100
314870,202112,1571,805,766,885500.19,842600,1728100.19
314875,202112,51,46,5,50600,5500,56100
314880,202112,42,30,12,33000,13200,46200
314890,202112,51,27,24,29700,26400,56100
314900,202112,26,20,6,22000,6600,28600
314910,202112,232,151,81,166100,89100,255200
314915,202112,132,116,16,128700,17600,146300
314920,202112,87,56,31,61600,34100,95700
314930,202112,1022,487,535,536800,589600,1126400
314940,202112,41,32,9,35200,9900,45100
314950,202112,21,17,4,18700,4400,23100
314960,202112,23,17,6,18700,6600,25300
314970,202112,164,79,85,86900,93500,180400
314980,202112,301,190,111,209000,122100,331100
314990,202112,439,241,198,265100,218900,484000
314995,202112,152,65,87,71500,95700,167200
315000,202112,83,64,19,70400,22000,92400
315010,202112,35,22,13,24200,14300,38500
315015,202112,157,124,33,136400,37400,173800
315020,202112,69,58,11,63800,12100,75900
315030,202112,108,81,27,89100,29700,118800
315040,202112,79,49,30,53900,33000,86900
315050,202112,203,120,83,132000,91300,223300
315053,202112,49,33,16,36300,17600,53900
315057,202112,115,91,24,100100,26400,126500
315060,202112,70,58,12,63800,14300,78100
315070,202112,101,56,45,61600,49500,111100
315080,202112,379,299,80,328900,88000,416900
315090,202112,95,56,39,61600,42900,104500
315100,202112,79,38,41,41800,45100,86900
315110,202112,270,138,132,151800,145200,297000
315120,202112,1798,857,941,944900,1035100,1980000
315130,202112,336,243,93,267300,102300,369600
315140,202112,528,290,238,319000,262900,581900
315150,202112,969,462,507,508200,559900,1068100
315160,202112,196,100,96,110000,105600,215600
315170,202112,303,202,101,222200,111100,333300
315180,202112,3202,1330,1872,1466300,2061400,3527700
315190,202112,297,179,118,196900,129800,326700
315200,202112,1187,704,483,774400,531300,1305700
315210,202112,1625,937,688,1032900,761200,1794100
315213,202112,27,15,12,16500,13200,29700
315217,202112,196,153,43,169400,47300,216700
315220,202112,1592,1182,410,1300200,452100.02,1752300.02
315230,202112,172,130,42,143000,46200,189200
315240,202112,388,249,139,275000,154000,429000
315250,202112,2567,1230,1337,1354100,1472900,2827000
315260,202112,132,71,61,78100,67100,145200
315270,202112,132,90,42,99000,46200,145200
315280,202112,613,408,205,452100,225500,677600
315290,202112,185,116,69,127600,75900,203500
315300,202112,87,66,21,72600,23100,95700
315310,202112,82,73,9,80300,9900,90200
315320,202112,145,87,58,95700,64900,160600
315330,202112,59,46,13,50600,14300,64900
315340,202112,391,286,105,315700,115500,431200
315350,202112,152,95,57,104500,62700,167200
315360,202112,93,41,52,45100,57200,102300
315370,202112,54,34,20,37400,22000,59400
315380,202112,5,5,0,5500,,5500.0
315390,202112,60,18,42,19800,46200,66000
315400,202112,784,581,203,639100.65,223300,862400.65
315410,202112,312,182,130,200200,143000,343200
315415,202112,56,41,15,45100,16500,61600
315420,202112,190,139,51,152900,56100,209000
315430,202112,645,365,280,401500,308000,709500
315440,202112,91,61,30,67100,33000,100100
315445,202112,221,184,37,202400,40700,243100
315450,202112,180,131,49,144100,53900,198000
315460,202112,4290,1980,2310,2180200,2542100,4722300
315470,202112,43,17,26,18700,28600,47300
315480,202112,74,20,54,22000,59400,81400
315490,202112,699,431,268,474100,294800,768900
315500,202112,19,13,6,14300,6600,20900
315510,202112,144,98,46,107800,50600,158400
315520,202112,78,67,11,73700,12100,85800
315530,202112,40,21,19,23100,20900,44000
315540,202112,261,183,78,201300,85800,287100
315550,202112,177,142,35,156200,38500,194700
315560,202112,718,568,150,624800,165000,789800
315570,202112,311,150,161,165000,177100,342100
315580,202112,727,493,234,542300,258500,800800
315590,202112,192,99,93,108900,102300,211200
315600,202112,316,243,73,267300,80300,347600
315610,202112,103,49,54,53900,59400,113300
315620,202112,35,27,8,29700,8800,38500
315630,202112,122,86,36,94600,39600,134200
315640,202112,67,41,26,45100,28600,73700
315645,202112,49,32,17,35200,18700,53900
315650,202112,167,123,44,135300,48400,183700
315660,202112,452,197,255,216700,280500,497200
315670,202112,2370,1094,1276,1203400,1405800,2609200
315680,202112,793,564,229,620400,251900,872300
315690,202112,671,452,219,498300,240900,739200
315700,202112,1963,1020,943,1122000.51,1037300,2159300.51
315710,202112,357,109,248,119900,272800,392700
315720,202112,474,286,188,314600,206800,521400
315725,202112,189,150,39,165000,42900,207900
315727,202112,55,28,27,30800,29700,60500
315730,202112,49,44,5,48400,5500,53900
315733,202112,85,54,31,59400,34100,93500
315737,202112,50,37,13,40700,14300,55000
315740,202112,32,24,8,26400,8800,35200
315750,202112,147,110,37,121000,40700,161700
315760,202112,39,30,9,33000,9900,42900
315765,202112,123,72,51,79200,56100,135300
315770,202112,215,133,82,146300.5,90200,236500.5
315780,202112,3715,1825,1890,2010800,2079000,4089800
315790,202112,241,185,56,203500,61600,265100
315800,202112,299,196,103,215600,113300,328900
315810,202112,91,56,35,61600,38500,100100
315820,202112,738,538,200,591800,220000,811800
315830,202112,113,72,41,79200,45100,124300
315840,202112,81,53,28,58300,30800,89100
315850,202112,259,180,79,199100,86900,286000
315860,202112,16,5,11,5500,12100,17600
315870,202112,41,32,9,35200,9900,45100
315880,202112,93,66,27,72600,29700,102300
315890,202112,107,78,29,85800,31900,117700
315895,202112,412,269,143,297000,157300,454300
315900,202112,74,36,38,39600,41800,81400
315910,202112,45,27,18,29700,19800,49500
315920,202112,150,99,51,108900,56100,165000
315930,202112,53,18,35,19800,38500,58300
315935,202112,121,98,23,107800,25300,133100
315940,202112,99,72,27,79200,29700,108900
315950,202112,37,29,8,31900,8800,40700
315960,202112,538,253,285,278300,313500,591800
315970,202112,33,26,7,28600,7700,36300
315980,202112,672,333,339,366300,372900,739200
315990,202112,257,145,112,160600,123200.23,283800.23
316000,202112,45,29,16,31900,17600,49500
316010,202112,79,66,13,72600,14300,86900
316020,202112,111,96,15,105600,16500,122100
316030,202112,374,207,167,227700,183700,411400
316040,202112,531,212,319,233200,350900,584100
316045,202112,49,44,5,48400,5500,53900
316050,202112,21,16,5,17600,5500,23100
316060,202112,99,66,33,72600,36300,108900
316070,202112,1109,729,380,803000,419100,1222100
316080,202112,87,55,32,60596.8,35200,95796.8
316090,202112,40,19,21,20900,23100,44000
316095,202112,87,72,15,79200,16500,95700
316100,202112,322,177,145,194700,159500,354200
316105,202112,43,25,18,27500,19800,47300
316110,202112,1868,1449,419,1596100.5,460900,2057000.5
316120,202112,79,51,28,56100,30800,86900
316130,202112,113,84,29,93500,31900,125400
316140,202112,34,23,11,25300,12100,37400
316150,202112,216,149,67,163900,73700,237600
316160,202112,83,48,35,52800,38500,91300
316165,202112,67,45,22,49500,24200,73700
316170,202112,187,119,68,132000,74800,206800
316180,202112,208,84,124,93500,137500,231000
316190,202112,141,101,40,111100,44000,155100
316200,202112,651,350,301,385000,332200,717200
316210,202112,765,508,257,561189.2,283800,844989.2
316220,202112,113,71,42,78100,46200,124300
316225,202112,35,19,16,20900,17600,38500
316230,202112,40,20,20,22000,22000,44000
316240,202112,658,526,132,578600,145200,723800
316245,202112,142,124,18,136400,19800,156200
316250,202112,1596,1080,516,1188000,567600,1755600
316255,202112,138,111,27,122100,29700,151800
316257,202112,173,88,85,96800,93500,190300
316260,202112,181,125,56,138600,62700,201300
316265,202112,29,21,8,23100,8800,31900
316270,202112,679,480,199,528000,218900,746900
316280,202112,533,327,206,360800.63,226600,587400.63
316290,202112,794,536,258,589600,283800,873400
316292,202112,538,215,323,237600,357500,595100
316294,202112,105,68,37,74800,40700,115500
316295,202112,333,147,186,161700,204600,366300
316300,202112,10,8,2,8800,2200,11000
316310,202112,26,13,13,14300,14300,28600
316320,202112,53,28,25,30800,27500,58300
316330,202112,167,116,51,127600,56100,183700
316340,202112,133,89,44,97900,48400,146300
316350,202112,187,131,56,144100,61600,205700
316360,202112,27,15,12,16500,13200,29700
316370,202112,1173,580,593,639100.8,653400,1292500.8
316380,202112,112,85,27,94600,29700,124300
316390,202112,102,74,28,81400,30800,112200
316400,202112,137,103,34,113300,37400,150700
316410,202112,308,223,85,245300,93500,338800
316420,202112,214,144,70,158400,77000,235400
316430,202112,155,83,72,91300,79200,170500
316440,202112,78,41,37,45100,40700,85800
316443,202112,41,37,4,40700,4400,45100
316447,202112,43,34,9,37400,9900,47300
316450,202112,225,172,53,189200,58300,247500
316460,202112,84,31,53,35200,58300,93500
316470,202112,1657,1200,457,1321089.65,503800,1824889.65
316480,202112,11,8,3,8800,3300,12100
316490,202112,20,7,13,7700,14300,22000
316500,202112,157,102,55,113300,60500,173800
316510,202112,146,114,32,125400,36300,161700
316520,202112,187,105,82,115500,91300,206800
316530,202112,162,101,61,111100,67100,178200
316540,202112,150,75,75,82500,82500,165000
316550,202112,138,84,54,92400,59400,151800
316553,202112,359,158,201,173800,222200.72,396000.72
316555,202112,48,44,4,48400,4400,52800
316556,202112,13,9,4,9900,4400,14300
316557,202112,27,22,5,24200,5500,29700
316560,202112,69,49,20,53900,22000,75900
316570,202112,205,186,19,204600,20900,225500
316580,202112,21,15,6,16500,6600,23100
316590,202112,95,80,15,88000,16500,104500
316600,202112,181,150,31,165000,34100,199100
316610,202112,68,51,17,56100,18700,74800
316620,202112,143,100,43,110000,47300,157300
316630,202112,43,33,10,36300,11000,47300
316640,202112,21,14,7,15400,7700,23100
316650,202112,88,71,17,78100,18700,96800
316660,202112,7,2,5,2200,5500,7700
316670,202112,436,148,288,162800,316800,479600
316680,202112,161,121,40,133100,46200,179300
316690,202112,170,102,68,112200,75900,188100
316695,202112,59,49,10,53900,11000,64900
316700,202112,18,13,5,14300,5500,19800
316710,202112,759,570,189,627000,207900,834900
316720,202112,5039,2402,2637,2644400,2902900,5547300
316730,202112,14,14,0,15400,,15400.0
316740,202112,151,95,56,104500,61600,166100
316750,202112,22,14,8,15400,8800,24200
316760,202112,307,249,58,273900,63800,337700
316770,202112,168,88,80,96800,88000,184800
316780,202112,68,42,26,46200,28600,74800
316790,202112,55,38,17,41800,18700,60500
316800,202112,1772,1081,691,1189100,761200,1950300
316805,202112,26,18,8,19800,8800,28600
316810,202112,62,39,23,42900,25300,68200
316820,202112,39,22,17,24200,18700,42900
316830,202112,97,44,53,48400,58300,106700
316840,202112,504,298,206,327800,227700,555500
316850,202112,304,203,101,224400,111100,335500
316860,202112,6007,2660,3347,2929300,3686100,6615400
316870,202112,1595,1015,580,1117600,639100,1756700
316880,202112,147,74,73,81400,80300,161700
316890,202112,232,158,74,173800,81400,255200
316900,202112,402,278,124,305800,137500,443300
316905,202112,21,9,12,9900,13200,23100
316910,202112,63,25,38,27500,41800,69300
316920,202112,139,108,31,118800,34100,152900
316930,202112,1896,943,953,1037300,1050500,2087800
316935,202112,907,537,370,590700,407000,997700
316940,202112,1081,611,470,673200,519200,1192400
316950,202112,174,83,91,91300,100100,191400
316960,202112,1081,594,487,653400,535700,1189100
316970,202112,622,490,132,539000,145200,684200
316980,202112,75,39,36,42900,39600,82500
316990,202112,2179,1467,712,1617000,783200.84,2400200.84
317000,202112,325,249,76,275000,83600,358600
317005,202112,220,158,62,173800,68200,242000
317010,202112,6448,3591,2857,3954500,3142700.42,7097200.42
317020,202112,15543,6760,8783,7440400,9669000.59,17109400.59
317030,202112,79,31,48,34100,52800,86900
317040,202112,3042,1922,1120,2114200,1234200,3348400
317043,202112,69,53,16,58300,17600,75900
317047,202112,41,22,19,24200,20900,45100
317050,202112,147,113,34,124300,37400,161700
317052,202112,143,112,31,123200,34100,157300
317057,202112,173,130,43,143000,47300,190300
317060,202112,58,35,23,38500,25300,63800
317065,202112,52,38,14,41800,15400,57200
317070,202112,1916,867,1049,953700,1156100,2109800
317075,202112,92,50,42,55000,46200,101200
317080,202112,913,462,451,509300,498300,1007600
317090,202112,694,543,151,597300,166100,763400
317100,202112,417,309,108,339900,118800,458700
317103,202112,110,89,21,97900,23100,121000
317107,202112,46,39,7,42900,7700,50600
317110,202112,99,48,51,52800,56100,108900
317115,202112,42,38,4,41800,4400,46200
317120,202112,1992,936,1056,1030700,1161600,2192300
317130,202112,1989,1320,669,1454200,735900,2190100
317140,202112,10,9,1,9900,1100,11000
317150,202112,283,170,113,187000,124300,311300
317160,202112,333,249,84,273900.63,92400,366300.63
317170,202112,236,160,76,176000,83600,259600
317180,202112,428,288,140,316800,154000,470800
317190,202112,259,187,72,205700,79200,284900
317200,202112,796,551,245,606100.84,269500,875600.84
317210,202112,177,92,85,101200,94600,195800
317220,202112,23,11,12,12100,13200,25300
320010,202112,559,404,155,444400,171600,616000
320013,202112,121,85,36,93500,39600,133100
320016,202112,264,167,97,183700,106700,290400
320020,202112,713,413,300,455400.8,330000,785400.8
320030,202112,166,112,54,123200.04,59400.08,182600.12
320035,202112,135,96,39,105600,42900,148500
320040,202112,493,252,241,277200,265100,542300
320050,202112,118,79,39,86900,42900,129800
320060,202112,1744,816,928,898700,1021900,1920600
320070,202112,98,60,38,66000,42900,108900
320080,202112,791,448,343,495000,377300,872300
320090,202112,1251,809,442,893200,487300,1380500
320100,202112,337,194,143,213400,157300,370700
320110,202112,121,75,46,82500,50600,133100
320115,202112,110,89,21,97900,23100,121000
320120,202112,3636,1879,1757,2073500,1937100.74,4010600.74
320130,202112,7772,3429,4343,3774100,4783900.75,8558000.75
320140,202112,440,279,161,308000,177100.81,485100.81
320150,202112,2100,1154,946,1271600,1042800,2314400
320160,202112,648,283,365,311300,401500,712800
320170,202112,108,83,25,91300.1,27500.02,118800.12
320180,202112,57,35,22,38500,24200,62700
320190,202112,234,146,88,160600,96800,257400
320200,202112,62,49,13,53900,14300,68200
320210,202112,895,481,414,529100,456500,985600
320220,202112,299,104,195,115500,214500,330000
320225,202112,78,61,17,67100,18700,85800
320230,202112,681,430,251,473000,276100,749100
320240,202112,3522,1614,1908,1776500,2099900,3876400
320245,202112,489,329,160,361900,176000,537900
320250,202112,227,105,122,115500,134200,249700
320255,202112,127,97,30,106700,33000,139700
320260,202112,242,137,105,150700.2,115500.12,266200.32
320265,202112,149,115,34,126500,37400,163900
320270,202112,150,115,35,127600,38500,166100
320280,202112,1172,660,512,726000.5,563200.02,1289200.52
320290,202112,61,50,11,55000,12100,67100
320300,202112,607,408,199,448800.02,218900,667700.02
320305,202112,714,376,338,413600,371800,785400
320310,202112,201,115,86,126500,94600,221100
320313,202112,341,157,184,172700,202400,375100
320316,202112,107,79,28,86900,30800,117700
320320,202112,3437,1513,1924,1667600,2121900.33,3789500.33
320330,202112,270,196,74,215600,81400,297000
320332,202112,785,463,322,510400,355300,865700
320334,202112,274,152,122,167200.02,134200,301400.02
320335,202112,140,88,52,96800,57200,154000
320340,202112,565,396,169,435600,185900,621500
320350,202112,1050,429,621,471900.5,683100,1155000.5
320360,202112,169,83,86,91300,94600,185900
320370,202112,232,171,61,188100,67100,255200
320380,202112,295,206,89,226600,99000,325600
320390,202112,1153,677,476,745800,525800,1271600
320400,202112,320,227,93,249700,102300,352000
320405,202112,956,391,565,431200,621500,1052700
320410,202112,960,478,482,525800,532400,1058200
320420,202112,534,252,282,277200,311300,588500
320425,202112,190,106,84,116600,92400,209000
320430,202112,377,195,182,214500,200200,414700
320435,202112,165,111,54,122100,59400,181500
320440,202112,202,111,91,122100.24,101200.2,223300.44
320450,202112,134,73,61,80300,67100,147400
320455,202112,235,186,49,204600,53900,258500
320460,202112,280,177,103,194700,113300,308000
320465,202112,114,76,38,83600,41800,125400
320470,202112,701,421,280,463100,308000,771100
320480,202112,199,131,68,145200,74800,220000
320490,202112,3197,1497,1700,1648900.75,1874400.71,3523301.46
320495,202112,115,66,49,72600,53900,126500
320500,202112,9752,4720,5032,5196400.47,5540700.06,10737100.53
320501,202112,547,272,275,299200,302500,601700
320503,202112,291,202,89,222200.06,97900.02,320100.08
320506,202112,251,176,75,193600,82500,276100
320510,202112,1147,502,645,552200.5,709500,1261700.5
320515,202112,78,59,19,64900,20900,85800
320517,202112,214,150,64,165000,70400,235400
320520,202112,7403,3080,4323,3393500,4758600,8152100
320530,202112,6684,3190,3494,3512281.5,3847800,7360081.5
330010,202112,3241,1616,1625,1778700,1794100,3572800
330015,202112,193,82,111,90200,123200,213400
330020,202112,3849,1521,2328,1674200,2568500.75,4242700.75
330022,202112,266,131,135,144100,148500,292600
330023,202112,700,200,500,221100,551100,772200
330025,202112,643,115,528,126500,584100,710600
330030,202112,1828,1125,703,1238600,775500,2014100
330040,202112,2523,1271,1252,1400300,1377200.5,2777500.5
330045,202112,9732,2817,6915,3104200.5,7627400.9,10731601.4
330050,202112,865,540,325,595100,358600,953700
330060,202112,1091,641,450,705430,495036.66,1200466.66
330070,202112,4121,1399,2722,1543300,3000800,4544100
330080,202112,1581,678,903,746900,994400,1741300
330090,202112,398,225,173,247500,190300,437800
330093,202112,252,107,145,118800,160600,279400
330095,202112,68,41,27,45100,30800,75900
330100,202112,10270,5010,5260,5522000.5,5790400,11312400.5
330110,202112,464,203,261,223300,289300,512600
330115,202112,522,266,256,292600,281600,574200
330120,202112,391,201,190,222200,210100,432300
330130,202112,1580,395,1185,434500,1306800,1741300
330140,202112,647,336,311,369600,342100,711700
330150,202112,514,293,221,324500,243100,567600
330160,202112,206,118,88,129800,96800,226600
330170,202112,27257,9081,18176,10008900,20039800,30048700
330180,202112,250,128,122,140800,134200,275000
330185,202112,1048,359,689,394900,757900,1152800
330187,202112,479,141,338,156200,372900,529100
330190,202112,6164,2238,3926,2464000,4323000,6787000
330200,202112,4672,1402,3270,1544400.86,3604700,5149100.86
330205,202112,451,249,202,273900,222200,496100
330210,202112,952,567,385,623700,423500,1047200
330220,202112,2708,1567,1141,1724800,1256200,2981000
330225,202112,569,286,283,314600,311300,625900
330227,202112,2441,727,1714,800800,1888700,2689500
330230,202112,268,144,124,158400,136400,294800
330240,202112,4097,1939,2158,2132900,2376000,4508900
330245,202112,153,65,88,71500,97900,169400
330250,202112,6735,3252,3483,3582700,3842300,7425000
330260,202112,704,188,516,206800,568700,775500
330270,202112,3815,1200,2615,1322200,2882000,4204200
330280,202112,447,275,172,302500,189200,491700
330285,202112,6836,2090,4746,2303400,5229400,7532800
330290,202112,698,242,456,266200,501600,767800
330300,202112,747,470,277,517675.4,304700,822375.4
330310,202112,450,245,205,269500,225500,495000
330320,202112,8005,2813,5192,3100900,5720097.9,8820997.9
330330,202112,9408,3444,5964,3789500.02,6568100.22,10357600.24
330340,202112,2675,1504,1171,1655500,1289200,2944700
330350,202112,19533,7079,12454,7796800,13722500.5,21519300.5
330360,202112,2102,982,1120,1082400,1233100,2315500
330370,202112,980,489,491,537900,540100,1078000
330380,202112,939,381,558,419100,616000.66,1035100.66
330385,202112,624,306,318,338800,349800,688600
330390,202112,5888,2998,2890,3302200,3181200,6483400
330395,202112,344,209,135,231000,148500,379500
330400,202112,708,348,360,382800,397100,779900
330410,202112,508,361,147,398200,161700,559900
330411,202112,283,144,139,158400,152900,311300
330412,202112,226,92,134,101200,147400,248600
330414,202112,5404,2114,3290,2330900,3625600,5956500
330415,202112,606,257,349,284900,383900,668800
330420,202112,2317,1165,1152,1285900,1270500,2556400
330430,202112,1796,758,1038,834900,1141800,1976700
330440,202112,339,159,180,174900,198000,372900
330450,202112,113,48,65,52800,71500,124300
330452,202112,2289,962,1327,1060400,1465200,2525600
330455,202112,119922,40274,79648,44358765.26,87798703.78,132157469.04
330460,202112,253,111,142,122100,156200,278300
330470,202112,1241,667,574,734066.66,631400,1365466.66
330475,202112,1722,478,1244,525800,1371700,1897500
330480,202112,809,443,366,487300,404800,892100
330490,202112,15806,4837,10969,5326305,12076900,17403205
330500,202112,1477,633,844,697400,928400,1625800
330510,202112,11103,3716,7387,4096400,8152100,12248500
330513,202112,101,51,50,56100,55000,111100
330515,202112,748,310,438,342100,481800,823900
330520,202112,2542,863,1679,951500.62,1848000,2799500.62
330530,202112,195,108,87,119900,95700,215600
330540,202112,334,166,168,183700,184800,368500
330550,202112,2829,947,1882,1046100,2073500,3119600
330555,202112,843,315,528,347600,581900,929500
330560,202112,717,236,481,259600,529100,788700
330570,202112,293,202,91,222200,100100,322300
330575,202112,809,283,526,311300,579700,891000
330580,202112,3376,1817,1559,2005300,1716000,3721300
330590,202112,268,138,130,151800.5,143000,294800.5
330600,202112,1270,754,516,832700,567600,1400300
330610,202112,1630,847,783,931700,862400,1794100
330615,202112,219,176,43,193600,47300,240900
330620,202112,1054,399,655,440000,721600,1161600
330630,202112,4310,2573,1737,2838001.07,1910700,4748701.07
350010,202112,599,391,208,430100.88,228800,658900.88
350020,202112,55,17,38,18700,41800,60500
350030,202112,526,327,199,359700,218900,578600
350040,202112,124,52,72,57200,79200,136400
350050,202112,344,176,168,193600,184800,378400
350055,202112,117,51,66,56100,72600,128700
350060,202112,90,37,53,40700,59400,100100
350070,202112,779,444,335,488400.2,368500,856900.2
350075,202112,69,43,26,47300,28600,75900
350080,202112,58,25,33,27500,36300,63800
350090,202112,83,47,36,51700,39600,91300
350100,202112,268,164,104,181500,114400,295900
350110,202112,48,32,16,35200,17600,52800
350115,202112,159,90,69,99000,75900,174900
350120,202112,106,67,39,73700,42900,116600
350130,202112,386,162,224,178200.56,246400,424600.56
350140,202112,41,26,15,28600,16500,45100
350150,202112,71,50,21,55000,23100,78100
350160,202112,2391,939,1452,1032900,1598300,2631200
350170,202112,391,221,170,243100,187000,430100
350180,202112,167,95,72,104500,79200,183700
350190,202112,1014,540,474,594000.63,522500.93,1116501.56
350200,202112,62,23,39,25300,42900,68200
350210,202112,1303,707,596,777700,655600.63,1433300.63
350220,202112,633,517,116,569800.63,127600,697400.63
350230,202112,75,49,26,53900,28600,82500
350240,202112,57,37,20,40700,22000,62700
350250,202112,1145,521,624,573100,686400,1259500
350260,202112,99,70,29,77000,31900,108900
350270,202112,939,623,316,685300,347600,1032900
350275,202112,306,120,186,132000,204600,336600
350280,202112,4457,2162,2295,2381500,2525600,4907100
350290,202112,462,198,264,217800,290400,508200
350300,202112,52,25,27,27500,29700,57200
350310,202112,75,47,28,51700,31900,83600
350315,202112,66,28,38,30800,41800,72600
350320,202112,3355,1591,1764,1750100.62,1944800,3694900.62
350330,202112,1673,866,807,952602.09,887700,1840302.09
350335,202112,16,10,6,11000,6600,17600
350340,202112,124,52,72,57200,79200,136400
350350,202112,102,51,51,56100,56100,112200
350360,202112,109,72,37,79200,40700,119900
350370,202112,80,41,39,45100.63,42900,88000.63
350380,202112,784,326,458,358600,503800,862400
350390,202112,1713,617,1096,678700.5,1207800,1886500.5
350395,202112,21,16,5,17600,5500,23100
350400,202112,1698,824,874,906401.89,962500,1868901.89
350410,202112,2939,1220,1719,1343100.1,1895300.63,3238400.73
350420,202112,257,151,106,166100,116600,282700
350430,202112,88,46,42,50600,46200,96800
350440,202112,152,111,41,122100,45100,167200
350450,202112,1723,961,762,1057100.63,838200,1895300.63
350460,202112,394,136,258,149600,283800,433400
350470,202112,20,12,8,13200,8800,22000
350480,202112,200,105,95,115500,104500,220000
350490,202112,240,112,128,123200,140800,264000
350500,202112,55,24,31,26400,34100,60500
350510,202112,155,92,63,101200,69300,170500
350520,202112,429,220,209,242000,231000,473000
350530,202112,441,207,234,227700,258500,486200
350535,202112,85,63,22,69300,24200,93500
350540,202112,369,195,174,214500,191400,405900
350550,202112,2731,1547,1184,1705000,1303501.26,3008501.26
350560,202112,576,389,187,430100,205700,635800
350570,202112,4447,1797,2650,1981100.63,2920501.27,4901601.90
350580,202112,358,175,183,192500,201300,393800
350590,202112,947,510,437,561000,481800,1042800
350600,202112,6227,2898,3329,3190001.96,3664100,6854101.96
350610,202112,1496,770,726,848100,798600,1646700
350620,202112,25,15,10,16500,11000,27500
350630,202112,246,122,124,135300,136400,271700
350635,202112,1084,421,663,464200,729300,1193500
350640,202112,111,83,28,91300,30800,122100
350650,202112,1857,1222,635,1348600,698500,2047100
350660,202112,749,296,453,325600,499400,825000
350670,202112,293,143,150,157300,165000,322300
350680,202112,167,81,86,89100,94600,183700
350690,202112,198,91,107,100100,117700,217800
350700,202112,852,394,458,433400,503800,937200
350710,202112,403,150,253,165000,279400,444400
350715,202112,57,45,12,49500,13200,62700
350720,202112,16,10,6,11000,6600,17600
350730,202112,43,25,18,27500,19800,47300
350740,202112,234,128,106,140800,116600,257400
350745,202112,28,12,16,13200,17600,30800
350750,202112,2333,1366,967,1504800,1064800,2569600
350760,202112,3789,1559,2230,1714900,2455200,4170100
350770,202112,58,38,20,41800,22000,63800
350775,202112,47,34,13,37400,14300,51700
350780,202112,428,220,208,242000,229900,471900
350790,202112,365,150,215,166100,236500,402600
350800,202112,507,300,207,330000,228800,558800
350810,202112,501,390,111,430100.23,122100,552200.23
350820,202112,95,54,41,59400,45100,104500
350830,202112,74,39,35,42900,38500,81400
350840,202112,780,313,467,344300.33,515900,860200.33
350850,202112,1828,957,871,1052700,961400,2014100
350860,202112,640,334,306,367400.95,337700,705100.95
350870,202112,440,291,149,320100,165000,485100
350880,202112,269,155,114,170500,125400,295900
350890,202112,38,24,14,26400,15400,41800
350900,202112,1584,477,1107,524700,1218800.63,1743500.63
350910,202112,22,12,10,13200,11000,24200
350920,202112,740,382,358,420200,393800,814000
350925,202112,1151,597,554,656700,609400.63,1266100.63
350930,202112,109,57,52,62700,57200,119900
350940,202112,732,383,349,422400,385000,807400
350945,202112,107,77,30,84700,33000,117700
350950,202112,17094,7780,9314,8565701.26,10256400,18822101.26
350960,202112,1546,618,928,682000,1020800,1702800
350970,202112,1082,541,541,594981.2,595100,1190081.2
350980,202112,96,65,31,71500,34100,105600
350990,202112,380,135,245,149600,270600,420200
350995,202112,39,18,21,19800,23100,42900
351000,202112,605,399,206,438900.63,226600,665500.63
351010,202112,51,32,19,35200,22000,57200
351015,202112,46,32,14,35200,15400,50600
351020,202112,1488,877,611,968000,673200,1641200
351030,202112,342,204,138,224400,151800,376200
351040,202112,952,480,472,528000,522500.2,1050500.2
351050,202112,3425,1516,1909,1669800,2103200,3773000
351060,202112,5750,2076,3674,2284700.85,4046900,6331600.85
351070,202112,394,248,146,272800.85,161700,434500.85
351080,202112,712,514,198,565400,217800,783200
351090,202112,47,21,26,23100,28600,51700
351100,202112,418,226,192,248600,211200,459800
351110,202112,2047,943,1104,1040600.5,1216600,2257200.5
351120,202112,66,34,32,37400,35200,72600
351130,202112,188,61,127,67100,139700,206800
351140,202112,312,192,120,211200,132000,343200
351150,202112,471,240,231,265100,254100,519200
351160,202112,275,167,108,183700.8,118800,302500.8
351170,202112,199,102,97,112200,107800,220000
351190,202112,88,56,32,61600,35200,96800
351200,202112,345,218,127,240900,139700,380600
351210,202112,115,58,57,63800,63800,127600
351220,202112,550,321,229,354200,251900,606100
351230,202112,280,189,91,207900,101200,309100
351240,202112,237,112,125,124300,138600,262900
351250,202112,85,55,30,60500.5,33000,93500.5
351260,202112,151,108,43,118800,47300,166100
351270,202112,44,19,25,20900,28600,49500
351280,202112,1040,476,564,523600.63,620400.63,1144001.26
351290,202112,244,111,133,122100,146300,268400
351300,202112,3841,1653,2188,1819313.1,2409000,4228313.1
351310,202112,746,362,384,400400,423500,823900
351320,202112,114,63,51,69300,56100,125400
351330,202112,37,23,14,25300,15400,40700
351340,202112,1344,755,589,832700,649000,1481700
351350,202112,2352,1340,1012,1474000.04,1113200,2587200.04
351360,202112,789,370,419,409200,464200,873400
351370,202112,387,187,200,205700,220000,425700
351380,202112,8854,3824,5030,4209700,5537400.63,9747100.63
351385,202112,28,18,10,19800,11000,30800
351390,202112,277,209,68,231000.16,74800,305800.16
351400,202112,65,43,22,47300,24200,71500
351410,202112,437,267,170,293700.55,187000,480700.55
351420,202112,69,49,20,53900,22000,75900
351430,202112,71,39,32,44000,35200,79200
351440,202112,772,516,256,568701.26,281600,850301.26
351450,202112,268,124,144,136400,158400,294800
351460,202112,127,57,70,62700,77000,139700
351470,202112,145,77,68,84700,74800,159500
351480,202112,482,279,203,306900.63,225500,532400.63
351490,202112,287,102,185,112200,203500,315700
351492,202112,28,17,11,18700,12100,30800
351495,202112,25,17,8,18700,8800,27500
351500,202112,3487,1397,2090,1537800,2301200,3839000
351510,202112,2041,736,1305,812900,1438800,2251700
351512,202112,15,11,4,12100,4400,16500
351515,202112,192,112,80,123200,88000,211200
351518,202112,698,417,281,460900,309100,770000
351519,202112,79,44,35,48400,38500,86900
351520,202112,160,94,66,103400,72619.8,176019.8
351530,202112,23,14,9,15400,9900,25300
351535,202112,131,80,51,88000,56100,144100
351540,202112,458,306,152,337700,167200,504900
351550,202112,1458,844,614,930601.26,675400,1606001.26
351560,202112,77,47,30,51700,33000,84700
351565,202112,13,6,7,6600,7700,14300
351570,202112,2719,1254,1465,1379400,1613700,2993100
351580,202112,37,31,6,34100,6600,40700
351590,202112,62,40,22,44000,24200,68200
351600,202112,173,123,50,135300,55000,190300
351610,202112,52,23,29,25300,31900,57200
351620,202112,5811,3116,2695,3428701.12,2968900.63,6397601.75
351630,202112,3116,1485,1631,1634600,1800700,3435300
351640,202112,2217,950,1267,1046100.55,1393700.63,2439801.18
351650,202112,28,24,4,26400,4400,30800
351660,202112,132,83,49,92400,53900,146300
351670,202112,708,418,290,459800,320100,779900
351680,202112,74,58,16,63800,17600,81400
351685,202112,12,8,4,8800,4400,13200
351690,202112,299,199,100,218900.5,110000,328900.5
351700,202112,174,113,61,124537,67100,191637
351710,202112,67,42,25,46200,27500,73700
351720,202112,128,70,58,77000,63800,140800
351730,202112,110,70,40,77000,44000,121000
351740,202112,764,481,283,529100.74,311300,840400.74
351750,202112,373,147,226,161700,248600,410300
351760,202112,725,556,169,612700,185900,798600
351770,202112,297,242,55,266200,60500,326700
351780,202112,153,93,60,102300,66000,168300
351790,202112,260,132,128,145200,140800,286000
351800,202112,39,24,15,26400,16500,42900
351810,202112,121,79,42,86900,46200,133100
351820,202112,776,552,224,607200,248600,855800
351830,202112,596,189,407,207900,448800,656700
351840,202112,2091,963,1128,1059300,1241900,2301200
351850,202112,226,158,68,173800,74800,248600
351860,202112,624,418,206,459800.79,226600,686400.79
351870,202112,5697,2566,3131,2822601.88,3450701.32,6273303.20
351880,202112,20709,7936,12773,8741700,14069000,22810700
351885,202112,87,48,39,52800,42900,95700
351890,202112,67,48,19,52800,20900,73700
351900,202112,224,123,101,135300,111100,246400
351905,202112,96,43,53,47300,59400,106700
351907,202112,3590,1452,2138,1600500,2355100,3955600
351910,202112,168,69,99,77000,110000,187000
351920,202112,110,59,51,64900,56100,121000
351925,202112,88,54,34,59400,37400,96800
351930,202112,413,270,143,297000,157300,454300
351940,202112,239,96,143,105600,159500,265100
351950,202112,139,73,66,80300,72600,152900
351960,202112,922,446,476,491700.63,524700,1016400.63
351970,202112,2043,980,1063,1078000,1172600,2250600
351980,202112,154,67,87,74800,95700,170500
351990,202112,254,161,93,177100,102300,279400
352000,202112,325,203,122,223300,134200,357500
352010,202112,419,266,153,292671,169400,462071
352020,202112,190,67,123,73700,135300,209000
352030,202112,1130,547,583,602800,642400,1245200
352040,202112,603,239,364,262900,401500,664400
352042,202112,300,71,229,78100,253000,331100
352044,202112,352,204,148,224400.63,162800,387200.63
352050,202112,3237,1189,2048,1311201.43,2257200,3568401.43
352060,202112,101,57,44,62700,48400,111100
352070,202112,92,67,25,74801.26,27500,102301.26
352080,202112,63,42,21,46200,23100,69300
352090,202112,164,108,56,118800,61600,180400
352100,202112,285,130,155,143000,170500,313500
352110,202112,114,36,78,39600,85800,125400
352115,202112,64,20,44,22000,48400,70400
352120,202112,74,50,24,55000.63,26400,81400.63
352130,202112,214,165,49,181500,53900,235400
352140,202112,173,80,93,88000,102300,190300
352150,202112,125,67,58,73700,63800,137500
352160,202112,141,91,50,100100,55000,155100
352170,202112,388,264,124,291500,136400,427900
352180,202112,667,402,265,442200.63,291500,733700.63
352190,202112,243,96,147,105600,161700,267300
352200,202112,27,10,17,11000,18700,29700
352210,202112,4309,1695,2614,1865600.95,2883100,4748700.95
352215,202112,69,39,30,42900,33000,75900
352220,202112,6451,2385,4066,2626323.33,4481400.63,7107723.96
352230,202112,3403,2167,1236,2391401.76,1361801.05,3753202.81
352240,202112,2604,1465,1139,1613700,1254000,2867700
352250,202112,3158,1408,1750,1549901.26,1927200,3477101.26
352260,202112,1009,536,473,590700,521400,1112100
352265,202112,60,32,28,35200,30800,66000
352270,202112,370,202,168,222200,184800,407000
352280,202112,488,292,196,321200.63,215600,536800.63
352290,202112,172,98,74,107800,81400,189200
352300,202112,99,65,34,71500,37400,108900
352310,202112,6782,2892,3890,3183401.62,4284500,7467901.62
352320,202112,1134,570,564,627000,620400,1247400
352330,202112,535,265,270,291500,297000,588500
352340,202112,1365,620,745,683100,820600,1503700
352350,202112,357,197,160,217800,176000,393800
352360,202112,225,100,125,110000,137500,247500
352370,202112,108,66,42,72600,46200,118800
352380,202112,109,77,32,84700,35200,119900
352390,202112,2604,1113,1491,1224300,1642300,2866600
352400,202112,524,224,300,246400,330000,576400
352410,202112,907,599,308,661100.63,338800.84,999901.47
352420,202112,90,68,22,74800,24200,99000
352430,202112,1757,775,982,853601.89,1081301.26,1934903.15
352440,202112,3328,1554,1774,1712700,1954700,3667400
352450,202112,202,155,47,171600,51700,223300
352460,202112,629,313,316,344300,347600,691900
352470,202112,652,227,425,249700,467500,717200
352480,202112,1513,825,688,907500,757900,1665400
352490,202112,45,15,30,16500,33000,49500
352500,202112,1281,516,765,568700,847000,1415700
352510,202112,701,364,337,400400,370700,771100
352520,202112,837,347,490,381700,539000,920700
352530,202112,1792,922,870,1016400,959200,1975600
352540,202112,66,43,23,47300,25300,72600
352550,202112,195,112,83,123200,91300,214500
352560,202112,47,38,9,41800,9900,51700
352570,202112,720,340,380,374000.63,418000,792000.63
352580,202112,55,42,13,46200,14300,60500
352585,202112,22,5,17,5500,18700,24200
352590,202112,4334,2090,2244,2300100.63,2471797,4771897.63
352600,202112,357,244,113,268400,124300,392700
352610,202112,916,405,511,445500,563200,1008700
352620,202112,1072,401,671,442200,740300,1182500
352630,202112,184,70,114,77000,126500,203500
352640,202112,516,331,185,365200,203500,568700
352650,202112,85,63,22,69300,24200,93500
352660,202112,64,37,27,40700,29700,70400
352670,202112,1691,879,812,966900.6,893200,1860100.6
352680,202112,918,560,358,618200,393800.63,1012000.63
352690,202112,4595,2009,2586,2212101.26,2846800.63,5058901.89
352700,202112,90,52,38,57200,41800,99000
352710,202112,1467,755,712,831600,786500,1618100
352720,202112,1480,640,840,705100,925100,1630200
352725,202112,23,18,5,19800,5500,25300
352730,202112,380,179,201,196900,221100,418000
352740,202112,393,256,137,282700,150700.8,433400.8
352750,202112,24,15,9,16500,9900,26400
352760,202112,209,133,76,146300,83600,229900
352770,202112,82,61,21,67100,23100,90200
352780,202112,73,36,37,39600,40700,80300
352790,202112,23,17,6,18700,6600,25300
352800,202112,233,176,57,193600,62700,256300
352810,202112,159,98,61,107800,67100,174900
352820,202112,44,33,11,36300,12100,48400
352830,202112,76,50,26,55000,28600,83600
352840,202112,672,302,370,332200,407000,739200
352850,202112,1694,511,1183,562100,1301300,1863400
352860,202112,111,70,41,77000,45100,122100
352870,202112,49,30,19,33000,20900,53900
352880,202112,173,105,68,116600,74800,191400
352885,202112,33,22,11,24200,12100,36300
352890,202112,52,34,18,37400,19800,57200
352900,202112,4640,2171,2469,2392500,2720300,5112800
352910,202112,36,29,7,31900,7700,39600
352920,202112,634,367,267,403700,295900,699600
352930,202112,1185,554,631,610500,695200,1305700
352940,202112,6163,2360,3803,2600400,4188800,6789200
352950,202112,111,42,69,46200,75900,122100
352960,202112,62,37,25,40700,27500,68200
352965,202112,15,8,7,8800,7700,16500
352970,202112,514,375,139,413600,154000,567600
352980,202112,161,91,70,100100,77000,177100
352990,202112,977,454,523,500500,576400,1076900
353000,202112,55,23,32,25300,35200,60500
353010,202112,513,314,199,345400,218900,564300
353020,202112,315,215,100,236500,110000,346500
353030,202112,1331,588,743,647900,819500,1467400
353040,202112,78,41,37,45100,40700,85800
353050,202112,1303,851,452,938300.9,501600,1439900.9
353060,202112,8680,3614,5066,3977600.71,5580300.88,9557901.59
353070,202112,1861,1094,767,1205600.63,844604.2,2050204.83
353080,202112,1286,692,594,761200.92,653400,1414600.92
353090,202112,60,32,28,35200,30800,66000
353100,202112,43,34,9,37400,9900,47300
353110,202112,2167,682,1485,751300,1637900,2389200
353120,202112,121,67,54,74800,59400,134200
353130,202112,865,409,456,449900.92,501600,951500.92
353140,202112,565,238,327,261800.63,359700,621500.63
353150,202112,330,178,152,196900.63,167200,364100.63
353160,202112,105,79,26,86900,28600,115500
353170,202112,206,65,141,71500,155100,226600
353180,202112,1145,507,638,558800,701800,1260600
353190,202112,485,343,142,377300,156200,533500
353200,202112,241,115,126,127600,138600,266200
353205,202112,20,13,7,14300,7700,22000
353210,202112,66,39,27,42900,29700,72600
353215,202112,40,23,17,25300,18700,44000
353220,202112,84,44,40,48400,44000,92400
353230,202112,153,64,89,70400,97900,168300
353240,202112,354,162,192,178200,212300,390500
353250,202112,201,98,103,108900,115500,224400
353260,202112,453,297,156,326700,171600,498300
353270,202112,72,53,19,58300,23100,81400
353280,202112,103,48,55,52800,60500,113300
353282,202112,123,85,38,93500,41800,135300
353284,202112,27,18,9,19800,9900,29700
353286,202112,5,1,4,1100,4400,5500
353290,202112,84,46,38,50600,41800,92400
353300,202112,440,224,216,246400.63,238700,485100.63
353310,202112,39,33,6,36300,6600,42900
353320,202112,38,22,16,24200,17600,41800
353325,202112,47,27,20,29700,22000,51700
353330,202112,61,41,20,45100,22000,67100
353340,202112,644,216,428,237600,470800,708400
353350,202112,880,422,458,464200,504900,969100
353360,202112,102,79,23,86900,25300,112200
353370,202112,112,65,47,71500,51700,123200
353380,202112,27,13,14,14300,15400,29700
353390,202112,1110,516,594,567600,653400,1221000
353400,202112,48,28,20,30800,22000,52800
353410,202112,113,65,48,71500,52800,124300
353420,202112,54,22,32,25300,36300,61600
353430,202112,571,371,200,408101.13,221100,629201.13
353440,202112,12072,5104,6968,5616600.63,7679100,13295700.63
353450,202112,56,28,28,30800,30800,61600
353460,202112,614,313,301,346500,331100,677600
353470,202112,2264,1095,1169,1205600.6,1287000,2492600.6
353475,202112,262,169,93,185900,102300,288200
353480,202112,173,138,35,151800,38500,190300
353490,202112,226,135,91,148500,100100,248600
353500,202112,213,120,93,132000,102300,234300
353510,202112,82,55,27,60500,29700,90200
353520,202112,222,159,63,174900,69300,244200
353530,202112,458,234,224,257400,247500,504900
353540,202112,399,244,155,268400,170500,438900
353550,202112,713,441,272,485100.63,299200,784300.63
353560,202112,564,223,341,245300,375100,620400
353570,202112,62,38,24,41800,26400,68200
353580,202112,342,234,108,257400,119900,377300
353590,202112,83,59,24,64900,26400,91300
353600,202112,271,156,115,172700.63,126500,299200.63
353610,202112,128,68,60,74800,66000,140800
353620,202112,672,335,337,368500,370700,739200
353625,202112,55,29,26,31900,28600,60500
353630,202112,225,159,66,174900,72600,247500
353640,202112,122,77,45,84700,49500,134200
353650,202112,981,372,609,409200,669900,1079100
353657,202112,23,19,4,20900,4400,25300
353660,202112,286,149,137,163900,150700,314600
353670,202112,712,411,301,453200.63,331100,784300.63
353680,202112,124,84,40,92400,44000,136400
353690,202112,41,29,12,31900,13200,45100
353700,202112,277,189,88,207900.8,96800,304700.8
353710,202112,490,232,258,255200,283800,539000
353715,202112,49,31,18,34100,19800,53900
353720,202112,341,152,189,167200,209000,376200
353730,202112,1162,707,455,777700.36,500500,1278200.36
353740,202112,617,338,279,371800,306900,678700
353750,202112,71,40,31,44000,34100,78100
353760,202112,3211,1190,2021,1310100,2226400.9,3536500.9
353770,202112,80,64,16,70400,17600,88000
353780,202112,1312,591,721,651200.63,795300,1446500.63
353790,202112,482,286,196,314600,215600,530200
353800,202112,3555,1661,1894,1828220,2086774,3914994
353810,202112,220,112,108,123200,118800,242000
353820,202112,231,93,138,102300,151800,254100
353830,202112,61,49,12,53900,13200,67100
353850,202112,191,86,105,94600,115500,210100
353860,202112,524,225,299,247500,330000,577500
353870,202112,5564,2782,2782,3061300,3067900,6129200
353880,202112,712,462,250,509300,275000,784300
353890,202112,557,321,236,353100,259600.59,612700.59
353900,202112,127,67,60,74800,66000,140800
353910,202112,191,79,112,86900,123200,210100
353920,202112,421,224,197,246400,216700,463100
353930,202112,1052,609,443,674300,490600,1164900
353940,202112,191,93,98,103400,107800,211200
353950,202112,481,300,181,332200,199100,531300
353960,202112,74,61,13,68200,14300,82500
353970,202112,40,27,13,29700,14300,44000
353980,202112,1810,811,999,893200.93,1102200,1995400.93
353990,202112,77,44,33,48400,36300,84700
354000,202112,372,168,204,184800,225500,410300
354010,202112,92,53,39,58300,42900,101200
354020,202112,506,316,190,347600.64,209000,556600.64
354025,202112,35,29,6,31900,6600,38500
354030,202112,46,27,19,29700,20900,50600
354040,202112,100,74,26,81400,28600,110000
354050,202112,172,92,80,101200.63,88000,189200.63
354060,202112,766,354,412,391600,453200,844800
354070,202112,927,519,408,572000,448800,1020800
354075,202112,181,83,98,91300,107800,199100
354080,202112,307,135,172,148500,190300,338800
354085,202112,23,12,11,13200,12100,25300
354090,202112,266,161,105,177007,115500,292507
354100,202112,5782,2327,3455,2564100.4,3806000,6370100.4
354105,202112,98,46,52,50600,57200,107800
354110,202112,43,20,23,22000,25300,47300
354120,202112,150,97,53,106700.93,58300,165000.93
354130,202112,710,430,280,473000.81,309100,782100.81
354140,202112,3198,1415,1783,1558700.55,1963500,3522200.55
354150,202112,629,361,268,400401.29,294800,695201.29
354160,202112,648,406,242,446600,267300,713900
354165,202112,16,13,3,14300,3300,17600
354170,202112,172,120,52,132000,57200,189200
354180,202112,58,34,24,37400,26400,63800
354190,202112,196,77,119,84700,130900,215600
354200,202112,106,55,51,60500,56100,116600
354210,202112,68,27,41,29700,45100,74800
354220,202112,626,392,234,431200.63,257400,688600.63
354230,202112,169,72,97,79200,106700,185900
354240,202112,325,203,122,223300.82,135300,358600.82
354250,202112,81,48,33,52800,36300,89100
354260,202112,2162,1002,1160,1104400.52,1276000.85,2380401.37
354270,202112,90,62,28,68200,30800,99000
354280,202112,52,28,24,30800,26400,57200
354290,202112,139,93,46,102300,50600,152900
354300,202112,351,246,105,270600.63,116600,387200.63
354310,202112,89,63,26,69300,28600,97900
354320,202112,218,106,112,116600,124300,240900
354323,202112,8,7,1,7700,1100,8800
354325,202112,122,66,56,72600.83,61600,134200.83
354330,202112,2411,800,1611,884243,1775400,2659643
354340,202112,10365,4735,5630,5211568,6198500,11410068
354350,202112,140,90,50,99000,55000,154000
354360,202112,71,41,30,45100,33000,78100
354370,202112,234,119,115,130900,126500,257400
354380,202112,170,97,73,106700,80300,187000
354390,202112,2702,956,1746,1052700,1921700,2974400
354400,202112,300,165,135,181500,148500,330000
354410,202112,645,288,357,316800,392700,709500
354420,202112,275,174,101,191400,111100,302500
354425,202112,319,176,143,193651,157300,350951
354430,202112,186,102,84,112200,92400,204600
354440,202112,32,26,6,28600,6600,35200
354450,202112,56,37,19,40700,20900,61600
354460,202112,95,55,40,60500,44000,104500
354470,202112,26,13,13,14300,14300,28600
354480,202112,107,56,51,61600,56100,117700
354490,202112,137,81,56,89100,61600,150700
354500,202112,393,177,216,194700,238700,433400
354510,202112,91,61,30,67100,33000,100100
354515,202112,44,12,32,13200,35200,48400
354520,202112,1606,677,929,744543,1024100,1768643
354530,202112,827,407,420,447700,462000,909700
354540,202112,270,134,136,147400,149600,297000
354550,202112,37,22,15,24200,16500,40700
354560,202112,151,81,70,89100,77000,166100
354570,202112,136,92,44,101200,48400,149600
354580,202112,1829,858,971,943800,1069200,2013000
354600,202112,272,135,137,148500,150700,299200
354610,202112,67,55,12,60500,13200,73700
354620,202112,64,17,47,18700,51700,70400
354625,202112,14,8,6,8800,6600,15400
354630,202112,316,203,113,223300,124300,347600
354640,202112,819,497,322,546700.95,355300,902000.95
354650,202112,63,35,28,38500,30800,69300
354660,202112,807,595,212,654500.63,233200,887700.63
354670,202112,224,82,142,90200,156200,246400
354680,202112,1306,459,847,504900,931700,1436600
354690,202112,71,46,25,50600,27500,78100
354700,202112,73,50,23,55000,25300,80300
354710,202112,47,33,14,36300,15400,51700
354720,202112,21,20,1,22000,1100,23100
354730,202112,1788,716,1072,788700,1179200,1967900
354740,202112,74,50,24,55000,26400,81400
354750,202112,411,233,178,257400,195800,453200
354760,202112,482,297,185,326700,204600,531300
354765,202112,7,2,5,3300,5500,8800
354770,202112,344,225,119,247500,130900,378400
354780,202112,8336,3091,5245,3404500.97,5783800,9188300.97
354790,202112,90,55,35,60500,38500,99000
354800,202112,432,232,200,255156.12,220000,475156.12
354805,202112,81,38,43,41800,47300,89100
354810,202112,99,54,45,59400,49500,108900
354820,202112,208,84,124,92400,136400,228800
354830,202112,44,23,21,26400,23100,49500
354840,202112,56,38,18,41800,19800,61600
354850,202112,4475,1937,2538,2132900.08,2795100.06,4928000.14
354860,202112,340,156,184,172700,203500,376200
354870,202112,11949,5119,6830,5636401.26,7524000,13160401.26
354880,202112,2671,967,1704,1064800.89,1874451.7,2939252.59
354890,202112,2913,1521,1392,1678600.63,1531200,3209800.63
354900,202112,63,42,21,46200,23100,69300
354910,202112,1283,646,637,711700,701800,1413500
354920,202112,39,32,7,35200,7700,42900
354925,202112,19,9,10,9900,11000,20900
354930,202112,35,30,5,33000.4,5500,38500.4
354940,202112,778,542,236,598400,259600,858000
354950,202112,215,131,84,145200,92400,237600
354960,202112,132,49,83,55000,91300,146300
354970,202112,1061,717,344,789800.63,378400,1168200.63
354980,202112,9109,3210,5899,3534302.62,6497700.39,10032003.01
354990,202112,9921,4316,5605,4755300,6175400,10930700
354995,202112,565,179,386,196900.65,424600,621500.65
355000,202112,453,159,294,174900,323400,498300
355010,202112,604,367,237,403700,260700.63,664400.63
355020,202112,780,479,301,526900,331100,858000
355030,202112,212606,78283,134323,86202670.22,147934647.18,234137317.40
355040,202112,875,406,469,447700,517000,964700
355050,202112,172,97,75,106700,82500,189200
355060,202112,1710,803,907,884400,1001000,1885400
355070,202112,1555,694,861,763400.08,947100.73,1710500.81
355080,202112,193,116,77,127600.43,84700,212300.43
355090,202112,283,167,116,183700,128700.57,312400.57
355100,202112,5261,2451,2810,2698190.07,3092100,5790290.07
355110,202112,235,152,83,168300,91300,259600
355120,202112,56,36,20,39600,22000,61600
355130,202112,50,29,21,31900,23100,55000
355140,202112,190,112,78,123200,85800,209000
355150,202112,680,397,283,437800,312400,750200
355160,202112,477,225,252,247500.63,278300,525800.63
355170,202112,2059,1047,1012,1153900,1114300,2268200
355180,202112,691,269,422,295900,464200,760100
355190,202112,214,146,68,161700,74800,236500
355200,202112,108,56,52,61600,57200,118800
355210,202112,715,391,324,430100,357500,787600
355220,202112,7496,3654,3842,4019400,4230600,8250000
355230,202112,96,58,38,63800,41800,105600
355240,202112,4593,1860,2733,2048200.5,3006300,5054500.5
355250,202112,6343,2726,3617,3003022.3,3985300,6988322.3
355255,202112,46,29,17,31900,18700,50600
355260,202112,182,105,77,115500,84700,200200
355270,202112,168,107,61,117700,67100,184800
355280,202112,6848,2552,4296,2807200,4731100,7538300
355290,202112,71,56,15,61600,16500,78100
355300,202112,224,128,96,140800,106700,247500
355310,202112,110,56,54,61600,59400,121000
355320,202112,92,48,44,52800,48400,101200
355330,202112,295,168,127,184800,139700,324500
355340,202112,1417,486,931,534601.18,1025200,1559801.18
355350,202112,160,77,83,86900,91300,178200
355360,202112,169,111,58,122100,63800,185900
355365,202112,16,12,4,13200,4400,17600
355370,202112,1022,611,411,672100.63,454300,1126400.63
355380,202112,816,505,311,556600,343200,899800
355385,202112,83,53,30,58300,33000,91300
355390,202112,108,56,52,61600,57200,118800
355395,202112,191,102,89,112200.5,97900,210100.5
355400,202112,1735,987,748,1085609,823900.63,1909509.63
355410,202112,5021,2290,2731,2523400.07,3011800,5535200.07
355420,202112,47,33,14,36300,15400,51700
355430,202112,408,242,166,266200,182600,448800
355440,202112,86,51,35,56100,38500,94600
355450,202112,441,214,227,235400,250800,486200
355460,202112,57,44,13,48400,14300,62700
355465,202112,51,29,22,31900,24200,56100
355470,202112,186,72,114,79200,127600,206800
355475,202112,10,7,3,7700,3300,11000
355480,202112,590,236,354,259600,390500,650100
355490,202112,111,75,36,82500,39600,122100
355495,202112,76,26,50,28600,55000,83600
355500,202112,1592,851,741,937200.48,815100,1752300.48
355510,202112,275,195,80,214500.63,88000,302500.63
355520,202112,29,22,7,24200,7700,31900
355530,202112,22,11,11,12100,12100,24200
355535,202112,73,32,41,35200,45100,80300
355540,202112,2656,1020,1636,1123255.1,1799600,2922855.1
355550,202112,62,36,26,39600,28600,68200
355560,202112,237,106,131,116600,144100,260700
355570,202112,18,11,7,12100,7700,19800
355580,202112,241,161,80,178200,88000,266200
355590,202112,17,10,7,11000,7700,18700
355600,202112,269,130,139,143000,152900,295900
355610,202112,231,145,86,159500,94600,254100
355620,202112,1303,569,734,627000,809600,1436600
355630,202112,415,301,114,331100,125400,456500
355635,202112,125,56,69,61600,77000,138600
355640,202112,537,283,254,311300,279400,590700
355645,202112,885,326,559,359700,614900,974600
355650,202112,1904,797,1107,878900,1218800,2097700
355660,202112,231,120,111,132000,123200,255200
355670,202112,612,250,362,275000,398200,673200
355680,202112,206,116,90,127600,100100,227700
355690,202112,87,43,44,47300,48400,95700
355695,202112,24,15,9,16500,9900,26400
355700,202112,1202,601,601,661100,661100,1322200
355710,202112,2235,1208,1027,1329900.59,1133000,2462900.59
355715,202112,13,11,2,12100,2200,14300
355720,202112,249,154,95,169400,105600,275000
355730,202112,107,61,46,67100,50600,117700
410010,202112,130,103,27,113300,29700,143000
410020,202112,120,87,33,95700,36300,132000
410030,202112,170,95,75,106700,82500,189200
410040,202112,1281,627,654,689700,722700,1412400
410045,202112,46,35,11,38500,12100,50600
410050,202112,508,289,219,317900,240900,558800
410060,202112,282,204,78,224400,85800,310200
410070,202112,289,246,43,270600,47300,317900
410080,202112,176,105,71,115500,78100,193600
410090,202112,69,59,10,66000,11000,77000
410100,202112,257,168,89,184800,99000,283800
410105,202112,47,27,20,29700,22000,51700
410110,202112,343,206,137,226600,150700,377300
410115,202112,45,29,16,31900,18700,50600
410120,202112,429,200,229,221100,251900,473000
410130,202112,53,30,23,33000,25300,58300
410140,202112,3123,1406,1717,1548800.03,1892000,3440800.03
410150,202112,2669,1053,1616,1158300,1783100,2941400
410160,202112,479,278,201,306900,221100,528000
410165,202112,51,29,22,31900,24200,56100
410170,202112,193,121,72,133100,79200,212300
410180,202112,2276,1220,1056,1345300,1167100,2512400
410185,202112,36,32,4,35200,4400,39600
410190,202112,480,308,172,338800.2,189200,528000.2
410200,202112,979,695,284,764500,312400,1076900
410210,202112,625,318,307,349800,337700,687500
410220,202112,48,21,27,23100,29700,52800
410230,202112,168,75,93,82500,102300,184800
410240,202112,717,454,263,499400,289300,788700
410250,202112,375,261,114,288200,125400,413600
410260,202112,304,165,139,181500,152900,334400
410270,202112,29,22,7,24200,7700,31900
410275,202112,60,45,15,49500,16500,66000
410280,202112,324,184,140,203500,154000,357500
410290,202112,274,152,122,168300,134200,302500
410300,202112,87,54,33,59400,36300,95700
410302,202112,23,13,10,15400,11000,26400
410304,202112,38,25,13,27500,14300,41800
410305,202112,227,126,101,138600,112200,250800
410310,202112,195,113,82,125400,91300,216700
410315,202112,42,30,12,33000,13200,46200
410320,202112,138,91,47,100100,52800,152900
410322,202112,33,20,13,22000,14300,36300
410330,202112,172,114,58,125400,63800,189200
410335,202112,94,51,43,57200,47300,104500
410337,202112,44,34,10,37400,11000,48400
410340,202112,38,30,8,33000,8800,41800
410345,202112,198,115,83,126500,91300,217800
410347,202112,46,35,11,38500,12100,50600
410350,202112,259,147,112,161700,123200,284900
410360,202112,427,264,163,291500,179300,470800
410370,202112,2322,963,1359,1059300,1499300,2558600
410380,202112,190,111,79,123200,86900,210100
410390,202112,392,265,127,292600,139700,432300
410395,202112,34,21,13,23100,15400,38500
410400,202112,848,365,483,401500.5,533500,935000.5
410405,202112,81,61,20,67100,22000,89100
410410,202112,26,16,10,17600,11000,28600
410420,202112,1700,759,941,834802.1,1037300,1872102.1
410425,202112,180,70,110,78100,121000,199100
410430,202112,2306,1224,1082,1346400,1193500,2539900
410440,202112,362,258,104,283800,114400,398200
410442,202112,356,225,131,249700,144100,393800
410445,202112,419,293,126,322300,138600,460900
410450,202112,379,181,198,199100,217800,416900
410460,202112,559,286,273,314600,300300,614900
410465,202112,244,131,113,145200,124300,269500
410470,202112,261,143,118,157300,129800,287100
410480,202112,6460,3060,3400,3368200,3743300.25,7111500.25
410490,202112,1399,804,595,884400,655600,1540000
410500,202112,265,151,114,168300,125400,293700
410510,202112,178,131,47,144100,51700,195800
410520,202112,262,187,75,205700,82500,288200
410530,202112,299,97,202,107800,222200,330000
410540,202112,334,242,92,266200,102300,368500
410550,202112,1695,695,1000,764500,1100000,1864500
410560,202112,155,104,51,114400,56100,170500
410570,202112,440,292,148,321200,162800,484000
410580,202112,3628,1517,2111,1669800,2323200,3993000
410590,202112,413,267,146,293681,160600,454281
410600,202112,192,167,25,183700,27500,211200
410610,202112,50,40,10,44000,11000,55000
410620,202112,259,171,88,189200.4,97900,287100.4
410630,202112,449,242,207,266200,227700,493900
410640,202112,1045,644,401,708400,442200,1150600
410645,202112,112,80,32,88000,35200,123200
410650,202112,362,223,139,247500,154000,401500
410655,202112,89,61,28,67100,30800,97900
410657,202112,34,10,24,11000,26400,37400
410660,202112,631,423,208,465300.5,229900,695200.5
410670,202112,77,63,14,69300,15400,84700
410680,202112,189,153,36,168300,39600,207900
410685,202112,28,17,11,18700,12100,30800
410690,202112,28468,11638,16830,12821600,18537200.74,31358800.74
410700,202112,322,233,89,256300,97900,354200
410710,202112,132,108,24,118800,26400,145200
410712,202112,46,34,12,37400,13200,50600
410715,202112,93,71,22,78100,24200,102300
410720,202112,661,377,284,415800,313500,729300
410725,202112,185,134,51,147400,56100,203500
410730,202112,103,49,54,53900.8,59400,113300.8
410740,202112,103,72,31,79200,34100,113300
410750,202112,289,189,100,209000,110000,319000
410752,202112,20,14,6,15400,6600,22000
410753,202112,57,22,35,24200,38500,62700
410754,202112,52,24,28,26400,30800,57200
410755,202112,79,46,33,50600,36300,86900
410760,202112,754,404,350,444400,385000,829400
410765,202112,1854,825,1029,907500,1133000,2040500
410770,202112,110,79,31,86900,34100,121000
410773,202112,60,41,19,45100,20900,66000
410775,202112,177,132,45,145750,49500,195250
410780,202112,89,47,42,51700,46200,97900
410785,202112,50,40,10,45100,11000,56100
410790,202112,85,37,48,40700,52800,93500
410800,202112,281,173,108,191400,118800,310200
410810,202112,27,15,12,16500,13200,29700
410820,202112,160,114,46,125400,50600,176000
410830,202112,8906,3725,5181,4104100.4,5706800,9810900.4
410832,202112,115,74,41,82500,45100,127600
410840,202112,1422,752,670,827200.21,738100,1565300.21
410845,202112,51,28,23,30800,25300,56100
410850,202112,176,127,49,139700,53900,193600
410855,202112,71,61,10,67100,11000,78100
410860,202112,781,396,385,435600,423500,859100
410865,202112,103,71,32,78100,35200,113300
410870,202112,149,127,22,139700,24200,163900
410880,202112,1147,564,583,620400,641300,1261700
410890,202112,92,62,30,68200,33000,101200
410895,202112,74,57,17,62700,18700,81400
410900,202112,25,18,7,19800,7700,27500
410910,202112,15,10,5,11000,5500,16500
410920,202112,41,26,15,28600,16500,45100
410930,202112,547,331,216,365200,238700,603900
410940,202112,4403,2312,2091,2546500,2301200,4847700
410950,202112,101,74,27,81400,29700,111100
410960,202112,872,334,538,367400,592900,960300
410965,202112,66,43,23,47300,25300,72600
410970,202112,609,418,191,459800,211200,671000
410975,202112,121,75,46,82500.38,50600,133100.38
410980,202112,1629,710,919,783200,1010900,1794100
410990,202112,274,195,79,214500,86900,301400
411000,202112,61,35,26,39600,28600,68200
411005,202112,28,22,6,24200,6600,30800
411007,202112,251,140,111,154000,122100,276100
411010,202112,593,387,206,425700,226600,652300
411020,202112,287,181,106,199100,116600,315700
411030,202112,23,12,11,13200,12100,25300
411040,202112,56,37,19,40700,20900,61600
411050,202112,213,154,59,169804.21,64900,234704.21
411060,202112,528,355,173,390500,191400,581900
411065,202112,48,43,5,47300,5500,52800
411070,202112,1262,724,538,797500,591800,1389300
411080,202112,241,170,71,187000,78100,265100
411090,202112,87,67,20,73700,22000,95700
411095,202112,340,121,219,133100,240900,374000
411100,202112,112,88,24,97900,26400,124300
411110,202112,134,81,53,89100,58300,147400
411120,202112,211,139,72,152900,79200,232100
411125,202112,281,127,154,140800,169400,310200
411130,202112,118,100,18,110000,19800,129800
411140,202112,211,145,66,160600,72600,233200
411150,202112,1238,789,449,870100,493900.63,1364000.63
411155,202112,124,86,38,94600,41800,136400
411160,202112,29,12,17,13200,18700,31900
411170,202112,51,46,5,50600,5500,56100
411180,202112,990,646,344,710600,378400,1089000
411190,202112,333,180,153,198000,168300,366300
411200,202112,663,383,280,421300.63,308000,729300.63
411210,202112,684,351,333,386100,366300.1,752400.1
411220,202112,161,111,50,122100,55000,177100
411230,202112,37,29,8,31900,8800,40700
411240,202112,113,70,43,77000,47300,124300
411250,202112,422,307,115,337700,126500,464200
411260,202112,14,10,4,11000,4400,15400
411270,202112,264,132,132,146300,145200,291500
411275,202112,185,159,26,174900,28600,203500
411280,202112,204,147,57,161700.63,62700,224400.63
411290,202112,64,50,14,55000,15400,70400
411295,202112,122,97,25,106700,27500,134200
411300,202112,78,35,43,38500,47300,85800
411310,202112,92,67,25,73700,27500,101200
411320,202112,798,503,295,554400.9,325600,880000.9
411325,202112,64,46,18,50600,19800,70400
411330,202112,903,581,322,640200,354200,994400
411340,202112,31,20,11,22000,12100,34100
411342,202112,56,42,14,46200,15400,61600
411345,202112,108,54,54,59400,59400,118800
411350,202112,500,371,129,408100,143000,551100
411360,202112,58,37,21,40700,23100,63800
411370,202112,13943,5543,8400,6102801.89,9248801.34,15351603.23
411373,202112,183,123,60,135300,66000,201300
411375,202112,81,64,17,70400,18700,89100
411380,202112,76,55,21,61600,23100,84700
411390,202112,131,76,55,83600,61600,145200
411400,202112,418,282,136,310200,150700,460900
411410,202112,486,222,264,245300,290400,535700
411420,202112,966,403,563,443300,620400,1063700
411430,202112,496,268,228,294800,250800,545600
411435,202112,31,20,11,22000,12100,34100
411440,202112,468,370,98,408100,107800,515900
411450,202112,410,346,64,380600,70400,451000
411460,202112,788,292,496,322300,546700,869000
411470,202112,104,72,32,79200,35200,114400
411480,202112,702,367,335,403700,369600,773300
411490,202112,283,174,109,191400,119900,311300
411500,202112,100,81,19,89100,20900,110000
411510,202112,226,179,47,196900,51700,248600
411520,202112,6051,2098,3953,2314400,4359300.7,6673700.7
411530,202112,122,82,40,90200,44000,134200
411535,202112,46,15,31,16500,34100,50600
411540,202112,370,247,123,271700,135300,407000
411545,202112,58,42,16,46200,17600,63800
411550,202112,90,68,22,74800,24200,99000
411560,202112,401,163,238,179300,262900,442200
411570,202112,911,309,602,341000,664400,1005400
411573,202112,25,16,9,17600,9900,27500
411575,202112,308,186,122,204600,134200,338800
411580,202112,1232,438,794,481800,874500,1356300
411585,202112,72,36,36,39600,39600,79200
411590,202112,15,10,5,11000,5500,16500
411600,202112,21,9,12,9900,13200,23100
411605,202112,245,93,152,102300,167200,269500
411610,202112,227,142,85,156200,93500,249700
411620,202112,389,185,204,204600,224400,429000
411630,202112,50,35,15,38500,16500,55000
411640,202112,33,23,10,25300,11000,36300
411650,202112,9,6,3,6600,3300,9900
411660,202112,40,28,12,30800,13200,44000
411670,202112,239,166,73,182600,80300,262900
411680,202112,154,124,30,136400,33000,169400
411690,202112,622,326,296,358600,325600,684200
411695,202112,64,46,18,50600,19800,70400
411700,202112,147,116,31,127600,34100,161700
411705,202112,103,69,34,75900,37400,113300
411710,202112,294,195,99,214500,108900,323400
411720,202112,137,92,45,101200,49500,150700
411721,202112,83,67,16,73700,17600,91300
411722,202112,103,44,59,48400,64900,113300
411725,202112,170,123,47,135300,51700,187000
411727,202112,100,78,22,85800,24200,110000
411729,202112,44,32,12,35200,13200,48400
411730,202112,555,342,213,376200,234300,610500
411740,202112,32,20,12,22000,13200,35200
411745,202112,65,49,16,53900,17600,71500
411750,202112,841,350,491,386100,540100,926200
411760,202112,1216,876,340,963600,375100,1338700
411770,202112,431,283,148,313500,162800,476300
411780,202112,365,236,129,259600,141900,401500
411790,202112,567,313,254,344300.18,279400,623700.18
411800,202112,147,104,43,114400.65,47300,161700.65
411810,202112,182,138,44,152900,48400,201300
411820,202112,2400,982,1418,1080200,1560900,2641100
411830,202112,13,12,1,13200,1100,14300
411840,202112,2115,1255,860,1382700,948200,2330900
411845,202112,63,21,42,23100,46200,69300
411850,202112,1231,657,574,722700,631400,1354100
411860,202112,51,32,19,35200,20900,56100
411870,202112,66,39,27,42900,29700,72600
411880,202112,427,252,175,277786.66,192500,470286.66
411885,202112,104,61,43,67100,48400,115500
411890,202112,309,211,98,232100,107800,339900
411900,202112,100,71,29,78100,31900,110000
411910,202112,184,138,46,152900,50600,203500
411915,202112,2334,910,1424,1002100,1568600,2570700
411920,202112,115,89,26,97900,28600,126500
411925,202112,16,10,6,11000,6600,17600
411930,202112,787,545,242,599570.4,266200,865770.4
411940,202112,593,376,217,413600.1,238700,652300.1
411950,202112,1146,515,631,566500,695200,1261700
411960,202112,1116,706,410,776600,451000,1227600
411965,202112,22,12,10,13200,11000,24200
411970,202112,93,78,15,85800,16500,102300
411980,202112,202,112,90,123200,99000,222200
411990,202112,5113,2750,2363,3028301.42,2603771.5,5632072.92
411995,202112,582,170,412,187000,453200,640200
412000,202112,327,210,117,231000,128700,359700
412010,202112,45,23,22,25300,24200,49500
412015,202112,38,30,8,33000,9900,42900
412020,202112,21,16,5,17600,5500,23100
412030,202112,38,34,4,37400,4400,41800
412033,202112,48,28,20,30800,22000,52800
412035,202112,73,46,27,50600,29700,80300
412040,202112,36,17,19,18700,20900,39600
412050,202112,211,154,57,169400,62700,232100
412060,202112,764,551,213,609400.6,234300.13,843700.73
412065,202112,51,29,22,31900,24200,56100
412070,202112,162,114,48,126500,53900,180400
412080,202112,315,144,171,158400,188100,346500
412085,202112,35,14,21,15400,23100,38500
412090,202112,842,519,323,570900,355300,926200
412100,202112,265,221,44,243100,48400,291500
412110,202112,71,55,16,60500,17600,78100
412120,202112,334,181,153,199100,168300,367400
412125,202112,70,42,28,46200,30800,77000
412130,202112,45,29,16,31900,17600,49500
412135,202112,29,17,12,18700,13200,31900
412140,202112,414,263,151,289300,166100,455400
412150,202112,237,154,83,169400,92400,261800
412160,202112,87,54,33,59400,36300,95700
412170,202112,708,474,234,522500,257400,779900
412175,202112,38,28,10,30800,11000,41800
412180,202112,186,137,49,151800,53900,205700
412190,202112,314,245,69,269500,75900,345400
412200,202112,185,114,71,125400,78100,203500
412210,202112,95,71,24,78100,26400,104500
412215,202112,237,158,79,173800,86900,260700
412217,202112,67,55,12,61600,13200,74800
412220,202112,820,545,275,599500,302500,902000
412230,202112,299,181,118,199100,129800,328900
412240,202112,1316,636,680,700700,748000,1448700
412250,202112,406,248,158,272800,173800,446600
412260,202112,116,76,40,83600,44000,127600
412265,202112,170,127,43,139700,47300,187000
412270,202112,91,57,34,62700,37400,100100
412280,202112,89,69,20,75900,22000,97900
412290,202112,91,56,35,61600,38500,100100
412300,202112,207,143,64,157300,70400,227700
412310,202112,52,42,10,46200,11000,57200
412320,202112,88,69,19,75900,20900,96800
412330,202112,185,151,34,166100,38500,204600
412340,202112,167,111,56,123200,61600,184800
412350,202112,640,296,344,326700,378400,705100
412360,202112,24,21,3,23100,3300,26400
412370,202112,152,129,23,141900,25300,167200
412380,202112,217,162,55,178200,60500,238700
412382,202112,63,35,28,38500,30800,69300
412385,202112,152,106,46,116600,50600,167200
412390,202112,307,229,78,251900,85800,337700
412395,202112,64,51,13,56100,14300,70400
412400,202112,99,66,33,72600,36300,108900
412402,202112,237,115,122,126500,134200,260700
412405,202112,940,317,623,348700,685300,1034000
412410,202112,960,577,383,634163.37,421300,1055463.37
412420,202112,18,17,1,18700,1100,19800
412430,202112,24,22,2,24200,2200,26400
412440,202112,643,324,319,356400,350900,707300
412450,202112,71,62,9,69300,9900,79200
412460,202112,91,69,22,75900,24200,100100
412470,202112,212,166,46,182600,50600,233200
412480,202112,145,102,43,112200,49500,161700
412490,202112,158,133,25,147400,27500,174900
412500,202112,406,319,87,350900.44,95700,446600.44
412510,202112,167,138,29,151800,31900,183700
412520,202112,88,56,32,61600,35200,96800
412530,202112,108,54,54,59400,59400,118800
412535,202112,87,67,20,73700,22000,95700
412540,202112,83,38,45,41800,49500,91300
412545,202112,83,57,26,62700,28600,91300
412550,202112,3964,1579,2385,1741300,2626800,4368100
412555,202112,10,6,4,6600,4400,11000
412560,202112,649,434,215,477400,237600,715000
412570,202112,800,383,417,422400,459800,882200
412575,202112,93,66,27,72600,29700,102300
412580,202112,171,114,57,125400,62700,188100
412590,202112,31,28,3,30800,3300,34100
412600,202112,173,118,55,130900,60500,191400
412610,202112,36,15,21,16500,23100,39600
412620,202112,138,115,23,126500,26400,152900
412625,202112,2111,1033,1078,1138501.13,1191300,2329801.13
412627,202112,64,47,17,52800,18700,71500
412630,202112,385,256,129,281600,143000,424600
412635,202112,72,20,52,22000,57200,79200
412640,202112,104,71,33,78100,36300,114400
412650,202112,323,215,108,237600,118800,356400
412660,202112,452,261,191,287100,210100,497200
412665,202112,43,39,4,42900,4400,47300
412667,202112,292,188,104,206800,114400,321200
412670,202112,74,60,14,66000,15400,81400
412680,202112,328,250,78,275000,85800,360800
412690,202112,128,83,45,91300,49500,140800
412700,202112,186,125,61,137500,67100,204600
412710,202112,1320,749,571,827200,629200,1456400
412720,202112,228,124,104,137500,114400,251900
412730,202112,203,171,32,188100,35200,223300
412740,202112,421,215,206,236500,227700,464200
412750,202112,429,230,199,253000,220000,473000
412760,202112,324,160,164,176000,180400,356400
412770,202112,2090,1119,971,1232000.63,1071400,2303400.63
412780,202112,144,106,38,116600,41800,158400
412785,202112,313,152,161,168300,177100,345400
412788,202112,44,24,20,26400,22000,48400
412790,202112,126,104,22,114400,24200,138600
412795,202112,148,102,46,112200,50600,162800
412796,202112,299,187,112,205700,123200,328900
412800,202112,652,390,262,429000,288200,717200
412810,202112,3037,1650,1387,1817200.59,1525700,3342900.59
412820,202112,947,570,377,628100,414700,1042800
412830,202112,12,10,2,11000,2200,13200
412840,202112,255,169,86,185900,94600,280500
412850,202112,711,443,268,487300,295900,783200
412853,202112,164,76,88,83600,96800,180400
412855,202112,197,105,92,115500.26,102300,217800.26
412860,202112,94,61,33,67100,36300,103400
412862,202112,76,50,26,55000,28600,83600
412863,202112,8,6,2,6600,2200,8800
412865,202112,43,32,11,35200,12100,47300
412870,202112,109,65,44,71500,48400,119900
412880,202112,95,66,29,72600,31900,104500
420005,202112,38,34,4,37400,4400,41800
420010,202112,369,240,129,264000,143000,407000
420020,202112,90,73,17,80300,18700,99000
420030,202112,26,21,5,23100,5500,28600
420040,202112,96,73,23,80300,25300,105600
420050,202112,59,37,22,40700,24200,64900
420055,202112,18,17,1,18700,1100,19800
420060,202112,24,17,7,18700,7700,26400
420070,202112,100,85,15,93500,16500,110000
420075,202112,9,9,0,9900,,9900.0
420080,202112,39,34,5,37400,5500,42900
420090,202112,37,30,7,33000,7700,40700
420100,202112,153,128,25,141900,27500,169400
420110,202112,20,20,0,22000,,22000.0
420120,202112,56,38,18,41800,19800,61600
420125,202112,84,66,18,73700,19800,93500
420127,202112,33,27,6,29700,6600,36300
420130,202112,453,270,183,297000,202400,499400
420140,202112,1313,724,589,797500,647900,1445400
420150,202112,43,35,8,39600,8800,48400
420160,202112,30,28,2,30800,2200,33000
420165,202112,14,9,5,9900,5500,15400
420170,202112,67,41,26,45100,28600,73700
420180,202112,22,19,3,20900,3300,24200
420190,202112,25,22,3,24200,3300,27500
420195,202112,149,67,82,73700,90200,163900
420200,202112,1286,537,749,591800,823900,1415700
420205,202112,100,59,41,64900,46200,111100
420207,202112,130,69,61,75900,67100,143000
420208,202112,19,15,4,16500,4400,20900
420209,202112,14,12,2,13200,2200,15400
420210,202112,555,259,296,286000,325600,611600
420213,202112,50,37,13,40700,14300,55000
420215,202112,25,21,4,23100,4400,27500
420220,202112,61,38,23,41800,25300,67100
420230,202112,907,542,365,597300,402600,999900
420240,202112,2224,1441,783,1591406.66,861300.69,2452707.35
420243,202112,44,35,9,38500,9900,48400
420245,202112,191,95,96,104500,105600,210100
420250,202112,61,41,20,45100,22000,67100
420253,202112,28,22,6,24200,6600,30800
420257,202112,12,9,3,9900,3300,13200
420260,202112,113,90,23,99000,25300,124300
420270,202112,31,24,7,26400,7700,34100
420280,202112,279,207,72,228800,79200,308000
420285,202112,24,16,8,17600,8800,26400
420287,202112,51,34,17,37400,18700,56100
420290,202112,917,627,290,690800,319000,1009800
420300,202112,1474,1171,303,1289200,333300,1622500
420310,202112,48,33,15,36300,16500,52800
420315,202112,31,24,7,26400,7700,34100
420320,202112,962,454,508,501600,559900,1061500
420325,202112,4,2,2,2200,2200,4400
420330,202112,120,79,41,86900,45100,132000
420340,202112,178,119,59,130900,64900,195800
420350,202112,254,174,80,192500,88000,280500
420360,202112,702,538,164,591800.88,180400,772200.88
420370,202112,128,71,57,79200,62700,141900
420380,202112,1198,825,373,909700,412500,1322200
420390,202112,226,157,69,172700,75900,248600
420395,202112,188,137,51,150700,56100,206800
420400,202112,232,176,56,193600,61600,255200
420410,202112,52,39,13,42900,14300,57200
420415,202112,33,28,5,30800,5500,36300
420417,202112,53,42,11,46200,12100,58300
420419,202112,10,9,1,9900,1100,11000
420420,202112,2782,1723,1059,1897500,1166000,3063500
420425,202112,70,55,15,60500,16500,77000
420430,202112,1083,782,301,861300,332200,1193500
420435,202112,14,12,2,13200,2200,15400
420440,202112,93,66,27,72600,29700,102300
420445,202112,30,27,3,29700,3300,33000
420450,202112,80,40,40,44000,44000,88000
420455,202112,194,149,45,163900,49500,213400
420460,202112,2309,1445,864,1592800,952600,2545400
420470,202112,95,66,29,73700,31900,105600
420475,202112,9,8,1,8800,1100,9900
420480,202112,861,652,209,718300,229900,948200
420490,202112,94,68,26,74800,28600,103400
420500,202112,434,234,200,257400.26,220000,477400.26
420510,202112,24,20,4,22000,4400,26400
420515,202112,29,16,13,17600,14300,31900
420517,202112,8,8,0,8800,,8800.0
420519,202112,0,,,,,0.0
420520,202112,61,46,15,50600,16500,67100
420530,202112,142,91,51,100100,56100,156200
420535,202112,16,14,2,17600,2200,19800
420540,202112,6059,3746,2313,4125275.26,2548700,6673975.26
420543,202112,30,28,2,30800,2200,33000
420545,202112,209,144,65,158400,71500,229900
420550,202112,784,647,137,713900,150700,864600
420555,202112,28,19,9,20900,9900,30800
420560,202112,59,47,12,52800,13200,66000
420570,202112,180,95,85,104500,93500,198000
420580,202112,288,140,148,154000,163900,317900
420590,202112,461,298,163,331100,179300,510400
420600,202112,144,79,65,86900,71500,158400
420610,202112,36,33,3,36300,3300,39600
420620,202112,78,57,21,62700,23100,85800
420630,202112,147,95,52,104500,57200,161700
420640,202112,72,62,10,68200,11000,79200
420650,202112,259,137,122,150700,134200,284900
420660,202112,41,33,8,36300,8800,45100
420665,202112,43,27,16,29700,17600,47300
420670,202112,252,197,55,216700,60500,277200
420675,202112,15,13,2,14300,2200,16500
420680,202112,32,26,6,28600,6600,35200
420690,202112,188,145,43,159500,47300,206800
420700,202112,696,450,246,495000.7,271700,766700.7
420710,202112,147,75,72,82500,79200,161700
420720,202112,101,81,20,90200,22000,112200
420730,202112,677,405,272,446600,299200,745800
420740,202112,52,52,0,57200,,57200.0
420750,202112,482,315,167,347600,183700,531300
420757,202112,17,15,2,16500,2200,18700
420760,202112,36,28,8,30800,8800,39600
420765,202112,76,54,22,60500,24200,84700
420768,202112,52,42,10,46200,11000,57200
420770,202112,73,60,13,66000,14300,80300
420775,202112,37,34,3,37400,3300,40700
420780,202112,200,157,43,172700,47300,220000
420785,202112,21,13,8,14300,8800,23100
420790,202112,145,120,25,133100,27500,160600
420800,202112,62,46,16,50600,17600,68200
420810,202112,263,213,50,235400,55000,290400
420820,202112,2441,1360,1081,1497100,1190200.5,2687300.5
420830,202112,641,328,313,361900,344300,706200
420840,202112,142,97,45,106700,49500,156200
420845,202112,426,181,245,199100,269500,468600
420850,202112,260,196,64,215600,70400,286000
420860,202112,58,49,9,53900,11000,64900
420870,202112,129,90,39,99000,44000,143000
420880,202112,185,121,64,133100,70400,203500
420890,202112,939,450,489,495000,539000,1034000
420895,202112,8,8,0,8800,,8800.0
420900,202112,411,328,83,361900,91300,453200
420910,202112,5694,3063,2631,3373701.3,2898500,6272201.3
420915,202112,61,54,7,59400,7700,67100
420917,202112,19,14,5,15400,5500,20900
420920,202112,19,13,6,14300,6600,20900
420930,202112,3002,1913,1089,2105329,1201200,3306529
420940,202112,585,425,160,467500,176000,643500
420945,202112,10,7,3,7700,3300,11000
420950,202112,48,38,10,41800,11000,52800
420960,202112,110,89,21,97900,23100,121000
420970,202112,279,222,57,246400,62700,309100
420980,202112,20,19,1,20900,1100,22000
420985,202112,54,48,6,52800,6600,59400
420990,202112,81,61,20,67100,22000,89100
421000,202112,49,27,22,29700,24200,53900
421003,202112,39,27,12,29700,13200,42900
421005,202112,8,5,3,5500,3300,8800
421010,202112,807,525,282,577500,310200,887700
421020,202112,22,17,5,18700,5500,24200
421030,202112,110,94,16,103400,17600,121000
421040,202112,68,46,22,50600,24200,74800
421050,202112,332,231,101,255200,112200,367400
421055,202112,18,14,4,15400,4400,19800
421060,202112,101,54,47,59400,51700,111100
421070,202112,38,32,6,35200,6600,41800
421080,202112,37,32,5,35200,5500,40700
421085,202112,18,15,3,16500,3300,19800
421090,202112,35,28,7,30800,7700,38500
421100,202112,116,85,31,93500,34100,127600
421105,202112,176,141,35,155100,38500,193600
421110,202112,110,81,29,90200,31900,122100
421120,202112,172,122,50,136400,55000,191400
421125,202112,19,12,7,13200,7700,20900
421130,202112,817,491,326,542300,358600,900900
421140,202112,35,25,10,27500,11000,38500
421145,202112,49,38,11,41800,12100,53900
421150,202112,92,72,20,79200,22000,101200
421160,202112,62,39,23,42900,25300,68200
421165,202112,15,12,3,13200,3300,16500
421170,202112,175,147,28,162932,31900,194832
421175,202112,180,122,58,134200,63800,198000
421180,202112,43,29,14,31900,15400,47300
421185,202112,14,11,3,12100,3300,15400
421187,202112,3,1,2,1100,2200,3300
421189,202112,46,33,13,36300,14300,50600
421190,202112,1827,1143,684,1258400,753500.55,2011900.55
421200,202112,94,66,28,72600,30800,103400
421205,202112,28,20,8,22000,8800,30800
421210,202112,176,128,48,140800,52800,193600
421220,202112,247,192,55,212300,60500,272800
421223,202112,48,37,11,40700,12100,52800
421225,202112,70,44,26,48400,28600,77000
421227,202112,75,59,16,64900,17600,82500
421230,202112,63,44,19,48400,20900,69300
421240,202112,15,15,0,16500,,16500.0
421250,202112,376,221,155,243100,171600,414700
421260,202112,21,17,4,18700,4400,23100
421265,202112,4,3,1,3300,1100,4400
421270,202112,49,43,6,47300,6600,53900
421280,202112,350,176,174,195800,191400,387200
421290,202112,318,213,105,235400,115500,350900
421300,202112,24,19,5,20900,5500,26400
421310,202112,53,36,17,39600,18700,58300
421315,202112,31,19,12,20900,13200,34100
421320,202112,128,82,46,90200,50600,140800
421330,202112,110,83,27,91300,30800,122100
421335,202112,42,31,11,34100,12100,46200
421340,202112,242,155,87,171600,96800,268400
421350,202112,186,108,78,118800.39,85800,204600.39
421360,202112,696,491,205,540100,225500,765600
421370,202112,187,137,50,150700,55000,205700
421380,202112,138,107,31,117700,34100,151800
421390,202112,15,9,6,9900,6600,16500
421400,202112,114,94,20,103400,22000,125400
421410,202112,22,19,3,20900,3300,24200
421415,202112,21,18,3,19800,3300,23100
421420,202112,104,90,14,99000,15400,114400
421430,202112,18,13,5,14300,5500,19800
421440,202112,58,51,7,56100,7700,63800
421450,202112,89,73,16,80300,17600.51,97900.51
421460,202112,57,43,14,47300,15400,62700
421470,202112,74,42,32,46200,35200,81400
421480,202112,739,559,180,614900,198000,812900
421490,202112,25,24,1,26400,1100,27500
421500,202112,473,283,190,311300,209000.1,520300.1
421505,202112,28,20,8,22000,8800,30800
421507,202112,30,24,6,26400,6600,33000
421510,202112,71,45,26,49500,28600,78100
421520,202112,53,44,9,48400,9900,58300
421530,202112,50,40,10,44000,11000,55000
421535,202112,19,18,1,19800,1100,20900
421540,202112,53,41,12,45100,13200,58300
421545,202112,81,58,23,63800,25300,89100
421550,202112,288,207,81,227700,89100,316800
421555,202112,18,15,3,16500,3300,19800
421560,202112,9,8,1,8800,1100,9900
421565,202112,119,77,42,84700,46200,130900
421567,202112,31,24,7,26400,7700,34100
421568,202112,43,40,3,44000,4400,48400
421569,202112,11,11,0,13200,,13200.0
421570,202112,218,142,76,157300,83600,240900
421575,202112,25,22,3,24200,3300,27500
421580,202112,701,409,292,451072,322300,773372
421590,202112,19,18,1,19800,1100,20900
421600,202112,154,100,54,110000,59400,169400
421605,202112,108,74,34,81400,37400,118800
421610,202112,165,127,38,139700,41800,181500
421620,202112,1022,576,446,635800,490600,1126400
421625,202112,21,19,2,20900,2200,23100
421630,202112,331,198,133,217800,146300,364100
421635,202112,20,9,11,9900,12100,22000
421640,202112,99,82,17,91300,18700,110000
421650,202112,291,170,121,188100,133100,321200
421660,202112,2442,1469,973,1620300,1070300,2690600
421670,202112,168,119,49,132000,53900,185900
421680,202112,187,169,18,185900,19800,205700
421690,202112,345,236,109,259600,119900,379500
421700,202112,55,38,17,41800,18700,60500
421710,202112,19,18,1,19800,1100,20900
421715,202112,5,4,1,4400,1100,5500
421720,202112,629,433,196,476300,215600,691900
421725,202112,22,7,15,7700,16500,24200
421730,202112,25,19,6,20900,6600,27500
421740,202112,102,38,64,41800,70400,112200
421750,202112,196,142,54,156200,59400,215600
421755,202112,20,18,2,19800,2200,22000
421760,202112,98,66,32,72600,35200,107800
421770,202112,696,445,251,490600,276100,766700
421775,202112,27,17,10,18700,11000,29700
421780,202112,179,141,38,155100,41800,196900
421790,202112,150,128,22,140800,24200,165000
421795,202112,17,13,4,14300,4400,18700
421800,202112,540,330,210,363000,231000,594000
421810,202112,72,59,13,64900,14300,79200
421820,202112,302,190,112,209000,123200,332200
421825,202112,149,123,26,135300,28600,163900
421830,202112,148,89,59,97900,64900,162800
421835,202112,7,2,5,2200,5500,7700
421840,202112,45,39,6,42900,6600,49500
421850,202112,81,68,13,74800,14300,89100
421860,202112,41,29,12,31900,13200,45100
421870,202112,1030,748,282,822800,310200,1133000
421875,202112,52,41,11,45100,12100,57200
421880,202112,181,122,59,134200,64900,199100
421885,202112,28,20,8,22000,8800,30800
421890,202112,133,94,39,104500,44000.5,148500.5
421895,202112,43,38,5,41800,5500,47300
421900,202112,131,99,32,108900,36300,145200
421910,202112,62,40,22,44000,24200,68200
421915,202112,33,27,6,29700,6600,36300
421917,202112,38,28,10,30800,11000,41800
421920,202112,35,31,4,34100,4400,38500
421930,202112,614,482,132,531300,145200,676500
421935,202112,43,37,6,40700,6600,47300
421940,202112,49,41,8,45100,8800,53900
421950,202112,853,564,289,620400,317900,938300
421960,202112,39,33,6,36300,6600,42900
421970,202112,323,207,116,227700,127600,355300
421985,202112,18,11,7,12100,7700,19800
422000,202112,0,0,0,,,0.0
430003,202112,193,55,138,61600,151800,213400
430005,202112,36,26,10,28600,11000,39600
430010,202112,260,186,74,204600,81400,286000
430020,202112,146,98,48,107800,52800,160600
430030,202112,120,100,20,110000,22000,132000
430040,202112,2913,1720,1193,1894200,1314500,3208700
430045,202112,71,60,11,66000,12100,78100
430047,202112,6,5,1,5500,1100,6600
430050,202112,86,72,14,80300,15400,95700
430055,202112,12,11,1,12100,1100,13200
430057,202112,5,4,1,4400,1100,5500
430060,202112,3893,2252,1641,2482700,1809500,4292200
430063,202112,55,45,10,50600,11000,61600
430064,202112,158,122,36,134200,39600,173800
430066,202112,6,3,3,3300,3300,6600
430070,202112,42,31,11,34100,12100,46200
430080,202112,74,46,28,50600,30800,81400
430085,202112,29,13,16,14300,17600,31900
430087,202112,23,16,7,17600,7700,25300
430090,202112,60,50,10,55000,11000,66000
430100,202112,133,90,43,99000,47300,146300
430105,202112,148,83,65,91300,71500,162800
430107,202112,19,13,6,14300,6600,20900
430110,202112,493,269,224,297000,246400,543400
430120,202112,163,147,16,161700,17600,179300
430130,202112,786,476,310,523600,341000,864600
430140,202112,130,119,11,130900,12100,143000
430150,202112,100,63,37,69300,41800,111100
430155,202112,30,25,5,27500,5500,33000
430160,202112,3613,2074,1539,2281400,1695100,3976500
430163,202112,399,179,220,196900,242000,438900
430165,202112,32,20,12,22000,13200,35200
430170,202112,81,67,14,74800,15400,90200
430175,202112,81,62,19,68200,22000,90200
430180,202112,105,85,20,95700,22000,117700
430185,202112,28,19,9,20900,9900,30800
430187,202112,55,29,26,31900,28600,60500
430190,202112,226,118,108,129800,118800,248600
430192,202112,16,12,4,13200,4400,17600
430195,202112,17,11,6,12100,6600,18700
430200,202112,152,128,24,140800,26400,167200
430205,202112,19,19,0,20900,,20900.0
430210,202112,703,531,172,585200,191400,776600
430215,202112,11,10,1,11000,1100,12100
430220,202112,74,50,24,55000,26400,81400
430222,202112,12,4,8,4400,8800,13200
430223,202112,17,11,6,12100,6600,18700
430225,202112,2,1,1,1100,1100,2200
430230,202112,321,195,126,214500,138600,353100
430235,202112,47,34,13,37400,14300,51700
430237,202112,20,15,5,16500,5500,22000
430240,202112,110,77,33,84700,36300,121000
430245,202112,68,54,14,59400,15400,74800
430250,202112,186,106,80,117700,88000,205700
430258,202112,8,7,1,7700,1100,8800
430260,202112,32,28,4,30800,4400,35200
430265,202112,33,29,4,31900,5500,37400
430270,202112,518,379,139,418000,154000,572000
430280,202112,1069,628,441,691900,486200,1178100
430290,202112,420,219,201,240900,222200,463100
430300,202112,2100,1123,977,1236400,1076900,2313300
430310,202112,2043,996,1047,1098900,1151701.19,2250601.19
430320,202112,56,47,9,51700,9900,61600
430330,202112,94,82,12,90200,13200,103400
430340,202112,65,52,13,57200,14300,71500
430350,202112,1665,1091,574,1200100,632500,1832600
430355,202112,19,17,2,18700,2200,20900
430360,202112,88,41,47,45100,51700,96800
430367,202112,36,27,9,29700,9900,39600
430370,202112,58,51,7,56100,7700,63800
430380,202112,115,87,28,95700,30800,126500
430390,202112,574,351,223,386100,245300,631400
430400,202112,263,185,78,203500,85800,289300
430410,202112,59,47,12,51700,13200,64900
430420,202112,506,313,193,344300,212300,556600
430430,202112,54,52,2,56467.4,2200,58667.4
430435,202112,140,107,33,117700,36300,154000
430440,202112,523,327,196,359700,216700,576400
430450,202112,1168,954,214,1050500.89,236500,1287000.89
430460,202112,5625,2886,2739,3175700,3014000,6189700
430461,202112,16,14,2,15400,2200,17600
430462,202112,5,3,2,3300,2200,5500
430463,202112,1145,620,525,685300,578600,1263900
430465,202112,24,13,11,14300,12100,26400
430466,202112,649,452,197,497200,216700,713900
430467,202112,118,69,49,75900,53900,129800
430468,202112,135,79,56,86900,61600,148500
430469,202112,19,15,4,16500,4400,20900
430470,202112,1130,622,508,685628.16,558800,1244428.16
430471,202112,65,42,23,46200,26400,72600
430480,202112,117,81,36,89100,39600,128700
430485,202112,8,8,0,8800,,8800.0
430490,202112,75,59,16,64900,17600,82500
430495,202112,32,24,8,26400,8800,35200
430500,202112,185,124,61,136400,67100,203500
430510,202112,3634,2347,1287,2583900.67,1417900,4001800.67
430511,202112,16,16,0,17600,,17600.0
430512,202112,151,103,48,113300,52800,166100
430513,202112,51,40,11,44000,12100,56100
430515,202112,25,24,1,26400,1100,27500
430517,202112,173,145,28,159500,30800,190300
430520,202112,336,237,99,260700,108900,369600
430530,202112,80,44,36,48400,39600,88000
430535,202112,444,295,149,325600,165000,490600
430537,202112,11,11,0,12100,,12100.0
430540,202112,78,52,26,57200,28600,85800
430543,202112,373,116,257,127600,283800,411400
430544,202112,44,41,3,46200,3300,49500
430545,202112,390,183,207,201300,227700,429000
430550,202112,40,32,8,35200,8800,44000
430558,202112,1,1,0,1100,,1100.0
430560,202112,53,30,23,33000,25300,58300
430570,202112,112,47,65,51700,71500.26,123200.26
430580,202112,124,99,25,108900,27500,136400
430583,202112,15,15,0,16500,,16500.0
430585,202112,11,7,4,7700,4400,12100
430587,202112,13,8,5,8800,5500,14300
430590,202112,156,127,29,139700,33000,172700
430593,202112,2,2,0,2200,,2200.0
430595,202112,16,13,3,14300,3300,17600
430597,202112,45,24,21,26400,23100,49500
430600,202112,218,168,50,184800,55000,239800
430605,202112,167,98,69,107800,75900,183700
430607,202112,29,23,6,25300,6600,31900
430610,202112,1710,802,908,885500,998800,1884300
430613,202112,5,5,0,5500,,5500.0
430620,202112,108,81,27,89100,29700,118800
430630,202112,45,38,7,41800,7700,49500
430632,202112,30,25,5,27500,5500,33000
430635,202112,38,32,6,35200,6600,41800
430637,202112,67,34,33,37400,36300,73700
430640,202112,173,94,79,104500,86900,191400
430642,202112,18,16,2,17600,2200,19800
430645,202112,28,24,4,26400,4400,30800
430650,202112,249,199,50,218900,55000,273900
430655,202112,5,4,1,4400,1100,5500
430660,202112,967,469,498,517000,547800,1064800
430670,202112,74,50,24,55000,26400,81400
430673,202112,79,48,31,52800,34100,86900
430675,202112,8,6,2,6600,2200,8800
430676,202112,577,339,238,372900,264000,636900
430680,202112,237,156,81,171600,89100,260700
430690,202112,524,317,207,348700,227700.63,576400.63
430692,202112,9,7,2,7700,2200,9900
430693,202112,137,86,51,94600,57200,151800
430695,202112,64,53,11,58300,12100,70400
430697,202112,62,37,25,40700,27500,68200
430700,202112,1399,944,455,1042800,500500,1543300
430705,202112,29,26,3,28600,3300,31900
430710,202112,256,160,96,176000,105600,281600
430720,202112,109,92,17,101200,18700,119900
430730,202112,142,120,22,132000,24200,156200
430740,202112,76,50,26,55000,28600,83600
430745,202112,30,19,11,20900,12100,33000
430750,202112,334,217,117,239800,128700,368500
430755,202112,90,49,41,53900,45100,99000
430760,202112,390,215,175,236500,192500,429000
430770,202112,1558,806,752,887700,828300,1716000
430780,202112,315,196,119,215600,132000,347600
430781,202112,24,22,2,24200,2200,26400
430783,202112,64,50,14,55000,15400,70400
430786,202112,5,3,2,3300,2200,5500
430790,202112,527,336,191,369600,211200,580800
430800,202112,153,120,33,132000.01,36300,168300.01
430805,202112,38,31,7,34100,7700,41800
430807,202112,56,32,24,35200,26400,61600
430810,202112,74,48,26,52800,28600,81400
430820,202112,147,90,57,99000,62700,161700
430825,202112,11,9,2,9900,2200,12100
430830,202112,243,226,17,248600,18700,267300
430840,202112,138,92,46,101200,50600,151800
430843,202112,7,5,2,5500,2200,7700
430845,202112,73,41,32,45100,35200,80300
430850,202112,581,416,165,457600,181500,639100
430860,202112,149,93,56,102300,61600,163900
430865,202112,78,41,37,45100,40700,85800
430870,202112,77,62,15,69300,16500,85800
430880,202112,156,114,42,125400,46200,171600
430885,202112,10,9,1,9900,1100,11000
430890,202112,334,197,137,218900,150700,369600
430900,202112,521,359,162,394900,178200,573100
430905,202112,124,52,72,57200,79200,136400
430910,202112,275,152,123,167200,138600,305800
430912,202112,4,4,0,4400,,4400.0
430915,202112,37,34,3,37400,3300,40700
430920,202112,4453,2336,2117,2578400,2334200,4912600
430925,202112,5,4,1,4400,1100,5500
430930,202112,2059,1189,870,1310100,957000,2267100
430940,202112,253,162,91,178200,100100,278300
430950,202112,153,125,28,137500,30800,168300
430955,202112,25,14,11,15400,12100,27500
430957,202112,23,20,3,22000,3300,25300
430960,202112,244,161,83,177100,91300,268400
430965,202112,106,68,38,74800,41800,116600
430970,202112,91,73,18,80300,19800,100100
430975,202112,45,39,6,42900,6600,49500
430980,202112,50,31,19,34100,20900,55000
430990,202112,100,76,24,83600,26400,110000
430995,202112,114,105,9,115500,9900,125400
431000,202112,289,145,144,159500.6,158400,317900.6
431010,202112,354,202,152,222200,168300,390500
431020,202112,1868,1074,794,1183600,873400,2057000
431030,202112,38,30,8,33000,8800,41800
431033,202112,444,201,243,222200,267300,489500
431036,202112,13,7,6,7700,6600,14300
431040,202112,141,90,51,100100,56100,156200
431041,202112,37,22,15,24200,16500,40700
431043,202112,39,22,17,24200,19800,44000
431046,202112,13,10,3,11000,3300,14300
431050,202112,202,127,75,139700,82500,222200
431053,202112,70,39,31,42900,34100,77000
431055,202112,68,46,22,50600,24200,74800
431057,202112,17,17,0,18700,,18700.0
431060,202112,1575,1011,564,1112100.31,621500,1733600.31
431065,202112,15,8,7,8800,7700,16500
431070,202112,60,54,6,59400,6600,66000
431075,202112,7,7,0,7700,,7700.0
431080,202112,127,75,52,82500,57200,139700
431085,202112,34,30,4,33000,4400,37400
431087,202112,12,10,2,11000,2200,13200
431090,202112,52,39,13,42900,14300,57200
431100,202112,1233,731,502,806300,552200,1358500
431110,202112,220,132,88,146300,96800,243100
431112,202112,24,17,7,18700,7700,26400
431113,202112,31,23,8,25300,8800,34100
431115,202112,158,112,46,123200,50600,173800
431120,202112,588,338,250,372900,275000,647900
431123,202112,4,4,0,4400,,4400.0
431125,202112,98,85,13,93500,14300,107800
431127,202112,7,4,3,4400,3300,7700
431130,202112,717,472,245,521400,269500,790900
431140,202112,778,539,239,594000,262900,856900
431142,202112,20,18,2,19800.55,2200,22000.55
431150,202112,196,147,49,161700,53900,215600
431160,202112,46,43,3,47300,3300,50600
431162,202112,4,3,1,3300,1100,4400
431164,202112,4,4,0,4400,,4400.0
431170,202112,113,83,30,91300,33000,124300
431171,202112,72,41,31,45100,34100,79200
431173,202112,1,1,0,1100,,1100.0
431175,202112,206,108,98,118800,107800,226600
431177,202112,90,64,26,70400,28600,99000
431179,202112,15,11,4,12100,4400,16500
431180,202112,405,254,151,279400,167200,446600
431190,202112,74,54,20,59400,22000,81400
431198,202112,66,46,20,50600,22000,72600
431200,202112,20,16,4,17600,4400,22000
431205,202112,23,21,2,23100,2200,25300
431210,202112,101,64,37,70400,40700,111100
431213,202112,33,27,6,29700,6600,36300
431215,202112,22,19,3,20900,3300,24200
431217,202112,7,6,1,6600,1100,7700
431220,202112,67,57,10,62700,11000,73700
431225,202112,163,105,58,115500,63800,179300
431230,202112,96,85,11,93500,12100,105600
431235,202112,5,5,0,5500,,5500.0
431237,202112,9,7,2,7700,2200,9900
431238,202112,12,9,3,9900,3300,13200
431240,202112,1066,650,416,715000,457600,1172600
431242,202112,39,38,1,41800,1100,42900
431244,202112,18,14,4,15400,4400,19800
431245,202112,50,37,13,40700,14300,55000
431247,202112,10,6,4,6600,4400,11000
431250,202112,285,139,146,152900,160600,313500
431260,202112,55,46,9,50600,9900,60500
431261,202112,18,12,6,13200,6600,19800
431262,202112,16,14,2,15400,2200,17600
431265,202112,152,80,72,88000,79200,167200
431267,202112,18,16,2,17600,2200,19800
431270,202112,332,259,73,284900,80300,365200
431275,202112,40,35,5,38500,5500,44000
431280,202112,19,15,4,16500,4400,20900
431290,202112,16,14,2,15400,2200,17600
431295,202112,2,1,1,1100,1100,2200
431300,202112,20,18,2,19800,2200,22000
431301,202112,6,6,0,6600,,6600.0
431303,202112,59,37,22,40700,24200,64900
431306,202112,239,126,113,138404.2,124300,262704.2
431308,202112,6,4,2,4400,2200,6600
431310,202112,64,53,11,58300,12100,70400
431320,202112,162,96,66,105600,72600,178200
431330,202112,190,119,71,132000,78100,210100
431333,202112,29,23,6,25300,6600,31900
431335,202112,7,4,3,4400,3300,7700
431337,202112,390,183,207,201300,227700,429000
431339,202112,22,17,5,18700,5500,24200
431340,202112,3120,1685,1435,1853413.1,1578500,3431913.1
431342,202112,36,24,12,26400,13200,39600
431344,202112,18,18,0,19800,,19800.0
431346,202112,4,4,0,4400,,4400.0
431349,202112,33,29,4,31900,4400,36300
431350,202112,983,542,441,596200,486200,1082400
431360,202112,52,40,12,44000,13200,57200
431365,202112,348,148,200,162800,220000,382800
431370,202112,1188,679,509,746900,561000,1307900
431380,202112,99,89,10,97900,11000,108900
431390,202112,502,273,229,302500,253000,555500
431395,202112,324,137,187,150700,205700,356400
431400,202112,39,25,14,27500,15400,42900
431402,202112,101,71,30,78100,33000,111100
431403,202112,22,14,8,15400,8800,24200
431405,202112,706,401,305,441100,336600,777700
431406,202112,36,28,8,30800,8800,39600
431407,202112,49,38,11,42900,12100,55000
431410,202112,3385,2044,1341,2249500,1477300,3726800
431413,202112,17,14,3,15400,3300,18700
431415,202112,64,45,19,49500,20900,70400
431417,202112,25,11,14,12100,15400,27500
431420,202112,347,233,114,257400,125400,382800
431430,202112,59,29,30,31900,33000,64900
431440,202112,9009,6139,2870,6763900.59,3159250.6,9923151.19
431442,202112,27,14,13,15400,14300,29700
431445,202112,29,27,2,29700,2200,31900
431446,202112,4,3,1,3300,1100,4400
431447,202112,83,60,23,66000,25300,91300
431449,202112,51,41,10,45100,11000,56100
431450,202112,408,269,139,297000,152900,449900
431454,202112,12,7,5,7700,5500,13200
431455,202112,45,36,9,39600,9900,49500
431460,202112,498,343,155,377300,170500,547800
431470,202112,125,93,32,103400,35200,138600
431475,202112,9,7,2,7700,2200,9900
431477,202112,39,24,15,26400,16500,42900
431478,202112,9,8,1,8800,1100,9900
431480,202112,578,342,236,377300,259600,636900
431490,202112,28965,16092,12873,17726386,14184500,31910886
431500,202112,79,62,17,68200,18700,86900
431505,202112,29,19,10,20900,11000,31900
431507,202112,8,7,1,7700,1100,8800
431510,202112,228,167,61,183700,67100,250800
431513,202112,22,20,2,22000,2200,24200
431514,202112,4,3,1,3300,1100,4400
431515,202112,80,67,13,73700,14300,88000
431517,202112,6,3,3,3300,3300,6600
431520,202112,37,33,4,36300,4400,40700
431530,202112,1409,627,782,689700,860200,1549900
431531,202112,20,18,2,19800,2200,22000
431532,202112,37,28,9,30800,9900,40700
431535,202112,27,14,13,15400,14300,29700
431540,202112,139,114,25,125400,27500,152900
431545,202112,12,10,2,11000,2200,13200
431550,202112,359,192,167,211200,183700,394900
431555,202112,9,9,0,9900,,9900.0
431560,202112,4650,3099,1551,3415500,1711600,5127100
431570,202112,828,428,400,471900,440000,911900
431575,202112,48,27,21,29700,23100,52800
431580,202112,90,60,30,67100,33000,100100
431590,202112,140,116,24,127600,26400,154000
431595,202112,19,16,3,17600,3300,20900
431600,202112,252,147,105,161700,115500,277200
431610,202112,111,83,28,91300,30800,122100
431620,202112,41,34,7,37400,7700,45100
431630,202112,127,103,24,113300,26400,139700
431640,202112,1327,821,506,904200,558800,1463000
431642,202112,35,32,3,35200,3300,38500
431643,202112,43,17,26,18700,29700,48400
431645,202112,317,186,131,204600,144100,348700
431647,202112,9,8,1,8800,1100,9900
431650,202112,30,16,14,17600,15400,33000
431660,202112,272,169,103,185900,113300,299200
431670,202112,221,98,123,107800,136400,244200
431673,202112,13,11,2,12100,2200,14300
431675,202112,25,20,5,22000,5500,27500
431680,202112,1127,825,302,908600,332200,1240800
431690,202112,4851,2873,1978,3161400.66,2179100,5340500.66
431695,202112,21,15,6,16500,6600,23100
431697,202112,2,1,1,1100,1100,2200
431700,202112,185,139,46,152900,50600,203500
431710,202112,4056,1755,2301,1930500,2536600,4467100
431720,202112,1294,795,499,876150.92,551100,1427250.92
431725,202112,2,2,0,2200,,2200.0
431730,202112,1144,761,383,840400,421300,1261700
431740,202112,1318,637,681,700700,750200,1450900
431750,202112,1824,1190,634,1309000.32,698500,2007500.32
431755,202112,6,5,1,5500,1100,6600
431760,202112,985,613,372,675400,409200,1084600
431770,202112,422,290,132,319000,145200,464200
431775,202112,25,19,6,20900,6600,27500
431780,202112,547,328,219,360800,240900,601700
431790,202112,153,120,33,133100,36300,169400
431795,202112,13,10,3,11000,3300,14300
431800,202112,3164,1651,1513,1816101.22,1665400,3481501.22
431805,202112,19,17,2,18700,2200,20900
431810,202112,593,389,204,427900,225500,653400
431820,202112,337,199,138,218900,151800,370700
431830,202112,2275,1374,901,1511400,993300,2504700
431840,202112,477,314,163,345400,179300,524700
431842,202112,36,29,7,31900,7700,39600
431843,202112,11,8,3,8800,3300,12100
431844,202112,17,12,5,13200,5500,18700
431845,202112,25,22,3,24200,3300,27500
431846,202112,25,22,3,24200,3300,27500
431848,202112,15,12,3,14300,3300,17600
431849,202112,4,4,0,4400,,4400.0
431850,202112,756,591,165,650100,181500,831600
431860,202112,119,78,41,85800,45100,130900
431861,202112,6,2,4,2200,4400,6600
431862,202112,57,40,17,44000,18700,62700
431870,202112,3586,2024,1562,2228600.14,1720400,3949000.14
431880,202112,954,679,275,746900,302500,1049400
431890,202112,1261,732,529,806300,585200,1391500
431900,202112,189,131,58,144100,63800,207900
431910,202112,51,37,14,40700,15400,56100
431912,202112,50,31,19,34100,20900,55000
431915,202112,145,110,35,121000,38500,159500
431920,202112,152,110,42,122100,46200,168300
431930,202112,81,68,13,74800,14300,89100
431935,202112,2,2,0,2200,,2200.0
431936,202112,3,3,0,3300,,3300.0
431937,202112,20,15,5,16500,5500,22000
431940,202112,466,315,151,346500,166100,512600
431950,202112,468,298,170,328900,187000,515900
431960,202112,731,392,339,432300,374000,806300
431970,202112,69,63,6,69300,6600,75900
431971,202112,5,3,2,3300,2200,5500
431973,202112,17,14,3,15400,3300,18700
431975,202112,9,9,0,9900,,9900.0
431980,202112,206,121,85,133100,93500,226600
431990,202112,1108,590,518,651128.5,569800,1220928.5
432000,202112,1808,937,871,1031800,964700,1996500
432010,202112,260,177,83,194700,91300,286000
432020,202112,179,148,31,162800,34100,196900
432023,202112,15,13,2,14300,2200,16500
432026,202112,53,47,6,51700,6600,58300
432030,202112,62,31,31,34100,35200,69300
432032,202112,15,11,4,12100,4400,16500
432035,202112,61,47,14,51700,15400,67100
432040,202112,86,57,29,62700,31900,94600
432045,202112,2,2,0,2200,,2200.0
432050,202112,80,49,31,53900,34100,88000
432055,202112,130,93,37,102300,40700,143000
432057,202112,6,4,2,4400,2200,6600
432060,202112,35,31,4,34100,4400,38500
432065,202112,29,26,3,28600,3300,31900
432067,202112,86,79,7,88000,7700,95700
432070,202112,379,294,85,324775,93500,418275
432080,202112,818,571,247,629200,272800,902000
432085,202112,7,5,2,5500,2200,7700
432090,202112,264,177,87,195800,95700,291500
432100,202112,170,109,61,121000,67100,188100
432110,202112,542,359,183,394900,201300,596200
432120,202112,994,561,433,618200,476300,1094500
432130,202112,491,348,143,382800,157300,540100
432132,202112,24,21,3,23100,3300,26400
432135,202112,78,63,15,69300,16500,85800
432140,202112,262,197,65,216700,71500,288200
432143,202112,213,128,85,140800,93500,234300
432145,202112,275,189,86,207900,94600,302500
432146,202112,13,12,1,13200,1100,14300
432147,202112,109,59,50,64900,55000,119900
432149,202112,15,9,6,9900,6600,16500
432150,202112,984,607,377,669900,415800,1085700
432160,202112,1609,830,779,914100.5,858000,1772100.5
432162,202112,3,2,1,2200,1100,3300
432163,202112,17,12,5,13200,5500,18700
432166,202112,127,94,33,103675,36300,139975
432170,202112,224,111,113,122100,124300,246400
432180,202112,563,350,213,385000,234300,619300
432183,202112,10,9,1,9900,1100,11000
432185,202112,75,62,13,68200,14300,82500
432190,202112,508,298,210,327800,231000,558800
432195,202112,92,78,14,85800,15400,101200
432200,202112,403,250,153,275000,168300,443300
432210,202112,112,69,43,75900,47300,123200
432215,202112,33,31,2,34100,2200,36300
432218,202112,21,20,1,22000,1100,23100
432220,202112,633,323,310,355300,341000,696300
432225,202112,18,13,5,14300,5500,19800
432230,202112,130,84,46,92400,50600,143000
432232,202112,22,18,4,19800,4400,24200
432234,202112,3,1,2,1100,2200,3300
432235,202112,2,2,0,2200,,2200.0
432237,202112,25,16,9,17600,9900,27500
432240,202112,4407,2456,1951,2703800,2150500,4854300
432250,202112,1112,727,385,801900,424600,1226500
432252,202112,50,49,1,53900,1100,55000
432253,202112,60,48,12,52800,13200,66000
432254,202112,29,12,17,13200,18700,31900
432255,202112,13,11,2,12100,2200,14300
432260,202112,834,664,170,730400,187000,917400
432270,202112,221,166,55,182600,60500,243100
432280,202112,148,111,37,122100,40700,162800
432285,202112,1,1,0,1100,,1100.0
432290,202112,55,48,7,53900,7700,61600
432300,202112,4839,2582,2257,2842328.5,2489300.61,5331629.11
432310,202112,126,104,22,114400,24200,138600
432320,202112,22,17,5,18700,5500,24200
432330,202112,15,10,5,11000,5500,16500
432335,202112,8,6,2,6600,2200,8800
432340,202112,36,30,6,33000,6600,39600
432345,202112,109,73,36,80300,39600,119900
432350,202112,21,20,1,22000,1100,23100
432360,202112,5,4,1,4400,1100,5500
432370,202112,25,25,0,27500,,27500.0
432375,202112,27,25,2,27500,2200,29700
432377,202112,6,6,0,6600,,6600.0
432380,202112,181,78,103,85800,114400,200200
500020,202112,257,133,124,146300,136400,282700
500025,202112,139,68,71,74800,78100,152900
500060,202112,1444,908,536,1001000,590700,1591700
500070,202112,741,352,389,387200,427900,815100
500080,202112,136,106,30,116600,33000,149600
500085,202112,134,107,27,117700,29700,147400
500090,202112,367,169,198,185900,218900,404800
500100,202112,704,368,336,404800,369600,774400
500110,202112,2270,1070,1200,1177000,1324400,2501400
500124,202112,269,147,122,161700,134200,295900
500150,202112,337,135,202,148500,222200,370700
500190,202112,519,347,172,381700,190300,572000
500200,202112,202,170,32,187000,35200,222200
500210,202112,1611,540,1071,594000,1178100,1772100
500215,202112,206,118,88,129800,96800,226600
500220,202112,722,461,261,507100.92,288200,795300.92
500230,202112,226,138,88,152900,97900,250800
500240,202112,644,428,216,470800,237600,708400
500260,202112,585,225,360,247500,396000,643500
500270,202112,29947,12824,17123,14113422.3,18870500.15,32983922.45
500280,202112,201,68,133,74800,146300,221100
500290,202112,1167,717,450,790900,495000,1285900
500295,202112,456,294,162,323400,178200,501600
500310,202112,101,36,65,39600,71500,111100
500315,202112,812,451,361,496100,397100,893200
500320,202112,3663,1753,1910,1928300.84,2102100,4030400.84
500325,202112,912,501,411,551100,453200,1004300
500330,202112,1502,703,799,774380.2,878900,1653280.2
500345,202112,310,233,77,256300,84700,341000
500348,202112,251,151,100,167200,110000,277200
500350,202112,106,49,57,53900,62700,116600
500370,202112,5710,2572,3138,2832500,3454000,6286500
500375,202112,351,236,115,259600,126500,386100
500380,202112,592,333,259,366300,286000,652300
500390,202112,72,35,37,38500,40700,79200
500400,202112,210,137,73,150700,80300,231000
500410,202112,519,220,299,242000,330000,572000
500430,202112,543,377,166,414700,183700,598400
500440,202112,213,115,98,126500,107800,234300
500450,202112,416,179,237,196900,261800,458700
500460,202112,261,141,120,155100,132000,287100
500470,202112,423,319,104,350900,114400,465300
500480,202112,104,61,43,67100,47300,114400
500490,202112,103,45,58,49500,63800,113300
500500,202112,1431,524,907,577500,998800,1576300
500510,202112,42,35,7,38500,7700,46200
500515,202112,99,68,31,74800,34100,108900
500520,202112,297,157,140,172700,154000,326700
500525,202112,91,49,42,53900,47300,101200
500540,202112,895,391,504,430100,554400,984500
500560,202112,915,507,408,557700,449900,1007600
500568,202112,1002,536,466,590700,512600,1103300
500570,202112,1178,678,500,745800,551100,1296900
500580,202112,322,168,154,184800,169400,354200
500600,202112,356,175,181,192500,199100,391600
500620,202112,939,650,289,716100.5,320100,1036200.5
500625,202112,77,60,17,66000,18700,84700
500627,202112,41,19,22,20900,24200,45100
500630,202112,1564,892,672,981839.1,739200,1721039.1
500635,202112,517,307,210,338800,231000,569800
500640,202112,359,195,164,214500,180400,394900
500660,202112,5718,2058,3660,2264900,4031500,6296400
500690,202112,608,216,392,237600,431200,668800
500710,202112,398,196,202,215600,222200,437800
500720,202112,933,506,427,557700,469700,1027400
500730,202112,165,100,65,110000,71500,181500
500740,202112,920,375,545,413600,600600,1014200
500750,202112,166,54,112,59400,123200,182600
500755,202112,117,89,28,97900,30800,128700
500769,202112,740,403,337,443300,370700,814000
500770,202112,435,240,195,264000,214500,478500
500780,202112,135,91,44,101200,49500,150700
500790,202112,1035,510,525,561000,578600,1139600
500793,202112,292,148,144,162800,158400,321200
500795,202112,165,107,58,117700,63800,181500
500797,202112,49,33,16,36300,17600,53900
500800,202112,427,182,245,200200,269500,469700
500830,202112,2221,1204,1017,1325500,1122000,2447500
500840,202112,122,91,31,101200,34100,135300
510010,202112,168,92,76,101200,83600,184800
510020,202112,526,232,294,255200,323400,578600
510025,202112,1661,923,738,1016400.87,812900,1829300.87
510030,202112,669,339,330,374000,364100,738100
510035,202112,133,71,62,78100,68200,146300
510040,202112,411,195,216,214500,237600,452100
510050,202112,372,201,171,221100,188100.3,409200.3
510060,202112,125,60,65,66000,71500,137500
510080,202112,245,92,153,102300,168300,270600
510100,202112,65,27,38,29700,41800,71500
510120,202112,33,20,13,22000,14300,36300
510125,202112,374,228,146,250800,161700,412500
510130,202112,540,327,213,360800,234300,595100
510140,202112,441,140,301,154000,331100,485100
510160,202112,100,34,66,37400,72600,110000
510170,202112,746,454,292,499400,321200,820600
510180,202112,2888,1336,1552,1472900,1708300,3181200
510185,202112,24,13,11,14300,12100,26400
510190,202112,239,82,157,90200,172700,262900
510250,202112,2635,1613,1022,1775400,1126400,2901800
510260,202112,174,125,49,137500,53900,191400
510263,202112,467,261,206,287100,229900,517000
510267,202112,623,342,281,377300,310200,687500
510268,202112,61,27,34,29700,37400,67100
510269,202112,76,34,42,37400,46200,83600
510270,202112,379,183,196,201300,215600,416900
510279,202112,199,151,48,167200,52800,220000
510285,202112,176,71,105,78100,115500,193600
510300,202112,518,270,248,297000,272800,569800
510305,202112,200,90,110,100100,121000,221100
510310,202112,108,55,53,60500,58300,118800
510320,202112,815,506,309,556600,339900,896500
510325,202112,424,172,252,189200,277200,466400
510330,202112,427,234,193,257400,212300,469700
510335,202112,641,378,263,415800,289300,705100
510336,202112,55,39,16,42900,17600,60500
510337,202112,102,46,56,51700,61600,113300
510340,202112,17594,7836,9758,8629500.63,10740400.99,19369901.62
510343,202112,64,47,17,51700,18700,70400
510345,202112,153,96,57,105600,62700,168300
510350,202112,658,350,308,385000,339900,724900
510360,202112,212,135,77,148500,84700,233200
510370,202112,153,70,83,77000,91300,168300
510380,202112,80,60,20,66000,22000,88000
510385,202112,58,26,32,28600,35200,63800
510390,202112,103,44,59,48400,64900,113300
510395,202112,46,32,14,35200,15400,50600
510410,202112,738,463,275,509300,302500,811800
510420,202112,557,267,290,293700,319000,612700
510450,202112,47,23,24,25300,26400,51700
510452,202112,51,23,28,25300,31900,57200
510454,202112,51,24,27,26400,29700,56100
510455,202112,131,77,54,84700,59400,144100
510460,202112,179,82,97,90200,107800,198000
510480,202112,707,418,289,459800,317900,777700
510490,202112,340,168,172,184800,189200,374000
510500,202112,230,173,57,190300,63800,254100
510510,202112,799,459,340,504900,374000,878900
510515,202112,1250,643,607,708400,668800,1377200
510517,202112,273,125,148,137500,162800,300300
510520,202112,216,142,74,157300,81400,238700
510523,202112,107,83,24,91300,26400,117700
510525,202112,851,508,343,559900,377300,937200
510530,202112,19,12,7,13200,7700,20900
510550,202112,240,110,130,121000,143000,264000
510558,202112,291,141,150,155100,165000,320100
510560,202112,395,221,174,243100,191400,434500
510562,202112,643,463,180,509300,198000,707300
510590,202112,727,371,356,409200,392700,801900
510600,202112,220,113,107,125400,117700,243100
510610,202112,226,94,132,103400,145200,248600
510615,202112,189,86,103,94600,113300,207900
510617,202112,26,12,14,13200,15400,28600
510618,202112,122,60,62,66000,68200,134200
510619,202112,88,63,25,69300,27500,96800
510620,202112,158,89,69,97900,75900,173800
510621,202112,174,111,63,122100,69300,191400
510622,202112,478,266,212,292600,233200,525800
510623,202112,291,195,96,215600,105600,321200
510624,202112,86,46,40,50600,44000,94600
510625,202112,511,324,187,357500,205700.63,563200.63
510626,202112,110,63,47,69300,51700,121000
510627,202112,89,61,28,67100,31900,99000
510628,202112,158,95,63,104500,69300,173800
510629,202112,272,162,110,178200,121019.8,299219.8
510630,202112,438,217,221,238700,244200,482900
510631,202112,15,7,8,7700,8800,16500
510637,202112,349,197,152,216700,167200,383900
510642,202112,1054,558,496,614900,545600,1160500
510645,202112,7,1,6,1100,6600,7700
510650,202112,1341,875,466,962500,512600,1475100
510665,202112,81,32,49,35200,53900,89100
510670,202112,56,30,26,33000,28600,61600
510675,202112,1108,707,401,778800,441100,1219900
510677,202112,351,185,166,203500,182600,386100
510680,202112,96,57,39,62700,42900,105600
510682,202112,192,97,95,106700,104500,211200
510685,202112,54,39,15,44000,16500,60500
510700,202112,559,313,246,345400,270600,616000
510704,202112,1169,603,566,664400,623700,1288100
510706,202112,143,73,70,80300,78100,158400
510710,202112,413,286,127,316800,140800,457600
510715,202112,56,40,16,44000,17600,61600
510718,202112,232,113,119,124300,130900,255200
510719,202112,45,17,28,18700,30800,49500
510720,202112,184,129,55,144100,60500,204600
510724,202112,83,32,51,35200,56100,91300
510726,202112,63,30,33,33000,36300,69300
510729,202112,18,8,10,8800,11000,19800
510730,202112,471,257,214,282700,235400,518100
510735,202112,114,46,68,50600,74800,125400
510740,202112,22,11,11,12100,12100,24200
510757,202112,25,19,6,20900,6600,27500
510760,202112,7297,3702,3595,4075500,3961100,8036600
510770,202112,672,317,355,348700,390500,739200
510774,202112,19,6,13,6600,14300,20900
510775,202112,110,85,25,93500,27500,121000
510776,202112,36,12,24,13200,26400,39600
510777,202112,194,82,112,90200,123200,213400
510779,202112,36,21,15,23100,16500,39600
510780,202112,265,149,116,163900,127600,291500
510785,202112,358,195,163,215600,179300,394900
510787,202112,187,88,99,96800,110000,206800
510788,202112,6,1,5,1100,5500,6600
510790,202112,2560,1326,1234,1459751,1358500,2818251
510792,202112,1119,622,497,685300,546700.71,1232000.71
510794,202112,112,60,52,66000,57200,123200
510795,202112,2266,1317,949,1452440.11,1046100,2498540.11
510800,202112,188,113,75,124300,82500,206800
510805,202112,201,133,68,147400,74800,222200
510810,202112,102,42,60,46200,66000,112200
510820,202112,234,115,119,126500,130900.5,257400.5
510830,202112,75,41,34,45100,37400,82500
510835,202112,15,10,5,11000,5500,16500
510840,202112,9114,4259,4855,4692600,5344900,10037500
510850,202112,210,86,124,94600,136400,231000
510860,202112,405,191,214,210100,235400,445500
510880,202112,70,50,20,55000,22000,77000
510885,202112,66,39,27,42900,29700,72600
510890,202112,65,36,29,39600,31900,71500
510895,202112,167,99,68,108900,74800,183700
520005,202112,132,56,76,61600,83600,145200
520010,202112,291,128,163,140800,179300,320100
520013,202112,724,482,242,531300,268400,799700
520015,202112,48,34,14,37400,15400,52800
520017,202112,88,51,37,56100,40700,96800
520020,202112,18,10,8,11000,8800,19800
520025,202112,2628,1379,1249,1518000,1376100,2894100
520030,202112,805,434,371,477675,408100,885775
520050,202112,66,46,20,50600,22000,72600
520055,202112,59,39,20,42900,22000,64900
520060,202112,177,112,65,123200,71500,194700
520080,202112,571,414,157,455400,173800,629200
520082,202112,17,11,6,12100,6600,18700
520085,202112,89,67,22,73700,24200,97900
520090,202112,87,62,25,68200,27500,95700
520110,202112,9131,3898,5233,4296600,5766200.18,10062800.18
520120,202112,10,5,5,5500,5500,11000
520130,202112,813,568,245,624800,269500,894300
520140,202112,11943,6608,5335,7269900.4,5872900,13142800.4
520145,202112,54,32,22,35200,24200,59400
520150,202112,153,121,32,135300,35200,170500
520160,202112,47,33,14,36300,15400,51700
520170,202112,235,132,103,145200,113300,258500
520180,202112,177,80,97,88000,106700,194700
520215,202112,201,133,68,147400,74800,222200
520235,202112,80,63,17,70400,18700,89100
520250,202112,127,73,54,80300,59400,139700
520260,202112,115,71,44,78100,48400,126500
520280,202112,44,31,13,34100,14300,48400
520310,202112,44,26,18,28600,19800,48400
520320,202112,170,103,67,113300,73700,187000
520330,202112,812,437,375,482900,413600,896500
520340,202112,361,208,153,228800,168300,397100
520350,202112,500,240,260,264000,286000,550000
520355,202112,88,47,41,51700,45100,96800
520357,202112,25,20,5,22000,5500,27500
520360,202112,5,2,3,2200,3300,5500
520380,202112,140,77,63,84700,69300,154000
520390,202112,244,103,141,113300,155100,268400
520393,202112,16,13,3,14300,3300,17600
520396,202112,74,50,24,55000,26400,81400
520400,202112,198,120,78,132000,85800,217800
520410,202112,188,92,96,102300,105600,207900
520420,202112,20,12,8,13200,8800,22000
520425,202112,257,131,126,144100,138600,282700
520430,202112,512,244,268,269500,294800,564300
520440,202112,657,471,186,519200,204600,723800
520450,202112,2047,866,1181,952600,1300200,2252800
520455,202112,57,32,25,35200,27500,62700
520460,202112,36,21,15,23100,16500,39600
520465,202112,31,26,5,28600,5500,34100
520470,202112,436,277,159,305800,176000,481800
520480,202112,82,46,36,50600,39600,90200
520485,202112,101,37,64,40700,70400,111100
520490,202112,433,323,110,356400,121000,477400
520495,202112,157,91,66,100100,72600,172700
520500,202112,185,144,41,159500,45100,204600
520505,202112,192,112,80,126500,88000,214500
520510,202112,1871,882,989,971300,1089000,2060300
520520,202112,48,33,15,36300,16500,52800
520530,202112,213,168,45,184800,49500,234300
520540,202112,634,425,209,467500,229900,697400
520545,202112,136,75,61,82500,67100,149600
520547,202112,58,34,24,37400,26400,63800
520549,202112,1323,606,717,667700,789800,1457500
520551,202112,326,167,159,183700,174900,358600
520552,202112,34,24,10,26400,11000,37400
520570,202112,13,8,5,8800,5500,14300
520580,202112,271,168,103,184800,113300,298100
520590,202112,135,76,59,83600,64900,148500
520620,202112,1123,521,602,574200,663300,1237500
520630,202112,42,21,21,23100,23100,46200
520640,202112,368,216,152,238700,168300,407000
520650,202112,64,31,33,34100,36300,70400
520660,202112,42,22,20,24200,22000,46200
520670,202112,38,30,8,33000,8800,41800
520680,202112,43,26,17,28600,18700,47300
520690,202112,39,10,29,11000,31900,42900
520710,202112,36,31,5,34100,5500,39600
520725,202112,194,145,49,160600,53900,214500
520735,202112,55,35,20,38500,22000,60500
520740,202112,459,225,234,247500,257400,504900
520750,202112,34,25,9,27500,9900,37400
520753,202112,72,49,23,53900,25300,79200
520760,202112,102,67,35,73700,38500,112200
520780,202112,271,208,63,228800,70400,299200
520790,202112,158,92,66,101200,72600,173800
520800,202112,3393,1866,1527,2052600,1681900,3734500
520810,202112,148,114,34,125400,37400,162800
520815,202112,4,3,1,3300,1100,4400
520830,202112,146,100,46,110000,50600,160600
520840,202112,385,248,137,272800,150700,423500
520850,202112,99,56,43,62700,47300,110000
520860,202112,1751,1115,636,1227600,699600,1927200
520870,202112,31809,14644,17165,16123801.51,18900200,35024001.51
520880,202112,1173,630,543,694100,597300,1291400
520890,202112,785,480,305,529136.66,335500,864636.66
520910,202112,969,511,458,562100.4,503800,1065900.4
520915,202112,87,68,19,74800,20900,95700
520920,202112,447,210,237,231000,261800,492800
520929,202112,16,14,2,15400,2200,17600
520940,202112,65,46,19,50600,20900,71500
520945,202112,14,9,5,9900,5500,15400
520960,202112,38,24,14,26400,15400,41800
520970,202112,370,217,153,238700,168300,407000
520980,202112,93,66,27,72600,29700,102300
520990,202112,440,308,132,338800,145200,484000
520993,202112,127,64,63,70400,69300,139700
520995,202112,253,139,114,152900,125400,278300
521000,202112,1552,905,647,996600,711700,1708300
521010,202112,668,344,324,378400,356400,734800
521015,202112,14,9,5,9900,5500,15400
521020,202112,1377,953,424,1049400,466400,1515800
521030,202112,57,36,21,39600,23100,62700
521040,202112,933,613,320,675400,353100,1028500
521056,202112,50,33,17,36300,18700,55000
521060,202112,129,83,46,91300,50600,141900
521080,202112,356,274,82,302500,90200,392700
521090,202112,557,362,195,399300,214500,613800
521100,202112,258,192,66,211200,72600,283800
521120,202112,1061,741,320,815100,352000,1167100
521130,202112,342,248,94,272800,103400,376200
521140,202112,182,97,85,106700,93500,200200
521150,202112,2572,1090,1482,1199000,1631300,2830300
521160,202112,23,9,14,11000,15400,26400
521170,202112,221,129,92,141900,101200,243100
521180,202112,1175,754,421,830500,465300,1295800
521190,202112,2518,1059,1459,1164900,1604900,2769800
521200,202112,55,40,15,44000,16500,60500
521205,202112,10,7,3,7700,3300,11000
521210,202112,123,76,47,83600,51700,135300
521220,202112,727,510,217,561000,238700,799700
521225,202112,25,19,6,20900,6600,27500
521230,202112,110,66,44,72600,49500,122100
521250,202112,6235,3489,2746,3843400.9,3023900,6867300.9
521260,202112,33,15,18,16500,19800,36300
521270,202112,135,102,33,112200,36300,148500
521280,202112,415,254,161,279400,177100,456500
521290,202112,26,18,8,19800,8800,28600
521295,202112,99,66,33,72600,36300,108900
521300,202112,222,121,101,133100,111100,244200
521305,202112,39,31,8,34100,8800,42900
521308,202112,999,763,236,839300,261800,1101100
521310,202112,1331,748,583,822800,641300,1464100
521340,202112,20,16,4,17600,4400,22000
521350,202112,116,88,28,96800,30800,127600
521370,202112,161,111,50,122100,55000,177100
521375,202112,183,92,91,103400,100100,203500
521377,202112,49,39,10,42900,11000,53900
521380,202112,1047,636,411,700700,453200,1153900
521385,202112,11,7,4,7700,4400,12100
521390,202112,99,81,18,89100,19800,108900
521400,202112,347,238,109,261800,119900,381700
521405,202112,144,82,62,90200,69300,159500
521410,202112,73,52,21,57200,23100,80300
521440,202112,199,137,62,150700,68200,218900
521450,202112,757,416,341,457600,376200,833800
521460,202112,1097,723,374,795300,413600,1208900
521470,202112,11,8,3,8800,3300,12100
521480,202112,39,28,11,30800,12100,42900
521483,202112,313,193,120,212300,133100,345400
521486,202112,290,186,104,205700,114400,320100
521487,202112,25,11,14,13200,15400,28600
521490,202112,24,12,12,13200,13200,26400
521500,202112,140,66,74,73700,81400,155100
521520,202112,44,34,10,37400,11000,48400
521523,202112,844,497,347,547800,381700,929500
521525,202112,43,27,16,29700,17600,47300
521530,202112,241,132,109,145200,119900,265100
521540,202112,40,20,20,22000,22000,44000
521550,202112,100,43,57,47300,62700,110000
521560,202112,831,559,272,614900,299200,914100
521565,202112,65,47,18,51700,19800,71500
521570,202112,540,342,198,377300,217800,595100
521580,202112,50,31,19,34100,20900,55000
521590,202112,35,15,20,16500,22000,38500
521600,202112,23,12,11,13200,12100,25300
521630,202112,239,126,113,138600,124300,262900
521640,202112,299,162,137,179300,151800,331100
521645,202112,38,20,18,22000,19800,41800
521680,202112,240,147,93,161700,102300,264000
521690,202112,9,8,1,8800,1100,9900
521710,202112,1130,537,593,590700,653400,1244100
521720,202112,531,368,163,404800,179300,584100
521730,202112,654,310,344,341000,380600,721600
521740,202112,883,387,496,425700,545600,971300
521760,202112,2200,1147,1053,1262872.45,1159400,2422272.45
521770,202112,807,504,303,555500,333300,888800
521800,202112,1919,1251,668,1376100,735900,2112000
521805,202112,31,17,14,18700,15400,34100
521810,202112,91,53,38,58300,41800,100100
521830,202112,972,689,283,759000.73,311300,1070300.73
521839,202112,81,47,34,51700,37400,89100
521850,202112,1117,559,558,614900.17,613800,1228700.17
521860,202112,322,204,118,224400,129800,354200
521870,202112,77,48,29,52800,31900,84700
521878,202112,38,14,24,15400,26400,41800
521880,202112,4807,2114,2693,2327600,2966700,5294300
521890,202112,593,405,188,446600,206800,653400
521900,202112,278,221,57,243100,62700,305800
521910,202112,167,114,53,125400,58300,183700
521920,202112,43,22,21,24200,23100,47300
521925,202112,51,30,21,33000,23100,56100
521930,202112,1174,655,519,720500,570900,1291400
521935,202112,30,20,10,22000,11000,33000
521940,202112,213,96,117,105600,129800,235400
521945,202112,16,13,3,14300,3300,17600
521950,202112,14,9,5,9900,5500,15400
521960,202112,69,52,17,57200,18700,75900
521970,202112,406,260,146,286000,160600,446600
521971,202112,108,56,52,61600,57200,118800
521973,202112,38,19,19,20900,20900,41800
521975,202112,1575,797,778,877800.75,855800.18,1733600.93
521980,202112,243,162,81,178200,89100,267300
521990,202112,74,55,19,60500,22000,82500
522000,202112,288,186,102,204216.1,112200,316416.1
522005,202112,19,12,7,13200,7700,20900
522010,202112,1121,634,487,698500,535700,1234200
522015,202112,60,36,24,39600,26400,66000
522020,202112,882,515,367,566500,403700,970200
522026,202112,26,17,9,18700,9900,28600
522028,202112,16,12,4,13200,4400,17600
522040,202112,778,325,453,357500,499400,856900
522045,202112,2500,1497,1003,1650000,1104400,2754400
522050,202112,154,74,80,81400,88000,169400
522060,202112,541,341,200,375100,220000,595100
522068,202112,107,73,34,80300,37400,117700
522070,202112,12,11,1,12100,1100,13200
522100,202112,33,21,12,23100,13200,36300
522108,202112,45,34,11,37400,12100,49500
522119,202112,60,34,26,38500,28600,67100
522130,202112,75,27,48,29700,52800,82500
522140,202112,4044,2088,1956,2299000,2153800,4452800
522145,202112,46,35,11,38500,12100,50600
522150,202112,103,70,33,77000,36300,113300
522155,202112,52,40,12,44000,13200,57200
522157,202112,7,5,2,5500,2200,7700
522160,202112,1661,991,670,1092300,737000,1829300
522170,202112,396,267,129,293700,141900,435600
522180,202112,35,13,22,14300,24200,38500
522185,202112,2225,921,1304,1015740,1437700,2453440
522190,202112,61,34,27,37400,29700,67100
522200,202112,298,175,123,192500,135300,327800
522205,202112,145,100,45,110000,49500,159500
522220,202112,136,100,36,110000,39600,149600
522230,202112,31,27,4,29700,4400,34100
530010,202112,54460,27503,26957,30289883.28,29671577.49,59961460.77
