ibge,anomes,bpc_ben,bpc_pcd_ben,bpc_idoso_ben,bpc_pcd_val,bpc_idoso_val,bpc_val
110001,201801,512,406,106,386340.35,100478.96,486819.31
110002,201801,2774,1659,1115,1580806.19,1062803.49,2643609.68
110003,201801,94,74,20,70596,19080,89676
110004,201801,1989,1265,724,1203909.02,690400.26,1894309.28
110005,201801,434,349,85,332660,81080.46,413740.46
110006,201801,446,342,104,325981.8,99196.92,425178.72
110007,201801,82,65,17,62010,16218,78228
110008,201801,240,137,103,129462.9,98262,227724.9
110009,201801,785,532,253,505335.2,241163,746498.2
110010,201801,1776,1098,678,1046259,646670.52,1692929.52
110011,201801,1886,1449,437,1380815.2,416868.35,1797683.55
110012,201801,4118,2391,1727,2273557.36,1646286.46,3919843.82
110013,201801,747,563,184,537092.46,175536,712628.46
110014,201801,364,309,55,294765.89,52465.23,347231.12
110015,201801,1422,1144,278,1088948.91,264620.52,1353569.43
110018,201801,1113,661,452,630280,431195.23,1061475.23
110020,201801,15311,8995,6316,8536983.58,6015128.39,14552111.97
110025,201801,646,473,173,449244.11,165033,614277.11
110026,201801,43,29,14,27666,13356,41022
110028,201801,1638,1187,451,1127549.59,426661.44,1554211.03
110029,201801,139,122,17,116388,16218,132606
110030,201801,2473,1661,812,1581879.24,773747.46,2355626.70
110032,201801,396,304,92,289707,87764,377471
110033,201801,661,499,162,473043,154544,627587
110034,201801,360,269,91,254314,86147,340461
110037,201801,103,84,19,80136,18126,98262
110040,201801,329,221,108,210834,103032,313866
110045,201801,931,614,317,584210,300714.39,884924.39
110050,201801,95,77,18,73458,17172,90630
110060,201801,86,45,41,42930,39114,82044
110070,201801,128,76,52,72504,49322,121826
110080,201801,395,235,160,221967.18,152591.27,374558.45
110090,201801,32,27,5,25758,4770,30528
110092,201801,110,62,48,59148,45722,104870
110094,201801,196,137,59,130698,56286,186984
110100,201801,27,22,5,20988,4770,25758
110110,201801,72,45,27,42930,25758,68688
110120,201801,73,60,13,57240,12402,69642
110130,201801,302,243,59,230327.12,56286,286613.12
110140,201801,246,159,87,151400.59,82988.46,234389.05
110143,201801,46,39,7,37206,6678,43884
110145,201801,29,20,9,19080,8586,27666
110146,201801,22,11,11,10494,10494,20988
110147,201801,39,30,9,28620,8586,37206
110148,201801,39,27,12,25706.57,11448,37154.57
110149,201801,296,213,83,202915.8,79182,282097.8
110150,201801,84,57,27,54378,25491.89,79869.89
110155,201801,8,7,1,6678,954,7632
110160,201801,71,59,12,56286,11448,67734
110170,201801,210,170,40,162180,38160,200340
110175,201801,33,25,8,23850,7632,31482
110180,201801,93,81,12,77274,11448,88722
120001,201801,132,89,43,84864,40992.12,125856.12
120005,201801,191,120,71,114437.12,67734,182171.12
120010,201801,1006,648,358,611828.36,339299.16,951127.52
120013,201801,138,95,43,89943.94,40656.16,130600.10
120017,201801,92,59,33,56177.48,31439.12,87616.60
120020,201801,3512,2793,719,2634945.68,682319.67,3317265.35
120025,201801,601,337,264,319463.22,250815.03,570278.25
120030,201801,1021,853,168,805625.7,159514.12,965139.82
120032,201801,48,40,8,38138.12,7632,45770.12
120033,201801,213,187,26,178050.75,24804,202854.75
120034,201801,157,114,43,106826.12,40978.24,147804.36
120035,201801,31,21,10,20034,9540,29574
120038,201801,388,244,144,231951.88,137332.24,369284.12
120039,201801,23,21,2,20034,1908,21942
120040,201801,14001,9693,4308,9110828.68,4070573.76,13181402.44
120042,201801,43,37,6,35298,5724,41022
120043,201801,13,3,10,2862,9540,12402
120045,201801,536,344,192,326095.38,182902.6,508997.98
120050,201801,1253,957,296,906186.98,282007.27,1188194.25
120060,201801,1405,1137,268,1068341.93,251578.72,1319920.65
120070,201801,503,361,142,337902.44,134126.54,472028.98
120080,201801,159,103,56,97054.3,52879.18,149933.48
130002,201801,149,104,45,99216,42930,142146
130006,201801,75,43,32,41022,30528,71550
130008,201801,144,77,67,72737.72,63195.96,135933.68
130010,201801,140,74,66,70596,62964,133560
130014,201801,240,175,65,166950,62010,228960
130020,201801,89,49,40,46746,38160,84906
130030,201801,886,541,345,516114,329120.46,845234.46
130040,201801,329,165,164,157410,155502.28,312912.28
130050,201801,553,307,246,292591.8,234684,527275.8
130060,201801,885,605,280,572021.2,264299.24,836320.44
130063,201801,550,287,263,273798,250880.12,524678.12
130068,201801,187,121,66,115434,62677.8,178111.8
130070,201801,1329,923,406,867044.65,382340.12,1249384.77
130080,201801,659,430,229,409838.4,218457,628295.4
130083,201801,70,38,32,36252,30528,66780
130090,201801,375,195,180,184350.96,171720,356070.96
130100,201801,1106,515,591,491310,563527.8,1054837.8
130110,201801,702,315,387,300360,369198,669558
130115,201801,173,69,104,65826,99216,165042
130120,201801,1619,1009,610,962586,581940,1544526
130130,201801,610,416,194,396864,185076,581940
130140,201801,1533,1153,380,1099299.02,361566.2,1460865.22
130150,201801,427,361,66,344394,62964,407358
130160,201801,468,261,207,248994,197478,446472
130165,201801,24,17,7,16218,6678,22896
130170,201801,943,667,276,636247.4,263304,899551.4
130180,201801,151,91,60,86337,57240,143577
130185,201801,2230,1159,1071,1103757.89,1021142.92,2124900.81
130190,201801,3609,2261,1348,2152766.68,1284403.99,3437170.67
130195,201801,291,233,58,222282,55332,277614
130200,201801,178,81,97,77264.46,92538,169802.46
130210,201801,77,37,40,35298,38160,73458
130220,201801,187,128,59,122112,56286,178398
130230,201801,335,211,124,201294,118296,319590
130240,201801,1463,918,545,874432.4,519352.83,1393785.23
130250,201801,4694,3027,1667,2882220.98,1590165.49,4472386.47
130255,201801,425,209,216,199386,205777.8,405163.8
130260,201801,53013,25317,27696,24118445.61,26414923.72,50533369.33
130270,201801,1490,956,534,911547,509436,1420983
130280,201801,114,69,45,65826,42930,108756
130290,201801,2084,1509,575,1439586,548263.8,1987849.8
130300,201801,428,306,122,291637.8,116388,408025.8
130310,201801,892,474,418,452196,398772,850968
130320,201801,443,236,207,224190,197478,421668
130330,201801,704,428,276,408312,263017.8,671329.8
130340,201801,3233,1957,1276,1862399.2,1215873.2,3078272.4
130350,201801,477,301,176,287132.12,167904,455036.12
130353,201801,776,320,456,304994,435024,740018
130356,201801,755,344,411,328176,391807.8,719983.8
130360,201801,69,40,29,38160,27666,65826
130370,201801,680,499,181,476046,172674,648720
130380,201801,631,433,198,413082,188892,601974
130390,201801,485,390,95,372060,90630,462690
130395,201801,182,41,141,39114,134514,173628
130400,201801,68,46,22,43884,20988,64872
130406,201801,2085,1315,770,1250896.3,733655.76,1984552.06
130410,201801,502,215,287,205110,273778.92,478888.92
130420,201801,3184,2555,629,2433683.32,600066,3033749.32
130423,201801,163,76,87,72504,82998,155502
130426,201801,141,83,58,79182,55332,134514
130430,201801,407,268,139,255672,132606,388278
130440,201801,198,71,127,67734,121158,188892
140002,201801,36,14,22,13356,20988,34344
140005,201801,203,123,80,117103.5,76320,193423.5
140010,201801,10241,6920,3321,6568984.09,3165413.63,9734397.72
140015,201801,154,69,85,65826,81090,146916
140017,201801,110,76,34,72504,32436,104940
140020,201801,476,323,153,307188,145962,453150
140023,201801,25,16,9,15045,8586,23631
140028,201801,17,12,5,11448,4770,16218
140030,201801,359,255,104,243270,98614.98,341884.98
140040,201801,55,38,17,36252,16122.6,52374.6
140045,201801,246,115,131,109042.2,124974,234016.2
140047,201801,556,370,186,350968.39,176681,527649.39
140050,201801,151,99,52,93633,49608,143241
140060,201801,34,23,11,21207.42,10494,31701.42
140070,201801,32,29,3,27666,2862,30528
150010,201801,4709,2914,1795,2777237.5,1710311.09,4487548.59
150013,201801,146,99,47,94446,44838,139284
150020,201801,1077,571,506,544734,482724,1027458
150030,201801,739,301,438,287154,417852,705006
150034,201801,191,119,72,113526,68688,182214
150040,201801,1389,822,567,784188,540918,1325106
150050,201801,702,414,288,393954.8,274552,668506.8
150060,201801,4725,3064,1661,2919488.77,1584165.15,4503653.92
150070,201801,315,146,169,139284,161226,300510
150080,201801,14562,7323,7239,6975922.43,6897791.74,13873714.17
150085,201801,371,233,138,222272.46,131652,353924.46
150090,201801,760,647,113,617238,107802,725040
150095,201801,345,209,136,198616.12,128923.56,327539.68
150100,201801,55,39,16,37206,15264,52470
150110,201801,169,82,87,78228,82998,161226
150120,201801,436,324,112,309096,106848,415944
150125,201801,54,23,31,21942,29574,51516
150130,201801,1901,1011,890,964494,849055.23,1813549.23
150140,201801,54649,25438,29211,24236282.15,27853230.22,52089512.37
150145,201801,176,102,74,97308,70596,167904
150150,201801,2822,1257,1565,1198960.49,1489065.61,2688026.10
150157,201801,436,302,134,288108,127831.23,415939.23
150160,201801,123,99,24,94446,22896,117342
150170,201801,3672,2718,954,2589633,909829.8,3499462.8
150172,201801,317,217,100,207018,95400,302418
150175,201801,90,56,34,53424,32436,85860
150178,201801,750,498,252,475092,240408,715500
150180,201801,3034,1453,1581,1385351.6,1507963.95,2893315.55
150190,201801,336,215,121,205110,115434,320544
150195,201801,119,58,61,55332,58194,113526
150200,201801,208,98,110,93492,104940,198432
150210,201801,3163,2561,602,2442135.86,574065.5,3016201.36
150215,201801,501,331,170,315774,162180,477954
150220,201801,3929,2654,1275,2530356.8,1214232.32,3744589.12
150230,201801,1139,914,225,871376.04,214650,1086026.04
150240,201801,5767,3367,2400,3208676.73,2289591,5498267.73
150250,201801,33,16,17,15264,16218,31482
150260,201801,72,43,29,41022,27666,68688
150270,201801,2338,1531,807,1459282.32,769019.8,2228302.12
150275,201801,578,352,226,335808,215604,551412
150276,201801,103,45,58,42930,55332,98262
150277,201801,752,327,425,311939.46,405450,717389.46
150280,201801,342,211,131,201294,124974,326268
150285,201801,74,37,37,35298,35298,70596
150290,201801,961,589,372,561610.26,354602,916212.26
150293,201801,681,314,367,299228.92,350118,649346.92
150295,201801,460,204,256,194616,244071.44,438687.44
150300,201801,80,41,39,39114,37206,76320
150304,201801,139,91,48,86814,45792,132606
150307,201801,398,329,69,313866,65826,379692
150309,201801,550,396,154,377784,146916,524700
150310,201801,253,171,82,163134,78228,241362
150320,201801,1802,1242,560,1184586.57,534240,1718826.57
150330,201801,2070,1191,879,1135546.2,838566,1974112.2
150340,201801,198,132,66,125689.5,62964,188653.5
150345,201801,602,326,276,310822.74,263304,574126.74
150350,201801,417,323,94,305747.46,89676,395423.46
150360,201801,4466,2854,1612,2719048.19,1537828.92,4256877.11
150370,201801,755,540,215,514364,204814.8,719178.8
150375,201801,192,101,91,96354,86814,183168
150380,201801,1280,849,431,809946,410888,1220834
150390,201801,742,421,321,401634,306225,707859
150400,201801,99,82,17,78228,16218,94446
150405,201801,1257,831,426,792017.48,405831.6,1197849.08
150410,201801,140,90,50,85840.92,47700,133540.92
150420,201801,7393,4040,3353,3852501.48,3196812.46,7049313.94
150430,201801,487,328,159,312912,151686,464598
150440,201801,594,349,245,332183,233730,565913
150442,201801,2120,1124,996,1070636.04,949893.03,2020529.07
150445,201801,522,326,196,311004,186030,497034
150450,201801,272,127,145,121158,138330,259488
150460,201801,767,581,186,552447.09,177424.92,729872.01
150470,201801,1343,806,537,768638,512298,1280936
150475,201801,37,26,11,24804,10494,35298
150480,201801,1244,866,378,826164,360325.8,1186489.8
150490,201801,617,335,282,319590,269028,588618
150495,201801,328,228,100,217512,95400,312912
150497,201801,297,202,95,192708,90620.46,283328.46
150500,201801,428,288,140,274752,133560,408312
150503,201801,853,405,448,386084,427374,813458
150506,201801,1030,668,362,637272,345338.46,982610.46
150510,201801,1236,695,541,662744,516114,1178858
150520,201801,271,181,90,172674,85860,258534
150530,201801,1574,849,725,806798.3,690409.8,1497208.1
150540,201801,240,167,73,159318,69642,228960
150543,201801,693,390,303,371468.52,288775.8,660244.32
150548,201801,500,346,154,330084,146916,477000
150549,201801,60,40,20,38160,19080,57240
150550,201801,2897,1513,1384,1442449,1319818,2762267
150553,201801,3047,1810,1237,1725214.6,1180088.46,2905303.06
150555,201801,142,74,68,70596,64872,135468
150560,201801,54,41,13,39114,12402,51516
150563,201801,72,39,33,37206,31482,68688
150565,201801,169,101,68,96354,64872,161226
150570,201801,402,268,134,255652.92,127836,383488.92
150580,201801,1510,637,873,607030.2,832842,1439872.2
150590,201801,778,475,303,453150,289062,742212
150600,201801,460,274,186,261396,177444,438840
150610,201801,145,125,20,118401,19080,137481
150611,201801,129,90,39,85860,37206,123066
150613,201801,3151,1927,1224,1838358,1167687,3006045
150616,201801,485,300,185,285962,176490,462452
150618,201801,1136,627,509,597929.58,485586,1083515.58
150619,201801,393,300,93,286200,88722,374922
150620,201801,1277,740,537,705960,512011.8,1217971.8
150630,201801,315,212,103,202248,98262,300510
150635,201801,495,207,288,197478,274752,472230
150640,201801,62,30,32,28620,30528,59148
150650,201801,2321,1347,974,1285000.34,928905.03,2213905.37
150655,201801,248,185,63,176490,60102,236592
150658,201801,104,59,45,56286,42930,99216
150660,201801,482,336,146,320544,139284,459828
150670,201801,993,359,634,342190.8,604817.46,947008.26
150680,201801,9868,5375,4493,5120478.67,4283986.38,9404465.05
150690,201801,53,34,19,32436,18126,50562
150700,201801,543,349,194,332755.2,185076,517831.2
150710,201801,272,163,109,155502,103986,259488
150715,201801,872,530,342,504637.92,326239.38,830877.30
150720,201801,443,338,105,322452,99883.8,422335.8
150730,201801,907,482,425,459819,405163.8,864982.8
150740,201801,233,163,70,155502,66780,222282
150745,201801,768,411,357,392094,340578,732672
150746,201801,53,32,21,30528,20034,50562
150747,201801,269,208,61,198432,58194,256626
150750,201801,130,75,55,71550,52470,124020
150760,201801,1707,1105,602,1054170,574308,1628478
150770,201801,367,190,177,181260,168682.95,349942.95
150775,201801,90,40,50,38160,47700,85860
150780,201801,187,100,87,95400,82998,178398
150790,201801,896,488,408,465552,389232,854784
150795,201801,1435,835,600,796590,572400,1368990
150796,201801,403,231,172,220374,164088,384462
150797,201801,282,156,126,148824,120204,269028
150800,201801,1419,854,565,813757.23,539010,1352767.23
150803,201801,599,494,105,471276,100170,571446
150805,201801,188,119,69,113526,65812.46,179338.46
150808,201801,980,534,446,509436,425484,934920
150810,201801,3361,2315,1046,2205067,997312,3202379
150812,201801,428,223,205,212742,195570,408312
150815,201801,968,637,331,606319.47,315774,922093.47
150820,201801,1571,962,609,916793.5,580966.92,1497760.42
150830,201801,833,585,248,557136,236592,793728
150835,201801,189,111,78,105894,74412,180306
150840,201801,1306,829,477,790866,455058,1245924
160005,201801,53,31,22,29574,20988,50562
160010,201801,194,119,75,113526,71546,185072
160015,201801,119,68,51,64872,48654,113526
160020,201801,128,73,55,69642,52470,122112
160021,201801,41,21,20,20034,19080,39114
160023,201801,110,63,47,60102,44838,104940
160025,201801,33,14,19,13356,18126,31482
160027,201801,1441,822,619,780658.7,589772,1370430.7
160030,201801,15530,7963,7567,7587244.94,7214175.29,14801420.23
160040,201801,316,180,136,171720,129744,301464
160050,201801,653,339,314,323406,299269.8,622675.8
160053,201801,322,184,138,175250,131652,306902
160055,201801,23,18,5,17172,4770,21942
160060,201801,6329,3299,3030,3136870,2889662.2,6026532.2
160070,201801,165,101,64,96354,61056,157410
160080,201801,80,40,40,38160,38160,76320
170025,201801,23,15,8,14310,7632,21942
170030,201801,225,180,45,171523,42930,214453
170035,201801,227,111,116,104940,110664,215604
170040,201801,191,147,44,139951.8,41976,181927.8
170070,201801,325,192,133,183168,126882,310050
170100,201801,375,268,107,255672,102078,357750
170105,201801,61,50,11,47700,10494,58194
170110,201801,103,63,40,60102,38160,98262
170130,201801,73,34,39,32436,36920,69356
170190,201801,105,66,39,62964,37206,100170
170200,201801,391,261,130,248317.2,123915.76,372232.96
170210,201801,6005,3105,2900,2954742.54,2763338.86,5718081.40
170215,201801,88,44,44,41976,41976,83952
170220,201801,1426,1046,380,995689.8,362234,1357923.8
170230,201801,154,99,55,94446,52470,146916
170240,201801,553,366,187,349164,178398,527562
170255,201801,1111,888,223,846942.12,212455.8,1059397.92
170270,201801,38,29,9,27666,8395.2,36061.2
170290,201801,75,56,19,53424,18126,71550
170300,201801,80,53,27,49798.8,25758,75556.8
170305,201801,41,33,8,31482,7632,39114
170307,201801,63,46,17,43884,16218,60102
170310,201801,102,56,46,53424,43884,97308
170320,201801,17,13,4,12402,3816,16218
170330,201801,19,16,3,15264,2862,18126
170360,201801,25,15,10,14310,9540,23850
170370,201801,122,65,57,62010,54378,116388
170380,201801,80,57,23,54378,21942,76320
170382,201801,47,42,5,40068,4770,44838
170384,201801,127,92,35,87768,33390,121158
170386,201801,62,28,34,26712,32436,59148
170388,201801,47,16,31,15264,29574,44838
170389,201801,24,18,6,17172,5724,22896
170390,201801,51,30,21,28620,20034,48654
170410,201801,33,22,11,20988,10494,31482
170460,201801,17,12,5,11448,4770,16218
170510,201801,27,20,7,19080,6678,25758
170550,201801,1478,837,641,798498,610751,1409249
170555,201801,109,75,34,71550,32436,103986
170560,201801,97,70,27,66780,25758,92538
170600,201801,39,19,20,18126,19080,37206
170610,201801,191,100,91,95242.59,86796,182038.59
170625,201801,38,19,19,18126,18126,36252
170650,201801,85,63,22,60102,20988,81090
170700,201801,556,418,138,397246.3,131652,528898.3
170710,201801,154,94,60,89676,57231,146907
170720,201801,84,68,16,64872,15264,80136
170730,201801,59,35,24,33390,22896,56286
170740,201801,76,57,19,54378,18126,72504
170755,201801,71,37,34,34678,32436,67114
170765,201801,143,69,74,65206,70596,135802
170770,201801,228,129,99,121968.9,94446,216414.9
170820,201801,594,389,205,371106,195141,566247
170825,201801,30,19,11,18126,10494,28620
170830,201801,75,54,21,51325.2,20034,71359.2
170900,201801,201,152,49,145008,46746,191754
170930,201801,806,416,390,396540,371488,768028
170950,201801,3031,1322,1709,1258832.96,1626838.51,2885671.47
170980,201801,17,9,8,8586,7632,16218
171050,201801,131,100,31,95400,29574,124974
171070,201801,35,28,7,26712,6678,33390
171090,201801,37,27,10,25758,9540,35298
171110,201801,21,14,7,13356,6678,20034
171150,201801,39,18,21,17172,20034,37206
171180,201801,22,10,12,9540,11448,20988
171190,201801,134,79,55,75366,52470,127836
171195,201801,63,49,14,46746,13356,60102
171200,201801,46,19,27,18126,25758,43884
171215,201801,2,2,0,1908,0,1908
171240,201801,54,44,10,41976,9540,51516
171245,201801,47,43,4,41022,3816,44838
171250,201801,71,37,34,35298,32426.46,67724.46
171270,201801,17,13,4,12402,3816,16218
171280,201801,38,35,3,33247,2862,36109
171320,201801,994,563,431,537102,410220,947322
171330,201801,427,203,224,193662,213696,407358
171360,201801,85,63,22,60102,20988,81090
171370,201801,24,13,11,12402,10494,22896
171380,201801,133,108,25,103032,23620.09,126652.09
171395,201801,55,33,22,31482,20988,52470
171420,201801,307,202,105,192708,99883.8,292591.8
171430,201801,63,50,13,47700,12402,60102
171488,201801,208,110,98,104940,93492,198432
171500,201801,59,32,27,30528,25758,56286
171510,201801,68,45,23,42930,21942,64872
171515,201801,43,37,6,35298,5724,41022
171525,201801,31,26,5,24804,4770,29574
171550,201801,13,7,6,6678,5724,12402
171570,201801,60,30,30,28620,28620,57240
171575,201801,341,209,132,199243,125918.46,325161.46
171610,201801,1692,845,847,804231.53,806461.58,1610693.11
171620,201801,132,90,42,85306.68,40068,125374.68
171630,201801,52,27,25,25758,23850,49608
171650,201801,275,179,96,170766,91584,262350
171660,201801,260,138,122,131652,116384,248036
171665,201801,46,30,16,28620,15264,43884
171670,201801,432,252,180,238345.96,171147.6,409493.56
171700,201801,64,56,8,53424,7632,61056
171720,201801,24,7,17,6678,16218,22896
171750,201801,102,55,47,52470,44838,97308
171780,201801,70,57,13,54378,12402,66780
171790,201801,80,66,14,62964,13356,76320
171800,201801,36,28,8,26712,7632,34344
171820,201801,2058,1163,895,1108793.74,849222.82,1958016.56
171830,201801,34,28,6,26712,5724,32436
171840,201801,61,34,27,32436,25758,58194
171845,201801,32,20,12,19080,11448,30528
171850,201801,38,26,12,24804,11448,36252
171855,201801,76,59,17,56286,16218,72504
171865,201801,8,7,1,6678,954,7632
171870,201801,30,22,8,20988,7632,28620
171875,201801,77,52,25,49608,23850,73458
171880,201801,26,19,7,18126,6678,24804
171884,201801,46,23,23,21942,21942,43884
171886,201801,115,40,75,38160,71263.8,109423.8
171888,201801,24,18,6,17172,5724,22896
171889,201801,19,15,4,14310,3816,18126
171890,201801,56,46,10,43884,9540,53424
171900,201801,43,30,13,28620,12402,41022
172000,201801,41,35,6,33390,5724,39114
172010,201801,39,32,7,29717.1,6678,36395.1
172015,201801,26,16,10,15264,9253.8,24517.8
172020,201801,127,79,48,75366,45792,121158
172025,201801,32,21,11,20034,10494,30528
172030,201801,36,20,16,19080,15264,34344
172049,201801,74,44,30,41976,28620,70596
172065,201801,149,97,52,92538,49608,142146
172080,201801,90,64,26,59873.84,24804,84677.84
172085,201801,26,13,13,12402,12402,24804
172090,201801,402,304,98,290016,92729,382745
172093,201801,25,18,7,17172,6678,23850
172097,201801,16,8,8,7632,7346,14978
172100,201801,4661,2615,2046,2489717.8,1949415,4439132.8
172110,201801,82,54,28,51516,26712,78228
172120,201801,1725,1476,249,1401987.65,236438.41,1638426.06
172125,201801,2,2,0,1908,0,1908
172130,201801,16,13,3,12402,2862,15264
172208,201801,195,123,72,117342,68688,186030
172210,201801,444,211,233,201294,221996,423290
210005,201801,2930,1830,1100,1742767.22,1046540,2789307.22
210010,201801,195,98,97,93492,92538,186030
210015,201801,28,19,9,18126,8586,26712
210020,201801,347,177,170,168858,162180,331038
210030,201801,340,212,128,202248,122103,324351
210040,201801,156,120,36,114480,34344,148824
210043,201801,251,167,84,159318,80136,239454
210047,201801,619,312,307,297266.4,292868.46,590134.86
210050,201801,296,215,81,205110,77274,282384
210055,201801,41,31,10,29574,9540,39114
210060,201801,573,445,128,424530,122112,546642
210070,201801,415,304,111,290016,105894,395910
210080,201801,105,97,8,92538,7632,100170
210083,201801,310,130,180,124020,171720,295740
210087,201801,45,33,12,31482,11448,42930
210090,201801,492,338,154,322452,146916,469368
210095,201801,494,352,142,335798.46,135468,471266.46
210100,201801,685,516,169,491930.1,160272.02,652202.12
210110,201801,148,79,69,75366,65826,141192
210120,201801,5494,4106,1388,3909635.2,1322898.68,5232533.88
210125,201801,215,119,96,113526,91584,205110
210130,201801,556,285,271,270936,258514.92,529450.92
210135,201801,34,20,14,19080,13356,32436
210140,201801,4232,3314,918,3158362.71,875534,4033896.71
210150,201801,354,222,132,211788,125928,337716
210160,201801,3356,2811,545,2678834.78,519644,3198478.78
210170,201801,1132,877,255,836658,243270,1079928
210173,201801,119,98,21,93492,20034,113526
210177,201801,467,226,241,215604,229914,445518
210180,201801,32,18,14,17172,13356,30528
210190,201801,410,261,149,248994,142146,391140
210193,201801,1,1,0,954,0,954
210197,201801,81,54,27,51516,25758,77274
210200,201801,642,506,136,482724,129744,612468
210203,201801,264,176,88,167904,83952,251856
210207,201801,379,291,88,277614,83952,361566
210210,201801,771,699,72,666846,68688,735534
210215,201801,76,63,13,60102,12402,72504
210220,201801,397,324,73,309096,69355.8,378451.8
210230,201801,302,223,79,212742,75366,288108
210232,201801,1481,933,548,889796,522792,1412588
210235,201801,153,118,35,112382,33390,145772
210237,201801,46,25,21,23850,20034,43884
210240,201801,95,77,18,73458,17172,90630
210250,201801,181,143,38,136422,36252,172674
210255,201801,329,239,90,228006,85860,313866
210260,201801,428,261,167,248994,159318,408312
210270,201801,699,442,257,421668,245178,666846
210275,201801,42,33,9,31482,8586,40068
210280,201801,1022,650,372,617285.33,353552.5,970837.83
210290,201801,498,319,179,304326,170766,475092
210300,201801,6134,3566,2568,3397327.27,2448661.23,5845988.50
210310,201801,102,69,33,65826,31482,97308
210312,201801,128,79,49,75366,46746,122112
210315,201801,118,85,33,81090,31482,112572
210317,201801,123,88,35,83952,33390,117342
210320,201801,2389,1961,428,1869083.84,408312,2277395.84
210325,201801,131,88,43,82998,40736,123734
210330,201801,5615,2832,2783,2696896.09,2654972.46,5351868.55
210340,201801,1415,1007,408,959878,389161.07,1349039.07
210350,201801,606,493,113,470083.5,107802,577885.5
210355,201801,132,106,26,101124,24804,125928
210360,201801,2666,1660,1006,1580493.6,959438,2539931.6
210370,201801,1263,533,730,508482,695752.2,1204234.2
210375,201801,188,98,90,92949,85860,178809
210380,201801,728,542,186,517068,177444,694512
210390,201801,202,165,37,157410,35298,192708
210400,201801,405,338,67,322452,63918,386370
210405,201801,1000,658,342,627128.11,326268,953396.11
210407,201801,56,44,12,41976,11448,53424
210408,201801,63,56,7,53424,6678,60102
210409,201801,312,260,52,248040,49608,297648
210410,201801,436,338,98,322452,93483,415935
210420,201801,194,157,37,149778,35298,185076
210430,201801,34,26,8,24804,7632,32436
210440,201801,379,225,154,214650,146916,361566
210450,201801,145,107,38,102078,36252,138330
210455,201801,209,113,96,107802,91584,199386
210460,201801,346,216,130,206064,124020,330084
210462,201801,60,50,10,47700,9540,57240
210465,201801,176,125,51,119250,48654,167904
210467,201801,523,371,152,353934,145008,498942
210470,201801,46,34,12,32436,11448,43884
210480,201801,1303,914,389,871956,371106,1243062
210490,201801,226,135,91,128790,86814,215604
210500,201801,563,291,272,277614,259488,537102
210510,201801,554,428,126,408312,120204,528516
210515,201801,449,242,207,230868,197478,428346
210520,201801,400,347,53,330751.8,50562,381313.8
210530,201801,9338,5007,4331,4765383.66,4126609.83,8891993.49
210535,201801,132,94,38,89676,36252,125928
210540,201801,1537,918,619,874627.8,589095,1463722.8
210542,201801,1154,583,571,555800.4,544734,1100534.4
210545,201801,13,12,1,11448,954,12402
210547,201801,137,118,19,112572,18126,130698
210550,201801,746,519,227,493578,216558,710136
210560,201801,176,145,31,138330,29574,167904
210565,201801,30,21,9,20034,8586,28620
210570,201801,1367,1067,300,1017918,286200,1304118
210580,201801,104,90,14,85860,13356,99216
210590,201801,772,602,170,573544.8,162180,735724.8
210592,201801,31,27,4,25758,3816,29574
210594,201801,102,84,18,80136,17172,97308
210596,201801,83,70,13,66780,12402,79182
210598,201801,124,92,32,87768,30528,118296
210600,201801,339,285,54,271890,51516,323406
210610,201801,246,228,18,216558,17172,233730
210620,201801,47,28,19,26712,18126,44838
210630,201801,62,58,4,55332,3816,59148
210632,201801,1126,741,385,706914,366561.44,1073475.44
210635,201801,16,13,3,12402,2862,15264
210637,201801,106,74,32,70596,30528,101124
210640,201801,586,508,78,484632,74412,559044
210650,201801,406,325,81,309124.62,76320,385444.62
210660,201801,402,284,118,270269,112448,382717
210663,201801,17,10,7,9540,6678,16218
210667,201801,118,37,81,35298,77274,112572
210670,201801,270,238,32,226337,30528,256865
210675,201801,569,291,278,277614,265212,542826
210680,201801,215,135,80,128790,76320,205110
210690,201801,643,505,138,481770,131652,613422
210700,201801,193,140,53,133560,50562,184122
210710,201801,304,168,136,160028.77,129744,289772.77
210720,201801,123,102,21,97308,20034,117342
210725,201801,65,57,8,54378,7632,62010
210730,201801,23,18,5,17172,4770,21942
210735,201801,415,275,140,262350,133274,395624
210740,201801,542,458,84,436932,80136,517068
210745,201801,153,108,45,103032,42930,145962
210750,201801,2416,1080,1336,1028365,1274524.92,2302889.92
210760,201801,273,198,75,188892,71535.69,260427.69
210770,201801,397,306,91,291924,86527.8,378451.8
210780,201801,421,302,119,288108,113526,401634
210790,201801,182,140,42,133560,40068,173628
210800,201801,136,102,34,97308,32436,129744
210805,201801,42,38,4,36252,3816,40068
210810,201801,488,368,120,350404.2,114480,464884.2
210820,201801,2311,1818,493,1726256.54,470322,2196578.54
210825,201801,171,87,84,82998,80136,163134
210830,201801,810,485,325,461736,309096,770832
210840,201801,217,143,74,136422,70596,207018
210845,201801,251,156,95,148824,90630,239454
210850,201801,863,550,313,524700,298602,823302
210860,201801,4170,2125,2045,2026009.8,1950624.72,3976634.52
210870,201801,466,348,118,331992,112572,444564
210880,201801,56,38,18,36252,17172,53424
210890,201801,337,277,60,264258,57240,321498
210900,201801,566,368,198,351072,188892,539964
210905,201801,73,35,38,33390,36252,69642
210910,201801,1996,1461,535,1393076.19,510390,1903466.19
210920,201801,230,66,164,62964,156456,219420
210923,201801,79,55,24,52470,22896,75366
210927,201801,440,178,262,169812,249948,419760
210930,201801,58,45,13,42930,12402,55332
210940,201801,93,69,24,65826,22896,88722
210945,201801,195,88,107,83952,102078,186030
210950,201801,503,360,143,343440,136417.23,479857.23
210955,201801,75,49,26,46746,24804,71550
210960,201801,2464,1025,1439,976228.4,1372520,2348748.4
210970,201801,115,99,16,94446,15264,109710
210975,201801,88,79,9,75366,8586,83952
210980,201801,1248,528,720,503597.52,686594,1190191.52
210990,201801,4402,2711,1691,2585182.13,1613214,4198396.13
211000,201801,1379,1085,294,1034804,280190,1314994
211003,201801,918,626,292,597204,278559,875763
211010,201801,467,407,60,388278,57240,445518
211020,201801,1605,575,1030,548550,982400.58,1530950.58
211023,201801,26,22,4,20701.8,3816,24517.8
211027,201801,62,38,24,36252,22896,59148
211030,201801,384,255,129,243270,123066,366336
211040,201801,316,237,79,225812,75366,301178
211050,201801,1193,745,448,710730,427101.23,1137831.23
211060,201801,685,579,106,551125.8,101124,652249.8
211065,201801,24,20,4,19080,3816,22896
211070,201801,912,736,176,700532.74,167904,868436.74
211080,201801,90,86,4,82044,3816,85860
211085,201801,59,31,28,29288,26712,56000
211090,201801,94,76,18,72504,17172,89676
211100,201801,504,401,103,382554,98262,480816
211102,201801,263,173,90,165042,85860,250902
211105,201801,214,145,69,138330,65826,204156
211107,201801,136,77,59,73458,56286,129744
211110,201801,821,530,291,505048,277605,782653
211120,201801,5842,2429,3413,2312004.54,3254910.23,5566914.77
211125,201801,33,26,7,24804,6678,31482
211130,201801,46126,18909,27217,18005732.32,25952521.62,43958253.94
211140,201801,432,363,69,345344,65826,411170
211150,201801,1254,785,469,748556.1,447136,1195692.1
211153,201801,167,97,70,92538,66780,159318
211157,201801,58,42,16,40068,15264,55332
211160,201801,707,586,121,558077.5,115434,673511.5
211163,201801,0,0,0,0,0,0
211167,201801,5,3,2,2862,1908,4770
211170,201801,443,307,136,292878,129744,422622
211172,201801,122,84,38,80136,36252,116388
211174,201801,285,163,122,155502,116388,271890
211176,201801,522,372,150,354888,143100,497988
211178,201801,98,62,36,59148,34344,93492
211180,201801,210,163,47,155502,44675.82,200177.82
211190,201801,63,58,5,55332,4770,60102
211195,201801,25,16,9,15264,8586,23850
211200,201801,157,134,23,127492.56,21942,149434.56
211210,201801,535,325,210,309382.2,200340,509722.2
211220,201801,3972,2223,1749,2112899.39,1661259.64,3774159.03
211223,201801,97,90,7,85678.74,6678,92356.74
211227,201801,69,47,22,44838,20988,65826
211230,201801,781,629,152,599922.9,144988.92,744911.82
211240,201801,420,313,107,298602,102078,400680
211245,201801,215,93,122,88722,116388,205110
211250,201801,1644,1398,246,1332521.45,234684,1567205.45
211260,201801,805,633,172,603882,164088,767970
211270,201801,2100,1633,467,1557882,444564.2,2002446.2
211280,201801,1824,1085,739,1033183.36,705006,1738189.36
211285,201801,211,119,92,113526,87768,201294
211290,201801,692,460,232,438649.2,221328,659977.2
211300,201801,808,617,191,588340.09,182214,770554.09
211400,201801,1609,898,711,856692,678294,1534986
220005,201801,18,17,1,16218,954,17172
220010,201801,89,68,21,64872,19747.8,84619.8
220020,201801,589,459,130,437281.84,124020,561301.84
220025,201801,106,102,4,97308,3816,101124
220027,201801,35,28,7,26712,6678,33390
220030,201801,95,77,18,73458,17172,90630
220040,201801,1109,822,287,782928.76,273798,1056726.76
220045,201801,39,28,11,26712,10494,37206
220050,201801,647,525,122,499838.96,116368.92,616207.88
220060,201801,173,147,26,140238,24804,165042
220070,201801,92,83,9,79182,8586,87768
220080,201801,9,8,1,7632,954,8586
220090,201801,33,27,6,25472,5724,31196
220095,201801,2,1,1,954,954,1908
220100,201801,28,24,4,22896,3816,26712
220105,201801,36,33,3,31482,2862,34344
220110,201801,207,191,16,181927.8,15264,197191.8
220115,201801,47,44,3,41976,2862,44838
220117,201801,19,18,1,17172,954,18126
220120,201801,1526,1049,477,1000117.31,455038.92,1455156.23
220130,201801,26,25,1,23850,954,24804
220140,201801,97,77,20,72504,19080,91584
220150,201801,450,319,131,304326,124974,429300
220155,201801,4,4,0,3816,0,3816
220157,201801,16,13,3,12402,2862,15264
220160,201801,73,63,10,60102,9540,69642
220170,201801,33,31,2,29574,1908,31482
220173,201801,7,7,0,6678,0,6678
220177,201801,5,5,0,4770,0,4770
220180,201801,67,66,1,62959.23,954,63913.23
220190,201801,1062,950,112,906300,106084.8,1012384.8
220191,201801,42,37,5,35298,4770,40068
220192,201801,60,57,3,54378,2862,57240
220194,201801,29,25,4,23850,3816,27666
220196,201801,103,85,18,81090,17172,98262
220198,201801,6,4,2,3816,1908,5724
220200,201801,431,349,82,333773,78228,412001
220202,201801,37,33,4,31482,3816,35298
220205,201801,39,34,5,32436,4770,37206
220207,201801,19,18,1,17172,954,18126
220208,201801,83,43,40,41022,38160,79182
220209,201801,32,29,3,27666,2862,30528
220210,201801,14,13,1,12402,954,13356
220211,201801,35,35,0,33390,0,33390
220213,201801,41,37,4,35298,3530,38828
220217,201801,36,28,8,26712,7632,34344
220220,201801,1997,1266,731,1204158.68,695971.92,1900130.60
220225,201801,16,9,7,8586,6678,15264
220230,201801,930,739,191,704557.62,181574.82,886132.44
220240,201801,143,131,12,124974,11448,136422
220245,201801,35,32,3,29538.84,2862,32400.84
220250,201801,106,94,12,89676,11448,101124
220253,201801,45,37,8,35298,7632,42930
220255,201801,28,25,3,23850,2862,26712
220260,201801,690,502,188,478908,179352,658260
220265,201801,15,11,4,10494,3816,14310
220270,201801,661,587,74,559272.96,70119,629391.96
220271,201801,47,39,8,37206,7632,44838
220272,201801,26,25,1,23850,954,24804
220273,201801,15,13,2,12402,1908,14310
220275,201801,53,42,11,40068,10494,50562
220277,201801,11,9,2,8586,1908,10494
220280,201801,12,10,2,9540,1908,11448
220285,201801,42,39,3,37206,2862,40068
220290,201801,1380,1178,202,1121284,192661,1313945
220300,201801,56,54,2,51516,1908,53424
220310,201801,312,264,48,251852,45783,297635
220320,201801,430,395,35,375400,33390,408790
220323,201801,0,0,0,0,0,0
220325,201801,14,9,5,8586,4770,13356
220327,201801,11,10,1,9540,954,10494
220330,201801,197,133,64,126882,61056,187938
220335,201801,140,123,17,117342,16218,133560
220340,201801,20,11,9,10494,8586,19080
220342,201801,56,47,9,44838,8586,53424
220345,201801,83,75,8,71550,7632,79182
220350,201801,428,377,51,357035.42,48654,405689.42
220360,201801,43,31,12,29574,11448,41022
220370,201801,1094,866,228,825210,217225.8,1042435.8
220375,201801,26,24,2,22896,1908,24804
220380,201801,32,25,7,23850,6678,30528
220385,201801,28,24,4,22896,3816,26712
220390,201801,2222,1264,958,1201965.82,912549.5,2114515.32
220400,201801,28,26,2,24804,1908,26712
220410,201801,14,13,1,12402,954,13356
220415,201801,12,11,1,10494,954,11448
220420,201801,124,103,21,98262,19747.8,118009.8
220430,201801,132,119,13,111857.8,12402,124259.8
220435,201801,22,16,6,15260,5724,20984
220440,201801,290,247,43,235638,41022,276660
220450,201801,328,168,160,159106.98,152640,311746.98
220455,201801,53,51,2,48654,1908,50562
220460,201801,17,17,0,15550.2,0,15550.2
220465,201801,109,69,40,65826,38160,103986
220470,201801,240,211,29,201294,27666,228960
220480,201801,71,60,11,57240,10494,67734
220490,201801,86,75,11,71550,10494,82044
220500,201801,96,83,13,79182,12402,91584
220510,201801,380,302,78,287345,74221.2,361566.2
220515,201801,21,17,4,16218,3816,20034
220520,201801,368,331,37,314214,35279,349493
220525,201801,25,17,8,16218,7632,23850
220527,201801,37,29,8,27666,6822,34488
220530,201801,33,12,21,11448,20034,31482
220535,201801,13,12,1,11448,954,12402
220540,201801,60,47,13,44838,12402,57240
220545,201801,62,40,22,38160,20988,59148
220550,201801,632,480,152,457156.8,145008,602164.8
220551,201801,26,19,7,18126,6678,24804
220552,201801,8,8,0,7632,0,7632
220553,201801,47,43,4,41022,3816,44838
220554,201801,13,8,5,7345.8,4770,12115.8
220555,201801,22,18,4,17172,3816,20988
220556,201801,56,52,4,49608,3816,53424
220557,201801,55,49,6,46746,5724,52470
220558,201801,7,2,5,1908,4770,6678
220559,201801,7,6,1,5724,954,6678
220560,201801,55,35,20,33199.2,19080,52279.2
220570,201801,791,468,323,444982.14,308142,753124.14
220580,201801,571,522,49,497988,46059.92,544047.92
220585,201801,6,5,1,4770,954,5724
220590,201801,14,14,0,13356,0,13356
220595,201801,59,44,15,41976,14310,56286
220600,201801,19,10,9,9540,8586,18126
220605,201801,21,20,1,19080,954,20034
220610,201801,60,51,9,48654,8586,57240
220620,201801,559,436,123,415705.5,117342,533047.5
220630,201801,7,5,2,4770,1908,6678
220635,201801,37,33,4,31482,3816,35298
220640,201801,98,77,21,73458,20034,93492
220650,201801,113,107,6,102078,5724,107802
220660,201801,28,23,5,21942,4770,26712
220665,201801,4,4,0,3816,0,3816
220667,201801,10,10,0,9540,0,9540
220669,201801,24,21,3,20034,2862,22896
220670,201801,71,55,16,52279.2,15264,67543.2
220672,201801,58,39,19,37206,18126,55332
220675,201801,34,26,8,24804,7632,32436
220680,201801,34,29,5,27666,4770,32436
220690,201801,48,45,3,42930,2862,45792
220695,201801,62,30,32,28620,30528,59148
220700,201801,1508,1156,352,1100982.78,335808,1436790.78
220710,201801,3,1,2,954,1908,2862
220720,201801,113,92,21,87529.5,19890.9,107420.4
220730,201801,19,18,1,17172,954,18126
220735,201801,3,1,2,954,1908,2862
220740,201801,42,39,3,37206,2862,40068
220750,201801,98,78,20,74412,19080,93492
220755,201801,14,14,0,13356,0,13356
220760,201801,50,47,3,44838,2862,47700
220770,201801,5754,2863,2891,2726092.83,2752163.41,5478256.24
220775,201801,28,14,14,13356,13356,26712
220777,201801,15,14,1,13356,954,14310
220779,201801,18,14,4,13356,3816,17172
220780,201801,872,743,129,708154.2,122780,830934.2
220785,201801,10,5,5,4770,4770,9540
220790,201801,1005,797,208,757936,198432,956368
220793,201801,13,13,0,12402,0,12402
220795,201801,22,21,1,20034,954,20988
220800,201801,3894,2968,926,2829829.36,882427.89,3712257.25
220810,201801,57,51,6,48654,5724,54378
220820,201801,238,216,22,206064,20988,227052
220830,201801,1155,980,175,934915.23,166931,1101846.23
220840,201801,2410,1588,822,1502459.75,782090,2284549.75
220850,201801,52,41,11,39114,10494,49608
220855,201801,14,9,5,8586,4770,13356
220860,201801,8,7,1,6678,954,7632
220865,201801,22,20,2,19080,1908,20988
220870,201801,56,54,2,51516,1908,53424
220880,201801,318,241,77,229246.2,73172,302418.2
220885,201801,45,39,6,37206,5724,42930
220887,201801,19,18,1,17172,954,18126
220890,201801,103,91,12,86814,11448,98262
220900,201801,46,26,20,24804,19080,43884
220910,201801,54,45,9,42930,8586,51516
220915,201801,10,9,1,8586,954,9540
220920,201801,35,32,3,30528,2862,33390
220930,201801,43,42,1,40068,954,41022
220935,201801,14,14,0,13356,0,13356
220937,201801,45,42,3,40068,2862,42930
220940,201801,49,45,4,42930,3816,46746
220945,201801,0,0,0,0,0,0
220950,201801,45,41,4,39114,3816,42930
220955,201801,32,29,3,27666,2862,30528
220960,201801,1,1,0,954,0,954
220965,201801,29,25,4,23850,3816,27666
220970,201801,46,39,7,37206,6678,43884
220975,201801,9,8,1,7632,954,8586
220980,201801,34,32,2,30528,1908,32436
220985,201801,62,56,6,53424,5724,59148
220987,201801,31,30,1,28620,954,29574
220990,201801,13,12,1,11448,954,12402
220995,201801,42,35,7,33390,6678,40068
220997,201801,38,32,6,30528,5724,36252
221000,201801,1115,1004,111,953747.6,105607.8,1059355.4
221005,201801,66,59,7,56286,6678,62964
221010,201801,15,12,3,11448,2862,14310
221020,201801,46,44,2,41976,1908,43884
221030,201801,28,22,6,20988,5724,26712
221035,201801,19,19,0,18126,0,18126
221037,201801,12,6,6,5724,5724,11448
221038,201801,24,22,2,20988,1908,22896
221039,201801,22,22,0,20988,0,20988
221040,201801,249,214,35,204156,33390,237546
221050,201801,230,194,36,185076,34344,219420
221060,201801,1705,1496,209,1425668.76,199386,1625054.76
221062,201801,29,28,1,26712,954,27666
221063,201801,14,10,4,9540,3816,13356
221065,201801,48,41,7,39114,6678,45792
221070,201801,142,122,20,116388,19080,135468
221080,201801,375,331,44,315774,41689.8,357463.8
221090,201801,37,36,1,34344,954,35298
221093,201801,57,38,19,36252,18126,54378
221095,201801,11,10,1,9540,954,10494
221097,201801,22,19,3,18126,2862,20988
221100,201801,24371,13967,10404,13303132.41,9920706.67,23223839.08
221110,201801,1022,747,275,712352,262350,974702
221120,201801,522,389,133,370820,126882,497702
221130,201801,924,751,173,715214.8,165042,880256.8
221135,201801,34,31,3,29574,2862,32436
221140,201801,39,31,8,29574,7632,37206
221150,201801,14,11,3,10494,2862,13356
221160,201801,10,10,0,9540,0,9540
221170,201801,13,13,0,12402,0,12402
230010,201801,160,149,11,142146,10494,152640
230015,201801,114,93,21,88722,20034,108756
230020,201801,1521,1300,221,1237625,209946.87,1447571.87
230030,201801,1602,1152,450,1093439.04,429300,1522739.04
230040,201801,197,173,24,164088,22896,186984
230050,201801,206,150,56,143100,53424,196524
230060,201801,145,119,26,112762.8,24804,137566.8
230070,201801,285,253,32,241362,30528,271890
230075,201801,791,691,100,657211,95113.8,752324.8
230080,201801,174,151,23,144054,21942,165996
230090,201801,92,62,30,58384.8,28620,87004.8
230100,201801,1929,1150,779,1094813,743166,1837979
230110,201801,2627,1679,948,1598127.4,903819.8,2501947.2
230120,201801,931,736,195,699760.22,186011,885771.22
230125,201801,137,112,25,106848,23850,130698
230130,201801,457,408,49,389232,46746,435978
230140,201801,203,175,28,166950,26712,193662
230150,201801,156,120,36,114480,34344,148824
230160,201801,901,783,118,746267,112572,858839
230170,201801,577,533,44,504668.7,41976,546644.7
230180,201801,80,75,5,71550,4770,76320
230185,201801,403,346,57,328718.83,54378,383096.83
230190,201801,2173,1755,418,1670004.48,398455,2068459.48
230195,201801,484,422,62,402588,59148,461736
230200,201801,366,319,47,303362.46,44838,348200.46
230205,201801,351,219,132,207156.33,125928,333084.33
230210,201801,1245,993,252,945995.29,239644.8,1185640.09
230220,201801,1380,963,417,917938.8,397818,1315756.8
230230,201801,893,786,107,748190.7,102078,850268.7
230240,201801,1617,1394,223,1327941.7,212742,1540683.7
230250,201801,1752,1441,311,1370703.07,296535,1667238.07
230260,201801,2913,1738,1175,1652859.16,1119977.69,2772836.85
230270,201801,1332,1071,261,1019134.39,247801.5,1266935.89
230280,201801,2665,1981,684,1884439.43,651868.2,2536307.63
230290,201801,395,359,36,335395.41,34344,369739.41
230300,201801,509,374,135,355536.72,128790,484326.72
230310,201801,419,313,106,298454.13,101124,399578.13
230320,201801,898,766,132,726780.6,125928,852708.6
230330,201801,297,240,57,228196.8,54188,282384.8
230340,201801,452,362,90,344395,85860,430255
230350,201801,3013,1891,1122,1803994.92,1067527.08,2871522.00
230360,201801,252,213,39,202292,37206,239498
230365,201801,132,105,27,99455,25758,125213
230370,201801,9628,4694,4934,4469313.48,4703150.22,9172463.70
230380,201801,460,397,63,378452,59148.6,437600.6
230390,201801,495,273,222,258638.94,211788,470426.94
230393,201801,269,224,45,212842.8,42930,255772.8
230395,201801,332,271,61,258286,58194,316480
230400,201801,600,476,124,452196,117799.92,569995.92
230410,201801,2593,1615,978,1535082.75,932726,2467808.75
230420,201801,5847,3809,2038,3615510.76,1939671.02,5555181.78
230423,201801,306,265,41,252810,39114,291924
230425,201801,341,284,57,270936,54378,325314
230426,201801,106,96,10,90858.96,9253.8,100112.76
230427,201801,78,75,3,71550,2862,74412
230428,201801,1334,689,645,657077.04,615330,1272407.04
230430,201801,439,354,85,337522,81090,418612
230435,201801,775,541,234,514572.23,221996.61,736568.84
230440,201801,83027,36557,46470,34789503.08,44289904.41,79079407.49
230445,201801,267,182,85,173437.2,81090,254527.2
230450,201801,537,435,102,414990,97308,512298
230460,201801,58,48,10,45792,9540,55332
230465,201801,294,239,55,228006,52470,280476
230470,201801,1825,1416,409,1350864,389079.1,1739943.1
230480,201801,146,141,5,134227.8,4770,138997.8
230490,201801,279,226,53,215604,50562,266166
230495,201801,432,326,106,310150,101124,411274
230500,201801,938,706,232,671616,221319,892935
230510,201801,43,35,8,33390,7632,41022
230520,201801,387,305,82,290970,78228,369198
230523,201801,1969,1246,723,1187201.8,689294,1876495.8
230526,201801,290,241,49,229914,45955,275869
230530,201801,664,499,165,473033.59,156456.2,629489.79
230533,201801,181,173,8,165042,7632,172674
230535,201801,340,255,85,243270,81090,324360
230540,201801,1820,1596,224,1519941.04,213123.8,1733064.84
230550,201801,3601,2310,1291,2195510.06,1229992.2,3425502.26
230560,201801,577,442,135,419569.8,127836,547405.8
230565,201801,188,137,51,130698,48654,179352
230570,201801,303,269,34,256626,32436,289062
230580,201801,1095,807,288,768418.38,273511.8,1041930.18
230590,201801,937,725,212,687407.1,201771,889178.1
230600,201801,250,228,22,216768.07,20988,237756.07
230610,201801,333,267,66,254528,62964,317492
230620,201801,163,134,29,126882,27666,154548
230625,201801,715,514,201,488973.5,190600.68,679574.18
230630,201801,1231,974,257,929196,244796.4,1173992.4
230640,201801,3439,2972,467,2828053.45,444759.57,3272813.02
230650,201801,391,341,50,324482.68,47700,372182.68
230655,201801,626,543,83,517068.8,79102.07,596170.87
230660,201801,331,275,56,262350,53137.8,315487.8
230670,201801,421,374,47,356796,44838,401634
230680,201801,200,184,16,175536,15264,190800
230690,201801,856,746,110,711684,104940,816624
230700,201801,694,588,106,560932.92,100551.6,661484.52
230710,201801,732,692,40,659978,38160,698138
230720,201801,145,122,23,115996.86,21942,137938.86
230725,201801,226,178,48,169812,45783,215595
230730,201801,11574,6274,5300,5968616.5,5048122.22,11016738.72
230740,201801,656,525,131,500564,124283.46,624847.46
230750,201801,793,678,115,645620.3,109710,755330.3
230760,201801,1289,1117,172,1061571.25,164088,1225659.25
230763,201801,320,264,56,249900.95,53424,303324.95
230765,201801,6769,3172,3597,3020376.71,3429531.98,6449908.69
230770,201801,4957,2549,2408,2421895.5,2294525.46,4716420.96
230780,201801,672,591,81,560674.1,77259.69,637933.79
230790,201801,189,154,35,146916,32589.4,179505.4
230800,201801,1104,806,298,768900.15,284292,1053192.15
230810,201801,1264,1127,137,1074156.3,130507.2,1204663.5
230820,201801,327,236,91,224191,86814,311005
230830,201801,930,806,124,765410.41,118296,883706.41
230835,201801,276,237,39,225144,36491,261635
230837,201801,164,138,26,131652,24804,156456
230840,201801,888,709,179,675146.5,169526,844672.5
230850,201801,1469,1282,187,1222741.8,178112,1400853.8
230860,201801,302,224,78,213696,73458.5,287154.5
230870,201801,1786,1516,270,1445310,256244.8,1701554.8
230880,201801,33,25,8,23850,7632,31482
230890,201801,565,518,47,494049.8,44824,538873.8
230900,201801,269,205,64,195570,60859,256429
230910,201801,198,161,37,152830.8,35298,188128.8
230920,201801,395,312,83,297648,79182,376830
230930,201801,913,646,267,613422.64,254718,868140.64
230940,201801,820,658,162,627732,154358,782090
230945,201801,459,383,76,365192,72504,437696
230950,201801,377,321,56,306234,53424,359658
230960,201801,2476,1676,800,1592176.84,762914,2355090.84
230970,201801,1726,976,750,930193.9,714622.32,1644816.22
230980,201801,210,179,31,170766,29574,200340
230990,201801,138,110,28,104940,25955.47,130895.47
231000,201801,207,187,20,176490,19080,195570
231010,201801,132,104,28,98643.6,26712,125355.6
231020,201801,1261,877,384,835037,366336,1201373
231025,201801,939,703,236,668498.2,223598.8,892097.0
231030,201801,1142,958,184,913928,175250,1089178
231040,201801,138,94,44,88931.88,41245,130176.88
231050,201801,978,871,107,829169.9,102078,931247.9
231060,201801,139,123,16,117342,15264,132606
231070,201801,1405,992,413,945223.3,394002,1339225.3
231080,201801,261,243,18,231011.1,17172,248183.1
231085,201801,540,339,201,322453,191754,514207
231090,201801,236,195,41,186030,39114,225144
231095,201801,163,129,34,123066,32436,155502
231100,201801,122,102,20,97308,17839.8,115147.8
231110,201801,342,296,46,281675,43884,325559
231120,201801,296,255,41,242311.86,38924,281235.86
231123,201801,131,125,6,119250,5724,124974
231126,201801,275,238,37,227052,35298,262350
231130,201801,4545,3530,1015,3357712.5,967251.26,4324963.76
231135,201801,198,171,27,163134,24492.4,187626.4
231140,201801,3030,2236,794,2129475.91,756483.84,2885959.75
231150,201801,349,334,15,318636,14310,332946
231160,201801,1203,941,262,894661.7,249719.04,1144380.74
231170,201801,535,352,183,335808,174582,510390
231180,201801,1589,1342,247,1279504.8,235638,1515142.8
231190,201801,199,177,22,168858,20988,189846
231195,201801,213,184,29,174812,27666,202478
231200,201801,820,676,144,644904,136116,781020
231210,201801,601,499,102,475092.8,97308,572400.8
231220,201801,1019,740,279,704987.92,266166,971153.92
231230,201801,1375,1103,272,1051060.04,258724.8,1309784.84
231240,201801,1352,981,371,935587.8,352694.2,1288282.0
231250,201801,110,102,8,97308,7632,104940
231260,201801,291,187,104,178398,98930,277328
231270,201801,990,830,160,786590.68,152640,939230.68
231280,201801,55,43,12,41022,11448,52470
231290,201801,7138,3965,3173,3773702.84,3024640.21,6798343.05
231300,201801,620,572,48,545688,45792,591480
231310,201801,691,641,50,610297,47700,657997
231320,201801,556,432,124,411652,118296,529948
231325,201801,88,78,10,74412,9540,83952
231330,201801,2002,1547,455,1469832.66,431114.6,1900947.26
231335,201801,242,214,28,204156,26712,230868
231340,201801,1580,1159,421,1103970.08,401348,1505318.08
231350,201801,1136,928,208,885312,197860,1083172
231355,201801,389,335,54,319590,51516,371106
231360,201801,468,372,96,352178.2,91584,443762.2
231370,201801,88,72,16,68688,15264,83952
231375,201801,283,204,79,194616,75366,269982
231380,201801,443,359,84,340890.69,79945.2,420835.89
231390,201801,195,160,35,152640,33390,186030
231395,201801,721,439,282,417508.56,268909.4,686417.96
231400,201801,1045,865,180,822638.84,171377.38,994016.22
231410,201801,1286,1037,249,984673.4,236593,1221266.4
240010,201801,386,180,206,170568.26,196515,367083.26
240020,201801,2179,1696,483,1616190.89,460778,2076968.89
240030,201801,138,117,21,111618,20034,131652
240040,201801,32,32,0,30528,0,30528
240050,201801,505,433,72,412228.45,68688,480916.45
240060,201801,67,63,4,60102,3816,63918
240070,201801,174,134,40,127836,38160,165996
240080,201801,430,286,144,272840,137376,410216
240090,201801,103,92,11,87462.72,10494,97956.72
240100,201801,1428,1344,84,1279203.55,79945.2,1359148.75
240110,201801,961,604,357,575244.26,340578,915822.26
240120,201801,139,117,22,111618,20988,132606
240130,201801,286,268,18,254955.54,17172,272127.54
240140,201801,79,62,17,59148,16218,75366
240145,201801,673,593,80,565197.3,76110.12,641307.42
240150,201801,20,15,5,14310,4755.69,19065.69
240160,201801,44,38,6,36252,5724,41976
240165,201801,34,28,6,26474,5724,32198
240170,201801,92,71,21,67734,20034,87768
240180,201801,77,63,14,60102,13356,73458
240185,201801,42,38,4,36242.46,3816,40058.46
240190,201801,14,12,2,11448,1908,13356
240200,201801,2986,1688,1298,1604181.67,1237053,2841234.67
240210,201801,161,127,34,121158,32436,153594
240220,201801,1103,791,312,754471,297638.46,1052109.46
240230,201801,816,756,60,718390.05,56592,774982.05
240240,201801,117,84,33,80136,31482,111618
240250,201801,92,81,11,77274,10494,87768
240260,201801,1781,1320,461,1258593.12,438811.38,1697404.50
240270,201801,190,168,22,159890.4,20988,180878.4
240280,201801,43,33,10,31482,9540,41022
240290,201801,51,49,2,46746,1908,48654
240300,201801,180,99,81,94446,77274,171720
240310,201801,1980,1082,898,1023362.38,853455.57,1876817.95
240320,201801,210,199,11,189846,10494,200340
240325,201801,4291,2625,1666,2497238.46,1587195.22,4084433.68
240330,201801,64,61,3,58194,2862,61056
240340,201801,101,72,29,68688,27666,96354
240350,201801,91,80,11,76320,10494,86814
240360,201801,373,268,105,255672,100170,355842
240370,201801,36,34,2,32436,1908,34344
240375,201801,72,41,31,39114,29574,68688
240380,201801,235,191,44,181300,41881,223181
240390,201801,15,13,2,12402,1908,14310
240400,201801,78,74,4,70596,3816,74412
240410,201801,10,6,4,5724,3816,9540
240420,201801,880,684,196,651135.52,185934.6,837070.12
240430,201801,264,249,15,235285.09,14310,249595.09
240440,201801,69,36,33,34344,31482,65826
240450,201801,206,138,68,131079.8,64872,195951.8
240460,201801,59,46,13,43884,12402,56286
240470,201801,234,203,31,193104.86,29574,222678.86
240480,201801,14,14,0,13260.6,0,13260.6
240485,201801,71,61,10,57908,9540,67448
240490,201801,44,44,0,41766.12,0,41766.12
240500,201801,83,66,17,62964,16218,79182
240510,201801,51,36,15,34344,14310,48654
240520,201801,125,119,6,113526,5724,119250
240530,201801,50,45,5,42930,4770,47700
240540,201801,76,65,11,62010,10494,72504
240550,201801,15,13,2,12402,1908,14310
240560,201801,369,273,96,259815.23,91584,351399.23
240570,201801,460,285,175,270752.33,166950,437702.33
240580,201801,1256,1016,240,963779.9,227802.2,1191582.1
240590,201801,30,28,2,26712,1908,28620
240600,201801,112,111,1,105894,954,106848
240610,201801,514,428,86,407955.7,81281,489236.7
240615,201801,22,21,1,20034,954,20988
240620,201801,95,91,4,85860,3816,89676
240630,201801,34,32,2,30528,1908,32436
240640,201801,27,23,4,21942,3816,25758
240650,201801,234,197,37,187079.9,35298,222377.9
240660,201801,97,84,13,80136,12402,92538
240670,201801,288,171,117,161035.3,111618,272653.3
240680,201801,48,37,11,35298,10494,45792
240690,201801,50,47,3,44838,2862,47700
240700,201801,190,158,32,150732,30528,181260
240710,201801,1905,1218,687,1161539.6,655388.46,1816928.06
240720,201801,1034,756,278,720260.66,265212,985472.66
240725,201801,66,63,3,60102,2862,62964
240730,201801,131,115,16,109710,15264,124974
240740,201801,241,204,37,193251.78,34308.02,227559.80
240750,201801,34,21,13,20034,12402,32436
240760,201801,32,28,4,26712,3816,30528
240770,201801,147,112,35,106848,33390,140238
240780,201801,694,579,115,550925.46,109710,660635.46
240790,201801,37,36,1,34344,954,35298
240800,201801,8514,5766,2748,5462102.19,2614382.2,8076484.39
240810,201801,19912,10934,8978,10389406.37,8554708.65,18944115.02
240820,201801,195,129,66,122392.03,62964,185356.03
240830,201801,1589,1302,287,1235583.16,272844,1508427.16
240840,201801,76,67,9,63918,8586,72504
240850,201801,84,73,11,69642,10494,80136
240860,201801,113,110,3,104940,2862,107802
240870,201801,56,49,7,46746,6678,53424
240880,201801,29,26,3,24794.46,2862,27656.46
240890,201801,1147,676,471,640995.18,449330,1090325.18
240895,201801,42,32,10,30528,9540,40068
240910,201801,153,138,15,131652,14310,145962
240920,201801,15,11,4,10494,3816,14310
240930,201801,376,340,36,323406,34344,357750
240933,201801,28,20,8,19080,7632,26712
240940,201801,2421,2139,282,2027041.49,266146.92,2293188.41
240950,201801,49,47,2,44838,1908,46746
240960,201801,32,25,7,23850,6678,30528
240970,201801,133,96,37,91584,34544,126128
240980,201801,188,151,37,144054,35298,179352
240990,201801,120,81,39,77274,37206,114480
241000,201801,72,66,6,62964,5724,68688
241010,201801,56,45,11,42930,10494,53424
241020,201801,114,107,7,102078,6678,108756
241025,201801,9,3,6,2862,5724,8586
241030,201801,120,98,22,93492,20988,114480
241040,201801,32,28,4,26712,3816,30528
241050,201801,90,78,12,74412,11448,85860
241060,201801,27,24,3,22896,2862,25758
241070,201801,15,15,0,14310,0,14310
241080,201801,65,57,8,54091.8,7632,61723.8
241090,201801,48,40,8,38160,7617.69,45777.69
241100,201801,74,65,9,62010,8586,70596
241105,201801,6,2,4,1908,3816,5724
241110,201801,49,47,2,44838,1908,46746
241120,201801,1419,1103,316,1049276.8,300700.8,1349977.6
241140,201801,224,182,42,172675,40068,212743
241142,201801,42,41,1,39114,954,40068
241150,201801,1206,1059,147,1007568,140238,1147806
241160,201801,23,22,1,20988,954,21942
241170,201801,42,39,3,37206,2862,40068
241180,201801,51,42,9,39893.42,8586,48479.42
241190,201801,38,37,1,35298,954,36252
241200,201801,3822,2093,1729,1992722.82,1647545.66,3640268.48
241210,201801,72,60,12,57240,10590,67830
241220,201801,1355,903,452,860939.04,431174.92,1292113.96
241230,201801,245,207,38,197287.2,36252,233539.2
241240,201801,52,40,12,38160,11448,49608
241250,201801,1069,994,75,947990,71264,1019254
241255,201801,47,38,9,36252,8586,44838
241260,201801,627,494,133,471271.23,126882,598153.23
241270,201801,46,32,14,30528,13356,43884
241280,201801,99,87,12,82998,11448,94446
241290,201801,109,81,28,77274,26712,103986
241300,201801,76,53,23,50562,21942,72504
241310,201801,51,38,13,36109,12402,48511
241320,201801,26,14,12,13356,11448,24804
241330,201801,60,54,6,51516,5724,57240
241335,201801,60,53,7,49989.6,6678,56667.6
241340,201801,188,142,46,135468,43884,179352
241350,201801,57,52,5,49608,4770,54378
241355,201801,41,38,3,36252,2862,39114
241360,201801,46,46,0,43884,0,43884
241370,201801,44,36,8,34219.98,7632,41851.98
241380,201801,40,38,2,36252,1908,38160
241390,201801,77,62,15,58957.2,14310,73267.2
241400,201801,188,155,33,147202.2,31482,178684.2
241410,201801,175,159,16,151686,15168.6,166854.6
241415,201801,93,74,19,70596,18126,88722
241420,201801,94,73,21,69642,19694,89336
241430,201801,28,27,1,25758,954,26712
241440,201801,451,384,67,366322,63918,430240
241445,201801,36,34,2,32436,1908,34344
241450,201801,274,224,50,213569,47700,261269
241460,201801,137,125,12,119012,11448,130460
241470,201801,44,37,7,35298,6678,41976
241475,201801,65,61,4,58194,3816,62010
241480,201801,97,70,27,65477.53,25758,91235.53
241490,201801,9,8,1,7632,954,8586
241500,201801,46,35,11,33390,10494,43884
250010,201801,100,87,13,82854.9,12402,95256.9
250020,201801,25,22,3,20988,2862,23850
250030,201801,808,594,214,565331.2,203107.6,768438.8
250040,201801,325,271,54,258534,51516,310050
250050,201801,224,185,39,175913.6,37206,213119.6
250053,201801,54,42,12,40068,11448,51516
250057,201801,0,0,0,0,0,0
250060,201801,446,341,105,325314,99883.8,425197.8
250070,201801,689,582,107,553210,102078,655288
250073,201801,7,7,0,6678,0,6678
250077,201801,205,152,53,144616.86,50562,195178.86
250080,201801,420,328,92,311291.2,87768,399059.2
250090,201801,201,135,66,127836.4,62944.92,190781.32
250100,201801,466,380,86,362520,81663,444183
250110,201801,486,368,118,349288.02,112572,461860.02
250115,201801,27,8,19,7632,18126,25758
250120,201801,111,84,27,80136,25758,105894
250130,201801,586,462,124,440748,118106,558854
250135,201801,14,8,6,7632,5724,13356
250140,201801,75,66,9,62964,8586,71550
250150,201801,562,415,147,393742,139923.18,533665.18
250153,201801,11,10,1,9540,954,10494
250157,201801,29,24,5,22896,4770,27666
250160,201801,209,164,45,156456,42930,199386
250170,201801,68,48,20,45792,19080,64872
250180,201801,3982,2678,1304,2540632.9,1238918,3779550.9
250190,201801,904,597,307,567868.5,292162.5,860031.0
250200,201801,51,43,8,41022,7632,48654
250205,201801,21,19,2,18126,1908,20034
250210,201801,90,78,12,74412,11448,85860
250215,201801,62,54,8,51516,7632,59148
250220,201801,27,21,6,20034,5724,25758
250230,201801,74,67,7,63914,6678,70592
250240,201801,244,203,41,192851.1,39114,231965.1
250250,201801,385,331,54,315774,51516,367290
250260,201801,31,26,5,24804,4770,29574
250270,201801,57,45,12,42930,11448,54378
250280,201801,384,322,62,307188,59148,366336
250290,201801,94,89,5,84619.8,4770,89389.8
250300,201801,553,379,174,360918.71,165983,526901.71
250310,201801,47,41,6,39114,5724,44838
250320,201801,1919,1316,603,1249051.07,573689,1822740.07
250330,201801,82,73,9,69642,8586,78228
250340,201801,25,21,4,20034,3816,23850
250350,201801,138,88,50,83665.8,47127.6,130793.4
250355,201801,28,23,5,21942,4770,26712
250360,201801,198,161,37,153594,35060,188654
250370,201801,2362,1601,761,1521442.78,724437.82,2245880.60
250375,201801,19,15,4,14310,3816,18126
250380,201801,52,36,16,34344,15264,49608
250390,201801,42,35,7,33390,6678,40068
250400,201801,15552,7876,7676,7488665.54,7315952.35,14804617.89
250403,201801,420,341,79,325304.46,75366,400670.46
250407,201801,53,46,7,43884,6678,50562
250410,201801,28,23,5,21942,4770,26712
250415,201801,42,28,14,26712,13336.92,40048.92
250420,201801,46,38,8,36252,7632,43884
250430,201801,1656,1397,259,1330545,247086,1577631
250435,201801,15,12,3,11448,2862,14310
250440,201801,687,595,92,564937.38,87768,652705.38
250450,201801,87,73,14,69642,13356,82998
250460,201801,412,279,133,266166,126872.46,393038.46
250470,201801,88,65,23,62010,21942,83952
250480,201801,319,252,67,240408,63918,304326
250485,201801,2,1,1,954,954,1908
250490,201801,204,166,38,158364,36252,194616
250500,201801,74,54,20,51516,19080,70596
250510,201801,731,572,159,544352.6,150677.43,695030.03
250520,201801,174,121,53,115414.92,50557.23,165972.15
250523,201801,110,92,18,87768,17172,104940
250527,201801,104,80,24,76315.23,22896,99211.23
250530,201801,8,6,2,5724,1908,7632
250535,201801,25,21,4,20034,3816,23850
250540,201801,125,95,30,89914.5,28620,118534.5
250550,201801,69,66,3,62964,2862,65826
250560,201801,35,29,6,27666,5724,33390
250570,201801,153,122,31,116388,29574,145962
250580,201801,133,103,30,97975.8,28620,126595.8
250590,201801,20,16,4,15264,3816,19080
250600,201801,1320,896,424,851924.25,404400.6,1256324.85
250610,201801,153,132,21,125928,20034,145962
250620,201801,21,17,4,16218,3816,20034
250625,201801,59,45,14,42930,13356,56286
250630,201801,2997,1919,1078,1822678.88,1027344.74,2850023.62
250640,201801,203,168,35,160272,33390,193662
250650,201801,31,21,10,20034,9540,29574
250660,201801,42,32,10,30528,9540,40068
250670,201801,58,38,20,36252,19080,55332
250680,201801,386,316,70,301464,66780,368244
250690,201801,1809,1245,564,1184291.53,537674.8,1721966.33
250700,201801,954,839,115,795944.91,109500.12,905445.03
250710,201801,443,343,100,327222,95400,422622
250720,201801,102,80,22,76320,20988,97308
250730,201801,371,311,60,295740.6,57240,352980.6
250740,201801,51,47,4,44838,3816,48654
250750,201801,20151,12055,8096,11442741.86,7714808.33,19157550.19
250760,201801,68,51,17,48654,16218,64872
250770,201801,349,232,117,219386.14,110449.55,329835.69
250780,201801,58,45,13,42930,12402,55332
250790,201801,484,314,170,296694.92,161464.5,458159.42
250800,201801,150,139,11,131890.5,10494,142384.5
250810,201801,79,59,20,56286,19080,75366
250820,201801,158,127,31,121158,29574,150732
250830,201801,429,289,140,274704.5,133560,408264.5
250840,201801,53,51,2,48654,1908,50562
250850,201801,54,42,12,39381.12,11448,50829.12
250855,201801,13,11,2,10494,1908,12402
250860,201801,206,146,60,139284,56953.8,196237.8
250870,201801,32,29,3,27666,2862,30528
250880,201801,79,60,19,57182.76,18126,75308.76
250890,201801,2369,1749,620,1667210.4,590616.73,2257827.13
250900,201801,112,95,17,90630,16218,106848
250905,201801,128,99,29,94446,27666,122112
250910,201801,1173,835,338,795427.31,322165.8,1117593.11
250915,201801,111,76,35,72504,33390,105894
250920,201801,138,106,32,101124,30528,131652
250930,201801,160,100,60,95400,57240,152640
250933,201801,0,0,0,0,0,0
250937,201801,6,5,1,4770,954,5724
250939,201801,30,22,8,20988,7632,28620
250940,201801,104,78,26,74412,24804,99216
250950,201801,72,47,25,44838,23850,68688
250960,201801,93,51,42,48654,40068,88722
250970,201801,1206,859,347,817865,330751.8,1148616.8
250980,201801,90,63,27,60102,25758,85860
250990,201801,165,129,36,122622.39,34301.07,156923.46
251000,201801,72,66,6,62773.2,5724,68497.2
251010,201801,94,74,20,70592,18301.53,88893.53
251020,201801,81,70,11,65969.1,10494,76463.1
251030,201801,42,32,10,30528,9540,40068
251040,201801,54,39,15,37206,14310,51516
251050,201801,24,22,2,20988,1908,22896
251060,201801,50,40,10,37206,9540,46746
251065,201801,3,3,0,2862,0,2862
251070,201801,25,20,5,19071,4770,23841
251080,201801,4697,2279,2418,2161900.26,2300219.01,4462119.27
251090,201801,196,168,28,160272,26712,186984
251100,201801,19,18,1,17172,954,18126
251110,201801,46,36,10,34344,9540,43884
251120,201801,1766,1056,710,1002514.2,677340,1679854.2
251130,201801,353,286,67,272844,63918,336762
251140,201801,506,329,177,312722.8,168689.34,481412.14
251150,201801,289,251,38,238682,36252,274934
251160,201801,92,77,15,73454,14310,87764
251170,201801,98,79,19,75337.38,18121.23,93458.61
251180,201801,290,183,107,174573.23,102069.23,276642.46
251190,201801,192,131,61,124645.83,58194,182839.83
251200,201801,256,207,49,197478,46746,244224
251203,201801,33,31,2,29574,1908,31482
251207,201801,93,77,16,73458,15264,88722
251210,201801,1256,897,359,854184.53,342104.4,1196288.93
251220,201801,45,34,11,32436,10494,42930
251230,201801,471,394,77,375876,73458,449334
251240,201801,100,72,28,67734,26712,94446
251250,201801,1326,950,376,903273.87,358561,1261834.87
251260,201801,13,8,5,7632,4770,12402
251270,201801,343,253,90,241362,85717,327079
251272,201801,67,61,6,58194,5724,63918
251274,201801,28,23,5,21942,4770,26712
251275,201801,22,15,7,14310,6678,20988
251276,201801,18,14,4,13356,3816,17172
251278,201801,9,7,2,6678,1908,8586
251280,201801,95,91,4,86814,3816,90630
251290,201801,696,527,169,502758,161226,663984
251300,201801,17,15,2,14310,1908,16218
251310,201801,361,260,101,248036,96354,344390
251315,201801,18,17,1,16218,954,17172
251320,201801,60,49,11,46746,10494,57240
251330,201801,79,70,9,66780,8586,75366
251335,201801,10,6,4,5724,3816,9540
251340,201801,688,406,282,387324,268003.25,655327.25
251350,201801,34,32,2,30528,1908,32436
251360,201801,65,57,8,54171.94,7632,61803.94
251365,201801,14,14,0,13356,0,13356
251370,201801,5257,3573,1684,3404066.28,1605202,5009268.28
251380,201801,49,39,10,37206,9540,46746
251385,201801,2,2,0,1908,0,1908
251390,201801,660,526,134,500660.2,126596,627256.2
251392,201801,31,21,10,20034,9540,29574
251394,201801,9,9,0,8586,0,8586
251396,201801,20,15,5,14310,4770,19080
251398,201801,17,15,2,14310,1908,16218
251400,201801,38,31,7,29574,6678,36252
251410,201801,35,30,5,28620,4770,33390
251420,201801,108,81,27,77274,25758,103032
251430,201801,38,36,2,34344,1908,36252
251440,201801,35,22,13,20988,12402,33390
251445,201801,52,47,5,44838,4770,49608
251450,201801,417,368,49,349416.8,46746,396162.8
251455,201801,2,1,1,954,954,1908
251460,201801,17,13,4,12402,3816,16218
251465,201801,5,2,3,1908,2862,4770
251470,201801,45,36,9,34344,8586,42930
251480,201801,24,22,2,20988,1908,22896
251490,201801,129,91,38,86337,35299,121636
251500,201801,116,94,22,89676,20225,109901
251510,201801,34,26,8,24804,7632,32436
251520,201801,25,25,0,23850,0,23850
251530,201801,4529,3173,1356,3021028.24,1293328.26,4314356.50
251540,201801,73,65,8,62010,7632,69642
251550,201801,411,318,93,302418.2,88198,390616.2
251560,201801,21,16,5,15264,4770,20034
251570,201801,18,18,0,17172,0,17172
251580,201801,119,97,22,92538,20988,113526
251590,201801,128,94,34,89676,32436,122112
251593,201801,18,10,8,9540,7632,17172
251597,201801,60,50,10,47700,9540,57240
251600,201801,1104,786,318,748543.28,301763.92,1050307.20
251610,201801,210,158,52,150064.2,48941,199005.2
251615,201801,2,2,0,1908,0,1908
251620,201801,4239,2839,1400,2698283,1332835.28,4031118.28
251630,201801,448,329,119,313866,113230.8,427096.8
251640,201801,149,107,42,102078,40068,142146
251650,201801,263,191,72,180381.1,68688,249069.1
251660,201801,218,200,18,189846.1,16981.2,206827.3
251670,201801,360,283,77,268286,73458,341744
251675,201801,3,3,0,2862,0,2862
251680,201801,88,80,8,76320,7632,83952
251690,201801,337,283,54,269028,51165.89,320193.89
251700,201801,282,235,47,223603.29,44823.69,268426.98
251710,201801,19,12,7,11448,6678,18126
251720,201801,33,22,11,20988,10208,31196
251740,201801,10,8,2,7632,1908,9540
260005,201801,3098,1762,1336,1670516.79,1273377.1,2943893.89
260010,201801,1417,1015,402,964589.54,381505.32,1346094.86
260020,201801,430,377,53,359658,50562,410220
260030,201801,571,412,159,392280.98,151686,543966.98
260040,201801,856,519,337,494038.44,321345.36,815383.80
260050,201801,1119,800,319,762962,303754,1066716
260060,201801,410,372,38,354124.8,36252,390376.8
260070,201801,1442,901,541,855451,514098.36,1369549.36
260080,201801,724,574,150,546642.1,143100,689742.1
260090,201801,569,353,216,336534.12,206064,542598.12
260100,201801,225,155,70,146869.2,66780,213649.2
260105,201801,234,131,103,124974,98262,223236
260110,201801,2724,2032,692,1938509.46,659358,2597867.46
260120,201801,2903,1466,1437,1388845.95,1368610.1,2757456.05
260130,201801,148,101,47,96354,44838,141192
260140,201801,2086,1370,716,1298489.96,681519.46,1980009.42
260150,201801,228,149,79,142146,75366,217512
260160,201801,293,253,40,241362,38160,279522
260170,201801,3332,2033,1299,1933390.58,1238148.9,3171539.48
260180,201801,135,115,20,109710,19080,128790
260190,201801,2251,1607,644,1529927.9,614376,2144303.9
260200,201801,891,736,155,701369.08,147584,848953.08
260210,201801,1404,989,415,943355.27,394661.11,1338016.38
260220,201801,713,654,59,623127,56286,679413
260230,201801,1190,901,289,857362.99,275706,1133068.99
260240,201801,216,163,53,154328.58,50562,204890.58
260250,201801,71,56,15,53424,14310,67734
260260,201801,987,708,279,675432,266166,941598
260270,201801,432,351,81,333471.2,76987.8,410459.0
260280,201801,1239,860,379,819866.64,361280,1181146.64
260290,201801,6338,3360,2978,3186636.35,2834283,6020919.35
260300,201801,835,734,101,698167.6,96068,794235.6
260310,201801,499,397,102,377359.47,97308,474667.47
260320,201801,876,662,214,631261.2,204156,835417.2
260330,201801,32,27,5,25758,4770,30528
260340,201801,66,48,18,45792,17172,62964
260345,201801,5598,3140,2458,2989097.43,2343645.54,5332742.97
260350,201801,465,340,125,322616.08,118297,440913.08
260360,201801,280,141,139,134514,132606,267120
260370,201801,643,419,224,397116.4,213556,610672.4
260380,201801,601,431,170,411174,161035.56,572209.56
260390,201801,292,250,42,237421.98,39114,276535.98
260392,201801,93,81,12,77274,11448,88722
260400,201801,4077,2337,1740,2219068.26,1659598.22,3878666.48
260410,201801,14169,7674,6495,7306244.57,6193499,13499743.57
260415,201801,123,111,12,105894,11448,117342
260420,201801,1765,1046,719,992368.2,684129.64,1676497.84
260430,201801,191,174,17,164784.66,16218,181002.66
260440,201801,230,167,63,158594,60102,218696
260450,201801,477,345,132,327845,125928,453773
260460,201801,856,457,399,433308.8,380641.23,813950.03
260470,201801,373,229,144,217702.8,136184.1,353886.9
260480,201801,203,126,77,120204,73458,193662
260490,201801,206,166,40,158364,38160,196524
260500,201801,1121,749,372,712258.2,353791.8,1066050.0
260510,201801,731,581,150,554274,142146,696420
260515,201801,258,230,28,219420,26235,245655
260520,201801,3284,1946,1338,1848081.88,1274535.82,3122617.70
260530,201801,772,623,149,591522.64,142146,733668.64
260540,201801,573,430,143,410220,135468.72,545688.72
260545,201801,14,10,4,9540,3816,13356
260550,201801,341,212,129,202248,123066,325314
260560,201801,514,387,127,368607,120871.8,489478.8
260570,201801,1007,831,176,789769.8,167617.8,957387.6
260580,201801,269,241,28,229914,26712,256626
260590,201801,651,369,282,350614.08,269028,619642.08
260600,201801,8186,4157,4029,3942312.68,3840417.63,7782730.31
260610,201801,493,328,165,312912,157123.8,470035.8
260620,201801,3611,1876,1735,1778014.79,1650197.81,3428212.60
260630,201801,70,67,3,63918,2862,66780
260640,201801,3619,1974,1645,1879877.58,1568959.02,3448836.60
260650,201801,337,232,105,221328,100127.07,321455.07
260660,201801,492,335,157,319208.4,149157.9,468366.3
260670,201801,101,76,25,72504,23850,96354
260680,201801,3673,2041,1632,1929276.72,1555897.76,3485174.48
260690,201801,121,93,28,88722,26712,115434
260700,201801,326,199,127,189082.8,120324,309406.8
260710,201801,36,33,3,31482,2862,34344
260720,201801,2200,1323,877,1256254.45,835579.98,2091834.43
260730,201801,586,442,144,421668,135181.8,556849.8
260740,201801,61,57,4,54378,3816,58194
260750,201801,638,444,194,423251.64,185076,608327.64
260760,201801,623,343,280,327222,266803,594025
260765,201801,993,521,472,494091.8,450049.5,944141.3
260770,201801,223,167,56,159318,53424,212742
260775,201801,814,482,332,458445.8,316719,775164.8
260780,201801,271,173,98,165042,93358.44,258400.44
260790,201801,12419,6801,5618,6459320.43,5352289.13,11811609.56
260795,201801,157,108,49,101868.12,46746,148614.12
260800,201801,284,233,51,221805,48654,270459
260805,201801,177,114,63,108027.14,60102,168129.14
260810,201801,739,643,96,612172.26,91584,703756.26
260820,201801,315,211,104,199964.79,99216,299180.79
260825,201801,207,142,65,135090.99,62010,197100.99
260830,201801,262,168,94,160128.9,89676,249804.9
260840,201801,229,166,63,157697,59816,217513
260845,201801,210,147,63,139951.8,60102,200053.8
260850,201801,506,368,138,349408.09,131652,481060.09
260860,201801,254,190,64,181062.34,61056,242118.34
260870,201801,366,259,107,247086,102078,349164
260875,201801,690,482,208,458714.69,198432,657146.69
260880,201801,1553,949,604,903387.09,576025.2,1479412.29
260890,201801,2429,1695,734,1610589.36,699283,2309872.36
260900,201801,1030,701,329,667451.79,313866,981317.79
260910,201801,278,217,61,207018,58194,265212
260915,201801,306,203,103,193662,98142,291804
260920,201801,173,98,75,93492,71550,165042
260930,201801,389,333,56,317682,53324.14,371006.14
260940,201801,2746,1503,1243,1429380.89,1185097.92,2614478.81
260950,201801,1970,1145,825,1085023.82,787050,1872073.82
260960,201801,14200,7375,6825,6999887.59,6503575.61,13503463.20
260970,201801,435,373,62,355842,59148,414990
260980,201801,197,173,24,164756,22896,187652
260990,201801,2551,2103,448,2005756.42,426724.2,2432480.62
261000,201801,4311,2547,1764,2416605.76,1681244.54,4097850.30
261010,201801,189,138,51,131652,47836.23,179488.23
261020,201801,603,449,154,428203,146105.1,574308.1
261030,201801,219,161,58,153594,55126.89,208720.89
261040,201801,360,324,36,309096,33771.8,342867.8
261050,201801,467,412,55,393048,52470,445518
261060,201801,1315,864,451,822110.75,430254,1252364.75
261070,201801,9008,4613,4395,4376326.93,4184934.45,8561261.38
261080,201801,384,295,89,280658,84906,365564
261090,201801,2207,1694,513,1607496.05,488630,2096126.05
261100,201801,1086,770,316,732243.6,299594.16,1031837.76
261110,201801,8036,4927,3109,4695408.59,2963695.69,7659104.28
261120,201801,278,230,48,219420,45787.23,265207.23
261130,201801,573,331,242,315440.9,230868,546308.9
261140,201801,188,119,69,113526,65826,179352
261150,201801,659,387,272,369198,258820.2,628018.2
261153,201801,74,71,3,66780.31,2862,69642.31
261160,201801,76620,38820,37800,36911718.2,36037247.68,72948965.88
261170,201801,451,337,114,320582.36,108756,429338.36
261180,201801,1767,1079,688,1023823.86,656352,1680175.86
261190,201801,616,425,191,405053.92,182205,587258.92
261200,201801,212,187,25,177680.3,23850,201530.3
261210,201801,36,32,4,30528,3816,34344
261220,201801,2500,1767,733,1679850.95,698137.8,2377988.75
261230,201801,318,238,80,227052,76305.69,303357.69
261240,201801,443,384,59,362322.95,56286,418608.95
261245,201801,222,186,36,177444,34344,211788
261247,201801,151,113,38,107802,36252,144054
261250,201801,2848,1435,1413,1368417.8,1346891.83,2715309.63
261255,201801,253,231,22,220374,20988,241362
261260,201801,848,729,119,695466,113526,808992
261270,201801,173,134,39,127836,37206,165042
261280,201801,157,128,29,122112,27666,149778
261290,201801,129,90,39,85621.5,37206,122827.5
261300,201801,1236,874,362,833796,345348,1179144
261310,201801,757,508,249,484632,236925.9,721557.9
261320,201801,539,367,172,350118,164088,514206
261330,201801,814,647,167,614239.5,158472.46,772711.96
261340,201801,309,173,136,165042,129744,294786
261350,201801,784,562,222,535194.2,211788,746982.2
261360,201801,1200,772,428,736086.37,408312,1144398.37
261370,201801,4954,3041,1913,2886141.82,1821782.91,4707924.73
261380,201801,572,420,152,398781.64,144722,543503.64
261390,201801,3412,2283,1129,2173202.84,1073205.3,3246408.14
261400,201801,276,251,25,238881.6,23850,262731.6
261410,201801,1053,697,356,664938,339619.23,1004557.23
261420,201801,877,543,334,517041.46,318617.46,835658.92
261430,201801,328,298,30,283446,28333.8,311779.8
261440,201801,106,95,11,90630,10494,101124
261450,201801,2489,2067,422,1969448.24,401577.04,2371025.28
261460,201801,714,568,146,540918.02,139284,680202.02
261470,201801,245,188,57,178542,54378,232920
261480,201801,344,283,61,268743,58190,326933
261485,201801,338,205,133,194902.2,126882,321784.2
261500,201801,632,425,207,405450,197478,602928
261510,201801,40,28,12,26712,11448,38160
261520,201801,155,140,15,133560,14310,147870
261530,201801,4166,2635,1531,2505592.94,1459320.69,3964913.63
261540,201801,1075,662,413,631084.36,394002,1025086.36
261550,201801,285,140,145,132178,138310.92,270488.92
261560,201801,782,522,260,494746.2,246751.6,741497.8
261570,201801,364,285,79,271890,75366,347256
261580,201801,372,291,81,276850,77274,354124
261590,201801,191,154,37,146916,35298,182214
261600,201801,288,230,58,218657,54855,273512
261610,201801,104,89,15,84551.69,14310,98861.69
261618,201801,64,50,14,47700,13356,61056
261620,201801,203,122,81,116388,77274,193662
261630,201801,589,452,137,428847.6,130698,559545.6
261640,201801,6281,3342,2939,3179953.09,2800954.92,5980908.01
261650,201801,474,295,179,280752.66,170766,451518.66
270010,201801,521,457,64,435692,60293,495985
270020,201801,302,239,63,228002,60102,288104
270030,201801,9113,5810,3303,5529170.85,3148609.96,8677780.81
270040,201801,1930,1180,750,1125138.06,713973.6,1839111.66
270050,201801,175,128,47,122112,44838,166950
270060,201801,118,65,53,62010,50562,112572
270070,201801,905,657,248,624763.14,236287.26,861050.40
270080,201801,40,34,6,32436,5724,38160
270090,201801,20,16,4,15264,3816,19080
270100,201801,1260,826,434,784843.33,411889.7,1196733.03
270110,201801,154,114,40,108756,38160,146916
270120,201801,223,182,41,172776.55,39031.2,211807.75
270130,201801,261,182,79,173341.8,75079.8,248421.6
270135,201801,96,59,37,56286,35298,91584
270140,201801,1265,762,503,726755.27,478613,1205368.27
270150,201801,265,213,52,203202,49608,252810
270160,201801,513,380,133,362520,126214.2,488734.2
270170,201801,702,449,253,427201.2,240551.1,667752.3
270180,201801,72,55,17,52152.04,16008.12,68160.16
270190,201801,103,90,13,85860,12402,98262
270200,201801,107,96,11,91393.2,10494,101887.2
270210,201801,482,246,236,234684,224857.8,459541.8
270220,201801,189,149,40,142146,38160,180306
270230,201801,2078,1240,838,1177926.74,796596.19,1974522.93
270235,201801,740,553,187,527253.43,178032.95,705286.38
270240,201801,3086,2382,704,2260817.03,668537.8,2929354.83
270250,201801,172,120,52,114480,49608,164088
270255,201801,222,192,30,183168,28238.4,211406.4
270260,201801,322,256,66,244224,62964,307188
270270,201801,115,48,67,45783,63918,109701
270280,201801,210,131,79,124974,75366,200340
270290,201801,1165,871,294,829856.78,279589.92,1109446.70
270300,201801,265,166,99,158364,94159.8,252523.8
270310,201801,923,737,186,700859.83,176720.04,877579.87
270320,201801,887,754,133,718248.8,126595.8,844844.6
270330,201801,268,223,45,211788,42930,254718
270340,201801,60,47,13,44838,12402,57240
270350,201801,93,48,45,45267.3,42930,88197.3
270360,201801,72,38,34,36252,32436,68688
270370,201801,52,39,13,37206,12402,49608
270375,201801,62,33,29,31482,27662,59144
270380,201801,1080,605,475,576216,453150,1029366
270390,201801,196,105,91,100170,86814,186984
270400,201801,704,510,194,485325.27,185067,670392.27
270410,201801,698,496,202,472667.53,192698.46,665365.99
270420,201801,398,259,139,245388,132521.38,377909.38
270430,201801,31987,22778,9209,21674767.35,8776678.91,30451446.26
270440,201801,493,384,109,365525.1,103699.8,469224.9
270450,201801,764,397,367,378499.5,348878.66,727378.16
270460,201801,197,148,49,141192,46746,187938
270470,201801,1341,886,455,844890.69,434070,1278960.69
270480,201801,527,423,104,400461.88,98500.5,498962.38
270490,201801,25,21,4,20034,3816,23850
270500,201801,512,420,92,400680,87768,488448
270510,201801,734,450,284,429300,270936,700236
270520,201801,387,235,152,223837.9,145008,368845.9
270530,201801,64,56,8,53424,7632,61056
270540,201801,124,95,29,90630,27666,118296
270550,201801,1713,1298,415,1237015.28,395905.23,1632920.51
270560,201801,315,143,172,136422,164088,300510
270570,201801,446,294,152,279648.66,145008,424656.66
270580,201801,77,55,22,52470,20988,73458
270590,201801,82,68,14,64872,13356,78228
270600,201801,176,146,30,139284,28620,167904
270610,201801,175,139,36,132597,34344,166941
270620,201801,30,29,1,27666,954,28620
270630,201801,3829,2904,925,2759558.43,880294.96,3639853.39
270640,201801,902,659,243,626982.6,231507.8,858490.4
270642,201801,208,175,33,166950,31482,198432
270644,201801,281,193,88,183931.74,83947.23,267878.97
270650,201801,236,136,100,129744,95400,225144
270660,201801,257,207,50,197478,47700,245178
270670,201801,3159,2395,764,2274012.82,726887.27,3000900.09
270680,201801,463,268,195,255663,186025.23,441688.23
270690,201801,1115,696,419,662251.76,399716.46,1061968.22
270700,201801,36,27,9,25758,8586,34344
270710,201801,868,650,218,618481.34,207972,826453.34
270720,201801,245,185,60,176490,56953.8,233443.8
270730,201801,1871,1086,785,1033803.4,746784.2,1780587.6
270740,201801,46,29,17,27666,16218,43884
270750,201801,630,460,170,438650,161513,600163
270760,201801,309,225,84,214650,80136,294786
270770,201801,2692,1695,997,1609756.28,950184,2559940.28
270780,201801,92,57,35,54373.23,33372.46,87745.69
270790,201801,272,182,90,173628,85860,259488
270800,201801,1977,1568,409,1494914,389441.88,1884355.88
270810,201801,319,250,69,238485.69,65817.23,304302.92
270820,201801,155,99,56,94446,53329,147775
270830,201801,949,683,266,650819,253478,904297
270840,201801,1410,1023,387,975035.7,367530,1342565.7
270850,201801,1704,1037,667,984476.56,636299.46,1620776.02
270860,201801,2443,1578,865,1502406.23,822312.57,2324718.80
270870,201801,123,67,56,63918,53424,117342
270880,201801,906,659,247,626850.14,234744.58,861594.72
270890,201801,361,263,98,250453.62,93487.23,343940.85
270895,201801,72,62,10,59148,9540,68688
270900,201801,107,83,24,79182,22896,102078
270910,201801,324,257,67,244033.2,63918,307951.2
270915,201801,1803,1072,731,1017810.26,696655.1,1714465.36
270920,201801,473,394,79,375876,75366,451242
270930,201801,6206,4464,1742,4252570.7,1658802.55,5911373.25
270940,201801,2371,1786,585,1702622.88,557118,2259740.88
280010,201801,44,39,5,37206,4770,41976
280020,201801,699,599,100,569507.03,94446,663953.03
280030,201801,19060,12182,6878,11542891.81,6533678.43,18076570.24
280040,201801,339,214,125,204156,117819,321975
280050,201801,377,292,85,278281.8,81090,359371.8
280060,201801,323,214,109,201909.43,103986,305895.43
280067,201801,980,687,293,652639.94,278568.25,931208.19
280070,201801,128,106,22,101124,20988,122112
280100,201801,616,485,131,459850.27,124784,584634.27
280110,201801,75,71,4,67734,3816,71550
280120,201801,624,502,122,478908,116388,595296
280130,201801,1337,830,507,790389.8,483534.9,1273924.7
280140,201801,465,374,91,355937.4,85573.8,441511.2
280150,201801,314,231,83,219694.09,79182,298876.09
280160,201801,99,84,15,80136,14310,94446
280170,201801,582,390,192,370577.56,182357.1,552934.66
280190,201801,27,25,2,23850,1908,25758
280200,201801,23,15,8,14310,7632,21942
280210,201801,2742,1934,808,1827380.11,765196.87,2592576.98
280220,201801,40,31,9,29574,8586,38160
280230,201801,309,254,55,241481.63,52470,293951.63
280240,201801,112,106,6,100980.9,5724,106704.9
280250,201801,21,12,9,11448,8586,20034
280260,201801,77,68,9,64872,8586,73458
280270,201801,158,123,35,117342,33390,150732
280280,201801,197,125,72,119250,68688,187938
280290,201801,3041,2202,839,2086661.41,799095.25,2885756.66
280300,201801,1087,822,265,782523.27,252046.8,1034570.07
280310,201801,105,100,5,94932.22,4770,99702.22
280320,201801,657,447,210,426429,200340,626769
280330,201801,355,255,100,243270,95275.98,338545.98
280340,201801,412,330,82,313348.57,77465,390813.57
280350,201801,3381,2606,775,2477110.59,736610.21,3213720.80
280360,201801,465,295,170,281430,161226,442656
280370,201801,99,87,12,82998,11448,94446
280380,201801,56,41,15,39114,14310,53424
280390,201801,186,154,32,146916,30528,177444
280400,201801,346,232,114,220469.8,108756,329225.8
280410,201801,291,234,57,222074,54368.46,276442.46
280420,201801,176,147,29,140238,27666,167904
280430,201801,106,78,28,74412,26603.63,101015.63
280440,201801,671,514,157,486446.9,149577.66,636024.56
280445,201801,113,105,8,100170,7632,107802
280450,201801,1058,903,155,858123,147870,1005993
280460,201801,732,530,202,498759.44,192708,691467.44
280470,201801,190,173,17,165042,15265,180307
280480,201801,2234,1588,646,1500157.5,612338.09,2112495.59
280490,201801,362,332,30,315219,28620,343839
280500,201801,45,40,5,38160,4770,42930
280510,201801,147,115,32,109409.2,30242,139651.2
280520,201801,55,41,14,39114,13356,52470
280530,201801,77,54,23,51516,21942,73458
280540,201801,500,400,100,381600,95113.8,476713.8
280550,201801,701,648,53,615576.6,50562,666138.6
280560,201801,470,407,63,385272.9,60102,445374.9
280570,201801,1771,1346,425,1280355.47,404595.37,1684950.84
280580,201801,595,453,142,430494.6,135373,565867.6
280590,201801,161,97,64,92258.48,61056,153314.48
280600,201801,353,296,57,281639.88,54378,336017.88
280610,201801,145,110,35,104734,33390,138124
280620,201801,544,443,101,421369.24,95400.9,516770.14
280630,201801,165,136,29,129744,27666,157410
280640,201801,209,166,43,157535,41022,198557
280650,201801,78,52,26,49608,24804,74412
280660,201801,128,92,36,87768,34105.5,121873.5
280670,201801,1597,1001,596,949875.74,564839.95,1514715.69
280680,201801,178,151,27,142271.02,25758,168029.02
280690,201801,48,41,7,39114,6678,45792
280700,201801,17,17,0,16218,0,16218
280710,201801,1410,1063,347,1006359.79,330370.2,1336729.99
280720,201801,107,73,34,68036.4,32436,100472.4
280730,201801,25,21,4,20034,3816,23850
280740,201801,2370,1743,627,1657983.71,596099.25,2254082.96
280750,201801,291,251,40,239454,38160,277614
280760,201801,873,594,279,565531.2,266022.9,831554.1
290010,201801,196,130,66,124020,62964,186984
290020,201801,177,164,13,156456,12402,168858
290030,201801,588,379,209,360898.2,199386,560284.2
290035,201801,141,114,27,105551.7,25758,131309.7
290040,201801,267,169,98,161226,93492,254718
290050,201801,72,53,19,50562,18126,68688
290060,201801,255,111,144,105607.8,137376,242983.8
290070,201801,5550,2730,2820,2596981.67,2686518.7,5283500.37
290080,201801,501,229,272,218160.72,259469,477629.72
290090,201801,382,166,216,158364,206064,364428
290100,201801,1582,1037,545,984915.1,519357.8,1504272.9
290110,201801,753,441,312,419088.2,297409.5,716497.7
290115,201801,212,196,16,186030,15264,201294
290120,201801,782,507,275,483010.2,262350,745360.2
290130,201801,420,248,172,236296.26,164088,400384.26
290135,201801,295,225,70,213972.66,66780,280752.66
290140,201801,298,244,54,232776,51325.2,284101.2
290150,201801,127,95,32,90630,30528,121158
290160,201801,245,190,55,180020.58,52470,232490.58
290170,201801,89,63,26,60102,24804,84906
290180,201801,152,119,33,113526,31482,145008
290190,201801,451,365,86,347924,81757.8,429681.8
290195,201801,300,173,127,165042,121158,286200
290200,201801,285,241,44,229914,41976,271890
290205,201801,137,84,53,80136,50562,130698
290210,201801,1111,807,304,768734.2,290016,1058750.2
290220,201801,216,118,98,112095,93492,205587
290225,201801,278,104,174,99216,165996,265212
290230,201801,64,41,23,39114,21942,61056
290240,201801,308,122,186,116101.8,177444,293545.8
290250,201801,271,245,26,233034,24804,257838
290260,201801,275,228,47,216749,44838,261587
290265,201801,183,150,33,142283,31482,173765
290270,201801,1376,1133,243,1078878.2,230959,1309837.2
290280,201801,466,347,119,331038,113526,444564
290290,201801,1203,698,505,661372.29,481770,1143142.29
290300,201801,449,381,68,362944.73,64872,427816.73
290310,201801,319,140,179,133560,170766,304326
290320,201801,3927,2444,1483,2328873.84,1411921,3740794.84
290323,201801,184,159,25,151400,23850,175250
290327,201801,148,117,31,111346.11,29574,140920.11
290330,201801,70,35,35,33390,33390,66780
290340,201801,907,359,548,341513,522251.08,863764.08
290350,201801,585,347,238,330275,227052,557327
290360,201801,365,274,91,259489.69,86814,346303.69
290370,201801,918,354,564,337716,538056,875772
290380,201801,302,185,117,176490,111618,288108
290390,201801,2469,1532,937,1458555.58,891990,2350545.58
290395,201801,242,133,109,126357.8,103986,230343.8
290400,201801,277,205,72,195128,68688,263816
290405,201801,258,222,36,211788,34344,246132
290410,201801,555,473,82,449190.9,78228,527418.9
290420,201801,231,179,52,170766,49608,220374
290430,201801,504,314,190,299556,181260,480816
290440,201801,71,62,9,59148,7949.96,67097.96
290450,201801,232,178,54,169812,51516,221328
290460,201801,1864,1105,759,1052219.04,723609.52,1775828.56
290470,201801,1443,603,840,574133.22,801045.36,1375178.58
290475,201801,589,552,37,525893,35298,561191
290480,201801,289,162,127,154548,121158,275706
290485,201801,220,206,14,196524,13356,209880
290490,201801,1142,816,326,778464,310050.2,1088514.2
290500,201801,662,331,331,314820,315774,630594
290510,201801,217,165,52,156457,49608,206065
290515,201801,135,78,57,74412,54378,128790
290520,201801,1374,879,495,836944.62,468988.42,1305933.04
290530,201801,312,283,29,269982,27666,297648
290540,201801,93,56,37,53424,35298,88722
290550,201801,150,128,22,122112,20635.02,142747.02
290560,201801,3365,1359,2006,1295474.76,1913529.59,3209004.35
290570,201801,5802,2993,2809,2850710.81,2676970.95,5527681.76
290580,201801,1229,710,519,676099.8,494410.5,1170510.3
290590,201801,530,439,91,418043,86814,504857
290600,201801,1713,1188,525,1128392.85,500821.38,1629214.23
290610,201801,218,196,22,186527,20988,207515
290620,201801,320,282,38,269028,35679.6,304707.6
290630,201801,2110,893,1217,847237.6,1155396.1,2002633.7
290640,201801,150,123,27,117342,25758,143100
290650,201801,1698,802,896,764145,854784,1618929
290660,201801,279,226,53,215604,50562,266166
290670,201801,982,513,469,488830,447080.38,935910.38
290680,201801,1179,947,232,902484,220374,1122858
290682,201801,291,212,79,201261.3,75347.46,276608.76
290685,201801,228,145,83,137376,79182,216558
290687,201801,935,619,316,587139.6,299432.18,886571.78
290689,201801,127,74,53,70582,50547.69,121129.69
290690,201801,648,270,378,257551.92,359732.8,617284.72
290700,201801,241,114,127,108756,121158,229914
290710,201801,690,454,236,433116,225144,658260
290720,201801,1019,832,187,793728,177921,971649
290730,201801,1109,633,476,602021.7,453150,1055171.7
290740,201801,15,12,3,11448,2862,14310
290750,201801,1339,607,732,577745.08,696216.1,1273961.18
290755,201801,69,61,8,58194,7632,65826
290760,201801,297,258,39,246132,37206,283338
290770,201801,185,173,12,165032.46,11448,176480.46
290780,201801,970,779,191,741222.66,180401.4,921624.06
290790,201801,372,260,112,247461,106848,354309
290800,201801,2619,1046,1573,995714.04,1499525.82,2495239.86
290810,201801,437,303,134,288776,127836,416612
290820,201801,378,234,144,222268,137376,359644
290830,201801,390,261,129,248994,123066,372060
290840,201801,1664,1021,643,971602.8,611342.48,1582945.28
290850,201801,755,416,339,396673.2,322452,719125.2
290860,201801,653,290,363,276660,346016,622676
290870,201801,658,479,179,456031.8,170766,626797.8
290880,201801,125,68,57,64872,54378,119250
290890,201801,322,228,94,217512,89676,307188
290900,201801,169,128,41,122112,39114,161226
290910,201801,358,271,87,258534,82998,341532
290920,201801,229,194,35,185076,33390,218466
290930,201801,806,610,196,581940,186965,768905
290940,201801,251,205,46,194806.8,43884,238690.8
290950,201801,170,98,72,93492,68688,162180
290960,201801,436,291,145,276374.24,138043.8,414418.04
290970,201801,252,221,31,210643.2,29277,239920.2
290980,201801,1471,1042,429,989899.76,408217.2,1398116.96
290990,201801,366,310,56,295711.92,53368.38,349080.30
291000,201801,854,237,617,226098,588045.6,814143.6
291005,201801,2069,881,1188,838985.76,1132575.03,1971560.79
291010,201801,157,142,15,135468,14310,149778
291020,201801,103,81,22,77274,20988,98262
291030,201801,91,66,25,62964,23850,86814
291040,201801,583,290,293,276660,279522,556182
291050,201801,1333,754,579,717671.23,552079.8,1269751.03
291060,201801,1479,814,665,775888.2,634410,1410298.2
291070,201801,1889,1396,493,1325161.87,468298.3,1793460.17
291072,201801,7271,2674,4597,2547647.58,4383059.42,6930707.00
291075,201801,198,159,39,151686,37206,188892
291077,201801,49,33,16,31482,15264,46746
291080,201801,19309,8404,10905,7994822.04,10390550.7,18385372.74
291085,201801,288,230,58,219420,55327.23,274747.23
291090,201801,304,115,189,109424,180296.46,289720.46
291100,201801,687,198,489,188892,466506,655398
291110,201801,400,305,95,290950.92,90630,381580.92
291120,201801,2500,1170,1330,1116037,1266841.92,2382878.92
291125,201801,59,31,28,29574,26712,56286
291130,201801,212,185,27,176490,25758,202248
291140,201801,121,90,31,85860,29288,115148
291150,201801,378,148,230,141192,219420,360612
291160,201801,359,301,58,286200.5,55332,341532.5
291165,201801,22,18,4,17172,3816,20988
291170,201801,2864,1443,1421,1372854.11,1352581.8,2725435.91
291180,201801,1317,508,809,484435.38,771652.68,1256088.06
291185,201801,74,72,2,68688,1908,70596
291190,201801,1243,527,716,501225.43,682520.8,1183746.23
291200,201801,164,118,46,112572,43884,156456
291210,201801,2187,849,1338,806807.34,1274640.14,2081447.48
291220,201801,261,196,65,186030.64,62010,248040.64
291230,201801,1027,343,684,326364,652536,978900
291240,201801,439,417,22,396578,20988,417566
291250,201801,425,347,78,331038,74412,405450
291260,201801,40,30,10,28620,9540,38160
291270,201801,1202,487,715,464598,681585.8,1146183.8
291280,201801,375,171,204,162943.2,194320.26,357263.46
291290,201801,1737,870,867,828835.2,826070,1654905.2
291300,201801,224,177,47,168190.2,44838,213028.2
291310,201801,228,204,24,194330,22896,217226
291320,201801,1385,990,395,941598,375781.29,1317379.29
291330,201801,125,106,19,100265.4,18126,118391.4
291340,201801,140,80,60,76320,57240,133560
291345,201801,127,83,44,79182,41976,121158
291350,201801,1565,492,1073,468891,1023451.3,1492342.3
291360,201801,8563,4197,4366,3992650.61,4161880.55,8154531.16
291370,201801,1078,592,486,564482,463644,1028126
291380,201801,254,201,53,191754,50562,242316
291390,201801,3875,1674,2201,1592544,2097942,3690486
291400,201801,2073,1477,596,1403907.39,566901.51,1970808.90
291410,201801,154,135,19,127836,18126,145962
291420,201801,106,77,29,73458,27666,101124
291430,201801,172,95,77,89923,72504.53,162427.53
291440,201801,489,391,98,370576.5,93492,464068.5
291450,201801,880,546,334,518691.68,317682,836373.68
291460,201801,1719,1402,317,1335027.6,302418,1637445.6
291465,201801,2197,1020,1177,972711.06,1122576.14,2095287.20
291470,201801,2765,1401,1364,1332768.47,1300526,2633294.47
291480,201801,11840,5222,6618,4970535.55,6302480.37,11273015.92
291490,201801,541,221,320,210834,305280,516114
291500,201801,369,200,169,190800,161226,352026
291510,201801,1230,457,773,434816.99,737155.8,1171972.79
291520,201801,957,433,524,413082,499886.46,912968.46
291530,201801,1009,270,739,257580,704700.92,962280.92
291535,201801,114,96,18,91584,17172,108756
291540,201801,362,110,252,104940,239454.6,344394.6
291550,201801,1175,548,627,520886.1,597567.8,1118453.9
291560,201801,5533,2840,2693,2696442.21,2556715.42,5253157.63
291570,201801,204,105,99,100170,94446,194616
291580,201801,1203,731,472,696607.46,450274.23,1146881.69
291590,201801,76,30,46,28476.9,43884,72360.9
291600,201801,1371,618,753,588618,718058,1306676
291610,201801,1385,627,758,596874.87,723076,1319950.87
291620,201801,576,267,309,254718,294404.4,549122.4
291630,201801,494,161,333,153594,317682,471276
291640,201801,3888,1940,1948,1844418.9,1857024.98,3701443.88
291650,201801,416,275,141,261215.74,133607.73,394823.47
291660,201801,440,174,266,165303.96,252666.9,417970.86
291670,201801,221,140,81,132988,77274,210262
291680,201801,705,401,304,382554,289921,672475
291685,201801,570,302,268,287870,255481.2,543351.2
291690,201801,554,283,271,269982,257580,527562
291700,201801,910,720,190,686150.19,180306,866456.19
291710,201801,1708,788,920,751056.28,876803.06,1627859.34
291720,201801,397,265,132,252805.23,125928,378733.23
291730,201801,928,537,391,510771.8,373004.46,883776.26
291733,201801,255,177,78,168571.8,74412,242983.8
291735,201801,65,49,16,46746,15264,62010
291740,201801,340,256,84,244224,80136,324360
291750,201801,1932,1285,647,1218418.78,615586.02,1834004.80
291760,201801,3068,1644,1424,1561736.54,1356111,2917847.54
291770,201801,804,542,262,514969.26,249948,764917.26
291780,201801,46,26,20,24804,19080,43884
291790,201801,166,77,89,73458,84906,158364
291800,201801,9904,3917,5987,3725466.54,5707401.8,9432868.34
291810,201801,1142,817,325,778841.03,310050,1088891.03
291820,201801,263,190,73,181260,69642,250902
291830,201801,1066,397,669,377517,637263,1014780
291835,201801,614,561,53,534717,50562,585279
291840,201801,4619,2377,2242,2262865.67,2138020.56,4400886.23
291845,201801,302,104,198,99216,188863.38,288079.38
291850,201801,322,280,42,266881.5,40068,306949.5
291855,201801,270,110,160,104940,152640,257580
291860,201801,177,109,68,103032,64872,167904
291870,201801,83,33,50,31482,47700,79182
291875,201801,182,165,17,157410,16218,173628
291880,201801,488,381,107,362664,102078,464742
291890,201801,246,79,167,75356.46,157601,232957.46
291900,201801,56,31,25,29574,23850,53424
291905,201801,141,95,46,90344,43884,134228
291910,201801,176,143,33,136422,31482,167904
291915,201801,391,347,44,329370,41976,371346
291920,201801,4901,2538,2363,2418563.61,2252393.23,4670956.84
291930,201801,181,105,76,99216.55,72504,171720.55
291940,201801,313,171,142,162437.58,134514,296951.58
291950,201801,1135,927,208,883595,198432,1082027
291955,201801,1002,595,407,567630,387849,955479
291960,201801,176,120,56,114480,53424,167904
291970,201801,782,594,188,566676,179352,746028
291980,201801,1498,1323,175,1258729.7,165996.4,1424726.1
291990,201801,122,113,9,107802,8586,116388
291992,201801,164,84,80,79372.8,76320,155692.8
291995,201801,149,105,44,100170,41976,142146
292000,201801,381,289,92,274292.95,87768,362060.95
292010,201801,278,200,78,190133,73458,263591
292020,201801,269,197,72,187938,68688,256626
292030,201801,139,109,30,103986,28620,132606
292040,201801,626,316,310,301464,295740,597204
292045,201801,90,81,9,77274,8586,85860
292050,201801,882,604,278,575206.87,265212,840418.87
292060,201801,938,771,167,734580.5,159318,893898.5
292070,201801,50,21,29,20034,27666,47700
292080,201801,113,78,35,74412,33390,107802
292090,201801,497,174,323,165805.2,308142,473947.2
292100,201801,1390,599,791,569872.7,754585.92,1324458.62
292105,201801,201,169,32,161226,30528,191754
292110,201801,2109,777,1332,740933.64,1268702.91,2009636.55
292120,201801,632,508,124,483499.79,118296,601795.79
292130,201801,445,262,183,249948,174582,424530
292140,201801,198,155,43,147870,40890.26,188760.26
292145,201801,156,83,73,79182,69613.38,148795.38
292150,201801,1404,1125,279,1073250,265138.16,1338388.16
292160,201801,181,148,33,140905.8,31482,172387.8
292170,201801,1215,1065,150,1014317.31,143042.76,1157360.07
292180,201801,198,139,59,132606,56286,188892
292190,201801,157,96,61,91584,58194,149778
292200,201801,1278,462,816,439605.71,777815.56,1217421.27
292205,201801,115,104,11,98929.8,10494,109423.8
292210,201801,364,251,113,238071,107086.5,345157.5
292220,201801,22,16,6,15264,5724,20988
292225,201801,39,36,3,34344,2862,37206
292230,201801,909,733,176,696775.03,167904,864679.03
292240,201801,617,438,179,416755,170766,587521
292250,201801,1672,1058,614,1009332,585756,1595088
292260,201801,435,242,193,230868,183358.8,414226.8
292265,201801,270,189,81,180019.8,77274,257293.8
292270,201801,770,333,437,317014.2,415944.8,732959.0
292273,201801,200,112,88,106070.49,83952,190022.49
292275,201801,163,78,85,74412,80803.8,155215.8
292280,201801,135,95,40,90630,38160,128790
292285,201801,60,50,10,47032.2,9540,56572.2
292290,201801,547,364,183,344766.47,174296,519062.47
292300,201801,1618,618,1000,588999.8,953166.58,1542166.38
292303,201801,98,67,31,63918,29574,93492
292305,201801,110,78,32,74412,30528,104940
292310,201801,796,497,299,473776,283857.52,757633.52
292320,201801,652,492,160,469081.8,152640,621721.8
292330,201801,190,98,92,93492,87768,181260
292335,201801,274,210,64,200340,61056,261396
292340,201801,568,392,176,373228.85,167904,541132.85
292350,201801,265,141,124,133703.1,118009.8,251712.9
292360,201801,701,530,171,503903,163134,667037
292370,201801,780,594,186,566676,177444,744120
292380,201801,649,501,148,476046.62,141192,617238.62
292390,201801,504,187,317,178398,300653.5,479051.5
292400,201801,3349,2059,1290,1945968.43,1226779.8,3172748.23
292405,201801,264,175,89,166473,84619.8,251092.8
292410,201801,152,89,63,84906,60102,145008
292420,201801,304,261,43,248707.8,41022,289729.8
292430,201801,519,403,116,384462,110187,494649
292440,201801,576,492,84,468147,79849.8,547996.8
292450,201801,244,189,55,180306,52470,232776
292460,201801,584,433,151,412509.8,144054,556563.8
292465,201801,191,160,31,152640,28836.09,181476.09
292467,201801,99,58,41,55332,39114,94446
292470,201801,251,170,81,162180,77274,239454
292480,201801,318,213,105,202248.5,99884,302132.5
292490,201801,218,142,76,135468,72504,207972
292500,201801,1172,506,666,482513,634906.28,1117419.28
292510,201801,3301,1482,1819,1412874.12,1732598.7,3145472.82
292520,201801,1048,499,549,474849.5,523737,998586.5
292525,201801,385,274,111,261391.23,105894,367285.23
292530,201801,4205,1721,2484,1638868.84,2367921.96,4006790.80
292540,201801,482,260,222,248040,211788,459828
292550,201801,1059,566,493,539222.74,469836.8,1009059.54
292560,201801,317,298,19,284292,18126,302418
292570,201801,300,229,71,218137,67734,285871
292575,201801,456,292,164,278282,156456,434738
292580,201801,896,565,331,537579,315488,853067
292590,201801,506,436,70,415641.59,66780,482421.59
292593,201801,143,112,31,106848,29574,136422
292595,201801,176,135,41,128790,39114,167904
292600,201801,1237,921,316,878317,300796.2,1179113.2
292610,201801,125,95,30,90630,28362.42,118992.42
292620,201801,519,431,88,410879,83952,494831
292630,201801,1355,784,571,746348,543112.68,1289460.68
292640,201801,766,534,232,509102.1,221328,730430.1
292650,201801,174,149,25,141710,23850,165560
292660,201801,1987,1425,562,1353626.85,531087.95,1884714.80
292665,201801,137,100,37,95400,35298,130698
292670,201801,393,319,74,304322,70596,374918
292680,201801,249,193,56,184122,52947,237069
292690,201801,179,137,42,130698,40068,170766
292700,201801,911,599,312,570492.8,297648,868140.8
292710,201801,97,85,12,81090,11192,92282
292720,201801,833,469,364,446624.64,347066,793690.64
292730,201801,202,95,107,89676.5,102078,191754.5
292740,201801,65787,32555,33232,30981863.05,31674988.79,62656851.84
292750,201801,369,263,106,249948.94,100313.57,350262.51
292760,201801,316,257,59,244167.5,56286,300453.5
292770,201801,780,331,449,315468,428346,743814
292780,201801,422,160,262,152412.48,249948,402360.48
292790,201801,731,355,376,338670,358465.5,697135.5
292800,201801,1136,697,439,663251.9,418806,1082057.9
292805,201801,423,122,301,115863.3,287154,403017.3
292810,201801,1460,847,613,807179.8,584506.46,1391686.26
292820,201801,744,598,146,568584.87,138988.8,707573.67
292830,201801,102,81,21,77274,20034,97308
292840,201801,651,535,116,509913,110649.69,620562.69
292850,201801,132,89,43,84902,41022,125924
292860,201801,2108,1233,875,1172210.94,834750,2006960.94
292870,201801,3352,2240,1112,2135697.8,1060828.92,3196526.72
292880,201801,1425,940,485,892993.86,462690,1355683.86
292890,201801,473,405,68,386342,64872,451214
292895,201801,137,90,47,84501.5,44838,129339.5
292900,201801,386,287,99,273798,94446,368244
292905,201801,442,226,216,215604,205874,421478
292910,201801,392,300,92,285867,87768,373635
292920,201801,531,234,297,223236,283338,506574
292925,201801,507,471,36,448656.66,34325,482981.66
292930,201801,553,341,212,325314,202248,527562
292935,201801,296,127,169,121158,161226,282384
292937,201801,239,162,77,154548,73458,228006
292940,201801,190,144,46,137376,43884,181260
292950,201801,1097,568,529,539726.5,503713,1043439.5
292960,201801,540,361,179,344394,170766,515160
292970,201801,274,190,84,180593,80136,260729
292975,201801,156,90,66,85860,62774,148634
292980,201801,258,174,84,164212.43,80136,244348.43
292990,201801,1302,959,343,907549.87,327034.93,1234584.80
293000,201801,103,74,29,70596,27656.46,98252.46
293010,201801,2652,1627,1025,1546396.92,973813.01,2520209.93
293015,201801,647,508,139,484414.49,131967,616381.49
293020,201801,333,273,60,260442,57240,317682
293030,201801,621,540,81,513634.44,77274,590908.44
293040,201801,337,265,72,252810,68688,321498
293050,201801,2702,1579,1123,1496858.89,1067212.38,2564071.27
293060,201801,254,204,50,193429,46746.8,240175.8
293070,201801,3362,1697,1665,1611085.68,1587189.92,3198275.60
293075,201801,90,58,32,55332,30528,85860
293076,201801,72,46,26,43884,24804,68688
293077,201801,428,263,165,246387.47,157410,403797.47
293080,201801,443,393,50,374922,47700,422622
293090,201801,129,111,18,105894,16854.04,122748.04
293100,201801,517,364,153,347256,145962,493218
293105,201801,338,229,109,218180,103986,322166
293110,201801,168,118,50,112572,47700,160272
293120,201801,319,214,105,204156,99979.2,304135.2
293130,201801,248,164,84,156456,80136,236592
293135,201801,7900,3134,4766,2983395.16,4538221.96,7521617.12
293140,201801,178,115,63,109710,59339,169049
293150,201801,328,278,50,263781.2,47700,311481.2
293160,201801,430,242,188,230868,179352,410220
293170,201801,190,132,58,125642,54474,180116
293180,201801,462,314,148,299270,141192,440462
293190,201801,1269,881,388,835824.73,370152,1205976.73
293200,201801,526,464,62,441576,59148,500724
293210,201801,337,245,92,233578,87052.5,320630.5
293220,201801,2689,1083,1606,1031248.41,1529930.47,2561178.88
293230,201801,1770,637,1133,606267.8,1080596,1686863.8
293240,201801,220,201,19,191754,18126,209880
293245,201801,109,92,17,87768,16218,103986
293250,201801,736,274,462,261148,439794.18,700942.18
293260,201801,313,261,52,248040.17,49608,297648.17
293270,201801,1173,552,621,524700.68,592434,1117134.68
293280,201801,235,131,104,124974,99216,224190
293290,201801,3070,2000,1070,1905848.73,1020481,2926329.73
293300,201801,691,489,202,464173.5,191181.6,655355.1
293305,201801,152,130,22,124020,20988,145008
293310,201801,136,102,34,97308,32436,129744
293315,201801,156,120,36,114480,34344,148824
293317,201801,97,68,29,64872,27666,92538
293320,201801,958,543,415,517068.5,395910,912978.5
293325,201801,181,65,116,62010,110625.84,172635.84
293330,201801,12823,5976,6847,5690187.31,6524224.55,12214411.86
293340,201801,254,182,72,173628,67734,241362
293345,201801,244,193,51,184122,48654,232776
293350,201801,622,324,298,309096,282813.3,591909.3
293360,201801,1575,1123,452,1070102,429968.7,1500070.7
310010,201801,151,74,77,70596,73172,143768
310020,201801,1053,578,475,549027.2,451059.96,1000087.16
310030,201801,323,261,62,247868.88,58861.8,306730.68
310040,201801,51,32,19,30528,18126,48654
310050,201801,180,116,64,109710.4,60770,170480.4
310060,201801,234,163,71,155025,67734,222759
310070,201801,16,8,8,7632,7632,15264
310080,201801,50,27,23,25758,21942,47700
310090,201801,955,500,455,471754.68,432925.6,904680.28
310100,201801,296,221,75,210834,71550,282384
310110,201801,732,391,341,371979.1,324360,696339.1
310120,201801,381,213,168,202534.2,159897.94,362432.14
310130,201801,33,20,13,19080,12402,31482
310140,201801,28,16,12,15264,11448,26712
310150,201801,1282,879,403,834370.6,383889.8,1218260.4
310160,201801,2106,1064,1042,1006949.53,991683.4,1998632.93
310163,201801,91,50,41,47700,39114,86814
310170,201801,2542,1041,1501,992990,1429378.6,2422368.6
310180,201801,129,48,81,45792,76892.4,122684.4
310190,201801,485,324,161,309096,153021.6,462117.6
310200,201801,504,317,187,302418,178398,480816
310205,201801,61,45,16,42930,15264,58194
310210,201801,278,225,53,214650,50562,265212
310220,201801,53,32,21,30528,20034,50562
310230,201801,261,184,77,175345.2,73458,248803.2
310240,201801,105,92,13,87529.5,12402,99931.5
310250,201801,99,80,19,76320,18126,94446
310260,201801,800,430,370,406595.7,352245.42,758841.12
310270,201801,269,181,88,172121,83952,256073
310280,201801,366,273,93,259775,88722,348497
310285,201801,221,157,64,149469.86,61056,210525.86
310290,201801,255,146,109,139284,103986,243270
310300,201801,155,128,27,122112,25758,147870
310310,201801,7,5,2,4770,1908,6678
310320,201801,22,14,8,13356,7632,20988
310330,201801,30,22,8,20988,7632,28620
310340,201801,1695,1093,602,1034979.86,572782.5,1607762.36
310350,201801,2814,1519,1295,1444304.01,1234848.8,2679152.81
310360,201801,41,33,8,31482,7632,39114
310370,201801,122,100,22,95400,20702,116102
310375,201801,102,36,66,34344,62945,97289
310380,201801,53,31,22,28668,20988,49656
310390,201801,100,70,30,66780,28620,95400
310400,201801,2302,1487,815,1414688,777204.8,2191892.8
310410,201801,128,69,59,65826,56286,122112
310420,201801,670,361,309,342104.1,293823.06,635927.16
310430,201801,332,219,113,208639.8,107802,316441.8
310440,201801,67,40,27,38160,25758,63918
310445,201801,84,67,17,63918,16218,80136
310450,201801,857,539,318,513538.2,303372,816910.2
310460,201801,267,192,75,183168,71550,254718
310470,201801,491,308,183,293832,174582,468414
310480,201801,77,53,24,50562,22896,73458
310490,201801,485,226,259,214650.2,247086,461736.2
310500,201801,128,56,72,53424,68688,122112
310510,201801,606,395,211,375590.6,201275.46,576866.06
310520,201801,131,87,44,82998,41976,124974
310530,201801,89,41,48,39114,45505.8,84619.8
310540,201801,451,280,171,264736.6,163134,427870.6
310550,201801,86,56,30,53424,28620,82044
310560,201801,2916,2006,910,1903243,866561.13,2769804.13
310570,201801,137,92,45,87768,42930,130698
310590,201801,342,223,119,211208.7,113511.69,324720.39
310600,201801,158,91,67,85049.7,63918,148967.7
310610,201801,59,21,38,20034,36252,56286
310620,201801,45467,21729,23738,20654655.12,22606301.16,43260956.28
310630,201801,589,377,212,356939.6,200754.88,557694.48
310640,201801,136,114,22,108565.2,20988,129553.2
310650,201801,159,139,20,131652,19080,150732
310660,201801,90,57,33,54378,31482,85860
310665,201801,55,40,15,38160,14310,52470
310670,201801,6286,2922,3364,2778746.31,3204478.3,5983224.61
310680,201801,54,36,18,34344,17172,51516
310690,201801,588,427,161,403152.66,153594,556746.66
310700,201801,63,40,23,38160,21798.9,59958.9
310710,201801,1240,826,414,786750.23,394383.8,1181134.03
310720,201801,86,28,58,26712,55332,82044
310730,201801,1367,943,424,899336,404496,1303832
310740,201801,1011,566,445,536626.4,424282.46,960908.86
310750,201801,243,142,101,134514.18,96354,230868.18
310760,201801,68,52,16,49608,15264,64872
310770,201801,93,45,48,42930,45792,88722
310780,201801,400,326,74,310995,70596,381591
310790,201801,98,80,18,76320,17172,93492
310800,201801,458,222,236,211311,224857.8,436168.8
310810,201801,166,116,50,109508.2,46746,156254.2
310820,201801,359,283,76,269982,72217.8,342199.8
310825,201801,192,158,34,150732,32436,183168
310830,201801,463,222,241,211127.94,229656,440783.94
310840,201801,386,219,167,208926,159318,368244
310850,201801,109,88,21,83952,20034,103986
310855,201801,376,296,80,282384,76320,358704
310860,201801,1392,1039,353,985818.1,335026.9,1320845.0
310870,201801,55,42,13,40068,12402,52470
310880,201801,81,63,18,59815.8,17172,76987.8
310890,201801,313,184,129,175536,123066,298602
310900,201801,641,293,348,276598.07,331686.8,608284.87
310910,201801,250,171,79,161799.2,75366,237165.2
310920,201801,486,290,196,272845.2,186030.4,458875.6
310925,201801,37,30,7,28620,6392,35012
310930,201801,1094,656,438,625421.33,417757.07,1043178.40
310940,201801,681,348,333,331391.8,317682,649073.8
310945,201801,117,72,45,68688,42930,111618
310950,201801,249,195,54,186030,51516,237546
310960,201801,84,31,53,29574,50558,80132
310970,201801,168,105,63,100170,59179.76,159349.76
310980,201801,46,24,22,22896,20988,43884
310990,201801,152,86,66,81758,62964,144722
311000,201801,833,422,411,399059.69,392085,791144.69
311010,201801,40,33,7,31482,6678,38160
311020,201801,41,26,15,24804,14310,39114
311030,201801,392,231,161,218466,153594,372060
311040,201801,38,33,5,31482,4770,36252
311050,201801,469,196,273,186412,259869.6,446281.6
311060,201801,753,433,320,411651.4,304994,716645.4
311070,201801,329,147,182,140238,173628,313866
311080,201801,105,57,48,54378,45792,100170
311090,201801,398,188,210,178112,200340,378452
311100,201801,615,365,250,347923.8,238213.8,586137.6
311110,201801,681,469,212,447139.8,202239,649378.8
311115,201801,66,48,18,45792,17172,62964
311120,201801,1026,536,490,510340.8,466839.9,977180.7
311130,201801,406,235,171,223999.2,163134,387133.2
311140,201801,160,76,84,72504,79325.1,151829.1
311150,201801,354,231,123,220374,117103.5,337477.5
311160,201801,743,534,209,507051.4,198909,705960.4
311170,201801,79,58,21,55332,19747.8,75079.8
311180,201801,340,226,114,215317.8,108470,323787.8
311190,201801,35,18,17,17172,16218,33390
311200,201801,337,233,104,220660.6,99216,319876.6
311205,201801,29,19,10,18126,9158.4,27284.4
311210,201801,50,41,9,38828,8586,47414
311220,201801,16,14,2,13356,1908,15264
311230,201801,1633,1057,576,1004011.94,549504,1553515.94
311240,201801,169,106,63,100920.33,60102,161022.33
311250,201801,73,31,42,29574,40068,69642
311260,201801,556,350,206,333900,196524,530424
311265,201801,112,77,35,73458,33390,106848
311270,201801,281,203,78,193662,74412,268074
311280,201801,213,97,116,92538,110091.6,202629.6
311290,201801,110,88,22,83952,20416,104368
311300,201801,546,344,202,327222.96,192422,519644.96
311310,201801,23,18,5,17172,4770,21942
311320,201801,673,504,169,479862,161226,641088
311330,201801,1035,760,275,724706.5,261396.4,986102.9
311340,201801,2609,1858,751,1765771.23,716044.86,2481816.09
311350,201801,273,211,62,201294,59148,260442
311360,201801,177,106,71,101124,67734,168858
311370,201801,1199,483,716,458788.5,682491.6,1141280.1
311380,201801,7,6,1,5724,954,6678
311390,201801,282,149,133,142146,126405.2,268551.2
311400,201801,151,99,52,94446,49599,144045
311410,201801,96,55,41,52470,39114,91584
311420,201801,293,160,133,151629.56,126882,278511.56
311430,201801,852,553,299,526514,285246,811760
311440,201801,485,338,147,322452,139951.8,462403.8
311450,201801,319,198,121,188892,115434,304326
311455,201801,304,204,100,194320.8,95113.8,289434.6
311460,201801,127,51,76,48654,71698.27,120352.27
311470,201801,20,10,10,9540,9540,19080
311480,201801,24,9,15,8586,14310,22896
311490,201801,16,10,6,9540,5724,15264
311500,201801,19,10,9,9540,8586,18126
311510,201801,624,439,185,416863.7,176203.8,593067.5
311520,201801,45,33,12,30814.2,11448,42262.2
311530,201801,1808,1346,462,1275213.52,440748,1715961.52
311535,201801,67,51,16,48654,15264,63918
311540,201801,33,29,4,27666,3816,31482
311545,201801,183,135,48,128790,45792,174582
311547,201801,30,21,9,20034,8586,28620
311550,201801,612,278,334,265212,318617.46,583829.46
311560,201801,43,28,15,26712,14310,41022
311570,201801,304,201,103,191181.6,98262,289443.6
311580,201801,303,177,126,168571.8,120204,288775.8
311590,201801,32,28,4,26712,3816,30528
311600,201801,91,72,19,68688,18126,86814
311610,201801,261,228,33,216240.54,31482,247722.54
311615,201801,97,80,17,75680.82,16218,91898.82
311620,201801,19,11,8,10494,7632,18126
311630,201801,84,71,13,67734,12402,80136
311640,201801,117,66,51,62964,48654,111618
311650,201801,128,95,33,89914.5,31482,121396.5
311660,201801,408,194,214,185076,204156,389232
311670,201801,164,105,59,99925,56286,156211
311680,201801,222,162,60,153646.95,56476.8,210123.75
311690,201801,18,11,7,10494,6678,17172
311700,201801,197,136,61,129457.8,58194,187651.8
311710,201801,217,139,78,132606,74412,207018
311720,201801,38,28,10,26712,9540,36252
311730,201801,550,360,190,342868,181260,524128
311740,201801,37,26,11,24804,10494,35298
311750,201801,706,484,222,459828.8,211788,671616.8
311760,201801,65,36,29,34344,27666,62010
311770,201801,401,192,209,181260.62,199386,380646.62
311780,201801,168,96,72,91584,68371,159955
311783,201801,79,70,9,66780,8586,75366
311787,201801,37,17,20,16218,19080,35298
311790,201801,264,125,139,119250,132606,251856
311800,201801,634,436,198,412558.3,188224.2,600782.5
311810,201801,44,36,8,34344,7632,41976
311820,201801,108,90,18,85860,17172,103032
311830,201801,1863,1189,674,1128698.5,639657.8,1768356.3
311840,201801,1012,562,450,531856.9,427704.45,959561.35
311850,201801,8,5,3,4770,2862,7632
311860,201801,9455,4324,5131,4108525.71,4886485.67,8995011.38
311870,201801,151,84,67,80136,63918,144054
311880,201801,948,707,241,672942.8,229914,902856.8
311890,201801,219,110,109,104940,103986,208926
311900,201801,90,37,53,35298,50562,85860
311910,201801,1376,854,522,811807.1,495746.3,1307553.4
311920,201801,226,149,77,141908,73458,215366
311930,201801,904,525,379,500564,361328,861892
311940,201801,2426,1246,1180,1186347.7,1123191.9,2309539.6
311950,201801,31,22,9,20988,8586,29574
311960,201801,68,48,20,45792,19080,64872
311970,201801,22,12,10,11448,9540,20988
311980,201801,43,32,11,30528,10494,41022
311990,201801,59,43,16,41022,15264,56286
311995,201801,61,42,19,40068,18126,58194
312000,201801,33,22,11,20701.8,10494,31195.8
312010,201801,85,62,23,59148,21942,81090
312015,201801,95,70,25,66494,23850,90344
312020,201801,138,85,53,81090,50562,131652
312030,201801,41,34,7,31483,6678,38161
312040,201801,80,51,29,48654,27666,76320
312050,201801,225,117,108,111618,103032,214650
312060,201801,65,40,25,38160,23182.2,61342.2
312070,201801,75,44,31,41976,29574,71550
312080,201801,526,228,298,217512,284292,501804
312083,201801,48,35,13,33390,12402,45792
312087,201801,109,87,22,82998,20988,103986
312090,201801,2829,1609,1220,1519323.5,1160068.97,2679392.47
312100,201801,160,114,46,108756,43102,151858
312110,201801,116,73,43,69642,41022,110664
312120,201801,141,103,38,98262,36252,134514
312125,201801,94,54,40,51325.2,38160,89485.2
312130,201801,121,80,41,76320,39114,115434
312140,201801,132,105,27,100170,25758,125928
312150,201801,43,35,8,33390,7632,41022
312160,201801,1530,1018,512,968215.2,487036.48,1455251.68
312170,201801,11,9,2,8586,1908,10494
312180,201801,100,60,40,56525,37874,94399
312190,201801,32,28,4,26712,3816,30528
312200,201801,727,626,101,595248.7,96354,691602.7
312210,201801,98,63,35,60102,33390,93492
312220,201801,120,90,30,85622,28620,114242
312230,201801,3456,1692,1764,1610382.18,1681217.12,3291599.30
312235,201801,138,91,47,86814,44838,131652
312240,201801,111,72,39,68688,37206,105894
312245,201801,159,105,54,100166,51516,151682
312247,201801,55,39,16,36443,15264,51707
312250,201801,184,87,97,82521,92538,175059
312260,201801,104,69,35,64968.2,33390,98358.2
312270,201801,136,85,51,81090,48654,129744
312280,201801,25,15,10,14310,9540,23850
312290,201801,162,111,51,105607.8,47701,153308.8
312300,201801,201,133,68,126882,64872,191754
312310,201801,58,53,5,50562,4770,55332
312320,201801,423,265,158,250902,149444.5,400346.5
312330,201801,86,75,11,70787,10207.8,80994.8
312340,201801,36,16,20,15264,19080,34344
312350,201801,16,10,6,9540,5724,15264
312352,201801,96,65,31,62010,29574,91584
312360,201801,560,254,306,241362,291924,533286
312370,201801,296,176,120,167617.8,114480,282097.8
312380,201801,137,87,50,82998,47700,130698
312385,201801,180,146,34,139284,32436,171720
312390,201801,297,188,109,179352,103319,282671
312400,201801,379,286,93,272844,88246,361090
312410,201801,857,275,582,261873,554652,816525
312420,201801,608,487,121,463930.2,115434,579364.2
312430,201801,853,627,226,595537.05,214650.2,810187.25
312440,201801,45,34,11,32436,10494,42930
312450,201801,212,129,83,123066,79182,202248
312460,201801,58,29,29,27666,27666,55332
312470,201801,55,35,20,33390,19080,52470
312480,201801,211,128,83,122112,79182,201294
312490,201801,255,174,81,165996,77274,243270
312500,201801,32,18,14,17172,13356,30528
312510,201801,419,156,263,148824,250286.39,399110.39
312520,201801,40,14,26,13356,24804,38160
312530,201801,49,37,12,35298,11448,46746
312540,201801,99,87,12,82998,11448,94446
312550,201801,41,32,9,30528,8586,39114
312560,201801,199,143,56,136136,53137.8,189273.8
312570,201801,436,263,173,250234.2,164350.45,414584.65
312580,201801,84,44,40,41976,38160,80136
312590,201801,275,216,59,205683,56286,261969
312595,201801,145,130,15,124020,14310,138330
312600,201801,74,45,29,42501,27666,70167
312610,201801,1626,850,776,804033.78,738587.6,1542621.38
312620,201801,189,131,58,124974,55327.23,180301.23
312630,201801,64,54,10,51516,9540,61056
312640,201801,46,13,33,12402,31482,43884
312650,201801,146,118,28,112286,26426,138712
312660,201801,69,52,17,49322,16218,65540
312670,201801,866,567,299,539344.9,285032.3,824377.2
312675,201801,41,31,10,29574,9540,39114
312680,201801,86,60,26,56858.4,24804,81662.4
312690,201801,240,128,112,122102.46,106561.8,228664.26
312695,201801,31,24,7,22896,6678,29574
312700,201801,208,121,87,115434,82998,198432
312705,201801,72,60,12,57240,11448,68688
312707,201801,94,70,24,66277.75,22896,89173.75
312710,201801,1855,988,867,941064,826907,1767971
312720,201801,66,33,33,31482,31482,62964
312730,201801,289,171,118,162180,112285.8,274465.8
312733,201801,51,44,7,41690,6678,48368
312735,201801,22,16,6,15264,5724,20988
312737,201801,67,36,31,34344,29574,63918
312738,201801,52,37,15,35298,14310,49608
312740,201801,70,48,22,45792,20988,66780
312750,201801,71,51,20,48654,19080,67734
312760,201801,269,195,74,186030,70596,256626
312770,201801,7661,3540,4121,3354272.08,3922770.73,7277042.81
312780,201801,434,336,98,320257.8,93492,413749.8
312790,201801,20,15,5,14310,4770,19080
312800,201801,1591,1120,471,1060094.86,448151.62,1508246.48
312810,201801,373,239,134,227720,127836,355556
312820,201801,193,145,48,138330,45792,184122
312825,201801,27,19,8,18126,7632,25758
312830,201801,285,163,122,154263,115749,270012
312840,201801,148,109,39,103986,37206,141192
312850,201801,23,21,2,20034,1908,21942
312860,201801,170,106,64,100838,61056,161894
312870,201801,983,517,466,490420.34,444564,934984.34
312880,201801,149,103,46,98118.9,43788.6,141907.5
312890,201801,163,113,50,107802,47700,155502
312900,201801,211,156,55,148156.2,52470,200626.2
312910,201801,184,92,92,86599.72,87768,174367.72
312920,201801,155,86,69,82044,65826,147870
312930,201801,340,246,94,234684,89676,324360
312940,201801,103,70,33,66780,31482,98262
312950,201801,703,464,239,441320.6,228006,669326.6
312960,201801,176,132,44,125928,41976,167904
312965,201801,51,45,6,42930,5724,48654
312970,201801,282,227,55,215604.2,52470,268074.2
312980,201801,2310,1238,1072,1176084.2,1022111.6,2198195.8
312990,201801,50,29,21,27666,20034,47700
313000,201801,39,25,14,23850,13356,37206
313005,201801,166,127,39,120166.5,36920,157086.5
313010,201801,936,390,546,370819.8,520588.8,891408.6
313020,201801,187,98,89,93015,84906,177921
313030,201801,208,134,74,125929,70596,196525
313040,201801,60,22,38,20988,36252,57240
313050,201801,295,206,89,195570.2,84906,280476.2
313055,201801,46,33,13,31482,12402,43884
313060,201801,127,84,43,80136,40735.8,120871.8
313065,201801,59,39,20,37206,19080,56286
313070,201801,153,82,71,78228,67734,145962
313080,201801,42,18,24,17172,22896,40068
313090,201801,703,483,220,459494.3,209880,669374.3
313100,201801,165,64,101,61056,96346,157402
313110,201801,125,73,52,69642,49608,119250
313115,201801,157,86,71,81843.66,67734,149577.66
313120,201801,760,415,345,395624,327603.8,723227.8
313130,201801,5189,2795,2394,2640645.57,2274471.64,4915117.21
313140,201801,161,85,76,81090,72504,153594
313150,201801,315,251,64,239454,60769.8,300223.8
313160,201801,191,136,55,129744,52470,182214
313170,201801,1332,941,391,885648.1,372623.4,1258271.5
313180,201801,330,195,135,185381.28,128790,314171.28
313190,201801,725,427,298,404591.4,283529,688120.4
313200,201801,23,22,1,20988,954,21942
313210,201801,1036,872,164,828885.16,156451.23,985336.39
313220,201801,235,161,74,152640,69880.5,222520.5
313230,201801,269,198,71,187939,67734,255673
313240,201801,1910,1021,889,970973.93,844730.55,1815704.48
313250,201801,1239,913,326,866329.8,309097.8,1175427.6
313260,201801,91,54,37,51516,35298,86814
313270,201801,952,557,395,527323.34,376830,904153.34
313280,201801,61,52,9,49131,8586,57717
313290,201801,226,183,43,174296,40068.8,214364.8
313300,201801,373,186,187,175536.8,178398,353934.8
313310,201801,225,117,108,111618,103032,214650
313320,201801,368,285,83,269935.1,79182,349117.1
313330,201801,1357,811,546,772263.2,519692.5,1291955.7
313340,201801,336,230,106,219420,101124,320544
313350,201801,524,352,172,333900.1,164088,497988.1
313360,201801,113,66,47,62964,44552,107516
313370,201801,188,69,119,65826,113526,179352
313375,201801,273,163,110,155502,104940,260442
313380,201801,1277,650,627,618211.08,597868,1216079.08
313390,201801,48,40,8,37206.8,7632,44838.8
313400,201801,418,272,146,259488,138998,398486
313410,201801,22,12,10,11448,9540,20988
313420,201801,4665,2406,2259,2286330.98,2148114.02,4434445.00
313430,201801,134,62,72,59148,68688,127836
313440,201801,1454,977,477,930580.3,454200,1384780.3
313450,201801,63,27,36,25758,34057.8,59815.8
313460,201801,377,176,201,166464,191754,358218
313470,201801,533,242,291,230868,276946.2,507814.2
313480,201801,161,109,52,103033,49608,152641
313490,201801,511,250,261,238495.23,248947,487442.23
313500,201801,20,12,8,11448,7632,19080
313505,201801,954,742,212,706977.5,201961.8,908939.3
313507,201801,93,55,38,52470,36252,88722
313510,201801,2758,1773,985,1685677.76,938736,2624413.76
313520,201801,3594,2807,787,2665334.82,750794,3416128.82
313530,201801,42,29,13,27666,12402,40068
313535,201801,104,83,21,78515,20034,98549
313540,201801,70,53,17,50562,16218,66780
313545,201801,108,88,20,83952,19080,103032
313550,201801,234,191,43,182214,40736,222950
313560,201801,330,173,157,165042,149778,314820
313570,201801,59,31,28,29574,26712,56286
313580,201801,1288,698,590,663306.29,561143.4,1224449.69
313590,201801,81,48,33,45792,31482,77274
313600,201801,689,413,276,394002,262446,656448
313610,201801,56,44,12,41356.8,11448,52804.8
313620,201801,1343,710,633,667448.92,600410,1267858.92
313630,201801,1632,1251,381,1191928,363188,1555116
313640,201801,125,71,54,67734,51516,119250
313650,201801,234,108,126,103032,120204,223236
313652,201801,15,14,1,13356,954,14310
313655,201801,54,31,23,29574,21942,51516
313657,201801,46,42,4,40068,3816,43884
313660,201801,132,92,40,87768,38160,125928
313665,201801,636,314,322,299556,306949.5,606505.5
313670,201801,10208,7087,3121,6736982.78,2976575.8,9713558.58
313680,201801,41,30,11,28620,10494,39114
313690,201801,159,122,37,116388,35298,151686
313695,201801,65,49,16,46746,15264,62010
313700,201801,288,231,57,220088,54378,274466
313710,201801,151,102,49,97308,46746,144054
313720,201801,1050,497,553,471636.51,526217.86,997854.37
313730,201801,60,42,18,40068,17172,57240
313740,201801,162,129,33,123066,31482,154548
313750,201801,441,323,118,307855.8,112572,420427.8
313753,201801,240,168,72,159604.2,68688,228292.2
313760,201801,1217,441,776,420714,737567.52,1158281.52
313770,201801,357,255,102,243270,97308,340578
313780,201801,754,385,369,367290,351739.8,719029.8
313790,201801,27,26,1,24804,954,25758
313800,201801,143,88,55,83952,52470,136422
313810,201801,65,37,28,35298,26712,62010
313820,201801,1282,632,650,601974.2,619123.2,1221097.4
313830,201801,67,50,17,47700,16218,63918
313835,201801,51,46,5,43884,4770,48654
313840,201801,1671,1027,644,974131.52,613136,1587267.52
313850,201801,180,62,118,59148,111992.06,171140.06
313860,201801,483,377,106,356177.3,100170.1,456347.4
313862,201801,173,113,60,107802,57240,165042
313865,201801,83,66,17,62964,16218,79182
313867,201801,49,37,12,35298,11448,46746
313868,201801,26,17,9,15455,8586,24041
313870,201801,124,65,59,62010,56286,118296
313880,201801,338,215,123,204824,116769.8,321593.8
313890,201801,316,169,147,160463.8,139665.6,300129.4
313900,201801,914,495,419,470609.5,399679,870288.5
313910,201801,136,96,40,91584,37206.2,128790.2
313920,201801,610,429,181,409075.2,172674,581749.2
313925,201801,35,30,5,28620,4770,33390
313930,201801,800,614,186,585756,177421,763177
313940,201801,1751,1101,650,1046824.4,619432.4,1666256.8
313950,201801,937,603,334,573450.6,318349.8,891800.4
313960,201801,1380,792,588,751304.3,559712,1311016.3
313970,201801,122,83,39,79182,37206,116388
313980,201801,209,136,73,129506,69642,199148
313990,201801,364,218,146,207685.8,139204.81,346890.61
314000,201801,908,615,293,583229.9,279517.23,862747.13
314010,201801,77,50,27,47700,25758,73458
314015,201801,50,15,35,14310,33390,47700
314020,201801,49,33,16,31482,15168.6,46650.6
314030,201801,88,41,47,38713.67,44838,83551.67
314040,201801,43,30,13,28620,12402,41022
314050,201801,314,184,130,175250,122541.3,297791.3
314053,201801,103,68,35,63918.4,33390,97308.4
314055,201801,295,172,123,164088,117342,281430
314060,201801,146,124,22,117342,20988,138330
314070,201801,951,468,483,442435.14,459876,902311.14
314080,201801,214,140,74,133560,69546.88,203106.88
314085,201801,124,81,43,77274,41022,118296
314090,201801,347,252,95,240408,90625.23,331033.23
314100,201801,474,389,85,367291,80518,447809
314110,201801,693,375,318,355851.54,302656.6,658508.14
314120,201801,97,54,43,51516,41022,92538
314130,201801,26,12,14,11448,13356,24804
314140,201801,1089,653,436,620558.12,414036.66,1034594.78
314150,201801,165,103,62,98262,59148,157410
314160,201801,355,262,93,247086.8,88532,335618.8
314170,201801,70,52,18,48844.8,17172,66016.8
314180,201801,722,631,91,601688,85860.5,687548.5
314190,201801,100,57,43,54378,41022,95400
314200,201801,586,404,182,383859.4,172674,556533.4
314210,201801,276,208,68,197478,64586,262064
314220,201801,311,235,76,222283,72218,294501
314225,201801,65,45,20,42930,19080,62010
314230,201801,102,46,56,43884,53424,97308
314240,201801,139,105,34,100170,32436,132606
314250,201801,60,36,24,34344,22896,57240
314260,201801,187,96,91,91584,86814,178398
314270,201801,331,257,74,244415,70310,314725
314280,201801,683,381,302,363465,288108,651573
314290,201801,552,445,107,423290.5,101791.8,525082.3
314300,201801,415,297,118,280402,112525,392927
314310,201801,1432,956,476,910032.27,453797.97,1363830.24
314315,201801,33,26,7,24804,6678,31482
314320,201801,596,378,218,360039.8,207046.62,567086.42
314330,201801,10670,5366,5304,5108073.34,5055550.78,10163624.12
314340,201801,571,266,305,253191.8,290398,543589.8
314345,201801,27,21,6,20034,5724,25758
314350,201801,189,117,72,111618,68688,180306
314360,201801,77,46,31,43884,29574,73458
314370,201801,58,48,10,45792,9540,55332
314380,201801,91,65,26,62010,24804,86814
314390,201801,3194,2015,1179,1918017.5,1121809.4,3039826.9
314400,201801,686,492,194,466498.2,185076,651574.2
314410,201801,424,271,153,258534,145962,404496
314420,201801,20,9,11,8586,10494,19080
314430,201801,2504,895,1609,849893.3,1532302.75,2382196.05
314435,201801,269,155,114,147583.8,107802,255385.8
314437,201801,26,20,6,19080,5724,24804
314440,201801,98,70,28,66780,26712,93492
314450,201801,152,116,36,110664,34344,145008
314460,201801,655,301,354,287154,337716,624870
314465,201801,80,56,24,53424,22896,76320
314467,201801,68,58,10,55323,9540,64863
314470,201801,383,197,186,184486.52,176490.5,360977.02
314480,201801,1039,504,535,480816,510199.2,991015.2
314490,201801,87,66,21,62964,20034,82998
314500,201801,317,208,109,198432,103986,302418
314505,201801,129,81,48,77274,45792,123066
314510,201801,228,184,44,175250,41976,217226
314520,201801,1230,633,597,596636.7,567582.9,1164219.6
314530,201801,700,551,149,525168,142146,667314
314535,201801,209,131,78,123924.6,74161.01,198085.61
314537,201801,62,37,25,35298,23850,59148
314540,201801,13,9,4,8586,3816,12402
314545,201801,50,33,17,31482,16218,47700
314550,201801,79,42,37,40068,35298,75366
314560,201801,805,434,371,411842,353934,765776
314570,201801,22,17,5,16218,4770,20988
314580,201801,18,9,9,8586,8586,17172
314585,201801,20,14,6,13356,5724,19080
314587,201801,83,72,11,68688,10494,79182
314590,201801,547,405,142,386370,135468,521838
314600,201801,996,648,348,613510.86,329702.8,943213.66
314610,201801,938,517,421,490642.9,400489.2,891132.1
314620,201801,148,110,38,103317.6,36252,139569.6
314625,201801,96,72,24,68116,22896,91012
314630,201801,1229,631,598,600495.3,570205.8,1170701.1
314640,201801,90,60,30,57240,28620,85860
314650,201801,206,120,86,113432.6,81567,194999.6
314655,201801,65,51,14,48654,13356,62010
314660,201801,20,15,5,14310,4770,19080
314670,201801,183,145,38,138044,36252,174296
314675,201801,211,119,92,113526,87768,201294
314690,201801,538,298,240,284292,228960,513252
314700,201801,2425,1328,1097,1261476.2,1045636.9,2307113.1
314710,201801,1634,954,680,905158.9,647818.1,1552977.0
314720,201801,411,243,168,230419.62,160272,390691.62
314730,201801,506,273,233,259012,222273,481285
314740,201801,685,338,347,320782.5,331038,651820.5
314750,201801,22,19,3,18126,2862,20988
314760,201801,316,153,163,145962,155492.46,301454.46
314770,201801,120,83,37,79182,35298,114480
314780,201801,21,6,15,5724,14310,20034
314790,201801,2326,1450,876,1376615.7,835026.66,2211642.36
314795,201801,50,43,7,40784,6678,47462
314800,201801,2909,1703,1206,1619375.96,1148893.2,2768269.16
314810,201801,1498,826,672,785667.5,639467,1425134.5
314820,201801,91,51,40,48654,38160,86814
314830,201801,210,164,46,155740.5,43598,199338.5
314840,201801,83,49,34,46746,32436,79182
314850,201801,350,170,180,162180,171720,333900
314860,201801,704,529,175,502662.86,165423.7,668086.56
314870,201801,1444,740,704,705006,671616,1376622
314875,201801,59,51,8,48654,7632,56286
314880,201801,46,33,13,31482,12402,43884
314890,201801,52,31,21,29574,20034,49608
314900,201801,30,25,5,23850,4770,28620
314910,201801,257,172,85,163801.8,81090,244891.8
314915,201801,153,134,19,127598,18126,145724
314920,201801,121,75,46,71550,43597.8,115147.8
314930,201801,1024,520,504,494222,480529.8,974751.8
314940,201801,53,41,12,39114,11448,50562
314950,201801,38,27,11,25758,10494,36252
314960,201801,61,44,17,41976,16218,58194
314970,201801,136,68,68,64300,64872,129172
314980,201801,304,199,105,187604.1,99216,286820.1
314990,201801,464,256,208,244224,197526.5,441750.5
314995,201801,199,65,134,62010,127826.46,189836.46
315000,201801,87,70,17,66780,16218,82998
315010,201801,47,31,16,29574,15264,44838
315015,201801,169,138,31,130926.96,29574,160500.96
315020,201801,66,56,10,53424,9540,62964
315030,201801,118,91,27,85860,25758,111618
315040,201801,65,49,16,46746,15264,62010
315050,201801,196,116,80,110664,76320,186984
315053,201801,40,35,5,33390,4770,38160
315057,201801,97,80,17,75938.4,16218,92156.4
315060,201801,70,63,7,58195.16,6678,64873.16
315070,201801,104,58,46,55332,43884,99216
315080,201801,371,305,66,290970,62964,353934
315090,201801,107,64,43,61056,41022,102078
315100,201801,74,38,36,36252,34344,70596
315110,201801,290,161,129,152736,123066,275802
315120,201801,1637,831,806,788816.2,767732,1556548.2
315130,201801,338,246,92,234684,87768,322452
315140,201801,537,313,224,296980.2,213696,510676.2
315150,201801,975,455,520,433117,495794,928911
315160,201801,211,108,103,103032,98262,201294
315170,201801,343,222,121,210835,115147.8,325982.8
315180,201801,3198,1355,1843,1289094.3,1755028.2,3044122.5
315190,201801,309,177,132,168477,125928,294405
315200,201801,1176,664,512,631644.2,487589.4,1119233.6
315210,201801,1547,876,671,831317.9,637714.2,1469032.1
315213,201801,45,27,18,25758,17172,42930
315217,201801,197,155,42,147870,40068,187938
315220,201801,1511,1155,356,1101250.6,339528.6,1440779.2
315230,201801,171,124,47,118010,44838,162848
315240,201801,420,271,149,258534,140944.5,399478.5
315250,201801,2542,1255,1287,1196411.6,1227216.66,2423628.26
315260,201801,148,92,56,86432.4,53424,139856.4
315270,201801,127,86,41,81471.6,38388.96,119860.56
315280,201801,686,446,240,425103,228950.46,654053.46
315290,201801,196,115,81,109710,76320.49,186030.49
315300,201801,71,46,25,43884,23850,67734
315310,201801,64,57,7,54378,6678,61056
315320,201801,159,89,70,84906,66780,151686
315330,201801,55,47,8,44838,7632,52470
315340,201801,419,294,125,279236.64,119250,398486.64
315350,201801,144,86,58,82044,55332,137376
315360,201801,96,51,45,48654,42930,91584
315370,201801,56,32,24,30528,22752.9,53280.9
315380,201801,12,7,5,6678,4770,11448
315390,201801,56,13,43,12402,41022,53424
315400,201801,818,613,205,579364.6,194902.2,774266.8
315410,201801,351,212,139,201962,132320,334282
315415,201801,58,44,14,41976,13356,55332
315420,201801,203,152,51,144245,48654,192899
315430,201801,675,398,277,378738.2,263781.8,642520.0
315440,201801,81,57,24,54378,22896,77274
315445,201801,255,204,51,194301.18,48654,242955.18
315450,201801,181,137,44,130698,41976,172674
315460,201801,3356,1704,1652,1620985.8,1573567.1,3194552.9
315470,201801,45,23,22,21656,20988,42644
315480,201801,62,23,39,21942,37206,59148
315490,201801,612,379,233,359514.9,222282,581796.9
315500,201801,21,13,8,12402,7632,20034
315510,201801,152,99,53,94446,50562,145008
315520,201801,71,62,9,59148,8586,67734
315530,201801,52,28,24,26712,22896,49608
315540,201801,240,157,83,149778,79182,228960
315550,201801,178,142,36,135468,34344,169812
315560,201801,747,594,153,565336.8,145962,711298.8
315570,201801,310,166,144,155741.7,137376,293117.7
315580,201801,656,429,227,409266,216558,625824
315590,201801,211,108,103,103032,98262,201294
315600,201801,294,215,79,204156,75176,279332
315610,201801,98,48,50,45792,47700,93492
315620,201801,35,28,7,26712,6678,33390
315630,201801,142,93,49,88722,46746,135468
315640,201801,56,32,24,30528,22896,53424
315645,201801,63,45,18,42930,16695,59625
315650,201801,167,121,46,115148,43884,159032
315660,201801,477,203,274,193662,261396,455058
315670,201801,2321,1186,1135,1128659.32,1081617.66,2210276.98
315680,201801,855,573,282,543076.66,268302.96,811379.62
315690,201801,698,475,223,452075.67,212742,664817.67
315700,201801,1900,1002,898,952036.37,856692,1808728.37
315710,201801,323,82,241,78228,229914,308142
315720,201801,426,273,153,260442,145962,406404
315725,201801,202,162,40,154548,38160,192708
315727,201801,42,22,20,20988,19080,40068
315730,201801,41,39,2,37206,1908,39114
315733,201801,86,55,31,52470,29574,82044
315737,201801,51,38,13,36252,12402,48654
315740,201801,44,39,5,37206,4770,41976
315750,201801,160,126,34,120204,32436,152640
315760,201801,47,32,15,30528,14310,44838
315765,201801,118,77,41,73458,39114,112572
315770,201801,228,136,92,129744,87482,217226
315780,201801,3265,1700,1565,1615075.5,1490626.58,3105702.08
315790,201801,210,162,48,154548,45219.6,199767.6
315800,201801,282,204,78,194616,74412,269028
315810,201801,96,56,40,53424,37874,91298
315820,201801,797,574,223,545307.34,212742,758049.34
315830,201801,143,82,61,78228,58194,136422
315840,201801,91,63,28,60102,26712,86814
315850,201801,259,189,70,180306,66780,247086
315860,201801,12,4,8,3816,7632,11448
315870,201801,34,27,7,25758,6678,32436
315880,201801,104,69,35,65826,33390,99216
315890,201801,81,60,21,57240,20034,77274
315895,201801,433,285,148,270651,140620,411271
315900,201801,70,33,37,31482,35298,66780
315910,201801,38,24,14,22657.5,13356,36013.5
315920,201801,184,120,64,114480,60102.9,174582.9
315930,201801,39,14,25,13356,23850,37206
315935,201801,146,114,32,108756,30519,139275
315940,201801,89,67,22,63918,20988,84906
315950,201801,65,46,19,43884,18126,62010
315960,201801,556,258,298,245483.48,283719.8,529203.28
315970,201801,37,29,8,27666,7632,35298
315980,201801,693,322,371,305619.2,353924.46,659543.66
315990,201801,248,150,98,143100,93206,236306
316000,201801,49,31,18,29574,17172,46746
316010,201801,75,63,12,60102,11448,71550
316020,201801,109,89,20,84906,19080,103986
316030,201801,398,207,191,197478,181690,379168
316040,201801,498,220,278,208926.2,264926,473852.2
316045,201801,59,52,7,49608,6678,56286
316050,201801,16,14,2,13356,1908,15264
316060,201801,93,60,33,56953.8,31482,88435.8
316070,201801,1036,667,369,629788.5,351263,981051.5
316080,201801,103,62,41,59148,39114,98262
316090,201801,42,26,16,24136.2,15264,39400.2
316095,201801,70,58,12,55056,11448,66504
316100,201801,308,181,127,171863.3,121158,293021.3
316105,201801,35,24,11,22896,10494,33390
316110,201801,1914,1534,380,1454898.55,361852.2,1816750.75
316120,201801,79,59,20,56286,18793.8,75079.8
316130,201801,138,106,32,100457,30528,130985
316140,201801,27,20,7,19080,6678,25758
316150,201801,202,141,61,133798.5,58194,191992.5
316160,201801,87,51,36,48654,34344,82998
316165,201801,65,47,18,44648,16456.5,61104.5
316170,201801,203,136,67,128790,63918,192708
316180,201801,198,91,107,86480.1,102078,188558.1
316190,201801,139,98,41,92538,39114,131652
316200,201801,697,389,308,371106,293259.8,664365.8
316210,201801,758,507,251,483332.33,239454,722786.33
316220,201801,116,78,38,74412,36252,110664
316225,201801,23,14,9,13356,8586,21942
316230,201801,33,19,14,18126,13356,31482
316240,201801,613,498,115,474138.2,109710,583848.2
316245,201801,99,82,17,78228,16218,94446
316250,201801,1510,1053,457,996197,434508.92,1430705.92
316255,201801,113,90,23,85478.4,21942,107420.4
316257,201801,182,95,87,90630,82711.8,173341.8
316260,201801,244,162,82,153251.06,78133,231384.06
316265,201801,25,16,9,15264,8586,23850
316270,201801,675,468,207,443705.6,197478,641183.6
316280,201801,543,338,205,320894.8,194902.6,515797.4
316290,201801,697,471,226,445535.98,215604,661139.98
316292,201801,492,194,298,185076,284054,469130
316294,201801,105,62,43,59148,41022,100170
316295,201801,278,120,158,113032,150732,263764
316300,201801,105,74,31,70596,29574,100170
316310,201801,35,18,17,17172,16218,33390
316320,201801,41,25,16,23850,15264,39114
316330,201801,129,82,47,77274.5,44551.8,121826.3
316340,201801,142,94,48,89676,45792,135468
316350,201801,191,138,53,131486,50562,182048
316360,201801,23,18,5,17172,4770,21942
316370,201801,1055,561,494,531398.5,470980.26,1002378.76
316380,201801,123,93,30,88722,28620,117342
316390,201801,121,87,34,82998,32436,115434
316400,201801,138,105,33,100170,31482,131652
316410,201801,305,225,80,213266.7,76320,289586.7
316420,201801,196,140,56,132844.5,53424,186268.5
316430,201801,158,78,80,74412,76320,150732
316440,201801,98,47,51,44838,48654,93492
316443,201801,36,34,2,32436,1908,34344
316447,201801,63,49,14,46746,13356,60102
316450,201801,221,167,54,159318,51516,210834
316460,201801,66,28,38,26712,36252,62964
316470,201801,1594,1147,447,1086532.44,424910.76,1511443.20
316480,201801,13,10,3,9540,2862,12402
316490,201801,18,7,11,6678,10494,17172
316500,201801,150,100,50,95113.8,47700,142813.8
316510,201801,169,124,45,117294.3,42930,160224.3
316520,201801,192,117,75,111045.6,71550,182595.6
316530,201801,152,110,42,104940,39781.8,144721.8
316540,201801,142,79,63,74412,60102,134514
316550,201801,141,100,41,95400,39114,134514
316553,201801,235,112,123,106339.33,117342,223681.33
316555,201801,32,23,9,21942,8586,30528
316556,201801,9,6,3,5724,2862,8586
316557,201801,17,14,3,13356,2862,16218
316560,201801,58,45,13,42930,12402,55332
316570,201801,246,224,22,213458,20988,234446
316580,201801,21,15,6,14310,5724,20034
316590,201801,115,99,16,94446,15264,109710
316600,201801,182,148,34,140906,32436,173342
316610,201801,65,45,20,42643.8,19080,61723.8
316620,201801,133,103,30,98262,28620,126882
316630,201801,37,27,10,25758,9540,35298
316640,201801,16,10,6,9540,5724,15264
316650,201801,64,50,14,47700,13356,61056
316660,201801,6,4,2,3816,1908,5724
316670,201801,437,155,282,147851,268455.8,416306.8
316680,201801,160,110,50,104940,47510,152450
316690,201801,190,120,70,114480,66780,181260
316695,201801,59,52,7,49608,6678,56286
316700,201801,13,7,6,6678,5724,12402
316710,201801,714,521,193,496796,184122,680918
316720,201801,4864,2472,2392,2343795.04,2278025.43,4621820.47
316730,201801,14,13,1,12402,954,13356
316740,201801,134,84,50,80136,47700,127836
316750,201801,19,13,6,12402,5724,18126
316760,201801,324,261,63,248994,60102,309096
316770,201801,139,80,59,76320,56286,132606
316780,201801,69,41,28,38808.72,26712,65520.72
316790,201801,56,43,13,41022,12402,53424
316800,201801,1790,1097,693,1044248.8,659406.2,1703655.0
316805,201801,18,9,9,8586,8586,17172
316810,201801,64,41,23,39114,21656,60770
316820,201801,37,18,19,17172,18126,35298
316830,201801,90,39,51,37206,47414,84620
316840,201801,500,303,197,288299,186030,474329
316850,201801,345,224,121,212312.7,115434,327746.7
316860,201801,5945,2636,3309,2500492.11,3153581.46,5654073.57
316870,201801,1444,932,512,880744.7,483680,1364424.7
316880,201801,113,65,48,61723.8,45792,107515.8
316890,201801,251,166,85,158171,81090,239261
316900,201801,414,285,129,269343.28,123066,392409.28
316905,201801,17,10,7,9540,6678,16218
316910,201801,50,26,24,24804,22896,47700
316920,201801,137,106,31,100409,29574,129983
316930,201801,1919,967,952,916748.3,906009.93,1822758.23
316935,201801,853,512,341,486540.72,324360,810900.72
316940,201801,1095,629,466,599112.4,443982.26,1043094.66
316950,201801,188,98,90,93492,85860,179352
316960,201801,1091,606,485,576788.8,462394.46,1039183.26
316970,201801,637,496,141,473184,134514,607698
316980,201801,113,69,44,65826,41966.46,107792.46
316990,201801,2175,1426,749,1353012.18,712867.96,2065880.14
317000,201801,327,253,74,241076,70596,311672
317005,201801,247,175,72,166950,68688,235638
317010,201801,6249,3429,2820,3251604.94,2688372.4,5939977.34
317020,201801,16058,7100,8958,6741541,8527736.14,15269277.14
317030,201801,85,33,52,31482,49391.26,80873.26
317040,201801,3117,1931,1186,1839999.88,1128392.61,2968392.49
317043,201801,70,50,20,47700,19080,66780
317047,201801,35,17,18,16218,17168,33386
317050,201801,181,135,46,128790,43884,172674
317052,201801,123,96,27,91584,25758,117342
317057,201801,198,149,49,142146,46174,188320
317060,201801,55,36,19,34344,17839.8,52183.8
317065,201801,60,48,12,45792,11448,57240
317070,201801,1954,924,1030,876727.7,980521.6,1857249.3
317075,201801,107,55,52,52470,49608,102078
317080,201801,820,432,388,410950.86,369962,780912.86
317090,201801,629,504,125,478479.5,119250,597729.5
317100,201801,408,305,103,289062.2,98262,387324.2
317103,201801,109,94,15,89676,14310,103986
317107,201801,36,32,4,30528,3816,34344
317110,201801,94,39,55,37206,52470,89676
317115,201801,39,33,6,31482,5724,37206
317120,201801,1788,902,886,852604.62,844787,1697391.62
317130,201801,1898,1215,683,1156161.4,650915,1807076.4
317140,201801,6,5,1,4770,954,5724
317150,201801,271,163,108,155502,102268.8,257770.8
317160,201801,318,233,85,221965,81090,303055
317170,201801,206,143,63,136422,60102,196524
317180,201801,430,307,123,292162.5,117342,409504.5
317190,201801,253,169,84,161226,79596.53,240822.53
317200,201801,791,560,231,521848,220136,741984
317210,201801,153,87,66,82044.2,62964,145008.2
317220,201801,21,14,7,13356,6678,20034
320010,201801,616,457,159,432640.5,151686,584326.5
320013,201801,132,98,34,93492,32436,125928
320016,201801,282,178,104,169812,99216,269028
320020,201801,716,430,286,407670.75,270201.74,677872.49
320030,201801,150,112,38,106848,35918.1,142766.1
320035,201801,133,98,35,93492,33390,126882
320040,201801,500,261,239,247849.6,228006,475855.6
320050,201801,114,87,27,82998,25758,108756
320060,201801,1517,706,811,673477,773017.6,1446494.6
320070,201801,100,70,30,66780,28620,95400
320080,201801,759,434,325,411205,310050,721255
320090,201801,1193,832,361,790374.86,343535.6,1133910.46
320100,201801,314,178,136,169812,129744,299556
320110,201801,140,89,51,83189.2,48654,131843.2
320115,201801,112,92,20,87768,19080,106848
320120,201801,3272,1840,1432,1743163,1364450.64,3107613.64
320130,201801,7271,3479,3792,3298520.54,3610228.13,6908748.67
320140,201801,416,266,150,252429.2,142856,395285.2
320150,201801,1867,1093,774,1034936.03,738355.46,1773291.49
320160,201801,694,314,380,297543.83,361167.29,658711.12
320170,201801,114,88,26,83189,24804,107993
320180,201801,53,30,23,28620,21942,50562
320190,201801,234,158,76,149959.26,72218,222177.26
320200,201801,56,42,14,40068,13356,53424
320210,201801,841,475,366,451624.6,348192,799816.6
320220,201801,302,113,189,107802,180020,287822
320225,201801,73,60,13,57240,12402,69642
320230,201801,546,351,195,333518.4,185220,518738.4
320240,201801,3112,1568,1544,1493392.8,1470309.78,2963702.58
320245,201801,450,315,135,299365.4,128790,428155.4
320250,201801,221,116,105,109710.6,100170,209880.6
320255,201801,146,116,30,109357.02,28477,137834.02
320260,201801,175,123,52,117342,49560.3,166902.3
320265,201801,160,128,32,121302,30528,151830
320270,201801,151,125,26,119250,24804,144054
320280,201801,940,570,370,538152.4,351864.02,890016.42
320290,201801,65,55,10,52470,9540,62010
320300,201801,535,380,155,361061.3,146602.1,507663.4
320305,201801,656,354,302,337716,287918,625634
320310,201801,210,119,91,112006.28,86058,198064.28
320313,201801,300,152,148,145008,140906,285914
320316,201801,109,90,19,85860,18126,103986
320320,201801,3305,1505,1800,1429799.8,1714211,3144010.8
320330,201801,259,191,68,181551.3,62964.91,244516.21
320332,201801,882,536,346,509201.6,329035.3,838236.9
320334,201801,238,145,93,138044,88722,226766
320335,201801,146,105,41,98977.9,39114,138091.9
320340,201801,591,410,181,389996,172007,562003
320350,201801,963,414,549,392476.88,523220.48,915697.36
320360,201801,165,92,73,87482,69642,157124
320370,201801,244,187,57,176706,53345,230051
320380,201801,283,192,91,181737.8,86814,268551.8
320390,201801,1111,680,431,648348,409351.93,1057699.93
320400,201801,323,234,89,222283,84906,307189
320405,201801,885,376,509,358700,485273.92,843973.92
320410,201801,962,491,471,466725.4,448963.34,915688.74
320420,201801,479,246,233,234207.4,222282,456489.4
320425,201801,194,104,90,99216,85860,185076
320430,201801,393,223,170,211120.7,162180,373300.7
320435,201801,165,111,54,105073.56,51516,156589.56
320440,201801,200,122,78,116101.8,74126,190227.8
320450,201801,129,76,53,72504,50562,123066
320455,201801,245,198,47,187939,44838,232777
320460,201801,242,154,88,146916,83952,230868
320465,201801,113,76,37,72141.48,35298,107439.48
320470,201801,629,400,229,381296.26,218462,599758.26
320480,201801,173,115,58,109710,55332,165042
320490,201801,2997,1497,1500,1423750.74,1428102.47,2851853.21
320495,201801,88,56,32,53405,30528,83933
320500,201801,9329,4727,4602,4484341.32,4378277.85,8862619.17
320501,201801,540,275,265,262350,252810,515160
320503,201801,274,197,77,186984.2,73458,260442.2
320506,201801,252,193,59,184122,56286,240408
320510,201801,925,444,481,420667.3,457348.1,878015.4
320515,201801,79,66,13,62010.9,12402,74412.9
320517,201801,203,143,60,136422,57240,193662
320520,201801,6744,3009,3735,2856368.59,3554855.22,6411223.81
320530,201801,5198,2619,2579,2489784.02,2457125.23,4946909.25
330010,201801,2995,1559,1436,1479626.56,1367146.37,2846772.93
330015,201801,156,62,94,57884.78,89676,147560.78
330020,201801,3533,1539,1994,1464964.84,1901704,3366668.84
330022,201801,212,119,93,112811,87768.8,200579.8
330023,201801,522,184,338,174343.8,322452,496795.8
330025,201801,535,121,414,115434,394383.8,509817.8
330030,201801,1918,1221,697,1156539.28,661669.68,1818208.96
330040,201801,2297,1165,1132,1109306.1,1078641,2187947.1
330045,201801,8261,2600,5661,2471989.18,5394460.78,7866449.96
330050,201801,797,504,293,480816,279522,760338
330060,201801,878,547,331,518023.9,315125.28,833149.18
330070,201801,3422,1310,2112,1244276.47,2013533.56,3257810.03
330080,201801,1482,701,781,663491.3,743834.4,1407325.7
330090,201801,351,213,138,203202,131652,334854
330093,201801,288,129,159,123066,151650,274716
330095,201801,101,53,48,50562,45792,96354
330100,201801,9461,4886,4575,4652773.46,4360686.9,9013460.36
330110,201801,475,212,263,201532.5,250902,452434.5
330115,201801,522,308,214,293832,204156,497988
330120,201801,375,193,182,182977.2,172864.8,355842.0
330130,201801,1504,425,1079,404724.96,1029330,1434054.96
330140,201801,593,311,282,296676,268075,564751
330150,201801,448,266,182,251856,172674,424530
330160,201801,204,126,78,120204,74412,194616
330170,201801,26615,9413,17202,8959011.02,16398209.2,25357220.22
330180,201801,234,147,87,136737.5,82282.5,219020.0
330185,201801,771,327,444,310422.8,422308.8,732731.6
330187,201801,278,91,187,86814,178398,265212
330190,201801,5543,2220,3323,2107993.3,3166846.68,5274839.98
330200,201801,4369,1533,2836,1457660.13,2700863.76,4158523.89
330205,201801,388,240,148,228530.7,140906,369436.7
330210,201801,995,604,391,570687.6,371439.9,942127.5
330220,201801,2513,1506,1007,1433338.5,959724.2,2393062.7
330225,201801,550,307,243,292239,231154.2,523393.2
330227,201801,2465,795,1670,755272.46,1592824.23,2348096.69
330230,201801,198,122,76,115721,72504,188225
330240,201801,3604,1883,1721,1790851.26,1638817.68,3429668.94
330245,201801,152,64,88,61056,83188.8,144244.8
330250,201801,6450,3364,3086,3198248.09,2934900.52,6133148.61
330260,201801,562,169,393,161226,374922,536148
330270,201801,3313,1229,2084,1171609,1987565.2,3159174.2
330280,201801,439,287,152,270861.28,144999,415860.28
330285,201801,6994,2326,4668,2214982.4,4450948.4,6665930.8
330290,201801,571,223,348,211789,331992,543781
330300,201801,745,503,242,476046.7,230850,706896.7
330310,201801,408,237,171,224190.7,163134,387324.7
330320,201801,8050,3016,5034,2869350.8,4796504.22,7665855.02
330330,201801,9246,3618,5628,3445717.4,5364707.13,8810424.53
330340,201801,2635,1581,1054,1506071.06,1005496.92,2511567.98
330350,201801,17772,7027,10745,6677803.39,10230236.5,16908039.89
330360,201801,2595,1276,1319,1216140.4,1258317,2474457.4
330370,201801,965,533,432,507718.8,410125.6,917844.4
330380,201801,841,367,474,349392.96,451576.8,800969.76
330385,201801,604,317,287,301465,273798,575263
330390,201801,5134,2856,2278,2710798.68,2170650.4,4881449.08
330395,201801,245,155,90,146153.1,84095.2,230248.3
330400,201801,653,335,318,316156.6,301477.85,617634.45
330410,201801,506,360,146,341772,138508.13,480280.13
330411,201801,235,135,100,128609,95352.3,223961.3
330412,201801,253,108,145,102746,138330,241076
330414,201801,6188,2509,3679,2389714.8,3507786.3,5897501.1
330415,201801,559,266,293,253764,278568.8,532332.8
330420,201801,2269,1200,1069,1141648.91,1017147,2158795.91
330430,201801,1799,823,976,783807,928733.02,1712540.02
330440,201801,261,121,140,115434,133560,248994
330450,201801,120,48,72,45792,68688,114480
330452,201801,1687,787,900,749084.18,858295.88,1607380.06
330455,201801,110256,39377,70879,37492967.02,67556398.99,105049366.01
330460,201801,262,105,157,100170,149778,249948
330470,201801,1235,675,560,637656.98,534230.46,1171887.44
330475,201801,1385,377,1008,357694.16,961059.6,1318753.76
330480,201801,745,397,348,378070.2,331038.8,709109.0
330490,201801,13465,4745,8720,4519923.93,8312261.73,12832185.66
330500,201801,1336,613,723,584802,689361,1274163
330510,201801,11230,3744,7486,3564057.91,7134953.34,10699011.25
330513,201801,103,51,52,48654,49608,98262
330515,201801,852,353,499,332737.8,475665,808402.8
330520,201801,2438,915,1523,872691,1452798.9,2325489.9
330530,201801,226,118,108,112572,102842,215414
330540,201801,350,175,175,166950,166473,333423
330550,201801,3101,1099,2002,1045728.2,1907857.3,2953585.5
330555,201801,744,275,469,262331,446472.8,708803.8
330560,201801,548,209,339,199386,323388,522774
330570,201801,249,171,78,163134,74412,237546
330575,201801,808,334,474,318398,450141.5,768539.5
330580,201801,3355,1888,1467,1794296,1397754.2,3192050.2
330590,201801,306,154,152,146916,145008,291924
330600,201801,1093,706,387,671387.24,367510.38,1038897.62
330610,201801,1520,841,679,795142.42,643617.9,1438760.32
330615,201801,188,140,48,133560,45792,179352
330620,201801,953,449,504,425963.4,479385.8,905349.2
330630,201801,3762,2386,1376,2260657.35,1305166.53,3565823.88
350010,201801,590,384,206,364980.18,196524,561504.18
350020,201801,40,21,19,20034,18126,38160
350030,201801,521,337,184,320354,174346.66,494700.66
350040,201801,126,47,79,44494.56,75366,119860.56
350050,201801,290,161,129,153594,122809.46,276403.46
350055,201801,84,46,38,43884,36252,80136
350060,201801,73,28,45,26712,42930,69642
350070,201801,795,467,328,441213.14,311245.56,752458.70
350075,201801,66,43,23,41022,21942,62964
350080,201801,51,32,19,29891.96,18126,48017.96
350090,201801,99,56,43,53424,41017.23,94441.23
350100,201801,297,185,112,175774.5,106848,282622.5
350110,201801,59,37,22,35298,20988,56286
350115,201801,152,93,59,88054.2,56286,144340.2
350120,201801,112,75,37,71550,35298,106848
350130,201801,359,173,186,164470,177444,341914
350140,201801,34,20,14,18317,13356,31673
350150,201801,72,57,15,54378,14310,68688
350160,201801,2457,950,1507,903231.16,1436336.68,2339567.84
350170,201801,397,244,153,230582,145676,376258
350180,201801,185,97,88,92538,83952,176490
350190,201801,963,490,473,465458.64,450941.49,916400.13
350200,201801,71,26,45,24804,42665.08,67469.08
350210,201801,1350,760,590,718293.13,562342.66,1280635.79
350220,201801,668,574,94,543458.73,89676,633134.73
350230,201801,79,57,22,54378,20988,75366
350240,201801,62,47,15,44838,14310,59148
350250,201801,1214,614,600,579084.37,571676.06,1150760.43
350260,201801,93,66,27,62964,25758,88722
350270,201801,827,543,284,516944.58,269486.92,786431.50
350275,201801,293,115,178,109329,169812,279141
350280,201801,4680,2384,2296,2262177.04,2186607.65,4448784.69
350290,201801,397,187,210,178107.23,199767.8,377875.03
350300,201801,45,25,20,23850,19080,42930
350310,201801,96,69,27,65540,25758,91298
350315,201801,39,24,15,22896,14310,37206
350320,201801,3251,1608,1643,1529502.7,1566889.3,3096392.0
350330,201801,1670,888,782,843051.96,744724.04,1587776.00
350335,201801,21,14,7,13356,6678,20034
350340,201801,129,62,67,59148,63918,123066
350350,201801,96,47,49,44838,46746,91584
350360,201801,128,88,40,83948,37977,121925
350370,201801,97,57,40,53741.96,38150.46,91892.42
350380,201801,737,310,427,295072.2,406594.8,701667.0
350390,201801,1407,574,833,546800.35,793537.4,1340337.75
350395,201801,26,19,7,18126,6678,24804
350400,201801,1693,908,785,856626.88,745338.16,1601965.04
350410,201801,2225,998,1227,949002.96,1170239.03,2119241.99
350420,201801,235,145,90,137727,85860,223587
350430,201801,74,44,30,41404,28620,70024
350440,201801,152,112,40,105846.5,38160,144006.5
350450,201801,1599,1005,594,951550.95,566581,1518131.95
350460,201801,335,121,214,115434,203869.8,319303.8
350470,201801,14,10,4,9540,3816,13356
350480,201801,158,88,70,83952,66780,150732
350490,201801,245,121,124,114480.8,118296,232776.8
350500,201801,38,18,20,17172,19080,36252
350510,201801,167,112,55,106848,52470,159318
350520,201801,448,207,241,194297.96,229277.96,423575.92
350530,201801,452,213,239,203202,228006,431208
350535,201801,62,49,13,46202.22,12402,58604.22
350540,201801,374,189,185,179492.04,176204,355696.04
350550,201801,2728,1602,1126,1520442.86,1073195.07,2593637.93
350560,201801,627,436,191,415939.23,181856.25,597795.48
350570,201801,4199,1742,2457,1656397.98,2341471.2,3997869.18
350580,201801,365,173,192,164089,183154.46,347243.46
350590,201801,897,487,410,464598,390186,854784
350600,201801,6150,3091,3059,2934613.24,2914831.72,5849444.96
350610,201801,1542,779,763,737568.6,727893,1465461.6
350620,201801,39,27,12,25758,11448,37206
350630,201801,240,137,103,129744.96,97309,227053.96
350635,201801,845,332,513,316442,488755.21,805197.21
350640,201801,121,88,33,83952,31482,115434
350650,201801,1881,1239,642,1178282.12,610832.73,1789114.85
350660,201801,753,343,410,326582.82,390182,716764.82
350670,201801,314,162,152,154310,145008,299318
350680,201801,174,96,78,91584,74412,165996
350690,201801,194,96,98,91584,93492,185076
350700,201801,693,343,350,323887.94,333900,657787.94
350710,201801,320,131,189,124401.6,180306,304707.6
350715,201801,50,43,7,41022,6678,47700
350720,201801,17,13,4,12402,3816,16218
350730,201801,42,26,16,24804,15264,40068
350740,201801,207,115,92,109414.26,87768,197182.26
350745,201801,22,12,10,11424,9540,20964
350750,201801,2124,1372,752,1300600.74,716771.96,2017372.70
350760,201801,3721,1611,2110,1535273.36,2010736.46,3546009.82
350770,201801,60,40,20,38160,19080,57240
350775,201801,48,35,13,33390,12393,45783
350780,201801,419,207,212,197478,202248,399726
350790,201801,369,159,210,151686,200340,352026
350800,201801,431,240,191,228960,182214,411174
350810,201801,513,410,103,390187,98262,488449
350820,201801,85,51,34,48654,32436,81090
350830,201801,80,46,34,43884,32436,76320
350840,201801,708,325,383,310050,364142,674192
350850,201801,1749,1009,740,956578.34,705690.46,1662268.80
350860,201801,573,335,238,317664.72,227052,544716.72
350870,201801,438,298,140,284292,133273.8,417565.8
350880,201801,284,154,130,144056.1,123352.2,267408.3
350890,201801,43,26,17,24804,16218,41022
350900,201801,1461,474,987,450209.93,940834.8,1391044.73
350910,201801,28,18,10,17172,9540,26712
350920,201801,596,333,263,317364.04,250902,568266.04
350925,201801,1162,626,536,594162.34,509913.4,1104075.74
350930,201801,96,58,38,55332,36252,91584
350940,201801,705,395,310,375303.6,293899.6,669203.2
350945,201801,106,79,27,74830,25758,100588
350950,201801,15122,7295,7827,6931967.13,7456877.3,14388844.43
350960,201801,1289,602,687,569626.96,655394,1225020.96
350970,201801,1127,609,518,578127.96,493876.46,1072004.42
350980,201801,97,65,32,62010,30528,92538
350990,201801,358,129,229,122181.63,218179.8,340361.43
350995,201801,34,17,17,16218,16218,32436
351000,201801,639,456,183,432800.07,174582,607382.07
351010,201801,52,30,22,28620,20988,49608
351015,201801,58,42,16,40068,15264,55332
351020,201801,1657,958,699,912226.25,664747.4,1576973.65
351030,201801,332,230,102,216844.2,97308,314152.2
351040,201801,846,458,388,435978,369198.66,805176.66
351050,201801,3254,1571,1683,1491698.75,1603710.04,3095408.79
351060,201801,4912,2035,2877,1930867.82,2741623.89,4672491.71
351070,201801,418,268,150,253451.14,143100,396551.14
351080,201801,814,583,231,556182,219420,775602
351090,201801,63,27,36,25758,34344,60102
351100,201801,463,264,199,249634.48,189832.23,439466.71
351110,201801,2111,1024,1087,971649.72,1034361.66,2006011.38
351120,201801,73,39,34,37121.09,32436,69557.09
351130,201801,174,59,115,56286,109710,165996
351140,201801,334,233,101,220754.64,96354,317108.64
351150,201801,394,202,192,192135.8,183168,375303.8
351160,201801,245,160,85,152640,81090,233730
351170,201801,181,94,87,89676,82235,171911
351190,201801,91,62,29,59148,27666,86814
351200,201801,379,249,130,236942.04,124020,360962.04
351210,201801,131,61,70,57939.38,66780,124719.38
351220,201801,524,316,208,297604.92,198432,496036.92
351230,201801,276,202,74,192071.96,70576.92,262648.88
351240,201801,229,99,130,94255.2,124020,218275.2
351250,201801,70,49,21,46522,19844,66366
351260,201801,152,111,41,105894,38828,144722
351270,201801,49,20,29,19080,27666,46746
351280,201801,1101,504,597,477003.42,569014.38,1046017.80
351290,201801,224,100,124,95400,118010,213410
351300,201801,3725,1750,1975,1663017.15,1883543,3546560.15
351310,201801,760,392,368,373253,351072,724325
351320,201801,106,65,41,62010,39114,101124
351330,201801,41,29,12,27666,11448,39114
351340,201801,1220,763,457,720393.09,434994.23,1155387.32
351350,201801,2437,1320,1117,1257706.7,1065327.03,2323033.73
351360,201801,782,391,391,371106,371879.98,742985.98
351370,201801,366,191,175,182209.23,166313.96,348523.19
351380,201801,8876,4062,4814,3860460.36,4583604.96,8444065.32
351385,201801,30,20,10,19080,9540,28620
351390,201801,292,214,78,203202,74412,277614
351400,201801,65,40,25,38160,23804.46,61964.46
351410,201801,422,267,155,253206.99,147458,400664.99
351420,201801,62,50,12,47700,11448,59148
351430,201801,77,40,37,38160,35298,73458
351440,201801,792,550,242,522505.76,230864,753369.76
351450,201801,252,126,126,120204,120204,240408
351460,201801,121,55,66,51755,62964,114719
351470,201801,140,74,66,70587,62964,133551
351480,201801,519,290,229,275420.96,218346.75,493767.71
351490,201801,297,105,192,100170,183168,283338
351492,201801,32,23,9,21942,8586,30528
351495,201801,28,18,10,17172,9540,26712
351500,201801,3554,1537,2017,1460507.69,1919306.41,3379814.10
351510,201801,1769,738,1031,703765.8,981370.26,1685136.06
351512,201801,22,18,4,17172,3816,20988
351515,201801,194,111,83,105894,79182,185076
351518,201801,734,448,286,426434,272561.16,698995.16
351519,201801,75,48,27,45792,25758,71550
351520,201801,143,87,56,82361.96,53424,135785.96
351530,201801,19,13,6,12402,5724,18126
351535,201801,135,73,62,69642,59148,128790
351540,201801,460,331,129,313391,123066,436457
351550,201801,1311,798,513,756829.96,489202.06,1246032.02
351560,201801,74,38,36,36252,34344,70596
351565,201801,12,7,5,6678,4770,11448
351570,201801,2574,1328,1246,1264588.35,1188017.65,2452606.00
351580,201801,39,35,4,33390,3816,37206
351590,201801,68,45,23,42930,21942,64872
351600,201801,189,142,47,135468,44838,180306
351610,201801,61,30,31,28620,29574,58194
351620,201801,5947,3422,2525,3254559.25,2406627.11,5661186.36
351630,201801,2514,1298,1216,1232977.43,1157865.23,2390842.66
351640,201801,1652,804,848,765131.38,807465.8,1572597.18
351650,201801,30,25,5,23850,4770,28620
351660,201801,158,101,57,95207,54378,149585
351670,201801,746,468,278,444136,265212,709348
351680,201801,75,61,14,58194,13356,71550
351685,201801,43,28,15,26712,14310,41022
351690,201801,310,221,89,208968.93,84906,293874.93
351700,201801,162,115,47,109710,44838,154548
351710,201801,74,53,21,50562,20034,70596
351720,201801,133,60,73,57240,69642,126882
351730,201801,100,73,27,68401.96,25753.23,94155.19
351740,201801,716,481,235,457634.96,224185.23,681820.19
351750,201801,365,154,211,145962.04,201294,347256.04
351760,201801,799,623,176,594581,167768,762349
351770,201801,289,247,42,235638,40068,275706
351780,201801,169,94,75,89667,71550,161217
351790,201801,242,129,113,123066,107802,230868
351800,201801,54,35,19,33390,18126,51516
351810,201801,123,81,42,77274,40068,117342
351820,201801,889,642,247,607891.4,235347.23,843238.63
351830,201801,503,183,320,173818.8,305280,479098.8
351840,201801,1863,943,920,890678,876178.94,1766856.94
351850,201801,227,168,59,159652.8,56286,215938.8
351860,201801,752,495,257,466444.84,244887.23,711332.07
351870,201801,5624,2653,2971,2521264.64,2828043.75,5349308.39
351880,201801,18908,8305,10603,7900588.21,10100296.61,18000884.82
351885,201801,89,61,28,57479,26712,84191
351890,201801,72,61,11,58194,10494,68688
351900,201801,224,133,91,126215,86814,213029
351905,201801,75,34,41,32436,39114,71550
351907,201801,3101,1351,1750,1285349.02,1667707.8,2953056.82
351910,201801,177,73,104,69642,99216,168858
351920,201801,135,79,56,75366,53401.69,128767.69
351925,201801,87,60,27,57240,25758,82998
351930,201801,386,264,122,251760.6,116388,368148.6
351940,201801,231,107,124,102078,118296,220374
351950,201801,145,84,61,80136,58194,138330
351960,201801,840,392,448,373786.73,425522.36,799309.09
351970,201801,1902,1009,893,960439.84,851627,1812066.84
351980,201801,145,73,72,67734,68688,136422
351990,201801,279,188,91,178398,86012.64,264410.64
352000,201801,356,214,142,203774.4,135468,339242.4
352010,201801,351,210,141,200340,134514,334854
352020,201801,192,68,124,64872,118296,183168
352030,201801,1004,518,486,493456.5,462053.96,955510.46
352040,201801,571,250,321,238500,306234,544734
352042,201801,278,96,182,91584,173056,264640
352044,201801,391,236,155,223989.86,147870,371859.86
352050,201801,3142,1281,1861,1214237.94,1774295.26,2988533.20
352060,201801,105,65,40,62010,38160,100170
352070,201801,103,73,30,68372,28620,96992
352080,201801,65,40,25,37206,23850,61056
352090,201801,170,117,53,111618,50562,162180
352100,201801,252,124,128,118292,120960,239252
352110,201801,113,34,79,32436,75366,107802
352115,201801,72,28,44,26712,41976,68688
352120,201801,97,65,32,62010,30528,92538
352130,201801,221,185,36,176299.2,34344,210643.2
352140,201801,181,75,106,71073,101124,172197
352150,201801,119,66,53,62010.04,50562,112572.04
352160,201801,130,87,43,82998,41022,124020
352170,201801,373,253,120,240408.04,114480,354888.04
352180,201801,616,415,201,394956.5,191750,586706.5
352190,201801,260,101,159,96344.46,151647.84,247992.30
352200,201801,33,18,15,17172,14310,31482
352210,201801,3748,1556,2192,1476176.69,2086014.39,3562191.08
352215,201801,53,29,24,27666,22438.08,50104.08
352220,201801,6913,2729,4184,2598538.44,3989044.39,6587582.83
352230,201801,3170,2022,1148,1915904.03,1089482.88,3005386.91
352240,201801,2208,1299,909,1236766.49,864602.88,2101369.37
352250,201801,2590,1352,1238,1285867.7,1177989.66,2463857.36
352260,201801,1091,600,491,570583.23,468128,1038711.23
352265,201801,60,27,33,25758,31482,57240
352270,201801,407,234,173,222282.92,164986,387268.92
352280,201801,394,246,148,233413,141187.23,374600.23
352290,201801,173,110,63,104368,60102,164470
352300,201801,101,76,25,72504,23850,96354
352310,201801,5758,2817,2941,2674232.75,2799405.51,5473638.26
352320,201801,951,502,449,476269.37,426295.1,902564.47
352330,201801,530,236,294,224810.1,280190,505000.1
352340,201801,1391,682,709,647976,674336.5,1322312.5
352350,201801,329,207,122,197478,116102,313580
352360,201801,232,96,136,90677.7,126861.32,217539.02
352370,201801,102,69,33,65826,31482,97308
352380,201801,120,75,45,71550,42930,114480
352390,201801,2426,1107,1319,1052577.32,1256133.68,2308711.00
352400,201801,469,203,266,192708,253477.8,446185.8
352410,201801,752,539,213,509701.88,202726,712427.88
352420,201801,100,64,36,61056,34344,95400
352430,201801,1752,780,972,739037.84,924587.58,1663625.42
352440,201801,3081,1589,1492,1507583.14,1420466.67,2928049.81
352450,201801,189,160,29,152640,27666,180306
352460,201801,566,290,276,276102.68,262589.2,538691.88
352470,201801,588,197,391,187938,373005,560943
352480,201801,1365,763,602,726629.96,573735.8,1300365.76
352490,201801,83,31,52,29574,49608,79182
352500,201801,1212,542,670,515829,638023.07,1153852.07
352510,201801,730,395,335,375876.96,319590,695466.96
352520,201801,535,238,297,227052,283194.9,510246.9
352530,201801,1708,895,813,853162.2,775220.6,1628382.8
352540,201801,76,51,25,48654,23850,72504
352550,201801,183,105,78,100170,73744.2,173914.2
352560,201801,49,39,10,37206,9540,46746
352570,201801,661,344,317,327573,302418,629991
352580,201801,57,38,19,35298.65,18126,53424.65
352585,201801,16,5,11,4770,10494,15264
352590,201801,4291,2173,2118,2066828.52,2019671.41,4086499.93
352600,201801,359,251,108,238500.96,103032,341532.96
352610,201801,930,437,493,414182.57,470322,884504.57
352620,201801,962,390,572,371106.2,544482,915588.2
352630,201801,219,83,136,79182,129495.96,208677.96
352640,201801,559,397,162,376322.4,154548,530870.4
352650,201801,87,58,29,55332,27666,82998
352660,201801,82,48,34,45792,32436,78228
352670,201801,1651,900,751,855106.76,715360.6,1570467.36
352680,201801,884,570,314,539594.56,298094.04,837688.60
352690,201801,4332,2004,2328,1903495.14,2216760.49,4120255.63
352700,201801,108,62,46,58861.8,43884,102745.8
352710,201801,1351,715,636,680202,603594.72,1283796.72
352720,201801,1298,640,658,608016.2,627441.23,1235457.43
352725,201801,25,23,2,21942,1908,23850
352730,201801,361,179,182,169587.81,173628,343215.81
352740,201801,414,260,154,246085.68,146916,393001.68
352750,201801,23,15,8,14023.8,7632,21655.8
352760,201801,195,140,55,133560,52470,186030
352770,201801,81,63,18,60102,17172,77274
352780,201801,80,45,35,42930,33390,76320
352790,201801,28,23,5,21942,4770,26712
352800,201801,249,167,82,159318,77941.8,237259.8
352810,201801,165,108,57,100521.42,54378,154899.42
352820,201801,65,52,13,49608,12402,62010
352830,201801,89,62,27,59148,25758,84906
352840,201801,589,306,283,290637.2,269982,560619.2
352850,201801,1349,485,864,462022.2,824256,1286278.2
352860,201801,131,86,45,81408,42930,124338
352870,201801,43,27,16,25758,15264,41022
352880,201801,187,127,60,121138.92,57240,178378.92
352885,201801,29,20,9,19080,8586,27666
352890,201801,56,39,17,37206,15932,53138
352900,201801,4904,2380,2524,2252760.68,2400660.99,4653421.67
352910,201801,39,31,8,29574,7632,37206
352920,201801,716,442,274,420714,261396,682110
352930,201801,1263,611,652,581471.36,619039.26,1200510.62
352940,201801,6314,2744,3570,2605870.2,3402423.84,6008294.04
352950,201801,90,35,55,33390,52470,85860
352960,201801,70,46,24,43884,22896,66780
352965,201801,20,8,12,7632,11448,19080
352970,201801,464,350,114,329738.97,107803,437541.97
352980,201801,175,92,83,87768,79182,166950
352990,201801,933,426,507,404447.27,482387.09,886834.36
353000,201801,67,31,36,29574,34344,63918
353010,201801,554,347,207,331038,197458.92,528496.92
353020,201801,285,210,75,200340,71550,271890
353030,201801,1166,526,640,501480.46,609873.66,1111354.12
353040,201801,88,53,35,50562,33390,83952
353050,201801,1299,816,483,770819.03,460686.6,1231505.63
353060,201801,7837,3602,4235,3421682.84,4033983.37,7455666.21
353070,201801,1646,1035,611,980836.46,581603.38,1562439.84
353080,201801,1302,689,613,654755.55,584798,1239553.55
353090,201801,56,34,22,32436,20988,53424
353100,201801,62,51,11,48654,10494,59148
353110,201801,1967,610,1357,580208.88,1291942.26,1872151.14
353120,201801,75,40,35,38160,33390,71550
353130,201801,867,438,429,416879.46,409172.76,826052.22
353140,201801,574,226,348,215543,331992,547535
353150,201801,358,198,160,187938,152630.46,340568.46
353160,201801,102,84,18,80136,17172,97308
353170,201801,194,63,131,60102,124946.46,185048.46
353180,201801,953,434,519,411742.69,494602,906344.69
353190,201801,471,334,137,317483.9,130412,447895.9
353200,201801,185,94,91,89676,86814,176490
353205,201801,26,18,8,17172,7632,24804
353210,201801,83,51,32,48654,30528,79182
353215,201801,55,32,23,30528,21942,52470
353220,201801,85,49,36,46746,33390.27,80136.27
353230,201801,161,60,101,57240,96354,153594
353240,201801,285,160,125,152640,119250,271890
353250,201801,198,103,95,98262,90630,188892
353260,201801,451,323,128,307007.5,122102.46,429109.96
353270,201801,68,49,19,46746,17458.2,64204.2
353280,201801,96,48,48,45315,45792,91107
353282,201801,120,89,31,84906,29574,114480
353284,201801,21,17,4,16218,3816,20034
353286,201801,1,1,0,954,0,954
353290,201801,81,48,33,45792,31473,77265
353300,201801,397,221,176,209292.46,167904,377196.46
353310,201801,50,44,6,41976,5724,47700
353320,201801,62,39,23,37206,21942,59148
353325,201801,56,36,20,34335,18776,53111
353330,201801,68,52,16,49465,15264,64729
353340,201801,620,192,428,183168,407444.26,590612.26
353350,201801,916,425,491,404630.64,466875.9,871506.54
353360,201801,112,89,23,84588.04,21656,106244.04
353370,201801,120,70,50,65826.1,47700,113526.1
353380,201801,29,21,8,20030,7632,27662
353390,201801,1046,501,545,477954,519930,997884
353400,201801,51,31,20,29574,19080,48654
353410,201801,122,77,45,73458,42883,116341
353420,201801,58,25,33,23850,31482,55332
353430,201801,548,364,184,343535.3,175249.8,518785.1
353440,201801,10185,4452,5733,4235090.25,5462975.19,9698065.44
353450,201801,57,31,26,29574,24804,54378
353460,201801,605,332,273,313559.1,259717.5,573276.6
353470,201801,2139,1166,973,1108411.85,925827.23,2034239.08
353475,201801,241,162,79,151858.96,75366,227224.96
353480,201801,190,151,39,144054,37206,181260
353490,201801,233,140,93,133560,88722,222282
353500,201801,185,110,75,103700.96,71550,175250.96
353510,201801,101,73,28,69623.46,26702.46,96325.92
353520,201801,211,143,68,136422,64872,201294
353530,201801,473,257,216,245178,206064,451242
353540,201801,353,235,118,223867.27,112572,336439.27
353550,201801,741,501,240,474104.88,228960,703064.88
353560,201801,636,269,367,255060.69,349518.06,604578.75
353570,201801,57,30,27,28620,25758,54378
353580,201801,356,272,84,259011,80136,339147
353590,201801,83,56,27,53106.04,25758,78864.04
353600,201801,266,148,118,140875,111936,252811
353610,201801,114,59,55,56286,52470,108756
353620,201801,565,307,258,290891.5,245845.8,536737.3
353625,201801,51,29,22,27666,20988,48654
353630,201801,238,172,66,159757.16,62964,222721.16
353640,201801,125,87,38,82521,36252,118773
353650,201801,847,332,515,314629.2,491310,805939.2
353657,201801,22,16,6,15264,5724,20988
353660,201801,257,142,115,135468,109423.8,244891.8
353670,201801,749,445,304,423576.2,290016,713592.2
353680,201801,99,70,29,66780,27666,94446
353690,201801,47,37,10,35298,9540,44838
353700,201801,284,198,86,188892,82044,270936
353710,201801,412,195,217,185076.8,206732,391808.8
353715,201801,47,35,12,33103.8,11448,44551.8
353720,201801,358,168,190,160254,181260,341514
353730,201801,1130,694,436,659166.9,415657.8,1074824.7
353740,201801,653,362,291,345061.8,277614,622675.8
353750,201801,92,58,34,54800.14,32436,87236.14
353760,201801,2725,1035,1690,985331.11,1608657.28,2593988.39
353770,201801,100,81,19,76797,18126,94923
353780,201801,1103,558,545,530615.96,518022,1048637.96
353790,201801,506,288,218,272683.1,204967.35,477650.45
353800,201801,3252,1660,1592,1575610.69,1516388.72,3091999.41
353810,201801,238,133,105,126028.71,100143,226171.71
353820,201801,183,91,92,86814,87143.41,173957.41
353830,201801,47,40,7,38160,6678,44838
353850,201801,168,87,81,82998,77274,160272
353860,201801,458,206,252,195808.5,240121.8,435930.3
353870,201801,4975,2491,2484,2360279.7,2358407.4,4718687.1
353880,201801,664,474,190,450860.4,180306.12,631166.52
353890,201801,592,334,258,318064,245846,563910
353900,201801,135,66,69,62964,65826,128790
353910,201801,177,88,89,83952,84906,168858
353920,201801,452,249,203,236354.4,193219.16,429573.56
353930,201801,996,597,399,567368.79,379411.8,946780.59
353940,201801,188,104,84,98452.8,79278,177730.8
353950,201801,513,317,196,302131.8,186975,489106.8
353960,201801,71,59,12,56286,11448,67734
353970,201801,73,47,26,44838,24804,69642
353980,201801,1517,754,763,716656.95,726963.76,1443620.71
353990,201801,78,43,35,41022,33390,74412
354000,201801,373,178,195,169145,185835.2,354980.2
354010,201801,95,51,44,48654,41499,90153
354020,201801,547,345,202,328176,192708,520884
354025,201801,52,41,11,39114,10494,49608
354030,201801,65,35,30,33390,28620,62010
354040,201801,92,66,26,62582.4,24804,87386.4
354050,201801,192,107,85,101792,81090,182882
354060,201801,773,373,400,355842,379359.4,735201.4
354070,201801,883,514,369,488189.99,352026,840215.99
354075,201801,210,115,95,109615,89676.8,199291.8
354080,201801,293,127,166,120871.8,158364,279235.8
354085,201801,19,12,7,11448,6678,18126
354090,201801,314,175,139,166869,132606,299475
354100,201801,5433,2250,3183,2136466.96,3030190.98,5166657.94
354105,201801,80,39,41,37206,39114,76320
354110,201801,48,22,26,20988,24804,45792
354120,201801,150,104,46,99076.97,43884,142960.97
354130,201801,695,468,227,446234,216268,662502
354140,201801,3156,1480,1676,1407953.43,1597607.03,3005560.46
354150,201801,641,396,245,377498,232299,609797
354160,201801,701,443,258,421429.5,245846,667275.5
354165,201801,19,12,7,11448,6678,18126
354170,201801,171,116,55,109996.2,52470,162466.2
354180,201801,63,39,24,36880,22896,59776
354190,201801,217,100,117,93778.2,111618,205396.2
354200,201801,129,70,59,66303,56286,122589
354210,201801,71,35,36,33390,34344,67734
354220,201801,641,399,242,378579.16,229342.15,607921.31
354230,201801,158,65,93,62010,87768.6,149778.6
354240,201801,315,204,111,193662.49,105257.96,298920.45
354250,201801,91,55,36,52470,34344,86814
354260,201801,1896,880,1016,828901.94,967924,1796825.94
354270,201801,97,72,25,68688,23850,92538
354280,201801,34,18,16,17172,15264,32436
354290,201801,145,100,45,94589.1,42930,137519.1
354300,201801,419,285,134,271573,127678,399251
354310,201801,104,75,29,70596.2,27666,98262.2
354320,201801,180,95,85,90630,81090,171720
354323,201801,16,14,2,13356,1908,15264
354325,201801,109,62,47,58342,44838,103180
354330,201801,2538,859,1679,814851.26,1599595.98,2414447.24
354340,201801,10536,5133,5403,4883521.33,5148587.96,10032109.29
354350,201801,131,87,44,82998,41832.9,124830.9
354360,201801,87,48,39,45792,37206,82998
354370,201801,268,143,125,136422,119250,255672
354380,201801,210,127,83,120372,79182,199554
354390,201801,2760,997,1763,950187.95,1680526.98,2630714.93
354400,201801,322,170,152,161226.8,144435.8,305662.6
354410,201801,608,295,313,279804.43,297648.2,577452.63
354420,201801,271,171,100,163134,95400,258534
354425,201801,319,181,138,172674,131652,304326
354430,201801,185,116,69,109089.9,65062.8,174152.7
354440,201801,40,28,12,26712,11448,38160
354450,201801,52,37,15,35298,14310,49608
354460,201801,101,59,42,56286,40068,96354
354470,201801,37,26,11,24804,10494,35298
354480,201801,118,61,57,58185,54368.46,112553.46
354490,201801,147,93,54,88562.97,51516,140078.97
354500,201801,398,198,200,188892,190800,379692
354510,201801,103,71,32,67734,30528,98262
354515,201801,37,13,24,12402,22896,35298
354520,201801,1609,715,894,679399.2,852437.56,1531836.76
354530,201801,647,340,307,322639.09,292020.2,614659.29
354540,201801,273,156,117,148824,111613.23,260437.23
354550,201801,42,23,19,21942,18126,40068
354560,201801,162,97,65,92252,62000.46,154252.46
354570,201801,140,92,48,87768,45792,133560
354580,201801,1959,931,1028,885311,980412.26,1865723.26
354600,201801,277,147,130,137984.12,124005.69,261989.81
354610,201801,71,64,7,61056,6678,67734
354620,201801,64,21,43,20034,41022,61056
354625,201801,17,11,6,10494,5720,16214
354630,201801,318,207,111,196972.55,105894,302866.55
354640,201801,785,503,282,475936.36,269028,744964.36
354650,201801,71,39,32,36911,30499.92,67410.92
354660,201801,819,607,212,575056.46,202248,777304.46
354670,201801,284,101,183,95401,173629,269030
354680,201801,1243,469,774,447426,737919,1185345
354690,201801,91,62,29,58195,27666,85861
354700,201801,77,57,20,54378,19080,73458
354710,201801,58,40,18,37523.96,17172,54695.96
354720,201801,20,19,1,18126,954,19080
354730,201801,1906,804,1102,763859.2,1051117.2,1814976.4
354740,201801,59,43,16,41022,15264,56286
354750,201801,445,263,182,250893,173628,424521
354760,201801,515,317,198,300036,188319.8,488355.8
354765,201801,11,5,6,4770,5724,10494
354770,201801,329,227,102,215613.03,96544.8,312157.83
354780,201801,8116,3315,4801,3149056.73,4574354.44,7723411.17
354790,201801,114,68,46,64872,43884,108756
354800,201801,414,230,184,219420,175231,394651
354805,201801,103,53,50,49926,47700,97626
354810,201801,137,80,57,76033.8,54378,130411.8
354820,201801,186,81,105,77065,100170,177235
354830,201801,41,21,20,20034,19080,39114
354840,201801,55,37,18,35298,17172,52470
354850,201801,4555,2017,2538,1916430.19,2416975.08,4333405.27
354860,201801,330,160,170,152640,159785.52,312425.52
354870,201801,11776,5326,6450,5052766.2,6143064.79,11195830.99
354880,201801,2994,1125,1869,1071612.46,1781430.9,2853043.36
354890,201801,2823,1558,1265,1480816.63,1205637.38,2686454.01
354900,201801,59,39,20,37206,19080,56286
354910,201801,1217,638,579,605752.24,552366,1158118.24
354920,201801,52,44,8,41976,7632,49608
354925,201801,12,7,5,6678,4770,11448
354930,201801,30,27,3,25488,2862,28350
354940,201801,788,578,210,549459.19,200340,749799.19
354950,201801,219,145,74,137720,70596,208316
354960,201801,170,63,107,60102,101792,161894
354970,201801,843,551,292,520795.1,277929.02,798724.12
354980,201801,8392,3138,5254,2985078.09,5009612.21,7994690.30
354990,201801,9174,4311,4863,4100522.86,4633223.28,8733746.14
354995,201801,513,181,332,172674,316126.98,488800.98
355000,201801,452,148,304,141187.23,289062,430249.23
355010,201801,619,391,228,373014,215300.48,588314.48
355020,201801,711,444,267,422617.59,254710,677327.59
355030,201801,202948,78603,124345,74762252.42,118526651.8,193288904.22
355040,201801,715,340,375,322834.3,357559.2,680393.5
355050,201801,151,100,51,94129.77,48654,142783.77
355060,201801,1458,734,724,695386.94,689504.3,1384891.24
355070,201801,1469,727,742,689718.59,706875,1396593.59
355080,201801,200,115,85,109710,80202.8,189912.8
355090,201801,292,194,98,182978,93492,276470
355100,201801,4758,2370,2388,2240589.61,2276185.38,4516774.99
355110,201801,269,171,98,162177,93492,255669
355120,201801,80,55,25,52470,23850,76320
355130,201801,54,28,26,26712,24804,51516
355140,201801,182,122,60,116388,57240,173628
355150,201801,671,406,265,386080.2,252333,638413.2
355160,201801,445,213,232,200817.96,221042,421859.96
355170,201801,2036,1052,984,1002228.87,938716.92,1940945.79
355180,201801,623,267,356,253764,338789.25,592553.25
355190,201801,221,150,71,143100,67734,210834
355200,201801,116,68,48,64872,45792,110664
355210,201801,724,418,306,398772,291905.46,690677.46
355220,201801,6556,3526,3030,3353947.76,2881691.31,6235639.07
355230,201801,108,64,44,61056,41971.23,103027.23
355240,201801,4200,1844,2356,1745718.7,2243771.3,3989490.0
355250,201801,5342,2613,2729,2485444.3,2600063.1,5085507.4
355255,201801,51,30,21,28620,20034,48654
355260,201801,185,111,74,104921.12,70568.46,175489.58
355270,201801,166,98,68,93492,64157,157649
355280,201801,6279,2647,3632,2520330.46,3460226.46,5980556.92
355290,201801,78,59,19,56286,18126,74412
355300,201801,180,116,64,109424.6,61056,170480.6
355310,201801,104,58,46,55332,43884,99216
355320,201801,91,46,45,43884,41982.6,85866.6
355330,201801,270,149,121,142146,115434,257580
355340,201801,1461,545,916,517323.61,873121.97,1390445.58
355350,201801,142,74,68,70596,64872,135468
355360,201801,181,114,67,108546.12,63918,172464.12
355365,201801,26,21,5,20034,4770,24804
355370,201801,1027,581,446,548388.2,424226.09,972614.29
355380,201801,771,516,255,490818.52,242984,733802.52
355385,201801,59,41,18,39114,17172,56286
355390,201801,105,61,44,58194,41976,100170
355395,201801,187,113,74,106415.23,70596,177011.23
355400,201801,1536,958,578,909647.52,550839.8,1460487.32
355410,201801,4830,2252,2578,2130033.94,2450936.16,4580970.10
355420,201801,49,37,12,35298,11448,46746
355430,201801,347,214,133,202820.4,126882,329702.4
355440,201801,79,45,34,42930,32436,75366
355450,201801,428,202,226,189703.74,214554.8,404258.54
355460,201801,70,54,16,50562.42,15264,65826.42
355465,201801,50,31,19,29574,18126,47700
355470,201801,187,73,114,68688.1,108756,177444.1
355475,201801,12,8,4,7632,3816,11448
355480,201801,459,200,259,189179,245645.46,434824.46
355490,201801,115,82,33,78228,31482,109710
355495,201801,52,25,27,23850,25758,49608
355500,201801,1701,973,728,923366.46,694473.46,1617839.92
355510,201801,271,196,75,183525.67,71550,255075.67
355520,201801,36,28,8,26426,7632,34058
355530,201801,23,16,7,15264,6678,21942
355535,201801,78,39,39,37206,37206,74412
355540,201801,2343,935,1408,890531.53,1341019.42,2231550.95
355550,201801,63,38,25,36252,23850,60102
355560,201801,240,120,120,114480,113843.96,228323.96
355570,201801,31,20,11,19080,10494,29574
355580,201801,267,185,82,176490,77937.23,254427.23
355590,201801,23,14,9,13356,8586,21942
355600,201801,271,141,130,134514,123729.23,258243.23
355610,201801,207,136,71,129744,67734,197478
355620,201801,1255,583,672,555371.8,640005.98,1195377.78
355630,201801,403,290,113,275707,107802,383509
355635,201801,126,61,65,58194,61997,120191
355640,201801,569,333,236,316728.16,225144,541872.16
355645,201801,826,357,469,338885.99,445546.82,784432.81
355650,201801,2102,896,1206,851227.8,1150505.46,2001733.26
355660,201801,262,139,123,132606,117342,249948
355670,201801,485,187,298,178398,284292,462690
355680,201801,207,119,88,112572.58,83666,196238.58
355690,201801,87,40,47,38160,44838,82998
355695,201801,14,12,2,11448,1908,13356
355700,201801,1135,582,553,550158.6,526990,1077148.6
355710,201801,2187,1201,986,1142403.56,940043.8,2082447.36
355715,201801,20,18,2,17172,1908,19080
355720,201801,206,123,83,115752.08,79178,194930.08
355730,201801,91,52,39,48447.95,37206,85653.95
410010,201801,136,114,22,108756,20988,129744
410020,201801,105,94,11,89676,10494,100170
410030,201801,163,103,60,97594.4,57240,154834.4
410040,201801,968,528,440,503473.5,419570,923043.5
410045,201801,26,21,5,20034,4770,24804
410050,201801,467,261,206,248994,196047,445041
410060,201801,274,212,62,202248,59148,261396
410070,201801,311,257,54,245178,51516,296694
410080,201801,166,108,58,103032,55332,158364
410090,201801,77,68,9,64663,8586,73249
410100,201801,297,211,86,200979.18,81328.5,282307.68
410105,201801,43,25,18,23850,17172,41022
410110,201801,312,192,120,183168,114480,297648
410115,201801,25,18,7,17172,6678,23850
410120,201801,448,229,219,218164.8,208926,427090.8
410130,201801,42,26,16,24804,15264,40068
410140,201801,3080,1515,1565,1440385.58,1489662.06,2930047.64
410150,201801,2688,1079,1609,1028213.44,1534676,2562889.44
410160,201801,503,321,182,305947.8,173628,479575.8
410165,201801,67,45,22,42930,20988,63918
410170,201801,168,126,42,117966.44,40068,158034.44
410180,201801,2149,1247,902,1185227.19,858574.15,2043801.34
410185,201801,32,29,3,27666,2862,30528
410190,201801,442,276,166,263304,158364,421668
410200,201801,973,725,248,690800.94,236305.8,927106.74
410210,201801,556,286,270,272844,257008,529852
410220,201801,40,22,18,20988,17172,38160
410230,201801,125,69,56,65826,53424,119250
410240,201801,733,481,252,458301.8,240408,698709.8
410250,201801,379,278,101,264607.84,96349.23,360957.07
410260,201801,283,170,113,162180,107802,269982
410270,201801,28,17,11,16218,10494,26712
410275,201801,68,51,17,48654,16218,64872
410280,201801,322,179,143,170506.52,136422,306928.52
410290,201801,233,148,85,141192,81090,222282
410300,201801,83,67,16,63918,15264,79182
410302,201801,24,16,8,15264,7632,22896
410304,201801,45,31,14,29574,13356,42930
410305,201801,205,111,94,105086.2,89676,194762.2
410310,201801,262,168,94,160272,89656.92,249928.92
410315,201801,54,39,15,37182,14310,51492
410320,201801,139,98,41,93492,39114,132606
410322,201801,34,24,10,22896,9540,32436
410330,201801,164,116,48,110664,45602,156266
410335,201801,98,59,39,56286,37206,93492
410337,201801,38,33,5,31482,4770,36252
410340,201801,33,31,2,29574,1908,31482
410345,201801,215,137,78,130698,74412,205110
410347,201801,52,39,13,37206,12402,49608
410350,201801,231,141,90,134228,85860,220088
410360,201801,456,275,181,259806.4,172102,431908.4
410370,201801,2382,1013,1369,963760.32,1302960.62,2266720.94
410380,201801,218,143,75,136422,71550,207972
410390,201801,370,279,91,266162,86814,352976
410395,201801,34,22,12,20988,11067,32055
410400,201801,830,425,405,404120.4,385831,789951.4
410405,201801,89,65,24,62010,22896,84906
410410,201801,41,32,9,30528,8586,39114
410420,201801,1657,817,840,777323.89,799770.96,1577094.85
410425,201801,182,88,94,83762,89676,173438
410430,201801,2199,1285,914,1222742,870792.32,2093534.32
410440,201801,395,287,108,272845,103032,375877
410442,201801,359,241,118,228961,112572,341533
410445,201801,424,291,133,277614,126882,404496
410450,201801,410,199,211,189846,201294,391140
410460,201801,407,218,189,207676.8,180306,387982.8
410465,201801,193,125,68,118009.8,64872,182881.8
410470,201801,220,140,80,133560,76320,209880
410480,201801,5729,2831,2898,2680726.4,2758572.79,5439299.19
410490,201801,1383,915,468,871127,444565,1315692
410500,201801,265,154,111,146916,105894,252810
410510,201801,180,133,47,126882,44829,171711
410520,201801,262,195,67,186030,63918,249948
410530,201801,234,87,147,82998,140234,223232
410540,201801,317,228,89,216931.6,84901.23,301832.83
410550,201801,1603,698,905,665510.8,862263.36,1527774.16
410560,201801,145,114,31,108756,29574,138330
410570,201801,435,308,127,291744.2,121158,412902.2
410580,201801,3171,1427,1744,1359742.8,1662346,3022088.8
410590,201801,400,287,113,273798,107802,381600
410600,201801,182,158,24,150732,22896,173628
410610,201801,55,44,11,41976,10494,52470
410620,201801,238,172,66,164088,62964,227052
410630,201801,447,264,183,251856,173423,425279
410640,201801,973,597,376,566559.99,357097.28,923657.27
410645,201801,96,72,24,68307,22896,91203
410650,201801,365,251,114,238500,108756,347256
410655,201801,79,61,18,58194,17172,75366
410657,201801,44,20,24,19080,22896,41976
410660,201801,589,419,170,398483,162180,560663
410670,201801,77,63,14,60102,13356,73458
410680,201801,190,158,32,150732,30528,181260
410685,201801,16,10,6,9540,5724,15264
410690,201801,28443,12342,16101,11755823.32,15346926.55,27102749.87
410700,201801,321,235,86,223618,82044,305662
410710,201801,126,101,25,96354,23850,120204
410712,201801,23,14,9,13356,8586,21942
410715,201801,83,61,22,58194,20988,79182
410720,201801,588,354,234,337716,222686.54,560402.54
410725,201801,179,129,50,123066,47700,170766
410730,201801,87,54,33,51516,31482,82998
410740,201801,112,81,31,77274,29574,106848
410750,201801,220,164,56,156452,53419.23,209871.23
410752,201801,24,15,9,14310,8586,22896
410753,201801,53,23,30,21269.43,28620,49889.43
410754,201801,33,20,13,19080,12402,31482
410755,201801,81,55,26,52183.8,24804,76987.8
410760,201801,712,405,307,386370,292878,679248
410765,201801,1662,799,863,756330.68,822148.46,1578479.14
410770,201801,108,91,17,86814,16218,103032
410773,201801,45,34,11,32436,10494,42930
410775,201801,175,132,43,125260.2,41022,166282.2
410780,201801,81,43,38,41022,36252,77274
410785,201801,57,45,12,42930,11448,54378
410790,201801,70,33,37,31482,35298,66780
410800,201801,291,182,109,172675,103986,276661
410810,201801,26,22,4,20988,3530,24518
410820,201801,178,132,46,125785,43884,169669
410830,201801,8505,3875,4630,3688284.84,4414874.01,8103158.85
410832,201801,105,72,33,68401.8,31482,99883.8
410840,201801,1405,779,626,740898.08,596805.68,1337703.76
410845,201801,64,39,25,37206,23850,61056
410850,201801,190,131,59,124688,56286,180974
410855,201801,47,40,7,38160,6678,44838
410860,201801,666,391,275,372228.76,262350,634578.76
410865,201801,106,82,24,78228,22896,101124
410870,201801,150,131,19,124974,17835,142809
410880,201801,1104,550,554,524189.62,528471,1052660.62
410890,201801,74,51,23,48654,21942,70596
410895,201801,74,55,19,52470,18126,70596
410900,201801,19,13,6,12402,5724,18126
410910,201801,17,15,2,14310,1908,16218
410920,201801,33,22,11,20988,10494,31482
410930,201801,503,326,177,310792.98,168858,479650.98
410940,201801,4327,2576,1751,2448342.16,1667190.4,4115532.56
410950,201801,127,92,35,87768,33390,121158
410960,201801,763,338,425,322166,405260,727426
410965,201801,63,48,15,45505.8,14310,59815.8
410970,201801,628,444,184,423108.2,175536,598644.2
410975,201801,105,64,41,60545,39114,99659
410980,201801,1554,702,852,667161.82,811845.23,1479007.05
410990,201801,268,182,86,173459.24,81757.8,255217.04
411000,201801,62,40,22,38160,20988,59148
411005,201801,23,18,5,17172,4770,21942
411007,201801,236,136,100,129744,95400,225144
411010,201801,571,397,174,378738,165996,544734
411020,201801,287,197,90,187938,85860,273798
411030,201801,19,10,9,9540,8586,18126
411040,201801,49,34,15,32436,14310,46746
411050,201801,216,173,43,164364.72,40895.12,205259.84
411060,201801,522,353,169,336753,161226,497979
411065,201801,60,52,8,49608,7632,57240
411070,201801,1195,803,392,761866,373014,1134880
411080,201801,244,173,71,165126,67734,232860
411090,201801,114,86,28,82044,26712,108756
411095,201801,264,108,156,102555,148814,251369
411100,201801,112,93,19,88722,18126,106848
411110,201801,123,85,38,81090,36252,117342
411120,201801,181,135,46,128790,43884,172674
411125,201801,178,79,99,74717.28,94446,169163.28
411130,201801,123,107,16,101440,15264,116704
411140,201801,178,123,55,117108.12,51945.3,169053.42
411150,201801,1210,810,400,772730.46,381600,1154330.46
411155,201801,117,83,34,79182,32436,111618
411160,201801,21,10,11,9540,10494,20034
411170,201801,59,53,6,50275.8,5724,55999.8
411180,201801,924,607,317,577551.8,302413.23,879965.03
411190,201801,339,193,146,183454.2,139284,322738.2
411200,201801,666,443,223,421351.89,211835.9,633187.79
411210,201801,677,361,316,342844.21,301464,644308.21
411220,201801,147,111,36,105894,34344,140238
411230,201801,41,37,4,35298,3816,39114
411240,201801,120,81,39,77274,37206,114480
411250,201801,421,306,115,291924,109710,401634
411260,201801,22,16,6,15264,5724,20988
411270,201801,291,156,135,148824,128790,277614
411275,201801,200,176,24,167188.6,22896,190084.6
411280,201801,227,162,65,153277.12,62010,215287.12
411290,201801,57,42,15,40068,14310,54378
411295,201801,141,113,28,107802,26712,134514
411300,201801,70,36,34,34344,32436,66780
411310,201801,92,70,22,66780,20988,87768
411320,201801,756,549,207,522220.4,195875.28,718095.68
411325,201801,45,27,18,25758,17172,42930
411330,201801,914,584,330,555610.61,314089.6,869700.21
411340,201801,26,18,8,17172,7318,24490
411342,201801,76,55,21,52470,20034,72504
411345,201801,121,58,63,55332,60102,115434
411350,201801,482,385,97,366002.44,91575.2,457577.64
411360,201801,55,36,19,34344,18126,52470
411370,201801,14073,5763,8310,5480043.71,7915303.59,13395347.30
411373,201801,191,141,50,134514,47700,182214
411375,201801,74,61,13,58194,12402,70596
411380,201801,95,71,24,67734,22896,90630
411390,201801,139,92,47,87768,44838,132606
411400,201801,350,264,86,251847,82044,333891
411410,201801,450,229,221,217798.2,210548,428346.2
411420,201801,1029,470,559,446090.4,532237,978327.4
411430,201801,399,259,140,246418.2,133551,379969.2
411435,201801,36,25,11,23850,10494,34344
411440,201801,471,374,97,355142.76,92538,447680.76
411450,201801,429,356,73,339624,69642,409266
411460,201801,739,295,444,280485.2,422293.96,702779.16
411470,201801,89,66,23,62964,21942,84906
411480,201801,624,350,274,332374.6,260823.6,593198.2
411490,201801,290,181,109,172674,103986,276660
411500,201801,111,94,17,89676,15837,105513
411510,201801,217,175,42,166202.06,40068,206270.06
411520,201801,5902,2309,3593,2197821,3420208.93,5618029.93
411530,201801,109,73,36,69642,34344,103986
411535,201801,45,18,27,17172,25758,42930
411540,201801,346,239,107,226983.9,102078,329061.9
411545,201801,57,40,17,38160,16218,54378
411550,201801,73,57,16,54378,15264,69642
411560,201801,383,179,204,170102.38,194616,364718.38
411570,201801,787,301,486,286859,463454,750313
411573,201801,37,22,15,20988,14310,35298
411575,201801,261,159,102,151686,97308,248994
411580,201801,1218,482,736,458521.02,701155,1159676.02
411585,201801,79,39,40,37206,38160,75366
411590,201801,25,17,8,16218,7632,23850
411600,201801,25,10,15,9540,14310,23850
411605,201801,238,107,131,101935,124974,226909
411610,201801,237,159,78,151686,74412,226098
411620,201801,356,200,156,190609.2,148184.82,338794.02
411630,201801,58,39,19,37206,18126,55332
411640,201801,35,29,6,27666,5724,33390
411650,201801,14,10,4,9540,3816,13356
411660,201801,32,26,6,24804,5724,30528
411670,201801,245,186,59,177444,56286,233730
411680,201801,155,132,23,125928,21942,147870
411690,201801,604,320,284,304681.44,270594.72,575276.16
411695,201801,62,46,16,43884,15264,59148
411700,201801,167,145,22,138330,20988,159318
411705,201801,101,65,36,62010,34344,96354
411710,201801,296,200,96,190484.14,91584,282068.14
411720,201801,136,87,49,82998,46746,129744
411721,201801,57,47,10,44838,9540,54378
411722,201801,97,42,55,40068,52470,92538
411725,201801,143,111,32,105578,30528,136106
411727,201801,73,56,17,53424,15931.8,69355.8
411729,201801,32,24,8,22896,7632,30528
411730,201801,546,355,191,337079.96,181928,519007.96
411740,201801,30,19,11,18126,10494,28620
411745,201801,66,44,22,41185,20988,62173
411750,201801,855,408,447,388135.9,425460.15,813596.05
411760,201801,1176,889,287,846857.2,273789,1120646.2
411770,201801,441,293,148,279502.92,141192,420694.92
411780,201801,368,238,130,227052,124020,351072
411790,201801,531,297,234,281456.47,223123.14,504579.61
411800,201801,170,133,37,126882,35298,162180
411810,201801,164,127,37,121158,35298,156456
411820,201801,2102,1026,1076,976495.52,1025780.3,2002275.82
411830,201801,12,12,0,11448,0,11448
411840,201801,1958,1216,742,1159110,707088.8,1866198.8
411845,201801,50,19,31,18126,29574,47700
411850,201801,1251,721,530,685344.08,503667.02,1189011.10
411860,201801,44,28,16,26426,15264,41690
411870,201801,64,45,19,42930,17839.8,60769.8
411880,201801,426,276,150,263048,142355.88,405403.88
411885,201801,103,69,34,65826,32436,98262
411890,201801,322,204,118,192422.99,112562.46,304985.45
411900,201801,69,50,19,47700,18126,65826
411910,201801,165,136,29,129734.46,26826.48,156560.94
411915,201801,2078,892,1186,849815.57,1130380.05,1980195.62
411920,201801,124,102,22,97308,20988,118296
411925,201801,14,9,5,8586,4770,13356
411930,201801,795,589,206,560000,196524,756524
411940,201801,587,421,166,401157,158339.56,559496.56
411950,201801,896,472,424,449620.2,403510.24,853130.44
411960,201801,970,690,280,655888,267120,923008
411965,201801,23,16,7,15264,6678,21942
411970,201801,71,64,7,61056,6678,67734
411980,201801,196,129,67,123066,63918,186984
411990,201801,4880,2852,2028,2704791.77,1932938.8,4637730.57
411995,201801,459,172,287,164088,273798,437886
412000,201801,289,171,118,162419.56,112562.46,274982.02
412010,201801,45,27,18,25758,17172,42930
412015,201801,45,32,13,30528,12402,42930
412020,201801,28,25,3,23563.8,2862,26425.8
412030,201801,64,54,10,51516,9540,61056
412033,201801,55,35,20,33366,19080,52446
412035,201801,66,42,24,40068,22896,62964
412040,201801,35,25,10,23564,9540,33104
412050,201801,201,150,51,143100,48654,191754
412060,201801,747,584,163,554274.74,154511.8,708786.54
412065,201801,51,36,15,34344,14310,48654
412070,201801,153,103,50,97594.2,47700,145294.2
412080,201801,279,144,135,137376,128790,266166
412085,201801,32,15,17,14310,16218,30528
412090,201801,738,465,273,441655.2,260442,702097.2
412100,201801,247,207,40,196525,38160,234685
412110,201801,71,58,13,55332,12402,67734
412120,201801,313,204,109,194043.6,103986,298029.6
412125,201801,76,45,31,42643.8,29574,72217.8
412130,201801,48,35,13,33390,12402,45792
412135,201801,28,15,13,14310,12402,26712
412140,201801,303,215,88,204470.82,83952,288422.82
412150,201801,259,174,85,165042.04,81090,246132.04
412160,201801,81,48,33,45792,31482,77274
412170,201801,633,453,180,432162,171720,603882
412175,201801,39,28,11,26712,10494,37206
412180,201801,197,156,41,148224.61,38493.9,186718.51
412190,201801,331,266,65,253091.43,62010,315101.43
412200,201801,190,123,67,117342,63918,181260
412210,201801,74,58,16,55332,15264,70596
412215,201801,245,166,79,158078,75079.8,233157.8
412217,201801,70,55,15,52470,14310,66780
412220,201801,822,613,209,584802,199386,784188
412230,201801,337,205,132,193928.2,125909.46,319837.66
412240,201801,1319,650,669,615943.18,636145.44,1252088.62
412250,201801,380,245,135,233730,128790,362520
412260,201801,127,93,34,88722,32436,121158
412265,201801,168,134,34,127836,32436,160272
412270,201801,84,52,32,49608,30528,80136
412280,201801,89,70,19,66780,18126,84906
412290,201801,94,64,30,61056,28620,89676
412300,201801,219,140,79,133560,75223,208783
412310,201801,43,36,7,34344,6678,41022
412320,201801,95,81,14,77274,13356,90630
412330,201801,168,149,19,142146,18126,160272
412340,201801,142,98,44,93492,41690,135182
412350,201801,595,295,300,280428.3,286200,566628.3
412360,201801,27,24,3,22896,2862,25758
412370,201801,162,138,24,130698,22896,153594
412380,201801,255,193,62,183835.8,58900.5,242736.3
412382,201801,47,25,22,23850,20988,44838
412385,201801,137,98,39,93492,37206,130698
412390,201801,278,207,71,197478,67734,265212
412395,201801,64,50,14,47700,13356,61056
412400,201801,71,52,19,49608,18126,67734
412402,201801,239,111,128,105889.23,121825.8,227715.03
412405,201801,816,326,490,309546.43,466783.66,776330.09
412410,201801,945,594,351,565150,334854,900004
412420,201801,15,12,3,11448,2862,14310
412430,201801,22,15,7,14310,6678,20988
412440,201801,603,324,279,306760.38,264301.96,571062.34
412450,201801,83,69,14,65826,13356,79182
412460,201801,80,64,16,61056,15264,76320
412470,201801,257,204,53,194616,50562,245178
412480,201801,175,135,40,127836.9,38160,165996.9
412490,201801,165,139,26,132606,24804,157410
412500,201801,477,388,89,368863.8,84906,453769.8
412510,201801,188,155,33,147123,31482,178605
412520,201801,130,69,61,65826,58194,124020
412530,201801,108,58,50,55332,47413.8,102745.8
412535,201801,109,82,27,78210,25758,103968
412540,201801,63,30,33,28620,31482,60102
412545,201801,100,73,27,69642,25758,95400
412550,201801,3479,1577,1902,1500254.74,1813077.9,3313332.64
412555,201801,14,9,5,8586,4770,13356
412560,201801,587,441,146,417857.2,139284,557141.2
412570,201801,734,409,325,388335.24,309764,698099.24
412575,201801,85,60,25,57240,23850,81090
412580,201801,165,111,54,105894,51516,157410
412590,201801,33,31,2,29574,1908,31482
412600,201801,173,132,41,125928,39114,165042
412610,201801,32,21,11,20034,10494,30528
412620,201801,148,129,19,123066,18126,141192
412625,201801,2178,1172,1006,1115218.7,957846.59,2073065.29
412627,201801,69,56,13,53424,12402,65826
412630,201801,429,287,142,272364.2,135182,407546.2
412635,201801,63,20,43,19080,41022,60102
412640,201801,119,79,40,75366,38160,113526
412650,201801,338,212,126,201961.8,120199.23,322161.03
412660,201801,483,289,194,274991,185076,460067
412665,201801,50,44,6,41976,5724,47700
412667,201801,293,198,95,187786.9,90314.92,278101.82
412670,201801,61,51,10,48654,9540,58194
412680,201801,286,226,60,215604,57240,272844
412690,201801,113,74,39,70596,36920,107516
412700,201801,164,110,54,104940,51230,156170
412710,201801,1401,870,531,824544.6,504094.74,1328639.34
412720,201801,228,155,73,147870,69642,217512
412730,201801,205,163,42,155502,39114,194616
412740,201801,412,223,189,212598.9,180306,392904.9
412750,201801,463,266,197,252810,187938,440748
412760,201801,254,130,124,124020,118296,242316
412770,201801,2073,1178,895,1119428.94,852286.2,1971715.14
412780,201801,149,117,32,111618,30528,142146
412785,201801,265,136,129,129267,123066,252333
412788,201801,35,20,15,19080,14310,33390
412790,201801,140,115,25,109042.2,23850,132892.2
412795,201801,157,117,40,111618,38160,149778
412796,201801,298,206,92,195359.18,87634.44,282993.62
412800,201801,557,363,194,345742.39,185076,530818.39
412810,201801,2994,1670,1324,1587629.3,1261851.03,2849480.33
412820,201801,925,604,321,566523.99,304087.89,870611.88
412830,201801,16,13,3,12402,2862,15264
412840,201801,217,156,61,147870.2,58194,206064.2
412850,201801,778,529,249,503712,237546,741258
412853,201801,177,94,83,89676,79182,168858
412855,201801,224,122,102,115276.82,97308,212584.82
412860,201801,91,68,23,64872,21942,86814
412862,201801,59,44,15,41689.8,14310,55999.8
412863,201801,7,6,1,5724,954,6678
412865,201801,42,32,10,30528,9540,40068
412870,201801,108,72,36,68688,34344,103032
412880,201801,105,79,26,75366,24804,100170
420005,201801,34,31,3,29574,2290,31864
420010,201801,366,242,124,229680.34,118296,347976.34
420020,201801,76,65,11,62010,10494,72504
420030,201801,28,25,3,23850,2862,26712
420040,201801,107,80,27,76320,25758,102078
420050,201801,55,33,22,31461.89,20947.89,52409.78
420055,201801,20,19,1,18126,954,19080
420060,201801,29,21,8,20034,7632,27666
420070,201801,104,90,14,85860,13346.46,99206.46
420075,201801,13,11,2,10494,1908,12402
420080,201801,46,40,6,37253.7,5724,42977.7
420090,201801,35,33,2,30704.49,1908,32612.49
420100,201801,159,134,25,126882.2,23850,150732.2
420110,201801,18,18,0,17172,0,17172
420120,201801,43,32,11,30528,10494,41022
420125,201801,82,65,17,62010,16218,78228
420127,201801,33,30,3,28620,2862,31482
420130,201801,384,247,137,235342.46,130449.96,365792.42
420140,201801,1261,742,519,706257.38,495060,1201317.38
420150,201801,48,41,7,39114,6678,45792
420160,201801,40,38,2,36252,1908,38160
420165,201801,18,14,4,13356,3816,17172
420170,201801,63,41,22,39114,20988,60102
420180,201801,23,22,1,20988,954,21942
420190,201801,31,28,3,26712,2862,29574
420195,201801,127,61,66,58194,62678,120872
420200,201801,1271,565,706,535003.6,672200.04,1207203.64
420205,201801,66,33,33,31482,31482,62964
420207,201801,104,59,45,56286,42920.46,99206.46
420208,201801,23,18,5,17172,3911.4,21083.4
420209,201801,20,16,4,15264,3816,19080
420210,201801,468,223,245,212455.8,233635.14,446090.94
420213,201801,48,38,10,36252,9540,45792
420215,201801,26,22,4,20988,3816,24804
420220,201801,70,45,25,42930,23850,66780
420230,201801,740,424,316,403733,301168.46,704901.46
420240,201801,2276,1541,735,1462546.11,700751.16,2163297.27
420243,201801,36,29,7,27666,6678,34344
420245,201801,100,58,42,55332,40068,95400
420250,201801,56,32,24,30528,22896,53424
420253,201801,38,30,8,28620,7632,36252
420257,201801,10,8,2,7632,1908,9540
420260,201801,99,87,12,82998,11448,94446
420270,201801,37,30,7,28616,6678,35294
420280,201801,279,204,75,192873.52,70292.1,263165.62
420285,201801,20,12,8,11448,7632,19080
420287,201801,50,31,19,29574,18126,47700
420290,201801,972,685,287,652508.95,273730.3,926239.25
420300,201801,1384,1089,295,1034614.4,278950.14,1313564.54
420310,201801,56,43,13,41022,12402,53424
420315,201801,34,30,4,28620,3816,32436
420320,201801,849,427,422,406380.15,402584,808964.15
420325,201801,0,0,0,0,0,0
420330,201801,119,81,38,77274,36137.52,113411.52
420340,201801,159,108,51,102070,48625.38,150695.38
420350,201801,247,181,66,170865.12,62964,233829.12
420360,201801,747,571,176,542808.16,166283.78,709091.94
420370,201801,106,69,37,65636,35012,100648
420380,201801,1139,817,322,775594.5,306142.04,1081736.54
420390,201801,253,163,90,154243.52,85144.5,239388.02
420395,201801,182,130,52,124020,49598.46,173618.46
420400,201801,245,180,65,171148,62010,233158
420410,201801,58,45,13,42930,12402,55332
420415,201801,34,31,3,29574,2862,32436
420417,201801,46,35,11,33390,10484.46,43874.46
420419,201801,11,11,0,10494,0,10494
420420,201801,2782,1705,1077,1615574.24,1024884.42,2640458.66
420425,201801,69,59,10,56277,9226.26,65503.26
420430,201801,1277,887,390,843206.72,370314.18,1213520.90
420435,201801,15,13,2,12402,1908,14310
420440,201801,109,74,35,69969.56,33217.6,103187.16
420445,201801,23,21,2,20034,1908,21942
420450,201801,77,37,40,35289,38160,73449
420455,201801,248,191,57,182185.92,54304.92,236490.84
420460,201801,2326,1551,775,1474969.56,739125.9,2214095.46
420470,201801,121,86,35,82044,33390,115434
420475,201801,6,6,0,5724,0,5724
420480,201801,841,624,217,588571.96,206064.2,794636.16
420490,201801,113,88,25,83952,23850,107802
420500,201801,680,284,396,269251.2,377784,647035.2
420510,201801,20,17,3,16218,2862,19080
420515,201801,25,20,5,19080,4770,23850
420517,201801,12,12,0,11448,0,11448
420519,201801,0,0,0,0,0,0
420520,201801,67,51,16,48654,15264,63918
420530,201801,159,108,51,102078.9,48654,150732.9
420535,201801,20,18,2,17172,1908,19080
420540,201801,4708,2774,1934,2635249.4,1840400.98,4475650.38
420543,201801,21,21,0,20034,0,20034
420545,201801,194,137,57,129744,54358.92,184102.92
420550,201801,844,674,170,641051.32,162022.73,803074.05
420555,201801,42,30,12,28620,11448,40068
420560,201801,62,49,13,46364.4,12402,58766.4
420570,201801,140,79,61,75366,58184.46,133550.46
420580,201801,302,134,168,127836,159986,287822
420590,201801,504,360,144,343153.8,137376,480529.8
420600,201801,94,48,46,45792,43884,89676
420610,201801,37,35,2,33104,1908,35012
420620,201801,72,59,13,56286,12402,68688
420630,201801,148,106,42,101120,40064,141184
420640,201801,91,81,10,76797,9540,86337
420650,201801,235,126,109,119536.2,103367.23,222903.43
420660,201801,55,41,14,38350.8,13356,51706.8
420665,201801,38,29,9,27380,8586,35966
420670,201801,317,237,80,225372.96,76125.11,301498.07
420675,201801,15,14,1,13356,954,14310
420680,201801,36,26,10,24804,9540,34344
420690,201801,176,147,29,140238,27666,167904
420700,201801,615,428,187,408228.3,178174.44,586402.74
420710,201801,147,87,60,82998,56953.8,139951.8
420720,201801,107,87,20,82998,19080,102078
420730,201801,523,336,187,319505.58,177093.58,496599.16
420740,201801,45,44,1,41976,954,42930
420750,201801,493,327,166,311671.8,158364,470035.8
420757,201801,17,14,3,12545.1,2862,15407.1
420760,201801,39,30,9,28620,8586,37206
420765,201801,71,59,12,56286,11448,67734
420768,201801,66,58,8,55332,7632,62964
420770,201801,85,72,13,68688,12402,81090
420775,201801,48,45,3,41976,2862,44838
420780,201801,238,186,52,177434.46,49608,227042.46
420785,201801,13,9,4,8586,3816,12402
420790,201801,175,146,29,138943.8,26684.46,165628.26
420800,201801,77,58,19,54568.8,18126,72694.8
420810,201801,247,212,35,202239,32579.1,234818.1
420820,201801,2318,1389,929,1318753.16,884731.06,2203484.22
420830,201801,550,312,238,295366.83,226088.46,521455.29
420840,201801,142,107,35,102078,32686,134764
420845,201801,450,200,250,190129.07,237260,427389.07
420850,201801,224,180,44,171720,41976,213696
420860,201801,62,53,9,50562,8586,59148
420870,201801,118,85,33,81090,31482,112572
420880,201801,171,117,54,110940.66,51516,162456.66
420890,201801,864,425,439,402362.64,418797,821159.64
420895,201801,10,10,0,9540,0,9540
420900,201801,414,325,89,307991.04,84877.92,392868.96
420910,201801,5808,3247,2561,3087138.23,2438670.53,5525808.76
420915,201801,80,73,7,69642,6678,76320
420917,201801,18,13,5,12402,4770,17172
420920,201801,23,15,8,14310,7632,21942
420930,201801,2608,1585,1023,1504417.12,969108.08,2473525.20
420940,201801,596,434,162,412691.6,152896.08,565587.68
420945,201801,8,6,2,5724,1908,7632
420950,201801,55,49,6,46746,5724,52470
420960,201801,115,89,26,84868.92,24795,109663.92
420970,201801,305,245,60,232054.85,57212.46,289267.31
420980,201801,27,26,1,24804,954,25758
420985,201801,65,55,10,52470,9540,62010
420990,201801,67,51,16,48654,15264,63918
421000,201801,32,21,11,20034,10494,30528
421003,201801,68,44,24,41976,22887,64863
421005,201801,8,5,3,4770,2862,7632
421010,201801,767,544,223,517441.6,210682,728123.6
421020,201801,29,24,5,22896,4770,27666
421030,201801,128,108,20,102699,19080,121779
421040,201801,68,58,10,55332,9540,64872
421050,201801,310,222,88,209689.2,83952,293641.2
421055,201801,27,23,4,21942,3816,25758
421060,201801,83,56,27,53424,25758,79182
421070,201801,51,46,5,43884,4770,48654
421080,201801,35,32,3,30528,2862,33390
421085,201801,24,19,5,18126,4770,22896
421090,201801,42,32,10,30528,9540,40068
421100,201801,123,90,33,85860,31482,117342
421105,201801,219,178,41,169157.34,39090.69,208248.03
421110,201801,111,91,20,86193.9,19080,105273.9
421120,201801,152,120,32,113984.46,30508.92,144493.38
421125,201801,14,10,4,9540,3816,13356
421130,201801,798,513,285,488272.05,270850.54,759122.59
421140,201801,29,21,8,19318.5,7632,26950.5
421145,201801,40,31,9,29574,8586,38160
421150,201801,108,77,31,73458,29574,103032
421160,201801,61,41,20,39104.46,19080,58184.46
421165,201801,18,16,2,15264,1908,17172
421170,201801,192,167,25,158290.84,23841,182131.84
421175,201801,147,96,51,91584,48615.92,140199.92
421180,201801,56,35,21,33028,20034,53062
421185,201801,17,14,3,13356,2862,16218
421187,201801,0,0,0,0,0,0
421189,201801,38,30,8,28620,7622.46,36242.46
421190,201801,1463,900,563,857360,536119.58,1393479.58
421200,201801,87,65,22,61057,20988,82045
421205,201801,24,16,8,15264,7622.46,22886.46
421210,201801,179,121,58,115434,55332,170766
421220,201801,273,216,57,205197.9,54378,259575.9
421223,201801,55,46,9,43884,8586,52470
421225,201801,60,41,19,39114,18126,57240
421227,201801,93,70,23,66780,21942,88722
421230,201801,48,35,13,33390,12402,45792
421240,201801,20,20,0,19080,0,19080
421250,201801,355,219,136,208831,128952.18,337783.18
421260,201801,28,23,5,21942,4770,26712
421265,201801,0,0,0,0,0,0
421270,201801,51,46,5,43884,4770,48654
421280,201801,329,188,141,179352,132796.8,312148.8
421290,201801,314,210,104,200102,97805.76,297907.76
421300,201801,26,21,5,20034,4770,24804
421310,201801,54,41,13,38446.2,12402,50848.2
421315,201801,28,20,8,19080,7632,26712
421320,201801,130,94,36,89676,34344,124020
421330,201801,109,85,24,79926.12,22887,102813.12
421335,201801,40,26,14,24804,13356,38160
421340,201801,292,197,95,185887.05,90630,276517.05
421350,201801,166,99,67,94003,63918,157921
421360,201801,694,512,182,482109.72,173419.46,655529.18
421370,201801,186,143,43,136422,40688.1,177110.1
421380,201801,130,104,26,99211.23,24804,124015.23
421390,201801,20,16,4,15264,3816,19080
421400,201801,113,95,18,90630,17172,107802
421410,201801,23,18,5,17172,4770,21942
421415,201801,20,19,1,18126,954,19080
421420,201801,149,123,26,116769.6,24517.8,141287.4
421430,201801,14,11,3,10494,2862,13356
421440,201801,61,47,14,44838,13356,58194
421450,201801,99,86,13,82044,12402,94446
421460,201801,59,51,8,47849.77,7632,55481.77
421470,201801,70,46,24,43884,22896,66780
421480,201801,634,469,165,446949,157401,604350
421490,201801,22,21,1,19358,954,20312
421500,201801,515,329,186,312778.69,177166.44,489945.13
421505,201801,25,18,7,17172,6678,23850
421507,201801,33,27,6,25758,5724,31482
421510,201801,73,47,26,44838,24422.4,69260.4
421520,201801,64,56,8,52661,7632,60293
421530,201801,53,48,5,45124.2,4770,49894.2
421535,201801,29,28,1,26445,954,27399
421540,201801,59,52,7,49608,6678,56286
421545,201801,98,76,22,72018,20988,93006
421550,201801,282,204,78,193949,74412,268361
421555,201801,25,20,5,19080,4675,23755
421560,201801,8,8,0,7632,0,7632
421565,201801,123,92,31,87768,29574,117342
421567,201801,28,23,5,21942,4770,26712
421568,201801,33,31,2,29574,1908,31482
421569,201801,8,8,0,7632,0,7632
421570,201801,138,93,45,88722,42930,131652
421575,201801,27,22,5,20725.65,4770,25495.65
421580,201801,717,434,283,413082,269028.34,682110.34
421590,201801,21,20,1,19080,954,20034
421600,201801,112,76,36,72504,33105,105609
421605,201801,101,72,29,68355,27666,96021
421610,201801,188,148,40,141192,38160,179352
421620,201801,1104,661,443,628094.92,422602.92,1050697.84
421625,201801,21,18,3,17172,2862,20034
421630,201801,276,177,99,168811,93588,262399
421635,201801,17,8,9,7632,8586,16218
421640,201801,100,86,14,82044,13356,95400
421650,201801,276,160,116,152620.92,110644.92,263265.84
421660,201801,2088,1250,838,1189564.12,798184.26,1987748.38
421670,201801,173,126,47,120204,44838,165042
421680,201801,166,151,15,144054,14301,158355
421690,201801,350,242,108,229887,102068.58,331955.58
421700,201801,56,34,22,32436,20130,52566
421710,201801,25,25,0,23850,0,23850
421715,201801,11,10,1,9540,954,10494
421720,201801,582,418,164,396155.4,154729.26,550884.66
421725,201801,14,7,7,6678,6678,13356
421730,201801,43,30,13,27890.24,12402,40292.24
421740,201801,82,39,43,37206,41022,78228
421750,201801,216,159,57,148954.51,54378,203332.51
421755,201801,24,23,1,21942,954,22896
421760,201801,103,73,30,69632.46,28620,98252.46
421770,201801,564,381,183,361267.38,174516.3,535783.68
421775,201801,25,16,9,15264,8586,23850
421780,201801,191,150,41,142813.8,39114,181927.8
421790,201801,154,129,25,122586.6,23850,146436.6
421795,201801,17,14,3,13356,2862,16218
421800,201801,461,296,165,281587.31,157410,438997.31
421810,201801,67,54,13,51516,12402,63918
421820,201801,298,202,96,192040.2,91584,283624.2
421825,201801,130,108,22,103032,20988,124020
421830,201801,128,98,30,93492,28620,122112
421835,201801,3,3,0,2862,0,2862
421840,201801,61,51,10,48645,9540,58185
421850,201801,78,68,10,64872,9536,74408
421860,201801,41,32,9,30241.8,8586,38827.8
421870,201801,978,738,240,695150.64,228102.98,923253.62
421875,201801,51,45,6,42930,5724,48654
421880,201801,162,117,45,111618,42644,154262
421885,201801,27,23,4,21942,3816,25758
421890,201801,113,79,34,75366,32436,107802
421895,201801,38,35,3,33390,2862,36252
421900,201801,149,121,28,115359.3,26667,142026.3
421910,201801,64,42,22,40068,20988,61056
421915,201801,32,26,6,24804,5724,30528
421917,201801,40,29,11,27666,10494,38160
421920,201801,32,29,3,27666,2862,30528
421930,201801,753,582,171,553501.26,163097.46,716598.72
421935,201801,57,50,7,47700,6678,54378
421940,201801,39,37,2,35298,1908,37206
421950,201801,830,549,281,517787.74,265578.32,783366.06
421960,201801,39,35,4,33104,3816,36920
421970,201801,373,235,138,223691.12,131621.12,355312.24
421985,201801,29,19,10,18126,9540,27666
422000,201801,0,0,0,0,0,0
430003,201801,205,48,157,45076.5,149778,194854.5
430005,201801,36,28,8,26712,7632,34344
430010,201801,280,197,83,187461,79182,266643
430020,201801,151,98,53,93206,49608,142814
430030,201801,126,98,28,93205.8,26712,119917.8
430040,201801,2981,1733,1248,1645503.23,1188962.48,2834465.71
430045,201801,69,59,10,56000,9540,65540
430047,201801,6,5,1,4770,954,5724
430050,201801,81,68,13,64872,12402,77274
430055,201801,17,14,3,13356,2862,16218
430057,201801,4,2,2,1908,1908,3816
430060,201801,3699,2199,1500,2090602.72,1427455.58,3518058.30
430063,201801,57,51,6,48654,5724,54378
430064,201801,146,123,23,117342,21942,139284
430066,201801,10,7,3,6678,2862,9540
430070,201801,45,33,12,31482,11448,42930
430080,201801,69,48,21,45092.33,20034,65126.33
430085,201801,37,11,26,10494,24804,35298
430087,201801,35,26,9,24661,8586,33247
430090,201801,71,64,7,60769.8,6678,67447.8
430100,201801,115,76,39,71550,37206,108756
430105,201801,146,73,73,69642,69336.72,138978.72
430107,201801,21,16,5,15264,4770,20034
430110,201801,409,238,171,226241.1,163076.76,389317.86
430120,201801,138,126,12,119250.9,11448,130698.9
430130,201801,792,499,293,475425.9,279235.8,754661.7
430140,201801,123,113,10,107802,9540,117342
430150,201801,112,73,39,68879,36252,105131
430155,201801,33,30,3,28620,2862,31482
430160,201801,3810,2243,1567,2119124.05,1490844.62,3609968.67
430163,201801,325,144,181,136231.94,172616.76,308848.70
430165,201801,23,16,7,15264,6678,21942
430170,201801,80,72,8,68688,7632,76320
430175,201801,81,63,18,60102,16504.2,76606.2
430180,201801,92,73,19,69642,17505.9,87147.9
430185,201801,31,23,8,21942,7632,29574
430187,201801,103,43,60,41022,56934.8,97956.8
430190,201801,222,126,96,120156.3,90907.46,211063.76
430192,201801,14,14,0,13356,0,13356
430195,201801,13,8,5,7632,4770,12402
430200,201801,162,144,18,136708.2,17172,153880.2
430205,201801,20,19,1,18126,954,19080
430210,201801,622,482,140,456107.4,132272.3,588379.7
430215,201801,16,12,4,11448,3816,15264
430220,201801,63,44,19,41976,18126,60102
430222,201801,14,7,7,6678,6678,13356
430223,201801,15,8,7,7632,6678,14310
430225,201801,4,3,1,2862,954,3816
430230,201801,304,188,116,178398,110664,289062
430235,201801,53,39,14,37206,13346.46,50552.46
430237,201801,29,21,8,20034,7632,27666
430240,201801,132,83,49,78705,46736.46,125441.46
430245,201801,70,59,11,56286,10494,66780
430250,201801,191,110,81,104930.46,77264.46,182194.92
430258,201801,13,11,2,10494,1908,12402
430260,201801,34,30,4,28620,3806.46,32426.46
430265,201801,34,29,5,27646.92,4770,32416.92
430270,201801,562,412,150,389658.54,141289.02,530947.56
430280,201801,1025,631,394,598243.86,373376.6,971620.46
430290,201801,380,222,158,209880.8,150732,360612.8
430300,201801,2109,1164,945,1104667.12,898470.81,2003137.93
430310,201801,1973,1038,935,983204.4,888872.23,1872076.63
430320,201801,48,40,8,38145.69,7632,45777.69
430330,201801,97,88,9,83475,8586,92061
430340,201801,66,59,7,56286,6678,62964
430350,201801,1664,1157,507,1092302.38,481933.26,1574235.64
430355,201801,25,22,3,20988,2862,23850
430360,201801,80,39,41,37206,37874,75080
430367,201801,27,20,7,19080,6678,25758
430370,201801,54,47,7,44838,6678,51516
430380,201801,130,97,33,91965.6,31482,123447.6
430390,201801,613,381,232,363187.8,221023.46,584211.26
430400,201801,136,106,30,99406.8,28600.92,128007.72
430410,201801,58,46,12,43884,11448,55332
430420,201801,491,323,168,305662.8,157726.16,463388.96
430430,201801,55,52,3,48972.63,2862,51834.63
430435,201801,157,120,37,113526,34582.5,148108.5
430440,201801,507,340,167,324360,159127.2,483487.2
430450,201801,1194,983,211,930246.34,201284.46,1131530.80
430460,201801,5093,2776,2317,2632423.85,2205913.09,4838336.94
430461,201801,17,15,2,14310,1908,16218
430462,201801,11,7,4,6678,3816,10494
430463,201801,1021,541,480,513681.38,457568.1,971249.48
430465,201801,28,16,12,15264,11448,26712
430466,201801,655,473,182,449334.2,173437.2,622771.4
430467,201801,101,60,41,55999.8,39104.46,95104.26
430468,201801,109,68,41,64872,38862.91,103734.91
430469,201801,23,17,6,16218,5724,21942
430470,201801,1174,649,525,612380.39,498894.3,1111274.69
430471,201801,48,36,12,34324.92,11448,45772.92
430480,201801,95,60,35,56381.4,33380.46,89761.86
430485,201801,6,6,0,5438,0,5438
430490,201801,90,72,18,67877.7,17172,85049.7
430495,201801,35,28,7,26712,6678,33390
430500,201801,193,131,62,124974,58772.46,183746.46
430510,201801,3059,2042,1017,1941705.7,969331.32,2911037.02
430511,201801,18,18,0,17172,0,17172
430512,201801,137,94,43,89676,41022,130698
430513,201801,52,46,6,43407,5724,49131
430515,201801,31,29,2,27666,1908,29574
430517,201801,169,149,20,141192.5,19060.92,160253.42
430520,201801,365,250,115,237833,109681.38,347514.38
430530,201801,89,52,37,49608,35298,84906
430535,201801,471,312,159,297448.43,151662.15,449110.58
430537,201801,10,10,0,9540,0,9540
430540,201801,71,47,24,44838,22896,67734
430543,201801,374,115,259,109710,247086,356796
430544,201801,43,39,4,37206,3816,41022
430545,201801,340,161,179,153575,170269.92,323844.92
430550,201801,43,35,8,33390,7632,41022
430558,201801,6,4,2,3816,1908,5724
430560,201801,46,20,26,19080,24804,43884
430570,201801,107,46,61,43884,58136.76,102020.76
430580,201801,123,96,27,91584,25710.3,117294.3
430583,201801,14,14,0,13356,0,13356
430585,201801,9,4,5,3816,4770,8586
430587,201801,14,8,6,7632,5724,13356
430590,201801,151,126,25,118963.8,23850,142813.8
430593,201801,4,4,0,3816,0,3816
430595,201801,15,10,5,9540,4770,14310
430597,201801,51,26,25,24804,23850,48654
430600,201801,215,149,66,142136.46,62677.8,204814.26
430605,201801,163,100,63,95400,60092.46,155492.46
430607,201801,26,21,5,20034,4770,24804
430610,201801,1646,768,878,729429.3,832613.78,1562043.08
430613,201801,2,2,0,1908,0,1908
430620,201801,111,79,32,75223,30518.46,105741.46
430630,201801,45,40,5,38160,4770,42930
430632,201801,31,26,5,24804,4770,29574
430635,201801,41,37,4,35298,3816,39114
430637,201801,55,31,24,29574,22896,52470
430640,201801,209,115,94,108851.4,89676,198527.4
430642,201801,28,26,2,24804,1908,26712
430645,201801,32,28,4,26712,3816,30528
430650,201801,255,205,50,195284,47652.3,242936.3
430655,201801,4,4,0,3816,0,3816
430660,201801,963,470,493,446805.9,468795.8,915601.7
430670,201801,71,51,20,48654,19080,67734
430673,201801,75,41,34,39114,32436,71550
430675,201801,13,10,3,9540,2862,12402
430676,201801,490,301,189,286429.04,180235.07,466664.11
430680,201801,251,177,74,166664,70596,237260
430690,201801,524,307,217,291972.32,205362.14,497334.46
430692,201801,7,5,2,4770,1908,6678
430693,201801,140,93,47,88722,44208.36,132930.36
430695,201801,73,66,7,62029.08,6678,68707.08
430697,201801,59,35,24,33390,22896,56286
430700,201801,1594,1114,480,1049943.82,457920,1507863.82
430705,201801,19,18,1,17172,954,18126
430710,201801,259,168,91,160272,86814,247086
430720,201801,108,92,16,87577.2,15264,102841.2
430730,201801,119,102,17,96354,16218,112572
430740,201801,65,43,22,41022,20988,62010
430745,201801,36,29,7,27380,6678,34058
430750,201801,336,227,109,215614.64,103032,318646.64
430755,201801,82,45,37,42930,35298,78228
430760,201801,369,224,145,211025.72,138301.92,349327.64
430770,201801,1472,756,716,719106.32,678607.27,1397713.59
430780,201801,318,203,115,192680.72,109643.76,302324.48
430781,201801,28,23,5,21942,4770,26712
430783,201801,50,40,10,37842.13,9540,47382.13
430786,201801,6,3,3,2862,2862,5724
430790,201801,486,314,172,297997.92,163792.46,461790.38
430800,201801,151,126,25,120204,23850,144054
430805,201801,42,38,4,36252,3816,40068
430807,201801,35,21,14,20034,13356,33390
430810,201801,72,46,26,43884,24804,68688
430820,201801,134,84,50,80136,47032.2,127168.2
430825,201801,13,11,2,10494,1908,12402
430830,201801,232,217,15,206712.92,14310,221022.92
430840,201801,124,84,40,80136,37492.2,117628.2
430843,201801,5,3,2,2862,1908,4770
430845,201801,70,39,31,37206,29574,66780
430850,201801,568,391,177,371840.58,168726.68,540567.26
430860,201801,155,100,55,94732.2,51792.66,146524.86
430865,201801,62,30,32,27952.2,30213.18,58165.38
430870,201801,78,63,15,60102,14310,74412
430880,201801,159,119,40,113506.92,38160,151666.92
430885,201801,7,6,1,5724,954,6678
430890,201801,334,203,131,192002.04,124974,316976.04
430900,201801,542,372,170,350690.4,161693.46,512383.86
430905,201801,81,32,49,30528,46746,77274
430910,201801,269,151,118,144054,111896,255950
430912,201801,3,3,0,2862,0,2862
430915,201801,34,26,8,24804,7345.8,32149.8
430920,201801,4170,2335,1835,2220883.78,1748780.22,3969664.00
430925,201801,5,4,1,3567.96,954,4521.96
430930,201801,2083,1240,843,1175244.42,803021.43,1978265.85
430940,201801,239,151,88,143376.66,83932.92,227309.58
430950,201801,158,128,30,122112,28620,150732
430955,201801,21,13,8,12402,7632,20034
430957,201801,18,17,1,16218,954,17172
430960,201801,233,152,81,143243.1,77274,220517.1
430965,201801,103,64,39,61056,37206,98262
430970,201801,78,65,13,62010,11448,73458
430975,201801,33,31,2,29574,1908,31482
430980,201801,43,26,17,24804,16218,41022
430990,201801,108,83,25,79182,23850,103032
430995,201801,115,111,4,104653.8,3816,108469.8
431000,201801,296,136,160,127597.2,152640,280237.2
431010,201801,340,205,135,194587.38,128790,323377.38
431020,201801,1926,1116,810,1056102.42,768628.26,1824730.68
431030,201801,43,34,9,32436,8586,41022
431033,201801,384,189,195,179495.2,186030,365525.2
431036,201801,16,9,7,8586,6678,15264
431040,201801,130,78,52,73458,49498.29,122956.29
431041,201801,37,25,12,23850,11448,35298
431043,201801,44,25,19,23850,18126,41976
431046,201801,12,7,5,6678,4770,11448
431050,201801,207,131,76,124687.8,71502.3,196190.1
431053,201801,75,44,31,41212.8,29574,70786.8
431055,201801,63,42,21,40068,20014.92,60082.92
431057,201801,17,17,0,16218,0,16218
431060,201801,1690,1059,631,1003056.66,600112.9,1603169.56
431065,201801,17,10,7,9540,6678,16218
431070,201801,72,67,5,63918,4770,68688
431075,201801,8,8,0,7632,0,7632
431080,201801,137,87,50,82711.8,47700,130411.8
431085,201801,30,27,3,25758,2862,28620
431087,201801,15,13,2,12402,1908,14310
431090,201801,57,45,12,42930,11448,54378
431100,201801,1228,732,496,687264.82,473184,1160448.82
431110,201801,245,153,92,145962,87758.46,233720.46
431112,201801,29,17,12,16218,11448,27666
431113,201801,30,19,11,18126,10494,28620
431115,201801,152,104,48,98579.87,45782.46,144362.33
431120,201801,619,365,254,346264.64,242239.84,588504.48
431123,201801,3,2,1,1908,954,2862
431125,201801,90,80,10,76320,9540,85860
431127,201801,7,3,4,2862,3816,6678
431130,201801,618,400,218,380359.8,207666.72,588026.52
431140,201801,729,493,236,465981.6,225067.68,691049.28
431142,201801,33,25,8,22638,7632,30270
431150,201801,205,152,53,145008,50552.46,195560.46
431160,201801,56,50,6,47700,5724,53424
431162,201801,19,14,5,13356,4770,18126
431164,201801,4,4,0,3816,0,3816
431170,201801,102,84,18,80136,17172,97308
431171,201801,49,27,22,25758,20978.46,46736.46
431173,201801,1,1,0,954,0,954
431175,201801,203,101,102,95114,97298.46,192412.46
431177,201801,74,56,18,53424,16485.92,69909.92
431179,201801,11,10,1,9540,954,10494
431180,201801,437,263,174,250902,165691.46,416593.46
431190,201801,87,66,21,62964,20034,82998
431198,201801,72,47,25,44838,23850,68688
431200,201801,20,17,3,16218,2862,19080
431205,201801,23,23,0,21942,0,21942
431210,201801,87,53,34,50229,32436,82665
431213,201801,27,22,5,20988,4770,25758
431215,201801,26,23,3,21942,2862,24804
431217,201801,7,6,1,5724,954,6678
431220,201801,67,58,9,55332,8586,63918
431225,201801,150,100,50,95391,47690.46,143081.46
431230,201801,101,88,13,83952,12402,96354
431235,201801,7,7,0,6678,0,6678
431237,201801,26,16,10,15264,9540,24804
431238,201801,15,11,4,10208,3816,14024
431240,201801,985,635,350,604130.64,333384.84,937515.48
431242,201801,34,34,0,32436,0,32436
431244,201801,11,8,3,7632,2862,10494
431245,201801,63,48,15,45792,14310,60102
431247,201801,13,10,3,9540,2862,12402
431250,201801,268,137,131,130631.22,124287.92,254919.14
431260,201801,60,43,17,41022,16218,57240
431261,201801,23,16,7,15264,6678,21942
431262,201801,16,16,0,15264,0,15264
431265,201801,165,86,79,82044,75366,157410
431267,201801,15,14,1,13356,954,14310
431270,201801,313,262,51,249948,48654,298602
431275,201801,41,39,2,37206,1908,39114
431280,201801,21,17,4,15383.25,3816,19199.25
431290,201801,20,17,3,16218,2862,19080
431295,201801,5,5,0,4770,0,4770
431300,201801,22,19,3,18126,2862,20988
431301,201801,7,7,0,6678,0,6678
431303,201801,51,34,17,32311.98,15931.8,48243.78
431306,201801,224,118,106,112115.98,101124,213239.98
431308,201801,6,5,1,4770,954,5724
431310,201801,63,53,10,50562,9540,60102
431320,201801,122,72,50,68688,47304.05,115992.05
431330,201801,178,117,61,111618,58194,169812
431333,201801,33,27,6,25758,5724,31482
431335,201801,10,5,5,4770,4770,9540
431337,201801,321,151,170,143224.2,161149.88,304374.08
431339,201801,20,17,3,16218,2862,19080
431340,201801,3060,1765,1295,1679766.71,1232333.44,2912100.15
431342,201801,45,28,17,26712,16218,42930
431344,201801,18,17,1,16218,954,17172
431346,201801,3,3,0,2862,0,2862
431349,201801,36,33,3,31482,2862,34344
431350,201801,900,531,369,502025.66,351033.84,853059.50
431360,201801,45,39,6,37206,5724,42930
431365,201801,313,147,166,140218.92,157398.4,297617.32
431370,201801,1322,788,534,748098.14,509248.98,1257347.12
431380,201801,98,83,15,79182,14310,93492
431390,201801,499,279,220,265135.88,209336.22,474472.10
431395,201801,279,120,159,114480,151667,266147
431400,201801,39,30,9,28620,8586,37206
431402,201801,94,65,29,62010,27666,89676
431403,201801,14,9,5,8586,4770,13356
431405,201801,651,353,298,335122.02,284265,619387.02
431406,201801,32,28,4,26712,3816,30528
431407,201801,51,41,10,39114,9540,48654
431410,201801,3216,1910,1306,1809632.29,1242881.3,3052513.59
431413,201801,15,13,2,12402,1908,14310
431415,201801,72,52,20,49608,19080,68688
431417,201801,24,12,12,11448,11448,22896
431420,201801,299,210,89,199684.88,84896.46,284581.34
431430,201801,42,17,25,16218,23850,40068
431440,201801,8936,6372,2564,6007915,2437409.29,8445324.29
431442,201801,27,14,13,13356,12402,25758
431445,201801,26,20,6,19080,5724,24804
431446,201801,7,6,1,5724,954,6678
431447,201801,84,59,25,56286,23850,80136
431449,201801,51,44,7,41976,6678,48654
431450,201801,410,284,126,269171.1,119488.5,388659.6
431454,201801,0,0,0,0,0,0
431455,201801,49,38,11,36252,10494,46746
431460,201801,522,361,161,340768.8,153307.8,494076.6
431470,201801,116,91,25,86122.54,23349.35,109471.89
431475,201801,11,10,1,9540,954,10494
431477,201801,36,26,10,24804,9540,34344
431478,201801,8,7,1,6678,954,7632
431480,201801,494,314,180,297944.7,171672.3,469617.0
431490,201801,28202,15992,12210,15181829.93,11614114.42,26795944.35
431500,201801,79,53,26,50562,24804,75366
431505,201801,46,20,26,19080,24804,43884
431507,201801,11,9,2,8586,1908,10494
431510,201801,278,181,97,171958.8,91564.92,263523.72
431513,201801,22,17,5,16218,4770,20988
431514,201801,8,7,1,6678,954,7632
431515,201801,79,66,13,62964,12402,75366
431517,201801,3,1,2,954,1908,2862
431520,201801,37,33,4,31482,3816,35298
431530,201801,1607,716,891,682014.84,849551.93,1531566.77
431531,201801,23,21,2,20034,1908,21942
431532,201801,25,17,8,16218,7632,23850
431535,201801,25,16,9,15264,8586,23850
431540,201801,138,123,15,116321.22,14310,130631.22
431545,201801,19,17,2,16218,1908,18126
431550,201801,348,204,144,194616,137280.6,331896.6
431555,201801,12,11,1,10494,954,11448
431560,201801,4422,3129,1293,2955134.12,1231261.92,4186396.04
431570,201801,778,410,368,387992.2,348201.46,736193.66
431575,201801,35,24,11,22896,10494,33390
431580,201801,97,68,29,63918,27666,91584
431590,201801,139,116,23,109710,21942,131652
431595,201801,12,11,1,10494,954,11448
431600,201801,218,126,92,120204,87768,207972
431610,201801,128,93,35,88054.2,33390,121444.2
431620,201801,42,34,8,32436,7632,40068
431630,201801,136,116,20,110664,19080,129744
431640,201801,1329,829,500,786382.2,475416.44,1261798.64
431642,201801,41,37,4,34821,3816,38637
431643,201801,44,20,24,19080,22896,41976
431645,201801,300,172,128,164088,121158,285246
431647,201801,11,11,0,10494,0,10494
431650,201801,36,27,9,25758,8586,34344
431660,201801,278,182,96,171433.8,91584,263017.8
431670,201801,219,103,116,95638.5,110635.38,206273.88
431673,201801,3,3,0,2862,0,2862
431675,201801,29,24,5,22609.8,4770,27379.8
431680,201801,1096,782,314,742212,298507.68,1040719.68
431690,201801,4769,2918,1851,2762092.72,1760972.22,4523064.94
431695,201801,26,20,6,19080,5724,24804
431697,201801,0,0,0,0,0,0
431700,201801,169,128,41,122112,39114,161226
431710,201801,3987,1719,2268,1637246,2163183.02,3800429.02
431720,201801,1397,827,570,780794.55,542812.46,1323607.01
431725,201801,1,1,0,954,0,954
431730,201801,1196,810,386,765759.81,368244,1134003.81
431740,201801,1365,682,683,646010.72,651041.12,1297051.84
431750,201801,1880,1219,661,1151696.3,628657.92,1780354.22
431755,201801,6,5,1,4770,954,5724
431760,201801,1088,694,394,661694.4,375647.58,1037341.98
431770,201801,395,290,105,276650.46,100150.92,376801.38
431775,201801,27,21,6,20034,5724,25758
431780,201801,557,344,213,326996.22,203192.46,530188.68
431790,201801,151,112,39,105894,37158.3,143052.3
431795,201801,14,12,2,11448,1908,13356
431800,201801,3389,1775,1614,1681966.92,1532820.4,3214787.32
431805,201801,16,15,1,14310,954,15264
431810,201801,614,415,199,393276.96,189712.98,582989.94
431820,201801,314,175,139,166950,131604.3,298554.3
431830,201801,2320,1408,912,1339817.62,868787.65,2208605.27
431840,201801,518,344,174,324552.4,164756,489308.4
431842,201801,34,28,6,26712,5724,32436
431843,201801,11,7,4,6678,3816,10494
431844,201801,15,13,2,12402,1908,14310
431845,201801,30,27,3,25758,2862,28620
431846,201801,29,25,4,23850,3816,27666
431848,201801,14,12,2,11448,1908,13356
431849,201801,8,6,2,5724,1908,7632
431850,201801,801,665,136,632897.51,129505.5,762403.01
431860,201801,102,75,27,71550,24804,96354
431861,201801,4,2,2,1908,1908,3816
431862,201801,49,33,16,31482,15264,46746
431870,201801,3477,2049,1428,1946287.96,1360714.42,3307002.38
431880,201801,938,689,249,652508,236592,889100
431890,201801,1303,807,496,764841.74,471577,1236418.74
431900,201801,186,130,56,124020,52632.18,176652.18
431910,201801,57,42,15,40068,14310,54378
431912,201801,36,20,16,19080,15264,34344
431915,201801,127,102,25,97308,23850,121158
431920,201801,145,108,37,102745.8,35298,138043.8
431930,201801,86,70,16,66780,15264,82044
431935,201801,4,3,1,2862,954,3816
431936,201801,12,11,1,10494,954,11448
431937,201801,17,12,5,11448,4770,16218
431940,201801,445,296,149,279617.4,142136.46,421753.86
431950,201801,467,299,168,284006.88,160139.52,444146.40
431960,201801,715,421,294,397448.02,280314.9,677762.92
431970,201801,73,65,8,62010,7632,69642
431971,201801,3,3,0,2862,0,2862
431973,201801,19,16,3,15264,2862,18126
431975,201801,6,5,1,4770,954,5724
431980,201801,199,125,74,117723.6,70596,188319.6
431990,201801,1237,654,583,622442.99,556136,1178578.99
432000,201801,1674,897,777,848545.14,737694.04,1586239.18
432010,201801,277,185,92,175376.96,87768,263144.96
432020,201801,174,137,37,130698,35288.46,165986.46
432023,201801,20,16,4,15264,3816,19080
432026,201801,67,60,7,57240,6678,63918
432030,201801,62,28,34,26712,32436,59148
432032,201801,22,19,3,18126,2862,20988
432035,201801,47,37,10,35298,9540,44838
432040,201801,98,67,31,63918,29574,93492
432045,201801,8,7,1,6391.8,954,7345.8
432050,201801,71,42,29,40068,27666,67734
432055,201801,100,74,26,70576.92,24804,95380.92
432057,201801,1,0,1,0,954,954
432060,201801,39,36,3,33628.5,2862,36490.5
432065,201801,29,27,2,25758,1908,27666
432067,201801,93,82,11,78208.92,10494,88702.92
432070,201801,397,299,98,283644.18,93463.92,377108.10
432080,201801,810,557,253,529679.88,241295.3,770975.18
432085,201801,16,12,4,11448,3816,15264
432090,201801,261,165,96,157410,91584,248994
432100,201801,174,116,58,110377.8,55332,165709.8
432110,201801,606,415,191,389375.84,181260,570635.84
432120,201801,964,574,390,546928.2,372021.84,918950.04
432130,201801,498,359,139,341150.4,131923.06,473073.46
432132,201801,25,22,3,20988,2862,23850
432135,201801,78,65,13,62010,12402,74412
432140,201801,264,209,55,199090.26,52470,251560.26
432143,201801,186,117,69,111618,65826,177444
432145,201801,267,183,84,172770.2,79849.8,252620.0
432146,201801,15,14,1,13356,954,14310
432147,201801,140,62,78,59148,74388.15,133536.15
432149,201801,17,12,5,11448,4770,16218
432150,201801,824,523,301,497749.5,284116.84,781866.34
432160,201801,1399,728,671,692214.4,639247.52,1331461.92
432162,201801,4,3,1,2862,954,3816
432163,201801,18,14,4,13356,3816,17172
432166,201801,122,92,30,88246,28620,116866
432170,201801,224,122,102,115435,97308,212743
432180,201801,521,318,203,300224.38,193376,493600.38
432183,201801,9,7,2,6678,1908,8586
432185,201801,82,71,11,67638.6,10494,78132.6
432190,201801,471,259,212,245923.46,202115.52,448038.98
432195,201801,84,73,11,68926.5,10494,79420.5
432200,201801,410,263,147,250902,140190.84,391092.84
432210,201801,118,76,42,70452.9,40068,110520.9
432215,201801,62,58,4,55332,3816,59148
432218,201801,19,18,1,17172,954,18126
432220,201801,668,337,331,320487.64,315266.74,635754.38
432225,201801,16,10,6,9063,5724,14787
432230,201801,150,87,63,82759.5,60102,142861.5
432232,201801,15,13,2,12402,1908,14310
432234,201801,4,3,1,2862,954,3816
432235,201801,1,1,0,954,0,954
432237,201801,29,16,13,15264,12402,27666
432240,201801,4186,2336,1850,2218471.52,1757231.38,3975702.90
432250,201801,1013,643,370,610799.96,352817.82,963617.78
432252,201801,38,31,7,28829.88,6678,35507.88
432253,201801,60,49,11,46746,10494,57240
432254,201801,21,9,12,8586,11448,20034
432255,201801,14,13,1,12402,954,13356
432260,201801,842,659,183,627627.26,173628.5,801255.76
432270,201801,220,163,57,155502,54378,209880
432280,201801,122,88,34,83475.8,32436,115911.8
432285,201801,2,1,1,954,954,1908
432290,201801,69,62,7,57526.2,6678,64204.2
432300,201801,4647,2654,1993,2516250.74,1897002.53,4413253.27
432310,201801,115,91,24,86814,22896,109710
432320,201801,19,14,5,13356,4770,18126
432330,201801,15,10,5,9540,4770,14310
432335,201801,7,6,1,5724,954,6678
432340,201801,40,36,4,34344,3816,38160
432345,201801,86,62,24,59148,22896,82044
432350,201801,22,21,1,20034,954,20988
432360,201801,7,5,2,4770,1908,6678
432370,201801,25,25,0,23850,0,23850
432375,201801,40,34,6,32436,5724,38160
432377,201801,7,7,0,6678,0,6678
432380,201801,169,74,95,69928.2,90582.3,160510.5
500020,201801,249,136,113,129744,107200.98,236944.98
500025,201801,119,58,61,54378,58194,112572
500060,201801,1382,845,537,805557.6,511692.61,1317250.21
500070,201801,751,356,395,339273,376820.46,716093.46
500080,201801,136,104,32,99216,30528,129744
500085,201801,143,116,27,110378,24923.25,135301.25
500090,201801,333,160,173,152640,165042,317682
500100,201801,692,367,325,347923.8,309478,657401.8
500110,201801,2237,996,1241,949866.46,1183118.6,2132985.06
500124,201801,311,177,134,168858,127549.8,296407.8
500150,201801,329,132,197,125919,187578,313497
500190,201801,522,357,165,339891.12,156924,496815.12
500200,201801,201,171,30,162791,28620,191411
500210,201801,1459,525,934,499576.95,889872.99,1389449.94
500215,201801,242,140,102,132602.51,97308,229910.51
500220,201801,787,513,274,489157.84,260638.46,749796.30
500230,201801,257,178,79,169096.5,74889,243985.5
500240,201801,709,494,215,470512.8,204633.8,675146.6
500260,201801,565,209,356,199386,339624,539010
500270,201801,28334,12030,16304,11447544.99,15538317.84,26985862.83
500280,201801,192,74,118,70596,112572,183168
500290,201801,1191,696,495,663031,472221,1135252
500295,201801,405,248,157,236592,149768.46,386360.46
500310,201801,63,20,43,19080,41022,60102
500315,201801,697,418,279,398762.46,265870.26,664632.72
500320,201801,3640,1817,1823,1730991.38,1737495.62,3468487.00
500325,201801,942,520,422,495603,401613.44,897216.44
500330,201801,1498,682,816,648406.28,778032.64,1426438.92
500345,201801,323,236,87,224181.2,82998,307179.2
500348,201801,242,142,100,135468,95381.46,230849.46
500350,201801,142,69,73,65826,69642,135468
500370,201801,5419,2424,2995,2304730.1,2854620.7,5159350.8
500375,201801,346,250,96,238490.46,91584,330074.46
500380,201801,582,330,252,314662.59,240122.46,554785.05
500390,201801,72,36,36,34344,34344,68688
500400,201801,220,150,70,143080.92,66771,209851.92
500410,201801,574,223,351,212696.15,334706.22,547402.37
500430,201801,549,379,170,361566,162180,523746
500440,201801,204,106,98,100351.43,93492,193843.43
500450,201801,413,176,237,167198.8,225743.12,392941.92
500460,201801,316,157,159,149768.46,151686,301454.46
500470,201801,440,344,96,326961.67,90621,417582.67
500480,201801,113,68,45,64872,42930,107802
500490,201801,108,43,65,41017.23,62010,103027.23
500500,201801,1451,501,950,476124.13,905706.41,1381830.54
500510,201801,47,36,11,34344,10485,44829
500515,201801,110,77,33,73458,31196,104654
500520,201801,350,197,153,186889,145672,332561
500525,201801,87,49,38,46746,35965.8,82711.8
500540,201801,888,366,522,349097.76,496977.84,846075.60
500560,201801,894,507,387,481939.04,368516.42,850455.46
500568,201801,998,578,420,547596.2,400389.23,947985.43
500570,201801,1220,685,535,650774.78,508059.58,1158834.36
500580,201801,336,172,164,163792.26,156443,320235.26
500600,201801,316,159,157,150975.27,149760,300735.27
500620,201801,908,641,267,605736.67,254527.2,860263.87
500625,201801,81,69,12,65119.19,11448,76567.19
500627,201801,23,10,13,9540,12402,21942
500630,201801,1571,828,743,788949.26,708341.03,1497290.29
500635,201801,518,295,223,281010.24,212598.9,493609.14
500640,201801,428,225,203,212076,193643.46,405719.46
500660,201801,5485,2103,3382,2002542.6,3222689.12,5225231.72
500690,201801,576,201,375,191406.24,356061.17,547467.41
500710,201801,357,173,184,164756,175240.8,339996.8
500720,201801,969,566,403,538528.23,384252.92,922781.15
500730,201801,194,112,82,106848,77937.03,184785.03
500740,201801,850,367,483,348822.18,460027.75,808849.93
500750,201801,134,43,91,41022,86618.92,127640.92
500755,201801,123,89,34,84620,32436,117056
500769,201801,743,416,327,396542.04,311945,708487.04
500770,201801,443,232,211,221318.46,201284.46,422602.92
500780,201801,173,116,57,110664,54378,165042
500790,201801,1033,514,519,489779.23,494799.46,984578.69
500793,201801,255,136,119,129744,113517,243261
500795,201801,178,127,51,121148.46,48645,169793.46
500797,201801,40,32,8,30528,7632,38160
500800,201801,413,176,237,167895,225811.8,393706.8
500830,201801,2176,1217,959,1158605.92,913894.38,2072500.30
500840,201801,143,106,37,101124,35289,136413
510010,201801,165,91,74,86804.46,70596,157400.46
510020,201801,484,223,261,212448.6,248181.5,460630.1
510025,201801,1662,935,727,891148.21,690726.54,1581874.75
510030,201801,638,327,311,311911.92,295930.23,607842.15
510035,201801,127,57,70,54350.46,66761.46,121111.92
510040,201801,384,169,215,161226,204663.26,365889.26
510050,201801,427,232,195,220587.2,185206.38,405793.58
510060,201801,115,57,58,54368.46,55322.46,109690.92
510080,201801,219,87,132,82965.69,125805.06,208770.75
510100,201801,77,35,42,33390,40048.92,73438.92
510120,201801,37,22,15,20988,14310,35298
510125,201801,398,247,151,234955.89,144030.92,378986.81
510130,201801,590,343,247,326807.27,235213.56,562020.83
510140,201801,390,128,262,122103,249943.23,372046.23
510160,201801,91,42,49,40068,46742,86810
510170,201801,865,530,335,505354.05,318956.3,824310.35
510180,201801,2878,1398,1480,1330683.34,1409950.16,2740633.50
510185,201801,12,6,6,5724,5724,11448
510190,201801,212,73,139,69642,132601.23,202243.23
510250,201801,2606,1525,1081,1453800.07,1030151.18,2483951.25
510260,201801,202,144,58,137193.84,55295.46,192489.30
510263,201801,454,249,205,236078.2,194814.59,430892.79
510267,201801,650,363,287,345746.76,273527.45,619274.21
510268,201801,56,29,27,27666,25758,53424
510269,201801,70,30,40,28611,38160,66771
510270,201801,413,210,203,200161.98,193245.48,393407.46
510279,201801,230,169,61,161189.46,57888.92,219078.38
510285,201801,168,75,93,71531.46,88722,160253.46
510300,201801,547,296,251,281933.06,239379.84,521312.90
510305,201801,216,99,117,94423.46,111524.22,205947.68
510310,201801,115,58,57,55332,54368.46,109700.46
510320,201801,853,528,325,503134.64,309614.38,812749.02
510325,201801,414,165,249,157400.46,237250.26,394650.72
510330,201801,424,239,185,227993,176470.92,404463.92
510335,201801,603,322,281,307141.38,267400.44,574541.82
510336,201801,49,36,13,34344,12402,46746
510337,201801,118,47,71,44828.46,67724.46,112552.92
510340,201801,17462,8412,9050,8001451.82,8622701.22,16624153.04
510343,201801,70,48,22,45782.46,20988,66770.46
510345,201801,159,105,54,100160.46,51210.92,151371.38
510350,201801,667,373,294,354900.07,280411.38,635311.45
510360,201801,202,119,83,113517,79099.92,192616.92
510370,201801,137,71,66,67714.92,62832.6,130547.52
510380,201801,92,63,29,60102,27657,87759
510385,201801,59,27,32,25758,30519,56277
510390,201801,124,52,72,49608,68649.84,118257.84
510395,201801,41,28,13,26712,12402,39114
510410,201801,703,464,239,442632,227982.69,670614.69
510420,201801,593,287,306,272843.26,290456.29,563299.55
510450,201801,50,30,20,28620,19080,47700
510452,201801,40,23,17,21942,16218,38160
510454,201801,65,27,38,25758,36242.46,62000.46
510455,201801,126,80,46,76300.92,43884,120184.92
510460,201801,183,95,88,90163.72,83914.38,174078.10
510480,201801,738,419,319,398599.89,303978.36,702578.25
510490,201801,360,185,175,176100.8,166445.08,342545.88
510500,201801,252,189,63,180296.46,60102,240398.46
510510,201801,787,452,335,430322.06,319580.46,749902.52
510515,201801,1139,606,533,577287.64,508444.38,1085732.02
510517,201801,247,106,141,100551.6,134490.69,235042.29
510520,201801,228,147,81,140145.3,76954.3,217099.6
510523,201801,93,63,30,60102,28610.46,88712.46
510525,201801,717,408,309,388459.3,294675.3,683134.6
510530,201801,17,12,5,11448,4770,16218
510550,201801,272,122,150,115919.27,143091,259010.27
510558,201801,278,136,142,129711.15,135439.92,265151.07
510560,201801,386,240,146,228960,139266,368226
510562,201801,641,446,195,424153.17,185543.46,609696.63
510590,201801,827,431,396,411136.38,377765.69,788902.07
510600,201801,255,138,117,131628.92,111580.92,243209.84
510610,201801,172,82,90,78208.92,85555.46,163764.38
510615,201801,189,77,112,73438.92,106848,180286.92
510617,201801,17,10,7,9540,6678,16218
510618,201801,115,55,60,52470,56763,109233
510619,201801,105,73,32,69633,30519,100152
510620,201801,189,106,83,101114.46,79182,180296.46
510621,201801,193,123,70,117323.46,66752.46,184075.92
510622,201801,448,289,159,275613.84,151362.38,426976.22
510623,201801,361,240,121,228913.38,115405.38,344318.76
510624,201801,88,40,48,38151,45792,83943
510625,201801,532,326,206,310794.3,195926.98,506721.28
510626,201801,107,67,40,63918,38160,102078
510627,201801,57,42,15,40068,14310,54378
510628,201801,164,98,66,93445.92,62906.76,156352.68
510629,201801,254,164,90,156456,84896.46,241352.46
510630,201801,458,233,225,222197.22,214313.49,436510.71
510631,201801,11,3,8,2862,7346,10208
510637,201801,345,192,153,182822.18,145815.84,328638.02
510642,201801,980,543,437,517671.18,416755.44,934426.62
510645,201801,0,0,0,0,0,0
510650,201801,1513,996,517,950021.38,493106.22,1443127.60
510665,201801,87,44,43,41920,41022,82942
510670,201801,66,36,30,34344,28620,62964
510675,201801,1172,704,468,671585,446449.23,1118034.23
510677,201801,365,172,193,163082.84,183696.68,346779.52
510680,201801,109,64,45,61038,42921,103959
510682,201801,202,96,106,91262,101124,192386
510685,201801,51,37,14,35298,13356,48654
510700,201801,620,360,260,343321.92,247906.76,591228.68
510704,201801,1041,565,476,536730.78,452518.98,989249.76
510706,201801,129,61,68,58189.23,64834.92,123024.15
510710,201801,389,263,126,250704.06,120089.68,370793.74
510715,201801,64,47,17,44828.46,16218,61046.46
510718,201801,208,111,97,105800.76,92519.46,198320.22
510719,201801,35,19,16,18126,15264,33390
510720,201801,196,130,66,124011,62677.8,186688.8
510724,201801,88,37,51,35288.46,48621.38,83909.84
510726,201801,52,27,25,25748.46,23832,49580.46
510729,201801,79,38,41,36252,39075.84,75327.84
510730,201801,473,258,215,246114,204962.46,451076.46
510735,201801,109,43,66,41022,62964,103986
510740,201801,29,15,14,14310,13356,27666
510757,201801,19,15,4,14310,3816,18126
510760,201801,7050,3751,3299,3566682.68,3140959.15,6707641.83
510770,201801,730,346,384,329895.3,366131.76,696027.06
510774,201801,14,6,8,5724,7632,13356
510775,201801,113,85,28,81080.46,26702.46,107782.92
510776,201801,29,8,21,7632,20034,27666
510777,201801,188,84,104,80107.38,99187.38,179294.76
510779,201801,55,25,30,23841,28582.92,52423.92
510780,201801,297,164,133,156393.46,126798,283191.46
510785,201801,446,242,204,230801.76,194539.68,425341.44
510787,201801,188,95,93,90616.23,88704.23,179320.46
510788,201801,0,0,0,0,0,0
510790,201801,2397,1246,1151,1186583.94,1095897.96,2282481.90
510792,201801,1079,601,478,572867.55,455596.88,1028464.43
510794,201801,113,56,57,53424,54349.92,107773.92
510795,201801,2404,1400,1004,1328274.47,954866.6,2283141.07
510800,201801,177,107,70,102068.46,66771,168839.46
510805,201801,165,116,49,110664,46746,157410
510810,201801,93,38,55,36169.38,52346.52,88515.90
510820,201801,260,122,138,116151.46,130652.03,246803.49
510830,201801,66,40,26,38160,24795,62955
510835,201801,7,5,2,4770,1908,6678
510840,201801,9286,4604,4682,4377725.11,4458436.33,8836161.44
510850,201801,208,87,121,82988.46,115110.18,198098.64
510860,201801,388,170,218,161993.52,207281.8,369275.32
510880,201801,64,49,15,46727.46,14310,61037.46
510885,201801,72,44,28,41957.46,26683.38,68640.84
510890,201801,73,42,31,40068,29574,69642
510895,201801,189,107,82,102078,77919.46,179997.46
520005,201801,33,22,11,20988,10494,31482
520010,201801,281,127,154,121158,146821,267979
520013,201801,631,377,254,359630,242029.8,601659.8
520015,201801,51,37,14,35298,13356,48654
520017,201801,103,60,43,56954,41022,97976
520020,201801,29,15,14,14310,13356,27666
520025,201801,2015,1093,922,1041539.24,878720.4,1920259.64
520030,201801,801,405,396,385407,376209.9,761616.9
520050,201801,77,52,25,49608,23850,73458
520055,201801,43,29,14,27666,13356,41022
520060,201801,178,115,63,109710,60102,169812
520080,201801,589,407,182,387991.8,173628,561619.8
520082,201801,20,14,6,13356,5724,19080
520085,201801,98,72,26,68688,24804,93492
520090,201801,91,63,28,60102,26712,86814
520110,201801,9012,3895,5117,3710717.16,4877935.42,8588652.58
520120,201801,13,8,5,7431.66,4770,12201.66
520130,201801,758,536,222,511335,211779,723114
520140,201801,11778,6624,5154,6311164.97,4913982.23,11225147.20
520145,201801,44,33,11,31482,10494,41976
520150,201801,190,149,41,142146,39114,181260
520160,201801,32,22,10,20988,9540,30528
520170,201801,232,143,89,136390,84869,221259
520180,201801,115,60,55,57240,52470,109710
520215,201801,209,130,79,123733.8,75079.8,198813.6
520235,201801,70,53,17,50562,16218,66780
520250,201801,136,82,54,78228,51229.8,129457.8
520260,201801,112,70,42,66780,39114,105894
520280,201801,47,35,12,32723,11448,44171
520310,201801,39,26,13,24804,12402,37206
520320,201801,164,106,58,101114.46,55332,156446.46
520330,201801,781,411,370,392048.46,352953,745001.46
520340,201801,352,201,151,191754,144035.46,335789.46
520350,201801,523,238,285,227052,271843,498895
520355,201801,88,49,39,46746,37206,83952
520357,201801,25,18,7,17172,6678,23850
520360,201801,0,0,0,0,0,0
520380,201801,137,71,66,67734,62964,130698
520390,201801,294,122,172,115911,163825.5,279736.5
520393,201801,12,9,3,8586,2862,11448
520396,201801,97,57,40,54378,38160,92538
520400,201801,229,133,96,125261.2,91584,216845.2
520410,201801,203,103,100,98253,95391,193644
520420,201801,24,16,8,15264,7632,22896
520425,201801,299,128,171,121159,162658.2,283817.2
520430,201801,452,233,219,221995.8,208870,430865.8
520440,201801,601,399,202,380598.3,192708,573306.3
520450,201801,1905,863,1042,822187.46,993412.44,1815599.90
520455,201801,57,40,17,38160,16218,54378
520460,201801,30,15,15,14310,14310,28620
520465,201801,24,20,4,19080,3816,22896
520470,201801,417,258,159,245826.63,151686,397512.63
520480,201801,83,47,36,44838,34299,79137
520485,201801,126,42,84,40068,79850,119918
520490,201801,395,292,103,278383.98,98097.92,376481.90
520495,201801,179,108,71,103032,67734,170766
520500,201801,176,134,42,127836,40068,167904
520505,201801,173,91,82,86809.23,78228,165037.23
520510,201801,1769,866,903,822864.74,859437.96,1682302.70
520520,201801,38,29,9,27666,8586,36252
520530,201801,230,168,62,157880.32,58348.54,216228.86
520540,201801,533,353,180,335455.02,171720,507175.02
520545,201801,161,89,72,84906,68688,153594
520547,201801,52,29,23,27666,21942,49608
520549,201801,1076,512,564,488124,537652,1025776
520551,201801,291,149,142,142146,135468,277614
520552,201801,45,27,18,25758,17172,42930
520570,201801,16,9,7,8586,6678,15264
520580,201801,284,172,112,164069.46,106848,270917.46
520590,201801,161,95,66,90630,62677.8,153307.8
520620,201801,1137,534,603,508578.48,574680.26,1083258.74
520630,201801,42,25,17,23850,16218,40068
520640,201801,414,235,179,224190,170766,394956
520650,201801,53,38,15,36252,14310,50562
520660,201801,35,19,16,18126,15264,33390
520670,201801,33,28,5,26712,4770,31482
520680,201801,58,38,20,36252,19080,55332
520690,201801,33,10,23,9540,21914.46,31454.46
520710,201801,37,33,4,31482,3816,35298
520725,201801,197,126,71,120204,67734,187938
520735,201801,59,42,17,40068,16218,56286
520740,201801,400,198,202,188177.4,192699,380876.4
520750,201801,37,27,10,25758,9540,35298
520753,201801,53,38,15,36252,14310,50562
520760,201801,107,72,35,68688,33390,102078
520780,201801,286,218,68,207972,64872,272844
520790,201801,167,80,87,76033.8,82998,159031.8
520800,201801,3482,1856,1626,1767225.56,1550526.9,3317752.46
520810,201801,161,112,49,106848,46746,153594
520815,201801,5,5,0,4770,0,4770
520830,201801,139,91,48,86814,45505.8,132319.8
520840,201801,345,226,119,215127,113526,328653
520850,201801,107,69,38,65817,36099.36,101916.36
520860,201801,1683,1073,610,1022221.54,580796.2,1603017.74
520870,201801,30751,15137,15614,14412621.13,14880678.4,29293299.53
520880,201801,1062,591,471,563814,449314.92,1013128.92
520890,201801,795,457,338,434347.4,322347.46,756694.86
520910,201801,1027,537,490,508721.74,467460,976181.74
520915,201801,99,76,23,72504,21932.46,94436.46
520920,201801,404,197,207,187365.6,197478,384843.6
520929,201801,19,17,2,16218,1908,18126
520940,201801,75,47,28,44838,26712,71550
520945,201801,21,13,8,12402,7632,20034
520960,201801,47,31,16,29574,15264,44838
520970,201801,330,205,125,194941,118963.8,313904.8
520980,201801,89,65,24,62010,22896,84906
520990,201801,472,317,155,302418,147870,450288
520993,201801,127,61,66,58194,62955,121149
520995,201801,242,135,107,127837,101506,229343
521000,201801,1547,899,648,855643.4,618097,1473740.4
521010,201801,664,304,360,289689.36,343374.3,633063.66
521015,201801,17,10,7,9540,6678,16218
521020,201801,1473,1021,452,973404.9,430837.22,1404242.12
521030,201801,45,31,14,29574,13356,42930
521040,201801,921,562,359,535910.2,342200,878110.2
521056,201801,43,29,14,27666,13356,41022
521060,201801,131,82,49,78228,46746,124974
521080,201801,466,348,118,331983,112572,444555
521090,201801,527,316,211,301464,201017.34,502481.34
521100,201801,289,212,77,202239,73458,275697
521120,201801,1039,711,328,676481.6,312617,989098.6
521130,201801,360,257,103,245168.46,97376.6,342545.06
521140,201801,186,106,80,101124,76320,177444
521150,201801,2808,1218,1590,1160008.88,1515587.49,2675596.37
521160,201801,32,17,15,16218,14310,30528
521170,201801,196,114,82,108746.46,78228,186974.46
521180,201801,1115,702,413,668077.26,393287.2,1061364.46
521190,201801,2559,1086,1473,1036024.92,1404364.72,2440389.64
521200,201801,46,34,12,32436,11448,43884
521205,201801,15,11,4,10494,3816,14310
521210,201801,147,83,64,79182,61056,140238
521220,201801,812,548,264,520159.76,251800,771959.76
521225,201801,28,17,11,16218,10494,26712
521230,201801,113,74,39,70309.8,37206,107515.8
521250,201801,6739,3716,3023,3538624.12,2881635.26,6420259.38
521260,201801,19,14,5,13356,4770,18126
521270,201801,145,112,33,106848,31482,138330
521280,201801,435,254,181,241648.2,172674,414322.2
521290,201801,31,13,18,12402,17172,29574
521295,201801,100,67,33,63689.04,31482,95171.04
521300,201801,232,119,113,113508,107442.38,220950.38
521305,201801,36,24,12,22896,11448,34344
521308,201801,1085,786,299,749345.68,284951,1034296.68
521310,201801,1348,801,547,762869.4,520646.92,1283516.32
521340,201801,22,17,5,16218,4770,20988
521350,201801,132,97,35,92538,33390,125928
521370,201801,189,118,71,111618,67447.8,179065.8
521375,201801,191,107,84,102078,79849.8,181927.8
521377,201801,51,34,17,32436,16218,48654
521380,201801,1063,694,369,657928.22,352026,1009954.22
521385,201801,15,8,7,7632,6678,14310
521390,201801,107,87,20,82680.04,19080,101760.04
521400,201801,325,206,119,196237.8,113478.3,309716.1
521405,201801,149,75,74,71550,70596,142146
521410,201801,66,44,22,41976,20988,62964
521440,201801,210,147,63,139427.1,60102,199529.1
521450,201801,721,399,322,380646,307188,687834
521460,201801,1185,725,460,691363.8,438820.92,1130184.72
521470,201801,14,9,5,8586,4770,13356
521480,201801,48,32,16,30519,15199,45718
521483,201801,302,161,141,153308,134514,287822
521486,201801,288,181,107,172549.98,101411,273960.98
521487,201801,23,11,12,10494,11448,21942
521490,201801,28,16,12,15264,11448,26712
521500,201801,114,73,41,69642,39114,108756
521520,201801,41,30,11,28620,10494,39114
521523,201801,585,360,225,341213.78,214650,555863.78
521525,201801,45,30,15,28620,14310,42930
521530,201801,248,131,117,124974,111618,236592
521540,201801,31,16,15,15264,14310,29574
521550,201801,93,43,50,40707.92,47644.92,88352.84
521560,201801,798,547,251,521507.72,239311,760818.72
521565,201801,47,32,15,30528,14310,44838
521570,201801,488,327,161,311948.46,153499.3,465447.76
521580,201801,61,38,23,36252,21942,58194
521590,201801,35,19,16,18126,15264,33390
521600,201801,30,18,12,17172,11448,28620
521630,201801,237,119,118,113516.46,111581.96,225098.42
521640,201801,301,152,149,145008,142146,287154
521645,201801,30,16,14,15264,13356,28620
521680,201801,219,139,80,132606,76320,208926
521690,201801,3,2,1,1908,954,2862
521710,201801,1193,558,635,531473.8,605781,1137254.8
521720,201801,533,351,182,334844.46,173590.46,508434.92
521730,201801,626,305,321,290970,305127.56,596097.56
521740,201801,918,369,549,351997.92,522546.32,874544.24
521760,201801,1583,858,725,816954.63,691336,1508290.63
521770,201801,802,510,292,486540,278100.54,764640.54
521800,201801,2088,1294,794,1230934.56,757052.64,1987987.20
521805,201801,33,18,15,17172,14310,31482
521810,201801,94,58,36,54187.8,34344,88531.8
521830,201801,956,671,285,638512.62,271881,910393.62
521839,201801,93,62,31,59148,29574,88722
521850,201801,1105,589,516,560486.92,491939.68,1052426.60
521860,201801,346,213,133,203202,126596,329798
521870,201801,74,43,31,41022,29574,70596
521878,201801,42,20,22,19080,20988,40068
521880,201801,4459,1997,2462,1902847.36,2345857.7,4248705.06
521890,201801,574,397,177,378738,168571.8,547309.8
521900,201801,290,234,56,222599.96,53424,276023.96
521910,201801,154,108,46,103032,43884,146916
521920,201801,53,25,28,23850,26712,50562
521925,201801,35,21,14,20034,13356,33390
521930,201801,1118,639,479,609409.98,456313.34,1065723.32
521935,201801,32,25,7,23850,6678,30528
521940,201801,193,97,96,92538,91579.23,184117.23
521945,201801,14,12,2,11448,1908,13356
521950,201801,9,5,4,4770,3816,8586
521960,201801,74,55,19,52470,18126,70596
521970,201801,422,269,153,256339.8,145962,402301.8
521971,201801,96,47,49,44838,46746,91584
521973,201801,29,13,16,12402,15264,27666
521975,201801,1101,570,531,542636.2,505658.66,1048294.86
521980,201801,245,167,78,159318,74412,233730
521990,201801,71,52,19,49608,18126,67734
522000,201801,288,178,110,169812,104940,274752
522005,201801,21,13,8,12402,7632,20034
522010,201801,1116,626,490,597195,466878.06,1064073.06
522015,201801,54,33,21,31473,20034,51507
522020,201801,867,465,402,442656.2,382726.12,825382.32
522026,201801,30,22,8,20988,7632,28620
522028,201801,16,12,4,11448,3816,15264
522040,201801,747,296,451,282080,430199.46,712279.46
522045,201801,2054,1291,763,1230292.06,727368.8,1957660.86
522050,201801,169,81,88,77274,83952,161226
522060,201801,559,352,207,335521.8,197382.6,532904.4
522068,201801,136,90,46,85860,43884,129744
522070,201801,10,10,0,9540,0,9540
522100,201801,46,24,22,22628.88,20988,43616.88
522108,201801,40,30,10,28620,9540,38160
522119,201801,57,29,28,27666,26712,54378
522130,201801,74,25,49,23850,46728,70578
522140,201801,3696,1883,1813,1790760.42,1727437.9,3518198.32
522145,201801,51,30,21,28620,20034,48654
522150,201801,64,50,14,47700,13356,61056
522155,201801,58,41,17,39105,16218,55323
522157,201801,5,4,1,3816,954,4770
522160,201801,1728,1009,719,961441.2,685630.8,1647072.0
522170,201801,396,267,129,254718,123066,377784
522180,201801,36,20,16,19080,15264,34344
522185,201801,1295,542,753,514047.26,717841,1231888.26
522190,201801,48,27,21,25758,19938.6,45696.6
522200,201801,299,181,118,172674,112572,285246
522205,201801,166,111,55,105894,52470,158364
522220,201801,166,117,49,111618,46746,158364
522230,201801,31,24,7,22896,6678,29574
530010,201801,55576,28473,27103,27026612.28,25805267.63,52831879.91
110001,201802,515,408,107,388248.35,101432.96,489681.31
110002,201802,2791,1674,1117,1595116.19,1064711.49,2659827.68
110003,201802,93,73,20,69642,19080,88722
110004,201802,1992,1272,720,1210587.02,686584.26,1897171.28
110005,201802,440,352,88,334652.9,83942.46,418595.36
110006,201802,446,343,103,326935.8,98242.92,425178.72
110007,201802,82,65,17,62010,16218,78228
110008,201802,238,136,102,128508.9,97308,225816.9
110009,201802,785,531,254,504381.2,242117,746498.2
110010,201802,1790,1109,681,1056753,649532.52,1706285.52
110011,201802,1879,1446,433,1377953.2,413052.35,1791005.55
110012,201802,4108,2391,1717,2273527.71,1636746.46,3910274.17
110013,201802,747,565,182,539000.46,173628,712628.46
110014,201802,366,311,55,296673.89,52465.23,349139.12
110015,201802,1421,1147,274,1091810.91,260804.52,1352615.43
110018,201802,1117,665,452,634096,431195.23,1065291.23
110020,201802,15327,9007,6320,8548652.5,6018370.59,14567023.09
110025,201802,649,475,174,451152.11,165987,617139.11
110026,201802,42,28,14,26712,13356,40068
110028,201802,1645,1191,454,1131612.59,429523.44,1561136.03
110029,201802,140,123,17,117342,16218,133560
110030,201802,2472,1658,814,1578821.46,775655.46,2354476.92
110032,201802,395,304,91,289707,86810,376517
110033,201802,670,504,166,477813,158360,636173
110034,201802,359,267,92,252406,87101,339507
110037,201802,105,86,19,82044,18126,100170
110040,201802,333,222,111,211788,105894,317682
110045,201802,935,622,313,591842,296898.39,888740.39
110050,201802,94,76,18,72504,17172,89676
110060,201802,86,45,41,42930,39114,82044
110070,201802,125,74,51,70596,48368,118964
110080,201802,397,237,160,223875.18,152591.27,376466.45
110090,201802,32,27,5,25758,4770,30528
110092,201802,111,63,48,60102,45722,105824
110094,201802,200,139,61,132606,58194,190800
110100,201802,27,22,5,20988,4770,25758
110110,201802,71,44,27,41976,25758,67734
110120,201802,74,60,14,57240,13356,70596
110130,201802,303,244,59,231281.12,56286,287567.12
110140,201802,247,159,88,151495.2,83942.46,235437.66
110143,201802,48,40,8,38160,7632,45792
110145,201802,29,20,9,19080,8586,27666
110146,201802,23,12,11,11448,10494,21942
110147,201802,39,30,9,28620,8586,37206
110148,201802,39,27,12,25706.57,11448,37154.57
110149,201802,295,212,83,201961.8,79182,281143.8
110150,201802,84,57,27,54378,25491.89,79869.89
110155,201802,8,7,1,6678,954,7632
110160,201802,71,59,12,56286,11448,67734
110170,201802,210,170,40,162180,38160,200340
110175,201802,33,25,8,23850,7632,31482
110180,201802,92,80,12,76320,11448,87768
120001,201802,134,91,43,86772,40993,127765
120005,201802,190,118,72,112529.12,68688,181217.12
120010,201802,1012,651,361,613931.22,342161.16,956092.38
120013,201802,139,96,43,90897.94,40042,130939.94
120017,201802,92,59,33,56177.48,31439.12,87616.60
120020,201802,3515,2796,719,2638761.68,682319.67,3321081.35
120025,201802,600,338,262,319914.22,248866.6,568780.82
120030,201802,1017,850,167,802763.7,158560.12,961323.82
120032,201802,49,41,8,39092.12,7632,46724.12
120033,201802,215,189,26,179958.75,24804,204762.75
120034,201802,156,113,43,105872.12,40978.24,146850.36
120035,201802,30,21,9,20034,8586,28620
120038,201802,387,244,143,231951.88,136378.24,368330.12
120039,201802,23,21,2,20034,1908,21942
120040,201802,14027,9707,4320,9127854.42,4081920.24,13209774.66
120042,201802,43,37,6,35298,5724,41022
120043,201802,13,3,10,2862,9540,12402
120045,201802,538,348,190,329911.38,180994.6,510905.98
120050,201802,1259,962,297,912181.84,282961.27,1195143.11
120060,201802,1420,1149,271,1079789.93,254591.2,1334381.13
120070,201802,502,361,141,337902.44,133172.54,471074.98
120080,201802,161,103,58,97054.3,54765.3,151819.6
130002,201802,149,104,45,99216,42930,142146
130006,201802,75,43,32,41022,30528,71550
130008,201802,144,77,67,72737.72,63195.96,135933.68
130010,201802,138,73,65,69642,62010,131652
130014,201802,236,172,64,164088,61056,225144
130020,201802,88,47,41,44838,39114,83952
130030,201802,892,544,348,518976,331982.46,850958.46
130040,201802,330,164,166,156456,157410.28,313866.28
130050,201802,555,307,248,292591.8,236592,529183.8
130060,201802,888,605,283,572021.2,267161.24,839182.44
130063,201802,546,285,261,271890,248972.12,520862.12
130068,201802,187,121,66,115434,62677.8,178111.8
130070,201802,1333,926,407,869885.65,383315.12,1253200.77
130080,201802,660,430,230,409838.4,219411,629249.4
130083,201802,70,38,32,36252,30528,66780
130090,201802,377,195,182,184350.96,173628,357978.96
130100,201802,1107,517,590,493218,562573.8,1055791.8
130110,201802,701,314,387,299406,369198,668604
130115,201802,172,69,103,65826,98262,164088
130120,201802,1625,1013,612,966402,583848,1550250
130130,201802,615,416,199,396864,189846,586710
130140,201802,1531,1151,380,1097391.02,361566.2,1458957.22
130150,201802,426,361,65,344394,62010,406404
130160,201802,469,262,207,249948,197478,447426
130165,201802,23,16,7,15264,6678,21942
130170,201802,942,668,274,637201.4,261396,898597.4
130180,201802,151,91,60,86337,57240,143577
130185,201802,2244,1170,1074,1114251.89,1024004.92,2138256.81
130190,201802,3612,2258,1354,2149904.68,1290127.99,3440032.67
130195,201802,291,233,58,222282,55332,277614
130200,201802,178,81,97,77264.46,92538,169802.46
130210,201802,78,39,39,37206,37206,74412
130220,201802,187,128,59,122112,56286,178398
130230,201802,333,210,123,200340,117342,317682
130240,201802,1459,919,540,875386.4,514582.83,1389969.23
130250,201802,4721,3041,1680,2895766.98,1602567.49,4498334.47
130255,201802,424,209,215,199386,204823.8,404209.8
130260,201802,53164,25421,27743,24218244.46,26459982.72,50678227.18
130270,201802,1503,959,544,914409,518976,1433385
130280,201802,114,69,45,65826,42930,108756
130290,201802,2077,1504,573,1434816,546355.8,1981171.8
130300,201802,424,305,119,290683.8,113526,404209.8
130310,201802,883,467,416,445518,396864,842382
130320,201802,443,237,206,225144,196524,421668
130330,201802,705,427,278,407358,264925.8,672283.8
130340,201802,3249,1964,1285,1869077.2,1224459.2,3093536.4
130350,201802,472,301,171,287132.12,163134,450266.12
130353,201802,780,320,460,304994,438840,743834
130356,201802,759,347,412,331038,392761.8,723799.8
130360,201802,69,40,29,38160,27666,65826
130370,201802,677,499,178,476046,169812,645858
130380,201802,631,433,198,413082,188892,601974
130390,201802,484,390,94,372060,89676,461736
130395,201802,181,41,140,39114,133560,172674
130400,201802,69,46,23,43884,21942,65826
130406,201802,2077,1310,767,1246126.3,730507.76,1976634.06
130410,201802,501,214,287,204156,273778.92,477934.92
130420,201802,3193,2562,631,2440361.5,601974,3042335.5
130423,201802,161,75,86,71550,82044,153594
130426,201802,142,83,59,79182,56286,135468
130430,201802,406,268,138,255672,131652,387324
130440,201802,198,71,127,67734,121158,188892
140002,201802,36,14,22,13356,20988,34344
140005,201802,206,126,80,119965.5,76320,196285.5
140010,201802,10250,6928,3322,6576631.09,3166514.63,9743145.72
140015,201802,155,69,86,65826,82044,147870
140017,201802,110,76,34,72504,32436,104940
140020,201802,477,319,158,303372,150732,454104
140023,201802,26,16,10,15045,9540,24585
140028,201802,18,13,5,12402,4770,17172
140030,201802,360,256,104,244224,98614.98,342838.98
140040,201802,55,38,17,36252,16122.6,52374.6
140045,201802,247,115,132,109042.2,125928,234970.2
140047,201802,561,377,184,357646.39,174773,532419.39
140050,201802,148,97,51,91725,48654,140379
140060,201802,34,23,11,21207.42,10494,31701.42
140070,201802,31,28,3,26712,2862,29574
150010,201802,4719,2921,1798,2783915.5,1713280.84,4497196.34
150013,201802,146,99,47,94446,44838,139284
150020,201802,1074,570,504,543780,480816,1024596
150030,201802,736,300,436,286200,415944,702144
150034,201802,195,121,74,115434,70596,186030
150040,201802,1395,826,569,788004,542826,1330830
150050,201802,711,422,289,401586.8,275506,677092.8
150060,201802,4744,3070,1674,2925308.17,1596757.5,4522065.67
150070,201802,316,146,170,139284,162180,301464
150080,201802,14538,7309,7229,6961183.93,6888470.79,13849654.72
150085,201802,372,234,138,223226.46,131652,354878.46
150090,201802,760,647,113,617238,107802,725040
150095,201802,344,210,134,199570.12,127015.56,326585.68
150100,201802,55,39,16,37206,15264,52470
150110,201802,173,85,88,81090,83952,165042
150120,201802,434,323,111,308142,105894,414036
150125,201802,54,23,31,21942,29574,51516
150130,201802,1898,1013,885,966402,844285.23,1810687.23
150140,201802,54570,25422,29148,24220261.69,27793354.22,52013615.91
150145,201802,177,103,74,98262,70596,168858
150150,201802,2816,1259,1557,1200868.49,1481433.61,2682302.10
150157,201802,437,302,135,288108,128785.23,416893.23
150160,201802,122,98,24,93492,22896,116388
150170,201802,3667,2718,949,2589108.3,905059.8,3494168.1
150172,201802,322,221,101,210834,96354,307188
150175,201802,91,56,35,53424,33390,86814
150178,201802,761,507,254,482532.77,242316,724848.77
150180,201802,3052,1468,1584,1399661.6,1510539.95,2910201.55
150190,201802,336,215,121,205110,115434,320544
150195,201802,119,58,61,55332,58194,113526
150200,201802,207,97,110,92538,104940,197478
150210,201802,3172,2569,603,2449767.86,575019.5,3024787.36
150215,201802,506,332,174,316728,165996,482724
150220,201802,3927,2653,1274,2529402.8,1213278.32,3742681.12
150230,201802,1148,921,227,878054.04,216554,1094608.04
150240,201802,5791,3387,2404,3227756.73,2293407,5521163.73
150250,201802,33,16,17,15264,16218,31482
150260,201802,73,44,29,41976,27666,69642
150270,201802,2347,1534,813,1462144.32,774743.8,2236888.12
150275,201802,580,354,226,337716,215604,553320
150276,201802,104,44,60,41976,57240,99216
150277,201802,759,327,432,311939.46,412128,724067.46
150280,201802,342,210,132,200340,125928,326268
150285,201802,74,37,37,35298,35298,70596
150290,201802,966,591,375,563518.26,357464,920982.26
150293,201802,677,311,366,296494.46,349164,645658.46
150295,201802,464,206,258,196524,245979.44,442503.44
150300,201802,80,41,39,39114,37206,76320
150304,201802,141,93,48,88722,45792,134514
150307,201802,399,329,70,313866,66780,380646
150309,201802,553,398,155,379692,147870,527562
150310,201802,253,171,82,163134,78228,241362
150320,201802,1796,1236,560,1178862.57,534240,1713102.57
150330,201802,2073,1190,883,1134592.2,842382,1976974.2
150340,201802,198,133,65,126643.5,62010,188653.5
150345,201802,603,326,277,310822.74,264258,575080.74
150350,201802,418,324,94,306701.46,89676,396377.46
150360,201802,4500,2876,1624,2740036.19,1549286.46,4289322.65
150370,201802,755,539,216,513410,205768.8,719178.8
150375,201802,194,102,92,97308,87768,185076
150380,201802,1289,853,436,813762,415658,1229420
150390,201802,742,422,320,402584,305280,707864
150400,201802,98,81,17,77274,16218,93492
150405,201802,1252,827,425,788201.48,404877.6,1193079.08
150410,201802,140,90,50,85840.92,47700,133540.92
150420,201802,7429,4051,3378,3862995.48,3220764.73,7083760.21
150430,201802,491,330,161,314820,153594,468414
150440,201802,593,350,243,333137,231822,564959
150442,201802,2144,1150,994,1094572.04,947699.03,2042271.07
150445,201802,524,328,196,312912,186030,498942
150450,201802,274,128,146,122112,139284,261396
150460,201802,768,582,186,553401.09,177424.92,730826.01
150470,201802,1336,805,531,767684,506574,1274258
150475,201802,36,26,10,24804,9540,34344
150480,201802,1245,866,379,826164,361279.8,1187443.8
150490,201802,619,337,282,321498,269028,590526
150495,201802,330,230,100,219420,95400,314820
150497,201802,301,205,96,195570,91574.46,287144.46
150500,201802,431,290,141,276660,134514,411174
150503,201802,864,414,450,394670,429282,823952
150506,201802,1030,672,358,641088,341522.46,982610.46
150510,201802,1241,697,544,664652,518976,1183628
150520,201802,274,182,92,173628,87768,261396
150530,201802,1576,850,726,807752.3,691363.8,1499116.1
150540,201802,239,166,73,158364,69642,228006
150543,201802,695,396,299,377192.52,284959.8,662152.32
150548,201802,499,344,155,328176,147870,476046
150549,201802,60,40,20,38160,19080,57240
150550,201802,2900,1511,1389,1440541,1324820,2765361
150553,201802,3073,1815,1258,1729984.6,1200122.46,2930107.06
150555,201802,144,75,69,71550,65826,137376
150560,201802,53,40,13,38160,12402,50562
150563,201802,73,39,34,37206,32436,69642
150565,201802,167,99,68,94446,64872,159318
150570,201802,401,266,135,253744.92,128790,382534.92
150580,201802,1517,641,876,610846.2,835704,1446550.2
150590,201802,775,474,301,452196,287154,739350
150600,201802,461,276,185,263304,176490,439794
150610,201802,145,125,20,118401,19080,137481
150611,201802,126,88,38,83952,36252,120204
150613,201802,3188,1956,1232,1866024,1175319,3041343
150616,201802,486,300,186,285962,177444,463406
150618,201802,1139,629,510,599837.58,486540,1086377.58
150619,201802,396,303,93,289062,88722,377784
150620,201802,1278,741,537,706914,512011.8,1218925.8
150630,201802,310,208,102,198432,97308,295740
150635,201802,492,205,287,195570,273798,469368
150640,201802,62,30,32,28620,30528,59148
150650,201802,2322,1357,965,1294540.34,920319.03,2214859.37
150655,201802,244,181,63,172674,60102,232776
150658,201802,105,60,45,57240,42930,100170
150660,201802,484,338,146,322452,139284,461736
150670,201802,1003,364,639,346960.8,609587.46,956548.26
150680,201802,9869,5378,4491,5123440.86,4282091.21,9405532.07
150690,201802,53,34,19,32436,18126,50562
150700,201802,538,347,191,330847.2,182214,513061.2
150710,201802,275,163,112,155502,106848,262350
150715,201802,873,527,346,501775.92,330055.38,831831.30
150720,201802,443,338,105,322452,99883.8,422335.8
150730,201802,915,485,430,462681,409933.8,872614.8
150740,201802,234,164,70,156456,66780,223236
150745,201802,764,410,354,391140,337716,728856
150746,201802,53,32,21,30528,20034,50562
150747,201802,270,208,62,198432,59148,257580
150750,201802,131,75,56,71550,53424,124974
150760,201802,1708,1106,602,1055124,574308,1629432
150770,201802,371,192,179,183168,170590.95,353758.95
150775,201802,91,42,49,40068,46746,86814
150780,201802,187,99,88,94446,83952,178398
150790,201802,890,485,405,462690,386370,849060
150795,201802,1440,837,603,798498,575262,1373760
150796,201802,404,233,171,222282,163134,385416
150797,201802,283,158,125,150732,119250,269982
150800,201802,1419,857,562,816619.23,536148,1352767.23
150803,201802,599,492,107,469368,102078,571446
150805,201802,187,118,69,112572,65812.46,178384.46
150808,201802,984,539,445,514206,424530,938736
150810,201802,3385,2338,1047,2227009,998266,3225275
150812,201802,428,224,204,213696,194616,408312
150815,201802,969,636,333,605365.47,317682,923047.47
150820,201802,1571,961,610,915840,581920.92,1497760.92
150830,201802,830,582,248,554274,236592,790866
150835,201802,189,111,78,105894,74412,180306
150840,201802,1317,839,478,800406,456012,1256418
160005,201802,53,31,22,29574,20988,50562
160010,201802,191,118,73,112572,69638,182210
160015,201802,117,67,50,63918,47700,111618
160020,201802,128,73,55,69642,52470,122112
160021,201802,41,21,20,20034,19080,39114
160023,201802,110,63,47,60102,44838,104940
160025,201802,33,14,19,13356,18126,31482
160027,201802,1444,822,622,781612.7,592634,1374246.7
160030,201802,15516,7962,7554,7586510.36,7201777.29,14788287.65
160040,201802,316,180,136,171720,129744,301464
160050,201802,656,339,317,323406,302131.8,625537.8
160053,201802,322,184,138,175250,131652,306902
160055,201802,24,18,6,17172,5724,22896
160060,201802,6333,3300,3033,3138558,2892524.2,6031082.2
160070,201802,164,101,63,96354,60102,156456
160080,201802,79,41,38,39114,36252,75366
170025,201802,24,16,8,15264,7632,22896
170030,201802,229,186,43,177247,41022,218269
170035,201802,226,110,116,104940,110664,215604
170040,201802,192,148,44,140905.8,41976,182881.8
170070,201802,321,191,130,182214,124020,306234
170100,201802,375,269,106,256626,101124,357750
170105,201802,62,51,11,48654,10494,59148
170110,201802,103,63,40,60102,38160,98262
170130,201802,72,33,39,31482,36920,68402
170190,201802,105,66,39,62964,37206,100170
170200,201802,392,261,131,248317.2,124869.76,373186.96
170210,201802,6016,3121,2895,2969043.74,2758381.86,5727425.60
170215,201802,97,46,51,43884,48654,92538
170220,201802,1427,1047,380,996643.8,362234,1358877.8
170230,201802,154,99,55,94446,52470,146916
170240,201802,552,365,187,348210,178398,526608
170255,201802,1112,891,221,849804.12,210547.8,1060351.92
170270,201802,37,28,9,26712,8395.2,35107.2
170290,201802,75,56,19,53424,18126,71550
170300,201802,81,53,28,49798.8,26712,76510.8
170305,201802,43,33,10,31482,9540,41022
170307,201802,64,47,17,44838,16218,61056
170310,201802,101,55,46,52470,43884,96354
170320,201802,17,14,3,13356,2862,16218
170330,201802,19,17,2,16218,1908,18126
170360,201802,25,15,10,14310,9540,23850
170370,201802,122,64,58,61056,55332,116388
170380,201802,81,58,23,55332,21942,77274
170382,201802,48,43,5,41022,4770,45792
170384,201802,129,94,35,89676,33390,123066
170386,201802,61,27,34,25758,32436,58194
170388,201802,46,16,30,15264,28620,43884
170389,201802,24,18,6,17172,5724,22896
170390,201802,51,30,21,28620,20034,48654
170410,201802,34,23,11,21942,10494,32436
170460,201802,17,12,5,11448,4770,16218
170510,201802,28,21,7,20034,6678,26712
170550,201802,1486,842,644,803268,613613,1416881
170555,201802,111,76,35,72504,33390,105894
170560,201802,97,70,27,66780,25758,92538
170600,201802,39,19,20,18126,19080,37206
170610,201802,192,101,91,96196.59,86796,182992.59
170625,201802,39,20,19,19080,18126,37206
170650,201802,86,64,22,61056,20988,82044
170700,201802,554,420,134,399326.3,127836,527162.3
170710,201802,154,94,60,89676,57231,146907
170720,201802,86,69,17,65826,16218,82044
170730,201802,58,34,24,32436,22896,55332
170740,201802,79,59,20,56286,19080,75366
170755,201802,70,37,33,34678,31482,66160
170765,201802,143,69,74,65206,70596,135802
170770,201802,225,129,96,121968.9,91584,213552.9
170820,201802,595,390,205,372060,195141,567201
170825,201802,30,19,11,18126,10494,28620
170830,201802,76,55,21,52279.2,20034,72313.2
170900,201802,201,152,49,145008,46746,191754
170930,201802,813,424,389,404172,370534,774706
170950,201802,3039,1325,1714,1262505.86,1631789.51,2894295.37
170980,201802,17,9,8,8586,7632,16218
171050,201802,132,101,31,96354,29574,125928
171070,201802,38,31,7,29574,6678,36252
171090,201802,39,29,10,27666,9540,37206
171110,201802,21,14,7,13356,6678,20034
171150,201802,39,18,21,17172,20034,37206
171180,201802,21,10,11,9540,10494,20034
171190,201802,138,81,57,77274,54378,131652
171195,201802,64,50,14,47700,13356,61056
171200,201802,46,19,27,18126,25758,43884
171215,201802,2,2,0,1908,0,1908
171240,201802,54,44,10,41976,9540,51516
171245,201802,51,47,4,44838,3816,48654
171250,201802,72,38,34,36252,32426.46,68678.46
171270,201802,17,13,4,12402,3816,16218
171280,201802,39,36,3,34201,2862,37063
171320,201802,991,560,431,534240,410220,944460
171330,201802,426,203,223,193662,212742,406404
171360,201802,85,63,22,60102,20988,81090
171370,201802,24,13,11,12402,10494,22896
171380,201802,134,110,24,104940,22666.09,127606.09
171395,201802,54,33,21,31482,20034,51516
171420,201802,309,205,104,195570,98929.8,294499.8
171430,201802,64,51,13,48654,12402,61056
171488,201802,207,110,97,104940,92538,197478
171500,201802,59,32,27,30528,25758,56286
171510,201802,68,45,23,42930,21942,64872
171515,201802,43,37,6,35298,5724,41022
171525,201802,31,26,5,24804,4770,29574
171550,201802,13,7,6,6678,5724,12402
171570,201802,61,30,31,28620,29574,58194
171575,201802,340,210,130,200340,124010.46,324350.46
171610,201802,1691,849,842,808047.53,801701.12,1609748.65
171620,201802,133,92,41,87214.68,39114,126328.68
171630,201802,51,27,24,25758,22896,48654
171650,201802,273,179,94,170766,89676,260442
171660,201802,264,140,124,133560,118292,251852
171665,201802,46,30,16,28620,15264,43884
171670,201802,433,252,181,237489.26,172101.6,409590.86
171700,201802,63,55,8,52470,7632,60102
171720,201802,25,8,17,7632,16218,23850
171750,201802,102,54,48,51516,45792,97308
171780,201802,70,57,13,54378,12402,66780
171790,201802,80,66,14,62964,13356,76320
171800,201802,36,28,8,26712,7632,34344
171820,201802,2058,1163,895,1108793.74,849222.82,1958016.56
171830,201802,37,29,8,27666,7632,35298
171840,201802,61,34,27,32436,25758,58194
171845,201802,32,20,12,19080,11448,30528
171850,201802,39,27,12,25758,11448,37206
171855,201802,77,60,17,57240,16218,73458
171865,201802,8,7,1,6678,954,7632
171870,201802,30,22,8,20988,7632,28620
171875,201802,77,52,25,49608,23850,73458
171880,201802,26,18,8,17172,7632,24804
171884,201802,47,24,23,22896,21942,44838
171886,201802,116,40,76,38160,72217.8,110377.8
171888,201802,24,18,6,17172,5724,22896
171889,201802,19,15,4,14310,3816,18126
171890,201802,56,46,10,43884,9540,53424
171900,201802,42,29,13,27666,12402,40068
172000,201802,41,35,6,33390,5724,39114
172010,201802,39,33,6,30671.1,5724,36395.1
172015,201802,26,16,10,15264,9253.8,24517.8
172020,201802,129,81,48,77274,45792,123066
172025,201802,32,21,11,20034,10494,30528
172030,201802,35,20,15,19080,14310,33390
172049,201802,74,44,30,41976,28620,70596
172065,201802,148,96,52,91584,49608,141192
172080,201802,90,64,26,59873.84,24804,84677.84
172085,201802,26,13,13,12402,12402,24804
172090,201802,401,304,97,290016,91775,381791
172093,201802,25,18,7,17172,6678,23850
172097,201802,16,8,8,7632,7346,14978
172100,201802,4676,2623,2053,2497349.8,1956093,4453442.8
172110,201802,81,53,28,50562,26712,77274
172120,201802,1725,1477,248,1402941.65,235484.41,1638426.06
172125,201802,2,2,0,1908,0,1908
172130,201802,16,13,3,12402,2862,15264
172208,201802,194,123,71,117342,67734,185076
172210,201802,434,210,224,200340,213410,413750
210005,201802,2913,1816,1097,1729411.22,1043678,2773089.22
210010,201802,193,98,95,93492,90630,184122
210015,201802,29,19,10,18126,9540,27666
210020,201802,347,177,170,168858,162180,331038
210030,201802,341,212,129,202248,123057,325305
210040,201802,155,120,35,114480,33390,147870
210043,201802,249,166,83,158364,79182,237546
210047,201802,616,312,304,297266.4,290006.46,587272.86
210050,201802,296,216,80,206064,76320,282384
210055,201802,43,32,11,30528,10494,41022
210060,201802,571,444,127,423576,121158,544734
210070,201802,415,304,111,290016,105894,395910
210080,201802,103,95,8,90630,7632,98262
210083,201802,307,130,177,124020,168858,292878
210087,201802,46,33,13,31482,12402,43884
210090,201802,490,337,153,321498,145962,467460
210095,201802,496,353,143,336752.46,136422,473174.46
210100,201802,688,520,168,495746.1,159318.02,655064.12
210110,201802,148,79,69,75366,65826,141192
210120,201802,5489,4109,1380,3912780,1315266.68,5228046.68
210125,201802,216,120,96,114480,91584,206064
210130,201802,551,282,269,268074,256606.92,524680.92
210135,201802,35,21,14,20034,13356,33390
210140,201802,4268,3343,925,3186028.71,882212,4068240.71
210150,201802,356,224,132,213696,125928,339624
210160,201802,3356,2813,543,2680742.78,517736,3198478.78
210170,201802,1139,882,257,841428,245178,1086606
210173,201802,120,99,21,94446,20034,114480
210177,201802,467,226,241,215604,229914,445518
210180,201802,32,18,14,17172,13356,30528
210190,201802,412,262,150,249948,143100,393048
210193,201802,1,1,0,954,0,954
210197,201802,82,54,28,51516,26712,78228
210200,201802,639,502,137,478908,130698,609606
210203,201802,265,177,88,168858,83952,252810
210207,201802,379,291,88,277614,83952,361566
210210,201802,771,699,72,666846,68688,735534
210215,201802,74,62,12,59148,11448,70596
210220,201802,397,325,72,310050,68401.8,378451.8
210230,201802,304,225,79,214650,75366,290016
210232,201802,1483,937,546,893612,520884,1414496
210235,201802,153,118,35,112382,33390,145772
210237,201802,46,25,21,23850,20034,43884
210240,201802,95,77,18,73458,17172,90630
210250,201802,181,143,38,136422,36252,172674
210255,201802,335,244,91,232776,86814,319590
210260,201802,424,263,161,250902,153594,404496
210270,201802,697,441,256,420714,244224,664938
210275,201802,42,33,9,31482,8586,40068
210280,201802,1028,653,375,620147.33,356414.5,976561.83
210290,201802,499,321,178,306234,169812,476046
210300,201802,6115,3560,2555,3391603.27,2436278.23,5827881.50
210310,201802,104,71,33,67734,31482,99216
210312,201802,126,79,47,75366,44838,120204
210315,201802,117,84,33,80136,31482,111618
210317,201802,126,90,36,85860,34344,120204
210320,201802,2389,1962,427,1870037.84,407358,2277395.84
210325,201802,132,88,44,82998,41690,124688
210330,201802,5583,2831,2752,2695942.09,2625398.46,5321340.55
210340,201802,1410,1008,402,960832,383437.07,1344269.07
210350,201802,608,496,112,472945.5,106848,579793.5
210355,201802,132,107,25,102078,23850,125928
210360,201802,2660,1656,1004,1576677.6,957530,2534207.6
210370,201802,1262,538,724,513252,690028.2,1203280.2
210375,201802,187,98,89,92949,84906,177855
210380,201802,728,542,186,517068,177444,694512
210390,201802,203,166,37,158364,35298,193662
210400,201802,405,338,67,322452,63918,386370
210405,201802,1006,660,346,629640,330084,959724
210407,201802,56,44,12,41976,11448,53424
210408,201802,64,57,7,54378,6678,61056
210409,201802,312,260,52,248040,49608,297648
210410,201802,437,339,98,323406,93483,416889
210420,201802,195,159,36,151686,34344,186030
210430,201802,35,27,8,25758,7632,33390
210440,201802,379,226,153,215604,145962,361566
210450,201802,144,106,38,101124,36252,137376
210455,201802,213,115,98,109710,93492,203202
210460,201802,347,218,129,207972,123066,331038
210462,201802,62,52,10,49608,9540,59148
210465,201802,174,125,49,119250,46746,165996
210467,201802,525,373,152,355842,145008,500850
210470,201802,46,34,12,32436,11448,43884
210480,201802,1304,916,388,873864,370152,1244016
210490,201802,226,135,91,128790,86814,215604
210500,201802,565,291,274,277614,261396,539010
210510,201802,558,433,125,413082,119250,532332
210515,201802,448,242,206,230868,196524,427392
210520,201802,403,351,52,334567.8,49608,384175.8
210530,201802,9343,5016,4327,4773969.66,4122126.03,8896095.69
210535,201802,131,94,37,89676,35298,124974
210540,201802,1543,923,620,879397.8,590049,1469446.8
210542,201802,1158,583,575,555800.4,547978,1103778.4
210545,201802,14,13,1,12402,954,13356
210547,201802,137,117,20,111618,19080,130698
210550,201802,742,518,224,492624,213696,706320
210560,201802,176,146,30,139284,28620,167904
210565,201802,30,21,9,20034,8586,28620
210570,201802,1371,1071,300,1021734,286200,1307934
210580,201802,106,92,14,87768,13356,101124
210590,201802,772,604,168,575452.8,160272,735724.8
210592,201802,31,27,4,25758,3816,29574
210594,201802,102,84,18,80136,17172,97308
210596,201802,82,69,13,65826,12402,78228
210598,201802,124,92,32,87768,30528,118296
210600,201802,338,284,54,270936,51516,322452
210610,201802,247,229,18,217512,17172,234684
210620,201802,48,29,19,27666,18126,45792
210630,201802,62,58,4,55332,3816,59148
210632,201802,1124,742,382,707868,363933,1071801
210635,201802,16,13,3,12402,2862,15264
210637,201802,106,74,32,70596,30528,101124
210640,201802,587,511,76,487494,72504,559998
210650,201802,408,327,81,311032.62,76320,387352.62
210660,201802,403,286,117,272177,111494,383671
210663,201802,17,10,7,9540,6678,16218
210667,201802,117,36,81,34344,77274,111618
210670,201802,268,236,32,224429,30528,254957
210675,201802,571,294,277,280476,264258,544734
210680,201802,214,135,79,128790,75366,204156
210690,201802,644,505,139,481770,132606,614376
210700,201802,190,138,52,131652,49608,181260
210710,201802,303,168,135,160081.2,128790,288871.2
210720,201802,125,104,21,99216,20034,119250
210725,201802,65,57,8,54378,7632,62010
210730,201802,24,18,6,17172,5724,22896
210735,201802,417,277,140,264258,133274,397532
210740,201802,543,459,84,437886,80136,518022
210745,201802,154,109,45,103986,42930,146916
210750,201802,2425,1089,1336,1036951,1274524.92,2311475.92
210760,201802,273,199,74,189846,70581.69,260427.69
210770,201802,399,306,93,291924,88435.8,380359.8
210780,201802,423,304,119,290016,113526,403542
210790,201802,183,142,41,135468,39114,174582
210800,201802,136,101,35,96354,33390,129744
210805,201802,42,38,4,36252,3816,40068
210810,201802,486,368,118,350404.2,112572,462976.2
210820,201802,2322,1829,493,1736750.54,470322,2207072.54
210825,201802,171,87,84,82998,80136,163134
210830,201802,807,485,322,461736,306234,767970
210840,201802,216,143,73,136422,69642,206064
210845,201802,251,156,95,148824,90630,239454
210850,201802,859,546,313,520884,298602,819486
210860,201802,4161,2123,2038,2023148.3,1943946.72,3967095.02
210870,201802,467,349,118,332946,112572,445518
210880,201802,56,38,18,36252,17172,53424
210890,201802,340,279,61,266166,58194,324360
210900,201802,570,371,199,353930,189846,543776
210905,201802,73,35,38,33390,36252,69642
210910,201802,2008,1476,532,1407386.19,507528,1914914.19
210920,201802,229,66,163,62964,155502,218466
210923,201802,80,56,24,53424,22896,76320
210927,201802,439,180,259,171720,247086,418806
210930,201802,59,46,13,43884,12402,56286
210940,201802,92,69,23,65826,21942,87768
210945,201802,194,87,107,82998,102078,185076
210950,201802,502,360,142,343440,135463.23,478903.23
210955,201802,75,49,26,46746,24804,71550
210960,201802,2466,1030,1436,980998.4,1369658,2350656.4
210970,201802,115,99,16,94446,15264,109710
210975,201802,89,80,9,76320,8586,84906
210980,201802,1238,526,712,501689.52,678962,1180651.52
210990,201802,4405,2722,1683,2595687.13,1605582,4201269.13
211000,201802,1385,1092,293,1041482,279235.8,1320717.8
211003,201802,923,629,294,600066,280467,880533
211010,201802,469,410,59,391140,56286,447426
211020,201802,1611,578,1033,551412,985262.58,1536674.58
211023,201802,26,22,4,20701.8,3816,24517.8
211027,201802,63,39,24,37206,22896,60102
211030,201802,384,256,128,244224,122112,366336
211040,201802,318,238,80,226766,76320,303086
211050,201802,1190,748,442,713592,421382,1134974
211060,201802,686,581,105,551793.6,100170,651963.6
211065,201802,24,20,4,19080,3816,22896
211070,201802,919,745,174,709118.74,165996,875114.74
211080,201802,89,85,4,81090,3816,84906
211085,201802,59,31,28,29288,26712,56000
211090,201802,94,76,18,72504,17172,89676
211100,201802,508,403,105,384462,100170,484632
211102,201802,263,174,89,165996,84906,250902
211105,201802,216,146,70,139284,66780,206064
211107,201802,134,75,59,71550,56286,127836
211110,201802,825,530,295,505048,281421,786469
211120,201802,5834,2439,3395,2321544.54,3236816.03,5558360.57
211125,201802,34,27,7,25758,6678,32436
211130,201802,46079,18971,27108,18065834.32,25848535.62,43914369.94
211140,201802,429,360,69,342482,65826,408308
211150,201802,1257,793,464,756188.1,442366,1198554.1
211153,201802,168,97,71,92538,67734,160272
211157,201802,59,43,16,41022,15264,56286
211160,201802,712,589,123,560939.5,117342,678281.5
211163,201802,0,0,0,0,0,0
211167,201802,6,4,2,3816,1908,5724
211170,201802,444,307,137,292878,130698,423576
211172,201802,123,85,38,81090,36252,117342
211174,201802,284,164,120,156456,114480,270936
211176,201802,521,371,150,353934,143100,497034
211178,201802,96,62,34,59148,32436,91584
211180,201802,208,162,46,154548,43721.82,198269.82
211190,201802,63,58,5,55332,4770,60102
211195,201802,24,15,9,14310,8586,22896
211200,201802,157,134,23,127492.56,21942,149434.56
211210,201802,533,327,206,311290.2,196524,507814.2
211220,201802,3973,2223,1750,2112899.39,1662213.64,3775113.03
211223,201802,96,89,7,84724.74,6678,91402.74
211227,201802,70,47,23,44838,21942,66780
211230,201802,778,629,149,599922.9,142126.92,742049.82
211240,201802,420,313,107,298602,102078,400680
211245,201802,212,92,120,87768,114480,202248
211250,201802,1642,1398,244,1332700.12,232776,1565476.12
211260,201802,807,632,175,602928,166950,769878
211270,201802,2102,1639,463,1563606,440748.2,2004354.2
211280,201802,1824,1085,739,1033183.36,705006,1738189.36
211285,201802,209,118,91,112572,86814,199386
211290,201802,687,457,230,435787.2,219420,655207.2
211300,201802,808,619,189,590248.09,180306,770554.09
211400,201802,1606,897,709,855738,676386,1532124
220005,201802,18,17,1,16218,954,17172
220010,201802,88,67,21,63918,19747.8,83665.8
220020,201802,598,468,130,445290.54,124020,569310.54
220025,201802,106,102,4,97308,3816,101124
220027,201802,34,27,7,25758,6678,32436
220030,201802,97,79,18,75366,17172,92538
220040,201802,1117,831,286,791514.76,272844,1064358.76
220045,201802,38,28,10,26712,9540,36252
220050,201802,647,527,120,501445.96,114460.92,615906.88
220060,201802,176,150,26,143100,24804,167904
220070,201802,94,84,10,80136,9540,89676
220080,201802,10,8,2,7632,1908,9540
220090,201802,34,27,7,25472,6678,32150
220095,201802,2,1,1,954,954,1908
220100,201802,28,24,4,22896,3816,26712
220105,201802,32,30,2,28620,1908,30528
220110,201802,207,191,16,181927.8,15264,197191.8
220115,201802,47,44,3,41976,2862,44838
220117,201802,18,17,1,16218,954,17172
220120,201802,1525,1054,471,1004887.31,449314.92,1454202.23
220130,201802,26,25,1,23850,954,24804
220140,201802,97,77,20,72504,19080,91584
220150,201802,449,318,131,303372,124974,428346
220155,201802,4,4,0,3816,0,3816
220157,201802,16,13,3,12402,2862,15264
220160,201802,73,63,10,60102,9540,69642
220170,201802,33,31,2,29574,1908,31482
220173,201802,7,7,0,6678,0,6678
220177,201802,6,6,0,5724,0,5724
220180,201802,67,66,1,62959.23,668,63627.23
220190,201802,1055,944,111,900576,105894,1006470
220191,201802,41,36,5,34344,4770,39114
220192,201802,62,59,3,56286,2862,59148
220194,201802,32,28,4,26712,3816,30528
220196,201802,103,85,18,81090,17172,98262
220198,201802,6,4,2,3816,1908,5724
220200,201802,430,350,80,334727,76320,411047
220202,201802,36,32,4,30528,3816,34344
220205,201802,39,34,5,32436,4770,37206
220207,201802,19,18,1,17172,954,18126
220208,201802,84,43,41,41022,39114,80136
220209,201802,32,29,3,27666,2862,30528
220210,201802,15,13,2,12402,1908,14310
220211,201802,29,29,0,27666,0,27666
220213,201802,41,37,4,35298,3530,38828
220217,201802,35,27,8,25758,7632,33390
220220,201802,2014,1278,736,1215606.68,700741.92,1916348.60
220225,201802,16,9,7,8586,6678,15264
220230,201802,929,738,191,703603.62,181574.82,885178.44
220240,201802,145,133,12,126882,11448,138330
220245,201802,33,30,3,27647.58,2862,30509.58
220250,201802,105,94,11,89676,10494,100170
220253,201802,44,36,8,34344,7632,41976
220255,201802,28,25,3,23850,2862,26712
220260,201802,689,501,188,477954,179352,657306
220265,201802,16,12,4,11448,3816,15264
220270,201802,660,586,74,558318.96,70119,628437.96
220271,201802,45,37,8,35298,7632,42930
220272,201802,25,24,1,22896,954,23850
220273,201802,15,13,2,12402,1908,14310
220275,201802,55,44,11,41976,10494,52470
220277,201802,11,9,2,8586,1908,10494
220280,201802,14,12,2,11448,1908,13356
220285,201802,43,40,3,38160,2862,41022
220290,201802,1378,1177,201,1120330,191707,1312037
220300,201802,55,54,1,51516,954,52470
220310,201802,314,265,49,252806,46737,299543
220320,201802,430,396,34,376354,32436,408790
220323,201802,0,0,0,0,0,0
220325,201802,16,11,5,10494,4770,15264
220327,201802,11,10,1,9540,954,10494
220330,201802,197,134,63,127836,60102,187938
220335,201802,141,123,18,117342,17172,134514
220340,201802,20,11,9,10494,8586,19080
220342,201802,56,47,9,44838,8586,53424
220345,201802,83,75,8,71550,7632,79182
220350,201802,430,377,53,357035.42,50562,407597.42
220360,201802,43,31,12,29574,11448,41022
220370,201802,1104,875,229,833796,218179.8,1051975.8
220375,201802,27,25,2,23850,1908,25758
220380,201802,35,28,7,26712,6678,33390
220385,201802,28,24,4,22896,3816,26712
220390,201802,2227,1265,962,1202116.55,916365.5,2118482.05
220400,201802,28,26,2,24804,1908,26712
220410,201802,14,13,1,12402,954,13356
220415,201802,12,11,1,10494,954,11448
220420,201802,124,103,21,98262,19747.8,118009.8
220430,201802,133,120,13,112811.8,12402,125213.8
220435,201802,22,16,6,15260,5724,20984
220440,201802,291,247,44,235638,41976,277614
220450,201802,327,166,161,157198.98,153594,310792.98
220455,201802,52,50,2,47700,1908,49608
220460,201802,17,17,0,15550.2,0,15550.2
220465,201802,110,70,40,66780,38160,104940
220470,201802,240,211,29,201294,27666,228960
220480,201802,71,60,11,57240,10494,67734
220490,201802,86,75,11,71550,10494,82044
220500,201802,95,83,12,79182,11448,90630
220510,201802,379,302,77,287345,73267.2,360612.2
220515,201802,21,17,4,16218,3816,20034
220520,201802,368,330,38,313505,36233,349738
220525,201802,25,17,8,16218,7632,23850
220527,201802,37,29,8,27666,6822,34488
220530,201802,33,12,21,11448,20034,31482
220535,201802,13,12,1,11448,954,12402
220540,201802,60,47,13,44838,12402,57240
220545,201802,61,39,22,37206,20988,58194
220550,201802,644,490,154,466696.8,146916,613612.8
220551,201802,26,19,7,18126,6678,24804
220552,201802,8,8,0,7632,0,7632
220553,201802,47,43,4,41022,3816,44838
220554,201802,13,8,5,7345.8,4770,12115.8
220555,201802,24,20,4,19080,3816,22896
220556,201802,55,51,4,48654,3816,52470
220557,201802,55,49,6,46746,5724,52470
220558,201802,7,2,5,1908,4770,6678
220559,201802,7,6,1,5724,954,6678
220560,201802,56,36,20,34153.2,19080,53233.2
220570,201802,791,470,321,446890.14,306234,753124.14
220580,201802,568,519,49,495126,46059.92,541185.92
220585,201802,6,5,1,4770,954,5724
220590,201802,14,14,0,13356,0,13356
220595,201802,59,44,15,41976,14310,56286
220600,201802,20,11,9,10494,8586,19080
220605,201802,21,20,1,19080,954,20034
220610,201802,60,51,9,48654,8586,57240
220620,201802,561,438,123,417613.5,117342,534955.5
220630,201802,6,4,2,3816,1908,5724
220635,201802,37,33,4,31482,3816,35298
220640,201802,98,77,21,73458,20034,93492
220650,201802,114,108,6,103032,5724,108756
220660,201802,29,23,6,21942,5724,27666
220665,201802,4,4,0,3816,0,3816
220667,201802,11,10,1,9540,954,10494
220669,201802,24,21,3,20034,2862,22896
220670,201802,69,54,15,51325.2,14310,65635.2
220672,201802,59,40,19,38160,18126,56286
220675,201802,34,26,8,24804,7632,32436
220680,201802,35,29,6,27666,5724,33390
220690,201802,48,45,3,42930,2862,45792
220695,201802,61,29,32,27666,30528,58194
220700,201802,1522,1163,359,1107660.78,342486,1450146.78
220710,201802,3,1,2,954,1908,2862
220720,201802,113,91,22,86575.5,20844.9,107420.4
220730,201802,19,18,1,17172,954,18126
220735,201802,3,1,2,954,1908,2862
220740,201802,44,40,4,38160,3816,41976
220750,201802,101,81,20,77274,19080,96354
220755,201802,14,14,0,13356,0,13356
220760,201802,51,48,3,45792,2862,48654
220770,201802,5763,2874,2889,2736586.83,2749969.41,5486556.24
220775,201802,28,14,14,13356,13356,26712
220777,201802,15,14,1,13356,954,14310
220779,201802,18,14,4,13356,3816,17172
220780,201802,873,744,129,709108.2,122780,831888.2
220785,201802,10,5,5,4770,4770,9540
220790,201802,1009,802,207,762706,197478,960184
220793,201802,13,13,0,12402,0,12402
220795,201802,22,21,1,20034,954,20988
220800,201802,3905,2972,933,2833645.36,889105.89,3722751.25
220810,201802,57,51,6,48654,5724,54378
220820,201802,238,216,22,206064,20988,227052
220830,201802,1159,982,177,936823.23,168839,1105662.23
220840,201802,2426,1602,824,1515142.75,783998,2299140.75
220850,201802,52,41,11,39114,10494,49608
220855,201802,14,9,5,8586,4770,13356
220860,201802,8,7,1,6678,954,7632
220865,201802,23,21,2,20034,1908,21942
220870,201802,58,56,2,53424,1908,55332
220880,201802,317,242,75,230200.2,71264,301464.2
220885,201802,44,39,5,37206,4770,41976
220887,201802,18,17,1,16218,954,17172
220890,201802,102,90,12,85860,11448,97308
220900,201802,47,26,21,24804,20034,44838
220910,201802,54,46,8,43884,7632,51516
220915,201802,10,9,1,8586,954,9540
220920,201802,37,33,4,31482,3816,35298
220930,201802,42,41,1,39114,954,40068
220935,201802,15,15,0,14310,0,14310
220937,201802,44,41,3,39114,2862,41976
220940,201802,50,46,4,43884,3816,47700
220945,201802,0,0,0,0,0,0
220950,201802,46,42,4,40068,3816,43884
220955,201802,33,29,4,27666,3816,31482
220960,201802,1,1,0,954,0,954
220965,201802,29,25,4,23850,3816,27666
220970,201802,46,39,7,37206,6678,43884
220975,201802,8,7,1,6678,954,7632
220980,201802,34,32,2,30528,1908,32436
220985,201802,64,57,7,54378,6678,61056
220987,201802,32,31,1,29574,954,30528
220990,201802,13,12,1,11448,954,12402
220995,201802,40,34,6,32436,5724,38160
220997,201802,39,32,7,30528,6678,37206
221000,201802,1125,1013,112,962969.6,106561.8,1069531.4
221005,201802,66,59,7,56286,6678,62964
221010,201802,16,13,3,12402,2862,15264
221020,201802,44,42,2,40068,1908,41976
221030,201802,28,22,6,20988,5724,26712
221035,201802,19,19,0,18126,0,18126
221037,201802,12,6,6,5724,5724,11448
221038,201802,24,22,2,20988,1908,22896
221039,201802,22,22,0,20988,0,20988
221040,201802,250,215,35,205110,33390,238500
221050,201802,230,194,36,185076,34344,219420
221060,201802,1710,1499,211,1428530.76,201294,1629824.76
221062,201802,29,28,1,26712,954,27666
221063,201802,14,10,4,9540,3816,13356
221065,201802,49,41,8,39114,7632,46746
221070,201802,137,118,19,112572,18126,130698
221080,201802,377,334,43,318636,40735.8,359371.8
221090,201802,36,35,1,33390,954,34344
221093,201802,57,38,19,36252,18126,54378
221095,201802,11,10,1,9540,954,10494
221097,201802,22,19,3,18126,2862,20988
221100,201802,24454,14030,10424,13362381.97,9939214.27,23301596.24
221110,201802,1022,749,273,714260,260442,974702
221120,201802,526,391,135,372728,128790,501518
221130,201802,929,757,172,720938.8,164088,885026.8
221135,201802,34,31,3,29574,2862,32436
221140,201802,40,32,8,30528,7632,38160
221150,201802,14,11,3,10494,2862,13356
221160,201802,10,10,0,9540,0,9540
221170,201802,13,13,0,12402,0,12402
230010,201802,162,151,11,144054,10494,154548
230015,201802,115,94,21,89676,20034,109710
230020,201802,1534,1309,225,1246329,213748.87,1460077.87
230030,201802,1604,1154,450,1095347.04,429300,1524647.04
230040,201802,196,173,23,164088,21942,186030
230050,201802,210,153,57,145962,54378,200340
230060,201802,147,121,26,114670.8,24804,139474.8
230070,201802,283,252,31,240408,29574,269982
230075,201802,792,692,100,658165,95113.8,753278.8
230080,201802,177,153,24,145962,22896,168858
230090,201802,93,63,30,59338.8,28620,87958.8
230100,201802,1930,1145,785,1090043,748890,1838933
230110,201802,2633,1683,950,1603147.4,905727.8,2508875.2
230120,201802,925,730,195,694990.22,186011,881001.22
230125,201802,137,112,25,106848,23850,130698
230130,201802,458,409,49,390186,46746,436932
230140,201802,201,173,28,165042,26712,191754
230150,201802,160,117,43,111618,41022,152640
230160,201802,908,785,123,748175,117342,865517
230170,201802,579,535,44,506576.7,41976,548552.7
230180,201802,79,74,5,70596,4770,75366
230185,201802,408,351,57,333488.83,54378,387866.83
230190,201802,2182,1757,425,1672198.48,405133,2077331.48
230195,201802,483,421,62,401634,59148,460782
230200,201802,364,318,46,302408.46,43884,346292.46
230205,201802,353,222,131,210018.33,124974,334992.33
230210,201802,1249,995,254,948094.09,241552.8,1189646.89
230220,201802,1392,968,424,922708.8,404496,1327204.8
230230,201802,894,788,106,750098.7,101124,851222.7
230240,201802,1618,1394,224,1327905.7,213696,1541601.7
230250,201802,1765,1453,312,1382151.07,297648,1679799.07
230260,201802,2932,1755,1177,1669077.16,1121885.69,2790962.85
230270,201802,1336,1072,264,1020088.39,250663.5,1270751.89
230280,201802,2671,1987,684,1890163.43,651868.2,2542031.63
230290,201802,393,356,37,334250.27,35298,369548.27
230300,201802,511,376,135,357444.72,128790,486234.72
230310,201802,417,312,105,297500.13,100170,397670.13
230320,201802,900,767,133,727734.6,126631.11,854365.71
230330,201802,297,240,57,228196.8,54188,282384.8
230340,201802,448,359,89,341533,84906,426439
230350,201802,3022,1891,1131,1803994.92,1076113.08,2880108.00
230360,201802,257,215,42,204200,40068,244268
230365,201802,133,106,27,100409,25758,126167
230370,201802,9689,4715,4974,4489449.28,4741310.22,9230759.50
230380,201802,461,397,64,378452,60102.6,438554.6
230390,201802,498,277,221,262454.94,210834,473288.94
230393,201802,269,223,46,211888.8,43884,255772.8
230395,201802,333,272,61,259240,58194,317434
230400,201802,597,474,123,450288,116845.92,567133.92
230410,201802,2609,1625,984,1544622.75,938450,2483072.75
230420,201802,5896,3850,2046,3654696.76,1947303.02,5601999.78
230423,201802,308,267,41,254718,39114,293832
230425,201802,346,287,59,273798,56286,330084
230426,201802,105,96,9,90858.96,8299.8,99158.76
230427,201802,79,76,3,72504,2862,75366
230428,201802,1337,690,647,658031.04,617238,1275269.04
230430,201802,437,351,86,334660,82044,416704
230435,201802,785,550,235,523158.23,222950.61,746108.84
230440,201802,83350,36700,46650,34927920.84,44462097.74,79390018.58
230445,201802,267,182,85,173437.2,81090,254527.2
230450,201802,538,436,102,415944,97308,513252
230460,201802,58,48,10,45792,9540,55332
230465,201802,297,242,55,230868,52470,283338
230470,201802,1835,1428,407,1362312,387171.1,1749483.1
230480,201802,149,144,5,137089.8,4770,141859.8
230490,201802,281,227,54,216558,51516,268074
230495,201802,435,328,107,312058,102078,414136
230500,201802,938,703,235,669708,224181,893889
230510,201802,46,36,10,34344,9540,43884
230520,201802,387,305,82,290970,78228,369198
230523,201802,1983,1260,723,1200557.8,689294,1889851.8
230526,201802,292,242,50,230868,46909,277777
230530,201802,666,501,165,475895.59,156456.2,632351.79
230533,201802,182,174,8,165996,7632,173628
230535,201802,342,257,85,245178,81090,326268
230540,201802,1825,1600,225,1523757.04,214077.8,1737834.84
230550,201802,3593,2307,1286,2192648.06,1225207.89,3417855.95
230560,201802,578,442,136,419569.8,128790,548359.8
230565,201802,192,140,52,133560,49608,183168
230570,201802,303,269,34,256626,32436,289062
230580,201802,1099,810,289,771280.38,274465.8,1045746.18
230590,201802,949,738,211,699809.1,200817,900626.1
230600,201802,248,226,22,214860.07,20988,235848.07
230610,201802,336,269,67,256436,63918,320354
230620,201802,163,134,29,126882,27666,154548
230625,201802,718,516,202,490599.5,191554.68,682154.18
230630,201802,1242,983,259,937782,246704.4,1184486.4
230640,201802,3467,3000,467,2854765.45,444759.57,3299525.02
230650,201802,393,343,50,326362.37,47700,374062.37
230655,201802,634,550,84,523746.8,80056.07,603802.87
230660,201802,331,277,54,264258,51229.8,315487.8
230670,201802,423,376,47,358704,44838,403542
230680,201802,200,184,16,175536,15264,190800
230690,201802,857,747,110,712638,104940,817578
230700,201802,692,586,106,559024.92,100837.8,659862.72
230710,201802,733,693,40,660932,38160,699092
230720,201802,146,123,23,116950.86,21942,138892.86
230725,201802,228,179,49,170766,46737,217503
230730,201802,11599,6288,5311,5981755.8,5058616.22,11040372.02
230740,201802,652,521,131,496748,124283.46,621031.46
230750,201802,795,679,116,646574.3,110664,757238.3
230760,201802,1299,1126,173,1070157.25,165042,1235199.25
230763,201802,319,264,55,249900.95,52470,302370.95
230765,201802,6800,3193,3607,3040410.31,3439071.98,6479482.29
230770,201802,4959,2550,2409,2423326.6,2295506.14,4718832.74
230780,201802,676,594,82,563536.1,78213.69,641749.79
230790,201802,194,159,35,151686,32589.4,184275.4
230800,201802,1109,813,296,775578.15,282384,1057962.15
230810,201802,1274,1137,137,1083696.3,130507.2,1214203.5
230820,201802,330,239,91,227053,86814,313867
230830,201802,932,808,124,767318.41,118296,885614.41
230835,201802,276,238,38,226098,35537,261635
230837,201802,164,138,26,131652,24804,156456
230840,201802,889,710,179,676100.5,169526,845626.5
230850,201802,1472,1283,189,1223505,180020,1403525
230860,201802,300,224,76,213696,72504,286200
230870,201802,1791,1520,271,1449126,257198.8,1706324.8
230880,201802,36,25,11,23850,10494,34344
230890,201802,565,518,47,494049.8,44824,538873.8
230900,201802,270,205,65,195570,61813,257383
230910,201802,202,163,39,154738.8,37206,191944.8
230920,201802,393,310,83,295740,79182,374922
230930,201802,919,647,272,614376.64,259488,873864.64
230940,201802,823,661,162,630594,154358,784952
230945,201802,464,388,76,369962,72504,442466
230950,201802,374,319,55,304326,52470,356796
230960,201802,2477,1677,800,1593130.84,762914,2356044.84
230970,201802,1741,986,755,939733.9,719392.32,1659126.22
230980,201802,210,180,30,171720,28620,200340
230990,201802,139,112,27,106848,25001.47,131849.47
231000,201802,206,187,19,176490,18126,194616
231010,201802,134,105,29,99597.6,27666,127263.6
231020,201802,1276,886,390,843623,372060,1215683
231025,201802,937,702,235,667544.2,222644.8,890189.0
231030,201802,1140,956,184,912020,175250,1087270
231040,201802,138,94,44,88931.88,41245,130176.88
231050,201802,980,874,106,832031.9,101124,933155.9
231060,201802,138,123,15,117342,14310,131652
231070,201802,1413,997,416,948753.1,396864,1345617.1
231080,201802,265,244,21,231965.1,20034,251999.1
231085,201802,543,340,203,323407,193662,517069
231090,201802,238,197,41,187938,39114,227052
231095,201802,164,130,34,124020,32436,156456
231100,201802,123,102,21,97308,18793.8,116101.8
231110,201802,346,300,46,285491,43884,329375
231120,201802,297,256,41,243265.86,38924,282189.86
231123,201802,131,124,7,118296,6678,124974
231126,201802,276,239,37,228006,35298,263304
231130,201802,4553,3539,1014,3366298.5,966283.26,4332581.76
231135,201802,198,171,27,163134,24492.4,187626.4
231140,201802,3026,2236,790,2129498.91,752667.84,2882166.75
231150,201802,354,338,16,322452,15264,337716
231160,201802,1201,941,260,894661.7,247811.04,1142472.74
231170,201802,533,353,180,336762,171720,508482
231180,201802,1589,1345,244,1282366.8,232776,1515142.8
231190,201802,198,176,22,167904,20988,188892
231195,201802,216,186,30,176720,28620,205340
231200,201802,823,679,144,647766,136116,783882
231210,201802,602,502,100,477954.8,95400,573354.8
231220,201802,1031,748,283,711952.12,269982,981934.12
231230,201802,1379,1105,274,1052968.04,260632.8,1313600.84
231240,201802,1353,983,370,937495.8,351740.2,1289236.0
231250,201802,111,103,8,98262,7632,105894
231260,201802,290,187,103,178398,97976,276374
231270,201802,987,827,160,783728.68,152353.8,936082.48
231280,201802,55,44,11,41976,10494,52470
231290,201802,7148,3976,3172,3785149.84,3023743.21,6808893.05
231300,201802,624,575,49,548550,46746,595296
231310,201802,696,646,50,615067,47700,662767
231320,201802,561,436,125,415468,119250,534718
231325,201802,88,78,10,74412,9540,83952
231330,201802,2013,1556,457,1478418.66,433022.6,1911441.26
231335,201802,245,216,29,206064,27666,233730
231340,201802,1582,1162,420,1106832.08,400394,1507226.08
231350,201802,1142,932,210,889128,199768,1088896
231355,201802,387,334,53,318636,50562,369198
231360,201802,470,375,95,355040.2,90630,445670.2
231370,201802,90,74,16,70596,15264,85860
231375,201802,283,205,78,195570,74412,269982
231380,201802,443,359,84,340890.69,79945.2,420835.89
231390,201802,196,159,37,151686,35298,186984
231395,201802,720,437,283,415600.56,269982,685582.56
231400,201802,1043,864,179,821684.84,170423.38,992108.22
231410,201802,1289,1041,248,988489.4,235639,1224128.4
240010,201802,386,180,206,170568.26,196515,367083.26
240020,201802,2177,1697,480,1617351.89,457916,2075267.89
240030,201802,134,113,21,107802,20034,127836
240040,201802,32,32,0,30528,0,30528
240050,201802,506,434,72,413182.45,68688,481870.45
240060,201802,67,63,4,60102,3816,63918
240070,201802,176,136,40,129744,38160,167904
240080,201802,439,295,144,281426,137376,418802
240090,201802,102,91,11,86508.72,10494,97002.72
240100,201802,1427,1343,84,1278249.55,79945.2,1358194.75
240110,201802,967,610,357,580968.26,340578,921546.26
240120,201802,140,118,22,112572,20988,133560
240130,201802,289,271,18,257817.54,17172,274989.54
240140,201802,78,61,17,58194,16218,74412
240145,201802,674,594,80,566151.3,76110.12,642261.42
240150,201802,20,15,5,14310,4741.38,19051.38
240160,201802,44,38,6,36252,5724,41976
240165,201802,34,28,6,26474,5724,32198
240170,201802,92,71,21,67734,20034,87768
240180,201802,77,63,14,60102,13356,73458
240185,201802,41,37,4,35288.46,3816,39104.46
240190,201802,14,12,2,11448,1908,13356
240200,201802,2988,1682,1306,1598457.67,1244685,2843142.67
240210,201802,162,128,34,122112,32436,154548
240220,201802,1101,791,310,754471,295730.46,1050201.46
240230,201802,817,757,60,719344.05,56592,775936.05
240240,201802,118,85,33,81090,31482,112572
240250,201802,92,80,12,76320,11448,87768
240260,201802,1785,1324,461,1262409.12,438811.38,1701220.50
240270,201802,190,168,22,159890.4,20988,180878.4
240280,201802,43,33,10,31482,9540,41022
240290,201802,49,48,1,45792,954,46746
240300,201802,180,100,80,95400,76320,171720
240310,201802,1984,1084,900,1025310.38,855363.57,1880673.95
240320,201802,208,198,10,188892,9540,198432
240325,201802,4295,2631,1664,2502962.46,1585287.22,4088249.68
240330,201802,64,61,3,58194,2862,61056
240340,201802,102,74,28,70596,26712,97308
240350,201802,89,79,10,75366,9540,84906
240360,201802,378,270,108,257580,103032,360612
240370,201802,36,34,2,32436,1908,34344
240375,201802,71,41,30,39114,28620,67734
240380,201802,233,189,44,180306,41881,222187
240390,201802,15,13,2,12402,1908,14310
240400,201802,78,74,4,70596,3816,74412
240410,201802,10,6,4,5724,3816,9540
240420,201802,881,686,195,653043.52,184980.6,838024.12
240430,201802,264,249,15,235523.69,14310,249833.69
240440,201802,69,36,33,34344,31482,65826
240450,201802,208,140,68,132987.8,64872,197859.8
240460,201802,60,47,13,44838,12402,57240
240470,201802,234,203,31,193104.86,29574,222678.86
240480,201802,14,14,0,13260.6,0,13260.6
240485,201802,72,62,10,59010,9540,68550
240490,201802,45,45,0,42720.12,0,42720.12
240500,201802,84,66,18,62964,17172,80136
240510,201802,50,35,15,33390,14310,47700
240520,201802,124,118,6,112572,5724,118296
240530,201802,50,45,5,42930,4770,47700
240540,201802,78,67,11,63918,10494,74412
240550,201802,15,13,2,12402,1908,14310
240560,201802,371,275,96,261723.23,91584,353307.23
240570,201802,461,285,176,271031.4,167904,438935.4
240580,201802,1256,1015,241,962825.9,228756.2,1191582.1
240590,201802,29,27,2,25758,1908,27666
240600,201802,112,111,1,105894,954,106848
240610,201802,510,426,84,406047.7,79373,485420.7
240615,201802,21,20,1,19080,954,20034
240620,201802,95,91,4,86814,3816,90630
240630,201802,34,32,2,30528,1908,32436
240640,201802,26,22,4,20988,3816,24804
240650,201802,234,197,37,187079.9,35298,222377.9
240660,201802,97,84,13,80136,12402,92538
240670,201802,288,170,118,160081.3,112572,272653.3
240680,201802,48,37,11,35298,10494,45792
240690,201802,49,46,3,43884,2862,46746
240700,201802,193,161,32,153594,30528,184122
240710,201802,1908,1215,693,1158676.83,661112.46,1819789.29
240720,201802,1043,764,279,727892.66,266166,994058.66
240725,201802,66,63,3,60102,2862,62964
240730,201802,133,115,18,109710,17172,126882
240740,201802,239,202,37,191343.78,34344.02,225687.80
240750,201802,34,22,12,20988,11448,32436
240760,201802,32,28,4,26712,3816,30528
240770,201802,148,113,35,107802,33390,141192
240780,201802,700,580,120,551879.46,114480,666359.46
240790,201802,37,36,1,34344,954,35298
240800,201802,8514,5772,2742,5469828.64,2609611.2,8079439.84
240810,201802,19932,10955,8977,10408549.97,8554159.45,18962709.42
240820,201802,205,129,76,122392.03,72504,194896.03
240830,201802,1584,1295,289,1228905.16,274752,1503657.16
240840,201802,77,67,10,63918,9540,73458
240850,201802,85,74,11,70596,10494,81090
240860,201802,113,110,3,104940,2862,107802
240870,201802,56,49,7,46746,6678,53424
240880,201802,29,26,3,24794.46,2862,27656.46
240890,201802,1150,676,474,640994.78,452192,1093186.78
240895,201802,42,32,10,30528,9540,40068
240910,201802,153,138,15,131652,14310,145962
240920,201802,14,11,3,10494,2862,13356
240930,201802,379,343,36,326268,34344,360612
240933,201802,28,20,8,19080,7632,26712
240940,201802,2419,2139,280,2027113.29,264238.92,2291352.21
240950,201802,49,47,2,44838,1908,46746
240960,201802,32,25,7,23850,6678,30528
240970,201802,133,96,37,91584,34544,126128
240980,201802,187,151,36,144054,34344,178398
240990,201802,119,80,39,76320,37206,113526
241000,201802,72,66,6,62964,5724,68688
241010,201802,57,46,11,43884,10494,54378
241020,201802,114,107,7,102078,6678,108756
241025,201802,9,3,6,2862,5724,8586
241030,201802,120,98,22,93492,20988,114480
241040,201802,34,29,5,27666,4770,32436
241050,201802,90,78,12,74412,11448,85860
241060,201802,27,24,3,22896,2862,25758
241070,201802,15,15,0,14310,0,14310
241080,201802,65,57,8,54091.8,7632,61723.8
241090,201802,49,40,9,38160,8571.69,46731.69
241100,201802,73,64,9,61056,8586,69642
241105,201802,6,2,4,1908,3816,5724
241110,201802,48,46,2,43884,1908,45792
241120,201802,1417,1100,317,1046414.8,302418,1348832.8
241140,201802,225,183,42,173629,40068,213697
241142,201802,41,40,1,38160,954,39114
241150,201802,1205,1058,147,1006614,140238,1146852
241160,201802,22,21,1,20034,954,20988
241170,201802,42,39,3,37206,2862,40068
241180,201802,51,42,9,39893.42,8586,48479.42
241190,201802,38,37,1,35298,954,36252
241200,201802,3843,2104,1739,2003216.82,1657085.66,3660302.48
241210,201802,72,60,12,57240,10590,67830
241220,201802,1361,908,453,865709.04,432128.92,1297837.96
241230,201802,245,207,38,197287.2,36252,233539.2
241240,201802,52,40,12,38160,11448,49608
241250,201802,1080,1004,76,957530,72218,1029748
241255,201802,46,37,9,35298,8586,43884
241260,201802,629,497,132,474133.23,125928,600061.23
241270,201802,45,31,14,29574,13356,42930
241280,201802,98,86,12,82044,11448,93492
241290,201802,109,81,28,77274,26712,103986
241300,201802,77,54,23,51516,21942,73458
241310,201802,51,38,13,36109,12402,48511
241320,201802,26,14,12,13356,11448,24804
241330,201802,60,54,6,51516,5724,57240
241335,201802,62,55,7,51897.6,6678,58575.6
241340,201802,187,141,46,134514,43884,178398
241350,201802,57,52,5,49608,4770,54378
241355,201802,41,38,3,36252,2862,39114
241360,201802,46,46,0,43884,0,43884
241370,201802,45,37,8,35173.98,7632,42805.98
241380,201802,40,38,2,36252,1908,38160
241390,201802,77,62,15,58957.2,14310,73267.2
241400,201802,190,157,33,149110.2,31482,180592.2
241410,201802,177,159,18,151686,17076.6,168762.6
241415,201802,93,74,19,70596,18126,88722
241420,201802,94,72,22,68688,20817,89505
241430,201802,28,27,1,25758,954,26712
241440,201802,453,384,69,366322,65826,432148
241445,201802,36,34,2,32436,1908,34344
241450,201802,275,224,51,213569,48654,262223
241460,201802,137,125,12,119012,11448,130460
241470,201802,43,36,7,34344,6678,41022
241475,201802,65,61,4,58194,3816,62010
241480,201802,98,70,28,65540.69,26712,92252.69
241490,201802,9,8,1,7632,954,8586
241500,201802,46,35,11,33390,10494,43884
250010,201802,101,87,14,82854.9,13356,96210.9
250020,201802,26,23,3,21942,2862,24804
250030,201802,804,594,210,565331.2,199291.6,764622.8
250040,201802,328,275,53,262350,50562,312912
250050,201802,227,187,40,178041.76,38160,216201.76
250053,201802,54,42,12,40068,11448,51516
250057,201802,0,0,0,0,0,0
250060,201802,446,339,107,323406,101791.8,425197.8
250070,201802,695,581,114,552256,108756,661012
250073,201802,7,7,0,6678,0,6678
250077,201802,204,151,53,143662.86,50562,194224.86
250080,201802,422,330,92,313199.2,87768,400967.2
250090,201802,199,133,66,125928.4,62944.92,188873.32
250100,201802,469,383,86,365382,81663,447045
250110,201802,486,368,118,349288.02,112572,461860.02
250115,201802,28,9,19,8586,18126,26712
250120,201802,110,83,27,79182,25758,104940
250130,201802,582,462,120,440748,114290,555038
250135,201802,14,8,6,7632,5724,13356
250140,201802,77,68,9,64872,8586,73458
250150,201802,561,416,145,394696,138015.18,532711.18
250153,201802,10,9,1,8586,954,9540
250157,201802,29,24,5,22896,4770,27666
250160,201802,209,165,44,157410,41976,199386
250170,201802,68,48,20,45792,19080,64872
250180,201802,3999,2689,1310,2551648.9,1244642,3796290.9
250190,201802,908,603,305,573592.5,290254.5,863847.0
250200,201802,51,43,8,41022,7632,48654
250205,201802,21,19,2,18126,1908,20034
250210,201802,90,78,12,74412,11448,85860
250215,201802,63,54,9,51516,8586,60102
250220,201802,27,21,6,20034,5724,25758
250230,201802,75,68,7,64868,6678,71546
250240,201802,242,201,41,190943.1,39114,230057.1
250250,201802,387,330,57,314820,54378,369198
250260,201802,34,29,5,27666,4770,32436
250270,201802,56,45,11,42930,10494,53424
250280,201802,382,320,62,305280,59148,364428
250290,201802,94,89,5,84619.8,4770,89389.8
250300,201802,559,383,176,364734.71,167891,532625.71
250310,201802,47,41,6,39114,5724,44838
250320,201802,1933,1321,612,1253821.07,582275,1836096.07
250330,201802,80,71,9,67734,8586,76320
250340,201802,26,22,4,20988,3816,24804
250350,201802,139,89,50,84619.8,47127.6,131747.4
250355,201802,32,25,7,23850,6678,30528
250360,201802,200,162,38,154548,36014,190562
250370,201802,2377,1613,764,1533843.98,727299.82,2261143.80
250375,201802,18,14,4,13356,3816,17172
250380,201802,51,35,16,33390,15264,48654
250390,201802,42,35,7,33390,6678,40068
250400,201802,15546,7872,7674,7485228.99,7315497.35,14800726.34
250403,201802,425,345,80,329120.46,76320,405440.46
250407,201802,54,46,8,43884,7632,51516
250410,201802,28,23,5,21942,4770,26712
250415,201802,42,28,14,26712,13336.92,40048.92
250420,201802,46,38,8,36252,7632,43884
250430,201802,1641,1388,253,1321959,241362,1563321
250435,201802,15,12,3,11448,2862,14310
250440,201802,688,595,93,564937.38,88722,653659.38
250450,201802,86,73,13,69642,12402,82044
250460,201802,415,282,133,269028,126872.46,395900.46
250470,201802,88,65,23,62010,21942,83952
250480,201802,323,254,69,242316,65826,308142
250485,201802,2,1,1,954,954,1908
250490,201802,203,165,38,157410,36252,193662
250500,201802,74,54,20,51516,19080,70596
250510,201802,730,571,159,543398.6,150677.43,694076.03
250520,201802,175,122,53,116368.92,50557.23,166926.15
250523,201802,109,91,18,86814,17172,103986
250527,201802,104,80,24,76315.23,22896,99211.23
250530,201802,7,6,1,5724,954,6678
250535,201802,25,21,4,20034,3816,23850
250540,201802,123,93,30,88006.5,28620,116626.5
250550,201802,68,65,3,62010,2862,64872
250560,201802,35,29,6,27666,5724,33390
250570,201802,153,122,31,116388,29574,145962
250580,201802,132,103,29,97975.8,27666,125641.8
250590,201802,20,16,4,15264,3816,19080
250600,201802,1326,896,430,851924.25,410124.6,1262048.85
250610,201802,153,132,21,125928,20034,145962
250620,201802,21,17,4,16218,3816,20034
250625,201802,60,45,15,42930,14310,57240
250630,201802,2995,1915,1080,1818867.65,1029252.74,2848120.39
250640,201802,204,169,35,161226,33390,194616
250650,201802,31,21,10,20034,9540,29574
250660,201802,43,33,10,31482,9540,41022
250670,201802,59,39,20,37206,19080,56286
250680,201802,383,314,69,299556,65826,365382
250690,201802,1815,1249,566,1188107.53,539582.8,1727690.33
250700,201802,955,840,115,797851.91,109500.12,907352.03
250710,201802,443,344,99,328176,94159.8,422335.8
250720,201802,103,81,22,77274,20988,98262
250730,201802,368,309,59,293832.6,56286,350118.6
250740,201802,50,46,4,43884,3816,47700
250750,201802,20233,12093,8140,11479351.44,7756789.87,19236141.31
250760,201802,68,51,17,48654,16218,64872
250770,201802,351,233,118,220374.14,111403.55,331777.69
250780,201802,58,45,13,42930,12402,55332
250790,201802,485,318,167,300510.92,158602.5,459113.42
250800,201802,151,140,11,132844.5,10494,143338.5
250810,201802,79,59,20,56286,19080,75366
250820,201802,156,125,31,119250,29574,148824
250830,201802,429,289,140,274704.5,133560,408264.5
250840,201802,54,52,2,49608,1908,51516
250850,201802,54,42,12,39381.12,11448,50829.12
250855,201802,13,11,2,10494,1908,12402
250860,201802,204,146,58,139284,55045.8,194329.8
250870,201802,32,29,3,27666,2862,30528
250880,201802,79,60,19,57182.76,18126,75308.76
250890,201802,2383,1762,621,1679612.4,591570.73,2271183.13
250900,201802,114,97,17,92538,16218,108756
250905,201802,125,96,29,91584,27666,119250
250910,201802,1176,836,340,796381.31,324073.8,1120455.11
250915,201802,110,75,35,71550,33390,104940
250920,201802,137,105,32,100170,30528,130698
250930,201802,158,97,61,92538,58194,150732
250933,201802,0,0,0,0,0,0
250937,201802,6,5,1,4770,954,5724
250939,201802,31,23,8,21942,7632,29574
250940,201802,106,81,25,77274,23850,101124
250950,201802,72,47,25,44838,23850,68688
250960,201802,92,50,42,47700,40068,87768
250970,201802,1206,861,345,819773,328176,1147949
250980,201802,90,63,27,60102,25758,85860
250990,201802,164,129,35,122608.08,33347.07,155955.15
251000,201802,73,67,6,63727.2,5724,69451.2
251010,201802,97,76,21,72500,19255.53,91755.53
251020,201802,81,70,11,65969.1,10494,76463.1
251030,201802,42,32,10,30528,9540,40068
251040,201802,54,39,15,37206,14310,51516
251050,201802,24,22,2,20988,1908,22896
251060,201802,50,40,10,37206,9540,46746
251065,201802,3,3,0,2862,0,2862
251070,201802,25,20,5,19071,4770,23841
251080,201802,4695,2280,2415,2162568.26,2297357.01,4459925.27
251090,201802,197,169,28,161226,26712,187938
251100,201802,19,18,1,17172,954,18126
251110,201802,47,37,10,35298,9540,44838
251120,201802,1774,1062,712,1008238.2,679248,1687486.2
251130,201802,356,289,67,275706,63918,339624
251140,201802,506,329,177,312722.8,168689.34,481412.14
251150,201802,290,250,40,237728,38160,275888
251160,201802,92,77,15,73454,14310,87764
251170,201802,98,79,19,75337.38,18121.23,93458.61
251180,201802,287,180,107,171711.23,102069.23,273780.46
251190,201802,194,132,62,125599.83,59148,184747.83
251200,201802,253,207,46,197478,43884,241362
251203,201802,33,31,2,29574,1908,31482
251207,201802,93,77,16,73458,15264,88722
251210,201802,1254,900,354,857046.53,337048.2,1194094.73
251220,201802,45,34,11,32436,10494,42930
251230,201802,470,395,75,376830,71550,448380
251240,201802,100,72,28,67734,26712,94446
251250,201802,1323,948,375,901502.87,357607,1259109.87
251260,201802,13,8,5,7632,4770,12402
251270,201802,342,252,90,240408,85717,326125
251272,201802,66,60,6,57240,5724,62964
251274,201802,29,24,5,22896,4770,27666
251275,201802,22,15,7,14310,6678,20988
251276,201802,18,14,4,13356,3816,17172
251278,201802,9,7,2,6678,1908,8586
251280,201802,97,93,4,88722,3816,92538
251290,201802,696,528,168,503712,160272,663984
251300,201802,16,14,2,13356,1908,15264
251310,201802,360,259,101,247082,96354,343436
251315,201802,18,17,1,16218,954,17172
251320,201802,60,49,11,46746,10494,57240
251330,201802,79,70,9,66780,8586,75366
251335,201802,11,7,4,6678,3816,10494
251340,201802,687,407,280,388278,266095.25,654373.25
251350,201802,35,33,2,31482,1908,33390
251360,201802,65,57,8,54171.94,7632,61803.94
251365,201802,14,14,0,13356,0,13356
251370,201802,5253,3570,1683,3401204.28,1604248,5005452.28
251380,201802,49,39,10,37206,9540,46746
251385,201802,2,2,0,1908,0,1908
251390,201802,663,529,134,503522.2,126596,630118.2
251392,201802,30,20,10,19080,9540,28620
251394,201802,9,9,0,8586,0,8586
251396,201802,19,14,5,13356,4770,18126
251398,201802,17,15,2,14310,1908,16218
251400,201802,39,32,7,30528,6678,37206
251410,201802,35,30,5,28620,4770,33390
251420,201802,108,81,27,77274,25758,103032
251430,201802,38,36,2,34344,1908,36252
251440,201802,34,22,12,20988,11448,32436
251445,201802,52,47,5,44838,4770,49608
251450,201802,419,369,50,350370.8,47700,398070.8
251455,201802,2,1,1,954,954,1908
251460,201802,17,13,4,12402,3816,16218
251465,201802,5,2,3,1908,2862,4770
251470,201802,45,36,9,34344,8586,42930
251480,201802,24,22,2,20988,1908,22896
251490,201802,130,91,39,86337,36253,122590
251500,201802,116,94,22,89676,20225,109901
251510,201802,35,27,8,25758,7632,33390
251520,201802,26,26,0,24804,0,24804
251530,201802,4528,3177,1351,3024844.24,1288558.26,4313402.50
251540,201802,73,65,8,62010,7632,69642
251550,201802,410,317,93,301464.2,87912,389376.2
251560,201802,22,17,5,16218,4770,20988
251570,201802,18,18,0,17172,0,17172
251580,201802,119,97,22,92538,20988,113526
251590,201802,126,94,32,89676,30528,120204
251593,201802,19,10,9,9540,8586,18126
251597,201802,59,49,10,46746,9540,56286
251600,201802,1105,787,318,749497.28,301763.92,1051261.20
251610,201802,212,160,52,151972.2,48941,200913.2
251615,201802,3,3,0,2862,0,2862
251620,201802,4236,2834,1402,2693795.84,1334743.28,4028539.12
251630,201802,448,330,118,314820,112444.36,427264.36
251640,201802,148,107,41,102078,39114,141192
251650,201802,263,191,72,180381.1,68688,249069.1
251660,201802,222,202,20,191754.1,18889.2,210643.3
251670,201802,359,282,77,267332,73458,340790
251675,201802,4,4,0,3816,0,3816
251680,201802,89,81,8,77274,7632,84906
251690,201802,337,283,54,269028,51165.89,320193.89
251700,201802,281,234,47,222649.29,44823.69,267472.98
251710,201802,19,12,7,11448,6678,18126
251720,201802,33,22,11,20988,10208,31196
251740,201802,10,8,2,7632,1908,9540
260005,201802,3116,1775,1341,1682251.09,1278147.1,2960398.19
260010,201802,1433,1021,412,970314.34,391045.32,1361359.66
260020,201802,429,376,53,358704,50562,409266
260030,201802,579,420,159,399912.98,151686,551598.98
260040,201802,857,521,336,495946.44,320391.36,816337.80
260050,201802,1129,812,317,774410,301846,1076256
260060,201802,416,378,38,359848.8,36252,396100.8
260070,201802,1452,911,541,864972,514098.36,1379070.36
260080,201802,730,578,152,550458.1,145008,695466.1
260090,201802,564,351,213,334626.12,203202,537828.12
260100,201802,225,157,68,148777.2,64872,213649.2
260105,201802,234,131,103,124974,98262,223236
260110,201802,2724,2031,693,1937565,660312,2597877
260120,201802,2910,1465,1445,1387891.95,1376242.1,2764134.05
260130,201802,147,102,45,97308,42930,140238
260140,201802,2095,1375,720,1303259.96,685335.46,1988595.42
260150,201802,228,150,78,143100,74412,217512
260160,201802,292,252,40,240408,38160,278568
260170,201802,3341,2036,1305,1936252.58,1243872.9,3180125.48
260180,201802,136,114,22,108756,20988,129744
260190,201802,2253,1603,650,1526111.9,620100,2146211.9
260200,201802,890,734,156,699461.08,148538,847999.08
260210,201802,1411,996,415,950033.27,394661.11,1344694.38
260220,201802,715,656,59,625035,56286,681321
260230,201802,1190,902,288,858316.99,274752,1133068.99
260240,201802,217,163,54,154328.58,51516,205844.58
260250,201802,72,57,15,54378,14310,68688
260260,201802,984,709,275,676386,262350,938736
260270,201802,430,348,82,330609.2,77941.8,408551.0
260280,201802,1279,869,410,828549,390854,1219403
260290,201802,6358,3375,2983,3200946.35,2839072,6040018.35
260300,201802,847,745,102,708661.6,97022,805683.6
260310,201802,499,397,102,377359.47,97308,474667.47
260320,201802,881,664,217,633169.2,207018,840187.2
260330,201802,33,27,6,25758,5724,31482
260340,201802,65,48,17,45792,16218,62010
260345,201802,5604,3153,2451,3002262.63,2337238.54,5339501.17
260350,201802,467,340,127,322616.08,120205,442821.08
260360,201802,283,143,140,136422,133560,269982
260370,201802,641,418,223,396162.4,212602,608764.4
260380,201802,598,429,169,409266,160081.56,569347.56
260390,201802,293,251,42,238375.98,39114,277489.98
260392,201802,93,81,12,77274,11448,88722
260400,201802,4065,2341,1724,2223075.06,1644334.22,3867409.28
260410,201802,14224,7681,6543,7312922.57,6239291,13552213.57
260415,201802,123,111,12,105894,11448,117342
260420,201802,1768,1053,715,999242.63,680313.64,1679556.27
260430,201802,190,174,16,164784.66,15264,180048.66
260440,201802,230,166,64,157640,61056,218696
260450,201802,475,344,131,326891,124974,451865
260460,201802,851,454,397,430446.8,378733.23,809180.03
260470,201802,376,232,144,220564.8,136995,357559.8
260480,201802,204,127,77,121158,73458,194616
260490,201802,207,167,40,159318,38160,197478
260500,201802,1126,754,372,717028.2,353791.8,1070820.0
260510,201802,737,586,151,559044,143100,702144
260515,201802,256,229,27,218466,25281,243747
260520,201802,3296,1951,1345,1853668.32,1281213.82,3134882.14
260530,201802,778,630,148,598200.64,141192,739392.64
260540,201802,570,431,139,411174,131652.72,542826.72
260545,201802,14,10,4,9540,3816,13356
260550,201802,342,212,130,202248,124020,326268
260560,201802,517,389,128,370515,121825.8,492340.8
260570,201802,1009,831,178,789769.8,169525.8,959295.6
260580,201802,268,240,28,228960,26712,255672
260590,201802,655,374,281,355384.08,268074,623458.08
260600,201802,8171,4155,4016,3941215.58,3827300.13,7768515.71
260610,201802,494,328,166,312912,158077.8,470989.8
260620,201802,3625,1889,1736,1790416.79,1651151.81,3441568.60
260630,201802,72,69,3,65826,2862,68688
260640,201802,3616,1975,1641,1880831.58,1565143.02,3445974.60
260650,201802,337,233,104,222282,99173.07,321455.07
260660,201802,494,338,156,322070.4,148203.9,470274.3
260670,201802,101,76,25,72504,23850,96354
260680,201802,3674,2042,1632,1930230.72,1556851.76,3487082.48
260690,201802,120,93,27,88722,25758,114480
260700,201802,327,200,127,190036.8,120324,310360.8
260710,201802,39,35,4,33390,3816,37206
260720,201802,2210,1331,879,1263568.49,837487.98,2101056.47
260730,201802,587,442,145,421668,136135.8,557803.8
260740,201802,61,57,4,54378,3816,58194
260750,201802,640,446,194,425159.64,185076,610235.64
260760,201802,623,342,281,326268,267757,594025
260765,201802,991,520,471,493137.8,449095.5,942233.3
260770,201802,222,165,57,157410,54378,211788
260775,201802,816,483,333,459399.8,317673,777072.8
260780,201802,270,173,97,165042,92404.44,257446.44
260790,201802,12406,6798,5608,6457285.57,5342462.93,11799748.50
260795,201802,158,110,48,103776.12,45792,149568.12
260800,201802,280,229,51,217989,48654,266643
260805,201802,174,111,63,105165.14,60102,165267.14
260810,201802,740,644,96,613126.26,91584,704710.26
260820,201802,314,210,104,199010.79,99216,298226.79
260825,201802,206,142,64,135090.99,61056,196146.99
260830,201802,261,168,93,160272,88722,248994
260840,201802,229,166,63,157697,59816,217513
260845,201802,208,145,63,138043.8,60102,198145.8
260850,201802,506,368,138,349408.09,131652,481060.09
260860,201802,254,189,65,180108.34,62010,242118.34
260870,201802,368,262,106,249948,101124,351072
260875,201802,688,479,209,455852.69,199386,655238.69
260880,201802,1558,954,604,908157.09,576025.2,1484182.29
260890,201802,2419,1689,730,1603912.06,695467,2299379.06
260900,201802,1029,702,327,668405.79,311958,980363.79
260910,201802,278,218,60,207972,57240,265212
260915,201802,306,203,103,193662,98142,291804
260920,201802,173,98,75,93492,71550,165042
260930,201802,387,332,55,316728,52384.45,369112.45
260940,201802,2742,1502,1240,1428426.89,1182463.92,2610890.81
260950,201802,1980,1151,829,1090747.82,790837.38,1881585.20
260960,201802,14226,7377,6849,7001795.59,6526471.53,13528267.12
260970,201802,435,373,62,355842,59148,414990
260980,201802,196,172,24,163802,22896,186698
260990,201802,2549,2102,447,2004802.42,425770.2,2430572.62
261000,201802,4304,2542,1762,2411835.76,1679050.34,4090886.10
261010,201802,189,138,51,131652,47836.23,179488.23
261020,201802,602,448,154,427249,146105.1,573354.1
261030,201802,220,161,59,153594,56080.89,209674.89
261040,201802,361,324,37,309096,34868.8,343964.8
261050,201802,466,412,54,393048,51516,444564
261060,201802,1318,866,452,824018.75,431208,1255226.75
261070,201802,9030,4614,4416,4377280.93,4204128.93,8581409.86
261080,201802,381,292,89,277796,84906,362702
261090,201802,2223,1705,518,1617990.05,493400,2111390.05
261100,201802,1092,775,317,737013.6,300548.16,1037561.76
261110,201802,8026,4925,3101,4692827.25,2956067.69,7648894.94
261120,201802,276,228,48,217512,45787.23,263299.23
261130,201802,571,330,241,314486.9,229914,544400.9
261140,201802,188,119,69,113526,65826,179352
261150,201802,664,391,273,373014,259774.2,632788.2
261153,201802,74,71,3,66780.31,2862,69642.31
261160,201802,76752,38815,37937,36907419.94,36167488.15,73074908.09
261170,201802,448,335,113,318674.36,107802,426476.36
261180,201802,1777,1088,689,1032548.97,657306,1689854.97
261190,201802,617,427,190,406961.92,181251,588212.92
261200,201802,212,187,25,177680.3,23850,201530.3
261210,201802,36,32,4,30528,3816,34344
261220,201802,2511,1773,738,1685625.13,702907.8,2388532.93
261230,201802,324,241,83,229914,79167.69,309081.69
261240,201802,443,383,60,361368.95,57240,418608.95
261245,201802,223,187,36,178398,34344,212742
261247,201802,153,115,38,109710,36252,145962
261250,201802,2845,1437,1408,1370325.8,1342121.83,2712447.63
261255,201802,252,230,22,219420,20988,240408
261260,201802,851,730,121,696420,115434,811854
261270,201802,171,133,38,126882,36252,163134
261280,201802,156,127,29,121158,27666,148824
261290,201802,126,89,37,84667.5,35298,119965.5
261300,201802,1238,876,362,835704,345348,1181052
261310,201802,758,507,251,483678,238833.9,722511.9
261320,201802,537,362,175,345328.92,166950,512278.92
261330,201802,821,651,170,618055.5,161334.46,779389.96
261340,201802,313,175,138,166950,131652,298602
261350,201802,786,564,222,537102.2,211788,748890.2
261360,201802,1212,783,429,746580.37,409266,1155846.37
261370,201802,4955,3038,1917,2883279.82,1825629.53,4708909.35
261380,201802,574,422,152,400689.64,144722,545411.64
261390,201802,3408,2279,1129,2169386.84,1073205.3,3242592.14
261400,201802,276,251,25,238881.6,23850,262731.6
261410,201802,1060,700,360,667800,343435.23,1011235.23
261420,201802,880,547,333,520857.46,317663.46,838520.92
261430,201802,330,300,30,285354,28333.8,313687.8
261440,201802,109,98,11,93492,10494,103986
261450,201802,2498,2078,420,1979752.24,399669.04,2379421.28
261460,201802,723,576,147,548550.02,140238,688788.02
261470,201802,245,188,57,178542,54378,232920
261480,201802,348,285,63,270651,60098,330749
261485,201802,341,206,135,195856.2,128790,324646.2
261500,201802,629,425,204,405450,194616,600066
261510,201802,43,30,13,28620,12402,41022
261520,201802,140,126,14,120204,13356,133560
261530,201802,4161,2638,1523,2508475.02,1451688.69,3960163.71
261540,201802,1078,664,414,632992.36,394956,1027948.36
261550,201802,285,140,145,132178,138310.92,270488.92
261560,201802,782,521,261,493792.2,247840.6,741632.8
261570,201802,365,286,79,272844,75366,348210
261580,201802,372,293,79,278758,75366,354124
261590,201802,194,156,38,148824,36252,185076
261600,201802,289,231,58,219611,54855,274466
261610,201802,106,91,15,86459.69,14310,100769.69
261618,201802,65,51,14,48654,13356,62010
261620,201802,202,122,80,116388,76320,192708
261630,201802,583,448,135,425031.6,128790,553821.6
261640,201802,6264,3328,2936,3167551.09,2798092.92,5965644.01
261650,201802,476,297,179,282660.66,170766,453426.66
270010,201802,524,459,65,437600,61247,498847
270020,201802,302,238,64,227048,61056,288104
270030,201802,9126,5821,3305,5540776.85,3150517.42,8691294.27
270040,201802,1928,1177,751,1122562.26,714998.49,1837560.75
270050,201802,175,128,47,122112,44838,166950
270060,201802,115,63,52,60102,49608,109710
270070,201802,908,660,248,627625.14,236287.26,863912.40
270080,201802,39,33,6,31482,5724,37206
270090,201802,20,16,4,15264,3816,19080
270100,201802,1256,824,432,782935.33,409981.7,1192917.03
270110,201802,151,111,40,105894,38160,144054
270120,201802,223,182,41,172776.55,39114,211890.55
270130,201802,258,180,78,171433.8,74125.8,245559.6
270135,201802,96,59,37,56286,35298,91584
270140,201802,1271,766,505,730571.27,480521,1211092.27
270150,201802,265,213,52,203202,49608,252810
270160,201802,518,385,133,367290,126214.2,493504.2
270170,201802,709,450,259,428155.2,246275.1,674430.3
270180,201802,72,55,17,52152.04,16008.12,68160.16
270190,201802,103,90,13,85860,12402,98262
270200,201802,107,96,11,91393.2,10494,101887.2
270210,201802,481,247,234,235638,222949.8,458587.8
270220,201802,187,147,40,140238,38160,178398
270230,201802,2086,1238,848,1176018.74,806131.42,1982150.16
270235,201802,738,553,185,527253.43,176124.95,703378.38
270240,201802,3093,2391,702,2269597.67,666916,2936513.67
270250,201802,171,119,52,113526,49608,163134
270255,201802,221,191,30,182214,28238.4,210452.4
270260,201802,326,259,67,247086,63918,311004
270270,201802,115,48,67,45783,63918,109701
270280,201802,211,131,80,124974,76320,201294
270290,201802,1165,872,293,830652.42,278645.46,1109297.88
270300,201802,271,171,100,163134,95113.8,258247.8
270310,201802,920,736,184,699905.83,174812.04,874717.87
270320,201802,887,756,131,720156.8,124687.8,844844.6
270330,201802,274,229,45,217512,42930,260442
270340,201802,60,47,13,44838,12402,57240
270350,201802,94,48,46,45267.3,43884,89151.3
270360,201802,74,39,35,37206,33390,70596
270370,201802,52,39,13,37206,12402,49608
270375,201802,67,38,29,36252,27666,63918
270380,201802,1080,605,475,576216,453150,1029366
270390,201802,193,105,88,100170,83952,184122
270400,201802,703,511,192,486279.27,183159,669438.27
270410,201802,697,496,201,472866.04,191744.46,664610.50
270420,201802,395,254,141,240618,134429.38,375047.38
270430,201802,32038,22818,9220,21711593.07,8787172.91,30498765.98
270440,201802,489,383,106,364571.1,100837.8,465408.9
270450,201802,767,400,367,381361.5,348912.66,730274.16
270460,201802,199,150,49,143100,46746,189846
270470,201802,1343,885,458,843936.69,436932,1280868.69
270480,201802,528,424,104,401414.98,98500.5,499915.48
270490,201802,25,21,4,20034,3816,23850
270500,201802,514,422,92,402588,87768,490356
270510,201802,731,449,282,428346,269028,697374
270520,201802,383,234,149,223027,142146,365173
270530,201802,65,57,8,54378,7632,62010
270540,201802,124,95,29,90630,27666,118296
270550,201802,1714,1293,421,1232245.28,401247.63,1633492.91
270560,201802,316,143,173,136422,165042,301464
270570,201802,449,298,151,283464.66,144054,427518.66
270580,201802,77,55,22,52470,20988,73458
270590,201802,81,67,14,63918,13356,77274
270600,201802,176,146,30,139284,28620,167904
270610,201802,177,141,36,134505,34344,168849
270620,201802,30,29,1,27666,954,28620
270630,201802,3834,2908,926,2762452.23,881248.96,3643701.19
270640,201802,900,657,243,625074.6,231507.8,856582.4
270642,201802,208,175,33,166950,31482,198432
270644,201802,280,193,87,183931.74,82993.23,266924.97
270650,201802,241,138,103,131652,98262,229914
270660,201802,256,206,50,196524,47700,244224
270670,201802,3157,2397,760,2275920.82,721831.48,2997752.30
270680,201802,464,268,196,255663,186979.23,442642.23
270690,201802,1116,698,418,664159.76,398762.46,1062922.22
270700,201802,36,27,9,25758,8586,34344
270710,201802,874,656,218,624205.34,207972,832177.34
270720,201802,245,186,59,177444,55999.8,233443.8
270730,201802,1881,1094,787,1041435.4,748692.2,1790127.6
270740,201802,46,29,17,27666,16218,43884
270750,201802,631,461,170,439604,161513,601117
270760,201802,310,223,87,212742,82998,295740
270770,201802,2689,1702,987,1615512.08,940644,2556156.08
270780,201802,92,57,35,54373.23,33372.46,87745.69
270790,201802,274,184,90,175536,85860,261396
270800,201802,1966,1562,404,1488355.25,384671.88,1873027.13
270810,201802,315,246,69,234669.69,65817.23,300486.92
270820,201802,155,99,56,94446,53329,147775
270830,201802,940,680,260,647957,247754,895711
270840,201802,1412,1026,386,977659.7,366576,1344235.7
270850,201802,1698,1034,664,981614.56,633437.46,1615052.02
270860,201802,2438,1576,862,1499926.2,819450.57,2319376.77
270870,201802,122,66,56,62964,53424,116388
270880,201802,909,663,246,630666.14,233790.58,864456.72
270890,201802,360,262,98,249499.62,93487.23,342986.85
270895,201802,70,60,10,57240,9540,66780
270900,201802,107,83,24,79182,22896,102078
270910,201802,324,258,66,244987.2,62964,307951.2
270915,201802,1809,1076,733,1021606.64,698563.1,1720169.74
270920,201802,477,398,79,379692,75366,455058
270930,201802,6209,4474,1735,4262679.08,1652141.78,5914820.86
270940,201802,2367,1783,584,1699012.88,556164,2255176.88
280010,201802,44,39,5,37206,4770,41976
280020,201802,698,600,98,570461.03,92538,662999.03
280030,201802,19170,12259,6911,11612923.06,6564934.43,18177857.49
280040,201802,338,213,125,203202,117819,321021
280050,201802,376,291,85,277327.8,81090,358417.8
280060,201802,325,216,109,203817.43,103986,307803.43
280067,201802,981,687,294,652639.94,279522.25,932162.19
280070,201802,130,108,22,103032,20988,124020
280100,201802,613,481,132,456034.27,125738,581772.27
280110,201802,75,71,4,67734,3816,71550
280120,201802,628,504,124,480816,118296,599112
280130,201802,1348,838,510,798021.8,486396.9,1284418.7
280140,201802,468,376,92,357845.4,86771.31,444616.71
280150,201802,316,233,83,221602.09,79182,300784.09
280160,201802,99,84,15,80136,14310,94446
280170,201802,582,387,195,367732.56,185219.1,552951.66
280190,201802,27,25,2,23850,1908,25758
280200,201802,23,15,8,14310,7632,21942
280210,201802,2741,1935,806,1828334.11,763346.97,2591681.08
280220,201802,40,31,9,29574,8586,38160
280230,201802,310,255,55,242435.63,52470,294905.63
280240,201802,112,106,6,100980.9,5724,106704.9
280250,201802,20,12,8,11448,7632,19080
280260,201802,79,70,9,66780,8586,75366
280270,201802,160,123,37,117342,35298,152640
280280,201802,197,125,72,119250,68688,187938
280290,201802,3053,2207,846,2092390.18,805773.25,2898163.43
280300,201802,1093,823,270,783477.27,256816.8,1040294.07
280310,201802,106,101,5,96023.29,4770,100793.29
280320,201802,654,444,210,423567,200340,623907
280330,201802,354,253,101,241362,96229.98,337591.98
280340,201802,414,332,82,315256.57,77465,392721.57
280350,201802,3389,2612,777,2483120.79,738518.21,3221639.00
280360,201802,463,293,170,279522,161226,440748
280370,201802,99,87,12,82998,11448,94446
280380,201802,55,41,14,39114,13356,52470
280390,201802,186,154,32,146916,30528,177444
280400,201802,343,233,110,221423.8,104940,326363.8
280410,201802,290,234,56,222074,53414.46,275488.46
280420,201802,176,147,29,140238,27666,167904
280430,201802,105,77,28,73458,26603.63,100061.63
280440,201802,677,520,157,492170.9,149577.66,641748.56
280445,201802,114,106,8,101124,7632,108756
280450,201802,1063,908,155,862893,147870,1010763
280460,201802,732,530,202,498759.44,192708,691467.44
280470,201802,192,175,17,166950,15265,182215
280480,201802,2233,1587,646,1499344.21,612528.89,2111873.10
280490,201802,358,329,29,312415,27666,340081
280500,201802,45,40,5,38160,4770,42930
280510,201802,148,114,34,108455.2,32150,140605.2
280520,201802,53,39,14,37206,13356,50562
280530,201802,77,54,23,51516,21942,73458
280540,201802,504,404,100,385416,95113.8,480529.8
280550,201802,703,650,53,617484.6,50562,668046.6
280560,201802,473,410,63,388134.9,60102,448236.9
280570,201802,1774,1349,425,1283217.47,404594.83,1687812.30
280580,201802,594,449,145,426678.6,138235,564913.6
280590,201802,162,98,64,93212.48,61056,154268.48
280600,201802,354,297,57,282593.88,54378,336971.88
280610,201802,144,108,36,102826,34344,137170
280620,201802,546,446,100,424231.24,94446.9,518678.14
280630,201802,163,135,28,128790,26712,155502
280640,201802,209,167,42,158489,40068,198557
280650,201802,77,51,26,48654,24804,73458
280660,201802,130,93,37,88722,35059.5,123781.5
280670,201802,1616,1010,606,957631.76,574379.95,1532011.71
280680,201802,180,153,27,144178.14,25758,169936.14
280690,201802,50,42,8,40068,7632,47700
280700,201802,17,17,0,16218,0,16218
280710,201802,1408,1062,346,1006072.79,329416.2,1335488.99
280720,201802,108,74,34,67817.92,32436,100253.92
280730,201802,25,21,4,20034,3816,23850
280740,201802,2380,1752,628,1665396.29,598006.46,2263402.75
280750,201802,290,250,40,238500,38160,276660
280760,201802,877,600,277,571255.2,264114.9,835370.1
290010,201802,198,132,66,125928,62964,188892
290020,201802,177,164,13,156456,12402,168858
290030,201802,590,382,208,363760.2,198432,562192.2
290035,201802,141,114,27,105551.7,25758,131309.7
290040,201802,265,168,97,160272,92538,252810
290050,201802,71,52,19,49608,18126,67734
290060,201802,253,112,141,106561.8,134514,241075.8
290070,201802,5569,2744,2825,2610337.67,2691098.7,5301436.37
290080,201802,501,229,272,218160.72,259469,477629.72
290090,201802,376,162,214,154548,204156,358704
290100,201802,1586,1042,544,989873.1,518403.8,1508276.9
290110,201802,744,443,301,420996.2,286911.5,707907.7
290115,201802,213,197,16,186984,15264,202248
290120,201802,780,505,275,481102.2,262350,743452.2
290130,201802,419,249,170,237250.26,162180,399430.26
290135,201802,295,225,70,213972.66,66780,280752.66
290140,201802,301,246,55,234684,52279.2,286963.2
290150,201802,127,95,32,90630,30528,121158
290160,201802,244,188,56,178112.58,53424,231536.58
290170,201802,88,62,26,59148,24804,83952
290180,201802,151,118,33,112572,31482,144054
290190,201802,449,365,84,347924,79849.8,427773.8
290195,201802,299,173,126,165042,120204,285246
290200,201802,284,240,44,228960,41976,270936
290205,201802,138,84,54,80136,51516,131652
290210,201802,1117,810,307,771596.2,292878,1064474.2
290220,201802,217,119,98,113049,93492,206541
290225,201802,281,107,174,102078,165996,268074
290230,201802,63,40,23,38160,21942,60102
290240,201802,308,122,186,116101.8,177444,293545.8
290250,201802,272,245,27,233034,25758,258792
290260,201802,275,227,48,215795,45792,261587
290265,201802,182,151,31,143237,29574,172811
290270,201802,1378,1137,241,1082838.2,229051,1311889.2
290280,201802,468,347,121,331038,115434,446472
290290,201802,1214,705,509,667477.89,485586,1153063.89
290300,201802,450,381,69,362944.73,65826,428770.73
290310,201802,321,142,179,135468,170766,306234
290320,201802,3934,2443,1491,2327919.84,1419553,3747472.84
290323,201802,184,159,25,151400,23850,175250
290327,201802,149,118,31,112300.11,29574,141874.11
290330,201802,71,37,34,35298,32436,67734
290340,201802,908,360,548,342467,522506,864973
290350,201802,583,346,237,329321,226098,555419
290360,201802,365,274,91,259489.69,86814,346303.69
290370,201802,912,355,557,338670,531378,870048
290380,201802,303,186,117,177444,111618,289062
290390,201802,2476,1542,934,1468095.58,889128,2357223.58
290395,201802,242,133,109,126644,103986,230630
290400,201802,277,204,73,194330,69642,263972
290405,201802,255,220,35,209880,33390,243270
290410,201802,561,477,84,452053.64,80136,532189.64
290420,201802,232,180,52,171720,49608,221328
290430,201802,500,311,189,296694,180306,477000
290440,201802,72,63,9,60102,7949.96,68051.96
290450,201802,231,177,54,168858,51516,220374
290460,201802,1870,1109,761,1056117.8,725517.52,1781635.32
290470,201802,1448,607,841,577949.22,801999.36,1379948.58
290475,201802,586,548,38,522077,36252,558329
290480,201802,290,163,127,155502,121158,276660
290485,201802,223,209,14,199386,13356,212742
290490,201802,1155,832,323,792964.8,307188.2,1100153.0
290500,201802,664,331,333,314820,317682,632502
290510,201802,219,166,53,157411,50562,207973
290515,201802,135,78,57,74412,54378,128790
290520,201802,1378,885,493,842668.62,467080.42,1309749.04
290530,201802,314,285,29,271890,27666,299556
290540,201802,94,57,37,54378,35298,89676
290550,201802,149,127,22,121158,20701.8,141859.8
290560,201802,3369,1362,2007,1298336.76,1914483.59,3212820.35
290570,201802,5834,3004,2830,2861204.81,2697004.95,5558209.76
290580,201802,1236,718,518,683731.8,493456.5,1177188.3
290590,201802,535,441,94,419923,89676,509599
290600,201802,1713,1186,527,1126614.08,502729.38,1629343.46
290610,201802,219,197,22,187481,20988,208469
290620,201802,323,285,38,271890,35896.15,307786.15
290630,201802,2108,892,1216,846397.6,1154442.1,2000839.7
290640,201802,151,123,28,117342,26712,144054
290650,201802,1703,805,898,767007,856692,1623699
290660,201802,279,226,53,215604,50562,266166
290670,201802,984,512,472,487876,449942.38,937818.38
290680,201802,1176,945,231,900576,219420,1119996
290682,201802,290,212,78,201261.3,74393.46,275654.76
290685,201802,228,145,83,137376,79182,216558
290687,201802,931,616,315,584277.6,299556,883833.6
290689,201802,128,75,53,71536,50547.69,122083.69
290690,201802,649,269,380,256597.92,361640.8,618238.72
290700,201802,241,114,127,108756,121158,229914
290710,201802,697,458,239,436912.92,228006,664918.92
290720,201802,1021,832,189,793728,179829,973557
290730,201802,1108,634,474,602976.5,451242,1054218.5
290740,201802,15,12,3,11448,2862,14310
290750,201802,1340,606,734,575550.88,698124.1,1273674.98
290755,201802,69,61,8,58194,7632,65826
290760,201802,297,258,39,246132,37206,283338
290770,201802,186,175,11,166940.46,10494,177434.46
290780,201802,972,779,193,741222.66,182309.4,923532.06
290790,201802,374,262,112,249369,106848,356217
290800,201802,2614,1050,1564,999530.04,1490949.36,2490479.40
290810,201802,435,301,134,286868,127836,414704
290820,201802,373,231,142,219406,135468,354874
290830,201802,396,268,128,255672,122112,377784
290840,201802,1676,1026,650,976372.8,618020.48,1594393.28
290850,201802,749,414,335,394765.2,318636,713401.2
290860,201802,649,289,360,275706,343154,618860
290870,201802,662,480,182,456699.8,173628,630327.8
290880,201802,125,67,58,63918,55332,119250
290890,201802,327,232,95,221328,90630,311958
290900,201802,169,128,41,122112,39114,161226
290910,201802,360,272,88,259488,83952,343440
290920,201802,230,195,35,186030,33390,219420
290930,201802,808,613,195,584802,186011,770813
290940,201802,251,205,46,194806.8,43884,238690.8
290950,201802,172,99,73,94446,69642,164088
290960,201802,439,293,146,278282.24,138997.8,417280.04
290970,201802,250,219,31,208735.2,29431,238166.2
290980,201802,1482,1049,433,996577.76,412033.2,1408610.96
290990,201802,370,313,57,298573.92,54322.38,352896.30
291000,201802,864,243,621,231822,591861.6,823683.6
291005,201802,2081,880,1201,837459.76,1144977.03,1982436.79
291010,201802,156,141,15,134514,14310,148824
291020,201802,102,80,22,76320,20988,97308
291030,201802,93,68,25,64872,23850,88722
291040,201802,580,288,292,274752,278568,553320
291050,201802,1334,753,581,716717.23,553987.8,1270705.03
291060,201802,1479,816,663,777796.2,632502,1410298.2
291070,201802,1882,1392,490,1321637.41,465436.3,1787073.71
291072,201802,7293,2677,4616,2550509.58,4401480.42,6951990.00
291075,201802,201,162,39,154548,37206,191754
291077,201802,48,32,16,30528,15264,45792
291080,201802,19380,8450,10930,8039660.04,10414766.16,18454426.20
291085,201802,290,230,60,219420,57235.23,276655.23
291090,201802,302,114,188,108470,179342.46,287812.46
291100,201802,682,197,485,187938,462690,650628
291110,201802,398,300,98,286180.92,93492,379672.92
291120,201802,2510,1180,1330,1125577,1266841.92,2392418.92
291125,201802,58,30,28,28620,26712,55332
291130,201802,212,185,27,176490,25758,202248
291140,201802,122,90,32,85860,30242,116102
291150,201802,377,148,229,141192,218466,359658
291160,201802,361,301,60,286200.5,57240,343440.5
291165,201802,23,19,4,18126,3816,21942
291170,201802,2872,1443,1429,1372854.11,1360213.6,2733067.71
291180,201802,1312,508,804,484435.38,766882.68,1251318.06
291185,201802,74,72,2,68688,1908,70596
291190,201802,1249,531,718,505041.43,684428.8,1189470.23
291200,201802,164,119,45,113526,42930,156456
291210,201802,2199,855,1344,813485.34,1280364.14,2093849.48
291220,201802,262,196,66,186030.64,62964,248994.64
291230,201802,1026,346,680,329226,648720,977946
291240,201802,438,416,22,395624,20988,416612
291250,201802,426,348,78,331992,74412,406404
291260,201802,40,30,10,28620,9540,38160
291270,201802,1200,486,714,463644,680631.8,1144275.8
291280,201802,374,169,205,161020.89,195274.26,356295.15
291290,201802,1753,882,871,839711.2,829886,1669597.2
291300,201802,222,175,47,166282.2,44838,211120.2
291310,201802,228,204,24,194329.8,22896,217225.8
291320,201802,1382,987,395,938736,375781.29,1314517.29
291330,201802,128,109,19,102173.9,18126,120299.9
291340,201802,142,81,61,77274,58194,135468
291345,201802,130,86,44,82044,41976,124020
291350,201802,1563,496,1067,472993.2,1017727.3,1490720.5
291360,201802,8572,4203,4369,3998373.84,4164932.55,8163306.39
291370,201802,1082,596,486,568298,463644,1031942
291380,201802,253,200,53,190800,50562,241362
291390,201802,3880,1675,2205,1593498,2101758,3695256
291400,201802,2079,1484,595,1410585.39,565947.51,1976532.90
291410,201802,152,133,19,125928,18126,144054
291420,201802,106,77,29,73458,27666,101124
291430,201802,171,95,76,89923,71550.53,161473.53
291440,201802,496,395,101,374106.3,96354,470460.3
291450,201802,893,556,337,528231.68,320544,848775.68
291460,201802,1715,1395,320,1328349.6,305280,1633629.6
291465,201802,2203,1020,1183,972234.06,1128300.14,2100534.20
291470,201802,2760,1395,1365,1327044.47,1301480,2628524.47
291480,201802,11838,5220,6618,4968830.55,6304624.65,11273455.20
291490,201802,545,223,322,212742,307188,519930
291500,201802,372,202,170,192708,162180,354888
291510,201802,1232,465,767,442448.99,731431.8,1173880.79
291520,201802,960,436,524,415944,499886.46,915830.46
291530,201802,1010,272,738,259488,703746.72,963234.72
291535,201802,117,97,20,92538,19080,111618
291540,201802,361,108,253,103032,240408.6,343440.6
291550,201802,1176,550,626,523747.3,596613.8,1120361.1
291560,201802,5535,2823,2712,2680243.05,2574876.51,5255119.56
291570,201802,204,105,99,100170,94446,194616
291580,201802,1209,735,474,700423.46,452182.23,1152605.69
291590,201802,78,30,48,28476.9,45792,74268.9
291600,201802,1364,617,747,587664,712334,1299998
291610,201802,1401,639,762,608322.87,726892,1335214.87
291620,201802,577,266,311,253764,296312.4,550076.4
291630,201802,496,162,334,154548,318636,473184
291640,201802,3895,1955,1940,1858728.9,1849392.98,3708121.88
291650,201802,419,278,141,264077.74,133714.73,397792.47
291660,201802,444,176,268,167211.96,254574.9,421786.86
291670,201802,222,141,81,133942,77274,211216
291680,201802,701,400,301,381600,287049.46,668649.46
291685,201802,572,305,267,290732,254527.2,545259.2
291690,201802,557,287,270,273798,256617,530415
291700,201802,914,723,191,689012.19,181260,870272.19
291710,201802,1706,785,921,748194.28,877757.06,1625951.34
291720,201802,395,263,132,250897.23,125928,376825.23
291730,201802,928,537,391,510771.8,373004.46,883776.26
291733,201802,254,176,78,167617.8,74412,242029.8
291735,201802,65,49,16,46746,15264,62010
291740,201802,341,257,84,245178,80136,325314
291750,201802,1933,1289,644,1222422.78,613554,1835976.78
291760,201802,3073,1653,1420,1570322.54,1352295,2922617.54
291770,201802,806,542,264,514969.26,251856,766825.26
291780,201802,46,26,20,24804,19080,43884
291790,201802,164,77,87,73458,82998,156456
291800,201802,9928,3937,5991,3744822.54,5711217.8,9456040.34
291810,201802,1140,817,323,778841.03,308142,1086983.03
291820,201802,262,189,73,180306,69642,249948
291830,201802,1063,398,665,378471,633447,1011918
291835,201802,609,560,49,533763,46746,580509
291840,201802,4642,2384,2258,2269544.17,2153284.56,4422828.73
291845,201802,302,103,199,98262,189817.38,288079.38
291850,201802,323,281,42,267835.5,40068,307903.5
291855,201802,271,109,162,103986,154548,258534
291860,201802,175,110,65,103986,62010,165996
291870,201802,82,33,49,31482,46746,78228
291875,201802,186,168,18,160272,17172,177444
291880,201802,487,380,107,361710,102078,463788
291890,201802,243,79,164,75356.46,154739,230095.46
291900,201802,57,32,25,30528,23850,54378
291905,201802,138,95,43,90344,41022,131366
291910,201802,175,143,32,136422,30528,166950
291915,201802,389,346,43,328416,41022,369438
291920,201802,4918,2549,2369,2429057.61,2258355.23,4687412.84
291930,201802,181,105,76,100170,72504,172674
291940,201802,316,173,143,164345.58,135468,299813.58
291950,201802,1136,928,208,884549,198432,1082981
291955,201802,1006,595,411,567630,391665,959295
291960,201802,176,121,55,115434,52470,167904
291970,201802,779,589,190,561906,181260,743166
291980,201802,1498,1324,174,1259683.7,165042.4,1424726.1
291990,201802,123,114,9,108756,8586,117342
291992,201802,164,84,80,79372.8,76320,155692.8
291995,201802,150,106,44,101124,41976,143100
292000,201802,382,291,91,275133.8,86814,361947.8
292010,201802,280,200,80,190133,75366,265499
292020,201802,268,197,71,187938,67734,255672
292030,201802,138,108,30,103032,28620,131652
292040,201802,625,316,309,301464,294786,596250
292045,201802,91,82,9,78228,8586,86814
292050,201802,882,609,273,579976.87,260156,840132.87
292060,201802,942,772,170,734294.78,162180,896474.78
292070,201802,50,21,29,20034,27666,47700
292080,201802,114,79,35,75366,33390,108756
292090,201802,495,174,321,165805.2,306234,472039.2
292100,201802,1400,599,801,569872.7,764125.92,1333998.62
292105,201802,202,170,32,162180,30528,192708
292110,201802,2108,782,1326,745703.64,1262978.91,2008682.55
292120,201802,641,516,125,491131.79,119250,610381.79
292130,201802,446,264,182,251856,173628,425484
292140,201802,195,152,43,145008,40890.26,185898.26
292145,201802,157,84,73,80136,69613.38,149749.38
292150,201802,1413,1131,282,1078974,268000.16,1346974.16
292160,201802,179,147,32,139951.8,30528,170479.8
292170,201802,1218,1067,151,1016225.31,143996.76,1160222.07
292180,201802,198,139,59,132606,56286,188892
292190,201802,157,96,61,91584,58194,149778
292200,201802,1283,462,821,439605.71,782585.56,1222191.27
292205,201802,115,103,12,97975.8,11448,109423.8
292210,201802,366,254,112,240933,106132.5,347065.5
292220,201802,22,16,6,15264,5724,20988
292225,201802,38,35,3,33390,2862,36252
292230,201802,909,733,176,696393.03,167904,864297.03
292240,201802,622,444,178,422479,169812,592291
292250,201802,1679,1063,616,1014102,587664,1601766
292260,201802,437,245,192,233730,182404.8,416134.8
292265,201802,270,190,80,180973.8,76320,257293.8
292270,201802,771,334,437,318636,415944.8,734580.8
292273,201802,202,112,90,106070.49,85860,191930.49
292275,201802,162,78,84,74412,79849.8,154261.8
292280,201802,136,95,41,90630,39114,129744
292285,201802,59,50,9,47032.2,8586,55618.2
292290,201802,550,368,182,348582.47,173342,521924.47
292300,201802,1619,619,1000,589953.8,953166.58,1543120.38
292303,201802,97,66,31,62964,29574,92538
292305,201802,111,79,32,75366,30528,105894
292310,201802,799,499,300,475684,284902.15,760586.15
292320,201802,656,494,162,470989.8,154548,625537.8
292330,201802,189,98,91,93492,86814,180306
292335,201802,273,210,63,200340,60102,260442
292340,201802,570,395,175,376090.85,166950,543040.85
292350,201802,267,142,125,134657.1,118963.8,253620.9
292360,201802,700,529,171,502949,163134,666083
292370,201802,777,592,185,564768,176490,741258
292380,201802,642,496,146,471276.62,139284,610560.62
292390,201802,504,188,316,179352,299699.5,479051.5
292400,201802,3350,2053,1297,1940244.43,1233457.8,3173702.23
292405,201802,264,175,89,166473,84619.8,251092.8
292410,201802,152,90,62,85860,59148,145008
292420,201802,304,261,43,248707.8,41022,289729.8
292430,201802,518,404,114,385416,108279,493695
292440,201802,574,489,85,465285,80803.8,546088.8
292450,201802,245,189,56,180306,53424,233730
292460,201802,583,433,150,412509.8,143100,555609.8
292465,201802,195,161,34,153594,31698.09,185292.09
292467,201802,101,59,42,56286,40068,96354
292470,201802,251,169,82,161226,78228,239454
292480,201802,323,215,108,204156.5,102746,306902.5
292490,201802,219,143,76,136422,72504,208926
292500,201802,1167,504,663,480605,632044.28,1112649.28
292510,201802,3313,1486,1827,1416690.12,1740230.7,3156920.82
292520,201802,1054,501,553,476089.7,527553,1003642.7
292525,201802,386,275,111,262345.23,105894,368239.23
292530,201802,4215,1727,2488,1644724.25,2372085.96,4016810.21
292540,201802,482,261,221,248994,210834,459828
292550,201802,1058,568,490,541130.74,466955.72,1008086.46
292560,201802,318,299,19,285246,18126,303372
292570,201802,301,229,72,218137,68688,286825
292575,201802,459,294,165,280190,157410,437600
292580,201802,905,572,333,544257,317396,861653
292590,201802,507,436,71,415641.59,67734,483375.59
292593,201802,143,112,31,106848,29574,136422
292595,201802,180,137,43,130698,41022,171720
292600,201802,1239,924,315,881179,299842.2,1181021.2
292610,201802,126,96,30,91584,28362.42,119946.42
292620,201802,519,430,89,409925,84906,494831
292630,201802,1358,787,571,749210,543112.68,1292322.68
292640,201802,764,534,230,509102.1,219420,728522.1
292650,201802,173,148,25,140756,23850,164606
292660,201802,1991,1433,558,1361258.85,528134.83,1889393.68
292665,201802,139,102,37,97308,35298,132606
292670,201802,399,322,77,307184,73458,380642
292680,201802,247,191,56,182214,52947,235161
292690,201802,179,136,43,129744,41022,170766
292700,201802,910,598,312,569538.8,297648,867186.8
292710,201802,97,85,12,81090,11448,92538
292720,201802,830,467,363,444716.64,346112,790828.64
292730,201802,201,95,106,89676.5,101124,190800.5
292740,201802,65957,32647,33310,31071607.09,31748582.24,62820189.33
292750,201802,368,262,106,248994.94,100313.57,349308.51
292760,201802,318,257,61,244167.5,58194,302361.5
292770,201802,783,334,449,318350,428346,746696
292780,201802,420,159,261,151458.48,248994,400452.48
292790,201802,730,354,376,337716,358465.5,696181.5
292800,201802,1136,697,439,663984,418806,1082790
292805,201802,423,124,299,117771.3,285246,403017.3
292810,201802,1464,849,615,809087.8,586414.46,1395502.26
292820,201802,744,599,145,569538.87,138034.8,707573.67
292830,201802,102,81,21,77274,20034,97308
292840,201802,654,538,116,512775,110649.69,623424.69
292850,201802,131,89,42,84902,40068,124970
292860,201802,2127,1242,885,1180796.94,844290,2025086.94
292870,201802,3373,2259,1114,2153823.8,1062736.92,3216560.72
292880,201802,1433,943,490,895855.86,466220.62,1362076.48
292890,201802,480,411,69,392066,65826,457892
292895,201802,133,89,44,83547.5,41976,125523.5
292900,201802,387,286,101,272844,96354,369198
292905,201802,446,228,218,217512,207782,425294
292910,201802,396,303,93,288729,88722,377451
292920,201802,536,234,302,223236,288108,511344
292925,201802,509,473,36,450564.66,34325,484889.66
292930,201802,557,344,213,328176,203202,531378
292935,201802,293,125,168,119250,160272,279522
292937,201802,235,161,74,153594,70596,224190
292940,201802,189,143,46,136422,43884,180306
292950,201802,1096,568,528,539726.5,502759,1042485.5
292960,201802,543,360,183,343440,174582,518022
292970,201802,272,189,83,179639,79182,258821
292975,201802,155,89,66,84906,62774,147680
292980,201802,258,174,84,164212.43,80136,244348.43
292990,201802,1306,964,342,912319.87,325794.93,1238114.80
293000,201802,103,75,28,71550,26712,98262
293010,201802,2647,1627,1020,1546396.92,969043.01,2515439.93
293015,201802,646,510,136,486322.49,129105,615427.49
293020,201802,329,270,59,257580,56286,313866
293030,201802,621,540,81,513634.44,77274,590908.44
293040,201802,338,265,73,252810,69642,322452
293050,201802,2704,1579,1125,1496858.89,1070007.6,2566866.49
293060,201802,253,203,50,192475,46746.8,239221.8
293070,201802,3368,1703,1665,1616809.68,1587189.92,3203999.60
293075,201802,90,58,32,55332,30528,85860
293076,201802,72,46,26,43884,24804,68688
293077,201802,429,262,167,245433.47,159318,404751.47
293080,201802,446,396,50,377784,47700,425484
293090,201802,129,111,18,105894,16854.04,122748.04
293100,201802,517,365,152,348210,145008,493218
293105,201802,340,231,109,220088,103986,324074
293110,201802,168,119,49,113526,46746,160272
293120,201802,319,215,104,205110,99025.2,304135.2
293130,201802,245,164,81,156456,77274,233730
293135,201802,7900,3118,4782,2969084.36,4553344.85,7522429.21
293140,201802,179,115,64,109710,60293,170003
293150,201802,328,278,50,263781.2,47700,311481.2
293160,201802,432,245,187,233730,178398,412128
293170,201802,189,131,58,124688,54474,179162
293180,201802,464,316,148,301178,141192,442370
293190,201802,1273,882,391,836778.73,373014,1209792.73
293200,201802,523,462,61,439668,58194,497862
293210,201802,337,245,92,233578,87052.5,320630.5
293220,201802,2684,1075,1609,1023616.41,1532792.47,2556408.88
293230,201802,1768,640,1128,609129.8,1075826,1684955.8
293240,201802,220,201,19,191754,18126,209880
293245,201802,110,93,17,88722,16218,104940
293250,201802,734,272,462,259240,440748,699988
293260,201802,312,261,51,248040.17,48654,296694.17
293270,201802,1178,558,620,530424.68,591480,1121904.68
293280,201802,236,131,105,124974,100170,225144
293290,201802,3078,2007,1071,1912526.73,1021435,2933961.73
293300,201802,696,493,203,467989.5,191181.6,659171.1
293305,201802,153,131,22,124974,20988,145962
293310,201802,137,103,34,98262,32436,130698
293315,201802,156,120,36,114480,34344,148824
293317,201802,95,66,29,62964,27666,90630
293320,201802,960,552,408,525654.5,389232,914886.5
293325,201802,183,65,118,62010,112533.84,174543.84
293330,201802,12835,5981,6854,5694957.31,6530883.55,12225840.86
293340,201802,252,182,70,173628,65826,239454
293345,201802,244,193,51,184122,48654,232776
293350,201802,623,329,294,313866,278997.3,592863.3
293360,201802,1574,1122,452,1069148,429968.7,1499116.7
310010,201802,153,77,76,73458,72218,145676
310020,201802,1055,575,480,546165.2,456012.12,1002177.32
310030,201802,323,261,62,247868.88,58861.8,306730.68
310040,201802,50,31,19,29574,18126,47700
310050,201802,183,119,64,112572.4,60770,173342.4
310060,201802,233,162,71,154071,67734,221805
310070,201802,16,8,8,7632,7632,15264
310080,201802,51,28,23,26712,21942,48654
310090,201802,952,500,452,471754.68,430063.6,901818.28
310100,201802,296,222,74,211788,70596,282384
310110,201802,735,392,343,372933.1,326268,699201.1
310120,201802,387,215,172,204442.2,163713.94,368156.14
310130,201802,33,20,13,19080,12402,31482
310140,201802,28,16,12,15264,11448,26712
310150,201802,1284,882,402,835658.6,382935.8,1218594.4
310160,201802,2103,1064,1039,1006949.53,988821.4,1995770.93
310163,201802,92,51,41,48654,39114,87768
310170,201802,2549,1044,1505,995852,1433194.6,2429046.6
310180,201802,130,49,81,46746,76892.4,123638.4
310190,201802,489,327,162,311958,153975.6,465933.6
310200,201802,503,317,186,302418,177444,479862
310205,201802,58,44,14,41976,13356,55332
310210,201802,278,225,53,214650,50562,265212
310220,201802,53,32,21,30528,20034,50562
310230,201802,262,184,78,175345.2,74412,249757.2
310240,201802,105,92,13,87529.5,12402,99931.5
310250,201802,99,80,19,76320,18126,94446
310260,201802,800,429,371,406310.24,353199.42,759509.66
310270,201802,268,178,90,169259,85860,255119
310280,201802,368,274,94,260442.8,89676,350118.8
310285,201802,221,157,64,149469.86,61056,210525.86
310290,201802,255,147,108,140238,103032,243270
310300,201802,155,128,27,122112,25758,147870
310310,201802,7,5,2,4770,1908,6678
310320,201802,23,14,9,13356,8586,21942
310330,201802,30,22,8,20988,7632,28620
310340,201802,1693,1094,599,1036569.9,569920.5,1606490.4
310350,201802,2816,1519,1297,1444304.01,1236756.8,2681060.81
310360,201802,41,33,8,31482,7632,39114
310370,201802,124,102,22,97308,20702,118010
310375,201802,104,37,67,35298,63899,99197
310380,201802,53,31,22,28668,20988,49656
310390,201802,101,71,30,67734,28620,96354
310400,201802,2307,1485,822,1412780,783901.8,2196681.8
310410,201802,128,70,58,66780,55332,122112
310420,201802,670,361,309,342104.1,293823.06,635927.16
310430,201802,330,217,113,206731.8,107802,314533.8
310440,201802,67,41,26,39114,24804,63918
310445,201802,86,68,18,64872,17172,82044
310450,201802,856,538,318,512584.2,303372,815956.2
310460,201802,265,192,73,183168,69642,252810
310470,201802,492,310,182,295740,173628,469368
310480,201802,77,54,23,51516,21942,73458
310490,201802,494,230,264,218466.2,251856,470322.2
310500,201802,125,54,71,51516,67734,119250
310510,201802,607,394,213,374636.6,203183.46,577820.06
310520,201802,128,85,43,81090,41022,122112
310530,201802,87,40,47,38160,44551.8,82711.8
310540,201802,454,280,174,264736.6,165996,430732.6
310550,201802,86,56,30,53424,28620,82044
310560,201802,2917,2008,909,1905150.8,865607.13,2770757.93
310570,201802,133,90,43,85860,41022,126882
310590,201802,343,224,119,212313.8,113511.69,325825.49
310600,201802,158,90,68,84095.7,64872,148967.7
310610,201802,59,21,38,20034,36252,56286
310620,201802,45581,21803,23778,20724190.75,22643661.47,43367852.22
310630,201802,589,376,213,355985.6,201708.88,557694.48
310640,201802,135,114,21,108565.2,20034,128599.2
310650,201802,160,140,20,132320,19080,151400
310660,201802,90,57,33,54378,31482,85860
310665,201802,55,40,15,38160,14310,52470
310670,201802,6317,2920,3397,2777791.17,3235674.1,6013465.27
310680,201802,55,36,19,34344,18126,52470
310690,201802,597,435,162,410784.16,154548,565332.16
310700,201802,63,40,23,38160,21798.9,59958.9
310710,201802,1240,823,417,783888.23,397245.8,1181134.03
310720,201802,84,28,56,26712,53424,80136
310730,201802,1374,953,421,907636.5,401634,1309270.5
310740,201802,1005,562,443,533000.4,422374.46,955374.86
310750,201802,244,142,102,134514.18,97308,231822.18
310760,201802,69,53,16,50562,15264,65826
310770,201802,93,45,48,42930,45792,88722
310780,201802,401,328,73,312072.43,69642,381714.43
310790,201802,100,81,19,77274,18126,95400
310800,201802,454,221,233,210357,221995.8,432352.8
310810,201802,167,116,51,109605.2,47700,157305.2
310820,201802,354,281,73,268074,69355.8,337429.8
310825,201802,191,157,34,149778,32436,182214
310830,201802,461,222,239,211127.94,228006,439133.94
310840,201802,385,219,166,208926,158364,367290
310850,201802,109,88,21,83952,20034,103986
310855,201802,375,296,79,282384,75366,357750
310860,201802,1400,1045,355,991542.1,336934.9,1328477.0
310870,201802,53,41,12,39114,11448,50562
310880,201802,83,65,18,61723.8,17172,78895.8
310890,201802,312,183,129,174582,123066,297648
310900,201802,637,294,343,277552.07,326916.8,604468.87
310910,201802,250,171,79,161799.2,75366,237165.2
310920,201802,486,290,196,272845.2,186030.4,458875.6
310925,201802,38,31,7,29574,6392,35966
310930,201802,1095,660,435,629237.33,414895.07,1044132.40
310940,201802,681,348,333,331391.8,317682,649073.8
310945,201802,118,73,45,69642,42930,112572
310950,201802,249,195,54,186030,51516,237546
310960,201802,84,31,53,29574,50558,80132
310970,201802,170,106,64,101124,60133.76,161257.76
310980,201802,46,24,22,22896,20988,43884
310990,201802,149,83,66,78896,62964,141860
311000,201802,835,419,416,396197.69,396855,793052.69
311010,201802,40,33,7,31482,6678,38160
311020,201802,41,26,15,24804,14310,39114
311030,201802,393,232,161,219134,153594,372728
311040,201802,38,33,5,31482,4770,36252
311050,201802,466,195,271,185458,257961.6,443419.6
311060,201802,752,431,321,409743.4,305948,715691.4
311070,201802,330,149,181,142146,172674,314820
311080,201802,105,57,48,54378,45792,100170
311090,201802,397,186,211,176204,201294,377498
311100,201802,614,365,249,347923.8,237259.8,585183.6
311110,201802,680,467,213,445231.8,203193,648424.8
311115,201802,68,49,19,46746,18126,64872
311120,201802,1035,540,495,513920.8,471609.9,985530.7
311130,201802,407,235,172,223999.2,164088,388087.2
311140,201802,161,79,82,75366,77417.1,152783.1
311150,201802,355,234,121,223236,115195.5,338431.5
311160,201802,744,533,211,506097.4,200817,706914.4
311170,201802,79,58,21,55332,19747.8,75079.8
311180,201802,342,228,114,217225.8,108470,325695.8
311190,201802,34,17,17,16218,16218,32436
311200,201802,337,235,102,222568.6,97308,319876.6
311205,201802,29,19,10,18126,9158.4,27284.4
311210,201802,50,41,9,38828,8586,47414
311220,201802,16,14,2,13356,1908,15264
311230,201802,1631,1055,576,1002103.94,549504,1551607.94
311240,201802,169,107,62,101874.33,59148,161022.33
311250,201802,74,31,43,29574,41022,70596
311260,201802,555,350,205,333900,195570,529470
311265,201802,112,77,35,73458,33390,106848
311270,201802,282,203,79,193662,75366,269028
311280,201802,212,96,116,91584,110091.6,201675.6
311290,201802,110,88,22,83952,20416,104368
311300,201802,544,342,202,325314.96,192422,517736.96
311310,201802,23,18,5,17172,4770,21942
311320,201802,674,506,168,481770,160272,642042
311330,201802,1035,760,275,724801.5,261396.4,986197.9
311340,201802,2618,1861,757,1767964.63,721768.86,2489733.49
311350,201802,274,210,64,200340,61056,261396
311360,201802,177,106,71,101124,67734,168858
311370,201802,1198,484,714,459742.5,680583.6,1140326.1
311380,201802,7,6,1,5724,954,6678
311390,201802,281,148,133,141192,126405.2,267597.2
311400,201802,151,99,52,94446,49599,144045
311410,201802,97,54,43,51516,41022,92538
311420,201802,296,161,135,152584.98,128790,281374.98
311430,201802,849,550,299,523652,285246,808898
311440,201802,488,339,149,323406,141859.8,465265.8
311450,201802,319,199,120,189846,114480,304326
311455,201802,300,201,99,191458.8,94159.8,285618.6
311460,201802,129,51,78,48654,73606.27,122260.27
311470,201802,21,11,10,10494,9540,20034
311480,201802,25,10,15,9540,14310,23850
311490,201802,17,11,6,10494,5724,16218
311500,201802,19,10,9,9540,8586,18126
311510,201802,620,438,182,415909.7,173341.8,589251.5
311520,201802,47,34,13,31768.2,12402,44170.2
311530,201802,1806,1348,458,1276549.7,436932,1713481.7
311535,201802,67,51,16,48654,15264,63918
311540,201802,33,29,4,27666,3816,31482
311545,201802,185,138,47,131652,44838,176490
311547,201802,30,21,9,20034,8586,28620
311550,201802,618,283,335,269982,319571.46,589553.46
311560,201802,43,28,15,26712,14310,41022
311570,201802,302,201,101,191181.6,96354,287535.6
311580,201802,306,179,127,170479.8,121158,291637.8
311590,201802,32,28,4,26712,3816,30528
311600,201802,91,72,19,68688,18126,86814
311610,201802,257,223,34,211788.5,32436,244224.5
311615,201802,97,80,17,75680.82,16218,91898.82
311620,201802,19,11,8,10494,7632,18126
311630,201802,84,71,13,67734,12402,80136
311640,201802,118,65,53,62010,50562,112572
311650,201802,129,95,34,89914.5,32436,122350.5
311660,201802,406,194,212,185076,202248,387324
311670,201802,165,106,59,100879,56286,157165
311680,201802,223,162,61,153646.95,57430.8,211077.75
311690,201802,18,11,7,10494,6678,17172
311700,201802,199,138,61,131365.8,58194,189559.8
311710,201802,215,138,77,131652,73458,205110
311720,201802,39,28,11,26712,10494,37206
311730,201802,551,364,187,346684,178398,525082
311740,201802,38,27,11,25758,10494,36252
311750,201802,706,482,224,457920.8,213696,671616.8
311760,201802,65,36,29,34344,27666,62010
311770,201802,403,192,211,181260.62,201294,382554.62
311780,201802,169,96,73,91298,69325,160623
311783,201802,79,70,9,66780,8586,75366
311787,201802,35,15,20,14310,19080,33390
311790,201802,262,125,137,119250,130698,249948
311800,201802,641,438,203,414466.3,192994.2,607460.5
311810,201802,43,35,8,33390,7632,41022
311820,201802,107,89,18,84906,17172,102078
311830,201802,1877,1194,683,1133468.5,648243.8,1781712.3
311840,201802,1009,559,450,528994.9,427831.54,956826.44
311850,201802,8,5,3,4770,2862,7632
311860,201802,9488,4335,5153,4119019.71,4907454.59,9026474.30
311870,201802,149,83,66,79182,62964,142146
311880,201802,947,706,241,671988.8,229914,901902.8
311890,201802,218,111,107,105894,102078,207972
311900,201802,90,37,53,35298,50562,85860
311910,201802,1379,854,525,812761.1,498751.4,1311512.5
311920,201802,228,150,78,142862,74412,217274
311930,201802,908,524,384,499610,366098,865708
311940,201802,2436,1258,1178,1197795.7,1120568.4,2318364.1
311950,201802,32,22,10,20988,9540,30528
311960,201802,65,46,19,43884,18126,62010
311970,201802,27,17,10,13928.4,9540,23468.4
311980,201802,41,31,10,29574,9540,39114
311990,201802,59,42,17,40068,16218,56286
311995,201802,62,43,19,41022,18126,59148
312000,201802,33,23,10,21655.8,9540,31195.8
312010,201802,84,61,23,58194,21942,80136
312015,201802,96,71,25,67448,23850,91298
312020,201802,135,83,52,79182,49321.8,128503.8
312030,201802,42,34,8,31483,7632,39115
312040,201802,79,50,29,47700,27666,75366
312050,201802,223,116,107,110664,102078,212742
312060,201802,66,41,25,39114,23182.2,62296.2
312070,201802,73,44,29,41976,27666,69642
312080,201802,525,231,294,220374,280476,500850
312083,201802,48,35,13,33390,12402,45792
312087,201802,108,86,22,82044,20988,103032
312090,201802,2864,1635,1229,1544552.27,1169003.38,2713555.65
312100,201802,161,114,47,108756,44056,152812
312110,201802,116,73,43,69642,41022,110664
312120,201802,139,103,36,98262,34344,132606
312125,201802,94,54,40,51325.2,38160,89485.2
312130,201802,122,81,41,77274,39114,116388
312140,201802,133,106,27,101124,25758,126882
312150,201802,44,36,8,34344,7632,41976
312160,201802,1527,1016,511,966593.2,486082.48,1452675.68
312170,201802,11,9,2,8586,1908,10494
312180,201802,100,60,40,56525,37874,94399
312190,201802,32,28,4,26712,3816,30528
312200,201802,731,632,99,600972.7,94446,695418.7
312210,201802,97,62,35,59148,33390,92538
312220,201802,122,89,33,84668,31482,116150
312230,201802,3467,1697,1770,1615152.18,1686972.12,3302124.30
312235,201802,142,93,49,88722,46746,135468
312240,201802,109,71,38,67734,36252,103986
312245,201802,162,108,54,103028,51516,154544
312247,201802,58,41,17,38351,16218,54569
312250,201802,183,85,98,80613,93492,174105
312260,201802,103,68,35,64014.2,33390,97404.2
312270,201802,136,85,51,81090,48654,129744
312280,201802,25,15,10,14310,9540,23850
312290,201802,162,111,51,105607.8,47701,153308.8
312300,201802,203,135,68,128790,64872,193662
312310,201802,58,53,5,50562,4770,55332
312320,201802,416,261,155,247086,146582.5,393668.5
312330,201802,85,74,11,69833,10207.8,80040.8
312340,201802,35,16,19,15264,18126,33390
312350,201802,16,10,6,9540,5724,15264
312352,201802,97,66,31,62964,29574,92538
312360,201802,561,253,308,240408,293832,534240
312370,201802,296,176,120,167617.8,114480,282097.8
312380,201802,137,87,50,82998,47700,130698
312385,201802,177,144,33,137376,31482,168858
312390,201802,301,189,112,180306,106181,286487
312400,201802,382,289,93,275706,88246,363952
312410,201802,859,276,583,262827,555606,818433
312420,201802,609,487,122,463930.2,116388,580318.2
312430,201802,858,631,227,599353.05,215604.2,814957.25
312440,201802,45,34,11,32436,10494,42930
312450,201802,210,128,82,122112,78228,200340
312460,201802,58,29,29,27666,27666,55332
312470,201802,54,35,19,33390,18126,51516
312480,201802,211,130,81,124020,77274,201294
312490,201802,257,176,81,167904,77274,245178
312500,201802,32,18,14,17172,13356,30528
312510,201802,425,158,267,150732,254102.39,404834.39
312520,201802,39,14,25,13356,23850,37206
312530,201802,49,37,12,35298,11448,46746
312540,201802,100,87,13,82998,12402,95400
312550,201802,41,32,9,30528,8586,39114
312560,201802,197,143,54,136136,51229.8,187365.8
312570,201802,441,267,174,254050.2,165304.45,419354.65
312580,201802,84,44,40,41976,38160,80136
312590,201802,274,215,59,204729,56286,261015
312595,201802,144,129,15,123066,14310,137376
312600,201802,75,46,29,43455,27666,71121
312610,201802,1624,853,771,804988.98,733817.6,1538806.58
312620,201802,188,132,56,125928,53419.23,179347.23
312630,201802,64,55,9,52470,8586,61056
312640,201802,47,13,34,12402,32436,44838
312650,201802,147,120,27,114194,25472,139666
312660,201802,70,53,17,50276,16218,66494
312670,201802,862,567,295,539344.9,281216.3,820561.2
312675,201802,42,31,11,29574,10494,40068
312680,201802,85,59,26,55904.4,24804,80708.4
312690,201802,240,129,111,123056.46,105607.8,228664.26
312695,201802,30,23,7,21942,6678,28620
312700,201802,208,123,85,117342,81090,198432
312705,201802,75,62,13,59148,12402,71550
312707,201802,94,70,24,66360.44,22896,89256.44
312710,201802,1859,991,868,943067.4,827861,1770928.4
312720,201802,66,33,33,31482,31482,62964
312730,201802,288,170,118,161226,112285.8,273511.8
312733,201802,51,44,7,41690,6678,48368
312735,201802,22,16,6,15264,5724,20988
312737,201802,67,36,31,34344,29574,63918
312738,201802,52,37,15,35298,14310,49608
312740,201802,72,49,23,46746,21942,68688
312750,201802,71,51,20,48654,19080,67734
312760,201802,267,195,72,186030,68688,254718
312770,201802,7650,3540,4110,3354978.04,3912276.73,7267254.77
312780,201802,435,335,100,319303.8,95400,414703.8
312790,201802,20,15,5,14310,4770,19080
312800,201802,1591,1121,470,1062013.28,447197.62,1509210.90
312810,201802,372,239,133,227719.8,126882,354601.8
312820,201802,195,147,48,140238,45792,186030
312825,201802,26,18,8,17172,7632,24804
312830,201802,282,164,118,155217,111933,267150
312840,201802,149,110,39,104940,37206,142146
312850,201802,25,22,3,20988,2862,23850
312860,201802,170,105,65,99884,62010,161894
312870,201802,984,514,470,487557.64,448380,935937.64
312880,201802,149,103,46,98118.9,43788.6,141907.5
312890,201802,163,113,50,107802,47700,155502
312900,201802,211,156,55,148156.2,52470,200626.2
312910,201802,184,92,92,86599.72,87768,174367.72
312920,201802,155,86,69,82044,65826,147870
312930,201802,340,246,94,234684,89676,324360
312940,201802,104,70,34,66780,32436,99216
312950,201802,702,463,239,440366.6,228006,668372.6
312960,201802,174,131,43,124974,41022,165996
312965,201802,51,46,5,43884,4770,48654
312970,201802,284,229,55,217512.2,52470,269982.2
312980,201802,2312,1238,1074,1176084.2,1024019.6,2200103.8
312990,201802,50,29,21,27666,20034,47700
313000,201802,39,25,14,23850,13356,37206
313005,201802,168,129,39,122074.5,36920,158994.5
313010,201802,938,389,549,369865.8,523450.8,893316.6
313020,201802,188,99,89,93969,84906,178875
313030,201802,209,134,75,125929,71550,197479
313040,201802,60,22,38,20988,36252,57240
313050,201802,295,206,89,195570.2,84906,280476.2
313055,201802,47,34,13,32436,12402,44838
313060,201802,129,86,43,82044,40735.8,122779.8
313065,201802,59,39,20,37206,19080,56286
313070,201802,153,84,69,80136,65826,145962
313080,201802,42,18,24,17172,22896,40068
313090,201802,705,486,219,462356.3,208926,671282.3
313100,201802,166,65,101,62010,96346,158356
313110,201802,126,74,52,70596,49608,120204
313115,201802,157,87,70,82797.66,66780,149577.66
313120,201802,755,412,343,392762,325775.13,718537.13
313130,201802,5230,2815,2415,2659725.57,2294438.6,4954164.17
313140,201802,160,84,76,80136,72504,152640
313150,201802,315,251,64,239454,60769.8,300223.8
313160,201802,193,139,54,132606,51516,184122
313170,201802,1334,939,395,883644.7,376439.4,1260084.1
313180,201802,328,195,133,185381.28,126882,312263.28
313190,201802,723,428,295,405545.4,280667,686212.4
313200,201802,23,22,1,20988,954,21942
313210,201802,1036,871,165,827931.16,157405.23,985336.39
313220,201802,233,159,74,150732,69880.5,220612.5
313230,201802,270,199,71,188893,67734,256627
313240,201802,1916,1025,891,974797.93,846807.83,1821605.76
313250,201802,1247,922,325,873675.6,308143.8,1181819.4
313260,201802,92,54,38,51516,36252,87768
313270,201802,955,560,395,530185.34,376830,907015.34
313280,201802,61,52,9,49131,8586,57717
313290,201802,224,181,43,172388,40068.8,212456.8
313300,201802,369,184,185,173628.8,176490,350118.8
313310,201802,226,118,108,112572,103032,215604
313320,201802,367,284,83,268981.1,79182,348163.1
313330,201802,1360,816,544,777033.2,517784.5,1294817.7
313340,201802,335,229,106,218466,101124,319590
313350,201802,523,351,172,332946.1,164088,497034.1
313360,201802,114,68,46,64872,43598,108470
313370,201802,188,71,117,67734,111618,179352
313375,201802,273,162,111,154548,105894,260442
313380,201802,1286,655,631,622981.08,601684,1224665.08
313390,201802,48,40,8,37206.8,7632,44838.8
313400,201802,418,271,147,258534,139952,398486
313410,201802,21,12,9,11448,8586,20034
313420,201802,4676,2412,2264,2291482.98,2152884.02,4444367.00
313430,201802,134,62,72,59148,68688,127836
313440,201802,1456,978,478,930771.1,454868,1385639.1
313450,201802,61,25,36,23850,34057.8,57907.8
313460,201802,374,176,198,166464,188892,355356
313470,201802,536,245,291,233730,276946.2,510676.2
313480,201802,160,108,52,102079,49608,151687
313490,201802,512,250,262,238500,249901,488401
313500,201802,20,12,8,11448,7632,19080
313505,201802,959,745,214,709840,203870,913710
313507,201802,92,54,38,51516,36252,87768
313510,201802,2765,1774,991,1686345.76,944460,2630805.76
313520,201802,3589,2801,788,2659610.82,751748,3411358.82
313530,201802,42,29,13,27666,12402,40068
313535,201802,105,84,21,79469,20034,99503
313540,201802,70,53,17,50562,16218,66780
313545,201802,110,90,20,85860,19080,104940
313550,201802,233,190,43,181260,40736,221996
313560,201802,330,172,158,164088,150732,314820
313570,201802,59,31,28,29574,26712,56286
313580,201802,1294,700,594,665415,564959.4,1230374.4
313590,201802,81,48,33,45792,31482,77274
313600,201802,688,409,279,389900,265308,655208
313610,201802,56,44,12,41356.8,11448,52804.8
313620,201802,1345,710,635,667448.92,601907,1269355.92
313630,201802,1636,1256,380,1196698,362234,1558932
313640,201802,126,72,54,68688,51516,120204
313650,201802,233,108,125,103032,119250,222282
313652,201802,16,15,1,14310,954,15264
313655,201802,55,31,24,29574,22896,52470
313657,201802,46,42,4,40068,3816,43884
313660,201802,132,93,39,88722,37206,125928
313665,201802,637,313,324,298602,308857.5,607459.5
313670,201802,10224,7083,3141,6733167.28,2995655.8,9728823.08
313680,201802,41,30,11,28620,10494,39114
313690,201802,155,119,36,113526,34344,147870
313695,201802,67,50,17,47700,16218,63918
313700,201802,291,233,58,221996,55332,277328
313710,201802,151,102,49,97308,46746,144054
313720,201802,1057,502,555,476427.8,528125.86,1004553.66
313730,201802,59,41,18,39114,17172,56286
313740,201802,164,131,33,124974,31482,156456
313750,201802,440,323,117,307855.8,111618,419473.8
313753,201802,240,170,70,161512.2,66780,228292.2
313760,201802,1232,448,784,427392,745199.52,1172591.52
313770,201802,355,252,103,240408,98262,338670
313780,201802,753,384,369,366336,351739.8,718075.8
313790,201802,27,26,1,24804,954,25758
313800,201802,142,87,55,82998,52470,135468
313810,201802,66,38,28,36252,26712,62964
313820,201802,1286,633,653,602928.2,621985.2,1224913.4
313830,201802,67,50,17,47700,16218,63918
313835,201802,54,47,7,44838,6678,51516
313840,201802,1671,1024,647,971269.52,615998,1587267.52
313850,201802,178,61,117,58194,111038.06,169232.06
313860,201802,485,378,107,357131.3,101124.1,458255.4
313862,201802,171,113,58,107802,55332,163134
313865,201802,84,66,18,62964,17172,80136
313867,201802,49,37,12,35298,11448,46746
313868,201802,27,18,9,16409,8586,24995
313870,201802,124,65,59,62010,56286,118296
313880,201802,345,221,124,210548,117723.8,328271.8
313890,201802,318,169,149,160463.8,141573.6,302037.4
313900,201802,910,493,417,468701.5,397771,866472.5
313910,201802,137,97,40,92538,37206.2,129744.2
313920,201802,607,430,177,410029.2,168858,578887.2
313925,201802,33,29,4,27666,3816,31482
313930,201802,801,615,186,586710,177421,764131
313940,201802,1759,1107,652,1052548.4,621340.4,1673888.8
313950,201802,933,598,335,568680.6,319303.8,887984.4
313960,201802,1376,793,583,752258.3,554942,1307200.3
313970,201802,120,82,38,78228,36252,114480
313980,201802,208,135,73,128552,69642,198194
313990,201802,366,219,147,208639.8,140158.81,348798.61
314000,201802,912,619,293,587045.9,279517.23,866563.13
314010,201802,77,50,27,47700,25758,73458
314015,201802,53,16,37,15264,35298,50562
314020,201802,50,34,16,32436,15168.6,47604.6
314030,201802,87,40,47,37997.82,44838,82835.82
314040,201802,43,30,13,28620,12402,41022
314050,201802,314,183,131,174296,123495.3,297791.3
314053,201802,100,66,34,62010.4,32436,94446.4
314055,201802,297,174,123,165996,117342,283338
314060,201802,144,122,22,115434,20988,136422
314070,201802,960,470,490,444575.14,466554,911129.14
314080,201802,216,140,76,133560,71454.88,205014.88
314085,201802,124,81,43,77274,41022,118296
314090,201802,350,253,97,241362,92533.23,333895.23
314100,201802,475,391,84,369199,79564,448763
314110,201802,690,374,316,354897.54,300748.6,655646.14
314120,201802,96,54,42,51516,40068,91584
314130,201802,25,12,13,11448,12402,23850
314140,201802,1088,653,435,620558.12,413082.66,1033640.78
314150,201802,162,102,60,97308,57240,154548
314160,201802,355,262,93,247086.8,88532,335618.8
314170,201802,69,51,18,48654,17172,65826
314180,201802,724,633,91,603596,85860.5,689456.5
314190,201802,101,57,44,54378,41976,96354
314200,201802,585,403,182,383010.81,172674,555684.81
314210,201802,278,208,70,197478,66494,263972
314220,201802,307,232,75,219421,71264,290685
314225,201802,65,45,20,42930,19080,62010
314230,201802,105,47,58,44838,55332,100170
314240,201802,141,107,34,102078,32436,134514
314250,201802,59,35,24,33390,22896,56286
314260,201802,188,96,92,91584,87768,179352
314270,201802,333,259,74,246323,70583,316906
314280,201802,682,379,303,361557,289062,650619
314290,201802,554,449,105,427106.5,99883.8,526990.3
314300,201802,415,296,119,279448,113479,392927
314310,201802,1443,966,477,919657.32,454952.97,1374610.29
314315,201802,33,26,7,24804,6678,31482
314320,201802,608,385,223,366717.8,211816.62,578534.42
314330,201802,10660,5360,5300,5103302.84,5051734.75,10155037.59
314340,201802,569,265,304,252237.8,289444,541681.8
314345,201802,29,23,6,21942,5724,27666
314350,201802,191,119,72,113526,68688,182214
314360,201802,78,47,31,44838,29574,74412
314370,201802,56,46,10,43884,9540,53424
314380,201802,91,65,26,62010,24804,86814
314390,201802,3197,2012,1185,1915155.5,1127533.4,3042688.9
314400,201802,685,489,196,463636.2,186984,650620.2
314410,201802,427,275,152,262350,145008,407358
314420,201802,20,9,11,8586,10494,19080
314430,201802,2499,897,1602,851990.3,1525624.75,2377615.05
314435,201802,267,152,115,144721.8,108756,253477.8
314437,201802,26,20,6,19080,5724,24804
314440,201802,98,70,28,66780,26712,93492
314450,201802,153,117,36,111618,34344,145962
314460,201802,657,301,356,287154,339624,626778
314465,201802,81,55,26,52470,24804,77274
314467,201802,69,59,10,56277,9540,65817
314470,201802,384,197,187,184486.52,177444.5,361931.02
314480,201802,1047,504,543,480816,517831.2,998647.2
314490,201802,89,68,21,64872,20034,84906
314500,201802,316,207,109,197478,103986,301464
314505,201802,128,81,47,77274,44838,122112
314510,201802,225,181,44,172388,41976,214364
314520,201802,1235,633,602,596636.7,572066.9,1168703.6
314530,201802,707,557,150,530892,143100,673992
314535,201802,209,133,76,125832.6,72253.01,198085.61
314537,201802,62,37,25,35298,23850,59148
314540,201802,14,9,5,8586,4770,13356
314545,201802,49,32,17,30528,16218,46746
314550,201802,79,42,37,40068,35298,75366
314560,201802,806,434,372,411842,354888,766730
314570,201802,22,17,5,16218,4770,20988
314580,201802,18,9,9,8586,8586,17172
314585,201802,20,14,6,13356,5724,19080
314587,201802,84,72,12,68688,11448,80136
314590,201802,552,409,143,390186,136422,526608
314600,201802,996,649,347,614464.86,328748.8,943213.66
314610,201802,940,516,424,489688.9,403351.2,893040.1
314620,201802,149,110,39,103413.6,37206,140619.6
314625,201802,95,71,24,67162,22896,90058
314630,201802,1235,631,604,600495.3,575929.8,1176425.1
314640,201802,91,59,32,56286,30241.8,86527.8
314650,201802,205,119,86,112478.6,81567,194045.6
314655,201802,66,51,15,48654,14310,62964
314660,201802,20,15,5,14310,4770,19080
314670,201802,185,146,39,138998,37206,176204
314675,201802,212,121,91,115434,86814,202248
314690,201802,536,299,237,284959.8,226098,511057.8
314700,201802,2420,1322,1098,1255752.2,1046304.9,2302057.1
314710,201802,1629,954,675,905158.9,643330.1,1548489.0
314720,201802,407,242,165,229465.62,157410,386875.62
314730,201802,508,272,236,258058,225135,483193
314740,201802,688,341,347,323644.5,331038,654682.5
314750,201802,22,19,3,18126,2862,20988
314760,201802,316,151,165,144054,157400.46,301454.46
314770,201802,121,83,38,79182,36252,115434
314780,201802,21,6,15,5724,14310,20034
314790,201802,2333,1457,876,1384247.2,835026.66,2219273.86
314795,201802,50,43,7,40784,6678,47462
314800,201802,2929,1715,1214,1630823.96,1155858.2,2786682.16
314810,201802,1502,832,670,791391.5,637559,1428950.5
314820,201802,91,51,40,48654,38160,86814
314830,201802,210,165,45,155994.9,42644,198638.9
314840,201802,83,49,34,46746,32436,79182
314850,201802,350,170,180,162180,171720,333900
314860,201802,705,527,178,500754.86,168285.7,669040.56
314870,201802,1449,742,707,706914,674478,1381392
314875,201802,59,51,8,48654,7632,56286
314880,201802,47,34,13,32436,12402,44838
314890,201802,53,31,22,29574,20988,50562
314900,201802,30,25,5,23850,4770,28620
314910,201802,256,172,84,163801.8,80136,243937.8
314915,201802,156,135,21,128552,20034,148586
314920,201802,122,75,47,71550,44551.8,116101.8
314930,201802,1023,520,503,494555,479575.8,974130.8
314940,201802,53,41,12,39114,11448,50562
314950,201802,37,26,11,24804,10494,35298
314960,201802,61,45,16,42930,15264,58194
314970,201802,137,68,69,64300,65826,130126
314980,201802,300,195,105,183788.1,99216,283004.1
314990,201802,464,256,208,244224,197526.5,441750.5
314995,201802,199,65,134,62010,127826.46,189836.46
315000,201802,86,69,17,65826,16218,82044
315010,201802,47,31,16,29574,15264,44838
315015,201802,168,137,31,129972.96,29574,159546.96
315020,201802,71,61,10,58194,9540,67734
315030,201802,117,88,29,82998,27666,110664
315040,201802,66,49,17,46746,16218,62964
315050,201802,198,118,80,112572,76320,188892
315053,201802,39,34,5,32436,4770,37206
315057,201802,96,79,17,74984.4,16218,91202.4
315060,201802,69,62,7,57241.16,6678,63919.16
315070,201802,102,56,46,53424,43884,97308
315080,201802,368,302,66,288108,62964,351072
315090,201802,108,64,44,61056,41976,103032
315100,201802,78,40,38,38160,36252,74412
315110,201802,289,159,130,150828,124020,274848
315120,201802,1644,836,808,793586.2,769640,1563226.2
315130,201802,341,247,94,235638,89676,325314
315140,201802,538,315,223,298888.2,212742,511630.2
315150,201802,980,460,520,437887,495794,933681
315160,201802,211,107,104,102078,99216,201294
315170,201802,345,223,122,211789,116101.8,327890.8
315180,201802,3194,1351,1843,1285278.3,1755028.2,3040306.5
315190,201802,309,177,132,168477,125928,294405
315200,201802,1181,672,509,639276.2,484727.4,1124003.6
315210,201802,1560,891,669,845913.9,635806.2,1481720.1
315213,201802,46,28,18,26712,17172,43884
315217,201802,199,158,41,150732,39114,189846
315220,201802,1516,1160,356,1106020.6,339528.6,1445549.2
315230,201802,168,123,45,117056,42930,159986
315240,201802,422,272,150,259488,141898.5,401386.5
315250,201802,2538,1259,1279,1200222.83,1219107.66,2419330.49
315260,201802,148,91,57,85478.4,54378,139856.4
315270,201802,128,87,41,82425.6,38388.96,120814.56
315280,201802,688,448,240,427011,228950.46,655961.46
315290,201802,199,115,84,109710,79182.49,188892.49
315300,201802,71,47,24,44838,22896,67734
315310,201802,65,58,7,55332,6678,62010
315320,201802,159,89,70,84906,66780,151686
315330,201802,54,46,8,43884,7632,51516
315340,201802,419,294,125,279293.6,119250,398543.6
315350,201802,149,88,61,83952,58194,142146
315360,201802,96,51,45,48654,42930,91584
315370,201802,56,33,23,31482,21798.9,53280.9
315380,201802,12,7,5,6678,4770,11448
315390,201802,56,13,43,12402,41022,53424
315400,201802,820,613,207,579364.6,196810.2,776174.8
315410,201802,351,213,138,202916,131366,334282
315415,201802,59,45,14,42930,13356,56286
315420,201802,207,156,51,147727.1,48654,196381.1
315430,201802,677,395,282,375876.2,268551.8,644428.0
315440,201802,81,56,25,53424,23850,77274
315445,201802,255,204,51,194301.18,48654,242955.18
315450,201802,182,137,45,130698,42930,173628
315460,201802,3354,1696,1658,1614923.4,1579291.1,3194214.5
315470,201802,44,22,22,20988,20988,41976
315480,201802,62,23,39,21942,37206,59148
315490,201802,612,378,234,358560.9,223236,581796.9
315500,201802,22,14,8,13356,7632,20988
315510,201802,150,99,51,94446,48654,143100
315520,201802,71,62,9,59148,8586,67734
315530,201802,52,28,24,26712,22896,49608
315540,201802,239,156,83,148824,79182,228006
315550,201802,178,141,37,134514,35298,169812
315560,201802,742,591,151,562474.8,144054,706528.8
315570,201802,317,167,150,156695.7,143100,299795.7
315580,201802,652,425,227,405450,216558,622008
315590,201802,208,106,102,101124,97308,198432
315600,201802,291,214,77,204156,73268,277424
315610,201802,97,47,50,44838,47700,92538
315620,201802,33,26,7,24804,6678,31482
315630,201802,141,93,48,88722,45792,134514
315640,201802,59,35,24,33390,22896,56286
315645,201802,63,45,18,42930,16695,59625
315650,201802,166,121,45,115148,42930,158078
315660,201802,479,204,275,194616,262350,456966
315670,201802,2343,1194,1149,1136291.32,1094973.66,2231264.98
315680,201802,856,575,281,545116.4,267348.96,812465.36
315690,201802,691,473,218,450167.67,207972,658139.67
315700,201802,1908,1006,902,955852.37,860508,1816360.37
315710,201802,325,86,239,82044,228006,310050
315720,201802,429,274,155,261396,147870,409266
315725,201802,201,161,40,153594,38160,191754
315727,201802,42,22,20,20988,19080,40068
315730,201802,40,38,2,36252,1908,38160
315733,201802,86,57,29,54378,27666,82044
315737,201802,51,38,13,36252,12402,48654
315740,201802,45,40,5,38160,4770,42930
315750,201802,160,126,34,120204,32436,152640
315760,201802,47,32,15,30528,14310,44838
315765,201802,116,76,40,72504,38160,110664
315770,201802,226,136,90,129744,85574,215318
315780,201802,3271,1702,1569,1617269.5,1494442.58,3111712.08
315790,201802,211,162,49,154548,46173.6,200721.6
315800,201802,283,204,79,194616,75366,269982
315810,201802,96,55,41,52470,38828,91298
315820,201802,791,569,222,541491.34,211788,753279.34
315830,201802,144,82,62,78228,59148,137376
315840,201802,91,63,28,60102,26712,86814
315850,201802,258,190,68,181260,64872,246132
315860,201802,12,4,8,3816,7632,11448
315870,201802,34,27,7,25758,6678,32436
315880,201802,104,68,36,64872,34344,99216
315890,201802,82,61,21,58194,20034,78228
315895,201802,437,288,149,273703,141574,415277
315900,201802,70,34,36,32436,34344,66780
315910,201802,38,24,14,22657.5,13356,36013.5
315920,201802,183,120,63,114480,59148.9,173628.9
315930,201802,40,14,26,13356,24804,38160
315935,201802,147,115,32,109710,30519,140229
315940,201802,91,68,23,64872,21942,86814
315950,201802,65,47,18,44838,17172,62010
315960,201802,557,258,299,245435.78,284673.8,530109.58
315970,201802,37,29,8,27666,7632,35298
315980,201802,696,325,371,307425.61,353924.46,661350.07
315990,201802,250,151,99,143768,94160,237928
316000,201802,50,32,18,30528,17172,47700
316010,201802,75,63,12,60102,11448,71550
316020,201802,109,89,20,84906,19080,103986
316030,201802,402,211,191,201294,181690,382984
316040,201802,502,222,280,210834.2,266834,477668.2
316045,201802,58,52,6,49608,5724,55332
316050,201802,16,14,2,13356,1908,15264
316060,201802,94,61,33,58194,31482,89676
316070,201802,1035,669,366,631747.5,348401,980148.5
316080,201802,104,62,42,59148,40068,99216
316090,201802,41,25,16,23182.2,15264,38446.2
316095,201802,70,58,12,55056,11448,66504
316100,201802,309,180,129,170909.3,123066,293975.3
316105,201802,35,24,11,22896,10494,33390
316110,201802,1917,1539,378,1458428.35,359944.2,1818372.55
316120,201802,82,61,21,58194,19747.8,77941.8
316130,201802,138,106,32,100457,30528,130985
316140,201802,27,20,7,19080,6678,25758
316150,201802,204,142,62,134752.5,59148,193900.5
316160,201802,85,51,34,48654,32436,81090
316165,201802,65,47,18,44648,16456.5,61104.5
316170,201802,203,136,67,128790,63918,192708
316180,201802,197,89,108,84572.1,103032,187604.1
316190,201802,139,99,40,93492,38160,131652
316200,201802,699,389,310,371106,295167.6,666273.6
316210,201802,760,507,253,483332.33,241362,724694.33
316220,201802,115,78,37,74412,35298,109710
316225,201802,23,14,9,13356,8586,21942
316230,201802,32,19,13,18126,12402,30528
316240,201802,617,499,118,475092.2,112572,587664.2
316245,201802,101,84,17,80136,16218,96354
316250,201802,1508,1052,456,995958.5,433554.92,1429513.42
316255,201802,111,90,21,85478.4,20034,105512.4
316257,201802,183,96,87,91584,82711.8,174295.8
316260,201802,243,161,82,152297.06,78133,230430.06
316265,201802,25,16,9,15264,8586,23850
316270,201802,678,470,208,445613.6,198432,644045.6
316280,201802,542,337,205,319940.8,194902.6,514843.4
316290,201802,701,472,229,447426.98,218466,665892.98
316292,201802,501,199,302,189846,287870,477716
316294,201802,104,62,42,59148,40068,99216
316295,201802,281,123,158,115894,150732,266626
316300,201802,103,72,31,68688,29574,98262
316310,201802,35,18,17,17172,16218,33390
316320,201802,42,25,17,23850,16218,40068
316330,201802,132,84,48,79182.5,45505.8,124688.3
316340,201802,140,93,47,88722,44838,133560
316350,201802,192,139,53,132440,50562,183002
316360,201802,22,17,5,16218,4770,20988
316370,201802,1063,565,498,535214.5,474796.26,1010010.76
316380,201802,122,92,30,87768,28620,116388
316390,201802,121,87,34,82998,32436,115434
316400,201802,138,105,33,100170,31482,131652
316410,201802,303,222,81,210404.7,77274,287678.7
316420,201802,199,141,58,133798.5,55332,189130.5
316430,201802,160,81,79,77274,75366,152640
316440,201802,98,47,51,44838,48654,93492
316443,201802,38,35,3,33390,2862,36252
316447,201802,64,50,14,47700,13356,61056
316450,201802,220,166,54,158364,51516,209880
316460,201802,68,28,40,26712,38160,64872
316470,201802,1608,1158,450,1097026.44,427083.76,1524110.20
316480,201802,13,10,3,9540,2862,12402
316490,201802,18,7,11,6678,10494,17172
316500,201802,152,101,51,96067.8,48654,144721.8
316510,201802,168,124,44,117294.3,41976,159270.3
316520,201802,191,116,75,110091.6,71550,181641.6
316530,201802,155,112,43,106848,40735.8,147583.8
316540,201802,141,78,63,74412,60102,134514
316550,201802,140,99,41,94446,39114,133560
316553,201802,240,115,125,109201.33,119250,228451.33
316555,201802,32,23,9,21942,8586,30528
316556,201802,9,6,3,5724,2862,8586
316557,201802,18,15,3,14310,2862,17172
316560,201802,60,47,13,44838,12402,57240
316570,201802,246,224,22,213458,20988,234446
316580,201802,21,15,6,14310,5724,20034
316590,201802,115,99,16,94446,15264,109710
316600,201802,181,147,34,139952,32436,172388
316610,201802,64,45,19,42643.8,18126,60769.8
316620,201802,134,103,31,98262,29574,127836
316630,201802,38,28,10,26712,9540,36252
316640,201802,16,10,6,9540,5724,15264
316650,201802,64,50,14,47700,13356,61056
316660,201802,6,4,2,3816,1908,5724
316670,201802,437,156,281,148805,267501.8,416306.8
316680,201802,162,112,50,106848,47510,154358
316690,201802,192,121,71,115434,67734,183168
316695,201802,62,55,7,52470,6678,59148
316700,201802,14,7,7,6678,6678,13356
316710,201802,711,519,192,494888,183168,678056
316720,201802,4870,2475,2395,2346657.04,2279361.03,4626018.07
316730,201802,14,13,1,12402,954,13356
316740,201802,133,84,49,80136,46746,126882
316750,201802,19,13,6,12402,5724,18126
316760,201802,323,260,63,248040,60102,308142
316770,201802,139,80,59,76320,56286,132606
316780,201802,71,41,30,38808.72,28620,67428.72
316790,201802,56,43,13,41022,12402,53424
316800,201802,1795,1104,691,1051212.8,657498.2,1708711.0
316805,201802,18,9,9,8586,8586,17172
316810,201802,64,41,23,39114,21656,60770
316820,201802,37,18,19,17172,18126,35298
316830,201802,90,39,51,37206,47414,84620
316840,201802,504,305,199,290207,187938,478145
316850,201802,345,226,119,214220.7,113526,327746.7
316860,201802,5978,2647,3331,2510508.51,3174283.26,5684791.77
316870,201802,1450,940,510,888376.7,481772,1370148.7
316880,201802,114,65,49,61723.8,46746,108469.8
316890,201802,251,166,85,158317,81090,239407
316900,201802,417,287,130,271251.28,124020,395271.28
316905,201802,16,9,7,8586,6678,15264
316910,201802,50,26,24,24804,22896,47700
316920,201802,133,103,30,97547,28620,126167
316930,201802,1910,963,947,912932.3,901239.93,1814172.23
316935,201802,855,514,341,488115.72,324360,812475.72
316940,201802,1097,631,466,601020.4,443982.26,1045002.66
316950,201802,186,96,90,91584,85860,177444
316960,201802,1099,611,488,581558.8,465256.46,1046815.26
316970,201802,636,496,140,473184,133560,606744
316980,201802,111,68,43,64872,41012.46,105884.46
316990,201802,2173,1427,746,1353966.18,710005.96,2063972.14
317000,201802,328,254,74,242030,70596,312626
317005,201802,247,175,72,166950,68688,235638
317010,201802,6231,3430,2801,3251625.74,2670246.2,5921871.94
317020,201802,16065,7114,8951,6754448.4,8521909.88,15276358.28
317030,201802,84,33,51,31482,48437.26,79919.26
317040,201802,3120,1940,1180,1848585.88,1122668.61,2971254.49
317043,201802,69,49,20,46746,19080,65826
317047,201802,37,18,19,17172,18122,35294
317050,201802,176,130,46,124020,43884,167904
317052,201802,125,97,28,92538,26712,119250
317057,201802,200,150,50,143100,47128,190228
317060,201802,55,36,19,34344,17839.8,52183.8
317065,201802,60,48,12,45792,11448,57240
317070,201802,1965,928,1037,880543.7,988153.6,1868697.3
317075,201802,107,55,52,52470,49608,102078
317080,201802,819,431,388,410076.9,369962,780038.9
317090,201802,632,506,126,480387.5,120204,600591.5
317100,201802,411,306,105,290016.2,100170,390186.2
317103,201802,109,94,15,89676,14310,103986
317107,201802,36,32,4,30528,3816,34344
317110,201802,95,40,55,38160,52470,90630
317115,201802,40,34,6,32436,5724,38160
317120,201802,1807,910,897,860236.62,855281,1715517.62
317130,201802,1905,1220,685,1160931.4,652823,1813754.4
317140,201802,7,5,2,4770,1908,6678
317150,201802,267,161,106,153594,100360.8,253954.8
317160,201802,319,232,87,221011,82712,303723
317170,201802,205,142,63,135468,60102,195570
317180,201802,428,307,121,292162.5,115434,407596.5
317190,201802,252,169,83,161226,78895.8,240121.8
317200,201802,799,564,235,525664,223952,749616
317210,201802,153,87,66,82044.2,62964,145008.2
317220,201802,20,13,7,12402,6678,19080
320010,201802,620,459,161,434548.5,153594,588142.5
320013,201802,133,99,34,94446,32436,126882
320016,201802,279,177,102,168858,97308,266166
320020,201802,716,429,287,406716.75,271155.74,677872.49
320030,201802,150,112,38,106848,35918.1,142766.1
320035,201802,133,98,35,93492,33390,126882
320040,201802,499,259,240,246514,228960,475474
320050,201802,115,88,27,83952,25758,109710
320060,201802,1523,708,815,675385,776833.6,1452218.6
320070,201802,100,70,30,66780,28620,95400
320080,201802,759,434,325,411205,310050,721255
320090,201802,1202,839,363,797052.86,345443.6,1142496.46
320100,201802,315,178,137,169812,130698,300510
320110,201802,139,89,50,82762.2,47700,130462.2
320115,201802,112,92,20,87768,19080,106848
320120,201802,3275,1833,1442,1736849.78,1373990.64,3110840.42
320130,201802,7300,3489,3811,3308224.54,3627872.65,6936097.19
320140,201802,417,267,150,253383.2,142856,396239.2
320150,201802,1877,1096,781,1037985.91,745064.46,1783050.37
320160,201802,688,312,376,295635.83,357351.29,652987.12
320170,201802,113,87,26,82235,24804,107039
320180,201802,52,30,22,28620,20988,49608
320190,201802,233,157,76,149005.26,72218,221223.26
320200,201802,54,41,13,39114,12402,51516
320210,201802,839,472,367,448762.6,349146,797908.6
320220,201802,303,112,191,106848,181928,288776
320225,201802,73,60,13,57240,12402,69642
320230,201802,550,353,197,335426.4,187128,522554.4
320240,201802,3124,1575,1549,1500070.8,1475079.78,2975150.58
320245,201802,455,317,138,301273.4,131652,432925.4
320250,201802,219,114,105,107802.6,100170,207972.6
320255,201802,143,114,29,107449.02,27523,134972.02
320260,201802,175,122,53,116388,50514.3,166902.3
320265,201802,159,128,31,121302,29574,150876
320270,201802,152,125,27,119250,25758,145008
320280,201802,945,570,375,538820.2,356634.02,895454.22
320290,201802,65,55,10,52470,9540,62010
320300,201802,535,379,156,360107.3,147556.1,507663.4
320305,201802,652,351,301,334854,286964,621818
320310,201802,212,121,91,113479.5,86058,199537.5
320313,201802,302,151,151,144054,143768,287822
320316,201802,109,90,19,85860,18126,103986
320320,201802,3303,1505,1798,1430086,1712303,3142389
320330,201802,258,190,68,180597.3,62964.91,243562.21
320332,201802,882,532,350,505671.6,332851.3,838522.9
320334,201802,236,143,93,136136,88722,224858
320335,201802,146,105,41,98977.9,39114,138091.9
320340,201802,590,408,182,388088,172961,561049
320350,201802,964,410,554,388660.88,527990.48,916651.36
320360,201802,166,92,74,87482,70596,158078
320370,201802,244,187,57,176706,53345,230051
320380,201802,283,191,92,180259.1,87768,268027.1
320390,201802,1113,683,430,651258,408646.93,1059904.93
320400,201802,320,231,89,219421,84906,304327
320405,201802,884,377,507,359081.6,483365.92,842447.52
320410,201802,967,492,475,467679.4,452779.34,920458.74
320420,201802,480,249,231,237069.4,220374,457443.4
320425,201802,192,105,87,100170,82998,183168
320430,201802,394,224,170,212074.7,162180,374254.7
320435,201802,166,111,55,105073.56,52470,157543.56
320440,201802,201,122,79,116101.8,75080,191181.8
320450,201802,130,77,53,73458,50562,124020
320455,201802,243,197,46,186985,43884,230869
320460,201802,241,153,88,145962,83952,229914
320465,201802,114,77,37,73095.48,35298,108393.48
320470,201802,630,403,227,384158.26,216554,600712.26
320480,201802,176,118,58,111761.1,55332,167093.1
320490,201802,2996,1502,1494,1428594.74,1423331.92,2851926.66
320495,201802,90,56,34,53405,32436,85841
320500,201802,9379,4747,4632,4501321.22,4406376.79,8907698.01
320501,201802,540,274,266,261396,253764,515160
320503,201802,278,200,78,189846.2,74412,264258.2
320506,201802,256,197,59,187938,56286,244224
320510,201802,929,447,482,423529.3,458302.1,881831.4
320515,201802,79,66,13,62010.9,12402,74412.9
320517,201802,204,144,60,137376,57240,194616
320520,201802,6785,3035,3750,2881172.59,3569165.88,6450338.47
320530,201802,5226,2625,2601,2495517.02,2478104.23,4973621.25
330010,201802,3047,1571,1476,1491074.56,1405306.37,2896380.93
330015,201802,156,63,93,58958.08,88722,147680.08
330020,201802,3555,1554,2001,1479274.84,1908382,3387656.84
330022,201802,213,119,94,112811,88722.8,201533.8
330023,201802,522,181,341,171195.8,325314,496509.8
330025,201802,540,122,418,116388,398199.8,514587.8
330030,201802,1919,1225,694,1160355.28,658807.68,1819162.96
330040,201802,2303,1170,1133,1114320.1,1079548,2193868.1
330045,201802,8285,2609,5676,2480858.82,5408696.06,7889554.88
330050,201802,797,503,294,479862,280476,760338
330060,201802,884,552,332,522793.9,316079.28,838873.18
330070,201802,3429,1308,2121,1241875.47,2022119.56,3263995.03
330080,201802,1496,702,794,664445.3,756236.4,1420681.7
330090,201802,352,213,139,203202,132606,335808
330093,201802,288,129,159,123066,151650,274716
330095,201802,100,52,48,49608,45792,95400
330100,201802,9472,4888,4584,4653584.04,4369530.9,9023114.94
330110,201802,472,210,262,199624.5,249948,449572.5
330115,201802,528,311,217,296694,207018,503712
330120,201802,377,196,181,185839.2,171910.8,357750.0
330130,201802,1519,425,1094,404724.96,1043640,1448364.96
330140,201802,599,315,284,300492,269983,570475
330150,201802,448,267,181,252810,171720,424530
330160,201802,206,127,79,121158,75366,196524
330170,201802,26638,9413,17225,8958489.22,16419961.2,25378450.42
330180,201802,239,152,87,141507.22,82282.5,223789.72
330185,201802,782,330,452,313284.8,429940.8,743225.6
330187,201802,282,91,191,86814,182214,269028
330190,201802,5544,2221,3323,2109997.9,3166846.68,5276844.58
330200,201802,4438,1535,2903,1459716.58,2764781.76,4224498.34
330205,201802,389,241,148,229484.7,140906,370390.7
330210,201802,998,608,390,574789.6,370390.9,945180.5
330220,201802,2521,1507,1014,1434292.5,966402.2,2400694.7
330225,201802,552,310,242,295101,230200.2,525301.2
330227,201802,2465,789,1676,749548.46,1598548.23,2348096.69
330230,201802,199,122,77,115721,73458,189179
330240,201802,3614,1882,1732,1790851.26,1649043.56,3439894.82
330245,201802,152,65,87,62010,82234.8,144244.8
330250,201802,6452,3352,3100,3186985.6,2948447.32,6135432.92
330260,201802,566,169,397,161226,378738,539964
330270,201802,3319,1230,2089,1172563,1992335.2,3164898.2
330280,201802,437,286,151,269907.28,144045,413952.28
330285,201802,7001,2324,4677,2213074.4,4459674.4,6672748.8
330290,201802,567,220,347,208927,331038,539965
330300,201802,750,503,247,476046.7,235620,711666.7
330310,201802,413,240,173,227052.7,165042,392094.7
330320,201802,8071,3040,5031,2892435.8,4793922.84,7686358.64
330330,201802,9250,3636,5614,3462136.2,5351065.13,8813201.33
330340,201802,2645,1586,1059,1510841.06,1010266.92,2521107.98
330350,201802,17847,7062,10785,6712254.84,10268432.73,16980687.57
330360,201802,2576,1275,1301,1215377.2,1241145,2456522.2
330370,201802,970,534,436,508672.8,413941.6,922614.4
330380,201802,851,370,481,352254.96,458254.8,810509.76
330385,201802,602,317,285,301465,271890,573355
330390,201802,5152,2867,2285,2721480.55,2177328.4,4898808.95
330395,201802,248,156,92,147107.1,86003.2,233110.3
330400,201802,661,339,322,319972.6,305293.85,625266.45
330410,201802,503,358,145,339864,137805.53,477669.53
330411,201802,233,133,100,126701,95352.3,222053.3
330412,201802,253,108,145,102746,138330,241076
330414,201802,6163,2498,3665,2379984,3494436.3,5874420.3
330415,201802,568,270,298,256367.6,283338.8,539706.4
330420,201802,2270,1201,1069,1142769.6,1017147,2159916.6
330430,201802,1805,830,975,789722,928038.04,1717760.04
330440,201802,266,123,143,117342,136422,253764
330450,201802,123,51,72,48654,68688,117342
330452,201802,1698,796,902,757670.18,860203.88,1617874.06
330455,201802,110491,39506,70985,37612693.14,67656204.79,105268897.93
330460,201802,264,107,157,102078,149778,251856
330470,201802,1239,681,558,643380.98,532322.46,1175703.44
330475,201802,1397,379,1018,359589.62,970599.6,1330189.22
330480,201802,743,395,348,376162.2,331038.8,707201.0
330490,201802,13560,4759,8801,4533304.51,8388867.39,12922171.90
330500,201802,1340,614,726,585612.9,692223,1277835.9
330510,201802,11196,3752,7444,3571730.48,7094885.34,10666615.82
330513,201802,103,51,52,48654,49608,98262
330515,201802,854,356,498,335599.8,474711,810310.8
330520,201802,2444,922,1522,879369,1451844.9,2331213.9
330530,201802,227,118,109,112572,103796,216368
330540,201802,353,176,177,167904,168381,336285
330550,201802,3072,1090,1982,1037142.2,1888777.3,2925919.5
330555,201802,750,278,472,265193,449334.8,714527.8
330560,201802,551,206,345,196524,329112,525636
330570,201802,252,174,78,165996,74412,240408
330575,201802,808,332,476,316490,452049.5,768539.5
330580,201802,3356,1883,1473,1789240,1403477.7,3192717.7
330590,201802,306,155,151,147870,144054,291924
330600,201802,1096,707,389,672341.24,369418.38,1041759.62
330610,201802,1523,841,682,795142.42,646479.9,1441622.32
330615,201802,188,140,48,133560,45792,179352
330620,201802,975,444,531,421193.4,505143.8,926337.2
330630,201802,3773,2396,1377,2270196.65,1306268.59,3576465.24
350010,201802,593,386,207,366960.76,197478,564438.76
350020,201802,40,21,19,20034,18126,38160
350030,201802,522,339,183,322262,173392.66,495654.66
350040,201802,127,49,78,46402.56,74412,120814.56
350050,201802,292,161,131,153594,124717.46,278311.46
350055,201802,84,46,38,43884,36252,80136
350060,201802,74,28,46,26712,43884,70596
350070,201802,796,467,329,441237.14,312199.56,753436.70
350075,201802,65,43,22,41022,20988,62010
350080,201802,51,32,19,29891.96,18126,48017.96
350090,201802,98,56,42,53424,40063.23,93487.23
350100,201802,294,183,111,173866.5,105894,279760.5
350110,201802,59,36,23,34344,21942,56286
350115,201802,155,94,61,89008.2,58194,147202.2
350120,201802,112,75,37,71550,35298,106848
350130,201802,354,173,181,164470,172674,337144
350140,201802,35,21,14,19271,13356,32627
350150,201802,71,57,14,54378,13356,67734
350160,201802,2473,960,1513,912771.16,1442060.68,2354831.84
350170,201802,397,242,155,228960.2,147584,376544.2
350180,201802,185,97,88,92538,83952,176490
350190,201802,964,492,472,467366.64,449987.49,917354.13
350200,201802,71,26,45,24804,42665.08,67469.08
350210,201802,1353,761,592,718007.33,564250.66,1282257.99
350220,201802,668,574,94,543458.73,89676,633134.73
350230,201802,80,56,24,53424,22896,76320
350240,201802,62,47,15,44838,14310,59148
350250,201802,1215,611,604,577171.6,575492.06,1152663.66
350260,201802,93,66,27,62964,25758,88722
350270,201802,830,546,284,519807,269486.92,789293.92
350275,201802,297,115,182,109329,173628,282957
350280,201802,4711,2403,2308,2280565.38,2199009.65,4479575.03
350290,201802,399,189,210,180015.23,199767.8,379783.03
350300,201802,45,24,21,22896,20034,42930
350310,201802,98,69,29,65730,27666,93396
350315,201802,39,24,15,22896,14310,37206
350320,201802,3249,1608,1641,1529216.5,1564733.26,3093949.76
350330,201802,1671,888,783,843051.96,745678.04,1588730.00
350335,201802,21,14,7,13356,6678,20034
350340,201802,132,63,69,60102,64860.9,124962.9
350350,201802,97,47,50,44838,47700,92538
350360,201802,132,89,43,84902,41022,125924
350370,201802,96,56,40,52787.96,38150.46,90938.42
350380,201802,739,311,428,296026.2,407548.8,703575.0
350390,201802,1414,573,841,545846.35,801169.4,1347015.75
350395,201802,25,19,6,18126,5724,23850
350400,201802,1696,910,786,858851.98,746292.16,1605144.14
350410,201802,2232,998,1234,949002.96,1176917.03,2125919.99
350420,201802,231,142,89,134865,84906,219771
350430,201802,73,42,31,39496,29574,69070
350440,201802,151,111,40,104892.5,38160,143052.5
350450,201802,1613,1005,608,951550.95,579937,1531487.95
350460,201802,334,121,213,115434,202915.8,318349.8
350470,201802,14,10,4,9540,3816,13356
350480,201802,158,88,70,83952,66780,150732
350490,201802,244,120,124,113526.8,118296,231822.8
350500,201802,38,18,20,17172,19080,36252
350510,201802,163,109,54,103986,51516,155502
350520,201802,453,213,240,200021.96,228323.96,428345.92
350530,201802,450,211,239,201294,228006,429300
350535,201802,65,50,15,47381.85,14310,61691.85
350540,201802,373,190,183,180446.04,174296,354742.04
350550,201802,2740,1610,1130,1528360.74,1076916.07,2605276.81
350560,201802,631,438,193,417847.23,183764.25,601611.48
350570,201802,4189,1741,2448,1655443.98,2332885.2,3988329.18
350580,201802,364,172,192,163135,183154.46,346289.46
350590,201802,895,490,405,467460,385416,852876
350600,201802,6176,3106,3070,2948923.24,2925325.72,5874248.96
350610,201802,1538,785,753,742537.9,718353,1460890.9
350620,201802,37,25,12,23850,11448,35298
350630,201802,242,136,106,128790.96,100171,228961.96
350635,201802,862,340,522,324074,497341.21,821415.21
350640,201802,118,87,31,82998,29574,112572
350650,201802,1890,1245,645,1183276.31,613921.49,1797197.80
350660,201802,752,342,410,325628.82,390182,715810.82
350670,201802,310,161,149,153356,142146,295502
350680,201802,178,97,81,92538,77274,169812
350690,201802,196,98,98,93492,93492,186984
350700,201802,694,343,351,323887.94,334854,658741.94
350710,201802,324,131,193,124974,184122,309096
350715,201802,50,43,7,41022,6678,47700
350720,201802,18,13,5,12402,4770,17172
350730,201802,43,27,16,25758,15264,41022
350740,201802,204,115,89,109414.26,84906,194320.26
350745,201802,21,11,10,10470,9540,20010
350750,201802,2141,1377,764,1305370.74,728219.96,2033590.70
350760,201802,3722,1609,2113,1533365.36,2013598.46,3546963.82
350770,201802,59,40,19,38160,18126,56286
350775,201802,48,35,13,33390,12393,45783
350780,201802,423,210,213,200340,203202,403542
350790,201802,366,158,208,150732,198432,349164
350800,201802,433,241,192,229914,183168,413082
350810,201802,519,416,103,395911,98262,494173
350820,201802,84,50,34,47700,32436,80136
350830,201802,81,46,35,43884,33390,77274
350840,201802,723,329,394,313866,374636,688502
350850,201802,1750,1014,736,961348.34,701874.46,1663222.80
350860,201802,580,337,243,317265.12,231822,549087.12
350870,201802,436,296,140,282384,133273.8,415657.8
350880,201802,286,156,130,145964.1,123352.2,269316.3
350890,201802,43,26,17,24804,16218,41022
350900,201802,1465,473,992,449255.93,945604.8,1394860.73
350910,201802,28,18,10,17172,9540,26712
350920,201802,595,332,263,316410.04,250902,567312.04
350925,201802,1169,632,537,599886.34,510867.6,1110753.94
350930,201802,95,57,38,54378,36252,90630
350940,201802,715,401,314,381027.6,297715.6,678743.2
350945,201802,106,79,27,74830,25758,100588
350950,201802,15183,7328,7855,6962303.43,7483303.3,14445606.73
350960,201802,1283,599,684,566764.96,652532,1219296.96
350970,201802,1121,607,514,576491.96,490060.46,1066552.42
350980,201802,97,65,32,62010,30528,92538
350990,201802,359,130,229,123324,218179.8,341503.8
350995,201802,34,17,17,16218,16218,32436
351000,201802,639,457,182,433754.07,173628,607382.07
351010,201802,52,30,22,28620,20988,49608
351015,201802,58,42,16,40068,15264,55332
351020,201802,1669,968,701,921762.25,666655.4,1588417.65
351030,201802,333,229,104,215890.2,99216,315106.2
351040,201802,850,460,390,437886,371106.66,808992.66
351050,201802,3270,1565,1705,1484714.4,1625522.5,3110236.9
351060,201802,4966,2047,2919,1942315.82,2781691.89,4724007.71
351070,201802,416,266,150,251543.14,143100,394643.14
351080,201802,811,582,229,555228,217512,772740
351090,201802,63,27,36,25758,34344,60102
351100,201802,459,262,197,247726.48,187924.23,435650.71
351110,201802,2109,1022,1087,969751.26,1034352.12,2004103.38
351120,201802,74,39,35,37121.09,33390,70511.09
351130,201802,175,60,115,57240,109710,166950
351140,201802,339,236,103,223617.64,98262,321879.64
351150,201802,395,203,192,193089.8,183168,376257.8
351160,201802,246,160,86,152640,82044,234684
351170,201802,183,96,87,91584,82235,173819
351190,201802,92,63,29,60102,27666,87768
351200,201802,382,250,132,237896.04,125928,363824.04
351210,201802,131,62,69,58893.38,65826,124719.38
351220,201802,527,317,210,298730.13,200340,499070.13
351230,201802,276,202,74,192071.96,70576.92,262648.88
351240,201802,226,98,128,93301.2,122112,215413.2
351250,201802,69,48,21,45314,19844,65158
351260,201802,153,112,41,106848,38828,145676
351270,201802,48,20,28,19080,26712,45792
351280,201802,1106,502,604,475095.42,575692.38,1050787.80
351290,201802,225,101,124,96354,118010,214364
351300,201802,3742,1753,1989,1665593.15,1896613,3562206.15
351310,201802,771,394,377,375876,359658,735534
351320,201802,109,66,43,62964,41022,103986
351330,201802,41,28,13,26712,12402,39114
351340,201802,1237,766,471,723259.86,448350.23,1171610.09
351350,201802,2449,1330,1119,1267246.7,1067235.03,2334481.73
351360,201802,778,390,388,370152,369834.04,739986.04
351370,201802,364,189,175,180301.23,166313.96,346615.19
351380,201802,8882,4065,4817,3862625.94,4586466.96,8449092.90
351385,201802,30,20,10,19080,9540,28620
351390,201802,290,213,77,202248,73458,275706
351400,201802,65,40,25,38160,23803.92,61963.92
351410,201802,426,266,160,252493.04,152354,404847.04
351420,201802,62,50,12,47700,11448,59148
351430,201802,76,40,36,38160,34344,72504
351440,201802,790,549,241,521551.76,229910,751461.76
351450,201802,251,126,125,120204,119250,239454
351460,201802,122,55,67,51755,63918,115673
351470,201802,139,74,65,70587,62010,132597
351480,201802,514,288,226,273512.96,215484.75,488997.71
351490,201802,294,105,189,100170,180306,280476
351492,201802,32,23,9,21942,8586,30528
351495,201802,28,18,10,17172,9540,26712
351500,201802,3550,1538,2012,1461747.69,1914536.41,3376284.10
351510,201802,1770,739,1031,704719.8,981370.26,1686090.06
351512,201802,22,18,4,17172,3816,20988
351515,201802,194,111,83,105894,79182,185076
351518,201802,736,449,287,427388,273798,701186
351519,201802,74,48,26,45792,24804,70596
351520,201802,142,87,55,82361.96,52470,134831.96
351530,201802,20,13,7,12402,6678,19080
351535,201802,133,73,60,69642,57240,126882
351540,201802,462,333,129,315299,123066,438365
351550,201802,1319,804,515,762025.96,489051.11,1251077.07
351560,201802,74,38,36,36252,34344,70596
351565,201802,13,8,5,7632,4770,12402
351570,201802,2565,1322,1243,1258864.35,1185155.65,2444020.00
351580,201802,39,35,4,33390,3816,37206
351590,201802,67,44,23,41976,21942,63918
351600,201802,190,143,47,136422,44838,181260
351610,201802,61,30,31,28620,29574,58194
351620,201802,5954,3419,2535,3251697.25,2416167.11,5667864.36
351630,201802,2516,1300,1216,1234885.43,1157865.23,2392750.66
351640,201802,1657,809,848,769901.38,806750.8,1576652.18
351650,201802,30,25,5,23850,4770,28620
351660,201802,156,99,57,93492,54378,147870
351670,201802,741,466,275,442228,262350,704578
351680,201802,75,61,14,58194,13356,71550
351685,201802,43,28,15,26712,14310,41022
351690,201802,309,220,89,208014.93,84906,292920.93
351700,201802,163,115,48,109710,45792,155502
351710,201802,75,54,21,51516,20034,71550
351720,201802,136,63,73,60102,69642,129744
351730,201802,101,73,28,68401.96,26707.23,95109.19
351740,201802,720,486,234,461164.76,223231.23,684395.99
351750,201802,368,155,213,147234,203202,350436
351760,201802,796,619,177,590765,168858,759623
351770,201802,287,245,42,233730,40068,273798
351780,201802,172,97,75,92529,71550,164079
351790,201802,244,129,115,123066,109710,232776
351800,201802,54,35,19,33390,18126,51516
351810,201802,124,82,42,78228,40068,118296
351820,201802,884,637,247,603216.4,235347.23,838563.63
351830,201802,503,183,320,173818.8,305280,479098.8
351840,201802,1869,945,924,892586,879994.94,1772580.94
351850,201802,230,169,61,160606.8,58194,218800.8
351860,201802,758,501,257,472232.84,244887.23,717120.07
351870,201802,5630,2657,2973,2524413.64,2829951.75,5354365.39
351880,201802,18950,8302,10648,7897862.21,10142845.01,18040707.22
351885,201802,90,62,28,58433,26712,85145
351890,201802,72,61,11,58194,10494,68688
351900,201802,223,133,90,126215,85860,212075
351905,201802,76,34,42,32436,40068,72504
351907,201802,3107,1360,1747,1293935.02,1664559.8,2958494.82
351910,201802,177,74,103,70596,98262,168858
351920,201802,134,77,57,73458,54355.69,127813.69
351925,201802,87,60,27,57240,25758,82998
351930,201802,388,264,124,251760.6,118296,370056.6
351940,201802,231,105,126,100170,120204,220374
351950,201802,145,84,61,80136,58194,138330
351960,201802,860,399,461,380464.73,437638.36,818103.09
351970,201802,1900,1011,889,962347.84,847811,1810158.84
351980,201802,145,73,72,67734,68688,136422
351990,201802,278,188,90,178398,85058.64,263456.64
352000,201802,361,218,143,207972,136422,344394
352010,201802,350,208,142,198432,135468,333900
352020,201802,197,69,128,65826,122112,187938
352030,201802,1011,522,489,497272.5,464915.96,962188.46
352040,201802,572,249,323,237546,308142,545688
352042,201802,279,95,184,90630,175173,265803
352044,201802,392,235,157,223035.86,149778,372813.86
352050,201802,3150,1286,1864,1219007.98,1776434.26,2995442.24
352060,201802,106,67,39,63918,37206,101124
352070,201802,104,74,30,69326,28620,97946
352080,201802,65,40,25,37206,23850,61056
352090,201802,171,116,55,110664,52470,163134
352100,201802,253,124,129,118292,121914,240206
352110,201802,111,33,78,31482,74412,105894
352115,201802,73,29,44,27666,41976,69642
352120,201802,96,64,32,61056,30528,91584
352130,201802,219,185,34,176299.2,32436,208735.2
352140,201802,181,73,108,69165,103032,172197
352150,201802,121,68,53,63918.04,50562,114480.04
352160,201802,129,86,43,82044,41022,123066
352170,201802,370,252,118,239454.04,112572,352026.04
352180,201802,615,415,200,394956.5,190796,585752.5
352190,201802,262,102,160,97298.46,152601.84,249900.30
352200,201802,34,18,16,17172,15264,32436
352210,201802,3763,1569,2194,1488587.69,2087445.39,3576033.08
352215,201802,54,30,24,28620,22438.08,51058.08
352220,201802,6900,2722,4178,2591860.44,3983320.39,6575180.83
352230,201802,3174,2021,1153,1914950.03,1094253.65,3009203.68
352240,201802,2217,1303,914,1240582.49,869566.18,2110148.67
352250,201802,2596,1352,1244,1285867.7,1183713.66,2469581.36
352260,201802,1085,594,491,564859.23,468128,1032987.23
352265,201802,60,27,33,25758,31482,57240
352270,201802,408,233,175,221328.92,166894,388222.92
352280,201802,392,245,147,232459,140233.23,372692.23
352290,201802,172,109,63,103986,60102,164088
352300,201802,101,76,25,72504,23850,96354
352310,201802,5760,2814,2946,2671369.95,2804175.51,5475545.46
352320,201802,954,501,453,474459.84,430111.1,904570.94
352330,201802,524,236,288,224810.1,274466,499276.1
352340,201802,1393,680,713,646068,678152.5,1324220.5
352350,201802,330,208,122,198432,116102,314534
352360,201802,231,96,135,90677.7,125907.32,216585.02
352370,201802,102,69,33,65826,31482,97308
352380,201802,120,75,45,71550,42930,114480
352390,201802,2428,1108,1320,1053531.32,1258042.75,2311574.07
352400,201802,470,205,265,194616,252523.8,447139.8
352410,201802,751,539,212,509701.88,201962,711663.88
352420,201802,100,64,36,61056,34344,95400
352430,201802,1755,783,972,741929.84,924655.5,1666585.34
352440,201802,3111,1599,1512,1516550.74,1439546.67,2956097.41
352450,201802,189,160,29,152640,27666,180306
352460,201802,562,288,274,274194.68,260681.2,534875.88
352470,201802,593,200,393,190800,374913,565713
352480,201802,1376,771,605,734261.96,576597.8,1310859.76
352490,201802,84,32,52,30528,49608,80136
352500,201802,1209,539,670,512967,638027.2,1150994.2
352510,201802,731,397,334,377784.96,318350,696134.96
352520,201802,537,239,298,228006,284148.9,512154.9
352530,201802,1717,901,816,858886.2,778082.6,1636968.8
352540,201802,75,50,25,47700,23850,71550
352550,201802,181,104,77,99216,72790.2,172006.2
352560,201802,49,39,10,37206,9540,46746
352570,201802,661,343,318,326619,303372,629991
352580,201802,57,38,19,35298.65,18126,53424.65
352585,201802,17,5,12,4770,11448,16218
352590,201802,4307,2176,2131,2069690.52,2032073.41,4101763.93
352600,201802,359,251,108,238500.96,103032,341532.96
352610,201802,931,438,493,416831.22,470322,887153.22
352620,201802,961,389,572,370152.2,544735,914887.2
352630,201802,220,85,135,81090,128541.96,209631.96
352640,201802,560,396,164,375368.4,156456,531824.4
352650,201802,88,57,31,54378,29574,83952
352660,201802,81,48,33,45792,31482,77274
352670,201802,1654,904,750,858922.76,714410.6,1573333.36
352680,201802,882,568,314,538640.56,298094.04,836734.60
352690,201802,4341,1997,2344,1897027.84,2232260.79,4129288.63
352700,201802,106,61,45,57907.8,42930,100837.8
352710,201802,1367,728,639,692604,606644.6,1299248.6
352720,201802,1305,638,667,606108.2,636027.23,1242135.43
352725,201802,26,24,2,22896,1908,24804
352730,201802,363,178,185,168633.81,176490,345123.81
352740,201802,417,263,154,248947.68,146916,395863.68
352750,201802,22,14,8,13069.8,7632,20701.8
352760,201802,199,142,57,135468,54378,189846
352770,201802,81,63,18,60102,17172,77274
352780,201802,80,45,35,42930,33390,76320
352790,201802,28,23,5,21942,4770,26712
352800,201802,249,167,82,159318,77941.8,237259.8
352810,201802,166,109,57,101475.42,54378,155853.42
352820,201802,65,52,13,49182.52,12402,61584.52
352830,201802,89,62,27,59148,25758,84906
352840,201802,588,305,283,289683.2,269982,559665.2
352850,201802,1357,485,872,462022.2,831888,1293910.2
352860,201802,132,86,46,81408,43884,125292
352870,201802,43,27,16,25758,15264,41022
352880,201802,187,127,60,121138.92,57240,178378.92
352885,201802,28,20,8,19080,7632,26712
352890,201802,56,39,17,37206,15932,53138
352900,201802,4911,2373,2538,2245581.68,2413444.59,4659026.27
352910,201802,39,31,8,29574,7632,37206
352920,201802,716,441,275,419760,262350,682110
352930,201802,1262,610,652,580507.82,619038.72,1199546.54
352940,201802,6305,2736,3569,2598238.2,3401619.35,5999857.55
352950,201802,92,37,55,35298,52470,87768
352960,201802,69,45,24,42930,22896,65826
352965,201802,20,8,12,7632,11448,19080
352970,201802,465,350,115,330692.97,108757,439449.97
352980,201802,177,94,83,89676,79182,168858
352990,201802,939,422,517,401585.27,492130.09,893715.36
353000,201802,67,31,36,29574,34344,63918
353010,201802,552,343,209,327222,199366.92,526588.92
353020,201802,287,212,75,202248,71550,273798
353030,201802,1162,526,636,501480.46,606057.66,1107538.12
353040,201802,87,52,35,49608,33390,82998
353050,201802,1307,825,482,779405.03,459732.6,1239137.63
353060,201802,7922,3603,4319,3423017.84,4114092.84,7537110.68
353070,201802,1636,1029,607,975112.46,577787.38,1552899.84
353080,201802,1321,704,617,669279.55,587606.89,1256886.44
353090,201802,56,34,22,32436,20988,53424
353100,201802,62,51,11,48654,10494,59148
353110,201802,1982,607,1375,577346.88,1309114.26,1886461.14
353120,201802,74,40,34,38160,32436,70596
353130,201802,873,437,436,415925.46,415841.76,831767.22
353140,201802,569,224,345,213635,329130,542765
353150,201802,364,204,160,193662,152630.46,346292.46
353160,201802,102,84,18,80136,17172,97308
353170,201802,197,65,132,62010,125900.46,187910.46
353180,201802,952,433,519,410788.69,494602,905390.69
353190,201802,475,341,134,324258.9,127550,451808.9
353200,201802,190,96,94,91584,89676,181260
353205,201802,28,20,8,19080,7632,26712
353210,201802,85,52,33,49608,31482,81090
353215,201802,55,32,23,30528,21942,52470
353220,201802,84,48,36,45792,34344,80136
353230,201802,159,61,98,58194,93492,151686
353240,201802,287,161,126,153594,120204,273798
353250,201802,200,103,97,98262,92538,190800
353260,201802,453,326,127,309869.5,121148.46,431017.96
353270,201802,68,49,19,46746,17458.2,64204.2
353280,201802,95,48,47,45315,44838,90153
353282,201802,122,90,32,85860,30528,116388
353284,201802,22,18,4,17172,3816,20988
353286,201802,1,1,0,954,0,954
353290,201802,81,48,33,45792,31473,77265
353300,201802,399,221,178,209292.46,169812,379104.46
353310,201802,53,47,6,44838,5724,50562
353320,201802,62,39,23,37206,21942,59148
353325,201802,56,36,20,34335,18776,53111
353330,201802,67,51,16,48511,15264,63775
353340,201802,622,195,427,186030,406486.26,592516.26
353350,201802,919,423,496,402722.64,471640.8,874363.44
353360,201802,111,88,23,83634.04,21656,105290.04
353370,201802,120,70,50,65826.1,47700,113526.1
353380,201802,28,20,8,19076,7632,26708
353390,201802,1055,505,550,481770,524700,1006470
353400,201802,53,32,21,30528,20034,50562
353410,201802,122,77,45,73458,42883,116341
353420,201802,59,25,34,23850,32436,56286
353430,201802,552,363,189,342581.3,180019.8,522601.1
353440,201802,10205,4470,5735,4252252.71,5464129.73,9716382.44
353450,201802,56,30,26,28620,24804,53424
353460,201802,610,332,278,313559.1,264487.5,578046.6
353470,201802,2146,1168,978,1110319.85,930597.23,2040917.08
353475,201802,238,161,77,150904.96,73458,224362.96
353480,201802,190,151,39,144054,37206,181260
353490,201802,236,141,95,134514,90630,225144
353500,201802,184,108,76,101792.96,72504,174296.96
353510,201802,101,72,29,68669.46,27656.46,96325.92
353520,201802,209,141,68,134514,64872,199386
353530,201802,473,258,215,246132,205110,451242
353540,201802,353,236,117,224821.27,111618,336439.27
353550,201802,738,500,238,473186.88,227052,700238.88
353560,201802,639,270,369,256014.69,351426.06,607440.75
353570,201802,57,30,27,28620,25758,54378
353580,201802,360,276,84,262827,80136,342963
353590,201802,83,56,27,53106.04,25758,78864.04
353600,201802,266,149,117,141829,110982,252811
353610,201802,115,60,55,57240,52470,109710
353620,201802,570,309,261,292799.5,248707.8,541507.3
353625,201802,50,28,22,26712,20988,47700
353630,201802,240,173,67,160711.16,63918,224629.16
353640,201802,126,86,40,81567,38160,119727
353650,201802,853,331,522,313675.2,497988,811663.2
353657,201802,23,17,6,16218,5724,21942
353660,201802,257,144,113,137376,107515.8,244891.8
353670,201802,750,444,306,422622.2,291924,714546.2
353680,201802,99,70,29,66780,27666,94446
353690,201802,48,38,10,36252,9540,45792
353700,201802,285,199,86,189846,82044,271890
353710,201802,415,196,219,186030.8,208640,394670.8
353715,201802,47,35,12,33103.8,11448,44551.8
353720,201802,355,165,190,157392,181260,338652
353730,201802,1128,692,436,657258.9,415657.8,1072916.7
353740,201802,653,359,294,342199.8,280476,622675.8
353750,201802,93,59,34,55754.14,32436,88190.14
353760,201802,2732,1038,1694,988193.11,1612473.28,2600666.39
353770,201802,101,82,19,77751,18126,95877
353780,201802,1115,562,553,534431.96,525654,1060085.96
353790,201802,509,290,219,274591.1,206041.35,480632.45
353800,201802,3266,1671,1595,1586104.69,1519250.72,3105355.41
353810,201802,238,133,105,126028.71,100143,226171.71
353820,201802,182,91,91,86814,86189.41,173003.41
353830,201802,48,41,7,39114,6678,45792
353850,201802,165,85,80,81090,76320,157410
353860,201802,463,209,254,198670.5,242029.8,440700.3
353870,201802,4996,2509,2487,2377453.7,2361269.4,4738723.1
353880,201802,671,480,191,456584.4,181260.12,637844.52
353890,201802,592,334,258,318064,245846,563910
353900,201802,134,66,68,62964,64872,127836
353910,201802,177,88,89,83952,84906,168858
353920,201802,454,247,207,234446.4,197035.16,431481.56
353930,201802,995,592,403,563075.79,383227.8,946303.59
353940,201802,188,103,85,97498.8,80232,177730.8
353950,201802,511,318,193,303085.8,184113,487198.8
353960,201802,70,58,12,55332,11448,66780
353970,201802,76,47,29,44838,27666,72504
353980,201802,1532,755,777,717610.95,740319.76,1457930.71
353990,201802,75,42,33,40068,31482,71550
354000,201802,377,181,196,172007,186789.2,358796.2
354010,201802,96,51,45,48654,42453,91107
354020,201802,546,345,201,328176,191754,519930
354025,201802,55,43,12,41022,11448,52470
354030,201802,64,35,29,33390,27666,61056
354040,201802,94,66,28,62582.4,26712,89294.4
354050,201802,191,107,84,101792,80136,181928
354060,201802,774,371,403,353934,382221.4,736155.4
354070,201802,872,506,366,480557.99,349164,829721.99
354075,201802,212,116,96,110569,90630.8,201199.8
354080,201802,293,126,167,119917.8,159318,279235.8
354085,201802,18,11,7,10494,6678,17172
354090,201802,312,174,138,165915,131652,297567
354100,201802,5469,2273,3196,2157938.46,3042762.98,5200701.44
354105,201802,80,41,39,39114,37206,76320
354110,201802,47,21,26,20034,24804,44838
354120,201802,149,103,46,98122.97,43884,142006.97
354130,201802,698,468,230,446234,219130,665364
354140,201802,3166,1473,1693,1401275.43,1613864.03,3015139.46
354150,201802,644,399,245,380340.92,232299,612639.92
354160,201802,701,446,255,424291.5,242984,667275.5
354165,201802,19,12,7,11448,6678,18126
354170,201802,174,119,55,112858.2,52470,165328.2
354180,201802,62,38,24,35926,22896,58822
354190,201802,216,99,117,92824.2,111618,204442.2
354200,201802,130,72,58,68211,55332,123543
354210,201802,70,34,36,32436,34344,66780
354220,201802,643,401,242,380747.16,229342.15,610089.31
354230,201802,161,66,95,62964,89676.6,152640.6
354240,201802,318,206,112,195570.49,106211.96,301782.45
354250,201802,91,55,36,52470,34344,86814
354260,201802,1912,897,1015,844833.94,966970,1811803.94
354270,201802,97,72,25,68688,23850,92538
354280,201802,35,18,17,17172,16218,33390
354290,201802,143,99,44,93635.1,41976,135611.1
354300,201802,422,286,136,272527,129586,402113
354310,201802,104,76,28,71550.2,26712,98262.2
354320,201802,183,97,86,92538,82044,174582
354323,201802,16,14,2,13356,1908,15264
354325,201802,108,62,46,58342,43884,102226
354330,201802,2566,866,1700,821529.26,1619629.98,2441159.24
354340,201802,10537,5127,5410,4877838.36,5154794.67,10032633.03
354350,201802,130,87,43,82998,40878.9,123876.9
354360,201802,87,48,39,45792,37206,82998
354370,201802,268,144,124,137376,118296,255672
354380,201802,213,130,83,123234,79182,202416
354390,201802,2755,998,1757,951141.95,1674802.98,2625944.93
354400,201802,326,173,153,164088.8,145389.8,309478.6
354410,201802,609,297,312,281712.43,296694.2,578406.63
354420,201802,270,170,100,162180,95400,257580
354425,201802,321,183,138,174582,131652,306234
354430,201802,186,116,70,109089.9,66016.8,175106.7
354440,201802,40,28,12,26712,11448,38160
354450,201802,53,38,15,36252,14310,50562
354460,201802,102,60,42,57240,40068,97308
354470,201802,39,26,13,24804,12402,37206
354480,201802,120,63,57,60093,54368.46,114461.46
354490,201802,147,92,55,87608.97,52470,140078.97
354500,201802,397,197,200,187938,190800,378738
354510,201802,102,71,31,67734,29574,97308
354515,201802,39,13,26,12402,24804,37206
354520,201802,1616,717,899,681307.2,857207.56,1538514.76
354530,201802,650,340,310,323225.8,294882.2,618108.0
354540,201802,277,157,120,149778,114475.23,264253.23
354550,201802,41,23,18,21942,17172,39114
354560,201802,165,97,68,92252,64862.46,157114.46
354570,201802,138,90,48,85860,45792,131652
354580,201802,1956,930,1026,884357,978504.26,1862861.26
354600,201802,279,149,130,139892.12,124005.69,263897.81
354610,201802,72,65,7,60867.58,6678,67545.58
354620,201802,64,21,43,20034,41022,61056
354625,201802,17,11,6,10494,5720,16214
354630,201802,319,210,109,199834.55,103986,303820.55
354640,201802,790,506,284,478798.36,270936,749734.36
354650,201802,71,40,31,37864.8,29545.92,67410.72
354660,201802,814,603,211,571240.46,201294,772534.46
354670,201802,281,100,181,94161,171721,265882
354680,201802,1248,473,775,451242,738873,1190115
354690,201802,91,62,29,58195,27666,85861
354700,201802,76,56,20,53424,19080,72504
354710,201802,58,40,18,37523.96,17172,54695.96
354720,201802,20,19,1,18126,954,19080
354730,201802,1903,801,1102,760997.2,1051117.2,1812114.4
354740,201802,57,42,15,40068,14310,54378
354750,201802,442,261,181,248985,172674,421659
354760,201802,520,319,201,301944,191181.8,493125.8
354765,201802,11,5,6,4770,5724,10494
354770,201802,334,228,106,216688.03,100360.8,317048.83
354780,201802,8132,3318,4814,3151918.73,4587719.02,7739637.75
354790,201802,113,67,46,63918,43884,107802
354800,201802,417,232,185,221328,176185,397513
354805,201802,103,53,50,49926,47700,97626
354810,201802,137,80,57,76320,54378,130698
354820,201802,184,80,104,76111,99216,175327
354830,201802,40,21,19,20034,18126,38160
354840,201802,55,37,18,35298,17172,52470
354850,201802,4551,2015,2536,1914522.19,2414828.58,4329350.77
354860,201802,330,160,170,152640,159785.52,312425.52
354870,201802,11828,5352,6476,5077907.16,6167781.83,11245688.99
354880,201802,2990,1122,1868,1068750.46,1780476.9,2849227.36
354890,201802,2831,1560,1271,1482724.66,1211494.38,2694219.04
354900,201802,59,39,20,37206,19080,56286
354910,201802,1227,641,586,608614.24,559044,1167658.24
354920,201802,50,42,8,40068,7632,47700
354925,201802,12,7,5,6678,4770,11448
354930,201802,30,27,3,25488,2862,28350
354940,201802,794,586,208,557091.19,198432,755523.19
354950,201802,221,145,76,137720,72504,210224
354960,201802,170,63,107,60102,101792,161894
354970,201802,841,549,292,518887.1,277929.02,796816.12
354980,201802,8410,3137,5273,2984458.29,5027742.98,8012201.27
354990,201802,9174,4323,4851,4111344.73,4621765.74,8733110.47
354995,201802,509,179,330,170766,314362.78,485128.78
355000,201802,450,146,304,139279.23,289062,428341.23
355010,201802,614,390,224,372060,211484.48,583544.48
355020,201802,714,449,265,427387.59,252802,680189.59
355030,201802,203336,78820,124516,74966877.33,118690942,193657819.33
355040,201802,715,339,376,321880.3,358513.2,680393.5
355050,201802,152,100,52,94129.77,49608,143737.77
355060,201802,1490,749,741,709696.94,705722.3,1415419.24
355070,201802,1465,725,740,687826.36,704967,1392793.36
355080,201802,200,115,85,109710,80202.8,189912.8
355090,201802,293,193,100,182024,95400,277424
355100,201802,4765,2367,2398,2236966.12,2285814.36,4522780.48
355110,201802,271,171,100,162177,95400,257577
355120,201802,80,55,25,52470,23850,76320
355130,201802,54,28,26,26712,24804,51516
355140,201802,183,121,62,114718.5,59148,173866.5
355150,201802,674,406,268,386080.2,255195,641275.2
355160,201802,450,217,233,204633.96,221996,426629.96
355170,201802,2050,1065,985,1014630.87,939670.92,1954301.79
355180,201802,624,268,356,254718,338789.25,593507.25
355190,201802,221,150,71,143100,67734,210834
355200,201802,116,68,48,64872,45792,110664
355210,201802,721,412,309,393048,294767.46,687815.46
355220,201802,6601,3535,3066,3361579.76,2916186.9,6277766.66
355230,201802,106,62,44,59148,41971.23,101119.23
355240,201802,4213,1850,2363,1752139.12,2250513.95,4002653.07
355250,201802,5363,2621,2742,2493076.3,2612465.1,5105541.4
355255,201802,52,31,21,29574,20034,49608
355260,201802,186,112,74,105875.12,70568.46,176443.58
355270,201802,164,97,67,92538,63203,155741
355280,201802,6333,2663,3670,2535594.46,3496478.46,6032072.92
355290,201802,78,59,19,56286,18126,74412
355300,201802,180,116,64,109424.6,61056,170480.6
355310,201802,105,59,46,56286,43884,100170
355320,201802,92,46,46,43884,42936.6,86820.6
355330,201802,272,150,122,143100,116388,259488
355340,201802,1485,551,934,523047.61,890293.97,1413341.58
355350,201802,142,74,68,70596,64872,135468
355360,201802,183,116,67,110454.12,63918,174372.12
355365,201802,26,21,5,20034,4770,24804
355370,201802,1032,586,446,553167.74,424226.09,977393.83
355380,201802,767,514,253,488910.52,241076,729986.52
355385,201802,61,43,18,41022,17172,58194
355390,201802,108,62,46,59148,43884,103032
355395,201802,189,114,75,107434.23,71550,178984.23
355400,201802,1548,962,586,913463.52,557231.6,1470695.12
355410,201802,4844,2267,2577,2144441.54,2449982.16,4594423.70
355420,201802,48,36,12,34344,11448,45792
355430,201802,342,209,133,198050.4,126882,324932.4
355440,201802,79,46,33,43884,31482,75366
355450,201802,433,205,228,192670.19,216462.8,409132.99
355460,201802,70,54,16,50562.42,15264,65826.42
355465,201802,50,31,19,29574,18126,47700
355470,201802,185,72,113,67734.1,107802,175536.1
355475,201802,13,8,5,7632,4770,12402
355480,201802,456,200,256,189179,242783.46,431962.46
355490,201802,113,80,33,76320,31482,107802
355495,201802,54,26,28,24804,26712,51516
355500,201802,1681,958,723,909306.46,689703.46,1599009.92
355510,201802,269,194,75,181617.67,71550,253167.67
355520,201802,36,28,8,26426,7632,34058
355530,201802,23,16,7,15264,6678,21942
355535,201802,78,39,39,37206,37206,74412
355540,201802,2356,939,1417,894347.53,1349614.96,2243962.49
355550,201802,64,39,25,37206,23850,61056
355560,201802,238,120,118,114480,111935.96,226415.96
355570,201802,31,20,11,19080,10494,29574
355580,201802,271,189,82,180306,77937.23,258243.23
355590,201802,23,14,9,13356,8586,21942
355600,201802,272,140,132,133560,125637.23,259197.23
355610,201802,206,135,71,128790,67734,196524
355620,201802,1253,583,670,555371.8,638097.98,1193469.78
355630,201802,407,294,113,279523,107802,387325
355635,201802,125,60,65,57240,61997,119237
355640,201802,568,332,236,315774.16,225144,540918.16
355645,201802,828,357,471,339099.3,447454.82,786554.12
355650,201802,2125,893,1232,848478.8,1175309.46,2023788.26
355660,201802,261,139,122,132606,116388,248994
355670,201802,480,189,291,180306,277614,457920
355680,201802,208,119,89,112573,84620,197193
355690,201802,87,40,47,38160,44208,82368
355695,201802,14,12,2,11448,1908,13356
355700,201802,1141,586,555,553974.6,528898,1082872.6
355710,201802,2180,1200,980,1141449.56,934319.8,2075769.36
355715,201802,20,18,2,17172,1908,19080
355720,201802,207,124,83,116706.08,79178,195884.08
355730,201802,90,52,38,48447.95,36252,84699.95
410010,201802,137,115,22,109710,20988,130698
410020,201802,105,94,11,89676,10494,100170
410030,201802,165,105,60,99502.4,57240,156742.4
410040,201802,966,528,438,503473.5,417662,921135.5
410045,201802,26,21,5,20034,4770,24804
410050,201802,467,259,208,247086,197955,445041
410060,201802,275,212,63,202248,60102,262350
410070,201802,308,254,54,242316,51516,293832
410080,201802,166,108,58,103032,55332,158364
410090,201802,77,68,9,64663,8586,73249
410100,201802,297,214,83,203841.18,78466.5,282307.68
410105,201802,46,27,19,25758,18126,43884
410110,201802,312,193,119,184122,113526,297648
410115,201802,26,18,8,17172,7632,24804
410120,201802,444,227,217,216256.8,207018,423274.8
410130,201802,43,26,17,24804,16218,41022
410140,201802,3076,1514,1562,1439431.58,1486800.06,2926231.64
410150,201802,2687,1075,1612,1024397.44,1537538,2561935.44
410160,201802,506,320,186,304993.8,177444,482437.8
410165,201802,67,45,22,42930,20988,63918
410170,201802,167,125,42,117012.44,40068,157080.44
410180,201802,2137,1241,896,1179735.19,852850.15,2032585.34
410185,201802,32,29,3,27666,2862,30528
410190,201802,444,278,166,265212,158364,423576
410200,201802,967,721,246,686984.94,234578.83,921563.77
410210,201802,554,286,268,272844,255100,527944
410220,201802,40,22,18,20988,17172,38160
410230,201802,125,68,57,64872,54378,119250
410240,201802,743,488,255,464979.8,243270,708249.8
410250,201802,374,274,100,260791.84,95395.23,356187.07
410260,201802,289,172,117,164088,111618,275706
410270,201802,29,18,11,17172,10494,27666
410275,201802,68,51,17,48654,16218,64872
410280,201802,325,184,141,175276.52,134514,309790.52
410290,201802,230,145,85,138330,81090,219420
410300,201802,82,66,16,62964,15264,78228
410302,201802,24,16,8,15264,7632,22896
410304,201802,46,32,14,30528,13356,43884
410305,201802,205,111,94,105086.2,89676,194762.2
410310,201802,262,168,94,160272,89656.92,249928.92
410315,201802,52,37,15,35274,14310,49584
410320,201802,139,96,43,91584,41022,132606
410322,201802,34,24,10,22896,9540,32436
410330,201802,163,115,48,109710,45602,155312
410335,201802,100,61,39,58194,37206,95400
410337,201802,38,33,5,31482,4770,36252
410340,201802,30,28,2,26712,1908,28620
410345,201802,213,135,78,128790,74412,203202
410347,201802,51,38,13,36252,12402,48654
410350,201802,232,142,90,135182,85860,221042
410360,201802,455,274,181,258852.4,172102,430954.4
410370,201802,2379,1013,1366,962521.32,1300167.86,2262689.18
410380,201802,219,142,77,135468,73458,208926
410390,201802,370,277,93,264254,88722,352976
410395,201802,34,22,12,20988,11067,32055
410400,201802,838,430,408,408890.4,388693,797583.4
410405,201802,89,66,23,62964,21942,84906
410410,201802,40,31,9,29574,8586,38160
410420,201802,1653,817,836,777323.89,795954.96,1573278.85
410425,201802,181,87,94,82808,89676,172484
410430,201802,2194,1286,908,1223696,865354.32,2089050.32
410440,201802,392,287,105,272845,100170,373015
410442,201802,360,241,119,228961,113526,342487
410445,201802,422,290,132,276660,125928,402588
410450,201802,410,203,207,193662,197478,391140
410460,201802,406,218,188,207676.8,179352,387028.8
410465,201802,190,123,67,116101.8,63918,180019.8
410470,201802,218,140,78,133560,74412,207972
410480,201802,5747,2842,2905,2691494.56,2765255.56,5456750.12
410490,201802,1387,914,473,870281,449335,1319616
410500,201802,265,151,114,144054,108756,252810
410510,201802,180,132,48,125928,45783,171711
410520,201802,262,195,67,186030,63918,249948
410530,201802,235,87,148,82998,141188,224186
410540,201802,318,229,89,217885.6,84901.23,302786.83
410550,201802,1613,702,911,669326.8,867894.36,1537221.16
410560,201802,146,114,32,108756,30528,139284
410570,201802,431,302,129,286020.2,123066,409086.2
410580,201802,3182,1427,1755,1359742.8,1672840,3032582.8
410590,201802,400,284,116,270936,110664,381600
410600,201802,184,159,25,151686,23850,175536
410610,201802,56,45,11,42930,10494,53424
410620,201802,241,174,67,165996,63918,229914
410630,201802,444,261,183,248994,173423,422417
410640,201802,975,599,376,568467.99,357097.28,925565.27
410645,201802,96,72,24,68307,22896,91203
410650,201802,367,252,115,239454,109710,349164
410655,201802,78,60,18,57240,17172,74412
410657,201802,45,20,25,19080,23850,42930
410660,201802,591,418,173,397529,165042,562571
410670,201802,77,62,15,59148,14310,73458
410680,201802,189,156,33,148157,31482,179639
410685,201802,16,10,6,9540,5724,15264
410690,201802,28373,12319,16054,11733148.52,15302204.58,27035353.10
410700,201802,322,235,87,223618,82998,306616
410710,201802,127,102,25,97308,23850,121158
410712,201802,25,16,9,15264,8586,23850
410715,201802,84,62,22,59148,20988,80136
410720,201802,596,361,235,344394,223894.8,568288.8
410725,201802,178,128,50,122112,47700,169812
410730,201802,87,54,33,51516,31482,82998
410740,201802,111,80,31,76320,29574,105894
410750,201802,222,166,56,158360,53419.23,211779.23
410752,201802,24,15,9,14310,8586,22896
410753,201802,53,23,30,21269.43,28620,49889.43
410754,201802,34,21,13,20034,12402,32436
410755,201802,81,55,26,52183.8,24804,76987.8
410760,201802,713,404,309,385416,294786,680202
410765,201802,1665,802,863,758729.68,822148.46,1580878.14
410770,201802,107,90,17,85860,16218,102078
410773,201802,45,34,11,32436,10494,42930
410775,201802,176,133,43,126214.2,41022,167236.2
410780,201802,80,43,37,41022,35298,76320
410785,201802,55,43,12,41022,11448,52470
410790,201802,70,33,37,31482,35298,66780
410800,201802,297,187,110,177445,104940,282385
410810,201802,26,22,4,20988,3530,24518
410820,201802,178,132,46,125785,43884,169669
410830,201802,8495,3871,4624,3683725.79,4408863.49,8092589.28
410832,201802,105,72,33,68401.8,31482,99883.8
410840,201802,1407,782,625,743760.08,595851.68,1339611.76
410845,201802,63,38,25,36252,23850,60102
410850,201802,190,131,59,124688,56286,180974
410855,201802,48,41,7,39114,6678,45792
410860,201802,666,390,276,371274.76,263304,634578.76
410865,201802,105,81,24,77274,22896,100170
410870,201802,154,133,21,126882,19743,146625
410880,201802,1109,554,555,528005.62,529425,1057430.62
410890,201802,75,51,24,48654,22896,71550
410895,201802,74,55,19,52470,18126,70596
410900,201802,19,11,8,10494,7632,18126
410910,201802,17,15,2,14310,1908,16218
410920,201802,33,22,11,20988,10494,31482
410930,201802,504,326,178,310792.98,169812,480604.98
410940,201802,4333,2581,1752,2453112.16,1668201.4,4121313.56
410950,201802,123,88,35,83952,33390,117342
410960,201802,758,338,420,322166,400490,722656
410965,201802,63,48,15,45505.8,14310,59815.8
410970,201802,632,448,184,426924.2,175536,602460.2
410975,201802,106,64,42,60545,40068,100613
410980,201802,1565,708,857,672885.82,816615.23,1489501.05
410990,201802,268,181,87,172505.24,82711.8,255217.04
411000,201802,62,40,22,38160,20988,59148
411005,201802,24,19,5,18126,4770,22896
411007,201802,234,135,99,128790,94446,223236
411010,201802,571,397,174,378738,165996,544734
411020,201802,290,200,90,190800,85860,276660
411030,201802,19,10,9,9540,8586,18126
411040,201802,50,35,15,33390,14310,47700
411050,201802,217,172,45,163410.72,42803.12,206213.84
411060,201802,517,350,167,333891,159318,493209
411065,201802,61,53,8,50562,7632,58194
411070,201802,1197,800,397,759004,377784,1136788
411080,201802,244,172,72,164172,68688,232860
411090,201802,117,88,29,83952,27666,111618
411095,201802,262,106,156,100647,148814,249461
411100,201802,113,94,19,89676,18126,107802
411110,201802,122,85,37,81090,35298,116388
411120,201802,182,136,46,129744,43884,173628
411125,201802,179,80,99,75671.28,94446,170117.28
411130,201802,125,107,18,101440,16885.8,118325.8
411140,201802,178,123,55,117320.12,51945.3,169265.42
411150,201802,1212,815,397,776832.66,378738,1155570.66
411155,201802,117,83,34,79182,32436,111618
411160,201802,21,10,11,9540,10494,20034
411170,201802,58,52,6,49321.8,5724,55045.8
411180,201802,930,611,319,581368,304321.23,885689.23
411190,201802,343,197,146,187270.2,139284,326554.2
411200,201802,668,445,223,423259.89,211835.9,635095.79
411210,201802,682,366,316,347614.21,301464,649078.21
411220,201802,147,112,35,106848,33390,140238
411230,201802,40,36,4,34344,3816,38160
411240,201802,120,81,39,77274,37206,114480
411250,201802,420,306,114,291924,108756,400680
411260,201802,21,15,6,14310,5724,20034
411270,201802,296,161,135,153594,128790,282384
411275,201802,201,177,24,168142.6,22896,191038.6
411280,201802,227,163,64,154231.12,61056,215287.12
411290,201802,58,43,15,41022,14310,55332
411295,201802,143,114,29,108756,27666,136422
411300,201802,70,36,34,34344,32436,66780
411310,201802,91,69,22,65826,20988,86814
411320,201802,755,550,205,523174.4,193967.28,717141.68
411325,201802,44,27,17,25758,16218,41976
411330,201802,919,584,335,555610.61,318859.6,874470.21
411340,201802,25,17,8,16218,7318,23536
411342,201802,76,55,21,52470,20034,72504
411345,201802,123,60,63,57240,60102,117342
411350,201802,480,383,97,364142.14,91575.2,455717.34
411360,201802,55,36,19,34344,18126,52470
411370,201802,14076,5765,8311,5481740.82,7915216.79,13396957.61
411373,201802,192,142,50,135530,47700,183230
411375,201802,74,61,13,58194,12402,70596
411380,201802,93,69,24,65826,22896,88722
411390,201802,136,90,46,85860,43884,129744
411400,201802,351,263,88,250893,83952,334845
411410,201802,448,229,219,217798.2,208640,426438.2
411420,201802,1027,468,559,444182.4,532399,976581.4
411430,201802,404,261,143,248326.2,136413,384739.2
411435,201802,35,23,12,21942,11448,33390
411440,201802,474,377,97,358004.76,92538,450542.76
411450,201802,429,356,73,339624,69642,409266
411460,201802,740,295,445,280485.2,423247.96,703733.16
411470,201802,90,66,24,62964,22896,85860
411480,201802,624,352,272,334282.6,258915.6,593198.2
411490,201802,292,182,110,173628,104940,278568
411500,201802,111,94,17,89363.47,15837,105200.47
411510,201802,217,175,42,166202.06,40068,206270.06
411520,201802,5920,2308,3612,2196867,3437238.03,5634105.03
411530,201802,110,74,36,70596,34344,104940
411535,201802,45,18,27,17172,25758,42930
411540,201802,347,240,107,227937.9,102078,330015.9
411545,201802,55,39,16,37206,15264,52470
411550,201802,74,57,17,54378,16218,70596
411560,201802,384,179,205,170102.38,195570,365672.38
411570,201802,786,301,485,286859,462500,749359
411573,201802,33,20,13,19080,12402,31482
411575,201802,262,161,101,153594,96354,249948
411580,201802,1230,486,744,462337.02,707928.4,1170265.42
411585,201802,78,39,39,37206,37206,74412
411590,201802,24,17,7,16218,6678,22896
411600,201802,26,10,16,9540,15264,24804
411605,201802,239,108,131,102889,124974,227863
411610,201802,237,159,78,151686,74412,226098
411620,201802,358,201,157,191563.2,149139,340702.2
411630,201802,57,38,19,36252,18126,54378
411640,201802,35,29,6,27666,5724,33390
411650,201802,14,10,4,9540,3816,13356
411660,201802,31,25,6,23850,5724,29574
411670,201802,247,188,59,179352,56286,235638
411680,201802,154,132,22,125928,20988,146916
411690,201802,606,322,284,306589.44,270594.72,577184.16
411695,201802,62,46,16,43884,15264,59148
411700,201802,167,145,22,138330,20988,159318
411705,201802,100,65,35,62010,33390,95400
411710,201802,300,202,98,191641.81,93492,285133.81
411720,201802,136,87,49,82998,46746,129744
411721,201802,58,48,10,45792,9540,55332
411722,201802,99,43,56,41022,53424,94446
411725,201802,146,112,34,106532,32436,138968
411727,201802,72,56,16,53424,14977.8,68401.8
411729,201802,31,24,7,22896,6678,29574
411730,201802,545,354,191,336125.96,181928,518053.96
411740,201802,30,19,11,18126,10494,28620
411745,201802,66,44,22,41185,20988,62173
411750,201802,868,411,457,390997.9,435000.15,825998.05
411760,201802,1174,886,288,843995.2,274743,1118738.2
411770,201802,438,293,145,279502.92,138330,417832.92
411780,201802,368,238,130,227052,124020,351072
411790,201802,533,299,234,283364.47,223123.14,506487.61
411800,201802,173,136,37,129744,35298,165042
411810,201802,165,128,37,122112,35298,157410
411820,201802,2099,1024,1075,974587.52,1024826.3,1999413.82
411830,201802,13,13,0,12402,0,12402
411840,201802,1961,1221,740,1162639.8,705467,1868106.8
411845,201802,49,17,32,16218,30528,46746
411850,201802,1247,719,528,683436.08,501759.02,1185195.10
411860,201802,44,28,16,26426,15264,41690
411870,201802,68,49,19,46746,17839.8,64585.8
411880,201802,426,276,150,263048,142355.88,405403.88
411885,201802,104,69,35,65826,33390,99216
411890,201802,324,207,117,195284.99,111608.46,306893.45
411900,201802,69,50,19,47700,18126,65826
411910,201802,167,137,30,130688.46,27780.48,158468.94
411915,201802,2092,903,1189,860309.57,1133242.05,1993551.62
411920,201802,124,102,22,97308,20988,118296
411925,201802,13,8,5,7632,4770,12402
411930,201802,799,590,209,560954,199386,760340
411940,201802,586,420,166,400203,158339.56,558542.56
411950,201802,896,473,423,450574.2,402556.24,853130.44
411960,201802,974,691,283,656842,269982,926824
411965,201802,24,16,8,15264,7632,22896
411970,201802,70,63,7,60102,6678,66780
411980,201802,198,130,68,124020,64872,188892
411990,201802,4912,2867,2045,2718814.77,1948870.6,4667685.37
411995,201802,458,172,286,164088,272844,436932
412000,201802,292,174,118,164804.56,112562.46,277367.02
412010,201802,44,27,17,25758,16218,41976
412015,201802,44,31,13,29574,12402,41976
412020,201802,28,25,3,23563.8,2862,26425.8
412030,201802,64,54,10,51516,9540,61056
412033,201802,55,35,20,33366,19080,52446
412035,201802,66,43,23,41022,21942,62964
412040,201802,36,25,11,23564,10494,34058
412050,201802,200,149,51,142146,48654,190800
412060,201802,750,587,163,557136.74,154511.8,711648.54
412065,201802,51,35,16,33390,15264,48654
412070,201802,154,103,51,97594.2,48654,146248.2
412080,201802,280,147,133,140238,126882,267120
412085,201802,33,16,17,15264,16218,31482
412090,201802,741,465,276,441655.2,263304,704959.2
412100,201802,248,208,40,197479,38160,235639
412110,201802,71,57,14,54378,13069.8,67447.8
412120,201802,312,203,109,193089.6,103986,297075.6
412125,201802,75,45,30,42643.8,28620,71263.8
412130,201802,49,35,14,33390,13356,46746
412135,201802,28,15,13,14310,12402,26712
412140,201802,305,217,88,206378.82,83952,290330.82
412150,201802,259,175,84,165996.04,80136,246132.04
412160,201802,83,48,35,45792,33390,79182
412170,201802,634,452,182,430921.8,173628,604549.8
412175,201802,40,29,11,27666,10494,38160
412180,201802,198,157,41,149178.61,38493.9,187672.51
412190,201802,331,265,66,252137.43,62964,315101.43
412200,201802,191,123,68,117342,64872,182214
412210,201802,73,57,16,54378,15264,69642
412215,201802,244,168,76,159986,72217.8,232203.8
412217,201802,70,55,15,52470,14310,66780
412220,201802,825,618,207,589572,197478,787050
412230,201802,335,203,132,192020.2,125909.46,317929.66
412240,201802,1323,650,673,615656.98,639961.44,1255618.42
412250,201802,380,246,134,234684,127836,362520
412260,201802,126,94,32,89676,30528,120204
412265,201802,168,134,34,127836,32436,160272
412270,201802,84,52,32,49608,30528,80136
412280,201802,89,70,19,66780,18126,84906
412290,201802,92,63,29,60102,27666,87768
412300,201802,216,139,77,132606,73314.9,205920.9
412310,201802,43,36,7,34344,6678,41022
412320,201802,94,80,14,76320,13356,89676
412330,201802,170,151,19,144007,18126,162133
412340,201802,144,100,44,95400,41690,137090
412350,201802,593,294,299,279188.3,285246,564434.3
412360,201802,27,24,3,22896,2862,25758
412370,201802,160,136,24,128790,22896,151686
412380,201802,256,193,63,183835.8,59692.5,243528.3
412382,201802,47,25,22,23850,20988,44838
412385,201802,137,99,38,94446,36252,130698
412390,201802,277,207,70,197478,66780,264258
412395,201802,65,51,14,48654,13356,62010
412400,201802,69,50,19,47700,18126,65826
412402,201802,242,112,130,106843.23,123733.8,230577.03
412405,201802,819,327,492,310500.43,468691.66,779192.09
412410,201802,937,587,350,558472,333900,892372
412420,201802,15,12,3,11448,2862,14310
412430,201802,22,15,7,14310,6678,20988
412440,201802,599,323,276,305829.94,261439.96,567269.90
412450,201802,83,69,14,65826,13356,79182
412460,201802,82,65,17,62010,16218,78228
412470,201802,259,205,54,195570,51516,247086
412480,201802,174,134,40,126882.9,38160,165042.9
412490,201802,166,140,26,133560,24804,158364
412500,201802,476,389,87,369245.8,82998,452243.8
412510,201802,186,153,33,145215,31482,176697
412520,201802,131,70,61,66780,58194,124974
412530,201802,108,58,50,55332,47413.8,102745.8
412535,201802,108,80,28,76302,26712,103014
412540,201802,64,31,33,29574,31482,61056
412545,201802,99,72,27,68688,25758,94446
412550,201802,3498,1581,1917,1504070.74,1827387.9,3331458.64
412555,201802,13,9,4,8586,3816,12402
412560,201802,586,440,146,417170.2,139284,556454.2
412570,201802,731,408,323,387381.24,307856,695237.24
412575,201802,83,58,25,55332,23850,79182
412580,201802,163,111,52,105894,49608,155502
412590,201802,33,31,2,29574,1908,31482
412600,201802,173,131,42,124974,40068,165042
412610,201802,31,19,12,18126,11448,29574
412620,201802,147,128,19,122112,18126,140238
412625,201802,2179,1168,1011,1111470.21,962616.59,2074086.80
412627,201802,69,56,13,53424,12402,65826
412630,201802,426,285,141,270259.2,134228,404487.2
412635,201802,62,20,42,19080,40068,59148
412640,201802,118,79,39,75366,37206,112572
412650,201802,340,212,128,201961.8,122107.23,324069.03
412660,201802,486,293,193,278807,184122,462929
412665,201802,50,44,6,41976,5724,47700
412667,201802,288,194,94,184167.33,89360.92,273528.25
412670,201802,61,51,10,48654,9540,58194
412680,201802,289,227,62,216558,59148,275706
412690,201802,113,74,39,70596,36920,107516
412700,201802,165,111,54,105894,51230,157124
412710,201802,1403,868,535,822350.6,507910,1330260.6
412720,201802,229,156,73,148824,69642,218466
412730,201802,206,163,43,155502,40068,195570
412740,201802,418,225,193,214506.9,184122,398628.9
412750,201802,459,265,194,251856,185076,436932
412760,201802,256,131,125,124974,119250,244224
412770,201802,2080,1180,900,1121336.94,857056.2,1978393.14
412780,201802,149,118,31,112572,29574,142146
412785,201802,267,136,131,129267,124974,254241
412788,201802,35,21,14,20034,13356,33390
412790,201802,141,115,26,109042.2,24804,133846.2
412795,201802,156,117,39,111618,37206,148824
412796,201802,299,207,92,196313.18,87634.44,283947.62
412800,201802,559,366,193,348604.39,184122,532726.39
412810,201802,3003,1670,1333,1588582.45,1270437.03,2859019.48
412820,201802,919,599,320,560609.19,303133.89,863743.08
412830,201802,16,13,3,12402,2862,15264
412840,201802,215,154,61,145962.2,58194,204156.2
412850,201802,776,530,246,504666,234684,739350
412853,201802,174,91,83,86814,79182,165996
412855,201802,221,121,100,114322.82,95400,209722.82
412860,201802,91,68,23,64872,21942,86814
412862,201802,59,44,15,41689.8,14310,55999.8
412863,201802,7,6,1,5724,954,6678
412865,201802,42,32,10,30528,9540,40068
412870,201802,107,71,36,67734,34344,102078
412880,201802,103,77,26,73458,24804,98262
420005,201802,35,32,3,30528,2290,32818
420010,201802,368,241,127,228726.34,121158,349884.34
420020,201802,75,64,11,61056,10494,71550
420030,201802,28,25,3,23850,2862,26712
420040,201802,105,80,25,76320,23850,100170
420050,201802,55,33,22,31482,20988,52470
420055,201802,20,19,1,18126,954,19080
420060,201802,32,23,9,21942,8586,30528
420070,201802,101,87,14,82998,13346.46,96344.46
420075,201802,13,11,2,10494,1908,12402
420080,201802,49,43,6,40115.7,5724,45839.7
420090,201802,35,33,2,30704.49,1908,32612.49
420100,201802,159,133,26,125928.2,24804,150732.2
420110,201802,18,18,0,17172,0,17172
420120,201802,43,32,11,30528,10494,41022
420125,201802,81,64,17,61056,16218,77274
420127,201802,33,30,3,28620,2862,31482
420130,201802,385,247,138,235342.46,131403.96,366746.42
420140,201802,1264,741,523,705529.38,498876,1204405.38
420150,201802,48,41,7,39114,6678,45792
420160,201802,40,38,2,36252,1908,38160
420165,201802,17,13,4,12402,3816,16218
420170,201802,64,42,22,40068,20988,61056
420180,201802,23,22,1,20988,954,21942
420190,201802,31,28,3,26712,2862,29574
420195,201802,125,60,65,57240,61870,119110
420200,201802,1271,567,704,536911.6,670292.04,1207203.64
420205,201802,66,33,33,31482,31482,62964
420207,201802,108,62,46,59148,43874.46,103022.46
420208,201802,23,18,5,17172,3911.4,21083.4
420209,201802,20,16,4,15264,3816,19080
420210,201802,464,220,244,209593.8,232681.14,442274.94
420213,201802,47,37,10,35298,9540,44838
420215,201802,26,22,4,20988,3816,24804
420220,201802,70,45,25,42930,23850,66780
420230,201802,738,427,311,406595,296398.46,702993.46
420240,201802,2271,1534,737,1455868.11,702659.16,2158527.27
420243,201802,36,29,7,27666,6678,34344
420245,201802,102,58,44,55332,41976,97308
420250,201802,54,31,23,29574,21942,51516
420253,201802,40,32,8,30528,7632,38160
420257,201802,11,9,2,8586,1908,10494
420260,201802,99,87,12,82998,11448,94446
420270,201802,36,30,6,28616,5724,34340
420280,201802,280,205,75,193837.06,70292.1,264129.16
420285,201802,20,12,8,11448,7632,19080
420287,201802,50,31,19,29574,18126,47700
420290,201802,974,686,288,653458.18,274684.3,928142.48
420300,201802,1381,1086,295,1031466.4,278958.25,1310424.65
420310,201802,58,44,14,41976,13356,55332
420315,201802,36,32,4,30528,3816,34344
420320,201802,848,429,419,408288.15,399722,808010.15
420325,201802,0,0,0,0,0,0
420330,201802,119,81,38,77274,36137.52,113411.52
420340,201802,155,106,49,100162,46726.92,146888.92
420350,201802,245,179,66,169145,62964,232109
420360,201802,748,571,177,542808.16,167237.78,710045.94
420370,201802,107,69,38,65636,35966,101602
420380,201802,1139,819,320,777502.5,304234.04,1081736.54
420390,201802,252,162,90,153289.52,85144.5,238434.02
420395,201802,187,135,52,128790,49598.46,178388.46
420400,201802,246,181,65,172102,62010,234112
420410,201802,58,45,13,42930,12402,55332
420415,201802,35,32,3,30528,2862,33390
420417,201802,46,34,12,32436,11428.92,43864.92
420419,201802,11,11,0,10494,0,10494
420420,201802,2786,1703,1083,1613666.24,1030598.88,2644265.12
420425,201802,69,59,10,56277,9226.26,65503.26
420430,201802,1273,883,390,839390.72,370314.18,1209704.90
420435,201802,16,14,2,13356,1908,15264
420440,201802,108,74,34,69968.68,32263.6,102232.28
420445,201802,23,21,2,20034,1908,21942
420450,201802,79,37,42,35289,40068,75357
420455,201802,246,187,59,178369.92,56203.92,234573.84
420460,201802,2335,1557,778,1480693.56,741987.9,2222681.46
420470,201802,120,85,35,81090,33390,114480
420475,201802,6,6,0,5724,0,5724
420480,201802,848,633,215,597390.99,204156.2,801547.19
420490,201802,113,88,25,83952,23850,107802
420500,201802,673,285,388,270205.2,370152,640357.2
420510,201802,20,17,3,16218,2862,19080
420515,201802,25,20,5,19080,4770,23850
420517,201802,12,12,0,11448,0,11448
420519,201802,0,0,0,0,0,0
420520,201802,67,50,17,47700,16218,63918
420530,201802,162,110,52,103965.02,49608,153573.02
420535,201802,20,18,2,17172,1908,19080
420540,201802,4752,2808,1944,2666445.28,1849940.98,4516386.26
420543,201802,23,23,0,21942,0,21942
420545,201802,195,139,56,131652,53404.92,185056.92
420550,201802,843,675,168,642005.32,160114.73,802120.05
420555,201802,42,30,12,28620,11448,40068
420560,201802,62,49,13,46364.4,12402,58766.4
420570,201802,141,79,62,75366,59138.46,134504.46
420580,201802,303,133,170,126882,161894,288776
420590,201802,505,358,147,341245.8,140238,481483.8
420600,201802,93,47,46,44838,43884,88722
420610,201802,37,35,2,33104,1908,35012
420620,201802,72,59,13,56286,12402,68688
420630,201802,150,108,42,103028,40064,143092
420640,201802,95,84,11,79674.69,10494,90168.69
420650,201802,236,126,110,119536.2,104321.23,223857.43
420660,201802,55,41,14,38350.8,13356,51706.8
420665,201802,38,29,9,27380,8586,35966
420670,201802,317,238,79,226326.96,75347.46,301674.42
420675,201802,15,14,1,13356,954,14310
420680,201802,36,26,10,24804,9540,34344
420690,201802,176,147,29,140238,27666,167904
420700,201802,620,428,192,408228.3,182944.44,591172.74
420710,201802,146,87,59,82998,55999.8,138997.8
420720,201802,107,87,20,82998,19080,102078
420730,201802,529,338,191,321413.58,180919.12,502332.70
420740,201802,45,44,1,41976,954,42930
420750,201802,493,328,165,312625.8,157410,470035.8
420757,201802,18,15,3,13499.1,2862,16361.1
420760,201802,39,30,9,28620,8586,37206
420765,201802,71,59,12,56286,11448,67734
420768,201802,67,59,8,56286,7632,63918
420770,201802,86,72,14,68688,13356,82044
420775,201802,47,44,3,41022,2862,43884
420780,201802,237,185,52,176480.46,49608,226088.46
420785,201802,13,9,4,8586,3816,12402
420790,201802,179,149,30,141805.8,27638.46,169444.26
420800,201802,77,58,19,54568.8,18126,72694.8
420810,201802,249,214,35,204147,32579.1,236726.1
420820,201802,2308,1380,928,1310167.16,883777.06,2193944.22
420830,201802,558,316,242,299182.83,229904.46,529087.29
420840,201802,145,110,35,104940,32686,137626
420845,201802,451,201,250,191083.07,237260,428343.07
420850,201802,227,180,47,171720,44838,216558
420860,201802,62,53,9,50562,8586,59148
420870,201802,119,87,32,82998,30528,113526
420880,201802,171,118,53,111894.66,50562,162456.66
420890,201802,863,427,436,404269.84,415649,819918.84
420895,201802,10,10,0,9540,0,9540
420900,201802,417,326,91,308945.04,86785.92,395730.96
420910,201802,5810,3254,2556,3094816.25,2434015.01,5528831.26
420915,201802,80,73,7,69642,6678,76320
420917,201802,18,13,5,12402,4770,17172
420920,201802,23,15,8,14310,7632,21942
420930,201802,2616,1588,1028,1507269.58,973888.16,2481157.74
420940,201802,594,434,160,412691.6,150988.08,563679.68
420945,201802,8,6,2,5724,1908,7632
420950,201802,56,50,6,47700,5724,53424
420960,201802,115,89,26,84868.92,24795,109663.92
420970,201802,304,244,60,231100.85,57212.46,288313.31
420980,201802,25,24,1,22896,954,23850
420985,201802,64,55,9,52470,8586,61056
420990,201802,67,52,15,49608,14310,63918
421000,201802,32,21,11,20034,10494,30528
421003,201802,67,44,23,41976,21933,63909
421005,201802,8,5,3,4770,2862,7632
421010,201802,767,543,224,516494.91,211636,728130.91
421020,201802,29,24,5,22896,4770,27666
421030,201802,128,108,20,102699,19080,121779
421040,201802,68,58,10,55332,9540,64872
421050,201802,307,219,88,206827.2,83952,290779.2
421055,201802,25,21,4,20034,3816,23850
421060,201802,83,56,27,53424,25758,79182
421070,201802,51,46,5,43884,4770,48654
421080,201802,35,32,3,30528,2862,33390
421085,201802,24,19,5,18126,4770,22896
421090,201802,42,32,10,30528,9540,40068
421100,201802,126,93,33,88722,31482,120204
421105,201802,218,177,41,168428.8,39090.69,207519.49
421110,201802,111,91,20,86193.9,19080,105273.9
421120,201802,151,119,32,113030.46,30508.92,143539.38
421125,201802,14,10,4,9540,3816,13356
421130,201802,805,518,287,493042.05,272758.54,765800.59
421140,201802,29,21,8,19318.5,7632,26950.5
421145,201802,40,31,9,29574,8586,38160
421150,201802,108,78,30,74412,28620,103032
421160,201802,62,41,21,39104.46,20034,59138.46
421165,201802,19,17,2,16218,1908,18126
421170,201802,191,165,26,156382.84,24795,181177.84
421175,201802,149,97,52,92538,49569.92,142107.92
421180,201802,57,36,21,33982,20034,54016
421185,201802,17,14,3,13356,2862,16218
421187,201802,0,0,0,0,0,0
421189,201802,38,30,8,28620,7622.46,36242.46
421190,201802,1481,909,572,866137,544938.58,1411075.58
421200,201802,88,66,22,62011,20988,82999
421205,201802,24,16,8,15264,7622.46,22886.46
421210,201802,179,121,58,115434,55332,170766
421220,201802,275,218,57,207105.9,54378,261483.9
421223,201802,56,47,9,44838,8586,53424
421225,201802,62,43,19,41022,18126,59148
421227,201802,95,72,23,68688,21942,90630
421230,201802,49,36,13,34344,12402,46746
421240,201802,20,20,0,19080,0,19080
421250,201802,357,220,137,209785,129906.18,339691.18
421260,201802,28,23,5,21942,4770,26712
421265,201802,0,0,0,0,0,0
421270,201802,51,46,5,43884,4770,48654
421280,201802,331,187,144,178112,135658.8,313770.8
421290,201802,316,212,104,202010,97805.76,299815.76
421300,201802,25,20,5,19080,4770,23850
421310,201802,54,41,13,38446.2,12402,50848.2
421315,201802,28,20,8,19080,7632,26712
421320,201802,133,96,37,91584,35298,126882
421330,201802,110,86,24,79639.92,22887,102526.92
421335,201802,40,26,14,24804,13356,38160
421340,201802,292,198,94,187024.05,89676,276700.05
421350,201802,168,100,68,94957,64872,159829
421360,201802,689,507,182,477339.72,173419.46,650759.18
421370,201802,189,144,45,137376,42596.1,179972.1
421380,201802,132,106,26,101119.23,24804,125923.23
421390,201802,18,14,4,13356,3816,17172
421400,201802,113,95,18,90630,17172,107802
421410,201802,23,18,5,17172,4770,21942
421415,201802,21,20,1,19080,954,20034
421420,201802,148,122,26,115815.6,24517.8,140333.4
421430,201802,14,11,3,10494,2862,13356
421440,201802,61,47,14,44838,13356,58194
421450,201802,98,85,13,81090,12402,93492
421460,201802,60,51,9,47849.77,8586,56435.77
421470,201802,69,45,24,42930,22896,65826
421480,201802,632,467,165,445041,157401,602442
421490,201802,22,21,1,19358,954,20312
421500,201802,514,330,184,313732.69,175258.44,488991.13
421505,201802,25,18,7,17172,6678,23850
421507,201802,32,26,6,24804,5724,30528
421510,201802,72,46,26,43884,24422.4,68306.4
421520,201802,64,56,8,52661,7632,60293
421530,201802,54,49,5,46746,4770,51516
421535,201802,29,28,1,26445,954,27399
421540,201802,60,52,8,49608,7632,57240
421545,201802,98,76,22,72018,20988,93006
421550,201802,284,207,77,196811,73458,270269
421555,201802,27,22,5,20988,4675,25663
421560,201802,7,7,0,6678,0,6678
421565,201802,124,92,32,87768,30528,118296
421567,201802,29,24,5,22896,4770,27666
421568,201802,33,31,2,29574,1908,31482
421569,201802,8,8,0,7632,0,7632
421570,201802,141,95,46,90630,43884,134514
421575,201802,27,22,5,20725.65,4770,25495.65
421580,201802,718,435,283,413368.8,269028.34,682397.14
421590,201802,20,19,1,18126,954,19080
421600,201802,110,76,34,72504,31197,103701
421605,201802,103,74,29,70263,27666,97929
421610,201802,188,148,40,141192,38160,179352
421620,201802,1103,660,443,627140.92,422602.92,1049743.84
421625,201802,21,18,3,17172,2862,20034
421630,201802,276,177,99,168811,93588,262399
421635,201802,17,8,9,7632,8586,16218
421640,201802,101,87,14,82998,13356,96354
421650,201802,276,160,116,152620.92,110644.92,263265.84
421660,201802,2077,1248,829,1187389.2,790552.26,1977941.46
421670,201802,179,128,51,122112,48654,170766
421680,201802,166,151,15,144054,14301,158355
421690,201802,350,243,107,230841,101114.58,331955.58
421700,201802,57,35,22,33390,20130,53520
421710,201802,25,25,0,23850,0,23850
421715,201802,11,10,1,9540,954,10494
421720,201802,586,423,163,400925.4,153775.26,554700.66
421725,201802,14,7,7,6678,6678,13356
421730,201802,42,29,13,26936.24,12402,39338.24
421740,201802,83,40,43,38160,41022,79182
421750,201802,217,160,57,150040.28,54378,204418.28
421755,201802,24,23,1,21942,954,22896
421760,201802,101,71,30,67724.46,28620,96344.46
421770,201802,567,380,187,360322.38,178332.3,538654.68
421775,201802,25,16,9,15264,8586,23850
421780,201802,193,153,40,145962,38160,184122
421790,201802,153,128,25,121873.5,23850,145723.5
421795,201802,17,14,3,13356,2862,16218
421800,201802,464,300,164,285403.31,156456,441859.31
421810,201802,66,53,13,50562,12402,62964
421820,201802,298,203,95,192994.2,90630,283624.2
421825,201802,127,106,21,101124,20034,121158
421830,201802,126,97,29,92538,27666,120204
421835,201802,3,3,0,2862,0,2862
421840,201802,61,51,10,48645,9540,58185
421850,201802,78,68,10,64872,9536,74408
421860,201802,40,32,8,30311.14,7632,37943.14
421870,201802,978,739,239,696104.64,227148.98,923253.62
421875,201802,52,46,6,43884,5724,49608
421880,201802,161,117,44,111618,41690,153308
421885,201802,28,23,5,21942,4770,26712
421890,201802,111,78,33,74412,31482,105894
421895,201802,39,36,3,34344,2862,37206
421900,201802,149,123,26,117267.3,24759,142026.3
421910,201802,65,43,22,41022,20988,62010
421915,201802,32,26,6,24804,5724,30528
421917,201802,40,29,11,27666,10494,38160
421920,201802,32,29,3,27666,2862,30528
421930,201802,747,576,171,547777.26,163097.46,710874.72
421935,201802,57,50,7,47700,6678,54378
421940,201802,38,36,2,34344,1908,36252
421950,201802,824,544,280,513037.86,264624.32,777662.18
421960,201802,39,35,4,33104,3816,36920
421970,201802,375,236,139,224645.12,132575.12,357220.24
421985,201802,29,19,10,18126,9540,27666
422000,201802,0,0,0,0,0,0
430003,201802,204,48,156,45076.5,148824,193900.5
430005,201802,36,28,8,26712,7632,34344
430010,201802,280,197,83,187461,79182,266643
430020,201802,151,98,53,93206,49608,142814
430030,201802,127,99,28,94159.8,26712,120871.8
430040,201802,2983,1735,1248,1647125.23,1188962.48,2836087.71
430045,201802,69,59,10,56000,9540,65540
430047,201802,6,5,1,4770,954,5724
430050,201802,81,68,13,64872,12402,77274
430055,201802,17,14,3,13356,2862,16218
430057,201802,4,2,2,1908,1908,3816
430060,201802,3688,2195,1493,2086786.72,1420777.58,3507564.30
430063,201802,57,52,5,49608,4770,54378
430064,201802,146,123,23,117342,21942,139284
430066,201802,10,7,3,6678,2862,9540
430070,201802,45,33,12,31482,11448,42930
430080,201802,69,48,21,45092.33,20034,65126.33
430085,201802,37,11,26,10494,24804,35298
430087,201802,33,25,8,23707,7632,31339
430090,201802,71,64,7,60769.8,6678,67447.8
430100,201802,116,76,40,71550,38160,109710
430105,201802,145,73,72,69642,68382.72,138024.72
430107,201802,21,15,6,14310,5724,20034
430110,201802,410,237,173,225287.1,164975.22,390262.32
430120,201802,138,126,12,119250.9,11448,130698.9
430130,201802,797,502,295,478001.7,281143.8,759145.5
430140,201802,124,114,10,108756,9540,118296
430150,201802,112,73,39,68879,36252,105131
430155,201802,33,30,3,28620,2862,31482
430160,201802,3807,2246,1561,2122271,1485120.62,3607391.62
430163,201802,326,144,182,136231.94,173570.76,309802.70
430165,201802,24,16,8,15264,7632,22896
430170,201802,80,72,8,68688,7632,76320
430175,201802,81,63,18,60102,16504.2,76606.2
430180,201802,96,76,20,72504,18459.9,90963.9
430185,201802,31,23,8,21942,7632,29574
430187,201802,102,43,59,41022,55980.8,97002.8
430190,201802,225,127,98,121110.3,92815.46,213925.76
430192,201802,14,14,0,13356,0,13356
430195,201802,13,8,5,7632,4770,12402
430200,201802,164,146,18,138616.2,17172,155788.2
430205,201802,20,19,1,18126,954,19080
430210,201802,625,486,139,459923.4,131318.3,591241.7
430215,201802,16,12,4,11448,3816,15264
430220,201802,64,45,19,42930,18126,61056
430222,201802,14,7,7,6678,6678,13356
430223,201802,15,8,7,7632,6678,14310
430225,201802,4,3,1,2862,954,3816
430230,201802,303,187,116,177444,110664,288108
430235,201802,52,38,14,36252,13346.46,49598.46
430237,201802,29,21,8,20034,7632,27666
430240,201802,131,84,47,79904.56,44838,124742.56
430245,201802,70,59,11,56286,10494,66780
430250,201802,190,109,81,103976.46,77264.46,181240.92
430258,201802,13,11,2,10494,1908,12402
430260,201802,35,30,5,28620,4760.46,33380.46
430265,201802,34,29,5,27646.92,4770,32416.92
430270,201802,560,412,148,389658.54,139381.02,529039.56
430280,201802,1036,632,404,599293.26,382916.6,982209.86
430290,201802,379,221,158,208926.8,150732,359658.8
430300,201802,2112,1166,946,1106575.12,899424.81,2005999.93
430310,201802,1971,1038,933,983204.4,886983.23,1870187.63
430320,201802,49,41,8,39099.69,7632,46731.69
430330,201802,97,88,9,83475,8586,92061
430340,201802,66,59,7,56286,6678,62964
430350,201802,1667,1158,509,1093256.38,482698.6,1575954.98
430355,201802,25,22,3,20988,2862,23850
430360,201802,79,39,40,37206,37873.8,75079.8
430367,201802,26,19,7,18126,6678,24804
430370,201802,54,47,7,44838,6678,51516
430380,201802,130,98,32,92919.6,30528,123447.6
430390,201802,615,382,233,364141.8,221977.46,586119.26
430400,201802,136,106,30,99406.8,28600.92,128007.72
430410,201802,60,47,13,44838,12402,57240
430420,201802,491,322,169,304708.8,158523.62,463232.42
430430,201802,55,52,3,48972.63,2862,51834.63
430435,201802,158,120,38,113526,35536.5,149062.5
430440,201802,498,331,167,315774,159127.2,474901.2
430450,201802,1201,991,210,938832.14,200330.46,1139162.60
430460,201802,5104,2780,2324,2636239.85,2212533.85,4848773.70
430461,201802,17,15,2,14310,1908,16218
430462,201802,11,7,4,6678,3816,10494
430463,201802,1022,541,481,513681.38,458522.1,972203.48
430465,201802,28,16,12,15264,11448,26712
430466,201802,659,478,181,454104.2,172483.2,626587.4
430467,201802,100,59,41,55045.8,39104.46,94150.26
430468,201802,109,68,41,64872,38862.91,103734.91
430469,201802,23,17,6,16218,5724,21942
430470,201802,1173,646,527,609518.39,500802.3,1110320.69
430471,201802,48,36,12,34324.92,11448,45772.92
430480,201802,92,57,35,53519.4,33380.46,86899.86
430485,201802,6,6,0,5438,0,5438
430490,201802,89,71,18,66923.7,17172,84095.7
430495,201802,37,29,8,27666,7632,35298
430500,201802,192,131,61,124974,57818.46,182792.46
430510,201802,3070,2045,1025,1945377.8,976963.32,2922341.12
430511,201802,18,18,0,17172,0,17172
430512,201802,136,94,42,89676,40068,129744
430513,201802,53,46,7,43407,6678,50085
430515,201802,32,30,2,28620,1908,30528
430517,201802,169,149,20,141192,19060.92,160252.92
430520,201802,364,249,115,236879,109681.38,346560.38
430530,201802,90,53,37,50562,35298,85860
430535,201802,475,317,158,302218.43,150708.15,452926.58
430537,201802,10,10,0,9540,0,9540
430540,201802,70,47,23,44838,21942,66780
430543,201802,372,115,257,109710,245178,354888
430544,201802,43,39,4,37206,3816,41022
430545,201802,344,163,181,155483,172177.92,327660.92
430550,201802,42,34,8,32436,7632,40068
430558,201802,6,4,2,3816,1908,5724
430560,201802,46,20,26,19080,24804,43884
430570,201802,108,47,61,44838,58136.76,102974.76
430580,201802,125,97,28,92538,26664.3,119202.3
430583,201802,14,14,0,13356,0,13356
430585,201802,9,4,5,3816,4770,8586
430587,201802,14,8,6,7632,5724,13356
430590,201802,153,127,26,119917.8,24804,144721.8
430593,201802,4,4,0,3816,0,3816
430595,201802,17,12,5,11448,4770,16218
430597,201802,51,26,25,24804,23850,48654
430600,201802,214,149,65,142136.46,61723.8,203860.26
430605,201802,162,100,62,95400,59138.46,154538.46
430607,201802,26,21,5,20034,4770,24804
430610,201802,1645,769,876,730489.3,830705.78,1561195.08
430613,201802,2,2,0,1908,0,1908
430620,201802,113,81,32,77131,30518.46,107649.46
430630,201802,45,40,5,38160,4770,42930
430632,201802,31,26,5,24804,4770,29574
430635,201802,40,36,4,34344,3816,38160
430637,201802,56,31,25,29574,23850,53424
430640,201802,207,114,93,107897.4,88722,196619.4
430642,201802,28,26,2,24804,1908,26712
430645,201802,33,29,4,27666,3816,31482
430650,201802,256,206,50,196238,47652.3,243890.3
430655,201802,4,4,0,3816,0,3816
430660,201802,961,470,491,446805.9,466887.8,913693.7
430670,201802,71,51,20,48654,19080,67734
430673,201802,74,41,33,39114,31482,70596
430675,201802,13,10,3,9540,2862,12402
430676,201802,489,303,186,288337.04,177373.07,465710.11
430680,201802,250,176,74,165710,70596,236306
430690,201802,527,306,221,291018.24,209178.14,500196.38
430692,201802,7,5,2,4770,1908,6678
430693,201802,139,93,46,88722,43874.46,132596.46
430695,201802,73,66,7,62029.08,6678,68707.08
430697,201802,60,35,25,33390,23850,57240
430700,201802,1595,1117,478,1052710.42,456012,1508722.42
430705,201802,19,18,1,17172,954,18126
430710,201802,260,168,92,160272,87768,248040
430720,201802,109,92,17,87577.2,16218,103795.2
430730,201802,120,103,17,97308,16218,113526
430740,201802,65,43,22,41022,20988,62010
430745,201802,36,29,7,27380,6678,34058
430750,201802,338,229,109,217522.64,103032,320554.64
430755,201802,83,46,37,43884,35298,79182
430760,201802,371,225,146,211979.72,139255.92,351235.64
430770,201802,1471,756,715,719106.32,677653.27,1396759.59
430780,201802,314,200,114,189818.72,108689.76,298508.48
430781,201802,28,23,5,21942,4770,26712
430783,201802,50,40,10,37842.13,9540,47382.13
430786,201802,6,3,3,2862,2862,5724
430790,201802,488,315,173,299238.12,164746.46,463984.58
430800,201802,151,126,25,120204,23850,144054
430805,201802,42,38,4,36252,3816,40068
430807,201802,35,21,14,20034,13356,33390
430810,201802,73,47,26,44838,24804,69642
430820,201802,134,84,50,80136,47032.2,127168.2
430825,201802,13,11,2,10494,1908,12402
430830,201802,232,218,14,207666.92,13356,221022.92
430840,201802,125,84,41,80136,38446.2,118582.2
430843,201802,5,3,2,2862,1908,4770
430845,201802,69,39,30,37206,28620,65826
430850,201802,569,391,178,371840.58,169680.68,541521.26
430860,201802,156,99,57,93778.2,53700.66,147478.86
430865,201802,63,31,32,28906.2,30213.18,59119.38
430870,201802,78,64,14,61056,13356,74412
430880,201802,160,120,40,114460.92,38160,152620.92
430885,201802,7,6,1,5724,954,6678
430890,201802,333,204,129,192956.04,123066,316022.04
430900,201802,541,372,169,350690.4,160739.46,511429.86
430905,201802,82,32,50,30528,47700,78228
430910,201802,268,150,118,143100,111896,254996
430912,201802,3,3,0,2862,0,2862
430915,201802,35,27,8,25758,7345.8,33103.8
430920,201802,4196,2351,1845,2236775.27,1757728.52,3994503.79
430925,201802,5,4,1,3567.96,954,4521.96
430930,201802,2094,1243,851,1178106.42,810653.43,1988759.85
430940,201802,237,150,87,142422.66,82978.92,225401.58
430950,201802,160,130,30,124020,28620,152640
430955,201802,22,14,8,13356,7632,20988
430957,201802,18,17,1,16218,954,17172
430960,201802,238,157,81,147345.3,77274,224619.3
430965,201802,104,65,39,62010,37206,99216
430970,201802,78,65,13,62010,11448,73458
430975,201802,33,31,2,29574,1908,31482
430980,201802,43,26,17,24804,16218,41022
430990,201802,109,83,26,79182,24804,103986
430995,201802,113,108,5,101791.8,4770,106561.8
431000,201802,295,135,160,126643.2,152640,279283.2
431010,201802,340,205,135,194587.38,128742.3,323329.68
431020,201802,1923,1113,810,1053240.42,768628.26,1821868.68
431030,201802,43,34,9,32436,8586,41022
431033,201802,386,190,196,180449.2,186984,367433.2
431036,201802,16,9,7,8586,6678,15264
431040,201802,131,79,52,74412,49498.29,123910.29
431041,201802,37,25,12,23850,11448,35298
431043,201802,46,27,19,25758,18126,43884
431046,201802,12,7,5,6678,4770,11448
431050,201802,207,131,76,124687.8,71502.3,196190.1
431053,201802,74,44,30,41212.8,28620,69832.8
431055,201802,63,42,21,40068,20014.92,60082.92
431057,201802,17,17,0,16218,0,16218
431060,201802,1694,1063,631,1006586.66,600112.9,1606699.56
431065,201802,17,10,7,9540,6678,16218
431070,201802,73,68,5,64872,4770,69642
431075,201802,8,8,0,7632,0,7632
431080,201802,135,88,47,83665.8,44838,128503.8
431085,201802,30,27,3,25758,2862,28620
431087,201802,14,12,2,11448,1908,13356
431090,201802,56,44,12,41976,11448,53424
431100,201802,1223,726,497,681540.82,474138,1155678.82
431110,201802,245,153,92,145962,87758.46,233720.46
431112,201802,29,17,12,16218,11448,27666
431113,201802,30,20,10,19080,9540,28620
431115,201802,152,104,48,98579.87,45782.46,144362.33
431120,201802,619,364,255,345310.64,243193.84,588504.48
431123,201802,3,2,1,1908,954,2862
431125,201802,91,81,10,77274,9540,86814
431127,201802,7,3,4,2862,3816,6678
431130,201802,619,399,220,379405.8,209574.72,588980.52
431140,201802,731,497,234,470465.4,223159.68,693625.08
431142,201802,33,25,8,22638,7632,30270
431150,201802,205,152,53,145008,50552.46,195560.46
431160,201802,56,50,6,47700,5724,53424
431162,201802,19,14,5,13356,4770,18126
431164,201802,4,4,0,3816,0,3816
431170,201802,102,84,18,80136,17172,97308
431171,201802,49,27,22,25758,20978.46,46736.46
431173,201802,1,1,0,954,0,954
431175,201802,203,100,103,94160,98252.46,192412.46
431177,201802,75,57,18,54378,16485.92,70863.92
431179,201802,11,10,1,9540,954,10494
431180,201802,436,263,173,250902,164943.46,415845.46
431190,201802,87,66,21,62964,20034,82998
431198,201802,72,48,24,45792,22896,68688
431200,201802,20,17,3,16218,2862,19080
431205,201802,23,23,0,21942,0,21942
431210,201802,87,53,34,50229,32436,82665
431213,201802,28,23,5,21942,4770,26712
431215,201802,26,23,3,21942,2862,24804
431217,201802,5,4,1,3816,954,4770
431220,201802,67,58,9,55332,8586,63918
431225,201802,149,99,50,94437,47690.46,142127.46
431230,201802,99,87,12,82998,11448,94446
431235,201802,7,7,0,6678,0,6678
431237,201802,25,16,9,15264,8586,23850
431238,201802,15,11,4,10208,3816,14024
431240,201802,989,635,354,604130.64,337200.84,941331.48
431242,201802,34,34,0,32436,0,32436
431244,201802,11,8,3,7632,2862,10494
431245,201802,61,47,14,44838,13356,58194
431247,201802,13,10,3,9540,2862,12402
431250,201802,267,137,130,130631.22,123333.92,253965.14
431260,201802,60,43,17,41022,16218,57240
431261,201802,21,14,7,13356,6678,20034
431262,201802,15,15,0,14310,0,14310
431265,201802,163,86,77,82044,73458,155502
431267,201802,14,13,1,12402,954,13356
431270,201802,316,265,51,252810,48654,301464
431275,201802,41,39,2,37206,1908,39114
431280,201802,21,17,4,15383.25,3816,19199.25
431290,201802,20,17,3,16218,2862,19080
431295,201802,5,5,0,4770,0,4770
431300,201802,22,19,3,18126,2862,20988
431301,201802,7,7,0,6678,0,6678
431303,201802,51,34,17,32311.98,15931.8,48243.78
431306,201802,225,119,106,113069.98,101124,214193.98
431308,201802,6,5,1,4770,954,5724
431310,201802,62,53,9,50562,8586,59148
431320,201802,121,70,51,66780,48358.26,115138.26
431330,201802,179,118,61,112572,58194,170766
431333,201802,33,27,6,25758,5724,31482
431335,201802,10,5,5,4770,4770,9540
431337,201802,323,151,172,143224.2,163057.88,306282.08
431339,201802,21,18,3,17172,2862,20034
431340,201802,3053,1761,1292,1676069.96,1229451.82,2905521.78
431342,201802,45,28,17,26712,16218,42930
431344,201802,18,17,1,16218,954,17172
431346,201802,4,4,0,3816,0,3816
431349,201802,36,33,3,31482,2862,34344
431350,201802,902,530,372,501071.66,353228.04,854299.70
431360,201802,45,39,6,37206,5724,42930
431365,201802,311,148,163,141172.92,154538.46,295711.38
431370,201802,1327,786,541,746209.93,515926.98,1262136.91
431380,201802,97,84,13,80136,12402,92538
431390,201802,496,276,220,262273.88,209336.22,471610.10
431395,201802,282,122,160,116388,152621,269009
431400,201802,39,30,9,28620,8586,37206
431402,201802,94,65,29,62010,27666,89676
431403,201802,16,11,5,10494,4770,15264
431405,201802,650,351,299,333214.02,285219,618433.02
431406,201802,32,28,4,26712,3816,30528
431407,201802,51,41,10,39114,9540,48654
431410,201802,3224,1917,1307,1816024.29,1243947.9,3059972.19
431413,201802,15,13,2,12402,1908,14310
431415,201802,73,52,21,49608,20034,69642
431417,201802,22,11,11,10494,10494,20988
431420,201802,303,214,89,203519.96,84906,288425.96
431430,201802,42,17,25,16218,23850,40068
431440,201802,8959,6392,2567,6027030.26,2440271.29,8467301.55
431442,201802,27,14,13,13356,12402,25758
431445,201802,26,20,6,19080,5724,24804
431446,201802,7,6,1,5724,954,6678
431447,201802,84,59,25,56286,23850,80136
431449,201802,51,44,7,41976,6678,48654
431450,201802,412,286,126,271079.1,119488.5,390567.6
431454,201802,0,0,0,0,0,0
431455,201802,49,38,11,36252,10494,46746
431460,201802,525,363,162,343535.4,154261.8,497797.2
431470,201802,117,92,25,87076.54,23600,110676.54
431475,201802,11,10,1,9540,954,10494
431477,201802,35,25,10,23850,9540,33390
431478,201802,8,7,1,6678,954,7632
431480,201802,496,316,180,299852.7,171672.3,471525.0
431490,201802,28159,15988,12171,15177186.33,11577711.97,26754898.30
431500,201802,78,52,26,49608,24804,74412
431505,201802,36,20,16,19080,15264,34344
431507,201802,11,9,2,8586,1908,10494
431510,201802,278,182,96,172912.8,90610.92,263523.72
431513,201802,22,17,5,16218,4770,20988
431514,201802,8,7,1,6678,954,7632
431515,201802,79,66,13,62964,12402,75366
431517,201802,4,2,2,1908,1908,3816
431520,201802,37,33,4,31482,3816,35298
431530,201802,1600,714,886,680106.84,844781.93,1524888.77
431531,201802,23,21,2,20034,1908,21942
431532,201802,25,17,8,16218,7632,23850
431535,201802,25,16,9,15264,8586,23850
431540,201802,137,122,15,115367.22,14310,129677.22
431545,201802,18,16,2,15264,1908,17172
431550,201802,349,205,144,195570,137280.6,332850.6
431555,201802,12,11,1,10494,954,11448
431560,201802,4431,3137,1294,2962708.52,1232206.38,4194914.90
431570,201802,781,413,368,390854.2,348201.46,739055.66
431575,201802,36,25,11,23850,10494,34344
431580,201802,96,68,28,63918,26712,90630
431590,201802,138,115,23,108756,21942,130698
431595,201802,12,11,1,10494,954,11448
431600,201802,220,127,93,121158,88722,209880
431610,201802,128,93,35,88054.2,33390,121444.2
431620,201802,42,34,8,32436,7632,40068
431630,201802,136,115,21,109710,20034,129744
431640,201802,1330,827,503,783520.62,478278.44,1261799.06
431642,201802,41,37,4,34821,3816,38637
431643,201802,44,20,24,19080,22896,41976
431645,201802,301,173,128,165042,121158,286200
431647,201802,11,11,0,10494,0,10494
431650,201802,37,28,9,26712,8586,35298
431660,201802,282,185,97,174371.04,92538,266909.04
431670,201802,219,104,115,96592.5,109681.38,206273.88
431673,201802,3,3,0,2862,0,2862
431675,201802,29,24,5,22609.8,4770,27379.8
431680,201802,1091,781,310,741258,294691.68,1035949.68
431690,201802,4760,2913,1847,2757705.32,1758110.22,4515815.54
431695,201802,26,20,6,19080,5724,24804
431697,201802,0,0,0,0,0,0
431700,201802,167,127,40,121158,38160,159318
431710,201802,3994,1717,2277,1635338,2171768.48,3807106.48
431720,201802,1393,825,568,779168.38,540904.46,1320072.84
431725,201802,1,1,0,954,0,954
431730,201802,1194,809,385,765091.1,367290,1132381.1
431740,201802,1364,683,681,646964.72,649123.58,1296088.30
431750,201802,1878,1218,660,1150742.3,627703.92,1778446.22
431755,201802,6,5,1,4770,954,5724
431760,201802,1087,692,395,659786.4,376601.58,1036387.98
431770,201802,393,287,106,273788.46,101104.92,374893.38
431775,201802,27,21,6,20034,5724,25758
431780,201802,557,343,214,326105.82,204146.46,530252.28
431790,201802,150,112,38,105894,36204.3,142098.3
431795,201802,14,12,2,11448,1908,13356
431800,201802,3388,1774,1614,1681013.42,1532838.4,3213851.82
431805,201802,16,15,1,14310,954,15264
431810,201802,616,415,201,393276.96,191620.98,584897.94
431820,201802,315,176,139,167904,131604.3,299508.3
431830,201802,2335,1412,923,1343347.42,879281.65,2222629.07
431840,201802,513,341,172,321690.4,162848,484538.4
431842,201802,34,28,6,26712,5724,32436
431843,201802,12,7,5,6678,4770,11448
431844,201802,15,13,2,12402,1908,14310
431845,201802,30,27,3,25758,2862,28620
431846,201802,29,25,4,23850,3816,27666
431848,201802,14,12,2,11448,1908,13356
431849,201802,8,6,2,5724,1908,7632
431850,201802,803,667,136,634805.51,129505.5,764311.01
431860,201802,104,75,29,71550,26712,98262
431861,201802,4,2,2,1908,1908,3816
431862,201802,51,33,18,31482,17172,48654
431870,201802,3468,2044,1424,1941517.96,1356898.42,3298416.38
431880,201802,940,689,251,652508,238500,891008
431890,201802,1300,805,495,762933.74,470623,1233556.74
431900,201802,185,129,56,123066,52632.18,175698.18
431910,201802,57,42,15,40068,14310,54378
431912,201802,35,19,16,18126,15264,33390
431915,201802,129,103,26,98262,24804,123066
431920,201802,144,107,37,101791.8,35298,137089.8
431930,201802,87,71,16,67734,15264,82998
431935,201802,4,3,1,2862,954,3816
431936,201802,12,11,1,10494,954,11448
431937,201802,18,13,5,12402,4770,17172
431940,201802,445,298,147,281525.4,140228.46,421753.86
431950,201802,465,298,167,283052.88,159185.52,442238.40
431960,201802,714,422,292,398402.02,278406.9,676808.92
431970,201802,73,64,9,61056,8586,69642
431971,201802,2,2,0,1908,0,1908
431973,201802,19,16,3,15264,2862,18126
431975,201802,6,5,1,4770,954,5724
431980,201802,198,124,74,116769.6,70596,187365.6
431990,201802,1228,654,574,622442.99,547550,1169992.99
432000,201802,1680,905,775,856276.44,735786.04,1592062.48
432010,201802,276,184,92,174422.96,87768,262190.96
432020,201802,174,137,37,130698,35288.46,165986.46
432023,201802,20,16,4,15264,3816,19080
432026,201802,65,58,7,55332,6678,62010
432030,201802,62,28,34,26712,32436,59148
432032,201802,22,19,3,18126,2862,20988
432035,201802,47,37,10,35298,9540,44838
432040,201802,98,67,31,63918,29574,93492
432045,201802,8,7,1,6678,954,7632
432050,201802,69,42,27,40068,25758,65826
432055,201802,100,73,27,69622.92,25758,95380.92
432057,201802,1,0,1,0,954,954
432060,201802,38,35,3,32674.5,2862,35536.5
432065,201802,30,28,2,26712,1908,28620
432067,201802,90,79,11,75346.92,10494,85840.92
432070,201802,400,303,97,287460.18,92509.92,379970.10
432080,201802,814,558,256,530633.88,244157.3,774791.18
432085,201802,16,12,4,11448,3816,15264
432090,201802,259,162,97,154548,92538,247086
432100,201802,174,116,58,110377.8,55332,165709.8
432110,201802,605,413,192,387467.84,182214,569681.84
432120,201802,959,576,383,548836.2,365343.84,914180.04
432130,201802,501,361,140,343058.4,132462.9,475521.3
432132,201802,26,22,4,20988,3816,24804
432135,201802,78,65,13,62010,12402,74412
432140,201802,265,209,56,199090.26,53424,252514.26
432143,201802,188,119,69,113526,65826,179352
432145,201802,268,184,84,173724.2,79849.8,253574.0
432146,201802,15,14,1,13356,954,14310
432147,201802,136,61,75,58194,71526.15,129720.15
432149,201802,17,12,5,11448,4770,16218
432150,201802,823,521,302,495841.5,285070.84,780912.34
432160,201802,1401,725,676,689352.4,643998.44,1333350.84
432162,201802,4,3,1,2862,954,3816
432163,201802,18,14,4,13356,3816,17172
432166,201802,122,91,31,87292,29574,116866
432170,201802,221,121,100,114481,95400,209881
432180,201802,524,319,205,300710.51,195284,495994.51
432183,201802,9,7,2,6678,1908,8586
432185,201802,82,71,11,67638.6,10494,78132.6
432190,201802,466,260,206,246877.46,196391.52,443268.98
432195,201802,85,74,11,69880.5,10494,80374.5
432200,201802,412,265,147,252810,140190.84,393000.84
432210,201802,118,76,42,70452.9,40068,110520.9
432215,201802,62,58,4,55332,3816,59148
432218,201802,19,18,1,17172,954,18126
432220,201802,675,343,332,326211.64,316220.74,642432.38
432225,201802,14,8,6,7155,5724,12879
432230,201802,144,87,57,82759.5,54378,137137.5
432232,201802,15,13,2,12402,1908,14310
432234,201802,4,3,1,2862,954,3816
432235,201802,1,1,0,954,0,954
432237,201802,29,17,12,16218,11448,27666
432240,201802,4193,2329,1864,2212747.32,1770723.38,3983470.70
432250,201802,1025,649,376,616523.96,358541.82,975065.78
432252,201802,38,31,7,28829.88,6678,35507.88
432253,201802,61,49,12,46746,11448,58194
432254,201802,21,9,12,8586,11448,20034
432255,201802,14,13,1,12402,954,13356
432260,201802,846,661,185,629535.26,175536.5,805071.76
432270,201802,221,164,57,156456,54378,210834
432280,201802,123,89,34,84429.8,32436,116865.8
432285,201802,2,1,1,954,954,1908
432290,201802,69,62,7,57526.2,6678,64204.2
432300,201802,4626,2638,1988,2500840.67,1892695.17,4393535.84
432310,201802,117,94,23,89676,21942,111618
432320,201802,20,15,5,14310,4770,19080
432330,201802,15,10,5,9540,4770,14310
432335,201802,7,6,1,5724,954,6678
432340,201802,41,37,4,35298,3816,39114
432345,201802,89,62,27,59148,25758,84906
432350,201802,22,21,1,20034,954,20988
432360,201802,6,4,2,3816,1908,5724
432370,201802,25,25,0,23850,0,23850
432375,201802,40,34,6,32436,5724,38160
432377,201802,7,7,0,6678,0,6678
432380,201802,169,74,95,69928.2,90582.3,160510.5
500020,201802,247,134,113,127836,107200.98,235036.98
500025,201802,119,58,61,54378,58194,112572
500060,201802,1389,849,540,809373.6,514554.61,1323928.21
500070,201802,757,360,397,343089,378728.46,721817.46
500080,201802,136,105,31,100170,29574,129744
500085,201802,141,114,27,108470,24923.25,133393.25
500090,201802,332,160,172,152640,164088,316728
500100,201802,694,368,326,348877.8,310432,659309.8
500110,201802,2242,1001,1241,954636.46,1183109.6,2137746.06
500124,201802,305,175,130,166950,123733.8,290683.8
500150,201802,327,130,197,124011,187578,311589
500190,201802,518,355,163,338002.2,155016,493018.2
500200,201802,200,171,29,162791,27666,190457
500210,201802,1463,522,941,496714.95,896550.99,1393265.94
500215,201802,241,139,102,131648.51,97308,228956.51
500220,201802,788,514,274,490111.84,260638.46,750750.30
500230,201802,256,176,80,167188.5,75843,243031.5
500240,201802,708,492,216,468604.8,205777.8,674382.6
500260,201802,568,212,356,202248,339624,541872
500270,201802,28324,12048,16276,11464537.73,15510443.64,26974981.37
500280,201802,192,73,119,69642,113526,183168
500290,201802,1195,701,494,667515,471267,1138782
500295,201802,407,249,158,237546,150722.46,388268.46
500310,201802,63,20,43,19080,41022,60102
500315,201802,692,416,276,396854.46,263008.26,659862.72
500320,201802,3643,1815,1828,1729083.38,1742265.02,3471348.40
500325,201802,937,519,418,494649,397797.44,892446.44
500330,201802,1494,683,811,649360.28,773356.64,1422716.92
500345,201802,326,239,87,227043.2,82998,310041.2
500348,201802,242,142,100,135468,95381.46,230849.46
500350,201802,140,68,72,64872,68688,133560
500370,201802,5416,2425,2991,2305922.1,2850875.93,5156798.03
500375,201802,349,252,97,240398.46,92538,332936.46
500380,201802,583,330,253,314662.59,241352.46,556015.05
500390,201802,72,36,36,34344,34344,68688
500400,201802,221,150,71,143080.92,67725,210805.92
500410,201802,571,222,349,211742.15,332798.22,544540.37
500430,201802,544,378,166,360612,158364,518976
500440,201802,203,105,98,99397.43,93492,192889.43
500450,201802,410,175,235,166244.8,223835.12,390079.92
500460,201802,315,158,157,150722.46,149778,300500.46
500470,201802,437,343,94,326007.67,88713,414720.67
500480,201802,114,69,45,65826,42930,108756
500490,201802,108,44,64,41971.23,61056,103027.23
500500,201802,1442,500,942,475170.13,898074.41,1373244.54
500510,201802,47,36,11,34344,10485,44829
500515,201802,110,77,33,73458,31196,104654
500520,201802,350,197,153,186889,145672,332561
500525,201802,87,49,38,46746,35965.8,82711.8
500540,201802,892,369,523,351673.76,497931.84,849605.60
500560,201802,891,507,384,481939.04,365654.42,847593.46
500568,201802,999,577,422,546642.2,402297.23,948939.43
500570,201802,1217,685,532,650774.24,505206.58,1155980.82
500580,201802,332,170,162,161884.26,154535,316419.26
500600,201802,314,158,156,150021.27,148806,298827.27
500620,201802,910,639,271,603828.67,258343.2,862171.87
500625,201802,81,69,12,65119.19,11448,76567.19
500627,201802,24,11,13,10494,12402,22896
500630,201802,1573,831,742,791811.26,707387.03,1499198.29
500635,201802,514,294,220,280056.24,209736.9,489793.14
500640,201802,427,225,202,212076,192689.46,404765.46
500660,201802,5477,2105,3372,2004450.6,3211900.32,5216350.92
500690,201802,577,202,375,192360.78,356070.71,548431.49
500710,201802,356,174,182,165710,173543.9,339253.9
500720,201802,969,568,401,540198.23,382344.92,922543.15
500730,201802,197,115,82,109710,77937.03,187647.03
500740,201802,852,369,483,350734.95,460027.75,810762.70
500750,201802,136,44,92,41976,87739.92,129715.92
500755,201802,123,88,35,83666,33390,117056
500769,201802,745,419,326,399404.04,310991,710395.04
500770,201802,442,231,211,220364.46,201284.46,421648.92
500780,201802,173,116,57,110664,54378,165042
500790,201802,1030,511,519,486917.23,494799.46,981716.69
500793,201802,257,136,121,129744,115425,245169
500795,201802,179,128,51,122102.46,48645,170747.46
500797,201802,39,31,8,29574,7632,37206
500800,201802,408,175,233,166941,221995.8,388936.8
500830,201802,2183,1221,962,1162421.92,916708.68,2079130.60
500840,201802,144,107,37,102078,35289,137367
510010,201802,165,91,74,86804.46,70596,157400.46
510020,201802,486,224,262,213402.6,249135.5,462538.1
510025,201802,1665,937,728,893037.13,691690.08,1584727.21
510030,201802,645,331,314,315727.92,298792.23,614520.15
510035,201802,126,57,69,54350.46,65807.46,120157.92
510040,201802,382,167,215,159318,204663.26,363981.26
510050,201802,424,230,194,218679.2,184271.46,402950.66
510060,201802,116,58,58,55322.46,55322.46,110644.92
510080,201802,220,87,133,82965.69,126759.06,209724.75
510100,201802,77,34,43,32436,41002.92,73438.92
510120,201802,37,22,15,20988,14310,35298
510125,201802,398,247,151,234955.89,144030.92,378986.81
510130,201802,588,342,246,325871.81,234260.1,560131.91
510140,201802,392,129,263,123057,250897.23,373954.23
510160,201802,89,41,48,39114,45788,84902
510170,201802,865,526,339,501529.05,322763.3,824292.35
510180,201802,2885,1404,1481,1336407.34,1410923.24,2747330.58
510185,201802,12,6,6,5724,5724,11448
510190,201802,211,72,139,68688,132601.23,201289.23
510250,201802,2617,1535,1082,1463340.07,1031105.18,2494445.25
510260,201802,202,145,57,138147.84,54341.46,192489.30
510263,201802,455,249,206,236564.46,195768.59,432333.05
510267,201802,651,365,286,347654.76,272573.45,620228.21
510268,201802,56,29,27,27666,25758,53424
510269,201802,68,29,39,27657,37206,64863
510270,201802,413,211,202,201115.98,192291.48,393407.46
510279,201802,229,169,60,161189.46,56934.92,218124.38
510285,201802,166,73,93,69623.46,88722,158345.46
510300,201802,547,294,253,280025.06,241287.84,521312.90
510305,201802,217,100,117,95377.46,111524.22,206901.68
510310,201802,112,57,55,54378,52460.46,106838.46
510320,201802,855,530,325,505042.64,309614.38,814657.02
510325,201802,421,167,254,159308.46,242020.26,401328.72
510330,201802,423,239,184,227993,175516.92,403509.92
510335,201802,597,321,276,306187.38,262648.98,568836.36
510336,201802,49,36,13,34344,12402,46746
510337,201802,119,48,71,45782.46,67724.46,113506.92
510340,201802,17439,8393,9046,7984386.03,8619169.14,16603555.17
510343,201802,72,50,22,47690.46,20988,68678.46
510345,201802,158,104,54,99206.46,51210.92,150417.38
510350,201802,667,372,295,353946.07,281365.38,635311.45
510360,201802,202,119,83,113517,79099.92,192616.92
510370,201802,139,72,67,68659.38,63786.6,132445.98
510380,201802,92,63,29,60102,27657,87759
510385,201802,58,27,31,25758,29565,55323
510390,201802,121,51,70,48654,66741.84,115395.84
510395,201802,38,27,11,25758,10494,36252
510410,201802,707,466,241,444540,229890.69,674430.69
510420,201802,590,289,301,274751.26,285696.37,560447.63
510450,201802,50,30,20,28620,19080,47700
510452,201802,41,23,18,21942,17172,39114
510454,201802,65,27,38,25758,36242.46,62000.46
510455,201802,127,81,46,77254.92,43884,121138.92
510460,201802,181,95,86,90163.72,82006.38,172170.10
510480,201802,735,415,320,394783.89,304932.36,699716.25
510490,201802,361,185,176,176100.8,167399.08,343499.88
510500,201802,254,190,64,181250.46,61056,242306.46
510510,201802,783,450,333,428414.06,317672.46,746086.52
510515,201802,1141,607,534,578709.38,509398.38,1088107.76
510517,201802,242,103,139,97697.71,132582.69,230280.40
510520,201802,232,150,82,143007.3,77908.3,220915.6
510523,201802,92,63,29,60102,27656.46,87758.46
510525,201802,720,407,313,387514.3,298491.3,686005.6
510530,201802,17,12,5,11448,4770,16218
510550,201802,271,121,150,115425,143091,258516
510558,201802,278,137,141,130665.15,134485.92,265151.07
510560,201802,387,239,148,228006,141174,369180
510562,201802,637,445,192,423199.17,182681.46,605880.63
510590,201802,818,427,391,407320.38,372995.69,780316.07
510600,201802,256,139,117,132582.92,111580.92,244163.84
510610,201802,170,82,88,78208.92,83656.46,161865.38
510615,201802,192,79,113,75346.92,107802,183148.92
510617,201802,17,10,7,9540,6678,16218
510618,201802,115,55,60,52470,56763,109233
510619,201802,106,73,33,69633,31473,101106
510620,201802,188,105,83,100160.46,79182,179342.46
510621,201802,196,124,72,118277.46,68660.46,186937.92
510622,201802,452,292,160,278475.84,152316.38,430792.22
510623,201802,358,241,117,229867.38,111589.38,341456.76
510624,201802,87,40,47,38151,44838,82989
510625,201802,533,325,208,309840.3,197834.98,507675.28
510626,201802,108,67,41,63918,39114,103032
510627,201802,57,42,15,40068,14310,54378
510628,201802,162,97,65,92491.92,61952.76,154444.68
510629,201802,253,162,91,154548,85850.46,240398.46
510630,201802,462,234,228,223151.22,217175.49,440326.71
510631,201802,11,3,8,2862,7346,10208
510637,201802,344,193,151,183776.18,143907.84,327684.02
510642,201802,980,541,439,515763.18,418663.44,934426.62
510645,201802,0,0,0,0,0,0
510650,201802,1506,991,515,945278.92,491198.22,1436477.14
510665,201802,86,43,43,40966,41022,81988
510670,201802,65,36,29,34344,27666,62010
510675,201802,1168,701,467,668723,445495.23,1114218.23
510677,201802,366,174,192,164990.84,182742.68,347733.52
510680,201802,108,63,45,60084,42921,103005
510682,201802,202,96,106,91262,101124,192386
510685,201802,51,37,14,35298,13356,48654
510700,201802,622,361,261,344275.92,248860.76,593136.68
510704,201802,1057,571,486,542454.24,462068.52,1004522.76
510706,201802,127,61,66,58189.23,62926.92,121116.15
510710,201802,389,263,126,250704.06,120089.68,370793.74
510715,201802,64,47,17,44828.46,16218,61046.46
510718,201802,209,113,96,107708.76,91565.46,199274.22
510719,201802,36,19,17,18126,16218,34344
510720,201802,194,129,65,123057,61723.8,184780.8
510724,201802,88,37,51,35288.46,48621.38,83909.84
510726,201802,52,27,25,25748.46,23832,49580.46
510729,201802,78,37,41,35298,39075.84,74373.84
510730,201802,472,258,214,246114,204008.46,450122.46
510735,201802,112,44,68,41976,64872,106848
510740,201802,29,15,14,14310,13356,27666
510757,201802,19,15,4,14310,3816,18126
510760,201802,7049,3751,3298,3567854.29,3140005.69,6707859.98
510770,201802,729,348,381,331803.3,363269.76,695073.06
510774,201802,14,6,8,5724,7632,13356
510775,201802,111,84,27,80126.46,25748.46,105874.92
510776,201802,29,7,22,6678,20988,27666
510777,201802,188,84,104,80107.38,99187.38,179294.76
510779,201802,55,25,30,23841,28582.92,52423.92
510780,201802,297,164,133,156393.46,126798,283191.46
510785,201802,442,241,201,229857.3,191687.22,421544.52
510787,201802,186,94,92,89667,87750.23,177417.23
510788,201802,0,0,0,0,0,0
510790,201802,2390,1246,1144,1186574.4,1089228.96,2275803.36
510792,201802,1085,605,480,576673.47,457495.34,1034168.81
510794,201802,115,57,58,54378,55303.92,109681.92
510795,201802,2406,1397,1009,1325412.47,959636.6,2285049.07
510800,201802,178,107,71,102068.46,67725,169793.46
510805,201802,165,116,49,110664,46746,157410
510810,201802,93,38,55,36169.38,52346.52,88515.90
510820,201802,259,121,138,115197.46,130652.03,245849.49
510830,201802,66,40,26,38160,24795,62955
510835,201802,7,5,2,4770,1908,6678
510840,201802,9292,4605,4687,4378419.57,4464172.91,8842592.48
510850,201802,207,86,121,82034.46,115110.18,197144.64
510860,201802,386,169,217,161039.52,206327.8,367367.32
510880,201802,65,50,15,47681.46,14310,61991.46
510885,201802,72,44,28,41957.46,26683.38,68640.84
510890,201802,73,42,31,40068,29574,69642
510895,201802,188,107,81,102078,76965.46,179043.46
520005,201802,35,23,12,21942,11448,33390
520010,201802,280,126,154,120204,146821,267025
520013,201802,636,379,257,361538,244891.8,606429.8
520015,201802,51,37,14,35298,13356,48654
520017,201802,103,60,43,56954,41022,97976
520020,201802,28,14,14,13356,13356,26712
520025,201802,2012,1092,920,1040585.24,876812.4,1917397.64
520030,201802,800,408,392,388269,372393.9,760662.9
520050,201802,78,52,26,49608,24804,74412
520055,201802,45,30,15,28620,14310,42930
520060,201802,177,115,62,109710,59148,168858
520080,201802,590,407,183,388278,174582,562860
520082,201802,20,14,6,13356,5724,19080
520085,201802,98,72,26,68688,24804,93492
520090,201802,90,63,27,60102,25758,85860
520110,201802,8985,3885,5100,3701230.16,4861716.88,8562947.04
520120,201802,14,8,6,7431.66,5724,13155.66
520130,201802,754,531,223,506565,212733,719298
520140,201802,11766,6620,5146,6308044.85,4906350.23,11214395.08
520145,201802,43,32,11,30528,10494,41022
520150,201802,191,150,41,143100,39114,182214
520160,201802,32,22,10,20988,9540,30528
520170,201802,232,143,89,136390,84869,221259
520180,201802,116,61,55,58194,52470,110664
520215,201802,209,129,80,122779.8,76033.8,198813.6
520235,201802,70,53,17,50562,16218,66780
520250,201802,135,81,54,77274,51229.8,128503.8
520260,201802,112,70,42,66780,39114,105894
520280,201802,47,34,13,31769,12402,44171
520310,201802,38,26,12,24804,11448,36252
520320,201802,163,105,58,100160.46,55332,155492.46
520330,201802,782,409,373,390140.46,355815,745955.46
520340,201802,352,201,151,191754,144035.46,335789.46
520350,201802,523,239,284,228006,270889,498895
520355,201802,89,50,39,47700,37206,84906
520357,201802,25,18,7,17172,6678,23850
520360,201802,0,0,0,0,0,0
520380,201802,138,72,66,68688,62964,131652
520390,201802,293,120,173,114003,164779.5,278782.5
520393,201802,12,9,3,8586,2862,11448
520396,201802,99,59,40,56286,38160,94446
520400,201802,226,132,94,124307.2,89676,213983.2
520410,201802,203,103,100,98253,95391,193644
520420,201802,22,15,7,14310,6678,20988
520425,201802,298,127,171,120205,162658.2,282863.2
520430,201802,453,234,219,222949.8,208870,431819.8
520440,201802,605,405,200,386322.3,190800,577122.3
520450,201802,1902,861,1041,820279.46,992467.98,1812747.44
520455,201802,57,40,17,38160,16218,54378
520460,201802,29,14,15,13356,14310,27666
520465,201802,24,20,4,19080,3816,22896
520470,201802,414,257,157,244872.63,149778,394650.63
520480,201802,82,47,35,44838,33345,78183
520485,201802,126,42,84,40068,79850,119918
520490,201802,403,299,104,285061.98,99051.92,384113.90
520495,201802,177,106,71,101124,67734,168858
520500,201802,176,133,43,126882,41022,167904
520505,201802,176,92,84,87763.23,80136,167899.23
520510,201802,1780,872,908,828588.74,864225.42,1692814.16
520520,201802,38,29,9,27666,8586,36252
520530,201802,231,171,60,160742.32,56440.54,217182.86
520540,201802,530,354,176,336409.02,167904,504313.02
520545,201802,162,88,74,83952,70596,154548
520547,201802,54,30,24,28620,22896,51516
520549,201802,1089,521,568,496710,541468,1038178
520551,201802,290,148,142,141192,135468,276660
520552,201802,46,27,19,25758,18126,43884
520570,201802,16,9,7,8586,6678,15264
520580,201802,283,171,112,163115.46,106848,269963.46
520590,201802,162,96,66,91584,62677.8,154261.8
520620,201802,1146,535,611,509532.48,582312.26,1091844.74
520630,201802,43,25,18,23850,17172,41022
520640,201802,415,235,180,224190,171720,395910
520650,201802,53,38,15,36252,14310,50562
520660,201802,35,19,16,18126,15264,33390
520670,201802,33,28,5,26712,4770,31482
520680,201802,58,38,20,36252,19080,55332
520690,201802,33,10,23,9540,21913.92,31453.92
520710,201802,37,33,4,31482,3816,35298
520725,201802,192,123,69,117342,65826,183168
520735,201802,59,42,17,40068,16218,56286
520740,201802,404,201,203,191039.4,193653,384692.4
520750,201802,37,27,10,25758,9540,35298
520753,201802,55,37,18,35298,17172,52470
520760,201802,107,72,35,68688,33390,102078
520780,201802,287,219,68,208926,64872,273798
520790,201802,166,81,85,76987.8,81090,158077.8
520800,201802,3466,1842,1624,1753869.56,1548618.9,3302488.46
520810,201802,162,113,49,107802,46746,154548
520815,201802,5,5,0,4770,0,4770
520830,201802,139,91,48,86814,45505.8,132319.8
520840,201802,346,227,119,216081,113526,329607
520850,201802,109,70,39,66771,37053.36,103824.36
520860,201802,1686,1069,617,1018405.54,587474.2,1605879.74
520870,201802,30708,15129,15579,14405186.79,14847163.2,29252349.99
520880,201802,1065,589,476,561906,454084.92,1015990.92
520890,201802,794,456,338,433393.4,322347.46,755740.86
520910,201802,1028,539,489,510629.74,466506,977135.74
520915,201802,99,75,24,71550,22886.46,94436.46
520920,201802,405,196,209,186411.6,199386,385797.6
520929,201802,19,17,2,16218,1908,18126
520940,201802,76,48,28,45792,26712,72504
520945,201802,20,13,7,12402,6678,19080
520960,201802,47,31,16,29574,15264,44838
520970,201802,331,205,126,194941,119917.8,314858.8
520980,201802,89,65,24,62010,22896,84906
520990,201802,472,315,157,300510,149778,450288
520993,201802,128,61,67,58194,63909,122103
520995,201802,244,135,109,127837,103414,231251
521000,201802,1539,894,645,850873.4,615235,1466108.4
521010,201802,667,306,361,291597.36,344328.3,635925.66
521015,201802,17,10,7,9540,6678,16218
521020,201802,1469,1021,448,973404.9,427021.22,1400426.12
521030,201802,47,33,14,31482,13356,44838
521040,201802,939,577,362,550220.2,345062,895282.2
521056,201802,41,28,13,26712,12402,39114
521060,201802,132,82,50,78228,47700,125928
521080,201802,467,349,118,332651,112572,445223
521090,201802,532,321,211,304993.8,201017.34,506011.14
521100,201802,289,212,77,202239,73458,275697
521120,201802,1047,717,330,682205.6,314525,996730.6
521130,201802,359,255,104,243260.46,98330.6,341591.06
521140,201802,188,108,80,103032,76320,179352
521150,201802,2812,1219,1593,1161916.88,1518449.49,2680366.37
521160,201802,33,17,16,16218,15264,31482
521170,201802,195,114,81,108746.46,77274,186020.46
521180,201802,1120,707,413,672847.26,393287.2,1066134.46
521190,201802,2555,1083,1472,1033162.92,1403410.72,2436573.64
521200,201802,46,34,12,32436,11448,43884
521205,201802,15,11,4,10494,3816,14310
521210,201802,148,84,64,80136,61056,141192
521220,201802,811,548,263,520159.76,250846,771005.76
521225,201802,28,17,11,16218,10494,26712
521230,201802,113,74,39,70309.8,37206,107515.8
521250,201802,6761,3729,3032,3551026.12,2890221.26,6441247.38
521260,201802,18,13,5,12402,4770,17172
521270,201802,144,111,33,105894,31482,137376
521280,201802,437,256,181,243047.4,172674,415721.4
521290,201802,31,13,18,12402,17172,29574
521295,201802,100,68,32,64643.04,30528,95171.04
521300,201802,231,119,112,113508,106488.38,219996.38
521305,201802,36,24,12,22896,11448,34344
521308,201802,1084,786,298,749345.68,283997,1033342.68
521310,201802,1345,800,545,761915.4,518738.92,1280654.32
521340,201802,20,16,4,15264,3816,19080
521350,201802,133,98,35,93492,33390,126882
521370,201802,188,118,70,111618,66493.8,178111.8
521375,201802,191,107,84,102078,79849.8,181927.8
521377,201802,51,34,17,32436,16218,48654
521380,201802,1073,698,375,661744.22,357750,1019494.22
521385,201802,15,8,7,7632,6678,14310
521390,201802,104,85,19,80772.04,18126,98898.04
521400,201802,325,206,119,196237.8,113478.3,309716.1
521405,201802,148,75,73,71550,69642,141192
521410,201802,65,43,22,41022,20988,62010
521440,201802,211,146,65,138473.1,62010,200483.1
521450,201802,721,398,323,379692,308142,687834
521460,201802,1188,730,458,696133.8,436912.92,1133046.72
521470,201802,15,10,5,9540,4770,14310
521480,201802,48,32,16,30519,15199,45718
521483,201802,303,162,141,154262,134514,288776
521486,201802,287,182,105,173503.98,99503,273006.98
521487,201802,23,11,12,10494,11448,21942
521490,201802,28,16,12,15264,11448,26712
521500,201802,113,73,40,69642,38160,107802
521520,201802,42,31,11,29574,10494,40068
521523,201802,587,362,225,343121.78,214650,557771.78
521525,201802,45,30,15,28620,14023.8,42643.8
521530,201802,249,132,117,125928,111618,237546
521540,201802,31,16,15,15264,14310,29574
521550,201802,92,43,49,40707.92,46690.92,87398.84
521560,201802,796,544,252,518690,240265,758955
521565,201802,48,33,15,31482,14310,45792
521570,201802,491,330,161,314810.46,153499.3,468309.76
521580,201802,61,38,23,36252,21942,58194
521590,201802,36,19,17,18126,16218,34344
521600,201802,30,18,12,17172,11448,28620
521630,201802,236,118,118,112562.46,111581.96,224144.42
521640,201802,302,153,149,145962,142146,288108
521645,201802,30,16,14,15264,13356,28620
521680,201802,220,139,81,132606,77274,209880
521690,201802,3,2,1,1908,954,2862
521710,201802,1193,558,635,531473.8,605781,1137254.8
521720,201802,527,349,178,332936.46,169774.46,502710.92
521730,201802,629,304,325,290016,308943.56,598959.56
521740,201802,923,372,551,354859.92,524454.32,879314.24
521760,201802,1589,864,725,822678.63,691336,1514014.63
521770,201802,802,510,292,486540,278100.54,764640.54
521800,201802,2082,1290,792,1225623,755144.1,1980767.1
521805,201802,33,18,15,17172,14310,31482
521810,201802,92,58,34,54187.8,32436,86623.8
521830,201802,956,674,282,642042.42,269019,911061.42
521839,201802,94,63,31,60102,29574,89676
521850,201802,1106,588,518,559532.92,493847.68,1053380.60
521860,201802,345,211,134,201294,127550,328844
521870,201802,73,42,31,40068,29574,69642
521878,201802,42,20,22,19080,20988,40068
521880,201802,4482,2006,2476,1911433.36,2359616.7,4271050.06
521890,201802,571,395,176,376830,167617.8,544447.8
521900,201802,294,237,57,225461.96,54378,279839.96
521910,201802,154,108,46,103032,43884,146916
521920,201802,54,26,28,24804,26712,51516
521925,201802,36,21,15,20034,14310,34344
521930,201802,1119,637,482,607501.98,459175.34,1066677.32
521935,201802,33,25,8,23850,7632,31482
521940,201802,192,97,95,92538,90625.23,183163.23
521945,201802,14,12,2,11448,1908,13356
521950,201802,9,5,4,4770,3816,8586
521960,201802,73,54,19,51516,18126,69642
521970,201802,423,270,153,257293.8,145962,403255.8
521971,201802,96,47,49,44838,46746,91584
521973,201802,29,13,16,12402,15264,27666
521975,201802,1119,577,542,549314.2,516152.66,1065466.86
521980,201802,244,166,78,158364,74412,232776
521990,201802,72,53,19,50562,18126,68688
522000,201802,288,178,110,169812,104940,274752
522005,201802,21,13,8,12402,7632,20034
522010,201802,1124,631,493,601965,469749.6,1071714.6
522015,201802,54,33,21,31473,20034,51507
522020,201802,863,463,400,440748.2,380818.12,821566.32
522026,201802,30,22,8,20988,7632,28620
522028,201802,16,12,4,11448,3816,15264
522040,201802,751,297,454,283224,433061.46,716285.46
522045,201802,2073,1302,771,1240786.06,735000.8,1975786.86
522050,201802,169,81,88,77274,83952,161226
522060,201802,560,353,207,336475.8,197382.6,533858.4
522068,201802,136,90,46,85573.8,43884,129457.8
522070,201802,10,10,0,9540,0,9540
522100,201802,47,25,22,23582.88,20988,44570.88
522108,201802,40,30,10,28620,9540,38160
522119,201802,56,28,28,26712,26712,53424
522130,201802,75,28,47,26712,44820,71532
522140,201802,3696,1876,1820,1785217.28,1734115.9,3519333.18
522145,201802,51,30,21,28620,20034,48654
522150,201802,64,50,14,47700,13356,61056
522155,201802,57,41,16,39105,15264,54369
522157,201802,5,4,1,3816,954,4770
522160,201802,1729,1010,719,962045.03,685630.8,1647675.83
522170,201802,396,266,130,253764,124020,377784
522180,201802,36,20,16,19080,15264,34344
522185,201802,1298,545,753,516909.26,717841,1234750.26
522190,201802,48,27,21,25758,19938.6,45696.6
522200,201802,301,182,119,173628,113526,287154
522205,201802,166,110,56,104940,53424,158364
522220,201802,165,117,48,111618,45792,157410
522230,201802,31,24,7,22896,6678,29574
530010,201802,55608,28523,27085,27076522.41,25788613.11,52865135.52
110001,201803,518,410,108,390156.35,102386.96,492543.31
110002,201803,2798,1682,1116,1602748.19,1063757.49,2666505.68
110003,201803,94,74,20,70596,19080,89676
110004,201803,2000,1280,720,1218219.02,686584.26,1904803.28
110005,201803,441,354,87,336560.9,82988.46,419549.36
110006,201803,447,343,104,326935.8,99196.92,426132.72
110007,201803,82,65,17,62010,16218,78228
110008,201803,240,136,104,128508.9,99216,227724.9
110009,201803,790,536,254,509151.2,242117,751268.2
110010,201803,1796,1114,682,1061523,650486.52,1712009.52
110011,201803,1884,1447,437,1378927.2,416868.35,1795795.55
110012,201803,4110,2396,1714,2278317.01,1633884.46,3912201.47
110013,201803,752,570,182,543770.46,173628,717398.46
110014,201803,369,316,53,301443.89,50562,352005.89
110015,201803,1428,1152,276,1096580.91,262712.52,1359293.43
110018,201803,1118,666,452,635050,431195.23,1066245.23
110020,201803,15330,9018,6312,8561065.07,6010748.13,14571813.20
110025,201803,651,477,174,453060.11,165987,619047.11
110026,201803,42,29,13,27666,12402,40068
110028,201803,1653,1197,456,1137522.14,431431.44,1568953.58
110029,201803,140,123,17,117342,16218,133560
110030,201803,2470,1655,815,1575816.36,776609.46,2352425.82
110032,201803,398,308,90,293523,85856,379379
110033,201803,670,507,163,480675,155498,636173
110034,201803,358,265,93,250498,88055,338553
110037,201803,106,87,19,82998,18126,101124
110040,201803,340,228,112,217512,106848,324360
110045,201803,948,633,315,602336,298806.39,901142.39
110050,201803,94,76,18,72504,17172,89676
110060,201803,86,45,41,42930,39114,82044
110070,201803,124,74,50,70596,47414,118010
110080,201803,397,240,157,226737.18,149734.04,376471.22
110090,201803,33,27,6,25758,5724,31482
110092,201803,111,63,48,60102,45722,105824
110094,201803,200,139,61,132606,58194,190800
110100,201803,28,23,5,21942,4770,26712
110110,201803,71,44,27,41976,25758,67734
110120,201803,73,60,13,57240,12402,69642
110130,201803,303,244,59,231301.12,56286,287587.12
110140,201803,240,154,86,146725.2,82034.46,228759.66
110143,201803,48,40,8,38160,7632,45792
110145,201803,27,19,8,18126,7632,25758
110146,201803,23,12,11,11448,10494,21942
110147,201803,39,30,9,28620,8586,37206
110148,201803,39,27,12,25706.57,11448,37154.57
110149,201803,295,214,81,203869.8,77274,281143.8
110150,201803,84,57,27,54378,25758,80136
110155,201803,8,7,1,6678,954,7632
110160,201803,70,59,11,56286,10494,66780
110170,201803,209,170,39,162180,37206,199386
110175,201803,36,27,9,25758,8586,34344
110180,201803,92,80,12,76320,11448,87768
120001,201803,136,93,43,88680,40993,129673
120005,201803,192,119,73,113483.12,69642,183125.12
120010,201803,1021,657,364,619655.22,345023.16,964678.38
120013,201803,139,96,43,90897.94,40656.16,131554.10
120017,201803,93,59,34,56177.48,32393.12,88570.60
120020,201803,3514,2799,715,2641623.68,679457.67,3321081.35
120025,201803,598,337,261,318960.22,247912.6,566872.82
120030,201803,1014,848,166,800855.7,157606.12,958461.82
120032,201803,49,41,8,39092.12,7632,46724.12
120033,201803,214,188,26,179004.75,24804,203808.75
120034,201803,155,112,43,104918.12,40978.24,145896.36
120035,201803,28,19,9,18126,8586,26712
120038,201803,388,246,142,233859.88,135424.24,369284.12
120039,201803,23,21,2,20034,1908,21942
120040,201803,14031,9706,4325,9126306.81,4087345.86,13213652.67
120042,201803,43,37,6,35298,5724,41022
120043,201803,13,3,10,2862,9540,12402
120045,201803,537,348,189,329911.38,180040.6,509951.98
120050,201803,1258,960,298,911056.73,283939.51,1194996.24
120060,201803,1423,1154,269,1084582.69,252862.68,1337445.37
120070,201803,504,361,143,338055.44,135080.54,473135.98
120080,201803,163,105,58,98962.3,54765.3,153727.6
130002,201803,148,103,45,98262,42930,141192
130006,201803,75,43,32,41022,30528,71550
130008,201803,144,77,67,72737.72,63195.96,135933.68
130010,201803,137,73,64,69642,61056,130698
130014,201803,234,171,63,163134,60102,223236
130020,201803,89,48,41,45792,39114,84906
130030,201803,895,545,350,519930,333890.46,853820.46
130040,201803,328,164,164,156456,155502.28,311958.28
130050,201803,555,307,248,292591.8,236592,529183.8
130060,201803,888,605,283,572021.2,267161.24,839182.44
130063,201803,548,291,257,277614,245156.12,522770.12
130068,201803,186,121,65,115434,61723.8,177157.8
130070,201803,1332,924,408,867977.65,384291,1252268.65
130080,201803,663,431,232,410792.4,221319,632111.4
130083,201803,70,38,32,35701.8,30528,66229.8
130090,201803,377,194,183,183396.96,174582,357978.96
130100,201803,1102,515,587,491310,559711.8,1051021.8
130110,201803,704,315,389,300360,371106,671466
130115,201803,175,70,105,66780,100170,166950
130120,201803,1616,1009,607,962586,579078,1541664
130130,201803,613,420,193,400680,184122,584802
130140,201803,1526,1148,378,1094529.02,359658.2,1454187.22
130150,201803,424,361,63,344394,60102,404496
130160,201803,467,262,205,249948,195570,445518
130165,201803,24,17,7,16218,6678,22896
130170,201803,937,666,271,635293.4,258534,893827.4
130180,201803,152,92,60,87291,57240,144531
130185,201803,2261,1183,1078,1126653.89,1027820.92,2154474.81
130190,201803,3607,2256,1351,2147996.68,1287265.99,3435262.67
130195,201803,291,233,58,222282,55332,277614
130200,201803,176,81,95,77264.46,90630,167894.46
130210,201803,78,39,39,37206,37206,74412
130220,201803,187,128,59,122112,56286,178398
130230,201803,333,209,124,199386,118296,317682
130240,201803,1454,918,536,874432.4,510766.83,1385199.23
130250,201803,4703,3031,1672,2885940.86,1594954.57,4480895.43
130255,201803,423,208,215,198432,204823.8,403255.8
130260,201803,53216,25462,27754,24256953.11,26470514.1,50727467.21
130270,201803,1506,964,542,919369.8,517068,1436437.8
130280,201803,114,69,45,65826,42930,108756
130290,201803,2083,1508,575,1438632,548263.8,1986895.8
130300,201803,425,305,120,290683.8,114480,405163.8
130310,201803,880,464,416,442656,396864,839520
130320,201803,442,235,207,223236,197478,420714
130330,201803,707,426,281,406404,267787.8,674191.8
130340,201803,3266,1965,1301,1870031.2,1239723.2,3109754.4
130350,201803,466,298,168,284270.12,160272,444542.12
130353,201803,786,323,463,307856,441702,749558
130356,201803,767,350,417,333900,397531.8,731431.8
130360,201803,68,41,27,39114,25758,64872
130370,201803,674,499,175,476046,166950,642996
130380,201803,629,431,198,411174,188892,600066
130390,201803,485,391,94,373014,89676,462690
130395,201803,180,41,139,39114,132606,171720
130400,201803,70,47,23,44838,21942,66780
130406,201803,2074,1304,770,1240402.3,733369.76,1973772.06
130410,201803,500,214,286,204156,272824.92,476980.92
130420,201803,3192,2564,628,2442269.5,599112,3041381.5
130423,201803,161,75,86,71550,82044,153594
130426,201803,143,84,59,80136,56286,136422
130430,201803,405,268,137,255672,130698,386370
130440,201803,198,70,128,66780,122112,188892
140002,201803,36,14,22,13356,20988,34344
140005,201803,207,127,80,120919.5,76320,197239.5
140010,201803,10240,6921,3319,6567282.19,3163652.63,9730934.82
140015,201803,153,69,84,65826,80136,145962
140017,201803,111,77,34,73458,32436,105894
140020,201803,473,318,155,302418,147870,450288
140023,201803,26,16,10,15045,9540,24585
140028,201803,18,13,5,12402,4770,17172
140030,201803,357,255,102,243270,96706.98,339976.98
140040,201803,55,38,17,36252,16122.6,52374.6
140045,201803,248,116,132,109996.2,125928,235924.2
140047,201803,559,381,178,361462.39,169049,530511.39
140050,201803,148,97,51,91725,48654,140379
140060,201803,34,23,11,21207.42,10494,31701.42
140070,201803,31,28,3,26712,2862,29574
150010,201803,4733,2929,1804,2791547.5,1719183.29,4510730.79
150013,201803,149,103,46,98262,43884,142146
150020,201803,1071,569,502,542826,478908,1021734
150030,201803,730,298,432,284292,412128,696420
150034,201803,194,121,73,115434,69642,185076
150040,201803,1382,822,560,784188,534240,1318428
150050,201803,710,423,287,402540.8,273598,676138.8
150060,201803,4736,3066,1670,2920932.33,1592932.5,4513864.83
150070,201803,315,145,170,138330,162180,300510
150080,201803,14491,7284,7207,6937038.93,6867873.94,13804912.87
150085,201803,379,239,140,227996.46,133560,361556.46
150090,201803,762,647,115,617238,109710,726948
150095,201803,348,212,136,201478.12,128923.56,330401.68
150100,201803,55,39,16,37206,15264,52470
150110,201803,172,84,88,80136,83952,164088
150120,201803,432,320,112,305280,106848,412128
150125,201803,54,23,31,21942,29574,51516
150130,201803,1891,1007,884,960678,843331.23,1804009.23
150140,201803,54462,25390,29072,24189093.27,27720910.22,51910003.49
150145,201803,176,102,74,97308,70596,167904
150150,201803,2816,1260,1556,1201822.49,1480479.61,2682302.10
150157,201803,439,304,135,290016,128785.23,418801.23
150160,201803,124,100,24,95400,22896,118296
150170,201803,3670,2716,954,2587200.3,909829.8,3497030.1
150172,201803,322,222,100,211788,95400,307188
150175,201803,90,55,35,52470,33390,85860
150178,201803,764,512,252,487494,240408,727902
150180,201803,3057,1474,1583,1405385.6,1509581.18,2914966.78
150190,201803,336,215,121,205110,115434,320544
150195,201803,120,58,62,55332,59148,114480
150200,201803,205,96,109,91584,103986,195570
150210,201803,3172,2568,604,2448813.86,575973.5,3024787.36
150215,201803,509,333,176,317682,167904,485586
150220,201803,3908,2641,1267,2517954.8,1206600.32,3724555.12
150230,201803,1149,923,226,879962.04,215600,1095562.04
150240,201803,5793,3405,2388,3244928.73,2277857,5522785.73
150250,201803,34,16,18,15264,17172,32436
150260,201803,76,47,29,44838,27666,72504
150270,201803,2355,1536,819,1463447.78,780467.8,2243915.58
150275,201803,578,353,225,336762,214650,551412
150276,201803,107,45,62,42930,59148,102078
150277,201803,762,328,434,312893.46,414036,726929.46
150280,201803,340,209,131,199386,124974,324360
150285,201803,74,37,37,35298,35298,70596
150290,201803,968,592,376,564472.26,358418,922890.26
150293,201803,673,311,362,296494.46,345348,641842.46
150295,201803,467,209,258,199386,245979.44,445365.44
150300,201803,80,41,39,39114,37206,76320
150304,201803,140,95,45,90630,42930,133560
150307,201803,398,327,71,311958,67734,379692
150309,201803,554,401,153,382554,145962,528516
150310,201803,252,171,81,163134,77274,240408
150320,201803,1799,1241,558,1183632.57,532332,1715964.57
150330,201803,2065,1186,879,1130776.2,838566,1969342.2
150340,201803,201,136,65,129505.5,62010,191515.5
150345,201803,602,327,275,311776.74,262350,574126.74
150350,201803,413,323,90,305747.46,85860,391607.46
150360,201803,4509,2883,1626,2746714.19,1551194.46,4297908.65
150370,201803,760,539,221,513410,210538.8,723948.8
150375,201803,197,104,93,99216,88722,187938
150380,201803,1307,868,439,828072,418520,1246592
150390,201803,741,422,319,402584,304326,706910
150400,201803,98,81,17,77274,16218,93492
150405,201803,1250,825,425,786293.48,404877.6,1191171.08
150410,201803,138,89,49,84886.92,46746,131632.92
150420,201803,7462,4073,3389,3883983.48,3231415.66,7115399.14
150430,201803,493,332,161,316728,153594,470322
150440,201803,589,350,239,333137,228006,561143
150442,201803,2151,1155,996,1099342.04,949607.03,2048949.07
150445,201803,522,327,195,311958,185076,497034
150450,201803,269,126,143,120204,136422,256626
150460,201803,766,580,186,551493.09,177424.92,728918.01
150470,201803,1343,809,534,771500,509436,1280936
150475,201803,38,28,10,26712,9540,36252
150480,201803,1246,867,379,827118,361279.8,1188397.8
150490,201803,613,336,277,320544,264258,584802
150495,201803,330,232,98,221328,93492,314820
150497,201803,298,205,93,195570,88712.46,284282.46
150500,201803,426,288,138,274752,131652,406404
150503,201803,880,425,455,405164,434052,839216
150506,201803,1033,677,356,645858,339614.46,985472.46
150510,201803,1237,695,542,662744,517068,1179812
150520,201803,278,185,93,176490,88722,265212
150530,201803,1576,847,729,804890.3,694225.8,1499116.1
150540,201803,237,164,73,156456,69642,226098
150543,201803,703,400,303,381008.52,288775.8,669784.32
150548,201803,501,345,156,329130,148824,477954
150549,201803,61,41,20,39114,19080,58194
150550,201803,2889,1517,1372,1446265,1308602,2754867
150553,201803,3076,1818,1258,1732846.6,1200122.46,2932969.06
150555,201803,144,75,69,71550,65826,137376
150560,201803,52,39,13,37206,12402,49608
150563,201803,74,40,34,38160,32436,70596
150565,201803,165,97,68,92538,64872,157410
150570,201803,400,265,135,252790.92,128790,381580.92
150580,201803,1517,643,874,612754.2,833796,1446550.2
150590,201803,771,471,300,449334,286200,735534
150600,201803,461,276,185,263304,176490,439794
150610,201803,144,124,20,117447,19080,136527
150611,201803,128,89,39,84906,37206,122112
150613,201803,3204,1969,1235,1878426,1178181,3056607
150616,201803,486,300,186,285962,177444,463406
150618,201803,1138,626,512,596975.58,488448,1085423.58
150619,201803,393,300,93,286200,88722,374922
150620,201803,1281,742,539,707868,513919.8,1221787.8
150630,201803,306,205,101,195570,96354,291924
150635,201803,486,200,286,190800,272844,463644
150640,201803,62,30,32,28620,30528,59148
150650,201803,2329,1361,968,1298117.34,923181.03,2221298.37
150655,201803,246,183,63,174582,60102,234684
150658,201803,105,60,45,57240,42930,100170
150660,201803,483,339,144,323406,137376,460782
150670,201803,1004,364,640,346960.8,610541.46,957502.26
150680,201803,9903,5390,4513,5134888.86,4303352.58,9438241.44
150690,201803,52,33,19,31482,18126,49608
150700,201803,539,349,190,332755.2,181260,514015.2
150710,201803,276,164,112,156456,106848,263304
150715,201803,868,523,345,497959.92,329101.38,827061.30
150720,201803,438,338,100,322452,95113.8,417565.8
150730,201803,924,491,433,468405,412795.8,881200.8
150740,201803,229,161,68,153594,64872,218466
150745,201803,775,419,356,399726,339624,739350
150746,201803,55,32,23,30528,21942,52470
150747,201803,267,206,61,196524,58194,254718
150750,201803,130,75,55,71550,52470,124020
150760,201803,1703,1104,599,1053216,571446,1624662
150770,201803,373,193,180,184122,171544.95,355666.95
150775,201803,95,43,52,41022,49608,90630
150780,201803,187,99,88,94446,83952,178398
150790,201803,882,477,405,455058,386370,841428
150795,201803,1448,841,607,802314,579078,1381392
150796,201803,401,231,170,220374,161893.8,382267.8
150797,201803,284,159,125,151686,119250,270936
150800,201803,1413,855,558,814711.23,532332,1347043.23
150803,201803,598,494,104,471276,99216,570492
150805,201803,186,118,68,112572,64858.46,177430.46
150808,201803,995,545,450,519930,429300,949230
150810,201803,3398,2350,1048,2238457,999220,3237677
150812,201803,424,222,202,211788,192708,404496
150815,201803,965,632,333,601549.47,317682,919231.47
150820,201803,1566,956,610,911070,581920.92,1492990.92
150830,201803,827,579,248,551412,236592,788004
150835,201803,188,112,76,106848,72504,179352
150840,201803,1330,852,478,812808,456012,1268820
160005,201803,53,31,22,29574,20988,50562
160010,201803,190,118,72,112572,68684,181256
160015,201803,116,66,50,62964,47700,110664
160020,201803,127,73,54,69642,51516,121158
160021,201803,41,21,20,20034,19080,39114
160023,201803,110,64,46,61056,43884,104940
160025,201803,32,14,18,13356,17172,30528
160027,201803,1448,826,622,785237.9,592634,1377871.9
160030,201803,15499,7958,7541,7584316.16,7189375.29,14773691.45
160040,201803,317,181,136,172674,129744,302418
160050,201803,667,340,327,324360,311671.8,636031.8
160053,201803,322,181,141,172388,134514,306902
160055,201803,25,18,7,17172,6678,23850
160060,201803,6374,3339,3035,3174708.8,2894432.2,6069141.0
160070,201803,161,99,62,94446,59148,153594
160080,201803,78,41,37,39114,35298,74412
170025,201803,24,16,8,15264,7632,22896
170030,201803,227,185,42,176293,40068,216361
170035,201803,225,110,115,104940,109710,214650
170040,201803,192,148,44,140905.8,41976,182881.8
170070,201803,320,189,131,180306,124974,305280
170100,201803,374,268,106,255672,101124,356796
170105,201803,62,51,11,48654,10494,59148
170110,201803,103,63,40,60102,38160,98262
170130,201803,70,32,38,30528,35966,66494
170190,201803,105,66,39,62964,37206,100170
170200,201803,392,260,132,247363.2,125823.76,373186.96
170210,201803,6009,3121,2888,2969052.74,2751890.86,5720943.60
170215,201803,94,44,50,41976,47700,89676
170220,201803,1419,1044,375,993781.8,357464,1351245.8
170230,201803,154,100,54,95400,51516,146916
170240,201803,549,363,186,345410.86,177444,522854.86
170255,201803,1111,889,222,847896.12,211501.8,1059397.92
170270,201803,37,28,9,26712,8395.2,35107.2
170290,201803,78,57,21,54378,20034,74412
170300,201803,80,52,28,48844.8,26712,75556.8
170305,201803,45,34,11,32436,10494,42930
170307,201803,65,48,17,45792,16218,62010
170310,201803,102,55,47,52470,44838,97308
170320,201803,17,14,3,13356,2862,16218
170330,201803,21,19,2,18126,1908,20034
170360,201803,24,14,10,13356,9540,22896
170370,201803,122,64,58,61056,55332,116388
170380,201803,81,57,24,54378,22896,77274
170382,201803,47,42,5,40068,4770,44838
170384,201803,129,94,35,89676,33390,123066
170386,201803,61,27,34,25758,32436,58194
170388,201803,48,18,30,17172,28620,45792
170389,201803,25,18,7,17172,6678,23850
170390,201803,53,30,23,28620,21942,50562
170410,201803,34,23,11,21942,10494,32436
170460,201803,16,12,4,11448,3816,15264
170510,201803,28,21,7,20034,6678,26712
170550,201803,1483,838,645,799452,614567,1414019
170555,201803,111,76,35,72504,33390,105894
170560,201803,97,70,27,66780,25758,92538
170600,201803,39,19,20,18126,19080,37206
170610,201803,192,102,90,97150.59,85842,182992.59
170625,201803,39,20,19,19080,18126,37206
170650,201803,85,64,21,61056,20034,81090
170700,201803,554,420,134,399440.3,127836,527276.3
170710,201803,157,97,60,92538,57231,149769
170720,201803,87,70,17,66780,16218,82998
170730,201803,60,35,25,33390,23850,57240
170740,201803,78,58,20,55332,19080,74412
170755,201803,70,37,33,34678,31482,66160
170765,201803,143,69,74,65206,70596,135802
170770,201803,223,129,94,121968.9,89676,211644.9
170820,201803,594,389,205,371106,195141,566247
170825,201803,30,19,11,18126,10494,28620
170830,201803,76,56,20,53233.2,19080,72313.2
170900,201803,201,152,49,145008,46746,191754
170930,201803,816,428,388,407988,369580,777568
170950,201803,3046,1327,1719,1264700.06,1636664.51,2901364.57
170980,201803,17,9,8,8586,7632,16218
171050,201803,132,102,30,97308,28620,125928
171070,201803,38,31,7,29574,6678,36252
171090,201803,39,29,10,27666,9540,37206
171110,201803,22,15,7,14310,6678,20988
171150,201803,39,18,21,17172,20034,37206
171180,201803,20,10,10,9540,9540,19080
171190,201803,138,81,57,77274,54378,131652
171195,201803,64,50,14,47700,13356,61056
171200,201803,47,20,27,19080,25758,44838
171215,201803,2,2,0,1908,0,1908
171240,201803,54,44,10,41976,9540,51516
171245,201803,53,48,5,45792,4770,50562
171250,201803,72,38,34,36252,32426.46,68678.46
171270,201803,17,13,4,12402,3816,16218
171280,201803,39,36,3,34201,2862,37063
171320,201803,1000,566,434,539964,413082,953046
171330,201803,423,203,220,193662,209880,403542
171360,201803,85,63,22,60102,20988,81090
171370,201803,24,13,11,12402,10494,22896
171380,201803,135,110,25,104940,23620.09,128560.09
171395,201803,54,33,21,31482,20034,51516
171420,201803,310,205,105,195570,99883.8,295453.8
171430,201803,63,50,13,47700,12402,60102
171488,201803,204,108,96,103032,91584,194616
171500,201803,59,32,27,30528,25758,56286
171510,201803,68,45,23,42930,21942,64872
171515,201803,43,37,6,35298,5724,41022
171525,201803,31,26,5,24804,4770,29574
171550,201803,13,7,6,6678,5724,12402
171570,201803,63,31,32,29574,30528,60102
171575,201803,341,211,130,201294,124010.46,325304.46
171610,201803,1693,849,844,808047.53,803609.12,1611656.65
171620,201803,133,92,41,87214.68,39114,126328.68
171630,201803,51,27,24,25758,22896,48654
171650,201803,274,180,94,171720,89676,261396
171660,201803,264,140,124,133560,118292,251852
171665,201803,46,30,16,28620,15264,43884
171670,201803,432,253,179,238443.26,170193.6,408636.86
171700,201803,63,55,8,52470,7632,60102
171720,201803,25,8,17,7632,16218,23850
171750,201803,104,54,50,51516,47700,99216
171780,201803,71,58,13,55332,12402,67734
171790,201803,80,66,14,62964,13356,76320
171800,201803,36,28,8,26712,7632,34344
171820,201803,2057,1162,895,1107839.74,849222.82,1957062.56
171830,201803,37,29,8,27666,7632,35298
171840,201803,62,35,27,33390,25758,59148
171845,201803,31,20,11,19080,10494,29574
171850,201803,39,27,12,25758,11448,37206
171855,201803,77,60,17,57240,16218,73458
171865,201803,8,7,1,6678,954,7632
171870,201803,32,23,9,21942,8586,30528
171875,201803,78,53,25,50562,23850,74412
171880,201803,27,19,8,18126,7632,25758
171884,201803,47,24,23,22896,21942,44838
171886,201803,118,41,77,39114,73171.8,112285.8
171888,201803,24,18,6,17172,5724,22896
171889,201803,19,15,4,14310,3816,18126
171890,201803,56,46,10,43884,9540,53424
171900,201803,42,29,13,27666,12402,40068
172000,201803,40,34,6,32436,5724,38160
172010,201803,40,33,7,30671.1,6678,37349.1
172015,201803,26,16,10,15264,9253.8,24517.8
172020,201803,129,81,48,77274,45792,123066
172025,201803,32,21,11,20034,10494,30528
172030,201803,36,20,16,19080,15264,34344
172049,201803,75,44,31,41976,29574,71550
172065,201803,148,96,52,91584,49608,141192
172080,201803,92,65,27,60827.84,25758,86585.84
172085,201803,25,12,13,11448,12402,23850
172090,201803,401,305,96,290970,90821,381791
172093,201803,25,18,7,17172,6678,23850
172097,201803,17,8,9,7632,8300,15932
172100,201803,4684,2624,2060,2498097.8,1962771,4460868.8
172110,201803,83,55,28,52470,26712,79182
172120,201803,1717,1471,246,1397217.65,233576.41,1630794.06
172125,201803,3,3,0,2862,0,2862
172130,201803,17,13,4,12402,3816,16218
172208,201803,194,124,70,118296,66780,185076
172210,201803,431,208,223,198432,212456,410888
210005,201803,2916,1821,1095,1734181.22,1041770,2775951.22
210010,201803,192,98,94,93492,89676,183168
210015,201803,29,19,10,18126,9540,27666
210020,201803,346,178,168,169812,160272,330084
210030,201803,344,214,130,204156,124011,328167
210040,201803,155,120,35,114480,33390,147870
210043,201803,252,169,83,161226,79182,240408
210047,201803,605,313,292,298220.4,278558.46,576778.86
210050,201803,296,216,80,206064,76320,282384
210055,201803,45,34,11,32436,10494,42930
210060,201803,567,442,125,421282.59,119250,540532.59
210070,201803,411,301,110,287154,104940,392094
210080,201803,104,96,8,91584,7632,99216
210083,201803,305,128,177,122112,168858,290970
210087,201803,44,32,12,30528,11448,41976
210090,201803,492,340,152,324360,145008,469368
210095,201803,494,353,141,336752.46,134514,471266.46
210100,201803,685,519,166,494792.1,157410.02,652202.12
210110,201803,147,79,68,75366,64872,140238
210120,201803,5462,4098,1364,3902286,1300002.68,5202288.68
210125,201803,217,123,94,117342,89676,207018
210130,201803,549,283,266,269028,253744.92,522772.92
210135,201803,35,21,14,20034,13356,33390
210140,201803,4327,3391,936,3231820.71,892706,4124526.71
210150,201803,357,225,132,214650,125928,340578
210160,201803,3348,2811,537,2678834.78,512012,3190846.78
210170,201803,1127,878,249,837612,237546,1075158
210173,201803,122,101,21,96354,20034,116388
210177,201803,466,226,240,215604,228960,444564
210180,201803,32,18,14,17172,13356,30528
210190,201803,412,262,150,249948,143100,393048
210193,201803,1,1,0,954,0,954
210197,201803,82,54,28,51516,26712,78228
210200,201803,635,501,134,477954,127836,605790
210203,201803,261,175,86,166950,82044,248994
210207,201803,382,295,87,281430,82998,364428
210210,201803,772,702,70,669708,66780,736488
210215,201803,77,65,12,62010,11448,73458
210220,201803,394,323,71,308142,67447.8,375589.8
210230,201803,300,224,76,213696,72504,286200
210232,201803,1475,933,542,889796,517068,1406864
210235,201803,153,118,35,112382,33390,145772
210237,201803,46,25,21,23850,20034,43884
210240,201803,94,76,18,72504,17172,89676
210250,201803,183,145,38,138330,36252,174582
210255,201803,343,252,91,240408,86814,327222
210260,201803,422,263,159,250902,151686,402588
210270,201803,695,441,254,420714,242316,663030
210275,201803,42,33,9,31482,8586,40068
210280,201803,1030,656,374,623009.33,355460.5,978469.83
210290,201803,501,323,178,308142,169812,477954
210300,201803,6107,3555,2552,3386833.27,2433416.23,5820249.50
210310,201803,104,71,33,67734,31482,99216
210312,201803,127,80,47,76320,44838,121158
210315,201803,116,84,32,80136,30528,110664
210317,201803,126,89,37,84906,35298,120204
210320,201803,2390,1966,424,1873853.84,404496,2278349.84
210325,201803,131,88,43,82998,40736,123734
210330,201803,5540,2826,2714,2691172.09,2589146.46,5280318.55
210340,201803,1399,1000,399,953200,380575.07,1333775.07
210350,201803,610,497,113,473899.5,107802,581701.5
210355,201803,132,106,26,101124,24804,125928
210360,201803,2651,1653,998,1573815.6,951806,2525621.6
210370,201803,1251,541,710,516114,676672.2,1192786.2
210375,201803,185,99,86,93903,82044,175947
210380,201803,726,542,184,517068,175536,692604
210390,201803,204,167,37,159318,35298,194616
210400,201803,406,338,68,322452,64853,387305
210405,201803,1007,666,341,635364,325314,960678
210407,201803,56,44,12,41976,11448,53424
210408,201803,64,57,7,54378,6678,61056
210409,201803,313,261,52,248994,49608,298602
210410,201803,437,338,99,322452,94437,416889
210420,201803,195,159,36,151686,34344,186030
210430,201803,35,27,8,25758,7632,33390
210440,201803,376,226,150,215604,143100,358704
210450,201803,149,111,38,105894,36252,142146
210455,201803,221,121,100,115434,95400,210834
210460,201803,348,219,129,208926,123066,331992
210462,201803,61,51,10,48654,9540,58194
210465,201803,173,125,48,119250,45792,165042
210467,201803,521,372,149,354888,142146,497034
210470,201803,45,33,12,31482,11448,42930
210480,201803,1303,917,386,874818,368244,1243062
210490,201803,225,134,91,127836,86814,214650
210500,201803,571,297,274,283338,261396,544734
210510,201803,555,431,124,411174,118296,529470
210515,201803,445,242,203,230868,193662,424530
210520,201803,398,347,51,330751.8,48654,379405.8
210530,201803,9384,5030,4354,4786470.87,4147884.03,8934354.90
210535,201803,131,94,37,89676,35298,124974
210540,201803,1539,922,617,878443.8,587187,1465630.8
210542,201803,1165,585,580,557708.4,552748,1110456.4
210545,201803,13,12,1,11448,954,12402
210547,201803,136,116,20,110664,19080,129744
210550,201803,739,517,222,491670,211788,703458
210560,201803,174,145,29,138330,27666,165996
210565,201803,30,21,9,20034,8586,28620
210570,201803,1369,1072,297,1022688,283338,1306026
210580,201803,106,92,14,87768,13356,101124
210590,201803,770,602,168,573544.8,160272,733816.8
210592,201803,31,27,4,25758,3816,29574
210594,201803,103,84,19,80136,18126,98262
210596,201803,82,69,13,65826,12402,78228
210598,201803,124,91,33,86814,31482,118296
210600,201803,335,281,54,268074,51516,319590
210610,201803,247,229,18,217512,17172,234684
210620,201803,47,28,19,26712,18126,44838
210630,201803,60,57,3,54378,2862,57240
210632,201803,1115,738,377,704052,359163,1063215
210635,201803,16,13,3,12402,2862,15264
210637,201803,106,74,32,70596,30528,101124
210640,201803,586,511,75,487494,71550,559044
210650,201803,407,326,81,310078.62,76320,386398.62
210660,201803,403,286,117,272177,111494,383671
210663,201803,17,10,7,9540,6678,16218
210667,201803,116,36,80,34344,76320,110664
210670,201803,270,237,33,225383,31482,256865
210675,201803,570,294,276,280476,263304,543780
210680,201803,213,134,79,127836,75366,203202
210690,201803,645,507,138,483678,131652,615330
210700,201803,193,140,53,133560,50562,184122
210710,201803,299,165,134,157219.2,127836,285055.2
210720,201803,125,104,21,99216,20034,119250
210725,201803,65,57,8,54378,7632,62010
210730,201803,24,18,6,17172,5724,22896
210735,201803,417,278,139,265212,132320,397532
210740,201803,542,458,84,436932,80136,517068
210745,201803,152,109,43,103986,41022,145008
210750,201803,2424,1097,1327,1044583,1265938.92,2310521.92
210760,201803,276,201,75,191754,71535.69,263289.69
210770,201803,399,306,93,291924,88435.8,380359.8
210780,201803,421,303,118,289062,112572,401634
210790,201803,184,142,42,135468,40068,175536
210800,201803,137,102,35,97308,33390,130698
210805,201803,41,37,4,35298,3816,39114
210810,201803,485,368,117,350404.2,111618,462022.2
210820,201803,2315,1826,489,1733888.54,466506,2200394.54
210825,201803,170,87,83,82998,79182,162180
210830,201803,804,486,318,462690,302418,765108
210840,201803,215,142,73,135468,69642,205110
210845,201803,252,157,95,149778,90630,240408
210850,201803,856,544,312,518976,297648,816624
210860,201803,4152,2123,2029,2023148.3,1935360.72,3958509.02
210870,201803,466,348,118,331992,112572,444564
210880,201803,57,39,18,37206,17172,54378
210890,201803,339,278,61,265212,58194,323406
210900,201803,568,371,197,353930,187938,541868
210905,201803,71,35,36,33390,34344,67734
210910,201803,2006,1480,526,1410343.99,501804,1912147.99
210920,201803,229,66,163,62964,155502,218466
210923,201803,81,57,24,54378,22896,77274
210927,201803,437,181,256,172674,244224,416898
210930,201803,60,47,13,44838,12402,57240
210940,201803,92,69,23,65826,21942,87768
210945,201803,192,87,105,82998,100170,183168
210950,201803,505,364,141,347256,134509.23,481765.23
210955,201803,75,49,26,46746,24804,71550
210960,201803,2453,1032,1421,982906.4,1355348,2338254.4
210970,201803,114,98,16,93492,15264,108756
210975,201803,89,80,9,76320,8586,84906
210980,201803,1235,527,708,502643.52,675146,1177789.52
210990,201803,4379,2714,1665,2588055.13,1588410,4176465.13
211000,201803,1378,1084,294,1033850,280189.8,1314039.8
211003,201803,922,629,293,600066,279513,879579
211010,201803,479,418,61,398772,58194,456966
211020,201803,1612,581,1031,554274,983354.58,1537628.58
211023,201803,26,22,4,20701.8,3816,24517.8
211027,201803,64,40,24,38160,22896,61056
211030,201803,382,255,127,243270,121158,364428
211040,201803,317,238,79,226766,75366,302132
211050,201803,1184,749,435,714546,414699.23,1129245.23
211060,201803,686,581,105,551797.66,100170,651967.66
211065,201803,23,19,4,18126,3816,21942
211070,201803,916,743,173,707210.74,165042,872252.74
211080,201803,88,84,4,80136,3816,83952
211085,201803,59,31,28,29288,26712,56000
211090,201803,94,76,18,72504,17172,89676
211100,201803,508,403,105,384462,100170,484632
211102,201803,262,174,88,165996,83952,249948
211105,201803,221,151,70,144054,66780,210834
211107,201803,134,76,58,72504,55332,127836
211110,201803,825,531,294,506002,280467,786469
211120,201803,5808,2445,3363,2327152.54,3207210.23,5534362.77
211125,201803,35,28,7,26712,6678,33390
211130,201803,45951,18977,26974,18071321.32,25721653.62,43792974.94
211140,201803,427,360,67,342482,63918,406400
211150,201803,1254,791,463,754280.1,441412,1195692.1
211153,201803,166,97,69,92538,65826,158364
211157,201803,60,44,16,41976,15264,57240
211160,201803,707,585,122,557123.5,116388,673511.5
211163,201803,0,0,0,0,0,0
211167,201803,7,5,2,4770,1908,6678
211170,201803,446,309,137,294786,130698,425484
211172,201803,124,86,38,82044,36252,118296
211174,201803,281,161,120,153594,114480,268074
211176,201803,519,372,147,354888,140238,495126
211178,201803,96,62,34,59148,32436,91584
211180,201803,208,163,45,155502,42767.82,198269.82
211190,201803,62,57,5,54378,4770,59148
211195,201803,25,16,9,15264,8586,23850
211200,201803,156,134,22,127492.56,20988,148480.56
211210,201803,532,328,204,312244.2,194616,506860.2
211220,201803,3984,2229,1755,2118623.39,1666983.64,3785607.03
211223,201803,97,90,7,85678.74,6678,92356.74
211227,201803,72,49,23,46746,21942,68688
211230,201803,779,631,148,601830.9,141172.92,743003.82
211240,201803,416,311,105,296694,100170,396864
211245,201803,210,92,118,87768,112572,200340
211250,201803,1637,1395,242,1329838.12,230868,1560706.12
211260,201803,812,636,176,606744,167904,774648
211270,201803,2091,1638,453,1562652,431208.2,1993860.2
211280,201803,1821,1080,741,1029366.8,706914,1736280.8
211285,201803,207,118,89,112572,84906,197478
211290,201803,683,455,228,433879.2,217512,651391.2
211300,201803,809,621,188,592156.09,179352,771508.09
211400,201803,1606,902,704,860508,671616,1532124
220005,201803,18,17,1,16218,954,17172
220010,201803,88,67,21,63918,19747.8,83665.8
220020,201803,608,476,132,453119.04,125928,579047.04
220025,201803,106,102,4,97308,3816,101124
220027,201803,34,27,7,25758,6678,32436
220030,201803,99,81,18,77274,17172,94446
220040,201803,1122,840,282,800284.91,268933,1069217.91
220045,201803,39,28,11,26712,10494,37206
220050,201803,647,528,119,502550.96,113506.92,616057.88
220060,201803,176,150,26,143100,24804,167904
220070,201803,94,84,10,80136,9540,89676
220080,201803,10,8,2,7632,1908,9540
220090,201803,35,28,7,26426,6678,33104
220095,201803,2,1,1,954,954,1908
220100,201803,28,24,4,22896,3816,26712
220105,201803,29,27,2,25758,1908,27666
220110,201803,207,191,16,181927.8,15264,197191.8
220115,201803,47,44,3,41976,2862,44838
220117,201803,18,17,1,16218,954,17172
220120,201803,1528,1056,472,1006795.31,450268.92,1457064.23
220130,201803,26,25,1,23850,954,24804
220140,201803,98,78,20,73458,19080,92538
220150,201803,451,319,132,304326,125928,430254
220155,201803,4,4,0,3816,0,3816
220157,201803,17,14,3,13356,2862,16218
220160,201803,72,62,10,59148,9540,68688
220170,201803,34,32,2,30528,1908,32436
220173,201803,7,7,0,6678,0,6678
220177,201803,5,5,0,4770,0,4770
220180,201803,66,65,1,62005.23,668,62673.23
220190,201803,1055,943,112,899622,106848,1006470
220191,201803,41,36,5,34344,4770,39114
220192,201803,62,59,3,56286,2862,59148
220194,201803,32,28,4,26712,3816,30528
220196,201803,103,85,18,81090,17172,98262
220198,201803,6,4,2,3816,1908,5724
220200,201803,435,355,80,339497,76320,415817
220202,201803,37,33,4,31482,3816,35298
220205,201803,41,35,6,33390,5724,39114
220207,201803,19,18,1,17172,954,18126
220208,201803,84,44,40,41976,38160,80136
220209,201803,31,28,3,26712,2862,29574
220210,201803,15,13,2,12402,1908,14310
220211,201803,28,28,0,26712,0,26712
220213,201803,41,37,4,35298,3530,38828
220217,201803,36,28,8,26712,7632,34344
220220,201803,2024,1286,738,1223238.68,702649.92,1925888.60
220225,201803,15,8,7,7632,6678,14310
220230,201803,933,740,193,705511.62,183482.82,888994.44
220240,201803,146,134,12,127836,11448,139284
220245,201803,33,30,3,27917.04,2862,30779.04
220250,201803,105,94,11,89676,10494,100170
220253,201803,43,35,8,33390,7632,41022
220255,201803,28,25,3,23850,2862,26712
220260,201803,686,499,187,476046,178398,654444
220265,201803,17,14,3,13356,2862,16218
220270,201803,669,592,77,564042.96,72981,637023.96
220271,201803,45,37,8,35298,7632,42930
220272,201803,27,26,1,24804,954,25758
220273,201803,14,12,2,11448,1908,13356
220275,201803,58,47,11,44838,10494,55332
220277,201803,11,9,2,8586,1908,10494
220280,201803,14,12,2,11448,1908,13356
220285,201803,43,40,3,38160,2862,41022
220290,201803,1377,1177,200,1120330,190753,1311083
220300,201803,54,53,1,50562,954,51516
220310,201803,316,265,51,252806,48645,301451
220320,201803,429,395,34,375400,32436,407836
220323,201803,0,0,0,0,0,0
220325,201803,15,10,5,9540,4770,14310
220327,201803,11,10,1,9540,954,10494
220330,201803,200,136,64,129744,61056,190800
220335,201803,139,121,18,115434,17172,132606
220340,201803,21,12,9,11448,8586,20034
220342,201803,56,47,9,44838,8586,53424
220345,201803,83,75,8,71550,7632,79182
220350,201803,430,377,53,357035.42,50562,407597.42
220360,201803,43,31,12,29574,11448,41022
220370,201803,1107,885,222,843336,211501.8,1054837.8
220375,201803,28,26,2,24804,1908,26712
220380,201803,38,31,7,29574,6678,36252
220385,201803,28,24,4,22896,3816,26712
220390,201803,2232,1268,964,1204978.55,918273.5,2123252.05
220400,201803,28,26,2,24804,1908,26712
220410,201803,14,13,1,12402,954,13356
220415,201803,13,12,1,11448,954,12402
220420,201803,124,103,21,98262,19747.8,118009.8
220430,201803,131,118,13,110903.8,12402,123305.8
220435,201803,21,15,6,14306,5724,20030
220440,201803,292,247,45,235638,42930,278568
220450,201803,329,168,161,159106.98,153594,312700.98
220455,201803,53,51,2,48654,1908,50562
220460,201803,15,15,0,13642.2,0,13642.2
220465,201803,108,68,40,64872,38160,103032
220470,201803,240,212,28,202248,26712,228960
220480,201803,72,61,11,58194,10494,68688
220490,201803,86,75,11,71550,10494,82044
220500,201803,96,83,13,79182,12402,91584
220510,201803,380,302,78,287345,74221.2,361566.2
220515,201803,21,17,4,16218,3816,20034
220520,201803,369,331,38,314459,36233,350692
220525,201803,26,18,8,17172,7632,24804
220527,201803,36,28,8,26712,6822,33534
220530,201803,33,12,21,11448,20034,31482
220535,201803,11,10,1,9540,954,10494
220540,201803,64,50,14,47700,13356,61056
220545,201803,60,39,21,37206,20034,57240
220550,201803,647,492,155,468604.8,147870,616474.8
220551,201803,27,20,7,19080,6678,25758
220552,201803,8,8,0,7632,0,7632
220553,201803,45,41,4,39114,3816,42930
220554,201803,13,8,5,7345.8,4770,12115.8
220555,201803,24,20,4,19080,3816,22896
220556,201803,55,51,4,48654,3816,52470
220557,201803,56,50,6,47700,5724,53424
220558,201803,7,2,5,1908,4770,6678
220559,201803,6,5,1,4770,954,5724
220560,201803,57,37,20,35107.2,19080,54187.2
220570,201803,798,474,324,450706.14,309096,759802.14
220580,201803,565,515,50,491310,47013.92,538323.92
220585,201803,6,5,1,4770,954,5724
220590,201803,14,14,0,13356,0,13356
220595,201803,58,43,15,41022,14310,55332
220600,201803,21,12,9,11448,8586,20034
220605,201803,20,19,1,18126,954,19080
220610,201803,62,53,9,50562,8586,59148
220620,201803,558,435,123,414751.5,117342,532093.5
220630,201803,6,4,2,3816,1908,5724
220635,201803,37,33,4,31482,3816,35298
220640,201803,98,77,21,73458,20034,93492
220650,201803,114,108,6,103032,5724,108756
220660,201803,28,22,6,20988,5724,26712
220665,201803,4,4,0,3816,0,3816
220667,201803,12,11,1,10494,954,11448
220669,201803,25,22,3,20988,2862,23850
220670,201803,69,54,15,51325.2,14310,65635.2
220672,201803,61,40,21,38160,20034,58194
220675,201803,35,27,8,25758,7632,33390
220680,201803,35,29,6,27666,5724,33390
220690,201803,46,44,2,41976,1908,43884
220695,201803,61,29,32,27666,30528,58194
220700,201803,1537,1176,361,1120062.78,344394,1464456.78
220710,201803,3,1,2,954,1908,2862
220720,201803,110,89,21,84667.5,19890.9,104558.4
220730,201803,19,18,1,17172,954,18126
220735,201803,3,1,2,954,1908,2862
220740,201803,45,41,4,39114,3816,42930
220750,201803,101,82,19,78228,18126,96354
220755,201803,14,14,0,13356,0,13356
220760,201803,52,49,3,46746,2862,49608
220770,201803,5791,2894,2897,2755666.83,2757601.41,5513268.24
220775,201803,26,12,14,11448,13356,24804
220777,201803,15,14,1,13356,954,14310
220779,201803,18,14,4,13356,3816,17172
220780,201803,876,747,129,711970.2,122780,834750.2
220785,201803,12,6,6,5724,5724,11448
220790,201803,1009,802,207,762706,197478,960184
220793,201803,13,13,0,12402,0,12402
220795,201803,22,21,1,20034,954,20988
220800,201803,3908,2979,929,2840323.36,885003.89,3725327.25
220810,201803,58,52,6,49608,5724,55332
220820,201803,239,217,22,207018,20988,228006
220830,201803,1162,984,178,938731.23,169793,1108524.23
220840,201803,2433,1613,820,1525641.75,780182,2305823.75
220850,201803,52,42,10,40068,9540,49608
220855,201803,14,9,5,8586,4770,13356
220860,201803,8,7,1,6678,954,7632
220865,201803,24,22,2,20988,1908,22896
220870,201803,57,55,2,52470,1908,54378
220880,201803,318,243,75,231154.2,71264,302418.2
220885,201803,44,40,4,38160,3816,41976
220887,201803,18,17,1,16218,954,17172
220890,201803,102,90,12,85860,11448,97308
220900,201803,47,26,21,24804,20034,44838
220910,201803,53,45,8,42930,7632,50562
220915,201803,10,9,1,8586,954,9540
220920,201803,36,32,4,30528,3816,34344
220930,201803,42,41,1,39114,954,40068
220935,201803,15,15,0,14310,0,14310
220937,201803,44,41,3,39114,2862,41976
220940,201803,52,48,4,45792,3816,49608
220945,201803,0,0,0,0,0,0
220950,201803,47,43,4,41022,3816,44838
220955,201803,35,30,5,28620,4770,33390
220960,201803,2,2,0,1908,0,1908
220965,201803,28,24,4,22896,3816,26712
220970,201803,46,39,7,37206,6678,43884
220975,201803,9,8,1,7632,954,8586
220980,201803,34,32,2,30528,1908,32436
220985,201803,64,57,7,54378,6678,61056
220987,201803,31,30,1,28620,954,29574
220990,201803,13,12,1,11448,954,12402
220995,201803,38,33,5,31482,4770,36252
220997,201803,39,32,7,30528,6678,37206
221000,201803,1127,1015,112,964877.6,106561.8,1071439.4
221005,201803,63,57,6,54378,5724,60102
221010,201803,16,13,3,12402,2862,15264
221020,201803,45,43,2,41022,1908,42930
221030,201803,27,22,5,20988,4770,25758
221035,201803,19,19,0,18126,0,18126
221037,201803,12,6,6,5724,5724,11448
221038,201803,23,21,2,20034,1908,21942
221039,201803,23,23,0,21942,0,21942
221040,201803,253,218,35,207972,33390,241362
221050,201803,232,195,37,186030,35298,221328
221060,201803,1713,1505,208,1434254.76,198432,1632686.76
221062,201803,28,27,1,25758,954,26712
221063,201803,13,9,4,8586,3816,12402
221065,201803,50,43,7,41022,6678,47700
221070,201803,137,118,19,112572,18126,130698
221080,201803,377,335,42,319590,39781.8,359371.8
221090,201803,36,35,1,33390,954,34344
221093,201803,56,37,19,35298,18126,53424
221095,201803,11,10,1,9540,954,10494
221097,201803,22,19,3,18126,2862,20988
221100,201803,24518,14071,10447,13401756.49,9961146.73,23362903.22
221110,201803,1026,752,274,717122,261396,978518
221120,201803,529,394,135,375590,128790,504380
221130,201803,932,759,173,722846.8,165042,887888.8
221135,201803,34,31,3,29574,2862,32436
221140,201803,40,32,8,30528,7632,38160
221150,201803,15,12,3,11448,2862,14310
221160,201803,11,11,0,10494,0,10494
221170,201803,13,13,0,12402,0,12402
230010,201803,161,150,11,143100,10494,153594
230015,201803,116,95,21,90630,20034,110664
230020,201803,1535,1310,225,1247451,213748.87,1461199.87
230030,201803,1620,1165,455,1105841.04,434070,1539911.04
230040,201803,198,174,24,165042,22896,187938
230050,201803,211,154,57,146916,54378,201294
230060,201803,150,124,26,117532.8,24804,142336.8
230070,201803,281,250,31,238500,29574,268074
230075,201803,794,692,102,658165,97021.8,755186.8
230080,201803,179,154,25,146916,23850,170766
230090,201803,94,64,30,60292.8,28620,88912.8
230100,201803,1928,1141,787,1086227,750798,1837025
230110,201803,2633,1683,950,1603183.4,905727.8,2508911.2
230120,201803,933,739,194,702354.62,185057,887411.62
230125,201803,137,112,25,106848,23850,130698
230130,201803,459,411,48,392094,45792,437886
230140,201803,203,174,29,165996,27666,193662
230150,201803,161,119,42,113526,40068,153594
230160,201803,909,786,123,749129,117342,866471
230170,201803,581,536,45,507530.7,42930,550460.7
230180,201803,80,75,5,71550,4770,76320
230185,201803,408,351,57,333488.83,54378,387866.83
230190,201803,2191,1767,424,1681738.48,404179,2085917.48
230195,201803,486,424,62,404496,59148,463644
230200,201803,367,320,47,304316.46,44838,349154.46
230205,201803,354,222,132,210018.33,125928,335946.33
230210,201803,1258,1004,254,956298.15,241552.8,1197850.95
230220,201803,1395,966,429,920800.8,409266,1330066.8
230230,201803,896,788,108,750845.7,103032,853877.7
230240,201803,1615,1391,224,1325209.7,213696,1538905.7
230250,201803,1761,1452,309,1381197.07,294786,1675983.07
230260,201803,2928,1758,1170,1671939.16,1115207.69,2787146.85
230270,201803,1340,1077,263,1024858.39,249709.5,1274567.89
230280,201803,2690,2000,690,1901325.23,657592.2,2558917.43
230290,201803,398,362,36,339211.07,34344,373555.07
230300,201803,513,379,134,360306.72,127836,488142.72
230310,201803,414,311,103,296546.13,98262,394808.13
230320,201803,906,774,132,734412.6,125928,860340.6
230330,201803,298,239,59,227242.8,56096,283338.8
230340,201803,449,360,89,342487,84906,427393
230350,201803,3030,1892,1138,1804948.92,1082791.08,2887740.00
230360,201803,260,216,44,205154,41976,247130
230365,201803,135,108,27,102317,25758,128075
230370,201803,9729,4741,4988,4515064.18,4754399.3,9269463.48
230380,201803,462,397,65,378452,61056.6,439508.6
230390,201803,497,277,220,262454.94,209880,472334.94
230393,201803,268,221,47,209980.8,44838,254818.8
230395,201803,335,273,62,260194,59148,319342
230400,201803,596,472,124,448380,117799.92,566179.92
230410,201803,2618,1628,990,1547484.75,944174,2491658.75
230420,201803,5925,3870,2055,3673776.58,1955888.37,5629664.95
230423,201803,311,269,42,256626,40068,296694
230425,201803,346,288,58,274752,55332,330084
230426,201803,106,97,9,91812.96,8299.8,100112.76
230427,201803,79,76,3,72504,2862,75366
230428,201803,1340,688,652,656123.04,622008,1278131.04
230430,201803,439,354,85,337522,81090,418612
230435,201803,794,556,238,528882.23,225812.61,754694.84
230440,201803,83513,36808,46705,35028099.7,44514049.74,79542149.44
230445,201803,270,185,85,176299.2,81090,257389.2
230450,201803,539,438,101,417852,96354,514206
230460,201803,58,48,10,45792,9540,55332
230465,201803,297,242,55,230868,52470,283338
230470,201803,1850,1441,409,1374714,389079.1,1763793.1
230480,201803,152,146,6,138997.8,5724,144721.8
230490,201803,280,226,54,215604,51516,267120
230495,201803,436,327,109,311104,103986,415090
230500,201803,934,700,234,666846,223236,890082
230510,201803,46,36,10,34344,9540,43884
230520,201803,387,306,81,291924,77274,369198
230523,201803,1996,1263,733,1203419.8,698834,1902253.8
230526,201803,294,244,50,232776,46909,279685
230530,201803,673,504,169,477612.45,160272.2,637884.65
230533,201803,181,173,8,165042,7632,172674
230535,201803,342,257,85,245178,81090,326268
230540,201803,1822,1595,227,1518987.04,215985.8,1734972.84
230550,201803,3595,2310,1285,2195510.06,1224260.77,3419770.83
230560,201803,575,440,135,417661.8,127836,545497.8
230565,201803,193,140,53,133560,50562,184122
230570,201803,301,268,33,255672,31482,287154
230580,201803,1101,813,288,774142.38,273575.44,1047717.82
230590,201803,952,740,212,701717.1,201771,903488.1
230600,201803,248,225,23,213906.07,21942,235848.07
230610,201803,337,270,67,257390,63918,321308
230620,201803,164,135,29,127836,27666,155502
230625,201803,716,515,201,489927.5,190600.68,680528.18
230630,201803,1248,988,260,942552,247658.4,1190210.4
230640,201803,3477,3005,472,2859535.45,449529.57,3309065.02
230650,201803,395,344,51,327316.37,48654,375970.37
230655,201803,638,553,85,526608.8,81010.07,607618.87
230660,201803,334,280,54,267120,51229.8,318349.8
230670,201803,425,378,47,360612,44838,405450
230680,201803,198,182,16,173628,15264,188892
230690,201803,859,750,109,715500,103986,819486
230700,201803,697,590,107,562840.92,101791.8,664632.72
230710,201803,732,692,40,659978,38160,698138
230720,201803,147,124,23,117904.86,21942,139846.86
230725,201803,231,181,50,172674,47691,220365
230730,201803,11638,6314,5324,6007062.7,5071018.22,11078080.92
230740,201803,652,522,130,497702,123329.46,621031.46
230750,201803,797,682,115,649436.3,109710,759146.3
230760,201803,1304,1131,173,1074927.25,165042,1239969.25
230763,201803,319,263,56,248946.95,53424,302370.95
230765,201803,6833,3209,3624,3055645.69,3455289.98,6510935.67
230770,201803,4966,2551,2415,2424280.6,2301230.14,4725510.74
230780,201803,680,595,85,564490.1,80789.69,645279.79
230790,201803,192,158,34,150732,31635.4,182367.4
230800,201803,1111,812,299,774624.15,285246,1059870.15
230810,201803,1283,1144,139,1090374.3,132415.2,1222789.5
230820,201803,333,241,92,228961,87768,316729
230830,201803,936,811,125,770180.41,119250,889430.41
230835,201803,276,238,38,226098,35537,261635
230837,201803,163,138,25,131652,23850,155502
230840,201803,900,720,180,685640.5,170480,856120.5
230850,201803,1479,1290,189,1230183,180020,1410203
230860,201803,300,223,77,212742,73458,286200
230870,201803,1787,1515,272,1444356,258152.8,1702508.8
230880,201803,36,25,11,23850,10494,34344
230890,201803,567,520,47,495957.8,44824,540781.8
230900,201803,272,207,65,197478,61813,259291
230910,201803,204,165,39,156646.8,37206,193852.8
230920,201803,392,309,83,294786,79182,373968
230930,201803,919,647,272,614376.64,259488,873864.64
230940,201803,825,663,162,632502,154358,786860
230945,201803,472,395,77,376640,73458,450098
230950,201803,381,325,56,310050,53424,363474
230960,201803,2498,1699,799,1614118.84,761960,2376078.84
230970,201803,1736,978,758,932101.9,722254.32,1654356.22
230980,201803,210,180,30,171720,28620,200340
230990,201803,139,112,27,106848,25001.47,131849.47
231000,201803,207,188,19,177444,18126,195570
231010,201803,136,106,30,100551.6,28620,129171.6
231020,201803,1284,889,395,846485,376830,1223315
231025,201803,939,704,235,668327.78,222644.8,890972.58
231030,201803,1138,953,185,909158,176204,1085362
231040,201803,140,95,45,89885.88,42199,132084.88
231050,201803,981,875,106,832985.9,101124,934109.9
231060,201803,140,124,16,118296,15264,133560
231070,201803,1419,1002,417,953717.1,397818,1351535.1
231080,201803,264,244,20,231965.1,19080,251045.1
231085,201803,547,339,208,322453,198432,520885
231090,201803,243,202,41,192708,39114,231822
231095,201803,164,131,33,124974,31482,156456
231100,201803,122,101,21,96354,18793.8,115147.8
231110,201803,347,302,45,287399,42930,330329
231120,201803,297,255,42,242311.86,40039,282350.86
231123,201803,135,128,7,122112,6678,128790
231126,201803,282,241,41,229914,39114,269028
231130,201803,4561,3543,1018,3370794.5,970099.26,4340893.76
231135,201803,202,172,30,164088,27354.4,191442.4
231140,201803,3030,2233,797,2127172.91,759345.84,2886518.75
231150,201803,355,338,17,322452,16218,338670
231160,201803,1202,945,257,898477.7,244949.04,1143426.74
231170,201803,531,351,180,334854,171720,506574
231180,201803,1600,1356,244,1292860.8,232776,1525636.8
231190,201803,196,175,21,166950,20034,186984
231195,201803,215,186,29,176720,27666,204386
231200,201803,827,682,145,650628,137070,787698
231210,201803,603,504,99,479862.8,94446,574308.8
231220,201803,1035,752,283,715768.12,269982,985750.12
231230,201803,1381,1105,276,1052968.04,262540.8,1315508.84
231240,201803,1360,983,377,937495.8,358418.2,1295914.0
231250,201803,110,102,8,97308,7632,104940
231260,201803,289,186,103,177444,97976,275420
231270,201803,986,825,161,781820.68,153307.8,935128.48
231280,201803,56,44,12,41976,11448,53424
231290,201803,7134,3970,3164,3779998.24,3016111.21,6796109.45
231300,201803,625,576,49,549504,46746,596250
231310,201803,701,652,49,620791,46746,667537
231320,201803,564,436,128,415468,122112,537580
231325,201803,86,77,9,73458,8586,82044
231330,201803,2018,1555,463,1477464.66,438746.6,1916211.26
231335,201803,243,215,28,205110,26712,231822
231340,201803,1602,1179,423,1123050.08,403255.8,1526305.88
231350,201803,1151,939,212,895806,201676,1097482
231355,201803,389,337,52,321498,49608,371106
231360,201803,473,374,99,354086.2,94446,448532.2
231370,201803,91,74,17,70596,16218,86814
231375,201803,285,207,78,197478,74412,271890
231380,201803,444,360,84,341844.69,79945.2,421789.89
231390,201803,194,158,36,150732,34344,185076
231395,201803,727,442,285,420370.56,271890,692260.56
231400,201803,1048,867,181,824546.84,172331.38,996878.22
231410,201803,1296,1049,247,996121.4,234685,1230806.4
240010,201803,387,180,207,170568.26,197469,368037.26
240020,201803,2187,1709,478,1628799.89,456008,2084807.89
240030,201803,134,113,21,107802,20034,127836
240040,201803,33,33,0,31482,0,31482
240050,201803,510,437,73,416044.45,69642,485686.45
240060,201803,66,62,4,59148,3816,62964
240070,201803,178,138,40,131652,38160,169812
240080,201803,439,295,144,281426,137376,418802
240090,201803,102,91,11,86508.72,10494,97002.72
240100,201803,1434,1350,84,1284927.55,79945.2,1364872.75
240110,201803,972,615,357,585738.26,340578,926316.26
240120,201803,139,117,22,111618,20988,132606
240130,201803,289,271,18,257817.54,17172,274989.54
240140,201803,79,62,17,59148,16218,75366
240145,201803,677,597,80,569013.3,76110.12,645123.42
240150,201803,20,15,5,14310,4741.38,19051.38
240160,201803,44,38,6,36252,5724,41976
240165,201803,35,29,6,27428,5724,33152
240170,201803,92,71,21,67734,20034,87768
240180,201803,77,63,14,60102,13356,73458
240185,201803,40,37,3,35288.46,2862,38150.46
240190,201803,14,12,2,11448,1908,13356
240200,201803,3000,1688,1312,1604371.67,1250409,2854780.67
240210,201803,162,128,34,122112,32436,154548
240220,201803,1102,791,311,754471,296684.46,1051155.46
240230,201803,818,758,60,720298.05,56592,776890.05
240240,201803,118,85,33,81090,31482,112572
240250,201803,92,80,12,76320,11448,87768
240260,201803,1790,1330,460,1268133.12,437857.38,1705990.50
240270,201803,190,168,22,159890.4,20988,180878.4
240280,201803,43,33,10,31482,9540,41022
240290,201803,48,47,1,44838,954,45792
240300,201803,179,99,80,94446,76320,170766
240310,201803,1985,1085,900,1023785.98,855363.57,1879149.55
240320,201803,207,197,10,187938,9540,197478
240325,201803,4300,2630,1670,2502008.46,1591011.22,4093019.68
240330,201803,65,62,3,59148,2862,62010
240340,201803,101,73,28,69642,26712,96354
240350,201803,90,80,10,76320,9540,85860
240360,201803,382,271,111,258534,105894,364428
240370,201803,36,34,2,32436,1908,34344
240375,201803,71,41,30,39114,28620,67734
240380,201803,233,189,44,180306,41881,222187
240390,201803,15,13,2,12402,1908,14310
240400,201803,78,74,4,70596,3816,74412
240410,201803,10,6,4,5724,3816,9540
240420,201803,879,684,195,651154.6,184980.6,836135.2
240430,201803,263,248,15,234569.69,14310,248879.69
240440,201803,69,36,33,34344,31482,65826
240450,201803,206,139,67,132033.8,63918,195951.8
240460,201803,60,47,13,44838,12402,57240
240470,201803,235,204,31,194058.86,29574,223632.86
240480,201803,14,14,0,13260.6,0,13260.6
240485,201803,75,65,10,62010,9540,71550
240490,201803,45,45,0,42720.12,0,42720.12
240500,201803,84,66,18,62964,17172,80136
240510,201803,52,37,15,35298,14310,49608
240520,201803,124,118,6,112572,5724,118296
240530,201803,49,44,5,41976,4770,46746
240540,201803,78,67,11,63918,10494,74412
240550,201803,15,13,2,12402,1908,14310
240560,201803,371,275,96,261723.23,91584,353307.23
240570,201803,462,286,176,271985.4,167904,439889.4
240580,201803,1254,1014,240,961871.9,227802.2,1189674.1
240590,201803,30,28,2,26712,1908,28620
240600,201803,109,108,1,103032,954,103986
240610,201803,509,426,83,406047.7,78419,484466.7
240615,201803,20,19,1,18126,954,19080
240620,201803,95,91,4,86814,3816,90630
240630,201803,33,31,2,29574,1908,31482
240640,201803,26,22,4,20988,3816,24804
240650,201803,235,198,37,188033.9,35298,223331.9
240660,201803,99,86,13,82044,12402,94446
240670,201803,288,170,118,160081.3,112572,272653.3
240680,201803,48,37,11,35298,10494,45792
240690,201803,49,46,3,43884,2862,46746
240700,201803,196,163,33,155502,31482,186984
240710,201803,1921,1224,697,1167262.83,664928.46,1832191.29
240720,201803,1050,770,280,733426.66,267120,1000546.66
240725,201803,66,63,3,60102,2862,62964
240730,201803,133,114,19,108756,18126,126882
240740,201803,241,204,37,193251.78,34344.02,227595.80
240750,201803,34,22,12,20988,11448,32436
240760,201803,32,28,4,26712,3816,30528
240770,201803,148,113,35,107802,33390,141192
240780,201803,700,579,121,550925.46,115434,666359.46
240790,201803,38,37,1,35298,954,36252
240800,201803,8544,5791,2753,5486810.44,2620105.2,8106915.64
240810,201803,19948,10967,8981,10421174.57,8558046.68,18979221.25
240820,201803,213,132,81,125637.03,77274,202911.03
240830,201803,1598,1308,290,1241307.16,275706,1517013.16
240840,201803,79,69,10,65826,9540,75366
240850,201803,85,74,11,70596,10494,81090
240860,201803,114,111,3,105894,2862,108756
240870,201803,60,53,7,50562,6678,57240
240880,201803,29,26,3,24794.46,2862,27656.46
240890,201803,1149,676,473,640994.78,451238,1092232.78
240895,201803,42,32,10,30528,9540,40068
240910,201803,153,138,15,131652,14310,145962
240920,201803,14,11,3,10494,2862,13356
240930,201803,381,344,37,327222,35298,362520
240933,201803,30,22,8,20988,7632,28620
240940,201803,2428,2146,282,2033791.29,266146.92,2299938.21
240950,201803,51,48,3,45792,2862,48654
240960,201803,31,25,6,23850,5724,29574
240970,201803,131,94,37,89676,34544,124220
240980,201803,189,151,38,144054,36252,180306
240990,201803,118,79,39,75366,37206,112572
241000,201803,70,65,5,62010,4770,66780
241010,201803,57,46,11,43884,10494,54378
241020,201803,116,109,7,103986,6678,110664
241025,201803,9,3,6,2862,5724,8586
241030,201803,120,98,22,93492,20988,114480
241040,201803,34,29,5,27666,4770,32436
241050,201803,92,80,12,76320,11448,87768
241060,201803,27,24,3,22896,2862,25758
241070,201803,14,14,0,13356,0,13356
241080,201803,65,57,8,54091.8,7632,61723.8
241090,201803,50,40,10,38160,9525.69,47685.69
241100,201803,73,64,9,61056,8586,69642
241105,201803,6,2,4,1908,3816,5724
241110,201803,47,45,2,42930,1908,44838
241120,201803,1420,1101,319,1047368.8,304326,1351694.8
241140,201803,224,183,41,173629,39114,212743
241142,201803,41,40,1,38160,954,39114
241150,201803,1210,1064,146,1012338,139284,1151622
241160,201803,22,21,1,20034,954,20988
241170,201803,42,39,3,37206,2862,40068
241180,201803,51,42,9,39893.42,8586,48479.42
241190,201803,38,37,1,35298,954,36252
241200,201803,3846,2103,1743,2000727.42,1660901.66,3661629.08
241210,201803,72,60,12,57240,10590,67830
241220,201803,1362,909,453,866663.04,432128.92,1298791.96
241230,201803,246,208,38,198241.2,36252,234493.2
241240,201803,52,40,12,38160,11448,49608
241250,201803,1078,1001,77,954668,73172,1027840
241255,201803,46,37,9,35298,8586,43884
241260,201803,627,496,131,473179.23,124974,598153.23
241270,201803,44,31,13,29574,12402,41976
241280,201803,98,86,12,82044,11448,93492
241290,201803,108,81,27,77274,25758,103032
241300,201803,77,54,23,51516,21942,73458
241310,201803,51,38,13,36109,12402,48511
241320,201803,26,14,12,13356,11448,24804
241330,201803,59,53,6,50562,5724,56286
241335,201803,62,55,7,51897.6,6678,58575.6
241340,201803,187,142,45,135468,42930,178398
241350,201803,57,52,5,49608,4770,54378
241355,201803,41,38,3,36252,2862,39114
241360,201803,46,46,0,43884,0,43884
241370,201803,44,36,8,34219.98,7632,41851.98
241380,201803,39,37,2,35298,1908,37206
241390,201803,76,61,15,58003.2,14310,72313.2
241400,201803,194,160,34,151972.2,32436,184408.2
241410,201803,176,159,17,151686,16122.6,167808.6
241415,201803,94,75,19,71550,18126,89676
241420,201803,97,74,23,70596,21771,92367
241430,201803,28,27,1,25758,954,26712
241440,201803,457,386,71,368230,67734,435964
241445,201803,37,35,2,33390,1908,35298
241450,201803,276,225,51,214523,48654,263177
241460,201803,135,123,12,117104,11448,128552
241470,201803,43,36,7,34344,6678,41022
241475,201803,65,61,4,58194,3816,62010
241480,201803,99,70,29,65540.69,27666,93206.69
241490,201803,9,8,1,7632,954,8586
241500,201803,47,34,13,32436,12402,44838
250010,201803,101,87,14,82854.9,13356,96210.9
250020,201803,26,23,3,21942,2862,24804
250030,201803,805,596,209,567239.2,198337.6,765576.8
250040,201803,331,277,54,264258,51229.8,315487.8
250050,201803,230,190,40,180969.8,38160,219129.8
250053,201803,54,42,12,40068,11448,51516
250057,201803,0,0,0,0,0,0
250060,201803,447,341,106,325314,100837.8,426151.8
250070,201803,701,583,118,554164,112572,666736
250073,201803,7,7,0,6678,0,6678
250077,201803,200,149,51,141754.86,48654,190408.86
250080,201803,421,331,90,314153.2,85860,400013.2
250090,201803,198,133,65,125928.4,61990.92,187919.32
250100,201803,466,381,85,363474,80709,444183
250110,201803,485,366,119,347380.02,113526,460906.02
250115,201803,28,9,19,8586,18126,26712
250120,201803,113,86,27,82044,25758,107802
250130,201803,580,460,120,438840,114290,553130
250135,201803,14,8,6,7632,5724,13356
250140,201803,78,69,9,65826,8586,74412
250150,201803,566,419,147,397558,139923.18,537481.18
250153,201803,10,9,1,8586,954,9540
250157,201803,28,23,5,21942,4770,26712
250160,201803,210,166,44,158364,41976,200340
250170,201803,66,46,20,43884,19080,62964
250180,201803,4017,2696,1321,2558326.9,1255136,3813462.9
250190,201803,903,600,303,570730.5,288346.5,859077.0
250200,201803,50,42,8,40068,7632,47700
250205,201803,21,19,2,18126,1908,20034
250210,201803,90,78,12,74412,11448,85860
250215,201803,63,54,9,51516,8586,60102
250220,201803,27,21,6,20034,5724,25758
250230,201803,76,69,7,65822,6678,72500
250240,201803,246,202,44,191897.1,41976,233873.1
250250,201803,389,331,58,315774,55332,371106
250260,201803,35,30,5,28620,4770,33390
250270,201803,55,44,11,41976,10494,52470
250280,201803,382,320,62,305280,59148,364428
250290,201803,95,90,5,85573.8,4770,90343.8
250300,201803,557,380,177,361872.71,168845,530717.71
250310,201803,46,41,5,39114,4770,43884
250320,201803,1943,1330,613,1262407.15,583228.8,1845635.95
250330,201803,82,73,9,69642,8586,78228
250340,201803,25,21,4,20034,3816,23850
250350,201803,140,90,50,85573.8,47127.6,132701.4
250355,201803,32,25,7,23850,6678,30528
250360,201803,200,163,37,155502,35060,190562
250370,201803,2380,1615,765,1535751.98,728253.82,2264005.80
250375,201803,16,12,4,11448,3816,15264
250380,201803,52,37,15,35298,14310,49608
250390,201803,42,35,7,33390,6678,40068
250400,201803,15578,7887,7691,7499538.99,7330822.75,14830361.74
250403,201803,421,342,79,326258.46,75366,401624.46
250407,201803,54,46,8,43884,7632,51516
250410,201803,29,24,5,22896,4770,27666
250415,201803,42,28,14,26712,13336.92,40048.92
250420,201803,45,37,8,35298,7632,42930
250430,201803,1637,1386,251,1320051,239454,1559505
250435,201803,15,12,3,11448,2862,14310
250440,201803,687,593,94,563029.38,89676,652705.38
250450,201803,86,73,13,69642,12402,82044
250460,201803,418,285,133,271890,126872.46,398762.46
250470,201803,88,65,23,62010,21942,83952
250480,201803,323,254,69,242316,65826,308142
250485,201803,2,1,1,954,954,1908
250490,201803,205,167,38,159318,36252,195570
250500,201803,75,55,20,52470,19080,71550
250510,201803,732,572,160,544352.6,151631.43,695984.03
250520,201803,173,120,53,114460.92,50557.23,165018.15
250523,201803,111,92,19,87768,18126,105894
250527,201803,104,80,24,76315.23,22896,99211.23
250530,201803,6,5,1,4770,954,5724
250535,201803,25,21,4,20034,3816,23850
250540,201803,124,94,30,88960.5,28620,117580.5
250550,201803,68,65,3,62010,2862,64872
250560,201803,35,29,6,27666,5724,33390
250570,201803,151,120,31,114480,29574,144054
250580,201803,132,103,29,97975.8,27666,125641.8
250590,201803,20,16,4,15264,3816,19080
250600,201803,1323,894,429,850016.25,409170.6,1259186.85
250610,201803,153,132,21,125928,20034,145962
250620,201803,21,17,4,16218,3816,20034
250625,201803,62,46,16,43884,15264,59148
250630,201803,3004,1922,1082,1825545.65,1031160.74,2856706.39
250640,201803,203,168,35,160272,33390,193662
250650,201803,31,21,10,20034,9540,29574
250660,201803,43,33,10,31482,9540,41022
250670,201803,61,41,20,39114,19080,58194
250680,201803,383,314,69,299556,65826,365382
250690,201803,1825,1257,568,1196140.21,541490.8,1737631.01
250700,201803,953,839,114,796869.91,108546.12,905416.03
250710,201803,441,342,99,326268,94159.8,420427.8
250720,201803,103,81,22,77274,20988,98262
250730,201803,366,309,57,293832.6,54378,348210.6
250740,201803,48,44,4,41976,3816,45792
250750,201803,20299,12137,8162,11521478.9,7777777.87,19299256.77
250760,201803,68,51,17,48654,16218,64872
250770,201803,351,235,116,222282.14,109495.55,331777.69
250780,201803,57,44,13,41976,12402,54378
250790,201803,481,314,167,296694.92,158602.5,455297.42
250800,201803,151,140,11,132844.5,10494,143338.5
250810,201803,78,59,19,56286,18126,74412
250820,201803,158,127,31,121158,29574,150732
250830,201803,424,286,138,271842.5,131652,403494.5
250840,201803,53,51,2,48654,1908,50562
250850,201803,53,41,12,38427.12,11448,49875.12
250855,201803,13,11,2,10494,1908,12402
250860,201803,204,146,58,139284,55045.8,194329.8
250870,201803,33,30,3,28620,2862,31482
250880,201803,80,61,19,58136.76,18126,76262.76
250890,201803,2392,1766,626,1683428.4,596340.73,2279769.13
250900,201803,116,99,17,94446,16218,110664
250905,201803,125,96,29,91584,27666,119250
250910,201803,1171,834,337,794473.31,321211.8,1115685.11
250915,201803,109,74,35,70596,33390,103986
250920,201803,135,104,31,99216,29574,128790
250930,201803,159,98,61,93492,58194,151686
250933,201803,0,0,0,0,0,0
250937,201803,6,5,1,4770,954,5724
250939,201803,31,23,8,21942,7632,29574
250940,201803,108,82,26,78228,24804,103032
250950,201803,71,47,24,44838,22896,67734
250960,201803,90,50,40,47700,38160,85860
250970,201803,1205,859,346,817865,329130,1146995
250980,201803,90,63,27,60102,25758,85860
250990,201803,166,130,36,123562.08,34301.07,157863.15
251000,201803,74,67,7,63727.2,6678,70405.2
251010,201803,100,77,23,73454,21163.53,94617.53
251020,201803,80,69,11,65015.1,10494,75509.1
251030,201803,42,32,10,30528,9540,40068
251040,201803,53,38,15,36252,14310,50562
251050,201803,24,22,2,20988,1908,22896
251060,201803,51,41,10,38160,9540,47700
251065,201803,3,3,0,2862,0,2862
251070,201803,25,20,5,19071,4770,23841
251080,201803,4704,2285,2419,2167339.06,2301173.01,4468512.07
251090,201803,195,167,28,159318,26712,186030
251100,201803,18,17,1,16218,954,17172
251110,201803,46,37,9,35298,8586,43884
251120,201803,1774,1068,706,1013962.2,673524,1687486.2
251130,201803,355,288,67,274752,63918,338670
251140,201803,506,329,177,312722.8,168689.34,481412.14
251150,201803,292,252,40,239636,38160,277796
251160,201803,95,80,15,76316,14310,90626
251170,201803,98,78,20,74383.38,19075.23,93458.61
251180,201803,288,181,107,172665.23,102069.23,274734.46
251190,201803,193,131,62,124645.83,59148,183793.83
251200,201803,252,206,46,196524,43884,240408
251203,201803,33,31,2,29574,1908,31482
251207,201803,94,77,17,73458,16218,89676
251210,201803,1259,903,356,859908.53,338956.2,1198864.73
251220,201803,47,36,11,34344,10494,44838
251230,201803,470,394,76,375876,72504,448380
251240,201803,100,72,28,67734,26712,94446
251250,201803,1318,947,371,900548.87,353791,1254339.87
251260,201803,13,8,5,7632,4770,12402
251270,201803,345,254,91,242316,86671,328987
251272,201803,67,61,6,58194,5724,63918
251274,201803,29,24,5,22896,4770,27666
251275,201803,22,15,7,14310,6678,20988
251276,201803,18,14,4,13356,3816,17172
251278,201803,9,7,2,6678,1908,8586
251280,201803,97,93,4,88722,3816,92538
251290,201803,694,525,169,500850,161226,662076
251300,201803,16,14,2,13356,1908,15264
251310,201803,361,258,103,246128,98262,344390
251315,201803,18,17,1,16218,954,17172
251320,201803,60,49,11,46746,10494,57240
251330,201803,79,70,9,66780,8586,75366
251335,201803,11,7,4,6678,3816,10494
251340,201803,693,411,282,392094,268003.25,660097.25
251350,201803,35,33,2,31482,1908,33390
251360,201803,65,57,8,54171.94,7632,61803.94
251365,201803,14,14,0,13356,0,13356
251370,201803,5272,3583,1689,3413339.04,1609606.08,5022945.12
251380,201803,49,39,10,37206,9540,46746
251385,201803,2,2,0,1908,0,1908
251390,201803,667,532,135,506384.2,127550,633934.2
251392,201803,28,18,10,17172,9540,26712
251394,201803,9,9,0,8586,0,8586
251396,201803,18,13,5,12402,4770,17172
251398,201803,17,15,2,14310,1908,16218
251400,201803,40,33,7,31482,6678,38160
251410,201803,34,29,5,27666,4770,32436
251420,201803,107,80,27,76320,25758,102078
251430,201803,38,36,2,34344,1908,36252
251440,201803,34,22,12,20988,11448,32436
251445,201803,53,48,5,45792,4770,50562
251450,201803,418,369,49,350370.8,46746,397116.8
251455,201803,2,1,1,954,954,1908
251460,201803,17,13,4,12402,3816,16218
251465,201803,5,2,3,1908,2862,4770
251470,201803,46,36,10,34344,9540,43884
251480,201803,24,22,2,20988,1908,22896
251490,201803,131,92,39,87291,36253,123544
251500,201803,117,94,23,89676,21179,110855
251510,201803,35,27,8,25758,7632,33390
251520,201803,26,26,0,24804,0,24804
251530,201803,4520,3175,1345,3022650.24,1282834.26,4305484.50
251540,201803,73,65,8,62010,7632,69642
251550,201803,410,317,93,301464.2,87912,389376.2
251560,201803,22,17,5,16218,4770,20988
251570,201803,19,19,0,18126,0,18126
251580,201803,119,97,22,92538,20988,113526
251590,201803,124,92,32,87949,30528,118477
251593,201803,19,10,9,9540,8586,18126
251597,201803,57,47,10,44838,9540,54378
251600,201803,1099,781,318,743296.28,301763.92,1045060.20
251610,201803,212,160,52,151972.2,48941,200913.2
251615,201803,3,3,0,2862,0,2862
251620,201803,4231,2829,1402,2689025.84,1334743.28,4023769.12
251630,201803,453,333,120,317682,114471,432153
251640,201803,148,107,41,102078,39114,141192
251650,201803,263,191,72,180381.1,68688,249069.1
251660,201803,223,203,20,192708.1,18889.2,211597.3
251670,201803,360,282,78,267332,74412,341744
251675,201803,3,3,0,2862,0,2862
251680,201803,87,79,8,75366,7632,82998
251690,201803,341,286,55,271890,52119.89,324009.89
251700,201803,280,234,46,222649.29,43869.69,266518.98
251710,201803,19,12,7,11448,6678,18126
251720,201803,33,22,11,20988,10208,31196
251740,201803,10,8,2,7632,1908,9540
260005,201803,3115,1773,1342,1680353.34,1279101.1,2959454.44
260010,201803,1435,1024,411,973176.34,390091.32,1363267.66
260020,201803,430,377,53,359658,50562,410220
260030,201803,577,420,157,399912.98,149778,549690.98
260040,201803,857,521,336,495946.44,320391.36,816337.80
260050,201803,1135,815,320,777272,304708,1081980
260060,201803,417,377,40,358894.8,38160,397054.8
260070,201803,1452,910,542,864018,514098.36,1378116.36
260080,201803,729,578,151,550601.1,144054,694655.1
260090,201803,575,355,220,338442.12,209880,548322.12
260100,201803,226,158,68,149731.2,64872,214603.2
260105,201803,235,133,102,126882,97308,224190
260110,201803,2737,2036,701,1942335,667944,2610279
260120,201803,2901,1463,1438,1385983.95,1369564.1,2755548.05
260130,201803,149,104,45,99216,42930,142146
260140,201803,2112,1387,725,1314707.56,690105.46,2004813.02
260150,201803,228,151,77,144054,73458,217512
260160,201803,294,252,42,240408,40068,280476
260170,201803,3354,2051,1303,1950889.8,1241964.9,3192854.7
260180,201803,135,113,22,107802,20988,128790
260190,201803,2247,1602,645,1525157.9,615330,2140487.9
260200,201803,891,733,158,698507.08,150446,848953.08
260210,201803,1414,1003,411,956711.27,390845.11,1347556.38
260220,201803,713,654,59,623916,56286,680202
260230,201803,1194,907,287,863086.99,273798,1136884.99
260240,201803,219,165,54,156236.58,51516,207752.58
260250,201803,74,59,15,56286,14310,70596
260260,201803,986,709,277,676386,264258,940644
260270,201803,428,347,81,329655.2,76987.8,406643.0
260280,201803,1291,877,414,836181,394670,1230851
260290,201803,6384,3389,2995,3214302.35,2850520,6064822.35
260300,201803,854,751,103,714385.6,97976,812361.6
260310,201803,498,397,101,377359.47,96354,473713.47
260320,201803,885,667,218,636031.2,207972,844003.2
260330,201803,34,27,7,25758,6678,32436
260340,201803,67,48,19,45792,18126,63918
260345,201803,5652,3187,2465,3033935.43,2350609.54,5384544.97
260350,201803,467,340,127,322616.08,120205,442821.08
260360,201803,284,145,139,138330,132606,270936
260370,201803,644,419,225,397116.4,214510,611626.4
260380,201803,600,432,168,412128,159127.56,571255.56
260390,201803,291,249,42,236467.98,39114,275581.98
260392,201803,94,82,12,78228,11448,89676
260400,201803,4052,2335,1717,2217351.06,1637656.22,3855007.28
260410,201803,14254,7682,6572,7312493.67,6266957,13579450.67
260415,201803,123,111,12,105894,11448,117342
260420,201803,1769,1053,716,999523.2,681267.64,1680790.84
260430,201803,189,173,16,163830.66,15264,179094.66
260440,201803,229,165,64,156686,61056,217742
260450,201803,474,343,131,325937,124974,450911
260460,201803,848,451,397,427584.8,378733.23,806318.03
260470,201803,376,232,144,220564.8,136995,357559.8
260480,201803,206,129,77,123066,73458,196524
260490,201803,208,167,41,159318,39114,198432
260500,201803,1128,758,370,720844.2,351883.8,1072728.0
260510,201803,737,586,151,559044,143100,702144
260515,201803,260,232,28,221328,26235,247563
260520,201803,3308,1957,1351,1859678.52,1286651.82,3146330.34
260530,201803,781,633,148,601062.64,141192,742254.64
260540,201803,572,433,139,413082,131652.72,544734.72
260545,201803,13,10,3,9540,2862,12402
260550,201803,340,212,128,202248,122112,324360
260560,201803,523,393,130,374331,123733.8,498064.8
260570,201803,1010,832,178,790723.8,169525.8,960249.6
260580,201803,267,239,28,228006,26712,254718
260590,201803,653,373,280,354430.08,267120,621550.08
260600,201803,8165,4154,4011,3940261.58,3822530.13,7762791.71
260610,201803,497,331,166,315774,158077.8,473851.8
260620,201803,3636,1895,1741,1796140.79,1656742.25,3452883.04
260630,201803,72,69,3,65826,2862,68688
260640,201803,3620,1976,1644,1881785.58,1568005.02,3449790.60
260650,201803,340,236,104,225144,99173.07,324317.07
260660,201803,494,338,156,322070.4,148203.9,470274.3
260670,201803,100,75,25,71550,23850,95400
260680,201803,3675,2047,1628,1935000.72,1552749.76,3487750.48
260690,201803,118,92,26,87768,24804,112572
260700,201803,322,198,124,188128.8,117462,305590.8
260710,201803,39,36,3,34344,2862,37206
260720,201803,2211,1329,882,1261660.49,840349.98,2102010.47
260730,201803,595,448,147,427392,138043.8,565435.8
260740,201803,62,58,4,55332,3816,59148
260750,201803,642,448,194,427067.64,185076,612143.64
260760,201803,621,340,281,324360,267757,592117
260765,201803,987,518,469,491229.8,447187.5,938417.3
260770,201803,218,164,54,156456,51516,207972
260775,201803,814,482,332,458445.8,316719,775164.8
260780,201803,271,175,96,166950,91584,258534
260790,201803,12395,6798,5597,6457266.49,5331968.93,11789235.42
260795,201803,159,111,48,104730.12,45792,150522.12
260800,201803,279,228,51,217035,48654,265689
260805,201803,175,112,63,106119.14,60102,166221.14
260810,201803,741,645,96,614080.26,91584,705664.26
260820,201803,311,207,104,196148.79,99216,295364.79
260825,201803,204,140,64,133182.99,61056,194238.99
260830,201803,260,168,92,160272,87768,248040
260840,201803,228,166,62,157697,58862,216559
260845,201803,207,143,64,136135.8,61056,197191.8
260850,201803,504,366,138,347500.09,131652,479152.09
260860,201803,254,189,65,180108.34,62010,242118.34
260870,201803,373,267,106,254718,101124,355842
260875,201803,689,481,208,457760.69,198432,656192.69
260880,201803,1573,961,612,914835.09,583657.2,1498492.29
260890,201803,2421,1686,735,1601050.06,700237,2301287.06
260900,201803,1031,705,326,671267.79,311004,982271.79
260910,201803,281,220,61,209880,58194,268074
260915,201803,304,203,101,193662,96234,289896
260920,201803,173,98,75,93492,71550,165042
260930,201803,386,331,55,315774,52384.45,368158.45
260940,201803,2764,1513,1251,1439131.89,1192957.92,2632089.81
260950,201803,1995,1154,841,1094563.82,802285.38,1896849.20
260960,201803,14246,7393,6853,7017649.25,6530287.53,13547936.78
260970,201803,435,373,62,355053,59148,414201
260980,201803,197,173,24,164756,22896,187652
260990,201803,2561,2111,450,2013388.42,428632.2,2442020.62
261000,201803,4323,2555,1768,2424046.96,1684774.34,4108821.30
261010,201803,188,137,51,130698,47836.23,178534.23
261020,201803,606,450,156,429157,148013.1,577170.1
261030,201803,221,161,60,153594,57034.89,210628.89
261040,201803,363,326,37,311004,34868.8,345872.8
261050,201803,465,410,55,391140,52470,443610
261060,201803,1322,863,459,821156.75,437886,1259042.75
261070,201803,9026,4606,4420,4369648.93,4207944.85,8577593.78
261080,201803,382,293,89,278750,84906,363656
261090,201803,2231,1713,518,1625622.05,493400,2119022.05
261100,201803,1091,773,318,735105.6,301502.16,1036607.76
261110,201803,8024,4920,3104,4688057.25,2958929.69,7646986.94
261120,201803,278,228,50,217512,47695.23,265207.23
261130,201803,570,329,241,313532.9,229437,542969.9
261140,201803,187,119,68,113526,64872,178398
261150,201803,663,390,273,372060,259774.2,631834.2
261153,201803,74,71,3,66780.31,2862,69642.31
261160,201803,76913,38869,38044,36958530.55,36271078.07,73229608.62
261170,201803,446,333,113,316766.36,107802,424568.36
261180,201803,1771,1086,685,1030921.62,653490,1684411.62
261190,201803,617,427,190,406961.92,181251,588212.92
261200,201803,211,186,25,176726.3,23850,200576.3
261210,201803,35,31,4,29574,3816,33390
261220,201803,2527,1783,744,1695165.13,708917.8,2404082.93
261230,201803,326,241,85,229914,81075.69,310989.69
261240,201803,441,380,61,360087.3,58194,418281.3
261245,201803,223,187,36,178398,34344,212742
261247,201803,153,115,38,109710,36252,145962
261250,201803,2849,1442,1407,1375095.8,1341167.83,2716263.63
261255,201803,253,230,23,219420,21942,241362
261260,201803,862,740,122,705960,116388,822348
261270,201803,172,135,37,128790,35298,164088
261280,201803,157,128,29,122112,27666,149778
261290,201803,124,87,37,82759.5,35298,118057.5
261300,201803,1231,871,360,830934,343440,1174374
261310,201803,752,502,250,478908,237879.9,716787.9
261320,201803,544,367,177,350098.92,168858,518956.92
261330,201803,826,657,169,623779.5,160380.46,784159.96
261340,201803,313,176,137,167904,130698,298602
261350,201803,789,565,224,538056.2,213696,751752.2
261360,201803,1225,796,429,758982.37,409266,1168248.37
261370,201803,4970,3049,1921,2894631.62,1829477.53,4724109.15
261380,201803,573,424,149,402597.64,141860,544457.64
261390,201803,3420,2287,1133,2177018.84,1077021.3,3254040.14
261400,201803,276,250,26,237927.6,24804,262731.6
261410,201803,1060,701,359,668754,342481.23,1011235.23
261420,201803,883,552,331,525627.46,315755.46,841382.92
261430,201803,328,299,29,284400,27379.8,311779.8
261440,201803,113,102,11,97308,10494,107802
261450,201803,2496,2079,417,1980706.24,396807.04,2377513.28
261460,201803,726,579,147,551412.02,140238,691650.02
261470,201803,250,191,59,181404,56286,237690
261480,201803,353,288,65,273513,62006,335519
261485,201803,343,208,135,197764.2,128790,326554.2
261500,201803,629,426,203,406404,193662,600066
261510,201803,43,29,14,27666,13356,41022
261520,201803,126,113,13,107802,12402,120204
261530,201803,4159,2635,1524,2505593.94,1452642.69,3958236.63
261540,201803,1080,666,414,634900.36,394956,1029856.36
261550,201803,287,141,146,133132,139264.92,272396.92
261560,201803,788,526,262,498562.2,248794.6,747356.8
261570,201803,368,288,80,274752,76320,351072
261580,201803,378,299,79,284195.8,75366,359561.8
261590,201803,195,158,37,150732,35298,186030
261600,201803,291,234,57,222473,53901,276374
261610,201803,106,92,14,86936.69,13356,100292.69
261618,201803,65,51,14,48654,13356,62010
261620,201803,201,121,80,115434,76320,191754
261630,201803,581,448,133,425031.6,126882,551913.6
261640,201803,6276,3334,2942,3173275.09,2803053.92,5976329.01
261650,201803,477,299,178,284568.66,169812,454380.66
270010,201803,525,461,64,439508,60293,499801
270020,201803,301,238,63,227048,60102,287150
270030,201803,9144,5842,3302,5559828.85,3147664.96,8707493.81
270040,201803,1925,1172,753,1117792.26,717121.8,1834914.06
270050,201803,176,129,47,123066,44838,167904
270060,201803,116,64,52,61056,49608,110664
270070,201803,902,655,247,623055.82,235333.26,858389.08
270080,201803,39,33,6,31482,5724,37206
270090,201803,19,15,4,14310,3816,18126
270100,201803,1250,824,426,782935.33,404257.7,1187193.03
270110,201803,151,111,40,105894,38160,144054
270120,201803,222,181,41,171822.55,39114,210936.55
270130,201803,254,175,79,166663.8,75079.8,241743.6
270135,201803,98,60,38,57240,36252,93492
270140,201803,1269,765,504,729617.27,479730.75,1209348.02
270150,201803,268,213,55,203202,52470,255672
270160,201803,521,389,132,371106,125260.2,496366.2
270170,201803,715,455,260,432925.2,247229.1,680154.3
270180,201803,72,55,17,52152.04,16008.12,68160.16
270190,201803,101,88,13,83952,12402,96354
270200,201803,107,96,11,91393.2,10494,101887.2
270210,201803,484,251,233,239454,221995.8,461449.8
270220,201803,187,147,40,140238,38160,178398
270230,201803,2087,1238,849,1176971.94,807085.42,1984057.36
270235,201803,736,551,185,525364.51,176124.95,701489.46
270240,201803,3096,2394,702,2272459.67,666916,2939375.67
270250,201803,170,118,52,112572,49608,162180
270255,201803,219,189,30,180306,28238.4,208544.4
270260,201803,329,261,68,248994,64872,313866
270270,201803,115,49,66,46737,62964,109701
270280,201803,209,130,79,124020,75366,199386
270290,201803,1166,873,293,831606.42,278645.46,1110251.88
270300,201803,270,169,101,161226,96067.8,257293.8
270310,201803,917,734,183,697668.46,173858.04,871526.50
270320,201803,883,753,130,717294.8,123733.8,841028.6
270330,201803,271,226,45,214650,42930,257580
270340,201803,60,47,13,44838,12402,57240
270350,201803,94,48,46,45450.45,43884,89334.45
270360,201803,74,41,33,39114,31482,70596
270370,201803,52,39,13,37206,12402,49608
270375,201803,67,38,29,36252,27666,63918
270380,201803,1080,607,473,578124,451242,1029366
270390,201803,194,105,89,100170,84906,185076
270400,201803,702,509,193,484371.27,184113,668484.27
270410,201803,697,498,199,474774.04,189836.46,664610.50
270420,201803,394,255,139,241572,132521.38,374093.38
270430,201803,32076,22849,9227,21741202.1,8793850.91,30535053.01
270440,201803,485,379,106,360755.1,100837.8,461592.9
270450,201803,770,402,368,383269.5,350118.66,733388.16
270460,201803,200,153,47,145962,44838,190800
270470,201803,1351,891,460,849660.69,438840,1288500.69
270480,201803,527,424,103,401414.98,97546.5,498961.48
270490,201803,25,21,4,20034,3816,23850
270500,201803,513,421,92,401634,87768,489402
270510,201803,733,449,284,428346,270936,699282
270520,201803,380,232,148,221119,141192,362311
270530,201803,66,58,8,55332,7632,62964
270540,201803,124,96,28,91584,26712,118296
270550,201803,1716,1293,423,1232245.28,403255.01,1635500.29
270560,201803,314,144,170,137376,162180,299556
270570,201803,452,300,152,285229.56,145008,430237.56
270580,201803,79,57,22,54378,20988,75366
270590,201803,79,66,13,62964,12402,75366
270600,201803,175,145,30,138330,28620,166950
270610,201803,177,142,35,135459,33390,168849
270620,201803,30,29,1,27666,954,28620
270630,201803,3830,2907,923,2762037.57,878386.96,3640424.53
270640,201803,897,655,242,623166.6,230553.8,853720.4
270642,201803,209,176,33,167904,31482,199386
270644,201803,280,193,87,183931.74,82993.23,266924.97
270650,201803,241,139,102,132606,97308,229914
270660,201803,256,206,50,196524,47700,244224
270670,201803,3158,2396,762,2274044.62,724021.87,2998066.49
270680,201803,467,271,196,258525,186979.23,445504.23
270690,201803,1122,704,418,669883.76,398762.46,1068646.22
270700,201803,36,27,9,25758,8586,34344
270710,201803,870,654,216,622297.34,206064,828361.34
270720,201803,246,187,59,178398,55999.8,234397.8
270730,201803,1876,1089,787,1036665.4,748692.2,1785357.6
270740,201803,46,29,17,27666,16218,43884
270750,201803,631,460,171,438650,162467,601117
270760,201803,310,224,86,213696,82044,295740
270770,201803,2697,1705,992,1619296.28,945414,2564710.28
270780,201803,92,57,35,54373.23,33372.46,87745.69
270790,201803,272,181,91,172674,86814,259488
270800,201803,1963,1563,400,1489309.25,380855.88,1870165.13
270810,201803,312,244,68,232761.69,64863.23,297624.92
270820,201803,156,100,56,95400,53329,148729
270830,201803,932,675,257,643183,244892,888075
270840,201803,1412,1027,385,978613.7,365622,1344235.7
270850,201803,1687,1029,658,976744.56,627713.46,1604458.02
270860,201803,2422,1570,852,1495441.4,809910.57,2305351.97
270870,201803,121,65,56,62010,53424,115434
270880,201803,912,668,244,635436.14,231882.58,867318.72
270890,201803,360,264,96,251407.62,91579.23,342986.85
270895,201803,72,61,11,58194,10494,68688
270900,201803,104,80,24,76320,22896,99216
270910,201803,325,259,66,245941.2,62964,308905.2
270915,201803,1802,1072,730,1017799.64,695701.1,1713500.74
270920,201803,475,398,77,379692,73458,453150
270930,201803,6200,4478,1722,4266494.31,1640007.24,5906501.55
270940,201803,2369,1788,581,1703782.88,553302,2257084.88
280010,201803,44,39,5,37206,4770,41976
280020,201803,702,605,97,575231.03,91584,666815.03
280030,201803,19237,12305,6932,11657523.35,6585206.09,18242729.44
280040,201803,339,214,125,204156,117819,321975
280050,201803,375,290,85,276373.8,81090,357463.8
280060,201803,328,217,111,204771.43,105894,310665.43
280067,201803,983,690,293,655501.94,278568.25,934070.19
280070,201803,131,109,22,103986,20988,124974
280100,201803,614,482,132,456988.27,125738,582726.27
280110,201803,75,71,4,67734,3816,71550
280120,201803,627,503,124,479862,118296,598158
280130,201803,1351,841,510,800883.8,486396.9,1287280.7
280140,201803,466,377,89,358799.4,83909.33,442708.73
280150,201803,319,236,83,224464.09,79182,303646.09
280160,201803,97,82,15,78228,14310,92538
280170,201803,582,385,197,365824.56,187938,553762.56
280190,201803,27,25,2,23850,1908,25758
280200,201803,23,15,8,14310,7632,21942
280210,201803,2745,1936,809,1829288.11,766208.97,2595497.08
280220,201803,40,31,9,29574,8586,38160
280230,201803,313,257,56,244343.63,53424,297767.63
280240,201803,112,106,6,100980.9,5724,106704.9
280250,201803,19,12,7,11448,6678,18126
280260,201803,80,69,11,65826,10494,76320
280270,201803,159,122,37,116388,35298,151686
280280,201803,196,125,71,119250,67734,186984
280290,201803,3059,2213,846,2098297.18,805773.25,2904070.43
280300,201803,1093,825,268,785385.27,254908.8,1040294.07
280310,201803,107,102,5,96977.29,4770,101747.29
280320,201803,655,445,210,423694.2,200340,624034.2
280330,201803,358,255,103,243270,98137.98,341407.98
280340,201803,415,332,83,315256.57,78419,393675.57
280350,201803,3403,2618,785,2487605.33,746150.21,3233755.54
280360,201803,463,292,171,278568,162180,440748
280370,201803,98,87,11,82998,10494,93492
280380,201803,56,42,14,40068,13356,53424
280390,201803,186,155,31,147870,29574,177444
280400,201803,343,232,111,220469.8,105894,326363.8
280410,201803,289,234,55,222074,52470,274544
280420,201803,174,146,28,139265,26712,165977
280430,201803,105,77,28,73458,26603.63,100061.63
280440,201803,681,525,156,496940.9,148623.66,645564.56
280445,201803,114,106,8,101124,7632,108756
280450,201803,1072,914,158,869380.2,150732,1020112.2
280460,201803,735,534,201,502575.44,191754,694329.44
280470,201803,192,175,17,166950,15265,182215
280480,201803,2241,1588,653,1499999.21,618920.89,2118920.10
280490,201803,354,325,29,308599,27666,336265
280500,201803,45,40,5,38160,4770,42930
280510,201803,147,113,34,107501.2,32150,139651.2
280520,201803,53,39,14,37206,13356,50562
280530,201803,77,54,23,51516,21942,73458
280540,201803,502,402,100,383508,95113.8,478621.8
280550,201803,707,652,55,619392.6,52470,671862.6
280560,201803,478,415,63,393159.93,60102,453261.93
280570,201803,1773,1350,423,1284171.47,402686.83,1686858.30
280580,201803,595,450,145,427757.6,138235,565992.6
280590,201803,164,100,64,95120.48,61056,156176.48
280600,201803,356,298,58,283547.88,55332,338879.88
280610,201803,143,108,35,102826,33390,136216
280620,201803,545,445,100,423576.5,94446.9,518023.4
280630,201803,163,135,28,128790,26712,155502
280640,201803,209,168,41,159443,39114,198557
280650,201803,79,53,26,50562,24804,75366
280660,201803,130,93,37,88722,35059.5,123781.5
280670,201803,1627,1017,610,964023.76,578195.95,1542219.71
280680,201803,180,153,27,144178.14,25758,169936.14
280690,201803,52,43,9,41022,8586,49608
280700,201803,17,17,0,16218,0,16218
280710,201803,1409,1067,342,1010842.79,325600.2,1336442.99
280720,201803,109,74,35,68036.4,33390,101426.4
280730,201803,27,23,4,21942,3816,25758
280740,201803,2395,1763,632,1676089.11,601536.46,2277625.57
280750,201803,291,251,40,239454,38160,277614
280760,201803,881,601,280,572029.2,267120,839149.2
290010,201803,199,133,66,126882,62964,189846
290020,201803,177,164,13,156456,12402,168858
290030,201803,593,385,208,366622.2,198432,565054.2
290035,201803,139,113,26,104597.7,24804,129401.7
290040,201803,267,167,100,159318,95400,254718
290050,201803,75,56,19,53424,18126,71550
290060,201803,253,112,141,106561.8,134514,241075.8
290070,201803,5585,2759,2826,2624647.67,2691480.5,5316128.17
290080,201803,501,227,274,216252.72,261377,477629.72
290090,201803,380,164,216,156456,206064,362520
290100,201803,1586,1043,543,990827.1,517449.8,1508276.9
290110,201803,753,449,304,426720.2,289773.5,716493.7
290115,201803,212,195,17,185076,16218,201294
290120,201803,779,503,276,479194.2,263304,742498.2
290130,201803,418,249,169,237250.26,161226,398476.26
290135,201803,296,225,71,213972.66,67734,281706.66
290140,201803,301,246,55,234684,52279.2,286963.2
290150,201803,130,97,33,92538,31482,124020
290160,201803,245,189,56,179066.58,53424,232490.58
290170,201803,88,62,26,59148,24804,83952
290180,201803,154,121,33,115434,31482,146916
290190,201803,447,363,84,346016,79849.8,425865.8
290195,201803,303,176,127,167904,121158,289062
290200,201803,282,238,44,227052,41976,269028
290205,201803,138,85,53,81090,50562,131652
290210,201803,1125,817,308,778274.2,293832,1072106.2
290220,201803,217,119,98,113049,93492,206541
290225,201803,280,107,173,102078,165042,267120
290230,201803,63,41,22,39114,20988,60102
290240,201803,309,123,186,117055.8,177444,294499.8
290250,201803,274,246,28,233988,26712,260700
290260,201803,275,226,49,214841,46746,261587
290265,201803,180,150,30,142283,28620,170903
290270,201803,1388,1147,241,1092378.2,229051,1321429.2
290280,201803,467,345,122,329130,116388,445518
290290,201803,1217,705,512,667477.89,488448,1155925.89
290300,201803,446,377,69,359367.23,65826,425193.23
290310,201803,322,143,179,136422,170766,307188
290320,201803,3943,2454,1489,2338413.84,1417645,3756058.84
290323,201803,183,159,24,151400,22896,174296
290327,201803,151,119,32,113254.11,30528,143782.11
290330,201803,72,37,35,35298,33390,68688
290340,201803,907,360,547,342467,521552,864019
290350,201803,586,348,238,331229,227052,558281
290360,201803,367,274,93,259489.69,88722,348211.69
290370,201803,912,359,553,342486,527548,870034
290380,201803,307,189,118,180306,112572,292878
290390,201803,2489,1551,938,1476681.58,892648.46,2369330.04
290395,201803,243,134,109,127025.6,103986,231011.6
290400,201803,280,206,74,196238,70596,266834
290405,201803,255,220,35,209880,33390,243270
290410,201803,566,481,85,455869.64,81090,536959.64
290420,201803,234,182,52,173628,49608,223236
290430,201803,494,310,184,295740,175536,471276
290440,201803,73,64,9,61056,7949.96,69005.96
290450,201803,232,178,54,169812,51516,221328
290460,201803,1870,1109,761,1056117.8,725517.52,1781635.32
290470,201803,1444,608,836,578903.22,797229.36,1376132.58
290475,201803,585,547,38,521123,36252,557375
290480,201803,289,161,128,153594,122112,275706
290485,201803,225,210,15,200340,14310,214650
290490,201803,1166,844,322,804412.8,306234.2,1110647.0
290500,201803,672,338,334,321498,318636,640134
290510,201803,219,165,54,156457,51516,207973
290515,201803,136,78,58,74412,55332,129744
290520,201803,1393,899,494,856024.62,468034.42,1324059.04
290530,201803,312,283,29,269982,27666,297648
290540,201803,95,58,37,55332,35298,90630
290550,201803,150,128,22,122112,20658.98,142770.98
290560,201803,3372,1361,2011,1297096.76,1918299.59,3215396.35
290570,201803,5886,3012,2874,2868836.81,2738980.95,5607817.76
290580,201803,1245,729,516,694225.8,491548.5,1185774.3
290590,201803,537,442,95,420877,90630,511507
290600,201803,1717,1189,528,1129605.05,503683.38,1633288.43
290610,201803,218,196,22,186527,20988,207515
290620,201803,323,285,38,271890,35965.8,307855.8
290630,201803,2097,890,1207,844774.5,1145855.3,1990629.8
290640,201803,150,122,28,116388,26712,143100
290650,201803,1701,803,898,765099,856692,1621791
290660,201803,280,228,52,217512,49608,267120
290670,201803,989,513,476,488830,453758.38,942588.38
290680,201803,1178,947,231,902484,219420,1121904
290682,201803,291,213,78,202215.3,74393.46,276608.76
290685,201803,230,147,83,139284,79182,218466
290687,201803,930,615,315,583323.6,299556,882879.6
290689,201803,129,75,54,71536,51501.69,123037.69
290690,201803,648,266,382,253735.92,363548.8,617284.72
290700,201803,239,113,126,107802,120204,228006
290710,201803,702,464,238,442636.92,227052,669688.92
290720,201803,1021,830,191,791820,181737,973557
290730,201803,1115,639,476,607746.5,453150,1060896.5
290740,201803,15,12,3,11448,2862,14310
290750,201803,1350,614,736,583718.08,700032.1,1283750.18
290755,201803,70,62,8,59148,7632,66780
290760,201803,298,259,39,247086,37206,284292
290770,201803,186,175,11,166940.46,10494,177434.46
290780,201803,974,780,194,742176.66,183263.4,925440.06
290790,201803,371,259,112,247086,106848,353934
290800,201803,2623,1048,1575,997622.04,1501443.36,2499065.40
290810,201803,436,302,134,287822,127836,415658
290820,201803,374,232,142,220360,135468,355828
290830,201803,399,272,127,259488,121158,380646
290840,201803,1679,1027,652,977612.8,619928.48,1597541.28
290850,201803,754,417,337,397627.2,320544,718171.2
290860,201803,643,284,359,270936,342200,613136
290870,201803,663,478,185,454791.8,176490,631281.8
290880,201803,125,67,58,63918,55332,119250
290890,201803,328,233,95,222282,90630,312912
290900,201803,169,127,42,121158,40068,161226
290910,201803,361,273,88,260442,83952,344394
290920,201803,230,195,35,186030,33390,219420
290930,201803,810,613,197,584802,187919,772721
290940,201803,250,204,46,193852.8,43884,237736.8
290950,201803,172,99,73,94446,69642,164088
290960,201803,439,293,146,278282.24,138997.8,417280.04
290970,201803,251,220,31,209689.2,29431,239120.2
290980,201803,1491,1056,435,1003255.76,413941.2,1417196.96
290990,201803,369,312,57,297619.92,54322.38,351942.30
291000,201803,864,243,621,231822,591861.6,823683.6
291005,201803,2086,882,1204,839081.76,1147839.03,1986920.79
291010,201803,157,142,15,135468,14310,149778
291020,201803,102,80,22,76320,20988,97308
291030,201803,91,67,24,63918,22896,86814
291040,201803,578,286,292,272844,278568,551412
291050,201803,1335,746,589,710039.23,561619.8,1271659.03
291060,201803,1484,819,665,780658.2,634410,1415068.2
291070,201803,1879,1390,489,1319729.41,464482.3,1784211.71
291072,201803,7290,2671,4619,2544785.58,4404342.42,6949128.00
291075,201803,205,166,39,158364,37206,195570
291077,201803,48,32,16,30528,15264,45792
291080,201803,19508,8516,10992,8100239.5,10473647.24,18573886.74
291085,201803,294,234,60,223236,57235.23,280471.23
291090,201803,304,116,188,110378,179342.46,289720.46
291100,201803,677,196,481,186984,458874,645858
291110,201803,400,300,100,286180.92,95400,381580.92
291120,201803,2507,1181,1326,1126531,1263025.92,2389556.92
291125,201803,60,30,30,28620,28620,57240
291130,201803,213,187,26,178398,24804,203202
291140,201803,121,89,32,84906,30242,115148
291150,201803,378,150,228,143100,217512,360612
291160,201803,361,300,61,285246.5,58194,343440.5
291165,201803,23,19,4,18126,3816,21942
291170,201803,2881,1442,1439,1371900.11,1369753.6,2741653.71
291180,201803,1320,511,809,487297.38,771652.68,1258950.06
291185,201803,74,72,2,68688,1908,70596
291190,201803,1248,535,713,507618.17,679658.8,1187276.97
291200,201803,164,120,44,114480,41976,156456
291210,201803,2198,852,1346,809528.38,1282272.14,2091800.52
291220,201803,266,199,67,188892.64,63918,252810.64
291230,201803,1027,348,679,331134,647766,978900
291240,201803,438,415,23,394670,21942,416612
291250,201803,432,353,79,336762,75366,412128
291260,201803,43,32,11,30528,10494,41022
291270,201803,1202,488,714,465552,680631.8,1146183.8
291280,201803,373,170,203,161974.89,193366.26,355341.15
291290,201803,1760,888,872,845435.2,830840,1676275.2
291300,201803,223,176,47,167236.2,44838,212074.2
291310,201803,231,205,26,195283.8,24804,220087.8
291320,201803,1384,989,395,940644,375781.29,1316425.29
291330,201803,129,110,19,103127.4,18126,121253.4
291340,201803,144,83,61,79182,58194,137376
291345,201803,129,85,44,81090,41976,123066
291350,201803,1572,505,1067,481579.2,1017727.3,1499306.5
291360,201803,8595,4219,4376,4013160.84,4171857.55,8185018.39
291370,201803,1082,596,486,568298,463644,1031942
291380,201803,254,199,55,189846,52184,242030
291390,201803,3890,1687,2203,1604946,2099850,3704796
291400,201803,2075,1486,589,1412493.39,560223.51,1972716.90
291410,201803,152,133,19,125928,18126,144054
291420,201803,110,79,31,75366,29574,104940
291430,201803,169,95,74,89923,69642.53,159565.53
291440,201803,498,397,101,376014.3,96354,472368.3
291450,201803,902,566,336,538724.8,319590,858314.8
291460,201803,1719,1398,321,1331927.1,306234,1638161.1
291465,201803,2201,1020,1181,972234.06,1126392.14,2098626.20
291470,201803,2772,1399,1373,1330860.47,1309112,2639972.47
291480,201803,11843,5210,6633,4959290.55,6318801.65,11278092.20
291490,201803,547,226,321,215604,306234,521838
291500,201803,371,201,170,191754,162180,353934
291510,201803,1234,464,770,441494.99,734293.8,1175788.79
291520,201803,960,438,522,417852,497978.46,915830.46
291530,201803,1010,269,741,256626,706608.72,963234.72
291535,201803,115,95,20,90630,19080,109710
291540,201803,360,107,253,102078,240408.6,342486.6
291550,201803,1182,555,627,527373.1,597758.22,1125131.32
291560,201803,5537,2825,2712,2682179.05,2575023,5257202.05
291570,201803,206,107,99,102078,94446,196524
291580,201803,1216,740,476,705193.46,454090.23,1159283.69
291590,201803,81,31,50,29430.9,47700,77130.9
291600,201803,1370,624,746,594342,711380,1305722
291610,201803,1403,641,762,610230.87,726892,1337122.87
291620,201803,580,268,312,255672,297266.4,552938.4
291630,201803,495,162,333,154548,317682,472230
291640,201803,3902,1961,1941,1863233.7,1850346.98,3713580.68
291650,201803,419,278,141,264077.74,133714.73,397792.47
291660,201803,446,177,269,168165.96,255528.9,423694.86
291670,201803,223,142,81,134896,77274,212170
291680,201803,699,400,299,381600,285141.46,666741.46
291685,201803,581,311,270,296456,257389.2,553845.2
291690,201803,561,290,271,276660,257571,534231
291700,201803,916,724,192,689966.19,182214,872180.19
291710,201803,1702,787,915,750102.28,872033.06,1622135.34
291720,201803,397,263,134,250897.23,127836,378733.23
291730,201803,936,546,390,518928.5,372050.46,890978.96
291733,201803,259,181,78,172387.8,74412,246799.8
291735,201803,65,49,16,46746,15264,62010
291740,201803,343,258,85,246132,81090,327222
291750,201803,1937,1294,643,1227192.78,612600,1839792.78
291760,201803,3057,1650,1407,1567460.54,1339893,2907353.54
291770,201803,807,543,264,515923.26,251856,767779.26
291780,201803,46,27,19,25758,18126,43884
291790,201803,165,76,89,72504,84906,157410
291800,201803,9939,3953,5986,3760086.54,5706447.8,9466534.34
291810,201803,1142,819,323,780749.03,308142,1088891.03
291820,201803,262,190,72,181260,68688,249948
291830,201803,1072,405,667,385149,635355,1020504
291835,201803,608,559,49,532809,46746,579555
291840,201803,4658,2399,2259,2283854.17,2154238.02,4438092.19
291845,201803,302,103,199,98262,189817.38,288079.38
291850,201803,324,282,42,268789.5,40068,308857.5
291855,201803,267,106,161,101124,153594,254718
291860,201803,175,110,65,103986,62010,165996
291870,201803,82,33,49,31482,46746,78228
291875,201803,186,168,18,160272,17172,177444
291880,201803,488,382,106,363618,101124,464742
291890,201803,245,81,164,77264.46,154739,232003.46
291900,201803,57,32,25,30528,23850,54378
291905,201803,133,93,40,88436,38160,126596
291910,201803,175,142,33,135468,31482,166950
291915,201803,389,346,43,328416,41022,369438
291920,201803,4940,2563,2377,2442413.61,2265806.77,4708220.38
291930,201803,182,105,77,100170,73458,173628
291940,201803,319,176,143,167207.58,135468,302675.58
291950,201803,1135,925,210,881687,200340,1082027
291955,201803,1013,602,411,574308,391665,965973
291960,201803,180,124,56,118296,53137.8,171433.8
291970,201803,779,590,189,562860,180306,743166
291980,201803,1496,1322,174,1257775.7,165042.4,1422818.1
291990,201803,123,114,9,108756,8586,117342
291992,201803,164,85,79,80326.8,75366,155692.8
291995,201803,149,105,44,100170,41976,142146
292000,201803,383,290,93,274193.07,88722,362915.07
292010,201803,281,200,81,190133,76320,266453
292020,201803,268,197,71,187938,67734,255672
292030,201803,138,107,31,102078,29574,131652
292040,201803,624,314,310,299556,295740,595296
292045,201803,92,83,9,79182,8586,87768
292050,201803,883,609,274,579976.87,261110,841086.87
292060,201803,936,768,168,730478.78,160272,890750.78
292070,201803,50,21,29,20034,27666,47700
292080,201803,115,79,36,75366,34344,109710
292090,201803,496,174,322,165805.2,307188,472993.2
292100,201803,1402,600,802,570826.7,765079.92,1335906.62
292105,201803,203,171,32,163134,30528,193662
292110,201803,2109,780,1329,743795.64,1265840.91,2009636.55
292120,201803,643,517,126,492085.79,120204,612289.79
292130,201803,446,264,182,251856,173628,425484
292140,201803,197,154,43,146916,40890.26,187806.26
292145,201803,159,86,73,82044,69599.07,151643.07
292150,201803,1417,1134,283,1081836,268954.16,1350790.16
292160,201803,181,148,33,140905.8,31482,172387.8
292170,201803,1217,1066,151,1015271.31,143996.76,1159268.07
292180,201803,200,141,59,134514,56286,190800
292190,201803,157,96,61,91584,58194,149778
292200,201803,1274,461,813,438651.71,774953.56,1213605.27
292205,201803,115,103,12,97975.8,11448,109423.8
292210,201803,369,256,113,242841,107086.5,349927.5
292220,201803,22,16,6,15264,5724,20988
292225,201803,38,35,3,33390,2862,36252
292230,201803,912,736,176,699446.03,167904,867350.03
292240,201803,619,443,176,421525,167904,589429
292250,201803,1688,1072,616,1022688,587664,1610352
292260,201803,437,244,193,232776,183358.8,416134.8
292265,201803,269,189,80,180019.8,76320,256339.8
292270,201803,774,340,434,324360,413082.8,737442.8
292273,201803,199,110,89,104162.49,84906,189068.49
292275,201803,164,80,84,76320,79849.8,156169.8
292280,201803,138,97,41,92538,39114,131652
292285,201803,59,50,9,47032.2,8586,55618.2
292290,201803,551,369,182,349536.47,173342,522878.47
292300,201803,1623,619,1004,589953.8,956982.58,1546936.38
292303,201803,97,66,31,62964,29574,92538
292305,201803,111,79,32,75366,30528,105894
292310,201803,799,502,297,478546,282040.15,760586.15
292320,201803,662,498,164,474805.8,156265,631070.8
292330,201803,187,98,89,93492,84906,178398
292335,201803,273,210,63,200340,60102,260442
292340,201803,571,399,172,379906.85,164088,543994.85
292350,201803,267,142,125,134657.1,118963.8,253620.9
292360,201803,703,531,172,504857,164088,668945
292370,201803,774,590,184,562860,175536,738396
292380,201803,646,501,145,476046.62,138330,614376.62
292390,201803,502,187,315,178398,298745.5,477143.5
292400,201803,3356,2050,1306,1937382.43,1242043.8,3179426.23
292405,201803,264,175,89,166473,84619.8,251092.8
292410,201803,153,90,63,85860,60102,145962
292420,201803,306,261,45,248707.8,42930,291637.8
292430,201803,517,405,112,386370,106371,492741
292440,201803,577,492,85,467574.6,80803.8,548378.4
292450,201803,247,191,56,182214,53424,235638
292460,201803,585,435,150,414417.8,142909.03,557326.83
292465,201803,200,164,36,156456,33606.09,190062.09
292467,201803,103,60,43,57240,41022,98262
292470,201803,251,171,80,163134,76320,239454
292480,201803,325,215,110,204156.5,104654,308810.5
292490,201803,218,143,75,136422,71550,207972
292500,201803,1166,504,662,480605,631090.28,1111695.28
292510,201803,3327,1495,1832,1425276.12,1745000.7,3170276.82
292520,201803,1064,503,561,477997.7,535185,1013182.7
292525,201803,385,274,111,261391.23,105894,367285.23
292530,201803,4223,1727,2496,1644287.04,2379717.96,4024005.00
292540,201803,477,257,220,245178,209880,455058
292550,201803,1059,571,488,543992.74,465047.72,1009040.46
292560,201803,318,299,19,285246,18126,303372
292570,201803,299,227,72,216229,68688,284917
292575,201803,467,300,167,285914,159318,445232
292580,201803,911,576,335,548073,319304,867377
292590,201803,508,435,73,414687.59,69642,484329.59
292593,201803,143,112,31,106848,29574,136422
292595,201803,179,136,43,129744,41022,170766
292600,201803,1234,920,314,877363,298888.2,1176251.2
292610,201803,127,97,30,92538,28362.42,120900.42
292620,201803,520,430,90,409925,85860,495785
292630,201803,1370,788,582,750164,553559.75,1303723.75
292640,201803,763,533,230,508148.1,219420,727568.1
292650,201803,172,147,25,139802,23850,163652
292660,201803,1994,1439,555,1366982.85,525272.83,1892255.68
292665,201803,138,101,37,96354,35298,131652
292670,201803,398,321,77,306230,73458,379688
292680,201803,249,194,55,185076,51993,237069
292690,201803,180,137,43,130698,41022,171720
292700,201803,916,604,312,575262.8,297648,872910.8
292710,201803,97,85,12,81090,11448,92538
292720,201803,827,467,360,444716.64,343440,788156.64
292730,201803,201,95,106,89676.5,101124,190800.5
292740,201803,66191,32763,33428,31184034.15,31860079.64,63044113.79
292750,201803,372,266,106,252810.94,100313.57,353124.51
292760,201803,316,256,60,243213.5,57240,300453.5
292770,201803,788,335,453,319304,432162,751466
292780,201803,421,158,263,150504.48,250902,401406.48
292790,201803,731,357,374,340578,356557.5,697135.5
292800,201803,1138,699,439,665892,418806,1084698
292805,201803,426,123,303,116817.3,289062,405879.3
292810,201803,1465,850,615,809755.8,586414.46,1396170.26
292820,201803,743,596,147,566676.87,139942.8,706619.67
292830,201803,103,82,21,78228,20034,98262
292840,201803,656,539,117,513729,111603.69,625332.69
292850,201803,130,88,42,83948,40068,124016
292860,201803,2136,1247,889,1185566.94,848106,2033672.94
292870,201803,3380,2265,1115,2159547.8,1063700.46,3223248.26
292880,201803,1447,949,498,901579.86,473908.98,1375488.84
292890,201803,481,410,71,391112,67734,458846
292895,201803,137,91,46,85455.5,43884,129339.5
292900,201803,391,289,102,275706,97308,373014
292905,201803,447,230,217,219420,207018,426438
292910,201803,400,304,96,289683,91584,381267
292920,201803,541,236,305,225144,290970,516114
292925,201803,508,472,36,449610.66,34325,483935.66
292930,201803,562,348,214,331992,204156,536148
292935,201803,292,125,167,119250,159318,278568
292937,201803,233,160,73,152640,69642,222282
292940,201803,191,145,46,138330,43884,182214
292950,201803,1092,564,528,535910.5,502759,1038669.5
292960,201803,555,371,184,353934,175536,529470
292970,201803,275,192,83,182501,79182,261683
292975,201803,156,89,67,84906,63728,148634
292980,201803,255,173,82,163258.43,78228,241486.43
292990,201803,1311,969,342,917089.87,325991.93,1243081.80
293000,201803,103,75,28,71550,26712,98262
293010,201803,2656,1631,1025,1550212.92,973813.01,2524025.93
293015,201803,649,515,134,491092.49,127197,618289.49
293020,201803,329,270,59,257580,56286,313866
293030,201803,618,538,80,511726.44,76320,588046.44
293040,201803,338,264,74,251856,70596,322452
293050,201803,2707,1578,1129,1495904.89,1072936.38,2568841.27
293060,201803,251,201,50,190567,46746.8,237313.8
293070,201803,3378,1710,1668,1623487.68,1590051.92,3213539.60
293075,201803,90,58,32,55332,30528,85860
293076,201803,72,46,26,43884,24804,68688
293077,201803,430,263,167,246387.47,159318,405705.47
293080,201803,446,396,50,377784,47700,425484
293090,201803,130,112,18,106848,16854.04,123702.04
293100,201803,517,363,154,346302,146916,493218
293105,201803,342,233,109,221996,103986,325982
293110,201803,169,120,49,114480,46746,161226
293120,201803,316,212,104,202248,99025.2,301273.2
293130,201803,246,165,81,157410,77274,234684
293135,201803,7906,3127,4779,2976526.16,4550929.16,7527455.32
293140,201803,182,118,64,112572,60293,172865
293150,201803,328,278,50,263781.2,47700,311481.2
293160,201803,427,244,183,232776,174582,407358
293170,201803,189,132,57,125642,53520,179162
293180,201803,465,316,149,301178,142146,443324
293190,201803,1277,887,390,841548.73,372060,1213608.73
293200,201803,524,463,61,440622,58194,498816
293210,201803,342,250,92,238348,87052.5,325400.5
293220,201803,2686,1077,1609,1025524.41,1532896.47,2558420.88
293230,201803,1767,638,1129,607221.8,1077066,1684287.8
293240,201803,222,201,21,191754,20034,211788
293245,201803,110,93,17,88722,16218,104940
293250,201803,735,273,462,260194,440748,700942
293260,201803,312,262,50,248994.17,47700,296694.17
293270,201803,1182,562,620,534240.68,591480,1125720.68
293280,201803,239,132,107,125928,102078,228006
293290,201803,3074,2008,1066,1914434.73,1016665,2931099.73
293300,201803,699,496,203,470851.5,191181.6,662033.1
293305,201803,152,130,22,124020,20988,145008
293310,201803,136,102,34,97308,32436,129744
293315,201803,156,120,36,114480,34344,148824
293317,201803,96,67,29,63918,27666,91584
293320,201803,962,554,408,527562.5,389232,916794.5
293325,201803,184,64,120,61056,114441.84,175497.84
293330,201803,12867,6009,6858,5721669.31,6534699.55,12256368.86
293340,201803,250,181,69,172674,64872,237546
293345,201803,244,194,50,185076,47700,232776
293350,201803,630,337,293,321498,278043.3,599541.3
293360,201803,1573,1123,450,1070102,428060.7,1498162.7
310010,201803,152,77,75,73458,71264,144722
310020,201803,1055,577,478,548073.2,454104.12,1002177.32
310030,201803,324,263,61,249776.88,57907.8,307684.68
310040,201803,50,31,19,29574,18126,47700
310050,201803,186,123,63,116388.4,59816,176204.4
310060,201803,232,162,70,154071,66780,220851
310070,201803,16,8,8,7632,7632,15264
310080,201803,50,27,23,25758,21942,47700
310090,201803,956,503,453,474616.68,431017.6,905634.28
310100,201803,298,223,75,212742,71550,284292
310110,201803,733,390,343,371025.1,326268,697293.1
310120,201803,389,216,173,205396.2,164667.94,370064.14
310130,201803,33,20,13,19080,12402,31482
310140,201803,28,16,12,15264,11448,26712
310150,201803,1287,882,405,835658.6,385511.8,1221170.4
310160,201803,2104,1064,1040,1006949.53,989775.4,1996724.93
310163,201803,92,51,41,48654,39114,87768
310170,201803,2562,1052,1510,1003484,1437964.6,2441448.6
310180,201803,129,49,80,46746,75938.4,122684.4
310190,201803,487,327,160,311958,152067.6,464025.6
310200,201803,503,318,185,303372,176204,479576
310205,201803,59,45,14,42930,13356,56286
310210,201803,278,227,51,216558,48654,265212
310220,201803,54,32,22,30528,20988,51516
310230,201803,261,183,78,174391.2,74412,248803.2
310240,201803,106,93,13,88483.5,12402,100885.5
310250,201803,99,80,19,76320,18126,94446
310260,201803,799,428,371,405356.24,353199.42,758555.66
310270,201803,269,178,91,169259,86814,256073
310280,201803,366,273,93,259488.8,88722,348210.8
310285,201803,219,156,63,148515.86,60102,208617.86
310290,201803,257,149,108,142146,103032,245178
310300,201803,157,130,27,124020,25758,149778
310310,201803,7,5,2,4770,1908,6678
310320,201803,23,14,9,13356,8586,21942
310330,201803,31,23,8,21942,7632,29574
310340,201803,1691,1094,597,1035949.8,568012.5,1603962.3
310350,201803,2826,1532,1294,1456706.01,1233894.8,2690600.81
310360,201803,41,33,8,31482,7632,39114
310370,201803,124,102,22,97308,20702,118010
310375,201803,104,37,67,35298,63899,99197
310380,201803,53,31,22,28668,20988,49656
310390,201803,105,72,33,68688,31482,100170
310400,201803,2320,1495,825,1422320,786763.8,2209083.8
310410,201803,126,69,57,65826,54378,120204
310420,201803,669,359,310,340674.8,294777.06,635451.86
310430,201803,330,216,114,205777.8,108756,314533.8
310440,201803,67,41,26,39114,24804,63918
310445,201803,86,68,18,64872,17172,82044
310450,201803,857,539,318,513538.2,303372,816910.2
310460,201803,264,191,73,182214,69642,251856
310470,201803,499,317,182,302418,173628,476046
310480,201803,77,55,22,52470,20988,73458
310490,201803,498,234,264,222282.2,251856,474138.2
310500,201803,124,54,70,51516,66780,118296
310510,201803,606,394,212,374636.6,202229.46,576866.06
310520,201803,127,84,43,80136,41022,121158
310530,201803,87,41,46,39114,43597.8,82711.8
310540,201803,455,281,174,265690.6,165996,431686.6
310550,201803,85,56,29,53424,27666,81090
310560,201803,2916,2010,906,1906772.6,862745.13,2769517.73
310570,201803,126,85,41,81090,39114,120204
310590,201803,347,228,119,216129.8,113511.69,329641.49
310600,201803,158,91,67,85049.7,63918,148967.7
310610,201803,59,21,38,20034,36252,56286
310620,201803,45676,21863,23813,20783096.08,22676630.04,43459726.12
310630,201803,593,378,215,357893.6,203616.28,561509.88
310640,201803,134,113,21,107611.2,20034,127645.2
310650,201803,161,141,20,133274,19080,152354
310660,201803,90,57,33,54378,31482,85860
310665,201803,55,40,15,38160,14310,52470
310670,201803,6346,2924,3422,2781607.17,3259544.47,6041151.64
310680,201803,55,36,19,34344,18126,52470
310690,201803,602,437,165,412692.16,157410,570102.16
310700,201803,63,40,23,38160,21798.9,59958.9
310710,201803,1239,824,415,784842.23,395337.8,1180180.03
310720,201803,86,28,58,26712,55332,82044
310730,201803,1373,955,418,909544.5,398772,1308316.5
310740,201803,1003,564,439,534908.4,418558.46,953466.86
310750,201803,245,143,102,135468.18,97308,232776.18
310760,201803,69,53,16,50562,15264,65826
310770,201803,94,46,48,43884,45792,89676
310780,201803,402,328,74,312330.6,70596,382926.6
310790,201803,102,82,20,78228,19080,97308
310800,201803,454,221,233,210357,221995.8,432352.8
310810,201803,167,116,51,109605.2,47700,157305.2
310820,201803,354,281,73,268074,69355.8,337429.8
310825,201803,192,158,34,150732,32436,183168
310830,201803,463,222,241,211127.94,229914,441041.94
310840,201803,383,217,166,207018,158364,365382
310850,201803,109,88,21,83952,20034,103986
310855,201803,376,297,79,283338,75366,358704
310860,201803,1398,1045,353,992210.1,335026.9,1327237.0
310870,201803,54,42,12,40068,11448,51516
310880,201803,83,65,18,61723.8,17172,78895.8
310890,201803,313,185,128,176490,122112,298602
310900,201803,630,289,341,272887.22,325008.8,597896.02
310910,201803,247,168,79,158937.2,75366,234303.2
310920,201803,487,292,195,274753.2,186030,460783.2
310925,201803,38,31,7,29574,6392,35966
310930,201803,1092,659,433,628283.33,412987.07,1041270.40
310940,201803,679,348,331,331391.8,315774,647165.8
310945,201803,118,73,45,69642,42930,112572
310950,201803,252,198,54,188892,51516,240408
310960,201803,85,31,54,29574,51512,81086
310970,201803,168,105,63,100170,59179.76,159349.76
310980,201803,46,24,22,22896,20988,43884
310990,201803,149,84,65,79850,62010,141860
311000,201803,846,423,423,400013.69,403533,803546.69
311010,201803,40,33,7,31482,6678,38160
311020,201803,41,26,15,24804,14310,39114
311030,201803,389,231,158,218180,150732,368912
311040,201803,38,33,5,31482,4770,36252
311050,201803,461,194,267,184504,254145.6,438649.6
311060,201803,757,432,325,410697.4,309764,720461.4
311070,201803,333,152,181,145008,172674,317682
311080,201803,105,58,47,55332,44838,100170
311090,201803,396,185,211,175250,201294,376544
311100,201803,613,365,248,347923.8,236305.8,584229.6
311110,201803,679,469,210,447139.8,200331,647470.8
311115,201803,67,48,19,45792,18126,63918
311120,201803,1036,540,496,513870,472563.9,986433.9
311130,201803,409,237,172,225907.2,164088,389995.2
311140,201803,162,81,81,77274,76463.1,153737.1
311150,201803,352,232,120,221328,114241.5,335569.5
311160,201803,747,538,209,510867.4,198909,709776.4
311170,201803,79,58,21,55332,19747.8,75079.8
311180,201803,346,229,117,218179.8,111332,329511.8
311190,201803,35,18,17,17172,16218,33390
311200,201803,337,235,102,222568.6,97308,319876.6
311205,201803,29,19,10,18126,9158.4,27284.4
311210,201803,49,41,8,38828,7632,46460
311220,201803,18,16,2,15264,1908,17172
311230,201803,1636,1060,576,1006873.94,549504,1556377.94
311240,201803,170,107,63,101874.33,60102,161976.33
311250,201803,82,31,51,29574,48654,78228
311260,201803,556,352,204,335808,194616,530424
311265,201803,116,81,35,77274,33390,110664
311270,201803,284,204,80,194616,76320,270936
311280,201803,211,95,116,90630,110091.6,200721.6
311290,201803,110,88,22,83952,20416,104368
311300,201803,547,344,203,327222.96,193376,520598.96
311310,201803,23,18,5,17172,4770,21942
311320,201803,673,504,169,479862,161226,641088
311330,201803,1031,757,274,721653.3,260442.4,982095.7
311340,201803,2621,1863,758,1769872.63,722722.86,2492595.49
311350,201803,274,210,64,200340,61056,261396
311360,201803,179,106,73,101124,69642,170766
311370,201803,1202,487,715,462604.5,681537.6,1144142.1
311380,201803,7,6,1,5724,954,6678
311390,201803,283,150,133,143100,126405.2,269505.2
311400,201803,147,97,50,92538,47700,140238
311410,201803,97,54,43,51516,41022,92538
311420,201803,300,165,135,156456.8,128790,285246.8
311430,201803,847,549,298,522698,284292,806990
311440,201803,492,343,149,327222,141859.8,469081.8
311450,201803,319,199,120,189846,114480,304326
311455,201803,303,204,99,194320.8,94159.8,288480.6
311460,201803,131,52,79,49608,74560.27,124168.27
311470,201803,22,12,10,11448,9540,20988
311480,201803,25,10,15,9540,14310,23850
311490,201803,16,10,6,9540,5724,15264
311500,201803,19,10,9,9540,8586,18126
311510,201803,618,436,182,414001.7,173055.8,587057.5
311520,201803,46,33,13,30814.2,12402,43216.2
311530,201803,1802,1345,457,1273687.7,435978,1709665.7
311535,201803,68,51,17,48654,16218,64872
311540,201803,33,29,4,27666,3816,31482
311545,201803,186,140,46,133560,43884,177444
311547,201803,31,22,9,20988,8586,29574
311550,201803,638,299,339,285246,323387.46,608633.46
311560,201803,43,28,15,26712,14310,41022
311570,201803,304,204,100,194043.6,95400,289443.6
311580,201803,310,181,129,172387.8,123066,295453.8
311590,201803,33,29,4,27666,3816,31482
311600,201803,91,72,19,68688,18126,86814
311610,201803,258,224,34,212742.5,32436,245178.5
311615,201803,100,81,19,76634.82,17935.2,94570.02
311620,201803,19,11,8,10494,7632,18126
311630,201803,85,71,14,67734,13356,81090
311640,201803,121,65,56,62010,53424,115434
311650,201803,130,96,34,90868.5,32436,123304.5
311660,201803,405,193,212,184122,202248,386370
311670,201803,167,107,60,101833,57240,159073
311680,201803,223,161,62,152692.95,58384.8,211077.75
311690,201803,18,11,7,10494,6678,17172
311700,201803,200,139,61,132319.8,58194,190513.8
311710,201803,214,137,77,130698,73458,204156
311720,201803,39,28,11,26712,10494,37206
311730,201803,549,362,187,344776,178398,523174
311740,201803,39,28,11,26712,10494,37206
311750,201803,702,479,223,455058.8,212742,667800.8
311760,201803,65,36,29,34344,27666,62010
311770,201803,404,192,212,181260.62,202248,383508.62
311780,201803,169,95,74,90344,70279,160623
311783,201803,80,71,9,67734,8586,76320
311787,201803,35,15,20,14310,19080,33390
311790,201803,260,124,136,118296,129744,248040
311800,201803,642,434,208,410650.3,197764.2,608414.5
311810,201803,43,35,8,33390,7632,41022
311820,201803,109,91,18,86814,17172,103986
311830,201803,1882,1200,682,1139192.5,647003.6,1786196.1
311840,201803,1013,563,450,532810.9,427831.54,960642.44
311850,201803,8,5,3,4770,2862,7632
311860,201803,9477,4321,5156,4105915.2,4910336.09,9016251.29
311870,201803,149,83,66,79182,62964,142146
311880,201803,945,703,242,669126.8,230868,899994.8
311890,201803,218,111,107,105894,102078,207972
311900,201803,88,36,52,34344,49608,83952
311910,201803,1386,858,528,815336.9,501613.4,1316950.3
311920,201803,228,150,78,142862,74412,217274
311930,201803,908,524,384,499227.85,366098,865325.85
311940,201803,2451,1269,1182,1208289.7,1124384.4,2332674.1
311950,201803,34,24,10,22896,9540,32436
311960,201803,65,46,19,43884,18126,62010
311970,201803,26,17,9,13928.4,8586,22514.4
311980,201803,41,31,10,29574,9540,39114
311990,201803,58,41,17,39114,16218,55332
311995,201803,63,44,19,41976,18126,60102
312000,201803,34,24,10,22609.8,9540,32149.8
312010,201803,82,59,23,56286,21942,78228
312015,201803,97,72,25,68402,23850,92252
312020,201803,138,85,53,81090,50275.8,131365.8
312030,201803,42,34,8,31483,7632,39115
312040,201803,79,50,29,47700,27666,75366
312050,201803,223,116,107,110664,102078,212742
312060,201803,68,41,27,39114,25090.2,64204.2
312070,201803,73,45,28,42930,26712,69642
312080,201803,532,239,293,228006,279522,507528
312083,201803,49,36,13,34344,12402,46746
312087,201803,108,86,22,82044,20988,103032
312090,201803,2869,1637,1232,1547414.31,1171946.27,2719360.58
312100,201803,160,113,47,107802,44056,151858
312110,201803,117,74,43,70596,41022,111618
312120,201803,140,105,35,98930,33390,132320
312125,201803,95,54,41,51325.2,39114,90439.2
312130,201803,121,81,40,77274,38160,115434
312140,201803,135,106,29,101124,27666,128790
312150,201803,47,36,11,34344,10494,44838
312160,201803,1523,1014,509,964399,484174.48,1448573.48
312170,201803,11,9,2,8586,1908,10494
312180,201803,98,60,38,56525,35966,92491
312190,201803,31,27,4,25758,3816,29574
312200,201803,736,636,100,604788.7,95400,700188.7
312210,201803,98,62,36,59148,34344,93492
312220,201803,122,89,33,84668,31482,116150
312230,201803,3490,1704,1786,1622497.98,1702226.58,3324724.56
312235,201803,147,97,50,92538,47700,140238
312240,201803,109,71,38,67734,36252,103986
312245,201803,164,110,54,104936,51516,156452
312247,201803,58,41,17,38351,16218,54569
312250,201803,182,84,98,79659,93492,173151
312260,201803,104,68,36,64014.2,34344,98358.2
312270,201803,135,84,51,80136,48654,128790
312280,201803,25,15,10,14310,9540,23850
312290,201803,162,111,51,105607.8,47701,153308.8
312300,201803,202,135,67,128790,63918,192708
312310,201803,59,54,5,51516,4770,56286
312320,201803,419,261,158,247086,149444.5,396530.5
312330,201803,85,74,11,69833,10207.8,80040.8
312340,201803,36,17,19,16218,18126,34344
312350,201803,16,10,6,9540,5724,15264
312352,201803,96,65,31,62010,29574,91584
312360,201803,563,255,308,242316,293832,536148
312370,201803,298,178,120,169525.8,114480,284005.8
312380,201803,136,87,49,82998,46746,129744
312385,201803,176,142,34,135468,32436,167904
312390,201803,301,188,113,179352,107135,286487
312400,201803,383,290,93,276660,88246,364906
312410,201803,869,279,590,265689,562284,827973
312420,201803,610,486,124,462976.2,118296,581272.2
312430,201803,861,633,228,601594.05,216558.2,818152.25
312440,201803,45,34,11,32436,10494,42930
312450,201803,211,128,83,122112,79182,201294
312460,201803,58,29,29,27666,27666,55332
312470,201803,55,36,19,34344,18126,52470
312480,201803,209,128,81,122112,77274,199386
312490,201803,261,179,82,170766,78228,248994
312500,201803,32,18,14,17172,13356,30528
312510,201803,429,160,269,152640,256010.39,408650.39
312520,201803,41,14,27,13356,25758,39114
312530,201803,48,36,12,34344,11448,45792
312540,201803,100,87,13,82998,12402,95400
312550,201803,40,31,9,29574,8586,38160
312560,201803,199,145,54,138044,51229.8,189273.8
312570,201803,441,267,174,254050.2,165304.45,419354.65
312580,201803,85,45,40,42930,38160,81090
312590,201803,275,216,59,206064,56286,262350
312595,201803,144,129,15,123066,14310,137376
312600,201803,75,46,29,43455,27666,71121
312610,201803,1620,852,768,804987.98,730955.6,1535943.58
312620,201803,187,133,54,126882,51511.23,178393.23
312630,201803,64,55,9,52470,8586,61056
312640,201803,47,13,34,12402,32436,44838
312650,201803,147,120,27,114194,25472,139666
312660,201803,69,52,17,49322,16218,65540
312670,201803,865,568,297,540031.78,283124.3,823156.08
312675,201803,42,31,11,29574,10494,40068
312680,201803,84,58,26,54950.4,24804,79754.4
312690,201803,237,126,111,120194.46,105607.8,225802.26
312695,201803,31,24,7,22896,6678,29574
312700,201803,212,123,89,117342,84906,202248
312705,201803,76,62,14,59148,13356,72504
312707,201803,95,70,25,66360.44,23850,90210.44
312710,201803,1867,993,874,944975.4,833585,1778560.4
312720,201803,66,33,33,31482,31482,62964
312730,201803,289,169,120,160272,114193.8,274465.8
312733,201803,52,44,8,41690,7632,49322
312735,201803,22,16,6,15264,5724,20988
312737,201803,67,36,31,34344,29574,63918
312738,201803,53,38,15,36252,14310,50562
312740,201803,72,49,23,46746,21942,68688
312750,201803,72,52,20,49608,19080,68688
312760,201803,268,196,72,186984,68688,255672
312770,201803,7627,3528,4099,3342957.64,3901782.73,7244740.37
312780,201803,435,334,101,318349.8,96354,414703.8
312790,201803,20,15,5,14310,4770,19080
312800,201803,1590,1117,473,1058197.28,450059.62,1508256.90
312810,201803,368,237,131,225811.8,124974,350785.8
312820,201803,195,147,48,140238,45792,186030
312825,201803,26,18,8,17172,7632,24804
312830,201803,286,167,119,158079,112887,270966
312840,201803,149,109,40,103986,38160,142146
312850,201803,26,23,3,21942,2862,24804
312860,201803,170,105,65,99884,62010,161894
312870,201803,985,516,469,489335.2,447426,936761.2
312880,201803,150,104,46,99072.9,43788.6,142861.5
312890,201803,164,114,50,108756,47700,156456
312900,201803,209,155,54,147202.2,51516,198718.2
312910,201803,184,93,91,87553.72,86814,174367.72
312920,201803,155,85,70,81090,66780,147870
312930,201803,342,248,94,236592,89676,326268
312940,201803,105,71,34,67734,32436,100170
312950,201803,696,456,240,433688.6,228960,662648.6
312960,201803,174,132,42,125928,40068,165996
312965,201803,52,48,4,45792,3816,49608
312970,201803,285,232,53,220374.2,50562,270936.2
312980,201803,2314,1231,1083,1170169.4,1032319.4,2202488.8
312990,201803,51,29,22,27666,20988,48654
313000,201803,40,25,15,23850,14310,38160
313005,201803,166,127,39,120919.5,36920,157839.5
313010,201803,940,386,554,367003.8,528220.8,895224.6
313020,201803,188,99,89,93969,84906,178875
313030,201803,209,134,75,125929,71550,197479
313040,201803,61,23,38,21942,36252,58194
313050,201803,294,205,89,194616.2,84906,279522.2
313055,201803,46,34,12,32436,11448,43884
313060,201803,128,85,43,81090,40735.8,121825.8
313065,201803,59,38,21,36252,20034,56286
313070,201803,150,81,69,77274,65826,143100
313080,201803,41,17,24,16218,22896,39114
313090,201803,710,489,221,465218.3,210834,676052.3
313100,201803,164,65,99,62010,94438,156448
313110,201803,124,73,51,69642,48654,118296
313115,201803,158,86,72,81843.66,68688,150531.66
313120,201803,752,412,340,392762,323120,715882
313130,201803,5246,2824,2422,2668038.52,2302070.14,4970108.66
313140,201803,160,83,77,79182,73458,152640
313150,201803,315,251,64,239454,60769.8,300223.8
313160,201803,196,142,54,135468,51516,186984
313170,201803,1348,948,400,891314.41,381209.4,1272523.81
313180,201803,329,195,134,185381.28,127836,313217.28
313190,201803,727,433,294,410029.4,279713,689742.4
313200,201803,23,22,1,20988,954,21942
313210,201803,1038,874,164,830793.16,156451.23,987244.39
313220,201803,234,159,75,150732,70834.5,221566.5
313230,201803,268,199,69,188893,65826,254719
313240,201803,1920,1025,895,975266.73,850623.83,1825890.56
313250,201803,1249,924,325,875777.6,308143.8,1183921.4
313260,201803,92,54,38,51516,36252,87768
313270,201803,963,565,398,534955.34,379692,914647.34
313280,201803,61,52,9,49131,8586,57717
313290,201803,226,182,44,173342,41022.8,214364.8
313300,201803,369,186,183,175536.8,174582,350118.8
313310,201803,224,118,106,112572,101124,213696
313320,201803,367,284,83,268981.1,79182,348163.1
313330,201803,1364,820,544,780849.2,517784.5,1298633.7
313340,201803,336,231,105,220374,100170,320544
313350,201803,527,354,173,335808.1,165042,500850.1
313360,201803,116,68,48,64872,45506,110378
313370,201803,188,71,117,67734,111618,179352
313375,201803,275,164,111,156456,105894,262350
313380,201803,1297,660,637,627751.08,607408,1235159.08
313390,201803,48,40,8,37206.8,7632,44838.8
313400,201803,422,274,148,261396,140906,402302
313410,201803,20,11,9,10494,8586,19080
313420,201803,4690,2425,2265,2302739.78,2153838.02,4456577.80
313430,201803,136,62,74,59148,70596,129744
313440,201803,1463,983,480,935541.1,456776,1392317.1
313450,201803,61,24,37,22896,35011.8,57907.8
313460,201803,372,175,197,165510,187938,353448
313470,201803,535,244,291,232776,276946.2,509722.2
313480,201803,160,109,51,103033,48654,151687
313490,201803,514,252,262,240403.23,249901,490304.23
313500,201803,20,12,8,11448,7632,19080
313505,201803,966,750,216,714610,205778,920388
313507,201803,92,54,38,51516,36252,87768
313510,201803,2775,1775,1000,1687919.76,953046,2640965.76
313520,201803,3591,2801,790,2659610.82,753656,3413266.82
313530,201803,42,29,13,27666,12402,40068
313535,201803,106,84,22,79469,20988,100457
313540,201803,71,54,17,51516,16218,67734
313545,201803,110,90,20,85860,19080,104940
313550,201803,230,187,43,178398,40736,219134
313560,201803,330,172,158,164088,150732,314820
313570,201803,59,31,28,29574,26712,56286
313580,201803,1297,706,591,671139,562097.4,1233236.4
313590,201803,83,50,33,47700,31482,79182
313600,201803,687,409,278,389900,264354,654254
313610,201803,57,45,12,42310.8,11448,53758.8
313620,201803,1348,713,635,669643.12,601907,1271550.12
313630,201803,1636,1253,383,1192768.2,365096,1557864.2
313640,201803,128,74,54,70596,51516,122112
313650,201803,236,110,126,104940,120204,225144
313652,201803,17,16,1,15264,954,16218
313655,201803,55,31,24,29574,22896,52470
313657,201803,48,44,4,41976,3816,45792
313660,201803,132,93,39,88722,37206,125928
313665,201803,641,314,327,299556,311719.5,611275.5
313670,201803,10295,7122,3173,6769628.53,3026183.8,9795812.33
313680,201803,41,30,11,28620,10494,39114
313690,201803,155,118,37,112572,35298,147870
313695,201803,67,50,17,47700,16218,63918
313700,201803,294,237,57,225812,54378,280190
313710,201803,150,101,49,96354,46746,143100
313720,201803,1061,503,558,477381.8,530987.86,1008369.66
313730,201803,59,41,18,39114,17172,56286
313740,201803,165,132,33,125928,31482,157410
313750,201803,441,324,117,308809.8,111618,420427.8
313753,201803,238,169,69,160558.2,65826,226384.2
313760,201803,1239,451,788,430254,749015.52,1179269.52
313770,201803,357,255,102,243270,97308,340578
313780,201803,761,391,370,373014,352693.8,725707.8
313790,201803,27,26,1,24804,954,25758
313800,201803,145,89,56,84906,53424,138330
313810,201803,66,38,28,36252,26712,62964
313820,201803,1287,634,653,603882.2,621985.2,1225867.4
313830,201803,66,49,17,46746,16218,62964
313835,201803,55,48,7,45792,6678,52470
313840,201803,1682,1032,650,978901.52,618860,1597761.52
313850,201803,178,61,117,58194,111038.06,169232.06
313860,201803,487,380,107,359039.3,101124.1,460163.4
313862,201803,172,114,58,108756,55332,164088
313865,201803,85,67,18,63918,17172,81090
313867,201803,49,37,12,35298,11448,46746
313868,201803,27,18,9,16409,8586,24995
313870,201803,125,65,60,62010,56954,118964
313880,201803,348,223,125,212655,118677.8,331332.8
313890,201803,317,168,149,159509.8,141573.6,301083.4
313900,201803,915,494,421,469655.5,401587,871242.5
313910,201803,137,98,39,93492,36252.2,129744.2
313920,201803,610,433,177,412891.2,168858,581749.2
313925,201803,33,29,4,27666,3816,31482
313930,201803,800,614,186,585756,177421,763177
313940,201803,1780,1122,658,1066858.4,627064.4,1693922.8
313950,201803,940,603,337,573450.6,321211.8,894662.4
313960,201803,1379,793,586,752258.3,557804,1310062.3
313970,201803,121,82,39,78228,37206,115434
313980,201803,210,136,74,129506,70596,200102
313990,201803,365,217,148,206731.8,141112.81,347844.61
314000,201803,916,620,296,587999.9,282379.23,870379.13
314010,201803,76,49,27,46746,25519.5,72265.5
314015,201803,54,17,37,16218,35298,51516
314020,201803,49,34,15,32436,14214.6,46650.6
314030,201803,86,40,46,37997.82,43884,81881.82
314040,201803,43,30,13,28620,12402,41022
314050,201803,317,186,131,177158,123495.3,300653.3
314053,201803,103,68,35,63918.4,33390,97308.4
314055,201803,302,178,124,169812,118296,288108
314060,201803,142,120,22,113526,20988,134514
314070,201803,982,483,499,456977.14,475411,932388.14
314080,201803,219,143,76,135181.8,71454.88,206636.68
314085,201803,125,81,44,77274,41976,119250
314090,201803,352,253,99,241362,94441.23,335803.23
314100,201803,477,391,86,369199,81472,450671
314110,201803,688,371,317,352321.74,301702.6,654024.34
314120,201803,95,53,42,50562,40068,90630
314130,201803,25,12,13,11448,12402,23850
314140,201803,1089,655,434,621225.92,412128.66,1033354.58
314150,201803,162,103,59,98262,56286,154548
314160,201803,356,263,93,248040.8,88532,336572.8
314170,201803,70,52,18,49608,17172,66780
314180,201803,729,639,90,609320,84906.5,694226.5
314190,201803,104,60,44,57240,41976,99216
314200,201803,583,403,180,383191.6,170766,553957.6
314210,201803,280,209,71,198432,67448,265880
314220,201803,308,232,76,219421,72218,291639
314225,201803,64,44,20,41976,19080,61056
314230,201803,107,49,58,46746,55332,102078
314240,201803,139,106,33,101124,31482,132606
314250,201803,59,35,24,33390,22896,56286
314260,201803,187,95,92,90630,87768,178398
314270,201803,336,260,76,247277,72504,319781
314280,201803,684,381,303,363465,289062,652527
314290,201803,555,451,104,429014.5,98929.8,527944.3
314300,201803,414,295,119,278494,113479,391973
314310,201803,1451,976,475,929197.32,453129.97,1382327.29
314315,201803,36,29,7,27666,6678,34344
314320,201803,607,386,221,367671.8,209908.62,577580.42
314330,201803,10665,5377,5288,5118471.84,5040286.75,10158758.59
314340,201803,568,265,303,252237.8,288490,540727.8
314345,201803,30,24,6,22896,5724,28620
314350,201803,190,117,73,111618,69642,181260
314360,201803,78,47,31,44838,29574,74412
314370,201803,56,46,10,43884,9540,53424
314380,201803,91,65,26,62010,24804,86814
314390,201803,3195,2014,1181,1917063.5,1123717.4,3040780.9
314400,201803,681,487,194,461728.2,185076,646804.2
314410,201803,429,276,153,263304,145962,409266
314420,201803,18,8,10,7632,9540,17172
314430,201803,2507,896,1611,851036.3,1534210.75,2385247.05
314435,201803,268,153,115,145675.8,108756,254431.8
314437,201803,27,21,6,20034,5724,25758
314440,201803,98,70,28,66780,26712,93492
314450,201803,153,117,36,111618,34344,145962
314460,201803,661,301,360,287154,343440,630594
314465,201803,82,55,27,52470,25758,78228
314467,201803,67,57,10,54369,9540,63909
314470,201803,387,199,188,186394.52,178398.5,364793.02
314480,201803,1052,506,546,482724,520693.2,1003417.2
314490,201803,88,67,21,63918,20034,83952
314500,201803,316,209,107,199386,102078,301464
314505,201803,126,81,45,77274,42930,120204
314510,201803,226,183,43,174563,41022,215585
314520,201803,1238,637,601,600452.7,571398.9,1171851.6
314530,201803,712,563,149,536616,142146,678762
314535,201803,210,133,77,125832.6,73207.01,199039.61
314537,201803,62,37,25,35298,23850,59148
314540,201803,14,9,5,8586,4770,13356
314545,201803,49,32,17,30528,16218,46746
314550,201803,80,43,37,41022,35298,76320
314560,201803,805,433,372,410888,354888,765776
314570,201803,22,17,5,16218,4770,20988
314580,201803,18,9,9,8586,8586,17172
314585,201803,20,14,6,13356,5724,19080
314587,201803,84,72,12,68688,11448,80136
314590,201803,559,412,147,393048,140238,533286
314600,201803,993,646,347,611887.69,329702.6,941590.29
314610,201803,946,519,427,492550.9,406213.2,898764.1
314620,201803,150,111,39,104367.6,37206,141573.6
314625,201803,96,71,25,67162,23850,91012
314630,201803,1235,635,600,604311.3,572113.8,1176425.1
314640,201803,90,58,32,55332,30241.8,85573.8
314650,201803,202,117,85,111045.6,80613,191658.6
314655,201803,66,51,15,48654,14310,62964
314660,201803,19,14,5,13356,4770,18126
314670,201803,187,147,40,139952,38160,178112
314675,201803,214,122,92,116388,87768,204156
314690,201803,533,298,235,284005.8,224190,508195.8
314700,201803,2423,1325,1098,1258089.5,1046304.9,2304394.4
314710,201803,1624,952,672,903250.9,640468.1,1543719.0
314720,201803,407,242,165,229465.62,157410,386875.62
314730,201803,511,274,237,259966,226089,486055
314740,201803,690,344,346,326506.5,330084,656590.5
314750,201803,22,19,3,18126,2862,20988
314760,201803,317,151,166,144054,158354.46,302408.46
314770,201803,120,82,38,78228,36252,114480
314780,201803,21,6,15,5724,14310,20034
314790,201803,2348,1467,881,1392781.73,839796.66,2232578.39
314795,201803,52,45,7,42692,6678,49370
314800,201803,2937,1722,1215,1637502.66,1156812.2,2794314.86
314810,201803,1508,838,670,797115.5,637559,1434674.5
314820,201803,92,51,41,48654,39114,87768
314830,201803,210,166,44,157648.5,41690,199338.5
314840,201803,81,47,34,44838,32436,77274
314850,201803,357,175,182,166950,173628,340578
314860,201803,707,529,178,502662.86,168285.7,670948.56
314870,201803,1462,747,715,711684,682110,1393794
314875,201803,58,50,8,47700,7632,55332
314880,201803,47,34,13,32436,12402,44838
314890,201803,53,31,22,29574,20988,50562
314900,201803,32,27,5,25758,4770,30528
314910,201803,256,173,83,164755.8,79182,243937.8
314915,201803,154,133,21,126644,20034,146678
314920,201803,123,76,47,72504,44551.8,117055.8
314930,201803,1037,528,509,502187,485299.8,987486.8
314940,201803,54,42,12,40068,11448,51516
314950,201803,37,26,11,24804,10494,35298
314960,201803,60,44,16,41976,15264,57240
314970,201803,137,69,68,65373,64872,130245
314980,201803,303,197,106,185696.1,100170,285866.1
314990,201803,467,259,208,247086,197526.5,444612.5
314995,201803,201,65,136,62010,129734.46,191744.46
315000,201803,88,71,17,67734,16218,83952
315010,201803,46,30,16,28620,15264,43884
315015,201803,171,139,32,131880.96,30528,162408.96
315020,201803,71,61,10,58194,9540,67734
315030,201803,117,88,29,82998,27666,110664
315040,201803,66,49,17,46746,16218,62964
315050,201803,201,120,81,114480,77274,191754
315053,201803,39,34,5,32436,4770,37206
315057,201803,97,80,17,75938.4,16218,92156.4
315060,201803,70,63,7,58195.16,6678,64873.16
315070,201803,103,57,46,54378,43884,98262
315080,201803,371,304,67,290016,63918,353934
315090,201803,106,63,43,60102,41022,101124
315100,201803,77,39,38,37206,36252,73458
315110,201803,292,162,130,153690,124020,277710
315120,201803,1655,840,815,797402.2,776556,1573958.2
315130,201803,341,247,94,235638,89676,325314
315140,201803,536,315,221,298888.2,210834,509722.2
315150,201803,983,463,520,440749,495794,936543
315160,201803,211,107,104,102078,99216,201294
315170,201803,343,223,120,211789,114193.8,325982.8
315180,201803,3206,1359,1847,1292942.3,1758844.2,3051786.5
315190,201803,313,177,136,168477,129744,298221
315200,201803,1181,673,508,640230.2,483773.4,1124003.6
315210,201803,1561,893,668,847821.9,634852.2,1482674.1
315213,201803,46,28,18,26712,17172,43884
315217,201803,204,162,42,154548,40068,194616
315220,201803,1522,1164,358,1109550.4,341436.6,1450987.0
315230,201803,167,123,44,117056,41976,159032
315240,201803,425,273,152,260442,143806.5,404248.5
315250,201803,2549,1262,1287,1203370.83,1226548.86,2429919.69
315260,201803,150,92,58,86432.4,55332,141764.4
315270,201803,130,88,42,83379.6,39342.96,122722.56
315280,201803,701,457,244,435597,232766.46,668363.46
315290,201803,203,119,84,113526,79182.49,192708.49
315300,201803,71,47,24,44838,22896,67734
315310,201803,64,58,6,55332,5724,61056
315320,201803,159,89,70,84906,66780,151686
315330,201803,55,47,8,44838,7632,52470
315340,201803,420,293,127,278339.6,121158,399497.6
315350,201803,150,87,63,82998,60102,143100
315360,201803,95,51,44,48654,41976,90630
315370,201803,55,33,22,31482,20844.9,52326.9
315380,201803,12,7,5,6678,4770,11448
315390,201803,57,13,44,12402,41976,54378
315400,201803,817,610,207,576216.5,196810.2,773026.7
315410,201803,351,214,137,203870,130412,334282
315415,201803,61,47,14,44838,13356,58194
315420,201803,206,156,50,147727.1,47700,195427.1
315430,201803,678,395,283,375876.2,269505.8,645382.0
315440,201803,83,57,26,54378,24804,79182
315445,201803,255,205,50,195255.18,47700,242955.18
315450,201803,178,134,44,127836,41976,169812
315460,201803,3377,1710,1667,1628279.4,1587877.1,3216156.5
315470,201803,44,22,22,20988,20988,41976
315480,201803,63,24,39,22896,37206,60102
315490,201803,619,382,237,362376.9,226098,588474.9
315500,201803,22,14,8,13356,7632,20988
315510,201803,150,99,51,94446,48654,143100
315520,201803,71,62,9,59148,8586,67734
315530,201803,52,28,24,26712,22896,49608
315540,201803,238,156,82,148824,78228,227052
315550,201803,175,139,36,132606,34344,166950
315560,201803,742,592,150,563428.8,143100,706528.8
315570,201803,321,168,153,157077.7,145962,303039.7
315580,201803,661,431,230,410507,219420,629927
315590,201803,209,107,102,102078,97308,199386
315600,201803,291,213,78,203202,74222,277424
315610,201803,97,47,50,44838,47700,92538
315620,201803,34,27,7,25758,6678,32436
315630,201803,141,93,48,88722,45792,134514
315640,201803,61,36,25,34344,23850,58194
315645,201803,62,45,17,42930,15741,58671
315650,201803,167,121,46,115148,43884,159032
315660,201803,477,204,273,194616,260442,455058
315670,201803,2361,1193,1168,1135337.32,1113099.66,2248436.98
315680,201803,859,578,281,547978.4,267348.96,815327.36
315690,201803,690,471,219,448259.67,208926,657185.67
315700,201803,1906,1008,898,957760.37,856692,1814452.37
315710,201803,327,87,240,82998,228960,311958
315720,201803,433,278,155,265212,147870,413082
315725,201803,202,161,41,153594,39114,192708
315727,201803,43,22,21,20988,20034,41022
315730,201803,42,40,2,38160,1908,40068
315733,201803,88,58,30,55332,28620,83952
315737,201803,51,38,13,36252,12402,48654
315740,201803,45,40,5,38160,4770,42930
315750,201803,159,125,34,119250,32436,151686
315760,201803,47,32,15,30528,14310,44838
315765,201803,117,77,40,73458,38160,111618
315770,201803,228,137,91,130698,86528,217226
315780,201803,3285,1706,1579,1621085.5,1503982.58,3125068.08
315790,201803,211,162,49,154548,46173.6,200721.6
315800,201803,281,203,78,193662,74412,268074
315810,201803,96,56,40,53424,37874,91298
315820,201803,793,572,221,543399.34,210834,754233.34
315830,201803,143,82,61,78228,58194,136422
315840,201803,92,64,28,61056,26712,87768
315850,201803,260,192,68,183168,64872,248040
315860,201803,12,4,8,3816,7632,11448
315870,201803,35,27,8,25758,7632,33390
315880,201803,104,67,37,63918,35298,99216
315890,201803,79,61,18,58194,17172,75366
315895,201803,445,295,150,280381,142528,422909
315900,201803,70,34,36,32436,34344,66780
315910,201803,36,23,13,21703.5,12402,34105.5
315920,201803,184,120,64,114480,60102.9,174582.9
315930,201803,40,14,26,13356,24804,38160
315935,201803,149,117,32,111618,30519,142137
315940,201803,91,68,23,64872,21942,86814
315950,201803,63,45,18,42930,17172,60102
315960,201803,557,259,298,245817.58,283719.8,529537.38
315970,201803,38,29,9,27666,8586,36252
315980,201803,695,326,369,308481,352016.46,660497.46
315990,201803,255,150,105,142862,99875,242737
316000,201803,51,33,18,31482,16886,48368
316010,201803,75,63,12,60102,11448,71550
316020,201803,109,89,20,84906,19080,103986
316030,201803,402,211,191,201294,181690,382984
316040,201803,504,221,283,209880.2,269696,479576.2
316045,201803,58,52,6,49608,5724,55332
316050,201803,16,14,2,13356,1908,15264
316060,201803,95,61,34,58194,32436,90630
316070,201803,1045,676,369,638425.5,351263,989688.5
316080,201803,102,62,40,59148,38160,97308
316090,201803,43,25,18,23182.2,17172,40354.2
316095,201803,70,58,12,55056,11448,66504
316100,201803,307,179,128,169955.3,122112,292067.3
316105,201803,35,24,11,22896,10494,33390
316110,201803,1917,1543,374,1461140.36,356128.2,1817268.56
316120,201803,82,61,21,58194,19747.8,77941.8
316130,201803,139,107,32,101411,30528,131939
316140,201803,27,20,7,19080,6678,25758
316150,201803,204,142,62,134752.5,59148,193900.5
316160,201803,85,51,34,48654,32436,81090
316165,201803,64,47,17,44648,15502.5,60150.5
316170,201803,204,137,67,129744,63918,193662
316180,201803,199,89,110,84572.1,104940,189512.1
316190,201803,140,100,40,94446,38160,132606
316200,201803,702,392,310,373968,295167.6,669135.6
316210,201803,759,507,252,483332.33,240408,723740.33
316220,201803,117,79,38,75366,36252,111618
316225,201803,23,14,9,13356,8586,21942
316230,201803,32,19,13,18126,12402,30528
316240,201803,617,501,116,477000.2,110664,587664.2
316245,201803,104,87,17,82998,16218,99216
316250,201803,1518,1057,461,1000728.5,438432.02,1439160.52
316255,201803,110,90,20,85478.4,19080,104558.4
316257,201803,183,96,87,91584,82711.8,174295.8
316260,201803,242,162,80,153251.06,76225,229476.06
316265,201803,26,17,9,16218,8586,24804
316270,201803,680,472,208,447521.6,198432,645953.6
316280,201803,546,341,205,323756.8,194902.6,518659.4
316290,201803,699,473,226,448380.98,215604,663984.98
316292,201803,502,201,301,191754,286916,478670
316294,201803,101,59,42,56286,40068,96354
316295,201803,284,126,158,118279,150732,269011
316300,201803,103,72,31,68688,29574,98262
316310,201803,35,18,17,17172,16218,33390
316320,201803,41,25,16,23850,15264,39114
316330,201803,131,85,46,80136.5,43597.8,123734.3
316340,201803,140,93,47,88722,44838,133560
316350,201803,193,139,54,132440,51516,183956
316360,201803,22,17,5,16218,4770,20988
316370,201803,1072,571,501,540938.5,477658.26,1018596.76
316380,201803,120,90,30,85860,28620,114480
316390,201803,122,87,35,82998,33390,116388
316400,201803,137,103,34,98262,32436,130698
316410,201803,302,221,81,209450.7,77274,286724.7
316420,201803,203,144,59,136660.5,56286,192946.5
316430,201803,160,82,78,78228,74412,152640
316440,201803,98,47,51,44838,48654,93492
316443,201803,38,35,3,33390,2862,36252
316447,201803,64,50,14,47700,13356,61056
316450,201803,219,165,54,157410,51516,208926
316460,201803,68,28,40,26712,38160,64872
316470,201803,1607,1158,449,1097026.44,426225.16,1523251.60
316480,201803,13,10,3,9540,2862,12402
316490,201803,18,7,11,6678,10494,17172
316500,201803,152,101,51,96067.8,48654,144721.8
316510,201803,167,124,43,117294.3,41022,158316.3
316520,201803,191,117,74,111045.6,70596,181641.6
316530,201803,158,114,44,108756,41689.8,150445.8
316540,201803,143,79,64,75366,61056,136422
316550,201803,139,99,40,94446,38160,132606
316553,201803,241,116,125,110155.33,119250,229405.33
316555,201803,33,25,8,23850,7632,31482
316556,201803,10,7,3,6678,2862,9540
316557,201803,18,14,4,13356,3816,17172
316560,201803,60,46,14,43884,13356,57240
316570,201803,244,222,22,211550,20988,232538
316580,201803,21,15,6,14310,5724,20034
316590,201803,113,97,16,92538,15264,107802
316600,201803,181,147,34,139952,32436,172388
316610,201803,66,47,19,44551.8,18126,62677.8
316620,201803,134,103,31,98262,29574,127836
316630,201803,38,28,10,26712,9540,36252
316640,201803,16,10,6,9540,5724,15264
316650,201803,66,50,16,47700,15264,62964
316660,201803,7,4,3,3816,2862,6678
316670,201803,438,156,282,148805,268455.8,417260.8
316680,201803,162,111,51,105894,48464,154358
316690,201803,193,122,71,116388,67734,184122
316695,201803,62,55,7,52470,6678,59148
316700,201803,14,7,7,6678,6678,13356
316710,201803,711,517,194,492980,185076,678056
316720,201803,4879,2485,2394,2356197.04,2278160.05,4634357.09
316730,201803,15,14,1,13356,954,14310
316740,201803,133,84,49,80136,46746,126882
316750,201803,19,13,6,12402,5724,18126
316760,201803,323,260,63,248040,60102,308142
316770,201803,141,81,60,77274,57240,134514
316780,201803,72,42,30,39762.72,28620,68382.72
316790,201803,57,44,13,41976,12402,54378
316800,201803,1804,1107,697,1054074.8,663222.2,1717297.0
316805,201803,19,10,9,9540,8586,18126
316810,201803,66,43,23,41022,21656,62678
316820,201803,38,19,19,18126,18126,36252
316830,201803,90,39,51,37206,47414,84620
316840,201803,505,306,199,291161,187938,479099
316850,201803,347,225,122,213266.7,116388,329654.7
316860,201803,5988,2651,3337,2514324.51,3179721.06,5694045.57
316870,201803,1453,942,511,890363.7,482726,1373089.7
316880,201803,116,65,51,61723.8,48654,110377.8
316890,201803,255,170,85,162133,81090,243223
316900,201803,414,283,131,267435.28,124974,392409.28
316905,201803,16,9,7,8586,6678,15264
316910,201803,50,26,24,24804,22896,47700
316920,201803,135,104,31,98501,29574,128075
316930,201803,1926,979,947,928196.3,901239.93,1829436.23
316935,201803,860,519,341,492885.72,324360,817245.72
316940,201803,1102,635,467,604836.4,444936.26,1049772.66
316950,201803,185,96,89,91584,84906,176490
316960,201803,1104,613,491,583466.8,468118.46,1051585.26
316970,201803,637,497,140,474138,133560,607698
316980,201803,111,67,44,63918,41966.46,105884.46
316990,201803,2174,1428,746,1354920.18,710005.96,2064926.14
317000,201803,328,255,73,242984,69642,312626
317005,201803,246,174,72,165996,68688,234684
317010,201803,6255,3439,2816,3260721.13,2684556.2,5945277.33
317020,201803,16164,7144,9020,6783367.2,8587948.24,15371315.44
317030,201803,85,33,52,31482,49391.26,80873.26
317040,201803,3129,1945,1184,1852878.88,1126484.61,2979363.49
317043,201803,71,51,20,48654,19080,67734
317047,201803,37,18,19,17172,18122,35294
317050,201803,179,132,47,125928,44838,170766
317052,201803,127,97,30,92538,28620,121158
317057,201803,204,152,52,145008,49036,194044
317060,201803,55,36,19,34344,17839.8,52183.8
317065,201803,60,48,12,45792,11448,57240
317070,201803,1966,932,1034,884359.7,985291.6,1869651.3
317075,201803,107,55,52,52470,49608,102078
317080,201803,824,430,394,409122.9,375686,784808.9
317090,201803,630,504,126,478479.5,120204,598683.5
317100,201803,410,304,106,288108.2,101124,389232.2
317103,201803,109,95,14,90630,13356,103986
317107,201803,36,32,4,30528,3816,34344
317110,201803,100,42,58,40068,55332,95400
317115,201803,40,34,6,32436,5724,38160
317120,201803,1817,914,903,864052.62,861005,1725057.62
317130,201803,1909,1225,684,1165701.4,651869,1817570.4
317140,201803,9,7,2,6678,1908,8586
317150,201803,269,162,107,154548,101314.8,255862.8
317160,201803,317,229,88,218149,83666,301815
317170,201803,204,141,63,134514,60102,194616
317180,201803,430,309,121,294070.5,115434,409504.5
317190,201803,253,172,81,164088,76987.8,241075.8
317200,201803,805,565,240,526618,228722,755340
317210,201803,154,88,66,82998.2,62964,145962.2
317220,201803,20,13,7,12402,6678,19080
320010,201803,619,461,158,436456.5,150732,587188.5
320013,201803,133,99,34,94446,32436,126882
320016,201803,279,178,101,169812,96354,266166
320020,201803,714,427,287,404808.75,271890.32,676699.07
320030,201803,151,113,38,107802,35918.1,143720.1
320035,201803,137,100,37,95400,35298,130698
320040,201803,500,260,240,247468,228960,476428
320050,201803,114,87,27,82998,25758,108756
320060,201803,1541,726,815,692557,776833.6,1469390.6
320070,201803,103,72,31,68688,29574,98262
320080,201803,759,434,325,411205,310050,721255
320090,201803,1201,836,365,794190.86,347351.6,1141542.46
320100,201803,314,178,136,169812,129744,299556
320110,201803,139,89,50,83046.2,47700,130746.2
320115,201803,112,92,20,87768,19080,106848
320120,201803,3280,1832,1448,1736059.78,1379714.64,3115774.42
320130,201803,7338,3509,3829,3326197.83,3645044.65,6971242.48
320140,201803,412,267,145,253383.2,138086,391469.2
320150,201803,1889,1107,782,1048479.91,746018.46,1794498.37
320160,201803,690,312,378,295635.83,359259.29,654895.12
320170,201803,112,87,25,82235,23850,106085
320180,201803,52,30,22,28620,20988,49608
320190,201803,233,157,76,149005.26,72218,221223.26
320200,201803,54,41,13,39114,12402,51516
320210,201803,840,475,365,451338.6,347238,798576.6
320220,201803,306,112,194,106848,184790,291638
320225,201803,75,61,14,58194,13356,71550
320230,201803,550,353,197,335178.4,187128,522306.4
320240,201803,3129,1577,1552,1501978.8,1477941.78,2979920.58
320245,201803,451,315,136,299365.4,129744,429109.4
320250,201803,229,120,109,113526.6,103986,217512.6
320255,201803,143,114,29,107449.02,27523,134972.02
320260,201803,178,125,53,119250,50514.3,169764.3
320265,201803,158,127,31,120348,29574,149922
320270,201803,151,124,27,118296,25758,144054
320280,201803,954,572,382,540728.2,363312.02,904040.22
320290,201803,65,55,10,52470,9540,62010
320300,201803,537,383,154,363923.3,145867.1,509790.4
320305,201803,665,362,303,345348,288872,634220
320310,201803,210,119,91,111571.5,86058,197629.5
320313,201803,305,153,152,145962,144722,290684
320316,201803,108,89,19,84906,18126,103032
320320,201803,3307,1509,1798,1433902,1712303,3146205
320330,201803,258,190,68,180597.3,62964.8,243562.1
320332,201803,882,531,351,504717.6,333805.3,838522.9
320334,201803,235,143,92,136136,87768,223904
320335,201803,145,104,41,98023.9,39114,137137.9
320340,201803,588,406,182,386180,172961,559141
320350,201803,962,410,552,388660.88,526082.48,914743.36
320360,201803,165,92,73,87482,69642,157124
320370,201803,241,185,56,174798,52391,227189
320380,201803,284,191,93,180435.75,88722,269157.75
320390,201803,1112,682,430,649064,409600.13,1058664.13
320400,201803,318,229,89,217513,84906,302419
320405,201803,891,381,510,362897.6,486227.92,849125.52
320410,201803,968,494,474,469587.4,451825.34,921412.74
320420,201803,479,246,233,234207.4,222282,456489.4
320425,201803,193,105,88,100170,83952,184122
320430,201803,389,221,168,209212.7,160272,369484.7
320435,201803,167,112,55,106027.56,52470,158497.56
320440,201803,200,121,79,115147.8,75366,190513.8
320450,201803,129,76,53,72504,50562,123066
320455,201803,244,198,46,187939,43884,231823
320460,201803,239,152,87,145008,82998,228006
320465,201803,114,77,37,73095.48,35298,108393.48
320470,201803,633,404,229,385112.26,218462,603574.26
320480,201803,177,118,59,111761.1,56286,168047.1
320490,201803,3002,1501,1501,1428594.28,1430009.92,2858604.20
320495,201803,91,57,34,54359,32436,86795
320500,201803,9417,4761,4656,4514677.92,4429423.59,8944101.51
320501,201803,545,276,269,263304,256626,519930
320503,201803,280,202,78,191754.2,74412,266166.2
320506,201803,254,194,60,185076,57240,242316
320510,201803,934,443,491,419713.3,466888.1,886601.4
320515,201803,79,66,13,62010.9,12402,74412.9
320517,201803,204,144,60,137376,57240,194616
320520,201803,6798,3046,3752,2891857.39,3571073.22,6462930.61
320530,201803,5256,2638,2618,2507919.02,2494322.23,5002241.25
330010,201803,3067,1583,1484,1502522.56,1412938.37,2915460.93
330015,201803,157,63,94,58958.08,89676,148634.08
330020,201803,3576,1561,2015,1485952.84,1921738,3407690.84
330022,201803,219,122,97,115673,91584.8,207257.8
330023,201803,524,183,341,173103.8,325314,498417.8
330025,201803,546,120,426,114480,405831.8,520311.8
330030,201803,1916,1221,695,1156493.18,659761.68,1816254.86
330040,201803,2331,1192,1139,1135308.1,1085272,2220580.1
330045,201803,8287,2614,5673,2485628.82,5405853.14,7891481.96
330050,201803,803,508,295,484632,281430,766062
330060,201803,882,552,330,522793.9,314171.28,836965.18
330070,201803,3433,1312,2121,1245691.47,2022119.56,3267811.03
330080,201803,1499,701,798,663491.3,760052.4,1423543.7
330090,201803,350,212,138,202248,131652,333900
330093,201803,289,129,160,123066,152604,275670
330095,201803,101,53,48,49894.2,45792,95686.2
330100,201803,9474,4889,4585,4654538.78,4370512.9,9025051.68
330110,201803,475,210,265,199624.5,252810,452434.5
330115,201803,526,309,217,294786,207018,501804
330120,201803,377,196,181,185839.2,171910.8,357750.0
330130,201803,1525,424,1101,403770.96,1050336,1454106.96
330140,201803,600,315,285,300492,270937,571429
330150,201803,447,266,181,251856,171720,423576
330160,201803,208,129,79,123066,75366,198432
330170,201803,26666,9416,17250,8961351.22,16443811.1,25405162.32
330180,201803,237,151,86,141507.02,81328.5,222835.52
330185,201803,799,331,468,314238.8,445204.8,759443.6
330187,201803,292,92,200,87768,190800,278568
330190,201803,5542,2220,3322,2109137.9,3165892.68,5275030.58
330200,201803,4474,1529,2945,1454680.64,2804563.76,4259244.40
330205,201803,392,243,149,231392.7,141860,373252.7
330210,201803,1006,615,391,581467.6,371344.9,952812.5
330220,201803,2524,1512,1012,1439062.5,964494.2,2403556.7
330225,201803,554,309,245,294147,233062.2,527209.2
330227,201803,2466,782,1684,742870.46,1606180.23,2349050.69
330230,201803,201,121,80,114767,76320,191087
330240,201803,3626,1892,1734,1800391.26,1650933.56,3451324.82
330245,201803,153,65,88,62010,83188.8,145198.8
330250,201803,6475,3376,3099,3209881.6,2947493.32,6157374.92
330260,201803,566,166,400,158364,381600,539964
330270,201803,3337,1244,2093,1185919,1996151.2,3182070.2
330280,201803,438,281,157,266282.08,149769,416051.08
330285,201803,7003,2317,4686,2206396.4,4468260.4,6674656.8
330290,201803,565,218,347,207972,331038,539010
330300,201803,759,510,249,482724.7,237528,720252.7
330310,201803,411,238,173,225144.7,165042,390186.7
330320,201803,8051,3046,5005,2898159.8,4769261.84,7667421.64
330330,201803,9259,3630,5629,3456412.2,5365375.13,8821787.33
330340,201803,2640,1577,1063,1502255.06,1014082.92,2516337.98
330350,201803,17880,7074,10806,6723232.79,10289557.26,17012790.05
330360,201803,2558,1269,1289,1209653.2,1229697,2439350.2
330370,201803,979,542,437,516114.8,414895.6,931010.4
330380,201803,852,371,481,353208.96,458254.8,811463.76
330385,201803,599,315,284,299557,270936,570493
330390,201803,5162,2872,2290,2726250.55,2182098.4,4908348.95
330395,201803,251,156,95,147107.1,88865.2,235972.3
330400,201803,674,348,326,328558.6,309105.08,637663.68
330410,201803,501,356,145,337956,137840.33,475796.33
330411,201803,232,132,100,125747,95352.3,221099.3
330412,201803,253,106,147,100838,140238,241076
330414,201803,6157,2502,3655,2383800,3484896.3,5868696.3
330415,201803,573,270,303,256626,288108.8,544734.8
330420,201803,2283,1208,1075,1149447.6,1022871,2172318.6
330430,201803,1795,827,968,786860,921469.8,1708329.8
330440,201803,264,121,143,115434,136422,251856
330450,201803,121,51,70,48654,66780,115434
330452,201803,1715,803,912,764348.18,869725.76,1634073.94
330455,201803,110584,39559,71025,37663383.74,67695356.06,105358739.80
330460,201803,263,107,156,102078,148824,250902
330470,201803,1237,679,558,641472.98,532322.46,1173795.44
330475,201803,1403,378,1025,358648.36,977277.6,1335925.96
330480,201803,744,398,346,379024.2,329130.8,708155.0
330490,201803,13586,4764,8822,4538074.65,8408901.39,12946976.04
330500,201803,1343,618,725,589428.9,691269,1280697.9
330510,201803,11182,3746,7436,3566006.48,7087253.34,10653259.82
330513,201803,104,51,53,48654,50562,99216
330515,201803,857,358,499,337507.8,475665,813172.8
330520,201803,2481,933,1548,889863,1476648.9,2366511.9
330530,201803,226,118,108,112572,102842,215414
330540,201803,352,175,177,166950,168381,335331
330550,201803,3060,1089,1971,1036416.2,1878044.8,2914461.0
330555,201803,760,281,479,268055,456012.8,724067.8
330560,201803,550,205,345,195570,329112,524682
330570,201803,253,175,78,166950,74412,241362
330575,201803,806,330,476,314582,452049.5,766631.5
330580,201803,3356,1881,1475,1788507,1405385.7,3193892.7
330590,201803,307,153,154,145962,146916,292878
330600,201803,1096,704,392,669479.24,372280.38,1041759.62
330610,201803,1523,842,681,796115.5,645525.9,1441641.4
330615,201803,190,142,48,135468,45792,181260
330620,201803,971,443,528,420239.4,502281.8,922521.2
330630,201803,3832,2433,1399,2305828.35,1327214.4,3633042.75
350010,201803,589,383,206,364098.76,196524,560622.76
350020,201803,41,21,20,20034,19080,39114
350030,201803,526,341,185,324170,175300.66,499470.66
350040,201803,127,49,78,46402.56,74412,120814.56
350050,201803,290,159,131,151686,124717.46,276403.46
350055,201803,85,47,38,44838,36252,81090
350060,201803,74,28,46,26712,43884,70596
350070,201803,801,470,331,444099.58,314107.56,758207.14
350075,201803,66,44,22,41976,20988,62964
350080,201803,51,32,19,29891.96,18126,48017.96
350090,201803,97,54,43,51516,41017.23,92533.23
350100,201803,293,184,109,174820.5,103986,278806.5
350110,201803,59,36,23,34344,21942,56286
350115,201803,154,94,60,89008.2,57240,146248.2
350120,201803,113,76,37,72504,35298,107802
350130,201803,357,175,182,166378,173628,340006
350140,201803,35,21,14,19271,13356,32627
350150,201803,71,57,14,54378,13356,67734
350160,201803,2490,965,1525,917541.16,1453508.68,2371049.84
350170,201803,398,241,157,228006.2,149492,377498.2
350180,201803,184,96,88,91584,83952,175536
350190,201803,973,501,472,475666.64,449987.49,925654.13
350200,201803,70,26,44,24804,41711.08,66515.08
350210,201803,1355,766,589,723063.33,561388.66,1284451.99
350220,201803,667,574,93,543458.73,88722,632180.73
350230,201803,80,56,24,53424,22896,76320
350240,201803,63,48,15,45792,14310,60102
350250,201803,1216,610,606,576217.6,577590.06,1153807.66
350260,201803,93,66,27,62964,25758,88722
350270,201803,829,541,288,515037,273302.92,788339.92
350275,201803,298,116,182,110283,173628,283911
350280,201803,4709,2404,2305,2281542.28,2196815.45,4478357.73
350290,201803,402,190,212,180969.23,201675.8,382645.03
350300,201803,46,25,21,23850,20034,43884
350310,201803,97,69,28,65730,26712,92442
350315,201803,38,23,15,21942,14310,36252
350320,201803,3255,1614,1641,1534940.5,1564733.8,3099674.3
350330,201803,1676,889,787,844005.96,749494.04,1593500.00
350335,201803,21,13,8,12402,7632,20034
350340,201803,132,63,69,60102,64872.9,124974.9
350350,201803,96,47,49,44838,46746,91584
350360,201803,130,88,42,83948,40068,124016
350370,201803,96,56,40,52787.96,38150.46,90938.42
350380,201803,740,313,427,297934.2,406594.8,704529.0
350390,201803,1421,577,844,549662.35,804031.4,1353693.75
350395,201803,25,20,5,19080,4770,23850
350400,201803,1698,908,790,856626.02,750108.16,1606734.18
350410,201803,2242,1004,1238,954726.96,1180129.03,2134855.99
350420,201803,231,142,89,134865,84906,219771
350430,201803,73,43,30,40450,28620,69070
350440,201803,152,112,40,105846.5,38160,144006.5
350450,201803,1614,1000,614,946780.95,585661,1532441.95
350460,201803,336,122,214,116388,203869.8,320257.8
350470,201803,14,10,4,9540,3816,13356
350480,201803,157,87,70,82998,66780,149778
350490,201803,242,120,122,113526.8,116388,229914.8
350500,201803,37,18,19,17172,18126,35298
350510,201803,164,110,54,104940,51516,156456
350520,201803,452,214,238,200975.96,226415.96,427391.92
350530,201803,451,214,237,204156,226098,430254
350535,201803,66,51,15,48396.42,14310,62706.42
350540,201803,374,190,184,180446.04,175250,355696.04
350550,201803,2736,1607,1129,1525785.26,1075962.07,2601747.33
350560,201803,636,444,192,423571.23,182810.25,606381.48
350570,201803,4174,1738,2436,1652581.98,2321437.2,3974019.18
350580,201803,364,174,190,165043,181246.46,346289.46
350590,201803,893,488,405,465552,385416,850968
350600,201803,6211,3127,3084,2968670.84,2938676.95,5907347.79
350610,201803,1534,784,750,741843.22,715491,1457334.22
350620,201803,37,25,12,23850,11448,35298
350630,201803,238,133,105,125928.96,99217,225145.96
350635,201803,869,347,522,330752,497341.21,828093.21
350640,201803,119,87,32,82998,30528,113526
350650,201803,1893,1245,648,1183276.31,616842.93,1800119.24
350660,201803,757,344,413,327536.82,393044,720580.82
350670,201803,310,161,149,153356,142146,295502
350680,201803,179,98,81,93492,77274,170766
350690,201803,196,98,98,93492,93492,186984
350700,201803,702,348,354,328657.94,337716,666373.94
350710,201803,331,136,195,129744,186030,315774
350715,201803,50,43,7,41022,6678,47700
350720,201803,18,13,5,12402,4770,17172
350730,201803,44,28,16,26712,15264,41976
350740,201803,209,117,92,111322.26,87768,199090.26
350745,201803,21,11,10,10470,9540,20010
350750,201803,2144,1376,768,1304416.74,732035.96,2036452.70
350760,201803,3742,1614,2128,1538135.36,2027272.42,3565407.78
350770,201803,59,40,19,38160,18126,56286
350775,201803,50,37,13,35298,12393,47691
350780,201803,423,210,213,200340,203202,403542
350790,201803,364,158,206,150732,196524,347256
350800,201803,434,244,190,232776,181260,414036
350810,201803,520,420,100,399727,95400,495127
350820,201803,85,52,33,49608,31482,81090
350830,201803,81,46,35,43884,33390,77274
350840,201803,725,325,400,310050,380360,690410
350850,201803,1759,1014,745,961348.34,710698.46,1672046.80
350860,201803,579,336,243,316505.5,231822,548327.5
350870,201803,441,299,142,285246,135181.8,420427.8
350880,201803,286,156,130,145964.1,123352.2,269316.3
350890,201803,43,26,17,24804,16218,41022
350900,201803,1466,477,989,453071.93,942742.8,1395814.73
350910,201803,28,18,10,17172,9540,26712
350920,201803,595,332,263,316410.04,250902,567312.04
350925,201803,1167,631,536,598932.34,509913.6,1108845.94
350930,201803,95,57,38,54378,36252,90630
350940,201803,718,403,315,382935.6,298669.6,681605.2
350945,201803,106,79,27,74830,25758,100588
350950,201803,15257,7355,7902,6988253.43,7528332.3,14516585.73
350960,201803,1285,602,683,569626.96,651578,1221204.96
350970,201803,1123,605,518,574597.96,493876.46,1068474.42
350980,201803,95,64,31,61056,29574,90630
350990,201803,357,129,228,122112.72,217225.8,339338.52
350995,201803,34,17,17,16218,16218,32436
351000,201803,641,457,184,433754.07,175536,609290.07
351010,201803,52,30,22,28620,20988,49608
351015,201803,57,41,16,39114,15264,54378
351020,201803,1671,965,706,918900.25,671330,1590230.25
351030,201803,333,229,104,215890.2,99216,315106.2
351040,201803,848,458,390,435978,371106.66,807084.66
351050,201803,3271,1559,1712,1479001.01,1632200.5,3111201.51
351060,201803,5014,2050,2964,1945177.82,2824621.89,4769799.71
351070,201803,416,265,151,250302.92,144054,394356.92
351080,201803,813,584,229,557136,217512,774648
351090,201803,63,27,36,25758,34344,60102
351100,201803,460,264,196,249634.48,186979.23,436613.71
351110,201803,2117,1022,1095,969913.44,1042003.2,2011916.64
351120,201803,73,38,35,36167.09,33390,69557.09
351130,201803,175,60,115,57240,109710,166950
351140,201803,340,237,103,224571.64,98262,322833.64
351150,201803,401,207,194,196285.8,185076,381361.8
351160,201803,245,161,84,153594,80136,233730
351170,201803,187,100,87,95400,82235,177635
351190,201803,91,62,29,59148,27666,86814
351200,201803,379,247,132,235034.04,125928,360962.04
351210,201803,129,62,67,58893.38,63918,122811.38
351220,201803,527,317,210,298845.12,200340,499185.12
351230,201803,277,203,74,193025.96,70576.92,263602.88
351240,201803,227,98,129,93301.2,123066,216367.2
351250,201803,72,50,22,47476,20798,68274
351260,201803,153,112,41,106848,38828,145676
351270,201803,48,20,28,19080,26712,45792
351280,201803,1106,501,605,474141.42,576084.38,1050225.80
351290,201803,225,100,125,95400,118964,214364
351300,201803,3740,1747,1993,1659774.15,1900429,3560203.15
351310,201803,769,395,374,376830,356796,733626
351320,201803,109,67,42,63918,40068,103986
351330,201803,41,28,13,26712,12402,39114
351340,201803,1239,769,470,727074.9,447396.23,1174471.13
351350,201803,2464,1346,1118,1282510.7,1066281.03,2348791.73
351360,201803,778,388,390,369198,371742.04,740940.04
351370,201803,366,189,177,180301.23,168221.96,348523.19
351380,201803,8918,4066,4852,3863788.65,4619856.96,8483645.61
351385,201803,30,20,10,19080,9540,28620
351390,201803,288,212,76,201294.02,72504,273798.02
351400,201803,64,39,25,37206,23803.92,61009.92
351410,201803,427,267,160,253447.04,152640,406087.04
351420,201803,62,50,12,47700,11448,59148
351430,201803,73,38,35,36252,33390,69642
351440,201803,792,550,242,522505.76,230864,753369.76
351450,201803,253,127,126,121158,120204,241362
351460,201803,123,56,67,52709,63918,116627
351470,201803,138,74,64,70596,61056,131652
351480,201803,517,290,227,275420.96,216438.75,491859.71
351490,201803,293,105,188,100170,179352,279522
351492,201803,32,23,9,21942,8586,30528
351495,201803,27,18,9,17172,8586,25758
351500,201803,3541,1539,2002,1462701.69,1904996.41,3367698.10
351510,201803,1773,742,1031,707581.8,981370.26,1688952.06
351512,201803,22,18,4,17172,3816,20988
351515,201803,192,112,80,106848,76320,183168
351518,201803,751,459,292,436928,278568,715496
351519,201803,74,47,27,44838,25758,70596
351520,201803,144,89,55,84269.96,52470,136739.96
351530,201803,20,13,7,12402,6678,19080
351535,201803,133,74,59,70596,56286,126882
351540,201803,461,332,129,314345,123066,437411
351550,201803,1327,803,524,762024.96,497978.86,1260003.82
351560,201803,74,39,35,37206,33390,70596
351565,201803,13,8,5,7632,4770,12402
351570,201803,2563,1324,1239,1260772.35,1181339.65,2442112.00
351580,201803,39,35,4,33390,3816,37206
351590,201803,66,44,22,41976,20988,62964
351600,201803,192,146,46,139284,43884,183168
351610,201803,62,31,31,29574,29574,59148
351620,201803,5924,3391,2533,3224985.25,2414263.11,5639248.36
351630,201803,2531,1307,1224,1241563.43,1165211.23,2406774.66
351640,201803,1658,808,850,768947.38,808181.8,1577129.18
351650,201803,30,25,5,23850,4770,28620
351660,201803,157,100,57,94446,54378,148824
351670,201803,748,469,279,445090,266166,711256
351680,201803,74,60,14,57240,13356,70596
351685,201803,42,27,15,25758,14310,40068
351690,201803,310,220,90,208015.63,85860,293875.63
351700,201803,163,114,49,108756,46746,155502
351710,201803,75,54,21,51516,20034,71550
351720,201803,134,63,71,60102,67734,127836
351730,201803,101,73,28,68600.96,26707.23,95308.19
351740,201803,718,487,231,462098.01,220369.23,682467.24
351750,201803,366,154,212,146280,202248,348528
351760,201803,794,617,177,588857,168858,757715
351770,201803,288,247,41,235638,39114,274752
351780,201803,172,98,74,93483,70596,164079
351790,201803,243,127,116,121158,110664,231822
351800,201803,54,35,19,33390,18126,51516
351810,201803,126,84,42,80136,40068,120204
351820,201803,883,638,245,604170.4,233439.23,837609.63
351830,201803,507,184,323,174772.8,308142,482914.8
351840,201803,1869,947,922,894494,878087.71,1772581.71
351850,201803,231,169,62,160606.8,59148,219754.8
351860,201803,756,501,255,472232.84,242979.23,715212.07
351870,201803,5636,2659,2977,2526273.94,2833767.75,5360041.69
351880,201803,18984,8315,10669,7909904.87,10162959,18072863.87
351885,201803,90,62,28,58433,26712,85145
351890,201803,72,61,11,58194,10494,68688
351900,201803,224,133,91,126215,86814,213029
351905,201803,77,34,43,32436,41022,73458
351907,201803,3114,1362,1752,1296479.06,1669329.8,2965808.86
351910,201803,177,74,103,70596,98262,168858
351920,201803,133,76,57,72504,54355.69,126859.69
351925,201803,86,58,28,55332,26712,82044
351930,201803,383,259,124,246990.6,118296,365286.6
351940,201803,234,105,129,100170,123066,223236
351950,201803,145,84,61,80136,58194,138330
351960,201803,864,401,463,382372.73,439546.36,821919.09
351970,201803,1899,1014,885,965209.84,843709,1808918.84
351980,201803,146,73,73,67734,69642,137376
351990,201803,276,187,89,177444,84104.64,261548.64
352000,201803,357,216,141,206064,134514,340578
352010,201803,352,209,143,199386,136422,335808
352020,201803,199,68,131,64872,124974,189846
352030,201803,1011,522,489,497272.5,464915.96,962188.46
352040,201803,571,249,322,237546,307188,544734
352042,201803,280,95,185,90630,176204,266834
352044,201803,392,234,158,222282.2,150732,373014.2
352050,201803,3157,1284,1873,1217099.98,1785306.26,3002406.24
352060,201803,106,66,40,62964,38160,101124
352070,201803,104,74,30,69326,28620,97946
352080,201803,65,40,25,37206,23850,61056
352090,201803,173,117,56,111618,53424,165042
352100,201803,254,124,130,118292,122868,241160
352110,201803,112,33,79,31482,75366,106848
352115,201803,72,28,44,26712,41976,68688
352120,201803,96,64,32,61056,30528,91584
352130,201803,219,184,35,175345.2,33390,208735.2
352140,201803,180,73,107,69165,102078,171243
352150,201803,122,67,55,62964.04,52470,115434.04
352160,201803,130,86,44,82044,41976,124020
352170,201803,371,252,119,239454.04,113526,352980.04
352180,201803,611,412,199,392094.5,189842,581936.5
352190,201803,263,103,160,98252.46,152601.84,250854.30
352200,201803,32,16,16,15264,15264,30528
352210,201803,3766,1568,2198,1487076.44,2090975.19,3578051.63
352215,201803,54,30,24,28620,22438.08,51058.08
352220,201803,6887,2716,4171,2586136.44,3976642.39,6562778.83
352230,201803,3177,2025,1152,1918902.46,1092269.32,3011171.78
352240,201803,2217,1303,914,1240582.49,869659.08,2110241.57
352250,201803,2591,1348,1243,1282719.5,1181688.88,2464408.38
352260,201803,1084,593,491,563905.23,468128,1032033.23
352265,201803,61,27,34,25758,32436,58194
352270,201803,408,234,174,222282.92,165940,388222.92
352280,201803,396,248,148,235321,141187.23,376508.23
352290,201803,174,111,63,105894,60102,165996
352300,201803,102,76,26,72504,24804,97308
352310,201803,5765,2818,2947,2675122.35,2805295.95,5480418.30
352320,201803,969,506,463,479229.84,439651.1,918880.94
352330,201803,528,239,289,227672.1,275420,503092.1
352340,201803,1400,684,716,649884,681014.5,1330898.5
352350,201803,333,210,123,200340,117056,317396
352360,201803,231,96,135,90677.7,125907.32,216585.02
352370,201803,102,69,33,65826,31482,97308
352380,201803,120,75,45,71550,42930,114480
352390,201803,2430,1113,1317,1058301.32,1255256,2313557.32
352400,201803,474,204,270,193662,257293.8,450955.8
352410,201803,760,544,216,514471.88,205778,720249.88
352420,201803,101,65,36,62010,34344,96354
352430,201803,1763,783,980,741929.84,932287.5,1674217.34
352440,201803,3123,1610,1513,1526863.48,1441454.67,2968318.15
352450,201803,190,161,29,153594,27666,181260
352460,201803,568,292,276,278010.68,262589.2,540599.88
352470,201803,596,201,395,191754,376821,568575
352480,201803,1376,770,606,733307.96,577551.8,1310859.76
352490,201803,84,32,52,30528,49608,80136
352500,201803,1202,534,668,508483,636119.2,1144602.2
352510,201803,736,401,335,381600.96,319480,701080.96
352520,201803,537,239,298,228006,284148.9,512154.9
352530,201803,1725,904,821,862416,782852.6,1645268.6
352540,201803,74,49,25,46746,23850,70596
352550,201803,180,103,77,98262,72790.2,171052.2
352560,201803,49,39,10,37206,9540,46746
352570,201803,666,345,321,328527,306234,634761
352580,201803,57,38,19,35298.65,18126,53424.65
352585,201803,17,5,12,4770,11448,16218
352590,201803,4330,2186,2144,2079039.72,2044475.41,4123515.13
352600,201803,358,249,109,236592.96,103986,340578.96
352610,201803,933,437,496,415877.22,473184,889061.22
352620,201803,959,385,574,366336.2,546643,912979.2
352630,201803,175,66,109,62964,103976.46,166940.46
352640,201803,556,395,161,373778.36,153594,527372.36
352650,201803,89,58,31,55332,29574,84906
352660,201803,81,48,33,45792,31482,77274
352670,201803,1657,901,756,856060.76,720134.6,1576195.36
352680,201803,887,569,318,539594.56,301910.04,841504.60
352690,201803,4342,1999,2343,1898935.84,2231356.69,4130292.53
352700,201803,107,62,45,58861.8,42930,101791.8
352710,201803,1373,735,638,699282,605690.6,1304972.6
352720,201803,1311,638,673,606108.2,641751.23,1247859.43
352725,201803,26,24,2,22896,1908,24804
352730,201803,365,181,184,171495.81,175536,347031.81
352740,201803,416,261,155,247039.68,147870,394909.68
352750,201803,22,14,8,13069.8,7632,20701.8
352760,201803,199,142,57,135468,54378,189846
352770,201803,81,63,18,60102,17172,77274
352780,201803,79,44,35,41976,33390,75366
352790,201803,29,24,5,22896,4770,27666
352800,201803,248,168,80,160272,76033.8,236305.8
352810,201803,166,109,57,101475.42,54378,155853.42
352820,201803,65,52,13,48896.32,12402,61298.32
352830,201803,88,61,27,58194,25758,83952
352840,201803,596,308,288,292545.2,274752,567297.2
352850,201803,1368,488,880,464884.2,839520,1304404.2
352860,201803,132,86,46,81408,43884,125292
352870,201803,45,29,16,27666,15264,42930
352880,201803,190,128,62,122092.92,59148,181240.92
352885,201803,28,20,8,19080,7632,26712
352890,201803,56,39,17,37206,15932,53138
352900,201803,4899,2367,2532,2240103.91,2407946.82,4648050.73
352910,201803,38,31,7,29574,6678,36252
352920,201803,713,439,274,417852,261396,679248
352930,201803,1272,616,656,586231.82,622845.18,1209077.00
352940,201803,6309,2745,3564,2607174.2,3396894.64,6004068.84
352950,201803,93,37,56,35298,53424,88722
352960,201803,69,45,24,42930,22896,65826
352965,201803,20,8,12,7632,11448,19080
352970,201803,465,347,118,327830.97,111619,439449.97
352980,201803,175,94,81,89676,77274,166950
352990,201803,950,423,527,402539.27,501670.09,904209.36
353000,201803,67,31,36,29574,34344,63918
353010,201803,552,343,209,327222,199366.92,526588.92
353020,201803,289,212,77,202248,73458,275706
353030,201803,1186,538,648,512289.28,617505.66,1129794.94
353040,201803,89,54,35,51516,33390,84906
353050,201803,1315,833,482,787037.03,459732.6,1246769.63
353060,201803,7996,3613,4383,3431566.04,4175139.84,7606705.88
353070,201803,1635,1028,607,974158.46,577787.38,1551945.84
353080,201803,1325,705,620,670233.55,590522,1260755.55
353090,201803,56,34,22,32436,20988,53424
353100,201803,62,51,11,48654,10494,59148
353110,201803,1999,610,1389,580208.88,1323137.26,1903346.14
353120,201803,78,41,37,39114,35298,74412
353130,201803,878,442,436,420695.46,415822.68,836518.14
353140,201803,565,222,343,211727,327222,538949
353150,201803,364,204,160,193662,152630.46,346292.46
353160,201803,102,84,18,80136,17172,97308
353170,201803,196,65,131,62010,124946.46,186956.46
353180,201803,954,435,519,412696.69,494602,907298.69
353190,201803,481,347,134,329982.9,127550,457532.9
353200,201803,191,97,94,92538,89676,182214
353205,201803,27,19,8,18126,7632,25758
353210,201803,87,52,35,49608,33390,82998
353215,201803,54,32,22,30528,20988,51516
353220,201803,86,48,38,45792,35055.27,80847.27
353230,201803,161,63,98,60102,93492,153594
353240,201803,292,161,131,153594,124974,278568
353250,201803,202,105,97,100170,92538,192708
353260,201803,458,330,128,313685.5,122102.46,435787.96
353270,201803,68,49,19,46746,17458.2,64204.2
353280,201803,95,48,47,45315,44838,90153
353282,201803,120,88,32,83952,30528,114480
353284,201803,22,18,4,17172,3816,20988
353286,201803,1,1,0,954,0,954
353290,201803,80,47,33,44838,31473,76311
353300,201803,400,222,178,210246.46,169812,380058.46
353310,201803,55,48,7,45792,6678,52470
353320,201803,63,40,23,38160,21942,60102
353325,201803,57,35,22,33381,20684,54065
353330,201803,67,51,16,48511,15264,63775
353340,201803,617,197,420,187938,400094.26,588032.26
353350,201803,925,429,496,408275.64,471640.8,879916.44
353360,201803,111,88,23,83634.04,21656,105290.04
353370,201803,121,71,50,66780.1,47700,114480.1
353380,201803,27,19,8,18122,7632,25754
353390,201803,1062,504,558,480816,532332,1013148
353400,201803,52,31,21,29574,20034,49608
353410,201803,121,76,45,72504,42883,115387
353420,201803,57,23,34,21942,32436,54378
353430,201803,553,365,188,344489.3,179065.8,523555.1
353440,201803,10216,4476,5740,4257452.01,5468894.19,9726346.20
353450,201803,56,30,26,28620,24804,53424
353460,201803,613,334,279,315467.1,265441.5,580908.6
353470,201803,2149,1169,980,1111273.85,932505.23,2043779.08
353475,201803,239,161,78,150904.96,74412,225316.96
353480,201803,190,151,39,144054,37206,181260
353490,201803,237,142,95,135468,90630,226098
353500,201803,185,108,77,101792.96,73458,175250.96
353510,201803,102,73,29,69623.46,27656.46,97279.92
353520,201803,209,140,69,133560,65826,199386
353530,201803,474,259,215,247086,205110,452196
353540,201803,358,238,120,226729.27,114480,341209.27
353550,201803,737,500,237,473186.88,226098,699284.88
353560,201803,640,271,369,256968.69,351426.06,608394.75
353570,201803,59,31,28,29574,26712,56286
353580,201803,357,276,81,262827,77274,340101
353590,201803,85,59,26,55968.04,24804,80772.04
353600,201803,274,156,118,148507,111936,260443
353610,201803,113,59,54,56286,51516,107802
353620,201803,570,310,260,293753.5,247753.8,541507.3
353625,201803,50,28,22,26712,20988,47700
353630,201803,239,172,67,159757.16,63918,223675.16
353640,201803,128,87,41,82521,39114,121635
353650,201803,855,331,524,313675.2,499896,813571.2
353657,201803,23,17,6,16218,5724,21942
353660,201803,255,144,111,137376,105607.8,242983.8
353670,201803,755,446,309,424530.2,294786,719316.2
353680,201803,100,71,29,67734,27666,95400
353690,201803,47,37,10,34737,9540,44277
353700,201803,283,199,84,189846,80136,269982
353710,201803,417,196,221,186030.8,210548,396578.8
353715,201803,46,34,12,32149.8,11448,43597.8
353720,201803,361,170,191,162162,182214,344376
353730,201803,1128,694,434,659166.9,413835.67,1073002.57
353740,201803,651,358,293,341245.8,279522,620767.8
353750,201803,93,58,35,54800.14,33390,88190.14
353760,201803,2746,1043,1703,992963.11,1621059.28,2614022.39
353770,201803,98,81,17,76797,16218,93015
353780,201803,1123,562,561,534431.96,533286,1067717.96
353790,201803,514,296,218,280315.1,205087.35,485402.45
353800,201803,3273,1670,1603,1585150.69,1526882.72,3112033.41
353810,201803,237,132,105,125074.71,100143,225217.71
353820,201803,186,92,94,87768,89051.41,176819.41
353830,201803,48,41,7,39114,6678,45792
353850,201803,165,86,79,82044,75366,157410
353860,201803,467,210,257,199624.5,244891.8,444516.3
353870,201803,5008,2520,2488,2387661.9,2362346.68,4750008.58
353880,201803,679,486,193,462308.4,183168.12,645476.52
353890,201803,587,332,255,316156,242984,559140
353900,201803,134,68,66,64872,62964,127836
353910,201803,176,88,88,83952,83952,167904
353920,201803,452,244,208,231584.4,197989.16,429573.56
353930,201803,999,595,404,565937.79,384181.8,950119.59
353940,201803,188,102,86,96544.8,81186,177730.8
353950,201803,516,321,195,305947.8,186021,491968.8
353960,201803,71,58,13,55332,12402,67734
353970,201803,75,46,29,43884,27666,71550
353980,201803,1529,752,777,714748.95,740319.76,1455068.71
353990,201803,75,42,33,40068,31482,71550
354000,201803,375,181,194,172007,184881.2,356888.2
354010,201803,94,51,43,48654,40545,89199
354020,201803,544,343,201,326268,191754,518022
354025,201803,55,43,12,41022,11448,52470
354030,201803,64,35,29,33390,27666,61056
354040,201803,96,68,28,64490.4,26712,91202.4
354050,201803,189,105,84,99884,80136,180020
354060,201803,774,371,403,353934,381935.4,735869.4
354070,201803,876,511,365,485964.03,348210,834174.03
354075,201803,212,115,97,109615,91584.8,201199.8
354080,201803,293,126,167,119917.8,159318,279235.8
354085,201803,18,11,7,10494,6678,17172
354090,201803,311,172,139,164007,132606,296613
354100,201803,5495,2286,3209,2169768.26,3055567.02,5225335.28
354105,201803,79,41,38,39114,36252,75366
354110,201803,47,21,26,20034,24804,44838
354120,201803,147,101,46,96214.97,43884,140098.97
354130,201803,698,468,230,446234,219130,665364
354140,201803,3172,1479,1693,1406999.43,1613577.83,3020577.26
354150,201803,645,402,243,382248.96,230391,612639.96
354160,201803,709,451,258,429061.5,245846,674907.5
354165,201803,19,12,7,11448,6678,18126
354170,201803,176,119,57,112858.2,54378,167236.2
354180,201803,63,39,24,36880,22896,59776
354190,201803,215,100,115,93778.2,109710,203488.2
354200,201803,131,72,59,68211,56286,124497
354210,201803,69,34,35,32436,33390,65826
354220,201803,643,398,245,378388.16,232204.15,610592.31
354230,201803,160,66,94,62964,88722.6,151686.6
354240,201803,320,207,113,196524.49,107165.96,303690.45
354250,201803,92,56,36,53424,34344,87768
354260,201803,1929,904,1025,850729.34,976510,1827239.34
354270,201803,95,71,24,67734,22896,90630
354280,201803,36,19,17,18126,16218,34344
354290,201803,143,98,45,92681.1,42930,135611.1
354300,201803,422,288,134,274435,127678,402113
354310,201803,105,76,29,71550.2,27666,99216.2
354320,201803,181,97,84,92538,80136,172674
354323,201803,16,14,2,13356,1908,15264
354325,201803,108,62,46,58342,43884,102226
354330,201803,2586,866,1720,821529.26,1638713.98,2460243.24
354340,201803,10557,5146,5411,4896209.53,5155748.67,10051958.20
354350,201803,129,87,42,82998,39924.9,122922.9
354360,201803,87,48,39,45792,37206,82998
354370,201803,265,144,121,137376,115434,252810
354380,201803,210,127,83,120372,79182,199554
354390,201803,2752,999,1753,952095.95,1670991.75,2623087.70
354400,201803,329,173,156,164375,148251.8,312626.8
354410,201803,611,297,314,281712.43,298602.2,580314.63
354420,201803,270,170,100,162180,95400,257580
354425,201803,320,186,134,177444,127836,305280
354430,201803,187,116,71,109089.9,66970.8,176060.7
354440,201803,40,28,12,26712,11448,38160
354450,201803,53,38,15,36252,14310,50562
354460,201803,103,60,43,57240,41022,98262
354470,201803,39,26,13,24804,12402,37206
354480,201803,119,62,57,59139,54368.46,113507.46
354490,201803,149,93,56,88562.97,53424,141986.97
354500,201803,395,197,198,187938,188892,376830
354510,201803,101,70,31,66780,29574,96354
354515,201803,39,13,26,12402,24804,37206
354520,201803,1625,712,913,676537.2,870563.56,1547100.76
354530,201803,652,340,312,323225.8,296504,619729.8
354540,201803,279,159,120,151686,114475.23,266161.23
354550,201803,42,24,18,22896,17172,40068
354560,201803,165,96,69,91298,65816.46,157114.46
354570,201803,138,89,49,84906,46746,131652
354580,201803,1967,932,1035,886265,987090.26,1873355.26
354600,201803,275,148,127,138938.12,121143.69,260081.81
354610,201803,73,65,8,61056.58,7632,68688.58
354620,201803,64,21,43,20034,41022,61056
354625,201803,17,11,6,10494,5720,16214
354630,201803,320,211,109,200788.55,103986,304774.55
354640,201803,798,512,286,484522.36,272844,757366.36
354650,201803,72,41,31,38818.8,29545.92,68364.72
354660,201803,816,605,211,573148.46,201294,774442.46
354670,201803,279,100,179,94447,169813,264260
354680,201803,1250,477,773,455058,736965,1192023
354690,201803,92,63,29,59149,27666,86815
354700,201803,77,56,21,53424,20034,73458
354710,201803,56,38,18,35615.96,17172,52787.96
354720,201803,20,19,1,18126,954,19080
354730,201803,1902,803,1099,762905.2,1048255.2,1811160.4
354740,201803,56,41,15,39114,14310,53424
354750,201803,441,262,179,249939,170766,420705
354760,201803,516,316,200,299082,190227.8,489309.8
354765,201803,12,5,7,4770,6678,11448
354770,201803,340,232,108,220504.03,102268.8,322772.83
354780,201803,8115,3308,4807,3142877.69,4581041.02,7723918.71
354790,201803,113,67,46,63918,43884,107802
354800,201803,423,234,189,223236,180000.92,403236.92
354805,201803,103,53,50,49926,47700,97626
354810,201803,137,80,57,76320,54378,130698
354820,201803,185,81,104,77065,99216,176281
354830,201803,40,21,19,20034,18126,38160
354840,201803,55,37,18,35298,17172,52470
354850,201803,4564,2026,2538,1925020.96,2416736.58,4341757.54
354860,201803,329,159,170,151686,159785.52,311471.52
354870,201803,11850,5357,6493,5080577.61,6183673.54,11264251.15
354880,201803,3002,1125,1877,1071612.46,1789062.9,2860675.36
354890,201803,2833,1563,1270,1485586.71,1210597.38,2696184.09
354900,201803,59,39,20,37206,19080,56286
354910,201803,1228,643,585,610614.24,558090,1168704.24
354920,201803,50,42,8,40068,7632,47700
354925,201803,12,7,5,6678,4770,11448
354930,201803,31,28,3,26442,2862,29304
354940,201803,796,587,209,558045.19,199386,757431.19
354950,201803,220,144,76,136766,72504,209270
354960,201803,170,64,106,61056,100838,161894
354970,201803,844,551,293,520795.1,278883.02,799678.12
354980,201803,8414,3136,5278,2983637.31,5032226.98,8015864.29
354990,201803,9173,4326,4847,4112966.39,4617903.12,8730869.51
354995,201803,513,181,332,172674,316413.18,489087.18
355000,201803,495,164,331,156451.23,314581.5,471032.73
355010,201803,620,391,229,373014,216254.48,589268.48
355020,201803,720,451,269,429295.59,256618,685913.59
355030,201803,203881,79129,124752,75263138.88,118915798,194178936.88
355040,201803,717,337,380,319972.3,362329.2,682301.5
355050,201803,151,100,51,94129.77,48654,142783.77
355060,201803,1489,753,736,713493.86,700952.3,1414446.16
355070,201803,1459,718,741,681148.36,705921,1387069.36
355080,201803,199,115,84,109710,79248.8,188958.8
355090,201803,291,193,98,182024,93492,275516
355100,201803,4777,2374,2403,2243738.92,2290584.36,4534323.28
355110,201803,271,172,99,163131,94446,257577
355120,201803,80,56,24,53424,22896,76320
355130,201803,55,29,26,27666,24804,52470
355140,201803,182,120,62,113764.5,59148,172912.5
355150,201803,677,407,270,387034,257103,644137
355160,201803,450,218,232,205587.96,221276,426863.96
355170,201803,2054,1069,985,1018446.87,939670.92,1958117.79
355180,201803,621,267,354,253764,336881.25,590645.25
355190,201803,222,151,71,144054,67734,211788
355200,201803,116,68,48,64872,45792,110664
355210,201803,722,416,306,396864,291905.46,688769.46
355220,201803,6647,3558,3089,3382892.76,2938647.2,6321539.96
355230,201803,106,63,43,60102,41017.23,101119.23
355240,201803,4249,1870,2379,1770010.88,2264855.71,4034866.59
355250,201803,5378,2629,2749,2501452.42,2619143.1,5120595.52
355255,201803,53,32,21,30528,20034,50562
355260,201803,186,112,74,105875.12,70568.46,176443.58
355270,201803,164,97,67,92538,63203,155741
355280,201803,6346,2672,3674,2544180.46,3500294.46,6044474.92
355290,201803,78,58,20,55332,19080,74412
355300,201803,182,119,63,112286.6,60102,172388.6
355310,201803,106,60,46,57240,43884,101124
355320,201803,93,47,46,44838,42936.6,87774.6
355330,201803,270,150,120,143100,114480,257580
355340,201803,1513,551,962,523047.61,917005.97,1440053.58
355350,201803,142,74,68,70596,64872,135468
355360,201803,183,115,68,109500.12,64872,174372.12
355365,201803,26,21,5,20034,4770,24804
355370,201803,1036,586,450,553167.74,428032.55,981200.29
355380,201803,770,516,254,490818.52,242030,732848.52
355385,201803,61,43,18,41022,17172,58194
355390,201803,107,62,45,59148,42930,102078
355395,201803,188,114,74,107655.23,70596,178251.23
355400,201803,1548,960,588,911841.52,559291.33,1471132.85
355410,201803,4889,2290,2599,2167238.94,2471685.16,4638924.10
355420,201803,48,36,12,34344,11448,45792
355430,201803,343,208,135,197096.4,128790,325886.4
355440,201803,79,47,32,44838,30528,75366
355450,201803,440,209,231,196486.28,219324.8,415811.08
355460,201803,70,54,16,50562.42,15264,65826.42
355465,201803,51,32,19,30528,18126,48654
355470,201803,182,73,109,68688.1,103986,172674.1
355475,201803,13,8,5,7632,4770,12402
355480,201803,458,201,257,189856.34,243737.46,433593.80
355490,201803,116,82,34,78228,32436,110664
355495,201803,56,27,29,25758,27666,53424
355500,201803,1667,942,725,892802.66,691615.46,1584418.12
355510,201803,271,196,75,183525.67,71550,255075.67
355520,201803,36,28,8,26426,7632,34058
355530,201803,23,16,7,15264,6678,21942
355535,201803,76,38,38,36252,36252,72504
355540,201803,2357,940,1417,895301.53,1349677.96,2244979.49
355550,201803,64,39,25,37206,23850,61056
355560,201803,237,119,118,113526,111935.96,225461.96
355570,201803,31,20,11,19080,10494,29574
355580,201803,271,189,82,180306,77937.23,258243.23
355590,201803,23,14,9,13356,8586,21942
355600,201803,273,140,133,133560,126591.23,260151.23
355610,201803,206,135,71,128790,67734,196524
355620,201803,1249,581,668,553463.8,636189.98,1189653.78
355630,201803,408,297,111,283338,105894,389232
355635,201803,125,60,65,57240,61997,119237
355640,201803,570,332,238,315774.16,227052,542826.16
355645,201803,825,356,469,338145.3,445546.82,783692.12
355650,201803,2137,894,1243,849606.8,1185517.46,2035124.26
355660,201803,262,140,122,133560,116388,249948
355670,201803,484,191,293,182214,279235.8,461449.8
355680,201803,208,118,90,111619,85574,197193
355690,201803,87,40,47,38160,44434,82594
355695,201803,15,12,3,11448,2862,14310
355700,201803,1140,586,554,553974.6,527944,1081918.6
355710,201803,2190,1200,990,1141449.56,943669,2085118.56
355715,201803,20,18,2,17172,1908,19080
355720,201803,208,126,82,118614.08,78228,196842.08
355730,201803,93,53,40,49437.95,38160,87597.95
410010,201803,137,115,22,109710,20988,130698
410020,201803,106,94,12,89676,11448,101124
410030,201803,164,104,60,98548.4,57240,155788.4
410040,201803,970,532,438,507289.5,417662,924951.5
410045,201803,26,21,5,20034,4770,24804
410050,201803,471,260,211,248040,200626.2,448666.2
410060,201803,277,213,64,203202,61056,264258
410070,201803,307,254,53,242316,50562,292878
410080,201803,165,106,59,101124,56286,157410
410090,201803,75,66,9,62755,8586,71341
410100,201803,297,213,84,202887.18,79325.1,282212.28
410105,201803,46,27,19,25758,18126,43884
410110,201803,313,193,120,184122,114480,298602
410115,201803,26,18,8,17172,7632,24804
410120,201803,442,227,215,216256.8,205110,421366.8
410130,201803,43,26,17,24804,16218,41022
410140,201803,3088,1522,1566,1448017.58,1490616.06,2938633.64
410150,201803,2693,1079,1614,1028213.44,1539446,2567659.44
410160,201803,505,317,188,302131.8,179352,481483.8
410165,201803,68,46,22,43884,20988,64872
410170,201803,166,124,42,116871,40068,156939
410180,201803,2146,1250,896,1188511.19,852884.15,2041395.34
410185,201803,33,29,4,27666,3816,31482
410190,201803,443,277,166,264258,158364,422622
410200,201803,966,721,245,686984.94,233624.89,920609.83
410210,201803,554,287,267,273798,254146,527944
410220,201803,40,22,18,20988,17172,38160
410230,201803,128,69,59,65826,56286,122112
410240,201803,747,490,257,466887.8,245178,712065.8
410250,201803,377,276,101,262699.84,96349.23,359049.07
410260,201803,289,172,117,164088,111618,275706
410270,201803,29,18,11,17172,10494,27666
410275,201803,66,49,17,46746,16218,62964
410280,201803,324,185,139,176230.52,132606,308836.52
410290,201803,232,147,85,140238,81090,221328
410300,201803,80,64,16,61056,15264,76320
410302,201803,24,16,8,15264,7632,22896
410304,201803,46,32,14,30528,13356,43884
410305,201803,207,112,95,106040.2,90630,196670.2
410310,201803,264,169,95,161226,90610.92,251836.92
410315,201803,52,37,15,35274,14310,49584
410320,201803,139,96,43,91584,41022,132606
410322,201803,34,24,10,22896,9540,32436
410330,201803,164,116,48,110664,45602,156266
410335,201803,100,62,38,59148,36252,95400
410337,201803,38,33,5,31482,4770,36252
410340,201803,31,29,2,27666,1908,29574
410345,201803,215,136,79,129744,75366,205110
410347,201803,53,40,13,38160,12402,50562
410350,201803,227,138,89,131652,84906,216558
410360,201803,453,271,182,255990.4,173056,429046.4
410370,201803,2399,1023,1376,972208.32,1309707.97,2281916.29
410380,201803,219,144,75,137376,71550,208926
410390,201803,370,276,94,263300,89676,352976
410395,201803,34,22,12,20988,11067,32055
410400,201803,843,434,409,412707.2,389647,802354.2
410405,201803,90,68,22,64872,20988,85860
410410,201803,40,31,9,29574,8586,38160
410420,201803,1657,819,838,779231.89,798499,1577730.89
410425,201803,180,85,95,80900,90630,171530
410430,201803,2196,1291,905,1228466,862492.32,2090958.32
410440,201803,393,290,103,275707,98262,373969
410442,201803,357,239,118,227053,112572,339625
410445,201803,423,292,131,278568,124974,403542
410450,201803,412,206,206,196524,196524,393048
410460,201803,410,223,187,212446.8,178398,390844.8
410465,201803,190,124,66,117055.8,62964,180019.8
410470,201803,220,140,80,133560,76320,209880
410480,201803,5786,2863,2923,2711826.4,2783381.15,5495207.55
410490,201803,1384,914,470,870459,446473,1316932
410500,201803,268,152,116,145008,110664,255672
410510,201803,180,132,48,125928,45783,171711
410520,201803,258,191,67,182214,63918,246132
410530,201803,238,89,149,84906,142142,227048
410540,201803,318,228,90,216931.6,85855.23,302786.83
410550,201803,1613,699,914,666559.8,870756.36,1537316.16
410560,201803,147,115,32,109710,30528,140238
410570,201803,431,303,128,286974.2,122112,409086.2
410580,201803,3175,1424,1751,1356880.8,1669024,3025904.8
410590,201803,404,285,119,271890,113526,385416
410600,201803,184,159,25,151686,23850,175536
410610,201803,55,44,11,41976,10494,52470
410620,201803,241,174,67,165996,63918,229914
410630,201803,443,261,182,248994,172469,421463
410640,201803,975,599,376,567990.99,357097.28,925088.27
410645,201803,97,74,23,70215,21942,92157
410650,201803,367,252,115,239454,109710,349164
410655,201803,78,60,18,57240,17172,74412
410657,201803,44,19,25,18126,23850,41976
410660,201803,598,421,177,400391,168858,569249
410670,201803,77,63,14,60102,13356,73458
410680,201803,187,155,32,147203,30528,177731
410685,201803,16,10,6,9540,5724,15264
410690,201803,28299,12289,16010,11704817.49,15260389.75,26965207.24
410700,201803,320,232,88,220756,83952,304708
410710,201803,127,102,25,97308,23850,121158
410712,201803,24,15,9,14310,8586,22896
410715,201803,84,62,22,59148,20988,80136
410720,201803,597,361,236,344394,224909.05,569303.05
410725,201803,180,129,51,123066,48654,171720
410730,201803,87,54,33,51516,31482,82998
410740,201803,111,80,31,76320,29574,105894
410750,201803,222,165,57,157406,54373.23,211779.23
410752,201803,24,15,9,14310,8586,22896
410753,201803,54,24,30,22223.43,28620,50843.43
410754,201803,36,22,14,20702,13356,34058
410755,201803,81,55,26,52183.8,24804,76987.8
410760,201803,717,407,310,388278,295740,684018
410765,201803,1654,793,861,750177.68,820240.46,1570418.14
410770,201803,105,88,17,83952,16218,100170
410773,201803,45,34,11,32436,10494,42930
410775,201803,178,134,44,127168.2,41976,169144.2
410780,201803,79,43,36,41022,34344,75366
410785,201803,53,42,11,40068,10494,50562
410790,201803,71,33,38,31482,36252,67734
410800,201803,296,188,108,178399,103032,281431
410810,201803,26,22,4,20988,3530,24518
410820,201803,179,132,47,125785,44838,170623
410830,201803,8482,3868,4614,3681120.84,4399470.91,8080591.75
410832,201803,104,72,32,68401.8,30528,98929.8
410840,201803,1420,793,627,754254.08,597473.48,1351727.56
410845,201803,63,39,24,37206,22896,60102
410850,201803,189,131,58,124688,55332,180020
410855,201803,47,40,7,38160,6678,44838
410860,201803,670,392,278,373182.76,265212,638394.76
410865,201803,104,80,24,76320,22896,99216
410870,201803,155,134,21,127836,19743,147579
410880,201803,1111,555,556,528959.62,530379,1059338.62
410890,201803,76,53,23,50562,21942,72504
410895,201803,73,55,18,52470,17172,69642
410900,201803,19,11,8,10494,7632,18126
410910,201803,17,15,2,14310,1908,16218
410920,201803,34,23,11,21942,10494,32436
410930,201803,504,326,178,310792.98,169812,480604.98
410940,201803,4330,2580,1750,2452311.98,1667476.4,4119788.38
410950,201803,122,87,35,82998,33390,116388
410960,201803,761,338,423,322166,403352,725518
410965,201803,63,48,15,45505.8,14310,59815.8
410970,201803,627,446,181,425016.2,172674,597690.2
410975,201803,106,63,43,59591,41022,100613
410980,201803,1565,710,855,674793.82,814707.23,1489501.05
410990,201803,268,181,87,172505.24,82711.8,255217.04
411000,201803,62,40,22,38160,20988,59148
411005,201803,25,20,5,19080,4770,23850
411007,201803,235,137,98,130698,93492,224190
411010,201803,575,401,174,382554,165996,548550
411020,201803,290,200,90,190800,85860,276660
411030,201803,19,10,9,9540,8586,18126
411040,201803,49,35,14,33390,13356,46746
411050,201803,216,171,45,162477.72,42803.12,205280.84
411060,201803,519,349,170,332937,162180,495117
411065,201803,61,53,8,50562,7632,58194
411070,201803,1196,796,400,753877.31,380646,1134523.31
411080,201803,243,171,72,163218,68688,231906
411090,201803,118,89,29,84906,27666,112572
411095,201803,263,106,157,100647,149768,250415
411100,201803,113,94,19,89676,18126,107802
411110,201803,121,83,38,79182,36252,115434
411120,201803,183,137,46,130698,43884,174582
411125,201803,182,81,101,76625.28,96354,172979.28
411130,201803,125,107,18,101440,16885.8,118325.8
411140,201803,180,125,55,119228.12,51945.3,171173.42
411150,201803,1217,816,401,777786.66,382554,1160340.66
411155,201803,120,84,36,80136,34344,114480
411160,201803,21,10,11,9540,10494,20034
411170,201803,58,52,6,49321.8,5724,55045.8
411180,201803,938,616,322,586138,307183.23,893321.23
411190,201803,343,198,145,188224.2,138330,326554.2
411200,201803,671,445,226,423259.89,214697.9,637957.79
411210,201803,683,365,318,346660.21,303372,650032.21
411220,201803,147,111,36,105894,34344,140238
411230,201803,40,36,4,34344,3816,38160
411240,201803,118,80,38,76320,36252,112572
411250,201803,418,305,113,290970,107802,398772
411260,201803,21,15,6,14310,5724,20034
411270,201803,298,161,137,153594,130698,284292
411275,201803,202,178,24,169096.6,22896,191992.6
411280,201803,230,163,67,154231.12,63918,218149.12
411290,201803,58,43,15,41022,14310,55332
411295,201803,143,114,29,108756,27666,136422
411300,201803,70,36,34,34344,32436,66780
411310,201803,90,69,21,65826,20034,85860
411320,201803,757,548,209,521266.4,197783.28,719049.68
411325,201803,44,27,17,25758,16218,41976
411330,201803,919,584,335,555610.61,318859.6,874470.21
411340,201803,25,17,8,16218,7318,23536
411342,201803,76,55,21,52470,20034,72504
411345,201803,126,63,63,60102,60102,120204
411350,201803,480,382,98,363140.44,92529.2,455669.64
411360,201803,54,35,19,33390,18126,51516
411370,201803,14096,5785,8311,5501301.62,7914930.39,13416232.01
411373,201803,190,140,50,133499,47700,181199
411375,201803,72,60,12,57240,11448,68688
411380,201803,96,71,25,67734,23850,91584
411390,201803,137,91,46,86814,43884,130698
411400,201803,349,262,87,249939,82998,332937
411410,201803,448,230,218,218752.2,207686,426438.2
411420,201803,1025,468,557,444182.4,530877.08,975059.48
411430,201803,406,263,143,250234.2,136413,386647.2
411435,201803,35,23,12,21942,11448,33390
411440,201803,472,376,96,357050.76,91584,448634.76
411450,201803,429,356,73,339624,69642,409266
411460,201803,750,300,450,285255.2,428017.96,713273.16
411470,201803,87,63,24,60102,22896,82998
411480,201803,628,356,272,338098.6,258915.6,597014.2
411490,201803,290,179,111,170766,105894,276660
411500,201803,112,95,17,90426.33,15837,106263.33
411510,201803,219,176,43,167156.06,41022,208178.06
411520,201803,5912,2308,3604,2196883.53,3429510.83,5626394.36
411530,201803,111,75,36,71550,34344,105894
411535,201803,45,18,27,17172,25758,42930
411540,201803,347,242,105,229845.9,100170,330015.9
411545,201803,55,39,16,37206,15264,52470
411550,201803,75,58,17,55332,16218,71550
411560,201803,384,181,203,172010.38,193662,365672.38
411570,201803,785,298,487,283997,464408,748405
411573,201803,33,20,13,19080,12402,31482
411575,201803,264,163,101,155502,96354,251856
411580,201803,1243,489,754,465199.02,717468.4,1182667.42
411585,201803,80,40,40,38160,38160,76320
411590,201803,24,17,7,16218,6678,22896
411600,201803,26,10,16,9540,15264,24804
411605,201803,247,109,138,103735,131652,235387
411610,201803,239,161,78,153594,74412,228006
411620,201803,356,199,157,189655.2,149139,338794.2
411630,201803,58,38,20,36252,19080,55332
411640,201803,36,30,6,28620,5724,34344
411650,201803,12,9,3,8586,2862,11448
411660,201803,31,25,6,23850,5724,29574
411670,201803,247,188,59,179352,56286,235638
411680,201803,155,133,22,126882,20988,147870
411690,201803,606,321,285,305635.44,271547.84,577183.28
411695,201803,63,47,16,44838,15264,60102
411700,201803,164,142,22,135468,20988,156456
411705,201803,100,65,35,62010,33390,95400
411710,201803,299,201,98,190687.81,93492,284179.81
411720,201803,140,89,51,84906,48654,133560
411721,201803,58,48,10,45792,9540,55332
411722,201803,99,43,56,41022,53424,94446
411725,201803,147,113,34,107486,32436,139922
411727,201803,72,56,16,53424,14977.8,68401.8
411729,201803,32,25,7,23850,6678,30528
411730,201803,546,353,193,335171.96,183835.8,519007.76
411740,201803,30,19,11,18126,10494,28620
411745,201803,68,45,23,42139,21942,64081
411750,201803,871,412,459,391951.9,436908.15,828860.05
411760,201803,1178,891,287,848765.2,273789,1122554.2
411770,201803,439,291,148,277594.92,141192,418786.92
411780,201803,369,237,132,226098,125928,352026
411790,201803,530,299,231,283364.47,220261.14,503625.61
411800,201803,173,137,36,130698,34344,165042
411810,201803,166,128,38,122112,36252,158364
411820,201803,2094,1022,1072,972679.52,1021964.3,1994643.82
411830,201803,12,12,0,11448,0,11448
411840,201803,1965,1226,739,1167409.8,704513,1871922.8
411845,201803,49,18,31,17172,29574,46746
411850,201803,1242,713,529,678666.06,502713.02,1181379.08
411860,201803,44,28,16,26426,15264,41690
411870,201803,72,52,20,49608,18793.8,68401.8
411880,201803,426,274,152,261282,144263.88,405545.88
411885,201803,104,69,35,65826,33390,99216
411890,201803,320,205,115,194330.45,109700.46,304030.91
411900,201803,69,50,19,47700,18126,65826
411910,201803,170,140,30,133550.46,27780.48,161330.94
411915,201803,2114,910,1204,866987.57,1147552.05,2014539.62
411920,201803,126,104,22,99216,20988,120204
411925,201803,14,9,5,8586,4770,13356
411930,201803,797,588,209,559046,199386,758432
411940,201803,590,422,168,402111,160247.56,562358.56
411950,201803,905,481,424,458206.2,403828.2,862034.4
411960,201803,978,693,285,658219.49,271890,930109.49
411965,201803,23,15,8,14310,7632,21942
411970,201803,72,65,7,62010,6678,68688
411980,201803,199,130,69,124020,65826,189846
411990,201803,4939,2870,2069,2721038.57,1971841.28,4692879.85
411995,201803,460,172,288,164088,274752,438840
412000,201803,294,175,119,165758.56,113516.46,279275.02
412010,201803,46,29,17,27666,16218,43884
412015,201803,44,31,13,29574,12402,41976
412020,201803,27,25,2,23563.8,1908,25471.8
412030,201803,61,52,9,49608,8586,58194
412033,201803,55,36,19,34320,18126,52446
412035,201803,66,43,23,41022,21942,62964
412040,201803,36,25,11,23564,10494,34058
412050,201803,201,150,51,143100,48654,191754
412060,201803,747,586,161,556182.74,152603.8,708786.54
412065,201803,51,35,16,33390,15264,48654
412070,201803,154,103,51,97594.2,48654,146248.2
412080,201803,279,145,134,138330,127836,266166
412085,201803,33,16,17,15264,16218,31482
412090,201803,743,466,277,442895.2,264258,707153.2
412100,201803,249,209,40,198433,38160,236593
412110,201803,71,57,14,54378,13069.8,67447.8
412120,201803,312,204,108,194043.6,103032,297075.6
412125,201803,78,46,32,43597.8,30528,74125.8
412130,201803,47,35,12,33390,11448,44838
412135,201803,28,15,13,14310,12402,26712
412140,201803,308,219,89,208286.82,84906,293192.82
412150,201803,260,176,84,166950.04,80136,247086.04
412160,201803,83,48,35,45792,33390,79182
412170,201803,639,452,187,430921.8,178398,609319.8
412175,201803,39,29,10,27666,9540,37206
412180,201803,198,158,40,150132.61,37539.9,187672.51
412190,201803,329,264,65,251183.43,62010,313193.43
412200,201803,190,122,68,116388,64872,181260
412210,201803,72,56,16,53424,15264,68688
412215,201803,241,167,74,159032,70309.8,229341.8
412217,201803,71,55,16,52470,15264,67734
412220,201803,828,621,207,592434,197478,789912
412230,201803,337,205,132,193948.2,125891.46,319839.66
412240,201803,1322,647,675,613068,641869.44,1254937.44
412250,201803,381,247,134,235638,127836,363474
412260,201803,126,93,33,88722,31482,120204
412265,201803,167,133,34,126277.84,32436,158713.84
412270,201803,84,52,32,49608,30528,80136
412280,201803,90,71,19,67734,18126,85860
412290,201803,92,63,29,60102,27666,87768
412300,201803,216,139,77,132606,73314.9,205920.9
412310,201803,43,36,7,34344,6678,41022
412320,201803,94,80,14,76320,13356,89676
412330,201803,168,150,18,143100,17172,160272
412340,201803,144,100,44,95400,41690,137090
412350,201803,599,301,298,285866.3,284292,570158.3
412360,201803,27,24,3,22896,2862,25758
412370,201803,159,136,23,128790,21942,150732
412380,201803,255,193,62,183835.8,58738.5,242574.3
412382,201803,47,25,22,23850,20988,44838
412385,201803,139,100,39,95400,37206,132606
412390,201803,277,208,69,198432,65826,264258
412395,201803,66,52,14,49608,13356,62964
412400,201803,69,50,19,47700,18126,65826
412402,201803,245,114,131,108751.23,124687.8,233439.03
412405,201803,822,328,494,310214.23,470599.66,780813.89
412410,201803,935,587,348,558472,331992,890464
412420,201803,15,12,3,11448,2862,14310
412430,201803,21,14,7,13356,6678,20034
412440,201803,596,322,274,304875.94,259531.96,564407.90
412450,201803,84,70,14,66780,13356,80136
412460,201803,81,64,17,61056,16218,77274
412470,201803,260,206,54,195760.8,51516,247276.8
412480,201803,173,132,41,124974.9,39114,164088.9
412490,201803,166,140,26,133560,24804,158364
412500,201803,476,388,88,368291.8,83952,452243.8
412510,201803,186,152,34,144261,32436,176697
412520,201803,136,74,62,70596,59148,129744
412530,201803,108,58,50,55332,47413.8,102745.8
412535,201803,108,80,28,76302,26712,103014
412540,201803,63,31,32,29574,30528,60102
412545,201803,100,73,27,69642,25758,95400
412550,201803,3511,1578,1933,1501414.74,1841984.9,3343399.64
412555,201803,14,9,5,8586,4770,13356
412560,201803,590,443,147,420032.2,140238,560270.2
412570,201803,735,413,322,392151.24,306902,699053.24
412575,201803,81,56,25,53424,23850,77274
412580,201803,162,110,52,104940,49608,154548
412590,201803,34,32,2,30528,1908,32436
412600,201803,174,132,42,125928,40068,165996
412610,201803,31,19,12,18126,11448,29574
412620,201803,147,129,18,123066,17172,140238
412625,201803,2190,1178,1012,1121010.21,963570.59,2084580.80
412627,201803,68,55,13,52470,12402,64872
412630,201803,427,287,140,272265.2,133274,405539.2
412635,201803,64,19,45,18126,42930,61056
412640,201803,118,79,39,75366,37206,112572
412650,201803,343,214,129,203869.8,123061.23,326931.03
412660,201803,488,297,191,282623,182214,464837
412665,201803,51,45,6,42930,5724,48654
412667,201803,286,194,92,184191.81,87452.92,271644.73
412670,201803,61,52,9,49608,8586,58194
412680,201803,290,228,62,217512,59148,276660
412690,201803,115,74,41,70596,38828,109424
412700,201803,168,114,54,108756,51230,159986
412710,201803,1408,874,534,827788.6,507008,1334796.6
412720,201803,230,159,71,151686,67734,219420
412730,201803,205,162,43,154548,40068,194616
412740,201803,416,223,193,212598.9,184122,396720.9
412750,201803,463,267,196,253764,186984,440748
412760,201803,256,130,126,124020,120204,244224
412770,201803,2101,1192,909,1132784.94,865642.2,1998427.14
412780,201803,152,121,31,115434,29574,145008
412785,201803,269,135,134,128313,127836,256149
412788,201803,34,20,14,19080,13356,32436
412790,201803,142,116,26,109996.2,24804,134800.2
412795,201803,156,117,39,111618,37206,148824
412796,201803,301,209,92,198221.18,87634.44,285855.62
412800,201803,561,369,192,351466.39,183168,534634.39
412810,201803,2997,1664,1333,1581905.3,1270437.03,2852342.33
412820,201803,924,605,319,566618.74,303133.89,869752.63
412830,201803,16,13,3,12402,2862,15264
412840,201803,216,154,62,145962.2,59148,205110.2
412850,201803,782,535,247,508195.8,235638,743833.8
412853,201803,169,90,79,85860,75366,161226
412855,201803,212,117,95,110506.82,90630,201136.82
412860,201803,92,68,24,64872,22896,87768
412862,201803,59,44,15,41689.8,14310,55999.8
412863,201803,6,5,1,4770,954,5724
412865,201803,42,31,11,29574,10494,40068
412870,201803,108,72,36,68688,34344,103032
412880,201803,103,77,26,73458,24804,98262
420005,201803,35,32,3,30528,2290,32818
420010,201803,367,240,127,227772.34,121158,348930.34
420020,201803,76,64,12,61056,11448,72504
420030,201803,28,25,3,23850,2862,26712
420040,201803,105,80,25,76320,23850,100170
420050,201803,56,34,22,32436,20988,53424
420055,201803,20,19,1,18126,954,19080
420060,201803,32,23,9,21942,8586,30528
420070,201803,100,86,14,82044,13346.46,95390.46
420075,201803,13,11,2,10494,1908,12402
420080,201803,48,42,6,39161.7,5724,44885.7
420090,201803,35,33,2,30704.49,1908,32612.49
420100,201803,159,133,26,125928.2,24804,150732.2
420110,201803,18,18,0,17172,0,17172
420120,201803,45,34,11,32436,10494,42930
420125,201803,82,65,17,62010,16218,78228
420127,201803,35,31,4,29574,3816,33390
420130,201803,386,247,139,235342.46,132357.96,367700.42
420140,201803,1268,743,525,707497.38,500784,1208281.38
420150,201803,47,40,7,38160,6678,44838
420160,201803,39,37,2,35298,1908,37206
420165,201803,19,14,5,13356,4770,18126
420170,201803,63,41,22,39114,20988,60102
420180,201803,22,21,1,20034,954,20988
420190,201803,31,28,3,26712,2862,29574
420195,201803,126,60,66,57240,62824,120064
420200,201803,1270,567,703,536911.6,669338.04,1206249.64
420205,201803,69,36,33,34344,31482,65826
420207,201803,108,62,46,59148,43874.46,103022.46
420208,201803,23,18,5,17172,3911.4,21083.4
420209,201803,20,16,4,15264,3816,19080
420210,201803,464,220,244,209593.8,232681.14,442274.94
420213,201803,46,37,9,35298,8586,43884
420215,201803,26,22,4,20988,3816,24804
420220,201803,70,45,25,42930,23850,66780
420230,201803,748,429,319,408503,304030.46,712533.46
420240,201803,2280,1541,739,1462290.84,704567.16,2166858.00
420243,201803,36,29,7,27666,6678,34344
420245,201803,103,58,45,55332,42930,98262
420250,201803,54,31,23,29574,21942,51516
420253,201803,40,32,8,30528,7632,38160
420257,201803,11,9,2,8586,1908,10494
420260,201803,99,87,12,82998,11448,94446
420270,201803,37,30,7,28616,6678,35294
420280,201803,279,205,74,193846.06,69338.1,263184.16
420285,201803,20,12,8,11448,7632,19080
420287,201803,50,31,19,29574,18126,47700
420290,201803,974,685,289,652504.18,275638.3,928142.48
420300,201803,1381,1088,293,1033374.4,277328.34,1310702.74
420310,201803,59,45,14,42930,13356,56286
420315,201803,35,31,4,29574,3816,33390
420320,201803,848,430,418,409242.15,398768,808010.15
420325,201803,0,0,0,0,0,0
420330,201803,119,81,38,77274,36137.52,113411.52
420340,201803,156,107,49,101116,46726.92,147842.92
420350,201803,246,180,66,170099,62964,233063
420360,201803,752,574,178,545670.16,168191.78,713861.94
420370,201803,109,70,39,66590,36920,103510
420380,201803,1149,822,327,780364.5,310921.04,1091285.54
420390,201803,253,163,90,154243.52,85144.5,239388.02
420395,201803,185,133,52,126882,49598.46,176480.46
420400,201803,246,182,64,173056,61056,234112
420410,201803,57,44,13,41976,12402,54378
420415,201803,35,32,3,30528,2862,33390
420417,201803,47,35,12,33390,11428.92,44818.92
420419,201803,11,11,0,10494,0,10494
420420,201803,2789,1708,1081,1617444.28,1028700.42,2646144.70
420425,201803,71,60,11,57231,10180.26,67411.26
420430,201803,1274,885,389,841298.72,369360.18,1210658.90
420435,201803,16,14,2,13356,1908,15264
420440,201803,107,74,33,69968.68,31330.6,101299.28
420445,201803,22,20,2,19080,1908,20988
420450,201803,80,38,42,36243,40068,76311
420455,201803,249,189,60,180277.92,57148.38,237426.30
420460,201803,2341,1560,781,1483555.56,744849.9,2228405.46
420470,201803,120,85,35,81090,33390,114480
420475,201803,6,6,0,5724,0,5724
420480,201803,848,631,217,596518.12,206064.2,802582.32
420490,201803,113,88,25,83952,23850,107802
420500,201803,677,286,391,271159.2,373014,644173.2
420510,201803,20,17,3,16218,2862,19080
420515,201803,25,20,5,19080,4770,23850
420517,201803,12,12,0,11448,0,11448
420519,201803,0,0,0,0,0,0
420520,201803,66,49,17,46746,16218,62964
420530,201803,162,110,52,103965.02,49608,153573.02
420535,201803,20,18,2,17172,1908,19080
420540,201803,4815,2842,1973,2698881.28,1877606.98,4576488.26
420543,201803,23,23,0,21942,0,21942
420545,201803,194,138,56,130698,53404.92,184102.92
420550,201803,843,676,167,642959.32,159160.73,802120.05
420555,201803,41,29,12,27666,11448,39114
420560,201803,62,49,13,46364.4,12402,58766.4
420570,201803,142,79,63,75366,60092.46,135458.46
420580,201803,300,133,167,126882,159032,285914
420590,201803,509,359,150,342199.8,143100,485299.8
420600,201803,93,48,45,45792,42930,88722
420610,201803,37,35,2,33104,1908,35012
420620,201803,73,59,14,56286,13356,69642
420630,201803,152,111,41,105885.23,39110,144995.23
420640,201803,94,83,11,78991.2,10494,89485.2
420650,201803,241,129,112,122398.2,106229.23,228627.43
420660,201803,55,41,14,38350.8,13356,51706.8
420665,201803,38,29,9,27380,8586,35966
420670,201803,321,242,79,230142.96,75347.46,305490.42
420675,201803,15,14,1,13356,954,14310
420680,201803,36,26,10,24804,9540,34344
420690,201803,176,146,30,139284,28620,167904
420700,201803,626,429,197,409182.3,187705.44,596887.74
420710,201803,147,86,61,82044,57907.8,139951.8
420720,201803,107,87,20,82998,19080,102078
420730,201803,535,342,193,325210.5,182827.12,508037.62
420740,201803,45,44,1,41976,954,42930
420750,201803,494,330,164,314533.8,156456,470989.8
420757,201803,18,15,3,13499.1,2862,16361.1
420760,201803,38,29,9,27666,8586,36252
420765,201803,72,59,13,56286,12402,68688
420768,201803,67,59,8,56286,7632,63918
420770,201803,85,71,14,67734,13356,81090
420775,201803,49,46,3,42930,2862,45792
420780,201803,238,186,52,177434.46,49608,227042.46
420785,201803,14,10,4,9540,3816,13356
420790,201803,180,149,31,141805.8,28592.46,170398.26
420800,201803,78,59,19,55522.8,18126,73648.8
420810,201803,250,214,36,204147,33533.1,237680.1
420820,201803,2309,1379,930,1309212.66,885692.17,2194904.83
420830,201803,563,315,248,297561.83,235628.46,533190.29
420840,201803,144,109,35,103986,32686,136672
420845,201803,450,199,251,189175.07,238214,427389.07
420850,201803,230,183,47,174582,44838,219420
420860,201803,62,53,9,50562,8586,59148
420870,201803,120,87,33,82998,31482,114480
420880,201803,172,120,52,113802.66,49608,163410.66
420890,201803,862,426,436,404268.84,415649,819917.84
420895,201803,10,10,0,9540,0,9540
420900,201803,421,329,92,311807.04,87739.92,399546.96
420910,201803,5827,3266,2561,3105041.23,2438211.81,5543253.04
420915,201803,80,73,7,69642,6678,76320
420917,201803,18,13,5,12402,4770,17172
420920,201803,24,16,8,15264,7632,22896
420930,201803,2630,1600,1030,1517831.04,976731.42,2494562.46
420940,201803,599,438,161,416507.6,151942.08,568449.68
420945,201803,8,6,2,5724,1908,7632
420950,201803,55,50,5,47700,4770,52470
420960,201803,113,88,25,83914.92,23841,107755.92
420970,201803,303,242,61,229192.85,58166.46,287359.31
420980,201803,26,25,1,23850,954,24804
420985,201803,65,56,9,53424,8586,62010
420990,201803,67,52,15,49608,14310,63918
421000,201803,34,22,12,20988,11448,32436
421003,201803,68,44,24,41976,22887,64863
421005,201803,8,5,3,4770,2862,7632
421010,201803,771,543,228,516773,215452,732225
421020,201803,29,24,5,22896,4770,27666
421030,201803,130,110,20,104607,19080,123687
421040,201803,69,59,10,56286,9540,65826
421050,201803,306,221,85,208735.2,81090,289825.2
421055,201803,24,20,4,19080,3816,22896
421060,201803,82,56,26,53424,24804,78228
421070,201803,51,46,5,43884,4770,48654
421080,201803,36,32,4,30528,3816,34344
421085,201803,25,20,5,19080,4770,23850
421090,201803,42,32,10,30528,9540,40068
421100,201803,127,94,33,89676,31482,121158
421105,201803,218,177,41,168428.8,39090.69,207519.49
421110,201803,109,89,20,84285.9,19080,103365.9
421120,201803,151,118,33,112076.46,31462.92,143539.38
421125,201803,14,10,4,9540,3816,13356
421130,201803,806,519,287,493996.05,272758.54,766754.59
421140,201803,31,22,9,20272.5,8586,28858.5
421145,201803,39,31,8,29574,7632,37206
421150,201803,108,78,30,74412,28620,103032
421160,201803,61,40,21,38150.46,20034,58184.46
421165,201803,20,18,2,17172,1908,19080
421170,201803,192,166,26,157336.84,24795,182131.84
421175,201803,150,98,52,93492,49569.92,143061.92
421180,201803,56,35,21,33028,20034,53062
421185,201803,17,14,3,13356,2862,16218
421187,201803,0,0,0,0,0,0
421189,201803,38,30,8,28620,7622.46,36242.46
421190,201803,1500,924,576,880534,548807.58,1429341.58
421200,201803,88,66,22,62010.7,20988,82998.7
421205,201803,24,16,8,15264,7622.46,22886.46
421210,201803,179,121,58,115434,55332,170766
421220,201803,275,219,56,208059.9,53424,261483.9
421223,201803,55,46,9,43884,8586,52470
421225,201803,61,43,18,41022,17172,58194
421227,201803,95,72,23,68688,21942,90630
421230,201803,49,36,13,34344,12402,46746
421240,201803,18,18,0,17172,0,17172
421250,201803,357,221,136,209500,128952.18,338452.18
421260,201803,28,23,5,21942,4770,26712
421265,201803,0,0,0,0,0,0
421270,201803,52,46,6,43884,5724,49608
421280,201803,335,188,147,179066,138520.8,317586.8
421290,201803,319,213,106,202964,99713.76,302677.76
421300,201803,25,20,5,19080,4770,23850
421310,201803,54,41,13,38446.2,12402,50848.2
421315,201803,28,20,8,19080,7632,26712
421320,201803,131,94,37,89676,35298,124974
421330,201803,110,86,24,79639.92,22887,102526.92
421335,201803,40,26,14,24804,13356,38160
421340,201803,292,198,94,187128.05,89676,276804.05
421350,201803,178,104,74,98773,70596,169369
421360,201803,691,508,183,478989.72,174373.46,653363.18
421370,201803,190,145,45,138330,42596.1,180926.1
421380,201803,131,105,26,100165.23,24804,124969.23
421390,201803,19,15,4,14310,3816,18126
421400,201803,112,94,18,89676,17172,106848
421410,201803,23,18,5,17172,4770,21942
421415,201803,23,22,1,20988,954,21942
421420,201803,148,122,26,115815.6,24517.8,140333.4
421430,201803,14,11,3,10494,2862,13356
421440,201803,57,44,13,41976,12402,54378
421450,201803,98,85,13,81090,12402,93492
421460,201803,58,49,9,45941.77,8586,54527.77
421470,201803,69,45,24,42930,22896,65826
421480,201803,635,470,165,447903,157401,605304
421490,201803,22,21,1,19358,954,20312
421500,201803,515,331,184,314686.69,175248.9,489935.59
421505,201803,24,18,6,17172,5724,22896
421507,201803,33,27,6,25758,5724,31482
421510,201803,72,46,26,43884,24422.4,68306.4
421520,201803,66,57,9,53615,8586,62201
421530,201803,53,48,5,45792,4770,50562
421535,201803,28,27,1,25491,954,26445
421540,201803,60,52,8,49608,7632,57240
421545,201803,97,76,21,72018,20034,92052
421550,201803,286,208,78,197765,74412,272177
421555,201803,27,22,5,20988,4675,25663
421560,201803,8,7,1,6678,954,7632
421565,201803,123,90,33,85860,31482,117342
421567,201803,30,25,5,23850,4770,28620
421568,201803,34,32,2,30528,1908,32436
421569,201803,8,8,0,7632,0,7632
421570,201803,138,94,44,89676,41976,131652
421575,201803,27,22,5,20725.65,4770,25495.65
421580,201803,713,430,283,408884.35,269028.34,677912.69
421590,201803,20,19,1,18126,954,19080
421600,201803,109,75,34,71550,31197,102747
421605,201803,102,72,30,68355,28620,96975
421610,201803,187,148,39,139999.5,37206,177205.5
421620,201803,1106,661,445,628094.92,424510.92,1052605.84
421625,201803,21,18,3,17172,2862,20034
421630,201803,278,179,99,169955.8,93588,263543.8
421635,201803,16,8,8,7632,7632,15264
421640,201803,101,87,14,82998,13356,96354
421650,201803,276,161,115,153574.92,109690.92,263265.84
421660,201803,2095,1256,839,1195021.2,800092.26,1995113.46
421670,201803,181,129,52,123066,49608,172674
421680,201803,167,152,15,145008,14301,159309
421690,201803,353,243,110,230841,103976.58,334817.58
421700,201803,58,36,22,34344,20130,54474
421710,201803,24,24,0,22896,0,22896
421715,201803,11,10,1,9540,954,10494
421720,201803,588,426,162,403787.4,152821.26,556608.66
421725,201803,14,7,7,6678,6678,13356
421730,201803,44,30,14,27912.12,13356,41268.12
421740,201803,85,41,44,39114,41976,81090
421750,201803,218,161,57,151148.71,54378,205526.71
421755,201803,24,23,1,21942,954,22896
421760,201803,100,71,29,67724.46,27666,95390.46
421770,201803,566,381,185,361276.38,176433.3,537709.68
421775,201803,26,17,9,16218,8586,24804
421780,201803,195,153,42,145962,40068,186030
421790,201803,155,130,25,123127.5,23850,146977.5
421795,201803,17,14,3,13356,2862,16218
421800,201803,464,301,163,286357.31,155498,441855.31
421810,201803,67,54,13,51516,12402,63918
421820,201803,302,207,95,196810.2,90630,287440.2
421825,201803,126,105,21,100170,20034,120204
421830,201803,125,96,29,91584,27666,119250
421835,201803,3,3,0,2862,0,2862
421840,201803,61,51,10,48358.8,9540,57898.8
421850,201803,76,66,10,62964,9536,72500
421860,201803,40,32,8,30528,7632,38160
421870,201803,977,739,238,696104.64,226219.42,922324.06
421875,201803,52,46,6,43884,5724,49608
421880,201803,161,117,44,111618,41690,153308
421885,201803,28,23,5,21942,4770,26712
421890,201803,111,78,33,74412,31482,105894
421895,201803,39,36,3,34344,2862,37206
421900,201803,151,124,27,117935.3,25713,143648.3
421910,201803,64,42,22,40068,20988,61056
421915,201803,32,26,6,24804,5724,30528
421917,201803,38,28,10,26712,9540,36252
421920,201803,34,30,4,28620,3816,32436
421930,201803,743,575,168,546237.26,160245,706482.26
421935,201803,57,50,7,47700,6678,54378
421940,201803,39,37,2,35298,1908,37206
421950,201803,822,542,280,511149.1,264623.44,775772.54
421960,201803,39,35,4,33104,3816,36920
421970,201803,374,235,139,223691.12,132575.12,356266.24
421985,201803,30,20,10,19080,9540,28620
422000,201803,0,0,0,0,0,0
430003,201803,204,48,156,45076.5,148824,193900.5
430005,201803,36,28,8,26712,7632,34344
430010,201803,278,196,82,186507,78228,264735
430020,201803,151,98,53,93206,49608,142814
430030,201803,128,100,28,95113.8,26712,121825.8
430040,201803,2976,1731,1245,1643328.31,1186100.28,2829428.59
430045,201803,68,58,10,55046,9540,64586
430047,201803,6,5,1,4770,954,5724
430050,201803,81,68,13,64872,12402,77274
430055,201803,17,14,3,13356,2862,16218
430057,201803,4,2,2,1908,1908,3816
430060,201803,3679,2195,1484,2086786.72,1412238.58,3499025.30
430063,201803,57,52,5,49608,4770,54378
430064,201803,148,124,24,118296,22896,141192
430066,201803,10,7,3,6678,2862,9540
430070,201803,43,33,10,31482,9540,41022
430080,201803,68,47,21,44138.33,20034,64172.33
430085,201803,37,11,26,10494,24804,35298
430087,201803,33,25,8,23707,7632,31339
430090,201803,72,65,7,61723.8,6678,68401.8
430100,201803,118,78,40,73458,38160,111618
430105,201803,142,70,72,66780,68382.72,135162.72
430107,201803,20,15,5,14310,4770,19080
430110,201803,412,239,173,227195.1,164975.22,392170.32
430120,201803,137,125,12,118296.9,11448,129744.9
430130,201803,799,503,296,479241.9,282097.8,761339.7
430140,201803,124,114,10,108756,9540,118296
430150,201803,113,74,39,69833,36252,106085
430155,201803,33,30,3,28620,2862,31482
430160,201803,3815,2250,1565,2126067.92,1488936.62,3615004.54
430163,201803,329,146,183,138235.34,174524.76,312760.10
430165,201803,24,16,8,15264,7632,22896
430170,201803,82,74,8,70596,7632,78228
430175,201803,83,65,18,62010,16504.2,78514.2
430180,201803,100,80,20,76320,18459.9,94779.9
430185,201803,31,23,8,21942,7632,29574
430187,201803,102,43,59,41022,55980.8,97002.8
430190,201803,224,126,98,120156.3,92815.46,212971.76
430192,201803,15,14,1,13356,954,14310
430195,201803,13,8,5,7632,4770,12402
430200,201803,165,147,18,139570.2,17172,156742.2
430205,201803,20,19,1,18126,954,19080
430210,201803,630,489,141,462785.4,132653.9,595439.3
430215,201803,15,11,4,10494,3816,14310
430220,201803,65,45,20,42930,19080,62010
430222,201803,14,7,7,6678,6678,13356
430223,201803,15,8,7,7632,6678,14310
430225,201803,4,3,1,2862,954,3816
430230,201803,301,186,115,176490,109710,286200
430235,201803,53,39,14,37206,13346.46,50552.46
430237,201803,30,22,8,20988,7632,28620
430240,201803,131,84,47,79945.2,44838,124783.2
430245,201803,71,60,11,57240,10494,67734
430250,201803,191,109,82,103976.46,78218.46,182194.92
430258,201803,13,11,2,10494,1908,12402
430260,201803,35,30,5,28620,4760.46,33380.46
430265,201803,34,29,5,27646.92,4770,32416.92
430270,201803,558,413,145,390612.54,137473.02,528085.56
430280,201803,1035,629,406,596431.26,384824.6,981255.86
430290,201803,374,217,157,205110.8,149778,354888.8
430300,201803,2112,1171,941,1111345.12,894654.81,2005999.93
430310,201803,1964,1038,926,983204.4,880352.85,1863557.25
430320,201803,49,41,8,39099.69,7632,46731.69
430330,201803,99,89,10,84429,9520.92,93949.92
430340,201803,65,58,7,55332,6678,62010
430350,201803,1665,1154,511,1089440.38,484786.52,1574226.90
430355,201803,26,23,3,21942,2862,24804
430360,201803,79,39,40,37206,37873.8,75079.8
430367,201803,27,19,8,18126,7632,25758
430370,201803,53,46,7,43884,6678,50562
430380,201803,132,100,32,94827.6,30528,125355.6
430390,201803,618,384,234,366049.8,222931.46,588981.26
430400,201803,135,105,30,98452.8,28600.92,127053.72
430410,201803,60,47,13,44838,12402,57240
430420,201803,491,322,169,304708.8,158680.16,463388.96
430430,201803,55,52,3,48972.63,2862,51834.63
430435,201803,159,120,39,113526,36490.5,150016.5
430440,201803,495,329,166,313866,158173.2,472039.2
430450,201803,1200,990,210,937878.14,200330.46,1138208.60
430460,201803,5099,2787,2312,2643700.67,2201057.23,4844757.90
430461,201803,17,15,2,14310,1908,16218
430462,201803,10,7,3,6678,2862,9540
430463,201803,1029,545,484,517497.38,461374.56,978871.94
430465,201803,27,15,12,14310,11448,25758
430466,201803,660,479,181,455058.2,172483.2,627541.4
430467,201803,101,59,42,55045.8,40058.46,95104.26
430468,201803,110,69,41,65826,38862.91,104688.91
430469,201803,23,17,6,16218,5724,21942
430470,201803,1170,644,526,607610.39,499848.3,1107458.69
430471,201803,48,36,12,34324.92,11448,45772.92
430480,201803,92,56,36,52565.4,34334.46,86899.86
430485,201803,6,6,0,5438,0,5438
430490,201803,89,71,18,66923.7,17172,84095.7
430495,201803,38,29,9,27666,8586,36252
430500,201803,192,131,61,124974,57818.46,182792.46
430510,201803,3081,2050,1031,1950147.8,982687.32,2932835.12
430511,201803,18,18,0,17172,0,17172
430512,201803,136,94,42,89676,40068,129744
430513,201803,54,46,8,43407,7632,51039
430515,201803,32,30,2,28620,1908,30528
430517,201803,169,150,19,142146,18106.92,160252.92
430520,201803,365,250,115,237833,109681.38,347514.38
430530,201803,89,53,36,50562,34344,84906
430535,201803,476,318,158,303172.43,150708.15,453880.58
430537,201803,10,10,0,9540,0,9540
430540,201803,71,48,23,45792,21942,67734
430543,201803,374,116,258,110664,246132,356796
430544,201803,43,39,4,37206,3816,41022
430545,201803,347,164,183,156437,174085.92,330522.92
430550,201803,43,34,9,32436,8586,41022
430558,201803,6,4,2,3816,1908,5724
430560,201803,46,20,26,19080,24804,43884
430570,201803,108,47,61,44838,58136.76,102974.76
430580,201803,125,97,28,92538,26664.3,119202.3
430583,201803,14,14,0,13356,0,13356
430585,201803,9,4,5,3816,4770,8586
430587,201803,14,8,6,7632,5724,13356
430590,201803,154,126,28,118963.8,26712,145675.8
430593,201803,4,4,0,3816,0,3816
430595,201803,17,12,5,11448,4770,16218
430597,201803,51,27,24,25758,22896,48654
430600,201803,215,151,64,144044.46,60769.8,204814.26
430605,201803,160,100,60,95400,57230.46,152630.46
430607,201803,26,21,5,20034,4770,24804
430610,201803,1643,770,873,731443.3,827843.78,1559287.08
430613,201803,2,2,0,1908,0,1908
430620,201803,113,81,32,77130.9,30518.46,107649.36
430630,201803,45,41,4,39114,3816,42930
430632,201803,31,26,5,24804,4770,29574
430635,201803,40,36,4,34344,3816,38160
430637,201803,56,31,25,29574,23850,53424
430640,201803,207,114,93,107897.4,88722,196619.4
430642,201803,27,25,2,23850,1908,25758
430645,201803,33,29,4,27666,3816,31482
430650,201803,255,205,50,195284,47652.3,242936.3
430655,201803,3,3,0,2862,0,2862
430660,201803,970,474,496,450621.9,471657.8,922279.7
430670,201803,71,51,20,48654,19080,67734
430673,201803,75,42,33,40068,31482,71550
430675,201803,13,10,3,9540,2862,12402
430676,201803,486,299,187,284521.04,178327.07,462848.11
430680,201803,249,174,75,163802,71550,235352
430690,201803,525,307,218,291972.24,206316.14,498288.38
430692,201803,7,5,2,4770,1908,6678
430693,201803,144,96,48,91584,45782.46,137366.46
430695,201803,71,64,7,60121.08,6678,66799.08
430697,201803,59,35,24,33390,22896,56286
430700,201803,1590,1113,477,1048894.42,455058,1503952.42
430705,201803,20,19,1,18126,954,19080
430710,201803,258,167,91,159318,86814,246132
430720,201803,109,92,17,87577.2,16218,103795.2
430730,201803,121,102,19,96354,18126,114480
430740,201803,65,42,23,40068,21942,62010
430745,201803,36,29,7,27380,6678,34058
430750,201803,339,229,110,217522.64,103986,321508.64
430755,201803,82,46,36,43884,34344,78228
430760,201803,368,223,145,210071.72,138301.92,348373.64
430770,201803,1474,757,717,720060.82,679561.27,1399622.09
430780,201803,312,201,111,190772.72,105827.76,296600.48
430781,201803,29,23,6,21942,5724,27666
430783,201803,50,40,10,37842.13,9540,47382.13
430786,201803,6,3,3,2862,2862,5724
430790,201803,489,316,173,300192.12,164746.46,464938.58
430800,201803,152,126,26,120184.92,24804,144988.92
430805,201803,42,38,4,36252,3816,40068
430807,201803,35,21,14,20034,13356,33390
430810,201803,74,48,26,45792,24804,70596
430820,201803,136,84,52,80136,48940.2,129076.2
430825,201803,13,11,2,10494,1908,12402
430830,201803,233,219,14,208620.92,13356,221976.92
430840,201803,125,84,41,80136,38446.2,118582.2
430843,201803,5,3,2,2862,1908,4770
430845,201803,69,39,30,37206,28620,65826
430850,201803,570,392,178,372794.58,169680.68,542475.26
430860,201803,156,99,57,93778.2,53700.66,147478.86
430865,201803,63,32,31,29860.2,29259.18,59119.38
430870,201803,78,64,14,61056,13356,74412
430880,201803,159,118,41,112552.92,39114,151666.92
430885,201803,7,6,1,5724,954,6678
430890,201803,334,204,130,192956.04,124020,316976.04
430900,201803,541,372,169,350690.4,160739.46,511429.86
430905,201803,89,36,53,34344,50562,84906
430910,201803,264,147,117,140238,110942,251180
430912,201803,3,3,0,2862,0,2862
430915,201803,35,27,8,25758,7345.8,33103.8
430920,201803,4211,2353,1858,2238072.71,1770130.52,4008203.23
430925,201803,5,4,1,3567.96,954,4521.96
430930,201803,2090,1240,850,1175263.5,810653.43,1985916.93
430940,201803,245,151,94,143376.66,89656.92,233033.58
430950,201803,160,130,30,124020,28620,152640
430955,201803,22,14,8,13356,7632,20988
430957,201803,18,17,1,16218,954,17172
430960,201803,237,158,79,148299.3,75366,223665.3
430965,201803,103,64,39,61056,37206,98262
430970,201803,78,65,13,62010,11448,73458
430975,201803,34,32,2,30528,1908,32436
430980,201803,44,27,17,25758,16218,41976
430990,201803,113,87,26,82998,24804,107802
430995,201803,113,108,5,101791.8,4770,106561.8
431000,201803,294,135,159,126643.2,151686,278329.2
431010,201803,339,206,133,195541.38,126882,322423.38
431020,201803,1919,1113,806,1053516.21,764812.26,1818328.47
431030,201803,43,34,9,32436,8586,41022
431033,201803,392,194,198,184265.2,188892,373157.2
431036,201803,16,9,7,8586,6678,15264
431040,201803,130,78,52,73458,49498.29,122956.29
431041,201803,36,24,12,22896,11448,34344
431043,201803,46,27,19,25758,18126,43884
431046,201803,11,6,5,5724,4770,10494
431050,201803,206,132,74,124401.6,69594.3,193995.9
431053,201803,75,44,31,41212.8,29574,70786.8
431055,201803,63,42,21,40068,20014.92,60082.92
431057,201803,17,17,0,16218,0,16218
431060,201803,1679,1055,624,998954.66,593444.44,1592399.10
431065,201803,18,11,7,10494,6678,17172
431070,201803,72,67,5,63918,4770,68688
431075,201803,8,8,0,7632,0,7632
431080,201803,132,86,46,81757.8,43884,125641.8
431085,201803,30,27,3,25758,2862,28620
431087,201803,14,12,2,11448,1908,13356
431090,201803,55,43,12,41022,11448,52470
431100,201803,1228,729,499,684461.33,476046,1160507.33
431110,201803,243,152,91,145008,86804.46,231812.46
431112,201803,29,17,12,16218,11448,27666
431113,201803,30,20,10,19080,9540,28620
431115,201803,153,105,48,99533.87,45782.46,145316.33
431120,201803,618,363,255,344356.64,243193.84,587550.48
431123,201803,3,2,1,1908,954,2862
431125,201803,91,81,10,77274,9540,86814
431127,201803,7,3,4,2862,3816,6678
431130,201803,624,403,221,383221.8,210528.72,593750.52
431140,201803,731,495,236,468557.4,225067.68,693625.08
431142,201803,34,26,8,23592,7632,31224
431150,201803,205,152,53,145008,50552.46,195560.46
431160,201803,56,50,6,47700,5724,53424
431162,201803,19,14,5,13356,4770,18126
431164,201803,4,4,0,3816,0,3816
431170,201803,102,83,19,79182,18126,97308
431171,201803,52,29,23,27666,21932.46,49598.46
431173,201803,1,1,0,954,0,954
431175,201803,202,100,102,94160,97298.46,191458.46
431177,201803,75,57,18,54378,16485.92,70863.92
431179,201803,11,10,1,9540,954,10494
431180,201803,434,262,172,249948,164069.46,414017.46
431190,201803,86,65,21,62010,20034,82044
431198,201803,73,48,25,45792,23850,69642
431200,201803,20,17,3,16218,2862,19080
431205,201803,23,23,0,21942,0,21942
431210,201803,88,55,33,52137,31482,83619
431213,201803,28,23,5,21942,4770,26712
431215,201803,27,24,3,22896,2862,25758
431217,201803,5,4,1,3816,954,4770
431220,201803,67,57,10,54378,9540,63918
431225,201803,149,99,50,94437,47690.46,142127.46
431230,201803,99,87,12,82998,11448,94446
431235,201803,7,7,0,6678,0,6678
431237,201803,23,15,8,14310,7632,21942
431238,201803,14,10,4,9254,3816,13070
431240,201803,990,635,355,604130.64,338154.84,942285.48
431242,201803,36,36,0,34344,0,34344
431244,201803,11,8,3,7632,2862,10494
431245,201803,60,46,14,43884,13356,57240
431247,201803,14,11,3,10494,2862,13356
431250,201803,269,139,130,132539.22,123333.92,255873.14
431260,201803,62,45,17,42930,16218,59148
431261,201803,21,14,7,13356,6678,20034
431262,201803,15,15,0,14310,0,14310
431265,201803,162,86,76,82044,72504,154548
431267,201803,13,12,1,11448,954,12402
431270,201803,316,265,51,252810,48654,301464
431275,201803,41,39,2,37206,1908,39114
431280,201803,21,17,4,15383.25,3816,19199.25
431290,201803,21,18,3,17172,2862,20034
431295,201803,5,5,0,4770,0,4770
431300,201803,20,17,3,16218,2862,19080
431301,201803,7,7,0,6678,0,6678
431303,201803,51,34,17,32311.98,15931.8,48243.78
431306,201803,226,118,108,112115.98,103032,215147.98
431308,201803,7,5,2,4770,1908,6678
431310,201803,62,53,9,50562,8586,59148
431320,201803,119,69,50,65826,47404.26,113230.26
431330,201803,178,116,62,110664,59148,169812
431333,201803,33,27,6,25758,5724,31482
431335,201803,10,5,5,4770,4770,9540
431337,201803,325,152,173,144178.2,164002.34,308180.54
431339,201803,20,17,3,16218,2862,19080
431340,201803,3042,1754,1288,1669420.04,1225543.36,2894963.40
431342,201803,42,25,17,23850,16218,40068
431344,201803,19,18,1,17172,954,18126
431346,201803,4,4,0,3816,0,3816
431349,201803,36,33,3,31482,2862,34344
431350,201803,904,529,375,500117.66,356090.04,856207.70
431360,201803,44,38,6,36252,5724,41976
431365,201803,312,149,163,142126.92,154538.46,296665.38
431370,201803,1335,790,545,750025.93,519742.98,1269768.91
431380,201803,97,84,13,80136,12402,92538
431390,201803,496,275,221,261319.88,210290.22,471610.10
431395,201803,283,121,162,115434,154529,269963
431400,201803,39,30,9,28620,8586,37206
431402,201803,97,66,31,62964,29574,92538
431403,201803,19,11,8,10494,7632,18126
431405,201803,651,350,301,332260.02,286841,619101.02
431406,201803,32,28,4,26712,3816,30528
431407,201803,51,41,10,39114,9540,48654
431410,201803,3242,1930,1312,1827882.29,1248738.3,3076620.59
431413,201803,15,13,2,12402,1908,14310
431415,201803,71,52,19,49608,18126,67734
431417,201803,22,11,11,10494,10494,20988
431420,201803,303,214,89,203519.96,84906,288425.96
431430,201803,43,17,26,16218,24804,41022
431440,201803,8979,6399,2580,6034533.43,2452654.21,8487187.64
431442,201803,27,14,13,13356,12402,25758
431445,201803,26,20,6,19080,5724,24804
431446,201803,7,6,1,5724,954,6678
431447,201803,85,60,25,57240,23850,81090
431449,201803,52,45,7,42930,6678,49608
431450,201803,410,283,127,268932.6,120442.5,389375.1
431454,201803,0,0,0,0,0,0
431455,201803,49,39,10,37206,9540,46746
431460,201803,527,363,164,343535.4,156169.8,499705.2
431470,201803,116,91,25,86122.54,23600,109722.54
431475,201803,11,10,1,9540,954,10494
431477,201803,35,25,10,23850,9540,33390
431478,201803,8,7,1,6678,954,7632
431480,201803,500,318,182,301785.36,173580.3,475365.66
431490,201803,28163,16001,12162,15190888.56,11569397.85,26760286.41
431500,201803,78,52,26,49608,24804,74412
431505,201803,37,21,16,20034,15264,35298
431507,201803,11,9,2,8586,1908,10494
431510,201803,278,183,95,173866.8,89656.92,263523.72
431513,201803,22,17,5,16218,4770,20988
431514,201803,8,7,1,6678,954,7632
431515,201803,78,65,13,62010,12402,74412
431517,201803,4,2,2,1908,1908,3816
431520,201803,37,33,4,31482,3816,35298
431530,201803,1599,715,884,681060.84,842893.01,1523953.85
431531,201803,23,21,2,20034,1908,21942
431532,201803,25,17,8,16218,7632,23850
431535,201803,25,16,9,15264,8586,23850
431540,201803,138,123,15,116321.22,14310,130631.22
431545,201803,17,15,2,14310,1908,16218
431550,201803,351,205,146,195570,139188.6,334758.6
431555,201803,12,11,1,10494,954,11448
431560,201803,4473,3166,1307,2989134.72,1244608.38,4233743.10
431570,201803,784,415,369,392762.2,349155.46,741917.66
431575,201803,36,25,11,23850,10494,34344
431580,201803,96,68,28,63918,26712,90630
431590,201803,138,115,23,108756,21942,130698
431595,201803,12,11,1,10494,954,11448
431600,201803,217,125,92,119250,87768,207018
431610,201803,128,93,35,88054.2,33390,121444.2
431620,201803,42,34,8,32436,7632,40068
431630,201803,139,118,21,112572,20034,132606
431640,201803,1341,833,508,789486.06,483270.79,1272756.85
431642,201803,39,36,3,33867,2862,36729
431643,201803,45,20,25,19080,23850,42930
431645,201803,299,172,127,164088,120204,284292
431647,201803,11,11,0,10494,0,10494
431650,201803,36,27,9,25758,8586,34344
431660,201803,283,185,98,174582,93492,268074
431670,201803,218,104,114,96592.5,108727.38,205319.88
431673,201803,3,3,0,2862,0,2862
431675,201803,29,24,5,22609.8,4770,27379.8
431680,201803,1096,783,313,743166,297553.14,1040719.14
431690,201803,4767,2914,1853,2758504.03,1763843.76,4522347.79
431695,201803,26,20,6,19080,5724,24804
431697,201803,0,0,0,0,0,0
431700,201803,168,128,40,122112,38160,160272
431710,201803,4003,1726,2277,1643924,2171749.4,3815673.4
431720,201803,1387,823,564,777202.25,536802.26,1314004.51
431725,201803,1,1,0,954,0,954
431730,201803,1194,811,383,766999.1,365382,1132381.1
431740,201803,1370,683,687,646678.52,654847.58,1301526.10
431750,201803,1878,1217,661,1149788.3,628657.92,1778446.22
431755,201803,6,5,1,4770,954,5724
431760,201803,1076,685,391,653108.4,372785.58,1025893.98
431770,201803,395,288,107,274742.46,102058.92,376801.38
431775,201803,27,21,6,20034,5724,25758
431780,201803,561,346,215,328967.82,205100.46,534068.28
431790,201803,150,112,38,105894,36204.3,142098.3
431795,201803,14,12,2,11448,1908,13356
431800,201803,3383,1774,1609,1681013.42,1528086.94,3209100.36
431805,201803,16,15,1,14310,954,15264
431810,201803,618,414,204,392322.96,194482.98,586805.94
431820,201803,316,177,139,168858,131604.3,300462.3
431830,201803,2330,1408,922,1339694.66,878327.65,2218022.31
431840,201803,510,340,170,320736.4,160940,481676.4
431842,201803,34,28,6,26712,5724,32436
431843,201803,12,8,4,7632,3816,11448
431844,201803,15,13,2,12402,1908,14310
431845,201803,29,26,3,24804,2862,27666
431846,201803,28,24,4,22896,3816,26712
431848,201803,14,12,2,11448,1908,13356
431849,201803,8,6,2,5724,1908,7632
431850,201803,806,668,138,635759.51,131413.5,767173.01
431860,201803,101,72,29,68688,26712,95400
431861,201803,4,2,2,1908,1908,3816
431862,201803,52,34,18,32436,17172,49608
431870,201803,3468,2047,1421,1944437.96,1353378.96,3297816.92
431880,201803,941,691,250,654416,237546,891962
431890,201803,1303,806,497,763887.74,472531,1236418.74
431900,201803,187,130,57,124020,53586.18,177606.18
431910,201803,57,42,15,40068,14310,54378
431912,201803,35,19,16,18126,15264,33390
431915,201803,130,103,27,98262,25758,124020
431920,201803,145,107,38,101791.8,36252,138043.8
431930,201803,86,70,16,66780,15264,82044
431935,201803,4,3,1,2862,954,3816
431936,201803,12,11,1,10494,954,11448
431937,201803,17,12,5,11448,4770,16218
431940,201803,451,301,150,284387.4,143090.46,427477.86
431950,201803,473,302,171,286868.88,162982.98,449851.86
431960,201803,713,421,292,397448.02,278406.9,675854.92
431970,201803,72,63,9,60102,8586,68688
431971,201803,2,2,0,1908,0,1908
431973,201803,19,16,3,15264,2862,18126
431975,201803,7,6,1,5724,954,6678
431980,201803,199,125,74,117723.6,70596,188319.6
431990,201803,1227,652,575,620534.99,548504,1169038.99
432000,201803,1670,901,769,852174.44,730062.04,1582236.48
432010,201803,279,186,93,176330.96,88722,265052.96
432020,201803,170,135,35,128790,33380.46,162170.46
432023,201803,20,16,4,15264,3816,19080
432026,201803,65,57,8,54378,7632,62010
432030,201803,62,28,34,26712,32436,59148
432032,201803,22,19,3,18126,2862,20988
432035,201803,48,38,10,36252,9540,45792
432040,201803,102,69,33,65826,31482,97308
432045,201803,8,7,1,6678,954,7632
432050,201803,69,42,27,40068,25758,65826
432055,201803,99,73,26,69622.92,24804,94426.92
432057,201803,1,0,1,0,954,954
432060,201803,38,35,3,32674.5,2862,35536.5
432065,201803,30,28,2,26712,1908,28620
432067,201803,90,79,11,75346.92,10494,85840.92
432070,201803,403,303,100,287165.39,95371.92,382537.31
432080,201803,810,555,255,527771.88,243222.38,770994.26
432085,201803,16,12,4,11448,3816,15264
432090,201803,258,160,98,152640,93492,246132
432100,201803,179,119,60,113239.8,57240,170479.8
432110,201803,609,416,193,390329.84,183168,573497.84
432120,201803,956,577,379,549790.2,361527.84,911318.04
432130,201803,504,364,140,345920.4,132462.9,478383.3
432132,201803,26,22,4,20988,3816,24804
432135,201803,79,66,13,62964,12402,75366
432140,201803,264,209,55,199090.26,52470,251560.26
432143,201803,190,121,69,115434,65826,181260
432145,201803,272,189,83,178494.2,78895.8,257390.0
432146,201803,14,13,1,12402,954,13356
432147,201803,135,61,74,58194,70572.15,128766.15
432149,201803,17,12,5,11448,4770,16218
432150,201803,830,521,309,495831.96,292702.64,788534.60
432160,201803,1405,728,677,692214.4,644952.44,1337166.84
432162,201803,4,3,1,2862,954,3816
432163,201803,18,14,4,13356,3816,17172
432166,201803,123,92,31,88246,29574,117820
432170,201803,220,119,101,112573,96354,208927
432180,201803,520,317,203,299470.4,193376,492846.4
432183,201803,9,7,2,6678,1908,8586
432185,201803,83,72,11,68592.6,10494,79086.6
432190,201803,465,259,206,245932.46,196391.52,442323.98
432195,201803,85,74,11,69880.5,10494,80374.5
432200,201803,410,266,144,253764,137328.84,391092.84
432210,201803,119,76,43,70739.1,41022,111761.1
432215,201803,62,58,4,55332,3816,59148
432218,201803,19,18,1,17172,954,18126
432220,201803,682,345,337,328119.64,320990.74,649110.38
432225,201803,14,8,6,7155,5724,12879
432230,201803,143,86,57,81805.5,54378,136183.5
432232,201803,15,13,2,12402,1908,14310
432234,201803,4,3,1,2862,954,3816
432235,201803,1,1,0,954,0,954
432237,201803,29,17,12,16218,11448,27666
432240,201803,4194,2329,1865,2213033.52,1771827.38,3984860.90
432250,201803,1027,651,376,618431.96,358541.82,976973.78
432252,201803,39,32,7,29783.88,6678,36461.88
432253,201803,61,49,12,46746,11448,58194
432254,201803,22,10,12,9540,11448,20988
432255,201803,14,13,1,12402,954,13356
432260,201803,857,670,187,638121.26,177444.5,815565.76
432270,201803,223,164,59,156456,56286,212742
432280,201803,125,91,34,86337.8,32436,118773.8
432285,201803,2,1,1,954,954,1908
432290,201803,70,63,7,58480.2,6678,65158.2
432300,201803,4627,2637,1990,2500068.25,1894556.17,4394624.42
432310,201803,118,95,23,90630,21942,112572
432320,201803,20,15,5,14310,4770,19080
432330,201803,15,10,5,9540,4770,14310
432335,201803,7,6,1,5724,954,6678
432340,201803,40,37,3,35298,2862,38160
432345,201803,90,64,26,61056,24804,85860
432350,201803,24,23,1,21942,954,22896
432360,201803,6,4,2,3816,1908,5724
432370,201803,25,25,0,23850,0,23850
432375,201803,41,34,7,32436,6678,39114
432377,201803,7,7,0,6678,0,6678
432380,201803,169,75,94,70882.2,89628.3,160510.5
500020,201803,249,136,113,129744,107200.98,236944.98
500025,201803,119,58,61,54378,58194,112572
500060,201803,1390,848,542,808419.6,516462.61,1324882.21
500070,201803,765,364,401,346905,382544.46,729449.46
500080,201803,134,104,30,99216,28620,127836
500085,201803,140,114,26,108470,23969.25,132439.25
500090,201803,332,160,172,152640,164088,316728
500100,201803,695,371,324,351739.8,308524,660263.8
500110,201803,2249,1006,1243,959406.46,1185017.6,2144424.06
500124,201803,313,179,134,170766,127549.8,298315.8
500150,201803,327,130,197,124011,187578,311589
500190,201803,520,357,163,339910.2,155016,494926.2
500200,201803,201,172,29,163745,27666,191411
500210,201803,1459,522,937,496857.01,892734.99,1389592.00
500215,201803,242,139,103,131648.51,98262,229910.51
500220,201803,796,519,277,494881.84,263214.46,758096.30
500230,201803,254,174,80,165280.5,75843,241123.5
500240,201803,711,492,219,468604.8,208639.8,677244.6
500260,201803,569,213,356,203202,339624,542826
500270,201803,28310,12045,16265,11461675.73,15500313.05,26961988.78
500280,201803,193,73,120,69642,114480,184122
500290,201803,1203,708,495,674193,472221,1146414
500295,201803,412,252,160,240408,152630.46,393038.46
500310,201803,64,21,43,20034,41022,61056
500315,201803,693,413,280,393992.46,266824.26,660816.72
500320,201803,3636,1817,1819,1730991.38,1733679.02,3464670.40
500325,201803,938,521,417,496557,396843.44,893400.44
500330,201803,1496,687,809,653176.28,771162.64,1424338.92
500345,201803,324,239,85,227043.2,81090,308133.2
500348,201803,243,142,101,135468,96335.46,231803.46
500350,201803,141,68,73,64872,69642,134514
500370,201803,5418,2429,2989,2309738.1,2848982.24,5158720.34
500375,201803,350,254,96,242306.46,91584,333890.46
500380,201803,585,334,251,318478.59,239444.46,557923.05
500390,201803,72,36,36,34344,34344,68688
500400,201803,221,150,71,143080.92,67725,210805.92
500410,201803,570,222,348,211742.15,331844.22,543586.37
500430,201803,542,377,165,359658,157410,517068
500440,201803,203,106,97,100351.43,92538,192889.43
500450,201803,412,177,235,168152.8,223835.12,391987.92
500460,201803,309,156,153,148814.46,145962,294776.46
500470,201803,441,346,95,328869.67,89667,418536.67
500480,201803,115,69,46,65826,43884,109710
500490,201803,108,44,64,41971.23,61056,103027.23
500500,201803,1429,499,930,474023.59,886603.64,1360627.23
500510,201803,47,37,10,35298,9531,44829
500515,201803,110,77,33,73458,31196,104654
500520,201803,348,195,153,184981,145672,330653
500525,201803,88,50,38,47700,35965.8,83665.8
500540,201803,889,372,517,354535.76,492207.84,846743.60
500560,201803,887,504,383,479077.04,364690.88,843767.92
500568,201803,999,575,424,546642,404205.23,950847.23
500570,201803,1209,680,529,646004.24,502335.58,1148339.82
500580,201803,336,171,165,162838.26,157397,320235.26
500600,201803,312,156,156,148113.27,148806,296919.27
500620,201803,914,641,273,605736.67,260251.2,865987.87
500625,201803,81,69,12,65119.19,11448,76567.19
500627,201803,24,11,13,10494,12402,22896
500630,201803,1575,833,742,794005.46,707387.03,1501392.49
500635,201803,516,293,223,279102.24,212598.9,491701.14
500640,201803,427,225,202,212076,192689.46,404765.46
500660,201803,5489,2108,3381,2007312.5,3220649.32,5227961.82
500690,201803,574,202,372,192360.78,353208.71,545569.49
500710,201803,356,174,182,165710,173619,339329
500720,201803,972,569,403,541142.69,384252.92,925395.61
500730,201803,199,117,82,111618,78223.23,189841.23
500740,201803,851,371,480,352642.95,457473.75,810116.70
500750,201803,138,45,93,42930,88693.92,131623.92
500755,201803,121,87,34,82712,32436,115148
500769,201803,750,425,325,405128.04,310037,715165.04
500770,201803,440,230,210,219410.46,200330.46,419740.92
500780,201803,173,115,58,109710,55332,165042
500790,201803,1029,513,516,488825.23,491937.46,980762.69
500793,201803,254,137,117,130698,111609,242307
500795,201803,179,128,51,122102.46,48645,170747.46
500797,201803,38,30,8,28620,7632,36252
500800,201803,409,177,232,168849,221041.8,389890.8
500830,201803,2188,1221,967,1162421.92,921478.68,2083900.60
500840,201803,145,108,37,103032,35289,138321
510010,201803,165,92,73,87758.46,69642,157400.46
510020,201803,486,223,263,212448.6,250089.5,462538.1
510025,201803,1666,939,727,894945.13,690736.08,1585681.21
510030,201803,652,335,317,319543.92,301654.23,621198.15
510035,201803,126,58,68,55304.46,64853.46,120157.92
510040,201803,383,171,212,163134,201801.26,364935.26
510050,201803,426,233,193,221541.2,183317.46,404858.66
510060,201803,116,57,59,54368.46,56276.46,110644.92
510080,201803,221,88,133,83919.69,126768.6,210688.29
510100,201803,77,34,43,32436,41002.92,73438.92
510120,201803,37,22,15,20988,14310,35298
510125,201803,395,243,152,231139.89,144984.92,376124.81
510130,201803,580,335,245,319193.81,233315.64,552509.45
510140,201803,392,130,262,124011,249943.23,373954.23
510160,201803,89,40,49,38160,46742,84902
510170,201803,868,526,342,501529.05,325625.84,827154.89
510180,201803,2870,1395,1475,1327817.34,1405199.24,2733016.58
510185,201803,12,6,6,5724,5724,11448
510190,201803,210,71,139,67734,132601.23,200335.23
510250,201803,2617,1544,1073,1471926.07,1022519.18,2494445.25
510260,201803,202,146,56,139101.84,53387.46,192489.30
510263,201803,455,248,207,235610.46,196722.59,432333.05
510267,201803,654,364,290,346700.76,276389.45,623090.21
510268,201803,56,29,27,27666,25758,53424
510269,201803,67,29,38,27657,36252,63909
510270,201803,407,206,201,196345.98,191623.68,387969.66
510279,201803,231,171,60,163097.46,56934.92,220032.38
510285,201803,168,73,95,69623.46,90630,160253.46
510300,201803,547,294,253,280025.06,241287.84,521312.90
510305,201803,218,102,116,97285.46,110570.22,207855.68
510310,201803,112,57,55,54378,52460.46,106838.46
510320,201803,855,534,321,508858.64,305798.38,814657.02
510325,201803,418,169,249,161216.46,237250.26,398466.72
510330,201803,422,240,182,228947,173608.92,402555.92
510335,201803,593,321,272,306187.38,258841.98,565029.36
510336,201803,49,36,13,34344,12402,46746
510337,201803,120,49,71,46736.46,67724.46,114460.92
510340,201803,17427,8376,9051,7968186.26,8624568.21,16592754.47
510343,201803,72,50,22,47690.46,20988,68678.46
510345,201803,158,106,52,101114.46,49302.92,150417.38
510350,201803,665,370,295,352038.07,281365.38,633403.45
510360,201803,204,121,83,115425,79099.92,194524.92
510370,201803,138,72,66,68659.38,62832.6,131491.98
510380,201803,92,63,29,60102,27657,87759
510385,201803,57,27,30,25758,28611,54369
510390,201803,123,53,70,50562,66741.84,117303.84
510395,201803,39,28,11,26712,10494,37206
510410,201803,708,470,238,448376,227028.69,675404.69
510420,201803,591,290,301,275714.8,285715.45,561430.25
510450,201803,50,30,20,28620,19080,47700
510452,201803,41,23,18,21942,17172,39114
510454,201803,65,27,38,25758,36242.46,62000.46
510455,201803,126,81,45,77254.92,42930,120184.92
510460,201803,180,95,85,90163.72,81052.38,171216.10
510480,201803,746,424,322,403369.89,306840.36,710210.25
510490,201803,360,183,177,174202.8,168353.08,342555.88
510500,201803,256,191,65,182204.46,62010,244214.46
510510,201803,788,451,337,429368.06,321488.46,750856.52
510515,201803,1144,609,535,580617.38,510352.38,1090969.76
510517,201803,243,103,140,97975.8,133536.69,231512.49
510520,201803,234,152,82,144915.3,77908.3,222823.6
510523,201803,92,63,29,60102,27656.46,87758.46
510525,201803,728,409,319,389422.3,304215.3,693637.6
510530,201803,16,11,5,10494,4770,15264
510550,201803,273,120,153,114471,145953,260424
510558,201803,278,137,141,130665.15,134485.92,265151.07
510560,201803,385,239,146,228006,139266,367272
510562,201803,642,450,192,427969.17,182681.46,610650.63
510590,201803,817,426,391,406356.84,372995.69,779352.53
510600,201803,258,141,117,134490.92,111580.92,246071.84
510610,201803,169,82,87,78208.92,82702.46,160911.38
510615,201803,192,79,113,75346.92,107802,183148.92
510617,201803,17,10,7,9540,6678,16218
510618,201803,114,54,60,51516,56763,108279
510619,201803,106,73,33,69633,31473,101106
510620,201803,188,105,83,100160.46,79182,179342.46
510621,201803,198,126,72,120185.46,68660.46,188845.92
510622,201803,449,289,160,275613.84,152316.38,427930.22
510623,201803,359,241,118,229876.92,112543.38,342420.30
510624,201803,87,41,46,39105,43884,82989
510625,201803,534,326,208,310794.3,197835.52,508629.82
510626,201803,108,68,40,64872,38160,103032
510627,201803,58,43,15,41022,14310,55332
510628,201803,164,97,67,92491.92,63860.76,156352.68
510629,201803,254,162,92,154548,86804.46,241352.46
510630,201803,460,234,226,223151.22,215267.49,438418.71
510631,201803,11,3,8,2862,7346,10208
510637,201803,341,193,148,183776.18,141045.84,324822.02
510642,201803,977,545,432,519579.18,411994.98,931574.16
510645,201803,0,0,0,0,0,0
510650,201803,1505,990,515,944306.38,491198.76,1435505.14
510665,201803,85,43,42,40966,40068,81034
510670,201803,65,36,29,34344,27666,62010
510675,201803,1170,703,467,670631,445495.23,1116126.23
510677,201803,364,174,190,164990.84,180834.68,345825.52
510680,201803,108,63,45,60084,42921,103005
510682,201803,201,95,106,90308,101124,191432
510685,201803,52,37,15,35298,14310,49608
510700,201803,627,365,262,348091.92,249814.76,597906.68
510704,201803,1052,570,482,541445.7,458260.98,999706.68
510706,201803,126,61,65,58189.23,61972.92,120162.15
510710,201803,390,264,126,251658.06,120089.68,371747.74
510715,201803,64,47,17,44828.46,16218,61046.46
510718,201803,210,114,96,108662.76,91565.46,200228.22
510719,201803,36,19,17,18126,16218,34344
510720,201803,195,130,65,124011,61723.8,185734.8
510724,201803,88,37,51,35288.46,48621.38,83909.84
510726,201803,52,27,25,25748.46,23832,49580.46
510729,201803,76,36,40,34344,38121.84,72465.84
510730,201803,470,259,211,247068,201146.46,448214.46
510735,201803,111,44,67,41976,63918,105894
510740,201803,29,15,14,14310,13356,27666
510757,201803,19,15,4,14310,3816,18126
510760,201803,7046,3751,3295,3568820.29,3137144.23,6705964.52
510770,201803,724,346,378,329895.3,360417.3,690312.6
510774,201803,14,6,8,5724,7632,13356
510775,201803,111,84,27,80126.46,25748.46,105874.92
510776,201803,30,7,23,6678,21942,28620
510777,201803,187,83,104,79153.38,99187.38,178340.76
510779,201803,53,24,29,22887,27628.92,50515.92
510780,201803,295,163,132,155439.46,125844,281283.46
510785,201803,445,241,204,229857.3,194549.22,424406.52
510787,201803,189,97,92,92529,87750.23,180279.23
510788,201803,0,0,0,0,0,0
510790,201803,2383,1244,1139,1184757.4,1084468.5,2269225.9
510792,201803,1090,611,479,581475.24,456541.34,1038016.58
510794,201803,115,58,57,55332,54349.92,109681.92
510795,201803,2397,1392,1005,1320356.47,955820.6,2276177.07
510800,201803,181,109,72,103976.46,68679,172655.46
510805,201803,170,118,52,112572,49608,162180
510810,201803,94,39,55,37123.38,52346.52,89469.90
510820,201803,260,122,138,115961.46,130652.03,246613.49
510830,201803,66,40,26,38160,24795,62955
510835,201803,7,5,2,4770,1908,6678
510840,201803,9300,4597,4703,4370750.03,4479164.45,8849914.48
510850,201803,207,86,121,82034.46,115110.18,197144.64
510860,201803,385,168,217,160085.52,206327.8,366413.32
510880,201803,63,48,15,45773.46,14310,60083.46
510885,201803,72,44,28,41957.46,26683.38,68640.84
510890,201803,73,42,31,40068,29574,69642
510895,201803,189,108,81,103032,76965.46,179997.46
520005,201803,34,23,11,21942,10494,32436
520010,201803,279,126,153,120204,145867,266071
520013,201803,632,375,257,357722,244891.8,602613.8
520015,201803,51,37,14,35298,13356,48654
520017,201803,103,60,43,56954,41022,97976
520020,201803,27,13,14,12402,13356,25758
520025,201803,2004,1086,918,1034861.24,874904.4,1909765.64
520030,201803,797,408,389,388269,369531.9,757800.9
520050,201803,78,52,26,49608,24804,74412
520055,201803,44,30,14,28620,13356,41976
520060,201803,177,115,62,109710,59148,168858
520080,201803,591,412,179,393048,170766,563814
520082,201803,20,14,6,13356,5724,19080
520085,201803,99,72,27,68688,25758,94446
520090,201803,90,63,27,60102,25758,85860
520110,201803,8982,3893,5089,3708862.16,4851222.98,8560085.14
520120,201803,14,8,6,7431.66,5724,13155.66
520130,201803,754,531,223,506278.8,212733,719011.8
520140,201803,11739,6611,5128,6299735.85,4889464.23,11189200.08
520145,201803,43,32,11,30528,10494,41022
520150,201803,191,149,42,142146,40068,182214
520160,201803,30,22,8,20988,7632,28620
520170,201803,231,143,88,136390,83915,220305
520180,201803,114,61,53,58194,50562,108756
520215,201803,213,131,82,124687.8,77941.8,202629.6
520235,201803,70,53,17,50562,16218,66780
520250,201803,137,82,55,78228,52183.8,130411.8
520260,201803,111,69,42,65826,39114,104940
520280,201803,46,33,13,30815,12402,43217
520310,201803,38,26,12,24804,11448,36252
520320,201803,164,106,58,101114.46,55332,156446.46
520330,201803,781,410,371,391094.46,353907,745001.46
520340,201803,353,202,151,192708,144035.46,336743.46
520350,201803,524,239,285,228006,271843,499849
520355,201803,89,51,38,48654,36252,84906
520357,201803,25,18,7,17172,6678,23850
520360,201803,0,0,0,0,0,0
520380,201803,136,71,65,67734,62010,129744
520390,201803,286,118,168,112095,160009.5,272104.5
520393,201803,13,10,3,9540,2862,12402
520396,201803,97,57,40,54378,38160,92538
520400,201803,225,132,93,124307.2,88722,213029.2
520410,201803,202,103,99,98253,94437,192690
520420,201803,22,15,7,14310,6678,20988
520425,201803,297,127,170,120205,161704.2,281909.2
520430,201803,454,235,219,223903.8,208870,432773.8
520440,201803,613,414,199,394956,189846,584802
520450,201803,1913,866,1047,825049.46,998191.98,1823241.44
520455,201803,57,40,17,38160,16218,54378
520460,201803,31,16,15,15264,14310,29574
520465,201803,23,19,4,18126,3816,21942
520470,201803,412,255,157,242964.63,149778,392742.63
520480,201803,82,47,35,44838,33345,78183
520485,201803,126,42,84,40068,79850,119918
520490,201803,401,297,104,283153.98,99051.92,382205.90
520495,201803,175,106,69,101124,65826,166950
520500,201803,175,132,43,125928,41022,166950
520505,201803,177,92,85,87763.23,81090,168853.23
520510,201803,1777,874,903,830496.74,859464.42,1689961.16
520520,201803,37,28,9,26712,8586,35298
520530,201803,230,171,59,160742.32,55486.54,216228.86
520540,201803,529,355,174,337363.02,165996,503359.02
520545,201803,163,89,74,84906,70596,155502
520547,201803,54,30,24,28620,22896,51516
520549,201803,1114,541,573,515790,546311,1062101
520551,201803,292,150,142,143100,135468,278568
520552,201803,45,27,18,25758,17172,42930
520570,201803,16,9,7,8586,6678,15264
520580,201803,285,171,114,163115.46,108756,271871.46
520590,201803,162,96,66,91584,62677.8,154261.8
520620,201803,1153,539,614,513348.48,585174.26,1098522.74
520630,201803,44,26,18,24804,17172,41976
520640,201803,413,235,178,224190,169812,394002
520650,201803,53,38,15,36252,14310,50562
520660,201803,35,19,16,18126,15264,33390
520670,201803,33,28,5,26712,4770,31482
520680,201803,58,38,20,36252,19080,55332
520690,201803,33,10,23,9540,21913.92,31453.92
520710,201803,38,34,4,32436,3816,36252
520725,201803,194,124,70,118296,66780,185076
520735,201803,59,41,18,39114,17172,56286
520740,201803,405,203,202,192947.4,192699,385646.4
520750,201803,37,27,10,25758,9540,35298
520753,201803,55,37,18,35298,17172,52470
520760,201803,109,74,35,70596,33390,103986
520780,201803,288,219,69,208926,65826,274752
520790,201803,164,81,83,76987.8,79182,156169.8
520800,201803,3450,1833,1617,1745999.06,1541940.9,3287939.96
520810,201803,164,115,49,109710,46746,156456
520815,201803,5,5,0,4770,0,4770
520830,201803,139,91,48,86814,45505.8,132319.8
520840,201803,349,228,121,217035,115434,332469
520850,201803,110,71,39,67725,37053.36,104778.36
520860,201803,1687,1067,620,1016497.54,590336.2,1606833.74
520870,201803,30737,15138,15599,14414137.79,14866926.2,29281063.99
520880,201803,1064,587,477,559998,455038.92,1015036.92
520890,201803,795,458,337,435301.4,321393.46,756694.86
520910,201803,1034,547,487,518261.74,464598,982859.74
520915,201803,100,76,24,72504,22886.46,95390.46
520920,201803,406,197,209,187365.6,199376.46,386742.06
520929,201803,19,17,2,16218,1908,18126
520940,201803,73,46,27,43884,25758,69642
520945,201803,21,13,8,12402,7632,20034
520960,201803,46,30,16,28620,15264,43884
520970,201803,329,206,123,195895,117055.8,312950.8
520980,201803,89,65,24,62010,22896,84906
520990,201803,474,317,157,302418,149778,452196
520993,201803,128,61,67,58194,63909,122103
520995,201803,242,135,107,127837,101506,229343
521000,201803,1543,898,645,854689.4,615235,1469924.4
521010,201803,670,307,363,292551.36,346236.3,638787.66
521015,201803,17,10,7,9540,6678,16218
521020,201803,1464,1018,446,970542.9,425113.22,1395656.12
521030,201803,47,33,14,31482,13356,44838
521040,201803,942,576,366,549266.2,348878,898144.2
521056,201803,40,28,12,26712,11448,38160
521060,201803,130,80,50,76320,47700,124020
521080,201803,469,350,119,333605,113526,447131
521090,201803,534,322,212,305947.8,202248,508195.8
521100,201803,289,213,76,203193,72504,275697
521120,201803,1046,717,329,682435.38,313571,996006.38
521130,201803,361,257,104,245168.46,98330.6,343499.06
521140,201803,189,109,80,103986,76320,180306
521150,201803,2802,1214,1588,1157146.88,1513393.49,2670540.37
521160,201803,33,17,16,16218,15264,31482
521170,201803,195,114,81,108746.46,77274,186020.46
521180,201803,1129,714,415,679525.26,395195.2,1074720.46
521190,201803,2551,1080,1471,1030300.92,1402456.72,2432757.64
521200,201803,46,34,12,32436,11448,43884
521205,201803,16,12,4,11448,3816,15264
521210,201803,148,84,64,80136,61056,141192
521220,201803,819,556,263,527791.76,250846,778637.76
521225,201803,28,17,11,16218,10494,26712
521230,201803,112,74,38,70309.8,36252,106561.8
521250,201803,6793,3754,3039,3574876.12,2896613.26,6471489.38
521260,201803,21,14,7,13356,6678,20034
521270,201803,143,111,32,105894,30528,136422
521280,201803,437,258,179,245464.2,170766,416230.2
521290,201803,31,13,18,12402,17172,29574
521295,201803,100,68,32,64643.04,30528,95171.04
521300,201803,231,119,112,113508,106488.38,219996.38
521305,201803,36,24,12,22896,11448,34344
521308,201803,1080,786,294,748454.74,280181,1028635.74
521310,201803,1350,800,550,761915.4,523508.92,1285424.32
521340,201803,20,16,4,15264,3816,19080
521350,201803,131,96,35,91584,33390,124974
521370,201803,188,119,69,112572,65539.8,178111.8
521375,201803,189,106,83,101124,78895.8,180019.8
521377,201803,51,34,17,32436,16218,48654
521380,201803,1080,698,382,661744.22,364428,1026172.22
521385,201803,15,8,7,7632,6678,14310
521390,201803,106,87,19,82680.04,18126,100806.04
521400,201803,323,205,118,195283.8,112524.3,307808.1
521405,201803,150,78,72,74412,68688,143100
521410,201803,65,43,22,41022,20988,62010
521440,201803,210,146,64,138473.1,61056,199529.1
521450,201803,721,397,324,378738,309096,687834
521460,201803,1187,728,459,694225.8,437866.92,1132092.72
521470,201803,14,9,5,8586,4770,13356
521480,201803,47,32,15,30519,14245,44764
521483,201803,307,165,142,157124,135468,292592
521486,201803,284,181,103,172549.98,97595,270144.98
521487,201803,23,11,12,10494,11448,21942
521490,201803,28,16,12,15264,11448,26712
521500,201803,117,76,41,72504,39114,111618
521520,201803,42,31,11,29574,10494,40068
521523,201803,595,365,230,345983.78,219420,565403.78
521525,201803,45,30,15,28620,14023.8,42643.8
521530,201803,251,134,117,127836,111618,239454
521540,201803,31,16,15,15264,14310,29574
521550,201803,91,43,48,40707.92,45736.92,86444.84
521560,201803,801,546,255,520598,243127,763725
521565,201803,50,33,17,31482,16218,47700
521570,201803,495,332,163,316718.46,155407.3,472125.76
521580,201803,61,38,23,36252,21942,58194
521590,201803,36,19,17,18126,16218,34344
521600,201803,30,18,12,17172,11448,28620
521630,201803,238,117,121,111608.46,114443.96,226052.42
521640,201803,301,154,147,146916,140238,287154
521645,201803,31,17,14,16218,13356,29574
521680,201803,221,140,81,133560,77274,210834
521690,201803,3,2,1,1908,954,2862
521710,201803,1196,561,635,534350.8,605781,1140131.8
521720,201803,536,359,177,342476.46,168820.46,511296.92
521730,201803,624,302,322,288108,306081.56,594189.56
521740,201803,925,375,550,357721.92,523509.32,881231.24
521760,201803,1594,866,728,824586.63,694198,1518784.63
521770,201803,803,511,292,487494,278100.54,765594.54
521800,201803,2081,1295,786,1231888.56,749420.1,1981308.66
521805,201803,32,18,14,17172,13356,30528
521810,201803,92,58,34,54187.8,32436,86623.8
521830,201803,950,670,280,636986.22,267111,904097.22
521839,201803,94,62,32,59148,30528,89676
521850,201803,1115,591,524,562394.92,499562.68,1061957.60
521860,201803,346,212,134,202248,127550,329798
521870,201803,73,42,31,40068,29574,69642
521878,201803,42,20,22,19080,20988,40068
521880,201803,4503,2026,2477,1930513.36,2361221.9,4291735.26
521890,201803,571,395,176,376830,167617.8,544447.8
521900,201803,293,237,56,225461.96,53424,278885.96
521910,201803,154,108,46,103032,43884,146916
521920,201803,55,27,28,25758,26712,52470
521925,201803,36,21,15,20034,14310,34344
521930,201803,1114,634,480,604639.98,457276.88,1061916.86
521935,201803,34,26,8,24804,7632,32436
521940,201803,191,96,95,91584,90625.23,182209.23
521945,201803,14,12,2,11448,1908,13356
521950,201803,9,5,4,4770,3816,8586
521960,201803,73,54,19,51516,18126,69642
521970,201803,425,272,153,259201.8,145962,405163.8
521971,201803,97,48,49,45792,46746,92538
521973,201803,29,13,16,12402,15264,27666
521975,201803,1128,585,543,557137,517106.66,1074243.66
521980,201803,239,164,75,156456,71550,228006
521990,201803,72,54,18,51516,17172,68688
522000,201803,288,178,110,169812,104940,274752
522005,201803,21,13,8,12402,7632,20034
522010,201803,1130,633,497,603873,473565.6,1077438.6
522015,201803,54,33,21,31473,20034,51507
522020,201803,860,463,397,440748.2,377956.12,818704.32
522026,201803,30,22,8,20988,7632,28620
522028,201803,16,12,4,11448,3816,15264
522040,201803,748,298,450,284178,429245.46,713423.46
522045,201803,2090,1318,772,1256050.06,735954.8,1992004.86
522050,201803,166,81,85,77274,81090,158364
522060,201803,561,354,207,337429.8,197382.6,534812.4
522068,201803,138,90,48,85573.8,45792,131365.8
522070,201803,10,10,0,9540,0,9540
522100,201803,47,26,21,24536.88,20034,44570.88
522108,201803,40,30,10,28620,9540,38160
522119,201803,55,28,27,26712,25758,52470
522130,201803,76,29,47,27666,44820,72486
522140,201803,3703,1880,1823,1789033.28,1736977.9,3526011.18
522145,201803,51,30,21,28620,20034,48654
522150,201803,65,51,14,48654,13356,62010
522155,201803,58,41,17,39105,16218,55323
522157,201803,4,3,1,2862,954,3816
522160,201803,1720,1004,716,956671.2,682768.8,1639440.0
522170,201803,394,264,130,251856,124020,375876
522180,201803,36,20,16,19080,15264,34344
522185,201803,1305,543,762,515001.26,726427,1241428.26
522190,201803,48,27,21,25758,19938.6,45696.6
522200,201803,302,182,120,173628,114480,288108
522205,201803,164,110,54,104940,51516,156456
522220,201803,164,117,47,111618,44838,156456
522230,201803,30,24,6,22896,5724,28620
530010,201803,55583,28538,27045,27089897.65,25748736.71,52838634.36
110001,201804,519,410,109,390156.35,103340.96,493497.31
110002,201804,2795,1690,1105,1610380.19,1053263.49,2663643.68
110003,201804,96,76,20,72504,19080,91584
110004,201804,2016,1295,721,1232529.02,687538.26,1920067.28
110005,201804,446,358,88,340376.9,83952,424328.9
110006,201804,451,347,104,330751.8,99196.92,429948.72
110007,201804,82,65,17,62010,16218,78228
110008,201804,236,135,101,127554.9,96354,223908.9
110009,201804,796,541,255,514101.2,243071,757172.2
110010,201804,1801,1116,685,1063431,653348.52,1716779.52
110011,201804,1885,1451,434,1382743.2,414006.35,1796749.55
110012,201804,4113,2398,1715,2281255.19,1634838.46,3916093.65
110013,201804,750,571,179,544724.46,170766,715490.46
110014,201804,370,317,53,302397.89,50562,352959.89
110015,201804,1434,1155,279,1099442.71,265574.52,1365017.23
110018,201804,1117,664,453,633142,432149.23,1065291.23
110020,201804,15383,9044,6339,8583685.78,6035318.15,14619003.93
110025,201804,652,478,174,454014.11,165987,620001.11
110026,201804,41,28,13,26712,12402,39114
110028,201804,1650,1197,453,1137150.92,428568.95,1565719.87
110029,201804,142,126,16,120204,15264,135468
110030,201804,2477,1662,815,1582655.36,776609.46,2359264.82
110032,201804,394,307,87,292569,82994,375563
110033,201804,674,510,164,483537,156452,639989
110034,201804,361,267,94,252406,89009,341415
110037,201804,104,85,19,81090,18126,99216
110040,201804,340,229,111,218466,105894,324360
110045,201804,947,633,314,602336,297852.39,900188.39
110050,201804,95,78,17,74412,16218,90630
110060,201804,87,46,41,43884,39114,82998
110070,201804,125,75,50,71550,47414,118964
110080,201804,403,244,159,230553.18,151642.04,382195.22
110090,201804,33,27,6,25758,5724,31482
110092,201804,112,64,48,61056,45722,106778
110094,201804,199,139,60,132606,57240,189846
110100,201804,28,23,5,21942,4770,26712
110110,201804,69,42,27,40068,25758,65826
110120,201804,73,60,13,57240,12402,69642
110130,201804,301,243,58,230347.12,55332,285679.12
110140,201804,240,154,86,146725.2,82034.46,228759.66
110143,201804,49,41,8,39114,7632,46746
110145,201804,28,20,8,19080,7632,26712
110146,201804,23,12,11,11448,10494,21942
110147,201804,39,30,9,28620,8586,37206
110148,201804,39,27,12,25706.57,11448,37154.57
110149,201804,293,211,82,201007.8,78228,279235.8
110150,201804,85,58,27,55332,25758,81090
110155,201804,8,7,1,6678,954,7632
110160,201804,70,59,11,56286,10494,66780
110170,201804,208,169,39,161226,37206,198432
110175,201804,39,28,11,26712,10494,37206
110180,201804,92,80,12,76320,11448,87768
120001,201804,136,93,43,88680,40993,129673
120005,201804,191,119,72,113483.12,68688,182171.12
120010,201804,1037,667,370,629172.46,350747.16,979919.62
120013,201804,140,98,42,92784.06,39724.04,132508.10
120017,201804,93,57,36,54269.48,34301.12,88570.60
120020,201804,3536,2819,717,2660856.41,681365.67,3342222.08
120025,201804,596,337,259,318960.22,246004.6,564964.82
120030,201804,1020,856,164,808487.7,155698.12,964185.82
120032,201804,49,41,8,39092.12,7632,46724.12
120033,201804,215,188,27,179004.75,25758,204762.75
120034,201804,156,113,43,105872.12,40978.24,146850.36
120035,201804,29,20,9,19080,8586,27666
120038,201804,389,247,142,234792,135424.24,370216.24
120039,201804,23,21,2,20034,1908,21942
120040,201804,14047,9734,4313,9154236.77,4076125.31,13230362.08
120042,201804,43,37,6,35298,5724,41022
120043,201804,12,3,9,2862,8586,11448
120045,201804,538,348,190,329911.38,180994.6,510905.98
120050,201804,1264,962,302,912196.28,288017.47,1200213.75
120060,201804,1423,1155,268,1085601.45,251930.56,1337532.01
120070,201804,505,363,142,340000.44,134126.54,474126.98
120080,201804,165,106,59,99916.3,55719.3,155635.6
130002,201804,148,103,45,98262,42930,141192
130006,201804,75,43,32,41022,30528,71550
130008,201804,144,77,67,72737.72,63195.96,135933.68
130010,201804,137,73,64,69642,61056,130698
130014,201804,237,173,64,165042,61056,226098
130020,201804,88,48,40,45792,38160,83952
130030,201804,899,549,350,523746,333890.46,857636.46
130040,201804,328,164,164,156456,155502.28,311958.28
130050,201804,554,306,248,291637.8,236592,528229.8
130060,201804,885,601,284,568205.2,268137.12,836342.32
130063,201804,565,307,258,292878,246110.12,538988.12
130068,201804,188,122,66,116388,62677.8,179065.8
130070,201804,1328,922,406,866110.76,382403,1248513.76
130080,201804,668,435,233,414608.4,222273,636881.4
130083,201804,71,38,33,35701.8,31482,67183.8
130090,201804,376,193,183,182442.96,174582,357024.96
130100,201804,1104,515,589,491310,561619.8,1052929.8
130110,201804,703,316,387,301314,369198,670512
130115,201804,175,71,104,67734,99216,166950
130120,201804,1625,1011,614,964494,585756,1550250
130130,201804,617,423,194,403542,185076,588618
130140,201804,1523,1144,379,1090713.02,360612.2,1451325.22
130150,201804,423,360,63,343418.12,60102,403520.12
130160,201804,468,263,205,250902,195570,446472
130165,201804,23,16,7,15264,6678,21942
130170,201804,937,667,270,636247.4,257580,893827.4
130180,201804,152,92,60,87291,57240,144531
130185,201804,2284,1204,1080,1146687.89,1029728.92,2176416.81
130190,201804,3618,2257,1361,2148950.68,1297091.99,3446042.67
130195,201804,291,233,58,222282,55332,277614
130200,201804,177,81,96,77264.46,91584,168848.46
130210,201804,78,39,39,37206,37206,74412
130220,201804,183,127,56,121158,53424,174582
130230,201804,334,211,123,201294,117342,318636
130240,201804,1448,916,532,872524.4,506950.83,1379475.23
130250,201804,4721,3047,1674,2901373.18,1596862.57,4498235.75
130255,201804,421,206,215,196524,204823.8,401347.8
130260,201804,53536,25674,27862,24459382.82,26573640.3,51033023.12
130270,201804,1511,969,542,923758.07,517068,1440826.07
130280,201804,113,68,45,64872,42930,107802
130290,201804,2080,1509,571,1439586,544447.8,1984033.8
130300,201804,426,307,119,292591.8,113526,406117.8
130310,201804,883,462,421,440748,401634,842382
130320,201804,448,235,213,223236,203202,426438
130330,201804,704,426,278,406404,264925.8,671329.8
130340,201804,3276,1970,1306,1874801.2,1244493.2,3119294.4
130350,201804,464,297,167,283316.12,159318,442634.12
130353,201804,792,327,465,311672,443610,755282
130356,201804,777,352,425,335808,405163.8,740971.8
130360,201804,68,41,27,39114,25758,64872
130370,201804,677,504,173,480816,165042,645858
130380,201804,627,430,197,410220,187938,598158
130390,201804,484,389,95,371106,90630,461736
130395,201804,183,42,141,40068,134514,174582
130400,201804,72,47,25,44838,23850,68688
130406,201804,2066,1298,768,1234678.3,731461.76,1966140.06
130410,201804,501,214,287,204156,273778.92,477934.92
130420,201804,3192,2564,628,2442269.5,599112,3041381.5
130423,201804,162,76,86,72504,82044,154548
130426,201804,141,83,58,79182,55332,134514
130430,201804,406,268,138,255672,131652,387324
130440,201804,198,69,129,65826,123066,188892
140002,201804,36,14,22,13356,20988,34344
140005,201804,211,128,83,121873.5,79182,201055.5
140010,201804,10274,6937,3337,6580257.19,3180824.63,9761081.82
140015,201804,155,68,87,64872,82998,147870
140017,201804,115,78,37,74412,35298,109710
140020,201804,475,317,158,301464,150732,452196
140023,201804,31,18,13,16953,12402,29355
140028,201804,17,12,5,11448,4770,16218
140030,201804,358,256,102,244224,96706.98,340930.98
140040,201804,54,38,16,36252,15168.6,51420.6
140045,201804,246,115,131,109042.2,124974,234016.2
140047,201804,564,386,178,366232.39,169049,535281.39
140050,201804,148,97,51,91725,48654,140379
140060,201804,35,24,11,22161.42,10494,32655.42
140070,201804,31,28,3,26712,2862,29574
150010,201804,4737,2938,1799,2800944.4,1713746.29,4514690.69
150013,201804,150,106,44,101124,41976,143100
150020,201804,1067,569,498,542826,475092,1017918
150030,201804,726,297,429,283338,409266,692604
150034,201804,196,123,73,117342,69642,186984
150040,201804,1394,831,563,792774,537102,1329876
150050,201804,702,420,282,399678.8,268828,668506.8
150060,201804,4724,3068,1656,2922923.37,1579576.5,4502499.87
150070,201804,315,146,169,139284,161226,300510
150080,201804,14489,7290,7199,6942934.93,6860241.94,13803176.87
150085,201804,387,243,144,231812.46,137376,369188.46
150090,201804,764,650,114,620100,108756,728856
150095,201804,347,212,135,201478.12,127969.56,329447.68
150100,201804,56,40,16,38160,15264,53424
150110,201804,173,83,90,79182,85860,165042
150120,201804,433,320,113,305280,107802,413082
150125,201804,54,23,31,21942,29574,51516
150130,201804,1898,1015,883,968310,842377.23,1810687.23
150140,201804,54487,25404,29083,24202597.04,27730813.22,51933410.26
150145,201804,180,106,74,101124,70596,171720
150150,201804,2813,1259,1554,1200868.49,1478823.63,2679692.12
150157,201804,439,303,136,289062,129739.23,418801.23
150160,201804,125,101,24,96354,22896,119250
150170,201804,3671,2719,952,2591970.3,907921.8,3499892.1
150172,201804,322,221,101,210834,96354,307188
150175,201804,88,54,34,51516,32436,83952
150178,201804,770,518,252,493218,240408,733626
150180,201804,3065,1481,1584,1412063.6,1510535.18,2922598.78
150190,201804,332,213,119,203202,113526,316728
150195,201804,123,61,62,58194,59148,117342
150200,201804,205,96,109,91584,103986,195570
150210,201804,3183,2577,606,2457399.86,577881.5,3035281.36
150215,201804,513,334,179,318636,170480,489116
150220,201804,3898,2636,1262,2513184.8,1201830.32,3715015.12
150230,201804,1146,923,223,879962.04,212742,1092704.04
150240,201804,5806,3420,2386,3259503.73,2275949,5535452.73
150250,201804,34,16,18,15264,17172,32436
150260,201804,74,45,29,42930,27666,70596
150270,201804,2351,1543,808,1470730.32,769973.8,2240704.12
150275,201804,577,352,225,335808,214650,550458
150276,201804,109,46,63,43884,60102,103986
150277,201804,763,326,437,310985.46,416898,727883.46
150280,201804,339,209,130,199386,124020,323406
150285,201804,74,37,37,35298,35298,70596
150290,201804,975,597,378,569242.26,360326,929568.26
150293,201804,673,311,362,296494.46,345348,641842.46
150295,201804,479,216,263,206064,250749.44,456813.44
150300,201804,79,41,38,39114,36252,75366
150304,201804,143,97,46,92538,43884,136422
150307,201804,393,323,70,308142,66780,374922
150309,201804,559,407,152,388278,145008,533286
150310,201804,256,173,83,165042,79182,244224
150320,201804,1802,1246,556,1188402.57,530424,1718826.57
150330,201804,2064,1188,876,1132684.2,835704,1968388.2
150340,201804,201,136,65,129505.5,62010,191515.5
150345,201804,606,329,277,313684.74,264258,577942.74
150350,201804,416,325,91,307655.46,86814,394469.46
150360,201804,4539,2892,1647,2755300.19,1571228.46,4326528.65
150370,201804,755,535,220,509594,209584.8,719178.8
150375,201804,198,104,94,99216,89676,188892
150380,201804,1333,889,444,848106,423290,1271396
150390,201804,742,423,319,403538,304326,707864
150400,201804,99,82,17,78228,16218,94446
150405,201804,1246,824,422,784824.48,402015.6,1186840.08
150410,201804,136,89,47,84886.92,44838,129724.92
150420,201804,7441,4064,3377,3875397.28,3219986.2,7095383.48
150430,201804,498,334,164,318636,156456,475092
150440,201804,587,349,238,332183,227052,559235
150442,201804,2159,1160,999,1103387,952469.03,2055856.03
150445,201804,526,332,194,316728,184122,500850
150450,201804,264,124,140,118296,133560,251856
150460,201804,765,580,185,551493.09,176470.92,727964.01
150470,201804,1340,809,531,770259.8,506574,1276833.8
150475,201804,41,31,10,29574,9540,39114
150480,201804,1244,867,377,827118,359371.8,1186489.8
150490,201804,612,335,277,319590,264258,583848
150495,201804,329,232,97,221328,92538,313866
150497,201804,299,205,94,195570,89666.46,285236.46
150500,201804,427,287,140,273798,133560,407358
150503,201804,882,426,456,406118,434945,841063
150506,201804,1030,674,356,642996,339614.46,982610.46
150510,201804,1239,695,544,662744,518976,1181720
150520,201804,275,184,91,175536,86814,262350
150530,201804,1575,851,724,808706.3,689455.8,1498162.1
150540,201804,240,167,73,159318,69642,228960
150543,201804,720,409,311,389594.52,296407.8,686002.32
150548,201804,505,349,156,332946,148824,481770
150549,201804,63,43,20,41022,19080,60102
150550,201804,2887,1516,1371,1445311,1307648,2752959
150553,201804,3079,1815,1264,1730937.8,1205846.46,2936784.26
150555,201804,144,76,68,72504,64872,137376
150560,201804,51,39,12,37206,11448,48654
150563,201804,74,40,34,38160,32436,70596
150565,201804,169,100,69,95400,65826,161226
150570,201804,400,265,135,252790.92,128790,381580.92
150580,201804,1521,647,874,616570.2,833796,1450366.2
150590,201804,775,475,300,453150,286200,739350
150600,201804,462,278,184,265212,175536,440748
150610,201804,145,124,21,117447,20034,137481
150611,201804,128,89,39,84906,37206,122112
150613,201804,3215,1976,1239,1885104,1181997,3067101
150616,201804,487,297,190,283100,181260,464360
150618,201804,1168,636,532,606515.58,507528,1114043.58
150619,201804,394,301,93,287154,88722,375876
150620,201804,1284,744,540,709776,514873.8,1224649.8
150630,201804,307,206,101,196524,96354,292878
150635,201804,484,197,287,187938,273798,461736
150640,201804,61,29,32,27666,30528,58194
150650,201804,2331,1373,958,1309804.34,913641.03,2223445.37
150655,201804,246,183,63,174582,60102,234684
150658,201804,106,62,44,59148,41976,101124
150660,201804,488,344,144,328176,137376,465552
150670,201804,1006,365,641,347914.8,611495.46,959410.26
150680,201804,9912,5409,4503,5153014.86,4293526.58,9446541.44
150690,201804,51,32,19,30528,18126,48654
150700,201804,534,344,190,327985.2,181260,509245.2
150710,201804,280,167,113,159318,107802,267120
150715,201804,870,527,343,501775.92,327193.38,828969.30
150720,201804,438,338,100,322452,95113.8,417565.8
150730,201804,932,496,436,473175,415657.8,888832.8
150740,201804,228,161,67,153594,63918,217512
150745,201804,781,423,358,403542,341532,745074
150746,201804,57,34,23,32436,21942,54378
150747,201804,264,206,58,196524,55332,251856
150750,201804,131,76,55,72504,52470,124974
150760,201804,1718,1116,602,1064664,574308,1638972
150770,201804,371,192,179,183168,170590.95,353758.95
150775,201804,95,44,51,41976,48654,90630
150780,201804,186,99,87,94446,82998,177444
150790,201804,882,476,406,454104,387324,841428
150795,201804,1454,847,607,808038,579078,1387116
150796,201804,399,230,169,219420,161019.84,380439.84
150797,201804,288,163,125,155502,119250,274752
150800,201804,1414,854,560,813757.23,534240,1347997.23
150803,201804,596,493,103,470322,98262,568584
150805,201804,188,120,68,114480,64858.46,179338.46
150808,201804,993,547,446,521838,425484,947322
150810,201804,3407,2356,1051,2244181,1001796,3245977
150812,201804,423,221,202,210834,192708,403542
150815,201804,966,635,331,604411.47,315774,920185.47
150820,201804,1573,961,612,915840,583828.92,1499668.92
150830,201804,831,585,246,557136,234684,791820
150835,201804,186,111,75,105894,71550,177444
150840,201804,1344,860,484,820440,461736,1282176
160005,201804,52,30,22,28620,20988,49608
160010,201804,193,120,73,114480,69638,184118
160015,201804,115,65,50,62010,47700,109710
160020,201804,127,72,55,68688,52470,121158
160021,201804,41,21,20,20034,19080,39114
160023,201804,110,64,46,61056,43884,104940
160025,201804,32,14,18,13356,17172,30528
160027,201804,1461,828,633,787145.9,603128,1390273.9
160030,201804,15492,7969,7523,7594619.36,7172203.29,14766822.65
160040,201804,315,181,134,172674,127836,300510
160050,201804,671,340,331,324360,315487.8,639847.8
160053,201804,323,182,141,173342,134514,307856
160055,201804,26,19,7,18126,6678,24804
160060,201804,6405,3362,3043,3197604.8,2902064.2,6099669.0
160070,201804,162,99,63,94446,60102,154548
160080,201804,79,42,37,40068,35298,75366
170025,201804,23,15,8,14310,7632,21942
170030,201804,227,185,42,176293,40068,216361
170035,201804,226,110,116,104940,110664,215604
170040,201804,191,148,43,140905.8,41022,181927.8
170070,201804,322,193,129,184122,123066,307188
170100,201804,370,268,102,255672,97308,352980
170105,201804,62,51,11,48654,10494,59148
170110,201804,103,63,40,60102,38160,98262
170130,201804,69,32,37,30528,35012,65540
170190,201804,105,67,38,63918,36252,100170
170200,201804,392,262,130,249271.2,123915.76,373186.96
170210,201804,6025,3148,2877,2995096.54,2741396.86,5736493.40
170215,201804,96,45,51,42930,48654,91584
170220,201804,1418,1041,377,991873.8,359372,1351245.8
170230,201804,154,100,54,95400,51516,146916
170240,201804,540,355,185,338670,176490,515160
170255,201804,1107,887,220,845988.12,209593.8,1055581.92
170270,201804,37,28,9,26712,8395.2,35107.2
170290,201804,80,59,21,56286,20034,76320
170300,201804,82,54,28,50752.8,26712,77464.8
170305,201804,45,34,11,32436,10494,42930
170307,201804,65,48,17,45792,16218,62010
170310,201804,103,56,47,53424,44838,98262
170320,201804,17,14,3,13356,2862,16218
170330,201804,21,19,2,18126,1908,20034
170360,201804,24,14,10,13356,9540,22896
170370,201804,123,64,59,61056,56286,117342
170380,201804,79,57,22,54378,20988,75366
170382,201804,46,41,5,39114,4770,43884
170384,201804,130,95,35,90630,33390,124020
170386,201804,61,27,34,25758,32436,58194
170388,201804,48,18,30,17172,28620,45792
170389,201804,23,18,5,17172,4770,21942
170390,201804,54,30,24,28620,22896,51516
170410,201804,35,24,11,22896,10494,33390
170460,201804,16,12,4,11448,3816,15264
170510,201804,29,22,7,20988,6678,27666
170550,201804,1489,844,645,805176,614567,1419743
170555,201804,114,79,35,75366,33390,108756
170560,201804,98,71,27,67734,25758,93492
170600,201804,40,19,21,18126,20034,38160
170610,201804,191,102,89,97150.59,84888,182038.59
170625,201804,38,20,18,19080,17172,36252
170650,201804,85,64,21,61056,20034,81090
170700,201804,557,423,134,402302.3,127836,530138.3
170710,201804,157,97,60,92538,57231,149769
170720,201804,86,70,16,66780,15264,82044
170730,201804,60,36,24,34344,22896,57240
170740,201804,77,57,20,54378,19080,73458
170755,201804,70,37,33,34678,31482,66160
170765,201804,142,69,73,65206,69642,134848
170770,201804,223,130,93,122922.9,88722,211644.9
170820,201804,596,389,207,371106,197049,568155
170825,201804,31,20,11,19080,10494,29574
170830,201804,77,57,20,54187.2,19080,73267.2
170900,201804,201,152,49,145008,46746,191754
170930,201804,824,430,394,409896,375304,785200
170950,201804,3046,1325,1721,1263078.26,1638572.51,2901650.77
170980,201804,18,10,8,9540,7632,17172
171050,201804,132,102,30,97308,28620,125928
171070,201804,38,31,7,29574,6678,36252
171090,201804,39,29,10,27666,9540,37206
171110,201804,21,14,7,13356,6678,20034
171150,201804,38,18,20,17172,19080,36252
171180,201804,21,10,11,9540,10494,20034
171190,201804,138,81,57,77274,54378,131652
171195,201804,65,50,15,47700,14310,62010
171200,201804,47,20,27,19080,25758,44838
171215,201804,3,3,0,2862,0,2862
171240,201804,54,44,10,41976,9540,51516
171245,201804,53,48,5,45792,4770,50562
171250,201804,72,38,34,36252,32426.46,68678.46
171270,201804,17,13,4,12402,3816,16218
171280,201804,38,35,3,33247,2862,36109
171320,201804,994,562,432,536148,411174,947322
171330,201804,424,204,220,194616,209880,404496
171360,201804,88,64,24,61056,22896,83952
171370,201804,24,13,11,12402,10494,22896
171380,201804,135,110,25,104940,23850,128790
171395,201804,54,33,21,31482,20034,51516
171420,201804,306,202,104,192708,98929.8,291637.8
171430,201804,65,52,13,49608,12402,62010
171488,201804,204,108,96,103032,91584,194616
171500,201804,59,32,27,30528,25758,56286
171510,201804,68,45,23,42930,21942,64872
171515,201804,43,37,6,35298,5724,41022
171525,201804,31,26,5,24804,4770,29574
171550,201804,13,7,6,6678,5724,12402
171570,201804,62,30,32,28620,30528,59148
171575,201804,342,211,131,201294,124964.46,326258.46
171610,201804,1704,854,850,812817.53,809342.12,1622159.65
171620,201804,131,92,39,87214.68,37206,124420.68
171630,201804,50,27,23,25758,21942,47700
171650,201804,274,181,93,172674,88722,261396
171660,201804,265,140,125,133560,119246,252806
171665,201804,48,32,16,30528,15264,45792
171670,201804,429,251,178,236535.26,169239.6,405774.86
171700,201804,63,55,8,52470,7632,60102
171720,201804,25,8,17,7632,16218,23850
171750,201804,102,54,48,51516,45792,97308
171780,201804,74,60,14,57240,13356,70596
171790,201804,78,65,13,62010,12402,74412
171800,201804,35,27,8,25758,7632,33390
171820,201804,2069,1165,904,1109669.64,857808.82,1967478.46
171830,201804,37,29,8,27666,7632,35298
171840,201804,63,36,27,34344,25758,60102
171845,201804,31,20,11,19080,10494,29574
171850,201804,40,29,11,27666,10494,38160
171855,201804,78,61,17,58194,16218,74412
171865,201804,8,7,1,6678,954,7632
171870,201804,30,21,9,20034,8586,28620
171875,201804,78,53,25,50562,23850,74412
171880,201804,29,21,8,20034,7632,27666
171884,201804,47,24,23,22896,21942,44838
171886,201804,118,41,77,39114,73171.8,112285.8
171888,201804,24,18,6,17172,5724,22896
171889,201804,19,15,4,14310,3816,18126
171890,201804,56,46,10,43884,9540,53424
171900,201804,42,29,13,27666,12402,40068
172000,201804,39,33,6,31482,5724,37206
172010,201804,42,35,7,32579.1,6678,39257.1
172015,201804,27,17,10,16218,9253.8,25471.8
172020,201804,130,82,48,78228,45792,124020
172025,201804,32,21,11,20034,10494,30528
172030,201804,36,20,16,19080,15264,34344
172049,201804,75,44,31,41976,29574,71550
172065,201804,147,96,51,91534,48654,140188
172080,201804,94,66,28,61781.84,26712,88493.84
172085,201804,25,12,13,11448,12402,23850
172090,201804,403,308,95,293832,89867,383699
172093,201804,24,18,6,17172,5724,22896
172097,201804,17,8,9,7632,8300,15932
172100,201804,4714,2647,2067,2520039.8,1969449,4489488.8
172110,201804,81,54,27,51516,25758,77274
172120,201804,1717,1469,248,1395309.65,236208.5,1631518.15
172125,201804,4,4,0,3816,0,3816
172130,201804,17,13,4,12402,3816,16218
172208,201804,194,124,70,118296,66780,185076
172210,201804,428,207,221,197478,210548,408026
210005,201804,2933,1829,1104,1741813.22,1050356,2792169.22
210010,201804,190,98,92,93492,87768,181260
210015,201804,29,19,10,18126,9540,27666
210020,201804,348,179,169,170766,161226,331992
210030,201804,346,217,129,207018,123057,330075
210040,201804,154,119,35,113526,33390,146916
210043,201804,255,171,84,163134,80136,243270
210047,201804,605,315,290,300128.4,276650.46,576778.86
210050,201804,297,217,80,207018,76320,283338
210055,201804,42,32,10,30528,9540,40068
210060,201804,567,444,123,423368.23,117342,540710.23
210070,201804,411,301,110,287154,104940,392094
210080,201804,103,95,8,90630,7632,98262
210083,201804,307,131,176,124974,167904,292878
210087,201804,43,31,12,29574,11448,41022
210090,201804,493,341,152,325314,145008,470322
210095,201804,491,355,136,338660.46,129744,468404.46
210100,201804,688,523,165,498608.1,156456.02,655064.12
210110,201804,149,81,68,77274,64872,142146
210120,201804,5461,4100,1361,3904480.2,1297140.68,5201620.88
210125,201804,218,124,94,118296,89676,207972
210130,201804,551,287,264,272844,251836.92,524680.92
210135,201804,35,21,14,20034,13356,33390
210140,201804,4365,3425,940,3263970.51,896522,4160492.51
210150,201804,358,227,131,216558,124974,341532
210160,201804,3371,2833,538,2699822.78,512966,3212788.78
210170,201804,1133,883,250,842382,238500,1080882
210173,201804,121,100,21,95400,20034,115434
210177,201804,464,226,238,215604,227052,442656
210180,201804,32,18,14,17172,13356,30528
210190,201804,415,264,151,251856,144054,395910
210193,201804,1,1,0,954,0,954
210197,201804,83,54,29,51516,27647.88,79163.88
210200,201804,636,502,134,478908,127836,606744
210203,201804,262,175,87,166950,82998,249948
210207,201804,383,297,86,283338,82044,365382
210210,201804,775,704,71,671616,67734,739350
210215,201804,78,66,12,62964,11448,74412
210220,201804,394,323,71,308142,67447.8,375589.8
210230,201804,305,230,75,219420,71550,290970
210232,201804,1474,933,541,889796,516114,1405910
210235,201804,156,122,34,116198,32436,148634
210237,201804,46,25,21,23850,20034,43884
210240,201804,94,77,17,73458,16218,89676
210250,201804,186,149,37,142146,35298,177444
210255,201804,346,255,91,243270,86814,330084
210260,201804,416,263,153,250902,145962,396864
210270,201804,695,441,254,420714,242316,663030
210275,201804,45,35,10,33390,9540,42930
210280,201804,1038,661,377,627779.33,358322.5,986101.83
210290,201804,506,328,178,312912,169812,482724
210300,201804,6095,3547,2548,3378629.27,2429600.23,5808229.50
210310,201804,104,71,33,67734,31482,99216
210312,201804,128,81,47,77274,44838,122112
210315,201804,116,85,31,81090,29574,110664
210317,201804,125,88,37,83952,35298,119250
210320,201804,2393,1970,423,1877669.84,403542,2281211.84
210325,201804,131,88,43,82998,40736,123734
210330,201804,5522,2830,2692,2694997.63,2568158.46,5263156.09
210340,201804,1394,999,395,952246,376759.07,1329005.07
210350,201804,615,502,113,478669.5,107802,586471.5
210355,201804,134,107,27,102078,25758,127836
210360,201804,2642,1655,987,1575723.6,941312,2517035.6
210370,201804,1248,544,704,518976,670948.2,1189924.2
210375,201804,183,96,87,91041,82998,174039
210380,201804,728,542,186,517068,177444,694512
210390,201804,203,166,37,158364,35298,193662
210400,201804,417,350,67,333900,63899,397799
210405,201804,1015,677,338,645858,322452,968310
210407,201804,56,44,12,41976,11448,53424
210408,201804,66,59,7,56286,6678,62964
210409,201804,317,264,53,251856,50562,302418
210410,201804,440,341,99,325314,94437,419751
210420,201804,194,159,35,151686,33390,185076
210430,201804,38,28,10,26712,9540,36252
210440,201804,376,227,149,216558,142146,358704
210450,201804,145,107,38,102078,36252,138330
210455,201804,225,124,101,118296,96354,214650
210460,201804,347,219,128,208926,122112,331038
210462,201804,62,52,10,49608,9540,59148
210465,201804,173,125,48,119250,45792,165042
210467,201804,525,378,147,360612,140238,500850
210470,201804,46,34,12,32436,11448,43884
210480,201804,1311,923,388,880542,370152,1250694
210490,201804,220,130,90,124020,85860,209880
210500,201804,572,300,272,286200,259488,545688
210510,201804,555,431,124,411174,118296,529470
210515,201804,447,244,203,232776,193662,426438
210520,201804,403,352,51,335521.8,48654,384175.8
210530,201804,9420,5041,4379,4797240.67,4171734.03,8968974.70
210535,201804,131,94,37,89676,35298,124974
210540,201804,1546,932,614,887983.8,584325,1472308.8
210542,201804,1173,589,584,561524.4,556564,1118088.4
210545,201804,13,12,1,11448,954,12402
210547,201804,136,116,20,110664,19080,129744
210550,201804,744,520,224,494532,213696,708228
210560,201804,173,145,28,138330,26712,165042
210565,201804,30,21,9,20034,8586,28620
210570,201804,1366,1071,295,1021734,281430,1303164
210580,201804,106,92,14,87768,13356,101124
210590,201804,775,607,168,578314.8,160272,738586.8
210592,201804,32,28,4,26712,3816,30528
210594,201804,105,86,19,82044,18126,100170
210596,201804,84,70,14,66780,13356,80136
210598,201804,125,91,34,86814,32436,119250
210600,201804,335,282,53,269028,50562,319590
210610,201804,251,232,19,220374,18126,238500
210620,201804,47,27,20,25758,19080,44838
210630,201804,59,57,2,54378,1908,56286
210632,201804,1109,734,375,700236,357273,1057509
210635,201804,16,13,3,12402,2862,15264
210637,201804,106,74,32,70596,30528,101124
210640,201804,585,512,73,488448,69642,558090
210650,201804,406,327,79,311032.62,74412,385444.62
210660,201804,400,286,114,272177,108632,380809
210663,201804,18,11,7,10494,6678,17172
210667,201804,114,35,79,33390,75366,108756
210670,201804,272,239,33,227291,31482,258773
210675,201804,571,294,277,280476,264258,544734
210680,201804,210,131,79,124974,75366,200340
210690,201804,649,511,138,487494,131652,619146
210700,201804,192,141,51,134514,48654,183168
210710,201804,298,165,133,157219.2,126882,284101.2
210720,201804,126,105,21,100170,20034,120204
210725,201804,67,58,9,55332,8586,63918
210730,201804,25,19,6,18126,5724,23850
210735,201804,416,278,138,265212,131366,396578
210740,201804,547,461,86,439794,82044,521838
210745,201804,151,109,42,103986,40068,144054
210750,201804,2420,1095,1325,1042675,1264030.92,2306705.92
210760,201804,273,199,74,189846,70581.69,260427.69
210770,201804,404,312,92,297648,87481.8,385129.8
210780,201804,423,303,120,289062,114480,403542
210790,201804,184,143,41,136422,39114,175536
210800,201804,142,104,38,99216,36252,135468
210805,201804,42,38,4,36252,3816,40068
210810,201804,485,369,116,351358.2,110664,462022.2
210820,201804,2318,1836,482,1743428.54,459828,2203256.54
210825,201804,172,88,84,83952,80136,164088
210830,201804,805,488,317,464598,301464,766062
210840,201804,214,142,72,135468,68688,204156
210845,201804,254,160,94,152640,89676,242316
210850,201804,856,543,313,518022,298602,816624
210860,201804,4152,2130,2022,2029540.3,1928682.72,3958223.02
210870,201804,469,353,116,336762,110664,447426
210880,201804,58,39,19,37206,18126,55332
210890,201804,342,282,60,269028,57240,326268
210900,201804,574,375,199,357746,189846,547592
210905,201804,70,35,35,33390,33390,66780
210910,201804,2013,1489,524,1419167.99,499896,1919063.99
210920,201804,231,68,163,64872,155502,220374
210923,201804,81,57,24,54378,22896,77274
210927,201804,438,181,257,172674,245178,417852
210930,201804,63,49,14,46746,13356,60102
210940,201804,93,70,23,66780,21942,88722
210945,201804,193,87,106,82998,101124,184122
210950,201804,507,364,143,347256,136417.23,483673.23
210955,201804,75,49,26,46746,24804,71550
210960,201804,2463,1042,1421,992446.4,1355348,2347794.4
210970,201804,114,98,16,93492,15264,108756
210975,201804,91,81,10,77274,9540,86814
210980,201804,1235,530,705,505505.52,672284,1177789.52
210990,201804,4367,2712,1655,2586147.13,1578870,4165017.13
211000,201804,1381,1089,292,1038620,278281.8,1316901.8
211003,201804,925,631,294,601974,280467,882441
211010,201804,482,422,60,402588,57240,459828
211020,201804,1625,586,1039,559044,990986.58,1550030.58
211023,201804,27,23,4,21655.8,3816,25471.8
211027,201804,63,41,22,39114,20988,60102
211030,201804,387,259,128,247086,122112,369198
211040,201804,320,243,77,231536,73458,304994
211050,201804,1180,750,430,715500,409929.23,1125429.23
211060,201804,685,579,106,550171.8,101124,651295.8
211065,201804,23,19,4,18126,3816,21942
211070,201804,923,749,174,712934.74,165996,878930.74
211080,201804,88,84,4,80136,3816,83952
211085,201804,60,32,28,30242,26712,56954
211090,201804,92,74,18,70596,17172,87768
211100,201804,505,402,103,382267.8,98262,480529.8
211102,201804,261,173,88,165042,83952,248994
211105,201804,222,152,70,145008,66780,211788
211107,201804,135,77,58,73458,55332,128790
211110,201804,828,531,297,506002,283329,789331
211120,201804,5814,2463,3351,2344324.54,3195762.23,5540086.77
211125,201804,36,29,7,27666,6678,34344
211130,201804,45969,19166,26803,18250624.12,25557596.75,43808220.87
211140,201804,428,361,67,343436,63918,407354
211150,201804,1261,796,465,759050.1,443320,1202370.1
211153,201804,167,97,70,92538,66780,159318
211157,201804,63,46,17,43884,16218,60102
211160,201804,710,588,122,559985.5,116388,676373.5
211163,201804,0,0,0,0,0,0
211167,201804,7,5,2,4770,1908,6678
211170,201804,446,308,138,293832,131652,425484
211172,201804,122,85,37,81090,35298,116388
211174,201804,281,164,117,156456,111618,268074
211176,201804,521,373,148,355842,141192,497034
211178,201804,95,61,34,58194,32436,90630
211180,201804,207,162,45,154548,42767.82,197315.82
211190,201804,62,57,5,54378,4770,59148
211195,201804,25,16,9,15264,8586,23850
211200,201804,157,136,21,129400.56,20034,149434.56
211210,201804,531,331,200,315106.2,190800,505906.2
211220,201804,3995,2246,1749,2134841.39,1662209.04,3797050.43
211223,201804,96,89,7,84724.74,6678,91402.74
211227,201804,70,48,22,45792,20988,66780
211230,201804,782,632,150,602784.9,143080.92,745865.82
211240,201804,418,314,104,299556,99216,398772
211245,201804,212,93,119,88722,113526,202248
211250,201804,1640,1398,242,1332700.12,230868,1563568.12
211260,201804,820,641,179,611514,170766,782280
211270,201804,2091,1640,451,1564560,429300.2,1993860.2
211280,201804,1826,1086,740,1035090.8,705960,1741050.8
211285,201804,207,120,87,114480,82998,197478
211290,201804,688,459,229,437695.2,218466,656161.2
211300,201804,812,622,190,593110.09,181260,774370.09
211400,201804,1604,905,699,863370,666846,1530216
220005,201804,18,17,1,16218,954,17172
220010,201804,88,67,21,63918,19747.8,83665.8
220020,201804,617,484,133,460751.04,126882,587633.04
220025,201804,107,103,4,98262,3816,102078
220027,201804,34,27,7,25758,6678,32436
220030,201804,99,81,18,77274,17172,94446
220040,201804,1133,850,283,809736.96,269982,1079718.96
220045,201804,38,28,10,26712,9540,36252
220050,201804,653,534,119,508274.96,113506.92,621781.88
220060,201804,170,145,25,138330,23850,162180
220070,201804,97,88,9,83952,8586,92538
220080,201804,10,9,1,8586,954,9540
220090,201804,36,29,7,27380,6678,34058
220095,201804,2,1,1,954,954,1908
220100,201804,28,24,4,22896,3816,26712
220105,201804,27,25,2,23278,1908,25186
220110,201804,208,192,16,182881.8,15264,198145.8
220115,201804,47,44,3,41976,2862,44838
220117,201804,18,17,1,16218,954,17172
220120,201804,1530,1062,468,1012519.31,446452.92,1458972.23
220130,201804,26,25,1,23850,954,24804
220140,201804,98,78,20,73458,19080,92538
220150,201804,455,323,132,308142,125928,434070
220155,201804,4,4,0,3816,0,3816
220157,201804,18,15,3,14310,2862,17172
220160,201804,71,61,10,58194,9540,67734
220170,201804,35,33,2,31482,1908,33390
220173,201804,7,7,0,6678,0,6678
220177,201804,7,6,1,5724,954,6678
220180,201804,65,64,1,61051.23,668,61719.23
220190,201804,1053,942,111,898668,105894,1004562
220191,201804,42,37,5,35298,4770,40068
220192,201804,62,59,3,56286,2862,59148
220194,201804,34,30,4,28620,3816,32436
220196,201804,103,85,18,81090,17172,98262
220198,201804,7,5,2,4770,1908,6678
220200,201804,434,355,79,339116,75366,414482
220202,201804,37,33,4,31482,3816,35298
220205,201804,41,35,6,33390,5724,39114
220207,201804,19,18,1,17172,954,18126
220208,201804,84,44,40,41976,38160,80136
220209,201804,31,28,3,26712,2862,29574
220210,201804,15,13,2,12402,1908,14310
220211,201804,27,27,0,25758,0,25758
220213,201804,42,38,4,36252,3530,39782
220217,201804,36,28,8,26712,7632,34344
220220,201804,2042,1298,744,1234686.68,708373.92,1943060.60
220225,201804,17,9,8,8586,7632,16218
220230,201804,942,744,198,709327.62,188252.82,897580.44
220240,201804,147,134,13,127836,12402,140238
220245,201804,33,30,3,27917.04,2862,30779.04
220250,201804,108,97,11,92538,10494,103032
220253,201804,45,37,8,35298,7632,42930
220255,201804,28,25,3,23850,2862,26712
220260,201804,688,498,190,475092,181260,656352
220265,201804,15,12,3,11448,2862,14310
220270,201804,677,598,79,569766.96,74889,644655.96
220271,201804,46,38,8,36252,7632,43884
220272,201804,28,27,1,25758,954,26712
220273,201804,14,12,2,11448,1908,13356
220275,201804,58,47,11,44838,10494,55332
220277,201804,11,9,2,8586,1908,10494
220280,201804,15,12,3,11448,2862,14310
220285,201804,42,39,3,37206,2862,40068
220290,201804,1383,1181,202,1124146,192661,1316807
220300,201804,53,52,1,49608,954,50562
220310,201804,317,267,50,254714,47691,302405
220320,201804,439,404,35,383986,33390,417376
220323,201804,0,0,0,0,0,0
220325,201804,15,10,5,9540,4770,14310
220327,201804,11,10,1,9540,954,10494
220330,201804,205,140,65,133560,62010,195570
220335,201804,139,121,18,115434,17172,132606
220340,201804,25,15,10,14310,9540,23850
220342,201804,55,47,8,44838,7632,52470
220345,201804,83,75,8,71550,7632,79182
220350,201804,432,377,55,357035.42,52470,409505.42
220360,201804,43,31,12,29574,11448,41022
220370,201804,1122,898,224,855928.8,213409.8,1069338.6
220375,201804,27,25,2,23850,1908,25758
220380,201804,38,31,7,29574,6678,36252
220385,201804,28,24,4,22896,3816,26712
220390,201804,2237,1270,967,1206886.55,921135.5,2128022.05
220400,201804,28,26,2,24804,1908,26712
220410,201804,15,14,1,13356,954,14310
220415,201804,13,12,1,11448,954,12402
220420,201804,123,102,21,97308,19747.8,117055.8
220430,201804,130,118,12,110903.8,11448,122351.8
220435,201804,21,15,6,14306,5724,20030
220440,201804,291,248,43,236592,41022,277614
220450,201804,333,169,164,160060.98,156456,316516.98
220455,201804,53,51,2,48654,1908,50562
220460,201804,17,17,0,15550.2,0,15550.2
220465,201804,108,69,39,65826,37206,103032
220470,201804,240,211,29,201294,27666,228960
220480,201804,71,60,11,57240,10494,67734
220490,201804,85,74,11,70596,10494,81090
220500,201804,97,84,13,80136,12402,92538
220510,201804,385,305,80,290207,76129.2,366336.2
220515,201804,21,17,4,16218,3816,20034
220520,201804,374,336,38,319229,36233,355462
220525,201804,26,18,8,17172,7632,24804
220527,201804,38,29,9,27666,7776,35442
220530,201804,34,13,21,12402,20034,32436
220535,201804,9,9,0,8586,0,8586
220540,201804,65,52,13,49608,12402,62010
220545,201804,60,39,21,37206,20034,57240
220550,201804,645,492,153,468604.8,145962,614566.8
220551,201804,27,20,7,19080,6678,25758
220552,201804,8,8,0,7632,0,7632
220553,201804,47,43,4,41022,3816,44838
220554,201804,13,8,5,7345.8,4770,12115.8
220555,201804,24,20,4,19080,3816,22896
220556,201804,55,51,4,48654,3816,52470
220557,201804,57,51,6,48654,5724,54378
220558,201804,7,2,5,1908,4770,6678
220559,201804,7,6,1,5724,954,6678
220560,201804,58,37,21,35107.2,20034,55141.2
220570,201804,801,478,323,454607.14,308142,762749.14
220580,201804,560,513,47,489402,44151.92,533553.92
220585,201804,6,5,1,4770,954,5724
220590,201804,14,14,0,13356,0,13356
220595,201804,58,43,15,41022,14310,55332
220600,201804,22,12,10,11448,9540,20988
220605,201804,20,19,1,18126,954,19080
220610,201804,62,53,9,50562,8586,59148
220620,201804,560,438,122,417613.5,116388,534001.5
220630,201804,6,4,2,3816,1908,5724
220635,201804,37,33,4,31482,3816,35298
220640,201804,98,77,21,73458,20034,93492
220650,201804,114,108,6,103032,5724,108756
220660,201804,30,24,6,22896,5724,28620
220665,201804,4,4,0,3816,0,3816
220667,201804,14,11,3,10494,2862,13356
220669,201804,26,23,3,21942,2862,24804
220670,201804,72,56,16,53233.2,15264,68497.2
220672,201804,63,42,21,40068,20034,60102
220675,201804,36,28,8,26712,7632,34344
220680,201804,34,28,6,26712,5724,32436
220690,201804,46,44,2,41976,1908,43884
220695,201804,59,28,31,26712,29574,56286
220700,201804,1545,1185,360,1128648.78,343440,1472088.78
220710,201804,3,1,2,954,1908,2862
220720,201804,111,90,21,85621.5,19890.9,105512.4
220730,201804,20,19,1,18126,954,19080
220735,201804,3,1,2,954,1908,2862
220740,201804,46,42,4,40068,3816,43884
220750,201804,98,80,18,76320,17172,93492
220755,201804,14,14,0,13356,0,13356
220760,201804,53,50,3,47700,2862,50562
220770,201804,5821,2922,2899,2782378.83,2759509.41,5541888.24
220775,201804,24,10,14,9540,13356,22896
220777,201804,16,15,1,14310,954,15264
220779,201804,18,14,4,13356,3816,17172
220780,201804,876,748,128,712924.2,121826,834750.2
220785,201804,13,7,6,6678,5724,12402
220790,201804,1011,803,208,763660,198432,962092
220793,201804,13,13,0,12402,0,12402
220795,201804,22,21,1,20034,954,20988
220800,201804,3931,3004,927,2864173.36,883095.89,3747269.25
220810,201804,62,55,7,52470,6678,59148
220820,201804,240,218,22,207972,20988,228960
220830,201804,1163,984,179,938731.23,170747,1109478.23
220840,201804,2440,1618,822,1530777.82,782090,2312867.82
220850,201804,53,43,10,41022,9540,50562
220855,201804,14,9,5,8586,4770,13356
220860,201804,8,7,1,6678,954,7632
220865,201804,23,21,2,20034,1908,21942
220870,201804,59,57,2,54378,1908,56286
220880,201804,317,242,75,230200.2,71264,301464.2
220885,201804,47,44,3,41976,2862,44838
220887,201804,19,17,2,16218,1908,18126
220890,201804,101,89,12,84906,11448,96354
220900,201804,47,26,21,24804,20034,44838
220910,201804,53,45,8,42930,7632,50562
220915,201804,10,9,1,8586,954,9540
220920,201804,39,36,3,34344,2862,37206
220930,201804,42,41,1,39114,954,40068
220935,201804,15,15,0,14310,0,14310
220937,201804,44,41,3,39114,2862,41976
220940,201804,52,48,4,45792,3816,49608
220945,201804,0,0,0,0,0,0
220950,201804,47,43,4,41022,3816,44838
220955,201804,35,31,4,29574,3816,33390
220960,201804,1,1,0,954,0,954
220965,201804,28,25,3,23850,2862,26712
220970,201804,46,39,7,37206,6678,43884
220975,201804,9,8,1,7632,954,8586
220980,201804,33,31,2,29574,1908,31482
220985,201804,65,58,7,55332,6678,62010
220987,201804,31,30,1,28620,954,29574
220990,201804,13,12,1,11448,954,12402
220995,201804,37,32,5,30528,4770,35298
220997,201804,42,34,8,32436,7632,40068
221000,201804,1128,1014,114,963923.6,108469.8,1072393.4
221005,201804,62,56,6,53424,5724,59148
221010,201804,17,14,3,13356,2862,16218
221020,201804,44,42,2,40068,1908,41976
221030,201804,29,23,6,21942,5724,27666
221035,201804,19,19,0,18126,0,18126
221037,201804,12,6,6,5724,5724,11448
221038,201804,25,23,2,21942,1908,23850
221039,201804,23,23,0,21942,0,21942
221040,201804,257,222,35,211788,33390,245178
221050,201804,234,197,37,187938,35298,223236
221060,201804,1723,1513,210,1441886.76,200340,1642226.76
221062,201804,28,27,1,25758,954,26712
221063,201804,14,10,4,9540,3816,13356
221065,201804,50,43,7,41022,6678,47700
221070,201804,139,120,19,114480,18126,132606
221080,201804,376,334,42,318636,39781.8,358417.8
221090,201804,36,35,1,33390,954,34344
221093,201804,55,37,18,35298,17172,52470
221095,201804,11,10,1,9540,954,10494
221097,201804,20,17,3,16218,2862,19080
221100,201804,24688,14192,10496,13518068.61,10007143.52,23525212.13
221110,201804,1031,754,277,719030,264258,983288
221120,201804,533,395,138,376544,131652,508196
221130,201804,939,766,173,729524.8,165042,894566.8
221135,201804,34,31,3,29574,2862,32436
221140,201804,40,32,8,30528,7632,38160
221150,201804,16,13,3,12402,2862,15264
221160,201804,13,13,0,12402,0,12402
221170,201804,13,13,0,12402,0,12402
230010,201804,164,151,13,144054,12402,156456
230015,201804,114,94,20,89676,19080,108756
230020,201804,1559,1327,232,1263029.82,220426.56,1483456.38
230030,201804,1634,1172,462,1112519.04,440748,1553267.04
230040,201804,203,179,24,169573.5,22896,192469.5
230050,201804,210,153,57,145962,54378,200340
230060,201804,153,126,27,119440.8,25758,145198.8
230070,201804,278,248,30,236592,28620,265212
230075,201804,805,700,105,665797,99883.8,765680.8
230080,201804,181,156,25,148824,23850,172674
230090,201804,97,66,31,62200.8,29574,91774.8
230100,201804,1939,1149,790,1093859,753660,1847519
230110,201804,2643,1691,952,1610815.4,907635.8,2518451.2
230120,201804,941,749,192,712162.22,183149,895311.22
230125,201804,137,112,25,106848,23850,130698
230130,201804,459,412,47,393048,44838,437886
230140,201804,204,175,29,166950,27666,194616
230150,201804,157,121,36,115434,34344,149778
230160,201804,913,789,124,752229,118296,870525
230170,201804,584,539,45,509693.7,42930,552623.7
230180,201804,79,74,5,70596,4770,75366
230185,201804,409,352,57,334442.83,54378,388820.83
230190,201804,2198,1776,422,1690324.48,402271,2092595.48
230195,201804,487,425,62,405450,59148,464598
230200,201804,370,321,49,305270.46,46746,352016.46
230205,201804,357,226,131,213834.33,124974,338808.33
230210,201804,1259,1003,256,955535.29,243460.8,1198996.09
230220,201804,1409,976,433,930340.8,413082,1343422.8
230230,201804,892,785,107,747983.7,102078,850061.7
230240,201804,1625,1399,226,1332961.7,215604,1548565.7
230250,201804,1776,1465,311,1393171.97,296694,1689865.97
230260,201804,2945,1774,1171,1687203.16,1116161.69,2803364.85
230270,201804,1339,1075,264,1023331.99,250663.5,1273995.49
230280,201804,2717,2022,695,1922313.23,662362.2,2584675.43
230290,201804,398,363,35,340165.07,33390,373555.07
230300,201804,515,382,133,363168.72,126882,490050.72
230310,201804,415,312,103,297500.13,98262,395762.13
230320,201804,913,778,135,738228.6,128790,867018.6
230330,201804,298,239,59,227242.8,56096,283338.8
230340,201804,452,363,89,345349,84906,430255
230350,201804,3052,1913,1139,1824982.92,1083745.08,2908728.00
230360,201804,262,215,47,204200,44838,249038
230365,201804,134,108,26,102317,24804,127121
230370,201804,9778,4771,5007,4543684.18,4772239.3,9315923.48
230380,201804,462,398,64,379406,60102.6,439508.6
230390,201804,507,280,227,265316.94,216558,481874.94
230393,201804,267,220,47,209026.8,44838,253864.8
230395,201804,334,271,63,258286,60102,318388
230400,201804,597,476,121,452196,114937.92,567133.92
230410,201804,2625,1631,994,1550346.75,947990,2498336.75
230420,201804,5956,3892,2064,3694783.66,1964474.37,5659258.03
230423,201804,313,270,43,257580,41022,298602
230425,201804,353,293,60,278921,57240,336161
230426,201804,108,97,11,91812.96,10207.8,102020.76
230427,201804,78,75,3,71550,2862,74412
230428,201804,1355,697,658,664709.04,627732,1292441.04
230430,201804,445,359,86,342292,82044,424336
230435,201804,797,561,236,533652.23,223904.61,757556.84
230440,201804,83762,36995,46767,35206882.73,44572681.62,79779564.35
230445,201804,268,187,81,178207.2,77274,255481.2
230450,201804,537,436,101,415944,96354,512298
230460,201804,58,49,9,46746,8586,55332
230465,201804,300,244,56,232776,53424,286200
230470,201804,1860,1451,409,1384254,389079.1,1773333.1
230480,201804,150,144,6,137089.8,5724,142813.8
230490,201804,278,224,54,213696,51516,265212
230495,201804,436,328,108,312058,103032,415090
230500,201804,952,716,236,682110,225144,907254
230510,201804,45,36,9,34344,8586,42930
230520,201804,385,306,79,291924,75366,367290
230523,201804,2028,1279,749,1217872.9,714098,1931970.9
230526,201804,294,244,50,232776,46909,279685
230530,201804,675,505,170,478757.59,161226.2,639983.79
230533,201804,182,173,9,165042,8586,173628
230535,201804,345,259,86,247086,82044,329130
230540,201804,1831,1600,231,1523757.04,219801.8,1743558.84
230550,201804,3603,2317,1286,2202188.06,1225494.09,3427682.15
230560,201804,575,440,135,417661.8,127836,545497.8
230565,201804,194,141,53,134514,50562,185076
230570,201804,301,267,34,254718,32436,287154
230580,201804,1099,809,290,769572.72,275706,1045278.72
230590,201804,951,737,214,699522.1,203679,903201.1
230600,201804,259,235,24,223446.07,22896,246342.07
230610,201804,338,270,68,257390,64872,322262
230620,201804,162,134,28,126882,26712,153594
230625,201804,722,522,200,496443.31,189646.68,686089.99
230630,201804,1251,991,260,945414,247658.4,1193072.4
230640,201804,3520,3039,481,2891971.65,458115.57,3350087.22
230650,201804,393,343,50,326362.37,47700,374062.37
230655,201804,638,554,84,527562.8,80070.38,607633.18
230660,201804,343,288,55,274752,52183.8,326935.8
230670,201804,427,380,47,362520,44838,407358
230680,201804,198,182,16,173628,15264,188892
230690,201804,862,752,110,717408,104940,822348
230700,201804,698,591,107,563814,101791.8,665605.8
230710,201804,733,693,40,660932,38160,699092
230720,201804,146,123,23,116950.86,21942,138892.86
230725,201804,237,187,50,178398,47691,226089
230730,201804,11672,6335,5337,6027096.7,5083134.02,11110230.72
230740,201804,655,524,131,499610,124283.46,623893.46
230750,201804,806,690,116,657068.3,110664,767732.3
230760,201804,1309,1133,176,1076835.25,167904,1244739.25
230763,201804,319,264,55,249900.95,52470,302370.95
230765,201804,6858,3229,3629,3075679.59,3461013,6536692.59
230770,201804,4980,2559,2421,2431912.6,2308193.46,4740106.06
230780,201804,687,602,85,571168.1,80789.69,651957.79
230790,201804,199,164,35,156456,32589.4,189045.4
230800,201804,1112,814,298,776246.15,284292,1060538.15
230810,201804,1294,1153,141,1098960.3,134323.2,1233283.5
230820,201804,333,239,94,227053,89676,316729
230830,201804,937,810,127,769226.41,121158,890384.41
230835,201804,277,239,38,227052,35537,262589
230837,201804,160,135,25,128790,23850,152640
230840,201804,898,721,177,686594.5,168572,855166.5
230850,201804,1474,1285,189,1225413,180020,1405433
230860,201804,301,224,77,213696,73458,287154
230870,201804,1797,1527,270,1455804,257008,1712812
230880,201804,39,28,11,26712,10494,37206
230890,201804,572,525,47,500727.8,44824,545551.8
230900,201804,278,211,67,201294,63721,265015
230910,201804,202,164,38,155692.8,36252,191944.8
230920,201804,400,314,86,299556,82044,381600
230930,201804,920,646,274,613422.64,261396,874818.64
230940,201804,827,667,160,636318,152450,788768
230945,201804,480,401,79,382078,75366,457444
230950,201804,382,326,56,311004,53424,364428
230960,201804,2531,1713,818,1627474.84,780086,2407560.84
230970,201804,1747,986,761,939733.9,725116.32,1664850.22
230980,201804,208,179,29,170766,27666,198432
230990,201804,139,112,27,106848,25001.47,131849.47
231000,201804,208,188,20,177444,19080,196524
231010,201804,136,107,29,101505.6,27666,129171.6
231020,201804,1290,893,397,850301,378738,1229039
231025,201804,950,714,236,678038.2,223598.8,901637.0
231030,201804,1134,949,185,905342,176204,1081546
231040,201804,144,99,45,93701.88,42199,135900.88
231050,201804,981,874,107,832031.9,102078,934109.9
231060,201804,141,124,17,118296,16218,134514
231070,201804,1428,1008,420,959534.1,400680,1360214.1
231080,201804,262,243,19,231011.1,18126,249137.1
231085,201804,557,346,211,329131,201294,530425
231090,201804,241,201,40,191754,38160,229914
231095,201804,166,132,34,125928,32436,158364
231100,201804,123,102,21,97308,18793.8,116101.8
231110,201804,348,303,45,287539.9,42930,330469.9
231120,201804,297,254,43,241357.86,41022,282379.86
231123,201804,138,131,7,124974,6678,131652
231126,201804,292,243,49,231822,46746,278568
231130,201804,4564,3552,1012,3379520.5,964375.26,4343895.76
231135,201804,204,173,31,165042,28308.4,193350.4
231140,201804,3044,2247,797,2140528.91,759345.84,2899874.75
231150,201804,355,338,17,322452,16218,338670
231160,201804,1202,945,257,898477.7,244949.04,1143426.74
231170,201804,536,355,181,338670,172674,511344
231180,201804,1613,1369,244,1305262.8,232776,1538038.8
231190,201804,196,174,22,165996,20988,186984
231195,201804,216,186,30,176720,28620,205340
231200,201804,827,680,147,648720,138978,787698
231210,201804,605,506,99,481770.8,94446,576216.8
231220,201804,1038,751,287,714814.12,273798,988612.12
231230,201804,1384,1105,279,1052968.04,265402.8,1318370.84
231240,201804,1369,988,381,942265.8,362234.2,1304500.0
231250,201804,110,102,8,97308,7632,104940
231260,201804,287,184,103,175536,97976,273512
231270,201804,997,835,162,791360.68,154261.8,945622.48
231280,201804,56,43,13,41022,12402,53424
231290,201804,7172,3994,3178,3803180.24,3029467.21,6832647.45
231300,201804,623,575,48,548550,45792,594342
231310,201804,704,654,50,622699,47700,670399
231320,201804,565,436,129,415468,123066,538534
231325,201804,88,79,9,75366,8586,83952
231330,201804,2026,1565,461,1487195.66,437124.6,1924320.26
231335,201804,245,217,28,207018,26712,233730
231340,201804,1615,1188,427,1132208.08,407071.8,1539279.88
231350,201804,1157,946,211,902484,200722,1103206
231355,201804,395,343,52,327222,49608,376830
231360,201804,477,377,100,356948.2,95396,452344.2
231370,201804,91,74,17,70596,16218,86814
231375,201804,287,208,79,198432,75366,273798
231380,201804,449,362,87,343752.69,82807.2,426559.89
231390,201804,195,160,35,152640,33390,186030
231395,201804,732,447,285,425140.56,271890,697030.56
231400,201804,1056,875,181,832178.53,172331.38,1004509.91
231410,201804,1317,1071,246,1017109.4,233731,1250840.4
240010,201804,389,181,208,171522.26,198423,369945.26
240020,201804,2189,1714,475,1633569.89,453146,2086715.89
240030,201804,132,111,21,105894,20034,125928
240040,201804,32,32,0,30528,0,30528
240050,201804,509,435,74,414136.45,70596,484732.45
240060,201804,65,61,4,58194,3816,62010
240070,201804,182,143,39,136422,37206,173628
240080,201804,438,294,144,280472,137376,417848
240090,201804,104,92,12,87462.72,11448,98910.72
240100,201804,1440,1356,84,1290651.55,79945.2,1370596.75
240110,201804,977,621,356,591462.26,339624,931086.26
240120,201804,139,117,22,111618,20988,132606
240130,201804,286,268,18,254955.54,17172,272127.54
240140,201804,79,63,16,60102,15264,75366
240145,201804,683,603,80,574737.3,76110.12,650847.42
240150,201804,20,15,5,14310,4741.38,19051.38
240160,201804,44,38,6,36252,5724,41976
240165,201804,34,28,6,26474,5724,32198
240170,201804,93,71,22,67734,20988,88722
240180,201804,77,63,14,60102,13356,73458
240185,201804,42,39,3,37196.46,2862,40058.46
240190,201804,13,11,2,10494,1908,12402
240200,201804,3007,1689,1318,1605325.67,1256133,2861458.67
240210,201804,163,129,34,123066,32436,155502
240220,201804,1105,793,312,756379,297638.46,1054017.46
240230,201804,824,762,62,724114.05,58500,782614.05
240240,201804,119,86,33,82044,31482,113526
240250,201804,93,80,13,76320,12402,88722
240260,201804,1801,1336,465,1273857.12,442341.18,1716198.30
240270,201804,192,170,22,161798.4,20988,182786.4
240280,201804,43,33,10,31482,9540,41022
240290,201804,48,47,1,44838,954,45792
240300,201804,179,100,79,95400,75366,170766
240310,201804,2000,1095,905,1033592.98,860152.57,1893745.55
240320,201804,207,197,10,187938,9540,197478
240325,201804,4321,2646,1675,2517272.46,1595781.22,4113053.68
240330,201804,65,62,3,59148,2862,62010
240340,201804,102,74,28,70596,26712,97308
240350,201804,90,80,10,76320,9540,85860
240360,201804,394,279,115,266166,109710,375876
240370,201804,38,36,2,34344,1908,36252
240375,201804,69,40,29,38160,27666,65826
240380,201804,234,189,45,180306,42835,223141
240390,201804,16,13,3,12402,2862,15264
240400,201804,78,74,4,70596,3816,74412
240410,201804,10,6,4,5724,3816,9540
240420,201804,879,684,195,651154.6,184980.6,836135.2
240430,201804,262,247,15,233493.85,14310,247803.85
240440,201804,70,37,33,35298,31482,66780
240450,201804,207,140,67,132987.8,63918,196905.8
240460,201804,60,47,13,44838,12402,57240
240470,201804,235,204,31,194058.86,29574,223632.86
240480,201804,14,14,0,13260.6,0,13260.6
240485,201804,74,64,10,61056,9540,70596
240490,201804,45,45,0,42720.12,0,42720.12
240500,201804,85,67,18,63918,17172,81090
240510,201804,53,38,15,36252,14310,50562
240520,201804,122,116,6,110664,5724,116388
240530,201804,52,47,5,44838,4770,49608
240540,201804,78,67,11,63918,10494,74412
240550,201804,15,13,2,12402,1908,14310
240560,201804,372,275,97,261723.23,92538,354261.23
240570,201804,463,289,174,274847.4,165996,440843.4
240580,201804,1260,1020,240,967595.9,227802.2,1195398.1
240590,201804,30,28,2,26712,1908,28620
240600,201804,109,108,1,103032,954,103986
240610,201804,508,426,82,406047.7,77465,483512.7
240615,201804,20,19,1,18126,954,19080
240620,201804,95,91,4,86814,3816,90630
240630,201804,34,32,2,30528,1908,32436
240640,201804,26,22,4,20988,3816,24804
240650,201804,232,196,36,186125.9,34344,220469.9
240660,201804,98,85,13,81090,12402,93492
240670,201804,290,172,118,161989.3,112572,274561.3
240680,201804,48,37,11,35298,10494,45792
240690,201804,48,45,3,42930,2862,45792
240700,201804,194,160,34,152640,32436,185076
240710,201804,1928,1228,700,1171078.83,667790.46,1838869.29
240720,201804,1057,776,281,739150.66,268074,1007224.66
240725,201804,65,62,3,59148,2862,62010
240730,201804,133,115,18,109710,17172,126882
240740,201804,240,203,37,192297.78,34344.02,226641.80
240750,201804,36,24,12,22896,11448,34344
240760,201804,32,28,4,26712,3816,30528
240770,201804,147,112,35,106848,33390,140238
240780,201804,699,578,121,549971.46,115434,665405.46
240790,201804,38,37,1,35298,954,36252
240800,201804,8610,5837,2773,5528500.44,2638613.2,8167113.64
240810,201804,20008,11009,8999,10461351.22,8574932.48,19036283.70
240820,201804,210,130,80,123729.03,76320,200049.03
240830,201804,1610,1316,294,1248939.16,279522,1528461.16
240840,201804,79,69,10,65826,9540,75366
240850,201804,86,75,11,71550,10494,82044
240860,201804,114,111,3,105894,2862,108756
240870,201804,59,52,7,49608,6678,56286
240880,201804,29,26,3,24794.46,2862,27656.46
240890,201804,1156,684,472,648626.78,450284,1098910.78
240895,201804,43,33,10,31482,9540,41022
240910,201804,153,138,15,131652,14310,145962
240920,201804,15,12,3,11448,2862,14310
240930,201804,382,345,37,328176,35298,363474
240933,201804,30,23,7,21942,6678,28620
240940,201804,2430,2150,280,2037607.29,264238.92,2301846.21
240950,201804,51,48,3,45792,2862,48654
240960,201804,31,25,6,23850,5724,29574
240970,201804,129,91,38,86814,35498,122312
240980,201804,189,149,40,142146,38160,180306
240990,201804,117,78,39,74412,37206,111618
241000,201804,70,65,5,62010,4770,66780
241010,201804,59,47,12,44838,11448,56286
241020,201804,117,110,7,104940,6678,111618
241025,201804,9,3,6,2862,5724,8586
241030,201804,119,97,22,92538,20988,113526
241040,201804,35,29,6,27666,5724,33390
241050,201804,90,78,12,74412,11448,85860
241060,201804,27,24,3,22896,2862,25758
241070,201804,14,14,0,13356,0,13356
241080,201804,64,57,7,54091.8,6678,60769.8
241090,201804,51,41,10,39114,9525.69,48639.69
241100,201804,73,63,10,60102,9540,69642
241105,201804,6,2,4,1908,3816,5724
241110,201804,47,45,2,42930,1908,44838
241120,201804,1424,1103,321,1049276.8,306234,1355510.8
241140,201804,223,183,40,173629,38160,211789
241142,201804,42,40,2,38160,1908,40068
241150,201804,1216,1068,148,1016154,141192,1157346
241160,201804,22,21,1,20034,954,20988
241170,201804,42,39,3,37206,2862,40068
241180,201804,50,41,9,38939.42,8586,47525.42
241190,201804,39,38,1,36252,954,37206
241200,201804,3870,2110,1760,2007405.42,1677119.66,3684525.08
241210,201804,70,59,11,56286,9636,65922
241220,201804,1376,925,451,881926.84,430220.92,1312147.76
241230,201804,244,205,39,195379.2,37206,232585.2
241240,201804,52,40,12,38160,11448,49608
241250,201804,1086,1006,80,959438,76034,1035472
241255,201804,47,38,9,36252,8586,44838
241260,201804,629,498,131,475087.23,124974,600061.23
241270,201804,43,31,12,29574,11448,41022
241280,201804,98,85,13,81090,12402,93492
241290,201804,109,81,28,77274,26712,103986
241300,201804,78,55,23,52470,21942,74412
241310,201804,51,38,13,36109,12402,48511
241320,201804,27,14,13,13356,12402,25758
241330,201804,60,54,6,51516,5724,57240
241335,201804,61,54,7,50848.2,6678,57526.2
241340,201804,188,141,47,134514,44838,179352
241350,201804,59,54,5,51516,4770,56286
241355,201804,41,38,3,36252,2862,39114
241360,201804,46,46,0,43884,0,43884
241370,201804,43,36,7,34219.98,6678,40897.98
241380,201804,38,35,3,33390,2862,36252
241390,201804,75,60,15,57049.2,14310,71359.2
241400,201804,195,161,34,152926.2,32436,185362.2
241410,201804,177,160,17,152640,16122.6,168762.6
241415,201804,95,76,19,72504,18126,90630
241420,201804,99,75,24,71550,22725,94275
241430,201804,28,27,1,25758,954,26712
241440,201804,458,384,74,366322,70596,436918
241445,201804,38,36,2,34344,1908,36252
241450,201804,277,226,51,215596,48654,264250
241460,201804,134,122,12,116150,11448,127598
241470,201804,43,36,7,34344,6678,41022
241475,201804,63,61,2,58194,1908,60102
241480,201804,101,72,29,67448.69,27666,95114.69
241490,201804,8,7,1,6678,954,7632
241500,201804,46,33,13,31482,12402,43884
250010,201804,101,87,14,82854.9,13356,96210.9
250020,201804,27,24,3,22896,2862,25758
250030,201804,801,595,206,566285.2,195475.6,761760.8
250040,201804,330,278,52,265212,49321.8,314533.8
250050,201804,230,190,40,180969.8,38160,219129.8
250053,201804,54,42,12,40068,11448,51516
250057,201804,0,0,0,0,0,0
250060,201804,447,340,107,324360,101791.8,426151.8
250070,201804,705,585,120,556072,114480,670552
250073,201804,7,7,0,6678,0,6678
250077,201804,202,150,52,142708.86,49608,192316.86
250080,201804,421,331,90,314153.2,85860,400013.2
250090,201804,198,134,64,126882.4,61036.92,187919.32
250100,201804,470,383,87,365382,82617,447999
250110,201804,492,372,120,353104.02,114480,467584.02
250115,201804,26,9,17,8586,16218,24804
250120,201804,112,84,28,80136,26712,106848
250130,201804,579,460,119,438840,113336,552176
250135,201804,14,8,6,7632,5724,13356
250140,201804,78,70,8,66780,7632,74412
250150,201804,569,419,150,397558,142785.18,540343.18
250153,201804,10,9,1,8586,954,9540
250157,201804,28,23,5,21942,4770,26712
250160,201804,210,166,44,158364,41976,200340
250170,201804,66,46,20,43884,19080,62964
250180,201804,4014,2696,1318,2558326.9,1252274,3810600.9
250190,201804,902,599,303,569776.5,288346.5,858123.0
250200,201804,52,43,9,41022,8586,49608
250205,201804,24,21,3,20034,2862,22896
250210,201804,90,78,12,74412,11448,85860
250215,201804,63,54,9,51516,8586,60102
250220,201804,27,21,6,20034,5724,25758
250230,201804,77,70,7,66776,6678,73454
250240,201804,244,202,42,191897.1,40068,231965.1
250250,201804,395,337,58,321498,55332,376830
250260,201804,35,30,5,28620,4770,33390
250270,201804,56,45,11,42930,10494,53424
250280,201804,383,321,62,306234,59148,365382
250290,201804,94,89,5,84619.8,4770,89389.8
250300,201804,556,381,175,362826.71,166937,529763.71
250310,201804,47,42,5,40068,4770,44838
250320,201804,1960,1339,621,1271096.15,590860.8,1861956.95
250330,201804,83,74,9,70596,8586,79182
250340,201804,25,21,4,20034,3816,23850
250350,201804,140,90,50,85573.8,47127.6,132701.4
250355,201804,32,25,7,23850,6678,30528
250360,201804,201,164,37,156456,35060,191516
250370,201804,2392,1621,771,1541475.98,733977.82,2275453.80
250375,201804,16,12,4,11448,3816,15264
250380,201804,52,37,15,35298,14310,49608
250390,201804,41,34,7,32436,6678,39114
250400,201804,15652,7936,7716,7546485.33,7354615.55,14901100.88
250403,201804,423,345,78,329120.46,74412,403532.46
250407,201804,55,47,8,44838,7632,52470
250410,201804,30,25,5,23850,4770,28620
250415,201804,42,28,14,26712,13336.92,40048.92
250420,201804,46,38,8,36252,7632,43884
250430,201804,1644,1393,251,1326729,239454,1566183
250435,201804,16,13,3,12402,2862,15264
250440,201804,686,590,96,560167.38,91584,651751.38
250450,201804,88,73,15,69642,13544.53,83186.53
250460,201804,417,286,131,272844,124964.46,397808.46
250470,201804,89,66,23,62964,21942,84906
250480,201804,326,256,70,244224,66604,310828
250485,201804,2,1,1,954,954,1908
250490,201804,208,171,37,163134,35298,198432
250500,201804,77,57,20,54378,19080,73458
250510,201804,729,572,157,544352.6,148769.43,693122.03
250520,201804,174,121,53,115414.92,50557.23,165972.15
250523,201804,111,92,19,87768,18126,105894
250527,201804,103,81,22,77269.23,20988,98257.23
250530,201804,7,5,2,4770,1908,6678
250535,201804,25,21,4,20034,3816,23850
250540,201804,126,96,30,90868.5,28620,119488.5
250550,201804,68,65,3,62010,2862,64872
250560,201804,35,29,6,27666,5724,33390
250570,201804,151,120,31,114480,29574,144054
250580,201804,132,103,29,97975.8,27666,125641.8
250590,201804,20,16,4,15264,3816,19080
250600,201804,1321,893,428,849062.25,408216.6,1257278.85
250610,201804,152,131,21,124974,20034,145008
250620,201804,22,18,4,17172,3816,20988
250625,201804,63,47,16,44838,15264,60102
250630,201804,3005,1925,1080,1828407.65,1029252.74,2857660.39
250640,201804,201,167,34,159318,32436,191754
250650,201804,31,21,10,20034,9540,29574
250660,201804,45,34,11,32436,10494,42930
250670,201804,62,41,21,39114,20034,59148
250680,201804,385,316,69,301464,65826,367290
250690,201804,1831,1262,569,1200223.33,542444.8,1742668.13
250700,201804,950,837,113,794961.91,107592.12,902554.03
250710,201804,443,343,100,327222,95220.04,422442.04
250720,201804,104,82,22,78228,20988,99216
250730,201804,373,317,56,301464.6,53424,354888.6
250740,201804,50,46,4,43884,3816,47700
250750,201804,20420,12238,8182,11617250.96,7794773.42,19412024.38
250760,201804,69,52,17,49608,16218,65826
250770,201804,352,236,116,223236.14,109495.55,332731.69
250780,201804,56,43,13,41022,12402,53424
250790,201804,480,313,167,295740.92,158602.5,454343.42
250800,201804,152,141,11,133798.5,10494,144292.5
250810,201804,79,60,19,57240,18126,75366
250820,201804,161,130,31,124020,29574,153594
250830,201804,421,286,135,271842.5,128790,400632.5
250840,201804,53,51,2,48654,1908,50562
250850,201804,54,42,12,39381.12,11448,50829.12
250855,201804,13,11,2,10494,1908,12402
250860,201804,203,144,59,137376,55999.8,193375.8
250870,201804,32,29,3,27666,2862,30528
250880,201804,80,61,19,58136.76,18126,76262.76
250890,201804,2408,1774,634,1690583.4,603972.73,2294556.13
250900,201804,117,99,18,94446,17172,111618
250905,201804,125,97,28,92538,26712,119250
250910,201804,1180,837,343,797335.31,326935.8,1124271.11
250915,201804,110,76,34,72504,32436,104940
250920,201804,136,105,31,100170,29574,129744
250930,201804,160,99,61,94446,58194,152640
250933,201804,1,1,0,954,0,954
250937,201804,6,5,1,4770,954,5724
250939,201804,31,22,9,20988,8586,29574
250940,201804,106,80,26,76320,24804,101124
250950,201804,71,47,24,44838,22896,67734
250960,201804,88,49,39,46746,37206,83952
250970,201804,1207,858,349,816911,331992,1148903
250980,201804,90,63,27,60102,25758,85860
250990,201804,166,130,36,123547.77,34301.07,157848.84
251000,201804,74,67,7,63727.2,6678,70405.2
251010,201804,100,77,23,73454,21163.53,94617.53
251020,201804,80,70,10,65969.1,9540,75509.1
251030,201804,43,33,10,31482,9540,41022
251040,201804,53,38,15,36252,14310,50562
251050,201804,23,21,2,20034,1908,21942
251060,201804,52,41,11,38160,10494,48654
251065,201804,3,3,0,2862,0,2862
251070,201804,25,20,5,19071,4770,23841
251080,201804,4722,2292,2430,2173969.36,2311667.01,4485636.37
251090,201804,197,169,28,161226,26712,187938
251100,201804,19,18,1,17172,954,18126
251110,201804,46,37,9,35298,8586,43884
251120,201804,1800,1090,710,1034950.2,677340,1712290.2
251130,201804,355,289,66,275706,62964,338670
251140,201804,510,331,179,314630.8,170597.34,485228.14
251150,201804,295,255,40,242498,38160,280658
251160,201804,94,79,15,75362,14310,89672
251170,201804,98,78,20,74383.38,19075.23,93458.61
251180,201804,289,181,108,172665.23,103023.23,275688.46
251190,201804,194,133,61,126553.83,58194,184747.83
251200,201804,251,205,46,195570,43884,239454
251203,201804,33,31,2,29574,1908,31482
251207,201804,95,78,17,74412,16218,90630
251210,201804,1269,912,357,868494.53,339910.2,1208404.73
251220,201804,47,37,10,35298,9540,44838
251230,201804,473,397,76,378738,72504,451242
251240,201804,100,72,28,67734,26712,94446
251250,201804,1325,952,373,905318.87,355699,1261017.87
251260,201804,13,8,5,7632,4770,12402
251270,201804,344,255,89,243270,84763,328033
251272,201804,64,59,5,56286,4770,61056
251274,201804,30,25,5,23850,4770,28620
251275,201804,22,15,7,14310,6678,20988
251276,201804,18,14,4,13356,3816,17172
251278,201804,9,7,2,6678,1908,8586
251280,201804,99,94,5,89676,4770,94446
251290,201804,698,528,170,503712,162180,665892
251300,201804,16,14,2,13356,1908,15264
251310,201804,363,261,102,248990,97308,346298
251315,201804,18,17,1,16218,954,17172
251320,201804,60,49,11,46746,10494,57240
251330,201804,79,70,9,66780,8586,75366
251335,201804,12,7,5,6678,4770,11448
251340,201804,694,409,285,390186,270865.25,661051.25
251350,201804,37,35,2,33390,1908,35298
251360,201804,66,58,8,55125.94,7632,62757.94
251365,201804,14,14,0,13356,0,13356
251370,201804,5297,3594,1703,3423796.94,1623089.5,5046886.44
251380,201804,50,40,10,38160,9540,47700
251385,201804,3,3,0,2862,0,2862
251390,201804,667,532,135,506384.2,127550,633934.2
251392,201804,28,18,10,17172,9540,26712
251394,201804,10,10,0,9540,0,9540
251396,201804,18,13,5,12402,4770,17172
251398,201804,18,15,3,14310,2862,17172
251400,201804,41,34,7,32436,6678,39114
251410,201804,34,29,5,27666,4770,32436
251420,201804,107,80,27,76320,25758,102078
251430,201804,39,37,2,35298,1908,37206
251440,201804,33,22,11,20988,10494,31482
251445,201804,52,47,5,44838,4770,49608
251450,201804,420,372,48,353232.8,45792,399024.8
251455,201804,2,1,1,954,954,1908
251460,201804,17,13,4,12402,3816,16218
251465,201804,5,2,3,1908,2862,4770
251470,201804,47,37,10,35298,9540,44838
251480,201804,25,23,2,21942,1908,23850
251490,201804,129,90,39,85383,36253,121636
251500,201804,116,93,23,88722,21179,109901
251510,201804,35,27,8,25758,7632,33390
251520,201804,26,26,0,24804,0,24804
251530,201804,4532,3186,1346,3033144.24,1283788.26,4316932.50
251540,201804,72,64,8,61056,7632,68688
251550,201804,413,319,94,303372.2,88866,392238.2
251560,201804,23,17,6,16218,5724,21942
251570,201804,19,19,0,18126,0,18126
251580,201804,121,98,23,93492,21942,115434
251590,201804,125,93,32,88903,30528,119431
251593,201804,20,11,9,10494,8586,19080
251597,201804,55,45,10,42930,9540,52470
251600,201804,1101,779,322,741578.34,305579.92,1047158.26
251610,201804,210,158,52,150064.2,48941,199005.2
251615,201804,3,3,0,2862,0,2862
251620,201804,4241,2836,1405,2695703.84,1337605.28,4033309.12
251630,201804,453,334,119,318636,113517,432153
251640,201804,151,108,43,103032,41022,144054
251650,201804,265,193,72,182289.1,68688,250977.1
251660,201804,225,204,21,193662.1,19843.2,213505.3
251670,201804,357,279,78,264470,74412,338882
251675,201804,3,3,0,2862,0,2862
251680,201804,91,83,8,79182,7632,86814
251690,201804,341,286,55,271890,52119.89,324009.89
251700,201804,280,234,46,222649.29,43869.69,266518.98
251710,201804,19,12,7,11448,6678,18126
251720,201804,33,22,11,20988,10208,31196
251740,201804,10,8,2,7632,1908,9540
260005,201804,3139,1788,1351,1694663.34,1287687.1,2982350.44
260010,201804,1455,1034,421,981477.34,399631.32,1381108.66
260020,201804,429,376,53,358704,50562,409266
260030,201804,582,422,160,401820.98,152640,554460.98
260040,201804,863,529,334,503578.44,318626.46,822204.90
260050,201804,1139,815,324,777272,308524,1085796
260060,201804,414,376,38,357940.8,36252,394192.8
260070,201804,1462,921,541,874512,513144.36,1387656.36
260080,201804,729,579,150,551555.1,143100,694655.1
260090,201804,580,358,222,341304.12,211788,553092.12
260100,201804,230,161,69,152593.2,65826,218419.2
260105,201804,234,132,102,125928,97308,223236
260110,201804,2750,2042,708,1948059,674622,2622681
260120,201804,2916,1460,1456,1383122.21,1386736.1,2769858.31
260130,201804,150,104,46,99216,43884,143100
260140,201804,2121,1393,728,1320431.56,692967.46,2013399.02
260150,201804,227,150,77,143100,73458,216558
260160,201804,298,256,42,244224,40068,284292
260170,201804,3360,2050,1310,1948891.2,1248356.9,3197248.1
260180,201804,135,113,22,107802,20988,128790
260190,201804,2265,1605,660,1528019.9,629640,2157659.9
260200,201804,893,733,160,698507.08,152354,850861.08
260210,201804,1411,1002,409,955757.27,388937.11,1344694.38
260220,201804,716,655,61,624870,58194,683064
260230,201804,1199,910,289,865948.99,275706,1141654.99
260240,201804,220,166,54,157190.58,51516,208706.58
260250,201804,74,59,15,56286,14310,70596
260260,201804,993,713,280,680202,267120,947322
260270,201804,427,347,80,329655.2,76033.8,405689.0
260280,201804,1337,882,455,840951,433784,1274735
260290,201804,6373,3390,2983,3215256.35,2839072,6054328.35
260300,201804,862,759,103,722017.6,97976,819993.6
260310,201804,496,398,98,378313.47,93492,471805.47
260320,201804,882,667,215,636031.2,205110,841141.2
260330,201804,34,27,7,25758,6678,32436
260340,201804,68,49,19,46746,18126,64872
260345,201804,5678,3197,2481,3043475.43,2365797.76,5409273.19
260350,201804,472,341,131,323570.08,124021,447591.08
260360,201804,288,147,141,140238,134514,274752
260370,201804,649,422,227,399978.4,216418,616396.4
260380,201804,598,432,166,412128,157219.56,569347.56
260390,201804,292,249,43,236467.98,40068,276535.98
260392,201804,95,83,12,79182,11448,90630
260400,201804,4058,2337,1721,2219259.06,1641453.68,3860712.74
260410,201804,14347,7701,6646,7330619.67,6337839.2,13668458.87
260415,201804,123,111,12,105894,11448,117342
260420,201804,1775,1058,717,1004293.2,682221.64,1686514.84
260430,201804,190,174,16,164784.66,15264,180048.66
260440,201804,232,169,63,160502,60102,220604
260450,201804,472,341,131,324029,124974,449003
260460,201804,849,452,397,428538.8,378733.23,807272.03
260470,201804,376,232,144,220564.8,136995,357559.8
260480,201804,203,126,77,120204,73458,193662
260490,201804,208,167,41,159318,39114,198432
260500,201804,1135,762,373,724660.2,354745.8,1079406.0
260510,201804,738,586,152,557803.8,144054,701857.8
260515,201804,261,233,28,222282,26235,248517
260520,201804,3324,1972,1352,1873988.52,1288558.68,3162547.20
260530,201804,787,638,149,605832.64,142146,747978.64
260540,201804,570,433,137,413082,129744.72,542826.72
260545,201804,13,10,3,9540,2862,12402
260550,201804,342,213,129,203202,123066,326268
260560,201804,519,389,130,370515,123733.8,494248.8
260570,201804,1010,831,179,789769.8,170479.8,960249.6
260580,201804,268,239,29,228006,27666,255672
260590,201804,659,376,283,357292.08,269982,627274.08
260600,201804,8200,4170,4030,3955526.38,3841514.73,7797041.11
260610,201804,498,333,165,317682,157123.8,474805.8
260620,201804,3640,1897,1743,1798048.79,1658650.25,3456699.04
260630,201804,72,69,3,65826,2862,68688
260640,201804,3654,1993,1661,1898003.58,1584518.76,3482522.34
260650,201804,343,238,105,227052,100127.07,327179.07
260660,201804,504,343,161,326840.4,152973.9,479814.3
260670,201804,100,75,25,71550,23850,95400
260680,201804,3668,2046,1622,1935000.32,1547025.76,3482026.08
260690,201804,120,94,26,89676,24804,114480
260700,201804,321,196,125,186220.8,118416,304636.8
260710,201804,39,36,3,34344,2862,37206
260720,201804,2218,1335,883,1267383.69,841303.98,2108687.67
260730,201804,600,451,149,430254,139951.8,570205.8
260740,201804,62,58,4,55332,3816,59148
260750,201804,639,444,195,423251.64,186030,609281.64
260760,201804,622,338,284,322452,270619,593071
260765,201804,982,516,466,489321.8,444325.5,933647.3
260770,201804,217,163,54,155502,51516,207018
260775,201804,819,488,331,464169.8,315765,779934.8
260780,201804,274,175,99,166950,94446,261396
260790,201804,12367,6790,5577,6449586.34,5312888.93,11762475.27
260795,201804,164,113,51,106638.12,48654,155292.12
260800,201804,277,227,50,216081,47700,263781
260805,201804,177,114,63,108027.14,60102,168129.14
260810,201804,743,646,97,615034.26,92538,707572.26
260820,201804,318,215,103,203780.79,98262,302042.79
260825,201804,205,141,64,134136.99,61056,195192.99
260830,201804,260,168,92,160272,87768,248040
260840,201804,230,167,63,158651,59816,218467
260845,201804,209,145,64,138043.8,61056,199099.8
260850,201804,501,363,138,344638.09,131652,476290.09
260860,201804,255,190,65,181062.34,62010,243072.34
260870,201804,375,270,105,257580,100170,357750
260875,201804,694,485,209,461576.69,199386,660962.69
260880,201804,1583,964,619,917697.09,590335.2,1508032.29
260890,201804,2431,1692,739,1606774.06,704053,2310827.06
260900,201804,1043,718,325,683669.79,310050,993719.79
260910,201804,278,218,60,207972,57240,265212
260915,201804,300,202,98,192708,93372,286080
260920,201804,173,97,76,92538,72504,165042
260930,201804,387,331,56,315774,53338.45,369112.45
260940,201804,2777,1526,1251,1451609.89,1192957.92,2644567.81
260950,201804,2009,1166,843,1106011.82,804222,1910233.82
260960,201804,14266,7407,6859,7030986.17,6536011.53,13566997.70
260970,201804,439,375,64,356961,61056,418017
260980,201804,197,173,24,164756,22896,187652
260990,201804,2565,2116,449,2016918.62,427678.2,2444596.82
261000,201804,4331,2561,1770,2429770.96,1686682.34,4116453.30
261010,201804,188,137,51,130698,47836.23,178534.23
261020,201804,606,452,154,431065,146916,577981
261030,201804,220,161,59,153594,56080.89,209674.89
261040,201804,361,325,36,310050,34057.8,344107.8
261050,201804,470,413,57,394002,54378,448380
261060,201804,1319,864,455,823064.75,434070,1257134.75
261070,201804,9033,4599,4434,4362915.65,4222225.18,8585140.83
261080,201804,390,293,97,278750,92538,371288
261090,201804,2239,1716,523,1628484.05,498170,2126654.05
261100,201804,1092,774,318,736059.6,301502.16,1037561.76
261110,201804,8045,4924,3121,4691873.25,2975147.69,7667020.94
261120,201804,274,225,49,214650,46741.23,261391.23
261130,201804,569,330,239,314486.9,227662,542148.9
261140,201804,189,122,67,116388,63918,180306
261150,201804,667,390,277,372060,263590.2,635650.2
261153,201804,73,70,3,65826.31,2862,68688.31
261160,201804,76950,38864,38086,36952541.57,36310694.6,73263236.17
261170,201804,452,338,114,321547.36,108756,430303.36
261180,201804,1776,1088,688,1032829.62,656352,1689181.62
261190,201804,614,424,190,404099.92,181251,585350.92
261200,201804,213,188,25,178587.3,23850,202437.3
261210,201804,35,31,4,29574,3816,33390
261220,201804,2548,1801,747,1712337.13,711856.8,2424193.93
261230,201804,328,241,87,229914,82983.69,312897.69
261240,201804,441,380,61,360087.3,58194,418281.3
261245,201804,223,188,35,179352,33390,212742
261247,201804,152,114,38,108756,36252,145008
261250,201804,2859,1448,1411,1380581.8,1344983.83,2725565.63
261255,201804,254,231,23,220374,21942,242316
261260,201804,865,744,121,709776,115434,825210
261270,201804,173,135,38,128790,36252,165042
261280,201804,157,128,29,122112,27666,149778
261290,201804,126,88,38,83713.5,36252,119965.5
261300,201804,1232,872,360,831888,343440,1175328
261310,201804,760,508,252,484632,239787.9,724419.9
261320,201804,542,368,174,351052.92,165996,517048.92
261330,201804,838,664,174,630457.5,165150.46,795607.96
261340,201804,311,176,135,167904,128790,296694
261350,201804,796,570,226,542826.2,215604,758430.2
261360,201804,1225,795,430,758028.37,410220,1168248.37
261370,201804,4996,3061,1935,2905077.92,1843068.45,4748146.37
261380,201804,574,422,152,400689.64,144722,545411.64
261390,201804,3430,2290,1140,2179880.84,1083699.3,3263580.14
261400,201804,276,249,27,236973.6,25758,262731.6
261410,201804,1068,707,361,674478,344389.23,1018867.23
261420,201804,885,555,330,528489.46,314801.46,843290.92
261430,201804,328,299,29,284400,27379.8,311779.8
261440,201804,112,101,11,96354,10494,106848
261450,201804,2492,2078,414,1979751.44,393945.04,2373696.48
261460,201804,721,575,146,547596.02,139284,686880.02
261470,201804,251,192,59,182358,56286,238644
261480,201804,358,292,66,277329,62960,340289
261485,201804,346,210,136,199672.2,129744,329416.2
261500,201804,628,426,202,406404,192708,599112
261510,201804,45,30,15,28620,14310,42930
261520,201804,114,101,13,96354,12402,108756
261530,201804,4171,2655,1516,2524673.94,1445010.69,3969684.63
261540,201804,1083,671,412,639670.36,393048,1032718.36
261550,201804,285,142,143,134086,136402.92,270488.92
261560,201804,792,529,263,501424.2,249748.6,751172.8
261570,201804,370,290,80,276660,76320,352980
261580,201804,374,295,79,280379.8,75366,355745.8
261590,201804,192,155,37,147870,35298,183168
261600,201804,293,236,57,224381,53901,278282
261610,201804,107,92,15,86936.69,14310,101246.69
261618,201804,66,51,15,48654,14310,62964
261620,201804,200,121,79,115434,75366,190800
261630,201804,584,451,133,427893.6,126882,554775.6
261640,201804,6314,3353,2961,3191401.09,2821179.92,6012581.01
261650,201804,479,302,177,287430.66,168858,456288.66
270010,201804,526,462,64,440462,60293,500755
270020,201804,305,241,64,229910,61056,290966
270030,201804,9175,5864,3311,5580824.59,3156250.96,8737075.55
270040,201804,1956,1198,758,1142596.26,721891.8,1864488.06
270050,201804,175,129,46,123066,43884,166950
270060,201804,115,64,51,61056,48654,109710
270070,201804,904,657,247,624963.82,235333.26,860297.08
270080,201804,38,32,6,30528,5724,36252
270090,201804,20,16,4,15264,3816,19080
270100,201804,1254,828,426,786751.33,404098.7,1190850.03
270110,201804,150,110,40,104940,38160,143100
270120,201804,225,184,41,174684.55,39114,213798.55
270130,201804,248,170,78,161321.4,74412,235733.4
270135,201804,98,60,38,57240,36252,93492
270140,201804,1282,774,508,738203.27,483669.2,1221872.47
270150,201804,267,212,55,202248,52470,254718
270160,201804,520,388,132,370152,125260.2,495412.2
270170,201804,726,464,262,441511.2,248850.9,690362.1
270180,201804,73,56,17,53106.04,16008.12,69114.16
270190,201804,102,89,13,84906,12402,97308
270200,201804,106,95,11,90439.2,10494,100933.2
270210,201804,485,252,233,240408,221995.8,462403.8
270220,201804,185,146,39,139284,37206,176490
270230,201804,2103,1250,853,1188324.54,810901.42,1999225.96
270235,201804,734,551,183,525364.51,174216.95,699581.46
270240,201804,3100,2397,703,2276649.67,667870,2944519.67
270250,201804,170,118,52,112572,49608,162180
270255,201804,221,191,30,182214,28238.4,210452.4
270260,201804,327,260,67,248040,63918,311958
270270,201804,112,47,65,44829,62010,106839
270280,201804,205,127,78,121158,74412,195570
270290,201804,1167,875,292,833514.42,277691.46,1111205.88
270300,201804,278,174,104,165996,98929.8,264925.8
270310,201804,916,735,181,698894.25,171950.04,870844.29
270320,201804,882,753,129,717294.8,122779.8,840074.6
270330,201804,275,230,45,218466,42930,261396
270340,201804,59,47,12,44838,11448,56286
270350,201804,94,48,46,45553.5,43884,89437.5
270360,201804,75,41,34,39114,32436,71550
270370,201804,52,40,12,38160,11448,49608
270375,201804,69,40,29,38160,27666,65826
270380,201804,1086,611,475,581940,453150,1035090
270390,201804,197,109,88,103986,83952,187938
270400,201804,706,514,192,489141.27,183159,672300.27
270410,201804,696,499,197,475728.04,187928.46,663656.50
270420,201804,399,258,141,244434,134429.38,378863.38
270430,201804,32318,23066,9252,21946804.84,8818921.03,30765725.87
270440,201804,490,383,107,364571.1,101791.8,466362.9
270450,201804,770,401,369,382315.5,351072.66,733388.16
270460,201804,199,153,46,145962,43884,189846
270470,201804,1368,907,461,864924.69,439794,1304718.69
270480,201804,534,428,106,405230.98,100408.5,505639.48
270490,201804,25,21,4,20034,3816,23850
270500,201804,514,422,92,402588,87768,490356
270510,201804,736,451,285,430254,271890,702144
270520,201804,375,230,145,219211,138330,357541
270530,201804,66,58,8,55332,7632,62964
270540,201804,123,95,28,90630,26712,117342
270550,201804,1730,1300,430,1239877.18,409738.23,1649615.41
270560,201804,313,145,168,138330,160272,298602
270570,201804,452,299,153,283035.36,145962,428997.36
270580,201804,79,57,22,54378,20988,75366
270590,201804,78,64,14,61056,13356,74412
270600,201804,177,146,31,139284,29574,168858
270610,201804,181,145,36,138321,34344,172665
270620,201804,30,29,1,27666,954,28620
270630,201804,3834,2907,927,2762658.93,882202.96,3644861.89
270640,201804,900,659,241,626982.6,229599.8,856582.4
270642,201804,211,178,33,169812,31482,201294
270644,201804,277,191,86,182023.74,82039.23,264062.97
270650,201804,246,144,102,137376,97308,234684
270660,201804,255,205,50,195570,47700,243270
270670,201804,3178,2415,763,2292538.23,724979.68,3017517.91
270680,201804,467,271,196,258525,186979.23,445504.23
270690,201804,1122,705,417,670837.76,397808.46,1068646.22
270700,201804,37,27,10,25758,9540,35298
270710,201804,876,660,216,628021.34,206064,834085.34
270720,201804,246,187,59,178398,55999.8,234397.8
270730,201804,1897,1095,802,1042389.4,763002.2,1805391.6
270740,201804,45,28,17,26712,16218,42930
270750,201804,635,465,170,443420,161513,604933
270760,201804,312,225,87,214650,82998,297648
270770,201804,2730,1736,994,1648870.28,947322,2596192.28
270780,201804,92,57,35,54373.23,33372.46,87745.69
270790,201804,272,182,90,173628,85860,259488
270800,201804,1966,1570,396,1495987.25,377039.88,1873027.13
270810,201804,311,244,67,232761.69,63909.23,296670.92
270820,201804,159,102,57,97308,54283,151591
270830,201804,926,669,257,637459,244892,882351
270840,201804,1414,1032,382,983737.33,362760,1346497.33
270850,201804,1674,1020,654,966918.36,623897.46,1590815.82
270860,201804,2439,1590,849,1514521.4,807048.57,2321569.97
270870,201804,120,65,55,62010,52470,114480
270880,201804,919,673,246,640206.14,233790.58,873996.72
270890,201804,357,261,96,248545.62,91579.23,340124.85
270895,201804,71,61,10,58194,9540,67734
270900,201804,104,80,24,76320,22896,99216
270910,201804,324,258,66,244987.2,62964,307951.2
270915,201804,1827,1091,736,1035925.64,701238.1,1737163.74
270920,201804,475,398,77,379692,73458,453150
270930,201804,6197,4480,1717,4268402.31,1635237.24,5903639.55
270940,201804,2375,1798,577,1713322.88,549486,2262808.88
280010,201804,44,39,5,37206,4770,41976
280020,201804,704,607,97,577139.03,91584,668723.03
280030,201804,19399,12403,6996,11749793.46,6645166.63,18394960.09
280040,201804,337,211,126,201294,118773,320067
280050,201804,375,290,85,276373.8,81090,357463.8
280060,201804,327,218,109,205725.43,103986,309711.43
280067,201804,980,690,290,655501.94,275706.25,931208.19
280070,201804,130,109,21,103986,20034,124020
280100,201804,617,485,132,459945.67,125738,585683.67
280110,201804,75,71,4,67734,3816,71550
280120,201804,635,510,125,486540,119250,605790
280130,201804,1360,847,513,806607.8,489258.9,1295866.7
280140,201804,473,385,88,366431.4,82998,449429.4
280150,201804,318,236,82,224464.09,78228,302692.09
280160,201804,99,84,15,80136,14310,94446
280170,201804,594,394,200,374679.56,190800,565479.56
280190,201804,28,26,2,24804,1908,26712
280200,201804,24,16,8,15264,7632,22896
280210,201804,2763,1947,816,1839782.11,772886.97,2612669.08
280220,201804,40,31,9,29574,8586,38160
280230,201804,317,261,56,248159.63,53424,301583.63
280240,201804,114,108,6,102888.9,5724,108612.9
280250,201804,19,12,7,11448,6678,18126
280260,201804,81,70,11,66780,10494,77274
280270,201804,159,122,37,116388,35298,151686
280280,201804,195,125,70,119250,66780,186030
280290,201804,3071,2213,858,2099239.74,816935.25,2916174.99
280300,201804,1099,830,269,790155.27,255862.8,1046018.07
280310,201804,107,102,5,96977.29,4770,101747.29
280320,201804,651,444,207,423567,197478,621045
280330,201804,358,254,104,242316,99091.98,341407.98
280340,201804,419,336,83,319072.57,78419,397491.57
280350,201804,3434,2645,789,2513363.33,749966.21,3263329.54
280360,201804,467,295,172,281430,163134,444564
280370,201804,98,87,11,82998,10494,93492
280380,201804,56,42,14,40068,13356,53424
280390,201804,186,155,31,147870,29574,177444
280400,201804,341,231,110,219515.8,104940,324455.8
280410,201804,290,235,55,223237,52470,275707
280420,201804,172,144,28,137357,26712,164069
280430,201804,108,79,29,75366,27557.63,102923.63
280440,201804,681,527,154,499802.4,146715.66,646518.06
280445,201804,115,107,8,102078,7632,109710
280450,201804,1089,928,161,882736.2,153594,1036330.2
280460,201804,746,545,201,513069.44,191754,704823.44
280470,201804,190,173,17,165042,15265,180307
280480,201804,2249,1588,661,1500270.21,626552.89,2126823.10
280490,201804,353,325,28,308658,26712,335370
280500,201804,46,41,5,39114,4770,43884
280510,201804,146,112,34,106547.2,32150,138697.2
280520,201804,52,38,14,36252,13356,49608
280530,201804,77,54,23,51516,21942,73458
280540,201804,504,403,101,384462,96067.8,480529.8
280550,201804,711,656,55,623208.6,52470,675678.6
280560,201804,478,415,63,393191.1,60102,453293.1
280570,201804,1774,1350,424,1284171.47,403640.83,1687812.30
280580,201804,591,451,140,428873.6,133465,562338.6
280590,201804,164,100,64,95120.48,61056,156176.48
280600,201804,357,299,58,285246,55332,340578
280610,201804,141,107,34,101872,32436,134308
280620,201804,545,446,99,424530.5,93492.9,518023.4
280630,201804,163,134,29,127836,27666,155502
280640,201804,212,171,41,162305,39114,201419
280650,201804,79,53,26,50562,24804,75366
280660,201804,131,94,37,89676,35059.5,124735.5
280670,201804,1637,1025,612,970702.55,580103.95,1550806.50
280680,201804,179,152,27,143224.14,25758,168982.14
280690,201804,54,45,9,42930,8586,51516
280700,201804,19,19,0,18126,0,18126
280710,201804,1414,1071,343,1014658.79,326554.2,1341212.99
280720,201804,110,74,36,68036.4,34344,102380.4
280730,201804,27,23,4,21942,3816,25758
280740,201804,2408,1773,635,1685716.49,604501.2,2290217.69
280750,201804,292,254,38,242316,36252,278568
280760,201804,886,608,278,578887.2,265212,844099.2
290010,201804,201,134,67,127836,63918,191754
290020,201804,177,164,13,156456,12402,168858
290030,201804,596,388,208,369484.2,198432,567916.2
290035,201804,139,113,26,104597.7,24804,129401.7
290040,201804,268,167,101,159318,96354,255672
290050,201804,78,58,20,55332,19080,74412
290060,201804,254,113,141,107515.8,134514,242029.8
290070,201804,5620,2776,2844,2640865.67,2708670.5,5349536.17
290080,201804,504,228,276,217206.72,263285,480491.72
290090,201804,384,166,218,158364,207972,366336
290100,201804,1589,1047,542,994643.1,516495.8,1511138.9
290110,201804,760,452,308,429582.2,293303.3,722885.5
290115,201804,210,193,17,183168,16218,199386
290120,201804,776,503,273,479194.2,260442,739636.2
290130,201804,416,247,169,235342.26,161226,396568.26
290135,201804,297,225,72,213972.66,68688,282660.66
290140,201804,304,251,53,239454,50371.2,289825.2
290150,201804,130,97,33,92538,31482,124020
290160,201804,244,188,56,178112.58,53424,231536.58
290170,201804,90,64,26,61056,24804,85860
290180,201804,154,121,33,115434,31482,146916
290190,201804,448,364,84,346970,79849.8,426819.8
290195,201804,311,182,129,173628,123066,296694
290200,201804,282,238,44,227052,41976,269028
290205,201804,141,89,52,84906,49608,134514
290210,201804,1128,819,309,780182.2,294786,1074968.2
290220,201804,221,122,99,115911,94446,210357
290225,201804,285,111,174,105894,165996,271890
290230,201804,63,41,22,39114,20988,60102
290240,201804,309,123,186,117055.8,177444,294499.8
290250,201804,274,246,28,233988,26712,260700
290260,201804,280,228,52,216463,49608,266071
290265,201804,181,151,30,143237,28620,171857
290270,201804,1393,1150,243,1095240.2,230959,1326199.2
290280,201804,468,345,123,329130,117342,446472
290290,201804,1229,710,519,672247.89,495126,1167373.89
290300,201804,447,378,69,360321.23,65826,426147.23
290310,201804,316,140,176,133560,167904,301464
290320,201804,3968,2464,1504,2347953.84,1431955,3779908.84
290323,201804,185,161,24,153308,22896,176204
290327,201804,151,119,32,113254.11,30528,143782.11
290330,201804,74,40,34,38160,32436,70596
290340,201804,911,361,550,343421,524414,867835
290350,201804,587,349,238,332946,227052,559998
290360,201804,365,273,92,258535.69,87768,346303.69
290370,201804,909,360,549,343440,523732,867172
290380,201804,308,189,119,180306,113526,293832
290390,201804,2495,1556,939,1481451.58,893602.46,2375054.04
290395,201804,243,135,108,128265.29,103032,231297.29
290400,201804,281,208,73,198146,69642,267788
290405,201804,252,220,32,209880,30528,240408
290410,201804,571,485,86,459685.64,82044,541729.64
290420,201804,234,182,52,173628,49608,223236
290430,201804,496,311,185,296694,176490,473184
290440,201804,72,64,8,61056,7632,68688
290450,201804,232,178,54,169812,51516,221328
290460,201804,1872,1113,759,1059933.8,723323.32,1783257.12
290470,201804,1440,606,834,576995.22,795321.36,1372316.58
290475,201804,587,549,38,522593,36252,558845
290480,201804,288,160,128,152640,122112,274752
290485,201804,230,214,16,204156,15264,219420
290490,201804,1177,853,324,812998.8,308142.2,1121141.0
290500,201804,672,338,334,321498,318636,640134
290510,201804,221,168,53,159319,50562,209881
290515,201804,136,79,57,75366,54378,129744
290520,201804,1399,905,494,861748.62,468034.42,1329783.04
290530,201804,315,286,29,272844,27666,300510
290540,201804,96,58,38,55332,36252,91584
290550,201804,151,129,22,123066,20921.22,143987.22
290560,201804,3369,1363,2006,1299004.76,1913529.59,3212534.35
290570,201804,5945,3020,2925,2876468.81,2787634.95,5664103.76
290580,201804,1262,742,520,706627.8,495364.5,1201992.3
290590,201804,532,439,93,418015,88722,506737
290600,201804,1712,1186,526,1126743.05,501775.38,1628518.43
290610,201804,218,196,22,186527,20988,207515
290620,201804,325,288,37,274752,35298,310050
290630,201804,2091,893,1198,847820.8,1138491.3,1986312.1
290640,201804,151,123,28,117342,26712,144054
290650,201804,1697,799,898,761283,856692,1617975
290660,201804,279,228,51,217512,48654,266166
290670,201804,992,516,476,491692,453758.38,945450.38
290680,201804,1183,951,232,906013.8,220374,1126387.8
290682,201804,292,213,79,202215.3,75347.46,277562.76
290685,201804,231,148,83,140238,79182,219420
290687,201804,933,615,318,583323.6,302418,885741.6
290689,201804,130,75,55,71536,52455.69,123991.69
290690,201804,647,264,383,251827.92,364502.8,616330.72
290700,201804,239,113,126,107802,120204,228006
290710,201804,707,473,234,451222.92,223236,674458.92
290720,201804,1024,831,193,792774,183645,976419
290730,201804,1124,645,479,613470.5,456012,1069482.5
290740,201804,15,12,3,11448,2862,14310
290750,201804,1361,619,742,588613.23,705756.1,1294369.33
290755,201804,70,62,8,59148,7632,66780
290760,201804,300,260,40,248040,38160,286200
290770,201804,186,175,11,166940.46,10494,177434.46
290780,201804,977,783,194,745038.66,183263.4,928302.06
290790,201804,373,261,112,248994,106848,355842
290800,201804,2631,1053,1578,1001629.04,1504305.36,2505934.40
290810,201804,434,303,131,288776,124784,413560
290820,201804,380,233,147,221314,140238,361552
290830,201804,403,276,127,263304,121158,384462
290840,201804,1688,1032,656,982382.8,623744.48,1606127.28
290850,201804,763,420,343,400489.2,326268,726757.2
290860,201804,643,285,358,271890,341246,613136
290870,201804,665,477,188,453837.8,179352,633189.8
290880,201804,125,67,58,63918,55332,119250
290890,201804,330,235,95,224190,90630,314820
290900,201804,170,128,42,122112,40068,162180
290910,201804,364,276,88,263304,83952,347256
290920,201804,231,197,34,187938,32436,220374
290930,201804,815,617,198,588618,188873,777491
290940,201804,250,205,45,194806.8,42930,237736.8
290950,201804,172,99,73,94446,69642,164088
290960,201804,445,298,147,283052.24,139951.8,423004.04
290970,201804,251,219,32,208735.2,30385,239120.2
290980,201804,1497,1062,435,1008979.76,413941.2,1422920.96
290990,201804,368,311,57,296665.92,54322.38,350988.30
291000,201804,864,244,620,232776,590907.6,823683.6
291005,201804,2111,899,1212,855299.76,1155471.03,2010770.79
291010,201804,155,140,15,133560,14310,147870
291020,201804,101,80,21,76320,20034,96354
291030,201804,90,66,24,62964,22896,85860
291040,201804,573,285,288,271890,274752,546642
291050,201804,1346,752,594,715763.23,566389.8,1282153.03
291060,201804,1488,820,668,781612.2,637272,1418884.2
291070,201804,1891,1398,493,1327361.41,469061.5,1796422.91
291072,201804,7341,2694,4647,2566727.58,4431054.42,6997782.00
291075,201804,205,167,38,159318,36252,195570
291077,201804,50,34,16,32436,15264,47700
291080,201804,19691,8623,11068,8203748.84,10546387.24,18750136.08
291085,201804,292,233,59,222282,56281.23,278563.23
291090,201804,308,118,190,112286,181250.46,293536.46
291100,201804,675,196,479,186984,456966,643950
291110,201804,399,299,100,285226.92,95400,380626.92
291120,201804,2516,1194,1322,1138933,1259219.46,2398152.46
291125,201804,59,30,29,28620,27666,56286
291130,201804,214,188,26,179352,24804,204156
291140,201804,125,92,33,87768,31196,118964
291150,201804,375,150,225,143100,214650,357750
291160,201804,364,303,61,288108.5,58194,346302.5
291165,201804,24,20,4,19080,3816,22896
291170,201804,2918,1459,1459,1388118.11,1388833.6,2776951.71
291180,201804,1324,513,811,489205.38,773560.68,1262766.06
291185,201804,74,72,2,68688,1908,70596
291190,201804,1254,538,716,510480.17,682520.8,1193000.97
291200,201804,167,123,44,117342,41976,159318
291210,201804,2211,864,1347,821117.34,1283226.14,2104343.48
291220,201804,269,202,67,191754.64,63918,255672.64
291230,201804,1031,350,681,333042,649674,982716
291240,201804,439,416,23,395624,21942,417566
291250,201804,431,354,77,337716,73458,411174
291260,201804,45,34,11,32436,10494,42930
291270,201804,1205,494,711,471276,678007.8,1149283.8
291280,201804,374,169,205,161020.89,195274.26,356295.15
291290,201804,1764,892,872,849251.2,830840,1680091.2
291300,201804,222,174,48,165328.2,45792,211120.2
291310,201804,229,204,25,194329.8,23850,218179.8
291320,201804,1397,999,398,950184,378643.29,1328827.29
291330,201804,128,110,18,103127.4,17172,120299.4
291340,201804,146,83,63,79182,60102,139284
291345,201804,133,86,47,82044,44838,126882
291350,201804,1585,516,1069,492073.2,1019635.3,1511708.5
291360,201804,8626,4254,4372,4046541.84,4168080.55,8214622.39
291370,201804,1096,606,490,577838,467460,1045298
291380,201804,253,198,55,188892,52184,241076
291390,201804,3893,1693,2200,1610670,2096988,3707658
291400,201804,2085,1494,591,1420125.39,562131.51,1982256.90
291410,201804,154,133,21,125928,20034,145962
291420,201804,112,80,32,76320,30528,106848
291430,201804,168,95,73,89923,68688.53,158611.53
291440,201804,493,392,101,371244.3,96354,467598.3
291450,201804,903,572,331,544448.8,314820,859268.8
291460,201804,1725,1402,323,1335743.1,308142,1643885.1
291465,201804,2214,1024,1190,976114.19,1134978.14,2111092.33
291470,201804,2785,1407,1378,1338492.47,1313882,2652374.47
291480,201804,11842,5218,6624,4966728.89,6310082.65,11276811.54
291490,201804,551,228,323,217512,308142,525654
291500,201804,372,203,169,193662,161226,354888
291510,201804,1240,470,770,447218.99,734293.8,1181512.79
291520,201804,957,437,520,416898,496070.46,912968.46
291530,201804,1012,270,742,257580,707562.72,965142.72
291535,201804,116,97,19,92538,18126,110664
291540,201804,361,106,255,101124,242316.6,343440.6
291550,201804,1188,559,629,531380.1,599762,1131142.1
291560,201804,5532,2818,2714,2675472.97,2576951.16,5252424.13
291570,201804,204,104,100,99216,95400,194616
291580,201804,1215,738,477,703285.46,455044.23,1158329.69
291590,201804,81,31,50,29430.9,47700,77130.9
291600,201804,1364,625,739,595296,704702,1299998
291610,201804,1423,655,768,623586.87,732616,1356202.87
291620,201804,585,270,315,257580,300128.4,557708.4
291630,201804,493,163,330,155502,314820,470322
291640,201804,3906,1966,1940,1867288.2,1849392.98,3716681.18
291650,201804,423,282,141,267894,133714.73,401608.73
291660,201804,444,177,267,168165.96,253620.9,421786.86
291670,201804,223,142,81,134896,77274,212170
291680,201804,699,397,302,378738,288003.46,666741.46
291685,201804,585,315,270,300272,257389.2,557661.2
291690,201804,566,290,276,276660,262341,539001
291700,201804,915,723,192,689012.19,182214,871226.19
291710,201804,1713,797,916,759642.28,872987.06,1632629.34
291720,201804,399,264,135,251851.23,128790,380641.23
291730,201804,945,558,387,530520.98,369188.46,899709.44
291733,201804,259,180,79,171433.8,75366,246799.8
291735,201804,64,49,15,46746,14310,61056
291740,201804,339,256,83,244224,79182,323406
291750,201804,1936,1291,645,1224330.78,614508,1838838.78
291760,201804,3059,1660,1399,1577773,1332261,2910034
291770,201804,811,543,268,515923.26,255672,771595.26
291780,201804,47,29,18,27666,17172,44838
291790,201804,166,77,89,73458,84906,158364
291800,201804,10024,4014,6010,3817325.54,5727897.6,9545223.14
291810,201804,1142,818,324,779795.03,309096,1088891.03
291820,201804,263,190,73,181260,69642,250902
291830,201804,1077,410,667,389465,635355,1024820
291835,201804,603,555,48,528993,45792,574785
291840,201804,4662,2405,2257,2289578.17,2152330.02,4441908.19
291845,201804,300,102,198,97308,188863.38,286171.38
291850,201804,322,279,43,265927.5,41022,306949.5
291855,201804,269,107,162,102078,154548,256626
291860,201804,175,110,65,103986,62010,165996
291870,201804,83,34,49,32436,46746,79182
291875,201804,186,168,18,160272,17172,177444
291880,201804,489,385,104,366480,99216,465696
291890,201804,243,81,162,77264.46,152863.17,230127.63
291900,201804,56,32,24,30528,22896,53424
291905,201804,134,94,40,89390,38160,127550
291910,201804,176,143,33,136422,31482,167904
291915,201804,388,345,43,327462,41022,368484
291920,201804,4965,2579,2386,2457677.41,2274392.77,4732070.18
291930,201804,183,106,77,101124,73458,174582
291940,201804,322,178,144,169115.58,136422,305537.58
291950,201804,1139,926,213,882641,203202,1085843
291955,201804,1018,605,413,577170,393700,970870
291960,201804,180,124,56,118296,53137.8,171433.8
291970,201804,778,589,189,561906,180306,742212
291980,201804,1500,1327,173,1262545.7,164088.4,1426634.1
291990,201804,123,114,9,108756,8586,117342
291992,201804,164,84,80,79372.8,76320,155692.8
291995,201804,149,105,44,100170,41976,142146
292000,201804,384,291,93,275420.95,88722,364142.95
292010,201804,285,202,83,191754.8,78228,269982.8
292020,201804,274,199,75,189846,71550,261396
292030,201804,138,107,31,102078,29574,131652
292040,201804,627,316,311,301464,296694,598158
292045,201804,93,84,9,80136,8586,88722
292050,201804,885,612,273,582838.87,260156,842994.87
292060,201804,934,770,164,732654.28,156456,889110.28
292070,201804,50,21,29,20034,27666,47700
292080,201804,115,79,36,75366,34344,109710
292090,201804,505,177,328,168667.2,312912,481579.2
292100,201804,1410,605,805,575596.7,766702.52,1342299.22
292105,201804,201,169,32,161226,30528,191754
292110,201804,2116,784,1332,747611.64,1268702.91,2016314.55
292120,201804,648,518,130,493039.79,124020,617059.79
292130,201804,448,265,183,252810,174582,427392
292140,201804,197,154,43,146916,40890.26,187806.26
292145,201804,163,89,74,84906,70553.07,155459.07
292150,201804,1420,1136,284,1083744,269908.16,1353652.16
292160,201804,180,147,33,139951.8,31482,171433.8
292170,201804,1221,1070,151,1019087.31,143996.76,1163084.07
292180,201804,200,141,59,134514,56286,190800
292190,201804,160,97,63,92538,60102,152640
292200,201804,1280,459,821,436914.71,782585.56,1219500.27
292205,201804,116,104,12,98929.8,11448,110377.8
292210,201804,373,258,115,244749,108994.5,353743.5
292220,201804,22,16,6,15264,5724,20988
292225,201804,38,35,3,33390,2862,36252
292230,201804,916,744,172,707078.03,164088,871166.03
292240,201804,620,446,174,424387,165996,590383
292250,201804,1709,1089,620,1038906,591480,1630386
292260,201804,444,248,196,236592,186220.8,422812.8
292265,201804,268,189,79,180019.8,75366,255385.8
292270,201804,773,339,434,323406,413082.8,736488.8
292273,201804,199,110,89,104162.49,84906,189068.49
292275,201804,164,80,84,76320,79849.8,156169.8
292280,201804,137,97,40,92538,38160,130698
292285,201804,62,52,10,48940.2,9540,58480.2
292290,201804,553,369,184,349536.47,175250,524786.47
292300,201804,1633,621,1012,591861.8,964614.58,1556476.38
292303,201804,96,66,30,62964,28620,91584
292305,201804,110,78,32,74412,30528,104940
292310,201804,814,515,299,490948,283948.15,774896.15
292320,201804,662,497,165,473851.8,157410,631261.8
292330,201804,185,99,86,94446,82044,176490
292335,201804,273,210,63,200340,60102,260442
292340,201804,575,399,176,379906.85,167904,547810.85
292350,201804,271,144,127,136565.1,120871.8,257436.9
292360,201804,706,534,172,507719,164088,671807
292370,201804,775,591,184,563814,175536,739350
292380,201804,654,504,150,478908.62,143100,622008.62
292390,201804,500,188,312,179352,295883.5,475235.5
292400,201804,3373,2065,1308,1951461.47,1243665.8,3195127.27
292405,201804,265,176,89,167427,84619.8,252046.8
292410,201804,151,88,63,83952,60102,144054
292420,201804,306,261,45,248707.8,42930,291637.8
292430,201804,519,407,112,388278,106371,494649
292440,201804,580,494,86,469482.6,81757.8,551240.4
292450,201804,247,191,56,182214,53424,235638
292460,201804,585,434,151,413463.8,143958.6,557422.4
292465,201804,199,164,35,156456,32652.09,189108.09
292467,201804,103,61,42,58194,40068,98262
292470,201804,258,176,82,167904,78228,246132
292480,201804,327,217,110,206064.5,104654,310718.5
292490,201804,219,144,75,137376,71550,208926
292500,201804,1161,502,659,478697,628228.28,1106925.28
292510,201804,3332,1501,1831,1430714.12,1743812.54,3174526.66
292520,201804,1061,503,558,477997.7,532323,1010320.7
292525,201804,387,275,112,262345.23,106848,369193.23
292530,201804,4244,1734,2510,1650965.04,2393329.92,4044294.96
292540,201804,478,257,221,245178,210834,456012
292550,201804,1057,571,486,544011.82,463139.72,1007151.54
292560,201804,318,299,19,285246,18126,303372
292570,201804,299,228,71,217183,67734,284917
292575,201804,467,301,166,286868,158364,445232
292580,201804,917,579,338,550935,322166,873101
292590,201804,511,438,73,417549.59,69642,487191.59
292593,201804,143,112,31,106848,29574,136422
292595,201804,180,137,43,130698,41022,171720
292600,201804,1233,918,315,875455,299842.2,1175297.2
292610,201804,127,97,30,92538,28362.42,120900.42
292620,201804,525,434,91,413741,86814,500555
292630,201804,1377,791,586,753026,557413.14,1310439.14
292640,201804,772,538,234,512918.1,223236,736154.1
292650,201804,172,147,25,139952,23850,163802
292660,201804,1989,1433,556,1361258.85,526226.83,1887485.68
292665,201804,137,101,36,96354,34344,130698
292670,201804,399,321,78,306230,74412,380642
292680,201804,252,195,57,186030,53901,239931
292690,201804,179,138,41,131652,39114,170766
292700,201804,920,609,311,580032.8,296694,876726.8
292710,201804,96,84,12,80136,11448,91584
292720,201804,834,471,363,448532.64,346112,794644.64
292730,201804,201,95,106,89676.5,101124,190800.5
292740,201804,66614,32983,33631,31390470.97,32053569.12,63444040.09
292750,201804,371,264,107,251856,101267.57,353123.57
292760,201804,321,260,61,247029.5,58194,305223.5
292770,201804,789,333,456,317396,435024,752420
292780,201804,418,155,263,147642.48,250902,398544.48
292790,201804,739,362,377,345348,359419.5,704767.5
292800,201804,1147,704,443,670662,422622,1093284
292805,201804,428,124,304,117771.3,290016,407787.3
292810,201804,1473,855,618,814525.8,589276.46,1403802.26
292820,201804,741,596,145,566676.87,138034.8,704711.67
292830,201804,105,83,22,79182,20988,100170
292840,201804,658,542,116,516591,110649.69,627240.69
292850,201804,130,87,43,82994,41022,124016
292860,201804,2156,1254,902,1192244.94,860508,2052752.94
292870,201804,3395,2276,1119,2170041.8,1067516.46,3237558.26
292880,201804,1460,956,504,908257.86,479576,1387833.86
292890,201804,483,414,69,394928,65826,460754
292895,201804,134,89,45,83547.5,42930,126477.5
292900,201804,389,287,102,273798,97308,371106
292905,201804,448,231,217,220374,207018,427392
292910,201804,409,310,99,295407,94446,389853
292920,201804,548,241,307,229914,292878,522792
292925,201804,506,469,37,446748.66,35279,482027.66
292930,201804,574,355,219,338670,208926,547596
292935,201804,293,126,167,120204,159318,279522
292937,201804,233,160,73,152640,69642,222282
292940,201804,194,147,47,140238,44838,185076
292950,201804,1103,569,534,540680.5,508483,1049163.5
292960,201804,555,371,184,353934,175536,529470
292970,201804,272,190,82,180593,78228,258821
292975,201804,156,89,67,84906,63728,148634
292980,201804,255,173,82,163258.43,78228,241486.43
292990,201804,1310,969,341,917089.87,325126.93,1242216.80
293000,201804,103,75,28,71550,26712,98262
293010,201804,2672,1635,1037,1554028.92,985261.01,2539289.93
293015,201804,657,523,134,498724.49,127197,625921.49
293020,201804,331,271,60,258534,57240,315774
293030,201804,619,539,80,512680.44,76320,589000.44
293040,201804,339,266,73,253764,69642,323406
293050,201804,2722,1586,1136,1504489.79,1079614.38,2584104.17
293060,201804,252,202,50,191521,46746.8,238267.8
293070,201804,3379,1718,1661,1631119.68,1583148.92,3214268.60
293075,201804,90,58,32,55332,30528,85860
293076,201804,72,46,26,43884,24804,68688
293077,201804,436,267,169,250203.47,161226,411429.47
293080,201804,449,398,51,379692,48654,428346
293090,201804,128,111,17,105894,16218,122112
293100,201804,517,365,152,348210,145008,493218
293105,201804,343,234,109,222950,103986,326936
293110,201804,171,121,50,115434,47700,163134
293120,201804,315,213,102,203202,97117.2,300319.2
293130,201804,246,166,80,158364,76320,234684
293135,201804,7939,3132,4807,2980322.06,4577642.98,7557965.04
293140,201804,183,117,66,111618,62201,173819
293150,201804,327,278,49,263781.2,46746,310527.2
293160,201804,429,247,182,235638,173628,409266
293170,201804,191,132,59,125744,55428,181172
293180,201804,464,317,147,302132,140238,442370
293190,201804,1276,886,390,840594.73,372060,1212654.73
293200,201804,529,468,61,445392,58194,503586
293210,201804,347,255,92,243118,87052.5,330170.5
293220,201804,2678,1085,1593,1033156.41,1517575.97,2550732.38
293230,201804,1771,638,1133,607221.8,1080882,1688103.8
293240,201804,219,200,19,190800,18126,208926
293245,201804,111,93,18,88722,17172,105894
293250,201804,735,273,462,260194,440748,700942
293260,201804,312,262,50,248994.17,47700,296694.17
293270,201804,1180,562,618,534240.68,589572,1123812.68
293280,201804,236,132,104,125928,99216,225144
293290,201804,3080,2010,1070,1916586,1020481,2937067
293300,201804,711,506,205,480391.5,193089.6,673481.1
293305,201804,151,129,22,123066,20988,144054
293310,201804,134,100,34,95400,32436,127836
293315,201804,158,122,36,116388,34344,150732
293317,201804,97,68,29,64872,27666,92538
293320,201804,967,558,409,531378.5,390186,921564.5
293325,201804,190,65,125,62010,119211.84,181221.84
293330,201804,12910,6049,6861,5759829.31,6537561.55,12297390.86
293340,201804,253,183,70,174582,65826,240408
293345,201804,247,197,50,187938,47700,235638
293350,201804,634,341,293,325314,278043.3,603357.3
293360,201804,1577,1125,452,1072010,429968.7,1501978.7
310010,201804,150,77,73,73458,69356,142814
310020,201804,1051,576,475,547119.2,451242.12,998361.32
310030,201804,326,263,63,249776.88,59908.39,309685.27
310040,201804,49,30,19,28620,18126,46746
310050,201804,185,123,62,116388.4,58862,175250.4
310060,201804,234,163,71,155025,67734,222759
310070,201804,16,8,8,7632,7632,15264
310080,201804,50,27,23,25758,21942,47700
310090,201804,965,510,455,480137.54,432925.6,913063.14
310100,201804,298,224,74,213696,70596,284292
310110,201804,730,389,341,369784.9,324360,694144.9
310120,201804,390,216,174,205396.2,165621.94,371018.14
310130,201804,34,21,13,20034,12402,32436
310140,201804,28,16,12,15264,11448,26712
310150,201804,1296,888,408,841382.6,388373.8,1229756.4
310160,201804,2104,1062,1042,1005041.53,991397.4,1996438.93
310163,201804,95,53,42,50562,40068,90630
310170,201804,2587,1075,1512,1024758.2,1440826.6,2465584.8
310180,201804,132,51,81,48654,76892.4,125546.4
310190,201804,484,328,156,312912,148251.6,461163.6
310200,201804,502,319,183,304326,174296,478622
310205,201804,58,45,13,42930,12402,55332
310210,201804,276,225,51,214650,48654,263304
310220,201804,56,32,24,30528,22896,53424
310230,201804,261,183,78,174391.2,74412,248803.2
310240,201804,104,90,14,85621.5,13356,98977.5
310250,201804,99,80,19,76320,18126,94446
310260,201804,801,428,373,405356.24,355107.42,760463.66
310270,201804,271,181,90,172121,85860,257981
310280,201804,367,274,93,260442.8,88722,349164.8
310285,201804,219,156,63,148515.86,60102,208617.86
310290,201804,259,150,109,143100,103986,247086
310300,201804,155,129,26,123066,24804,147870
310310,201804,7,5,2,4770,1908,6678
310320,201804,23,14,9,13356,8586,21942
310330,201804,31,23,8,21942,7632,29574
310340,201804,1711,1105,606,1045203.6,576598.5,1621802.1
310350,201804,2838,1538,1300,1463383.81,1239618.8,2703002.61
310360,201804,40,33,7,31482,6678,38160
310370,201804,124,102,22,97308,20702,118010
310375,201804,105,38,67,36252,63899,100151
310380,201804,53,31,22,28668,20988,49656
310390,201804,104,71,33,67734,31482,99216
310400,201804,2345,1514,831,1440446,792487.8,2232933.8
310410,201804,125,68,57,64872,54378,119250
310420,201804,667,355,312,336858.8,296685.06,633543.86
310430,201804,328,217,111,206731.8,105894,312625.8
310440,201804,71,43,28,41022,26712,67734
310445,201804,84,66,18,62964,17172,80136
310450,201804,862,540,322,515160,306901.8,822061.8
310460,201804,264,191,73,182214,69642,251856
310470,201804,504,321,183,306234,174582,480816
310480,201804,79,57,22,54378,20988,75366
310490,201804,501,236,265,224190.2,252810,477000.2
310500,201804,125,54,71,51516,67734,119250
310510,201804,611,396,215,376544.6,205091.46,581636.06
310520,201804,129,86,43,82044,41022,123066
310530,201804,85,39,46,37206,43597.8,80803.8
310540,201804,457,281,176,265690.6,167617.8,433308.4
310550,201804,89,60,29,57240,27666,84906
310560,201804,2941,2026,915,1922036.6,871331.13,2793367.73
310570,201804,124,86,38,82044,36252,118296
310590,201804,348,230,118,218037.8,112557.69,330595.49
310600,201804,159,90,69,84095.7,65826,149921.7
310610,201804,59,21,38,20034,36252,56286
310620,201804,45933,22008,23925,20920390.15,22783278.7,43703668.85
310630,201804,602,383,219,362663.6,207591.4,570255.0
310640,201804,139,115,24,109710,22896,132606
310650,201804,162,142,20,134228,19080,153308
310660,201804,91,57,34,54378,32436,86814
310665,201804,55,40,15,38160,14310,52470
310670,201804,6378,2923,3455,2780653.17,3291301.84,6071955.01
310680,201804,57,37,20,35298,19080,54378
310690,201804,606,442,164,417462.16,156456,573918.16
310700,201804,61,40,21,38160,19890.9,58050.9
310710,201804,1240,825,415,785796.23,395337.8,1181134.03
310720,201804,89,29,60,27666,57240,84906
310730,201804,1379,962,417,916253.5,397532,1313785.5
310740,201804,1000,561,439,532046.4,418272.26,950318.66
310750,201804,244,143,101,135468.18,96354,231822.18
310760,201804,71,54,17,51516,15932,67448
310770,201804,93,46,47,43884,44838,88722
310780,201804,405,329,76,313284.6,72504,385788.6
310790,201804,102,82,20,78228,19080,97308
310800,201804,452,220,232,209403,221041.8,430444.8
310810,201804,168,117,51,110559.2,47700,158259.2
310820,201804,354,281,73,268074,69355.8,337429.8
310825,201804,198,162,36,154548,34344,188892
310830,201804,463,222,241,211127.94,229770.9,440898.84
310840,201804,386,220,166,209880,158364,368244
310850,201804,109,88,21,83952,20034,103986
310855,201804,379,300,79,286200,75366,361566
310860,201804,1405,1051,354,997647.9,335980.9,1333628.8
310870,201804,55,43,12,41022,11448,52470
310880,201804,83,65,18,61723.8,17172,78895.8
310890,201804,311,184,127,175536,121158,296694
310900,201804,630,292,338,275930.27,322146.8,598077.07
310910,201804,247,167,80,157983.2,76320,234303.2
310920,201804,483,290,193,272845.2,184122,456967.2
310925,201804,39,32,7,30528,6392,36920
310930,201804,1096,663,433,632385.53,412987.07,1045372.60
310940,201804,685,347,338,330437.8,322452,652889.8
310945,201804,117,73,44,69642,41976,111618
310950,201804,252,198,54,188892,51516,240408
310960,201804,83,30,53,28620,50558,79178
310970,201804,168,104,64,99216,60133.76,159349.76
310980,201804,45,24,21,22896,20034,42930
310990,201804,152,86,66,81758,62964,144722
311000,201804,855,422,433,399059.69,413073,812132.69
311010,201804,40,33,7,31482,6678,38160
311020,201804,42,26,16,24804,15264,40068
311030,201804,388,231,157,218180,149778,367958
311040,201804,38,33,5,31482,4770,36252
311050,201804,461,193,268,183550,255099.6,438649.6
311060,201804,765,435,330,413559.4,314534,728093.4
311070,201804,331,152,179,145008,170766,315774
311080,201804,106,59,47,56286,44838,101124
311090,201804,394,183,211,173342,201294,374636
311100,201804,609,364,245,346969.8,233443.8,580413.6
311110,201804,680,469,211,447139.8,201285,648424.8
311115,201804,68,49,19,46746,18126,64872
311120,201804,1048,546,502,519594,478001.9,997595.9
311130,201804,409,241,168,229723.2,160272,389995.2
311140,201804,164,83,81,79182,76463.1,155645.1
311150,201804,356,234,122,223236,116149.5,339385.5
311160,201804,750,540,210,512775.4,199863,712638.4
311170,201804,79,58,21,55332,19747.8,75079.8
311180,201804,347,231,116,220087.8,110378,330465.8
311190,201804,35,18,17,17172,16218,33390
311200,201804,340,238,102,225430.6,97308,322738.6
311205,201804,29,19,10,18126,9158.4,27284.4
311210,201804,49,41,8,38828,7632,46460
311220,201804,18,16,2,15264,1908,17172
311230,201804,1632,1059,573,1006204.94,546642,1552846.94
311240,201804,174,110,64,104736.33,61056,165792.33
311250,201804,83,31,52,29574,49608,79182
311260,201804,558,354,204,337716,194616,532332
311265,201804,115,80,35,76320,33390,109710
311270,201804,284,206,78,196524,74412,270936
311280,201804,214,96,118,91584,111999.6,203583.6
311290,201804,109,88,21,83952,19748,103700
311300,201804,548,345,203,329130,193376,522506
311310,201804,25,19,6,18126,5724,23850
311320,201804,677,504,173,479862,165042,644904
311330,201804,1031,758,273,722893.5,259488.4,982381.9
311340,201804,2637,1870,767,1775557.11,731022.86,2506579.97
311350,201804,272,208,64,198432,61056,259488
311360,201804,180,106,74,101124,70596,171720
311370,201804,1204,489,715,464512.5,681537.6,1146050.1
311380,201804,7,6,1,5724,954,6678
311390,201804,281,150,131,143100,124497.2,267597.2
311400,201804,149,99,50,94446,47700,142146
311410,201804,101,56,45,53138,42930,96068
311420,201804,300,168,132,159318.8,125928,285246.8
311430,201804,853,552,301,525573,287154,812727
311440,201804,492,343,149,327222,141859.8,469081.8
311450,201804,325,203,122,193662,116388,310050
311455,201804,302,204,98,194320.8,93205.8,287526.6
311460,201804,135,54,81,51516,76468.27,127984.27
311470,201804,23,13,10,12402,9540,21942
311480,201804,29,11,18,10494,17172,27666
311490,201804,16,10,6,9540,5724,15264
311500,201804,20,11,9,10494,8586,19080
311510,201804,624,437,187,414955.7,177825.8,592781.5
311520,201804,45,33,12,30814.2,11448,42262.2
311530,201804,1801,1346,455,1274641.12,434070,1708711.12
311535,201804,68,51,17,48654,16218,64872
311540,201804,35,30,5,28620,4770,33390
311545,201804,188,141,47,134514,44838,179352
311547,201804,32,23,9,21942,8586,30528
311550,201804,639,298,341,284292,325295.46,609587.46
311560,201804,43,28,15,26712,14310,41022
311570,201804,301,201,100,191181.6,95400,286581.6
311580,201804,311,184,127,175249.8,121158,296407.8
311590,201804,33,29,4,27666,3816,31482
311600,201804,90,71,19,67734,18126,85860
311610,201804,257,224,33,212742.5,31482,244224.5
311615,201804,101,82,19,77588.82,17935.2,95524.02
311620,201804,19,11,8,10494,7632,18126
311630,201804,85,71,14,67734,13356,81090
311640,201804,122,65,57,62010,54378,116388
311650,201804,130,96,34,90868.5,32436,123304.5
311660,201804,408,196,212,186984,202248,389232
311670,201804,169,109,60,103741,57240,160981
311680,201804,223,160,63,151738.95,59338.8,211077.75
311690,201804,18,11,7,10494,6678,17172
311700,201804,200,140,60,133273.8,57240,190513.8
311710,201804,213,135,78,128790,74412,203202
311720,201804,39,28,11,26712,10494,37206
311730,201804,551,359,192,341914,183168,525082
311740,201804,40,29,11,27666,10494,38160
311750,201804,706,478,228,454104.8,217512,671616.8
311760,201804,65,36,29,34344,27666,62010
311770,201804,406,194,212,183168.62,202248,385416.62
311780,201804,170,95,75,90344,71233,161577
311783,201804,82,73,9,69642,8586,78228
311787,201804,35,15,20,14310,19080,33390
311790,201804,263,127,136,121158,129744,250902
311800,201804,639,431,208,408551.5,197764.2,606315.7
311810,201804,44,36,8,34344,7632,41976
311820,201804,106,89,17,84906,16218,101124
311830,201804,1899,1203,696,1141814.84,659787.4,1801602.24
311840,201804,1025,570,455,539488.9,432601.54,972090.44
311850,201804,8,5,3,4770,2862,7632
311860,201804,9495,4312,5183,4096705.49,4936888.97,9033594.46
311870,201804,151,84,67,80136,63918,144054
311880,201804,950,708,242,673896.8,230868,904764.8
311890,201804,219,111,108,105894,103032,208926
311900,201804,84,35,49,33390,46746,80136
311910,201804,1398,861,537,819200.09,510199.4,1329399.49
311920,201804,231,152,79,144770,75366,220136
311930,201804,914,527,387,502248.5,368960,871208.5
311940,201804,2480,1287,1193,1225461.7,1134878.4,2360340.1
311950,201804,37,26,11,24804,10494,35298
311960,201804,65,46,19,43884,18126,62010
311970,201804,26,17,9,13928.4,8586,22514.4
311980,201804,41,31,10,29574,9540,39114
311990,201804,59,41,18,39114,17172,56286
311995,201804,63,44,19,41976,18126,60102
312000,201804,35,25,10,23563.8,9540,33103.8
312010,201804,81,59,22,56286,20988,77274
312015,201804,100,75,25,71264,23850,95114
312020,201804,140,88,52,83952,49321.8,133273.8
312030,201804,43,34,9,31659,8586,40245
312040,201804,82,51,31,48654,29574,78228
312050,201804,224,116,108,110664,103032,213696
312060,201804,69,42,27,40068,25090.2,65158.2
312070,201804,74,46,28,43884,26712,70596
312080,201804,531,239,292,228006,278568,506574
312083,201804,49,36,13,34344,12402,46746
312087,201804,111,89,22,84906,20988,105894
312090,201804,2894,1647,1247,1557315.5,1186256.27,2743571.77
312100,201804,158,111,47,105894,44056,149950
312110,201804,119,74,45,70596,42930,113526
312120,201804,142,107,35,100838,33390,134228
312125,201804,98,55,43,52279.2,41022,93301.2
312130,201804,121,82,39,78228,37206,115434
312140,201804,136,106,30,101124,28620,129744
312150,201804,46,36,10,34344,9540,43884
312160,201804,1527,1013,514,961919.2,488944.48,1450863.68
312170,201804,12,10,2,9540,1908,11448
312180,201804,98,59,39,55571,36920,92491
312190,201804,32,28,4,26712,3816,30528
312200,201804,739,638,101,606696.7,96354,703050.7
312210,201804,97,63,34,60102,32436,92538
312220,201804,123,91,32,86576,30528,117104
312230,201804,3511,1718,1793,1634725.98,1708904.58,3343630.56
312235,201804,153,101,52,96354,49608,145962
312240,201804,109,72,37,68688,35298,103986
312245,201804,165,111,54,105890,51516,157406
312247,201804,62,44,18,41213,17172,58385
312250,201804,182,84,98,79659,93492,173151
312260,201804,102,68,34,64013.4,32436,96449.4
312270,201804,136,85,51,81090,48654,129744
312280,201804,25,15,10,14310,9540,23850
312290,201804,163,111,52,105607.8,48655,154262.8
312300,201804,203,134,69,127836,65826,193662
312310,201804,59,54,5,51516,4770,56286
312320,201804,419,260,159,246132,150684.5,396816.5
312330,201804,85,74,11,69833,10207.8,80040.8
312340,201804,36,16,20,15264,19080,34344
312350,201804,16,10,6,9540,5724,15264
312352,201804,96,64,32,61056,30528,91584
312360,201804,557,253,304,240408,290016,530424
312370,201804,298,179,119,170479.8,113526,284005.8
312380,201804,137,88,49,83952,46746,130698
312385,201804,175,142,33,135468,31482,166950
312390,201804,300,186,114,177444,108089,285533
312400,201804,380,289,91,275706,86338,362044
312410,201804,882,283,599,269505,570870,840375
312420,201804,615,490,125,466792.2,119250,586042.2
312430,201804,864,638,226,606364.05,214650.2,821014.25
312440,201804,47,35,12,33390,11448,44838
312450,201804,209,128,81,122112,77274,199386
312460,201804,58,29,29,27666,27666,55332
312470,201804,55,36,19,34344,18126,52470
312480,201804,207,128,79,122112,75366,197478
312490,201804,263,181,82,172674,78228,250902
312500,201804,32,18,14,17172,13356,30528
312510,201804,436,166,270,158364,256964.39,415328.39
312520,201804,41,14,27,13356,25758,39114
312530,201804,49,37,12,35298,11448,46746
312540,201804,104,91,13,86814,12402,99216
312550,201804,40,31,9,29574,8586,38160
312560,201804,205,151,54,143768,51229.8,194997.8
312570,201804,440,265,175,252142.2,166258.45,418400.65
312580,201804,82,43,39,41022,37206,78228
312590,201804,271,213,58,203202,55332,258534
312595,201804,141,126,15,120204,14310,134514
312600,201804,76,46,30,43455,28620,72075
312610,201804,1633,864,769,816435.98,731909.6,1548345.58
312620,201804,190,135,55,128790,52465.23,181255.23
312630,201804,63,54,9,51516,8586,60102
312640,201804,48,13,35,12402,33390,45792
312650,201804,149,122,27,116102,25472,141574
312660,201804,71,53,18,50276,17172,67448
312670,201804,863,568,295,540919,281216.3,822135.3
312675,201804,42,31,11,29574,10494,40068
312680,201804,85,57,28,53996.4,26712,80708.4
312690,201804,235,126,109,120194.46,103699.8,223894.26
312695,201804,31,24,7,22896,6678,29574
312700,201804,215,125,90,119250,85860,205110
312705,201804,76,62,14,59148,13356,72504
312707,201804,95,70,25,66360.44,23850,90210.44
312710,201804,1876,998,878,950029.78,837401,1787430.78
312720,201804,67,33,34,31482,32436,63918
312730,201804,289,169,120,160272,114193.8,274465.8
312733,201804,52,44,8,41690,7632,49322
312735,201804,21,15,6,14310,5724,20034
312737,201804,67,36,31,34344,29574,63918
312738,201804,54,39,15,37206,14310,51516
312740,201804,73,50,23,47700,21942,69642
312750,201804,71,52,19,49608,18126,67734
312760,201804,269,197,72,187938,68688,256626
312770,201804,7632,3534,4098,3346419.99,3900828.73,7247248.72
312780,201804,431,331,100,315487.8,95400,410887.8
312790,201804,20,15,5,14310,4770,19080
312800,201804,1611,1132,479,1072507.28,455783.62,1528290.90
312810,201804,370,238,132,226765.8,125928,352693.8
312820,201804,195,147,48,140238,45792,186030
312825,201804,28,19,9,18126,8586,26712
312830,201804,286,170,116,160941,110025,270966
312840,201804,149,109,40,103986,38160,142146
312850,201804,26,23,3,21942,2862,24804
312860,201804,170,104,66,98930,62964,161894
312870,201804,990,517,473,490324.24,451242,941566.24
312880,201804,150,103,47,98118.9,44742.6,142861.5
312890,201804,165,114,51,108756,48654,157410
312900,201804,210,157,53,149110.2,50562,199672.2
312910,201804,187,95,92,89461.72,87768,177229.72
312920,201804,160,90,70,85860,66780,152640
312930,201804,341,247,94,235638,89676,325314
312940,201804,105,71,34,67734,32436,100170
312950,201804,699,460,239,437667.6,228006,665673.6
312960,201804,173,132,41,125928,39114,165042
312965,201804,52,48,4,45792,3816,49608
312970,201804,284,229,55,217512.2,52470,269982.2
312980,201804,2327,1230,1097,1169215.4,1045675.4,2214890.8
312990,201804,51,29,22,27666,20988,48654
313000,201804,40,25,15,23850,14310,38160
313005,201804,166,127,39,120919.5,36920,157839.5
313010,201804,937,382,555,363187.8,529174.8,892362.6
313020,201804,187,99,88,93969,83952,177921
313030,201804,205,134,71,125929,67734,193663
313040,201804,61,23,38,21942,36252,58194
313050,201804,292,201,91,190800.2,86814,277614.2
313055,201804,46,34,12,32436,11448,43884
313060,201804,129,86,43,82044,40131.6,122175.6
313065,201804,59,38,21,36252,20034,56286
313070,201804,151,80,71,76320,67734,144054
313080,201804,41,17,24,16218,22896,39114
313090,201804,710,492,218,468080.3,207972,676052.3
313100,201804,163,64,99,61056,94438,155494
313110,201804,127,75,52,71550,49608,121158
313115,201804,158,86,72,81843.66,68688,150531.66
313120,201804,752,412,340,392762,323120,715882
313130,201804,5256,2832,2424,2675753.52,2303930.86,4979684.38
313140,201804,158,81,77,77274,73458,150732
313150,201804,315,251,64,239454,60769.8,300223.8
313160,201804,198,143,55,136136,52470,188606
313170,201804,1351,947,404,890418.1,385025.4,1275443.5
313180,201804,330,197,133,187289.28,126882,314171.28
313190,201804,737,438,299,414799.4,284483,699282.4
313200,201804,24,23,1,21942,954,22896
313210,201804,1041,878,163,834609.16,155497.23,990106.39
313220,201804,238,162,76,153594,71788.5,225382.5
313230,201804,268,198,70,187939,66780,254719
313240,201804,1926,1028,898,978128.73,853729.83,1831858.56
313250,201804,1255,932,323,883502.6,306235.8,1189738.4
313260,201804,94,55,39,52470,37206,89676
313270,201804,965,565,400,535338.4,381600,916938.4
313280,201804,61,52,9,49131,8586,57717
313290,201804,227,183,44,174296,41022.8,215318.8
313300,201804,377,194,183,181929,174582,356511
313310,201804,227,118,109,112572,103986,216558
313320,201804,370,285,85,269935.1,81090,351025.1
313330,201804,1360,822,538,782757.2,512060.5,1294817.7
313340,201804,338,234,104,223236,99216,322452
313350,201804,526,352,174,333900.1,165996,499896.1
313360,201804,118,69,49,65826,46460,112286
313370,201804,190,70,120,66780,114480,181260
313375,201804,279,168,111,160272,105894,266166
313380,201804,1318,676,642,643015.08,612178,1255193.08
313390,201804,49,42,7,39114.8,6678,45792.8
313400,201804,424,278,146,265212,138712,403924
313410,201804,19,11,8,10494,7632,18126
313420,201804,4706,2442,2264,2319148.78,2152884.02,4472032.80
313430,201804,141,66,75,62964,71550,134514
313440,201804,1476,998,478,949851.1,454868,1404719.1
313450,201804,61,25,36,23850,34057.8,57907.8
313460,201804,370,174,196,164556,186984,351540
313470,201804,539,246,293,234684,278854.2,513538.2
313480,201804,157,107,50,101125,47700,148825
313490,201804,517,253,264,241357.23,251809,493166.23
313500,201804,22,14,8,13356,7632,20988
313505,201804,973,757,216,721574.2,205778,927352.2
313507,201804,94,55,39,52470,37206,89676
313510,201804,2778,1773,1005,1686679.56,957816,2644495.56
313520,201804,3606,2814,792,2669671.71,755564,3425235.71
313530,201804,43,29,14,27666,13356,41022
313535,201804,104,83,21,78515,20034,98549
313540,201804,71,55,16,52470,15264,67734
313545,201804,115,95,20,90630,19080,109710
313550,201804,232,189,43,180306,40736,221042
313560,201804,333,172,161,164088,153594,317682
313570,201804,60,31,29,29574,27666,57240
313580,201804,1304,709,595,674001,565913.4,1239914.4
313590,201804,83,50,33,47700,31482,79182
313600,201804,690,408,282,388946,268170,657116
313610,201804,59,47,12,44218.8,11448,55666.8
313620,201804,1362,722,640,677592.58,606583.55,1284176.13
313630,201804,1642,1252,390,1190974.4,371774,1562748.4
313640,201804,129,75,54,71550,51516,123066
313650,201804,237,109,128,103986,122112,226098
313652,201804,18,17,1,16218,954,17172
313655,201804,55,31,24,29574,22896,52470
313657,201804,47,44,3,41976,2862,44838
313660,201804,133,93,40,88722,38160,126882
313665,201804,644,314,330,299270,314581.5,613851.5
313670,201804,10372,7160,3212,6807006.68,3063103.8,9870110.48
313680,201804,41,30,11,28620,10106,38726
313690,201804,156,118,38,112572,36252,148824
313695,201804,72,54,18,51516,17172,68688
313700,201804,297,239,58,227720,55332,283052
313710,201804,152,102,50,97308,47700,145008
313720,201804,1084,516,568,489783.8,540527.86,1030311.66
313730,201804,60,41,19,39114,18126,57240
313740,201804,163,130,33,124020,31482,155502
313750,201804,442,325,117,309763.8,111618,421381.8
313753,201804,238,169,69,160558.2,65826,226384.2
313760,201804,1251,452,799,431208,759509.52,1190717.52
313770,201804,356,256,100,243700,95400,339100
313780,201804,760,393,367,374922,349831.8,724753.8
313790,201804,27,26,1,24804,954,25758
313800,201804,148,90,58,85860,55332,141192
313810,201804,68,40,28,38160,26712,64872
313820,201804,1285,635,650,604836.2,618837,1223673.2
313830,201804,66,48,18,45792,17172,62964
313835,201804,55,48,7,45792,6678,52470
313840,201804,1699,1042,657,988727.52,625252,1613979.52
313850,201804,181,62,119,59148,112946.06,172094.06
313860,201804,493,383,110,361901.3,104940,466841.3
313862,201804,172,114,58,108756,55332,164088
313865,201804,87,68,19,64872,18126,82998
313867,201804,49,38,11,36252,10494,46746
313868,201804,25,17,8,15455,7632,23087
313870,201804,126,66,60,62964,56954,119918
313880,201804,353,224,129,213696,122493.8,336189.8
313890,201804,321,170,151,161417.8,143481.6,304899.4
313900,201804,912,497,415,472517.5,395863,868380.5
313910,201804,139,100,39,95400,36252.2,131652.2
313920,201804,615,437,178,416707.2,169812,586519.2
313925,201804,31,27,4,25758,3816,29574
313930,201804,810,625,185,595678,176467,772145
313940,201804,1792,1129,663,1072496.43,631834.4,1704330.83
313950,201804,942,602,340,572496.6,324073.8,896570.4
313960,201804,1386,794,592,753212.3,563528,1316740.3
313970,201804,119,82,37,78228,35298,113526
313980,201804,213,139,74,132368,70596,202964
313990,201804,371,221,150,210648.63,143020.81,353669.44
314000,201804,927,629,298,596585.9,284287.23,880873.13
314010,201804,77,50,27,47700,25519.5,73219.5
314015,201804,52,17,35,16218,33390,49608
314020,201804,50,34,16,32436,15191.05,47627.05
314030,201804,87,40,47,37997.82,44838,82835.82
314040,201804,43,30,13,28620,12402,41022
314050,201804,317,187,130,178112,123209.1,301321.1
314053,201804,101,66,35,62010.4,33390,95400.4
314055,201804,302,178,124,169812,118296,288108
314060,201804,144,123,21,116388,20034,136422
314070,201804,1006,501,505,474149.14,481150,955299.14
314080,201804,219,143,76,135181.8,71454.88,206636.68
314085,201804,129,83,46,79182,43884,123066
314090,201804,354,256,98,244224,93487.23,337711.23
314100,201804,475,389,86,367291,81472,448763
314110,201804,694,373,321,354229.74,305518.6,659748.34
314120,201804,96,54,42,51516,40068,91584
314130,201804,25,12,13,11448,12402,23850
314140,201804,1094,662,432,627903.92,409552.86,1037456.78
314150,201804,162,103,59,98262,56286,154548
314160,201804,354,262,92,247086.8,87578,334664.8
314170,201804,73,55,18,52470,17172,69642
314180,201804,728,640,88,610274,82998.5,693272.5
314190,201804,103,60,43,57240,41022,98262
314200,201804,583,404,179,384145.6,169812,553957.6
314210,201804,281,211,70,200340,66494,266834
314220,201804,310,234,76,221329,72218,293547
314225,201804,63,44,19,41976,18126,60102
314230,201804,106,48,58,45792,55332,101124
314240,201804,137,105,32,100170,30528,130698
314250,201804,59,35,24,33390,22896,56286
314260,201804,189,95,94,90630,89676,180306
314270,201804,330,260,70,247277,66780,314057
314280,201804,688,383,305,365373,290970,656343
314290,201804,559,455,104,432830.5,98929.8,531760.3
314300,201804,412,292,120,275632,114433,390065
314310,201804,1465,987,478,939691.32,455991.97,1395683.29
314315,201804,36,29,7,27666,6678,34344
314320,201804,608,389,219,370533.8,208000.82,578534.62
314330,201804,10673,5377,5296,5118767.84,5047918.75,10166686.59
314340,201804,573,267,306,254145.8,291352,545497.8
314345,201804,31,25,6,23850,5724,29574
314350,201804,191,119,72,113526,68688,182214
314360,201804,77,47,30,44838,28620,73458
314370,201804,56,46,10,43884,9540,53424
314380,201804,91,65,26,62010,24804,86814
314390,201804,3228,2046,1182,1946351.3,1124671.4,3071022.7
314400,201804,682,488,194,462682.2,185076,647758.2
314410,201804,432,281,151,268074,144054,412128
314420,201804,19,9,10,8586,9540,18126
314430,201804,2516,901,1615,855806.3,1538026.75,2393833.05
314435,201804,270,155,115,147583.8,108756,256339.8
314437,201804,27,21,6,20034,5724,25758
314440,201804,98,70,28,66780,26712,93492
314450,201804,153,115,38,109710,36252,145962
314460,201804,661,304,357,290016,340578,630594
314465,201804,83,55,28,52470,26712,79182
314467,201804,67,56,11,53415,10494,63909
314470,201804,386,200,186,187348.52,176490.5,363839.02
314480,201804,1086,519,567,495126,540727.2,1035853.2
314490,201804,89,67,22,63918,20988,84906
314500,201804,316,209,107,199386,102078,301464
314505,201804,127,81,46,77274,43884,121158
314510,201804,226,183,43,174582,41022,215604
314520,201804,1251,645,606,608084.7,576168.9,1184253.6
314530,201804,724,570,154,543294,146916,690210
314535,201804,211,132,79,124878.6,75115.01,199993.61
314537,201804,62,37,25,35298,23850,59148
314540,201804,14,9,5,8586,4770,13356
314545,201804,50,32,18,30528,17172,47700
314550,201804,80,43,37,41022,35298,76320
314560,201804,810,435,375,412796,357750,770546
314570,201804,22,17,5,16218,4770,20988
314580,201804,18,9,9,8586,8586,17172
314585,201804,21,15,6,14310,5724,20034
314587,201804,85,73,12,69642,11448,81090
314590,201804,563,412,151,393048,144054,537102
314600,201804,998,646,352,611889.06,334472.6,946361.66
314610,201804,947,519,428,492264.7,408121.2,900385.9
314620,201804,152,112,40,105321.6,38160,143481.6
314625,201804,97,71,26,67162,24804,91966
314630,201804,1235,636,599,605265.3,571159.8,1176425.1
314640,201804,92,60,32,57240,30241.8,87481.8
314650,201804,201,116,85,110180.67,80613,190793.67
314655,201804,66,51,15,48654,14310,62964
314660,201804,20,15,5,14310,4770,19080
314670,201804,191,151,40,143768,38160,181928
314675,201804,220,127,93,121158,88722,209880
314690,201804,533,295,238,281143.8,227052,508195.8
314700,201804,2435,1331,1104,1264481.3,1052028.9,2316510.2
314710,201804,1623,950,673,901342.9,641422.1,1542765.0
314720,201804,408,244,164,231373.62,156456,387829.62
314730,201804,514,274,240,259966,228951,488917
314740,201804,687,339,348,321736.5,331992,653728.5
314750,201804,21,18,3,17172,2862,20034
314760,201804,323,154,169,146916,161216.46,308132.46
314770,201804,120,81,39,77274,37206,114480
314780,201804,21,6,15,5724,14310,20034
314790,201804,2360,1472,888,1397889.3,846474.66,2244363.96
314795,201804,53,45,8,42692,7632,50324
314800,201804,2943,1724,1219,1639410.66,1160628.2,2800038.86
314810,201804,1509,837,672,796161.5,639467,1435628.5
314820,201804,91,50,41,47700,39114,86814
314830,201804,209,165,44,156694.5,41690,198384.5
314840,201804,82,48,34,45792,32436,78228
314850,201804,356,174,182,165996,173628,339624
314860,201804,710,533,177,506478.86,167474.7,673953.56
314870,201804,1472,762,710,725994,677340,1403334
314875,201804,57,49,8,46746,7632,54378
314880,201804,47,34,13,32436,12402,44838
314890,201804,53,31,22,29574,20988,50562
314900,201804,33,27,6,25758,5724,31482
314910,201804,252,172,80,163801.8,76320,240121.8
314915,201804,157,137,20,130698,19080,149778
314920,201804,122,76,46,72504,43597.8,116101.8
314930,201804,1036,526,510,500279,486253.8,986532.8
314940,201804,52,40,12,38160,11448,49608
314950,201804,37,26,11,24804,10494,35298
314960,201804,58,43,15,41022,14310,55332
314970,201804,138,70,68,66494,64872,131366
314980,201804,307,197,110,185696.1,103986,289682.1
314990,201804,466,256,210,244224,199434.5,443658.5
314995,201804,201,65,136,62010,129734.46,191744.46
315000,201804,92,75,17,71550,16218,87768
315010,201804,46,30,16,28620,15264,43884
315015,201804,174,141,33,133788.96,31482,165270.96
315020,201804,72,63,9,60102,8586,68688
315030,201804,116,89,27,83952,25758,109710
315040,201804,68,50,18,47700,17172,64872
315050,201804,205,122,83,116388,79182,195570
315053,201804,39,34,5,32436,4770,37206
315057,201804,97,80,17,75938.4,16218,92156.4
315060,201804,71,63,8,58195.16,7632,65827.16
315070,201804,103,57,46,54378,43884,98262
315080,201804,375,307,68,292878,64872,357750
315090,201804,106,63,43,60102,41022,101124
315100,201804,79,39,40,37206,38160,75366
315110,201804,292,162,130,153690,124020,277710
315120,201804,1656,846,810,801886,771786,1573672
315130,201804,343,249,94,237546,89676,327222
315140,201804,532,313,219,296980.2,208926,505906.2
315150,201804,986,466,520,443611,495794,939405
315160,201804,215,110,105,104940,100170,205110
315170,201804,343,223,120,211789,114193.8,325982.8
315180,201804,3218,1360,1858,1293829.93,1768766,3062595.93
315190,201804,320,184,136,175155,129744,304899
315200,201804,1193,681,512,647862.2,487589.4,1135451.6
315210,201804,1555,888,667,843051.9,633898.2,1476950.1
315213,201804,46,27,19,25758,18126,43884
315217,201804,209,165,44,157410,41976,199386
315220,201804,1530,1170,360,1115274.4,343344.6,1458619.0
315230,201804,168,122,46,116102,43884,159986
315240,201804,427,272,155,259488,146668.5,406156.5
315250,201804,2556,1266,1290,1207186.83,1229410.86,2436597.69
315260,201804,151,92,59,86432.4,56286,142718.4
315270,201804,132,91,41,86241.6,38388.96,124630.56
315280,201804,698,458,240,436551,228950.46,665501.46
315290,201804,204,120,84,114480,79182.49,193662.49
315300,201804,73,49,24,46746,22896,69642
315310,201804,65,59,6,56286,5724,62010
315320,201804,162,91,71,86814,67734,154548
315330,201804,55,47,8,44838,7632,52470
315340,201804,423,297,126,282155.6,120204,402359.6
315350,201804,151,89,62,84906,59148,144054
315360,201804,97,51,46,48654,43884,92538
315370,201804,56,33,23,31482,21798.9,53280.9
315380,201804,12,7,5,6678,4770,11448
315390,201804,59,13,46,12402,43884,56286
315400,201804,819,613,206,579227.5,196524,775751.5
315410,201804,358,217,141,206732,134228,340960
315415,201804,61,47,14,44838,13356,58194
315420,201804,207,157,50,148681.1,47700,196381.1
315430,201804,679,396,283,376544,269505.8,646049.8
315440,201804,84,57,27,54378,25758,80136
315445,201804,256,206,50,196209.18,47700,243909.18
315450,201804,178,134,44,127836,41976,169812
315460,201804,3400,1703,1697,1621601.4,1616497.1,3238098.5
315470,201804,42,21,21,20034,20034,40068
315480,201804,63,24,39,22896,37206,60102
315490,201804,617,381,236,361422.9,225144,586566.9
315500,201804,22,14,8,13356,7632,20988
315510,201804,150,99,51,94446,48654,143100
315520,201804,71,62,9,59148,8586,67734
315530,201804,52,28,24,26712,22896,49608
315540,201804,237,156,81,148824,77274,226098
315550,201804,179,142,37,135468,35298,170766
315560,201804,738,588,150,559612.8,143100,702712.8
315570,201804,318,167,151,156323.7,144054,300377.7
315580,201804,663,435,228,414323,217512,631835
315590,201804,206,105,101,100170,96354,196524
315600,201804,293,214,79,204156,75176,279332
315610,201804,99,48,51,45792,48654,94446
315620,201804,34,27,7,25758,6678,32436
315630,201804,141,94,47,89676,44838,134514
315640,201804,61,36,25,34344,23850,58194
315645,201804,63,45,18,42930,16695,59625
315650,201804,168,122,46,116102,43311.6,159413.6
315660,201804,477,208,269,198432,256626,455058
315670,201804,2383,1193,1190,1135337.32,1134087.66,2269424.98
315680,201804,859,578,281,548931.6,267348.96,816280.56
315690,201804,689,473,216,450167.67,206064,656231.67
315700,201804,1914,1011,903,960622.37,861462,1822084.37
315710,201804,327,89,238,84906,227052,311958
315720,201804,437,277,160,264258,152640,416898
315725,201804,200,160,40,152640,38160,190800
315727,201804,43,22,21,20988,20034,41022
315730,201804,41,39,2,37206,1908,39114
315733,201804,88,58,30,55332,28620,83952
315737,201804,52,39,13,37206,12402,49608
315740,201804,45,39,6,37206,5724,42930
315750,201804,160,125,35,119250,33390,152640
315760,201804,48,33,15,31482,14310,45792
315765,201804,118,77,41,73458,39114,112572
315770,201804,229,137,92,130698,87482,218180
315780,201804,3315,1722,1593,1635548.14,1517338.58,3152886.72
315790,201804,211,162,49,154548,46173.6,200721.6
315800,201804,284,204,80,194616,76320,270936
315810,201804,97,58,39,55332,36920,92252
315820,201804,796,575,221,545975.34,210834,756809.34
315830,201804,143,82,61,78228,58194,136422
315840,201804,93,65,28,62010,26712,88722
315850,201804,259,192,67,183168,63918,247086
315860,201804,12,4,8,3816,7632,11448
315870,201804,35,27,8,25758,7632,33390
315880,201804,106,69,37,65826,35298,101124
315890,201804,78,60,18,57240,17172,74412
315895,201804,451,301,150,286105,142528,428633
315900,201804,71,34,37,32150,35298,67448
315910,201804,36,23,13,21703.5,12402,34105.5
315920,201804,183,119,64,113526,60102.9,173628.9
315930,201804,40,14,26,13356,24804,38160
315935,201804,149,117,32,111618,30519,142137
315940,201804,91,68,23,64872,21942,86814
315950,201804,65,46,19,43884,18126,62010
315960,201804,557,260,297,246771.58,282479.6,529251.18
315970,201804,37,28,9,26712,8586,35298
315980,201804,700,329,371,311343,353924.46,665267.46
315990,201804,255,151,104,143816,98921,242737
316000,201804,51,33,18,31482,16886,48368
316010,201804,76,64,12,61056,11448,72504
316020,201804,109,89,20,84906,19080,103986
316030,201804,405,215,190,204538,180736,385274
316040,201804,506,223,283,211788.2,269696,481484.2
316045,201804,59,53,6,50562,5724,56286
316050,201804,16,14,2,13356,1908,15264
316060,201804,95,62,33,59148,31482,90630
316070,201804,1058,685,373,647023.5,355079,1002102.5
316080,201804,102,63,39,60102,37206,97308
316090,201804,42,25,17,23182.2,16218,39400.2
316095,201804,72,60,12,56964,11448,68412
316100,201804,309,181,128,171863.3,122112,293975.3
316105,201804,34,23,11,21942,10494,32436
316110,201804,1928,1549,379,1467016.11,360898.2,1827914.31
316120,201804,80,60,20,57240,18793.8,76033.8
316130,201804,139,107,32,101411,30528,131939
316140,201804,27,20,7,19080,6678,25758
316150,201804,203,141,62,133798.5,59148,192946.5
316160,201804,84,50,34,47700,32436,80136
316165,201804,63,46,17,43694,15502.5,59196.5
316170,201804,206,139,67,131652,63918,195570
316180,201804,205,90,115,85526.1,109710,195236.1
316190,201804,143,103,40,97308,38160,135468
316200,201804,707,393,314,374922,298983.6,673905.6
316210,201804,769,516,253,491918.33,241362,733280.33
316220,201804,117,79,38,75366,36252,111618
316225,201804,24,14,10,13356,9540,22896
316230,201804,31,19,12,18126,11448,29574
316240,201804,621,505,116,481770,110664,592434
316245,201804,106,88,18,83952,17172,101124
316250,201804,1521,1061,460,1004544.5,437657.12,1442201.62
316255,201804,111,91,20,86432.4,19065.69,105498.09
316257,201804,185,97,88,92538,83665.8,176203.8
316260,201804,243,162,81,153251.06,77179,230430.06
316265,201804,26,17,9,16218,8586,24804
316270,201804,676,471,205,446567.6,195570,642137.6
316280,201804,544,338,206,320999.8,195856.6,516856.4
316290,201804,694,464,230,439794.98,219420,659214.98
316292,201804,507,205,302,195570,287870,483440
316294,201804,100,57,43,54378,41022,95400
316295,201804,289,129,160,121141,152640,273781
316300,201804,102,71,31,67734,29574,97308
316310,201804,34,17,17,16218,16218,32436
316320,201804,41,25,16,23850,15264,39114
316330,201804,132,86,46,81090.5,43597.8,124688.3
316340,201804,144,96,48,91584,45792,137376
316350,201804,193,139,54,132440,51516,183956
316360,201804,22,17,5,16218,4770,20988
316370,201804,1081,575,506,544754.5,482428.26,1027182.76
316380,201804,121,91,30,86814,28620,115434
316390,201804,123,88,35,83952,33390,117342
316400,201804,139,105,34,100170,32436,132606
316410,201804,305,224,81,212312.7,77274,289586.7
316420,201804,202,143,59,135706.5,56286,191992.5
316430,201804,158,80,78,76320,74412,150732
316440,201804,98,46,52,43884,49608,93492
316443,201804,39,35,4,33390,3816,37206
316447,201804,64,50,14,47700,13356,61056
316450,201804,223,168,55,160272,52470,212742
316460,201804,69,28,41,26712,39114,65826
316470,201804,1603,1155,448,1094164.44,425271.16,1519435.60
316480,201804,13,10,3,9540,2862,12402
316490,201804,18,7,11,6678,10494,17172
316500,201804,154,103,51,97975.8,48654,146629.8
316510,201804,163,123,40,116340.3,38160,154500.3
316520,201804,190,114,76,108183.6,72356,180539.6
316530,201804,158,113,45,107802,42643.8,150445.8
316540,201804,145,80,65,76320,62010,138330
316550,201804,139,99,40,94446,38160,132606
316553,201804,245,119,126,113017.33,120204,233221.33
316555,201804,33,25,8,23850,7632,31482
316556,201804,10,7,3,6678,2862,9540
316557,201804,18,14,4,13356,3816,17172
316560,201804,62,48,14,45792,13356,59148
316570,201804,243,220,23,209642,21942,231584
316580,201804,21,15,6,14310,5724,20034
316590,201804,113,97,16,92538,15264,107802
316600,201804,183,149,34,141860,32436,174296
316610,201804,64,45,19,42643.8,18126,60769.8
316620,201804,134,103,31,98262,29574,127836
316630,201804,44,32,12,30528,11448,41976
316640,201804,16,10,6,9540,5724,15264
316650,201804,69,51,18,48654,17172,65826
316660,201804,7,4,3,3816,2862,6678
316670,201804,441,157,284,149759,270363.8,420122.8
316680,201804,159,112,47,106848,44648,151496
316690,201804,193,122,71,116388,67734,184122
316695,201804,60,53,7,50562,6678,57240
316700,201804,15,8,7,7632,6678,14310
316710,201804,712,520,192,495842,183168,679010
316720,201804,4913,2503,2410,2373364.27,2294159.72,4667523.99
316730,201804,15,14,1,13356,954,14310
316740,201804,128,80,48,76320,45792,122112
316750,201804,19,13,6,12402,5724,18126
316760,201804,325,262,63,249948,60102,310050
316770,201804,143,81,62,77274,59148,136422
316780,201804,74,44,30,41670.72,28620,70290.72
316790,201804,56,43,13,41022,12402,53424
316800,201804,1809,1111,698,1057890.8,664176.2,1722067.0
316805,201804,18,10,8,9540,7632,17172
316810,201804,67,43,24,41022,22610,63632
316820,201804,38,19,19,18126,18126,36252
316830,201804,89,38,51,36252,47637,83889
316840,201804,504,303,201,288299,190800,479099
316850,201804,343,224,119,212312.7,113526,325838.7
316860,201804,6021,2674,3347,2536837.45,3189261.06,5726098.51
316870,201804,1464,948,516,896094.7,487496,1383590.7
316880,201804,117,65,52,61723.8,49608,111331.8
316890,201804,255,170,85,162133,81090,243223
316900,201804,418,286,132,270297.28,125928,396225.28
316905,201804,17,9,8,8586,7632,16218
316910,201804,51,26,25,24804,23850,48654
316920,201804,136,105,31,99455,29574,129029
316930,201804,1933,987,946,935828.3,900285.93,1836114.23
316935,201804,869,524,345,497655.72,328176,825831.72
316940,201804,1108,639,469,608652.4,446844.26,1055496.66
316950,201804,186,97,89,92538,84906,177444
316960,201804,1112,620,492,589318,469072.46,1058390.46
316970,201804,633,493,140,470322,133560,603882
316980,201804,110,67,43,63918,41012.46,104930.46
316990,201804,2188,1438,750,1364460.18,713535.96,2077996.14
317000,201804,328,254,74,242030,70596,312626
317005,201804,248,175,73,166950,69642,236592
317010,201804,6281,3458,2823,3277817.61,2691234.2,5969051.81
317020,201804,16255,7183,9072,6819864.43,8637461.29,15457325.72
317030,201804,85,33,52,31482,49391.26,80873.26
317040,201804,3117,1945,1172,1852221.28,1115036.61,2967257.89
317043,201804,72,52,20,49608,19080,68688
317047,201804,38,18,20,17172,19076,36248
317050,201804,181,134,47,127836,44838,172674
317052,201804,127,96,31,91584,29574,121158
317057,201804,204,152,52,145008,49036,194044
317060,201804,57,37,20,35298,18793.8,54091.8
317065,201804,59,46,13,43884,12402,56286
317070,201804,1962,927,1035,879589.7,986245.6,1865835.3
317075,201804,110,57,53,54378,50562,104940
317080,201804,826,432,394,411030.9,375686,786716.9
317090,201804,634,509,125,483249.5,119250,602499.5
317100,201804,416,311,105,294786,100170,394956
317103,201804,108,94,14,89676,13356,103032
317107,201804,36,32,4,30528,3816,34344
317110,201804,102,43,59,41022,56286,97308
317115,201804,41,35,6,33390,5724,39114
317120,201804,1827,929,898,878362.62,856235,1734597.62
317130,201804,1915,1228,687,1168563.4,654731,1823294.4
317140,201804,11,9,2,8586,1908,10494
317150,201804,270,161,109,153594,103222.8,256816.8
317160,201804,313,226,87,215287,82712,297999
317170,201804,209,145,64,138330,61056,199386
317180,201804,436,314,122,298840.5,116388,415228.5
317190,201804,255,173,82,165042,77941.8,242983.8
317200,201804,812,570,242,531388,230630,762018
317210,201804,154,89,65,83952.2,62010,145962.2
317220,201804,21,13,8,12402,7632,20034
320010,201804,620,462,158,437410.5,150732,588142.5
320013,201804,132,98,34,93492,32436,125928
320016,201804,282,179,103,170766,98262,269028
320020,201804,717,429,288,406716.75,272844.32,679561.07
320030,201804,152,114,38,108756,35918.1,144674.1
320035,201804,137,102,35,97308,33390,130698
320040,201804,503,257,246,245178,234684,479862
320050,201804,118,88,30,83952,28620,112572
320060,201804,1555,735,820,701143,781603.6,1482746.6
320070,201804,104,72,32,68688,30528,99216
320080,201804,763,436,327,413113,311958,725071
320090,201804,1209,842,367,799914.86,349259.6,1149174.46
320100,201804,321,182,139,173628,132606,306234
320110,201804,136,87,49,81138.2,46460,127598.2
320115,201804,113,93,20,88722,19080,107802
320120,201804,3294,1840,1454,1743820.2,1385438.64,3129258.84
320130,201804,7408,3535,3873,3350366.52,3688020.16,7038386.68
320140,201804,414,269,145,255291.2,138086,393377.2
320150,201804,1912,1122,790,1062580.02,753364.26,1815944.28
320160,201804,688,312,376,295445.03,357303.59,652748.62
320170,201804,113,88,25,83189,23850,107039
320180,201804,52,30,22,28620,20988,49608
320190,201804,235,156,79,148051.26,75080,223131.26
320200,201804,56,43,13,41022,12402,53424
320210,201804,846,476,370,452492.6,352008,804500.6
320220,201804,304,111,193,105894,183836,289730
320225,201804,78,63,15,60102,14310,74412
320230,201804,556,357,199,339052.4,189036,528088.4
320240,201804,3126,1570,1556,1495300.8,1481757.78,2977058.58
320245,201804,454,314,140,298411.4,133560,431971.4
320250,201804,231,122,109,115434.6,103986,219420.6
320255,201804,144,113,31,106495.02,29431,135926.02
320260,201804,179,126,53,120204,50514.3,170718.3
320265,201804,159,127,32,120348,30528,150876
320270,201804,153,125,28,119250,26712,145962
320280,201804,969,582,387,550268.2,368082.02,918350.22
320290,201804,66,56,10,53424,9540,62964
320300,201804,543,385,158,365115.8,149683.1,514798.9
320305,201804,667,363,304,346302,289826,636128
320310,201804,212,119,93,111571.5,87966,199537.5
320313,201804,308,157,151,149778,143768,293546
320316,201804,107,89,18,84906,17172,102078
320320,201804,3318,1507,1811,1431994,1724713.8,3156707.8
320330,201804,260,191,69,181551.3,63918.8,245470.1
320332,201804,884,537,347,510441.6,329989.3,840430.9
320334,201804,236,143,93,136136,88722,224858
320335,201804,147,106,41,100170.4,39114,139284.4
320340,201804,589,407,182,387134,172961,560095
320350,201804,967,414,553,392476.88,526722.48,919199.36
320360,201804,166,91,75,86528,71550,158078
320370,201804,240,184,56,173844,52391,226235
320380,201804,281,189,92,178637.3,87768,266405.3
320390,201804,1126,687,439,652880.8,418186.13,1071066.93
320400,201804,318,229,89,217513,84906,302419
320405,201804,899,385,514,366713.6,490043.92,856757.52
320410,201804,975,499,476,474377.4,453733.34,928110.74
320420,201804,479,245,234,233635,223236,456871
320425,201804,193,105,88,100170,83952,184122
320430,201804,390,221,169,209212.7,161226,370438.7
320435,201804,169,114,55,107935.56,52470,160405.56
320440,201804,203,122,81,116101.8,77274,193375.8
320450,201804,130,77,53,73458,50562,124020
320455,201804,246,201,45,190801,42930,233731
320460,201804,241,155,86,147870,82044,229914
320465,201804,114,77,37,73095.48,35298,108393.48
320470,201804,635,403,232,384158.26,221324,605482.26
320480,201804,179,120,59,113669.1,56286,169955.1
320490,201804,3022,1517,1505,1444309.18,1433825.92,2878135.10
320495,201804,93,56,37,53405,35298,88703
320500,201804,9457,4771,4686,4523136.17,4458321.59,8981457.76
320501,201804,551,280,271,267120,258534,525654
320503,201804,284,203,81,192708.2,77274,269982.2
320506,201804,257,194,63,185076,60102,245178
320510,201804,945,445,500,420691.6,475474.1,896165.7
320515,201804,79,67,12,62964.9,11448,74412.9
320517,201804,202,142,60,135468,57240,192708
320520,201804,6862,3067,3795,2911843.69,3612095.22,6523938.91
320530,201804,5291,2668,2623,2537493.02,2499092.23,5036585.25
330010,201804,3143,1616,1527,1534148.22,1453960.37,2988108.59
330015,201804,156,64,92,59912.08,87768,147680.08
330020,201804,3604,1562,2042,1487859.84,1947496,3435355.84
330022,201804,229,130,99,123305,93492.8,216797.8
330023,201804,533,183,350,173103.8,333900,507003.8
330025,201804,550,120,430,114480,409647.8,524127.8
330030,201804,1930,1234,696,1168895.18,660715.68,1829610.86
330040,201804,2363,1215,1148,1157250.1,1093763.3,2251013.4
330045,201804,8326,2630,5696,2500892.82,5427794.74,7928687.56
330050,201804,807,509,298,485586,284292,769878
330060,201804,894,558,336,528518.1,319228.28,847746.38
330070,201804,3470,1316,2154,1249507.47,2053601.56,3303109.03
330080,201804,1507,708,799,670169.3,761006.4,1431175.7
330090,201804,354,212,142,202248,135468,337716
330093,201804,288,129,159,123066,151650,274716
330095,201804,100,52,48,48940.2,45792,94732.2
330100,201804,9461,4879,4582,4645142.13,4367723.9,9012866.03
330110,201804,480,210,270,198909,257580,456489
330115,201804,526,306,220,291924,209880,501804
330120,201804,379,197,182,186793.2,172864.8,359658.0
330130,201804,1541,428,1113,407586.96,1061784,1469370.96
330140,201804,602,317,285,302400,270937,573337
330150,201804,448,266,182,251856,172674,424530
330160,201804,208,129,79,123066,75366,198432
330170,201804,26799,9503,17296,9044302.22,16487208.76,25531510.98
330180,201804,236,151,85,141507.02,80374.5,221881.52
330185,201804,813,332,481,315192.6,457606.8,772799.4
330187,201804,293,88,205,83952,195570,279522
330190,201804,5552,2225,3327,2112967.3,3170948.68,5283915.98
330200,201804,4451,1528,2923,1452753.06,2783575.76,4236328.82
330205,201804,395,243,152,231392.7,144722,376114.7
330210,201804,1008,618,390,584329.6,370390.9,954720.5
330220,201804,2549,1528,1021,1454326.5,973080.2,2427406.7
330225,201804,556,306,250,291285,237832.2,529117.2
330227,201804,2444,775,1669,736192.46,1591870.23,2328062.69
330230,201804,199,120,79,113813,75366,189179
330240,201804,3648,1908,1740,1815616.9,1656747.08,3472363.98
330245,201804,153,65,88,62010,83188.8,145198.8
330250,201804,6489,3377,3112,3210835.6,2960038.32,6170873.92
330260,201804,567,166,401,158364,382554,540918
330270,201804,3370,1251,2119,1192597,2020955.2,3213552.2
330280,201804,450,288,162,272960.08,154539,427499.08
330285,201804,7063,2314,4749,2202962.4,4528343.32,6731305.72
330290,201804,566,218,348,207972,331992,539964
330300,201804,760,508,252,480816.7,240390,721206.7
330310,201804,416,238,178,225144.7,169812,394956.7
330320,201804,8151,3085,5066,2934888.8,4826597.24,7761486.04
330330,201804,9275,3641,5634,3466763.2,5370270.13,8837033.33
330340,201804,2642,1573,1069,1498439.06,1019806.92,2518245.98
330350,201804,17936,7105,10831,6751566.99,10312192.71,17063759.70
330360,201804,2546,1264,1282,1204883.2,1223019,2427902.2
330370,201804,998,553,445,526608,422527.6,949135.6
330380,201804,856,370,486,352254.96,463024.8,815279.76
330385,201804,604,317,287,301465,273798,575263
330390,201804,5158,2864,2294,2717390.57,2185914.4,4903304.97
330395,201804,260,165,95,155693.1,88865.2,244558.3
330400,201804,678,349,329,329512.6,311681.08,641193.68
330410,201804,500,355,145,337002,137840.33,474842.33
330411,201804,230,131,99,124793,94398.3,219191.3
330412,201804,252,104,148,98930,141192,240122
330414,201804,6123,2494,3629,2376168,3460092.3,5836260.3
330415,201804,575,269,306,255672,290970.8,546642.8
330420,201804,2276,1201,1075,1142769.6,1022976,2165745.6
330430,201804,1791,828,963,787241.8,916699.8,1703941.6
330440,201804,266,122,144,116388,137376,253764
330450,201804,121,51,70,48654,66780,115434
330452,201804,1738,824,914,784400.3,871633.76,1656034.06
330455,201804,110804,39699,71105,37795132.38,67771119.86,105566252.24
330460,201804,265,108,157,103032,149778,252810
330470,201804,1240,677,563,639564.98,537092.46,1176657.44
330475,201804,1406,377,1029,357694.36,981093.6,1338787.96
330480,201804,749,397,352,378070.2,333614.6,711684.8
330490,201804,13667,4788,8879,4561375.23,8464363.96,13025739.19
330500,201804,1345,617,728,588474.9,694131,1282605.9
330510,201804,11233,3787,7446,3605091.86,7096221.34,10701313.20
330513,201804,103,50,53,47700,50562,98262
330515,201804,850,354,496,334645,472803,807448
330520,201804,2523,942,1581,898449,1508121.9,2406570.9
330530,201804,226,118,108,112048,102842,214890
330540,201804,352,175,177,166950,168381,335331
330550,201804,3061,1086,1975,1033612.2,1881860.8,2915473.0
330555,201804,761,284,477,270917,454104.8,725021.8
330560,201804,550,205,345,195570,329112,524682
330570,201804,253,176,77,167904,73458,241362
330575,201804,805,335,470,319352,446325.5,765677.5
330580,201804,3373,1893,1480,1800020,1410155.7,3210175.7
330590,201804,305,152,153,145008,145962,290970
330600,201804,1102,705,397,670433.24,377040.84,1047474.08
330610,201804,1521,839,682,793311.54,646479.9,1439791.44
330615,201804,192,146,46,139284,43884,183168
330620,201804,994,439,555,417376.6,528039.8,945416.4
330630,201804,3872,2469,1403,2340601.05,1331120.8,3671721.85
350010,201804,592,389,203,369246.67,193662,562908.67
350020,201804,41,21,20,20034,19080,39114
350030,201804,526,341,185,324170,175300.66,499470.66
350040,201804,127,50,77,47356.56,73458,120814.56
350050,201804,290,159,131,151686,124717.46,276403.46
350055,201804,85,47,38,44838,36252,81090
350060,201804,74,27,47,25758,44838,70596
350070,201804,809,472,337,446055.58,319831.56,765887.14
350075,201804,65,44,21,41976,20034,62010
350080,201804,52,33,19,30845.96,18126,48971.96
350090,201804,98,55,43,52470,41017.23,93487.23
350100,201804,293,184,109,174820.5,103986,278806.5
350110,201804,58,36,22,34344,20988,55332
350115,201804,156,94,62,89008.2,59148,148156.2
350120,201804,112,75,37,71550,35298,106848
350130,201804,359,175,184,166378,175536,341914
350140,201804,35,21,14,19271,13356,32627
350150,201804,71,56,15,53424,14310,67734
350160,201804,2521,981,1540,932805.16,1467805.91,2400611.07
350170,201804,406,246,160,232776.2,152354,385130.2
350180,201804,181,95,86,90630,82044,172674
350190,201804,976,501,475,475666.64,452849.69,928516.33
350200,201804,67,24,43,22896,40757.08,63653.08
350210,201804,1352,764,588,721155.33,560434.66,1281589.99
350220,201804,665,572,93,541550.73,88722,630272.73
350230,201804,83,58,25,55332,23850,79182
350240,201804,63,48,15,45792,14310,60102
350250,201804,1219,611,608,577171.6,579498.06,1156669.66
350260,201804,94,67,27,63918,25758,89676
350270,201804,828,541,287,515036.58,272348.92,787385.50
350275,201804,299,116,183,110283,174582,284865
350280,201804,4732,2421,2311,2297759.32,2201871.65,4499630.97
350290,201804,406,191,215,181923.23,204537.8,386461.03
350300,201804,49,26,23,24804,21942,46746
350310,201804,96,68,28,64872,26712,91584
350315,201804,38,23,15,21942,14310,36252
350320,201804,3263,1622,1641,1542572.5,1564733.8,3107306.3
350330,201804,1680,892,788,846867.96,750448.04,1597316.00
350335,201804,20,13,7,12402,6678,19080
350340,201804,131,63,68,60102,63918.9,124020.9
350350,201804,96,47,49,44838,46746,91584
350360,201804,131,88,43,83948,41022,124970
350370,201804,96,57,39,53741.96,37196.46,90938.42
350380,201804,749,317,432,301750.2,411364.8,713115.0
350390,201804,1423,576,847,548708.35,806893.4,1355601.75
350395,201804,25,20,5,19080,4770,23850
350400,201804,1691,903,788,852666.92,748200.16,1600867.08
350410,201804,2257,1015,1242,965220.96,1183945.03,2149165.99
350420,201804,233,142,91,134865,86814,221679
350430,201804,73,43,30,40450,28620,69070
350440,201804,151,111,40,104892.5,38160,143052.5
350450,201804,1626,1010,616,956420.95,587569,1543989.95
350460,201804,337,122,215,116388,204823.8,321211.8
350470,201804,14,10,4,9540,3816,13356
350480,201804,158,87,71,82998,67734,150732
350490,201804,241,119,122,112572.8,116388,228960.8
350500,201804,38,18,20,17172,19080,36252
350510,201804,164,110,54,104940,51516,156456
350520,201804,454,214,240,200975.96,228323.96,429299.92
350530,201804,453,217,236,207018,225144,432162
350535,201804,67,52,15,49350.42,14310,63660.42
350540,201804,374,192,182,182354.04,173342,355696.04
350550,201804,2740,1606,1134,1523590.38,1080732.07,2604322.45
350560,201804,642,448,194,427387.23,184718.25,612105.48
350570,201804,4168,1739,2429,1653535.98,2314759.2,3968295.18
350580,201804,373,179,194,169813,185062.46,354875.46
350590,201804,896,489,407,466506,387324,853830
350600,201804,6205,3129,3076,2970578.84,2929852.59,5900431.43
350610,201804,1541,788,753,745676.19,718353,1464029.19
350620,201804,36,24,12,22896,11448,34344
350630,201804,240,135,105,127836.96,99217,227053.96
350635,201804,883,350,533,333614,507835.21,841449.21
350640,201804,118,87,31,82998,29574,112572
350650,201804,1889,1242,647,1180414.31,615888.93,1796303.24
350660,201804,759,342,417,325624.05,396860,722484.05
350670,201804,309,160,149,152402,142146,294548
350680,201804,180,98,82,93492,78228,171720
350690,201804,198,99,99,94446,94446,188892
350700,201804,717,347,370,327703.94,352980,680683.94
350710,201804,334,137,197,130125.6,187938,318063.6
350715,201804,50,43,7,41022,6678,47700
350720,201804,17,12,5,11448,4770,16218
350730,201804,44,29,15,27666,14310,41976
350740,201804,211,118,93,112276.26,88722,200998.26
350745,201804,19,10,9,9516,8586,18102
350750,201804,2157,1384,773,1312048.74,736805.96,2048854.70
350760,201804,3744,1623,2121,1546005.86,2020594.42,3566600.28
350770,201804,62,42,20,40068,19080,59148
350775,201804,51,37,14,35298,13347,48645
350780,201804,425,211,214,201294,204156,405450
350790,201804,365,160,205,152640,195570,348210
350800,201804,436,246,190,234684,181260,415944
350810,201804,521,421,100,400681,95400,496081
350820,201804,85,52,33,49608,31482,81090
350830,201804,80,45,35,42930,33390,76320
350840,201804,741,331,410,315536,389900,705436
350850,201804,1770,1020,750,967072.34,715459.46,1682531.80
350860,201804,585,341,244,321481.72,232776,554257.72
350870,201804,441,299,142,285246,135181.8,420427.8
350880,201804,285,155,130,145010.1,123352.2,268362.3
350890,201804,44,27,17,25758,16218,41976
350900,201804,1467,476,991,451669.93,944650.8,1396320.73
350910,201804,27,17,10,16218,9540,25758
350920,201804,596,331,265,315456.04,252810,568266.04
350925,201804,1172,631,541,598932.34,514397.4,1113329.74
350930,201804,96,58,38,55332,36252,91584
350940,201804,725,408,317,387705.6,300577.6,688283.2
350945,201804,106,79,27,74830,25758,100588
350950,201804,15355,7389,7966,7021357.23,7589383.53,14610740.76
350960,201804,1287,599,688,566764.96,656348,1223112.96
350970,201804,1126,606,520,575551.96,495784.46,1071336.42
350980,201804,96,65,31,62010,29574,91584
350990,201804,361,130,231,122370.72,220156.08,342526.80
350995,201804,33,17,16,16218,15264,31482
351000,201804,642,454,188,430892.07,179352,610244.07
351010,201804,51,30,21,28620,20034,48654
351015,201804,57,41,16,39114,15264,54378
351020,201804,1660,960,700,914176.82,665606,1579782.82
351030,201804,333,230,103,216844.2,98262,315106.2
351040,201804,854,461,393,438840,373968.66,812808.66
351050,201804,3275,1554,1721,1474231.01,1640500.5,3114731.51
351060,201804,5047,2068,2979,1962349.82,2838931.89,4801281.71
351070,201804,417,265,152,250302.92,145008,395310.92
351080,201804,808,583,225,556182,213696,769878
351090,201804,63,27,36,25758,34344,60102
351100,201804,459,267,192,252496.48,183163.23,435659.71
351110,201804,2119,1015,1104,962272.08,1050589.2,2012861.28
351120,201804,72,37,35,35298,33390,68688
351130,201804,175,61,114,58194,108756,166950
351140,201804,340,238,102,225525.64,97308,322833.64
351150,201804,402,206,196,195335.8,186984,382319.8
351160,201804,244,160,84,152640,80136,232776
351170,201804,187,99,88,94446,83189,177635
351190,201804,90,61,29,58194,27666,85860
351200,201804,378,245,133,233126.04,126882,360008.04
351210,201804,130,62,68,58893.38,64872,123765.38
351220,201804,525,315,210,296937.12,200340,497277.12
351230,201804,278,203,75,193025.96,71530.92,264556.88
351240,201804,229,98,131,93301.2,124974,218275.2
351250,201804,73,50,23,47476,21752,69228
351260,201804,155,114,41,108756,38828,147584
351270,201804,50,21,29,20034,27666,47700
351280,201804,1108,501,607,475094.46,578246.38,1053340.84
351290,201804,226,100,126,95400,119918,215318
351300,201804,3739,1741,1998,1654330.15,1905714,3560044.15
351310,201804,771,398,373,379692,355556,735248
351320,201804,108,66,42,62964,40068,103032
351330,201804,40,27,13,25758,12402,38160
351340,201804,1250,776,474,733768.93,451212.23,1184981.16
351350,201804,2488,1356,1132,1290906.07,1079637.03,2370543.10
351360,201804,777,387,390,368244,371742.04,739986.04
351370,201804,368,192,176,183163.23,167267.96,350431.19
351380,201804,8930,4077,4853,3873819.23,4619217.78,8493037.01
351385,201804,30,20,10,19080,9540,28620
351390,201804,288,212,76,201294.02,72504,273798.02
351400,201804,67,42,25,40068,23812.92,63880.92
351410,201804,440,272,168,258217.04,160272,418489.04
351420,201804,60,49,11,46746,10494,57240
351430,201804,73,39,34,37206,32436,69642
351440,201804,787,546,241,518689.76,229910,748599.76
351450,201804,255,128,127,122112,121158,243270
351460,201804,122,55,67,51755,63918,115673
351470,201804,138,74,64,70596,61056,131652
351480,201804,521,295,226,280190.96,215484.75,495675.71
351490,201804,293,104,189,99216,180306,279522
351492,201804,32,23,9,21942,8586,30528
351495,201804,27,18,9,17172,8586,25758
351500,201804,3547,1547,2000,1470476.79,1903088.41,3373565.20
351510,201804,1784,748,1036,713306,986140.26,1699446.26
351512,201804,21,18,3,17172,2862,20034
351515,201804,193,112,81,106848,77274,184122
351518,201804,762,469,293,446468,279522,725990
351519,201804,77,49,28,46746,26712,73458
351520,201804,146,89,57,84269.96,54378,138647.96
351530,201804,22,14,8,13356,7632,20988
351535,201804,135,75,60,71550,57240,128790
351540,201804,460,331,129,313391,123066,436457
351550,201804,1331,808,523,766794.96,497024.86,1263819.82
351560,201804,73,38,35,36252,33390,69642
351565,201804,11,7,4,6678,3816,10494
351570,201804,2564,1328,1236,1264588.35,1178477.65,2443066.00
351580,201804,39,35,4,33390,3816,37206
351590,201804,67,45,22,42930,20988,63918
351600,201804,195,148,47,141192,44838,186030
351610,201804,61,30,31,28620,29574,58194
351620,201804,5926,3386,2540,3221486.25,2420941.11,5642427.36
351630,201804,2547,1315,1232,1249195.43,1172843.23,2422038.66
351640,201804,1662,813,849,773717.38,807227.8,1580945.18
351650,201804,30,25,5,23850,4770,28620
351660,201804,157,101,56,95400,53424,148824
351670,201804,748,468,280,444136,267120,711256
351680,201804,73,60,13,57240,12402,69642
351685,201804,40,25,15,23850,14310,38160
351690,201804,309,218,91,206107.63,86814,292921.63
351700,201804,162,114,48,108756,45792,154548
351710,201804,74,53,21,50562,20034,70596
351720,201804,133,63,70,60102,66780,126882
351730,201804,101,73,28,68688.96,26707.23,95396.19
351740,201804,718,486,232,461164.76,221323.23,682487.99
351750,201804,368,155,213,147234,203202,350436
351760,201804,790,615,175,586949,166950,753899
351770,201804,287,246,41,234684,39114,273798
351780,201804,171,98,73,93483,69642,163125
351790,201804,240,125,115,119250,109710,228960
351800,201804,53,35,18,33390,17172,50562
351810,201804,126,84,42,80136,40068,120204
351820,201804,881,635,246,601021.6,234393.23,835414.83
351830,201804,508,184,324,174772.8,309096,483868.8
351840,201804,1877,950,927,897356,882857.71,1780213.71
351850,201804,231,169,62,160606.8,59148,219754.8
351860,201804,757,504,253,475094.84,241071.23,716166.07
351870,201804,5647,2667,2980,2533867.94,2836591.59,5370459.53
351880,201804,19024,8328,10696,7922179.67,10188174.06,18110353.73
351885,201804,89,60,29,56525,27666,84191
351890,201804,72,61,11,58194,10494,68688
351900,201804,224,134,90,127169,85860,213029
351905,201804,78,34,44,32436,41976,74412
351907,201804,3128,1372,1756,1306019.06,1673145.8,2979164.86
351910,201804,180,75,105,71550,100170,171720
351920,201804,133,75,58,71550,55309.69,126859.69
351925,201804,88,60,28,57240,26712,83952
351930,201804,378,258,120,246036.6,114480,360516.6
351940,201804,234,104,130,99216,124020,223236
351950,201804,142,83,59,79182,56286,135468
351960,201804,867,405,462,386188.73,438592.36,824781.09
351970,201804,1908,1018,890,969025.84,848193,1817218.84
351980,201804,146,73,73,67734,69642,137376
351990,201804,278,187,91,177444,86012.64,263456.64
352000,201804,364,220,144,209880,137376,347256
352010,201804,355,212,143,202248,136422,338670
352020,201804,203,68,135,64872,128790,193662
352030,201804,1018,526,492,501088.5,467777.96,968866.46
352040,201804,577,253,324,241362,309096,550458
352042,201804,281,95,186,90630,177158,267788
352044,201804,395,234,161,222081.86,153594,375675.86
352050,201804,3182,1291,1891,1224541.18,1802478.26,3027019.44
352060,201804,105,65,40,62010,38160,100170
352070,201804,103,74,29,69326,27666,96992
352080,201804,66,41,25,38160,23850,62010
352090,201804,174,115,59,109710,56286,165996
352100,201804,253,125,128,119246,120960,240206
352110,201804,112,33,79,31482,75366,106848
352115,201804,71,27,44,25758,41976,67734
352120,201804,98,65,33,62010,31482,93492
352130,201804,219,183,36,174582,34344,208926
352140,201804,184,75,109,71073,103986,175059
352150,201804,122,67,55,62964.04,52470,115434.04
352160,201804,131,87,44,82998,41976,124974
352170,201804,375,255,120,242316.04,114480,356796.04
352180,201804,611,410,201,389519.5,191750,581269.5
352190,201804,259,101,158,96344.46,150693.84,247038.30
352200,201804,32,16,16,15264,15264,30528
352210,201804,3799,1585,2214,1503813.87,2104998.99,3608812.86
352215,201804,54,30,24,28620,22438.08,51058.08
352220,201804,6909,2720,4189,2589373.44,3993519.39,6582892.83
352230,201804,3205,2044,1161,1937243.43,1100932.65,3038176.08
352240,201804,2234,1310,924,1247461.75,879199.08,2126660.83
352250,201804,2589,1338,1251,1273179.5,1189389.96,2462569.46
352260,201804,1077,586,491,557227.23,468128,1025355.23
352265,201804,62,27,35,25758,33390,59148
352270,201804,409,234,175,222282.92,166894,389176.92
352280,201804,400,250,150,237229,143095.23,380324.23
352290,201804,176,112,64,106848,61056,167904
352300,201804,102,76,26,72504,24804,97308
352310,201804,5769,2822,2947,2679211.83,2805410.74,5484622.57
352320,201804,970,506,464,479229.84,440605.1,919834.94
352330,201804,528,242,286,230534.1,272558,503092.1
352340,201804,1399,680,719,646068,683876.5,1329944.5
352350,201804,332,210,122,200340,116102,316442
352360,201804,230,96,134,90677.7,124953.32,215631.02
352370,201804,101,70,31,66780,29574,96354
352380,201804,121,75,46,71550,43884,115434
352390,201804,2453,1124,1329,1068795.32,1266704,2335499.32
352400,201804,475,203,272,192946.5,259201.8,452148.3
352410,201804,771,553,218,523057.88,207686,730743.88
352420,201804,103,66,37,62964,35298,98262
352430,201804,1764,786,978,744791.84,930379.5,1675171.34
352440,201804,3138,1608,1530,1524955.48,1457672.67,2982628.15
352450,201804,191,160,31,152640,29574,182214
352460,201804,573,295,278,280872.68,264497.2,545369.88
352470,201804,597,203,394,193662,375867,569529
352480,201804,1374,767,607,730445.96,578505.8,1308951.76
352490,201804,84,32,52,30528,49608,80136
352500,201804,1210,539,671,512680.6,638981.2,1151661.8
352510,201804,739,401,338,381600.96,322452,704052.96
352520,201804,541,241,300,229914,286056.9,515970.9
352530,201804,1738,921,817,878634,779036.6,1657670.6
352540,201804,74,49,25,46746,23850,70596
352550,201804,181,104,77,99216,72790.2,172006.2
352560,201804,50,40,10,38160,9540,47700
352570,201804,666,348,318,331389,303372,634761
352580,201804,57,38,19,35298.65,18126,53424.65
352585,201804,17,5,12,4770,11448,16218
352590,201804,4359,2204,2155,2096433.09,2054969.41,4151402.50
352600,201804,358,248,110,235638.96,104940,340578.96
352610,201804,939,439,500,416545.33,477000,893545.33
352620,201804,957,387,570,368244.2,543780,912024.2
352630,201804,170,66,104,62964,99206.46,162170.46
352640,201804,560,393,167,371870.36,159318,531188.36
352650,201804,87,57,30,54378,28620,82998
352660,201804,80,47,33,44838,31482,76320
352670,201804,1666,905,761,860839.89,724904.6,1585744.49
352680,201804,896,575,321,545318.56,304772.04,850090.60
352690,201804,4352,2000,2352,1899285.88,2239942.69,4139228.57
352700,201804,108,63,45,59815.8,42930,102745.8
352710,201804,1366,729,637,693558,603801.52,1297359.52
352720,201804,1327,640,687,608016.2,655107.23,1263123.43
352725,201804,26,24,2,22896,1908,24804
352730,201804,363,181,182,171495.81,173628,345123.81
352740,201804,422,266,156,251809.68,148824,400633.68
352750,201804,22,14,8,13069.8,7632,20701.8
352760,201804,201,144,57,137376,54378,191754
352770,201804,81,63,18,60102,17172,77274
352780,201804,79,44,35,41976,33390,75366
352790,201804,28,23,5,21942,4770,26712
352800,201804,249,170,79,162180,75079.8,237259.8
352810,201804,166,109,57,101475.42,54378,155853.42
352820,201804,66,52,14,48896.32,13356,62252.32
352830,201804,90,62,28,59148,26712,85860
352840,201804,601,310,291,294453.2,277614,572067.2
352850,201804,1374,493,881,469654.2,840474,1310128.2
352860,201804,134,88,46,83316,43884,127200
352870,201804,45,29,16,27666,15264,42930
352880,201804,191,129,62,123046.92,59148,182194.92
352885,201804,28,20,8,19080,7632,26712
352890,201804,57,39,18,37206,16886,54092
352900,201804,4879,2357,2522,2229323.71,2398461.82,4627785.53
352910,201804,38,31,7,29574,6678,36252
352920,201804,709,435,274,414036,261396,675432
352930,201804,1274,619,655,589093.82,621881.64,1210975.46
352940,201804,6335,2753,3582,2614768.04,3414066.64,6028834.68
352950,201804,93,38,55,36252,52470,88722
352960,201804,65,42,23,40068,21942,62010
352965,201804,19,8,11,7632,10494,18126
352970,201804,467,348,119,328784.97,112573,441357.97
352980,201804,173,92,81,87768,77274,165042
352990,201804,965,420,545,399677.27,518842.09,918519.36
353000,201804,67,31,36,29574,34344,63918
353010,201804,547,336,211,320544,201274.92,521818.92
353020,201804,289,212,77,202248,73458,275706
353030,201804,1199,545,654,518958.28,623229.66,1142187.94
353040,201804,87,54,33,51516,31482,82998
353050,201804,1327,845,482,798485.03,459732.6,1258217.63
353060,201804,8058,3647,4411,3463373.04,4201851.84,7665224.88
353070,201804,1640,1034,606,980463.42,576833.38,1557296.80
353080,201804,1331,705,626,670233.55,596246,1266479.55
353090,201804,56,34,22,32436,20988,53424
353100,201804,62,51,11,48654,10494,59148
353110,201804,2042,621,1421,590702.88,1353665.26,1944368.14
353120,201804,80,42,38,40068,36252,76320
353130,201804,876,439,437,417842.46,416785.68,834628.14
353140,201804,559,218,341,207911,325314,533225
353150,201804,362,205,157,194616,149768.46,344384.46
353160,201804,101,83,18,79182,17172,96354
353170,201804,195,65,130,62010,123992.46,186002.46
353180,201804,960,437,523,414890.69,498418,913308.69
353190,201804,486,348,138,330936.9,131366,462302.9
353200,201804,195,98,97,93492,92538,186030
353205,201804,25,18,7,17172,6678,23850
353210,201804,88,53,35,50562,33390,83952
353215,201804,54,32,22,30528,20988,51516
353220,201804,86,47,39,44838,36252.27,81090.27
353230,201804,162,64,98,61056,93492,154548
353240,201804,298,163,135,155502,128790,284292
353250,201804,205,108,97,103032,92538,195570
353260,201804,461,332,129,315593.5,123056.46,438649.96
353270,201804,69,50,19,47700,17458.2,65158.2
353280,201804,93,48,45,45315,42930,88245
353282,201804,122,89,33,84906,31482,116388
353284,201804,23,19,4,18126,3816,21942
353286,201804,1,1,0,954,0,954
353290,201804,80,47,33,44838,31473,76311
353300,201804,401,222,179,210246.46,170766,381012.46
353310,201804,54,48,6,45792,5724,51516
353320,201804,62,39,23,37206,21942,59148
353325,201804,58,34,24,32427,22592,55019
353330,201804,67,51,16,48511,15264,63775
353340,201804,625,203,422,193662,402002.26,595664.26
353350,201804,921,432,489,411137.64,465249,876386.64
353360,201804,110,88,22,83634.04,20702,104336.04
353370,201804,121,71,50,66780.1,47700,114480.1
353380,201804,26,18,8,17168,7632,24800
353390,201804,1066,506,560,482724,534240,1016964
353400,201804,52,31,21,29574,20034,49608
353410,201804,119,75,44,71550,41929,113479
353420,201804,57,23,34,21942,32436,54378
353430,201804,554,367,187,346397.3,178111.8,524509.1
353440,201804,10233,4476,5757,4258405.91,5485064.49,9743470.40
353450,201804,56,30,26,28620,24804,53424
353460,201804,615,337,278,318329.1,264487.5,582816.6
353470,201804,2145,1165,980,1107457.85,932514.23,2039972.08
353475,201804,240,161,79,150904.96,75366,226270.96
353480,201804,187,151,36,144054,34344,178398
353490,201804,236,141,95,134514,90630,225144
353500,201804,188,109,79,102746.96,75366,178112.96
353510,201804,103,73,30,69623.46,28610.46,98233.92
353520,201804,206,139,67,132606,63918,196524
353530,201804,473,259,214,247086,204156,451242
353540,201804,357,235,122,223867.27,116388,340255.27
353550,201804,740,504,236,477002.88,225144,702146.88
353560,201804,643,274,369,259830.69,351426.06,611256.75
353570,201804,60,31,29,29574,27666,57240
353580,201804,358,276,82,262827,78228,341055
353590,201804,87,60,27,56922.04,25758,82680.04
353600,201804,273,154,119,146599,112890,259489
353610,201804,114,60,54,57240,51516,108756
353620,201804,572,311,261,294707.5,248707.8,543415.3
353625,201804,50,28,22,26712,20988,47700
353630,201804,238,170,68,158485.4,64872,223357.4
353640,201804,127,86,41,81567,39114,120681
353650,201804,867,340,527,322261.2,502758,825019.2
353657,201804,23,17,6,16218,5724,21942
353660,201804,253,142,111,135468,105607.8,241075.8
353670,201804,765,453,312,431208.2,297648,728856.2
353680,201804,100,71,29,67210,27666,94876
353690,201804,47,37,10,34989,9540,44529
353700,201804,284,201,83,191754,79182,270936
353710,201804,426,197,229,186984.8,218180,405164.8
353715,201804,46,34,12,32149.8,11448,43597.8
353720,201804,362,168,194,160254,185076,345330
353730,201804,1123,691,432,656304.9,412128,1068432.9
353740,201804,647,358,289,341245.8,275706,616951.8
353750,201804,92,58,34,54800.14,32436,87236.14
353760,201804,2773,1047,1726,996779.11,1643001.28,2639780.39
353770,201804,97,81,16,76797,15264,92061
353780,201804,1139,567,572,539201.96,543494,1082695.96
353790,201804,509,293,216,277453.5,203239.35,480692.85
353800,201804,3285,1671,1614,1585389.69,1537381.49,3122771.18
353810,201804,236,132,104,125074.71,99189,224263.71
353820,201804,187,93,94,88722,89051.41,177773.41
353830,201804,47,40,7,38160,6678,44838
353850,201804,169,86,83,82044,79182,161226
353860,201804,470,214,256,203440.5,243937.8,447378.3
353870,201804,5025,2531,2494,2396787.09,2368090.6,4764877.69
353880,201804,683,488,195,464216.4,185076.12,649292.52
353890,201804,586,330,256,314248,243938,558186
353900,201804,133,66,67,62964,63918,126882
353910,201804,176,87,89,82998,84906,167904
353920,201804,454,246,208,233492.4,197989.16,431481.56
353930,201804,1004,593,411,564029.79,390859.8,954889.59
353940,201804,188,101,87,95590.8,82140,177730.8
353950,201804,516,321,195,305947.8,186021,491968.8
353960,201804,70,57,13,54378,12402,66780
353970,201804,76,46,30,43884,28620,72504
353980,201804,1531,754,777,716656.95,740323.76,1456980.71
353990,201804,74,42,32,40068,30528,70596
354000,201804,374,181,193,172007,183927.2,355934.2
354010,201804,93,52,41,49608,38637,88245
354020,201804,547,345,202,328176,192708,520884
354025,201804,56,44,12,41976,11448,53424
354030,201804,64,35,29,33390,27666,61056
354040,201804,96,68,28,64490.4,26712,91202.4
354050,201804,192,106,86,100838,82044,182882
354060,201804,776,373,403,355842,382062.4,737904.4
354070,201804,868,506,362,481194.03,345348,826542.03
354075,201804,213,113,100,107802,94446.8,202248.8
354080,201804,294,127,167,120871.8,159318,280189.8
354085,201804,18,11,7,10494,6678,17172
354090,201804,313,173,140,164961,133560,298521
354100,201804,5504,2296,3208,2179178.76,3054608.25,5233787.01
354105,201804,80,41,39,39114,37206,76320
354110,201804,48,22,26,20988,24804,45792
354120,201804,148,102,46,97168.97,43884,141052.97
354130,201804,705,473,232,451004,221038,672042
354140,201804,3174,1485,1689,1413390.43,1609761.83,3023152.26
354150,201804,650,406,244,384824.84,231345,616169.84
354160,201804,706,452,254,430015.5,242030,672045.5
354165,201804,22,13,9,12402,8586,20988
354170,201804,176,120,56,113812.2,53424,167236.2
354180,201804,63,39,24,36880,22896,59776
354190,201804,215,100,115,93778.2,109710,203488.2
354200,201804,131,72,59,68211,56286,124497
354210,201804,67,33,34,31482,32436,63918
354220,201804,642,395,247,376162.2,234306.39,610468.59
354230,201804,165,67,98,63918,92538.6,156456.6
354240,201804,318,205,113,194616.49,107165.96,301782.45
354250,201804,95,56,39,53424,37206,90630
354260,201804,1938,910,1028,856211.34,979372,1835583.34
354270,201804,95,71,24,67734,22896,90630
354280,201804,38,20,18,19080,17172,36252
354290,201804,145,99,46,93635.1,43884,137519.1
354300,201804,422,288,134,274435,127678,402113
354310,201804,105,76,29,71550.2,27666,99216.2
354320,201804,182,97,85,92538,81090,173628
354323,201804,16,14,2,13356,1908,15264
354325,201804,106,61,45,57388,42930,100318
354330,201804,2597,873,1724,828207.26,1642530.18,2470737.44
354340,201804,10568,5166,5402,4916242.53,5146876.67,10063119.20
354350,201804,130,86,44,82044,41832.9,123876.9
354360,201804,88,48,40,45792,38160,83952
354370,201804,266,147,119,140238,113526,253764
354380,201804,214,129,85,122280,81090,203370
354390,201804,2767,1008,1759,960682.72,1677162.75,2637845.47
354400,201804,330,174,156,165266.25,148251.8,313518.05
354410,201804,615,299,316,283620.43,300510.2,584130.63
354420,201804,274,172,102,164088,97308,261396
354425,201804,320,185,135,176490,128790,305280
354430,201804,185,116,69,109089.9,65062.8,174152.7
354440,201804,39,27,12,25758,11448,37206
354450,201804,51,37,14,35298,13356,48654
354460,201804,104,60,44,57240,41976,99216
354470,201804,39,26,13,24804,12402,37206
354480,201804,117,60,57,57231,54368.46,111599.46
354490,201804,149,92,57,87608.97,54378,141986.97
354500,201804,392,195,197,186030,187938,373968
354510,201804,102,70,32,66780,30528,97308
354515,201804,38,13,25,12402,23850,36252
354520,201804,1645,728,917,691801.2,874379.56,1566180.76
354530,201804,659,345,314,327408.8,298412,625820.8
354540,201804,278,156,122,148824,116383.23,265207.23
354550,201804,43,25,18,23850,17172,41022
354560,201804,165,94,71,89390,67724.46,157114.46
354570,201804,138,89,49,84906,46746,131652
354580,201804,1969,934,1035,888459,986804.26,1875263.26
354600,201804,273,147,126,137984.12,120189.69,258173.81
354610,201804,72,65,7,61056.58,6678,67734.58
354620,201804,64,21,43,20034,41022,61056
354625,201804,17,11,6,10494,5720,16214
354630,201804,320,211,109,200919.34,103986,304905.34
354640,201804,805,520,285,492154.36,271890,764044.36
354650,201804,72,41,31,38818.8,29545.92,68364.72
354660,201804,812,602,210,570286.46,200340,770626.46
354670,201804,277,98,179,92539,169813,262352
354680,201804,1247,471,776,449334,739827,1189161
354690,201804,90,60,30,56287,28620,84907
354700,201804,78,56,22,53424,20988,74412
354710,201804,55,38,17,35615.96,16218,51833.96
354720,201804,20,19,1,18126,954,19080
354730,201804,1895,800,1095,760043.2,1044439.2,1804482.4
354740,201804,59,41,18,39114,17172,56286
354750,201804,439,260,179,248031,170766,418797
354760,201804,519,318,201,300811,191319.74,492130.74
354765,201804,12,5,7,4770,6678,11448
354770,201804,340,229,111,217642.03,105130.8,322772.83
354780,201804,8157,3322,4835,3156233.15,4607753.02,7763986.17
354790,201804,114,67,47,63918,44838,108756
354800,201804,426,236,190,225144,180954.92,406098.92
354805,201804,104,52,52,48972,49608,98580
354810,201804,137,80,57,76320,54378,130698
354820,201804,186,81,105,77065,100170,177235
354830,201804,40,22,18,20988,17172,38160
354840,201804,55,37,18,35298,17172,52470
354850,201804,4576,2038,2538,1936468.96,2416323.06,4352792.02
354860,201804,328,160,168,152640,157877.52,310517.52
354870,201804,11917,5401,6516,5124744.73,6205423.51,11330168.24
354880,201804,3005,1124,1881,1070658.46,1792878.9,2863537.36
354890,201804,2861,1581,1280,1501614.82,1220137.38,2721752.20
354900,201804,60,39,21,37206,20034,57240
354910,201804,1232,650,582,617486.24,555228,1172714.24
354920,201804,50,42,8,40068,7632,47700
354925,201804,12,7,5,6678,4770,11448
354930,201804,31,28,3,26442,2862,29304
354940,201804,796,584,212,555183.19,202248,757431.19
354950,201804,218,143,75,135812,71550,207362
354960,201804,168,64,104,61056,98930,159986
354970,201804,848,556,292,525565.1,277929.02,803494.12
354980,201804,8451,3138,5313,2985658.31,5065616.98,8051275.29
354990,201804,9190,4330,4860,4117299.65,4630300.12,8747599.77
354995,201804,518,182,336,173628,320229.18,493857.18
355000,201804,496,165,331,157405.23,314581.5,471986.73
355010,201804,625,393,232,374922,219116.48,594038.48
355020,201804,716,452,264,430249.59,251848,682097.59
355030,201804,204952,79582,125370,75693168.63,119503586.7,195196755.33
355040,201804,720,340,380,322309.6,362329.2,684638.8
355050,201804,153,101,52,95083.77,49608,144691.77
355060,201804,1520,758,762,718263.86,725756.3,1444020.16
355070,201804,1451,711,740,674470.36,704967,1379437.36
355080,201804,201,117,84,111618,79248.8,190866.8
355090,201804,294,196,98,184886,93492,278378
355100,201804,4785,2373,2412,2244180.4,2299170.36,4543350.76
355110,201804,269,171,98,162177,93492,255669
355120,201804,80,56,24,53424,22896,76320
355130,201804,53,29,24,27666,22896,50562
355140,201804,183,121,62,114718.5,59148,173866.5
355150,201804,680,410,270,389896,257103,646999
355160,201804,453,219,234,206541.96,223236,429777.96
355170,201804,2060,1075,985,1024170.87,939670.92,1963841.79
355180,201804,618,264,354,250902,336881.25,587783.25
355190,201804,224,152,72,145008,68688,213696
355200,201804,117,68,49,64872,46746,111618
355210,201804,722,418,304,398772,289997.46,688769.46
355220,201804,6727,3585,3142,3408631.67,2988242.8,6396874.47
355230,201804,106,63,43,60102,41017.23,101119.23
355240,201804,4274,1876,2398,1776846.15,2283267.91,4060114.06
355250,201804,5395,2622,2773,2495423.22,2642034.33,5137457.55
355255,201804,53,32,21,30528,20034,50562
355260,201804,187,113,74,106829.12,70568.46,177397.58
355270,201804,166,98,68,93492,64157,157649
355280,201804,6381,2685,3696,2556201.46,3520996.46,6077197.92
355290,201804,78,58,20,55332,19080,74412
355300,201804,184,119,65,112565.56,62010,174575.56
355310,201804,108,60,48,57240,45792,103032
355320,201804,91,47,44,44838,41028.6,85866.6
355330,201804,268,151,117,144054,111618,255672
355340,201804,1519,543,976,515415.61,930361.97,1445777.58
355350,201804,143,72,71,68688,67734,136422
355360,201804,184,116,68,110454.12,64872,175326.12
355365,201804,25,20,5,19080,4770,23850
355370,201804,1040,590,450,556983.74,428032.55,985016.29
355380,201804,771,516,255,491672.52,242984,734656.52
355385,201804,62,44,18,41976,17172,59148
355390,201804,107,62,45,59148,42930,102078
355395,201804,186,114,72,107655.23,68688,176343.23
355400,201804,1547,959,588,910887.52,559425.8,1470313.32
355410,201804,4903,2302,2601,2179211.54,2473583.62,4652795.16
355420,201804,50,37,13,35298,12402,47700
355430,201804,347,208,139,197096.4,132606,329702.4
355440,201804,79,48,31,45792,29574,75366
355450,201804,451,217,234,204299.94,222186.8,426486.74
355460,201804,69,53,16,49608.42,15264,64872.42
355465,201804,51,32,19,30528,18126,48654
355470,201804,181,73,108,68688.1,103032,171720.1
355475,201804,13,8,5,7632,4770,12402
355480,201804,458,199,259,187948.34,245645.46,433593.80
355490,201804,116,81,35,77274,33390,110664
355495,201804,57,28,29,26712,27666,54378
355500,201804,1658,931,727,883500.66,693523.46,1577024.12
355510,201804,272,199,73,186387.67,69642,256029.67
355520,201804,36,28,8,26426,7632,34058
355530,201804,25,17,8,16218,7632,23850
355535,201804,77,39,38,37206,36252,73458
355540,201804,2368,941,1427,896255.53,1359441.96,2255697.49
355550,201804,63,38,25,36252,23850,60102
355560,201804,240,120,120,114480,113843.96,228323.96
355570,201804,31,20,11,19080,10494,29574
355580,201804,272,185,87,176490,82707.23,259197.23
355590,201804,23,14,9,13356,8586,21942
355600,201804,272,139,133,132606,126591.23,259197.23
355610,201804,212,138,74,131652,70596,202248
355620,201804,1260,589,671,561095.8,639175.51,1200271.31
355630,201804,418,303,115,289062,108469.96,397531.96
355635,201804,126,61,65,58194,61997,120191
355640,201804,574,334,240,317682.16,228960,546642.16
355645,201804,828,356,472,338145.3,448408.82,786554.12
355650,201804,2147,895,1252,850560.8,1194103.26,2044664.06
355660,201804,259,138,121,131652,115434,247086
355670,201804,491,192,299,183168,284959.8,468127.8
355680,201804,206,116,90,109711,85574,195285
355690,201804,87,40,47,38160,44494,82654
355695,201804,15,12,3,11448,2862,14310
355700,201804,1145,589,556,556836.6,529852,1086688.6
355710,201804,2191,1201,990,1142117.56,943780.07,2085897.63
355715,201804,20,18,2,17172,1908,19080
355720,201804,209,126,83,118614.08,79182,197796.08
355730,201804,94,54,40,50641.95,38160,88801.95
410010,201804,134,113,21,107802,20034,127836
410020,201804,104,93,11,88722,10494,99216
410030,201804,165,104,61,98548.4,58194,156742.4
410040,201804,975,533,442,508243.5,421478,929721.5
410045,201804,26,21,5,20034,4770,24804
410050,201804,477,264,213,251856,202725,454581
410060,201804,279,214,65,204156,62010,266166
410070,201804,308,255,53,243270,50562,293832
410080,201804,165,106,59,101124,56286,157410
410090,201804,74,66,8,62755,7632,70387
410100,201804,298,214,84,203841.18,79325.1,283166.28
410105,201804,47,28,19,26712,18126,44838
410110,201804,318,194,124,185076,118296,303372
410115,201804,28,19,9,18126,8586,26712
410120,201804,446,230,216,219118.8,206064,425182.8
410130,201804,44,27,17,25758,16218,41976
410140,201804,3106,1527,1579,1452501.38,1503027.6,2955528.98
410150,201804,2700,1082,1618,1030789.24,1542975.8,2573765.04
410160,201804,503,318,185,303085.8,176490,479575.8
410165,201804,68,46,22,43884,20988,64872
410170,201804,169,126,43,118779,41022,159801
410180,201804,2145,1252,893,1190419.19,850464.95,2040884.14
410185,201804,34,30,4,28620,3816,32436
410190,201804,444,278,166,265212,158364,423576
410200,201804,964,721,243,686984.94,231822,918806.94
410210,201804,555,289,266,275706,253478,529184
410220,201804,39,21,18,20034,17172,37206
410230,201804,131,70,61,66780,58194,124974
410240,201804,741,485,256,462117.8,244224,706341.8
410250,201804,377,276,101,262699.84,96349.23,359049.07
410260,201804,294,174,120,165996,114480,280476
410270,201804,31,19,12,18126,11448,29574
410275,201804,65,48,17,45792,16218,62010
410280,201804,323,185,138,176230.52,131652,307882.52
410290,201804,234,147,87,140238,82998,223236
410300,201804,80,64,16,61056,15264,76320
410302,201804,24,16,8,15264,7632,22896
410304,201804,46,32,14,30528,13356,43884
410305,201804,206,111,95,105086.2,90630,195716.2
410310,201804,265,168,97,160272,92518.92,252790.92
410315,201804,52,37,15,35274,14310,49584
410320,201804,139,97,42,92538,40068,132606
410322,201804,34,24,10,22896,9540,32436
410330,201804,164,116,48,110664,45602,156266
410335,201804,100,62,38,59148,36252,95400
410337,201804,38,33,5,31482,4770,36252
410340,201804,31,29,2,27666,1908,29574
410345,201804,217,136,81,129744,77274,207018
410347,201804,54,41,13,39114,12402,51516
410350,201804,228,139,89,132606,84906,217512
410360,201804,457,277,180,261714.4,171148,432862.4
410370,201804,2414,1028,1386,977117.32,1319464.82,2296582.14
410380,201804,222,146,76,139284,72504,211788
410390,201804,372,277,95,264254,90630,354884
410395,201804,35,23,12,21942,11448,33390
410400,201804,844,428,416,406983.2,396325,803308.2
410405,201804,92,70,22,66780,20988,87768
410410,201804,40,31,9,29574,8586,38160
410420,201804,1655,817,838,777323.89,798499,1575822.89
410425,201804,179,84,95,79946,90630,170576
410430,201804,2195,1293,902,1230374,859630.32,2090004.32
410440,201804,391,290,101,275707,96354,372061
410442,201804,356,238,118,226099,112572,338671
410445,201804,419,291,128,277614,122112,399726
410450,201804,413,209,204,199386,194616,394002
410460,201804,413,224,189,213400.8,180306,393706.8
410465,201804,187,122,65,115147.8,62010,177157.8
410470,201804,219,140,79,133560,75366,208926
410480,201804,5831,2883,2948,2731574.2,2805991.56,5537565.76
410490,201804,1401,924,477,879999,453151,1333150
410500,201804,269,153,116,145962,110664,256626
410510,201804,183,135,48,128790,45783,174573
410520,201804,257,191,66,182214,62964,245178
410530,201804,236,87,149,82998,142142,225140
410540,201804,321,232,89,220747.6,84901.23,305648.83
410550,201804,1623,702,921,669383.8,877434.36,1546818.16
410560,201804,146,114,32,108756,30528,139284
410570,201804,429,302,127,286020.2,121158,407178.2
410580,201804,3173,1426,1747,1358521.8,1665208,3023729.8
410590,201804,407,288,119,274752,113526,388278
410600,201804,185,160,25,152640,23850,176490
410610,201804,55,44,11,41976,10494,52470
410620,201804,246,176,70,167904,66780,234684
410630,201804,445,260,185,248040,175331,423371
410640,201804,980,604,376,572760.99,357097.28,929858.27
410645,201804,100,75,25,71169,23850,95019
410650,201804,369,253,116,240408,110664,351072
410655,201804,80,61,19,58194,18126,76320
410657,201804,44,19,25,18126,23850,41976
410660,201804,598,420,178,399437,169812,569249
410670,201804,78,65,13,62010,12402,74412
410680,201804,191,157,34,149111,32436,181547
410685,201804,17,11,6,10494,5724,16218
410690,201804,28306,12289,16017,11703649.4,15267353.75,26971003.15
410700,201804,322,235,87,223109.2,82998,306107.2
410710,201804,126,101,25,96354,23850,120204
410712,201804,24,15,9,14310,8586,22896
410715,201804,84,62,22,59148,20988,80136
410720,201804,597,362,235,345348,224181,569529
410725,201804,181,131,50,124974,47700,172674
410730,201804,87,54,33,51516,31482,82998
410740,201804,112,81,31,77274,29574,106848
410750,201804,220,163,57,155502,54373.23,209875.23
410752,201804,24,15,9,14310,8586,22896
410753,201804,54,24,30,22223.43,28620,50843.43
410754,201804,38,23,15,21561,14310,35871
410755,201804,79,54,25,51229.8,23850,75079.8
410760,201804,718,405,313,386345.56,298602,684947.56
410765,201804,1666,805,861,760585.68,820240.26,1580825.94
410770,201804,105,87,18,82998,17172,100170
410773,201804,47,35,12,33390,11448,44838
410775,201804,179,136,43,129076.2,41022,170098.2
410780,201804,78,42,36,40068,34344,74412
410785,201804,53,43,10,41022,9540,50562
410790,201804,70,33,37,31482,35298,66780
410800,201804,297,189,108,179353,103032,282385
410810,201804,26,22,4,20988,3530,24518
410820,201804,178,132,46,125785,43884,169669
410830,201804,8489,3870,4619,3682266.04,4404236.14,8086502.18
410832,201804,104,72,32,68688,30528,99216
410840,201804,1428,794,634,755208.08,603912.98,1359121.06
410845,201804,63,39,24,37206,22896,60102
410850,201804,188,130,58,123734,55332,179066
410855,201804,47,40,7,38160,6678,44838
410860,201804,671,392,279,373014.76,266166,639180.76
410865,201804,103,80,23,76320,21942,98262
410870,201804,159,137,22,130698,20697,151395
410880,201804,1119,559,560,532775.62,534195,1066970.62
410890,201804,77,54,23,51516,21942,73458
410895,201804,74,56,18,53424,17172,70596
410900,201804,21,13,8,12402,7632,20034
410910,201804,17,15,2,14310,1908,16218
410920,201804,34,23,11,21942,10494,32436
410930,201804,501,325,176,309838.98,167904,477742.98
410940,201804,4324,2580,1744,2450538.04,1660512.2,4111050.24
410950,201804,120,87,33,82998,31482,114480
410960,201804,761,339,422,323120,402398,725518
410965,201804,64,49,15,46459.8,14310,60769.8
410970,201804,629,448,181,426924.2,172674,599598.2
410975,201804,104,62,42,58637,40068,98705
410980,201804,1575,717,858,681471.82,817574,1499045.82
410990,201804,269,181,88,172674,83665.8,256339.8
411000,201804,63,41,22,39114,20988,60102
411005,201804,25,20,5,19080,4770,23850
411007,201804,235,139,96,132606,91584,224190
411010,201804,580,402,178,383508,169812,553320
411020,201804,295,205,90,195570,85860,281430
411030,201804,18,9,9,8586,8586,17172
411040,201804,49,35,14,33390,13356,46746
411050,201804,220,174,46,165339.72,43757.12,209096.84
411060,201804,514,344,170,328167,162180,490347
411065,201804,62,54,8,51516,7632,59148
411070,201804,1202,798,404,755785.31,384462,1140247.31
411080,201804,242,172,70,164172,66780,230952
411090,201804,117,88,29,83952,27666,111618
411095,201804,264,108,156,102555,148814,251369
411100,201804,113,94,19,89676,18126,107802
411110,201804,120,83,37,79182,35298,114480
411120,201804,183,136,47,129744,44838,174582
411125,201804,182,82,100,77579.28,95400,172979.28
411130,201804,125,107,18,101440,16885.8,118325.8
411140,201804,183,126,57,120182.12,53853.3,174035.42
411150,201804,1227,821,406,782556.66,387324,1169880.66
411155,201804,121,84,37,80136,35298,115434
411160,201804,21,10,11,9540,10494,20034
411170,201804,59,53,6,50275.8,5724,55999.8
411180,201804,946,623,323,593019,308137.23,901156.23
411190,201804,346,199,147,189178.2,140238,329416.2
411200,201804,666,440,226,418489.89,214697.7,633187.59
411210,201804,684,366,318,347614.21,303372,650986.21
411220,201804,147,111,36,105894,34344,140238
411230,201804,40,36,4,34344,3816,38160
411240,201804,119,81,38,77274,36252,113526
411250,201804,422,307,115,292878,109710,402588
411260,201804,22,15,7,14310,6678,20988
411270,201804,293,157,136,149778,129744,279522
411275,201804,202,178,24,169096.6,22896,191992.6
411280,201804,230,163,67,154231.12,63918,218149.12
411290,201804,58,43,15,41022,14310,55332
411295,201804,146,115,31,109710,29574,139284
411300,201804,70,36,34,34344,32436,66780
411310,201804,90,69,21,65826,20034,85860
411320,201804,762,551,211,524128.4,199691.28,723819.68
411325,201804,44,27,17,25758,16218,41976
411330,201804,917,588,329,559426.61,313708,873134.61
411340,201804,25,17,8,16218,7318,23536
411342,201804,74,56,18,53424,17172,70596
411345,201804,126,64,62,61056,59148,120204
411350,201804,481,385,96,366002.44,90621.2,456623.64
411360,201804,53,34,19,32436,18126,50562
411370,201804,14177,5811,8366,5522648.88,7964698.62,13487347.50
411373,201804,187,137,50,130698,47700,178398
411375,201804,73,61,12,58194,11448,69642
411380,201804,96,71,25,67734,23850,91584
411390,201804,137,91,46,86814,43884,130698
411400,201804,350,263,87,250893,82998,333891
411410,201804,452,233,219,221614.2,208640,430254.2
411420,201804,1026,471,555,446758.2,528993.2,975751.4
411430,201804,411,264,147,251188.2,140229,391417.2
411435,201804,34,23,11,21942,10494,32436
411440,201804,469,376,93,357050.76,88722,445772.76
411450,201804,432,359,73,342486,69642,412128
411460,201804,755,302,453,287187.64,430689.16,717876.80
411470,201804,87,65,22,62010,20988,82998
411480,201804,636,360,276,340674.4,262731.6,603406.0
411490,201804,293,183,110,174582,104940,279522
411500,201804,112,94,18,89472.33,16791,106263.33
411510,201804,218,176,42,167156.06,40068,207224.06
411520,201804,5919,2311,3608,2199648.31,3434280.33,5633928.64
411530,201804,110,75,35,71550,33390,104940
411535,201804,47,20,27,19080,25758,44838
411540,201804,348,242,106,229845.9,101124,330969.9
411545,201804,55,39,16,37206,15264,52470
411550,201804,73,56,17,53424,16218,69642
411560,201804,381,178,203,169148.38,193662,362810.38
411570,201804,780,298,482,283997,459638,743635
411573,201804,33,20,13,19080,12402,31482
411575,201804,263,163,100,155502,95400,250902
411580,201804,1250,499,751,474739.02,714606.4,1189345.42
411585,201804,80,40,40,38160,38160,76320
411590,201804,25,18,7,17172,6678,23850
411600,201804,26,10,16,9540,15264,24804
411605,201804,248,109,139,103843,132606,236449
411610,201804,234,158,76,150732,72504,223236
411620,201804,357,200,157,190323,149139,339462
411630,201804,58,38,20,36252,19080,55332
411640,201804,35,29,6,27666,5724,33390
411650,201804,13,9,4,8586,3816,12402
411660,201804,31,25,6,23850,5724,29574
411670,201804,247,188,59,179352,56286,235638
411680,201804,155,133,22,126882,20988,147870
411690,201804,602,318,284,302794.44,270592.08,573386.52
411695,201804,63,47,16,44838,15264,60102
411700,201804,166,144,22,137376,20988,158364
411705,201804,101,66,35,62964,33390,96354
411710,201804,300,201,99,190687.81,94446,285133.81
411720,201804,142,91,51,86814,48654,135468
411721,201804,63,52,11,49608,10494,60102
411722,201804,99,42,57,40068,54378,94446
411725,201804,146,113,33,107486,31482,138968
411727,201804,74,58,16,55332,14977.8,70309.8
411729,201804,32,25,7,23850,6678,30528
411730,201804,545,353,192,335171.96,182881.8,518053.76
411740,201804,33,20,13,19080,12402,31482
411745,201804,69,46,23,43093,21942,65035
411750,201804,871,417,454,396721.9,432147.69,828869.59
411760,201804,1193,898,295,855443.2,281421,1136864.2
411770,201804,443,295,148,281410.92,141192,422602.92
411780,201804,370,240,130,228960,124020,352980
411790,201804,531,298,233,282410.47,222169.14,504579.61
411800,201804,172,135,37,128790,35298,164088
411810,201804,166,129,37,123066,35298,158364
411820,201804,2100,1027,1073,976209.42,1022918.3,1999127.72
411830,201804,12,12,0,11448,0,11448
411840,201804,1965,1226,739,1167409.8,704513,1871922.8
411845,201804,50,19,31,18126,29574,47700
411850,201804,1242,711,531,676739.94,504621.02,1181360.96
411860,201804,44,28,16,26426,15264,41690
411870,201804,74,53,21,50562,19747.8,70309.8
411880,201804,427,274,153,261282,145217.88,406499.88
411885,201804,104,69,35,65826,33390,99216
411890,201804,321,205,116,194330.45,110654.46,304984.91
411900,201804,68,50,18,47700,17172,64872
411910,201804,171,140,31,133550.46,28734.48,162284.94
411915,201804,2112,904,1208,861263.57,1151368.05,2012631.62
411920,201804,126,104,22,99216,20988,120204
411925,201804,13,9,4,8586,3816,12402
411930,201804,795,586,209,557138,199386,756524
411940,201804,589,421,168,401157,160247.56,561404.56
411950,201804,901,480,421,457252.2,400966.2,858218.4
411960,201804,977,692,285,656788.49,271890,928678.49
411965,201804,23,15,8,14310,7632,21942
411970,201804,72,65,7,62010,6678,68688
411980,201804,199,129,70,123066,66780,189846
411990,201804,4982,2887,2095,2736617.39,1996856.8,4733474.19
411995,201804,461,173,288,165042,274752,439794
412000,201804,295,175,120,165968.18,114470.46,280438.64
412010,201804,45,28,17,26712,16218,42930
412015,201804,44,31,13,29574,12402,41976
412020,201804,27,24,3,22609.8,2862,25471.8
412030,201804,60,51,9,48654,8586,57240
412033,201804,55,36,19,34320,18126,52446
412035,201804,67,42,25,40068,23850,63918
412040,201804,36,25,11,23564,10494,34058
412050,201804,202,152,50,145008,47700,192708
412060,201804,748,585,163,555228.74,154511.8,709740.54
412065,201804,51,35,16,33390,15264,48654
412070,201804,154,103,51,97594.2,48654,146248.2
412080,201804,282,146,136,139284,129744,269028
412085,201804,34,17,17,16218,16218,32436
412090,201804,744,468,276,444803.2,263304,708107.2
412100,201804,251,210,41,199387,39114,238501
412110,201804,71,57,14,54378,13181.08,67559.08
412120,201804,310,203,107,193089.6,102078,295167.6
412125,201804,78,46,32,43597.8,30528,74125.8
412130,201804,46,35,11,33390,10494,43884
412135,201804,28,15,13,14310,12402,26712
412140,201804,311,221,90,210194.82,85860,296054.82
412150,201804,260,176,84,166950.04,80136,247086.04
412160,201804,85,49,36,46746,34344,81090
412170,201804,648,456,192,434737.8,183168,617905.8
412175,201804,40,29,11,27666,10494,38160
412180,201804,197,157,40,149178.61,37539.9,186718.51
412190,201804,334,266,68,253091.43,64872,317963.43
412200,201804,193,122,71,116388,67734,184122
412210,201804,73,56,17,53424,16218,69642
412215,201804,242,166,76,158078,72217.8,230295.8
412217,201804,69,53,16,50562,15264,65826
412220,201804,828,619,209,590526,199386,789912
412230,201804,340,206,134,194902.2,127799.46,322701.66
412240,201804,1325,650,675,617199.18,641869.44,1259068.62
412250,201804,383,249,134,237546,127836,365382
412260,201804,127,94,33,89676,31482,121158
412265,201804,168,134,34,127231.84,32436,159667.84
412270,201804,84,53,31,50562,29574,80136
412280,201804,91,72,19,68688,18126,86814
412290,201804,96,65,31,62010,29574,91584
412300,201804,215,138,77,131652,73314.9,204966.9
412310,201804,43,36,7,34344,6678,41022
412320,201804,94,80,14,76320,13356,89676
412330,201804,169,151,18,144054,17172,161226
412340,201804,144,100,44,95400,41690,137090
412350,201804,605,308,297,292520.3,283338,575858.3
412360,201804,27,24,3,22896,2862,25758
412370,201804,160,137,23,129744,21942,151686
412380,201804,253,192,61,182881.8,58090,240971.8
412382,201804,50,26,24,24804,22896,47700
412385,201804,141,102,39,97308,37206,134514
412390,201804,277,209,68,199386,64872,264258
412395,201804,66,52,14,49608,13356,62964
412400,201804,69,50,19,47700,18126,65826
412402,201804,250,118,132,112567.23,125641.8,238209.03
412405,201804,820,328,492,310218.08,468682.66,778900.74
412410,201804,938,589,349,559807.6,332946,892753.6
412420,201804,15,12,3,11448,2862,14310
412430,201804,21,14,7,13356,6678,20034
412440,201804,595,323,272,305829.94,257623.96,563453.90
412450,201804,80,68,12,64872,11448,76320
412460,201804,81,64,17,61056,16218,77274
412470,201804,260,206,54,195760.8,51516,247276.8
412480,201804,173,132,41,124974.9,39114,164088.9
412490,201804,168,142,26,135468,24804,160272
412500,201804,475,387,88,367485.8,83952,451437.8
412510,201804,186,152,34,144261,32436,176697
412520,201804,136,74,62,70596,59148,129744
412530,201804,108,58,50,55332,47413.8,102745.8
412535,201804,106,78,28,74394,26712,101106
412540,201804,67,33,34,31482,32436,63918
412545,201804,99,72,27,68688,25758,94446
412550,201804,3528,1594,1934,1514914.74,1842652.9,3357567.64
412555,201804,14,9,5,8586,4770,13356
412560,201804,591,441,150,418124.2,143100,561224.2
412570,201804,734,411,323,390243.24,307856,698099.24
412575,201804,81,56,25,53424,23850,77274
412580,201804,158,107,51,102078,48654,150732
412590,201804,34,32,2,30528,1908,32436
412600,201804,175,133,42,126882,40068,166950
412610,201804,30,18,12,17172,11448,28620
412620,201804,148,130,18,124020,17172,141192
412625,201804,2202,1182,1020,1124826.21,971202.59,2096028.80
412627,201804,68,54,14,51516,13356,64872
412630,201804,428,288,140,273219.2,133274,406493.2
412635,201804,66,20,46,19080,43884,62964
412640,201804,120,80,40,76320,38160,114480
412650,201804,341,212,129,201961.8,123061.23,325023.03
412660,201804,484,295,189,280715,180306,461021
412665,201804,52,46,6,43884,5724,49608
412667,201804,283,193,90,183327.54,85593.8,268921.34
412670,201804,61,52,9,49608,8586,58194
412680,201804,292,230,62,219420,59148,278568
412690,201804,114,73,41,69642,38828,108470
412700,201804,163,111,52,105894,49322,155216
412710,201804,1409,873,536,826834.6,509282.65,1336117.25
412720,201804,228,158,70,150732,66780,217512
412730,201804,201,160,41,152640,38160,190800
412740,201804,419,226,193,215460.9,184122,399582.9
412750,201804,466,270,196,256626,186984,443610
412760,201804,260,134,126,127836,120204,248040
412770,201804,2115,1201,914,1141370.94,870126,2011496.94
412780,201804,154,123,31,117342,29574,146916
412785,201804,275,139,136,132129,129744,261873
412788,201804,35,21,14,20034,13356,33390
412790,201804,142,116,26,109996.2,24804,134800.2
412795,201804,154,115,39,109710,37206,146916
412796,201804,300,209,91,198221.18,86680.44,284901.62
412800,201804,561,369,192,351466.39,183168,534634.39
412810,201804,3013,1670,1343,1587629.3,1279977.03,2867606.33
412820,201804,925,606,319,567688.86,302466.09,870154.95
412830,201804,15,12,3,11448,2862,14310
412840,201804,220,157,63,148824.2,60102,208926.2
412850,201804,785,535,250,508282.96,238500,746782.96
412853,201804,170,90,80,85860,76320,162180
412855,201804,214,117,97,110506.82,92538,203044.82
412860,201804,92,68,24,64872,22896,87768
412862,201804,59,44,15,41689.8,14310,55999.8
412863,201804,6,5,1,4770,954,5724
412865,201804,42,31,11,29574,10494,40068
412870,201804,108,71,37,67734,35298,103032
412880,201804,103,77,26,73458,24804,98262
420005,201804,37,33,4,31482,3244,34726
420010,201804,366,238,128,225864.34,122112,347976.34
420020,201804,75,64,11,61056,10494,71550
420030,201804,29,26,3,24804,2862,27666
420040,201804,105,80,25,76320,23850,100170
420050,201804,56,34,22,32436,20988,53424
420055,201804,20,19,1,18126,954,19080
420060,201804,32,23,9,21942,8586,30528
420070,201804,103,88,15,83952,14300.46,98252.46
420075,201804,14,12,2,11448,1908,13356
420080,201804,48,42,6,38398.5,5724,44122.5
420090,201804,35,33,2,30704.49,1908,32612.49
420100,201804,160,133,27,125928.2,25758,151686.2
420110,201804,20,20,0,19080,0,19080
420120,201804,47,36,11,34344,10494,44838
420125,201804,85,68,17,64872,16218,81090
420127,201804,35,31,4,29574,3816,33390
420130,201804,389,248,141,236296.46,134265.96,370562.42
420140,201804,1284,744,540,708451.38,515094,1223545.38
420150,201804,46,40,6,38160,5724,43884
420160,201804,38,36,2,34344,1908,36252
420165,201804,19,14,5,13356,4770,18126
420170,201804,63,41,22,39114,20988,60102
420180,201804,22,21,1,20034,954,20988
420190,201804,31,28,3,26712,2862,29574
420195,201804,127,60,67,57240,63918,121158
420200,201804,1276,568,708,537865.6,674088.76,1211954.36
420205,201804,68,36,32,34344,30528,64872
420207,201804,106,61,45,58194,42920.46,101114.46
420208,201804,24,19,5,18126,3911.4,22037.4
420209,201804,20,16,4,15264,3816,19080
420210,201804,466,222,244,211501.8,232681.14,444182.94
420213,201804,45,36,9,34344,8586,42930
420215,201804,26,22,4,20988,3816,24804
420220,201804,68,43,25,41022,23850,64872
420230,201804,756,431,325,410411,310024.46,720435.46
420240,201804,2296,1548,748,1469224.11,713153.16,2182377.27
420243,201804,37,30,7,28620,6678,35298
420245,201804,109,64,45,61056,42930,103986
420250,201804,54,31,23,29574,21942,51516
420253,201804,40,32,8,30528,7632,38160
420257,201804,11,9,2,8586,1908,10494
420260,201804,98,86,12,82044,11448,93492
420270,201804,37,30,7,28616,6678,35294
420280,201804,281,205,76,193846.06,71246.1,265092.16
420285,201804,19,12,7,11448,6678,18126
420287,201804,50,31,19,29574,18126,47700
420290,201804,966,678,288,644776.72,274684.3,919461.02
420300,201804,1382,1091,291,1036236.4,275134.14,1311370.54
420310,201804,60,46,14,43884,13356,57240
420315,201804,34,30,4,28620,3816,32436
420320,201804,851,432,419,411150.15,399722,810872.15
420325,201804,0,0,0,0,0,0
420330,201804,120,82,38,78228,36137.52,114365.52
420340,201804,157,107,50,101116,47680.92,148796.92
420350,201804,246,181,65,171053,62010,233063
420360,201804,758,578,180,549486.16,170099.78,719585.94
420370,201804,109,71,38,67544,35966,103510
420380,201804,1141,819,322,777502.5,306151.04,1083653.54
420390,201804,255,163,92,154243.52,87052.5,241296.02
420395,201804,187,134,53,127072.8,49789.26,176862.06
420400,201804,248,184,64,174964,61056,236020
420410,201804,61,48,13,45792,12402,58194
420415,201804,35,32,3,30528,2862,33390
420417,201804,47,35,12,33390,11428.92,44818.92
420419,201804,12,12,0,11448,0,11448
420420,201804,2796,1716,1080,1624719.03,1027847.42,2652566.45
420425,201804,71,60,11,57231,10180.26,67411.26
420430,201804,1283,893,390,848501.42,370314.18,1218815.60
420435,201804,16,14,2,13356,1908,15264
420440,201804,111,76,35,71876.68,33238.6,105115.28
420445,201804,23,20,3,19080,2862,21942
420450,201804,79,38,41,36243,39114,75357
420455,201804,254,193,61,184093.92,58102.38,242196.30
420460,201804,2350,1571,779,1494050.1,742932.9,2236983.0
420470,201804,121,86,35,82044,33390,115434
420475,201804,6,6,0,5724,0,5724
420480,201804,859,639,220,604150.12,208831.2,812981.32
420490,201804,112,88,24,83952,22896,106848
420500,201804,673,290,383,274689.2,365382,640071.2
420510,201804,19,16,3,15264,2862,18126
420515,201804,26,20,6,19080,5724,24804
420517,201804,12,12,0,11448,0,11448
420519,201804,0,0,0,0,0,0
420520,201804,67,50,17,47700,16218,63918
420530,201804,163,111,52,104919.02,49608,154527.02
420535,201804,20,18,2,17172,1908,19080
420540,201804,4888,2886,2002,2740892.28,1905272.98,4646165.26
420543,201804,23,23,0,21942,0,21942
420545,201804,195,139,56,131175,53404.92,184579.92
420550,201804,851,684,167,650591.32,159160.73,809752.05
420555,201804,41,29,12,27666,11448,39114
420560,201804,64,51,13,48272.4,12402,60674.4
420570,201804,145,82,63,78228,60092.46,138320.46
420580,201804,296,131,165,124974,157124,282098
420590,201804,515,365,150,347923.8,142718.4,490642.2
420600,201804,94,49,45,46746,42930,89676
420610,201804,37,35,2,33104,1908,35012
420620,201804,74,60,14,57240,13356,70596
420630,201804,154,112,42,106839.23,40064,146903.23
420640,201804,93,83,10,78991.2,9540,88531.2
420650,201804,243,130,113,123352.2,107183.23,230535.43
420660,201804,53,41,12,38350.8,11448,49798.8
420665,201804,37,28,9,26426,8586,35012
420670,201804,321,242,79,230142.96,75347.46,305490.42
420675,201804,15,14,1,13356,954,14310
420680,201804,36,26,10,24804,9540,34344
420690,201804,176,147,29,140238,27666,167904
420700,201804,643,441,202,420621.84,192446.82,613068.66
420710,201804,148,86,62,82044,58861.8,140905.8
420720,201804,108,86,22,82044,20988,103032
420730,201804,540,347,193,329980.5,182827.12,512807.62
420740,201804,46,45,1,42930,954,43884
420750,201804,500,336,164,320257.8,156456,476713.8
420757,201804,19,16,3,14453.1,2862,17315.1
420760,201804,40,31,9,29574,8586,38160
420765,201804,71,58,13,55332,12402,67734
420768,201804,66,59,7,56286,6678,62964
420770,201804,84,70,14,66780,13356,80136
420775,201804,48,45,3,41976,2862,44838
420780,201804,238,186,52,177434.46,49608,227042.46
420785,201804,14,10,4,9540,3816,13356
420790,201804,178,149,29,141805.8,26684.46,168490.26
420800,201804,77,58,19,54568.8,18126,72694.8
420810,201804,251,216,35,206055,32579.1,238634.1
420820,201804,2321,1383,938,1313028.66,893126.8,2206155.46
420830,201804,576,323,253,305171.95,240398.46,545570.41
420840,201804,148,112,36,106848,33640,140488
420845,201804,450,198,252,188221.07,239168,427389.07
420850,201804,233,186,47,177444,44838,222282
420860,201804,62,53,9,50562,8586,59148
420870,201804,119,86,33,82044,31482,113526
420880,201804,172,121,51,114756.66,48654,163410.66
420890,201804,861,424,437,401407.84,416317,817724.84
420895,201804,10,10,0,9540,0,9540
420900,201804,423,331,92,313715.04,87739.92,401454.96
420910,201804,5830,3278,2552,3116433.17,2429625.81,5546058.98
420915,201804,79,72,7,68688,6678,75366
420917,201804,19,14,5,13356,4770,18126
420920,201804,24,17,7,16218,6678,22896
420930,201804,2641,1613,1028,1531336.7,974849.88,2506186.58
420940,201804,610,446,164,424139.6,154804.08,578943.68
420945,201804,8,6,2,5724,1908,7632
420950,201804,55,50,5,47700,4770,52470
420960,201804,113,88,25,83914.92,23841,107755.92
420970,201804,305,244,61,231100.85,58166.46,289267.31
420980,201804,24,23,1,21942,954,22896
420985,201804,65,57,8,54378,7632,62010
420990,201804,69,54,15,51516,14310,65826
421000,201804,34,22,12,20988,11448,32436
421003,201804,68,44,24,41976,22887,64863
421005,201804,8,5,3,4770,2862,7632
421010,201804,769,541,228,514865,215452,730317
421020,201804,30,25,5,23850,4770,28620
421030,201804,131,111,20,105561,19080,124641
421040,201804,71,60,11,57240,10494,67734
421050,201804,318,230,88,217321.2,83952,301273.2
421055,201804,24,20,4,19080,3816,22896
421060,201804,82,56,26,53424,24804,78228
421070,201804,53,48,5,45792,4770,50562
421080,201804,36,32,4,30528,3816,34344
421085,201804,25,20,5,19080,4770,23850
421090,201804,42,31,11,29574,10494,40068
421100,201804,129,95,34,90630,32436,123066
421105,201804,219,178,41,169382.8,39090.69,208473.49
421110,201804,109,89,20,84285.9,19080,103365.9
421120,201804,150,117,33,111122.46,31462.92,142585.38
421125,201804,14,10,4,9540,3816,13356
421130,201804,810,523,287,497812.05,272758.54,770570.59
421140,201804,31,22,9,20272.5,8586,28858.5
421145,201804,40,31,9,29574,8586,38160
421150,201804,108,78,30,74412,28620,103032
421160,201804,61,40,21,38150.46,20034,58184.46
421165,201804,18,17,1,16218,954,17172
421170,201804,194,168,26,159244.84,24795,184039.84
421175,201804,150,98,52,93492,49569.92,143061.92
421180,201804,56,35,21,33028,20034,53062
421185,201804,17,14,3,13356,2862,16218
421187,201804,0,0,0,0,0,0
421189,201804,38,30,8,28620,7622.46,36242.46
421190,201804,1519,938,581,893889.46,553577.58,1447467.04
421200,201804,88,66,22,62010.7,20988,82998.7
421205,201804,24,16,8,15264,7622.46,22886.46
421210,201804,182,123,59,117342,56286,173628
421220,201804,275,219,56,208059.9,53424,261483.9
421223,201804,55,46,9,43407,8586,51993
421225,201804,60,41,19,39114,18126,57240
421227,201804,94,71,23,67734,21942,89676
421230,201804,48,35,13,33390,12402,45792
421240,201804,18,18,0,17172,0,17172
421250,201804,357,222,135,210454,127998.18,338452.18
421260,201804,27,22,5,20988,4770,25758
421265,201804,0,0,0,0,0,0
421270,201804,53,47,6,44838,5724,50562
421280,201804,334,189,145,180020,136612.8,316632.8
421290,201804,325,213,112,202964,105437.76,308401.76
421300,201804,25,20,5,19080,4770,23850
421310,201804,54,41,13,39114,12402,51516
421315,201804,29,20,9,19080,8586,27666
421320,201804,132,93,39,88722,37206,125928
421330,201804,111,85,26,78726.07,24795,103521.07
421335,201804,40,26,14,24804,13356,38160
421340,201804,292,199,93,188082.05,88722,276804.05
421350,201804,176,104,72,98773,68688,167461
421360,201804,691,506,185,477081.18,175709.06,652790.24
421370,201804,197,151,46,144054,43550.1,187604.1
421380,201804,130,105,25,100165.23,23850,124015.23
421390,201804,17,13,4,12402,3816,16218
421400,201804,113,95,18,90630,17172,107802
421410,201804,24,19,5,18126,4770,22896
421415,201804,22,21,1,20034,954,20988
421420,201804,149,122,27,115815.6,25471.8,141287.4
421430,201804,15,12,3,11448,2862,14310
421440,201804,56,43,13,41022,12402,53424
421450,201804,98,85,13,81090,12402,93492
421460,201804,59,50,9,46895.77,8586,55481.77
421470,201804,69,45,24,42930,22896,65826
421480,201804,640,475,165,452387,157401,609788
421490,201804,22,21,1,19358,954,20312
421500,201804,517,332,185,314925.19,176202.9,491128.09
421505,201804,24,18,6,17172,5724,22896
421507,201804,33,27,6,25758,5724,31482
421510,201804,72,46,26,43884,24804,68688
421520,201804,66,57,9,53615,8586,62201
421530,201804,53,49,4,46746,3816,50562
421535,201804,28,27,1,25491,954,26445
421540,201804,59,51,8,48654,7632,56286
421545,201804,96,74,22,70110,20988,91098
421550,201804,287,209,78,198719,74412,273131
421555,201804,27,22,5,20988,4675,25663
421560,201804,8,7,1,6678,954,7632
421565,201804,125,92,33,87768,31482,119250
421567,201804,30,25,5,23850,4770,28620
421568,201804,33,31,2,29574,1908,31482
421569,201804,8,8,0,7632,0,7632
421570,201804,145,99,46,94446,43884,138330
421575,201804,26,21,5,19771.65,4770,24541.65
421580,201804,720,430,290,408599,275706.34,684305.34
421590,201804,21,20,1,19080,954,20034
421600,201804,107,73,34,69642,31197,100839
421605,201804,102,72,30,68355,28620,96975
421610,201804,188,149,39,141192.5,37206,178398.5
421620,201804,1105,662,443,629048.92,422602.92,1051651.84
421625,201804,23,20,3,19080,2862,21942
421630,201804,281,181,100,171863.8,94542,266405.8
421635,201804,16,8,8,7632,7632,15264
421640,201804,101,87,14,82998,13356,96354
421650,201804,279,164,115,156436.92,109690.92,266127.84
421660,201804,2099,1259,840,1198169.2,801046.26,1999215.46
421670,201804,186,131,55,124974,52470,177444
421680,201804,168,153,15,145962,14301,160263
421690,201804,359,247,112,234657,105884.58,340541.58
421700,201804,59,37,22,35298,20130,55428
421710,201804,24,24,0,22896,0,22896
421715,201804,10,9,1,8586,954,9540
421720,201804,585,424,161,401879.4,151867.26,553746.66
421725,201804,14,7,7,6678,6678,13356
421730,201804,40,28,12,26004.12,11448,37452.12
421740,201804,86,41,45,39114,42930,82044
421750,201804,221,164,57,154010.51,54378,208388.51
421755,201804,24,23,1,21942,954,22896
421760,201804,102,73,29,69632.46,27666,97298.46
421770,201804,569,384,185,364138.38,176415.3,540553.68
421775,201804,29,20,9,19080,8586,27666
421780,201804,196,155,41,147870,39114,186984
421790,201804,156,131,25,124081.5,23850,147931.5
421795,201804,16,13,3,12402,2862,15264
421800,201804,468,302,166,287311.31,158364,445675.31
421810,201804,67,54,13,51516,12402,63918
421820,201804,309,212,97,201580.2,92538,294118.2
421825,201804,126,105,21,100170,20034,120204
421830,201804,128,97,31,92538,29574,122112
421835,201804,3,3,0,2862,0,2862
421840,201804,60,50,10,47691,9540,57231
421850,201804,76,66,10,62964,9536,72500
421860,201804,41,32,9,30528,8586,39114
421870,201804,981,745,236,701851.7,224335.42,926187.12
421875,201804,53,47,6,44838,5724,50562
421880,201804,162,119,43,113526,40736,154262
421885,201804,27,22,5,20988,4770,25758
421890,201804,111,78,33,74412,31482,105894
421895,201804,40,37,3,35298,2862,38160
421900,201804,151,124,27,117935.1,25722,143657.1
421910,201804,65,43,22,41022,20988,62010
421915,201804,33,27,6,25758,5724,31482
421917,201804,39,29,10,27666,9540,37206
421920,201804,33,30,3,28620,2862,31482
421930,201804,746,577,169,548417.26,161199,709616.26
421935,201804,57,50,7,47700,6678,54378
421940,201804,39,37,2,35298,1908,37206
421950,201804,825,542,283,510364.3,267486.32,777850.62
421960,201804,40,35,5,33104,4770,37874
421970,201804,374,233,141,221783.12,134483.12,356266.24
421985,201804,31,20,11,19080,10494,29574
422000,201804,0,0,0,0,0,0
430003,201804,207,49,158,46030.5,150732,196762.5
430005,201804,36,28,8,26712,7632,34344
430010,201804,276,194,82,184599,78228,262827
430020,201804,151,98,53,93206,49608,142814
430030,201804,130,102,28,97021.8,26712,123733.8
430040,201804,2979,1731,1248,1643206.04,1188848.42,2832054.46
430045,201804,68,58,10,55046,9540,64586
430047,201804,6,5,1,4770,954,5724
430050,201804,81,68,13,64872,12402,77274
430055,201804,17,14,3,13356,2862,16218
430057,201804,4,2,2,1908,1908,3816
430060,201804,3686,2204,1482,2095372.92,1409530.28,3504903.20
430063,201804,60,55,5,52470,4770,57240
430064,201804,148,124,24,118296,22896,141192
430066,201804,10,7,3,6678,2862,9540
430070,201804,42,32,10,30528,9540,40068
430080,201804,67,45,22,42230.33,20988,63218.33
430085,201804,35,11,24,10494,22896,33390
430087,201804,34,26,8,24661,7632,32293
430090,201804,72,65,7,61723.8,6678,68401.8
430100,201804,127,86,41,81090,39114,120204
430105,201804,143,71,72,67734,68382.72,136116.72
430107,201804,20,15,5,14310,4770,19080
430110,201804,414,240,174,228149.1,165929.22,394078.32
430120,201804,139,128,11,121158.9,10494,131652.9
430130,201804,799,504,295,480195.9,281143.8,761339.7
430140,201804,125,115,10,109710,9540,119250
430150,201804,112,73,39,68879,36252,105131
430155,201804,31,28,3,26712,2862,29574
430160,201804,3812,2253,1559,2128882.22,1483212.62,3612094.84
430163,201804,326,147,179,139189.34,170708.76,309898.10
430165,201804,24,16,8,15264,7632,22896
430170,201804,84,76,8,72504,7632,80136
430175,201804,84,66,18,62964,16504.2,79468.2
430180,201804,102,81,21,77274,19413.9,96687.9
430185,201804,32,24,8,22896,7632,30528
430187,201804,102,43,59,41022,55980.8,97002.8
430190,201804,220,123,97,117294.3,91861.46,209155.76
430192,201804,15,14,1,13356,954,14310
430195,201804,13,8,5,7632,4770,12402
430200,201804,166,148,18,140524.2,17172,157696.2
430205,201804,20,19,1,18126,954,19080
430210,201804,631,492,139,465647.4,130745.9,596393.3
430215,201804,15,11,4,10494,3816,14310
430220,201804,65,45,20,42930,19080,62010
430222,201804,13,7,6,6678,5724,12402
430223,201804,14,7,7,6678,6678,13356
430225,201804,4,3,1,2862,954,3816
430230,201804,300,185,115,175536,109710,285246
430235,201804,53,39,14,37206,13346.46,50552.46
430237,201804,30,22,8,20988,7632,28620
430240,201804,131,84,47,79945.2,44838,124783.2
430245,201804,72,61,11,58194,10494,68688
430250,201804,190,108,82,103022.46,78218.46,181240.92
430258,201804,13,11,2,10494,1908,12402
430260,201804,35,30,5,28620,4760.46,33380.46
430265,201804,34,29,5,27646.92,4770,32416.92
430270,201804,556,413,143,390612.54,135565.02,526177.56
430280,201804,1034,629,405,596431.26,383870.6,980301.86
430290,201804,375,219,156,207018.8,148824,355842.8
430300,201804,2127,1175,952,1117078.46,905148.81,2022227.27
430310,201804,1979,1044,935,988928.4,888938.85,1877867.25
430320,201804,49,41,8,39099.69,7632,46731.69
430330,201804,97,87,10,82521,9520.92,92041.92
430340,201804,65,58,7,55332,6678,62010
430350,201804,1677,1161,516,1096118.38,489537.44,1585655.82
430355,201804,26,23,3,21942,2862,24804
430360,201804,79,38,41,36252,38827.8,75079.8
430367,201804,27,19,8,18126,7632,25758
430370,201804,53,46,7,43884,6678,50562
430380,201804,129,98,31,92919.6,29574,122493.6
430390,201804,618,387,231,368864.1,220069.46,588933.56
430400,201804,139,106,33,99406.8,31462.92,130869.72
430410,201804,60,48,12,45792,11448,57240
430420,201804,497,325,172,307570.8,161549.21,469120.01
430430,201804,55,53,2,49926.63,1908,51834.63
430435,201804,156,117,39,110664,36490.5,147154.5
430440,201804,494,329,165,313866,157219.2,471085.2
430450,201804,1203,991,212,938832.14,202238.46,1141070.60
430460,201804,5081,2789,2292,2645417.87,2181330.71,4826748.58
430461,201804,17,15,2,14310,1908,16218
430462,201804,9,6,3,5724,2862,8586
430463,201804,1035,547,488,519414.92,465200.1,984615.02
430465,201804,26,15,11,14310,10494,24804
430466,201804,665,482,183,457920.2,174391.2,632311.4
430467,201804,101,58,43,54091.8,41012.46,95104.26
430468,201804,110,70,40,66780,37908.91,104688.91
430469,201804,22,17,5,16218,4770,20988
430470,201804,1161,641,520,604748.39,494124.3,1098872.69
430471,201804,48,36,12,34324.92,11448,45772.92
430480,201804,93,56,37,52565.4,35288.46,87853.86
430485,201804,6,6,0,5438,0,5438
430490,201804,88,70,18,65969.7,17172,83141.7
430495,201804,37,28,9,26712,8586,35298
430500,201804,195,132,63,125928,59726.46,185654.46
430510,201804,3103,2062,1041,1959353.29,991861.87,2951215.16
430511,201804,18,18,0,17172,0,17172
430512,201804,136,95,41,90630,39114,129744
430513,201804,52,44,8,41499,7632,49131
430515,201804,32,30,2,28620,1908,30528
430517,201804,170,150,20,142146,19060.92,161206.92
430520,201804,364,252,112,239741,106819.38,346560.38
430530,201804,88,53,35,50562,33390,83952
430535,201804,477,318,159,303172.43,151662.15,454834.58
430537,201804,10,10,0,9540,0,9540
430540,201804,71,48,23,45792,21942,67734
430543,201804,373,114,259,108756,247086,355842
430544,201804,41,38,3,36252,2862,39114
430545,201804,354,170,184,161684,175039.92,336723.92
430550,201804,44,36,8,34344,7632,41976
430558,201804,6,4,2,3816,1908,5724
430560,201804,47,20,27,19080,25758,44838
430570,201804,107,46,61,43884,58136.76,102020.76
430580,201804,123,96,27,91584,25710.3,117294.3
430583,201804,14,14,0,13356,0,13356
430585,201804,9,4,5,3816,4770,8586
430587,201804,14,8,6,7632,5724,13356
430590,201804,155,125,30,118009.8,28620,146629.8
430593,201804,4,4,0,3816,0,3816
430595,201804,17,13,4,12402,3816,16218
430597,201804,52,27,25,25758,23850,49608
430600,201804,219,155,64,147860.46,60769.8,208630.26
430605,201804,162,102,60,97308,57230.46,154538.46
430607,201804,27,22,5,20988,4770,25758
430610,201804,1643,773,870,734723.8,825935.78,1560659.58
430613,201804,2,2,0,1908,0,1908
430620,201804,113,82,31,78084.9,29564.46,107649.36
430630,201804,46,41,5,39114,4770,43884
430632,201804,32,27,5,25758,4770,30528
430635,201804,40,36,4,34344,3816,38160
430637,201804,54,30,24,28620,22896,51516
430640,201804,209,115,94,108279,89676,197955
430642,201804,27,25,2,23850,1908,25758
430645,201804,34,29,5,27666,4770,32436
430650,201804,257,206,51,196238,48606.3,244844.3
430655,201804,3,3,0,2862,0,2862
430660,201804,975,477,498,453483.9,473565.8,927049.7
430670,201804,73,51,22,48654,20988,69642
430673,201804,75,42,33,40068,31482,71550
430675,201804,13,10,3,9540,2862,12402
430676,201804,494,301,193,286429.04,184051.07,470480.11
430680,201804,250,175,75,164756,71550,236306
430690,201804,527,309,218,293899.32,206297.06,500196.38
430692,201804,7,5,2,4770,1908,6678
430693,201804,143,95,48,90630,45782.46,136412.46
430695,201804,73,65,8,61075.08,7632,68707.08
430697,201804,58,35,23,33390,21942,55332
430700,201804,1594,1117,477,1053664.42,454772,1508436.42
430705,201804,20,19,1,18126,954,19080
430710,201804,262,169,93,161226,88722,249948
430720,201804,108,91,17,86623.2,16218,102841.2
430730,201804,121,102,19,96354,17839.8,114193.8
430740,201804,65,43,22,41022,20988,62010
430745,201804,36,29,7,27380,6678,34058
430750,201804,341,227,114,215614.64,107802,323416.64
430755,201804,83,47,36,44838,34344,79182
430760,201804,372,225,147,211979.72,140209.92,352189.64
430770,201804,1475,763,712,725212.7,674791.27,1400003.97
430780,201804,311,200,111,189818.72,105827.76,295646.48
430781,201804,29,23,6,21942,5724,27666
430783,201804,51,41,10,38796.13,9540,48336.13
430786,201804,6,3,3,2862,2862,5724
430790,201804,501,323,178,306870.12,169516.46,476386.58
430800,201804,154,128,26,122092.92,24804,146896.92
430805,201804,41,37,4,35298,3816,39114
430807,201804,35,21,14,20034,13356,33390
430810,201804,73,47,26,44838,24804,69642
430820,201804,136,84,52,80136,48940.2,129076.2
430825,201804,12,10,2,9540,1908,11448
430830,201804,233,219,14,208620.92,13356,221976.92
430840,201804,126,86,40,82044,37492.2,119536.2
430843,201804,5,3,2,2862,1908,4770
430845,201804,68,39,29,37206,27666,64872
430850,201804,570,394,176,374702.58,167791.76,542494.34
430860,201804,155,99,56,93778.2,52746.66,146524.86
430865,201804,64,33,31,30814.2,29259.18,60073.38
430870,201804,81,66,15,62296.2,14310,76606.2
430880,201804,160,118,42,112552.92,40068,152620.92
430885,201804,7,6,1,5724,954,6678
430890,201804,337,205,132,193910.04,125928,319838.04
430900,201804,540,371,169,349736.4,160739.46,510475.86
430905,201804,89,37,52,35298,49608,84906
430910,201804,263,146,117,139284,110942,250226
430912,201804,3,3,0,2862,0,2862
430915,201804,36,28,8,26712,7345.8,34057.8
430920,201804,4240,2363,1877,2246822.91,1788208.82,4035031.73
430925,201804,5,4,1,3567.96,954,4521.96
430930,201804,2107,1252,855,1186663.8,815423.43,2002087.23
430940,201804,247,153,94,145284.66,89656.92,234941.58
430950,201804,158,128,30,122112,28620,150732
430955,201804,22,14,8,13356,7632,20988
430957,201804,18,17,1,16218,954,17172
430960,201804,238,160,78,150207.3,74412,224619.3
430965,201804,106,67,39,63918,37206,101124
430970,201804,79,65,14,62010,12402,74412
430975,201804,35,33,2,31482,1908,33390
430980,201804,44,26,18,24804,17172,41976
430990,201804,115,88,27,83952,25758,109710
430995,201804,114,110,4,103699.8,3816,107515.8
431000,201804,291,134,157,125689.2,149778,275467.2
431010,201804,335,201,134,190771.38,127836,318607.38
431020,201804,1924,1115,809,1055434.62,767674.26,1823108.88
431030,201804,43,34,9,32436,8586,41022
431033,201804,390,193,197,183311.2,187938,371249.2
431036,201804,16,9,7,8586,6678,15264
431040,201804,128,77,51,72504,48544.29,121048.29
431041,201804,36,24,12,22896,11448,34344
431043,201804,46,27,19,25758,18126,43884
431046,201804,11,6,5,5724,4770,10494
431050,201804,207,132,75,124401.6,70548.3,194949.9
431053,201804,75,45,30,42166.8,28620,70786.8
431055,201804,64,42,22,40068,20968.92,61036.92
431057,201804,17,17,0,16218,0,16218
431060,201804,1682,1060,622,1003724.66,591536.44,1595261.10
431065,201804,18,11,7,10494,6678,17172
431070,201804,71,66,5,62964,4770,67734
431075,201804,7,7,0,6678,0,6678
431080,201804,135,86,49,81757.8,46746,128503.8
431085,201804,30,27,3,25758,2862,28620
431087,201804,14,12,2,11448,1908,13356
431090,201804,54,42,12,40068,11448,51516
431100,201804,1237,737,500,692274.02,477000,1169274.02
431110,201804,243,151,92,144054,87758.46,231812.46
431112,201804,29,17,12,16218,11448,27666
431113,201804,30,20,10,19080,9540,28620
431115,201804,154,105,49,99533.87,46736.46,146270.33
431120,201804,617,363,254,344356.64,242239.84,586596.48
431123,201804,3,2,1,1908,954,2862
431125,201804,92,82,10,78228,9540,87768
431127,201804,7,3,4,2862,3816,6678
431130,201804,638,409,229,388945.8,218160.72,607106.52
431140,201804,729,493,236,466649.4,225067.68,691717.08
431142,201804,35,27,8,24546,7632,32178
431150,201804,207,152,55,145008,52460.46,197468.46
431160,201804,56,50,6,47700,5724,53424
431162,201804,19,14,5,13356,4770,18126
431164,201804,4,4,0,3816,0,3816
431170,201804,104,85,19,81090,18126,99216
431171,201804,53,29,24,27666,22886.46,50552.46
431173,201804,1,1,0,954,0,954
431175,201804,201,99,102,93206,97298.46,190504.46
431177,201804,76,57,19,54378,17439.92,71817.92
431179,201804,12,10,2,9540,1908,11448
431180,201804,440,265,175,252810,166931.46,419741.46
431190,201804,91,70,21,66780,20034,86814
431198,201804,72,47,25,44838,23850,68688
431200,201804,20,17,3,16218,2862,19080
431205,201804,23,23,0,21942,0,21942
431210,201804,89,55,34,52137,32436,84573
431213,201804,29,24,5,22896,4770,27666
431215,201804,26,23,3,21942,2862,24804
431217,201804,6,5,1,4770,954,5724
431220,201804,67,57,10,54378,9540,63918
431225,201804,149,98,51,93483,48634.92,142117.92
431230,201804,99,87,12,82998,11448,94446
431235,201804,7,7,0,6678,0,6678
431237,201804,24,15,9,14310,8586,22896
431238,201804,14,10,4,9254,3816,13070
431240,201804,996,641,355,609854.64,338154.84,948009.48
431242,201804,36,36,0,34344,0,34344
431244,201804,11,8,3,7632,2862,10494
431245,201804,59,45,14,42930,13356,56286
431247,201804,13,11,2,10494,1908,12402
431250,201804,269,138,131,131585.22,124954.92,256540.14
431260,201804,60,43,17,41022,16218,57240
431261,201804,21,14,7,13356,6678,20034
431262,201804,15,15,0,14310,0,14310
431265,201804,164,88,76,83952,72504,156456
431267,201804,13,12,1,11448,954,12402
431270,201804,316,265,51,252810,48654,301464
431275,201804,40,38,2,36252,1908,38160
431280,201804,20,16,4,14429.25,3816,18245.25
431290,201804,21,18,3,17172,2862,20034
431295,201804,5,5,0,4770,0,4770
431300,201804,20,17,3,16218,2862,19080
431301,201804,7,7,0,6678,0,6678
431303,201804,52,35,17,33265.98,15931.8,49197.78
431306,201804,225,117,108,111161.98,103032,214193.98
431308,201804,7,5,2,4770,1908,6678
431310,201804,64,55,9,52470,8586,61056
431320,201804,117,68,49,64872,46450.26,111322.26
431330,201804,178,116,62,110664,59148,169812
431333,201804,33,27,6,25758,5724,31482
431335,201804,10,5,5,4770,4770,9540
431337,201804,326,152,174,144149.58,164956.34,309105.92
431339,201804,20,17,3,16218,2862,19080
431340,201804,3042,1757,1285,1671662.34,1223087.9,2894750.24
431342,201804,43,26,17,24804,16218,41022
431344,201804,18,17,1,16218,954,17172
431346,201804,4,4,0,3816,0,3816
431349,201804,35,32,3,30528,2862,33390
431350,201804,910,532,378,502979.66,358952.04,861931.70
431360,201804,44,38,6,36252,5724,41976
431365,201804,318,152,166,144988.92,157400.46,302389.38
431370,201804,1333,789,544,749071.93,518455.08,1267527.01
431380,201804,97,84,13,80136,12402,92538
431390,201804,494,275,219,261319.88,208382.22,469702.10
431395,201804,283,123,160,117342,152621,269963
431400,201804,40,30,10,28620,9540,38160
431402,201804,97,66,31,62964,29574,92538
431403,201804,19,11,8,10494,7632,18126
431405,201804,646,348,298,330352.02,283979,614331.02
431406,201804,32,28,4,26712,3816,30528
431407,201804,50,40,10,38160,9540,47700
431410,201804,3271,1955,1316,1851732.29,1250822.72,3102555.01
431413,201804,16,13,3,12402,2862,15264
431415,201804,71,52,19,49608,18126,67734
431417,201804,23,12,11,11448,10494,21942
431420,201804,305,215,90,204426.26,85860,290286.26
431430,201804,44,17,27,16218,25758,41976
431440,201804,8997,6406,2591,6040374,2463959.11,8504333.11
431442,201804,27,14,13,13356,12402,25758
431445,201804,27,21,6,20034,5724,25758
431446,201804,7,6,1,5724,954,6678
431447,201804,85,60,25,57240,23850,81090
431449,201804,51,45,6,42930,5724,48654
431450,201804,412,284,128,269886.6,121396.5,391283.1
431454,201804,0,0,0,0,0,0
431455,201804,50,40,10,38160,9540,47700
431460,201804,531,366,165,347112.9,157123.8,504236.7
431470,201804,116,91,25,86122.54,23600,109722.54
431475,201804,11,10,1,9540,954,10494
431477,201804,37,25,12,23850,11448,35298
431478,201804,8,7,1,6678,954,7632
431480,201804,503,319,184,302780.52,175488.3,478268.82
431490,201804,28210,16038,12172,15224218.1,11577625.94,26801844.04
431500,201804,79,53,26,50562,24804,75366
431505,201804,38,22,16,20988,15264,36252
431507,201804,12,10,2,9540,1908,11448
431510,201804,276,183,93,174153,87748.92,261901.92
431513,201804,23,18,5,17172,4770,21942
431514,201804,8,7,1,6678,954,7632
431515,201804,80,67,13,63918,12402,76320
431517,201804,3,2,1,1908,954,2862
431520,201804,38,34,4,32436,3816,36252
431530,201804,1599,713,886,679152.84,844820.09,1523972.93
431531,201804,23,21,2,20034,1908,21942
431532,201804,25,17,8,16218,7632,23850
431535,201804,25,16,9,15264,8586,23850
431540,201804,140,125,15,118229.22,14310,132539.22
431545,201804,17,15,2,14310,1908,16218
431550,201804,350,202,148,192708,141096.6,333804.6
431555,201804,12,11,1,10494,954,11448
431560,201804,4527,3195,1332,3016680.62,1268362.98,4285043.60
431570,201804,794,423,371,400394.2,351063.46,751457.66
431575,201804,36,25,11,23850,10494,34344
431580,201804,96,67,29,62964,27666,90630
431590,201804,139,116,23,109710,21942,131652
431595,201804,12,11,1,10494,954,11448
431600,201804,219,126,93,120204,88722,208926
431610,201804,128,93,35,88054.2,33390,121444.2
431620,201804,42,34,8,32436,7632,40068
431630,201804,139,117,22,111618,20988,132606
431640,201804,1353,839,514,794181.49,487829.14,1282010.63
431642,201804,39,36,3,33867,2862,36729
431643,201804,45,20,25,19080,23850,42930
431645,201804,300,173,127,165042,120871.8,285913.8
431647,201804,10,10,0,9540,0,9540
431650,201804,36,27,9,25758,8586,34344
431660,201804,282,183,99,172674,94446,267120
431670,201804,220,105,115,97546.5,109681.38,207227.88
431673,201804,3,3,0,2862,0,2862
431675,201804,31,26,5,24517.8,4770,29287.8
431680,201804,1099,785,314,744978.6,298459.44,1043438.04
431690,201804,4803,2929,1874,2773023.6,1783877.76,4556901.36
431695,201804,26,20,6,19080,5724,24804
431697,201804,0,0,0,0,0,0
431700,201804,171,132,39,125928,37206,163134
431710,201804,4015,1727,2288,1644878,2182252.94,3827130.94
431720,201804,1392,828,564,781972.25,536802.26,1318774.51
431725,201804,1,1,0,954,0,954
431730,201804,1193,811,382,766999.1,364428,1131427.1
431740,201804,1366,680,686,643816.52,653893.58,1297710.10
431750,201804,1877,1216,661,1149787.5,628657.92,1778445.42
431755,201804,6,5,1,4770,954,5724
431760,201804,1082,692,390,659786.4,371831.58,1031617.98
431770,201804,396,289,107,275696.46,102058.92,377755.38
431775,201804,29,22,7,20988,6678,27666
431780,201804,562,348,214,330875.82,204146.46,535022.28
431790,201804,152,114,38,107802,36204.3,144006.3
431795,201804,14,12,2,11448,1908,13356
431800,201804,3377,1774,1603,1679506.02,1522962.88,3202468.90
431805,201804,16,15,1,14310,954,15264
431810,201804,619,415,204,393276.96,194482.98,587759.94
431820,201804,311,175,136,166950,128742.3,295692.3
431830,201804,2334,1412,922,1343708.43,878327.65,2222036.08
431840,201804,516,343,173,323598.4,163802,487400.4
431842,201804,34,28,6,26712,5724,32436
431843,201804,12,8,4,7632,3816,11448
431844,201804,14,12,2,11448,1908,13356
431845,201804,29,26,3,24804,2862,27666
431846,201804,28,24,4,22896,3816,26712
431848,201804,14,12,2,11448,1908,13356
431849,201804,9,7,2,6678,1908,8586
431850,201804,801,666,135,633851.51,128551.5,762403.01
431860,201804,103,73,30,69642,27666,97308
431861,201804,4,2,2,1908,1908,3816
431862,201804,52,34,18,32436,17172,49608
431870,201804,3466,2047,1419,1944390.96,1350047.02,3294437.98
431880,201804,948,694,254,657278,241362,898640
431890,201804,1301,807,494,764841.74,469669,1234510.74
431900,201804,185,128,57,122112,53586.18,175698.18
431910,201804,56,42,14,40068,13356,53424
431912,201804,36,19,17,18126,16218,34344
431915,201804,129,102,27,97308,25758,123066
431920,201804,145,107,38,101791.8,36252,138043.8
431930,201804,87,71,16,67734,15264,82998
431935,201804,4,3,1,2862,954,3816
431936,201804,12,11,1,10494,954,11448
431937,201804,18,13,5,12402,4770,17172
431940,201804,459,308,151,291065.4,144044.46,435109.86
431950,201804,480,307,173,291638.88,164890.98,456529.86
431960,201804,721,425,296,401264.02,282222.9,683486.92
431970,201804,71,62,9,59148,8586,67734
431971,201804,2,2,0,1908,0,1908
431973,201804,20,16,4,15264,3816,19080
431975,201804,7,6,1,5724,954,6678
431980,201804,202,128,74,120585.6,70596,191181.6
431990,201804,1228,665,563,632889.29,537056,1169945.29
432000,201804,1665,900,765,851201.44,726245.24,1577446.68
432010,201804,281,186,95,176330.96,90630,266960.96
432020,201804,171,135,36,128790,34334.46,163124.46
432023,201804,19,15,4,14310,3816,18126
432026,201804,64,57,7,54378,6678,61056
432030,201804,64,28,36,26712,34344,61056
432032,201804,21,18,3,17172,2862,20034
432035,201804,49,38,11,36252,10494,46746
432040,201804,102,69,33,65826,31482,97308
432045,201804,8,7,1,6678,954,7632
432050,201804,69,42,27,40068,25758,65826
432055,201804,99,72,27,68688,25758,94446
432057,201804,1,0,1,0,954,954
432060,201804,36,33,3,31482,2862,34344
432065,201804,31,28,3,26712,2862,29574
432067,201804,88,78,10,74392.92,9540,83932.92
432070,201804,403,302,101,286211.39,96325.92,382537.31
432080,201804,810,557,253,529489.78,241266.68,770756.46
432085,201804,16,12,4,11448,3816,15264
432090,201804,260,162,98,154548,93492,248040
432100,201804,178,118,60,112190.4,57240,169430.4
432110,201804,613,420,193,394145.64,183168,577313.64
432120,201804,955,576,379,548836.2,361480.14,910316.34
432130,201804,509,368,141,349736.4,133416.9,483153.3
432132,201804,26,23,3,21942,2862,24804
432135,201804,79,65,14,62010,13356,75366
432140,201804,266,212,54,201952.26,51516,253468.26
432143,201804,189,120,69,114480,65826,180306
432145,201804,271,189,82,178494.2,77941.8,256436.0
432146,201804,14,13,1,12402,954,13356
432147,201804,134,61,73,58194,69618.15,127812.15
432149,201804,18,13,5,12402,4770,17172
432150,201804,838,526,312,500601.96,295564.64,796166.60
432160,201804,1400,724,676,688398.4,643998.44,1332396.84
432162,201804,5,4,1,3816,954,4770
432163,201804,18,14,4,13356,3816,17172
432166,201804,122,92,30,88246,28620,116866
432170,201804,224,122,102,115435,97308,212743
432180,201804,525,319,206,301559.98,196238,497797.98
432183,201804,9,7,2,6678,1908,8586
432185,201804,84,73,11,69546.6,10494,80040.6
432190,201804,468,259,209,246504.86,199253.52,445758.38
432195,201804,85,74,11,69880.5,10494,80374.5
432200,201804,414,269,145,256626,138282.84,394908.84
432210,201804,120,78,42,72647.1,40068,112715.1
432215,201804,62,58,4,55332,3816,59148
432218,201804,19,18,1,17172,954,18126
432220,201804,684,346,338,329073.64,321944.74,651018.38
432225,201804,13,8,5,7155,4770,11925
432230,201804,142,86,56,81805.5,53424,135229.5
432232,201804,16,13,3,12402,2862,15264
432234,201804,4,3,1,2862,954,3816
432235,201804,1,1,0,954,0,954
432237,201804,29,17,12,16218,11448,27666
432240,201804,4229,2354,1875,2236617.28,1781081.38,4017698.66
432250,201804,1030,655,375,622200.26,357559.2,979759.46
432252,201804,39,32,7,29783.88,6678,36461.88
432253,201804,60,48,12,45792,11448,57240
432254,201804,23,11,12,10494,11448,21942
432255,201804,14,13,1,12402,954,13356
432260,201804,869,681,188,648615.26,178398.5,827013.76
432270,201804,227,167,60,159318,57240,216558
432280,201804,126,92,34,87291.8,32436,119727.8
432285,201804,2,1,1,954,954,1908
432290,201804,70,63,7,58194,6678,64872
432300,201804,4641,2649,1992,2511420.35,1896498.16,4407918.51
432310,201804,118,95,23,90630,21942,112572
432320,201804,20,15,5,14262.3,4770,19032.3
432330,201804,15,10,5,9540,4770,14310
432335,201804,7,6,1,5724,954,6678
432340,201804,39,36,3,34344,2862,37206
432345,201804,94,66,28,62964,26712,89676
432350,201804,24,23,1,21942,954,22896
432360,201804,6,4,2,3816,1908,5724
432370,201804,25,25,0,23850,0,23850
432375,201804,39,34,5,32436,4770,37206
432377,201804,7,7,0,6678,0,6678
432380,201804,169,77,92,72790.2,87720.3,160510.5
500020,201804,249,136,113,129744,107200.98,236944.98
500025,201804,115,56,59,52470,56286,108756
500060,201804,1397,857,540,817005.6,514554.61,1331560.21
500070,201804,769,367,402,349767,383498.46,733265.46
500080,201804,135,103,32,98262,30528,128790
500085,201804,139,113,26,107516,23969.25,131485.25
500090,201804,333,160,173,152640,165042,317682
500100,201804,702,376,326,356509.8,310432,666941.8
500110,201804,2251,1014,1237,967019.92,1179275.6,2146295.52
500124,201804,312,178,134,169812,127549.8,297361.8
500150,201804,326,128,198,122103,188532,310635
500190,201804,521,359,162,341818.2,154062,495880.2
500200,201804,200,171,29,162791,27666,190457
500210,201804,1466,523,943,497811.01,898458.99,1396270.00
500215,201804,242,137,105,129250.73,100170,229420.73
500220,201804,795,520,275,495835.84,261592.46,757428.30
500230,201804,255,172,83,163372.5,78705,242077.5
500240,201804,710,491,219,467650.8,208639.8,676290.6
500260,201804,568,213,355,203202,338670,541872
500270,201804,28372,12062,16310,11476699.27,15544154.91,27020854.18
500280,201804,193,73,120,69642,114480,184122
500290,201804,1198,707,491,673239,468405,1141644
500295,201804,412,251,161,239454,153584.46,393038.46
500310,201804,63,20,43,19080,41022,60102
500315,201804,702,422,280,402578.46,266824.26,669402.72
500320,201804,3621,1817,1804,1730991.38,1719512,3450503.38
500325,201804,932,518,414,493695,393981.44,887676.44
500330,201804,1485,685,800,651268.28,762789.64,1414057.92
500345,201804,326,239,87,227043.2,82998,310041.2
500348,201804,242,143,99,136422,94427.46,230849.46
500350,201804,140,67,73,63918,69642,133560
500370,201804,5436,2445,2991,2325002.1,2850613.24,5175615.34
500375,201804,351,255,96,242020.64,91584,333604.64
500380,201804,591,337,254,321340.59,242306.46,563647.05
500390,201804,72,36,36,34344,34344,68688
500400,201804,222,149,73,142126.92,69633,211759.92
500410,201804,564,221,343,210788.15,327074.22,537862.37
500430,201804,552,384,168,366336,160272,526608
500440,201804,204,105,99,99397.43,94446,193843.43
500450,201804,413,178,235,169106.8,223835.12,392941.92
500460,201804,312,159,153,151676.46,145962,297638.46
500470,201804,442,346,96,328869.67,90621,419490.67
500480,201804,116,69,47,65826,44838,110664
500490,201804,108,44,64,41971.23,61056,103027.23
500500,201804,1427,501,926,475922.59,882814.64,1358737.23
500510,201804,48,38,10,36252,9531,45783
500515,201804,110,77,33,73458,31196,104654
500520,201804,348,194,154,184027,146626,330653
500525,201804,87,50,37,47700,35011.8,82711.8
500540,201804,896,377,519,359305.76,494115.84,853421.60
500560,201804,885,504,381,478326.62,362782.88,841109.50
500568,201804,999,576,423,546928.2,403251.23,950179.43
500570,201804,1214,683,531,648579.5,504253.12,1152832.62
500580,201804,336,171,165,162838.26,157397,320235.26
500600,201804,313,157,156,149067.27,148806,297873.27
500620,201804,917,645,272,609552.67,259297.2,868849.87
500625,201804,83,71,12,67027.19,11448,78475.19
500627,201804,25,12,13,11448,12402,23850
500630,201804,1572,833,739,794005.46,704529.8,1498535.26
500635,201804,518,294,224,280056.24,213552.9,493609.14
500640,201804,426,223,203,210168,193643.46,403811.46
500660,201804,5517,2118,3399,2016852.5,3237944.32,5254796.82
500690,201804,570,202,368,192351.24,349365.71,541716.95
500710,201804,358,176,182,167618,173610,341228
500720,201804,973,570,403,542096.69,384252.92,926349.61
500730,201804,198,117,81,111618,77269.23,188887.23
500740,201804,846,368,478,349780.95,455737.75,805518.70
500750,201804,140,47,93,44838,88693.92,133531.92
500755,201804,122,88,34,83666,32436,116102
500769,201804,746,422,324,402266.04,309083,711349.04
500770,201804,435,230,205,219410.46,195560.46,414970.92
500780,201804,171,114,57,108756,54378,163134
500790,201804,1043,515,528,490733.23,503385.46,994118.69
500793,201804,254,137,117,130698,111609,242307
500795,201804,179,128,51,122102.46,48645,170747.46
500797,201804,38,30,8,28620,7632,36252
500800,201804,408,176,232,167895,221041.8,388936.8
500830,201804,2202,1230,972,1171007.92,926248.68,2097256.60
500840,201804,145,109,36,103986,34335,138321
510010,201804,162,91,71,86804.46,67734,154538.46
510020,201804,487,225,262,214356.06,249363.5,463719.56
510025,201804,1673,948,725,903522.13,689114.08,1592636.21
510030,201804,663,341,322,325267.92,306414.69,631682.61
510035,201804,129,59,70,56258.46,66761.46,123019.92
510040,201804,385,173,212,165042,201801.26,366843.26
510050,201804,426,233,193,221531.66,183317.46,404849.12
510060,201804,116,57,59,54368.46,56276.46,110644.92
510080,201804,221,89,132,84873.69,125814.06,210687.75
510100,201804,77,34,43,32436,41002.92,73438.92
510120,201804,37,22,15,20988,14310,35298
510125,201804,397,243,154,231139.89,146892.92,378032.81
510130,201804,574,335,239,319175.81,227573.1,546748.91
510140,201804,394,130,264,124011,251851.23,375862.23
510160,201804,92,40,52,38160,49604,87764
510170,201804,869,526,343,501538.05,326589.38,828127.43
510180,201804,2872,1396,1476,1328789.72,1406190.32,2734980.04
510185,201804,13,7,6,6678,5724,12402
510190,201804,212,72,140,68688,133555.23,202243.23
510250,201804,2622,1548,1074,1475751.07,1023473.18,2499224.25
510260,201804,203,145,58,138147.84,55295.46,193443.30
510263,201804,458,251,207,238451.46,196722.59,435174.05
510267,201804,659,366,293,348608.76,279251.45,627860.21
510268,201804,56,29,27,27666,25758,53424
510269,201804,66,30,36,28611,34344,62955
510270,201804,408,206,202,196345.98,192291.48,388637.46
510279,201804,228,168,60,160245,56934.92,217179.92
510285,201804,166,73,93,69623.46,88722,158345.46
510300,201804,546,297,249,282887.06,237471.84,520358.90
510305,201804,219,101,118,96331.46,112478.22,208809.68
510310,201804,112,57,55,54378,52460.46,106838.46
510320,201804,866,541,325,515536.64,309689.38,825226.02
510325,201804,415,167,248,159308.46,236296.26,395604.72
510330,201804,425,240,185,228947,176470.92,405417.92
510335,201804,593,321,272,306187.38,258850.98,565038.36
510336,201804,48,36,12,34344,11448,45792
510337,201804,119,48,71,45782.46,67724.46,113506.92
510340,201804,17409,8359,9050,7951654.72,8623633.14,16575287.86
510343,201804,71,49,22,46736.46,20988,67724.46
510345,201804,157,105,52,100160.46,49302.92,149463.38
510350,201804,666,369,297,351084.07,283273.38,634357.45
510360,201804,204,121,83,115425,79099.92,194524.92
510370,201804,139,71,68,67705.38,64740.6,132445.98
510380,201804,90,62,28,59148,26703,85851
510385,201804,58,27,31,25758,29565,55323
510390,201804,121,51,70,48654,66741.84,115395.84
510395,201804,40,29,11,27666,10494,38160
510410,201804,710,473,237,451238,226074.69,677312.69
510420,201804,588,286,302,271899.34,286687.99,558587.33
510450,201804,51,30,21,28620,20034,48654
510452,201804,41,23,18,21942,17172,39114
510454,201804,63,27,36,25758,34334.46,60092.46
510455,201804,127,81,46,77254.92,43884,121138.92
510460,201804,185,99,86,94107.16,82006.38,176113.54
510480,201804,757,435,322,413863.81,306859.36,720723.17
510490,201804,362,185,177,176110.8,168353.08,344463.88
510500,201804,253,191,62,182204.46,59148,241352.46
510510,201804,797,454,343,432230.06,327212.46,759442.52
510515,201804,1147,611,536,582525.38,511297.38,1093822.76
510517,201804,244,104,140,98929.8,133536.69,232466.49
510520,201804,236,154,82,146823.3,77908.3,224731.6
510523,201804,91,64,27,61056,25748.46,86804.46
510525,201804,726,408,318,388477.84,303261.3,691739.14
510530,201804,15,11,4,10494,3816,14310
510550,201804,273,118,155,112563,147861,260424
510558,201804,274,134,140,127803.15,133531.92,261335.07
510560,201804,387,241,146,229628,139266,368894
510562,201804,639,449,190,427015.17,180773.46,607788.63
510590,201804,813,423,390,403494.84,372041.69,775536.53
510600,201804,259,142,117,135444.92,111580.92,247025.84
510610,201804,170,82,88,78208.92,83370.46,161579.38
510615,201804,195,80,115,76300.92,109710,186010.92
510617,201804,17,10,7,9540,6678,16218
510618,201804,115,54,61,51516,57717,109233
510619,201804,106,74,32,70587,30519,101106
510620,201804,185,103,82,98252.46,78228,176480.46
510621,201804,196,124,72,118277.46,68660.46,186937.92
510622,201804,451,290,161,276567.84,153270.38,429838.22
510623,201804,354,237,117,226051.38,111589.38,337640.76
510624,201804,88,42,46,40059,43884,83943
510625,201804,537,332,205,316518.3,194992.52,511510.82
510626,201804,107,67,40,63918,38160,102078
510627,201804,59,43,16,41022,15264,56286
510628,201804,163,97,66,92491.92,62906.76,155398.68
510629,201804,253,161,92,153594,86804.46,240398.46
510630,201804,467,238,229,226967.22,218119.95,445087.17
510631,201804,11,3,8,2862,7346,10208
510637,201804,344,193,151,183776.18,143916.84,327693.02
510642,201804,978,544,434,518625.18,413893.44,932518.62
510645,201804,0,0,0,0,0,0
510650,201804,1502,992,510,946214.38,486408.76,1432623.14
510665,201804,85,43,42,40966,40068,81034
510670,201804,65,36,29,34344,27666,62010
510675,201804,1170,705,465,672539,443587.23,1116126.23
510677,201804,361,174,187,164990.84,178145.68,343136.52
510680,201804,108,63,45,60084,42921,103005
510682,201804,202,96,106,91262,101124,192386
510685,201804,52,37,15,35298,14310,49608
510700,201804,621,365,256,348091.92,244090.76,592182.68
510704,201804,1068,579,489,550022.16,464949.44,1014971.60
510706,201804,128,63,65,60097.23,61972.92,122070.15
510710,201804,394,267,127,253728.24,121043.68,374771.92
510715,201804,64,47,17,44828.46,16218,61046.46
510718,201804,210,113,97,107708.76,92519.46,200228.22
510719,201804,35,19,16,18126,15264,33390
510720,201804,196,131,65,124965,61723.8,186688.8
510724,201804,90,37,53,35288.46,50529.38,85817.84
510726,201804,52,27,25,25748.46,23832,49580.46
510729,201804,73,34,39,32436,37167.84,69603.84
510730,201804,474,264,210,251838,200192.46,452030.46
510735,201804,111,43,68,41022,64872,105894
510740,201804,29,16,13,15264,12402,27666
510757,201804,19,15,4,14310,3816,18126
510760,201804,7062,3744,3318,3562217.29,3159109.23,6721326.52
510770,201804,723,343,380,327033.3,362325.3,689358.6
510774,201804,15,6,9,5724,8586,14310
510775,201804,113,85,28,81080.46,26702.46,107782.92
510776,201804,31,8,23,7632,21942,29574
510777,201804,186,82,104,78199.38,99187.38,177386.76
510779,201804,53,24,29,22887,27628.92,50515.92
510780,201804,293,163,130,155439.46,123955,279394.46
510785,201804,441,239,202,227949.3,192641.22,420590.52
510787,201804,191,97,94,92529,89658.23,182187.23
510788,201804,0,0,0,0,0,0
510790,201804,2408,1250,1158,1190628.4,1102632.66,2293261.06
510792,201804,1090,616,474,586881.47,451780.34,1038661.81
510794,201804,118,59,59,56286,56257.92,112543.92
510795,201804,2400,1392,1008,1321148.29,958873.63,2280021.92
510800,201804,186,113,73,107792.46,69633,177425.46
510805,201804,171,119,52,113526,49608,163134
510810,201804,95,39,56,37123.38,53300.52,90423.90
510820,201804,259,121,138,115007.46,130652.03,245659.49
510830,201804,65,40,25,38160,23841,62001
510835,201804,7,5,2,4770,1908,6678
510840,201804,9282,4589,4693,4362985.03,4469679.53,8832664.56
510850,201804,211,89,122,84896.46,116064.18,200960.64
510860,201804,384,168,216,160085.52,205373.8,365459.32
510880,201804,63,48,15,45773.46,14310,60083.46
510885,201804,72,44,28,41957.46,26683.38,68640.84
510890,201804,73,42,31,40068,29574,69642
510895,201804,186,106,80,101124,76011.46,177135.46
520005,201804,35,24,11,22896,10494,33390
520010,201804,275,123,152,117342,144913,262255
520013,201804,640,384,256,366308,243937.8,610245.8
520015,201804,51,37,14,35298,13356,48654
520017,201804,104,60,44,56954,41976,98930
520020,201804,27,13,14,12402,13356,25758
520025,201804,2005,1086,919,1034861.24,875286.4,1910147.64
520030,201804,790,405,385,385407,366669.9,752076.9
520050,201804,80,55,25,52470,23850,76320
520055,201804,44,30,14,28620,13356,41976
520060,201804,177,113,64,107802,61056,168858
520080,201804,594,417,177,397818,168858,566676
520082,201804,20,14,6,13356,5724,19080
520085,201804,100,72,28,68688,26712,95400
520090,201804,93,65,28,62010,26712,88722
520110,201804,9001,3902,5099,3717376.16,4860285.98,8577662.14
520120,201804,14,8,6,7431.66,5724,13155.66
520130,201804,760,529,231,504370.8,220365,724735.8
520140,201804,11780,6654,5126,6340733.15,4887842.23,11228575.38
520145,201804,45,34,11,32436,10494,42930
520150,201804,190,148,42,141192,40068,181260
520160,201804,29,22,7,20988,6678,27666
520170,201804,234,146,88,139252,83915,223167
520180,201804,119,62,57,59148,54378,113526
520215,201804,216,133,83,126595.8,78895.8,205491.6
520235,201804,70,53,17,50562,16218,66780
520250,201804,134,80,54,76320,51229.8,127549.8
520260,201804,111,69,42,65826,39114,104940
520280,201804,47,33,14,30815,13356,44171
520310,201804,39,27,12,25758,11448,37206
520320,201804,165,106,59,101114.46,56286,157400.46
520330,201804,782,411,371,392048.46,353907,745955.46
520340,201804,352,200,152,190800,144970.46,335770.46
520350,201804,523,238,285,227052,271843,498895
520355,201804,89,51,38,48654,36252,84906
520357,201804,25,18,7,17172,6678,23850
520360,201804,0,0,0,0,0,0
520380,201804,139,72,67,68688,63918,132606
520390,201804,283,118,165,112095,157147.5,269242.5
520393,201804,13,10,3,9540,2862,12402
520396,201804,96,56,40,53424,38160,91584
520400,201804,224,131,93,123353.2,88722,212075.2
520410,201804,202,104,98,99207,93483,192690
520420,201804,22,15,7,14310,6678,20988
520425,201804,299,128,171,121159,162658.2,283817.2
520430,201804,458,238,220,226765.8,209824,436589.8
520440,201804,617,418,199,398772,189826.92,588598.92
520450,201804,1912,867,1045,826223.46,996283.98,1822507.44
520455,201804,58,41,17,39114,16218,55332
520460,201804,31,16,15,15264,14310,29574
520465,201804,23,19,4,18126,3816,21942
520470,201804,415,256,159,243918.63,151686,395604.63
520480,201804,81,46,35,43884,33345,77229
520485,201804,125,42,83,40068,78896,118964
520490,201804,403,296,107,282199.98,102078,384277.98
520495,201804,176,107,69,102078,65826,167904
520500,201804,174,131,43,124974,41022,165996
520505,201804,177,92,85,87763.23,81090,168853.23
520510,201804,1782,879,903,835239.74,859308.18,1694547.92
520520,201804,37,28,9,26712,8586,35298
520530,201804,230,172,58,161696.32,55322.46,217018.78
520540,201804,530,356,174,338317.02,165996,504313.02
520545,201804,161,89,72,84906,68688,153594
520547,201804,54,30,24,28620,22896,51516
520549,201804,1122,546,576,520560,549386,1069946
520551,201804,295,152,143,145008,136136,281144
520552,201804,46,27,19,25758,18126,43884
520570,201804,16,9,7,8586,6678,15264
520580,201804,283,170,113,162161.46,107802,269963.46
520590,201804,166,99,67,94446,63631.8,158077.8
520620,201804,1168,543,625,517164.48,595668.26,1112832.74
520630,201804,44,26,18,24804,17172,41976
520640,201804,414,235,179,224190,170766,394956
520650,201804,55,39,16,37206,15264,52470
520660,201804,35,19,16,18117,15264,33381
520670,201804,34,29,5,27666,4770,32436
520680,201804,57,37,20,35298,19080,54378
520690,201804,33,10,23,9540,21913.92,31453.92
520710,201804,39,35,4,33390,3816,37206
520725,201804,197,125,72,119250,68688,187938
520735,201804,60,42,18,40068,17172,57240
520740,201804,404,200,204,190085.4,194607,384692.4
520750,201804,37,27,10,25758,9540,35298
520753,201804,55,38,17,36252,16218,52470
520760,201804,111,75,36,71550,34344,105894
520780,201804,289,218,71,207972,67734,275706
520790,201804,165,82,83,77941.8,79182,157123.8
520800,201804,3452,1840,1612,1752677.06,1537170.9,3289847.96
520810,201804,168,120,48,114480,45792,160272
520815,201804,5,5,0,4770,0,4770
520830,201804,139,91,48,86814,45505.8,132319.8
520840,201804,350,229,121,217989,115434,333423
520850,201804,110,70,40,66771,38007.36,104778.36
520860,201804,1685,1070,615,1019359.54,585566.2,1604925.74
520870,201804,30808,15184,15624,14457138.93,14890027.72,29347166.65
520880,201804,1066,584,482,557136,459808.92,1016944.92
520890,201804,796,459,337,436255.4,321393.46,757648.86
520910,201804,1037,548,489,519215.74,466506,985721.74
520915,201804,101,76,25,72504,23840.46,96344.46
520920,201804,406,198,208,188319.6,198422.46,386742.06
520929,201804,17,16,1,15264,954,16218
520940,201804,73,46,27,43884,25758,69642
520945,201804,21,13,8,12402,7632,20034
520960,201804,45,29,16,27666,15264,42930
520970,201804,328,205,123,194941,117055.8,311996.8
520980,201804,87,63,24,60102,22896,82998
520990,201804,475,320,155,305280,147870,453150
520993,201804,128,61,67,58194,63909,122103
520995,201804,242,135,107,127837,101506,229343
521000,201804,1553,906,647,862321.4,616857,1479178.4
521010,201804,675,313,362,298275.36,345282.3,643557.66
521015,201804,17,10,7,9540,6678,16218
521020,201804,1464,1021,443,973404.9,422251.22,1395656.12
521030,201804,47,33,14,31482,13356,44838
521040,201804,940,577,363,550220.2,346016,896236.2
521056,201804,41,29,12,27666,11448,39114
521060,201804,132,81,51,77274,48654,125928
521080,201804,470,351,119,334559,113526,448085
521090,201804,534,322,212,305375.4,202248,507623.4
521100,201804,283,210,73,200331,69642,269973
521120,201804,1054,726,328,691255.88,312617,1003872.88
521130,201804,365,261,104,248984.46,98330.6,347315.06
521140,201804,187,108,79,103032,75366,178398
521150,201804,2797,1212,1585,1155238.88,1510531.49,2665770.37
521160,201804,33,17,16,16218,15264,31482
521170,201804,192,113,79,107792.46,75366,183158.46
521180,201804,1136,719,417,684295.26,397103.2,1081398.46
521190,201804,2546,1076,1470,1026484.92,1401502.72,2427987.64
521200,201804,47,34,13,32436,12402,44838
521205,201804,14,10,4,9540,3816,13356
521210,201804,145,83,62,79182,59148,138330
521220,201804,819,560,259,531607.76,247030,778637.76
521225,201804,31,20,11,19080,10494,29574
521230,201804,110,72,38,68401.8,36252,104653.8
521250,201804,6221,3578,2643,3408117.22,2518829.26,5926946.48
521260,201804,22,14,8,13356,7632,20988
521270,201804,143,111,32,105894,30528,136422
521280,201804,437,259,178,246418.2,169812,416230.2
521290,201804,30,12,18,11448,17172,28620
521295,201804,99,67,32,63689.04,30528,94217.04
521300,201804,230,118,112,112554,106488.38,219042.38
521305,201804,35,23,12,21942,11448,33390
521308,201804,1075,783,292,746483.14,278273,1024756.14
521310,201804,1352,801,551,762869.4,524462.92,1287332.32
521340,201804,19,16,3,15264,2862,18126
521350,201804,131,96,35,91584,33390,124974
521370,201804,190,121,69,115434,65539.8,180973.8
521375,201804,190,107,83,102078,78895.8,180973.8
521377,201804,52,35,17,33390,16218,49608
521380,201804,1087,708,379,671284.22,361566,1032850.22
521385,201804,15,8,7,7632,6678,14310
521390,201804,106,86,20,81726.04,19080,100806.04
521400,201804,326,207,119,197191.8,113478.3,310670.1
521405,201804,150,78,72,74412,68688,143100
521410,201804,65,43,22,41022,20988,62010
521440,201804,207,146,61,138473.1,58194,196667.1
521450,201804,719,395,324,376830,309096,685926
521460,201804,1187,729,458,695179.8,436912.92,1132092.72
521470,201804,14,9,5,8586,4770,13356
521480,201804,47,32,15,30501,14245,44746
521483,201804,307,167,140,159032,133560,292592
521486,201804,285,182,103,172836.18,97595,270431.18
521487,201804,21,10,11,9540,10494,20034
521490,201804,27,16,11,15264,10494,25758
521500,201804,116,75,41,71550,39114,110664
521520,201804,42,31,11,29574,10494,40068
521523,201804,604,370,234,349952.42,223236,573188.42
521525,201804,45,30,15,28620,14023.8,42643.8
521530,201804,250,133,117,126882,111618,238500
521540,201804,30,16,14,15264,13356,28620
521550,201804,92,44,48,41661.92,45736.92,87398.84
521560,201804,804,551,253,525208.54,241219,766427.54
521565,201804,53,36,17,34344,16218,50562
521570,201804,497,332,165,316718.46,157315.3,474033.76
521580,201804,60,37,23,35298,21942,57240
521590,201804,37,20,17,19080,16218,35298
521600,201804,28,16,12,15264,11448,26712
521630,201804,238,120,118,114470.46,111581.96,226052.42
521640,201804,299,153,146,145962,139284,285246
521645,201804,30,16,14,15264,13356,28620
521680,201804,219,138,81,131652,77274,208926
521690,201804,3,2,1,1908,954,2862
521710,201804,1194,560,634,533667.8,604827,1138494.8
521720,201804,544,368,176,351062.46,167866.46,518928.92
521730,201804,626,304,322,290016,306081.56,596097.56
521740,201804,926,376,550,359100.92,523509.32,882610.24
521760,201804,1602,876,726,834126.63,692290,1526416.63
521770,201804,803,514,289,490356,275238.54,765594.54
521800,201804,2077,1290,787,1227118.02,750374.1,1977492.12
521805,201804,33,18,15,17172,14310,31482
521810,201804,92,58,34,54187.8,32436,86623.8
521830,201804,962,684,278,650342.22,265203,915545.22
521839,201804,93,62,31,59148,29574,88722
521850,201804,1118,594,524,565256.92,499571.68,1064828.60
521860,201804,343,210,133,200340,126596,326936
521870,201804,73,42,31,40068,29574,69642
521878,201804,42,20,22,19080,20988,40068
521880,201804,4544,2054,2490,1957225.36,2373960.3,4331185.66
521890,201804,581,405,176,386370,167617.8,553987.8
521900,201804,293,236,57,224507.96,54378,278885.96
521910,201804,153,107,46,102078,43884,145962
521920,201804,56,28,28,26712,26712,53424
521925,201804,36,21,15,20034,14310,34344
521930,201804,1127,641,486,611318.52,462714.68,1074033.20
521935,201804,34,26,8,24804,7632,32436
521940,201804,189,94,95,89676,90625.23,180301.23
521945,201804,14,12,2,11448,1908,13356
521950,201804,9,5,4,4770,3816,8586
521960,201804,73,54,19,51516,18126,69642
521970,201804,422,272,150,259201.8,143100,402301.8
521971,201804,99,50,49,47700,46746,94446
521973,201804,28,13,15,12402,14310,26712
521975,201804,1136,584,552,556183,525692.66,1081875.66
521980,201804,243,168,75,160272,71550,231822
521990,201804,72,54,18,51516,17172,68688
522000,201804,286,178,108,169812,103032,272844
522005,201804,21,13,8,12402,7632,20034
522010,201804,1139,638,501,608643,477381.6,1086024.6
522015,201804,54,33,21,31473,20034,51507
522020,201804,856,462,394,439794.2,375094.12,814888.32
522026,201804,30,22,8,20988,7632,28620
522028,201804,16,12,4,11448,3816,15264
522040,201804,749,298,451,284274,430199.46,714473.46
522045,201804,2105,1326,779,1263682.06,742632.8,2006314.86
522050,201804,167,81,86,77274,82044,159318
522060,201804,558,352,206,335521.8,196428.6,531950.4
522068,201804,135,89,46,84619.8,43884,128503.8
522070,201804,11,11,0,10494,0,10494
522100,201804,48,27,21,25490.88,20034,45524.88
522108,201804,40,30,10,28620,9540,38160
522119,201804,55,29,26,27666,24804,52470
522130,201804,76,29,47,27657,44820,72477
522140,201804,3724,1885,1839,1793803.28,1752241.9,3546045.18
522145,201804,50,30,20,28620,19080,47700
522150,201804,65,51,14,48654,13356,62010
522155,201804,59,40,19,38151,18126,56277
522157,201804,4,3,1,2862,954,3816
522160,201804,1723,1007,716,959533.2,682768.8,1642302.0
522170,201804,396,266,130,253764,124020,377784
522180,201804,36,20,16,19080,15264,34344
522185,201804,1913,746,1167,707987.16,1112797,1820784.16
522190,201804,48,27,21,25758,19938.6,45696.6
522200,201804,301,181,120,172674,114480,287154
522205,201804,164,111,53,105894,50562,156456
522220,201804,163,116,47,110664,44838,155502
522230,201804,29,23,6,21942,5724,27666
530010,201804,55625,28569,27056,27118949.17,25758235.24,52877184.41
110001,201805,520,411,109,391110.35,103340.96,494451.31
110002,201805,2790,1689,1101,1609426.19,1049447.49,2658873.68
110003,201805,95,75,20,71550,19080,90630
110004,201805,2016,1294,722,1231575.02,688492.26,1920067.28
110005,201805,444,357,87,339422.9,82998,422420.9
110006,201805,455,350,105,333613.8,100150.92,433764.72
110007,201805,83,66,17,62964,16218,79182
110008,201805,240,136,104,128508.9,99216,227724.9
110009,201805,798,544,254,517069.2,242117,759186.2
110010,201805,1812,1125,687,1072114.52,655256.52,1727371.04
110011,201805,1886,1453,433,1384651.2,413052.35,1797703.55
110012,201805,4109,2392,1717,2275741.02,1636766.57,3912507.59
110013,201805,761,583,178,556172.46,169812,725984.46
110014,201805,371,319,52,304305.89,49608,353913.89
110015,201805,1437,1159,278,1103258.71,264620.52,1367879.23
110018,201805,1117,668,449,636958,428333.23,1065291.23
110020,201805,15397,9051,6346,8587644.02,6041709.61,14629353.63
110025,201805,652,481,171,456876.11,163125,620001.11
110026,201805,41,28,13,26712,12402,39114
110028,201805,1654,1199,455,1139244.59,430476.95,1569721.54
110029,201805,141,125,16,119250,15264,134514
110030,201805,2491,1675,816,1595064.26,777563.46,2372627.72
110032,201805,387,302,85,287799,81086,368885
110033,201805,678,512,166,485424,158360,643784
110034,201805,366,270,96,255268,90917,346185
110037,201805,103,85,18,81090,17172,98262
110040,201805,340,229,111,218466,105894,324360
110045,201805,945,636,309,605198,293082.39,898280.39
110050,201805,96,80,16,76320,15264,91584
110060,201805,86,46,40,43884,38160,82044
110070,201805,123,73,50,69642,47414,117056
110080,201805,407,247,160,233415.18,152596.04,386011.22
110090,201805,33,27,6,25758,5724,31482
110092,201805,109,61,48,58194,45722,103916
110094,201805,197,140,57,133560,54378,187938
110100,201805,27,23,4,21942,3816,25758
110110,201805,69,42,27,40068,25758,65826
110120,201805,73,60,13,57240,12402,69642
110130,201805,302,244,58,231301.12,55332,286633.12
110140,201805,243,157,86,149587.2,82034.46,231621.66
110143,201805,50,42,8,40068,7632,47700
110145,201805,29,21,8,20034,7632,27666
110146,201805,24,12,12,11448,11448,22896
110147,201805,38,30,8,28620,7632,36252
110148,201805,39,27,12,25706.57,11448,37154.57
110149,201805,291,210,81,200053.8,77274,277327.8
110150,201805,85,58,27,55332,25758,81090
110155,201805,8,7,1,6678,954,7632
110160,201805,70,59,11,56286,10494,66780
110170,201805,207,168,39,160272,37206,197478
110175,201805,40,29,11,27666,10494,38160
110180,201805,92,80,12,76320,11448,87768
120001,201805,137,94,43,89634,40993,130627
120005,201805,191,119,72,113483.12,68688,182171.12
120010,201805,1039,668,371,631058.38,351744.92,982803.30
120013,201805,142,99,43,93737.18,40678.04,134415.22
120017,201805,92,57,35,54269.48,33347.12,87616.60
120020,201805,3521,2807,714,2650648.16,678591.19,3329239.35
120025,201805,595,337,258,318960.22,245050.6,564010.82
120030,201805,1026,862,164,814211.7,155698.12,969909.82
120032,201805,49,41,8,39114,7632,46746
120033,201805,212,186,26,177096.75,24804,201900.75
120034,201805,157,114,43,106826.12,40978.24,147804.36
120035,201805,29,21,8,20034,7632,27666
120038,201805,390,249,141,236700,134470.24,371170.24
120039,201805,22,21,1,20034,954,20988
120040,201805,14061,9753,4308,9171535.58,4071331.07,13242866.65
120042,201805,43,37,6,35298,5724,41022
120043,201805,12,3,9,2862,8586,11448
120045,201805,543,351,192,332751.5,182902.6,515654.1
120050,201805,1271,968,303,916966.28,288971.47,1205937.75
120060,201805,1422,1155,267,1091606.01,252085.4,1343691.41
120070,201805,505,360,145,337179.56,137008.66,474188.22
120080,201805,166,106,60,99894.42,56651.42,156545.84
130002,201805,150,105,45,100170,42930,143100
130006,201805,75,43,32,41022,30528,71550
130008,201805,143,78,65,73691.72,61331.72,135023.44
130010,201805,139,75,64,71528.12,61056,132584.12
130014,201805,237,171,66,163134,62964,226098
130020,201805,92,48,44,45792,41976,87768
130030,201805,899,550,349,524700,332936.46,857636.46
130040,201805,327,164,163,156456,154548.28,311004.28
130050,201805,557,307,250,292591.8,238500,531091.8
130060,201805,882,601,281,568205.2,265318.88,833524.08
130063,201805,577,320,257,305280,245112.36,550392.36
130068,201805,187,122,65,116388,61723.8,178111.8
130070,201805,1329,922,407,866068.76,383357.88,1249426.64
130080,201805,665,434,231,413654.4,220365,634019.4
130083,201805,71,38,33,35792.7,31482,67274.7
130090,201805,372,192,180,181488.96,171720,353208.96
130100,201805,1103,515,588,491310,560665.8,1051975.8
130110,201805,699,311,388,296544,370152,666696
130115,201805,174,71,103,67734,98262,165996
130120,201805,1629,1020,609,973080,580986,1554066
130130,201805,630,434,196,414036,186984,601020
130140,201805,1515,1137,378,1084035.02,359658.2,1443693.22
130150,201805,421,358,63,341510.12,60102,401612.12
130160,201805,468,263,205,250902,195570,446472
130165,201805,24,17,7,16218,6678,22896
130170,201805,936,665,271,634339.4,258534,892873.4
130180,201805,152,92,60,87291,57240,144531
130185,201805,2294,1206,1088,1148595.89,1037360.92,2185956.81
130190,201805,3616,2259,1357,2150858.68,1293275.99,3444134.67
130195,201805,291,233,58,222282,55332,277614
130200,201805,176,80,96,76310.46,91584,167894.46
130210,201805,79,40,39,38160,37206,75366
130220,201805,183,127,56,121158,53424,174582
130230,201805,333,210,123,200340,117342,317682
130240,201805,1450,915,535,871570.4,509812.83,1381383.23
130250,201805,4746,3072,1674,2925245.06,1596862.57,4522107.63
130255,201805,421,206,215,196524,204823.8,401347.8
130260,201805,53772,25818,27954,24596472.82,26661408.3,51257881.12
130270,201805,1511,971,540,925857,515160,1441017
130280,201805,113,68,45,64872,42930,107802
130290,201805,2088,1518,570,1448172,543493.8,1991665.8
130300,201805,429,307,122,292591.8,116388,408979.8
130310,201805,881,462,419,440748,399726,840474
130320,201805,446,234,212,222282,202248,424530
130330,201805,702,424,278,404496,264925.8,669421.8
130340,201805,3284,1963,1321,1868123.2,1258803.2,3126926.4
130350,201805,464,298,166,284270.12,158364,442634.12
130353,201805,805,332,473,316442,451242,767684
130356,201805,783,356,427,339624,407071.8,746695.8
130360,201805,68,41,27,39114,25758,64872
130370,201805,679,507,172,483678,164088,647766
130380,201805,620,430,190,410220,181260,591480
130390,201805,492,389,103,371106,98262,469368
130395,201805,182,41,141,39114,134514,173628
130400,201805,72,47,25,44838,23850,68688
130406,201805,2071,1301,770,1237540.3,733369.76,1970910.06
130410,201805,496,213,283,203202,269962.92,473164.92
130420,201805,3186,2567,619,2445131.5,590526,3035657.5
130423,201805,160,75,85,71550,81090,152640
130426,201805,141,83,58,79182,55332,134514
130430,201805,407,269,138,256626,131652,388278
130440,201805,202,69,133,65826,126882,192708
140002,201805,36,14,22,13356,20988,34344
140005,201805,210,128,82,121873.5,78228,200101.5
140010,201805,10274,6933,3341,6578525.3,3184992.63,9763517.93
140015,201805,154,68,86,64872,82044,146916
140017,201805,116,78,38,74412,36252,110664
140020,201805,478,319,159,303372,151686,455058
140023,201805,31,18,13,16953,12402,29355
140028,201805,17,12,5,11448,4770,16218
140030,201805,356,256,100,244224,95400,339624
140040,201805,53,37,16,35298,15168.6,50466.6
140045,201805,245,114,131,108088.2,124974,233062.2
140047,201805,579,398,181,377680.39,171911,549591.39
140050,201805,148,97,51,91725,48654,140379
140060,201805,35,24,11,22161.42,10494,32655.42
140070,201805,32,29,3,27666,2862,30528
150010,201805,4721,2929,1792,2792358.4,1707068.29,4499426.69
150013,201805,152,107,45,102078,42930,145008
150020,201805,1065,570,495,543780,472230,1016010
150030,201805,721,295,426,281430,406404,687834
150034,201805,196,123,73,117342,69642,186984
150040,201805,1392,828,564,789912,538056,1327968
150050,201805,700,418,282,397770.8,268828,666598.8
150060,201805,4716,3064,1652,2919107.37,1575760.5,4494867.87
150070,201805,312,146,166,139284,158364,297648
150080,201805,14453,7285,7168,6939785.93,6830667.94,13770453.87
150085,201805,386,241,145,229904.46,138330,368234.46
150090,201805,759,645,114,615330,108756,724086
150095,201805,346,213,133,202432.12,126061.56,328493.68
150100,201805,57,40,17,38160,16218,54378
150110,201805,173,83,90,79182,85860,165042
150120,201805,431,319,112,304326,106848,411174
150125,201805,54,23,31,21942,29574,51516
150130,201805,1897,1015,882,968310,841423.23,1809733.23
150140,201805,54368,25369,28999,24169790.44,27650676.82,51820467.26
150145,201805,181,106,75,101124,71550,172674
150150,201805,2821,1276,1545,1217086.49,1470271.81,2687358.30
150157,201805,439,304,135,290016,128785.23,418801.23
150160,201805,124,100,24,95400,22896,118296
150170,201805,3661,2713,948,2586246.3,904105.8,3490352.1
150172,201805,323,221,102,210834,97308,308142
150175,201805,87,53,34,50562,32436,82998
150178,201805,771,520,251,495126,239454,734580
150180,201805,3061,1481,1580,1412063.6,1506719.18,2918782.78
150190,201805,332,213,119,203202,113526,316728
150195,201805,121,60,61,57240,58194,115434
150200,201805,202,96,106,91584,101124,192708
150210,201805,3175,2573,602,2453583.86,574065.5,3027649.36
150215,201805,515,335,180,319590,171434,491024
150220,201805,3872,2624,1248,2501736.8,1188474.32,3690211.12
150230,201805,1141,921,220,878054.04,209880,1087934.04
150240,201805,5813,3427,2386,3266202.73,2275949,5542151.73
150250,201805,34,16,18,15264,17172,32436
150260,201805,75,45,30,42930,28620,71550
150270,201805,2345,1537,808,1465024.32,769973.8,2234998.12
150275,201805,575,350,225,333900,214650,548550
150276,201805,111,48,63,45792,60102,105894
150277,201805,766,327,439,311939.46,418806,730745.46
150280,201805,339,208,131,198432,124974,323406
150285,201805,74,37,37,35298,35298,70596
150290,201805,974,596,378,568288.26,360326,928614.26
150293,201805,672,313,359,298402.46,342486,640888.46
150295,201805,475,214,261,204156,248841.44,452997.44
150300,201805,79,41,38,39114,36252,75366
150304,201805,144,98,46,93492,43884,137376
150307,201805,392,322,70,307188,66780,373968
150309,201805,562,411,151,392094,144054,536148
150310,201805,258,174,84,165996,80136,246132
150320,201805,1798,1247,551,1189356.57,525654,1715010.57
150330,201805,2068,1193,875,1137454.2,834750,1972204.2
150340,201805,201,135,66,128551.5,62964,191515.5
150345,201805,608,329,279,313684.74,266166,579850.74
150350,201805,413,323,90,305747.46,85860,391607.46
150360,201805,4560,2919,1641,2781088.21,1565504.46,4346592.67
150370,201805,754,534,220,508640,209584.8,718224.8
150375,201805,197,104,93,99216,88722,187938
150380,201805,1348,902,446,860508,425198,1285706
150390,201805,737,421,316,401630,301464,703094
150400,201805,99,82,17,78228,16218,94446
150405,201805,1245,823,422,783870.48,402015.6,1185886.08
150410,201805,136,89,47,84906,44838,129744
150420,201805,7419,4061,3358,3872535.28,3201860.2,7074395.48
150430,201805,501,336,165,320544,157410,477954
150440,201805,583,346,237,329321,226098,555419
150442,201805,2161,1165,996,1108157,949811.03,2057968.03
150445,201805,520,330,190,314820,180306,495126
150450,201805,261,124,137,118296,130698,248994
150460,201805,765,580,185,551493.09,176470.92,727964.01
150470,201805,1333,805,528,766443.8,503712,1270155.8
150475,201805,41,31,10,29574,9540,39114
150480,201805,1251,872,379,831888,361279.8,1193167.8
150490,201805,611,335,276,319590,263304,582894
150495,201805,328,232,96,221328,91584,312912
150497,201805,298,204,94,194616,89666.46,284282.46
150500,201805,424,287,137,273798,130698,404496
150503,201805,890,430,460,409934,438822,848756
150506,201805,1030,676,354,644904,337706.46,982610.46
150510,201805,1235,695,540,662744,515160,1177904
150520,201805,273,183,90,174582,85860,260442
150530,201805,1574,855,719,812522.3,685926,1498448.3
150540,201805,240,167,73,159318,69642,228960
150543,201805,723,411,312,391502.52,297361.8,688864.32
150548,201805,501,350,151,333900,144054,477954
150549,201805,61,43,18,41022,17172,58194
150550,201805,2879,1513,1366,1442449,1302878,2745327
150553,201805,3114,1837,1277,1751925.8,1218248.46,2970174.26
150555,201805,143,76,67,72504,63918,136422
150560,201805,52,40,12,38160,11448,49608
150563,201805,74,40,34,38160,32436,70596
150565,201805,168,100,68,95400,64872,160272
150570,201805,400,265,135,252790.92,128790,381580.92
150580,201805,1524,647,877,616570.2,836658,1453228.2
150590,201805,783,481,302,458874,288108,746982
150600,201805,461,278,183,265212,174582,439794
150610,201805,144,123,21,116493,20034,136527
150611,201805,130,91,39,86814,37206,124020
150613,201805,3214,1975,1239,1884150,1181997,3066147
150616,201805,489,299,190,285008,181260,466268
150618,201805,1174,638,536,608423.58,511344,1119767.58
150619,201805,395,303,92,289062,87768,376830
150620,201805,1277,742,535,707868,510103.8,1217971.8
150630,201805,303,203,100,193662,95400,289062
150635,201805,486,201,285,191754,271890,463644
150640,201805,60,28,32,26712,30528,57240
150650,201805,2331,1380,951,1316196.34,906963.03,2223159.37
150655,201805,246,183,63,174582,60102,234684
150658,201805,105,60,45,57240,42930,100170
150660,201805,491,346,145,330084,138330,468414
150670,201805,1004,368,636,350776.8,606725.46,957502.26
150680,201805,9914,5425,4489,5168278.86,4280170.58,9448449.44
150690,201805,51,32,19,30528,18126,48654
150700,201805,533,344,189,327985.2,180306,508291.2
150710,201805,277,165,112,157410,106848,264258
150715,201805,863,524,339,498913.92,323377.38,822291.30
150720,201805,435,336,99,320544,94159.8,414703.8
150730,201805,936,498,438,475083,417565.8,892648.8
150740,201805,227,160,67,152640,63918,216558
150745,201805,786,429,357,409266,340578,749844
150746,201805,56,34,22,32436,20988,53424
150747,201805,261,205,56,195570,53424,248994
150750,201805,132,77,55,73458,52470,125928
150760,201805,1721,1121,600,1069434,572400,1641834
150770,201805,371,192,179,183168,170590.95,353758.95
150775,201805,96,44,52,41976,49608,91584
150780,201805,190,101,89,96354,84906,181260
150790,201805,881,476,405,454104,386370,840474
150795,201805,1452,847,605,808038,577170,1385208
150796,201805,393,227,166,216558,158364,374922
150797,201805,285,162,123,154548,117342,271890
150800,201805,1411,853,558,812803.23,532332,1345135.23
150803,201805,596,494,102,471276,97308,568584
150805,201805,186,119,67,113526,63904.46,177430.46
150808,201805,990,546,444,520884,423576,944460
150810,201805,3399,2358,1041,2246089,992255.8,3238344.8
150812,201805,422,223,199,212742,189846,402588
150815,201805,967,633,334,602503.47,318636,921139.47
150820,201805,1567,960,607,914886,579058.92,1493944.92
150830,201805,831,584,247,556182,235638,791820
150835,201805,185,111,74,105894,70596,176490
150840,201805,1352,863,489,823302,466506,1289808
160005,201805,52,30,22,28620,20988,49608
160010,201805,193,121,72,115434,68684,184118
160015,201805,113,63,50,60102,47700,107802
160020,201805,126,71,55,67734,52470,120204
160021,201805,42,22,20,20988,19080,40068
160023,201805,111,65,46,62010,43884,105894
160025,201805,31,14,17,13356,16218,29574
160027,201805,1474,830,644,789053.9,613622,1402675.9
160030,201805,15475,7966,7509,7591757.36,7158847.29,14750604.65
160040,201805,314,181,133,172674,126882,299556
160050,201805,673,340,333,324360,317395.8,641755.8
160053,201805,322,184,138,175250,131652,306902
160055,201805,26,19,7,18126,6678,24804
160060,201805,6437,3387,3050,3221454.8,2908742.2,6130197.0
160070,201805,165,100,65,95400,62010,157410
160080,201805,78,41,37,39114,35298,74412
170025,201805,24,15,9,14310,8586,22896
170030,201805,228,186,42,177247,40068,217315
170035,201805,227,109,118,103986,112572,216558
170040,201805,189,146,43,138997.8,41022,180019.8
170070,201805,321,193,128,184122,122112,306234
170100,201805,372,269,103,256626,98262,354888
170105,201805,62,51,11,48654,10494,59148
170110,201805,103,63,40,60102,38160,98262
170130,201805,69,32,37,30528,35012,65540
170190,201805,102,67,35,63918,33390,97308
170200,201805,391,261,130,248317.2,123915.76,372232.96
170210,201805,6004,3143,2861,2990612.74,2726132.86,5716745.60
170215,201805,97,46,51,43884,48654,92538
170220,201805,1412,1042,370,992827.8,352694,1345521.8
170230,201805,154,101,53,96354,50562,146916
170240,201805,542,356,186,339624,177444,517068
170255,201805,1108,889,219,847896.12,208639.8,1056535.92
170270,201805,37,28,9,26712,8395.2,35107.2
170290,201805,80,59,21,56286,20034,76320
170300,201805,82,54,28,50752.8,26712,77464.8
170305,201805,44,34,10,32436,9540,41976
170307,201805,63,47,16,44838,15264,60102
170310,201805,103,56,47,53424,44838,98262
170320,201805,18,14,4,13356,3816,17172
170330,201805,21,19,2,18126,1908,20034
170360,201805,23,13,10,12402,9540,21942
170370,201805,122,64,58,61056,55332,116388
170380,201805,80,59,21,56286,20034,76320
170382,201805,45,40,5,38160,4770,42930
170384,201805,131,96,35,91584,33390,124974
170386,201805,61,27,34,25758,32436,58194
170388,201805,48,18,30,17172,28620,45792
170389,201805,23,18,5,17172,4770,21942
170390,201805,56,32,24,30528,22896,53424
170410,201805,35,24,11,22896,10494,33390
170460,201805,17,13,4,12402,3816,16218
170510,201805,29,22,7,20988,6678,27666
170550,201805,1492,849,643,809946,612659,1422605
170555,201805,115,80,35,76320,33390,109710
170560,201805,98,71,27,67734,25758,93492
170600,201805,40,19,21,18126,20034,38160
170610,201805,191,102,89,97150.59,84888,182038.59
170625,201805,38,20,18,19080,17172,36252
170650,201805,85,64,21,61056,20034,81090
170700,201805,558,424,134,403256.3,127836,531092.3
170710,201805,156,96,60,91584,57231,148815
170720,201805,86,70,16,66780,15264,82044
170730,201805,60,36,24,34344,22896,57240
170740,201805,78,56,22,53424,20988,74412
170755,201805,70,37,33,34678,31482,66160
170765,201805,139,68,71,64252,67734,131986
170770,201805,225,132,93,124830.9,88722,213552.9
170820,201805,597,388,209,370152,198957,569109
170825,201805,32,20,12,19080,11448,30528
170830,201805,79,59,20,56095.2,19080,75175.2
170900,201805,201,153,48,145962,45792,191754
170930,201805,821,427,394,407034,375304,782338
170950,201805,3042,1322,1720,1260216.26,1638572.51,2898788.77
170980,201805,18,10,8,9540,7632,17172
171050,201805,135,105,30,100170,28620,128790
171070,201805,38,31,7,29574,6678,36252
171090,201805,39,29,10,27666,9540,37206
171110,201805,21,14,7,13356,6678,20034
171150,201805,39,18,21,17172,20034,37206
171180,201805,21,10,11,9540,10494,20034
171190,201805,139,82,57,78228,54378,132606
171195,201805,64,49,15,46746,14310,61056
171200,201805,47,20,27,19080,25758,44838
171215,201805,3,3,0,2862,0,2862
171240,201805,54,44,10,41976,9540,51516
171245,201805,53,48,5,45792,4770,50562
171250,201805,72,38,34,36252,32426.46,68678.46
171270,201805,17,13,4,12402,3816,16218
171280,201805,39,36,3,34201,2862,37063
171320,201805,993,562,431,536148,409993.95,946141.95
171330,201805,422,203,219,193662,208926,402588
171360,201805,88,64,24,61056,22896,83952
171370,201805,24,13,11,12402,10494,22896
171380,201805,137,111,26,105894,24804,130698
171395,201805,54,33,21,31482,20034,51516
171420,201805,306,203,103,193662,97975.8,291637.8
171430,201805,66,53,13,50562,12402,62964
171488,201805,200,106,94,101124,89676,190800
171500,201805,59,32,27,30528,25758,56286
171510,201805,68,45,23,42930,21942,64872
171515,201805,44,37,7,35298,6392,41690
171525,201805,31,26,5,24804,4770,29574
171550,201805,13,7,6,6678,5724,12402
171570,201805,62,30,32,28620,30528,59148
171575,201805,340,211,129,201294,123056.46,324350.46
171610,201805,1710,860,850,818540.99,809351.66,1627892.65
171620,201805,131,92,39,87214.68,37206,124420.68
171630,201805,50,27,23,25758,21942,47700
171650,201805,272,179,93,170766,88722,259488
171660,201805,264,141,123,134514,117338,251852
171665,201805,48,32,16,30528,15264,45792
171670,201805,428,249,179,234627.26,170193.6,404820.86
171700,201805,63,55,8,52470,7632,60102
171720,201805,25,8,17,7632,16218,23850
171750,201805,101,54,47,51516,44838,96354
171780,201805,73,59,14,56286,13356,69642
171790,201805,78,65,13,61628.4,12402,74030.4
171800,201805,34,26,8,24804,7632,32436
171820,201805,2068,1168,900,1112659.74,853992.82,1966652.56
171830,201805,37,29,8,27666,7632,35298
171840,201805,64,37,27,35298,25758,61056
171845,201805,31,20,11,19080,10494,29574
171850,201805,40,29,11,27666,10494,38160
171855,201805,78,61,17,58194,16218,74412
171865,201805,8,7,1,6678,954,7632
171870,201805,31,22,9,20988,8586,29574
171875,201805,78,53,25,50562,23850,74412
171880,201805,29,21,8,20034,7632,27666
171884,201805,46,23,23,21942,21942,43884
171886,201805,117,42,75,40068,71263.8,111331.8
171888,201805,24,18,6,17172,5724,22896
171889,201805,19,15,4,14310,3816,18126
171890,201805,56,46,10,43884,9540,53424
171900,201805,42,29,13,27666,12402,40068
172000,201805,39,33,6,31482,5724,37206
172010,201805,41,35,6,32579.1,5724,38303.1
172015,201805,26,16,10,15264,9253.8,24517.8
172020,201805,131,83,48,79182,45792,124974
172025,201805,32,21,11,20034,10494,30528
172030,201805,34,19,15,18126,14310,32436
172049,201805,73,44,29,41976,27666,69642
172065,201805,148,97,51,92488,48654,141142
172080,201805,91,65,26,60827.84,24804,85631.84
172085,201805,25,12,13,11448,12402,23850
172090,201805,402,308,94,293832,88913,382745
172093,201805,24,18,6,17172,5724,22896
172097,201805,17,8,9,7632,8300,15932
172100,201805,4726,2652,2074,2524809.8,1976127,4500936.8
172110,201805,81,54,27,51516,25758,77274
172120,201805,1720,1475,245,1401033.65,233346.5,1634380.15
172125,201805,4,4,0,3816,0,3816
172130,201805,17,13,4,12402,3816,16218
172208,201805,193,123,70,117342,66780,184122
172210,201805,422,206,216,196524,205778,402302
210005,201805,2932,1829,1103,1741813.22,1049402,2791215.22
210010,201805,190,98,92,93492,87768,181260
210015,201805,31,21,10,20034,9540,29574
210020,201805,346,182,164,173628,156456,330084
210030,201805,347,217,130,207018,124011,331029
210040,201805,154,119,35,113526,33390,146916
210043,201805,256,172,84,164088,80136,244224
210047,201805,599,316,283,301082.4,269972.46,571054.86
210050,201805,300,220,80,209880,76320,286200
210055,201805,42,32,10,30528,9540,40068
210060,201805,560,441,119,420614.79,113526,534140.79
210070,201805,413,303,110,289062,104940,394002
210080,201805,102,94,8,89676,7632,97308
210083,201805,305,132,173,125928,165042,290970
210087,201805,42,31,11,29574,10494,40068
210090,201805,490,339,151,323406,144054,467460
210095,201805,487,356,131,339614.46,124974,464588.46
210100,201805,691,527,164,502424.1,155502.02,657926.12
210110,201805,148,82,66,78228,62964,141192
210120,201805,5445,4092,1353,3896562,1289508.68,5186070.68
210125,201805,215,124,91,118296,86814,205110
210130,201805,547,286,261,271890,248974.92,520864.92
210135,201805,34,20,14,19080,13356,32436
210140,201805,4390,3443,947,3281845.42,903200,4185045.42
210150,201805,361,229,132,218466,125928,344394
210160,201805,3375,2837,538,2703638.78,512966,3216604.78
210170,201805,1131,883,248,842382,236592,1078974
210173,201805,124,103,21,98262,20034,118296
210177,201805,461,224,237,213696,226098,439794
210180,201805,32,17,15,16218,14310,30528
210190,201805,416,264,152,251856,145008,396864
210193,201805,1,1,0,954,0,954
210197,201805,83,54,29,51516,27647.88,79163.88
210200,201805,640,506,134,482724,127836,610560
210203,201805,259,173,86,165042,82044,247086
210207,201805,383,297,86,283338,82044,365382
210210,201805,774,706,68,673524,64872,738396
210215,201805,77,65,12,62010,11448,73458
210220,201805,394,323,71,308142,67447.8,375589.8
210230,201805,304,231,73,220374,69642,290016
210232,201805,1466,931,535,887888,510390,1398278
210235,201805,155,121,34,115244,32436,147680
210237,201805,46,25,21,23850,20034,43884
210240,201805,92,75,17,71550,16218,87768
210250,201805,185,149,36,142146,34344,176490
210255,201805,348,257,91,245178,86814,331992
210260,201805,419,266,153,253764,145962,399726
210270,201805,691,439,252,418806,240408,659214
210275,201805,50,39,11,37206,10494,47700
210280,201805,1036,663,373,629687.33,354506.5,984193.83
210290,201805,502,327,175,311958,166950,478908
210300,201805,6081,3541,2540,3372905.27,2421968.23,5794873.50
210310,201805,105,72,33,68688,31482,100170
210312,201805,127,81,46,77274,43884,121158
210315,201805,116,85,31,81090,29574,110664
210317,201805,126,89,37,84906,35298,120204
210320,201805,2391,1971,420,1878623.84,400680,2279303.84
210325,201805,128,88,40,82998,37874,120872
210330,201805,5472,2823,2649,2688319.63,2527136.46,5215456.09
210340,201805,1391,999,392,952246,373897.07,1326143.07
210350,201805,615,505,110,481531.5,104940,586471.5
210355,201805,133,106,27,101124,25758,126882
210360,201805,2637,1653,984,1573815.6,938450,2512265.6
210370,201805,1242,545,697,519930,664938,1184868
210375,201805,186,96,90,91041,85860,176901
210380,201805,733,546,187,520884,178398,699282
210390,201805,205,168,37,160272,35298,195570
210400,201805,418,352,66,335808,62945,398753
210405,201805,1018,685,333,653490,317682,971172
210407,201805,56,44,12,41976,11448,53424
210408,201805,65,58,7,55332,6678,62010
210409,201805,320,267,53,254718,50562,305280
210410,201805,438,339,99,323406,94437,417843
210420,201805,192,157,35,149778,33390,183168
210430,201805,37,27,10,25758,9540,35298
210440,201805,376,228,148,217512,141192,358704
210450,201805,148,110,38,104940,36252,141192
210455,201805,224,123,101,117342,96354,213696
210460,201805,346,219,127,208926,121158,330084
210462,201805,63,53,10,50562,9540,60102
210465,201805,174,125,49,119250,46746,165996
210467,201805,528,378,150,360612,143100,503712
210470,201805,45,34,11,32436,10494,42930
210480,201805,1313,930,383,887220,365382,1252602
210490,201805,223,135,88,128790,83952,212742
210500,201805,579,303,276,289062,263304,552366
210510,201805,552,430,122,410220,116388,526608
210515,201805,441,241,200,229914,190800,420714
210520,201805,406,355,51,338383.8,48654,387037.8
210530,201805,9410,5044,4366,4798873.47,4159332.03,8958205.50
210535,201805,131,93,38,88722,36252,124974
210540,201805,1545,935,610,890845.8,580509,1471354.8
210542,201805,1180,589,591,561524.4,563242,1124766.4
210545,201805,13,12,1,11448,954,12402
210547,201805,135,115,20,109710,19080,128790
210550,201805,739,519,220,493578,209880,703458
210560,201805,176,147,29,140238,27666,167904
210565,201805,30,21,9,20034,8586,28620
210570,201805,1367,1073,294,1023642,280476,1304118
210580,201805,105,92,13,87768,12402,100170
210590,201805,769,603,166,574498.8,158364,732862.8
210592,201805,31,27,4,25758,3816,29574
210594,201805,104,85,19,81090,18126,99216
210596,201805,86,71,15,67734,14310,82044
210598,201805,125,91,34,86814,32436,119250
210600,201805,334,282,52,269028,49608,318636
210610,201805,251,232,19,220374,18126,238500
210620,201805,47,27,20,25758,19080,44838
210630,201805,59,57,2,54378,1908,56286
210632,201805,1105,733,372,699282,354411,1053693
210635,201805,17,14,3,13356,2862,16218
210637,201805,106,74,32,70596,30528,101124
210640,201805,588,515,73,491310,69642,560952
210650,201805,406,328,78,311986.62,73458,385444.62
210660,201805,401,289,112,275039,106724,381763
210663,201805,18,11,7,10494,6678,17172
210667,201805,115,37,78,35298,74412,109710
210670,201805,269,236,33,224429,31482,255911
210675,201805,573,297,276,283338,263304,546642
210680,201805,211,130,81,124020,77274,201294
210690,201805,643,507,136,483678,129744,613422
210700,201805,192,142,50,135468,47700,183168
210710,201805,300,167,133,159127.2,126882,286009.2
210720,201805,128,107,21,102078,20034,122112
210725,201805,69,60,9,57240,8586,65826
210730,201805,24,18,6,17172,5724,22896
210735,201805,416,278,138,265212,131366,396578
210740,201805,550,462,88,440748,83952,524700
210745,201805,152,110,42,104940,40068,145008
210750,201805,2423,1097,1326,1044583,1264984.92,2309567.92
210760,201805,271,198,73,188892,69627.69,258519.69
210770,201805,407,314,93,299556,88435.8,387991.8
210780,201805,423,304,119,290016,113526,403542
210790,201805,187,145,42,138330,40068,178398
210800,201805,144,106,38,101124,36252,137376
210805,201805,43,39,4,37206,3816,41022
210810,201805,484,371,113,353266.2,107802,461068.2
210820,201805,2324,1842,482,1748823.41,459828,2208651.41
210825,201805,176,91,85,86814,81090,167904
210830,201805,797,488,309,464598,293832,758430
210840,201805,214,143,71,136422,67734,204156
210845,201805,255,161,94,153594,89676,243270
210850,201805,850,538,312,513252,297648,810900
210860,201805,4142,2134,2008,2034310.3,1915326.72,3949637.02
210870,201805,468,353,115,336762,109710,446472
210880,201805,59,40,19,38160,18126,56286
210890,201805,345,287,58,273798,55332,329130
210900,201805,581,378,203,360608,193662,554270
210905,201805,71,35,36,33390,34344,67734
210910,201805,2010,1487,523,1417307.99,498942,1916249.99
210920,201805,232,69,163,65826,155502,221328
210923,201805,81,57,24,54378,22896,77274
210927,201805,437,182,255,173628,243270,416898
210930,201805,63,49,14,46746,13356,60102
210940,201805,94,71,23,67734,21942,89676
210945,201805,193,88,105,83952,100170,184122
210950,201805,516,370,146,352980,139279.23,492259.23
210955,201805,76,49,27,46746,25758,72504
210960,201805,2452,1045,1407,995308.4,1341992,2337300.4
210970,201805,114,98,16,93492,15264,108756
210975,201805,92,82,10,78228,9540,87768
210980,201805,1236,532,704,507413.52,671330,1178743.52
210990,201805,4352,2706,1646,2580423.13,1570284,4150707.13
211000,201805,1379,1091,288,1040528,274465.8,1314993.8
211003,201805,925,628,297,599112,283329,882441
211010,201805,488,430,58,410220,55332,465552
211020,201805,1613,585,1028,558090,980492.58,1538582.58
211023,201805,28,24,4,22609.8,3816,26425.8
211027,201805,63,41,22,39114,20988,60102
211030,201805,386,259,127,247086,121158,368244
211040,201805,324,247,77,235352,73458,308810
211050,201805,1176,749,427,714526.92,407067.23,1121594.15
211060,201805,687,581,106,552079.8,101124,653203.8
211065,201805,22,18,4,17172,3816,20988
211070,201805,924,750,174,713888.74,165996,879884.74
211080,201805,88,84,4,80136,3816,83952
211085,201805,60,32,28,30242,26712,56954
211090,201805,91,73,18,69642,17172,86814
211100,201805,507,406,101,386083.8,96354,482437.8
211102,201805,262,174,88,165996,83952,249948
211105,201805,224,151,73,144054,69642,213696
211107,201805,137,79,58,75366,55332,130698
211110,201805,822,525,297,500278,283329,783607
211120,201805,5795,2468,3327,2349094.54,3172866.23,5521960.77
211125,201805,36,28,8,26712,7632,34344
211130,201805,45817,19228,26589,18310245.68,25354363.62,43664609.30
211140,201805,426,359,67,341528,63918,405446
211150,201805,1266,799,467,761912.1,445228,1207140.1
211153,201805,167,97,70,92538,66780,159318
211157,201805,63,47,16,44838,15264,60102
211160,201805,708,589,119,561190.5,113526,674716.5
211163,201805,0,0,0,0,0,0
211167,201805,8,6,2,5724,1908,7632
211170,201805,446,310,136,295740,129744,425484
211172,201805,122,85,37,81090,35298,116388
211174,201805,277,163,114,155502,108756,264258
211176,201805,517,372,145,354888,138330,493218
211178,201805,95,61,34,58194,32436,90630
211180,201805,208,162,46,154548,43721.82,198269.82
211190,201805,65,60,5,57240,4770,62010
211195,201805,25,16,9,15264,8586,23850
211200,201805,157,136,21,129400.56,20034,149434.56
211210,201805,530,330,200,314152.2,190800,504952.2
211220,201805,3999,2253,1746,2141519.39,1659347.04,3800866.43
211223,201805,97,90,7,85678.74,6678,92356.74
211227,201805,68,47,21,44838,20034,64872
211230,201805,783,637,146,607554.9,139264.92,746819.82
211240,201805,418,314,104,299556,99216,398772
211245,201805,207,92,115,87768,109710,197478
211250,201805,1646,1405,241,1339378.12,229914,1569292.12
211260,201805,828,648,180,618192,171720,789912
211270,201805,2083,1638,445,1562652,423576.2,1986228.2
211280,201805,1834,1097,737,1045584.8,703098,1748682.8
211285,201805,206,121,85,115434,81090,196524
211290,201805,689,460,229,438649.2,218466,657115.2
211300,201805,808,619,189,590248.09,180306,770554.09
211400,201805,1596,902,694,860508,662076,1522584
220005,201805,18,17,1,16218,954,17172
220010,201805,87,66,21,62964,19747.8,82711.8
220020,201805,619,487,132,463613.04,125928,589541.04
220025,201805,107,103,4,98262,3816,102078
220027,201805,35,28,7,26712,6678,33390
220030,201805,100,82,18,78228,17172,95400
220040,201805,1138,859,279,818322.96,266166,1084488.96
220045,201805,38,28,10,26712,9540,36252
220050,201805,653,535,118,509228.96,112552.92,621781.88
220060,201805,173,147,26,140238,24804,165042
220070,201805,99,90,9,85860,8586,94446
220080,201805,11,10,1,9540,954,10494
220090,201805,36,29,7,27380,6678,34058
220095,201805,2,1,1,954,954,1908
220100,201805,28,24,4,22896,3816,26712
220105,201805,26,24,2,22324,1908,24232
220110,201805,208,192,16,182881.8,15264,198145.8
220115,201805,50,47,3,44838,2862,47700
220117,201805,20,18,2,17172,1908,19080
220120,201805,1533,1065,468,1014808.91,446452.92,1461261.83
220130,201805,26,25,1,23850,954,24804
220140,201805,99,78,21,73458,20034,93492
220150,201805,456,325,131,310050,124974,435024
220155,201805,4,4,0,3816,0,3816
220157,201805,18,15,3,14310,2862,17172
220160,201805,70,60,10,57240,9540,66780
220170,201805,35,33,2,31482,1908,33390
220173,201805,7,7,0,6678,0,6678
220177,201805,6,5,1,4770,954,5724
220180,201805,63,62,1,59143.23,668,59811.23
220190,201805,1054,943,111,899622,105894,1005516
220191,201805,42,37,5,35298,4770,40068
220192,201805,63,60,3,57240,2862,60102
220194,201805,36,32,4,30528,3816,34344
220196,201805,102,84,18,80136,17172,97308
220198,201805,7,5,2,4770,1908,6678
220200,201805,435,356,79,340356,75366,415722
220202,201805,37,33,4,31482,3816,35298
220205,201805,41,35,6,33390,5724,39114
220207,201805,18,17,1,16218,954,17172
220208,201805,85,44,41,41976,39114,81090
220209,201805,31,28,3,26712,2862,29574
220210,201805,15,13,2,12402,1908,14310
220211,201805,28,28,0,26712,0,26712
220213,201805,42,38,4,36252,3530,39782
220217,201805,36,28,8,26712,7632,34344
220220,201805,2044,1303,741,1239456.68,705511.92,1944968.60
220225,201805,16,8,8,7632,7632,15264
220230,201805,944,744,200,709327.62,190160.82,899488.44
220240,201805,146,133,13,126882,12402,139284
220245,201805,34,31,3,28871.04,2862,31733.04
220250,201805,110,99,11,94446,10494,104940
220253,201805,44,37,7,35298,6678,41976
220255,201805,28,25,3,23850,2862,26712
220260,201805,685,497,188,474138,179352,653490
220265,201805,18,15,3,14310,2862,17172
220270,201805,683,603,80,574536.96,75843,650379.96
220271,201805,45,37,8,35298,7632,42930
220272,201805,27,26,1,24804,954,25758
220273,201805,14,12,2,11448,1908,13356
220275,201805,59,48,11,45792,10494,56286
220277,201805,12,10,2,9540,1908,11448
220280,201805,15,12,3,11448,2862,14310
220285,201805,41,38,3,36252,2862,39114
220290,201805,1388,1185,203,1127198.8,193615,1320813.8
220300,201805,53,52,1,49608,954,50562
220310,201805,317,265,52,252806,49599,302405
220320,201805,440,405,35,384940,33390,418330
220323,201805,0,0,0,0,0,0
220325,201805,16,11,5,10494,4770,15264
220327,201805,12,11,1,10494,954,11448
220330,201805,207,141,66,134514,62964,197478
220335,201805,139,121,18,115434,17172,132606
220340,201805,25,15,10,14310,9540,23850
220342,201805,56,48,8,45792,7632,53424
220345,201805,84,76,8,72504,7632,80136
220350,201805,433,376,57,356081.42,54378,410459.42
220360,201805,43,31,12,29574,11448,41022
220370,201805,1139,912,227,869284.8,216271.8,1085556.6
220375,201805,26,24,2,22896,1908,24804
220380,201805,38,31,7,29574,6678,36252
220385,201805,28,24,4,22896,3816,26712
220390,201805,2242,1275,967,1211656.55,921224.5,2132881.05
220400,201805,28,26,2,24804,1908,26712
220410,201805,16,15,1,14310,954,15264
220415,201805,13,12,1,11448,954,12402
220420,201805,123,102,21,97308,19747.8,117055.8
220430,201805,129,117,12,109949.8,11448,121397.8
220435,201805,21,15,6,14305.23,5724,20029.23
220440,201805,292,249,43,237546,41022,278568
220450,201805,337,170,167,161014.98,159318,320332.98
220455,201805,55,53,2,50562,1908,52470
220460,201805,17,17,0,15550.2,0,15550.2
220465,201805,107,69,38,65826,36252,102078
220470,201805,242,213,29,203202,27666,230868
220480,201805,70,59,11,56286,10494,66780
220490,201805,87,75,12,71550,11448,82998
220500,201805,95,83,12,79182,11448,90630
220510,201805,383,303,80,288299,76129.2,364428.2
220515,201805,21,17,4,16218,3816,20034
220520,201805,373,335,38,318275,36233,354508
220525,201805,26,18,8,17172,7632,24804
220527,201805,36,27,9,25758,7776,33534
220530,201805,35,14,21,13356,20034,33390
220535,201805,8,8,0,7632,0,7632
220540,201805,62,50,12,47700,11448,59148
220545,201805,58,39,19,37206,18126,55332
220550,201805,646,493,153,469558.8,145962,615520.8
220551,201805,27,20,7,19080,6678,25758
220552,201805,7,7,0,6678,0,6678
220553,201805,48,43,5,41022,4770,45792
220554,201805,13,8,5,7345.8,4770,12115.8
220555,201805,24,20,4,19080,3816,22896
220556,201805,54,50,4,47700,3816,51516
220557,201805,57,51,6,48654,5724,54378
220558,201805,7,2,5,1908,4770,6678
220559,201805,6,5,1,4770,954,5724
220560,201805,57,36,21,34153.2,20034,54187.2
220570,201805,800,482,318,458624.14,303372,761996.14
220580,201805,559,513,46,489402,43197.92,532599.92
220585,201805,6,5,1,4770,954,5724
220590,201805,14,14,0,13356,0,13356
220595,201805,57,43,14,41022,13356,54378
220600,201805,23,12,11,11448,10494,21942
220605,201805,20,19,1,18126,954,19080
220610,201805,62,53,9,50562,8586,59148
220620,201805,557,436,121,415705.5,115434,531139.5
220630,201805,6,4,2,3816,1908,5724
220635,201805,38,34,4,32436,3816,36252
220640,201805,98,77,21,73458,20034,93492
220650,201805,116,110,6,104940,5724,110664
220660,201805,32,26,6,24804,5724,30528
220665,201805,4,4,0,3816,0,3816
220667,201805,16,13,3,12402,2862,15264
220669,201805,26,23,3,21942,2862,24804
220670,201805,71,55,16,52279.2,15264,67543.2
220672,201805,65,44,21,41976,20034,62010
220675,201805,36,28,8,26712,7632,34344
220680,201805,35,29,6,27666,5724,33390
220690,201805,45,43,2,41022,1908,42930
220695,201805,58,27,31,25758,29574,55332
220700,201805,1552,1189,363,1132464.78,346302,1478766.78
220710,201805,5,3,2,2862,1908,4770
220720,201805,110,90,20,85621.5,18936.9,104558.4
220730,201805,19,18,1,17172,954,18126
220735,201805,3,1,2,954,1908,2862
220740,201805,46,41,5,39114,4770,43884
220750,201805,98,80,18,76320,17172,93492
220755,201805,14,14,0,13356,0,13356
220760,201805,53,50,3,47700,2862,50562
220770,201805,5826,2932,2894,2791918.83,2754739.41,5546658.24
220775,201805,24,10,14,9540,13356,22896
220777,201805,16,15,1,14310,954,15264
220779,201805,18,14,4,13356,3816,17172
220780,201805,877,750,127,714832.2,120872,835704.2
220785,201805,13,7,6,6678,5724,12402
220790,201805,1015,807,208,767476,198432,965908
220793,201805,13,13,0,12402,0,12402
220795,201805,22,21,1,20034,954,20988
220800,201805,3954,3022,932,2881349.36,887920.89,3769270.25
220810,201805,60,53,7,50562,6678,57240
220820,201805,242,220,22,209880,20988,230868
220830,201805,1176,997,179,951133.23,170747,1121880.23
220840,201805,2443,1622,821,1534609.35,781136,2315745.35
220850,201805,53,44,9,41976,8586,50562
220855,201805,14,9,5,8586,4770,13356
220860,201805,8,7,1,6678,954,7632
220865,201805,23,21,2,20034,1908,21942
220870,201805,61,59,2,56286,1908,58194
220880,201805,318,243,75,231154.2,71264,302418.2
220885,201805,46,43,3,41022,2862,43884
220887,201805,19,18,1,17172,954,18126
220890,201805,101,89,12,84906,11448,96354
220900,201805,48,27,21,25758,20034,45792
220910,201805,53,45,8,42930,7632,50562
220915,201805,10,9,1,8586,954,9540
220920,201805,41,37,4,35298,3816,39114
220930,201805,41,40,1,38160,954,39114
220935,201805,15,15,0,14310,0,14310
220937,201805,43,40,3,38160,2862,41022
220940,201805,52,48,4,45792,3816,49608
220945,201805,0,0,0,0,0,0
220950,201805,47,43,4,41022,3816,44838
220955,201805,34,30,4,28620,3816,32436
220960,201805,1,1,0,954,0,954
220965,201805,30,27,3,25758,2862,28620
220970,201805,47,40,7,38160,6678,44838
220975,201805,9,8,1,7632,954,8586
220980,201805,34,32,2,30528,1908,32436
220985,201805,65,58,7,55332,6678,62010
220987,201805,31,30,1,28620,954,29574
220990,201805,15,14,1,13356,954,14310
220995,201805,37,32,5,30528,4770,35298
220997,201805,46,38,8,36252,7632,43884
221000,201805,1134,1018,116,967739.6,110377.8,1078117.4
221005,201805,61,55,6,52470,5724,58194
221010,201805,17,14,3,13356,2862,16218
221020,201805,45,43,2,41022,1908,42930
221030,201805,30,24,6,22896,5724,28620
221035,201805,19,19,0,18126,0,18126
221037,201805,12,6,6,5724,5724,11448
221038,201805,25,23,2,21942,1908,23850
221039,201805,23,23,0,21942,0,21942
221040,201805,259,223,36,212742,34344,247086
221050,201805,234,197,37,187938,35298,223236
221060,201805,1735,1525,210,1453334.76,200340,1653674.76
221062,201805,28,27,1,25758,954,26712
221063,201805,14,10,4,9540,3816,13356
221065,201805,50,43,7,41022,6678,47700
221070,201805,140,121,19,115434,18126,133560
221080,201805,374,332,42,316728,39781.8,356509.8
221090,201805,36,35,1,33390,954,34344
221093,201805,56,37,19,35298,18126,53424
221095,201805,11,10,1,9540,954,10494
221097,201805,20,17,3,16218,2862,19080
221100,201805,24724,14231,10493,13555274.61,10004363.03,23559637.64
221110,201805,1039,762,277,726662,264258,990920
221120,201805,528,392,136,373682,129744,503426
221130,201805,946,772,174,735248.8,165996,901244.8
221135,201805,36,33,3,31482,2862,34344
221140,201805,40,32,8,30528,7632,38160
221150,201805,14,11,3,10494,2862,13356
221160,201805,13,13,0,12402,0,12402
221170,201805,13,13,0,12402,0,12402
230010,201805,165,152,13,145008,12402,157410
230015,201805,119,99,20,94446,19080,113526
230020,201805,1566,1333,233,1268753.82,221394.87,1490148.69
230030,201805,1630,1172,458,1112519.04,436932,1549451.04
230040,201805,203,179,24,169573.5,22896,192469.5
230050,201805,208,152,56,145008,53424,198432
230060,201805,153,126,27,119440.8,25758,145198.8
230070,201805,279,249,30,237546,28620,266166
230075,201805,811,706,105,671521,99883.8,771404.8
230080,201805,180,155,25,147870,23850,171720
230090,201805,100,68,32,64108.8,30528,94636.8
230100,201805,1939,1152,787,1096721,750798,1847519
230110,201805,2645,1693,952,1612723.4,907635.8,2520359.2
230120,201805,944,751,193,714070.22,184103,898173.22
230125,201805,139,114,25,108756,23850,132606
230130,201805,464,416,48,396864,45792,442656
230140,201805,202,175,27,166950,25758,192708
230150,201805,156,122,34,116388,32436,148824
230160,201805,921,795,126,757953,120204,878157
230170,201805,584,539,45,509693.7,42930,552623.7
230180,201805,79,74,5,70596,4770,75366
230185,201805,410,354,56,336618.9,53424,390042.9
230190,201805,2210,1786,424,1699864.48,404179,2104043.48
230195,201805,489,427,62,407358,59148,466506
230200,201805,374,325,49,309086.46,46746,355832.46
230205,201805,357,229,128,216696.33,122112,338808.33
230210,201805,1258,1004,254,956470.21,241552.8,1198023.01
230220,201805,1403,969,434,923662.8,414036,1337698.8
230230,201805,892,783,109,746075.7,103986,850061.7
230240,201805,1630,1404,226,1337731.7,215604,1553335.7
230250,201805,1778,1468,310,1396043.51,295740,1691783.51
230260,201805,2943,1780,1163,1693881.16,1108529.69,2802410.85
230270,201805,1343,1078,265,1026193.99,251617.5,1277811.49
230280,201805,2724,2031,693,1931155.78,660454.2,2591609.98
230290,201805,398,362,36,340164.07,34344,374508.07
230300,201805,508,377,131,358398.72,124974,483372.72
230310,201805,417,314,103,299408.13,98262,397670.13
230320,201805,917,781,136,741149.6,129744,870893.6
230330,201805,300,241,59,229150.8,56096,285246.8
230340,201805,452,363,89,345349,84906,430255
230350,201805,3053,1928,1125,1839264.3,1070675.28,2909939.58
230360,201805,263,214,49,203246,46746,249992
230365,201805,134,108,26,102317,24804,127121
230370,201805,9748,4770,4978,4541864.32,4744603.64,9286467.96
230380,201805,461,397,64,378452,60102.6,438554.6
230390,201805,508,279,229,264362.94,218466,482828.94
230393,201805,262,215,47,204256.8,44838,249094.8
230395,201805,337,275,62,262102,59148,321250
230400,201805,594,473,121,449334,114937.92,564271.92
230410,201805,2636,1644,992,1562748.75,945477,2508225.75
230420,201805,6016,3942,2074,3742484.16,1974019.14,5716503.30
230423,201805,315,273,42,260442,40068,300510
230425,201805,350,289,61,275105,58194,333299
230426,201805,108,97,11,91812.96,10207.8,102020.76
230427,201805,79,76,3,72504,2862,75366
230428,201805,1356,700,656,667571.04,625824,1293395.04
230430,201805,446,361,85,344200,81090,425290
230435,201805,797,563,234,535791.23,221996.61,757787.84
230440,201805,83790,36989,46801,35198421.39,44603947.02,79802368.41
230445,201805,263,183,80,174391.2,76320,250711.2
230450,201805,540,437,103,416898,98262,515160
230460,201805,59,50,9,47700,8586,56286
230465,201805,302,246,56,234684,53424,288108
230470,201805,1877,1470,407,1402380,387171.1,1789551.1
230480,201805,152,146,6,138997.8,5724,144721.8
230490,201805,280,226,54,215604,51516,267120
230495,201805,438,331,107,314891.38,102078,416969.38
230500,201805,951,711,240,677340,228960,906300
230510,201805,45,36,9,34344,8586,42930
230520,201805,385,305,80,290970,76320,367290
230523,201805,2062,1293,769,1231171.66,733178,1964349.66
230526,201805,298,249,49,237546,45955,283501
230530,201805,673,503,170,476849.59,161226.2,638075.79
230533,201805,182,173,9,165042,8586,173628
230535,201805,345,259,86,247086,82044,329130
230540,201805,1834,1601,233,1524711.04,221709.8,1746420.84
230550,201805,3621,2324,1297,2208102.86,1235988.09,3444090.95
230560,201805,578,443,135,420523.8,127836,548359.8
230565,201805,194,140,54,133560,50753,184313
230570,201805,303,267,36,254718,34344,289062
230580,201805,1109,817,292,776990.72,277614,1054604.72
230590,201805,960,746,214,708108.1,203679,911787.1
230600,201805,258,234,24,222492.07,22896,245388.07
230610,201805,338,270,68,257390,64872,322262
230620,201805,165,136,29,128790,27666,156456
230625,201805,723,525,198,499295.78,187738.68,687034.46
230630,201805,1257,993,264,947322,251474.4,1198796.4
230640,201805,3557,3067,490,2918683.65,466701.57,3385385.22
230650,201805,398,346,52,329224.37,49593.69,378818.06
230655,201805,644,557,87,530424.8,82932.38,613357.18
230660,201805,345,291,54,277614,51229.8,328843.8
230670,201805,425,376,49,358704,46746,405450
230680,201805,196,180,16,171720,15264,186984
230690,201805,861,751,110,716454,104940,821394
230700,201805,699,591,108,563814,102745.8,666559.8
230710,201805,732,693,39,660932,37206,698138
230720,201805,149,126,23,119812.86,21942,141754.86
230725,201805,238,189,49,180306,46737,227043
230730,201805,11716,6364,5352,6055144.5,5097158.02,11152302.52
230740,201805,652,524,128,499610,121421.46,621031.46
230750,201805,811,693,118,659930.3,112572,772502.3
230760,201805,1315,1140,175,1083513.25,166950,1250463.25
230763,201805,315,262,53,247992.95,50562,298554.95
230765,201805,6874,3236,3638,3082367.21,3469513.76,6551880.97
230770,201805,4956,2543,2413,2416648.6,2300561.46,4717210.06
230780,201805,685,602,83,571168.1,78929.96,650098.06
230790,201805,200,165,35,157410,32589.4,189999.4
230800,201805,1122,821,301,782924.15,287154,1070078.15
230810,201805,1298,1155,143,1100868.3,136231.2,1237099.5
230820,201805,337,240,97,228007,92538,320545
230830,201805,936,809,127,768272.41,121158,889430.41
230835,201805,277,238,39,226098,36491,262589
230837,201805,161,136,25,129744,23850,153594
230840,201805,906,727,179,692318.5,170480,862798.5
230850,201805,1473,1283,190,1223505,180974,1404479
230860,201805,299,224,75,213696,71550,285246
230870,201805,1801,1533,268,1461528,255100,1716628
230880,201805,41,29,12,27666,11448,39114
230890,201805,569,523,46,498819.8,43870,542689.8
230900,201805,277,210,67,200340,63721,264061
230910,201805,199,160,39,151876.8,37206,189082.8
230920,201805,402,316,86,301464,82044,383508
230930,201805,923,648,275,615330.64,262350,877680.64
230940,201805,824,663,161,632502,153404,785906
230945,201805,481,402,79,383032,75366,458398
230950,201805,379,324,55,309096,52470,361566
230960,201805,2547,1720,827,1634152.84,788672,2422824.84
230970,201805,1736,979,757,933027.28,721300.32,1654327.60
230980,201805,211,180,31,171720,29574,201294
230990,201805,139,112,27,106848,25001.47,131849.47
231000,201805,208,188,20,177444,19080,196524
231010,201805,136,107,29,101655.59,27666,129321.59
231020,201805,1302,901,401,857933,382554,1240487
231025,201805,961,725,236,688532.2,223598.8,912131.0
231030,201805,1133,949,184,905342,175250,1080592
231040,201805,141,97,44,91793.88,41245,133038.88
231050,201805,986,880,106,837755.9,101124,938879.9
231060,201805,142,124,18,118296,17172,135468
231070,201805,1431,1009,422,960488.1,402588,1363076.1
231080,201805,263,244,19,231965.1,18126,250091.1
231085,201805,560,346,214,329131,204156,533287
231090,201805,244,203,41,193662,39114,232776
231095,201805,165,131,34,124974,32436,157410
231100,201805,125,104,21,99216,18793.8,118009.8
231110,201805,350,305,45,288780.1,42930,331710.1
231120,201805,297,254,43,241357.86,41022,282379.86
231123,201805,138,131,7,124974,6678,131652
231126,201805,293,244,49,232776,46746,279522
231130,201805,4571,3562,1009,3389206.5,961513.26,4350719.76
231135,201805,207,176,31,167904,28308.4,196212.4
231140,201805,3053,2253,800,2146504.54,762207.84,2908712.38
231150,201805,357,340,17,324360,16218,340578
231160,201805,1201,947,254,900357.08,242087.04,1142444.12
231170,201805,534,352,182,335808,173628,509436
231180,201805,1617,1373,244,1309078.8,232747.38,1541826.18
231190,201805,196,174,22,165996,20988,186984
231195,201805,218,187,31,177674,29574,207248
231200,201805,828,677,151,645858,142794,788652
231210,201805,606,506,100,481770.8,95400,577170.8
231220,201805,1037,750,287,713860.12,273798,987658.12
231230,201805,1393,1115,278,1062508.04,264448.8,1326956.84
231240,201805,1371,995,376,948943.8,357435.58,1306379.38
231250,201805,110,102,8,97308,7632,104940
231260,201805,288,184,104,175536,98930,274466
231270,201805,1002,838,164,794157.68,156169.8,950327.48
231280,201805,57,44,13,41976,12402,54378
231290,201805,7179,3998,3181,3806996.24,3032329.21,6839325.45
231300,201805,622,576,46,549504,43884,593388
231310,201805,705,654,51,622699,48654,671353
231320,201805,568,435,133,414514,126882,541396
231325,201805,89,80,9,76320,8586,84906
231330,201805,2030,1569,461,1491011.66,437505.6,1928517.26
231335,201805,245,217,28,207018,26712,233730
231340,201805,1622,1197,425,1140794.08,405163.8,1545957.88
231350,201805,1168,958,210,913932,199768,1113700
231355,201805,403,349,54,332946,51516,384462
231360,201805,478,375,103,355040.2,98262,453302.2
231370,201805,90,74,16,70596,15264,85860
231375,201805,288,208,80,198432,76320,274752
231380,201805,451,364,87,345660.69,82807.2,428467.89
231390,201805,195,160,35,152640,33390,186030
231395,201805,730,447,283,425140.56,269982,695122.56
231400,201805,1064,880,184,836962.84,175193.38,1012156.22
231410,201805,1320,1072,248,1018873.4,235639,1254512.4
240010,201805,392,182,210,172393.26,200331,372724.26
240020,201805,2191,1715,476,1634523.89,454100,2088623.89
240030,201805,130,110,20,104940,19080,124020
240040,201805,32,32,0,30528,0,30528
240050,201805,508,436,72,415090.45,68688,483778.45
240060,201805,66,62,4,59148,3816,62964
240070,201805,185,145,40,138330,38160,176490
240080,201805,439,296,143,282380,136422,418802
240090,201805,105,93,12,88416.72,11448,99864.72
240100,201805,1445,1360,85,1294467.55,80899.2,1375366.75
240110,201805,992,630,362,600048.26,345348,945396.26
240120,201805,139,117,22,111618,20988,132606
240130,201805,287,269,18,255909.54,17172,273081.54
240140,201805,79,63,16,60102,15264,75366
240145,201805,687,606,81,577599.3,77064.12,654663.42
240150,201805,20,15,5,14310,4741.38,19051.38
240160,201805,44,38,6,36252,5724,41976
240165,201805,35,29,6,27428,5724,33152
240170,201805,94,72,22,68688,20988,89676
240180,201805,78,64,14,61056,13356,74412
240185,201805,44,40,4,38150.46,3816,41966.46
240190,201805,12,10,2,9540,1908,11448
240200,201805,3012,1686,1326,1602177.67,1263765,2865942.67
240210,201805,165,129,36,123066,34344,157410
240220,201805,1101,790,311,753517,296684.46,1050201.46
240230,201805,828,767,61,728884.05,57546,786430.05
240240,201805,120,87,33,82998,31482,114480
240250,201805,92,80,12,76320,11448,87768
240260,201805,1802,1339,463,1276719.12,440433.18,1717152.30
240270,201805,190,167,23,158936.4,21942,180878.4
240280,201805,43,33,10,31482,9540,41022
240290,201805,50,49,1,46746,954,47700
240300,201805,180,100,80,95400,76320,171720
240310,201805,1999,1095,904,1033897.98,859198.57,1893096.55
240320,201805,206,196,10,186984,9540,196524
240325,201805,4305,2634,1671,2505365.46,1590725.86,4096091.32
240330,201805,65,61,4,58194,3816,62010
240340,201805,103,75,28,71550,26712,98262
240350,201805,89,79,10,75366,9540,84906
240360,201805,402,285,117,271890,111618,383508
240370,201805,38,36,2,34344,1908,36252
240375,201805,69,40,29,38160,27666,65826
240380,201805,233,189,44,180306,41881,222187
240390,201805,16,13,3,12402,2862,15264
240400,201805,76,72,4,68688,3816,72504
240410,201805,11,7,4,6678,3816,10494
240420,201805,883,687,196,653253.4,185934.6,839188.0
240430,201805,262,247,15,234707.65,14310,249017.65
240440,201805,69,37,32,35298,30528,65826
240450,201805,209,140,69,132987.8,65826,198813.8
240460,201805,61,48,13,45792,12402,58194
240470,201805,234,203,31,193104.86,29574,222678.86
240480,201805,14,14,0,13260.6,0,13260.6
240485,201805,75,65,10,62010,9540,71550
240490,201805,46,46,0,43674.12,0,43674.12
240500,201805,85,67,18,63918,17172,81090
240510,201805,51,36,15,34344,14310,48654
240520,201805,126,120,6,114480,5724,120204
240530,201805,53,47,6,44838,5724,50562
240540,201805,78,67,11,63918,10494,74412
240550,201805,15,13,2,12402,1908,14310
240560,201805,372,275,97,261723.23,92538,354261.23
240570,201805,459,286,173,271985.4,165042,437027.4
240580,201805,1259,1021,238,968549.9,225894.2,1194444.1
240590,201805,30,28,2,26712,1908,28620
240600,201805,110,107,3,102078,2862,104940
240610,201805,508,426,82,406047.7,77465,483512.7
240615,201805,20,19,1,18126,954,19080
240620,201805,95,91,4,86814,3816,90630
240630,201805,34,32,2,30528,1908,32436
240640,201805,26,22,4,20988,3816,24804
240650,201805,233,196,37,186125.9,35298,221423.9
240660,201805,98,86,12,82044,11448,93492
240670,201805,290,171,119,161035.3,113526,274561.3
240680,201805,49,38,11,36252,10494,46746
240690,201805,49,46,3,43884,2862,46746
240700,201805,195,162,33,154548,31482,186030
240710,201805,1927,1226,701,1169170.83,668744.46,1837915.29
240720,201805,1055,773,282,736288.66,269028,1005316.66
240725,201805,65,62,3,59148,2862,62010
240730,201805,133,115,18,109710,17172,126882
240740,201805,239,202,37,191343.78,34344.02,225687.80
240750,201805,36,24,12,22896,11448,34344
240760,201805,33,29,4,27666,3816,31482
240770,201805,148,114,34,108756,32436,141192
240780,201805,694,574,120,546155.46,114480,660635.46
240790,201805,38,37,1,35298,954,36252
240800,201805,8644,5868,2776,5557717.98,2641475.2,8199193.18
240810,201805,20045,11036,9009,10485332.21,8584472.48,19069804.69
240820,201805,211,133,78,126591.03,74412,201003.03
240830,201805,1609,1318,291,1250847.16,276660,1527507.16
240840,201805,79,69,10,65826,9540,75366
240850,201805,88,77,11,73458,10494,83952
240860,201805,114,111,3,105894,2862,108756
240870,201805,59,52,7,49608,6678,56286
240880,201805,29,26,3,24794.46,2862,27656.46
240890,201805,1164,691,473,655304.78,451238,1106542.78
240895,201805,45,33,12,31482,11448,42930
240910,201805,153,138,15,131652,14310,145962
240920,201805,15,12,3,11448,2862,14310
240930,201805,384,348,36,331038,34344,365382
240933,201805,30,23,7,21942,6678,28620
240940,201805,2432,2150,282,2037607.29,266146.92,2303754.21
240950,201805,51,48,3,45792,2862,48654
240960,201805,31,25,6,23850,5724,29574
240970,201805,128,91,37,86814,34544,121358
240980,201805,190,150,40,143100,38160,181260
240990,201805,119,79,40,75366,38160,113526
241000,201805,70,65,5,62010,4770,66780
241010,201805,60,48,12,45792,11448,57240
241020,201805,116,109,7,103986,6678,110664
241025,201805,9,3,6,2862,5724,8586
241030,201805,119,97,22,92538,20988,113526
241040,201805,35,29,6,27666,5724,33390
241050,201805,90,78,12,74412,11448,85860
241060,201805,27,24,3,22896,2862,25758
241070,201805,14,14,0,13356,0,13356
241080,201805,64,57,7,54091.8,6678,60769.8
241090,201805,50,40,10,38160,9525.69,47685.69
241100,201805,73,63,10,60102,9540,69642
241105,201805,6,2,4,1908,3816,5724
241110,201805,47,45,2,42930,1908,44838
241120,201805,1423,1103,320,1049276.8,305280,1354556.8
241140,201805,223,183,40,173629,38160,211789
241142,201805,42,40,2,38160,1908,40068
241150,201805,1212,1066,146,1014246,139284,1153530
241160,201805,22,21,1,20034,954,20988
241170,201805,42,39,3,37206,2862,40068
241180,201805,50,41,9,38939.42,8586,47525.42
241190,201805,39,38,1,36252,954,37206
241200,201805,3865,2111,1754,2009313.22,1671395.66,3680708.88
241210,201805,70,59,11,56286,9636,65922
241220,201805,1375,927,448,883834.84,427358.92,1311193.76
241230,201805,247,208,39,198241.2,37206,235447.2
241240,201805,52,40,12,38160,11448,49608
241250,201805,1096,1015,81,968024,76988,1045012
241255,201805,47,38,9,36252,8586,44838
241260,201805,631,499,132,476041.23,125928,601969.23
241270,201805,45,32,13,30528,12402,42930
241280,201805,97,84,13,80136,12402,92538
241290,201805,108,80,28,76320,26712,103032
241300,201805,78,55,23,52470,21942,74412
241310,201805,51,38,13,36109,12402,48511
241320,201805,27,14,13,13356,12402,25758
241330,201805,60,54,6,51516,5724,57240
241335,201805,63,56,7,52756.2,6678,59434.2
241340,201805,187,140,47,133560,44838,178398
241350,201805,59,54,5,51516,4770,56286
241355,201805,41,38,3,36252,2862,39114
241360,201805,46,46,0,43884,0,43884
241370,201805,44,37,7,35173.98,6678,41851.98
241380,201805,38,35,3,33390,2862,36252
241390,201805,75,60,15,57049.2,14310,71359.2
241400,201805,199,163,36,154834.2,34344,189178.2
241410,201805,177,160,17,152640,16122.6,168762.6
241415,201805,96,77,19,73458,18126,91584
241420,201805,99,75,24,71550,22725,94275
241430,201805,28,27,1,25758,954,26712
241440,201805,469,391,78,373000,74412,447412
241445,201805,38,36,2,34344,1908,36252
241450,201805,275,224,51,213696,48654,262350
241460,201805,135,123,12,117104,11448,128552
241470,201805,42,35,7,33390,6678,40068
241475,201805,63,61,2,58194,1908,60102
241480,201805,101,72,29,67448.69,27666,95114.69
241490,201805,8,7,1,6678,954,7632
241500,201805,46,33,13,31482,12402,43884
250010,201805,99,87,12,82854.9,11448,94302.9
250020,201805,27,24,3,22896,2862,25758
250030,201805,807,601,206,572009.2,195475.6,767484.8
250040,201805,331,280,51,267120,48367.8,315487.8
250050,201805,230,190,40,180969.8,38160,219129.8
250053,201805,55,42,13,40068,12402,52470
250057,201805,0,0,0,0,0,0
250060,201805,452,343,109,327222,103699.8,430921.8
250070,201805,706,588,118,558934,112572,671506
250073,201805,7,7,0,6678,0,6678
250077,201805,200,150,50,142708.86,47700,190408.86
250080,201805,423,331,92,314153.2,87768,401921.2
250090,201805,202,133,69,125928.4,65806.92,191735.32
250100,201805,517,425,92,405450,87387,492837
250110,201805,494,375,119,355966.02,113526,469492.02
250115,201805,25,8,17,7632,16218,23850
250120,201805,110,82,28,78228,26712,104940
250130,201805,580,464,116,442656,110474,553130
250135,201805,14,8,6,7632,5724,13356
250140,201805,76,68,8,64872,7632,72504
250150,201805,570,421,149,399107.33,141831.18,540938.51
250153,201805,10,9,1,8586,954,9540
250157,201805,29,24,5,22896,4770,27666
250160,201805,215,168,47,160272,44838,205110
250170,201805,66,46,20,43884,19080,62964
250180,201805,4005,2702,1303,2564050.9,1237964,3802014.9
250190,201805,863,567,296,539248.5,281668.5,820917.0
250200,201805,53,44,9,41976,8586,50562
250205,201805,23,20,3,19080,2862,21942
250210,201805,90,78,12,74412,11448,85860
250215,201805,63,54,9,51516,8586,60102
250220,201805,27,21,6,20034,5724,25758
250230,201805,77,70,7,66776,6678,73454
250240,201805,245,204,41,193805.1,39114,232919.1
250250,201805,394,336,58,320544,55332,375876
250260,201805,33,30,3,28620,2862,31482
250270,201805,56,45,11,42930,10494,53424
250280,201805,378,317,61,302418,58194,360612
250290,201805,95,90,5,85573.8,4770,90343.8
250300,201805,555,379,176,360918.71,167891,528809.71
250310,201805,48,43,5,41022,4770,45792
250320,201805,1974,1348,626,1280635.35,595630.8,1876266.15
250330,201805,84,74,10,70596,9540,80136
250340,201805,25,21,4,20034,3816,23850
250350,201805,139,88,51,83665.8,48081.6,131747.4
250355,201805,32,25,7,23850,6678,30528
250360,201805,201,164,37,156456,35060,191516
250370,201805,2389,1617,772,1537659.98,734931.82,2272591.80
250375,201805,16,12,4,11448,3816,15264
250380,201805,53,37,16,35298,15264,50562
250390,201805,42,34,8,32436,7632,40068
250400,201805,15682,7966,7716,7573864.13,7354615.55,14928479.68
250403,201805,421,343,78,327212.46,74412,401624.46
250407,201805,57,49,8,46746,7632,54378
250410,201805,30,25,5,23850,4770,28620
250415,201805,42,28,14,26692.92,13336.92,40029.84
250420,201805,46,38,8,36252,7632,43884
250430,201805,1527,1302,225,1239915,214650,1454565
250435,201805,16,13,3,12402,2862,15264
250440,201805,690,594,96,562743.22,91584,654327.22
250450,201805,88,73,15,69642,13642.2,83284.2
250460,201805,421,290,131,276660,124964.46,401624.46
250470,201805,88,65,23,62010,21942,83952
250480,201805,324,255,69,243270,65826,309096
250485,201805,2,1,1,954,954,1908
250490,201805,208,171,37,163134,35298,198432
250500,201805,77,57,20,54378,19080,73458
250510,201805,734,579,155,551316.8,146861.43,698178.23
250520,201805,173,121,52,115414.92,49603.23,165018.15
250523,201805,112,93,19,88722,18126,106848
250527,201805,102,81,21,77269.23,20034,97303.23
250530,201805,6,4,2,3816,1908,5724
250535,201805,25,21,4,20034,3816,23850
250540,201805,124,94,30,88960.5,28620,117580.5
250550,201805,69,66,3,62964,2862,65826
250560,201805,38,31,7,29574,6678,36252
250570,201805,150,120,30,114480,28620,143100
250580,201805,133,104,29,98929.8,27666,126595.8
250590,201805,20,16,4,15264,3816,19080
250600,201805,1319,892,427,849061.35,407262.6,1256323.95
250610,201805,151,130,21,124020,20034,144054
250620,201805,22,18,4,17172,3816,20988
250625,201805,65,49,16,46746,15264,62010
250630,201805,3016,1934,1082,1836993.65,1031160.74,2868154.39
250640,201805,203,169,34,161226,32436,193662
250650,201805,31,21,10,20034,9540,29574
250660,201805,44,34,10,32436,9540,41976
250670,201805,62,41,21,39114,20034,59148
250680,201805,383,314,69,299556,65826,365382
250690,201805,1834,1267,567,1205136.53,540536.8,1745673.33
250700,201805,921,813,108,772175.62,102822.12,874997.74
250710,201805,446,346,100,330084,95400,425484
250720,201805,104,82,22,78228,20988,99216
250730,201805,376,318,58,302418.6,55332,357750.6
250740,201805,51,47,4,44838,3816,48654
250750,201805,20492,12296,8196,11672784.78,7809049.88,19481834.66
250760,201805,71,52,19,49608,18126,67734
250770,201805,352,233,119,220374.14,112357.55,332731.69
250780,201805,54,41,13,39114,12402,51516
250790,201805,476,312,164,294786.92,155740.5,450527.42
250800,201805,155,142,13,134752.5,12402,147154.5
250810,201805,79,60,19,57240,18126,75366
250820,201805,161,130,31,124020,29574,153594
250830,201805,419,286,133,271842.5,126882,398724.5
250840,201805,53,51,2,48654,1908,50562
250850,201805,54,42,12,39381.12,11448,50829.12
250855,201805,14,12,2,11448,1908,13356
250860,201805,203,145,58,138330,55045.8,193375.8
250870,201805,32,29,3,27666,2862,30528
250880,201805,79,61,18,58136.76,17172,75308.76
250890,201805,2424,1789,635,1704893.4,604926.73,2309820.13
250900,201805,116,98,18,93492,17172,110664
250905,201805,124,96,28,91584,26712,118296
250910,201805,1179,840,339,800197.31,323119.8,1123317.11
250915,201805,110,76,34,72504,32436,104940
250920,201805,138,107,31,102078,29574,131652
250930,201805,160,99,61,94446,58194,152640
250933,201805,1,1,0,954,0,954
250937,201805,6,5,1,4770,954,5724
250939,201805,31,22,9,20988,8586,29574
250940,201805,106,79,27,75366,25758,101124
250950,201805,71,47,24,44838,22896,67734
250960,201805,89,49,40,46746,38160,84906
250970,201805,1208,859,349,817865,331992,1149857
250980,201805,92,64,28,61056,26712,87768
250990,201805,165,129,36,122593.77,34301.07,156894.84
251000,201805,75,68,7,64681.2,6678,71359.2
251010,201805,103,80,23,76316,21163.53,97479.53
251020,201805,80,70,10,65969.1,9540,75509.1
251030,201805,43,33,10,31482,9540,41022
251040,201805,53,38,15,36252,14310,50562
251050,201805,23,21,2,20034,1908,21942
251060,201805,52,41,11,38160,10494,48654
251065,201805,3,3,0,2862,0,2862
251070,201805,25,20,5,19071,4770,23841
251080,201805,4712,2285,2427,2168301.88,2308805.01,4477106.89
251090,201805,197,169,28,161226,26712,187938
251100,201805,19,18,1,17172,954,18126
251110,201805,46,37,9,35298,8586,43884
251120,201805,1809,1098,711,1042582.2,678294,1720876.2
251130,201805,390,316,74,301354.29,70596,371950.29
251140,201805,514,333,181,316538.8,172505.34,489044.14
251150,201805,294,254,40,241544,38160,279704
251160,201805,94,79,15,75362,14310,89672
251170,201805,98,78,20,74383.38,19075.23,93458.61
251180,201805,289,182,107,173619.23,102069.23,275688.46
251190,201805,193,133,60,126553.83,57240,183793.83
251200,201805,254,208,46,198432,43884,242316
251203,201805,34,32,2,30528,1908,32436
251207,201805,95,79,16,75366,15264,90630
251210,201805,1414,1017,397,968664.53,378070.2,1346734.73
251220,201805,48,38,10,36252,9540,45792
251230,201805,475,397,78,378738,74412,453150
251240,201805,101,73,28,68688,26712,95400
251250,201805,1330,953,377,906272.87,359515,1265787.87
251260,201805,13,8,5,7632,4770,12402
251270,201805,344,256,88,244224,83809,328033
251272,201805,63,58,5,55332,4770,60102
251274,201805,27,22,5,20988,4770,25758
251275,201805,23,16,7,15264,6678,21942
251276,201805,17,13,4,12402,3816,16218
251278,201805,9,7,2,6678,1908,8586
251280,201805,99,94,5,89676,4770,94446
251290,201805,703,530,173,505620,165042,670662
251300,201805,16,14,2,13356,1908,15264
251310,201805,365,262,103,249944,98262,348206
251315,201805,19,18,1,17172,954,18126
251320,201805,61,49,12,46746,11448,58194
251330,201805,80,71,9,67734,8586,76320
251335,201805,11,6,5,5724,4770,10494
251340,201805,699,412,287,393048,272773.25,665821.25
251350,201805,37,35,2,33390,1908,35298
251360,201805,66,58,8,55125.94,7632,62757.94
251365,201805,15,14,1,13356,954,14310
251370,201805,5305,3608,1697,3436866.94,1617365.5,5054232.44
251380,201805,50,40,10,38160,9540,47700
251385,201805,3,3,0,2862,0,2862
251390,201805,674,534,140,508292.2,132320,640612.2
251392,201805,12,7,5,6678,4770,11448
251394,201805,10,10,0,9540,0,9540
251396,201805,16,11,5,10494,4770,15264
251398,201805,18,15,3,14310,2862,17172
251400,201805,41,34,7,32436,6678,39114
251410,201805,35,30,5,28620,4770,33390
251420,201805,105,78,27,74412,25758,100170
251430,201805,39,37,2,35298,1908,37206
251440,201805,33,22,11,20988,10494,31482
251445,201805,54,49,5,46746,4770,51516
251450,201805,420,372,48,353232.8,45792,399024.8
251455,201805,2,1,1,954,954,1908
251460,201805,17,13,4,12402,3816,16218
251465,201805,5,2,3,1908,2862,4770
251470,201805,46,36,10,34344,9540,43884
251480,201805,26,24,2,22896,1908,24804
251490,201805,129,90,39,85383,36253,121636
251500,201805,118,95,23,90630,21179,111809
251510,201805,37,28,9,26712,8586,35298
251520,201805,25,25,0,23850,0,23850
251530,201805,4526,3185,1341,3032190.24,1279018.26,4311208.50
251540,201805,73,65,8,62010,7632,69642
251550,201805,414,320,94,304326.2,88924,393250.2
251560,201805,24,17,7,16218,6678,22896
251570,201805,19,19,0,18126,0,18126
251580,201805,120,98,22,93492,20988,114480
251590,201805,125,93,32,88903,30528,119431
251593,201805,20,11,9,10494,8586,19080
251597,201805,55,45,10,42930,9540,52470
251600,201805,1097,775,322,737858.48,305579.92,1043438.40
251610,201805,210,158,52,150732,48941,199673
251615,201805,3,3,0,2862,0,2862
251620,201805,4247,2833,1414,2692841.84,1346191,4039032.84
251630,201805,454,335,119,319590,113517,433107
251640,201805,149,104,45,99216,42930,142146
251650,201805,266,193,73,182289.1,69642,251931.1
251660,201805,224,202,22,191754.1,20797.2,212551.3
251670,201805,358,279,79,264470,75366,339836
251675,201805,3,3,0,2862,0,2862
251680,201805,95,87,8,82998,7632,90630
251690,201805,340,285,55,270936,52119.89,323055.89
251700,201805,281,235,46,223603.29,43869.69,267472.98
251710,201805,21,14,7,13356,6678,20034
251720,201805,32,22,10,20988,9254,30242
251740,201805,10,8,2,7632,1908,9540
260005,201805,3134,1784,1350,1690847.34,1286733.1,2977580.44
260010,201805,1473,1053,420,999696.48,398677.32,1398373.80
260020,201805,427,375,52,357750,49608,407358
260030,201805,579,421,158,400866.98,150732,551598.98
260040,201805,861,534,327,508348.44,311948.46,820296.90
260050,201805,1137,816,321,778226,305662,1083888
260060,201805,413,375,38,356986.8,36252,393238.8
260070,201805,1466,924,542,877374,514098.36,1391472.36
260080,201805,727,574,153,546785.1,145962,692747.1
260090,201805,575,358,217,341304.12,207018,548322.12
260100,201805,230,160,70,151639.2,66780,218419.2
260105,201805,234,131,103,124974,98262,223236
260110,201805,2752,2043,709,1949013,675576,2624589
260120,201805,2908,1459,1449,1382168.21,1380058.1,2762226.31
260130,201805,151,103,48,98262,45792,144054
260140,201805,2128,1398,730,1325201.56,694875.46,2020077.02
260150,201805,228,151,77,144054,73458,217512
260160,201805,296,254,42,242316,40068,282384
260170,201805,3375,2066,1309,1964103.37,1247402.9,3211506.27
260180,201805,136,115,21,109710,20034,129744
260190,201805,2266,1602,664,1525157.9,633456,2158613.9
260200,201805,896,735,161,700415.08,153308,853723.08
260210,201805,1407,999,408,952895.27,387983.11,1340878.38
260220,201805,722,660,62,629640,59148,688788
260230,201805,1200,910,290,865948.99,276660,1142608.99
260240,201805,221,168,53,159098.58,50562,209660.58
260250,201805,75,59,16,56286,15264,71550
260260,201805,992,711,281,678294,268074,946368
260270,201805,429,349,80,331563.2,76033.8,407597.0
260280,201805,1353,881,472,839997,450002,1289999
260290,201805,6383,3410,2973,3234336.35,2829532,6063868.35
260300,201805,861,759,102,722017.6,97022,819039.6
260310,201805,501,402,99,382129.47,94446,476575.47
260320,201805,882,666,216,635077.2,206064,841141.2
260330,201805,34,27,7,25758,6678,32436
260340,201805,68,49,19,46746,18126,64872
260345,201805,5687,3206,2481,3051393.63,2365797.76,5417191.39
260350,201805,476,346,130,328340.08,123067,451407.08
260360,201805,285,146,139,139284,132606,271890
260370,201805,656,430,226,407610.4,215464,623074.4
260380,201805,597,429,168,409266,159127.56,568393.56
260390,201805,297,251,46,238375.98,42930,281305.98
260392,201805,99,87,12,82998,11448,94446
260400,201805,4066,2343,1723,2226032.46,1643361.68,3869394.14
260410,201805,14458,7713,6745,7342117.67,6431999,13774116.67
260415,201805,122,110,12,104940,11448,116388
260420,201805,1784,1066,718,1011925.2,683175.64,1695100.84
260430,201805,190,174,16,164784.66,15264,180048.66
260440,201805,229,167,62,158594,59148,217742
260450,201805,476,344,132,326891,125928,452819
260460,201805,846,451,395,427584.8,376825.23,804410.03
260470,201805,372,228,144,216748.8,136995,353743.8
260480,201805,206,128,78,122112,74412,196524
260490,201805,209,168,41,160272,39114,199386
260500,201805,1136,764,372,726568.2,353791.8,1080360.0
260510,201805,742,588,154,559711.8,145962,705673.8
260515,201805,262,233,29,222282,27189,249471
260520,201805,3324,1973,1351,1874942.52,1286545.62,3161488.14
260530,201805,791,642,149,609648.64,142146,751794.64
260540,201805,570,433,137,413082,129744.72,542826.72
260545,201805,13,10,3,9540,2862,12402
260550,201805,346,215,131,205110,124974,330084
260560,201805,518,387,131,368912,124687.8,493599.8
260570,201805,1011,831,180,789769.8,171433.8,961203.6
260580,201805,263,235,28,224190,26712,250902
260590,201805,659,376,283,357292.08,269982,627274.08
260600,201805,8185,4185,4000,3970474.76,3812131.53,7782606.29
260610,201805,497,333,164,317682,156169.8,473851.8
260620,201805,3641,1896,1745,1797094.79,1661511.97,3458606.76
260630,201805,76,73,3,69642,2862,72504
260640,201805,3676,2008,1668,1912313.58,1591206.3,3503519.88
260650,201805,341,238,103,227052,98219.07,325271.07
260660,201805,507,343,164,326840.4,155835.9,482676.3
260670,201805,102,76,26,72504,24804,97308
260680,201805,3667,2045,1622,1934046.32,1547044.84,3481091.16
260690,201805,120,94,26,89676,24804,114480
260700,201805,325,198,127,188128.8,120324,308452.8
260710,201805,39,36,3,34344,2862,37206
260720,201805,2228,1337,891,1269291.69,848977.12,2118268.81
260730,201805,606,454,152,433116,142813.8,575929.8
260740,201805,62,58,4,55332,3816,59148
260750,201805,640,445,195,424205.64,186030,610235.64
260760,201805,623,338,285,322452,271890,594342
260765,201805,982,518,464,490943.8,442417.5,933361.3
260770,201805,220,164,56,156456,53424,209880
260775,201805,821,488,333,464169.8,317673,781842.8
260780,201805,274,176,98,167904,93492,261396
260790,201805,12344,6778,5566,6439143.52,5302394.93,11741538.45
260795,201805,166,115,51,108546.12,48654,157200.12
260800,201805,279,228,51,217035,48654,265689
260805,201805,175,112,63,106119.14,60102,166221.14
260810,201805,740,643,97,612935.46,92538,705473.46
260820,201805,317,214,103,202826.79,98262,301088.79
260825,201805,205,141,64,134136.99,61056,195192.99
260830,201805,263,169,94,161226,89676,250902
260840,201805,229,167,62,158651,58862,217513
260845,201805,210,146,64,138997.8,61056,200053.8
260850,201805,499,361,138,342730.09,131652,474382.09
260860,201805,254,191,63,182016.34,60102,242118.34
260870,201805,375,271,104,258534,99216,357750
260875,201805,701,490,211,466346.69,201294,667640.69
260880,201805,1590,963,627,916743.09,597967.2,1514710.29
260890,201805,2439,1696,743,1611544.06,707869,2319413.06
260900,201805,1039,714,325,679853.79,310050,989903.79
260910,201805,278,218,60,207972,57240,265212
260915,201805,300,202,98,192708,93372,286080
260920,201805,177,100,77,95400,73458,168858
260930,201805,389,334,55,318636,52384.45,371020.45
260940,201805,2777,1523,1254,1448747.89,1195819.92,2644567.81
260950,201805,2015,1169,846,1108873.82,807084,1915957.82
260960,201805,14274,7425,6849,7048994.84,6526471.53,13575466.37
260970,201805,438,374,64,356007,61056,417063
260980,201805,196,172,24,163802,22896,186698
260990,201805,2569,2113,456,2014057.2,434356.2,2448413.4
261000,201805,4356,2577,1779,2445244.84,1695268.34,4140513.18
261010,201805,188,137,51,130698,47836.23,178534.23
261020,201805,606,453,153,432019,145962,577981
261030,201805,223,162,61,154548,57960.27,212508.27
261040,201805,363,327,36,311958,34057.8,346015.8
261050,201805,470,413,57,394002,54378,448380
261060,201805,1324,871,453,829742.75,432162,1261904.75
261070,201805,9036,4596,4440,4359767.65,4227949.18,8587716.83
261080,201805,388,292,96,277796,91584,369380
261090,201805,2234,1714,520,1626576.05,495308,2121884.05
261100,201805,1094,772,322,734151.6,305318.16,1039469.76
261110,201805,8068,4922,3146,4689403.25,2998411.95,7687815.20
261120,201805,272,225,47,214650,44833.23,259483.23
261130,201805,568,329,239,313532.9,227816,541348.9
261140,201805,189,122,67,116388,63918,180306
261150,201805,664,389,275,371106,261682.2,632788.2
261153,201805,73,70,3,65826.31,2862,68688.31
261160,201805,77083,38879,38204,36970637.03,36423832.17,73394469.20
261170,201805,454,339,115,322776.36,109710,432486.36
261180,201805,1768,1084,684,1029013.62,652536,1681549.62
261190,201805,613,424,189,404099.92,180297,584396.92
261200,201805,211,186,25,176679.3,23850,200529.3
261210,201805,34,31,3,29574,2862,32436
261220,201805,2555,1801,754,1711982.82,718743.8,2430726.62
261230,201805,327,238,89,227052,84891.69,311943.69
261240,201805,442,381,61,359460.95,58194,417654.95
261245,201805,223,187,36,178398,34344,212742
261247,201805,152,114,38,108756,36252,145008
261250,201805,2864,1453,1411,1385351.8,1344983.83,2730335.63
261255,201805,252,229,23,218466,21942,240408
261260,201805,866,743,123,708822,117342,826164
261270,201805,172,134,38,127836,36252,164088
261280,201805,159,131,28,124974,26712,151686
261290,201805,126,87,39,82759.5,37206,119965.5
261300,201805,1233,878,355,837612,338670,1176282
261310,201805,764,510,254,486540,241695.9,728235.9
261320,201805,546,368,178,351052.92,169812,520864.92
261330,201805,861,683,178,648583.5,168966.46,817549.96
261340,201805,309,175,134,166950,127836,294786
261350,201805,794,569,225,541872.2,214650,756522.2
261360,201805,1225,798,427,760890.37,407358,1168248.37
261370,201805,4997,3067,1930,2910802.62,1838298.45,4749101.07
261380,201805,575,422,153,401405.14,145676,547081.14
261390,201805,3426,2292,1134,2181788.84,1077975.3,3259764.14
261400,201805,278,251,27,238881.6,25758,264639.6
261410,201805,1068,708,360,675432,343435.23,1018867.23
261420,201805,893,560,333,532973.26,317663.46,850636.72
261430,201805,329,299,30,284400,28333.8,312733.8
261440,201805,116,105,11,100170,10494,110664
261450,201805,2496,2076,420,1977844.24,399669.04,2377513.28
261460,201805,724,577,147,549504.02,140238,689742.02
261470,201805,253,195,58,185220,55332,240552
261480,201805,360,293,67,278283,63914,342197
261485,201805,345,210,135,199672.2,128790,328462.2
261500,201805,627,424,203,404496,193662,598158
261510,201805,45,30,15,28620,14310,42930
261520,201805,112,99,13,94446,12402,106848
261530,201805,4175,2657,1518,2526581.94,1446918.69,3973500.63
261540,201805,1089,673,416,641578.36,396864,1038442.36
261550,201805,285,143,142,135183,135448.92,270631.92
261560,201805,801,534,267,506246.2,253564.6,759810.8
261570,201805,370,288,82,274752,78228,352980
261580,201805,377,297,80,282287.8,76320,358607.8
261590,201805,194,157,37,149778,35298,185076
261600,201805,294,237,57,225335,53901,279236
261610,201805,104,89,15,84429,14310,98739
261618,201805,66,51,15,48654,14310,62964
261620,201805,199,121,78,115434,74412,189846
261630,201805,590,453,137,429801.6,130698,560499.6
261640,201805,6322,3357,2965,3195217.09,2824995.92,6020213.01
261650,201805,487,308,179,293154.66,170766,463920.66
270010,201805,528,466,62,444278,58385,502663
270020,201805,306,243,63,231818,60102,291920
270030,201805,9180,5872,3308,5587275.65,3153388.96,8740664.61
270040,201805,1964,1204,760,1148320.26,723799.8,1872120.06
270050,201805,176,129,47,123066,44838,167904
270060,201805,116,65,51,62010,48654,110664
270070,201805,898,652,246,620193.82,234379.26,854573.08
270080,201805,38,32,6,30528,5724,36252
270090,201805,20,16,4,15264,3816,19080
270100,201805,1248,827,421,785867.61,399487.7,1185355.31
270110,201805,149,110,39,104940,37206,142146
270120,201805,228,187,41,177546.55,39114,216660.55
270130,201805,249,170,79,161346.13,75366,236712.13
270135,201805,98,60,38,57240,36252,93492
270140,201805,1294,785,509,748009.68,484623.2,1232632.88
270150,201805,268,212,56,202248,53424,255672
270160,201805,518,387,131,369198,124306.2,493504.2
270170,201805,725,464,261,441511.2,247896.9,689408.1
270180,201805,71,55,16,52152.04,15054.12,67206.16
270190,201805,103,90,13,85860,12402,98262
270200,201805,106,95,11,90439.2,10494,100933.2
270210,201805,481,250,231,238500,220087.8,458587.8
270220,201805,186,146,40,139284,38160,177444
270230,201805,2101,1252,849,1190232.54,808038.62,1998271.16
270235,201805,732,550,182,524429.59,173262.95,697692.54
270240,201805,3107,2409,698,2287048.49,663100,2950148.49
270250,201805,169,117,52,111618,49608,161226
270255,201805,222,191,31,182214,29192.4,211406.4
270260,201805,328,260,68,248040,64872,312912
270270,201805,111,46,65,43875,62010,105885
270280,201805,202,125,77,119250,73458,192708
270290,201805,1177,883,294,841146.42,279599.46,1120745.88
270300,201805,276,174,102,165996,97021.8,263017.8
270310,201805,916,736,180,700802.25,171005.58,871807.83
270320,201805,876,748,128,711920.8,121825.8,833746.6
270330,201805,274,229,45,217512,42930,260442
270340,201805,59,47,12,44838,11448,56286
270350,201805,93,47,46,44599.5,43884,88483.5
270360,201805,73,41,32,39114,30528,69642
270370,201805,52,40,12,38160,11448,49608
270375,201805,69,39,30,37206,28620,65826
270380,201805,1081,612,469,582894,447426,1030320
270390,201805,197,109,88,103986,83952,187938
270400,201805,704,512,192,487233.27,183159,670392.27
270410,201805,699,501,198,477636.04,188882.46,666518.50
270420,201805,400,261,139,247296,132521.38,379817.38
270430,201805,32447,23178,9269,22053178.22,8835315.03,30888493.25
270440,201805,491,385,106,366479.1,100837.8,467316.9
270450,201805,775,404,371,385177.5,352980.66,738158.16
270460,201805,198,152,46,145008,43884,188892
270470,201805,1375,914,461,871602.69,439794,1311396.69
270480,201805,533,429,104,406114.7,98500.5,504615.2
270490,201805,24,20,4,19080,3816,22896
270500,201805,515,423,92,403542,87768,491310
270510,201805,738,453,285,432162,271890,704052
270520,201805,373,229,144,218257,137376,355633
270530,201805,65,57,8,54378,7632,62010
270540,201805,123,95,28,90630,26712,117342
270550,201805,1727,1297,430,1237015.18,409738.23,1646753.41
270560,201805,312,145,167,138330,159318,297648
270570,201805,456,303,153,286851.36,145962,432813.36
270580,201805,78,58,20,55332,19080,74412
270590,201805,74,61,13,58194,12402,70596
270600,201805,180,148,32,141192,30528,171720
270610,201805,186,150,36,143091,34344,177435
270620,201805,30,29,1,27666,954,28620
270630,201805,3868,2936,932,2787844.53,886972.96,3674817.49
270640,201805,901,662,239,629844.6,227691.8,857536.4
270642,201805,211,178,33,169812,31482,201294
270644,201805,273,187,86,178207.74,82039.23,260246.97
270650,201805,250,146,104,139284,99216,238500
270660,201805,258,208,50,198432,47700,246132
270670,201805,3180,2418,762,2296640.03,724025.68,3020665.71
270680,201805,468,273,195,260433,186026,446459
270690,201805,1119,703,416,668929.76,396854.46,1065784.22
270700,201805,37,27,10,25758,9540,35298
270710,201805,883,665,218,632791.34,207972,840763.34
270720,201805,250,188,62,179352,58861.8,238213.8
270730,201805,1905,1097,808,1044297.4,768726.2,1813023.6
270740,201805,45,28,17,26712,16218,42930
270750,201805,635,465,170,443420,161513,604933
270760,201805,308,222,86,211788,82044,293832
270770,201805,2751,1752,999,1664134.28,952092,2616226.28
270780,201805,92,57,35,54373.23,33372.46,87745.69
270790,201805,268,180,88,171720,83952,255672
270800,201805,1961,1568,393,1494079.25,374177.88,1868257.13
270810,201805,307,241,66,229899.69,62955.23,292854.92
270820,201805,158,102,56,97308,53329,150637
270830,201805,924,669,255,637459,242984,880443
270840,201805,1409,1035,374,986650.9,355128,1341778.9
270850,201805,1662,1015,647,962148.36,617219.46,1579367.82
270860,201805,2449,1595,854,1518527.52,811818.57,2330346.09
270870,201805,120,65,55,62010,52470,114480
270880,201805,918,679,239,645930.14,227112.58,873042.72
270890,201805,352,256,96,243775.62,91579.23,335354.85
270895,201805,72,62,10,59148,9540,68688
270900,201805,104,80,24,76320,22896,99216
270910,201805,322,257,65,244033.2,62010,306043.2
270915,201805,1837,1103,734,1047364.1,699517.1,1746881.2
270920,201805,480,403,77,384462,73458,457920
270930,201805,6192,4487,1705,4275075.54,1623789.24,5898864.78
270940,201805,2383,1808,575,1722862.88,547578,2270440.88
280010,201805,43,38,5,36252,4770,41022
280020,201805,703,607,96,577139.03,90630,667769.03
280030,201805,19443,12435,7008,11780051.54,6657135.1,18437186.64
280040,201805,338,212,126,202248,118773,321021
280050,201805,377,290,87,276373.8,82998,359371.8
280060,201805,328,219,109,206679.43,103986,310665.43
280067,201805,990,695,295,660271.94,280476.25,940748.19
280070,201805,130,109,21,103986,20034,124020
280100,201805,617,486,131,460899.67,124784,585683.67
280110,201805,74,69,5,65826,4770,70596
280120,201805,631,506,125,482724,119250,601974
280130,201805,1361,852,509,811377.8,485442.9,1296820.7
280140,201805,468,380,88,361661.4,82998,444659.4
280150,201805,325,241,84,228470.89,80136,308606.89
280160,201805,97,83,14,79182,13356,92538
280170,201805,598,396,202,376587.56,192708,569295.56
280190,201805,27,25,2,23850,1908,25758
280200,201805,23,15,8,14310,7632,21942
280210,201805,2762,1945,817,1838064.91,773840.97,2611905.88
280220,201805,41,31,10,29574,9540,39114
280230,201805,318,262,56,249113.63,53424,302537.63
280240,201805,112,106,6,100980.9,5724,106704.9
280250,201805,18,11,7,10494,6678,17172
280260,201805,81,70,11,66780,10494,77274
280270,201805,160,123,37,117342,35298,152640
280280,201805,194,124,70,118296,66780,185076
280290,201805,3083,2225,858,2110875.74,816935.05,2927810.79
280300,201805,1095,828,267,788247.27,253954.8,1042202.07
280310,201805,107,102,5,96977.29,4770,101747.29
280320,201805,650,444,206,423567,196524,620091
280330,201805,357,255,102,243270,97183.98,340453.98
280340,201805,419,336,83,319072.57,78419,397491.57
280350,201805,3447,2652,795,2520041.33,755691.09,3275732.42
280360,201805,462,292,170,278568,161226,439794
280370,201805,99,88,11,83952,10494,94446
280380,201805,56,42,14,40068,13356,53424
280390,201805,186,155,31,147870,29574,177444
280400,201805,342,232,110,220469.8,104940,325409.8
280410,201805,289,234,55,222283,52470,274753
280420,201805,171,143,28,136422,26712,163134
280430,201805,110,81,29,77274,27557.63,104831.63
280440,201805,685,531,154,502664.6,146715.66,649380.26
280445,201805,116,108,8,103032,7632,110664
280450,201805,1096,932,164,885733.46,156456,1042189.46
280460,201805,755,553,202,520701.44,192708,713409.44
280470,201805,190,173,17,165042,15265,180307
280480,201805,2262,1598,664,1509825.21,629591.89,2139417.10
280490,201805,351,323,28,306750,26712,333462
280500,201805,45,40,5,38160,4770,42930
280510,201805,143,111,32,105593.2,30242,135835.2
280520,201805,52,38,14,36252,13356,49608
280530,201805,77,54,23,51516,21942,73458
280540,201805,503,402,101,383086.54,96067.8,479154.34
280550,201805,706,652,54,621396,51516,672912
280560,201805,481,419,62,397007.1,59148,456155.1
280570,201805,1782,1355,427,1288464.47,406502.83,1694967.30
280580,201805,594,455,139,432689.6,132511,565200.6
280590,201805,164,101,63,96074.48,60102,156176.48
280600,201805,356,299,57,285246,54378,339624
280610,201805,141,106,35,100918,33390,134308
280620,201805,546,446,100,424530.5,94446.9,518977.4
280630,201805,164,136,28,129744,26712,156456
280640,201805,209,168,41,159443,39114,198557
280650,201805,78,53,25,50562,23850,74412
280660,201805,132,95,37,90630,35059.5,125689.5
280670,201805,1635,1023,612,968031.35,580103.95,1548135.30
280680,201805,185,158,27,148948.14,25758,174706.14
280690,201805,54,45,9,42930,8586,51516
280700,201805,19,19,0,18126,0,18126
280710,201805,1411,1069,342,1013895.39,325600.2,1339495.59
280720,201805,110,74,36,68036.4,34344,102380.4
280730,201805,26,22,4,20988,3816,24804
280740,201805,2410,1781,629,1693348.49,598960.46,2292308.95
280750,201805,293,255,38,243270,36252,279522
280760,201805,885,608,277,578887.2,264258,843145.2
290010,201805,202,135,67,128790,63918,192708
290020,201805,178,165,13,157410,12402,169812
290030,201805,596,388,208,369484.2,198432,567916.2
290035,201805,140,114,26,105551.7,24804,130355.7
290040,201805,274,171,103,163134,98262,261396
290050,201805,81,60,21,57240,20034,77274
290060,201805,254,113,141,107515.8,134514,242029.8
290070,201805,5636,2774,2862,2638957.67,2726954.48,5365912.15
290080,201805,500,225,275,214344.72,262331,476675.72
290090,201805,389,169,220,161226,209880,371106
290100,201805,1593,1052,541,999413.1,515541.8,1514954.9
290110,201805,764,455,309,432444.2,294257.3,726701.5
290115,201805,211,194,17,184122,16218,200340
290120,201805,776,503,273,479194.2,260442,739636.2
290130,201805,412,245,167,233434.26,159318,392752.26
290135,201805,296,224,72,213018.66,68688,281706.66
290140,201805,303,251,52,239454,49417.2,288871.2
290150,201805,130,96,34,91584,32436,124020
290160,201805,247,190,57,180020.58,54378,234398.58
290170,201805,89,64,25,61056,23850,84906
290180,201805,155,121,34,115434,32436,147870
290190,201805,448,364,84,346970,79849.8,426819.8
290195,201805,311,184,127,175536,121158,296694
290200,201805,281,236,45,225144,42930,268074
290205,201805,140,87,53,82998,50562,133560
290210,201805,1134,825,309,785906.2,294786,1080692.2
290220,201805,223,124,99,117819,94446,212265
290225,201805,288,110,178,104940,169812,274752
290230,201805,65,43,22,41022,20988,62010
290240,201805,309,123,186,117055.8,177444,294499.8
290250,201805,273,245,28,233034,26712,259746
290260,201805,286,232,54,220279,51516,271795
290265,201805,181,151,30,143237,28620,171857
290270,201805,1397,1156,241,1100964.2,229051,1330015.2
290280,201805,467,344,123,328176,117342,445518
290290,201805,1235,718,517,679169.89,493218,1172387.89
290300,201805,448,380,68,362229.23,64872,427101.23
290310,201805,317,141,176,134514,167904,302418
290320,201805,3964,2462,1502,2345040.86,1430047,3775087.86
290323,201805,186,160,26,152354,24804,177158
290327,201805,153,121,32,115162.11,30528,145690.11
290330,201805,74,40,34,38160,32436,70596
290340,201805,913,363,550,345329,524414,869743
290350,201805,593,352,241,335808,229914,565722
290360,201805,368,276,92,261397.69,87768,349165.69
290370,201805,911,364,547,347256,521824,869080
290380,201805,310,190,120,181260,114480,295740
290390,201805,2502,1564,938,1489083.58,892648.46,2381732.04
290395,201805,243,135,108,128265.8,103032,231297.8
290400,201805,281,208,73,198146,69642,267788
290405,201805,253,221,32,210834,30528,241362
290410,201805,568,484,84,458731.64,80136,538867.64
290420,201805,239,187,52,178398,49608,228006
290430,201805,495,311,184,296694,175536,472230
290440,201805,72,64,8,61056,7632,68688
290450,201805,232,178,54,169812,51516,221328
290460,201805,1877,1120,757,1066611.8,721415.32,1788027.12
290470,201805,1435,602,833,573179.22,794367.36,1367546.58
290475,201805,588,548,40,521639,38160,559799
290480,201805,289,161,128,152671.8,122112,274783.8
290485,201805,231,214,17,204156,16218,220374
290490,201805,1178,852,326,812044.8,310050.2,1122095.0
290500,201805,677,341,336,324360,320544,644904
290510,201805,222,170,52,161226,49608,210834
290515,201805,137,81,56,77274,53424,130698
290520,201805,1409,916,493,872242.62,466794.42,1339037.04
290530,201805,313,286,27,272844,25758,298602
290540,201805,96,58,38,55332,36252,91584
290550,201805,153,129,24,123066,22829.22,145895.22
290560,201805,3367,1366,2001,1301866.76,1908759.59,3210626.35
290570,201805,5969,3038,2931,2893640.81,2793358.95,5686999.76
290580,201805,1275,750,525,714259.8,500134.5,1214394.3
290590,201805,533,439,94,418015,89676,507691
290600,201805,1717,1189,528,1129605.05,503712,1633317.05
290610,201805,217,195,22,185747,20988,206735
290620,201805,324,287,37,273798,35298,309096
290630,201805,2076,887,1189,843050.69,1129905.3,1972955.99
290640,201805,151,123,28,117342,26712,144054
290650,201805,1704,801,903,763191,861462,1624653
290660,201805,278,227,51,216558,48654,265212
290670,201805,999,519,480,494554,457574.38,952128.38
290680,201805,1188,955,233,909829.8,221328,1131157.8
290682,201805,293,214,79,203169.3,75347.46,278516.76
290685,201805,233,150,83,142146,79182,221328
290687,201805,936,615,321,584194.1,305280,889474.1
290689,201805,130,75,55,71536,52455.69,123991.69
290690,201805,649,265,384,252781.92,365456.8,618238.72
290700,201805,238,112,126,106848,120204,227052
290710,201805,704,474,230,452196,219420,671616
290720,201805,1025,830,195,791820,185553,977373
290730,201805,1128,647,481,615378.5,457920,1073298.5
290740,201805,15,12,3,11448,2862,14310
290750,201805,1372,625,747,594337.23,710526.1,1304863.33
290755,201805,72,64,8,61056,7632,68688
290760,201805,302,260,42,248040,40068,288108
290770,201805,187,176,11,167894.46,10494,178388.46
290780,201805,984,786,198,747900.66,187079.4,934980.06
290790,201805,371,258,113,246132,107802,353934
290800,201805,2632,1056,1576,1004491.04,1502397.36,2506888.40
290810,201805,436,304,132,289730,125928,415658
290820,201805,380,233,147,221314,140238,361552
290830,201805,403,277,126,264258,120204,384462
290840,201805,1703,1047,656,996692.8,623744.48,1620437.28
290850,201805,769,425,344,405259.2,327222,732481.2
290860,201805,643,285,358,271890,341246,613136
290870,201805,668,478,190,454791.8,181260,636051.8
290880,201805,124,66,58,62964,55332,118296
290890,201805,333,236,97,225144,92538,317682
290900,201805,171,129,42,123066,40068,163134
290910,201805,366,276,90,263304,85860,349164
290920,201805,230,196,34,186984,32436,219420
290930,201805,823,625,198,596250,188873,785123
290940,201805,249,205,44,194806.8,41976,236782.8
290950,201805,171,98,73,93492,69642,163134
290960,201805,447,300,147,284960.24,139951.8,424912.04
290970,201805,251,219,32,208735.2,30385,239120.2
290980,201805,1503,1066,437,1012814.84,415849.2,1428664.04
290990,201805,371,312,59,297619.92,56230.38,353850.30
291000,201805,867,243,624,231822,594752.43,826574.43
291005,201805,2127,903,1224,859267.76,1166919.03,2026186.79
291010,201805,156,140,16,133560,15264,148824
291020,201805,101,80,21,76320,20034,96354
291030,201805,93,68,25,64872,23850,88722
291040,201805,571,286,285,272844,271890,544734
291050,201805,1346,754,592,717817.58,564562.99,1282380.57
291060,201805,1491,822,669,783520.2,638226,1421746.2
291070,201805,1891,1397,494,1327360.53,470015.5,1797376.03
291072,201805,7351,2704,4647,2576267.58,4431054.42,7007322.00
291075,201805,206,168,38,160272,36252,196524
291077,201805,51,35,16,33390,15264,48654
291080,201805,19783,8685,11098,8262896.84,10575057.64,18837954.48
291085,201805,292,233,59,222282,56281.23,278563.23
291090,201805,306,118,188,112286,179342.46,291628.46
291100,201805,665,191,474,182214,452196,634410
291110,201805,403,302,101,288088.92,96354,384442.92
291120,201805,2514,1194,1320,1138933,1257311.46,2396244.46
291125,201805,59,30,29,28620,27666,56286
291130,201805,214,188,26,179352,24804,204156
291140,201805,133,99,34,94160,32150,126310
291150,201805,372,149,223,142146,212742,354888
291160,201805,366,304,62,289062.5,59148,348210.5
291165,201805,25,21,4,20034,3816,23850
291170,201805,2943,1473,1470,1401474.11,1399327.6,2800801.71
291180,201805,1324,513,811,489205.38,773560.68,1262766.06
291185,201805,75,73,2,69642,1908,71550
291190,201805,1257,542,715,514296.17,681566.8,1195862.97
291200,201805,167,122,45,116388,42930,159318
291210,201805,2207,862,1345,819209.34,1281318.14,2100527.48
291220,201805,272,203,69,192708.64,65826,258534.64
291230,201805,1022,349,673,332088,642042,974130
291240,201805,441,418,23,397532,21942,419474
291250,201805,432,353,79,336762,75366,412128
291260,201805,46,35,11,33390,10494,43884
291270,201805,1209,494,715,471276,681823.8,1153099.8
291280,201805,374,170,204,161974.89,194320.26,356295.15
291290,201805,1766,896,870,853067.2,828932,1681999.2
291300,201805,222,174,48,165328.2,45792,211120.2
291310,201805,228,204,24,194329.8,22896,217225.8
291320,201805,1399,998,401,949230,381505.29,1330735.29
291330,201805,126,109,17,102173.4,16218,118391.4
291340,201805,148,84,64,80136,61056,141192
291345,201805,135,88,47,83952,44838,128790
291350,201805,1592,525,1067,500659.2,1017727.3,1518386.5
291360,201805,8645,4271,4374,4062760.8,4169988.55,8232749.35
291370,201805,1104,612,492,583562,469368,1052930
291380,201805,255,200,55,190800,52183.8,242983.8
291390,201805,3899,1702,2197,1618608.23,2094126,3712734.23
291400,201805,2089,1494,595,1420125.39,565947.51,1986072.90
291410,201805,154,133,21,125928,20034,145962
291420,201805,112,81,31,77274,29574,106848
291430,201805,168,95,73,89923,68688.53,158611.53
291440,201805,497,396,101,375060.3,96354,471414.3
291450,201805,898,567,331,539678.8,314820,854498.8
291460,201805,1728,1401,327,1334789.1,311958,1646747.1
291465,201805,2211,1024,1187,976293.41,1132116.14,2108409.55
291470,201805,2783,1410,1373,1341354.47,1309112,2650466.47
291480,201805,11841,5221,6620,4969304.89,6306295.19,11275600.08
291490,201805,554,232,322,221328,307188,528516
291500,201805,372,203,169,193662,161226,354888
291510,201805,1239,472,767,449126.99,731431.8,1180558.79
291520,201805,959,438,521,417852,497024.46,914876.46
291530,201805,1007,267,740,254718,705654.72,960372.72
291535,201805,113,95,18,90630,17172,107802
291540,201805,363,105,258,100170,245178.6,345348.6
291550,201805,1193,561,632,533288.1,602624,1135912.1
291560,201805,5528,2811,2717,2668832.59,2579737.88,5248570.47
291570,201805,206,105,101,100170,96354,196524
291580,201805,1217,740,477,704697.46,455044.23,1159741.69
291590,201805,84,32,52,30384.9,49608,79992.9
291600,201805,1363,627,736,597204,701840,1299044
291610,201805,1442,669,773,636942.87,737386,1374328.87
291620,201805,587,272,315,259488,300128.4,559616.4
291630,201805,496,164,332,156456,316728,473184
291640,201805,3918,1980,1938,1878769.07,1847503.52,3726272.59
291650,201805,419,281,138,266940,130852.73,397792.73
291660,201805,439,174,265,165303.96,251712.9,417016.86
291670,201805,223,142,81,134896,77274,212170
291680,201805,692,393,299,374922,285141.46,660063.46
291685,201805,588,317,271,302180,258343.2,560523.2
291690,201805,569,293,276,279522,262341,541863
291700,201805,922,726,196,691874.19,186030,877904.19
291710,201805,1705,794,911,756780.28,868217.06,1624997.34
291720,201805,400,264,136,251851.23,129744,381595.23
291730,201805,947,561,386,533524.7,368234.46,901759.16
291733,201805,261,181,80,172387.8,76320,248707.8
291735,201805,66,51,15,48654,14310,62964
291740,201805,343,261,82,248994,78228,327222
291750,201805,1952,1299,653,1232201.28,622140,1854341.28
291760,201805,3059,1669,1390,1586359,1323675,2910034
291770,201805,808,539,269,512107.26,256626,768733.26
291780,201805,47,29,18,27666,17172,44838
291790,201805,170,81,89,77274,84906,162180
291800,201805,10051,4024,6027,3826159.15,5745529.75,9571688.90
291810,201805,1139,821,318,782657.03,303372,1086029.03
291820,201805,265,191,74,182214,70596,252810
291830,201805,1084,413,671,392601,639171,1031772
291835,201805,601,553,48,527085,45792,572877
291840,201805,4674,2408,2266,2292440.17,2160916.02,4453356.19
291845,201805,299,102,197,97308,187909.38,285217.38
291850,201805,324,281,43,267835.5,41022,308857.5
291855,201805,270,108,162,103032,154548,257580
291860,201805,177,111,66,104940,62964,167904
291870,201805,84,34,50,32436,47700,80136
291875,201805,183,165,18,157410,17172,174582
291880,201805,490,386,104,367434,99216,466650
291890,201805,244,81,163,77264.46,154071.2,231335.66
291900,201805,56,32,24,30528,22896,53424
291905,201805,133,93,40,88436,38160,126596
291910,201805,177,144,33,137376,31482,168858
291915,201805,394,349,45,331278,42930,374208
291920,201805,4971,2582,2389,2460726.33,2277441.77,4738168.10
291930,201805,183,106,77,101124,73458,174582
291940,201805,321,177,144,168161.58,136422,304583.58
291950,201805,1147,930,217,886457,207018,1093475
291955,201805,1039,621,418,592434,398629,991063
291960,201805,179,126,53,120204,50275.8,170479.8
291970,201805,777,588,189,560952,180306,741258
291980,201805,1504,1332,172,1267315.7,163134.4,1430450.1
291990,201805,125,116,9,110664,8586,119250
291992,201805,164,83,81,78418.8,77274,155692.8
291995,201805,148,104,44,99216,41976,141192
292000,201805,386,294,92,278282.95,87768,366050.95
292010,201805,285,201,84,190800.8,79182,269982.8
292020,201805,277,202,75,192708,71550,264258
292030,201805,138,107,31,102078,29574,131652
292040,201805,630,319,311,304326,296694,601020
292045,201805,95,86,9,82044,8586,90630
292050,201805,892,621,271,591424.87,258248,849672.87
292060,201805,930,770,160,732673.28,152640,885313.28
292070,201805,50,21,29,20034,27666,47700
292080,201805,113,78,35,74412,33390,107802
292090,201805,503,177,326,168667.2,311004,479671.2
292100,201805,1410,604,806,574642.7,767656.52,1342299.22
292105,201805,204,172,32,164088,30528,194616
292110,201805,2110,781,1329,744749.64,1265850.45,2010600.09
292120,201805,644,517,127,492085.79,121158,613243.79
292130,201805,448,264,184,251856,175536,427392
292140,201805,197,154,43,146916,40890.26,187806.26
292145,201805,161,86,75,82044,71507.07,153551.07
292150,201805,1426,1141,285,1088514,270862.16,1359376.16
292160,201805,179,146,33,138997.8,31482,170479.8
292170,201805,1220,1069,151,1018133.31,143996.76,1162130.07
292180,201805,204,144,60,137376,57240,194616
292190,201805,159,96,63,91584,60102,151686
292200,201805,1278,463,815,440730.71,777015.56,1217746.27
292205,201805,118,105,13,99883.8,12402,112285.8
292210,201805,374,259,115,245703,108994.5,354697.5
292220,201805,22,16,6,15264,5724,20988
292225,201805,38,35,3,33390,2862,36252
292230,201805,923,750,173,712802.03,165042,877844.03
292240,201805,615,443,172,421525,164088,585613
292250,201805,1729,1107,622,1056078,593388,1649466
292260,201805,449,254,195,242316,185266.8,427582.8
292265,201805,267,188,79,179065.8,75366,254431.8
292270,201805,771,336,435,320544,414036.8,734580.8
292273,201805,202,111,91,105116.49,86814,191930.49
292275,201805,168,84,84,80136,79849.8,159985.8
292280,201805,141,100,41,95400,39114,134514
292285,201805,64,54,10,50848.2,9540,60388.2
292290,201805,562,376,186,356214.47,177158,533372.47
292300,201805,1633,619,1014,589953.8,966522.58,1556476.38
292303,201805,98,67,31,63918,29574,93492
292305,201805,111,79,32,75366,30528,105894
292310,201805,818,519,299,494764,283948.15,778712.15
292320,201805,661,497,164,473851.8,156456,630307.8
292330,201805,187,100,87,95400,82998,178398
292335,201805,278,215,63,205110,60102,265212
292340,201805,574,398,176,378952.85,167904,546856.85
292350,201805,270,145,125,137519.1,118963.8,256482.9
292360,201805,704,534,170,507719,162180,669899
292370,201805,773,591,182,563814,173628,737442
292380,201805,649,501,148,476046.62,141192,617238.62
292390,201805,500,188,312,179352,295883.5,475235.5
292400,201805,3373,2062,1311,1948599.47,1246527.8,3195127.27
292405,201805,263,175,88,166473,83665.8,250138.8
292410,201805,151,88,63,83952,60102,144054
292420,201805,307,262,45,249661.8,42930,292591.8
292430,201805,521,408,113,389232,107325,496557
292440,201805,582,496,86,471449.67,81757.8,553207.47
292450,201805,248,191,57,182214,54378,236592
292460,201805,588,436,152,415371.8,144912.6,560284.4
292465,201805,202,167,35,159318,32652.09,191970.09
292467,201805,103,60,43,57240,41022,98262
292470,201805,261,178,83,169812,79182,248994
292480,201805,330,220,110,208926.5,104654,313580.5
292490,201805,219,144,75,137376,71550,208926
292500,201805,1162,503,659,479651,628228.28,1107879.28
292510,201805,3341,1510,1831,1439300.12,1743903.6,3183203.72
292520,201805,1064,506,558,480859.7,532323,1013182.7
292525,201805,384,274,110,261391.23,104940,366331.23
292530,201805,4251,1741,2510,1657715.04,2393329.92,4051044.96
292540,201805,477,256,221,244224,210834,455058
292550,201805,1059,574,485,546873.82,462185.72,1009059.54
292560,201805,317,298,19,284292,18126,302418
292570,201805,301,230,71,219091,67734,286825
292575,201805,466,301,165,286868,157410,444278
292580,201805,918,580,338,551889,322166,874055
292590,201805,518,445,73,424227.59,69642,493869.59
292593,201805,142,112,30,106848,28620,135468
292595,201805,178,136,42,129744,40068,169812
292600,201805,1240,923,317,880225,301750.2,1181975.2
292610,201805,128,98,30,93492,28362.42,121854.42
292620,201805,528,437,91,416603,86814,503417
292630,201805,1382,796,586,757796,557413.14,1315209.14
292640,201805,774,541,233,515780.1,222282,738062.1
292650,201805,174,147,27,139952,25758,165710
292660,201805,1988,1431,557,1359350.85,527180.83,1886531.68
292665,201805,137,100,37,95400,35298,130698
292670,201805,399,321,78,306230,74412,380642
292680,201805,257,199,58,189846,54855,244701
292690,201805,186,143,43,136422,41022,177444
292700,201805,927,613,314,583848.8,299556,883404.8
292710,201805,99,87,12,82998,11448,94446
292720,201805,840,476,364,453302.64,347066,800368.64
292730,201805,199,94,105,88722.5,100170,188892.5
292740,201805,66835,33058,33777,31461877.97,32194282.26,63656160.23
292750,201805,374,267,107,253658.94,101267.57,354926.51
292760,201805,323,260,63,247029.5,60102,307131.5
292770,201805,791,331,460,315488,438840,754328
292780,201805,414,153,261,145448.28,248994,394442.28
292790,201805,739,360,379,343440,361327.5,704767.5
292800,201805,1158,709,449,675432,428346,1103778
292805,201805,429,124,305,117771.3,290970,408741.3
292810,201805,1477,855,622,814525.8,593092.46,1407618.26
292820,201805,748,603,145,573354.87,138034.8,711389.67
292830,201805,106,84,22,80136,20988,101124
292840,201805,661,543,118,517634,112557.69,630191.69
292850,201805,130,87,43,82994,41022,124016
292860,201805,2174,1266,908,1203692.94,866232,2069924.94
292870,201805,3414,2285,1129,2178627.8,1077056.46,3255684.26
292880,201805,1469,963,506,914935.86,481484,1396419.86
292890,201805,488,420,68,400652,64872,465524
292895,201805,132,87,45,81639.5,42930,124569.5
292900,201805,390,286,104,272844,99216,372060
292905,201805,449,232,217,221328,207018,428346
292910,201805,415,315,100,300177,95400,395577
292920,201805,547,243,304,231822,290016,521838
292925,201805,503,466,37,443886.66,35279,479165.66
292930,201805,574,356,218,339624,207972,547596
292935,201805,294,127,167,121158,159318,280476
292937,201805,236,161,75,153594,71550,225144
292940,201805,194,147,47,140238,44838,185076
292950,201805,1108,570,538,541634.5,512299,1053933.5
292960,201805,551,368,183,351072,174582,525654
292970,201805,273,191,82,181547,78228,259775
292975,201805,155,88,67,83952,63728,147680
292980,201805,253,171,82,162304.43,78228,240532.43
292990,201805,1318,975,343,922527.67,327034.93,1249562.60
293000,201805,103,75,28,71550,26712,98262
293010,201805,2675,1633,1042,1552407.12,990031.01,2542438.13
293015,201805,660,526,134,501586.49,127197,628783.49
293020,201805,334,274,60,261396,57240,318636
293030,201805,620,540,80,514588,76320,590908
293040,201805,341,268,73,255672,69642,325314
293050,201805,2725,1588,1137,1506397.79,1080568.38,2586966.17
293060,201805,253,203,50,192475,46746.8,239221.8
293070,201805,3396,1732,1664,1644717.68,1585997.82,3230715.50
293075,201805,91,59,32,56286,30528,86814
293076,201805,70,46,24,43884,22896,66780
293077,201805,438,267,171,250871.27,163134,414005.27
293080,201805,450,399,51,380646,48654,429300
293090,201805,128,111,17,105894,16218,122112
293100,201805,521,367,154,350118,146916,497034
293105,201805,343,236,107,224858,102078,326936
293110,201805,171,120,51,114480,48654,163134
293120,201805,317,214,103,204156,98071.2,302227.2
293130,201805,246,166,80,158364,76320,234684
293135,201805,7963,3135,4828,2983476.04,4597656.08,7581132.12
293140,201805,186,120,66,114480,62201,176681
293150,201805,326,278,48,263781.2,45792,309573.2
293160,201805,428,246,182,234684,173628,408312
293170,201805,190,132,58,125928,54474,180402
293180,201805,466,318,148,303086,141192,444278
293190,201805,1279,888,391,842502.73,373014,1215516.73
293200,201805,531,469,62,446346,59148,505494
293210,201805,354,264,90,251704,85144.5,336848.5
293220,201805,2667,1081,1586,1029340.41,1510897.97,2540238.38
293230,201805,1766,639,1127,608175.8,1075158,1683333.8
293240,201805,220,201,19,191754,18126,209880
293245,201805,111,93,18,88722,17172,105894
293250,201805,733,275,458,262102,436932,699034
293260,201805,310,260,50,247086.17,47700,294786.17
293270,201805,1184,564,620,536148.68,591480,1127628.68
293280,201805,240,135,105,128790,100170,228960
293290,201805,3076,2013,1063,1919448,1013803,2933251
293300,201805,712,507,205,481345.5,193089.6,674435.1
293305,201805,151,129,22,123066,20988,144054
293310,201805,136,102,34,97308,32436,129744
293315,201805,159,122,37,116388,35298,151686
293317,201805,98,69,29,65826,27666,93492
293320,201805,971,561,410,534240.5,391140,925380.5
293325,201805,189,64,125,61056,119211.84,180267.84
293330,201805,12935,6069,6866,5779620.04,6542150.99,12321771.03
293340,201805,252,182,70,173628,65826,239454
293345,201805,248,197,51,187938,48654,236592
293350,201805,639,346,293,330084,278043.3,608127.3
293360,201805,1579,1127,452,1074204,430921.8,1505125.8
310010,201805,152,78,74,74412,70310,144722
310020,201805,1055,577,478,548390.47,454104.12,1002494.59
310030,201805,324,262,62,248822.88,59148,307970.88
310040,201805,49,30,19,28620,18126,46746
310050,201805,186,124,62,117342,58862,176204
310060,201805,237,166,71,157887,67734,225621
310070,201805,16,8,8,7632,7632,15264
310080,201805,49,27,22,25758,20988,46746
310090,201805,967,512,455,482331.56,432925.6,915257.16
310100,201805,299,226,73,215604,69642,285246
310110,201805,730,390,340,370738.9,323043,693781.9
310120,201805,390,212,178,201580.2,169437.94,371018.14
310130,201805,33,21,12,20034,11448,31482
310140,201805,27,15,12,14310,11448,25758
310150,201805,1296,885,411,839379.4,391235.8,1230615.2
310160,201805,2106,1068,1038,1010765.53,987581.2,1998346.73
310163,201805,93,53,40,50562,38160,88722
310170,201805,2603,1094,1509,1042884.2,1437964.6,2480848.8
310180,201805,134,52,82,49608,77846.4,127454.4
310190,201805,486,327,159,311958,151113.6,463071.6
310200,201805,504,322,182,307188,173501,480689
310205,201805,59,46,13,43884,12402,56286
310210,201805,276,225,51,214650,48081.6,262731.6
310220,201805,58,33,25,31482,23850,55332
310230,201805,264,184,80,175345.2,76320,251665.2
310240,201805,104,90,14,85621.5,13356,98977.5
310250,201805,99,80,19,76320,18126,94446
310260,201805,797,425,372,402494.24,354153.42,756647.66
310270,201805,277,185,92,175937,87768,263705
310280,201805,364,273,91,259692.86,86814,346506.86
310285,201805,219,156,63,148515.86,60102,208617.86
310290,201805,259,150,109,143100,103986,247086
310300,201805,154,128,26,122112,24804,146916
310310,201805,8,5,3,4770,2862,7632
310320,201805,23,14,9,13356,8586,21942
310330,201805,31,23,8,21942,7632,29574
310340,201805,1716,1109,607,1049019.6,577552.5,1626572.1
310350,201805,2857,1552,1305,1476739.81,1244388.8,2721128.61
310360,201805,40,33,7,31482,6678,38160
310370,201805,127,105,22,100170,20702,120872
310375,201805,107,38,69,36252,65807,102059
310380,201805,53,31,22,28668,20988,49656
310390,201805,103,70,33,66780,31482,98262
310400,201805,2364,1536,828,1461434,789625.8,2251059.8
310410,201805,125,68,57,64872,54378,119250
310420,201805,666,354,312,335904.8,296685.06,632589.86
310430,201805,325,216,109,205825.5,103986,309811.5
310440,201805,69,41,28,39114,26712,65826
310445,201805,84,66,18,62964,17172,80136
310450,201805,861,539,322,514206,306901.8,821107.8
310460,201805,263,190,73,181260,69642,250902
310470,201805,505,323,182,308142,173628,481770
310480,201805,79,57,22,54378,20988,75366
310490,201805,505,240,265,228006.2,252810,480816.2
310500,201805,125,53,72,50562,68688,119250
310510,201805,610,398,212,378452.6,202229.46,580682.06
310520,201805,129,87,42,82998,40068,123066
310530,201805,85,39,46,37206,43597.8,80803.8
310540,201805,458,283,175,267598.6,166663.8,434262.4
310550,201805,89,59,30,56286,28620,84906
310560,201805,2954,2033,921,1928768.54,877055.13,2805823.67
310570,201805,119,81,38,77274,36252,113526
310590,201805,351,233,118,220899.8,112557.69,333457.49
310600,201805,159,90,69,84095.7,65826,149921.7
310610,201805,60,22,38,20988,36252,57240
310620,201805,46079,22098,23981,21000649.77,22835748.7,43836398.47
310630,201805,608,386,222,365525.6,210453.4,575979.0
310640,201805,140,116,24,110282,22896,133178
310650,201805,164,144,20,136136,19080,155216
310660,201805,91,57,34,54378,32436,86814
310665,201805,55,40,15,38160,14310,52470
310670,201805,6417,2937,3480,2794009.17,3315256.24,6109265.41
310680,201805,58,38,20,36252,19080,55332
310690,201805,610,445,165,419561.16,157410,576971.16
310700,201805,58,37,21,35298,19890.9,55188.9
310710,201805,1247,843,404,802424.45,384843.8,1187268.25
310720,201805,91,29,62,27666,59148,86814
310730,201805,1372,955,417,909830.5,397532,1307362.5
310740,201805,994,558,436,529184.4,415410.26,944594.66
310750,201805,248,146,102,138330.18,97308,235638.18
310760,201805,71,54,17,51516,15932,67448
310770,201805,92,45,47,42930,44838,87768
310780,201805,402,329,73,313284.6,69642,382926.6
310790,201805,101,81,20,77274,19080,96354
310800,201805,456,221,235,210357,223903.8,434260.8
310810,201805,169,118,51,111513.2,47700,159213.2
310820,201805,354,281,73,268074,69355.8,337429.8
310825,201805,198,162,36,154548,34344,188892
310830,201805,465,223,242,212081.94,230725,442806.94
310840,201805,385,221,164,210834,156456,367290
310850,201805,110,88,22,83952,20988,104940
310855,201805,379,301,78,287154,74412,361566
310860,201805,1403,1049,354,996736.9,335980.9,1332717.8
310870,201805,55,43,12,41022,11448,52470
310880,201805,84,66,18,62677.8,17172,79849.8
310890,201805,312,184,128,175536,122112,297648
310900,201805,636,294,342,277838.27,325962.8,603801.07
310910,201805,247,168,79,158937.2,75366,234303.2
310920,201805,486,290,196,272845.2,186984,459829.2
310925,201805,40,33,7,31482,6392,37874
310930,201805,1098,664,434,633339.53,413941.07,1047280.60
310940,201805,685,347,338,330437.8,322452,652889.8
310945,201805,116,71,45,67734,42930,110664
310950,201805,253,201,52,191754,49608,241362
310960,201805,83,30,53,28620,50558,79178
310970,201805,167,103,64,98262,60133.76,158395.76
310980,201805,42,22,20,20988,19080,40068
310990,201805,151,85,66,80804,62964,143768
311000,201805,861,425,436,401921.69,415935,817856.69
311010,201805,39,32,7,30528,6678,37206
311020,201805,42,26,16,24804,15264,40068
311030,201805,386,231,155,218359,147775,366134
311040,201805,39,34,5,32436,4770,37206
311050,201805,466,194,272,184504,258915.6,443419.6
311060,201805,768,436,332,414513.4,316442,730955.4
311070,201805,331,152,179,145008,170766,315774
311080,201805,107,58,49,55332,46746,102078
311090,201805,396,186,210,176204,200340,376544
311100,201805,611,365,246,347923.8,234397.8,582321.6
311110,201805,679,472,207,450001.8,197469,647470.8
311115,201805,68,49,19,46746,18126,64872
311120,201805,1058,556,502,529134,477906.9,1007040.9
311130,201805,407,240,167,228769.2,159318,388087.2
311140,201805,165,84,81,80136,76463.1,156599.1
311150,201805,356,234,122,223236,116149.5,339385.5
311160,201805,747,538,209,510867.4,198909,709776.4
311170,201805,79,59,20,56286,18793.8,75079.8
311180,201805,349,234,115,222949.8,109424,332373.8
311190,201805,36,18,18,17172,17172,34344
311200,201805,341,238,103,225430.6,98262,323692.6
311205,201805,30,20,10,19080,9158.4,28238.4
311210,201805,49,41,8,38828,7632,46460
311220,201805,19,17,2,16218,1908,18126
311230,201805,1634,1064,570,1010976.94,543780,1554756.94
311240,201805,175,111,64,105690.33,61056,166746.33
311250,201805,82,29,53,27666,50562,78228
311260,201805,556,350,206,333900,196524,530424
311265,201805,117,82,35,78228,33390,111618
311270,201805,283,205,78,195570,74412,269982
311280,201805,214,97,117,92538,111045.6,203583.6
311290,201805,108,88,20,83952,18794,102746
311300,201805,552,349,203,332946,193376,526322
311310,201805,25,19,6,18126,5724,23850
311320,201805,674,502,172,477954,164088,642042
311330,201805,1036,761,275,725755.5,261396.4,987151.9
311340,201805,2647,1878,769,1783895.93,732263.86,2516159.79
311350,201805,273,208,65,198432,62010,260442
311360,201805,180,106,74,101124,70596,171720
311370,201805,1204,493,711,468328.5,677721.6,1146050.1
311380,201805,7,6,1,5724,954,6678
311390,201805,280,148,132,141192,125451.2,266643.2
311400,201805,148,99,49,94446,46746,141192
311410,201805,103,58,45,55046,42930,97976
311420,201805,304,171,133,160976.8,126882,287858.8
311430,201805,859,558,301,531379,286868,818247
311440,201805,491,342,149,326268,141859.8,468127.8
311450,201805,324,204,120,194616,114480,309096
311455,201805,304,206,98,196228.8,93205.8,289434.6
311460,201805,136,56,80,53424,75514.27,128938.27
311470,201805,23,13,10,12402,9540,21942
311480,201805,30,12,18,11448,17172,28620
311490,201805,16,10,6,9540,5724,15264
311500,201805,20,10,10,9540,9540,19080
311510,201805,626,437,189,414955.7,180019.8,594975.5
311520,201805,45,34,11,31768.2,10494,42262.2
311530,201805,1804,1350,454,1278457.12,433116,1711573.12
311535,201805,69,51,18,48654,17172,65826
311540,201805,35,30,5,28620,4770,33390
311545,201805,189,141,48,134514,45792,180306
311547,201805,32,23,9,21942,8586,30528
311550,201805,655,296,359,282384,342467.46,624851.46
311560,201805,43,28,15,26712,14310,41022
311570,201805,302,202,100,192135.6,95400,287535.6
311580,201805,314,185,129,176203.8,123066,299269.8
311590,201805,33,29,4,27666,3816,31482
311600,201805,91,72,19,68688,18126,86814
311610,201805,260,227,33,215604.5,31482,247086.5
311615,201805,101,84,17,79496.82,16027.2,95524.02
311620,201805,20,11,9,10494,8586,19080
311630,201805,86,72,14,68688,13356,82044
311640,201805,125,66,59,62964,56286,119250
311650,201805,131,97,34,91822.5,32436,124258.5
311660,201805,410,197,213,187938,203202,391140
311670,201805,169,109,60,103741,57240,160981
311680,201805,223,160,63,151738.95,59338.8,211077.75
311690,201805,18,11,7,10494,6678,17172
311700,201805,200,141,59,134227.8,56286,190513.8
311710,201805,212,135,77,128790,73458,202248
311720,201805,38,27,11,25758,10494,36252
311730,201805,551,360,191,342868,182214,525082
311740,201805,40,29,11,27666,10494,38160
311750,201805,716,483,233,458874.8,222282,681156.8
311760,201805,65,36,29,34344,27666,62010
311770,201805,405,194,211,183168.62,201294,384462.62
311780,201805,170,95,75,90344,71233,161577
311783,201805,82,73,9,69642,8586,78228
311787,201805,34,14,20,13356,19080,32436
311790,201805,264,128,136,122112,129744,251856
311800,201805,640,430,210,406834.3,199672.2,606506.5
311810,201805,43,36,7,34344,6678,41022
311820,201805,107,90,17,85860,16218,102078
311830,201805,1917,1212,705,1150639.5,669192.1,1819831.6
311840,201805,1024,569,455,537962.9,432601.54,970564.44
311850,201805,9,5,4,4770,3816,8586
311860,201805,9483,4305,5178,4090284.61,4932118.97,9022403.58
311870,201805,151,84,67,80136,63918,144054
311880,201805,952,707,245,672942.8,233730,906672.8
311890,201805,219,111,108,105894,103032,208926
311900,201805,84,35,49,33390,46746,80136
311910,201805,1400,864,536,822062.6,509245.4,1331308.0
311920,201805,230,150,80,143100,76320,219420
311930,201805,916,525,391,500468.6,372776,873244.6
311940,201805,2498,1301,1197,1238817.7,1138694.4,2377512.1
311950,201805,38,27,11,25758,10494,36252
311960,201805,65,46,19,43884,18126,62010
311970,201805,26,17,9,13928.4,8586,22514.4
311980,201805,43,33,10,31482,9540,41022
311990,201805,57,40,17,38160,16218,54378
311995,201805,64,45,19,42930,18126,61056
312000,201805,35,25,10,23563.8,9540,33103.8
312010,201805,82,60,22,57240,20988,78228
312015,201805,99,75,24,71264,22896,94160
312020,201805,140,87,53,82998,50535.42,133533.42
312030,201805,43,34,9,31769,8586,40355
312040,201805,83,53,30,50562,28620,79182
312050,201805,220,116,104,110664,99216,209880
312060,201805,69,42,27,40068,25090.2,65158.2
312070,201805,74,46,28,43884,26712,70596
312080,201805,530,241,289,229914,275706,505620
312083,201805,49,36,13,34344,12402,46746
312087,201805,113,91,22,86814,20988,107802
312090,201805,2901,1650,1251,1561130.7,1190072.27,2751202.97
312100,201805,159,113,46,107802,43102,150904
312110,201805,120,73,47,69642,44838,114480
312120,201805,142,106,36,99884,34344,134228
312125,201805,98,55,43,52279.2,41022,93301.2
312130,201805,123,82,41,78228,39114,117342
312140,201805,136,106,30,101124,28620,129744
312150,201805,45,35,10,33390,9540,42930
312160,201805,1529,1013,516,961919.2,490852.48,1452771.68
312170,201805,12,10,2,9540,1908,11448
312180,201805,98,60,38,56525,35966,92491
312190,201805,32,28,4,26712,3816,30528
312200,201805,734,634,100,602880.7,95400,698280.7
312210,201805,97,64,33,61056,31482,92538
312220,201805,124,92,32,87530,30528,118058
312230,201805,3528,1733,1795,1648924.48,1710526.58,3359451.06
312235,201805,156,103,53,98262,50562,148824
312240,201805,108,71,37,67734,35298,103032
312245,201805,167,113,54,107798,51516,159314
312247,201805,62,44,18,41213,17172,58385
312250,201805,181,83,98,79182,93492,172674
312260,201805,105,70,35,65921.4,33390,99311.4
312270,201805,136,85,51,81090,48654,129744
312280,201805,27,17,10,16218,9540,25758
312290,201805,163,112,51,106714.54,47701,154415.54
312300,201805,201,132,69,125928,65826,191754
312310,201805,59,54,5,51516,4770,56286
312320,201805,423,263,160,248994,151066.1,400060.1
312330,201805,89,78,11,73649,10207.8,83856.8
312340,201805,35,16,19,15264,18126,33390
312350,201805,16,10,6,9540,5724,15264
312352,201805,98,66,32,62964,30528,93492
312360,201805,559,253,306,240408,291924,532332
312370,201805,304,179,125,170479.8,119250,289729.8
312380,201805,138,88,50,83952,47700,131652
312385,201805,174,141,33,134514,31482,165996
312390,201805,299,187,112,178398,106181,284579
312400,201805,381,290,91,276660,86338,362998
312410,201805,882,284,598,270459,569916,840375
312420,201805,612,488,124,464884.2,118296,583180.2
312430,201805,871,642,229,610180.05,217512.2,827692.25
312440,201805,47,35,12,33390,11448,44838
312450,201805,210,129,81,123066,77274,200340
312460,201805,59,29,30,27666,28620,56286
312470,201805,54,35,19,33390,18126,51516
312480,201805,205,126,79,120204,75366,195570
312490,201805,268,185,83,176490,79182,255672
312500,201805,32,18,14,17172,13356,30528
312510,201805,440,168,272,160272,258872.39,419144.39
312520,201805,42,15,27,14310,25758,40068
312530,201805,49,37,12,35298,11448,46746
312540,201805,103,90,13,85860,12402,98262
312550,201805,39,30,9,28620,8586,37206
312560,201805,211,156,55,148538,52183.8,200721.8
312570,201805,438,264,174,251188.2,165304.45,416492.65
312580,201805,82,43,39,41022,37206,78228
312590,201805,266,210,56,200340,53424,253764
312595,201805,140,125,15,119250,14310,133560
312600,201805,76,46,30,43455,28620,72075
312610,201805,1632,860,772,812745.98,734771.6,1547517.58
312620,201805,191,135,56,128790,53419.23,182209.23
312630,201805,64,54,10,51516,9540,61056
312640,201805,48,13,35,12402,33390,45792
312650,201805,151,124,27,118010,25472,143482
312660,201805,71,53,18,50276,17172,67448
312670,201805,865,569,296,541873,282170.3,824043.3
312675,201805,41,31,10,29574,9540,39114
312680,201805,85,57,28,53996.4,26712,80708.4
312690,201805,237,127,110,121148.46,104653.8,225802.26
312695,201805,32,24,8,22896,7632,30528
312700,201805,214,124,90,118296,85860,204156
312705,201805,77,63,14,60102,13356,73458
312707,201805,95,70,25,66360.24,23850,90210.24
312710,201805,1889,1007,882,958617.6,841217,1799834.6
312720,201805,66,33,33,31482,31482,62964
312730,201805,288,168,120,159318,114480,273798
312733,201805,52,44,8,41690,7632,49322
312735,201805,22,16,6,15264,5724,20988
312737,201805,67,36,31,34344,29574,63918
312738,201805,56,41,15,39114,14310,53424
312740,201805,75,50,25,47700,23850,71550
312750,201805,70,52,18,49608,17172,66780
312760,201805,270,198,72,188892,68688,257580
312770,201805,7637,3543,4094,3355123.88,3897251.23,7252375.11
312780,201805,432,332,100,316441.8,95400,411841.8
312790,201805,20,15,5,14310,4770,19080
312800,201805,1610,1130,480,1070599.28,456966.58,1527565.86
312810,201805,368,239,129,227719.8,123066,350785.8
312820,201805,193,146,47,139284,44838,184122
312825,201805,27,18,9,17172,8586,25758
312830,201805,282,167,115,158079,109071,267150
312840,201805,147,109,38,103986,36252,140238
312850,201805,26,23,3,21942,2862,24804
312860,201805,171,104,67,98930,63918,162848
312870,201805,987,517,470,490324.24,448380,938704.24
312880,201805,151,103,48,98118.9,45696.6,143815.5
312890,201805,166,114,52,108756,49608,158364
312900,201805,210,157,53,149110.2,50562,199672.2
312910,201805,192,98,94,92323.72,89676,181999.72
312920,201805,159,89,70,84906,66780,151686
312930,201805,341,247,94,235638,89676,325314
312940,201805,109,73,36,69642,34344,103986
312950,201805,699,463,236,440652.6,225144,665796.6
312960,201805,173,134,39,127836,37206,165042
312965,201805,52,48,4,45792,3816,49608
312970,201805,293,235,58,223236.2,55332,278568.2
312980,201805,2323,1227,1096,1166067.4,1045007.6,2211075.0
312990,201805,49,28,21,26712,20034,46746
313000,201805,40,25,15,23850,14310,38160
313005,201805,166,128,38,121873.5,35966,157839.5
313010,201805,939,381,558,362233.8,532323,894556.8
313020,201805,188,99,89,93969,84906,178875
313030,201805,208,135,73,126883,69642,196525
313040,201805,65,25,40,23850,38160,62010
313050,201805,297,206,91,195570.2,86814,282384.2
313055,201805,46,34,12,32436,11448,43884
313060,201805,127,88,39,83952,36919.8,120871.8
313065,201805,59,38,21,36252,20034,56286
313070,201805,150,80,70,76320,66780,143100
313080,201805,42,18,24,17172,22896,40068
313090,201805,706,488,218,464264.3,207972,672236.3
313100,201805,163,64,99,61056,94438,155494
313110,201805,127,75,52,71550,49608,121158
313115,201805,161,88,73,83751.66,69642,153393.66
313120,201805,754,413,341,393716,324074,717790
313130,201805,5292,2860,2432,2701797.22,2311467.86,5013265.08
313140,201805,160,82,78,78228,74412,152640
313150,201805,314,250,64,238500,60769.8,299269.8
313160,201805,200,145,55,138044,52470,190514
313170,201805,1364,959,405,901866.1,385979.4,1287845.5
313180,201805,330,198,132,188243.28,125928,314171.28
313190,201805,743,445,298,421477.4,283529,705006.4
313200,201805,24,23,1,21942,954,22896
313210,201805,1040,877,163,833655.16,155497.23,989152.39
313220,201805,238,162,76,153594,71788.5,225382.5
313230,201805,269,198,71,187939,67734,255673
313240,201805,1923,1024,899,974026.53,854683.83,1828710.36
313250,201805,1265,942,323,893042.6,306235.8,1199278.4
313260,201805,97,54,43,51516,41022,92538
313270,201805,962,563,399,533430.4,380646,914076.4
313280,201805,61,52,9,49131,8586,57717
313290,201805,226,183,43,174296,40068.8,214364.8
313300,201805,377,194,183,181929,174582,356511
313310,201805,230,120,110,114480,104940,219420
313320,201805,373,288,85,272797.1,81090,353887.1
313330,201805,1365,834,531,794205.2,505382.5,1299587.7
313340,201805,337,234,103,223236,98262,321498
313350,201805,522,353,169,334854.1,161226,496080.1
313360,201805,117,69,48,65826,45506,111332
313370,201805,190,70,120,66780,114480,181260
313375,201805,278,168,110,160272,104940,265212
313380,201805,1326,683,643,649693.08,613132,1262825.08
313390,201805,49,42,7,39114.8,6678,45792.8
313400,201805,424,279,145,266166,137758,403924
313410,201805,19,11,8,10494,7632,18126
313420,201805,4693,2445,2248,2322964.18,2138556.83,4461521.01
313430,201805,143,66,77,62964,73172,136136
313440,201805,1485,1011,474,961966.9,451052,1413018.9
313450,201805,63,27,36,25758,34057.8,59815.8
313460,201805,374,178,196,168372,186984,355356
313470,201805,537,245,292,233730,277900.2,511630.2
313480,201805,157,107,50,101125,47700,148825
313490,201805,514,251,263,238844.05,250855,489699.05
313500,201805,22,14,8,13356,7632,20988
313505,201805,976,758,218,722528.2,207685.8,930214.0
313507,201805,96,57,39,54378,37206,91584
313510,201805,2785,1775,1010,1688587.56,962586,2651173.56
313520,201805,3616,2820,796,2677536.67,759380,3436916.67
313530,201805,44,29,15,27666,14310,41976
313535,201805,107,85,22,80423,20988,101411
313540,201805,72,55,17,52470,16218,68688
313545,201805,116,96,20,91584,19080,110664
313550,201805,231,190,41,181260,38828,220088
313560,201805,331,172,159,164088,151686,315774
313570,201805,61,32,29,30528,27666,58194
313580,201805,1312,718,594,683541,564959.4,1248500.4
313590,201805,83,51,32,48654,30528,79182
313600,201805,695,413,282,393716,268170,661886
313610,201805,61,49,12,46126.8,11448,57574.8
313620,201805,1368,723,645,678546.58,611447,1289993.58
313630,201805,1643,1253,390,1191928.4,371774,1563702.4
313640,201805,129,75,54,71550,51516,123066
313650,201805,237,109,128,103986,121540,225526
313652,201805,17,17,0,16218,0,16218
313655,201805,54,31,23,29574,21942,51516
313657,201805,48,45,3,42930,2862,45792
313660,201805,134,92,42,87768,40068,127836
313665,201805,644,314,330,299270,314581.5,613851.5
313670,201805,10370,7153,3217,6799128.73,3067206.6,9866335.33
313680,201805,42,31,11,29574,10390,39964
313690,201805,156,118,38,112572,36252,148824
313695,201805,73,54,19,51516,18126,69642
313700,201805,300,241,59,229628,56286,285914
313710,201805,151,101,50,96354,47700,144054
313720,201805,1091,520,571,493599.8,543389.86,1036989.66
313730,201805,60,41,19,39114,18126,57240
313740,201805,162,130,32,124020,30528,154548
313750,201805,442,323,119,307866.54,113526,421392.54
313753,201805,241,172,69,163420.2,65826,229246.2
313760,201805,1258,455,803,434070,763325.52,1197395.52
313770,201805,355,256,99,243032.2,94446,337478.2
313780,201805,759,393,366,374922,348877.8,723799.8
313790,201805,27,26,1,24804,954,25758
313800,201805,148,90,58,85860,55332,141192
313810,201805,69,41,28,39114,26712,65826
313820,201805,1289,638,651,607698.2,619791,1227489.2
313830,201805,67,49,18,46746,17172,63918
313835,201805,55,47,8,44838,7632,52470
313840,201805,1701,1047,654,993497.52,622390,1615887.52
313850,201805,183,63,120,60102,113900.06,174002.06
313860,201805,485,377,108,356177.3,103032,459209.3
313862,201805,173,115,58,109710,55332,165042
313865,201805,89,71,18,67734,17172,84906
313867,201805,50,39,11,37206,10494,47700
313868,201805,26,17,9,15455,8586,24041
313870,201805,129,67,62,63918,58862,122780
313880,201805,356,225,131,214650,124401.8,339051.8
313890,201805,323,171,152,162371.8,144435.6,306807.4
313900,201805,907,497,410,473184.5,391093,864277.5
313910,201805,138,99,39,94446,36252.2,130698.2
313920,201805,615,438,177,417661.2,168338,585999.2
313925,201805,32,28,4,26712,3816,30528
313930,201805,810,628,182,598674,173605,772279
313940,201805,1808,1138,670,1081168.4,638512.4,1719680.8
313950,201805,943,600,343,570588.6,326935.8,897524.4
313960,201805,1394,803,591,761798.3,562574,1324372.3
313970,201805,118,81,37,77274,35298,112572
313980,201805,211,137,74,130460,70596,201056
313990,201805,372,223,149,212742,142066.81,354808.81
314000,201805,931,630,301,597539.9,287149.23,884689.13
314010,201805,77,50,27,47700,25758,73458
314015,201805,53,18,35,17172,33390,50562
314020,201805,50,34,16,32436,15264,47700
314030,201805,86,39,47,37043.82,44838,81881.82
314040,201805,43,30,13,28620,12402,41022
314050,201805,319,188,131,179066,124163.1,303229.1
314053,201805,100,67,33,62964.4,31482,94446.4
314055,201805,304,179,125,170766,119250,290016
314060,201805,146,124,22,117342,20988,138330
314070,201805,1016,509,507,481781.14,483058,964839.14
314080,201805,219,143,76,135181.8,71454.88,206636.68
314085,201805,135,88,47,83952,44838,128790
314090,201805,356,257,99,245178,94441.23,339619.23
314100,201805,478,392,86,370153,81472,451625
314110,201805,698,376,322,357091.74,306472.6,663564.34
314120,201805,96,54,42,51516,40068,91584
314130,201805,25,12,13,11448,12402,23850
314140,201805,1097,665,432,630765.92,409552.86,1040318.78
314150,201805,163,104,59,99216,56286,155502
314160,201805,352,261,91,246132.8,86624,332756.8
314170,201805,74,56,18,53424,17172,70596
314180,201805,733,644,89,614090,83952.5,698042.5
314190,201805,103,61,42,58194,40068,98262
314200,201805,588,407,181,387007.6,171720,558727.6
314210,201805,284,213,71,202248,67448,269696
314220,201805,312,236,76,223237,72218,295455
314225,201805,64,45,19,42930,18126,61056
314230,201805,105,47,58,44838,55332,100170
314240,201805,139,106,33,101124,31482,132606
314250,201805,60,36,24,34344,22896,57240
314260,201805,190,96,94,91584,89676,181260
314270,201805,331,262,69,249185,65540,314725
314280,201805,691,385,306,367281,291924,659205
314290,201805,558,455,103,432830.5,97975.8,530806.3
314300,201805,412,293,119,276586,113479,390065
314310,201805,1454,979,475,932059.32,453129.97,1385189.29
314315,201805,36,29,7,27666,6678,34344
314320,201805,608,390,218,371487.8,207332.82,578820.62
314330,201805,10688,5374,5314,5115905.84,5065090.75,10180996.59
314340,201805,576,266,310,253191.8,295168,548359.8
314345,201805,32,25,7,23850,6678,30528
314350,201805,190,119,71,113526,67734,181260
314360,201805,76,47,29,44838,27666,72504
314370,201805,57,47,10,44838,9540,54378
314380,201805,92,66,26,62964,24804,87768
314390,201805,3248,2055,1193,1954937.3,1135165.4,3090102.7
314400,201805,686,492,194,466498.2,185076,651574.2
314410,201805,436,285,151,271890,144054,415944
314420,201805,19,9,10,8586,9540,18126
314430,201805,2519,896,1623,851036.3,1545639.67,2396675.97
314435,201805,272,157,115,149491.8,108756,258247.8
314437,201805,28,22,6,20988,5724,26712
314440,201805,100,72,28,68688,26712,95400
314450,201805,156,115,41,109710,39114,148824
314460,201805,655,302,353,288108,336762,624870
314465,201805,84,56,28,53424,26712,80136
314467,201805,67,56,11,53415,10494,63909
314470,201805,390,202,188,189256.52,178398.5,367655.02
314480,201805,1084,518,566,494172,539773.2,1033945.2
314490,201805,88,66,22,62964,20988,83952
314500,201805,313,208,105,198432,100170,298602
314505,201805,126,82,44,78228,41976,120204
314510,201805,227,184,43,175536,41022,216558
314520,201805,1263,655,608,617338.7,578362.9,1195701.6
314530,201805,735,579,156,550640.77,148824,699464.77
314535,201805,212,134,78,126786.6,74161.01,200947.61
314537,201805,63,38,25,36252,23850,60102
314540,201805,14,9,5,8586,4770,13356
314545,201805,50,32,18,30528,17172,47700
314550,201805,81,44,37,41976,35298,77274
314560,201805,813,437,376,414417.8,358704,773121.8
314570,201805,22,17,5,16218,4770,20988
314580,201805,17,8,9,7632,8586,16218
314585,201805,19,14,5,13356,4770,18126
314587,201805,85,73,12,69642,11448,81090
314590,201805,562,411,151,392094,144054,536148
314600,201805,987,644,343,609981.06,325886.6,935867.66
314610,201805,945,515,430,488448.7,409743,898191.7
314620,201805,155,115,40,108183.6,38160,146343.6
314625,201805,97,71,26,67162,24804,91966
314630,201805,1240,636,604,605265.3,575643.8,1180909.1
314640,201805,91,60,31,57240,29287.8,86527.8
314650,201805,200,116,84,110377.8,79659,190036.8
314655,201805,67,52,15,49608,14310,63918
314660,201805,20,15,5,14310,4770,19080
314670,201805,193,153,40,145676,38160,183836
314675,201805,217,126,91,120204,86814,207018
314690,201805,535,297,238,283051.8,227052,510103.8
314700,201805,2440,1337,1103,1270205.3,1051074.9,2321280.2
314710,201805,1629,953,676,903584.9,644284.1,1547869.0
314720,201805,411,245,166,232327.62,158364,390691.62
314730,201805,515,273,242,259012,230859,489871
314740,201805,690,341,349,323930.7,332946,656876.7
314750,201805,21,18,3,17172,2862,20034
314760,201805,324,154,170,146916,162170.46,309086.46
314770,201805,122,83,39,79182,37206,116388
314780,201805,21,6,15,5724,14310,20034
314790,201805,2359,1471,888,1396935.3,846474.66,2243409.96
314795,201805,53,45,8,42692,7632,50324
314800,201805,2940,1725,1215,1640364.66,1156811.4,2797176.06
314810,201805,1514,843,671,801885.5,638513,1440398.5
314820,201805,90,50,40,47700,38160,85860
314830,201805,208,165,43,156694.5,40736,197430.5
314840,201805,81,47,34,44838,32436,77274
314850,201805,353,172,181,164088,172674,336762
314860,201805,704,528,176,502472.06,165853.7,668325.76
314870,201805,1476,762,714,725994,681156,1407150
314875,201805,56,48,8,45792,7632,53424
314880,201805,46,33,13,31482,12402,43884
314890,201805,53,31,22,29574,20988,50562
314900,201805,34,27,7,25758,6678,32436
314910,201805,254,173,81,164755.8,77274,242029.8
314915,201805,157,137,20,130698,19080,149778
314920,201805,123,77,46,73458,43597.8,117055.8
314930,201805,1041,529,512,502802.33,487818.24,990620.57
314940,201805,52,40,12,38160,11448,49608
314950,201805,37,26,11,24804,10494,35298
314960,201805,58,43,15,41022,14310,55332
314970,201805,140,71,69,67599,65826,133425
314980,201805,306,196,110,184742.1,103986,288728.1
314990,201805,466,258,208,246132,197526.5,443658.5
314995,201805,200,64,136,61056,129734.46,190790.46
315000,201805,94,77,17,73458,16218,89676
315010,201805,46,30,16,28620,15264,43884
315015,201805,178,145,33,137604.96,31482,169086.96
315020,201805,72,62,10,59148,9540,68688
315030,201805,116,90,26,84906,24804,109710
315040,201805,67,49,18,46746,17172,63918
315050,201805,205,123,82,117342,78228,195570
315053,201805,39,34,5,32436,4770,37206
315057,201805,98,81,17,76892.4,16218,93110.4
315060,201805,72,64,8,59149.16,7632,66781.16
315070,201805,101,55,46,52470,43884,96354
315080,201805,374,306,68,291924,64872,356796
315090,201805,110,65,45,62010,42930,104940
315100,201805,79,40,39,38160,37206,75366
315110,201805,291,163,128,154644,122112,276756
315120,201805,1660,851,809,806656,769592.64,1576248.64
315130,201805,343,249,94,237546,89676,327222
315140,201805,532,312,220,296026.2,209880,505906.2
315150,201805,981,463,518,440749,493886,934635
315160,201805,217,112,105,106848,100170,207018
315170,201805,337,218,119,207019,113239.8,320258.8
315180,201805,3224,1367,1857,1301018.5,1767612.86,3068631.36
315190,201805,317,183,134,174201,127836,302037
315200,201805,1195,684,511,650914.2,486635.4,1137549.6
315210,201805,1562,896,666,851637.4,632944.2,1484581.6
315213,201805,45,26,19,24804,18126,42930
315217,201805,215,172,43,164088,41022,205110
315220,201805,1538,1177,361,1121952.4,344012.6,1465965.0
315230,201805,170,124,46,117343,43884,161227
315240,201805,427,275,152,262350,143806.5,406156.5
315250,201805,2565,1268,1297,1209094.83,1235756.86,2444851.69
315260,201805,150,92,58,86432.4,55332,141764.4
315270,201805,133,92,41,87195.6,38388.96,125584.56
315280,201805,700,458,242,436551,230858.46,667409.46
315290,201805,201,118,83,112572,78228.49,190800.49
315300,201805,74,50,24,47700,22896,70596
315310,201805,66,60,6,57240,5724,62964
315320,201805,162,92,70,87768,66780,154548
315330,201805,56,48,8,45792,7632,53424
315340,201805,426,300,126,285017.6,120204,405221.6
315350,201805,150,89,61,84906,58194,143100
315360,201805,98,53,45,50562,42930,93492
315370,201805,59,36,23,33629,21798.9,55427.9
315380,201805,12,7,5,6678,4770,11448
315390,201805,59,13,46,12402,43884,56286
315400,201805,823,616,207,582226.5,197478,779704.5
315410,201805,358,219,139,208640,132320,340960
315415,201805,62,47,15,44838,14310,59148
315420,201805,206,156,50,147728,47700,195428
315430,201805,677,395,282,375590,268551.8,644141.8
315440,201805,86,58,28,55332,26712,82044
315445,201805,256,205,51,195255.18,48654,243909.18
315450,201805,177,133,44,126882,41976,168858
315460,201805,3415,1707,1708,1625417.4,1626991.1,3252408.5
315470,201805,43,21,22,20034,20988,41022
315480,201805,63,24,39,22896,37206,60102
315490,201805,622,385,237,365238.9,226098,591336.9
315500,201805,21,13,8,12402,7632,20034
315510,201805,152,101,51,96354,48654,145008
315520,201805,70,61,9,58194,8586,66780
315530,201805,53,28,25,26712,23850,50562
315540,201805,233,152,81,145008,77274,222282
315550,201805,177,142,35,135468,33390,168858
315560,201805,743,592,151,563428.8,144054,707482.8
315570,201805,316,166,150,155169.5,143100,298269.5
315580,201805,671,440,231,419093,220374,639467
315590,201805,207,107,100,102078,95400,197478
315600,201805,295,216,79,206064,75176,281240
315610,201805,99,48,51,45792,48654,94446
315620,201805,34,27,7,25758,6678,32436
315630,201805,138,94,44,89676,41976,131652
315640,201805,61,36,25,34344,23850,58194
315645,201805,65,46,19,43884,17649,61533
315650,201805,169,123,46,117056,43311.6,160367.6
315660,201805,477,208,269,198432,256626,455058
315670,201805,2395,1201,1194,1142969.32,1137903.66,2280872.98
315680,201805,859,582,277,552747.6,264258,817005.6
315690,201805,691,474,217,451121.67,207018,658139.67
315700,201805,1914,1013,901,962530.37,859554,1822084.37
315710,201805,334,93,241,88722,229914,318636
315720,201805,437,278,159,265212,151686,416898
315725,201805,201,161,40,153594,38160,191754
315727,201805,43,22,21,20988,20034,41022
315730,201805,44,42,2,40068,1908,41976
315733,201805,88,58,30,55332,28620,83952
315737,201805,51,39,12,37206,11448,48654
315740,201805,46,40,6,38160,5724,43884
315750,201805,158,123,35,117342,33390,150732
315760,201805,48,34,14,32436,13356,45792
315765,201805,119,77,42,73458,40068,113526
315770,201805,232,141,91,134514,86528,221042
315780,201805,3313,1719,1594,1632686.14,1518292.58,3150978.72
315790,201805,213,161,52,153594,49035.6,202629.6
315800,201805,283,205,78,195570,74412,269982
315810,201805,95,57,38,54378,35966,90344
315820,201805,792,571,221,542159.34,210834,752993.34
315830,201805,141,81,60,77274,57240,134514
315840,201805,92,65,27,62010,25758,87768
315850,201805,260,193,67,184122,63918,248040
315860,201805,12,4,8,3816,7632,11448
315870,201805,36,27,9,25758,8586,34344
315880,201805,106,69,37,65826,35298,101124
315890,201805,81,60,21,57240,20034,77274
315895,201805,460,311,149,295645,141574,437219
315900,201805,71,34,37,32150,35298,67448
315910,201805,37,24,13,22657.5,12402,35059.5
315920,201805,183,119,64,113526,60102.9,173628.9
315930,201805,40,14,26,13356,24804,38160
315935,201805,149,117,32,111618,30519,142137
315940,201805,94,69,25,65826,23850,89676
315950,201805,64,45,19,42930,18126,61056
315960,201805,555,260,295,246771.58,280571.6,527343.18
315970,201805,37,28,9,26712,8586,35298
315980,201805,695,327,368,309534,351062.46,660596.46
315990,201805,255,152,103,144770,97967,242737
316000,201805,50,33,17,31482,15931.8,47413.8
316010,201805,75,63,12,60102,11448,71550
316020,201805,112,93,19,88722,18126,106848
316030,201805,404,214,190,203870,180736,384606
316040,201805,507,220,287,208926.2,273512,482438.2
316045,201805,60,53,7,50562,6678,57240
316050,201805,16,14,2,13356,1908,15264
316060,201805,95,62,33,59148,31482,90630
316070,201805,1061,689,372,650839.5,354125,1004964.5
316080,201805,101,63,38,59386.5,36252,95638.5
316090,201805,42,25,17,23182.2,16218,39400.2
316095,201805,72,60,12,56964,11448,68412
316100,201805,311,183,128,173771.3,122112,295883.3
316105,201805,34,23,11,21942,10494,32436
316110,201805,1935,1556,379,1473978.55,360898.2,1834876.75
316120,201805,80,60,20,57240,18793.8,76033.8
316130,201805,139,107,32,101411,30528,131939
316140,201805,27,20,7,19080,6678,25758
316150,201805,203,142,61,134752.5,58194,192946.5
316160,201805,84,50,34,47700,32436,80136
316165,201805,62,45,17,42740,15502.5,58242.5
316170,201805,206,140,66,132606,62964,195570
316180,201805,205,90,115,85526.1,109710,195236.1
316190,201805,142,103,39,97308,37206,134514
316200,201805,707,393,314,374922,298697.4,673619.4
316210,201805,772,518,254,493825.41,242316,736141.41
316220,201805,117,79,38,75366,36252,111618
316225,201805,24,14,10,13356,9540,22896
316230,201805,31,19,12,18126,11448,29574
316240,201805,624,502,122,478908,116388,595296
316245,201805,108,90,18,85860,17172,103032
316250,201805,1520,1060,460,1004544.5,437657.12,1442201.62
316255,201805,111,91,20,86432.4,19065.69,105498.09
316257,201805,183,95,88,90630,83665.8,174295.8
316260,201805,243,161,82,152297.06,78133,230430.06
316265,201805,26,17,9,16218,8586,24804
316270,201805,678,472,206,446997.4,196524,643521.4
316280,201805,540,333,207,316411.8,196810.6,513222.4
316290,201805,688,460,228,435691.98,217512,653203.98
316292,201805,510,204,306,194616,291686,486302
316294,201805,102,59,43,56286,41022,97308
316295,201805,295,132,163,124003,155502,279505
316300,201805,103,72,31,68688,29574,98262
316310,201805,38,20,18,19080,17172,36252
316320,201805,41,26,15,24804,14310,39114
316330,201805,132,86,46,81090.5,43597.8,124688.3
316340,201805,146,98,48,93492,45792,139284
316350,201805,195,141,54,134348,51516,185864
316360,201805,22,17,5,16218,4770,20988
316370,201805,1088,578,510,547616.5,486244.26,1033860.76
316380,201805,119,89,30,84906,28620,113526
316390,201805,123,87,36,82998,34344,117342
316400,201805,138,104,34,99216,32436,131652
316410,201805,305,224,81,212503.5,77274,289777.5
316420,201805,207,147,60,139522.5,57240,196762.5
316430,201805,156,79,77,75366,73458,148824
316440,201805,100,47,53,44838,50562,95400
316443,201805,39,35,4,33390,3816,37206
316447,201805,65,51,14,48654,13356,62010
316450,201805,224,169,55,161226,52470,213696
316460,201805,69,28,41,26712,39114,65826
316470,201805,1608,1159,449,1097980.44,426225.16,1524205.60
316480,201805,13,10,3,9540,2862,12402
316490,201805,18,7,11,6678,10494,17172
316500,201805,154,103,51,97975.8,48654,146629.8
316510,201805,165,125,40,118248.3,38160,156408.3
316520,201805,189,114,75,108183.6,71550,179733.6
316530,201805,159,114,45,108756,42643.8,151399.8
316540,201805,144,80,64,76320,61056,137376
316550,201805,139,99,40,94446,38160,132606
316553,201805,248,118,130,112349.53,124020,236369.53
316555,201805,33,26,7,24804,6678,31482
316556,201805,11,8,3,7632,2862,10494
316557,201805,18,14,4,13356,3816,17172
316560,201805,62,48,14,45792,13356,59148
316570,201805,242,219,23,208688,21942,230630
316580,201805,22,16,6,15264,5724,20988
316590,201805,114,98,16,93492,15264,108756
316600,201805,181,147,34,139952,32436,172388
316610,201805,66,47,19,44551.8,18126,62677.8
316620,201805,134,103,31,98262,29574,127836
316630,201805,44,32,12,30528,11448,41976
316640,201805,16,10,6,9540,5724,15264
316650,201805,70,52,18,49608,17172,66780
316660,201805,7,4,3,3816,2862,6678
316670,201805,446,159,287,151667,273225.8,424892.8
316680,201805,161,114,47,108756,44648,153404
316690,201805,192,121,71,115434,67734,183168
316695,201805,60,53,7,50562,6678,57240
316700,201805,15,8,7,7632,6678,14310
316710,201805,717,521,196,496796,186984,683780
316720,201805,4913,2503,2410,2373364.27,2293957.03,4667321.30
316730,201805,15,14,1,13356,954,14310
316740,201805,127,80,47,76320,44838,121158
316750,201805,20,14,6,13356,5724,19080
316760,201805,325,262,63,249948,60102,310050
316770,201805,144,81,63,77274,60102,137376
316780,201805,74,44,30,41670.72,28620,70290.72
316790,201805,55,43,12,41022,11448,52470
316800,201805,1809,1110,699,1057890.8,665130.2,1723021.0
316805,201805,18,10,8,9540,7632,17172
316810,201805,67,43,24,41022,22610,63632
316820,201805,38,19,19,18126,18126,36252
316830,201805,90,39,51,37206,48654,85860
316840,201805,506,305,201,290684,190800,481484
316850,201805,342,223,119,211358.7,113526,324884.7
316860,201805,6041,2679,3362,2541607.45,3202851.17,5744458.62
316870,201805,1480,961,519,907473.5,489690.2,1397163.7
316880,201805,115,64,51,60769.8,48654,109423.8
316890,201805,255,170,85,162133,81090,243223
316900,201805,422,289,133,273159.28,126882,400041.28
316905,201805,17,9,8,8586,7632,16218
316910,201805,50,25,25,23850,23850,47700
316920,201805,135,104,31,98501,29574,128075
316930,201805,1930,989,941,937736.2,895515.93,1833252.13
316935,201805,865,520,345,495126.72,328176,823302.72
316940,201805,1111,640,471,609606.4,448752.26,1058358.66
316950,201805,186,97,89,92538,84906,177444
316960,201805,1116,625,491,594914.8,468118.46,1063033.26
316970,201805,636,495,141,472230,134514,606744
316980,201805,110,67,43,63918,41012.46,104930.46
316990,201805,2199,1448,751,1374000.18,714489.96,2088490.14
317000,201805,332,257,75,244892,71550,316442
317005,201805,249,176,73,167904,69642,237546
317010,201805,6296,3465,2831,3284699.61,2698866.2,5983565.81
317020,201805,16286,7186,9100,6823616.83,8664277.29,15487894.12
317030,201805,83,33,50,31482,47483.26,78965.26
317040,201805,3112,1939,1173,1846497.28,1116276.61,2962773.89
317043,201805,76,55,21,52470,20034,72504
317047,201805,36,18,18,17172,17168,34340
317050,201805,178,132,46,125928,43884,169812
317052,201805,128,97,31,92538,29574,122112
317057,201805,204,153,51,145962,48082,194044
317060,201805,57,37,20,35298,18793.8,54091.8
317065,201805,58,45,13,42930,12402,55332
317070,201805,1976,938,1038,890083.7,989107.6,1879191.3
317075,201805,109,57,52,54378,49608,103986
317080,201805,834,437,397,415800.9,378548,794348.9
317090,201805,634,508,126,482295.5,120204,602499.5
317100,201805,426,318,108,301464,103032,404496
317103,201805,109,95,14,90630,13356,103986
317107,201805,37,33,4,31482,3816,35298
317110,201805,106,44,62,41976,59148,101124
317115,201805,41,35,6,33390,5724,39114
317120,201805,1828,931,897,880270.62,855281,1735551.62
317130,201805,1941,1239,702,1179057.4,669041,1848098.4
317140,201805,10,8,2,7632,1908,9540
317150,201805,268,160,108,152182,102268.8,254450.8
317160,201805,311,225,86,214333,81758,296091
317170,201805,207,143,64,136422,61056,197478
317180,201805,438,315,123,299794.5,117342,417136.5
317190,201805,257,174,83,165996,78895.8,244891.8
317200,201805,817,574,243,535204,231584,766788
317210,201805,156,88,68,82998.2,64872,147870.2
317220,201805,20,13,7,12402,6678,19080
320010,201805,623,464,159,439318.5,151686,591004.5
320013,201805,132,98,34,93492,32436,125928
320016,201805,282,179,103,170766,98262,269028
320020,201805,723,432,291,409578.75,275706.32,685285.07
320030,201805,152,112,40,106848,37826.1,144674.1
320035,201805,139,103,36,98262,34344,132606
320040,201805,505,258,247,245560,235638,481198
320050,201805,120,90,30,85860,28620,114480
320060,201805,1558,735,823,701143,784465.6,1485608.6
320070,201805,105,71,34,67734,32436,100170
320080,201805,761,435,326,412159,311004,723163
320090,201805,1208,841,367,798960.86,349259.6,1148220.46
320100,201805,321,184,137,175536,130698,306234
320110,201805,135,86,49,80184.2,46460,126644.2
320115,201805,113,91,22,86814,20988,107802
320120,201805,3303,1842,1461,1745728.2,1392240.64,3137968.84
320130,201805,7440,3543,3897,3358746.26,3710965.85,7069712.11
320140,201805,415,270,145,256245.2,138086,394331.2
320150,201805,1912,1117,795,1057829.61,758134.26,1815963.87
320160,201805,687,309,378,292583.03,359211.59,651794.62
320170,201805,117,92,25,87005,23850,110855
320180,201805,53,30,23,28620,21942,50562
320190,201805,238,156,82,148051.26,77942,225993.26
320200,201805,57,44,13,41976,12402,54378
320210,201805,844,473,371,449716.6,352962,802678.6
320220,201805,304,113,191,107802,181928,289730
320225,201805,77,63,14,60102,13356,73458
320230,201805,556,357,199,339052.4,189036,528088.4
320240,201805,3118,1561,1557,1486714.8,1482711.78,2969426.58
320245,201805,456,313,143,297457.4,136422,433879.4
320250,201805,231,123,108,116388.6,103032,219420.6
320255,201805,145,113,32,106495.02,30385,136880.02
320260,201805,178,126,52,120204,49560.3,169764.3
320265,201805,159,127,32,120348,30528,150876
320270,201805,153,124,29,118296,27666,145962
320280,201805,961,578,383,546452.2,365096,911548.2
320290,201805,66,56,10,53424,9540,62964
320300,201805,542,384,158,363589.8,149683.1,513272.9
320305,201805,674,368,306,351072,291734,642806
320310,201805,214,119,95,111571.5,89874,201445.5
320313,201805,309,158,151,150732,143768,294500
320316,201805,108,89,19,84906,18126,103032
320320,201805,3324,1511,1813,1435810,1726621.8,3162431.8
320330,201805,256,189,67,179643.3,62010.8,241654.1
320332,201805,883,534,349,507579.6,331897.3,839476.9
320334,201805,238,144,94,137090,89676,226766
320335,201805,147,106,41,100170.4,39114,139284.4
320340,201805,593,410,183,389996,173915,563911
320350,201805,970,416,554,394385.67,527390.48,921776.15
320360,201805,168,91,77,86528,73458,159986
320370,201805,243,187,56,176706,52391,229097
320380,201805,285,193,92,182453.3,87768,270221.3
320390,201805,1125,682,443,648110.8,422002.13,1070112.93
320400,201805,315,225,90,213697,85860,299557
320405,201805,899,386,513,367667.6,489089.92,856757.52
320410,201805,979,498,481,473423.4,458503.34,931926.74
320420,201805,480,244,236,232299.4,225144,457443.4
320425,201805,193,105,88,100170,83952,184122
320430,201805,391,223,168,211120.7,160272,371392.7
320435,201805,170,115,55,108889.56,52470,161359.56
320440,201805,204,123,81,117055.8,77274,194329.8
320450,201805,130,77,53,73458,50562,124020
320455,201805,247,201,46,190801,43884,234685
320460,201805,239,154,85,146916,81090,228006
320465,201805,114,77,37,73095.48,35298,108393.48
320470,201805,632,401,231,382250.26,220370,602620.26
320480,201805,178,120,58,113669.1,55332,169001.1
320490,201805,3033,1517,1516,1444309.18,1443747.72,2888056.90
320495,201805,95,58,37,55313,35298,90611
320500,201805,9479,4785,4694,4536643.97,4465953.59,9002597.56
320501,201805,549,278,271,265212,258534,523746
320503,201805,286,203,83,192708.2,79182,271890.2
320506,201805,260,195,65,186030,62010,248040
320510,201805,955,446,509,421622.3,484060.1,905682.4
320515,201805,80,67,13,62964.9,12402,75366.9
320517,201805,202,142,60,135468,57240,192708
320520,201805,6900,3076,3824,2920143.69,3639770.22,6559913.91
320530,201805,5299,2656,2643,2526044.22,2518172.23,5044216.45
330010,201805,3160,1620,1540,1538106.16,1466080.37,3004186.53
330015,201805,156,64,92,59912.08,87768,147680.08
330020,201805,3627,1586,2041,1510755.84,1946542,3457297.84
330022,201805,232,132,100,125213,94446.8,219659.8
330023,201805,532,183,349,173532.8,332946,506478.8
330025,201805,567,120,447,114480,425865.8,540345.8
330030,201805,1935,1239,696,1173665.18,660715.68,1834380.86
330040,201805,2379,1223,1156,1164882.1,1101348.3,2266230.4
330045,201805,8309,2630,5679,2501703.72,5411481.34,7913185.06
330050,201805,810,511,299,487494,285246,772740
330060,201805,905,561,344,531380.1,326859.48,858239.58
330070,201805,3473,1320,2153,1254481.05,2052647.56,3307128.61
330080,201805,1499,706,793,669215.3,755282.4,1424497.7
330090,201805,359,214,145,204156,138330,342486
330093,201805,286,129,157,123066,149742,272808
330095,201805,102,54,48,50848.2,45792,96640.2
330100,201805,9481,4882,4599,4648004.13,4384154.9,9032159.03
330110,201805,486,212,274,200817,261396,462213
330115,201805,527,304,223,290016,212742,502758
330120,201805,377,194,183,184694.4,173246.8,357941.2
330130,201805,1541,424,1117,403770.96,1065600,1469370.96
330140,201805,601,317,284,302400,269983,572383
330150,201805,445,263,182,248994,172674,421668
330160,201805,208,127,81,121158,77274,198432
330170,201805,26961,9509,17452,9049065.06,16636780.28,25685845.34
330180,201805,236,151,85,141507.02,80374.5,221881.52
330185,201805,820,330,490,313284.6,466192.8,779477.4
330187,201805,301,90,211,85860,201294,287154
330190,201805,5573,2236,3337,2123496.3,3180488.68,5303984.98
330200,201805,4488,1519,2969,1444394.06,2827649.76,4272043.82
330205,201805,400,243,157,231392.7,149492,380884.7
330210,201805,1005,617,388,582371.6,368482.9,950854.5
330220,201805,2572,1544,1028,1469590.5,979758.2,2449348.7
330225,201805,558,302,256,287469,243556.2,531025.2
330227,201805,2435,774,1661,735238.46,1584238.23,2319476.69
330230,201805,202,122,80,115721,76320,192041
330240,201805,3662,1923,1739,1829917.36,1656069.86,3485987.22
330245,201805,154,67,87,63918,82234.8,146152.8
330250,201805,6502,3382,3120,3214795.6,2967813.32,6182608.92
330260,201805,566,166,400,158364,381600,539964
330270,201805,3390,1252,2138,1193551,2039081.2,3232632.2
330280,201805,450,289,161,273914.08,153585,427499.08
330285,201805,7070,2316,4754,2204870.4,4532636.32,6737506.72
330290,201805,565,217,348,207018,331992,539010
330300,201805,770,514,256,486826.7,244206,731032.7
330310,201805,421,239,182,226098.7,173628,399726.7
330320,201805,8224,3123,5101,2971197.8,4859987.24,7831185.04
330330,201805,9253,3638,5615,3463901.2,5352144.13,8816045.33
330340,201805,2645,1580,1065,1505117.06,1015990.92,2521107.98
330350,201805,17955,7100,10855,6746444.19,10335490.51,17081934.70
330360,201805,2529,1259,1270,1200113.2,1211571,2411684.2
330370,201805,1007,558,449,531378,426343.6,957721.6
330380,201805,853,367,486,349392.96,463024.8,812417.76
330385,201805,607,318,289,302419,275706,578125
330390,201805,5174,2876,2298,2728826.55,2189444.4,4918270.95
330395,201805,266,169,97,159509.1,90773.2,250282.3
330400,201805,687,351,336,331420.6,318359.08,649779.68
330410,201805,498,354,144,336048,136886.33,472934.33
330411,201805,231,131,100,124793,95352.3,220145.3
330412,201805,253,104,149,98930,142146,241076
330414,201805,6094,2483,3611,2364786.58,3442920.3,5807706.88
330415,201805,583,270,313,256626,297648.8,554274.8
330420,201805,2272,1195,1077,1137045.6,1025065,2162110.6
330430,201805,1790,829,961,788672.8,914791.8,1703464.6
330440,201805,272,126,146,120204,139284,259488
330450,201805,121,51,70,48654,66780,115434
330452,201805,1744,830,914,790353.8,871633.76,1661987.56
330455,201805,110771,39783,70988,37874884.26,67659222.08,105534106.34
330460,201805,263,106,157,101124,149778,250902
330470,201805,1240,676,564,638610.98,538046.46,1176657.44
330475,201805,1406,376,1030,357750.8,982047.6,1339798.4
330480,201805,749,402,347,382840.2,330085,712925.2
330490,201805,13692,4796,8896,4569007.23,8480593.39,13049600.62
330500,201805,1342,614,728,585612.9,694131,1279743.9
330510,201805,11234,3797,7437,3613859.12,7088207.34,10702066.46
330513,201805,103,50,53,47700,50562,98262
330515,201805,848,349,499,329875,475665,805540
330520,201805,2540,948,1592,904173,1518615.9,2422788.9
330530,201805,225,118,107,112190,101888,214078
330540,201805,349,174,175,165996,166473,332469
330550,201805,3050,1089,1961,1036474.2,1868504.8,2904979.0
330555,201805,762,286,476,272825,453150.8,725975.8
330560,201805,559,209,350,199386,333882,533268
330570,201805,254,178,76,169812,72504,242316
330575,201805,805,336,469,320306,445371.5,765677.5
330580,201805,3368,1893,1475,1800020,1405615.7,3205635.7
330590,201805,314,151,163,144054,155502,299556
330600,201805,1108,709,399,674249.24,378948.84,1053198.08
330610,201805,1529,841,688,795447.7,652203.9,1447651.6
330615,201805,194,146,48,139284,45792,185076
330620,201805,1046,441,605,419284.6,575739.8,995024.4
330630,201805,3909,2493,1416,2363497.05,1343522.8,3707019.85
350010,201805,593,388,205,368292.67,195570,563862.67
350020,201805,40,20,20,19080,19080,38160
350030,201805,524,336,188,319400,178162.66,497562.66
350040,201805,129,52,77,49264.56,73458,122722.56
350050,201805,289,158,131,150732,124717.46,275449.46
350055,201805,84,47,37,44838,35298,80136
350060,201805,75,27,48,25758,45792,71550
350070,201805,816,476,340,449871.14,322693.56,772564.70
350075,201805,65,44,21,41976,20034,62010
350080,201805,53,33,20,30845.96,17839.8,48685.76
350090,201805,97,55,42,52470,40063.23,92533.23
350100,201805,294,186,108,176728.5,103032,279760.5
350110,201805,58,36,22,34344,20988,55332
350115,201805,161,98,63,92824.2,60102,152926.2
350120,201805,111,75,36,71550,34344,105894
350130,201805,357,176,181,167332,172674,340006
350140,201805,35,21,14,19271,13356,32627
350150,201805,70,54,16,51516,15264,66780
350160,201805,2546,986,1560,937575.16,1487069.91,2424645.07
350170,201805,413,249,164,235638.2,156170,391808.2
350180,201805,183,98,85,93492,81090,174582
350190,201805,976,501,475,475843.64,452849.69,928693.33
350200,201805,67,24,43,22896,40757.08,63653.08
350210,201805,1362,770,592,726879.33,564250.66,1291129.99
350220,201805,668,574,94,543458.73,89676,633134.73
350230,201805,83,59,24,56286,22896,79182
350240,201805,62,47,15,44838,14310,59148
350250,201805,1223,609,614,575467.6,584936.66,1160404.26
350260,201805,93,66,27,62964,25758,88722
350270,201805,833,542,291,515990.58,276164.92,792155.50
350275,201805,299,117,182,111237,173628,284865
350280,201805,4745,2430,2315,2306354.86,2205682.88,4512037.74
350290,201805,407,193,214,183940.23,203583.8,387524.03
350300,201805,49,25,24,23850,22896,46746
350310,201805,101,70,31,66780,29574,96354
350315,201805,39,24,15,22896,14310,37206
350320,201805,3286,1632,1654,1551511.5,1577135.8,3128647.3
350330,201805,1685,897,788,851637.96,750448.04,1602086.00
350335,201805,21,14,7,13356,6678,20034
350340,201805,133,63,70,60102,66447,126549
350350,201805,95,48,47,45792,44838,90630
350360,201805,132,88,44,83948,41976,125924
350370,201805,93,54,39,50879.96,37196.46,88076.42
350380,201805,752,319,433,303658.2,412318.8,715977.0
350390,201805,1423,577,846,549662.35,805939.4,1355601.75
350395,201805,25,20,5,19080,4770,23850
350400,201805,1689,903,786,851856.02,746292.16,1598148.18
350410,201805,2258,1017,1241,967128.96,1182991.03,2150119.99
350420,201805,232,141,91,133911,86814,220725
350430,201805,75,43,32,40450,30528,70978
350440,201805,148,108,40,102030.5,38160,140190.5
350450,201805,1598,972,626,921122.95,597109,1518231.95
350460,201805,334,121,213,115434,202915.8,318349.8
350470,201805,15,10,5,9540,4770,14310
350480,201805,161,88,73,83952,69642,153594
350490,201805,240,119,121,112572.8,115434,228006.8
350500,201805,38,19,19,18126,18126,36252
350510,201805,165,110,55,104940,52470,157410
350520,201805,455,216,239,202883.96,227369.96,430253.92
350530,201805,452,215,237,205110,226098,431208
350535,201805,69,54,15,51258.42,14310,65568.42
350540,201805,371,191,180,182214,171434,353648
350550,201805,2751,1614,1137,1532430.54,1083594.07,2616024.61
350560,201805,647,449,198,428341.23,188534.25,616875.48
350570,201805,4162,1736,2426,1650006.18,2311897.2,3961903.38
350580,201805,379,183,196,173629,186970.46,360599.46
350590,201805,896,488,408,464980,388278,853258
350600,201805,6200,3117,3083,2959083.14,2936150.52,5895233.66
350610,201805,1553,793,760,750638.4,725031,1475669.4
350620,201805,36,24,12,22896,11448,34344
350630,201805,241,136,105,128790.96,99217,228007.96
350635,201805,889,353,536,336476,510697.21,847173.21
350640,201805,120,88,32,83952,30528,114480
350650,201805,1888,1239,649,1177266.31,617796.93,1795063.24
350660,201805,758,344,414,327532.05,393998,721530.05
350670,201805,314,161,153,153356,145962,299318
350680,201805,178,96,82,91584,78228,169812
350690,201805,196,100,96,95400,91584,186984
350700,201805,718,347,371,328339.98,353934,682273.98
350710,201805,337,138,199,130443.56,189846,320289.56
350715,201805,51,44,7,41976,6678,48654
350720,201805,17,12,5,11448,4770,16218
350730,201805,43,28,15,26712,14310,41022
350740,201805,212,118,94,112276.26,89676,201952.26
350745,201805,20,10,10,9516,9540,19056
350750,201805,2161,1388,773,1315864.74,736805.96,2052670.70
350760,201805,3753,1625,2128,1547913.86,2027272.42,3575186.28
350770,201805,61,41,20,39114,19080,58194
350775,201805,49,36,13,34344,12393,46737
350780,201805,429,214,215,204156,205110,409266
350790,201805,365,157,208,149778,198432,348210
350800,201805,434,245,189,233730,180306,414036
350810,201805,520,420,100,399727,95400,495127
350820,201805,86,52,34,49608,32436,82044
350830,201805,79,45,34,42930,32436,75366
350840,201805,753,330,423,314581.5,402302,716883.5
350850,201805,1790,1034,756,980428.34,721183.46,1701611.80
350860,201805,590,346,244,326251.8,232776,559027.8
350870,201805,439,299,140,285246,133273.8,418519.8
350880,201805,280,150,130,140478.6,123352.2,263830.8
350890,201805,42,26,16,24804,15264,40068
350900,201805,1457,468,989,444842.93,942742.8,1387585.73
350910,201805,27,17,10,16218,9540,25758
350920,201805,606,337,269,321180.04,256626,577806.04
350925,201805,1182,635,547,602748.34,520121.4,1122869.74
350930,201805,97,59,38,56286,36252,92538
350940,201805,728,408,320,387705.6,303439.6,691145.2
350945,201805,104,77,27,72922,25758,98680
350950,201805,15471,7430,8041,7060471.23,7661858.31,14722329.54
350960,201805,1285,600,685,567718.96,653486,1221204.96
350970,201805,1114,599,515,568873.96,491014.46,1059888.42
350980,201805,94,64,30,61056,28620,89676
350990,201805,362,130,232,122370.72,221328,343698.72
350995,201805,32,16,16,15264,15264,30528
351000,201805,640,453,187,429938.07,178398,608336.07
351010,201805,46,27,19,25758,18126,43884
351015,201805,57,41,16,39114,15264,54378
351020,201805,1646,953,693,907738.45,658928,1566666.45
351030,201805,331,229,102,215890.2,97308,313198.2
351040,201805,855,458,397,435978,377784.66,813762.66
351050,201805,3291,1559,1732,1479001.01,1651666.3,3130667.31
351060,201805,5080,2069,3011,1962063.8,2869459.89,4831523.69
351070,201805,413,264,149,249348.92,142146,391494.92
351080,201805,815,590,225,562860,213696,776556
351090,201805,63,27,36,25758,34344,60102
351100,201805,460,266,194,251542.48,185071.23,436613.71
351110,201805,2124,1014,1110,962281.92,1056303.66,2018585.58
351120,201805,72,36,36,34344,34344,68688
351130,201805,174,60,114,57240,108469.8,165709.8
351140,201805,341,238,103,225607.91,98262,323869.91
351150,201805,403,207,196,196572.8,186984,383556.8
351160,201805,246,162,84,154548,80136,234684
351170,201805,190,100,90,95400,85097,180497
351190,201805,91,61,30,58194,28620,86814
351200,201805,377,246,131,234080.04,124974,359054.04
351210,201805,130,62,68,58893.38,64872,123765.38
351220,201805,528,317,211,298845.12,201294,500139.12
351230,201805,282,206,76,196524,72484.92,269008.92
351240,201805,232,100,132,95213.1,125928,221141.1
351250,201805,72,50,22,47476,20798,68274
351260,201805,155,114,41,108756,38828,147584
351270,201805,51,21,30,20034,28620,48654
351280,201805,1117,504,613,477956.46,583970.38,1061926.84
351290,201805,226,101,125,96354,118964,215318
351300,201805,3738,1735,2003,1647993.35,1910541,3558534.35
351310,201805,772,398,374,379692,356510,736202
351320,201805,108,66,42,62964,40068,103032
351330,201805,40,27,13,25758,12402,38160
351340,201805,1252,776,476,734034.93,453120.23,1187155.16
351350,201805,2495,1353,1142,1288235.2,1089177.03,2377412.23
351360,201805,783,389,394,370152,375558.04,745710.04
351370,201805,368,192,176,183163.23,167267.96,350431.19
351380,201805,8974,4093,4881,3889323.23,4645929.78,8535253.01
351385,201805,30,20,10,19080,9540,28620
351390,201805,286,211,75,200340.02,71550,271890.02
351400,201805,66,41,25,39114,23812.92,62926.92
351410,201805,447,276,171,262033.04,163134,425167.04
351420,201805,60,49,11,46746,10494,57240
351430,201805,71,39,32,37206,30528,67734
351440,201805,790,547,243,519960.76,231818,751778.76
351450,201805,257,129,128,123066,122112,245178
351460,201805,120,54,66,51516,62964,114480
351470,201805,139,74,65,70596,62010,132606
351480,201805,524,297,227,282098.96,216438.75,498537.71
351490,201805,289,104,185,99216,176490,275706
351492,201805,31,22,9,20988,8586,29574
351495,201805,27,18,9,17172,8586,25758
351500,201805,3543,1541,2002,1464752.79,1905136.41,3369889.20
351510,201805,1784,746,1038,711398,988048.26,1699446.26
351512,201805,21,18,3,17172,2862,20034
351515,201805,195,113,82,107802,78228,186030
351518,201805,778,483,295,459824,281430,741254
351519,201805,77,49,28,46746,26712,73458
351520,201805,146,89,57,84269.96,54378,138647.96
351530,201805,23,15,8,14310,7632,21942
351535,201805,136,77,59,73458,56286,129744
351540,201805,459,331,128,313391,122112,435503
351550,201805,1332,810,522,768702.96,496070.86,1264773.82
351560,201805,74,39,35,37206,33390,70596
351565,201805,12,7,5,6678,4770,11448
351570,201805,2558,1322,1236,1258864.35,1178473.65,2437338.00
351580,201805,39,35,4,33390,3816,37206
351590,201805,67,45,22,42930,20988,63918
351600,201805,194,147,47,140238,44838,185076
351610,201805,59,30,29,28620,27666,56286
351620,201805,5925,3390,2535,3223847.53,2417125.11,5640972.64
351630,201805,2557,1321,1236,1254919.43,1176659.23,2431578.66
351640,201805,1674,819,855,779441.38,812713.3,1592154.68
351650,201805,30,25,5,23850,4770,28620
351660,201805,155,99,56,94446,53424,147870
351670,201805,741,464,277,440320,264258,704578
351680,201805,72,59,13,56286,12402,68688
351685,201805,40,25,15,23850,14310,38160
351690,201805,311,220,91,208015.63,86814,294829.63
351700,201805,158,110,48,104940,45792,150732
351710,201805,75,53,22,50562,20988,71550
351720,201805,131,62,69,59148,65826,124974
351730,201805,102,73,29,68688.96,27661.23,96350.19
351740,201805,719,487,232,462118.76,221323.23,683441.99
351750,201805,363,154,209,146280,199386,345666
351760,201805,790,615,175,586949,166950,753899
351770,201805,289,246,43,234684,41022,275706
351780,201805,175,99,76,94437,72504,166941
351790,201805,236,121,115,115434,109710,225144
351800,201805,51,33,18,31482,17172,48654
351810,201805,126,84,42,80136,40068,120204
351820,201805,882,636,246,600878.6,234393.23,835271.83
351830,201805,508,182,326,172864.8,311004,483868.8
351840,201805,1877,952,925,899264,880949.71,1780213.71
351850,201805,230,168,62,159652.8,59148,218800.8
351860,201805,754,503,251,474140.84,239163.23,713304.07
351870,201805,5643,2652,2991,2519605.64,2845369.98,5364975.62
351880,201805,18983,8315,10668,7910896.57,10162245.29,18073141.86
351885,201805,89,60,29,56525,27666,84191
351890,201805,71,60,11,57240,10494,67734
351900,201805,225,134,91,127169,86814,213983
351905,201805,78,34,44,32436,41976,74412
351907,201805,3149,1378,1771,1311743.06,1687455.8,2999198.86
351910,201805,182,77,105,73458,100170,173628
351920,201805,132,74,58,70596,55309.69,125905.69
351925,201805,87,60,27,57240,25758,82998
351930,201805,381,259,122,246990.6,116388,363378.6
351940,201805,237,105,132,100170,125928,226098
351950,201805,142,83,59,79182,56286,135468
351960,201805,863,403,460,384280.73,436684.36,820965.09
351970,201805,1918,1027,891,977611.84,849201,1826812.84
351980,201805,147,73,74,67734,70596,138330
351990,201805,276,186,90,176490,85058.64,261548.64
352000,201805,362,222,140,211788,133560,345348
352010,201805,358,215,143,205110,136422,341532
352020,201805,202,68,134,64872,127836,192708
352030,201805,1024,525,499,500134.5,474455.96,974590.46
352040,201805,578,251,327,239454,311958,551412
352042,201805,285,98,187,93492,178112,271604
352044,201805,397,234,163,222081.86,155502,377583.86
352050,201805,3220,1301,1919,1233317.98,1829190.26,3062508.24
352060,201805,106,66,40,62964,38160,101124
352070,201805,104,75,29,70280,27666,97946
352080,201805,65,40,25,37206,23850,61056
352090,201805,173,115,58,109710,55332,165042
352100,201805,253,124,129,118292,121914,240206
352110,201805,111,32,79,30528,75366,105894
352115,201805,71,27,44,25758,41976,67734
352120,201805,96,64,32,61056,30528,91584
352130,201805,220,183,37,174582,35298,209880
352140,201805,185,76,109,72027,103986,176013
352150,201805,121,67,54,62964.04,51516,114480.04
352160,201805,131,87,44,82998,41976,124974
352170,201805,374,255,119,242316.04,113526,355842.04
352180,201805,618,415,203,394289.5,193658,587947.5
352190,201805,258,100,158,95390.46,150693.84,246084.30
352200,201805,31,16,15,15264,14310,29574
352210,201805,3821,1589,2232,1507629.87,2122357.85,3629987.72
352215,201805,54,30,24,28620,22438.08,51058.08
352220,201805,6924,2717,4207,2586597.44,4010882.39,6597479.83
352230,201805,3203,2034,1169,1928657.43,1109518.77,3038176.20
352240,201805,2230,1303,927,1240868.69,882061.08,2122929.77
352250,201805,2596,1338,1258,1271700.96,1196067.96,2467768.92
352260,201805,1074,585,489,556336.23,466220,1022556.23
352265,201805,61,26,35,24804,33390,58194
352270,201805,413,236,177,224190.92,168802,392992.92
352280,201805,402,250,152,237229,145003.23,382232.23
352290,201805,177,113,64,107802,61056,168858
352300,201805,102,76,26,72504,24804,97308
352310,201805,5775,2814,2961,2671140.55,2819434.54,5490575.09
352320,201805,963,499,464,472551.84,440604.9,913156.74
352330,201805,527,243,284,231488.1,270650,502138.1
352340,201805,1398,683,715,648930,678630.3,1327560.3
352350,201805,330,209,121,199386,115148,314534
352360,201805,230,97,133,91631.7,124167.25,215798.95
352370,201805,102,70,32,66780,30528,97308
352380,201805,121,74,47,70596,44838,115434
352390,201805,2457,1119,1338,1064263.82,1273840.56,2338104.38
352400,201805,481,209,272,198670.5,259201.8,457872.3
352410,201805,768,550,218,520910.88,207785,728695.88
352420,201805,103,66,37,62964,35298,98262
352430,201805,1771,789,982,747653.84,934195.5,1681849.34
352440,201805,3146,1608,1538,1525112.43,1465304.67,2990417.10
352450,201805,193,162,31,154548,29574,184122
352460,201805,572,290,282,276102.68,268313.2,544415.88
352470,201805,608,204,404,194616,385407,580023
352480,201805,1375,767,608,730445.96,579459.8,1309905.76
352490,201805,83,31,52,29574,49608,79182
352500,201805,1208,536,672,509818.6,639935.2,1149753.8
352510,201805,741,402,339,382554.96,323406,705960.96
352520,201805,545,242,303,230868,288918.9,519786.9
352530,201805,1744,924,820,881496,781898.6,1663394.6
352540,201805,74,49,25,46746,23850,70596
352550,201805,183,105,78,100170,73744.2,173914.2
352560,201805,50,40,10,38160,9540,47700
352570,201805,669,351,318,334262,303372,637634
352580,201805,56,37,19,34344.65,18126,52470.65
352585,201805,17,5,12,4770,11448,16218
352590,201805,4372,2215,2157,2106991.92,2056877.41,4163869.33
352600,201805,358,246,112,234367,106848,341215
352610,201805,935,433,502,410821.33,478908,889729.33
352620,201805,960,389,571,370152.2,544734,914886.2
352630,201805,168,66,102,62964,97298.46,160262.46
352640,201805,560,393,167,372624.02,159318,531942.02
352650,201805,88,58,30,55332,28620,83952
352660,201805,80,47,33,44838,31482,76320
352670,201805,1674,914,760,869425.89,723950.6,1593376.49
352680,201805,895,573,322,543410.56,305726.04,849136.60
352690,201805,4376,2005,2371,1904055.88,2258354.69,4162410.57
352700,201805,110,64,46,60769.8,43884,104653.8
352710,201805,1361,730,631,694512,598344.8,1292856.8
352720,201805,1341,644,697,612118.2,664361.03,1276479.23
352725,201805,26,24,2,22896,1908,24804
352730,201805,368,185,183,175311.81,174582,349893.81
352740,201805,429,269,160,254671.68,152640,407311.68
352750,201805,22,14,8,13069.8,7632,20701.8
352760,201805,202,145,57,138330,54378,192708
352770,201805,81,63,18,60102,17172,77274
352780,201805,80,45,35,42930,33390,76320
352790,201805,28,23,5,21942,4770,26712
352800,201805,250,171,79,163134,75079.8,238213.8
352810,201805,165,109,56,101475.42,53424,154899.42
352820,201805,67,52,15,48909.07,14310,63219.07
352830,201805,90,62,28,59148,26712,85860
352840,201805,607,314,293,298269.2,279522,577791.2
352850,201805,1372,490,882,466792.2,840791.96,1307584.16
352860,201805,134,89,45,84270,42930,127200
352870,201805,47,31,16,29574,15264,44838
352880,201805,191,129,62,123046.92,59148,182194.92
352885,201805,29,21,8,20034,7632,27666
352890,201805,57,39,18,37206,16886,54092
352900,201805,4855,2342,2513,2214647.02,2389866.28,4604513.30
352910,201805,39,32,7,30528,6678,37206
352920,201805,705,433,272,412128,259488,671616
352930,201805,1274,618,656,588139.82,622826.64,1210966.46
352940,201805,6373,2762,3611,2624308,3441732.64,6066040.64
352950,201805,93,38,55,36252,52470,88722
352960,201805,65,42,23,40068,21942,62010
352965,201805,19,8,11,7632,10494,18126
352970,201805,473,353,120,333554.97,113527,447081.97
352980,201805,175,94,81,89676,77274,166950
352990,201805,960,420,540,399677.27,514072.09,913749.36
353000,201805,68,32,36,30528,34344,64872
353010,201805,549,339,210,323406,200320.92,523726.92
353020,201805,289,212,77,202248,73458,275706
353030,201805,1208,548,660,521819.46,628953.66,1150773.12
353040,201805,88,54,34,51516,32436,83952
353050,201805,1335,851,484,805264.02,461449.8,1266713.82
353060,201805,8043,3651,4392,3467332.04,4183725.84,7651057.88
353070,201805,1640,1042,598,988118.42,569031.56,1557149.98
353080,201805,1345,714,631,678819.55,601016,1279835.55
353090,201805,56,33,23,31482,21942,53424
353100,201805,62,51,11,48654,10494,59148
353110,201805,2073,625,1448,594518.88,1379423.26,1973942.14
353120,201805,80,43,37,41022,35298,76320
353130,201805,871,435,436,413974.52,415822.68,829797.20
353140,201805,566,220,346,209819,330084,539903
353150,201805,364,205,159,194616,151676.46,346292.46
353160,201805,102,83,19,79182,18126,97308
353170,201805,196,65,131,62010,124946.46,186956.46
353180,201805,960,440,520,417752.69,495556,913308.69
353190,201805,485,346,139,329028.9,132320,461348.9
353200,201805,195,98,97,93492,92538,186030
353205,201805,25,18,7,17172,6678,23850
353210,201805,88,53,35,50562,33390,83952
353215,201805,54,32,22,30528,20988,51516
353220,201805,85,47,38,44838,35298.27,80136.27
353230,201805,161,64,97,61056,92538,153594
353240,201805,301,164,137,156456,130698,287154
353250,201805,206,107,99,102078,94446,196524
353260,201805,460,330,130,313676.5,124010.46,437686.96
353270,201805,68,49,19,46746,17458.2,64204.2
353280,201805,95,49,46,46269,43884,90153
353282,201805,123,88,35,83952,33390,117342
353284,201805,24,19,5,18126,4770,22896
353286,201805,1,1,0,954,0,954
353290,201805,80,47,33,44838,31473,76311
353300,201805,401,222,179,210246.46,170731.5,380977.96
353310,201805,53,47,6,44838,5724,50562
353320,201805,62,38,24,36252,22896,59148
353325,201805,59,36,23,34335,21638,55973
353330,201805,68,51,17,48511,16218,64729
353340,201805,624,207,417,196795.89,397232.26,594028.15
353350,201805,917,429,488,408275.64,464295,872570.64
353360,201805,110,89,21,84588.04,19748,104336.04
353370,201805,118,68,50,64872,47700,112572
353380,201805,26,18,8,17168,7632,24800
353390,201805,1075,515,560,491310,534240,1025550
353400,201805,51,31,20,29574,19080,48654
353410,201805,113,72,41,68688,39067,107755
353420,201805,58,23,35,21942,33390,55332
353430,201805,555,369,186,348305.3,177157.8,525463.1
353440,201805,10245,4471,5774,4253349.91,5501573.26,9754923.17
353450,201805,56,30,26,28620,24804,53424
353460,201805,617,339,278,320237.1,264487.5,584724.6
353470,201805,2148,1169,979,1111273.85,931560.23,2042834.08
353475,201805,237,158,79,148042.96,75366,223408.96
353480,201805,188,153,35,145962,33390,179352
353490,201805,237,141,96,134514,91584,226098
353500,201805,190,111,79,104654.96,75366,180020.96
353510,201805,100,73,27,69623.46,25748.46,95371.92
353520,201805,208,141,67,134514,63918,198432
353530,201805,476,260,216,248040,206064,454104
353540,201805,361,237,124,225775.27,118296,344071.27
353550,201805,742,506,236,478910.88,225144,704054.88
353560,201805,637,271,366,257066.8,348564.06,605630.86
353570,201805,60,31,29,29574,27666,57240
353580,201805,360,278,82,264735,78228,342963
353590,201805,89,61,28,57876.04,26712,84588.04
353600,201805,275,155,120,147553,113844,261397
353610,201805,114,60,54,57240,51516,108756
353620,201805,574,310,264,293753.5,251569.8,545323.3
353625,201805,51,29,22,27666,20988,48654
353630,201805,238,171,67,158728.6,63918,222646.6
353640,201805,126,85,41,80613,39114,119727
353650,201805,885,342,543,324169.2,518022,842191.2
353657,201805,24,18,6,17172,5724,22896
353660,201805,253,142,111,135468,105607.8,241075.8
353670,201805,768,455,313,433116.2,298602,731718.2
353680,201805,101,72,29,68314,27666,95980
353690,201805,47,37,10,35024,9540,44564
353700,201805,281,200,81,190800,77274,268074
353710,201805,426,199,227,188892.8,216272,405164.8
353715,201805,46,34,12,32149.8,11448,43597.8
353720,201805,361,167,194,159300,185076,344376
353730,201805,1127,695,432,660120.9,412128,1072248.9
353740,201805,650,360,290,343153.8,276660,619813.8
353750,201805,90,56,34,52892.14,32436,85328.14
353760,201805,2785,1045,1740,994871.88,1656357.28,2651229.16
353770,201805,97,81,16,76797,15264,92061
353780,201805,1153,570,583,542063.96,553988,1096051.96
353790,201805,513,297,216,281269.5,203465.35,484734.85
353800,201805,3283,1671,1612,1584878.89,1536508.58,3121387.47
353810,201805,236,133,103,126028.71,98253,224281.71
353820,201805,187,93,94,88722,89051.41,177773.41
353830,201805,48,41,7,39114,6678,45792
353850,201805,168,86,82,82044,78228,160272
353860,201805,471,215,256,204394.5,243937.8,448332.3
353870,201805,5063,2539,2524,2404548.09,2396719.6,4801267.69
353880,201805,683,488,195,464216.4,185076.12,649292.52
353890,201805,583,330,253,314248,241076,555324
353900,201805,129,66,63,62964,60102,123066
353910,201805,177,86,91,82044,86814,168858
353920,201805,452,245,207,231870.6,197035.16,428905.76
353930,201805,1016,596,420,566891.79,399445.8,966337.59
353940,201805,187,102,85,96544.8,80232,176776.8
353950,201805,520,320,200,304993.8,190791,495784.8
353960,201805,69,56,13,53424,12402,65826
353970,201805,75,45,30,42930,28620,71550
353980,201805,1533,753,780,715702.95,743185.76,1458888.71
353990,201805,75,43,32,41022,30528,71550
354000,201805,372,181,191,172007,182019.2,354026.2
354010,201805,93,52,41,49608,38637,88245
354020,201805,543,344,199,327222,189846,517068
354025,201805,53,42,11,40068,10494,50562
354030,201805,65,36,29,34344,27666,62010
354040,201805,98,69,29,65444.4,27666,93110.4
354050,201805,191,105,86,99884,82044,181928
354060,201805,775,373,402,355842,381267.4,737109.4
354070,201805,873,509,364,484056.03,347256,831312.03
354075,201805,215,115,100,109710,94446.8,204156.8
354080,201805,293,127,166,120871.8,158364,279235.8
354085,201805,19,12,7,11448,6678,18126
354090,201805,315,175,140,166869,133560,300429
354100,201805,5545,2313,3232,2195009.35,3077790.25,5272799.60
354105,201805,82,40,42,38160,40068,78228
354110,201805,48,22,26,20988,24804,45792
354120,201805,149,103,46,98122.97,43884,142006.97
354130,201805,702,468,234,446234,222946,669180
354140,201805,3167,1482,1685,1410528.43,1605945.83,3016474.26
354150,201805,659,412,247,390675.46,234207,624882.46
354160,201805,712,451,261,429061.5,248708,677769.5
354165,201805,22,13,9,12402,8586,20988
354170,201805,177,120,57,113812.2,54378,168190.2
354180,201805,63,39,24,36880,22896,59776
354190,201805,212,98,114,91870.2,108756,200626.2
354200,201805,131,72,59,68211,56286,124497
354210,201805,68,34,34,32436,32436,64872
354220,201805,643,394,249,375208.2,236306.35,611514.55
354230,201805,165,68,97,64872,91584.6,156456.6
354240,201805,316,204,112,193662.49,106211.96,299874.45
354250,201805,95,56,39,53424,37206,90630
354260,201805,1949,909,1040,856568.04,989294.67,1845862.71
354270,201805,95,71,24,67734,22896,90630
354280,201805,39,21,18,20034,17172,37206
354290,201805,144,99,45,93635.1,42930,136565.1
354300,201805,424,290,134,276343,127678,404021
354310,201805,103,76,27,71550.2,25758,97308.2
354320,201805,182,98,84,93492,80136,173628
354323,201805,16,14,2,13356,1908,15264
354325,201805,107,62,45,58342,42930,101272
354330,201805,2623,878,1745,832977.26,1662564.18,2495541.44
354340,201805,10593,5176,5417,4926021.03,5161091.67,10087112.70
354350,201805,127,83,44,79182,41832.9,121014.9
354360,201805,88,48,40,45792,38160,83952
354370,201805,270,150,120,143100,114480,257580
354380,201805,213,128,85,121326,81090,202416
354390,201805,2787,1016,1771,967599.22,1688734.98,2656334.20
354400,201805,333,176,157,167237,149205.8,316442.8
354410,201805,614,298,316,282666.43,300510.2,583176.63
354420,201805,273,171,102,163134,97308,260442
354425,201805,319,184,135,175536,128790,304326
354430,201805,187,118,69,110997.9,65062.8,176060.7
354440,201805,39,27,12,25758,11448,37206
354450,201805,50,36,14,34344,13356,47700
354460,201805,104,60,44,57240,41976,99216
354470,201805,39,26,13,24804,12402,37206
354480,201805,121,62,59,59139,56276.46,115415.46
354490,201805,148,91,57,86654.97,54378,141032.97
354500,201805,392,195,197,186030,187938,373968
354510,201805,101,69,32,65826,30528,96354
354515,201805,39,14,25,13356,23850,37206
354520,201805,1652,728,924,692755.2,881057.56,1573812.76
354530,201805,659,347,312,329316.8,296504,625820.8
354540,201805,282,159,123,151686,117337.23,269023.23
354550,201805,42,25,17,23850,16218,40068
354560,201805,162,93,69,88436,65816.46,154252.46
354570,201805,137,88,49,83952,46746,130698
354580,201805,1973,935,1038,889413,989666.26,1879079.26
354600,201805,270,147,123,137984.12,117327.69,255311.81
354610,201805,73,67,6,62964.58,5724,68688.58
354620,201805,64,20,44,19080,41976,61056
354625,201805,18,11,7,10494,6674,17168
354630,201805,317,211,106,200919.34,101124,302043.34
354640,201805,805,523,282,495016.36,269028,764044.36
354650,201805,75,43,32,40726.8,30499.92,71226.72
354660,201805,807,597,210,565516.46,200340,765856.46
354670,201805,278,99,179,93015,169813,262828
354680,201805,1258,474,784,452196,747459,1199655
354690,201805,86,57,29,53425,27666,81091
354700,201805,78,56,22,53424,20988,74412
354710,201805,55,38,17,35615.96,16218,51833.96
354720,201805,20,19,1,18126,954,19080
354730,201805,1891,796,1095,756227.2,1044439.2,1800666.4
354740,201805,60,41,19,39114,18126,57240
354750,201805,437,259,178,247077,169812,416889
354760,201805,518,317,201,299857,191468,491325
354765,201805,13,5,8,4770,7632,12402
354770,201805,341,229,112,217642.03,106084.8,323726.83
354780,201805,8169,3315,4854,3150222.65,4625893.33,7776115.98
354790,201805,113,66,47,62964,44838,107802
354800,201805,429,237,192,226098,182862.92,408960.92
354805,201805,104,52,52,48972,49608,98580
354810,201805,136,78,58,74412,55332,129744
354820,201805,185,80,105,76111,100170,176281
354830,201805,41,22,19,20988,18126,39114
354840,201805,55,37,18,35298,17172,52470
354850,201805,4568,2027,2541,1925974.96,2419360.08,4345335.04
354860,201805,328,161,167,153594,157127.52,310721.52
354870,201805,11969,5437,6532,5159993.45,6220832.24,11380825.69
354880,201805,3016,1128,1888,1074474.46,1799032.9,2873507.36
354890,201805,2868,1584,1284,1504984.68,1223953.38,2728938.06
354900,201805,60,39,21,37206,20034,57240
354910,201805,1240,654,586,620157.24,559044,1179201.24
354920,201805,50,42,8,40068,7632,47700
354925,201805,13,7,6,6678,5724,12402
354930,201805,31,28,3,26442,2862,29304
354940,201805,803,592,211,562099.69,201294,763393.69
354950,201805,220,146,74,138855,70596,209451
354960,201805,167,64,103,61056,97976,159032
354970,201805,853,560,293,529381.1,278883.02,808264.12
354980,201805,8441,3122,5319,2970394.31,5071618.18,8042012.49
354990,201805,9191,4353,4838,4138982.65,4609007.04,8747989.69
354995,201805,518,183,335,174582,319275.18,493857.18
355000,201805,494,164,330,156451.23,314581.5,471032.73
355010,201805,628,396,232,377784,219116.48,596900.48
355020,201805,716,454,262,432157.59,249940,682097.59
355030,201805,205345,79677,125668,75784394.86,119785461.9,195569856.76
355040,201805,722,338,384,320401.6,366145.2,686546.8
355050,201805,155,103,52,96991.77,49608,146599.77
355060,201805,1541,770,771,729711.86,734342.3,1464054.16
355070,201805,1449,711,738,674470.36,703059,1377529.36
355080,201805,200,117,83,111618,78294.8,189912.8
355090,201805,299,200,99,188702,94446,283148
355100,201805,4825,2392,2433,2262306.4,2318575.36,4580881.76
355110,201805,269,170,99,161223,94446,255669
355120,201805,80,56,24,53424,22896,76320
355130,201805,54,30,24,28620,22896,51516
355140,201805,185,122,63,115672.5,60102,175774.5
355150,201805,681,412,269,391804,256149,647953
355160,201805,458,219,239,206541.96,228006,434547.96
355170,201805,2057,1069,988,1018446.87,942532.92,1960979.79
355180,201805,616,263,353,249948,335927.25,585875.25
355190,201805,223,152,71,145008,67734,212742
355200,201805,119,69,50,65826,47700,113526
355210,201805,721,415,306,395910,291905.46,687815.46
355220,201805,6749,3593,3156,3417235.76,3001325.8,6418561.56
355230,201805,104,62,42,59148,40063.23,99211.23
355240,201805,4314,1881,2433,1781744.12,2316657.91,4098402.03
355250,201805,5416,2622,2794,2495513.22,2662068.33,5157581.55
355255,201805,52,32,20,30528,19080,49608
355260,201805,188,114,74,107783.12,70568.46,178351.58
355270,201805,165,98,67,93492,63203,156695
355280,201805,6392,2686,3706,2556212.64,3530250.46,6086463.10
355290,201805,77,58,19,55332,18126,73458
355300,201805,184,118,66,111618.8,62964,174582.8
355310,201805,108,60,48,57240,45792,103032
355320,201805,90,47,43,44838,40074.6,84912.6
355330,201805,269,152,117,145008,111618,256626
355340,201805,1543,547,996,519231.61,949441.97,1468673.58
355350,201805,141,72,69,68688,65826,134514
355360,201805,185,117,68,111408.12,64872,176280.12
355365,201805,25,20,5,19080,4770,23850
355370,201805,1044,595,449,562716.78,427078.55,989795.33
355380,201805,780,520,260,495488.52,247754,743242.52
355385,201805,62,43,19,41022,18126,59148
355390,201805,105,61,44,58194,41976,100170
355395,201805,187,114,73,107655.23,69642,177297.23
355400,201805,1554,963,591,914703.52,562287.8,1476991.32
355410,201805,4913,2319,2594,2195525.34,2466915.16,4662440.50
355420,201805,51,38,13,36252,12402,48654
355430,201805,347,208,139,197096.4,132606,329702.4
355440,201805,85,52,33,49608,31482,81090
355450,201805,458,221,237,208115.94,225048.8,433164.74
355460,201805,69,53,16,49608.42,15264,64872.42
355465,201805,52,33,19,31482,18126,49608
355470,201805,180,72,108,67734.1,103032,170766.1
355475,201805,13,8,5,7632,4770,12402
355480,201805,463,205,258,193672.34,245464.2,439136.54
355490,201805,115,81,34,77274,32436,109710
355495,201805,55,27,28,25758,26712,52470
355500,201805,1664,934,730,886410.66,696385.46,1582796.12
355510,201805,271,197,74,183239.63,70596,253835.63
355520,201805,33,26,7,24518,6678,31196
355530,201805,24,16,8,15264,7632,22896
355535,201805,76,38,38,36252,36252,72504
355540,201805,2377,937,1440,892439.53,1371843.96,2264283.49
355550,201805,65,39,26,37206,24804,62010
355560,201805,240,120,120,114480,113843.96,228323.96
355570,201805,31,21,10,20034,9540,29574
355580,201805,275,188,87,179352,82707.23,262059.23
355590,201805,24,15,9,14310,8586,22896
355600,201805,271,139,132,132606,125637.23,258243.23
355610,201805,213,139,74,132606,70596,203202
355620,201805,1266,589,677,561095.8,645062.18,1206157.98
355630,201805,415,302,113,288108,106773.96,394881.96
355635,201805,126,61,65,58194,61997,120191
355640,201805,573,331,242,314820.16,230868,545688.16
355645,201805,833,355,478,337191.3,454132.82,791324.12
355650,201805,2160,899,1261,854376.8,1202960.99,2057337.79
355660,201805,258,138,120,131652,114480,246132
355670,201805,495,197,298,187938,284005.8,471943.8
355680,201805,204,115,89,108757,84620,193377
355690,201805,86,40,46,38160,43540,81700
355695,201805,15,12,3,11448,2862,14310
355700,201805,1151,591,560,558744.6,533668,1092412.6
355710,201805,2195,1201,994,1142117.56,947771.2,2089888.76
355715,201805,20,18,2,17172,1908,19080
355720,201805,209,126,83,118614.08,79182,197796.08
355730,201805,95,55,40,51595.95,38160,89755.95
410010,201805,133,113,20,107802,19080,126882
410020,201805,104,92,12,87768,11448,99216
410030,201805,165,104,61,98548.4,58194,156742.4
410040,201805,971,530,441,505381.5,420524,925905.5
410045,201805,26,21,5,20034,4770,24804
410050,201805,481,267,214,254718,203297,458015
410060,201805,277,211,66,201294,62964,264258
410070,201805,307,254,53,242316,50562,292878
410080,201805,167,108,59,103032,56286,159318
410090,201805,75,67,8,63709,7632,71341
410100,201805,298,212,86,201933.18,81233.1,283166.28
410105,201805,47,28,19,26712,18126,44838
410110,201805,316,194,122,185076,116388,301464
410115,201805,27,18,9,17172,8586,25758
410120,201805,440,228,212,217225.8,202248,419473.8
410130,201805,44,27,17,25758,16218,41976
410140,201805,3109,1520,1589,1445823.38,1512281.6,2958104.98
410150,201805,2704,1087,1617,1035559.24,1542021.8,2577581.04
410160,201805,506,321,185,305947.8,176490,482437.8
410165,201805,68,46,22,43884,20988,64872
410170,201805,167,124,43,116871,41022,157893
410180,201805,2136,1241,895,1179925.19,852372.95,2032298.14
410185,201805,34,30,4,28620,3816,32436
410190,201805,443,277,166,264258,158364,422622
410200,201805,957,716,241,682214.94,229914,912128.94
410210,201805,557,290,267,276660,254432,531092
410220,201805,39,21,18,20034,17172,37206
410230,201805,130,69,61,65826,58194,124020
410240,201805,737,485,252,462117.8,240408,702525.8
410250,201805,374,274,100,260791.84,95395.23,356187.07
410260,201805,296,174,122,165710,116388,282098
410270,201805,31,19,12,18126,11448,29574
410275,201805,64,47,17,44838,16218,61056
410280,201805,324,185,139,176230.52,132606,308836.52
410290,201805,233,146,87,139284,82998,222282
410300,201805,80,64,16,61056,15264,76320
410302,201805,24,16,8,15264,7632,22896
410304,201805,46,32,14,30528,13356,43884
410305,201805,211,115,96,109042.2,91584,200626.2
410310,201805,264,168,96,160272,91564.92,251836.92
410315,201805,52,37,15,35274,14310,49584
410320,201805,140,99,41,94446,39114,133560
410322,201805,35,25,10,23850,9540,33390
410330,201805,167,119,48,113526,45602,159128
410335,201805,98,60,38,57240,36252,93492
410337,201805,38,33,5,31482,4770,36252
410340,201805,31,29,2,27666,1908,29574
410345,201805,219,138,81,131652,77274,208926
410347,201805,54,41,13,39114,12402,51516
410350,201805,226,136,90,129744,85860,215604
410360,201805,454,275,179,259806.4,170194,430000.4
410370,201805,2409,1027,1382,976163.32,1315648.82,2291812.14
410380,201805,222,146,76,139284,72504,211788
410390,201805,370,274,96,261392,91584,352976
410395,201805,34,22,12,20988,11448,32436
410400,201805,844,427,417,406029.2,397279,803308.2
410405,201805,91,70,21,66780,20034,86814
410410,201805,40,31,9,29574,8586,38160
410420,201805,1657,821,836,781139.89,796591,1577730.89
410425,201805,176,82,94,78038,89676,167714
410430,201805,2195,1292,903,1229420,860584.32,2090004.32
410440,201805,389,289,100,274753,95400,370153
410442,201805,357,240,117,228007,111618,339625
410445,201805,418,290,128,276660,122112,398772
410450,201805,412,210,202,200340,192708,393048
410460,201805,412,222,190,211492.8,181260,392752.8
410465,201805,186,119,67,112285.8,63918,176203.8
410470,201805,221,142,79,135468,75366,210834
410480,201805,5842,2886,2956,2734436.23,2814819.76,5549255.99
410490,201805,1398,922,476,878091,452197,1330288
410500,201805,267,151,116,144054,110664,254718
410510,201805,177,130,47,123447.6,44829,168276.6
410520,201805,257,191,66,182214,62964,245178
410530,201805,235,86,149,82044,142142,224186
410540,201805,319,230,89,218843.6,84901.23,303744.83
410550,201805,1620,701,919,668467.8,875526.36,1543994.16
410560,201805,146,114,32,108756,30528,139284
410570,201805,432,302,130,286020.2,124020,410040.2
410580,201805,3165,1422,1743,1354829.8,1661392,3016221.8
410590,201805,406,287,119,273798,113526,387324
410600,201805,185,159,26,151686,24804,176490
410610,201805,56,45,11,42930,10494,53424
410620,201805,244,175,69,166950,65826,232776
410630,201805,446,258,188,246132,178193,424325
410640,201805,987,609,378,576976.27,359005.28,935981.55
410645,201805,100,75,25,71169,23850,95019
410650,201805,364,249,115,236592,109710,346302
410655,201805,79,61,18,58194,17172,75366
410657,201805,45,19,26,18126,24804,42930
410660,201805,603,423,180,402013,171720,573733
410670,201805,77,64,13,61056,12402,73458
410680,201805,191,157,34,149111,32436,181547
410685,201805,17,11,6,10494,5724,16218
410690,201805,28217,12243,15974,11659879.21,15226400.1,26886279.31
410700,201805,323,235,88,223651,83952,307603
410710,201805,126,102,24,97308,22896,120204
410712,201805,25,15,10,14310,9540,23850
410715,201805,83,61,22,58194,20988,79182
410720,201805,602,359,243,342486,231813,574299
410725,201805,180,129,51,123066,48654,171720
410730,201805,86,52,34,49608,32436,82044
410740,201805,113,80,33,76320,31482,107802
410750,201805,217,162,55,154548,52465.23,207013.23
410752,201805,25,15,10,14310,9540,23850
410753,201805,54,24,30,22223.43,28620,50843.43
410754,201805,38,23,15,21561,14310,35871
410755,201805,80,55,25,52470,23850,76320
410760,201805,723,408,315,389207.56,300510,689717.56
410765,201805,1669,806,863,761980.68,822148.26,1584128.94
410770,201805,104,86,18,82044,17172,99216
410773,201805,46,34,12,32436,11448,43884
410775,201805,177,135,42,128122.2,40068,168190.2
410780,201805,78,42,36,40068,34344,74412
410785,201805,52,42,10,40068,9540,49608
410790,201805,71,34,37,32436,35298,67734
410800,201805,295,187,108,177445,103032,280477
410810,201805,26,22,4,20988,3530,24518
410820,201805,176,130,46,123877,43884,167761
410830,201805,8486,3861,4625,3673139.44,4409695.14,8082834.58
410832,201805,104,71,33,67734,31482,99216
410840,201805,1432,793,639,754254.08,608682.98,1362937.06
410845,201805,63,39,24,37206,22896,60102
410850,201805,189,130,59,123734,56286,180020
410855,201805,47,40,7,38160,6678,44838
410860,201805,668,391,277,372060.76,264258,636318.76
410865,201805,104,82,22,78228,20988,99216
410870,201805,159,135,24,128790,22605,151395
410880,201805,1123,562,561,535637.62,535130,1070767.62
410890,201805,77,54,23,51516,21942,73458
410895,201805,73,56,17,53424,16218,69642
410900,201805,20,13,7,12402,6678,19080
410910,201805,17,15,2,14310,1908,16218
410920,201805,33,22,11,20988,10494,31482
410930,201805,504,324,180,308884.98,171720,480604.98
410940,201805,4314,2568,1746,2440043.98,1662706.2,4102750.18
410950,201805,119,87,32,82998,30528,113526
410960,201805,766,341,425,325028,405260,730288
410965,201805,66,51,15,48367.8,14310,62677.8
410970,201805,626,450,176,428832.2,167904,596736.2
410975,201805,107,63,44,59591,41976,101567
410980,201805,1581,713,868,677655.82,827114,1504769.82
410990,201805,270,182,88,173628,83665.8,257293.8
411000,201805,63,40,23,38160,21942,60102
411005,201805,25,20,5,19080,4770,23850
411007,201805,240,140,100,133560,95400,228960
411010,201805,577,404,173,385416,165042,550458
411020,201805,298,207,91,197478,86814,284292
411030,201805,19,9,10,8586,9540,18126
411040,201805,50,36,14,34344,13356,47700
411050,201805,221,173,48,164406.72,45665.12,210071.84
411060,201805,512,342,170,326259,162180,488439
411065,201805,63,55,8,52470,7632,60102
411070,201805,1203,797,406,754419.31,386370,1140789.31
411080,201805,243,173,70,165125.95,66780,231905.95
411090,201805,116,88,28,83952,26712,110664
411095,201805,269,110,159,104463,151676,256139
411100,201805,113,94,19,89676,18126,107802
411110,201805,119,85,34,81090,32436,113526
411120,201805,183,136,47,129744,44838,174582
411125,201805,181,83,98,78533.28,93492,172025.28
411130,201805,126,107,19,101440,17839.8,119279.8
411140,201805,186,127,59,121136.12,55761.3,176897.42
411150,201805,1229,820,409,781602.66,390186,1171788.66
411155,201805,118,82,36,78228,34344,112572
411160,201805,21,10,11,9540,10494,20034
411170,201805,59,52,7,49321.8,6678,55999.8
411180,201805,950,625,325,595010,310045.23,905055.23
411190,201805,348,201,147,191086.2,140238,331324.2
411200,201805,670,442,228,420397.89,216368.3,636766.19
411210,201805,682,366,316,347614.21,301464,649078.21
411220,201805,146,110,36,104940,34344,139284
411230,201805,40,36,4,34344,3816,38160
411240,201805,121,83,38,79182,36252,115434
411250,201805,424,311,113,296694,107802,404496
411260,201805,22,15,7,14310,6678,20988
411270,201805,295,158,137,150732,130698,281430
411275,201805,203,179,24,170050.6,22896,192946.6
411280,201805,227,162,65,153277.12,62010,215287.12
411290,201805,58,43,15,41022,14310,55332
411295,201805,146,115,31,109710,29574,139284
411300,201805,71,37,34,35298,32436,67734
411310,201805,91,70,21,66780,20034,86814
411320,201805,757,546,211,519358.4,199691.28,719049.68
411325,201805,42,26,16,24804,15264,40068
411330,201805,917,589,328,560380.61,312754,873134.61
411340,201805,26,17,9,16218,8272,24490
411342,201805,73,54,19,51516,18126,69642
411345,201805,126,64,62,61056,59148,120204
411350,201805,486,388,98,368864.44,92529.2,461393.64
411360,201805,53,34,19,32436,18126,50562
411370,201805,14175,5786,8389,5498789.16,7987277.49,13486066.65
411373,201805,185,137,48,130698,45792,176490
411375,201805,72,60,12,57240,11448,68688
411380,201805,93,70,23,66780,21942,88722
411390,201805,136,90,46,85860,43884,129744
411400,201805,350,262,88,249939,83952,333891
411410,201805,452,231,221,219706.2,210548,430254.2
411420,201805,1025,472,553,447712.2,527085.2,974797.4
411430,201805,413,266,147,253096.2,140229,393325.2
411435,201805,35,24,11,22896,10494,33390
411440,201805,470,377,93,358004.76,88722,446726.76
411450,201805,427,354,73,337716,69642,407358
411460,201805,762,301,461,286257.64,438345.6,724603.24
411470,201805,86,64,22,61056,20988,82044
411480,201805,634,359,275,339720.4,262063.8,601784.2
411490,201805,293,183,110,174582,104940,279522
411500,201805,112,94,18,89472.33,16791,106263.33
411510,201805,215,174,41,165248.06,39114,204362.06
411520,201805,5918,2304,3614,2194004.8,3440285.76,5634290.56
411530,201805,110,75,35,71550,33390,104940
411535,201805,47,20,27,19080,25758,44838
411540,201805,348,243,105,230799.9,100170,330969.9
411545,201805,55,39,16,37206,15264,52470
411550,201805,73,56,17,53424,16218,69642
411560,201805,386,179,207,170102.38,197478,367580.38
411570,201805,775,296,479,282089,456776,738865
411573,201805,33,20,13,19080,12402,31482
411575,201805,264,164,100,156456,95400,251856
411580,201805,1254,504,750,478334.84,713652.4,1191987.24
411585,201805,81,41,40,39114,38160,77274
411590,201805,25,18,7,17172,6678,23850
411600,201805,26,10,16,9540,15264,24804
411605,201805,251,109,142,103539,135468,239007
411610,201805,234,160,74,152640,70596,223236
411620,201805,357,201,156,191277,148185,339462
411630,201805,58,39,19,37206,18126,55332
411640,201805,35,29,6,27666,5724,33390
411650,201805,12,8,4,7632,3816,11448
411660,201805,31,25,6,23850,5724,29574
411670,201805,246,187,59,178398,56286,234684
411680,201805,157,135,22,128790,20988,149778
411690,201805,600,316,284,300886.44,270590.32,571476.76
411695,201805,62,46,16,43884,15264,59148
411700,201805,163,141,22,134514,20988,155502
411705,201805,100,65,35,62010,33390,95400
411710,201805,301,202,99,191641.81,94446,286087.81
411720,201805,139,90,49,85860,46746,132606
411721,201805,63,52,11,49608,10494,60102
411722,201805,98,42,56,40068,53424,93492
411725,201805,149,116,33,110091.8,31482,141573.8
411727,201805,74,58,16,55332,14977.8,70309.8
411729,201805,32,25,7,23850,6678,30528
411730,201805,545,355,190,337079.96,180973.8,518053.76
411740,201805,36,22,14,20988,13356,34344
411745,201805,69,46,23,43093,21942,65035
411750,201805,871,415,456,394813.9,434055.69,828869.59
411760,201805,1190,896,294,853535.2,280467,1134002.2
411770,201805,444,296,148,282364.92,141192,423556.92
411780,201805,372,242,130,230868,124020,354888
411790,201805,532,298,234,282410.47,223123.14,505533.61
411800,201805,170,133,37,126882,35298,162180
411810,201805,167,128,39,122112,37206,159318
411820,201805,2085,1017,1068,967530.75,1018148.3,1985679.05
411830,201805,12,12,0,11448,0,11448
411840,201805,1963,1218,745,1159777.8,710237,1870014.8
411845,201805,50,19,31,18126,29574,47700
411850,201805,1237,711,526,676735.94,499851.02,1176586.96
411860,201805,43,28,15,26426,14310,40736
411870,201805,74,54,20,51516,18793.8,70309.8
411880,201805,428,274,154,261282,146171.88,407453.88
411885,201805,103,68,35,64872,33390,98262
411890,201805,321,205,116,194330.45,110654.46,304984.91
411900,201805,69,51,18,48654,17172,65826
411910,201805,176,142,34,135458.46,31596.48,167054.94
411915,201805,2113,905,1208,862217.57,1151368.05,2013585.62
411920,201805,126,104,22,99216,20988,120204
411925,201805,14,9,5,8586,4770,13356
411930,201805,803,591,212,561908,202248,764156
411940,201805,588,419,169,399249,161201.56,560450.56
411950,201805,902,481,421,458206.2,400966.2,859172.4
411960,201805,981,691,290,656201.56,276660,932861.56
411965,201805,24,16,8,15264,7632,22896
411970,201805,73,65,8,62010,7632,69642
411980,201805,196,127,69,121158,65826,186984
411990,201805,5013,2902,2111,2751566.57,2012173.41,4763739.98
411995,201805,461,173,288,165042,274752,439794
412000,201805,301,177,124,167952.76,118286.46,286239.22
412010,201805,47,29,18,27380,17172,44552
412015,201805,45,31,14,29574,13356,42930
412020,201805,25,22,3,20701.8,2862,23563.8
412030,201805,60,51,9,48654,8586,57240
412033,201805,55,36,19,34320,18126,52446
412035,201805,68,43,25,41022,23850,64872
412040,201805,36,25,11,23564,10494,34058
412050,201805,201,151,50,144054,47700,191754
412060,201805,750,585,165,555228.74,156419.8,711648.54
412065,201805,50,34,16,32436,15264,47700
412070,201805,156,104,52,98548.2,49608,148156.2
412080,201805,281,147,134,140238,127836,268074
412085,201805,33,16,17,15264,16218,31482
412090,201805,752,475,277,451481.2,264258,715739.2
412100,201805,249,209,40,198433,38160,236593
412110,201805,71,57,14,54378,13356,67734
412120,201805,310,205,105,194997.6,100170,295167.6
412125,201805,78,46,32,43597.8,30528,74125.8
412130,201805,47,36,11,33753,10494,44247
412135,201805,29,16,13,15264,12402,27666
412140,201805,315,224,91,213056.82,86814,299870.82
412150,201805,255,174,81,165042.04,77274,242316.04
412160,201805,84,50,34,47700,32436,80136
412170,201805,657,458,199,436645.8,189846,626491.8
412175,201805,38,28,10,26712,9540,36252
412180,201805,198,158,40,150132.61,37539.9,187672.51
412190,201805,334,266,68,253091.43,64872,317963.43
412200,201805,196,122,74,116388,70596,186984
412210,201805,73,56,17,53424,16218,69642
412215,201805,241,166,75,158077.8,71263.8,229341.6
412217,201805,71,55,16,52470,15264,67734
412220,201805,827,618,209,589572,199386,788958
412230,201805,340,207,133,195856.2,126845.46,322701.66
412240,201805,1325,649,676,616253.18,642823.44,1259076.62
412250,201805,384,248,136,236592,129744,366336
412260,201805,127,93,34,88722,32436,121158
412265,201805,169,133,36,126277.84,34344,160621.84
412270,201805,85,54,31,51516,29574,81090
412280,201805,90,71,19,67734,18126,85860
412290,201805,95,64,31,61056,29574,90630
412300,201805,217,141,76,134514,72360.9,206874.9
412310,201805,43,37,6,35298,5724,41022
412320,201805,93,79,14,75366,13356,88722
412330,201805,169,151,18,144054,17172,161226
412340,201805,147,102,45,97308,42644,139952
412350,201805,602,304,298,288704.3,284292,572996.3
412360,201805,28,25,3,23850,2862,26712
412370,201805,160,138,22,130698,20988,151686
412380,201805,254,192,62,182881.8,59044,241925.8
412382,201805,50,26,24,24804,22896,47700
412385,201805,144,104,40,99216,38160,137376
412390,201805,280,212,68,202248,64872,267120
412395,201805,65,52,13,49608,12402,62010
412400,201805,72,53,19,50562,18126,68688
412402,201805,252,119,133,113521.23,126595.8,240117.03
412405,201805,820,326,494,308310.08,470590.66,778900.74
412410,201805,941,594,347,563814.6,331038,894852.6
412420,201805,14,12,2,11448,1908,13356
412430,201805,20,14,6,13356,5724,19080
412440,201805,597,321,276,303970.82,261463.96,565434.78
412450,201805,81,68,13,64872,12402,77274
412460,201805,79,62,17,59148,16218,75366
412470,201805,262,208,54,197668.8,51516,249184.8
412480,201805,172,131,41,124020.9,39114,163134.9
412490,201805,166,142,24,135468,22896,158364
412500,201805,471,383,88,363807.8,83952,447759.8
412510,201805,187,154,33,146169,31482,177651
412520,201805,136,75,61,71550,58194,129744
412530,201805,109,58,51,55332,48367.8,103699.8
412535,201805,105,77,28,73440,26712,100152
412540,201805,67,33,34,31482,32436,63918
412545,201805,98,72,26,68688,24804,93492
412550,201805,3541,1599,1942,1519684.74,1850284.9,3369969.64
412555,201805,15,10,5,9540,4770,14310
412560,201805,589,440,149,417170.2,142146,559316.2
412570,201805,738,407,331,386427.24,315488,701915.24
412575,201805,83,58,25,55332,23850,79182
412580,201805,161,107,54,102078,51516,153594
412590,201805,34,32,2,30528,1908,32436
412600,201805,177,135,42,128790,40068,168858
412610,201805,31,19,12,18126,11448,29574
412620,201805,148,131,17,124974,16218,141192
412625,201805,2189,1172,1017,1115286.21,968340.59,2083626.80
412627,201805,69,55,14,52470,13356,65826
412630,201805,425,286,139,271310.43,132320,403630.43
412635,201805,66,20,46,19080,43884,62964
412640,201805,120,80,40,76320,38160,114480
412650,201805,345,216,129,206064,123061.23,329125.23
412660,201805,484,296,188,281669,179352,461021
412665,201805,51,45,6,42930,5724,48654
412667,201805,284,193,91,183303.1,86547.8,269850.9
412670,201805,61,52,9,49608,8586,58194
412680,201805,295,233,62,222282,59148,281430
412690,201805,114,73,41,69642,38828,108470
412700,201805,163,112,51,106848,48368,155216
412710,201805,1404,870,534,823972.6,507528.2,1331500.8
412720,201805,230,158,72,150732,68688,219420
412730,201805,200,160,40,152640,37206,189846
412740,201805,420,227,193,216414.9,184122,400536.9
412750,201805,468,270,198,256626,188892,445518
412760,201805,262,135,127,128790,121158,249948
412770,201805,2117,1196,921,1136600.94,876804,2013404.94
412780,201805,155,123,32,117342,30528,147870
412785,201805,276,140,136,133083,129744,262827
412788,201805,38,23,15,21942,14310,36252
412790,201805,139,114,25,108088.2,23850,131938.2
412795,201805,154,113,41,107802,39114,146916
412796,201805,301,211,90,200129.18,85726.44,285855.62
412800,201805,556,364,192,346696.39,183168,529864.39
412810,201805,3012,1666,1346,1583813.3,1282839.03,2866652.33
412820,201805,930,609,321,570053.79,304374.09,874427.88
412830,201805,15,12,3,11448,2862,14310
412840,201805,219,156,63,147870.2,60102,207972.2
412850,201805,784,533,251,506574,239454,746028
412853,201805,173,93,80,88722,76320,165042
412855,201805,212,116,96,109552.82,91584,201136.82
412860,201805,92,69,23,65826,21942,87768
412862,201805,59,44,15,41739.32,14310,56049.32
412863,201805,6,5,1,4770,954,5724
412865,201805,44,33,11,31482,10494,41976
412870,201805,107,71,36,67734,34344,102078
412880,201805,100,75,25,71550,23850,95400
420005,201805,38,34,4,32436,3244,35680
420010,201805,364,237,127,224910.34,120872,345782.34
420020,201805,76,64,12,61056,11448,72504
420030,201805,29,26,3,24804,2862,27666
420040,201805,106,81,25,77274,23850,101124
420050,201805,55,33,22,31482,20988,52470
420055,201805,20,19,1,18126,954,19080
420060,201805,33,23,10,21942,9540,31482
420070,201805,105,90,15,85860,14300.46,100160.46
420075,201805,13,11,2,10494,1908,12402
420080,201805,50,44,6,40306.5,5724,46030.5
420090,201805,34,32,2,29750.49,1908,31658.49
420100,201805,164,136,28,128790.2,26712,155502.2
420110,201805,20,20,0,19080,0,19080
420120,201805,49,38,11,36252,10494,46746
420125,201805,85,68,17,64872,16218,81090
420127,201805,35,31,4,29574,3816,33390
420130,201805,390,248,142,236296.46,135219.96,371516.42
420140,201805,1289,748,541,712267.38,516048,1228315.38
420150,201805,45,40,5,38160,4770,42930
420160,201805,38,36,2,34344,1908,36252
420165,201805,18,13,5,12402,4770,17172
420170,201805,65,42,23,40068,21942,62010
420180,201805,22,21,1,20034,954,20988
420190,201805,31,28,3,26712,2862,29574
420195,201805,127,59,68,56286,64872,121158
420200,201805,1284,575,709,543209.6,675281.3,1218490.9
420205,201805,67,35,32,33390,30528,63918
420207,201805,107,62,45,59148,42920.46,102068.46
420208,201805,24,19,5,18126,3911.4,22037.4
420209,201805,20,16,4,15264,3816,19080
420210,201805,465,221,244,210547.8,232681.14,443228.94
420213,201805,44,35,9,33390,8586,41976
420215,201805,26,22,4,20988,3816,24804
420220,201805,68,43,25,41022,23850,64872
420230,201805,772,438,334,417089,318054.46,735143.46
420240,201805,2298,1548,750,1469224.11,715061.16,2184285.27
420243,201805,38,31,7,29574,6678,36252
420245,201805,112,63,49,60102,46746,106848
420250,201805,53,31,22,29574,20988,50562
420253,201805,39,32,7,30528,6678,37206
420257,201805,11,9,2,8586,1908,10494
420260,201805,98,86,12,82044,11448,93492
420270,201805,37,30,7,28616,6678,35294
420280,201805,279,205,74,193855.06,69338.1,263193.16
420285,201805,18,12,6,11448,5724,17172
420287,201805,49,30,19,28620,18126,46746
420290,201805,966,680,286,646780.18,272776.3,919556.48
420300,201805,1385,1097,288,1041960.4,272272.14,1314232.54
420310,201805,58,45,13,42930,12402,55332
420315,201805,35,31,4,29574,3816,33390
420320,201805,852,434,418,413058.15,398768,811826.15
420325,201805,0,0,0,0,0,0
420330,201805,122,83,39,79182,37091.52,116273.52
420340,201805,157,107,50,101116,47680.92,148796.92
420350,201805,249,183,66,172961,62964,235925
420360,201805,753,573,180,544716.16,170099.78,714815.94
420370,201805,110,71,39,67544,36920,104464
420380,201805,1140,815,325,773686.5,309013.04,1082699.54
420390,201805,255,163,92,154243.52,87052.5,241296.02
420395,201805,186,133,53,126118.8,49789.26,175908.06
420400,201805,244,182,62,173056,59148,232204
420410,201805,61,48,13,45792,12402,58194
420415,201805,35,32,3,30528,2862,33390
420417,201805,47,35,12,33390,11428.92,44818.92
420419,201805,12,12,0,11448,0,11448
420420,201805,2800,1724,1076,1632360.57,1024216.42,2656576.99
420425,201805,72,61,11,58185,10180.26,68365.26
420430,201805,1281,893,388,847929.02,368406.18,1216335.20
420435,201805,16,14,2,13356,1908,15264
420440,201805,108,73,35,69014.68,33238.6,102253.28
420445,201805,23,20,3,19080,2862,21942
420450,201805,79,38,41,36243,39114,75357
420455,201805,254,190,64,181231.92,60964.38,242196.30
420460,201805,2351,1569,782,1492428.1,745794.9,2238223.0
420470,201805,118,84,34,80136,32436,112572
420475,201805,6,6,0,5724,0,5724
420480,201805,869,648,221,612736.12,209785.2,822521.32
420490,201805,111,87,24,82998,22896,105894
420500,201805,672,291,381,275643.2,363474,639117.2
420510,201805,19,16,3,15264,2862,18126
420515,201805,26,20,6,19080,5724,24804
420517,201805,12,12,0,11448,0,11448
420519,201805,0,0,0,0,0,0
420520,201805,69,52,17,49608,16218,65826
420530,201805,167,114,53,107781.02,50562,158343.02
420535,201805,21,19,2,18126,1908,20034
420540,201805,4924,2908,2016,2762132.28,1917961.98,4680094.26
420543,201805,24,24,0,22896,0,22896
420545,201805,195,139,56,131358.96,53404.92,184763.88
420550,201805,853,686,167,652499.32,159160.73,811660.05
420555,201805,40,28,12,26712,11448,38160
420560,201805,65,52,13,49226.4,12402,61628.4
420570,201805,144,84,60,80136,57230.46,137366.46
420580,201805,295,131,164,124974,156170,281144
420590,201805,513,366,147,348877.8,139857,488734.8
420600,201805,96,49,47,46746,44838,91584
420610,201805,37,35,2,33104,1908,35012
420620,201805,76,62,14,59148,13356,72504
420630,201805,154,113,41,107793.23,39106,146899.23
420640,201805,93,83,10,78991.2,9540,88531.2
420650,201805,244,130,114,123352.2,108137.23,231489.43
420660,201805,53,41,12,38350.8,11448,49798.8
420665,201805,37,28,9,26426,8586,35012
420670,201805,320,242,78,230142.96,74393.46,304536.42
420675,201805,15,14,1,13356,954,14310
420680,201805,35,25,10,23850,9540,33390
420690,201805,176,147,29,140238,27666,167904
420700,201805,649,442,207,421566.3,197225.28,618791.58
420710,201805,152,90,62,85860,58861.8,144721.8
420720,201805,109,87,22,82988.46,20988,103976.46
420730,201805,540,344,196,327118.5,185689.12,512807.62
420740,201805,47,46,1,43884,954,44838
420750,201805,503,338,165,322165.8,157410,479575.8
420757,201805,19,16,3,14453.1,2862,17315.1
420760,201805,39,32,7,30528,6678,37206
420765,201805,70,57,13,54378,12402,66780
420768,201805,65,58,7,55332,6678,62010
420770,201805,84,70,14,66780,13356,80136
420775,201805,47,44,3,41022,2862,43884
420780,201805,240,187,53,178388.46,50562,228950.46
420785,201805,14,10,4,9540,3816,13356
420790,201805,180,150,30,142998.3,27638.46,170636.76
420800,201805,75,57,18,53614.8,17172,70786.8
420810,201805,250,214,36,204147,33533.1,237680.1
420820,201805,2324,1386,938,1315890.66,893310.8,2209201.46
420830,201805,583,326,257,308700.95,244214.46,552915.41
420840,201805,150,112,38,106848,35548,142396
420845,201805,450,198,252,188288.07,239168,427456.07
420850,201805,234,188,46,179352,43884,223236
420860,201805,62,53,9,50562,8586,59148
420870,201805,118,85,33,81090,31482,112572
420880,201805,172,121,51,115424.46,48654,164078.46
420890,201805,869,428,441,404270.84,420132.8,824403.64
420895,201805,10,10,0,9540,0,9540
420900,201805,425,331,94,313715.04,89647.92,403362.96
420910,201805,5835,3278,2557,3115468.78,2434408.04,5549876.82
420915,201805,78,71,7,67734,6678,74412
420917,201805,19,14,5,13356,4770,18126
420920,201805,23,16,7,15264,6678,21942
420930,201805,2640,1609,1031,1528465.74,977702.34,2506168.08
420940,201805,615,445,170,423185.6,160528.08,583713.68
420945,201805,8,6,2,5724,1908,7632
420950,201805,56,51,5,48654,4770,53424
420960,201805,115,90,25,85822.92,23841,109663.92
420970,201805,304,244,60,231100.85,57212.46,288313.31
420980,201805,23,23,0,21942,0,21942
420985,201805,63,55,8,52470,7632,60102
420990,201805,71,56,15,53424,14310,67734
421000,201805,33,22,11,20988,10494,31482
421003,201805,68,44,24,41976,22887,64863
421005,201805,8,5,3,4770,2862,7632
421010,201805,771,543,228,516773,215452,732225
421020,201805,30,25,5,23850,4770,28620
421030,201805,131,111,20,105894,19080,124974
421040,201805,71,60,11,57240,10494,67734
421050,201805,318,231,87,218275.2,82998,301273.2
421055,201805,24,20,4,19080,3816,22896
421060,201805,81,56,25,53424,23850,77274
421070,201805,52,47,5,44838,4770,49608
421080,201805,36,32,4,30528,3816,34344
421085,201805,25,20,5,19080,4770,23850
421090,201805,43,32,11,30528,10494,41022
421100,201805,129,95,34,90630,32436,123066
421105,201805,220,179,41,170336.8,39090.69,209427.49
421110,201805,109,88,21,83952,20034,103986
421120,201805,153,119,34,113030.46,32416.92,145447.38
421125,201805,14,10,4,9540,3816,13356
421130,201805,820,528,292,502582.05,277528.54,780110.59
421140,201805,32,23,9,21226.5,8586,29812.5
421145,201805,40,31,9,29574,8586,38160
421150,201805,108,78,30,74412,28620,103032
421160,201805,61,40,21,38150.46,20034,58184.46
421165,201805,18,17,1,16218,954,17172
421170,201805,190,166,24,157336.84,22887,180223.84
421175,201805,150,97,53,92538,50523.92,143061.92
421180,201805,57,36,21,33982,20034,54016
421185,201805,17,14,3,13356,2862,16218
421187,201805,0,0,0,0,0,0
421189,201805,38,30,8,28620,7622.46,36242.46
421190,201805,1536,950,586,905337.46,558347.58,1463685.04
421200,201805,88,66,22,62010.7,20988,82998.7
421205,201805,27,18,9,17172,8576.46,25748.46
421210,201805,183,123,60,117342,57240,174582
421220,201805,278,220,58,209259.9,55332,264591.9
421223,201805,55,46,9,43603,8586,52189
421225,201805,63,40,23,38160,21942,60102
421227,201805,93,70,23,66780,21942,88722
421230,201805,49,36,13,34344,12402,46746
421240,201805,18,18,0,17172,0,17172
421250,201805,357,222,135,210454,127998.18,338452.18
421260,201805,28,23,5,21942,4770,26712
421265,201805,0,0,0,0,0,0
421270,201805,53,47,6,44838,5724,50562
421280,201805,335,189,146,180283,137566.8,317849.8
421290,201805,322,210,112,200102,105437.76,305539.76
421300,201805,26,20,6,19080,5724,24804
421310,201805,55,42,13,39400.2,12402,51802.2
421315,201805,29,20,9,19080,8586,27666
421320,201805,133,93,40,88722,38160,126882
421330,201805,108,82,26,76110.12,24795,100905.12
421335,201805,40,26,14,24804,13356,38160
421340,201805,293,200,93,189036.05,88722,277758.05
421350,201805,177,103,74,97819,70596,168415
421360,201805,693,509,184,480229.68,174755.06,654984.74
421370,201805,198,153,45,145962,42596.1,188558.1
421380,201805,128,103,25,98257.23,23850,122107.23
421390,201805,17,13,4,12402,3816,16218
421400,201805,115,97,18,92538,17172,109710
421410,201805,24,19,5,18126,4770,22896
421415,201805,22,21,1,20034,954,20988
421420,201805,150,123,27,116769.6,25471.8,142241.4
421430,201805,15,12,3,11448,2862,14310
421440,201805,56,43,13,41022,12402,53424
421450,201805,98,85,13,81090,12402,93492
421460,201805,58,49,9,45941.77,8586,54527.77
421470,201805,68,44,24,41976,22896,64872
421480,201805,637,472,165,449525,157401,606926
421490,201805,22,21,1,19358,954,20312
421500,201805,521,334,187,316833.19,178110.9,494944.09
421505,201805,25,19,6,18126,5724,23850
421507,201805,33,27,6,25758,5724,31482
421510,201805,72,46,26,43884,24804,68688
421520,201805,67,58,9,54569,8586,63155
421530,201805,54,49,5,46746,4770,51516
421535,201805,27,26,1,24537,954,25491
421540,201805,59,51,8,48654,7632,56286
421545,201805,96,73,23,69156,21942,91098
421550,201805,286,208,78,197765,74412,272177
421555,201805,28,22,6,20988,5629,26617
421560,201805,8,7,1,6678,954,7632
421565,201805,125,92,33,87768,31482,119250
421567,201805,31,26,5,24804,4770,29574
421568,201805,33,31,2,29574,1908,31482
421569,201805,8,8,0,7632,0,7632
421570,201805,149,101,48,96354,45792,142146
421575,201805,26,21,5,19771.65,4770,24541.65
421580,201805,723,431,292,409553,277614.34,687167.34
421590,201805,21,20,1,19080,954,20034
421600,201805,107,73,34,69642,31197,100839
421605,201805,104,74,30,70263,28620,98883
421610,201805,188,149,39,141192.5,37206,178398.5
421620,201805,1105,662,443,629048.92,422602.92,1051651.84
421625,201805,23,20,3,19080,2862,21942
421630,201805,283,182,101,172817.8,95496,268313.8
421635,201805,16,8,8,7632,7632,15264
421640,201805,98,84,14,80136,13356,93492
421650,201805,279,166,113,158344.92,107782.92,266127.84
421660,201805,2113,1268,845,1206755.2,805530.26,2012285.46
421670,201805,186,131,55,124974,52470,177444
421680,201805,169,153,16,145962,15255,161217
421690,201805,358,245,113,232749,106838.58,339587.58
421700,201805,58,36,22,34344,20130,54474
421710,201805,24,24,0,22896,0,22896
421715,201805,9,8,1,7632,954,8586
421720,201805,590,427,163,404759.4,153775.26,558534.66
421725,201805,14,7,7,6678,6678,13356
421730,201805,40,28,12,26004.12,11448,37452.12
421740,201805,86,41,45,39114,42930,82044
421750,201805,224,166,58,155918.51,55332,211250.51
421755,201805,26,24,2,22896,1908,24804
421760,201805,104,74,30,70596,28620,99216
421770,201805,574,388,186,367668.38,177369.3,545037.68
421775,201805,30,20,10,19080,9540,28620
421780,201805,198,156,42,148824,40068,188892
421790,201805,158,133,25,125989.5,23850,149839.5
421795,201805,16,13,3,12402,2862,15264
421800,201805,479,309,170,293989.31,162180,456169.31
421810,201805,68,54,14,51516,13356,64872
421820,201805,315,216,99,205396.2,94446,299842.2
421825,201805,126,105,21,100170,20034,120204
421830,201805,129,97,32,92538,30528,123066
421835,201805,3,3,0,2862,0,2862
421840,201805,60,50,10,47691,9540,57231
421850,201805,77,67,10,63918,9536,73454
421860,201805,41,32,9,30528,8586,39114
421870,201805,980,748,232,704713.7,220543.42,925257.12
421875,201805,52,46,6,43884,5724,49608
421880,201805,163,120,43,114480,40736,155216
421885,201805,27,22,5,20988,4770,25758
421890,201805,115,81,34,77274,32436,109710
421895,201805,43,40,3,38160,2862,41022
421900,201805,155,126,29,119843.1,27630,147473.1
421910,201805,65,43,22,41022,20988,62010
421915,201805,33,27,6,25758,5724,31482
421917,201805,41,31,10,29574,9540,39114
421920,201805,34,31,3,29574,2862,32436
421930,201805,742,574,168,545569.26,160245,705814.26
421935,201805,57,50,7,47700,6678,54378
421940,201805,40,37,3,35298,2862,38160
421950,201805,828,544,284,513120.1,268461.32,781581.42
421960,201805,41,35,6,33104,5702.12,38806.12
421970,201805,375,234,141,222737.12,134483.12,357220.24
421985,201805,31,20,11,19080,10494,29574
422000,201805,0,0,0,0,0,0
430003,201805,208,51,157,47938.5,149778,197716.5
430005,201805,35,27,8,25758,7632,33390
430010,201805,275,192,83,182691,79182,261873
430020,201805,153,99,54,94160,50562,144722
430030,201805,130,102,28,97021.8,26712,123733.8
430040,201805,2982,1735,1247,1647091.84,1187942.12,2835033.96
430045,201805,69,59,10,56000,9540,65540
430047,201805,6,5,1,4770,954,5724
430050,201805,80,67,13,63918,12402,76320
430055,201805,17,14,3,13356,2862,16218
430057,201805,4,2,2,1908,1908,3816
430060,201805,3680,2201,1479,2092510.92,1407478.28,3499989.20
430063,201805,61,56,5,53424,4770,58194
430064,201805,149,124,25,118296,23850,142146
430066,201805,10,7,3,6678,2862,9540
430070,201805,43,33,10,31482,9540,41022
430080,201805,67,45,22,42230.33,20988,63218.33
430085,201805,35,13,22,12402,20988,33390
430087,201805,34,26,8,24661,7632,32293
430090,201805,72,65,7,61723.8,6678,68401.8
430100,201805,127,86,41,81090,39114,120204
430105,201805,144,71,73,67257,69336.72,136593.72
430107,201805,20,15,5,14310,4770,19080
430110,201805,415,242,173,230057.1,164975.22,395032.32
430120,201805,140,129,11,122112,10494,132606
430130,201805,800,503,297,479241.9,283051.8,762293.7
430140,201805,125,115,10,109710,9540,119250
430150,201805,112,72,40,67925,37206,105131
430155,201805,31,28,3,26712,2862,29574
430160,201805,3803,2251,1552,2128882.22,1478442.62,3607324.84
430163,201805,328,148,180,140143.34,171662.76,311806.10
430165,201805,25,17,8,16218,7632,23850
430170,201805,83,75,8,71550,7632,79182
430175,201805,84,66,18,62964,16504.2,79468.2
430180,201805,104,81,23,77274,21321.9,98595.9
430185,201805,33,25,8,23850,7632,31482
430187,201805,102,43,59,41022,55980.8,97002.8
430190,201805,219,124,95,118248.3,89953.46,208201.76
430192,201805,15,14,1,13356,954,14310
430195,201805,13,8,5,7632,4770,12402
430200,201805,167,148,19,140524.2,18126,158650.2
430205,201805,20,19,1,18126,954,19080
430210,201805,632,491,141,464693.4,132653.9,597347.3
430215,201805,16,11,5,10494,4770,15264
430220,201805,67,48,19,45792,18126,63918
430222,201805,13,7,6,6678,5724,12402
430223,201805,15,8,7,7632,6678,14310
430225,201805,4,3,1,2862,954,3816
430230,201805,300,184,116,174582,110664,285246
430235,201805,53,38,15,36252,14300.46,50552.46
430237,201805,29,22,7,20988,6678,27666
430240,201805,132,84,48,79945.2,45792,125737.2
430245,201805,71,60,11,57240,10494,67734
430250,201805,190,109,81,103976.46,77264.46,181240.92
430258,201805,13,11,2,10494,1908,12402
430260,201805,35,30,5,28620,4760.46,33380.46
430265,201805,34,29,5,27646.92,4770,32416.92
430270,201805,559,414,145,391706.54,137473.02,529179.56
430280,201805,1040,635,405,601315.74,383870.6,985186.34
430290,201805,377,219,158,207018.8,150732,357750.8
430300,201805,2135,1179,956,1119053.24,908974.35,2028027.59
430310,201805,1980,1042,938,987783.4,891819.93,1879603.33
430320,201805,49,41,8,39099.69,7632,46731.69
430330,201805,95,85,10,80613,9520.92,90133.92
430340,201805,66,58,8,55332,7632,62964
430350,201805,1683,1167,516,1101842.38,490490.64,1592333.02
430355,201805,26,23,3,21942,2862,24804
430360,201805,81,39,42,37206,40068,77274
430367,201805,27,19,8,18126,7632,25758
430370,201805,54,46,8,43884,7632,51516
430380,201805,130,97,33,91965.6,31482,123447.6
430390,201805,621,387,234,368864.1,222931.46,591795.56
430400,201805,141,109,32,102268.8,30508.92,132777.72
430410,201805,61,48,13,45792,12402,58194
430420,201805,496,325,171,307570.8,160874.36,468445.16
430430,201805,54,52,2,48972.63,1908,50880.63
430435,201805,156,116,40,109710,37444.5,147154.5
430440,201805,496,329,167,313866,159127.2,472993.2
430450,201805,1197,986,211,933661.46,201284.46,1134945.92
430460,201805,5085,2791,2294,2647306.79,2183219.63,4830526.42
430461,201805,17,15,2,14310,1908,16218
430462,201805,9,6,3,5724,2862,8586
430463,201805,1030,546,484,518460.92,461384.1,979845.02
430465,201805,25,14,11,13356,10494,23850
430466,201805,667,480,187,456012.2,178207.2,634219.4
430467,201805,100,57,43,53137.8,41012.46,94150.26
430468,201805,111,71,40,67734,37908.91,105642.91
430469,201805,22,17,5,16218,4770,20988
430470,201805,1162,643,519,607737.55,493170.3,1100907.85
430471,201805,49,37,12,35278.92,11448,46726.92
430480,201805,92,55,37,51611.4,35288.46,86899.86
430485,201805,6,6,0,5438,0,5438
430490,201805,89,71,18,66923.7,17172,84095.7
430495,201805,40,30,10,28620,9540,38160
430500,201805,193,130,63,124020,59726.46,183746.46
430510,201805,3133,2079,1054,1975825.95,1004343.12,2980169.07
430511,201805,18,18,0,17172,0,17172
430512,201805,136,95,41,90630,39114,129744
430513,201805,54,46,8,43407,7632,51039
430515,201805,32,30,2,28620,1908,30528
430517,201805,169,149,20,141192,19060.92,160252.92
430520,201805,367,257,110,244511,104911.38,349422.38
430530,201805,89,53,36,50562,34344,84906
430535,201805,477,317,160,302218.43,152616.15,454834.58
430537,201805,10,10,0,9540,0,9540
430540,201805,71,48,23,45792,21942,67734
430543,201805,368,110,258,104940,246132,351072
430544,201805,42,39,3,37206,2862,40068
430545,201805,355,170,185,161684,175959.58,337643.58
430550,201805,43,36,7,34344,6678,41022
430558,201805,5,3,2,2862,1908,4770
430560,201805,48,20,28,19080,26712,45792
430570,201805,105,45,60,42930,57182.76,100112.76
430580,201805,123,96,27,91584,25710.3,117294.3
430583,201805,14,14,0,13356,0,13356
430585,201805,9,4,5,3816,4770,8586
430587,201805,14,8,6,7632,5724,13356
430590,201805,155,125,30,118009.8,28620,146629.8
430593,201805,4,4,0,3816,0,3816
430595,201805,17,13,4,12402,3816,16218
430597,201805,53,29,24,27666,22896,50562
430600,201805,220,156,64,148814.46,60769.8,209584.26
430605,201805,161,102,59,97308,56276.46,153584.46
430607,201805,26,21,5,20034,4770,24804
430610,201805,1641,770,871,731852.26,826603.78,1558456.04
430613,201805,3,3,0,2862,0,2862
430620,201805,114,83,31,79038.9,29564.46,108603.36
430630,201805,46,40,6,38160,5724,43884
430632,201805,32,27,5,25758,4770,30528
430635,201805,40,36,4,34344,3816,38160
430637,201805,57,33,24,31482,22896,54378
430640,201805,207,114,93,107325,88722,196047
430642,201805,27,25,2,23850,1908,25758
430645,201805,35,30,5,28620,4770,33390
430650,201805,255,204,51,194330,48606.3,242936.3
430655,201805,3,3,0,2862,0,2862
430660,201805,968,474,494,450621.9,469749.8,920371.7
430670,201805,73,51,22,48654,20988,69642
430673,201805,72,39,33,37206,31482,68688
430675,201805,13,10,3,9540,2862,12402
430676,201805,493,300,193,285475.04,184051.07,469526.11
430680,201805,250,174,76,163516,72504,236020
430690,201805,532,315,217,299623.32,205343.06,504966.38
430692,201805,7,5,2,4770,1908,6678
430693,201805,144,96,48,91584,45782.46,137366.46
430695,201805,73,65,8,61075.08,7632,68707.08
430697,201805,57,34,23,32436,21942,54378
430700,201805,1590,1117,473,1053877.8,450956,1504833.8
430705,201805,20,19,1,18126,954,19080
430710,201805,261,168,93,160272,88722,248994
430720,201805,108,92,16,87577.2,15264,102841.2
430730,201805,121,102,19,96354,18018.8,114372.8
430740,201805,66,44,22,41976,20988,62964
430745,201805,36,29,7,27380,6678,34058
430750,201805,338,227,111,215614.64,104940,320554.64
430755,201805,84,47,37,44838,35298,80136
430760,201805,371,225,146,211979.72,139255.92,351235.64
430770,201805,1469,755,714,717599.78,676650.77,1394250.55
430780,201805,315,202,113,191726.72,107735.76,299462.48
430781,201805,29,23,6,21942,5724,27666
430783,201805,51,41,10,38796.13,9540,48336.13
430786,201805,6,3,3,2862,2862,5724
430790,201805,505,327,178,310686.12,169516.46,480202.58
430800,201805,154,128,26,122092.92,24804,146896.92
430805,201805,41,37,4,35298,3816,39114
430807,201805,36,22,14,20988,13356,34344
430810,201805,73,47,26,44838,24804,69642
430820,201805,135,84,51,80136,47986.2,128122.2
430825,201805,12,10,2,9540,1908,11448
430830,201805,233,220,13,209574.92,12402,221976.92
430840,201805,128,87,41,82998,38446.2,121444.2
430843,201805,5,3,2,2862,1908,4770
430845,201805,69,39,30,37206,28620,65826
430850,201805,572,396,176,375942.78,167800.76,543743.54
430860,201805,153,98,55,92824.2,51792.66,144616.86
430865,201805,66,36,30,33676.2,28305.18,61981.38
430870,201805,81,66,15,62296.2,14310,76606.2
430880,201805,160,119,41,113506.92,39114,152620.92
430885,201805,7,6,1,5724,954,6678
430890,201805,335,204,131,192956.04,124974,317930.04
430900,201805,539,371,168,349736.4,159785.46,509521.86
430905,201805,89,37,52,35298,49608,84906
430910,201805,265,148,117,141192,110942,252134
430912,201805,4,4,0,3816,0,3816
430915,201805,36,28,8,26712,7345.8,34057.8
430920,201805,4262,2376,1886,2259525.61,1796508.62,4056034.23
430925,201805,5,4,1,3567.96,954,4521.96
430930,201805,2107,1252,855,1186091.8,815423.43,2001515.23
430940,201805,243,153,90,145284.66,85840.92,231125.58
430950,201805,156,127,29,121158,27666,148824
430955,201805,22,14,8,13356,7632,20988
430957,201805,18,17,1,16218,954,17172
430960,201805,237,158,79,148299.3,75366,223665.3
430965,201805,107,68,39,64872,37206,102078
430970,201805,78,65,13,62010,11448,73458
430975,201805,37,33,4,31482,3816,35298
430980,201805,46,28,18,26712,17172,43884
430990,201805,116,88,28,83952,26712,110664
430995,201805,113,109,4,102745.8,3816,106561.8
431000,201805,299,138,161,129505.2,153594,283099.2
431010,201805,340,206,134,195541.38,127836,323377.38
431020,201805,1932,1124,808,1064020.62,766720.26,1830740.88
431030,201805,43,34,9,32436,8586,41022
431033,201805,387,194,193,184265.2,184122,368387.2
431036,201805,16,9,7,8586,6678,15264
431040,201805,129,78,51,73458,48544.29,122002.29
431041,201805,36,24,12,22896,11448,34344
431043,201805,46,26,20,24804,19080,43884
431046,201805,12,7,5,6678,4770,11448
431050,201805,206,130,76,123446.37,71502.3,194948.67
431053,201805,76,46,30,43120.8,28620,71740.8
431055,201805,64,43,21,41022,20014.92,61036.92
431057,201805,17,17,0,16218,0,16218
431060,201805,1675,1057,618,1000433.36,587720.44,1588153.80
431065,201805,18,11,7,10494,6678,17172
431070,201805,73,68,5,64872,4770,69642
431075,201805,7,7,0,6678,0,6678
431080,201805,137,87,50,82711.8,47700,130411.8
431085,201805,30,27,3,25758,2862,28620
431087,201805,14,12,2,11448,1908,13356
431090,201805,54,42,12,40068,11448,51516
431100,201805,1236,736,500,691320.02,477000,1168320.02
431110,201805,246,154,92,146916,87472.46,234388.46
431112,201805,29,17,12,16218,11448,27666
431113,201805,31,21,10,20034,9540,29574
431115,201805,155,106,49,100487.87,46736.46,147224.33
431120,201805,618,363,255,344356.64,243193.84,587550.48
431123,201805,3,2,1,1908,954,2862
431125,201805,91,81,10,77274,9540,86814
431127,201805,7,3,4,2862,3816,6678
431130,201805,650,417,233,396577.8,221976.72,618554.52
431140,201805,726,493,233,467603.3,222205.68,689808.98
431142,201805,35,27,8,24546,7632,32178
431150,201805,206,152,54,145008,51506.46,196514.46
431160,201805,57,51,6,48654,5724,54378
431162,201805,19,14,5,13356,4770,18126
431164,201805,4,4,0,3816,0,3816
431170,201805,105,85,20,81090,19080,100170
431171,201805,55,30,25,28277.94,23840.46,52118.40
431173,201805,1,1,0,954,0,954
431175,201805,201,98,103,92252,98252.46,190504.46
431177,201805,76,57,19,54378,17439.92,71817.92
431179,201805,13,11,2,10494,1908,12402
431180,201805,445,269,176,256626,167885.46,424511.46
431190,201805,90,69,21,65826,20034,85860
431198,201805,70,47,23,44838,21942,66780
431200,201805,21,17,4,16218,3816,20034
431205,201805,23,23,0,21942,0,21942
431210,201805,90,56,34,53091,32436,85527
431213,201805,30,25,5,23850,4770,28620
431215,201805,25,22,3,20988,2862,23850
431217,201805,7,6,1,5724,954,6678
431220,201805,67,57,10,54378,9540,63918
431225,201805,148,97,51,92529,48634.92,141163.92
431230,201805,99,87,12,82998,11448,94446
431235,201805,8,8,0,7632,0,7632
431237,201805,24,16,8,15264,7632,22896
431238,201805,13,10,3,9254,2862,12116
431240,201805,1004,645,359,613670.64,341970.84,955641.48
431242,201805,36,36,0,34344,0,34344
431244,201805,11,8,3,7632,2862,10494
431245,201805,58,44,14,41976,13356,55332
431247,201805,12,10,2,9540,1908,11448
431250,201805,269,138,131,131585.22,124954.92,256540.14
431260,201805,62,45,17,42930,16218,59148
431261,201805,21,14,7,13356,6678,20034
431262,201805,15,15,0,14310,0,14310
431265,201805,160,84,76,80136,72504,152640
431267,201805,13,12,1,11448,954,12402
431270,201805,320,268,52,255672,49608,305280
431275,201805,40,38,2,36252,1908,38160
431280,201805,20,16,4,14429.25,3816,18245.25
431290,201805,22,19,3,18126,2862,20988
431295,201805,4,4,0,3816,0,3816
431300,201805,22,19,3,18126,2862,20988
431301,201805,7,7,0,6678,0,6678
431303,201805,52,35,17,33265.98,15931.8,49197.78
431306,201805,225,117,108,111161.98,103032,214193.98
431308,201805,7,5,2,4770,1908,6678
431310,201805,64,55,9,52470,8586,61056
431320,201805,120,69,51,65826,48358.26,114184.26
431330,201805,178,116,62,110664,59148,169812
431333,201805,33,27,6,25758,5724,31482
431335,201805,10,5,5,4770,4770,9540
431337,201805,329,156,173,147965.58,164002.34,311967.92
431339,201805,20,17,3,16218,2862,19080
431340,201805,3029,1744,1285,1659097.34,1222945.44,2882042.78
431342,201805,42,25,17,23850,16218,40068
431344,201805,18,17,1,16218,954,17172
431346,201805,4,4,0,3816,0,3816
431349,201805,35,32,3,30528,2862,33390
431350,201805,916,536,380,506795.66,360860.04,867655.70
431360,201805,46,40,6,38160,5724,43884
431365,201805,319,153,166,145942.92,157400.46,303343.38
431370,201805,1341,793,548,752887.93,522271.08,1275159.01
431380,201805,98,85,13,81090,12402,93492
431390,201805,500,277,223,263256.5,212198.22,475454.72
431395,201805,283,125,158,119250,150713,269963
431400,201805,39,29,10,27666,9540,37206
431402,201805,103,72,31,68688,29574,98262
431403,201805,19,11,8,10494,7632,18126
431405,201805,643,347,296,329398.02,282071,611469.02
431406,201805,30,26,4,24804,3816,28620
431407,201805,51,40,11,38160,10494,48654
431410,201805,3286,1966,1320,1862424.29,1254749.3,3117173.59
431413,201805,16,13,3,12402,2862,15264
431415,201805,70,51,19,48654,18126,66780
431417,201805,23,12,11,11448,10494,21942
431420,201805,307,217,90,206334.26,85860,292194.26
431430,201805,43,17,26,16218,24804,41022
431440,201805,8989,6397,2592,6031757.52,2464960.81,8496718.33
431442,201805,27,14,13,13356,12402,25758
431445,201805,26,20,6,19080,5724,24804
431446,201805,7,6,1,5724,954,6678
431447,201805,86,61,25,58194,23850,82044
431449,201805,51,45,6,42930,5724,48654
431450,201805,412,283,129,268932.6,122350.5,391283.1
431454,201805,0,0,0,0,0,0
431455,201805,51,41,10,39114,9540,48654
431460,201805,536,369,167,349974.9,159031.8,509006.7
431470,201805,118,91,27,86122.54,25508,111630.54
431475,201805,11,10,1,9540,954,10494
431477,201805,37,25,12,23850,11448,35298
431478,201805,8,7,1,6678,954,7632
431480,201805,506,320,186,303734.52,177396.3,481130.82
431490,201805,28227,16061,12166,15249457.06,11571194.94,26820652.00
431500,201805,79,53,26,50562,24804,75366
431505,201805,35,21,14,20034,13356,33390
431507,201805,12,10,2,9540,1908,11448
431510,201805,275,183,92,174153,86785.38,260938.38
431513,201805,22,18,4,17172,3816,20988
431514,201805,9,8,1,7632,954,8586
431515,201805,80,67,13,63918,12402,76320
431517,201805,3,2,1,1908,954,2862
431520,201805,38,34,4,32436,3816,36252
431530,201805,1589,711,878,677912.64,837188.09,1515100.73
431531,201805,23,21,2,20034,1908,21942
431532,201805,24,16,8,15264,7632,22896
431535,201805,25,16,9,15264,8586,23850
431540,201805,140,124,16,117275.22,15264,132539.22
431545,201805,17,15,2,14310,1908,16218
431550,201805,351,202,149,192163.26,142050.6,334213.86
431555,201805,12,11,1,10494,954,11448
431560,201805,4546,3208,1338,3029116.62,1274086.98,4303203.60
431570,201805,802,426,376,402130.12,355833.46,757963.58
431575,201805,36,25,11,23850,10494,34344
431580,201805,97,68,29,63918,27666,91584
431590,201805,138,115,23,108756,21942,130698
431595,201805,12,11,1,10494,954,11448
431600,201805,220,127,93,121158,88722,209880
431610,201805,128,93,35,88054.2,33390,121444.2
431620,201805,42,34,8,32436,7632,40068
431630,201805,140,116,24,110664,22896,133560
431640,201805,1355,842,513,797223.62,487094.14,1284317.76
431642,201805,39,36,3,33867,2862,36729
431643,201805,45,20,25,19080,23850,42930
431645,201805,300,174,126,165996,119917.8,285913.8
431647,201805,9,9,0,8586,0,8586
431650,201805,36,27,9,25758,8586,34344
431660,201805,284,181,103,170766,98262,269028
431670,201805,222,104,118,96592.5,112543.38,209135.88
431673,201805,3,3,0,2862,0,2862
431675,201805,31,26,5,24517.8,4770,29287.8
431680,201805,1107,795,312,753535.92,296551.44,1050087.36
431690,201805,4811,2932,1879,2774703.8,1788647.76,4563351.56
431695,201805,26,20,6,19080,5724,24804
431697,201805,0,0,0,0,0,0
431700,201805,175,135,40,128790,38160,166950
431710,201805,4012,1727,2285,1645164.2,2179391.48,3824555.68
431720,201805,1392,833,559,786747.02,532318.46,1319065.48
431725,201805,1,1,0,954,0,954
431730,201805,1194,814,380,769861.1,362520,1132381.1
431740,201805,1368,680,688,644102.72,654561.38,1298664.10
431750,201805,1872,1213,659,1146925.5,626749.92,1773675.42
431755,201805,7,6,1,5724,954,6678
431760,201805,1079,689,390,656924.4,371831.58,1028755.98
431770,201805,394,288,106,274742.46,101104.92,375847.38
431775,201805,29,22,7,20988,6678,27666
431780,201805,564,350,214,332783.82,204146.46,536930.28
431790,201805,154,118,36,111618,34296.3,145914.3
431795,201805,14,12,2,11448,1908,13356
431800,201805,3379,1775,1604,1680632.02,1524212.42,3204844.44
431805,201805,16,15,1,14310,954,15264
431810,201805,620,415,205,393276.96,195436.98,588713.94
431820,201805,312,176,136,167904,128742.3,296646.3
431830,201805,2337,1415,922,1346289.57,878327.65,2224617.22
431840,201805,518,346,172,326460.4,162848,489308.4
431842,201805,34,28,6,26712,5724,32436
431843,201805,13,8,5,7632,4770,12402
431844,201805,14,12,2,11448,1908,13356
431845,201805,29,26,3,24804,2862,27666
431846,201805,28,24,4,22896,3816,26712
431848,201805,14,12,2,11448,1908,13356
431849,201805,9,7,2,6678,1908,8586
431850,201805,805,668,137,635759.51,130459.5,766219.01
431860,201805,104,73,31,69642,28620,98262
431861,201805,4,2,2,1908,1908,3816
431862,201805,52,34,18,32436,17172,49608
431870,201805,3466,2049,1417,1945220.76,1348751.86,3293972.62
431880,201805,958,701,257,662715.8,244224,906939.8
431890,201805,1306,808,498,765795.74,473485,1239280.74
431900,201805,185,129,56,123066,52632.18,175698.18
431910,201805,56,42,14,40068,13356,53424
431912,201805,35,19,16,18126,15264,33390
431915,201805,129,102,27,97308,25758,123066
431920,201805,143,105,38,99883.8,36252,136135.8
431930,201805,86,70,16,66780,15264,82044
431935,201805,4,3,1,2862,954,3816
431936,201805,13,12,1,11448,954,12402
431937,201805,18,13,5,12402,4770,17172
431940,201805,463,312,151,294881.4,144044.46,438925.86
431950,201805,483,306,177,290684.88,168706.98,459391.86
431960,201805,726,425,301,401264.02,286992.9,688256.92
431970,201805,71,62,9,59148,8586,67734
431971,201805,2,2,0,1908,0,1908
431973,201805,21,17,4,16218,3816,20034
431975,201805,7,6,1,5724,954,6678
431980,201805,204,129,75,121539.6,71550,193089.6
431990,201805,1222,655,567,623349.29,540872,1164221.29
432000,201805,1673,909,764,858547.24,725291.24,1583838.48
432010,201805,279,183,96,173284.56,91584,264868.56
432020,201805,171,136,35,129744,33380.46,163124.46
432023,201805,19,15,4,14310,3816,18126
432026,201805,66,60,6,57240,5724,62964
432030,201805,64,28,36,26712,34344,61056
432032,201805,21,18,3,17172,2862,20034
432035,201805,49,38,11,36252,10494,46746
432040,201805,104,71,33,67734,31482,99216
432045,201805,8,7,1,6678,954,7632
432050,201805,69,42,27,40068,25758,65826
432055,201805,101,72,29,68688,27666,96354
432057,201805,1,0,1,0,954,954
432060,201805,36,33,3,31482,2862,34344
432065,201805,30,27,3,25758,2862,28620
432067,201805,88,78,10,74392.92,9540,83932.92
432070,201805,409,307,102,290981.39,97279.92,388261.31
432080,201805,811,560,251,532370.86,239358.68,771729.54
432085,201805,16,12,4,11448,3816,15264
432090,201805,262,162,100,154548,95400,249948
432100,201805,178,120,58,114098.4,55332,169430.4
432110,201805,622,425,197,395768.24,186984,582752.24
432120,201805,957,576,381,548836.2,363388.14,912224.34
432130,201805,509,368,141,349736.4,133416.9,483153.3
432132,201805,26,23,3,21942,2862,24804
432135,201805,79,65,14,62010,13356,75366
432140,201805,268,214,54,203860.26,51516,255376.26
432143,201805,192,123,69,117342,65826,183168
432145,201805,273,192,81,181928.6,76987.8,258916.4
432146,201805,14,13,1,12402,954,13356
432147,201805,135,62,73,59148,69618.15,128766.15
432149,201805,19,14,5,13356,4770,18126
432150,201805,837,526,311,501555.96,294641.59,796197.55
432160,201805,1396,723,673,687396.7,641136.44,1328533.14
432162,201805,5,4,1,3816,954,4770
432163,201805,18,14,4,13356,3816,17172
432166,201805,122,91,31,87292,29574,116866
432170,201805,224,120,104,113527,99216,212743
432180,201805,529,321,208,303467.98,198146,501613.98
432183,201805,10,7,3,6678,2862,9540
432185,201805,83,72,11,68595.18,10494,79089.18
432190,201805,464,256,208,243642.86,198299.52,441942.38
432195,201805,85,73,12,68926.5,11448,80374.5
432200,201805,419,274,145,261396,138282.84,399678.84
432210,201805,119,77,42,71693.1,40068,111761.1
432215,201805,60,56,4,53424,3816,57240
432218,201805,19,18,1,17172,954,18126
432220,201805,685,346,339,329073.64,322898.74,651972.38
432225,201805,13,8,5,7155,4770,11925
432230,201805,144,87,57,82759.5,54378,137137.5
432232,201805,15,13,2,12402,1908,14310
432234,201805,4,3,1,2862,954,3816
432235,201805,1,1,0,954,0,954
432237,201805,30,17,13,16218,12402,28620
432240,201805,4259,2369,1890,2251184.18,1795105.18,4046289.36
432250,201805,1039,660,379,626970.26,361375.2,988345.46
432252,201805,41,33,8,30737.88,7632,38369.88
432253,201805,57,46,11,43884,10494,54378
432254,201805,24,11,13,10494,12402,22896
432255,201805,14,13,1,12402,954,13356
432260,201805,875,687,188,653672.26,178398.5,832070.76
432270,201805,230,167,63,159318,60102,219420
432280,201805,123,89,34,84429.8,32436,116865.8
432285,201805,1,1,0,954,0,954
432290,201805,70,63,7,58194,6678,64872
432300,201805,4646,2652,1994,2514301.43,1898415.7,4412717.13
432310,201805,118,95,23,90630,21942,112572
432320,201805,21,16,5,15216.3,4770,19986.3
432330,201805,15,10,5,9540,4770,14310
432335,201805,7,6,1,5724,954,6678
432340,201805,40,37,3,35298,2862,38160
432345,201805,96,68,28,64872,26712,91584
432350,201805,23,22,1,20988,954,21942
432360,201805,6,4,2,3816,1908,5724
432370,201805,25,25,0,23850,0,23850
432375,201805,39,34,5,32436,4770,37206
432377,201805,7,7,0,6678,0,6678
432380,201805,171,78,93,73744.2,88674.3,162418.5
500020,201805,247,135,112,128790,106246.98,235036.98
500025,201805,116,57,59,53424,56286,109710
500060,201805,1392,854,538,814143.6,512646.61,1326790.21
500070,201805,772,368,404,350721,385406.46,736127.46
500080,201805,134,103,31,98262,29574,127836
500085,201805,138,112,26,106562,23969.25,130531.25
500090,201805,334,160,174,152640,165996,318636
500100,201805,703,379,324,358799.8,308524,667323.8
500110,201805,2246,1013,1233,966065.92,1175469.14,2141535.06
500124,201805,310,177,133,168858,126595.8,295453.8
500150,201805,329,130,199,124011,189476.46,313487.46
500190,201805,529,364,165,346588.2,156924,503512.2
500200,201805,201,171,30,162791,28620,191411
500210,201805,1460,521,939,495903.01,894642.99,1390546.00
500215,201805,241,138,103,129653.46,98262,227915.46
500220,201805,795,519,276,494881.84,262546.46,757428.30
500230,201805,260,176,84,167188.5,79659,246847.5
500240,201805,706,488,218,464788.8,207685.8,672474.6
500260,201805,567,214,353,204156,336762,540918
500270,201805,28405,12077,16328,11490597.41,15560933.61,27051531.02
500280,201805,192,73,119,69642,113526,183168
500290,201805,1192,706,486,672285,463635,1135920
500295,201805,415,253,162,241362,154538.46,395900.46
500310,201805,63,20,43,19080,41022,60102
500315,201805,708,426,282,406394.46,268867.78,675262.24
500320,201805,3610,1814,1796,1728129.38,1711994.94,3440124.32
500325,201805,931,520,411,495603,391119.44,886722.44
500330,201805,1477,680,797,646498.28,760000.64,1406498.92
500345,201805,327,240,87,227997.2,82998,310995.2
500348,201805,246,143,103,136422,98243.46,234665.46
500350,201805,139,66,73,62964,69642,132606
500370,201805,5425,2442,2983,2322140.1,2843589.9,5165730.0
500375,201805,353,256,97,243786.36,92538,336324.36
500380,201805,589,335,254,319432.59,242306.46,561739.05
500390,201805,72,36,36,34344,34344,68688
500400,201805,220,148,72,141172.92,68679,209851.92
500410,201805,559,221,338,210788.15,322304.22,533092.37
500430,201805,549,383,166,365382,158364,523746
500440,201805,204,105,99,99397.43,94446,193843.43
500450,201805,409,177,232,168152.8,221318.46,389471.26
500460,201805,311,157,154,149768.46,146916,296684.46
500470,201805,442,347,95,329537.67,89667,419204.67
500480,201805,116,69,47,65826,44838,110664
500490,201805,109,44,65,41971.23,62010,103981.23
500500,201805,1427,504,923,478789.36,879966.41,1358755.77
500510,201805,49,39,10,37206,9531,46737
500515,201805,109,77,32,73458,30242,103700
500520,201805,348,194,154,184027,146626,330653
500525,201805,88,50,38,47700,35965.8,83665.8
500540,201805,898,378,520,360486.76,495069.84,855556.60
500560,201805,889,503,386,478123.04,367266.88,845389.92
500568,201805,1006,581,425,550998.82,405159.23,956158.05
500570,201805,1220,686,534,651451.04,506828.38,1158279.42
500580,201805,336,171,165,162838.26,157397,320235.26
500600,201805,314,158,156,150021.27,148806,298827.27
500620,201805,924,648,276,612414.64,263113.2,875527.84
500625,201805,81,69,12,65119.19,11448,76567.19
500627,201805,25,12,13,11448,12402,23850
500630,201805,1568,834,734,794959.46,699759.8,1494719.26
500635,201805,516,292,224,278148.24,213552.9,491701.14
500640,201805,422,221,201,208260,191735.46,399995.46
500660,201805,5526,2117,3409,2015898.5,3247484.32,5263382.82
500690,201805,570,204,366,194259.24,347476.25,541735.49
500710,201805,356,172,184,163802,175518,339320
500720,201805,981,573,408,544958.69,389022.92,933981.61
500730,201805,198,118,80,112572,76315.23,188887.23
500740,201805,841,367,474,348826.95,451917.75,800744.70
500750,201805,140,47,93,44838,88693.92,133531.92
500755,201805,123,89,34,84620,32436,117056
500769,201805,742,421,321,401303.04,306221,707524.04
500770,201805,436,231,205,220364.46,195560.46,415924.92
500780,201805,170,113,57,107802,54378,162180
500790,201805,1045,516,529,491187.25,504625.46,995812.71
500793,201805,253,138,115,131652,109701,241353
500795,201805,177,126,51,120194.46,48645,168839.46
500797,201805,39,30,9,28620,8586,37206
500800,201805,408,177,231,168849,220087.8,388936.8
500830,201805,2205,1232,973,1171580.32,927202.68,2098783.00
500840,201805,143,108,35,103032,33381,136413
510010,201805,162,91,71,86804.46,67734,154538.46
510020,201805,488,228,260,217218.06,247503.96,464722.02
510025,201805,1682,954,728,909246.13,691985.08,1601231.21
510030,201805,669,347,322,330991.92,306414.69,637406.61
510035,201805,129,59,70,56258.46,66761.46,123019.92
510040,201805,389,173,216,165042,205617.26,370659.26
510050,201805,427,233,194,221531.66,184271.46,405803.12
510060,201805,115,57,58,54368.46,55322.46,109690.92
510080,201805,221,89,132,84873.69,125814.06,210687.75
510100,201805,78,35,43,33390,41002.92,74392.92
510120,201805,37,22,15,20988,14310,35298
510125,201805,395,241,154,229231.89,146892.92,376124.81
510130,201805,570,332,238,316322.81,226628.64,542951.45
510140,201805,392,129,263,123057,250897.23,373954.23
510160,201805,93,40,53,38160,50558,88718
510170,201805,866,523,343,498667.05,326589.38,825256.43
510180,201805,2871,1395,1476,1327816.64,1406180.4,2733997.04
510185,201805,12,6,6,5724,5724,11448
510190,201805,212,71,141,67734,134509.23,202243.23
510250,201805,2620,1541,1079,1469073.07,1028233.1,2497306.17
510260,201805,200,144,56,137193.84,53387.46,190581.30
510263,201805,458,252,206,239405.46,195768.59,435174.05
510267,201805,668,372,296,353665.76,282113.45,635779.21
510268,201805,56,29,27,27666,25758,53424
510269,201805,66,30,36,28611,34344,62955
510270,201805,410,208,202,198253.98,192281.94,390535.92
510279,201805,231,170,61,162153,57888.92,220041.92
510285,201805,166,73,93,69623.46,88722,158345.46
510300,201805,537,296,241,281952.14,229839.84,511791.98
510305,201805,214,100,114,95377.46,108662.22,204039.68
510310,201805,113,58,55,55332,52460.46,107792.46
510320,201805,871,546,325,520306.64,309900.38,830207.02
510325,201805,412,165,247,157400.46,235342.26,392742.72
510330,201805,424,238,186,227039,177424.92,404463.92
510335,201805,593,324,269,309049.38,255321.18,564370.56
510336,201805,48,35,13,33390,12402,45792
510337,201805,120,49,71,46736.46,67724.46,114460.92
510340,201805,17335,8306,9029,7902019.18,8603860.93,16505880.11
510343,201805,71,49,22,46736.46,20988,67724.46
510345,201805,158,105,53,100160.46,50256.92,150417.38
510350,201805,668,370,298,352038.07,284227.38,636265.45
510360,201805,201,118,83,112563,79099.92,191662.92
510370,201805,139,71,68,67705.38,64740.6,132445.98
510380,201805,90,63,27,60102,25749,85851
510385,201805,58,27,31,25758,29565,55323
510390,201805,122,52,70,49608,66741.84,116349.84
510395,201805,40,29,11,27666,10494,38160
510410,201805,710,474,236,452192,225120.69,677312.69
510420,201805,590,289,301,274761.34,285733.99,560495.33
510450,201805,51,30,21,28620,20034,48654
510452,201805,41,23,18,21942,17172,39114
510454,201805,61,27,34,25758,32426.46,58184.46
510455,201805,127,81,46,77254.92,43884,121138.92
510460,201805,186,100,86,95219.92,82006.38,177226.30
510480,201805,753,432,321,411001.81,305905.36,716907.17
510490,201805,362,185,177,176120.34,168353.08,344473.42
510500,201805,255,194,61,185066.46,58194,243260.46
510510,201805,797,457,340,435377.72,324350.46,759728.18
510515,201805,1149,615,534,586341.38,509389.38,1095730.76
510517,201805,247,106,141,100837.8,134490.69,235328.49
510520,201805,238,155,83,147776.76,78862.3,226639.06
510523,201805,93,66,27,62964,25748.46,88712.46
510525,201805,730,412,318,392293.84,303270.3,695564.14
510530,201805,15,11,4,10494,3816,14310
510550,201805,271,118,153,112563,145953,258516
510558,201805,274,136,138,129711.15,131623.92,261335.07
510560,201805,395,243,152,231536,144990,376526
510562,201805,640,448,192,426061.17,182681.46,608742.63
510590,201805,807,419,388,399678.84,370124.69,769803.53
510600,201805,258,142,116,135444.92,110626.92,246071.84
510610,201805,170,83,87,79162.92,82685.46,161848.38
510615,201805,195,80,115,76300.92,109710,186010.92
510617,201805,18,10,8,9540,7632,17172
510618,201805,116,54,62,51516,58671,110187
510619,201805,104,73,31,69633,29565,99198
510620,201805,184,102,82,97298.46,78228,175526.46
510621,201805,196,125,71,119231.46,67706.46,186937.92
510622,201805,452,290,162,276567.84,154224.38,430792.22
510623,201805,353,237,116,226041.84,110635.38,336677.22
510624,201805,88,43,45,41013,42930,83943
510625,201805,538,332,206,316518.3,195946.52,512464.82
510626,201805,108,69,39,65826,37206,103032
510627,201805,61,43,18,41022,17172,58194
510628,201805,164,100,64,95353.92,60998.76,156352.68
510629,201805,256,164,92,156456,86804.46,243260.46
510630,201805,466,237,229,226013.22,218119.95,444133.17
510631,201805,11,3,8,2862,7346,10208
510637,201805,343,193,150,183776.18,142962.84,326739.02
510642,201805,974,543,431,517680.18,411031.44,928711.62
510645,201805,0,0,0,0,0,0
510650,201805,1493,985,508,939545.92,484500.76,1424046.68
510665,201805,86,43,43,40966,41022,81988
510670,201805,66,37,29,35298,27666,62964
510675,201805,1178,708,470,674160.43,448357.23,1122517.66
510677,201805,359,175,184,165944.84,175406.22,341351.06
510680,201805,108,63,45,60084,42921,103005
510682,201805,203,97,106,92216,101124,193340
510685,201805,52,37,15,35298,14310,49608
510700,201805,624,362,262,345229.92,249814.76,595044.68
510704,201805,1076,582,494,552838.62,469700.36,1022538.98
510706,201805,129,64,65,61051.23,61972.92,123024.15
510710,201805,396,269,127,255636.24,121043.68,376679.92
510715,201805,65,47,18,44828.46,17172,62000.46
510718,201805,212,115,97,109616.76,92519.46,202136.22
510719,201805,35,19,16,18126,15264,33390
510720,201805,197,133,64,126873,60769.8,187642.8
510724,201805,90,37,53,35288.46,50529.38,85817.84
510726,201805,52,27,25,25748.46,23832,49580.46
510729,201805,74,34,40,32436,38121.84,70557.84
510730,201805,474,267,207,254700,197330.46,452030.46
510735,201805,108,42,66,40068,62964,103032
510740,201805,29,16,13,15264,12402,27666
510757,201805,20,16,4,15264,3816,19080
510760,201805,7060,3735,3325,3553640.83,3165815.31,6719456.14
510770,201805,718,342,376,326079.3,358509.3,684588.6
510774,201805,15,6,9,5724,8586,14310
510775,201805,113,85,28,81080.46,26702.46,107782.92
510776,201805,31,8,23,7632,21942,29574
510777,201805,184,81,103,77245.38,98233.38,175478.76
510779,201805,53,24,29,22887,27628.92,50515.92
510780,201805,290,162,128,154485.46,122047,276532.46
510785,201805,445,243,202,231765.3,192641.22,424406.52
510787,201805,192,98,94,93483,89658.23,183141.23
510788,201805,0,0,0,0,0,0
510790,201805,2425,1258,1167,1198260.4,1111245.66,2309506.06
510792,201805,1089,617,472,587835.47,449872.34,1037707.81
510794,201805,117,59,58,56286,55303.92,111589.92
510795,201805,2397,1387,1010,1316387.83,960876.8,2277264.63
510800,201805,187,113,74,107792.46,70587,178379.46
510805,201805,172,118,54,112572,51516,164088
510810,201805,96,39,57,37123.38,54253.98,91377.36
510820,201805,257,120,137,114053.46,129698.03,243751.49
510830,201805,65,40,25,38160,23841,62001
510835,201805,7,5,2,4770,1908,6678
510840,201805,9250,4575,4675,4349121.49,4452535.84,8801657.33
510850,201805,213,90,123,85850.46,117018.18,202868.64
510860,201805,384,168,216,160085.52,205383.34,365468.86
510880,201805,65,50,15,47681.46,14310,61991.46
510885,201805,71,43,28,41003.46,26683.38,67686.84
510890,201805,71,41,30,39114,28620,67734
510895,201805,185,107,78,102078,74103.46,176181.46
520005,201805,34,23,11,21942,10494,32436
520010,201805,273,122,151,116388,143959,260347
520013,201805,643,390,253,372032,241075.8,613107.8
520015,201805,51,37,14,35298,13356,48654
520017,201805,103,59,44,56000,41976,97976
520020,201805,26,13,13,12402,12402,24804
520025,201805,2013,1090,923,1038677.24,879102.4,1917779.64
520030,201805,791,408,383,388269,364761.9,753030.9
520050,201805,78,53,25,50562,23850,74412
520055,201805,44,30,14,28620,13356,41976
520060,201805,177,113,64,107802,61056,168858
520080,201805,600,422,178,402588,169812,572400
520082,201805,20,14,6,13356,5724,19080
520085,201805,101,73,28,69642,26712,96354
520090,201805,90,62,28,59148,26712,85860
520110,201805,9037,3924,5113,3738364.16,4874876.98,8613241.14
520120,201805,14,8,6,7431.66,5724,13155.66
520130,201805,761,532,229,507232.8,218171,725403.8
520140,201805,11745,6639,5106,6326630.06,4868762.23,11195392.29
520145,201805,45,34,11,32436,10494,42930
520150,201805,191,149,42,142146,40068,182214
520160,201805,30,23,7,21942,6678,28620
520170,201805,234,145,89,138298,84869,223167
520180,201805,125,65,60,62010,57240,119250
520215,201805,218,134,84,127549.8,79849.8,207399.6
520235,201805,70,53,17,50562,16218,66780
520250,201805,131,79,52,75366,49321.8,124687.8
520260,201805,111,68,43,64872,40068,104940
520280,201805,47,33,14,30815,13356,44171
520310,201805,38,26,12,24804,11448,36252
520320,201805,165,105,60,100160.46,57240,157400.46
520330,201805,782,410,372,391094.46,354861,745955.46
520340,201805,349,197,152,187111.2,144989.46,332100.66
520350,201805,523,238,285,227052,271843,498895
520355,201805,86,50,36,47700,34344,82044
520357,201805,25,18,7,17172,6678,23850
520360,201805,0,0,0,0,0,0
520380,201805,140,72,68,68688,64872,133560
520390,201805,283,118,165,112095,157147.5,269242.5
520393,201805,13,10,3,9540,2862,12402
520396,201805,99,59,40,56286,38160,94446
520400,201805,222,130,92,122399.2,87768,210167.2
520410,201805,202,103,99,98253,94437,192690
520420,201805,22,15,7,14310,6678,20988
520425,201805,298,129,169,122113,160750.2,282863.2
520430,201805,461,239,222,227719.8,211732,439451.8
520440,201805,612,414,198,394956,188872.92,583828.92
520450,201805,1919,864,1055,823427.46,1005823.98,1829251.44
520455,201805,58,41,17,39114,16218,55332
520460,201805,30,15,15,14310,14310,28620
520465,201805,24,20,4,19080,3816,22896
520470,201805,416,255,161,242964.63,153594,396558.63
520480,201805,80,46,34,43884,32391,76275
520485,201805,126,43,83,41022,78896,119918
520490,201805,406,294,112,280291.98,106848,387139.98
520495,201805,173,106,67,101124,63918,165042
520500,201805,173,130,43,124020,41022,165042
520505,201805,177,92,85,87763.23,81090,168853.23
520510,201805,1777,878,899,834285.74,855483.18,1689768.92
520520,201805,35,27,8,25758,7632,33390
520530,201805,228,170,58,160456.12,55322.46,215778.58
520540,201805,532,357,175,339271.02,166950,506221.02
520545,201805,159,89,70,84906,66780,151686
520547,201805,54,30,24,28620,22896,51516
520549,201805,1129,551,578,525330,551294,1076624
520551,201805,293,150,143,143100,136135.8,279235.8
520552,201805,45,26,19,24804,18126,42930
520570,201805,16,9,7,8586,6678,15264
520580,201805,284,171,113,163124.46,107802,270926.46
520590,201805,162,98,64,93492,60769.8,154261.8
520620,201805,1169,545,624,519072.48,594714.26,1113786.74
520630,201805,44,26,18,24804,17172,41976
520640,201805,413,234,179,223236,170766,394002
520650,201805,57,40,17,38160,16218,54378
520660,201805,36,19,17,18117,16218,34335
520670,201805,34,29,5,27666,4770,32436
520680,201805,57,37,20,35298,19080,54378
520690,201805,33,10,23,9540,21913.92,31453.92
520710,201805,40,36,4,34344,3816,38160
520725,201805,197,125,72,119250,68688,187938
520735,201805,60,42,18,40068,17172,57240
520740,201805,405,200,205,190085.4,195561,385646.4
520750,201805,37,27,10,25758,9540,35298
520753,201805,55,37,18,35298,17172,52470
520760,201805,112,76,36,72504,34344,106848
520780,201805,290,219,71,208926,67734,276660
520790,201805,165,83,82,78895.8,78228,157123.8
520800,201805,3459,1843,1616,1755539.06,1540986.9,3296525.96
520810,201805,169,122,47,116388,44838,161226
520815,201805,5,5,0,4770,0,4770
520830,201805,139,91,48,86814,45505.8,132319.8
520840,201805,350,230,120,218943,114480,333423
520850,201805,110,70,40,66771,38007.36,104778.36
520860,201805,1684,1072,612,1021267.54,582704.2,1603971.74
520870,201805,30828,15190,15638,14463880.68,14903577.52,29367458.20
520880,201805,1070,587,483,559998,460762.92,1020760.92
520890,201805,794,460,334,437209.4,318531.46,755740.86
520910,201805,1029,544,485,515399.74,462690,978089.74
520915,201805,100,75,25,71550,23840.46,95390.46
520920,201805,405,195,210,185457.6,200330.46,385788.06
520929,201805,16,15,1,14310,954,15264
520940,201805,73,46,27,43884,25758,69642
520945,201805,21,13,8,12402,7632,20034
520960,201805,45,29,16,27666,15264,42930
520970,201805,326,204,122,193987,116101.8,310088.8
520980,201805,86,64,22,61056,20988,82044
520990,201805,478,323,155,308142,147870,456012
520993,201805,127,61,66,58194,62964,121158
520995,201805,242,135,107,127837,101506,229343
521000,201805,1569,916,653,871861.4,622581,1494442.4
521010,201805,675,314,361,299229.36,344328.3,643557.66
521015,201805,17,10,7,9540,6678,16218
521020,201805,1466,1021,445,973404.9,424159.22,1397564.12
521030,201805,47,33,14,31482,13356,44838
521040,201805,943,577,366,550220.2,348878,899098.2
521056,201805,41,29,12,27666,11448,39114
521060,201805,134,84,50,80136,47700,127836
521080,201805,465,348,117,331983,111618,443601
521090,201805,533,322,211,305626.14,201294,506920.14
521100,201805,282,210,72,200331,68688,269019
521120,201805,1055,728,327,692985.8,311663,1004648.8
521130,201805,365,261,104,248984.46,98330.6,347315.06
521140,201805,187,107,80,102078,76320,178398
521150,201805,2797,1209,1588,1152376.88,1513393.49,2665770.37
521160,201805,33,16,17,15264,16218,31482
521170,201805,192,113,79,107792.46,75366,183158.46
521180,201805,1134,719,415,684295.26,395195.2,1079490.46
521190,201805,2538,1076,1462,1026484.92,1393870.72,2420355.64
521200,201805,47,34,13,32436,12402,44838
521205,201805,13,9,4,8586,3816,12402
521210,201805,147,84,63,80136,60102,140238
521220,201805,820,561,259,532561.76,247030,779591.76
521225,201805,31,20,11,19080,10494,29574
521230,201805,110,72,38,68401.8,36252,104653.8
521250,201805,6224,3579,2645,3406906.1,2520737.26,5927643.36
521260,201805,22,14,8,13356,7632,20988
521270,201805,143,111,32,105894,30528,136422
521280,201805,437,260,177,247372.2,168858,416230.2
521290,201805,31,12,19,11448,18126,29574
521295,201805,98,66,32,62735.04,30528,93263.04
521300,201805,231,119,112,113508,106488.38,219996.38
521305,201805,35,23,12,21942,11448,33390
521308,201805,1076,786,290,749345.14,276365,1025710.14
521310,201805,1351,799,552,760961.4,525416.92,1286378.32
521340,201805,18,15,3,14310,2862,17172
521350,201805,131,96,35,91584,33390,124974
521370,201805,189,122,67,115815.6,63631.8,179447.4
521375,201805,190,107,83,102078,78895.8,180973.8
521377,201805,52,35,17,33390,16218,49608
521380,201805,1096,717,379,679870.22,361566,1041436.22
521385,201805,15,8,7,7632,6678,14310
521390,201805,106,85,21,80772.04,20034,100806.04
521400,201805,322,206,116,196237.8,110616.3,306854.1
521405,201805,148,77,71,73458,67734,141192
521410,201805,63,42,21,40068,20034,60102
521440,201805,206,146,60,138473.1,57240,195713.1
521450,201805,716,394,322,375876,307188,683064
521460,201805,1191,733,458,698995.8,436912.92,1135908.72
521470,201805,14,9,5,8586,4770,13356
521480,201805,47,32,15,30501,14245,44746
521483,201805,313,169,144,160940,137376,298316
521486,201805,285,182,103,172836.18,97595,270431.18
521487,201805,21,10,11,9540,10494,20034
521490,201805,27,16,11,15264,10494,25758
521500,201805,119,77,42,73458,40068,113526
521520,201805,41,30,11,28620,10494,39114
521523,201805,614,376,238,355387.32,227052,582439.32
521525,201805,45,30,15,28620,14023.8,42643.8
521530,201805,249,132,117,125928,111618,237546
521540,201805,30,16,14,15264,13356,28620
521550,201805,92,44,48,41661.92,45736.92,87398.84
521560,201805,805,551,254,525368,242173,767541
521565,201805,53,36,17,34344,16218,50562
521570,201805,496,331,165,315764.46,157315.3,473079.76
521580,201805,60,37,23,35298,21942,57240
521590,201805,37,20,17,19080,16218,35298
521600,201805,28,16,12,15264,11448,26712
521630,201805,239,121,118,115424.46,111581.96,227006.42
521640,201805,298,152,146,145008,139284,284292
521645,201805,30,16,14,15264,13356,28620
521680,201805,222,141,81,134514,77274,211788
521690,201805,2,2,0,1908,0,1908
521710,201805,1194,560,634,533667.8,604827,1138494.8
521720,201805,543,368,175,351062.46,166912.46,517974.92
521730,201805,632,307,325,292878,308943.56,601821.56
521740,201805,922,373,549,356238.92,522555.32,878794.24
521760,201805,1605,875,730,833172.63,696106,1529278.63
521770,201805,803,514,289,490356,275238.54,765594.54
521800,201805,2069,1292,777,1229025.48,739593.9,1968619.38
521805,201805,34,19,15,18126,14310,32436
521810,201805,92,58,34,54187.8,32436,86623.8
521830,201805,961,681,280,646843.41,267111,913954.41
521839,201805,93,62,31,59148,29574,88722
521850,201805,1124,597,527,568118.92,502433.68,1070552.60
521860,201805,342,208,134,198432,127550,325982
521870,201805,73,42,31,40068,29574,69642
521878,201805,42,20,22,19080,20988,40068
521880,201805,4554,2056,2498,1959133.36,2381473.72,4340607.08
521890,201805,587,413,174,394002,165709.8,559711.8
521900,201805,292,235,57,223553.96,54378,277931.96
521910,201805,151,105,46,100170,43884,144054
521920,201805,56,28,28,26712,26712,53424
521925,201805,36,21,15,20034,14310,34344
521930,201805,1131,644,487,614179.98,463668.68,1077848.66
521935,201805,34,26,8,24804,7632,32436
521940,201805,191,96,95,91584,90625.23,182209.23
521945,201805,14,12,2,11448,1908,13356
521950,201805,9,5,4,4770,3816,8586
521960,201805,74,55,19,52470,18126,70596
521970,201805,421,271,150,258247.8,143100,401347.8
521971,201805,96,49,47,46746,44838,91584
521973,201805,28,13,15,12402,14310,26712
521975,201805,1139,584,555,555706,528554.66,1084260.66
521980,201805,242,167,75,159318,71550,230868
521990,201805,74,54,20,51516,19080,70596
522000,201805,285,179,106,170766,101124,271890
522005,201805,21,13,8,12402,7632,20034
522010,201805,1137,637,500,607689,476427.6,1084116.6
522015,201805,54,33,21,31473,20034,51507
522020,201805,855,461,394,438840.2,375094.12,813934.32
522026,201805,30,22,8,20988,7632,28620
522028,201805,16,12,4,11448,3816,15264
522040,201805,744,295,449,281412,428291.46,709703.46
522045,201805,2116,1335,781,1272554.26,744540.8,2017095.06
522050,201805,168,82,86,78228,82044,160272
522060,201805,556,350,206,333613.8,196428.6,530042.4
522068,201805,135,89,46,84619.8,43884,128503.8
522070,201805,11,11,0,10494,0,10494
522100,201805,47,26,21,24536.88,20034,44570.88
522108,201805,38,29,9,27666,8586,36252
522119,201805,55,29,26,27666,24804,52470
522130,201805,76,29,47,27657,44820,72477
522140,201805,3738,1891,1847,1799527.28,1759883.44,3559410.72
522145,201805,51,31,20,29574,19080,48654
522150,201805,65,51,14,48654,13356,62010
522155,201805,60,40,20,38151,19080,57231
522157,201805,4,3,1,2862,954,3816
522160,201805,1728,1010,718,962109,684676.8,1646785.8
522170,201805,393,264,129,251856,123066,374922
522180,201805,36,20,16,19080,15264,34344
522185,201805,1935,750,1185,712193.26,1129969,1842162.26
522190,201805,48,27,21,25758,19938.6,45696.6
522200,201805,297,178,119,169812,113526,283338
522205,201805,165,112,53,106848,50562,157410
522220,201805,161,115,46,109710,43884,153594
522230,201805,29,23,6,21942,5724,27666
530010,201805,55575,28511,27064,27062879.53,25764546.44,52827425.97
110001,201806,520,411,109,391110.35,103340.96,494451.31
110002,201806,2779,1681,1098,1602405.88,1046594.49,2649000.37
110003,201806,95,75,20,71550.00,19080.00,90630.00
110004,201806,2016,1297,719,1234437.02,685630.26,1920067.28
110005,201806,442,355,87,337514.90,82998.00,420512.90
110006,201806,449,346,103,329797.80,98242.92,428040.72
110007,201806,82,65,17,62010.00,16218.00,78228.00
110008,201806,241,135,106,127554.90,101124.00,228678.90
110009,201806,799,546,253,518976.86,241163.00,760139.86
110010,201806,1812,1119,693,1066390.52,660980.52,1727371.04
110011,201806,1877,1446,431,1377973.20,411144.35,1789117.55
110012,201806,4112,2382,1730,2266906.98,1649168.57,3916075.55
110013,201806,757,579,178,552356.46,169812.00,722168.46
110014,201806,373,319,54,304305.89,51516.00,355821.89
110015,201806,1434,1159,275,1103118.05,261758.52,1364876.57
110018,201806,1118,668,450,636958.00,429287.23,1066245.23
110020,201806,15375,9018,6357,8556980.29,6053443.61,14610423.90
110025,201806,652,482,170,457830.11,162171.00,620001.11
110026,201806,41,28,13,26712.00,12402.00,39114.00
110028,201806,1652,1196,456,1136382.59,431430.95,1567813.54
110029,201806,141,125,16,119250.00,15264.00,134514.00
110030,201806,2486,1676,810,1596018.26,771839.46,2367857.72
110032,201806,387,300,87,285891.00,82994.00,368885.00
110033,201806,679,507,172,480654.00,163797.80,644451.80
110034,201806,367,268,99,253360.00,93779.00,347139.00
110037,201806,103,86,17,82044.00,16218.00,98262.00
110040,201806,341,232,109,221328.00,103986.00,325314.00
110045,201806,949,642,307,610922.00,291174.39,902096.39
110050,201806,97,80,17,76320.00,16218.00,92538.00
110060,201806,86,46,40,43884.00,38160.00,82044.00
110070,201806,122,73,49,69642.00,46460.00,116102.00
110080,201806,408,247,161,233415.18,153550.04,386965.22
110090,201806,33,27,6,25758.00,5724.00,31482.00
110092,201806,110,61,49,58194.00,46676.00,104870.00
110094,201806,197,142,55,135468.00,52470.00,187938.00
110100,201806,28,23,5,21942.00,4770.00,26712.00
110110,201806,68,41,27,39114.00,25758.00,64872.00
110120,201806,73,60,13,57240.00,12402.00,69642.00
110130,201806,298,241,57,228439.12,54378.00,282817.12
110140,201806,243,159,84,151495.20,80126.46,231621.66
110143,201806,51,43,8,41022.00,7632.00,48654.00
110145,201806,27,20,7,19080.00,6678.00,25758.00
110146,201806,24,12,12,11448.00,11448.00,22896.00
110147,201806,38,30,8,28620.00,7632.00,36252.00
110148,201806,39,27,12,25706.57,11448.00,37154.57
110149,201806,296,213,83,202915.80,79182.00,282097.80
110150,201806,84,58,26,55332.00,24804.00,80136.00
110155,201806,8,7,1,6678.00,954,7632.00
110160,201806,69,58,11,55332.00,10494.00,65826.00
110170,201806,203,166,37,158364.00,35298.00,193662.00
110175,201806,42,31,11,29574.00,10494.00,40068.00
110180,201806,92,80,12,76320.00,11448.00,87768.00
120001,201806,137,94,43,89634.00,40993.00,130627.00
120005,201806,192,120,72,114437.12,68688.00,183125.12
120010,201806,1038,666,372,627931.58,352698.92,980630.50
120013,201806,146,102,44,96600.06,41632.04,138232.10
120017,201806,92,57,35,54269.48,33347.12,87616.60
120020,201806,3539,2823,716,2666541.44,680608.59,3347150.03
120025,201806,588,333,255,315165.22,242188.60,557353.82
120030,201806,1035,866,169,818092.46,160468.12,978560.58
120032,201806,49,41,8,39114.00,7632.00,46746.00
120033,201806,213,186,27,177096.75,25758.00,202854.75
120034,201806,156,112,44,104918.12,41932.24,146850.36
120035,201806,29,21,8,20034.00,7632.00,27666.00
120038,201806,390,251,139,238608.00,132562.24,371170.24
120039,201806,22,21,1,20034.00,954,20988.00
120040,201806,14076,9768,4308,9182204.60,4071629.47,13253834.07
120042,201806,44,38,6,36252.00,5724.00,41976.00
120043,201806,12,3,9,2862.00,8586.00,11448.00
120045,201806,541,350,191,331797.50,181948.60,513746.10
120050,201806,1266,963,303,911305.88,288971.47,1200277.35
120060,201806,1419,1152,267,1094215.32,253632.72,1347848.04
120070,201806,501,357,144,335292.56,136054.66,471347.22
120080,201806,168,106,62,99894.42,58537.54,158431.96
130002,201806,150,105,45,100170.00,42930.00,143100.00
130006,201806,73,41,32,39114.00,30528.00,69642.00
130008,201806,143,78,65,73691.72,61331.72,135023.44
130010,201806,139,75,64,71528.12,61056.00,132584.12
130014,201806,243,176,67,167904.00,63918.00,231822.00
130020,201806,93,49,44,46746.00,41976.00,88722.00
130030,201806,898,549,349,523746.00,332936.46,856682.46
130040,201806,324,163,161,155502.00,152640.28,308142.28
130050,201806,562,307,255,292591.80,243270.00,535861.80
130060,201806,878,600,278,567294.08,262478.76,829772.84
130063,201806,578,322,256,306868.81,244158.36,551027.17
130068,201806,186,122,64,116388.00,60769.80,177157.80
130070,201806,1323,918,405,862340.28,381471.76,1243812.04
130080,201806,665,437,228,416516.40,217503.00,634019.40
130083,201806,71,38,33,35988.00,31482.00,67470.00
130090,201806,372,192,180,181488.96,171720.00,353208.96
130100,201806,1114,512,602,488448.00,574021.80,1062469.80
130110,201806,700,311,389,296544.00,371106.00,667650.00
130115,201806,175,71,104,67734.00,99216.00,166950.00
130120,201806,1631,1018,613,971172.00,584802.00,1555974.00
130130,201806,633,435,198,414990.00,188892.00,603882.00
130140,201806,1510,1137,373,1084035.02,354888.20,1438923.22
130150,201806,420,356,64,339602.12,61056.00,400658.12
130160,201806,467,263,204,250902.00,194616.00,445518.00
130165,201806,27,20,7,19080.00,6678.00,25758.00
130170,201806,929,660,269,629569.40,256626.00,886195.40
130180,201806,149,91,58,86814.00,55332.00,142146.00
130185,201806,2299,1207,1092,1149549.89,1041176.92,2190726.81
130190,201806,3624,2262,1362,2152480.48,1298045.99,3450526.47
130195,201806,291,233,58,222282.00,55332.00,277614.00
130200,201806,175,81,94,77264.46,89676.00,166940.46
130210,201806,78,40,38,38160.00,36252.00,74412.00
130220,201806,184,127,57,121158.00,54378.00,175536.00
130230,201806,332,209,123,199386.00,117342.00,316728.00
130240,201806,1443,913,530,869662.40,505042.83,1374705.23
130250,201806,4751,3074,1677,2926628.36,1599724.57,4526352.93
130255,201806,424,208,216,198432.00,205777.80,404209.80
130260,201806,53872,25862,28010,24637733.82,26714860.92,51352594.74
130270,201806,1511,976,535,930627.00,510390.00,1441017.00
130280,201806,113,69,44,65826.00,41976.00,107802.00
130290,201806,2095,1519,576,1449126.00,549217.80,1998343.80
130300,201806,432,307,125,292591.80,119250.00,411841.80
130310,201806,879,459,420,437886.00,400680.00,838566.00
130320,201806,452,237,215,225144.00,205110.00,430254.00
130330,201806,699,421,278,401634.00,264925.80,666559.80
130340,201806,3301,1969,1332,1873937.46,1269297.20,3143234.66
130350,201806,468,301,167,287132.12,159318.00,446450.12
130353,201806,807,332,475,316442.00,453150.00,769592.00
130356,201806,791,360,431,343440.00,410887.80,754327.80
130360,201806,68,41,27,39114.00,25758.00,64872.00
130370,201806,679,505,174,481770.00,165996.00,647766.00
130380,201806,611,422,189,402588.00,180306.00,582894.00
130390,201806,490,388,102,370152.00,97308.00,467460.00
130395,201806,181,40,141,38160.00,134514.00,172674.00
130400,201806,71,46,25,43884.00,23850.00,67734.00
130406,201806,2075,1299,776,1235632.30,739093.76,1974726.06
130410,201806,502,214,288,204156.00,274732.92,478888.92
130420,201806,3186,2566,620,2444177.32,591480.00,3035657.32
130423,201806,158,75,83,71550.00,79182.00,150732.00
130426,201806,145,86,59,82044.00,56286.00,138330.00
130430,201806,407,270,137,257580.00,130698.00,388278.00
130440,201806,202,69,133,65826.00,126882.00,192708.00
140002,201806,36,14,22,13356.00,20988.00,34344.00
140005,201806,207,126,81,119965.50,77274.00,197239.50
140010,201806,10285,6936,3349,6580010.93,3192624.63,9772635.56
140015,201806,153,67,86,63918.00,82044.00,145962.00
140017,201806,116,79,37,75366.00,35298.00,110664.00
140020,201806,482,320,162,304326.00,154548.00,458874.00
140023,201806,31,18,13,16953.00,12402.00,29355.00
140028,201806,17,12,5,11448.00,4770.00,16218.00
140030,201806,353,252,101,240408.00,96354.00,336762.00
140040,201806,54,38,16,36252.00,15168.60,51420.60
140045,201806,247,114,133,108088.20,126882.00,234970.20
140047,201806,582,403,179,382450.39,170003.00,552453.39
140050,201806,148,97,51,91725.00,48654.00,140379.00
140060,201806,36,25,11,23115.42,10494.00,33609.42
140070,201806,32,29,3,27666.00,2862.00,30528.00
150010,201806,4718,2929,1789,2792358.40,1704206.29,4496564.69
150013,201806,150,105,45,100170.00,42930.00,143100.00
150020,201806,1062,570,492,543780.00,469368.00,1013148.00
150030,201806,720,295,425,281430.00,405450.00,686880.00
150034,201806,195,123,72,117342.00,68688.00,186030.00
150040,201806,1398,839,559,800406.00,533286.00,1333692.00
150050,201806,694,413,281,393000.80,267874.00,660874.80
150060,201806,4739,3070,1669,2924831.37,1591978.50,4516809.87
150070,201806,311,146,165,139284.00,157410.00,296694.00
150080,201806,14421,7261,7160,6916222.93,6823321.94,13739544.87
150085,201806,385,240,145,228950.46,138330.00,367280.46
150090,201806,760,647,113,617238.00,107802.00,725040.00
150095,201806,346,214,132,203386.12,125107.56,328493.68
150100,201806,57,39,18,37206.00,17172.00,54378.00
150110,201806,172,82,90,78228.00,85860.00,164088.00
150120,201806,432,320,112,305280.00,106848.00,412128.00
150125,201806,54,23,31,21942.00,29574.00,51516.00
150130,201806,1901,1020,881,973080.00,840469.23,1813549.23
150140,201806,54303,25381,28922,24178713.92,27577123.82,51755837.74
150145,201806,179,104,75,99216.00,71550.00,170766.00
150150,201806,2830,1292,1538,1232350.49,1463832.31,2696182.80
150157,201806,435,303,132,289062.00,125923.23,414985.23
150160,201806,121,97,24,92538.00,22896.00,115434.00
150170,201806,3652,2707,945,2581285.50,901243.80,3482529.30
150172,201806,323,220,103,209880.00,98262.00,308142.00
150175,201806,86,52,34,49608.00,32436.00,82044.00
150178,201806,763,514,249,489402.00,237546.00,726948.00
150180,201806,3066,1483,1583,1413971.60,1509581.18,2923552.78
150190,201806,331,212,119,202248.00,113526.00,315774.00
150195,201806,122,61,61,58194.00,58194.00,116388.00
150200,201806,201,96,105,91584.00,100170.00,191754.00
150210,201806,3169,2567,602,2447859.86,573302.50,3021162.36
150215,201806,512,331,181,315774.00,172388.00,488162.00
150220,201806,3859,2616,1243,2494104.80,1183704.32,3677809.12
150230,201806,1141,921,220,878054.04,209880.00,1087934.04
150240,201806,5792,3419,2373,3258570.73,2263611.00,5522181.73
150250,201806,34,16,18,15264.00,17172.00,32436.00
150260,201806,75,45,30,42930.00,28620.00,71550.00
150270,201806,2341,1531,810,1459568.32,771881.80,2231450.12
150275,201806,572,348,224,331992.00,213696.00,545688.00
150276,201806,111,49,62,46746.00,59148.00,105894.00
150277,201806,766,326,440,310985.46,419760.00,730745.46
150280,201806,339,209,130,199386.00,124020.00,323406.00
150285,201806,73,36,37,34344.00,35298.00,69642.00
150290,201806,971,595,376,567334.26,358418.00,925752.26
150293,201806,670,312,358,297448.46,341532.00,638980.46
150295,201806,473,215,258,205110.00,245979.44,451089.44
150300,201806,79,41,38,39114.00,36252.00,75366.00
150304,201806,147,100,47,95400.00,44838.00,140238.00
150307,201806,396,324,72,309096.00,68688.00,377784.00
150309,201806,561,410,151,391140.00,144054.00,535194.00
150310,201806,258,174,84,165996.00,80136.00,246132.00
150320,201806,1799,1246,553,1188402.57,527323.50,1715726.07
150330,201806,2068,1195,873,1139362.20,832842.00,1972204.20
150340,201806,202,136,66,129505.50,62964.00,192469.50
150345,201806,607,327,280,311776.74,267120.00,578896.74
150350,201806,412,322,90,304793.46,85860.00,390653.46
150360,201806,4562,2932,1630,2793537.46,1555010.46,4348547.92
150370,201806,759,538,221,512456.00,210538.80,722994.80
150375,201806,195,102,93,97308.00,88722.00,186030.00
150380,201806,1353,909,444,867186.00,423551.00,1290737.00
150390,201806,736,420,316,400676.00,301464.00,702140.00
150400,201806,102,85,17,81090.00,16218.00,97308.00
150405,201806,1242,822,420,782916.48,400107.60,1183024.08
150410,201806,136,89,47,84906.00,44838.00,129744.00
150420,201806,7422,4076,3346,3887041.28,3190412.20,7077453.48
150430,201806,503,339,164,323406.00,156456.00,479862.00
150440,201806,583,347,236,330275.00,225144.00,555419.00
150442,201806,2184,1179,1005,1121513.00,958479.03,2079992.03
150445,201806,518,329,189,313866.00,179352.00,493218.00
150450,201806,261,126,135,120204.00,128790.00,248994.00
150460,201806,762,577,185,548631.09,176470.92,725102.01
150470,201806,1333,807,526,768351.80,501804.00,1270155.80
150475,201806,42,32,10,30528.00,9540.00,40068.00
150480,201806,1252,872,380,831888.00,362233.80,1194121.80
150490,201806,607,333,274,317682.00,261396.00,579078.00
150495,201806,329,234,95,223236.00,90630.00,313866.00
150497,201806,299,204,95,194616.00,90620.46,285236.46
150500,201806,426,289,137,275706.00,130698.00,406404.00
150503,201806,901,441,460,420428.00,438822.00,859250.00
150506,201806,1021,671,350,640134.00,333890.46,974024.46
150510,201806,1230,694,536,661790.00,511344.00,1173134.00
150520,201806,272,182,90,173628.00,85860.00,259488.00
150530,201806,1578,858,720,815384.30,686880.00,1502264.30
150540,201806,239,167,72,159318.00,68688.00,228006.00
150543,201806,730,415,315,395318.52,300223.80,695542.32
150548,201806,496,346,150,330084.00,143100.00,473184.00
150549,201806,61,44,17,41976.00,16218.00,58194.00
150550,201806,2879,1517,1362,1446265.00,1299062.00,2745327.00
150553,201806,3122,1840,1282,1754501.80,1223018.46,2977520.26
150555,201806,144,77,67,73458.00,63918.00,137376.00
150560,201806,55,42,13,40068.00,12402.00,52470.00
150563,201806,74,40,34,38160.00,32436.00,70596.00
150565,201806,170,102,68,97308.00,64872.00,162180.00
150570,201806,402,266,136,253744.92,129744.00,383488.92
150580,201806,1532,658,874,627089.49,833796.00,1460885.49
150590,201806,787,485,302,462690.00,288108.00,750798.00
150600,201806,465,279,186,266166.00,177444.00,443610.00
150610,201806,144,123,21,116493.00,20034.00,136527.00
150611,201806,130,91,39,86814.00,37206.00,124020.00
150613,201806,3228,1983,1245,1891782.00,1187721.00,3079503.00
150616,201806,492,299,193,285008.00,184122.00,469130.00
150618,201806,1189,641,548,611285.58,522792.00,1134077.58
150619,201806,398,305,93,290970.00,88722.00,379692.00
150620,201806,1278,741,537,706914.00,512011.80,1218925.80
150630,201806,302,202,100,192708.00,95400.00,288108.00
150635,201806,485,201,284,191754.00,270936.00,462690.00
150640,201806,61,28,33,26712.00,31482.00,58194.00
150650,201806,2330,1384,946,1320012.34,902193.80,2222206.14
150655,201806,245,182,63,173628.00,60102.00,233730.00
150658,201806,107,61,46,58194.00,43884.00,102078.00
150660,201806,489,344,145,328176.00,138330.00,466506.00
150670,201806,1013,372,641,354592.80,611495.46,966088.26
150680,201806,9896,5422,4474,5165416.86,4266094.58,9431511.44
150690,201806,51,32,19,30528.00,18126.00,48654.00
150700,201806,531,342,189,326077.20,180306.00,506383.20
150710,201806,277,164,113,156456.00,107802.00,264258.00
150715,201806,861,522,339,497005.92,323377.38,820383.30
150720,201806,431,333,98,317682.00,93205.80,410887.80
150730,201806,939,503,436,479853.00,415657.80,895510.80
150740,201806,228,161,67,153594.00,63918.00,217512.00
150745,201806,783,429,354,409266.00,337716.00,746982.00
150746,201806,56,34,22,32436.00,20988.00,53424.00
150747,201806,258,204,54,194616.00,51516.00,246132.00
150750,201806,132,76,56,72504.00,53424.00,125928.00
150760,201806,1730,1129,601,1077066.00,573354.00,1650420.00
150770,201806,369,192,177,183168.00,168682.95,351850.95
150775,201806,96,44,52,41976.00,49608.00,91584.00
150780,201806,191,101,90,96354.00,85860.00,182214.00
150790,201806,874,475,399,453150.00,380646.00,833796.00
150795,201806,1460,851,609,811854.00,580986.00,1392840.00
150796,201806,388,224,164,213696.00,156456.00,370152.00
150797,201806,285,163,122,155502.00,116388.00,271890.00
150800,201806,1412,856,556,815665.23,530424.00,1346089.23
150803,201806,592,490,102,467460.00,97308.00,564768.00
150805,201806,188,121,67,115434.00,63904.46,179338.46
150808,201806,992,546,446,520884.00,425484.00,946368.00
150810,201806,3396,2359,1037,2247085.54,988439.80,3235525.34
150812,201806,425,225,200,214650.00,190800.00,405450.00
150815,201806,964,635,329,604411.47,313866.00,918277.47
150820,201806,1573,963,610,917748.00,581920.92,1499668.92
150830,201806,827,581,246,553320.00,234684.00,788004.00
150835,201806,187,111,76,105894.00,72504.00,178398.00
150840,201806,1345,860,485,820440.00,462690.00,1283130.00
160005,201806,52,30,22,28620.00,20988.00,49608.00
160010,201806,196,125,71,119250.00,67730.00,186980.00
160015,201806,117,67,50,63918.00,47700.00,111618.00
160020,201806,126,71,55,67734.00,52470.00,120204.00
160021,201806,43,23,20,21942.00,19080.00,41022.00
160023,201806,114,68,46,64872.00,43884.00,108756.00
160025,201806,31,14,17,13356.00,16218.00,29574.00
160027,201806,1478,836,642,794777.90,611714.00,1406491.90
160030,201806,15531,7989,7542,7613700.96,7190043.09,14803744.05
160040,201806,314,181,133,172674.00,126882.00,299556.00
160050,201806,679,342,337,326268.00,321498.00,647766.00
160053,201806,323,186,137,177158.00,130698.00,307856.00
160055,201806,26,19,7,18126.00,6678.00,24804.00
160060,201806,6459,3410,3049,3243312.60,2907788.20,6151100.80
160070,201806,166,103,63,98262.00,60102.00,158364.00
160080,201806,80,43,37,41022.00,35298.00,76320.00
170025,201806,24,15,9,14310.00,8586.00,22896.00
170030,201806,229,187,42,178201.00,40068.00,218269.00
170035,201806,225,107,118,102078.00,112572.00,214650.00
170040,201806,185,142,43,135181.80,41022.00,176203.80
170070,201806,322,193,129,184122.00,123066.00,307188.00
170100,201806,369,267,102,254718.00,97308.00,352026.00
170105,201806,62,51,11,48654.00,10494.00,59148.00
170110,201806,102,63,39,60102.00,37206.00,97308.00
170130,201806,67,32,35,30528.00,33104.00,63632.00
170190,201806,100,65,35,62010.00,33390.00,95400.00
170200,201806,392,262,130,249271.20,123915.76,373186.96
170210,201806,5993,3143,2850,2990612.74,2715629.86,5706242.60
170215,201806,99,46,53,43884.00,50562.00,94446.00
170220,201806,1415,1044,371,994735.80,353648.00,1348383.80
170230,201806,154,101,53,96354.00,50562.00,146916.00
170240,201806,542,359,183,342486.00,174582.00,517068.00
170255,201806,1105,886,219,845034.12,208639.80,1053673.92
170270,201806,38,28,10,26712.00,9349.20,36061.20
170290,201806,81,60,21,57240.00,20034.00,77274.00
170300,201806,83,55,28,51706.80,26712.00,78418.80
170305,201806,47,35,12,33390.00,11448.00,44838.00
170307,201806,63,47,16,44838.00,15264.00,60102.00
170310,201806,103,56,47,53424.00,44838.00,98262.00
170320,201806,19,15,4,14310.00,3816.00,18126.00
170330,201806,20,18,2,17172.00,1908.00,19080.00
170360,201806,23,13,10,12402.00,9540.00,21942.00
170370,201806,120,63,57,60102.00,54378.00,114480.00
170380,201806,83,61,22,58194.00,20988.00,79182.00
170382,201806,45,40,5,38160.00,4770.00,42930.00
170384,201806,136,101,35,96354.00,33390.00,129744.00
170386,201806,61,27,34,25758.00,32436.00,58194.00
170388,201806,48,18,30,17172.00,28620.00,45792.00
170389,201806,22,18,4,17172.00,3816.00,20988.00
170390,201806,57,33,24,31482.00,22896.00,54378.00
170410,201806,35,24,11,22896.00,10494.00,33390.00
170460,201806,17,13,4,12402.00,3816.00,16218.00
170510,201806,29,22,7,20988.00,6678.00,27666.00
170550,201806,1495,855,640,815670.00,609797.00,1425467.00
170555,201806,113,78,35,74412.00,33390.00,107802.00
170560,201806,98,72,26,68688.00,24804.00,93492.00
170600,201806,39,19,20,18126.00,19080.00,37206.00
170610,201806,189,101,88,96196.59,83934.00,180130.59
170625,201806,38,20,18,19080.00,17172.00,36252.00
170650,201806,82,62,20,59148.00,19080.00,78228.00
170700,201806,556,423,133,402302.30,126595.80,528898.10
170710,201806,157,96,61,91584.00,58185.00,149769.00
170720,201806,84,68,16,64872.00,15264.00,80136.00
170730,201806,62,37,25,35298.00,23850.00,59148.00
170740,201806,79,57,22,54378.00,20988.00,75366.00
170755,201806,69,36,33,34344.00,31482.00,65826.00
170765,201806,138,67,71,63632.00,67734.00,131366.00
170770,201806,224,132,92,124830.90,87768.00,212598.90
170820,201806,596,388,208,370152.00,198003.00,568155.00
170825,201806,32,20,12,19080.00,11448.00,30528.00
170830,201806,79,60,19,57049.20,18126.00,75175.20
170900,201806,199,152,47,145008.00,44838.00,189846.00
170930,201806,814,424,390,404172.00,371488.00,775660.00
170950,201806,3037,1323,1714,1261170.26,1633039.31,2894209.57
170980,201806,18,10,8,9540.00,7632.00,17172.00
171050,201806,135,105,30,100170.00,28620.00,128790.00
171070,201806,38,31,7,29574.00,6678.00,36252.00
171090,201806,40,29,11,27666.00,10494.00,38160.00
171110,201806,20,13,7,12402.00,6678.00,19080.00
171150,201806,39,18,21,17172.00,20034.00,37206.00
171180,201806,22,10,12,9540.00,11448.00,20988.00
171190,201806,139,81,58,77274.00,55332.00,132606.00
171195,201806,65,50,15,47700.00,14310.00,62010.00
171200,201806,46,19,27,18126.00,25758.00,43884.00
171215,201806,3,3,0,2862.00,0,2862.00
171240,201806,54,44,10,41976.00,9540.00,51516.00
171245,201806,55,50,5,47700.00,4770.00,52470.00
171250,201806,71,37,34,35298.00,32426.46,67724.46
171270,201806,17,13,4,12402.00,3816.00,16218.00
171280,201806,39,36,3,34201.00,2862.00,37063.00
171320,201806,993,562,431,536148.00,408884.40,945032.40
171330,201806,422,204,218,194616.00,207972.00,402588.00
171360,201806,90,65,25,62010.00,23850.00,85860.00
171370,201806,24,13,11,12402.00,10494.00,22896.00
171380,201806,136,110,26,104940.00,24804.00,129744.00
171395,201806,55,34,21,32436.00,20034.00,52470.00
171420,201806,305,201,104,191754.00,98929.80,290683.80
171430,201806,68,54,14,51516.00,13356.00,64872.00
171488,201806,199,106,93,101124.00,88722.00,189846.00
171500,201806,58,32,26,30528.00,24804.00,55332.00
171510,201806,68,45,23,42930.00,21942.00,64872.00
171515,201806,44,37,7,35298.00,6392.00,41690.00
171525,201806,31,26,5,24804.00,4770.00,29574.00
171550,201806,13,7,6,6678.00,5724.00,12402.00
171570,201806,60,30,30,28620.00,28620.00,57240.00
171575,201806,340,212,128,202248.00,122102.46,324350.46
171610,201806,1706,858,848,816632.99,807443.66,1624076.65
171620,201806,132,94,38,89122.68,36252.00,125374.68
171630,201806,50,27,23,25758.00,21942.00,47700.00
171650,201806,270,178,92,169812.00,87768.00,257580.00
171660,201806,267,143,124,136422.00,118292.00,254714.00
171665,201806,49,33,16,31482.00,15264.00,46746.00
171670,201806,428,248,180,233673.26,171290.03,404963.29
171700,201806,63,55,8,52470.00,7632.00,60102.00
171720,201806,25,9,16,8586.00,15264.00,23850.00
171750,201806,101,55,46,52470.00,43884.00,96354.00
171780,201806,74,60,14,57240.00,13356.00,70596.00
171790,201806,76,64,12,61056.00,11448.00,72504.00
171800,201806,34,26,8,24804.00,7632.00,32436.00
171820,201806,2068,1168,900,1111896.74,853992.82,1965889.56
171830,201806,38,31,7,29574.00,6678.00,36252.00
171840,201806,65,38,27,36252.00,25758.00,62010.00
171845,201806,31,20,11,19080.00,10494.00,29574.00
171850,201806,40,29,11,27666.00,10494.00,38160.00
171855,201806,78,61,17,58194.00,16218.00,74412.00
171865,201806,8,7,1,6678.00,954,7632.00
171870,201806,31,22,9,20988.00,8586.00,29574.00
171875,201806,77,52,25,49608.00,23850.00,73458.00
171880,201806,28,20,8,19080.00,7632.00,26712.00
171884,201806,46,23,23,21942.00,21942.00,43884.00
171886,201806,118,43,75,41022.00,71263.80,112285.80
171888,201806,24,18,6,17172.00,5724.00,22896.00
171889,201806,19,15,4,14310.00,3816.00,18126.00
171890,201806,56,46,10,43884.00,9540.00,53424.00
171900,201806,42,29,13,27666.00,12402.00,40068.00
172000,201806,38,33,5,31482.00,4770.00,36252.00
172010,201806,41,35,6,32579.10,5724.00,38303.10
172015,201806,25,16,9,15264.00,8299.80,23563.80
172020,201806,131,83,48,79182.00,45792.00,124974.00
172025,201806,32,21,11,20034.00,10494.00,30528.00
172030,201806,33,19,14,18126.00,13356.00,31482.00
172049,201806,73,44,29,41976.00,27666.00,69642.00
172065,201806,150,98,52,93442.00,49608.00,143050.00
172080,201806,90,64,26,59873.84,24804.00,84677.84
172085,201806,25,12,13,11448.00,12402.00,23850.00
172090,201806,406,312,94,297648.00,88913.00,386561.00
172093,201806,24,18,6,17172.00,5724.00,22896.00
172097,201806,16,8,8,7632.00,7346.00,14978.00
172100,201806,4728,2662,2066,2534349.80,1968495.00,4502844.80
172110,201806,81,53,28,50562.00,26712.00,77274.00
172120,201806,1711,1469,242,1395309.65,230465.50,1625775.15
172125,201806,4,4,0,3816.00,0,3816.00
172130,201806,17,13,4,12402.00,3816.00,16218.00
172208,201806,191,121,70,115434.00,66780.00,182214.00
172210,201806,416,202,214,192708.00,203870.00,396578.00
210005,201806,2943,1832,1111,1744675.22,1057034.00,2801709.22
210010,201806,187,96,91,91584.00,86814.00,178398.00
210015,201806,31,21,10,20034.00,9540.00,29574.00
210020,201806,346,183,163,174582.00,155502.00,330084.00
210030,201806,345,216,129,206064.00,123057.00,329121.00
210040,201806,152,117,35,111618.00,33390.00,145008.00
210043,201806,259,175,84,166950.00,80136.00,247086.00
210047,201806,598,319,279,303944.40,266156.46,570100.86
210050,201806,297,217,80,207018.00,76320.00,283338.00
210055,201806,43,33,10,31482.00,9540.00,41022.00
210060,201806,557,441,116,420614.79,110664.00,531278.79
210070,201806,412,303,109,289062.00,103986.00,393048.00
210080,201806,103,94,9,89676.00,8586.00,98262.00
210083,201806,305,135,170,128790.00,162180.00,290970.00
210087,201806,43,32,11,29726.64,10494.00,40220.64
210090,201806,492,341,151,325314.00,144054.00,469368.00
210095,201806,487,355,132,338660.46,125928.00,464588.46
210100,201806,695,529,166,504332.10,157410.02,661742.12
210110,201806,147,81,66,77274.00,62964.00,140238.00
210120,201806,5447,4103,1344,3907253.00,1280922.68,5188175.68
210125,201806,212,122,90,116388.00,85860.00,202248.00
210130,201806,546,286,260,271890.00,248020.92,519910.92
210135,201806,34,20,14,19080.00,13356.00,32436.00
210140,201806,4404,3453,951,3291385.42,907016.00,4198401.42
210150,201806,360,228,132,217512.00,125928.00,343440.00
210160,201806,3385,2848,537,2714132.78,512012.00,3226144.78
210170,201806,1141,893,248,851922.00,236592.00,1088514.00
210173,201806,123,102,21,97308.00,20034.00,117342.00
210177,201806,452,221,231,210834.00,220374.00,431208.00
210180,201806,32,17,15,16218.00,14310.00,30528.00
210190,201806,417,268,149,255672.00,142146.00,397818.00
210193,201806,1,1,0,954,0,954
210197,201806,81,54,27,51516.00,25739.88,77255.88
210200,201806,640,506,134,482285.16,127836.00,610121.16
210203,201806,259,173,86,165042.00,82044.00,247086.00
210207,201806,384,298,86,284292.00,82044.00,366336.00
210210,201806,778,710,68,677340.00,64872.00,742212.00
210215,201806,79,67,12,63918.00,11448.00,75366.00
210220,201806,392,323,69,308142.00,65539.80,373681.80
210230,201806,306,233,73,222282.00,69642.00,291924.00
210232,201806,1472,939,533,895520.00,508482.00,1404002.00
210235,201806,157,122,35,116198.00,33390.00,149588.00
210237,201806,45,24,21,22896.00,20034.00,42930.00
210240,201806,92,75,17,71550.00,16218.00,87768.00
210250,201806,185,149,36,142146.00,34344.00,176490.00
210255,201806,347,257,90,245178.00,85860.00,331038.00
210260,201806,417,266,151,253764.00,144054.00,397818.00
210270,201806,693,441,252,420714.00,240408.00,661122.00
210275,201806,47,36,11,34344.00,10494.00,44838.00
210280,201806,1039,669,370,635411.33,351644.50,987055.83
210290,201806,505,333,172,317682.00,164088.00,481770.00
210300,201806,6054,3533,2521,3365273.27,2403842.23,5769115.50
210310,201806,106,73,33,69642.00,31482.00,101124.00
210312,201806,125,81,44,77274.00,41976.00,119250.00
210315,201806,116,87,29,82998.00,27666.00,110664.00
210317,201806,123,86,37,82044.00,35298.00,117342.00
210320,201806,2382,1966,416,1873853.84,396864.00,2270717.84
210325,201806,128,88,40,82998.00,37874.00,120872.00
210330,201806,5450,2823,2627,2688319.63,2506148.46,5194468.09
210340,201806,1386,998,388,951292.00,370081.07,1321373.07
210350,201806,615,506,109,482485.50,103986.00,586471.50
210355,201806,136,108,28,103032.00,26712.00,129744.00
210360,201806,2620,1647,973,1568091.60,927956.00,2496047.60
210370,201806,1239,547,692,521838.00,660168.00,1182006.00
210375,201806,187,97,90,91995.00,85860.00,177855.00
210380,201806,734,545,189,519930.00,180306.00,700236.00
210390,201806,205,169,36,161226.00,34344.00,195570.00
210400,201806,419,352,67,335808.00,63899.00,399707.00
210405,201806,1018,690,328,658260.00,312912.00,971172.00
210407,201806,54,43,11,41022.00,10494.00,51516.00
210408,201806,64,57,7,54378.00,6678.00,61056.00
210409,201806,321,268,53,255672.00,50562.00,306234.00
210410,201806,440,341,99,325314.00,94437.00,419751.00
210420,201806,192,157,35,149778.00,33390.00,183168.00
210430,201806,37,27,10,25758.00,9540.00,35298.00
210440,201806,375,229,146,218466.00,139284.00,357750.00
210450,201806,149,111,38,105894.00,36252.00,142146.00
210455,201806,223,122,101,116388.00,96354.00,212742.00
210460,201806,343,218,125,207972.00,119250.00,327222.00
210462,201806,64,54,10,51516.00,9540.00,61056.00
210465,201806,174,126,48,120204.00,45792.00,165996.00
210467,201806,533,382,151,364428.00,144054.00,508482.00
210470,201806,46,35,11,33390.00,10494.00,43884.00
210480,201806,1325,940,385,896760.00,367290.00,1264050.00
210490,201806,223,136,87,129744.00,82998.00,212742.00
210500,201806,579,306,273,291924.00,260442.00,552366.00
210510,201806,555,431,124,411174.00,118296.00,529470.00
210515,201806,435,239,196,228006.00,186984.00,414990.00
210520,201806,407,355,52,338383.80,49608.00,387991.80
210530,201806,9436,5057,4379,4810211.57,4169845.31,8980056.88
210535,201806,131,93,38,88722.00,36252.00,124974.00
210540,201806,1546,942,604,897523.80,574785.00,1472308.80
210542,201806,1184,593,591,565340.40,563337.00,1128677.40
210545,201806,13,12,1,11448.00,954,12402.00
210547,201806,134,114,20,108756.00,19080.00,127836.00
210550,201806,739,521,218,495486.00,207972.00,703458.00
210560,201806,178,149,29,142146.00,27666.00,169812.00
210565,201806,31,22,9,20988.00,8586.00,29574.00
210570,201806,1369,1075,294,1025550.00,280476.00,1306026.00
210580,201806,108,94,14,89676.00,13356.00,103032.00
210590,201806,771,610,161,581176.80,153594.00,734770.80
210592,201806,31,27,4,25758.00,3816.00,29574.00
210594,201806,104,85,19,81090.00,18126.00,99216.00
210596,201806,90,75,15,71550.00,14310.00,85860.00
210598,201806,124,90,34,85860.00,32436.00,118296.00
210600,201806,332,280,52,267120.00,49608.00,316728.00
210610,201806,252,233,19,221328.00,18126.00,239454.00
210620,201806,47,27,20,25758.00,19080.00,44838.00
210630,201806,61,59,2,56286.00,1908.00,58194.00
210632,201806,1099,729,370,695466.00,352503.00,1047969.00
210635,201806,17,14,3,13356.00,2862.00,16218.00
210637,201806,105,73,32,69642.00,30528.00,100170.00
210640,201806,591,517,74,493218.00,70596.00,563814.00
210650,201806,411,330,81,313894.62,76320.00,390214.62
210660,201806,398,287,111,273131.00,105770.00,378901.00
210663,201806,18,11,7,10494.00,6678.00,17172.00
210667,201806,114,36,78,34344.00,74412.00,108756.00
210670,201806,268,236,32,224429.00,30528.00,254957.00
210675,201806,575,300,275,286200.00,262350.00,548550.00
210680,201806,210,131,79,124974.00,75366.00,200340.00
210690,201806,646,511,135,487494.00,128790.00,616284.00
210700,201806,191,141,50,134514.00,47700.00,182214.00
210710,201806,299,168,131,160081.20,124974.00,285055.20
210720,201806,128,107,21,102078.00,20034.00,122112.00
210725,201806,71,62,9,59148.00,8586.00,67734.00
210730,201806,25,18,7,17172.00,6678.00,23850.00
210735,201806,417,278,139,265212.00,132320.00,397532.00
210740,201806,553,465,88,443610.00,83952.00,527562.00
210745,201806,153,111,42,105894.00,40068.00,145962.00
210750,201806,2418,1090,1328,1037905.00,1266892.92,2304797.92
210760,201806,273,200,73,190800.00,69627.69,260427.69
210770,201806,404,311,93,296694.00,88435.80,385129.80
210780,201806,425,307,118,292878.00,112572.00,405450.00
210790,201806,188,145,43,138330.00,41022.00,179352.00
210800,201806,145,107,38,102078.00,36252.00,138330.00
210805,201806,45,41,4,39114.00,3816.00,42930.00
210810,201806,488,375,113,357082.20,107802.00,464884.20
210820,201806,2323,1841,482,1747869.41,459828.00,2207697.41
210825,201806,174,90,84,85860.00,80136.00,165996.00
210830,201806,798,489,309,465552.00,293832.00,759384.00
210840,201806,211,143,68,136422.00,64872.00,201294.00
210845,201806,252,159,93,151686.00,88722.00,240408.00
210850,201806,846,537,309,512298.00,294786.00,807084.00
210860,201806,4138,2139,1999,2039080.30,1906740.72,3945821.02
210870,201806,469,354,115,337716.00,109710.00,447426.00
210880,201806,60,42,18,40068.00,17172.00,57240.00
210890,201806,348,289,59,275706.00,56286.00,331992.00
210900,201806,581,377,204,359654.00,194616.00,554270.00
210905,201806,69,35,34,33390.00,32436.00,65826.00
210910,201806,2007,1484,523,1414445.99,498942.00,1913387.99
210920,201806,229,68,161,64872.00,153594.00,218466.00
210923,201806,81,57,24,54378.00,22896.00,77274.00
210927,201806,438,183,255,174582.00,243270.00,417852.00
210930,201806,63,49,14,46746.00,13356.00,60102.00
210940,201806,94,71,23,67734.00,21942.00,89676.00
210945,201806,192,87,105,82998.00,100170.00,183168.00
210950,201806,519,375,144,357750.00,137371.23,495121.23
210955,201806,77,50,27,47700.00,25758.00,73458.00
210960,201806,2441,1045,1396,995308.40,1331498.00,2326806.40
210970,201806,114,98,16,93492.00,15264.00,108756.00
210975,201806,93,83,10,79182.00,9540.00,88722.00
210980,201806,1234,535,699,510275.52,666560.00,1176835.52
210990,201806,4343,2707,1636,2581377.13,1560744.00,4142121.13
211000,201806,1373,1087,286,1036712.00,272557.80,1309269.80
211003,201806,929,633,296,603882.00,282375.00,886257.00
211010,201806,489,431,58,411174.00,55332.00,466506.00
211020,201806,1616,589,1027,561906.00,979538.58,1541444.58
211023,201806,28,24,4,22609.80,3816.00,26425.80
211027,201806,66,44,22,41976.00,20988.00,62964.00
211030,201806,385,259,126,247086.00,120204.00,367290.00
211040,201806,324,248,76,236306.00,72504.00,308810.00
211050,201806,1179,753,426,718342.92,406113.23,1124456.15
211060,201806,690,582,108,553142.48,103032.00,656174.48
211065,201806,22,18,4,17172.00,3816.00,20988.00
211070,201806,927,751,176,714842.74,167904.00,882746.74
211080,201806,88,84,4,80136.00,3816.00,83952.00
211085,201806,59,31,28,29288.00,26712.00,56000.00
211090,201806,91,73,18,69642.00,17172.00,86814.00
211100,201806,504,403,101,383221.80,96354.00,479575.80
211102,201806,264,176,88,167904.00,83952.00,251856.00
211105,201806,221,150,71,143100.00,67734.00,210834.00
211107,201806,136,78,58,74412.00,55332.00,129744.00
211110,201806,826,529,297,504094.00,283329.00,787423.00
211120,201806,5783,2472,3311,2353145.54,3157602.23,5510747.77
211125,201806,36,29,7,27666.00,6678.00,34344.00
211130,201806,45820,19295,26525,18373116.79,25294262.52,43667379.31
211140,201806,427,360,67,342482.00,63918.00,406400.00
211150,201806,1285,813,472,775268.10,449998.00,1225266.10
211153,201806,166,98,68,93492.00,64872.00,158364.00
211157,201806,66,49,17,46746.00,16218.00,62964.00
211160,201806,709,590,119,562144.50,113526.00,675670.50
211163,201806,0,0,0,0,0,0
211167,201806,10,8,2,7632.00,1908.00,9540.00
211170,201806,447,311,136,296694.00,129744.00,426438.00
211172,201806,123,86,37,82044.00,35298.00,117342.00
211174,201806,276,163,113,155502.00,107802.00,263304.00
211176,201806,512,370,142,352980.00,135468.00,488448.00
211178,201806,96,62,34,59148.00,32436.00,91584.00
211180,201806,207,161,46,153594.00,43721.82,197315.82
211190,201806,67,62,5,59148.00,4770.00,63918.00
211195,201806,27,17,10,16218.00,9540.00,25758.00
211200,201806,157,136,21,129400.56,20034.00,149434.56
211210,201806,530,330,200,314152.20,190800.00,504952.20
211220,201806,4011,2254,1757,2142473.39,1669841.04,3812314.43
211223,201806,97,91,6,86632.74,5724.00,92356.74
211227,201806,69,48,21,45792.00,20034.00,65826.00
211230,201806,784,637,147,607554.90,140218.92,747773.82
211240,201806,416,313,103,298602.00,98262.00,396864.00
211245,201806,205,91,114,86814.00,108756.00,195570.00
211250,201806,1641,1402,239,1336516.12,228006.00,1564522.12
211260,201806,825,646,179,616284.00,170766.00,787050.00
211270,201806,2077,1637,440,1561698.00,418806.20,1980504.20
211280,201806,1844,1106,738,1054170.80,704052.00,1758222.80
211285,201806,204,120,84,114480.00,80136.00,194616.00
211290,201806,687,461,226,439603.20,215604.00,655207.20
211300,201806,812,624,188,595018.09,179352.00,774370.09
211400,201806,1597,905,692,863370.00,660168.00,1523538.00
220005,201806,18,17,1,16218.00,954,17172.00
220010,201806,87,66,21,62964.00,19747.80,82711.80
220020,201806,630,495,135,471245.04,128790.00,600035.04
220025,201806,107,103,4,98262.00,3816.00,102078.00
220027,201806,36,29,7,27666.00,6678.00,34344.00
220030,201806,99,81,18,77274.00,17172.00,94446.00
220040,201806,1133,855,278,814506.96,265212.00,1079718.96
220045,201806,39,28,11,26712.00,10494.00,37206.00
220050,201806,657,539,118,513044.96,112552.92,625597.88
220060,201806,174,148,26,141192.00,24804.00,165996.00
220070,201806,98,89,9,84906.00,8586.00,93492.00
220080,201806,10,9,1,8586.00,954,9540.00
220090,201806,36,29,7,27380.00,6678.00,34058.00
220095,201806,2,1,1,954,954,1908
220100,201806,27,23,4,21942.00,3816.00,25758.00
220105,201806,26,24,2,22324.00,1908.00,24232.00
220110,201806,212,194,18,184789.80,17172.00,201961.80
220115,201806,50,47,3,44838.00,2862.00,47700.00
220117,201806,20,18,2,17172.00,1908.00,19080.00
220120,201806,1490,1065,425,1014388.20,405430.92,1419819.12
220130,201806,26,25,1,23850.00,954,24804.00
220140,201806,98,77,21,72504.00,20034.00,92538.00
220150,201806,460,329,131,314305.79,124974.00,439279.79
220155,201806,4,4,0,3816.00,0,3816.00
220157,201806,18,15,3,14310.00,2862.00,17172.00
220160,201806,73,62,11,59148.00,10494.00,69642.00
220170,201806,37,35,2,33390.00,1908.00,35298.00
220173,201806,7,7,0,6678.00,0,6678.00
220177,201806,5,5,0,4770.00,0,4770.00
220180,201806,63,62,1,59143.23,770,59913.23
220190,201806,1056,946,110,902484.00,104940.00,1007424.00
220191,201806,42,37,5,35298.00,4770.00,40068.00
220192,201806,65,62,3,59148.00,2862.00,62010.00
220194,201806,38,34,4,32436.00,3816.00,36252.00
220196,201806,102,84,18,80136.00,17172.00,97308.00
220198,201806,6,4,2,3816.00,1908.00,5724.00
220200,201806,431,355,76,339402.00,72504.00,411906.00
220202,201806,36,32,4,30528.00,3816.00,34344.00
220205,201806,40,35,5,33390.00,4770.00,38160.00
220207,201806,18,17,1,16218.00,954,17172.00
220208,201806,85,45,40,42930.00,38160.00,81090.00
220209,201806,31,28,3,26712.00,2862.00,29574.00
220210,201806,15,13,2,12402.00,1908.00,14310.00
220211,201806,27,27,0,25758.00,0,25758.00
220213,201806,42,38,4,36252.00,3530.00,39782.00
220217,201806,36,28,8,26712.00,7632.00,34344.00
220220,201806,2045,1306,739,1242318.68,703603.92,1945922.60
220225,201806,16,8,8,7632.00,7632.00,15264.00
220230,201806,946,746,200,711235.62,190160.82,901396.44
220240,201806,147,134,13,127836.00,12402.00,140238.00
220245,201806,33,30,3,27917.04,2862.00,30779.04
220250,201806,111,100,11,95400.00,10494.00,105894.00
220253,201806,45,38,7,36252.00,6678.00,42930.00
220255,201806,28,25,3,23850.00,2862.00,26712.00
220260,201806,683,495,188,472230.00,179352.00,651582.00
220265,201806,18,14,4,13356.00,3816.00,17172.00
220270,201806,689,609,80,580260.96,75843.00,656103.96
220271,201806,44,37,7,35298.00,6678.00,41976.00
220272,201806,27,27,0,25758.00,0,25758.00
220273,201806,15,13,2,12402.00,1908.00,14310.00
220275,201806,58,47,11,44838.00,10494.00,55332.00
220277,201806,12,10,2,9540.00,1908.00,11448.00
220280,201806,15,12,3,11448.00,2862.00,14310.00
220285,201806,41,38,3,36252.00,2862.00,39114.00
220290,201806,1396,1192,204,1133876.80,194569.00,1328445.80
220300,201806,53,52,1,49608.00,954,50562.00
220310,201806,314,263,51,250898.00,48645.00,299543.00
220320,201806,435,402,33,382078.00,31482.00,413560.00
220323,201806,0,0,0,0,0,0
220325,201806,16,11,5,10494.00,4770.00,15264.00
220327,201806,13,12,1,11448.00,954,12402.00
220330,201806,208,143,65,136422.00,62010.00,198432.00
220335,201806,137,119,18,113526.00,17172.00,130698.00
220340,201806,26,15,11,14310.00,10494.00,24804.00
220342,201806,57,49,8,46746.00,7632.00,54378.00
220345,201806,85,77,8,73458.00,7632.00,81090.00
220350,201806,430,375,55,355127.42,52470.00,407597.42
220360,201806,43,31,12,29574.00,11448.00,41022.00
220370,201806,1123,913,210,870238.80,200053.80,1070292.60
220375,201806,26,24,2,22896.00,1908.00,24804.00
220380,201806,38,31,7,29574.00,6678.00,36252.00
220385,201806,27,23,4,21942.00,3816.00,25758.00
220390,201806,2247,1278,969,1214518.55,923329.50,2137848.05
220400,201806,29,26,3,24804.00,2862.00,27666.00
220410,201806,16,15,1,14310.00,954,15264.00
220415,201806,13,12,1,11448.00,954,12402.00
220420,201806,125,103,22,98262.00,20701.80,118963.80
220430,201806,128,116,12,108995.80,11448.00,120443.80
220435,201806,21,15,6,14305.23,5724.00,20029.23
220440,201806,288,247,41,235638.00,39114.00,274752.00
220450,201806,336,170,166,161014.98,158364.00,319378.98
220455,201806,54,52,2,49608.00,1908.00,51516.00
220460,201806,18,18,0,16504.20,0,16504.20
220465,201806,105,68,37,64872.00,35298.00,100170.00
220470,201806,242,214,28,204156.00,26712.00,230868.00
220480,201806,72,61,11,58194.00,10494.00,68688.00
220490,201806,87,75,12,71550.00,11448.00,82998.00
220500,201806,98,84,14,80136.00,13356.00,93492.00
220510,201806,382,304,78,289253.00,74221.20,363474.20
220515,201806,21,17,4,16218.00,3816.00,20034.00
220520,201806,372,334,38,317321.00,36233.00,353554.00
220525,201806,26,18,8,17172.00,7632.00,24804.00
220527,201806,37,28,9,26712.00,7776.00,34488.00
220530,201806,34,14,20,13356.00,19080.00,32436.00
220535,201806,7,7,0,6678.00,0,6678.00
220540,201806,59,50,9,47700.00,8586.00,56286.00
220545,201806,57,39,18,37206.00,17172.00,54378.00
220550,201806,645,494,151,470512.80,144054.00,614566.80
220551,201806,26,19,7,18126.00,6678.00,24804.00
220552,201806,7,7,0,6678.00,0,6678.00
220553,201806,49,44,5,41976.00,4770.00,46746.00
220554,201806,13,8,5,7345.80,4770.00,12115.80
220555,201806,25,21,4,20034.00,3816.00,23850.00
220556,201806,52,48,4,45792.00,3816.00,49608.00
220557,201806,57,51,6,48654.00,5724.00,54378.00
220558,201806,7,2,5,1908.00,4770.00,6678.00
220559,201806,6,5,1,4770.00,954,5724.00
220560,201806,58,37,21,35107.20,20034.00,55141.20
220570,201806,799,480,319,456716.14,304326.00,761042.14
220580,201806,557,511,46,487474.92,43197.92,530672.84
220585,201806,6,5,1,4770.00,954,5724.00
220590,201806,14,14,0,13356.00,0,13356.00
220595,201806,57,43,14,41022.00,13356.00,54378.00
220600,201806,23,12,11,11448.00,10494.00,21942.00
220605,201806,20,19,1,18126.00,954,19080.00
220610,201806,63,54,9,51516.00,8586.00,60102.00
220620,201806,559,438,121,417613.50,115434.00,533047.50
220630,201806,6,4,2,3816.00,1908.00,5724.00
220635,201806,38,34,4,32436.00,3816.00,36252.00
220640,201806,98,77,21,73458.00,20034.00,93492.00
220650,201806,116,110,6,104940.00,5724.00,110664.00
220660,201806,32,26,6,24804.00,5724.00,30528.00
220665,201806,4,4,0,3816.00,0,3816.00
220667,201806,15,13,2,12402.00,1908.00,14310.00
220669,201806,27,24,3,22896.00,2862.00,25758.00
220670,201806,73,57,16,54187.20,15264.00,69451.20
220672,201806,66,45,21,42930.00,20034.00,62964.00
220675,201806,36,28,8,26712.00,7632.00,34344.00
220680,201806,36,30,6,28620.00,5724.00,34344.00
220690,201806,45,43,2,41022.00,1908.00,42930.00
220695,201806,58,27,31,25758.00,29574.00,55332.00
220700,201806,1549,1184,365,1128391.20,348210.00,1476601.20
220710,201806,5,3,2,2862.00,1908.00,4770.00
220720,201806,109,89,20,84667.50,18936.90,103604.40
220730,201806,19,18,1,17172.00,954,18126.00
220735,201806,3,1,2,954,1908.00,2862.00
220740,201806,46,41,5,39114.00,4770.00,43884.00
220750,201806,99,81,18,77274.00,17172.00,94446.00
220755,201806,14,14,0,13356.00,0,13356.00
220760,201806,52,49,3,46746.00,2862.00,49608.00
220770,201806,5744,2937,2807,2796688.83,2671741.41,5468430.24
220775,201806,23,10,13,9540.00,12402.00,21942.00
220777,201806,16,15,1,14310.00,954,15264.00
220779,201806,17,13,4,12402.00,3816.00,16218.00
220780,201806,878,751,127,715786.20,120872.00,836658.20
220785,201806,13,8,5,7632.00,4770.00,12402.00
220790,201806,1016,811,205,771292.00,195570.00,966862.00
220793,201806,12,12,0,11448.00,0,11448.00
220795,201806,22,21,1,20034.00,954,20988.00
220800,201806,3964,3028,936,2886787.36,891967.89,3778755.25
220810,201806,60,53,7,50562.00,6678.00,57240.00
220820,201806,241,220,21,209880.00,20034.00,229914.00
220830,201806,1178,1000,178,953995.23,169793.00,1123788.23
220840,201806,2358,1624,734,1536517.35,698138.00,2234655.35
220850,201806,52,44,8,41976.00,7632.00,49608.00
220855,201806,14,9,5,8586.00,4770.00,13356.00
220860,201806,8,7,1,6678.00,954,7632.00
220865,201806,22,20,2,19080.00,1908.00,20988.00
220870,201806,61,59,2,56286.00,1908.00,58194.00
220880,201806,315,240,75,228292.20,71264.00,299556.20
220885,201806,42,39,3,37206.00,2862.00,40068.00
220887,201806,19,18,1,17172.00,954,18126.00
220890,201806,101,89,12,84906.00,11448.00,96354.00
220900,201806,49,28,21,26712.00,20034.00,46746.00
220910,201806,54,46,8,43884.00,7632.00,51516.00
220915,201806,10,9,1,8586.00,954,9540.00
220920,201806,41,37,4,35298.00,3816.00,39114.00
220930,201806,41,40,1,38160.00,954,39114.00
220935,201806,15,15,0,14310.00,0,14310.00
220937,201806,44,41,3,39114.00,2862.00,41976.00
220940,201806,52,48,4,45792.00,3816.00,49608.00
220945,201806,0,0,0,0,0,0
220950,201806,48,44,4,41976.00,3816.00,45792.00
220955,201806,33,29,4,27666.00,3816.00,31482.00
220960,201806,1,1,0,954,0,954
220965,201806,29,26,3,24804.00,2862.00,27666.00
220970,201806,47,40,7,38160.00,6678.00,44838.00
220975,201806,9,8,1,7632.00,954,8586.00
220980,201806,33,31,2,29574.00,1908.00,31482.00
220985,201806,65,57,8,54378.00,7632.00,62010.00
220987,201806,31,30,1,28620.00,954,29574.00
220990,201806,15,14,1,13356.00,954,14310.00
220995,201806,37,32,5,30528.00,4770.00,35298.00
220997,201806,45,37,8,35298.00,7632.00,42930.00
221000,201806,1136,1019,117,968951.18,111331.80,1080282.98
221005,201806,63,57,6,54378.00,5724.00,60102.00
221010,201806,17,14,3,13356.00,2862.00,16218.00
221020,201806,43,41,2,39114.00,1908.00,41022.00
221030,201806,30,24,6,22896.00,5724.00,28620.00
221035,201806,21,21,0,20034.00,0,20034.00
221037,201806,12,6,6,5724.00,5724.00,11448.00
221038,201806,26,23,3,21942.00,2862.00,24804.00
221039,201806,23,23,0,21942.00,0,21942.00
221040,201806,261,224,37,213696.00,35298.00,248994.00
221050,201806,234,198,36,188892.00,34344.00,223236.00
221060,201806,1746,1536,210,1462588.56,200340.00,1662928.56
221062,201806,29,28,1,26712.00,954,27666.00
221063,201806,14,10,4,9540.00,3816.00,13356.00
221065,201806,50,43,7,41022.00,6678.00,47700.00
221070,201806,141,122,19,116388.00,18126.00,134514.00
221080,201806,375,333,42,317682.00,39781.80,357463.80
221090,201806,34,33,1,31482.00,954,32436.00
221093,201806,56,36,20,34344.00,19080.00,53424.00
221095,201806,11,10,1,9540.00,954,10494.00
221097,201806,20,17,3,16218.00,2862.00,19080.00
221100,201806,24791,14293,10498,13614421.77,10009133.03,23623554.80
221110,201806,1043,769,274,733340.00,261396.00,994736.00
221120,201806,531,395,136,376544.00,129744.00,506288.00
221130,201806,941,768,173,731432.80,165042.00,896474.80
221135,201806,36,33,3,31482.00,2862.00,34344.00
221140,201806,41,33,8,31482.00,7632.00,39114.00
221150,201806,14,11,3,10494.00,2862.00,13356.00
221160,201806,12,12,0,11448.00,0,11448.00
221170,201806,13,13,0,12402.00,0,12402.00
230010,201806,165,152,13,145008.00,12402.00,157410.00
230015,201806,119,99,20,94446.00,19080.00,113526.00
230020,201806,1577,1342,235,1277339.82,223317.18,1500657.00
230030,201806,1634,1176,458,1116335.04,436932.00,1553267.04
230040,201806,204,180,24,170241.50,22896.00,193137.50
230050,201806,209,153,56,145962.00,53424.00,199386.00
230060,201806,156,127,29,120394.80,27666.00,148060.80
230070,201806,283,252,31,240408.00,29574.00,269982.00
230075,201806,817,713,104,678199.00,98929.80,777128.80
230080,201806,178,153,25,145962.00,23850.00,169812.00
230090,201806,102,70,32,66016.80,30528.00,96544.80
230100,201806,1943,1158,785,1102445.00,748890.00,1851335.00
230110,201806,2650,1697,953,1616825.40,908589.80,2525415.20
230120,201806,952,761,191,723610.22,182195.00,905805.22
230125,201806,142,116,26,110664.00,24804.00,135468.00
230130,201806,465,417,48,397818.00,45792.00,443610.00
230140,201806,203,176,27,167904.00,25758.00,193662.00
230150,201806,159,125,34,119250.00,32436.00,151686.00
230160,201806,922,792,130,755091.00,124020.00,879111.00
230170,201806,588,542,46,512555.70,43884.00,556439.70
230180,201806,78,73,5,69642.00,4770.00,74412.00
230185,201806,407,353,54,335664.90,51516.00,387180.90
230190,201806,2205,1782,423,1696048.48,403225.00,2099273.48
230195,201806,490,425,65,405450.00,62010.00,467460.00
230200,201806,371,322,49,306224.46,46746.00,352970.46
230205,201806,354,229,125,216982.53,119250.00,336232.53
230210,201806,1253,1001,252,953035.72,239644.80,1192680.52
230220,201806,1414,976,438,930340.80,417852.00,1348192.80
230230,201806,891,780,111,743929.20,105894.00,849823.20
230240,201806,1637,1412,225,1346126.70,214650.00,1560776.70
230250,201806,1775,1465,310,1393449.17,295740.00,1689189.17
230260,201806,2950,1789,1161,1703134.96,1106621.69,2809756.65
230270,201806,1349,1084,265,1031917.99,251617.50,1283535.49
230280,201806,2726,2029,697,1929276.80,664270.20,2593547.00
230290,201806,399,361,38,339343.79,36252.00,375595.79
230300,201806,512,380,132,361260.72,125928.00,487188.72
230310,201806,417,314,103,299408.13,98262.00,397670.13
230320,201806,924,787,137,747387.80,130698.00,878085.80
230330,201806,303,244,59,232012.80,56096.00,288108.80
230340,201806,454,365,89,347257.00,84906.00,432163.00
230350,201806,3048,1926,1122,1837356.30,1067813.28,2905169.58
230360,201806,267,215,52,204314.00,49608.00,253922.00
230365,201806,134,108,26,102317.00,24804.00,127121.00
230370,201806,9742,4781,4961,4551689.14,4729243.66,9280932.80
230380,201806,462,398,64,379406.00,60102.60,439508.60
230390,201806,511,282,229,267224.94,218466.00,485690.94
230393,201806,265,219,46,206832.96,43884.00,250716.96
230395,201806,337,275,62,262102.00,59148.00,321250.00
230400,201806,593,473,120,449334.00,113983.92,563317.92
230410,201806,2627,1639,988,1557215.75,941790.00,2499005.75
230420,201806,6052,3974,2078,3773012.16,1977835.14,5750847.30
230423,201806,314,273,41,260442.00,39114.00,299556.00
230425,201806,364,300,64,285599.00,61056.00,346655.00
230426,201806,109,98,11,92766.96,10207.80,102974.76
230427,201806,79,76,3,72504.00,2862.00,75366.00
230428,201806,1366,704,662,671367.96,631548.00,1302915.96
230430,201806,446,361,85,344200.00,81090.00,425290.00
230435,201806,805,567,238,539662.43,225812.61,765475.04
230440,201806,83966,37075,46891,35279652.74,44686369.22,79966021.96
230445,201806,268,187,81,178207.20,77274.00,255481.20
230450,201806,534,434,100,414036.00,95400.00,509436.00
230460,201806,58,49,9,46746.00,8586.00,55332.00
230465,201806,302,246,56,234684.00,53424.00,288108.00
230470,201806,1884,1477,407,1409058.00,387171.10,1796229.10
230480,201806,153,147,6,139951.80,5724.00,145675.80
230490,201806,280,226,54,215604.00,51516.00,267120.00
230495,201806,436,329,107,312983.38,102078.00,415061.38
230500,201806,950,710,240,676386.00,228960.00,905346.00
230510,201806,45,36,9,34344.00,8586.00,42930.00
230520,201806,385,304,81,290016.00,77274.00,367290.00
230523,201806,2081,1307,774,1244527.66,737948.00,1982475.66
230526,201806,300,251,49,239454.00,45955.00,285409.00
230530,201806,674,501,173,474941.59,164088.20,639029.79
230533,201806,181,172,9,164088.00,8586.00,172674.00
230535,201806,344,257,87,245178.00,82998.00,328176.00
230540,201806,1838,1606,232,1529481.04,220755.80,1750236.84
230550,201806,3639,2331,1308,2214780.86,1246482.09,3461262.95
230560,201806,578,443,135,420523.80,127836.00,548359.80
230565,201806,199,144,55,137376.00,51707.00,189083.00
230570,201806,304,268,36,255672.00,34344.00,290016.00
230580,201806,1114,823,291,782709.64,276660.00,1059369.64
230590,201806,960,747,213,709062.10,202725.00,911787.10
230600,201806,256,232,24,220584.07,22896.00,243480.07
230610,201806,334,266,68,253574.00,64872.00,318446.00
230620,201806,167,137,30,129744.00,28620.00,158364.00
230625,201806,725,527,198,501203.78,187738.68,688942.46
230630,201806,1273,1007,266,960678.00,253382.40,1214060.40
230640,201806,3589,3100,489,2950165.65,465747.57,3415913.22
230650,201806,396,344,52,327297.37,49593.69,376891.06
230655,201806,653,565,88,538056.80,83886.38,621943.18
230660,201806,348,293,55,279522.00,52183.80,331705.80
230670,201806,425,377,48,359658.00,45792.00,405450.00
230680,201806,195,179,16,170766.00,15264.00,186030.00
230690,201806,864,754,110,719316.00,104940.00,824256.00
230700,201806,703,595,108,567630.00,102726.80,670356.80
230710,201806,733,694,39,662076.00,37206.00,699282.00
230720,201806,149,126,23,119812.86,21942.00,141754.86
230725,201806,240,191,49,182214.00,46580.00,228794.00
230730,201806,11752,6380,5372,6070609.54,5116238.02,11186847.56
230740,201806,652,523,129,498656.00,122375.46,621031.46
230750,201806,809,692,117,658976.30,111618.00,770594.30
230760,201806,1322,1144,178,1087329.25,169812.00,1257141.25
230763,201806,319,266,53,251808.95,50562.00,302370.95
230765,201806,6904,3250,3654,3095150.96,3484787.30,6579938.26
230770,201806,4947,2541,2406,2414683.36,2293864.38,4708547.74
230780,201806,685,602,83,571406.10,79167.69,650573.79
230790,201806,200,165,35,157410.00,32589.40,189999.40
230800,201806,1119,821,298,782924.15,284292.00,1067216.15
230810,201806,1304,1159,145,1104684.30,138139.20,1242823.50
230820,201806,336,237,99,225145.00,94446.00,319591.00
230830,201806,940,813,127,772088.41,121158.00,893246.41
230835,201806,279,240,39,228006.00,36491.00,264497.00
230837,201806,161,136,25,129744.00,23850.00,153594.00
230840,201806,913,732,181,697088.50,172388.00,869476.50
230850,201806,1485,1294,191,1233999.00,181928.00,1415927.00
230860,201806,297,222,75,211788.00,71550.00,283338.00
230870,201806,1811,1542,269,1470114.00,256054.00,1726168.00
230880,201806,42,30,12,28620.00,11448.00,40068.00
230890,201806,567,521,46,496911.80,43870.00,540781.80
230900,201806,275,209,66,199386.00,62767.00,262153.00
230910,201806,197,159,38,150922.80,36252.00,187174.80
230920,201806,402,316,86,301464.00,82044.00,383508.00
230930,201806,922,649,273,616284.64,260442.00,876726.64
230940,201806,823,661,162,630594.00,154358.00,784952.00
230945,201806,482,404,78,384940.00,74412.00,459352.00
230950,201806,375,321,54,306234.00,51516.00,357750.00
230960,201806,2573,1736,837,1649416.84,798193.00,2447609.84
230970,201806,1747,983,764,936786.20,727978.32,1664764.52
230980,201806,211,179,32,170766.00,30528.00,201294.00
230990,201806,139,112,27,106848.00,25001.47,131849.47
231000,201806,208,188,20,177444.00,19080.00,196524.00
231010,201806,138,108,30,102745.80,28620.00,131365.80
231020,201806,1304,904,400,860795.00,381600.00,1242395.00
231025,201806,969,733,236,695415.20,223598.80,919014.00
231030,201806,1135,945,190,901526.00,180688.00,1082214.00
231040,201806,140,97,43,91793.88,40291.00,132084.88
231050,201806,987,879,108,836801.90,103032.00,939833.90
231060,201806,143,125,18,119250.00,17172.00,136422.00
231070,201806,1434,1013,421,964304.10,401634.00,1365938.10
231080,201806,262,244,18,231965.10,17172.00,249137.10
231085,201806,561,347,214,330085.00,204156.00,534241.00
231090,201806,241,200,41,190800.00,39114.00,229914.00
231095,201806,165,131,34,124974.00,32436.00,157410.00
231100,201806,125,104,21,99216.00,18793.80,118009.80
231110,201806,353,307,46,290688.10,43884.00,334572.10
231120,201806,296,253,43,240403.86,41022.00,281425.86
231123,201806,138,131,7,124974.00,6678.00,131652.00
231126,201806,298,246,52,234684.00,49608.00,284292.00
231130,201806,4565,3557,1008,3384436.50,960559.26,4344995.76
231135,201806,212,181,31,172674.00,28308.40,200982.40
231140,201806,3071,2269,802,2161773.54,764115.84,2925889.38
231150,201806,360,343,17,327222.00,16218.00,343440.00
231160,201806,1211,957,254,909878.62,242087.04,1151965.66
231170,201806,537,357,180,340578.00,171720.00,512298.00
231180,201806,1625,1379,246,1314802.80,234655.38,1549458.18
231190,201806,193,171,22,163134.00,20988.00,184122.00
231195,201806,212,182,30,172904.00,28620.00,201524.00
231200,201806,826,672,154,641088.00,145656.00,786744.00
231210,201806,607,507,100,482724.80,95400.00,578124.80
231220,201806,1032,744,288,708136.12,274752.00,982888.12
231230,201806,1402,1125,277,1072048.04,263494.80,1335542.84
231240,201806,1367,991,376,945127.80,357435.58,1302563.38
231250,201806,110,102,8,97308.00,7632.00,104940.00
231260,201806,291,187,104,178398.00,98930.00,277328.00
231270,201806,1000,833,167,789387.68,159245.23,948632.91
231280,201806,57,44,13,41976.00,12402.00,54378.00
231290,201806,7190,4013,3177,3821306.24,3028513.21,6849819.45
231300,201806,626,580,46,553320.00,43884.00,597204.00
231310,201806,707,656,51,624607.00,48654.00,673261.00
231320,201806,571,437,134,416422.00,127836.00,544258.00
231325,201806,88,79,9,75366.00,8586.00,83952.00
231330,201806,2025,1568,457,1490038.58,433975.60,1924014.18
231335,201806,248,220,28,209880.00,26712.00,236592.00
231340,201806,1628,1203,425,1146518.08,405163.80,1551681.88
231350,201806,1187,974,213,929196.00,202630.00,1131826.00
231355,201806,413,357,56,340578.00,53424.00,394002.00
231360,201806,476,374,102,354086.20,97308.00,451394.20
231370,201806,91,75,16,71550.00,15264.00,86814.00
231375,201806,286,208,78,198432.00,74412.00,272844.00
231380,201806,458,371,87,352338.69,82807.20,435145.89
231390,201806,197,162,35,154548.00,33390.00,187938.00
231395,201806,732,452,280,429910.56,267120.00,697030.56
231400,201806,1068,885,183,841718.53,174239.38,1015957.91
231410,201806,1319,1074,245,1020781.40,232758.00,1253539.40
240010,201806,396,183,213,173430.26,202907.00,376337.26
240020,201806,2192,1718,474,1636146.23,452192.00,2088338.23
240030,201806,131,111,20,105894.00,19080.00,124974.00
240040,201806,32,32,0,30528.00,0,30528.00
240050,201806,512,439,73,417952.45,69642.00,487594.45
240060,201806,66,62,4,59148.00,3816.00,62964.00
240070,201806,187,146,41,139284.00,39114.00,178398.00
240080,201806,445,300,145,286196.00,137090.71,423286.71
240090,201806,106,94,12,89370.72,11448.00,100818.72
240100,201806,1442,1359,83,1293513.55,78991.20,1372504.75
240110,201806,981,623,358,593370.26,341246.00,934616.26
240120,201806,138,117,21,111618.00,20034.00,131652.00
240130,201806,285,267,18,254001.54,17172.00,271173.54
240140,201806,80,64,16,61056.00,15264.00,76320.00
240145,201806,693,613,80,584277.30,76110.12,660387.42
240150,201806,20,15,5,14310.00,4741.38,19051.38
240160,201806,44,38,6,36252.00,5724.00,41976.00
240165,201806,34,28,6,26474.00,5724.00,32198.00
240170,201806,93,70,23,66780.00,21942.00,88722.00
240180,201806,78,64,14,61056.00,13356.00,74412.00
240185,201806,44,40,4,38150.46,3816.00,41966.46
240190,201806,12,10,2,9540.00,1908.00,11448.00
240200,201806,3001,1679,1322,1595499.67,1259949.00,2855448.67
240210,201806,167,130,37,124020.00,35298.00,159318.00
240220,201806,1090,788,302,751609.00,288098.46,1039707.46
240230,201806,831,771,60,732700.05,56592.00,789292.05
240240,201806,120,87,33,82998.00,31482.00,114480.00
240250,201806,91,79,12,75366.00,11448.00,86814.00
240260,201806,1802,1343,459,1280535.12,436617.18,1717152.30
240270,201806,191,168,23,159890.40,21942.00,181832.40
240280,201806,42,32,10,30528.00,9540.00,40068.00
240290,201806,50,49,1,46746.00,954,47700.00
240300,201806,178,100,78,95400.00,74412.00,169812.00
240310,201806,2011,1099,912,1037713.98,866535.03,1904249.01
240320,201806,206,196,10,186984.00,9540.00,196524.00
240325,201806,4300,2626,1674,2497733.46,1593587.86,4091321.32
240330,201806,66,62,4,59148.00,3816.00,62964.00
240340,201806,104,76,28,72504.00,26712.00,99216.00
240350,201806,89,79,10,75366.00,9540.00,84906.00
240360,201806,420,294,126,280476.00,120204.00,400680.00
240370,201806,40,38,2,36252.00,1908.00,38160.00
240375,201806,69,40,29,38160.00,27666.00,65826.00
240380,201806,231,188,43,179352.00,40927.00,220279.00
240390,201806,16,13,3,12402.00,2862.00,15264.00
240400,201806,76,72,4,68688.00,3816.00,72504.00
240410,201806,11,7,4,6678.00,3816.00,10494.00
240420,201806,900,698,202,663110.40,191658.60,854769.00
240430,201806,262,247,15,234727.89,14310.00,249037.89
240440,201806,71,38,33,36252.00,31482.00,67734.00
240450,201806,207,140,67,132987.80,63918.00,196905.80
240460,201806,60,47,13,44838.00,12402.00,57240.00
240470,201806,234,202,32,192150.86,30528.00,222678.86
240480,201806,14,14,0,13260.60,0,13260.60
240485,201806,75,65,10,62010.00,9540.00,71550.00
240490,201806,46,45,1,42720.12,954,43674.12
240500,201806,84,67,17,63918.00,16218.00,80136.00
240510,201806,51,36,15,34344.00,14310.00,48654.00
240520,201806,127,121,6,115434.00,5724.00,121158.00
240530,201806,54,48,6,45792.00,5724.00,51516.00
240540,201806,78,67,11,63918.00,10494.00,74412.00
240550,201806,15,13,2,12402.00,1908.00,14310.00
240560,201806,372,276,96,262677.23,91584.00,354261.23
240570,201806,464,289,175,274847.40,166950.00,441797.40
240580,201806,1255,1018,237,965687.90,224940.20,1190628.10
240590,201806,30,28,2,26712.00,1908.00,28620.00
240600,201806,110,107,3,102078.00,2862.00,104940.00
240610,201806,509,426,83,406047.70,78419.00,484466.70
240615,201806,19,18,1,17172.00,954,18126.00
240620,201806,96,92,4,87768.00,3816.00,91584.00
240630,201806,35,33,2,31482.00,1908.00,33390.00
240640,201806,25,21,4,20034.00,3816.00,23850.00
240650,201806,235,198,37,188033.90,35298.00,223331.90
240660,201806,99,87,12,82998.00,11448.00,94446.00
240670,201806,293,173,120,162943.30,114480.00,277423.30
240680,201806,49,38,11,36252.00,10494.00,46746.00
240690,201806,49,46,3,43884.00,2862.00,46746.00
240700,201806,192,158,34,150732.00,32436.00,183168.00
240710,201806,1935,1234,701,1176802.83,668735.46,1845538.29
240720,201806,1055,774,281,737241.86,268074.00,1005315.86
240725,201806,66,62,4,59148.00,3816.00,62964.00
240730,201806,133,115,18,109710.00,17172.00,126882.00
240740,201806,240,202,38,191343.78,35298.02,226641.80
240750,201806,37,25,12,23850.00,11448.00,35298.00
240760,201806,33,29,4,27666.00,3816.00,31482.00
240770,201806,148,114,34,108756.00,32436.00,141192.00
240780,201806,690,572,118,544247.46,112572.00,656819.46
240790,201806,38,37,1,35298.00,954,36252.00
240800,201806,8668,5886,2782,5576665.64,2646389.20,8223054.84
240810,201806,20067,11040,9027,10489445.33,8601649.25,19091094.58
240820,201806,209,132,77,125637.03,73458.00,199095.03
240830,201806,1606,1316,290,1249893.16,276660.00,1526553.16
240840,201806,81,71,10,67734.00,9540.00,77274.00
240850,201806,86,75,11,71550.00,10494.00,82044.00
240860,201806,115,112,3,106848.00,2862.00,109710.00
240870,201806,60,53,7,50562.00,6678.00,57240.00
240880,201806,29,26,3,24794.46,2862.00,27656.46
240890,201806,1169,696,473,660074.78,451238.00,1111312.78
240895,201806,47,34,13,32436.00,12402.00,44838.00
240910,201806,156,141,15,134514.00,14310.00,148824.00
240920,201806,16,13,3,12402.00,2862.00,15264.00
240930,201806,385,349,36,331992.00,34344.00,366336.00
240933,201806,31,24,7,22896.00,6678.00,29574.00
240940,201806,2435,2155,280,2042377.29,264238.92,2306616.21
240950,201806,51,48,3,45792.00,2862.00,48654.00
240960,201806,32,26,6,24804.00,5724.00,30528.00
240970,201806,126,89,37,84906.00,34544.00,119450.00
240980,201806,188,150,38,143100.00,36252.00,179352.00
240990,201806,118,77,41,73458.00,39114.00,112572.00
241000,201806,69,64,5,61056.00,4770.00,65826.00
241010,201806,60,48,12,45792.00,11448.00,57240.00
241020,201806,116,109,7,103986.00,6678.00,110664.00
241025,201806,10,4,6,3816.00,5724.00,9540.00
241030,201806,119,97,22,92538.00,20988.00,113526.00
241040,201806,35,29,6,27666.00,5724.00,33390.00
241050,201806,90,78,12,74412.00,11448.00,85860.00
241060,201806,28,24,4,22896.00,3816.00,26712.00
241070,201806,14,14,0,13356.00,0,13356.00
241080,201806,64,57,7,54091.80,6678.00,60769.80
241090,201806,49,40,9,38160.00,8571.69,46731.69
241100,201806,73,63,10,60102.00,9540.00,69642.00
241105,201806,6,2,4,1908.00,3816.00,5724.00
241110,201806,47,45,2,42930.00,1908.00,44838.00
241120,201806,1437,1112,325,1057862.80,310050.00,1367912.80
241140,201806,224,184,40,174583.00,38160.00,212743.00
241142,201806,43,41,2,39114.00,1908.00,41022.00
241150,201806,1214,1068,146,1016154.00,139284.00,1155438.00
241160,201806,22,21,1,20034.00,954,20988.00
241170,201806,42,39,3,37206.00,2862.00,40068.00
241180,201806,49,41,8,38939.42,7632.00,46571.42
241190,201806,38,37,1,35298.00,954,36252.00
241200,201806,3863,2105,1758,2002539.62,1675211.66,3677751.28
241210,201806,70,59,11,56286.00,9636.00,65922.00
241220,201806,1377,926,451,882939.04,430220.92,1313159.96
241230,201806,246,206,40,196333.20,38160.00,234493.20
241240,201806,51,39,12,37206.00,11448.00,48654.00
241250,201806,1094,1013,81,966116.00,77027.00,1043143.00
241255,201806,47,37,10,35298.00,9540.00,44838.00
241260,201806,637,502,135,478903.23,128790.00,607693.23
241270,201806,46,33,13,31482.00,12402.00,43884.00
241280,201806,98,85,13,81090.00,12402.00,93492.00
241290,201806,109,81,28,77274.00,26712.00,103986.00
241300,201806,79,56,23,53424.00,21942.00,75366.00
241310,201806,51,38,13,36109.00,12402.00,48511.00
241320,201806,28,14,14,13356.00,13356.00,26712.00
241330,201806,60,54,6,51516.00,5724.00,57240.00
241335,201806,62,55,7,51802.20,6678.00,58480.20
241340,201806,187,140,47,133560.00,44838.00,178398.00
241350,201806,59,54,5,51516.00,4770.00,56286.00
241355,201806,39,36,3,34344.00,2862.00,37206.00
241360,201806,46,46,0,43884.00,0,43884.00
241370,201806,44,37,7,35173.98,6678.00,41851.98
241380,201806,38,35,3,33390.00,2862.00,36252.00
241390,201806,75,60,15,57049.20,14310.00,71359.20
241400,201806,202,164,38,155788.20,36252.00,192040.20
241410,201806,177,160,17,152640.00,16122.60,168762.60
241415,201806,95,76,19,72504.00,18126.00,90630.00
241420,201806,98,74,24,70596.00,22725.00,93321.00
241430,201806,28,27,1,25758.00,954,26712.00
241440,201806,480,399,81,380632.00,77274.00,457906.00
241445,201806,38,36,2,34344.00,1908.00,36252.00
241450,201806,274,223,51,212742.00,48654.00,261396.00
241460,201806,136,124,12,118058.00,11448.00,129506.00
241470,201806,42,35,7,33390.00,6678.00,40068.00
241475,201806,64,62,2,59148.00,1908.00,61056.00
241480,201806,100,71,29,66780.69,27666.00,94446.69
241490,201806,8,7,1,6678.00,954,7632.00
241500,201806,47,34,13,32436.00,12402.00,44838.00
250010,201806,101,87,14,82854.90,13356.00,96210.90
250020,201806,27,24,3,22896.00,2862.00,25758.00
250030,201806,807,599,208,570101.20,197383.60,767484.80
250040,201806,334,280,54,267120.00,51229.80,318349.80
250050,201806,229,190,39,180969.80,37206.00,218175.80
250053,201806,54,41,13,39114.00,12402.00,51516.00
250057,201806,0,0,0,0,0,0
250060,201806,450,343,107,327222.00,101791.80,429013.80
250070,201806,707,588,119,558934.00,113526.00,672460.00
250073,201806,7,7,0,6678.00,0,6678.00
250077,201806,197,148,49,140800.86,46746.00,187546.86
250080,201806,423,330,93,313199.20,88722.00,401921.20
250090,201806,200,132,68,124974.40,64852.92,189827.32
250100,201806,511,421,90,401634.00,85479.00,487113.00
250110,201806,569,431,138,409390.02,131652.00,541042.02
250115,201806,25,8,17,7632.00,16218.00,23850.00
250120,201806,112,82,30,78228.00,28620.00,106848.00
250130,201806,579,465,114,443610.00,108566.00,552176.00
250135,201806,14,8,6,7632.00,5724.00,13356.00
250140,201806,79,71,8,67734.00,7632.00,75366.00
250150,201806,577,423,154,401154.58,146601.18,547755.76
250153,201806,10,9,1,8586.00,954,9540.00
250157,201806,28,23,5,21942.00,4770.00,26712.00
250160,201806,215,168,47,160272.00,44838.00,205110.00
250170,201806,64,45,19,42930.00,18126.00,61056.00
250180,201806,4020,2720,1300,2581222.90,1235102.00,3816324.90
250190,201806,867,570,297,542110.50,282622.50,824733.00
250200,201806,53,44,9,41976.00,8586.00,50562.00
250205,201806,22,19,3,18126.00,2862.00,20988.00
250210,201806,90,78,12,74412.00,11448.00,85860.00
250215,201806,63,54,9,51516.00,8586.00,60102.00
250220,201806,27,21,6,20034.00,5724.00,25758.00
250230,201806,78,71,7,67730.00,6678.00,74408.00
250240,201806,244,203,41,192851.10,39114.00,231965.10
250250,201806,396,338,58,322452.00,55332.00,377784.00
250260,201806,31,28,3,26712.00,2862.00,29574.00
250270,201806,57,45,12,42930.00,11448.00,54378.00
250280,201806,379,317,62,302418.00,59148.00,361566.00
250290,201806,95,90,5,85573.80,4770.00,90343.80
250300,201806,556,380,176,361872.71,167891.00,529763.71
250310,201806,47,42,5,40068.00,4770.00,44838.00
250320,201806,1991,1359,632,1291231.35,601354.80,1892586.15
250330,201806,84,75,9,71550.00,8586.00,80136.00
250340,201806,24,20,4,19080.00,3816.00,22896.00
250350,201806,139,89,50,84619.80,47127.60,131747.40
250355,201806,31,24,7,22896.00,6678.00,29574.00
250360,201806,199,163,36,155502.00,34106.00,189608.00
250370,201806,2376,1606,770,1527165.98,733023.82,2260189.80
250375,201806,16,12,4,11448.00,3816.00,15264.00
250380,201806,53,37,16,35298.00,15264.00,50562.00
250390,201806,42,34,8,32436.00,7632.00,40068.00
250400,201806,15751,7979,7772,7586266.13,7408039.55,14994305.68
250403,201806,418,342,76,326258.46,72504.00,398762.46
250407,201806,58,50,8,47700.00,7632.00,55332.00
250410,201806,32,27,5,25758.00,4770.00,30528.00
250415,201806,43,29,14,27646.92,13336.92,40983.84
250420,201806,46,38,8,36252.00,7632.00,43884.00
250430,201806,1528,1301,227,1238961.00,216558.00,1455519.00
250435,201806,16,13,3,12402.00,2862.00,15264.00
250440,201806,692,595,97,563697.22,92538.00,656235.22
250450,201806,88,73,15,69642.00,13642.20,83284.20
250460,201806,418,287,131,273798.00,124964.46,398762.46
250470,201806,86,63,23,60102.00,21942.00,82044.00
250480,201806,325,257,68,245178.00,64872.00,310050.00
250485,201806,2,1,1,954,954,1908
250490,201806,209,171,38,163134.00,36252.00,199386.00
250500,201806,77,57,20,54378.00,19080.00,73458.00
250510,201806,736,579,157,551603.00,148769.43,700372.43
250520,201806,173,120,53,114460.92,50557.23,165018.15
250523,201806,113,94,19,89676.00,18126.00,107802.00
250527,201806,102,81,21,77269.23,20034.00,97303.23
250530,201806,7,5,2,4770.00,1908.00,6678.00
250535,201806,25,21,4,20034.00,3816.00,23850.00
250540,201806,121,92,29,87052.50,27666.00,114718.50
250550,201806,70,67,3,63918.00,2862.00,66780.00
250560,201806,39,31,8,29574.00,7632.00,37206.00
250570,201806,150,120,30,114480.00,28620.00,143100.00
250580,201806,131,103,28,98037.80,26712.00,124749.80
250590,201806,20,16,4,15264.00,3816.00,19080.00
250600,201806,1239,833,406,792775.35,387228.60,1180003.95
250610,201806,150,130,20,124020.00,19080.00,143100.00
250620,201806,22,18,4,17172.00,3816.00,20988.00
250625,201806,65,49,16,46746.00,15264.00,62010.00
250630,201806,3017,1937,1080,1839855.65,1029252.74,2869108.39
250640,201806,203,169,34,161226.00,32436.00,193662.00
250650,201806,31,21,10,20034.00,9540.00,29574.00
250660,201806,45,35,10,33390.00,9540.00,42930.00
250670,201806,61,40,21,38160.00,20034.00,58194.00
250680,201806,382,315,67,300510.00,63918.00,364428.00
250690,201806,1843,1272,571,1210020.91,544352.80,1754373.71
250700,201806,928,818,110,777899.62,104730.12,882629.74
250710,201806,449,349,100,332946.00,95400.00,428346.00
250720,201806,104,82,22,78228.00,20988.00,99216.00
250730,201806,379,318,61,302418.60,58194.00,360612.60
250740,201806,52,48,4,45792.00,3816.00,49608.00
250750,201806,20533,12323,8210,11699666.50,7822797.08,19522463.58
250760,201806,74,55,19,52470.00,18126.00,70596.00
250770,201806,350,229,121,216558.14,113025.55,329583.69
250780,201806,54,41,13,39114.00,12402.00,51516.00
250790,201806,469,306,163,290016.92,154786.50,444803.42
250800,201806,155,142,13,134752.50,12402.00,147154.50
250810,201806,78,60,18,57240.00,17172.00,74412.00
250820,201806,160,130,30,124020.00,28620.00,152640.00
250830,201806,418,286,132,271842.50,125928.00,397770.50
250840,201806,53,51,2,48654.00,1908.00,50562.00
250850,201806,55,43,12,40335.12,11448.00,51783.12
250855,201806,14,12,2,11448.00,1908.00,13356.00
250860,201806,202,145,57,138330.00,54091.80,192421.80
250870,201806,33,30,3,28620.00,2862.00,31482.00
250880,201806,79,61,18,58184.46,17172.00,75356.46
250890,201806,2430,1793,637,1708824.75,606834.73,2315659.48
250900,201806,121,103,18,98262.00,17172.00,115434.00
250905,201806,124,96,28,91584.00,26712.00,118296.00
250910,201806,1176,836,340,796381.31,323787.80,1120169.11
250915,201806,110,76,34,72504.00,32436.00,104940.00
250920,201806,138,107,31,102078.00,29574.00,131652.00
250930,201806,162,99,63,94446.00,60102.00,154548.00
250933,201806,1,1,0,954,0,954
250937,201806,6,5,1,4770.00,954,5724.00
250939,201806,31,22,9,20988.00,8586.00,29574.00
250940,201806,103,76,27,72504.00,25758.00,98262.00
250950,201806,70,47,23,44838.00,21942.00,66780.00
250960,201806,90,49,41,46746.00,39114.00,85860.00
250970,201806,1212,864,348,822635.00,331038.00,1153673.00
250980,201806,91,64,27,61056.00,25758.00,86814.00
250990,201806,165,129,36,122593.77,34301.07,156894.84
251000,201806,76,68,8,64681.20,7632.00,72313.20
251010,201806,103,80,23,76316.00,21163.53,97479.53
251020,201806,80,70,10,65969.10,9540.00,75509.10
251030,201806,43,33,10,31482.00,9540.00,41022.00
251040,201806,53,38,15,36252.00,14310.00,50562.00
251050,201806,23,21,2,20034.00,1908.00,21942.00
251060,201806,51,40,11,37206.00,10494.00,47700.00
251065,201806,3,3,0,2862.00,0,2862.00
251070,201806,25,20,5,19071.00,4770.00,23841.00
251080,201806,4705,2278,2427,2162548.72,2308805.01,4471353.73
251090,201806,197,169,28,161226.00,26712.00,187938.00
251100,201806,18,17,1,16218.00,954,17172.00
251110,201806,46,37,9,35298.00,8586.00,43884.00
251120,201806,1817,1103,714,1047352.20,681156.00,1728508.20
251130,201806,385,313,72,298492.29,68688.00,367180.29
251140,201806,516,334,182,317492.80,173459.34,490952.14
251150,201806,295,256,39,243452.00,37206.00,280658.00
251160,201806,95,80,15,76316.00,14310.00,90626.00
251170,201806,98,78,20,74383.38,19075.23,93458.61
251180,201806,288,181,107,172665.23,102069.23,274734.46
251190,201806,191,130,61,123691.83,58194.00,181885.83
251200,201806,255,207,48,197478.00,45792.00,243270.00
251203,201806,34,32,2,30528.00,1908.00,32436.00
251207,201806,95,79,16,75366.00,15264.00,90630.00
251210,201806,1414,1016,398,967710.53,379024.20,1346734.73
251220,201806,47,37,10,35298.00,9540.00,44838.00
251230,201806,469,391,78,373014.00,74412.00,447426.00
251240,201806,100,72,28,67734.00,26712.00,94446.00
251250,201806,1342,961,381,913904.87,363331.00,1277235.87
251260,201806,13,8,5,7632.00,4770.00,12402.00
251270,201806,343,256,87,244224.00,82855.00,327079.00
251272,201806,63,58,5,55332.00,4770.00,60102.00
251274,201806,27,22,5,20988.00,4770.00,25758.00
251275,201806,23,16,7,15264.00,6678.00,21942.00
251276,201806,17,13,4,12402.00,3816.00,16218.00
251278,201806,9,7,2,6678.00,1908.00,8586.00
251280,201806,100,95,5,90630.00,4770.00,95400.00
251290,201806,705,532,173,507528.00,165042.00,672570.00
251300,201806,16,14,2,13356.00,1908.00,15264.00
251310,201806,366,263,103,250898.00,98262.00,349160.00
251315,201806,19,18,1,17172.00,954,18126.00
251320,201806,60,49,11,46746.00,10494.00,57240.00
251330,201806,81,72,9,68688.00,8586.00,77274.00
251335,201806,12,7,5,6678.00,4770.00,11448.00
251340,201806,697,411,286,392094.00,271819.25,663913.25
251350,201806,37,35,2,33390.00,1908.00,35298.00
251360,201806,68,60,8,57033.94,7632.00,64665.94
251365,201806,15,14,1,13356.00,954,14310.00
251370,201806,5300,3604,1696,3433901.94,1616650.00,5050551.94
251380,201806,50,40,10,38160.00,9540.00,47700.00
251385,201806,3,3,0,2862.00,0,2862.00
251390,201806,684,543,141,516878.20,133274.00,650152.20
251392,201806,12,7,5,6678.00,4770.00,11448.00
251394,201806,10,10,0,9540.00,0,9540.00
251396,201806,14,9,5,8586.00,4770.00,13356.00
251398,201806,18,15,3,14310.00,2862.00,17172.00
251400,201806,41,34,7,32436.00,6678.00,39114.00
251410,201806,36,31,5,29574.00,4770.00,34344.00
251420,201806,104,78,26,74412.00,24804.00,99216.00
251430,201806,39,37,2,35298.00,1908.00,37206.00
251440,201806,33,22,11,20988.00,10494.00,31482.00
251445,201806,54,49,5,46746.00,4770.00,51516.00
251450,201806,419,370,49,351324.80,46746.00,398070.80
251455,201806,2,1,1,954,954,1908
251460,201806,16,12,4,11448.00,3816.00,15264.00
251465,201806,5,2,3,1908.00,2862.00,4770.00
251470,201806,47,37,10,35298.00,9540.00,44838.00
251480,201806,26,24,2,22896.00,1908.00,24804.00
251490,201806,124,86,38,81567.00,35299.00,116866.00
251500,201806,119,95,24,90630.00,22133.00,112763.00
251510,201806,38,29,9,27666.00,8586.00,36252.00
251520,201806,25,25,0,23850.00,0,23850.00
251530,201806,4530,3187,1343,3033812.24,1280926.26,4314738.50
251540,201806,74,65,9,62010.00,8586.00,70596.00
251550,201806,412,319,93,303372.20,88198.00,391570.20
251560,201806,24,17,7,16218.00,6678.00,22896.00
251570,201806,19,19,0,18126.00,0,18126.00
251580,201806,121,99,22,94446.00,20988.00,115434.00
251590,201806,123,92,31,87949.00,29574.00,117523.00
251593,201806,21,12,9,11448.00,8586.00,20034.00
251597,201806,54,44,10,41976.00,9540.00,51516.00
251600,201806,1096,775,321,737858.48,304625.92,1042484.40
251610,201806,209,158,51,150732.00,47987.00,198719.00
251615,201806,4,3,1,2862.00,954,3816.00
251620,201806,4244,2830,1414,2689979.84,1346191.00,4036170.84
251630,201806,451,333,118,317682.00,112563.00,430245.00
251640,201806,150,105,45,100170.00,42930.00,143100.00
251650,201806,267,194,73,183243.10,69642.00,252885.10
251660,201806,225,203,22,192708.10,20797.20,213505.30
251670,201806,357,277,80,262562.00,76320.00,338882.00
251675,201806,3,3,0,2862.00,0,2862.00
251680,201806,96,87,9,82998.00,8586.00,91584.00
251690,201806,340,284,56,269982.00,53073.89,323055.89
251700,201806,279,234,45,222649.29,42915.69,265564.98
251710,201806,20,14,6,13356.00,5724.00,19080.00
251720,201806,32,22,10,20988.00,9254.00,30242.00
251740,201806,10,8,2,7632.00,1908.00,9540.00
260005,201806,3148,1785,1363,1691801.34,1299394.10,2991195.44
260010,201806,1477,1058,419,1004573.48,397723.32,1402296.80
260020,201806,426,374,52,356796.00,49608.00,406404.00
260030,201806,582,421,161,400866.98,153594.00,554460.98
260040,201806,851,527,324,501670.44,309086.46,810756.90
260050,201806,1141,817,324,779180.00,308524.00,1087704.00
260060,201806,413,374,39,356032.80,37206.00,393238.80
260070,201806,1465,923,542,876420.00,514098.36,1390518.36
260080,201806,730,575,155,547739.10,147870.00,695609.10
260090,201806,576,358,218,341304.12,207972.00,549276.12
260100,201806,229,160,69,151830.00,65826.00,217656.00
260105,201806,232,131,101,124974.00,96354.00,221328.00
260110,201806,2760,2047,713,1952829.00,679392.00,2632221.00
260120,201806,2913,1457,1456,1380260.21,1386736.10,2766996.31
260130,201806,151,105,46,100170.00,43884.00,144054.00
260140,201806,2144,1409,735,1335694.76,699645.46,2035340.22
260150,201806,228,152,76,145008.00,72504.00,217512.00
260160,201806,298,256,42,244224.00,40068.00,284292.00
260170,201806,3382,2069,1313,1967066.58,1251218.90,3218285.48
260180,201806,140,119,21,113526.00,20034.00,133560.00
260190,201806,2286,1609,677,1531835.90,645858.00,2177693.90
260200,201806,900,740,160,705185.08,152354.00,857539.08
260210,201806,1401,997,404,950987.27,384167.11,1335154.38
260220,201806,725,663,62,632502.00,59148.00,691650.00
260230,201806,1205,913,292,868810.99,278568.00,1147378.99
260240,201806,226,172,54,162914.58,51516.00,214430.58
260250,201806,74,58,16,55332.00,15264.00,70596.00
260260,201806,994,714,280,681156.00,267120.00,948276.00
260270,201806,427,346,81,328701.20,76987.80,405689.00
260280,201806,1404,884,520,842859.00,495794.00,1338653.00
260290,201806,6387,3413,2974,3237198.35,2830486.00,6067684.35
260300,201806,869,767,102,729649.60,97022.00,826671.60
260310,201806,506,404,102,384037.47,97308.00,481345.47
260320,201806,881,665,216,634123.20,206064.00,840187.20
260330,201806,35,28,7,26712.00,6678.00,33390.00
260340,201806,69,50,19,47700.00,18126.00,65826.00
260345,201806,5669,3190,2479,3036129.63,2363889.76,5400019.39
260350,201806,476,349,127,331202.08,121158.00,452360.08
260360,201806,285,147,138,140238.00,131652.00,271890.00
260370,201806,663,432,231,409518.40,220234.00,629752.40
260380,201806,598,430,168,410220.00,159127.56,569347.56
260390,201806,296,250,46,237421.98,42930.00,280351.98
260392,201806,101,89,12,84906.00,11448.00,96354.00
260400,201806,4074,2345,1729,2227462.44,1649085.68,3876548.12
260410,201806,14620,7715,6905,7344261.67,6584639.00,13928900.67
260415,201806,122,110,12,104940.00,11448.00,116388.00
260420,201806,1785,1069,716,1014787.20,681267.64,1696054.84
260430,201806,191,176,15,166692.66,14310.00,181002.66
260440,201806,228,166,62,157640.00,59148.00,216788.00
260450,201806,475,344,131,326891.00,124974.00,451865.00
260460,201806,847,449,398,425676.80,379687.23,805364.03
260470,201806,373,228,145,216748.80,137949.00,354697.80
260480,201806,206,128,78,122112.00,74412.00,196524.00
260490,201806,209,169,40,161226.00,38160.00,199386.00
260500,201806,1136,763,373,725614.20,354745.80,1080360.00
260510,201806,745,590,155,561645.59,146916.00,708561.59
260515,201806,260,232,28,221328.00,26235.00,247563.00
260520,201806,3326,1974,1352,1875896.52,1287605.62,3163502.14
260530,201806,792,642,150,609975.64,143100.00,753075.64
260540,201806,570,435,135,414990.00,127836.72,542826.72
260545,201806,13,10,3,9540.00,2862.00,12402.00
260550,201806,346,215,131,205110.00,124974.00,330084.00
260560,201806,516,386,130,367958.00,123733.80,491691.80
260570,201806,1013,833,180,791796.80,171433.80,963230.60
260580,201806,262,234,28,223236.00,26712.00,249948.00
260590,201806,662,380,282,361108.08,269028.00,630136.08
260600,201806,8200,4179,4021,3966216.68,3832165.53,7798382.21
260610,201806,496,333,163,317682.00,155215.80,472897.80
260620,201806,3655,1912,1743,1812597.29,1660557.17,3473154.46
260630,201806,77,74,3,70596.00,2862.00,73458.00
260640,201806,3692,2012,1680,1915684.63,1602663.30,3518347.93
260650,201806,331,233,98,222282.00,93449.07,315731.07
260660,201806,508,346,162,329702.40,153927.90,483630.30
260670,201806,102,76,26,72504.00,24804.00,97308.00
260680,201806,3664,2049,1615,1937862.32,1540366.84,3478229.16
260690,201806,121,95,26,90630.00,24804.00,115434.00
260700,201806,326,198,128,188128.80,121278.00,309406.80
260710,201806,38,35,3,33390.00,2862.00,36252.00
260720,201806,2245,1345,900,1276923.69,857808.18,2134731.87
260730,201806,611,461,150,439794.00,140905.80,580699.80
260740,201806,62,58,4,55332.00,3816.00,59148.00
260750,201806,640,446,194,425159.64,185076.00,610235.64
260760,201806,624,337,287,321498.00,273798.00,595296.00
260765,201806,985,518,467,490943.80,445279.50,936223.30
260770,201806,220,165,55,157410.00,52470.00,209880.00
260775,201806,820,487,333,463215.80,317673.00,780888.80
260780,201806,271,174,97,165996.00,92538.00,258534.00
260790,201806,12321,6784,5537,6445627.54,5274728.03,11720355.57
260795,201806,168,116,52,109500.12,49608.00,159108.12
260800,201806,283,232,51,220851.00,48654.00,269505.00
260805,201806,172,110,62,104211.14,59148.00,163359.14
260810,201806,741,645,96,614080.26,91584.00,705664.26
260820,201806,316,214,102,202826.79,97308.00,300134.79
260825,201806,201,137,64,130524.57,61056.00,191580.57
260830,201806,265,172,93,164088.00,88722.00,252810.00
260840,201806,233,168,65,159605.00,61939.00,221544.00
260845,201806,211,147,64,140238.00,61056.00,201294.00
260850,201806,502,363,139,344638.09,132606.00,477244.09
260860,201806,254,191,63,182016.34,60102.00,242118.34
260870,201806,373,270,103,256340.42,98262.00,354602.42
260875,201806,707,497,210,473024.69,200340.00,673364.69
260880,201806,1583,963,620,916973.34,591289.20,1508262.54
260890,201806,2429,1691,738,1606774.06,703099.00,2309873.06
260900,201806,1038,715,323,680807.79,308142.00,988949.79
260910,201806,277,217,60,207018.00,57240.00,264258.00
260915,201806,303,204,99,194616.00,94326.00,288942.00
260920,201806,176,100,76,95400.00,72504.00,167904.00
260930,201806,390,334,56,318636.00,53338.45,371974.45
260940,201806,2796,1527,1269,1452563.89,1210129.92,2662693.81
260950,201806,2027,1175,852,1114597.82,812808.00,1927405.82
260960,201806,14275,7434,6841,7058584.87,6518839.53,13577424.40
260970,201806,438,375,63,356961.00,60102.00,417063.00
260980,201806,194,171,23,162848.00,21942.00,184790.00
260990,201806,2563,2112,451,2013103.20,429586.20,2442689.40
261000,201806,4370,2584,1786,2451922.84,1702030.86,4153953.70
261010,201806,186,136,50,129744.00,46882.23,176626.23
261020,201806,612,459,153,437743.00,145962.00,583705.00
261030,201806,223,161,62,153594.00,58914.27,212508.27
261040,201806,362,324,38,309096.00,35965.80,345061.80
261050,201806,471,413,58,394002.00,55332.00,449334.00
261060,201806,1329,875,454,833558.75,433116.00,1266674.75
261070,201806,9058,4599,4459,4363392.85,4245102.61,8608495.46
261080,201806,403,293,110,278750.00,104940.00,383690.00
261090,201806,2246,1726,520,1638224.05,495308.00,2133532.05
261100,201806,1092,768,324,730621.80,307226.16,1037847.96
261110,201806,8098,4941,3157,4709389.09,3009096.95,7718486.04
261120,201806,273,227,46,216558.00,43879.23,260437.23
261130,201806,568,332,236,316204.10,224954.00,541158.10
261140,201806,187,121,66,115434.00,62964.00,178398.00
261150,201806,666,392,274,373968.00,261396.00,635364.00
261153,201806,74,70,4,65826.31,3816.00,69642.31
261160,201806,77183,38965,38218,37052899.80,36437132.27,73490032.07
261170,201806,450,338,112,321822.36,106848.00,428670.36
261180,201806,1770,1087,683,1031875.62,651582.00,1683457.62
261190,201806,612,423,189,403145.92,180297.00,583442.92
261200,201806,214,188,26,178587.30,24804.00,203391.30
261210,201806,35,32,3,30528.00,2862.00,33390.00
261220,201806,2566,1812,754,1722476.82,718743.80,2441220.62
261230,201806,329,240,89,228960.00,84891.69,313851.69
261240,201806,447,386,61,364230.95,58194.00,422424.95
261245,201806,225,189,36,180306.00,34344.00,214650.00
261247,201806,155,118,37,112572.00,35298.00,147870.00
261250,201806,2866,1463,1403,1394891.80,1337351.83,2732243.63
261255,201806,252,229,23,218466.00,21942.00,240408.00
261260,201806,868,746,122,711684.00,116388.00,828072.00
261270,201806,173,135,38,128790.00,36252.00,165042.00
261280,201806,159,132,27,125928.00,25758.00,151686.00
261290,201806,126,87,39,82759.50,37206.00,119965.50
261300,201806,1225,873,352,832842.00,335808.00,1168650.00
261310,201806,765,510,255,486540.00,242649.90,729189.90
261320,201806,538,363,175,346016.00,166950.00,512966.00
261330,201806,864,684,180,649537.50,170874.46,820411.96
261340,201806,307,174,133,165996.00,126882.00,292878.00
261350,201806,798,572,226,544734.20,215604.00,760338.20
261360,201806,1231,799,432,761844.37,411842.00,1173686.37
261370,201806,4996,3078,1918,2921296.62,1826850.45,4748147.07
261380,201806,574,423,151,401643.64,143768.00,545411.64
261390,201806,3448,2297,1151,2187360.20,1094606.49,3281966.69
261400,201806,279,252,27,239835.60,25758.00,265593.60
261410,201806,1079,714,365,681156.00,348205.23,1029361.23
261420,201806,890,558,332,531065.26,316709.46,847774.72
261430,201806,331,301,30,286308.00,28333.80,314641.80
261440,201806,116,105,11,100170.00,10494.00,110664.00
261450,201806,2499,2081,418,1982614.24,398524.04,2381138.28
261460,201806,721,575,146,547596.02,139284.00,686880.02
261470,201806,251,192,59,182358.00,56286.00,238644.00
261480,201806,363,294,69,279237.00,65822.00,345059.00
261485,201806,339,208,131,197764.20,124974.00,322738.20
261500,201806,625,423,202,403542.00,192708.00,596250.00
261510,201806,46,31,15,29574.00,14310.00,43884.00
261520,201806,112,98,14,93492.00,13356.00,106848.00
261530,201806,4172,2645,1527,2515133.94,1455504.69,3970638.63
261540,201806,1090,672,418,640624.36,398772.00,1039396.36
261550,201806,285,144,141,136137.00,134494.92,270631.92
261560,201806,799,534,265,506480.20,251656.60,758136.80
261570,201806,371,288,83,274752.00,79182.00,353934.00
261580,201806,377,297,80,282492.36,76320.00,358812.36
261590,201806,194,157,37,149778.00,35298.00,185076.00
261600,201806,294,237,57,225335.00,53901.00,279236.00
261610,201806,105,91,14,86337.00,13356.00,99693.00
261618,201806,65,51,14,48654.00,13356.00,62010.00
261620,201806,201,123,78,117342.00,74412.00,191754.00
261630,201806,589,453,136,429801.60,129744.00,559545.60
261640,201806,6344,3369,2975,3206665.09,2834535.92,6041201.01
261650,201806,489,311,178,296016.66,169812.00,465828.66
270010,201806,530,469,61,447140.00,57431.00,504571.00
270020,201806,305,242,63,230864.00,60102.00,290966.00
270030,201806,9210,5886,3324,5600760.11,3168652.96,8769413.07
270040,201806,1983,1216,767,1159863.66,730477.80,1890341.46
270050,201806,178,131,47,124974.00,44838.00,169812.00
270060,201806,116,65,51,62010.00,48654.00,110664.00
270070,201806,900,654,246,622101.82,234379.26,856481.08
270080,201806,38,32,6,30528.00,5724.00,36252.00
270090,201806,20,16,4,15264.00,3816.00,19080.00
270100,201806,1249,828,421,786913.51,399487.70,1186401.21
270110,201806,146,108,38,103032.00,36252.00,139284.00
270120,201806,225,185,40,175638.55,38160.00,213798.55
270130,201806,248,171,77,162561.60,73458.00,236019.60
270135,201806,99,61,38,58194.00,36252.00,94446.00
270140,201806,1301,787,514,750577.19,489393.20,1239970.39
270150,201806,266,212,54,202248.00,51516.00,253764.00
270160,201806,522,390,132,372060.00,125260.20,497320.20
270170,201806,727,468,259,446185.80,245845.80,692031.60
270180,201806,71,55,16,52152.04,15054.12,67206.16
270190,201806,102,89,13,84906.00,12402.00,97308.00
270200,201806,107,96,11,91393.20,10494.00,101887.20
270210,201806,481,249,232,237546.00,221041.80,458587.80
270220,201806,184,144,40,137376.00,38160.00,175536.00
270230,201806,2111,1262,849,1199777.31,808038.62,2007815.93
270235,201806,738,557,181,531107.59,172308.95,703416.54
270240,201806,3123,2428,695,2304719.68,660238.00,2964957.68
270250,201806,170,118,52,112572.00,49608.00,162180.00
270255,201806,225,192,33,183168.00,31100.40,214268.40
270260,201806,329,261,68,248994.00,64872.00,313866.00
270270,201806,112,46,66,43875.00,62964.00,106839.00
270280,201806,202,124,78,118296.00,74392.92,192688.92
270290,201806,1181,888,293,845916.42,278645.46,1124561.88
270300,201806,285,183,102,174582.00,97021.80,271603.80
270310,201806,916,737,179,701747.25,170051.58,871798.83
270320,201806,879,751,128,714178.37,121825.80,836004.17
270330,201806,275,229,46,217512.00,43884.00,261396.00
270340,201806,60,48,12,45792.00,11448.00,57240.00
270350,201806,93,47,46,44599.50,43884.00,88483.50
270360,201806,72,40,32,38160.00,30528.00,68688.00
270370,201806,51,39,12,37206.00,11448.00,48654.00
270375,201806,69,39,30,37206.00,28620.00,65826.00
270380,201806,1078,612,466,582894.00,444564.00,1027458.00
270390,201806,196,109,87,103986.00,82998.00,186984.00
270400,201806,701,511,190,486279.27,181260.00,667539.27
270410,201806,698,500,198,476682.04,188882.46,665564.50
270420,201806,401,260,141,246342.00,134429.38,380771.38
270430,201806,32593,23286,9307,22155486.90,8871385.87,31026872.77
270440,201806,495,388,107,370152.00,101791.80,471943.80
270450,201806,777,407,370,388039.50,352026.66,740066.16
270460,201806,199,153,46,145962.00,43884.00,189846.00
270470,201806,1377,921,456,878280.69,435024.00,1313304.69
270480,201806,531,429,102,406976.80,96592.50,503569.30
270490,201806,25,20,5,19080.00,4770.00,23850.00
270500,201806,513,422,91,402588.00,86814.00,489402.00
270510,201806,737,451,286,430254.00,272844.00,703098.00
270520,201806,367,226,141,215395.00,134514.00,349909.00
270530,201806,65,57,8,54378.00,7632.00,62010.00
270540,201806,123,94,29,89676.00,27666.00,117342.00
270550,201806,1728,1300,428,1239590.98,407830.23,1647421.21
270560,201806,313,146,167,139284.00,159318.00,298602.00
270570,201806,459,307,152,290667.36,145008.00,435675.36
270580,201806,82,61,21,58194.00,20034.00,78228.00
270590,201806,75,62,13,59148.00,12402.00,71550.00
270600,201806,180,148,32,141192.00,30528.00,171720.00
270610,201806,192,157,35,149769.00,33390.00,183159.00
270620,201806,30,29,1,27666.00,954,28620.00
270630,201806,3871,2940,931,2791803.63,886018.96,3677822.59
270640,201806,904,665,239,632706.60,227691.80,860398.40
270642,201806,212,179,33,170766.00,31482.00,202248.00
270644,201806,271,186,85,177253.74,81085.23,258338.97
270650,201806,258,153,105,145962.00,100170.00,246132.00
270660,201806,259,209,50,199386.00,47700.00,247086.00
270670,201806,3183,2421,762,2299025.43,724025.68,3023051.11
270680,201806,467,272,195,259479.00,186026.00,445505.00
270690,201806,1122,705,417,670836.96,397808.46,1068645.42
270700,201806,35,27,8,25758.00,7632.00,33390.00
270710,201806,887,669,218,636805.00,207972.00,844777.00
270720,201806,250,188,62,179352.00,58861.80,238213.80
270730,201806,1917,1109,808,1055745.40,768726.20,1824471.60
270740,201806,45,28,17,26712.00,16218.00,42930.00
270750,201806,635,465,170,443420.00,161513.00,604933.00
270760,201806,308,222,86,211788.00,82044.00,293832.00
270770,201806,2768,1765,1003,1676517.20,955908.00,2632425.20
270780,201806,92,57,35,54373.23,33372.46,87745.69
270790,201806,265,178,87,169812.00,82998.00,252810.00
270800,201806,1969,1573,396,1498849.25,377039.88,1875889.13
270810,201806,304,240,64,228945.69,61047.23,289992.92
270820,201806,158,102,56,97308.00,53329.00,150637.00
270830,201806,912,661,251,629827.00,239168.00,868995.00
270840,201806,1406,1031,375,982834.90,356082.00,1338916.90
270850,201806,1656,1013,643,960240.36,613403.46,1573643.82
270860,201806,2455,1598,857,1521653.60,814680.57,2336334.17
270870,201806,120,65,55,62010.00,52470.00,114480.00
270880,201806,919,681,238,647829.14,226158.58,873987.72
270890,201806,349,254,95,241867.62,90625.23,332492.85
270895,201806,73,63,10,60102.00,9540.00,69642.00
270900,201806,104,80,24,76320.00,22896.00,99216.00
270910,201806,324,257,67,244033.20,63918.00,307951.20
270915,201806,1838,1103,735,1047364.10,700709.60,1748073.70
270920,201806,478,402,76,383508.00,72504.00,456012.00
270930,201806,6182,4478,1704,4266494.31,1622835.24,5889329.55
270940,201806,2395,1817,578,1731448.88,550440.00,2281888.88
280010,201806,43,38,5,36252.00,4770.00,41022.00
280020,201806,713,617,96,585438.13,90630.00,676068.13
280030,201806,19553,12518,7035,11859262.16,6682854.02,18542116.18
280040,201806,339,214,125,204156.00,117819.00,321975.00
280050,201806,376,288,88,274465.80,83952.00,358417.80
280060,201806,334,221,113,208587.43,107802.00,316389.43
280067,201806,990,696,294,661225.94,279522.25,940748.19
280070,201806,129,108,21,103032.00,20034.00,123066.00
280100,201806,622,491,131,465383.47,124784.00,590167.47
280110,201806,75,70,5,66780.00,4770.00,71550.00
280120,201806,628,503,125,479862.00,119250.00,599112.00
280130,201806,1370,856,514,815193.80,490212.90,1305406.70
280140,201806,474,385,89,365285.78,83952.00,449237.78
280150,201806,326,242,84,229424.89,80136.00,309560.89
280160,201806,96,82,14,78228.00,13356.00,91584.00
280170,201806,600,395,205,375633.56,195570.00,571203.56
280190,201806,27,25,2,23850.00,1908.00,25758.00
280200,201806,26,18,8,17172.00,7632.00,24804.00
280210,201806,2758,1946,812,1837914.50,769080.51,2606995.01
280220,201806,41,31,10,29574.00,9540.00,39114.00
280230,201806,319,263,56,250067.63,53424.00,303491.63
280240,201806,115,109,6,103842.90,5724.00,109566.90
280250,201806,18,11,7,10494.00,6678.00,17172.00
280260,201806,80,69,11,65826.00,10494.00,76320.00
280270,201806,160,123,37,117342.00,35298.00,152640.00
280280,201806,192,124,68,118296.00,64872.00,183168.00
280290,201806,3101,2239,862,2124329.74,820927.39,2945257.13
280300,201806,1108,842,266,800840.07,253000.80,1053840.87
280310,201806,109,104,5,98885.29,4770.00,103655.29
280320,201806,653,445,208,424521.00,198432.00,622953.00
280330,201806,359,258,101,246132.00,96229.98,342361.98
280340,201806,424,339,85,321934.57,80327.00,402261.57
280350,201806,3456,2666,790,2531872.13,750921.09,3282793.22
280360,201806,462,290,172,276660.00,163134.00,439794.00
280370,201806,97,86,11,82044.00,10494.00,92538.00
280380,201806,56,42,14,40068.00,13356.00,53424.00
280390,201806,186,155,31,147870.00,29574.00,177444.00
280400,201806,343,234,109,222330.10,103986.00,326316.10
280410,201806,288,233,55,221329.00,52470.00,273799.00
280420,201806,172,144,28,137357.00,26712.00,164069.00
280430,201806,111,82,29,78228.00,27557.63,105785.63
280440,201806,686,532,154,503618.60,146715.66,650334.26
280445,201806,116,108,8,103032.00,7632.00,110664.00
280450,201806,1107,945,162,898135.46,154548.00,1052683.46
280460,201806,761,558,203,525236.47,193662.00,718898.47
280470,201806,189,173,16,165042.00,14311.00,179353.00
280480,201806,2276,1612,664,1521992.32,630511.79,2152504.11
280490,201806,353,325,28,308658.00,26712.00,335370.00
280500,201806,43,39,4,37206.00,3816.00,41022.00
280510,201806,142,111,31,105593.20,29288.00,134881.20
280520,201806,54,40,14,38160.00,13356.00,51516.00
280530,201806,78,55,23,52470.00,21942.00,74412.00
280540,201806,508,408,100,388975.80,95113.80,484089.60
280550,201806,707,654,53,623176.47,50562.00,673738.47
280560,201806,487,425,62,402731.10,59148.00,461879.10
280570,201806,1780,1352,428,1285602.47,407456.83,1693059.30
280580,201806,599,457,142,434298.60,135373.00,569671.60
280590,201806,165,102,63,97028.48,60102.00,157130.48
280600,201806,361,303,58,289062.00,55332.00,344394.00
280610,201806,139,105,34,99964.00,32436.00,132400.00
280620,201806,550,451,99,429300.50,94302.90,523603.40
280630,201806,166,138,28,131652.00,26712.00,158364.00
280640,201806,207,166,41,157535.00,39114.00,196649.00
280650,201806,78,53,25,50562.00,23850.00,74412.00
280660,201806,131,94,37,89676.00,35059.50,124735.50
280670,201806,1640,1022,618,967077.35,585827.95,1552905.30
280680,201806,185,158,27,148948.14,25758.00,174706.14
280690,201806,54,45,9,42930.00,8586.00,51516.00
280700,201806,19,19,0,18126.00,0,18126.00
280710,201806,1410,1071,339,1015136.39,323406.00,1338542.39
280720,201806,110,74,36,68036.40,34344.00,102380.40
280730,201806,27,23,4,21942.00,3816.00,25758.00
280740,201806,2432,1799,633,1709757.29,602776.46,2312533.75
280750,201806,296,257,39,245178.00,37206.00,282384.00
280760,201806,883,607,276,577550.78,263304.00,840854.78
290010,201806,204,137,67,130698.00,63918.00,194616.00
290020,201806,179,166,13,158364.00,12402.00,170766.00
290030,201806,594,387,207,368530.20,197478.00,566008.20
290035,201806,138,112,26,103643.70,24804.00,128447.70
290040,201806,276,173,103,165042.00,98262.00,263304.00
290050,201806,81,61,20,58194.00,19080.00,77274.00
290060,201806,255,114,141,108469.80,134514.00,242983.80
290070,201806,5615,2768,2847,2633233.67,2712754.70,5345988.37
290080,201806,499,224,275,213390.72,262331.00,475721.72
290090,201806,390,170,220,162180.00,209880.00,372060.00
290100,201806,1597,1055,542,1002275.10,516495.80,1518770.90
290110,201806,768,455,313,432444.20,298073.30,730517.50
290115,201806,212,195,17,185076.00,16218.00,201294.00
290120,201806,774,501,273,477286.20,260442.00,737728.20
290130,201806,412,244,168,232480.26,160272.00,392752.26
290135,201806,297,225,72,213972.66,68688.00,282660.66
290140,201806,301,250,51,238500.00,48463.20,286963.20
290150,201806,131,99,32,94446.00,30528.00,124974.00
290160,201806,249,191,58,180974.58,55332.00,236306.58
290170,201806,89,64,25,61056.00,23850.00,84906.00
290180,201806,157,123,34,117342.00,32436.00,149778.00
290190,201806,448,364,84,346970.00,79849.80,426819.80
290195,201806,314,187,127,178398.00,121158.00,299556.00
290200,201806,279,233,46,222282.00,43884.00,266166.00
290205,201806,142,88,54,83952.00,51516.00,135468.00
290210,201806,1135,823,312,783998.20,297648.00,1081646.20
290220,201806,224,125,99,118773.00,94446.00,213219.00
290225,201806,289,110,179,104940.00,170766.00,275706.00
290230,201806,65,43,22,41022.00,20988.00,62010.00
290240,201806,307,121,186,115147.80,177444.00,292591.80
290250,201806,272,245,27,233034.00,25758.00,258792.00
290260,201806,289,235,54,223141.00,51230.00,274371.00
290265,201806,181,151,30,143237.00,28620.00,171857.00
290270,201806,1392,1149,243,1094286.20,230959.00,1325245.20
290280,201806,471,345,126,329130.00,120204.00,449334.00
290290,201806,1233,718,515,679169.89,491310.00,1170479.89
290300,201806,448,379,69,361275.23,65826.00,427101.23
290310,201806,318,142,176,135468.00,167904.00,303372.00
290320,201806,3985,2476,1509,2358447.84,1437678.20,3796126.04
290323,201806,187,162,25,154262.00,23850.00,178112.00
290327,201806,154,122,32,116116.11,30528.00,146644.11
290330,201806,77,43,34,41022.00,32436.00,73458.00
290340,201806,906,361,545,343421.00,519644.00,863065.00
290350,201806,594,352,242,335808.00,230868.00,566676.00
290360,201806,370,277,93,262351.69,88722.00,351073.69
290370,201806,907,365,542,348210.00,517054.00,865264.00
290380,201806,310,190,120,181260.00,114480.00,295740.00
290390,201806,2499,1558,941,1483359.58,895520.00,2378879.58
290395,201806,242,135,107,128265.80,102078.00,230343.80
290400,201806,281,208,73,198146.00,69642.00,267788.00
290405,201806,252,220,32,209880.00,30528.00,240408.00
290410,201806,576,493,83,467317.64,79182.00,546499.64
290420,201806,237,187,50,178398.00,47700.00,226098.00
290430,201806,495,311,184,296694.00,175536.00,472230.00
290440,201806,72,64,8,61056.00,7632.00,68688.00
290450,201806,231,177,54,168858.00,51516.00,220374.00
290460,201806,1881,1120,761,1066611.80,725231.32,1791843.12
290470,201806,1441,608,833,578903.22,794367.36,1373270.58
290475,201806,589,548,41,521639.00,39114.00,560753.00
290480,201806,289,160,129,152640.00,123066.00,275706.00
290485,201806,231,214,17,204156.00,16218.00,220374.00
290490,201806,1168,842,326,803268.00,310050.20,1113318.20
290500,201806,684,348,336,331038.00,320544.00,651582.00
290510,201806,221,169,52,160558.20,49608.00,210166.20
290515,201806,135,80,55,76320.00,52470.00,128790.00
290520,201806,1414,917,497,871993.51,470610.22,1342603.73
290530,201806,311,283,28,269982.00,26712.00,296694.00
290540,201806,95,57,38,54378.00,36252.00,90630.00
290550,201806,152,127,25,121158.00,23783.22,144941.22
290560,201806,3354,1366,1988,1301866.76,1896357.59,3198224.35
290570,201806,5983,3053,2930,2907950.81,2792214.95,5700165.76
290580,201806,1280,758,522,721891.80,497272.50,1219164.30
290590,201806,539,445,94,423739.00,89676.00,513415.00
290600,201806,1725,1194,531,1134375.05,506545.38,1640920.43
290610,201806,217,195,22,185811.00,20988.00,206799.00
290620,201806,329,292,37,278568.00,35298.00,313866.00
290630,201806,2066,886,1180,842096.69,1121319.30,1963415.99
290640,201806,151,124,27,118296.00,25758.00,144054.00
290650,201806,1722,808,914,769869.00,871956.00,1641825.00
290660,201806,285,231,54,220374.00,51516.00,271890.00
290670,201806,998,518,480,493600.00,457574.38,951174.38
290680,201806,1196,962,234,916507.80,222282.00,1138789.80
290682,201806,293,214,79,203836.30,75347.46,279183.76
290685,201806,233,150,83,142146.00,79182.00,221328.00
290687,201806,930,612,318,581332.10,302418.00,883750.10
290689,201806,132,75,57,71536.00,54363.69,125899.69
290690,201806,646,263,383,250873.92,364502.80,615376.72
290700,201806,238,113,125,107802.00,119250.00,227052.00
290710,201806,707,476,231,454104.00,220374.00,674478.00
290720,201806,1020,828,192,789912.00,182691.00,972603.00
290730,201806,1137,652,485,620148.50,461736.00,1081884.50
290740,201806,16,13,3,12402.00,2862.00,15264.00
290750,201806,1376,629,747,598153.23,710526.10,1308679.33
290755,201806,72,64,8,61056.00,7632.00,68688.00
290760,201806,301,260,41,248040.00,39114.00,287154.00
290770,201806,189,178,11,169802.46,10494.00,180296.46
290780,201806,987,791,196,752670.66,185171.40,937842.06
290790,201806,375,261,114,248994.00,108756.00,357750.00
290800,201806,2624,1055,1569,1003758.04,1495719.36,2499477.40
290810,201806,434,303,131,288776.00,124974.00,413750.00
290820,201806,386,236,150,224176.00,143100.00,367276.00
290830,201806,404,278,126,265212.00,120204.00,385416.00
290840,201806,1712,1054,658,1003370.80,625652.48,1629023.28
290850,201806,774,426,348,406404.00,331038.00,737442.00
290860,201806,640,286,354,272844.00,337430.00,610274.00
290870,201806,662,476,186,452883.80,177444.00,630327.80
290880,201806,125,68,57,64872.00,54378.00,119250.00
290890,201806,335,236,99,225144.00,94446.00,319590.00
290900,201806,171,129,42,123066.00,40068.00,163134.00
290910,201806,365,276,89,263304.00,84906.00,348210.00
290920,201806,231,197,34,187938.00,32436.00,220374.00
290930,201806,827,628,199,599112.00,189827.00,788939.00
290940,201806,250,206,44,195760.80,41976.00,237736.80
290950,201806,170,97,73,92538.00,69642.00,162180.00
290960,201806,449,302,147,286868.24,139951.80,426820.04
290970,201806,252,221,31,210643.20,29574.00,240217.20
290980,201806,1505,1067,438,1013749.76,416803.20,1430552.96
290990,201806,372,312,60,297619.92,57184.38,354804.30
291000,201806,870,245,625,233730.00,595963.80,829693.80
291005,201806,2143,907,1236,863217.76,1178367.03,2041584.79
291010,201806,154,138,16,131652.00,15264.00,146916.00
291020,201806,103,81,22,77274.00,20988.00,98262.00
291030,201806,94,68,26,64872.00,24804.00,89676.00
291040,201806,576,289,287,275706.00,273798.00,549504.00
291050,201806,1352,760,592,723681.43,564768.00,1288449.43
291060,201806,1494,823,671,784474.20,640134.00,1424608.20
291070,201806,1896,1402,494,1332416.53,470015.50,1802432.03
291072,201806,7355,2704,4651,2576267.58,4434879.96,7011147.54
291075,201806,206,168,38,160272.00,36252.00,196524.00
291077,201806,50,34,16,32436.00,15264.00,47700.00
291080,201806,19840,8727,11113,8303728.04,10589339.02,18893067.06
291085,201806,295,238,57,227052.00,54373.23,281425.23
291090,201806,304,118,186,112286.00,177434.46,289720.46
291100,201806,665,192,473,183168.00,451242.00,634410.00
291110,201806,404,303,101,289042.92,96354.00,385396.92
291120,201806,2518,1206,1312,1150381.00,1249679.46,2400060.46
291125,201806,60,30,30,28620.00,28620.00,57240.00
291130,201806,214,188,26,179352.00,24804.00,204156.00
291140,201806,134,99,35,94160.00,33104.00,127264.00
291150,201806,371,148,223,141192.00,212742.00,353934.00
291160,201806,371,308,63,292878.50,60102.00,352980.50
291165,201806,24,20,4,19080.00,3816.00,22896.00
291170,201806,2965,1482,1483,1409774.11,1411443.60,2821217.71
291180,201806,1321,510,811,486343.38,773560.68,1259904.06
291185,201806,75,73,2,69642.00,1908.00,71550.00
291190,201806,1267,550,717,522309.77,683474.80,1205784.57
291200,201806,167,123,44,117342.00,41976.00,159318.00
291210,201806,2217,870,1347,826841.34,1283226.14,2110067.48
291220,201806,272,203,69,192708.64,65826.00,258534.64
291230,201806,1024,351,673,333996.00,642042.00,976038.00
291240,201806,438,415,23,394670.00,21942.00,416612.00
291250,201806,439,358,81,341532.00,77274.00,418806.00
291260,201806,46,35,11,33390.00,10494.00,43884.00
291270,201806,1214,496,718,473184.00,684685.80,1157869.80
291280,201806,372,170,202,161974.89,192412.26,354387.15
291290,201806,1760,896,864,853345.20,823208.00,1676553.20
291300,201806,225,177,48,168190.20,45792.00,213982.20
291310,201806,227,203,24,193375.80,22896.00,216271.80
291320,201806,1400,998,402,949230.00,382459.29,1331689.29
291330,201806,130,113,17,105989.40,16218.00,122207.40
291340,201806,151,86,65,82044.00,62010.00,144054.00
291345,201806,135,87,48,82998.00,45792.00,128790.00
291350,201806,1594,526,1068,501613.20,1018681.30,1520294.50
291360,201806,8639,4267,4372,4058657.84,4168366.75,8227024.59
291370,201806,1109,615,494,586424.00,471276.00,1057700.00
291380,201806,260,204,56,194616.00,53137.80,247753.80
291390,201806,3890,1703,2187,1619276.23,2084299.80,3703576.03
291400,201806,2083,1491,592,1418788.80,563085.51,1981874.31
291410,201806,152,132,20,124974.00,19080.00,144054.00
291420,201806,114,84,30,80136.00,28620.00,108756.00
291430,201806,167,95,72,89923.00,67734.53,157657.53
291440,201806,497,398,99,376968.30,94446.00,471414.30
291450,201806,901,567,334,539678.80,317682.00,857360.80
291460,201806,1739,1408,331,1341569.41,315774.00,1657343.41
291465,201806,2212,1025,1187,977247.41,1132116.14,2109363.55
291470,201806,2776,1404,1372,1335630.47,1308158.00,2643788.47
291480,201806,11822,5219,6603,4967396.89,6290409.81,11257806.70
291490,201806,556,233,323,222282.00,308142.00,530424.00
291500,201806,371,204,167,194616.00,159318.00,353934.00
291510,201806,1244,476,768,452942.99,732385.80,1185328.79
291520,201806,959,437,522,416898.00,497978.46,914876.46
291530,201806,1006,268,738,255672.00,703746.72,959418.72
291535,201806,115,96,19,91584.00,18126.00,109710.00
291540,201806,363,105,258,100170.00,245178.60,345348.60
291550,201806,1196,562,634,534242.10,604532.00,1138774.10
291560,201806,5520,2808,2712,2665951.97,2575082.89,5241034.86
291570,201806,203,103,100,98262.00,95400.00,193662.00
291580,201806,1218,741,477,705861.46,455044.23,1160905.69
291590,201806,84,32,52,30384.90,49608.00,79992.90
291600,201806,1365,626,739,596250.00,704702.00,1300952.00
291610,201806,1462,688,774,655068.87,738368.00,1393436.87
291620,201806,587,273,314,260442.00,299174.40,559616.40
291630,201806,494,163,331,155502.00,315774.00,471276.00
291640,201806,3914,1979,1935,1878736.86,1844632.52,3723369.38
291650,201806,415,278,137,264078.00,129898.73,393976.73
291660,201806,437,175,262,166257.96,248850.90,415108.86
291670,201806,222,142,80,134896.00,76320.00,211216.00
291680,201806,700,397,303,378738.00,288957.46,667695.46
291685,201806,589,318,271,303134.00,258343.20,561477.20
291690,201806,570,294,276,280476.00,262341.00,542817.00
291700,201806,930,731,199,696644.19,188892.00,885536.19
291710,201806,1701,795,906,757734.28,863447.06,1621181.34
291720,201806,400,264,136,251851.23,129744.00,381595.23
291730,201806,952,563,389,535432.70,371096.46,906529.16
291733,201806,263,183,80,174295.80,76320.00,250615.80
291735,201806,65,51,14,48654.00,13356.00,62010.00
291740,201806,350,267,83,254718.00,79182.00,333900.00
291750,201806,1964,1303,661,1236017.28,629772.00,1865789.28
291760,201806,3060,1676,1384,1593037.00,1317951.00,2910988.00
291770,201806,809,540,269,513061.26,256626.00,769687.26
291780,201806,46,28,18,26712.00,17172.00,43884.00
291790,201806,169,81,88,77274.00,83952.00,161226.00
291800,201806,10054,4049,6005,3850123.31,5724574.80,9574698.11
291810,201806,1136,817,319,778554.83,304326.00,1082880.83
291820,201806,266,191,75,182214.00,71550.00,253764.00
291830,201806,1088,415,673,394521.00,641079.00,1035600.00
291835,201806,602,553,49,527085.00,46746.00,573831.00
291840,201806,4673,2410,2263,2293757.17,2157386.22,4451143.39
291845,201806,297,101,196,96354.00,186955.38,283309.38
291850,201806,322,279,43,265927.50,41022.00,306949.50
291855,201806,272,108,164,103032.00,156456.00,259488.00
291860,201806,175,107,68,101124.00,64872.00,165996.00
291870,201806,85,35,50,33390.00,47700.00,81090.00
291875,201806,184,167,17,159318.00,16218.00,175536.00
291880,201806,488,385,103,366480.00,98262.00,464742.00
291890,201806,243,80,163,76310.46,154071.20,230381.66
291900,201806,55,32,23,30528.00,21942.00,52470.00
291905,201806,133,93,40,88436.00,38160.00,126596.00
291910,201806,175,143,32,136422.00,30528.00,166950.00
291915,201806,393,347,46,329370.00,43884.00,373254.00
291920,201806,4978,2591,2387,2469411.61,2275533.77,4744945.38
291930,201806,183,106,77,101124.00,73458.00,174582.00
291940,201806,320,176,144,167207.58,136422.00,303629.58
291950,201806,1150,934,216,890273.00,206064.00,1096337.00
291955,201806,1053,632,421,602928.00,401491.00,1004419.00
291960,201806,178,126,52,120204.00,49321.80,169525.80
291970,201806,775,587,188,559998.00,179352.00,739350.00
291980,201806,1506,1332,174,1267315.70,165042.40,1432358.10
291990,201806,127,118,9,112572.00,8586.00,121158.00
291992,201806,165,85,80,80326.80,76320.00,156646.80
291995,201806,145,102,43,97308.00,41022.00,138330.00
292000,201806,388,296,92,280190.95,87768.00,367958.95
292010,201806,287,203,84,192708.80,79182.00,271890.80
292020,201806,277,201,76,191754.00,72504.00,264258.00
292030,201806,139,108,31,103032.00,29574.00,132606.00
292040,201806,631,322,309,307188.00,294786.00,601974.00
292045,201806,95,86,9,82044.00,8586.00,90630.00
292050,201806,898,627,271,597148.67,258248.00,855396.67
292060,201806,934,772,162,734581.28,154548.00,889129.28
292070,201806,50,21,29,20034.00,27666.00,47700.00
292080,201806,113,79,34,75366.00,32436.00,107802.00
292090,201806,505,178,327,169621.20,311958.00,481579.20
292100,201806,1413,602,811,572734.70,772426.52,1345161.22
292105,201806,204,173,31,165042.00,29574.00,194616.00
292110,201806,2113,780,1333,743795.64,1269094.05,2012889.69
292120,201806,647,518,129,493039.79,123066.00,616105.79
292130,201806,449,263,186,250902.00,177444.00,428346.00
292140,201806,196,154,42,146916.00,39936.26,186852.26
292145,201806,160,85,75,81090.00,71507.07,152597.07
292150,201806,1427,1142,285,1089468.00,270862.16,1360330.16
292160,201806,182,147,35,139951.80,33390.00,173341.80
292170,201806,1214,1065,149,1014317.31,142088.76,1156406.07
292180,201806,206,146,60,139284.00,57240.00,196524.00
292190,201806,160,96,64,91584.00,61056.00,152640.00
292200,201806,1283,466,817,443592.71,778769.56,1222362.27
292205,201806,119,106,13,100837.80,12402.00,113239.80
292210,201806,373,259,114,245703.00,108040.50,353743.50
292220,201806,21,16,5,15264.00,4770.00,20034.00
292225,201806,38,35,3,33390.00,2862.00,36252.00
292230,201806,926,750,176,713946.23,167904.00,881850.23
292240,201806,616,445,171,423433.00,163134.00,586567.00
292250,201806,1732,1110,622,1058940.00,593388.00,1652328.00
292260,201806,447,253,194,241362.00,184312.80,425674.80
292265,201806,267,187,80,178111.80,76320.00,254431.80
292270,201806,771,338,433,322452.00,412128.80,734580.80
292273,201806,202,112,90,106070.49,85860.00,191930.49
292275,201806,168,86,82,82044.00,77941.80,159985.80
292280,201806,139,98,41,93492.00,39114.00,132606.00
292285,201806,64,54,10,50848.20,9540.00,60388.20
292290,201806,563,377,186,357454.67,177158.00,534612.67
292300,201806,1638,621,1017,592148.00,969384.58,1561532.58
292303,201806,95,65,30,62010.00,28620.00,90630.00
292305,201806,109,78,31,74412.00,29574.00,103986.00
292310,201806,817,520,297,495718.00,282040.15,777758.15
292320,201806,662,497,165,473851.80,157410.00,631261.80
292330,201806,186,100,86,95400.00,82044.00,177444.00
292335,201806,281,218,63,207972.00,60102.00,268074.00
292340,201806,578,401,177,381814.85,168858.00,550672.85
292350,201806,272,145,127,137519.10,120871.80,258390.90
292360,201806,703,533,170,506765.00,162180.00,668945.00
292370,201806,769,589,180,561906.00,171720.00,733626.00
292380,201806,652,505,147,479862.62,140238.00,620100.62
292390,201806,503,191,312,182214.00,295883.50,478097.50
292400,201806,3376,2073,1303,1958703.53,1239045.80,3197749.33
292405,201806,262,173,89,164565.00,84619.80,249184.80
292410,201806,151,88,63,83952.00,60102.00,144054.00
292420,201806,305,262,43,249661.80,41022.00,290683.80
292430,201806,524,409,115,390186.00,109233.00,499419.00
292440,201806,585,500,85,475492.80,80803.80,556296.60
292450,201806,251,194,57,185076.00,54378.00,239454.00
292460,201806,585,432,153,411555.80,145866.60,557422.40
292465,201806,202,166,36,158364.00,33606.09,191970.09
292467,201806,102,59,43,56286.00,41022.00,97308.00
292470,201806,265,179,86,170766.00,82044.00,252810.00
292480,201806,331,219,112,207972.50,106562.00,314534.50
292490,201806,220,147,73,140238.00,69642.00,209880.00
292500,201806,1160,503,657,479651.00,626320.28,1105971.28
292510,201806,3344,1507,1837,1436602.12,1749627.60,3186229.72
292520,201806,1070,512,558,486583.70,532323.00,1018906.70
292525,201806,385,276,109,263299.23,103986.00,367285.23
292530,201806,4254,1748,2506,1664607.04,2389513.92,4054120.96
292540,201806,478,256,222,244224.00,211788.00,456012.00
292550,201806,1058,575,483,547827.82,460258.64,1008086.46
292560,201806,318,299,19,285246.00,18126.00,303372.00
292570,201806,303,230,73,219091.00,69642.00,288733.00
292575,201806,465,298,167,284006.00,159318.00,443324.00
292580,201806,923,588,335,559521.00,319304.00,878825.00
292590,201806,523,448,75,427089.59,71550.00,498639.59
292593,201806,143,113,30,107802.00,28620.00,136422.00
292595,201806,182,140,42,133560.00,40068.00,173628.00
292600,201806,1237,917,320,874501.00,304612.20,1179113.20
292610,201806,129,99,30,94446.00,28362.42,122808.42
292620,201806,528,438,90,417557.00,85860.00,503417.00
292630,201806,1383,796,587,757796.00,558367.14,1316163.14
292640,201806,778,544,234,518642.10,223236.00,741878.10
292650,201806,175,148,27,140756.00,25758.00,166514.00
292660,201806,1996,1435,561,1364120.03,530996.83,1895116.86
292665,201806,137,100,37,95400.00,35298.00,130698.00
292670,201806,401,325,76,310046.00,72504.00,382550.00
292680,201806,257,199,58,189846.00,54855.00,244701.00
292690,201806,185,142,43,135468.00,41022.00,176490.00
292700,201806,928,614,314,584802.80,299556.00,884358.80
292710,201806,100,88,12,83952.00,11448.00,95400.00
292720,201806,846,479,367,456164.64,349928.00,806092.64
292730,201806,200,95,105,89676.50,100170.00,189846.50
292740,201806,67073,33158,33915,31557945.05,32325662.80,63883607.85
292750,201806,374,266,108,252810.94,102221.57,355032.51
292760,201806,324,262,62,248937.50,59148.00,308085.50
292770,201806,796,334,462,318350.00,440748.00,759098.00
292780,201806,414,155,259,147356.28,247086.00,394442.28
292790,201806,736,362,374,345348.00,356557.50,701905.50
292800,201806,1158,710,448,676386.00,427105.80,1103491.80
292805,201806,427,123,304,116817.30,290016.00,406833.30
292810,201806,1486,858,628,817542.80,599043.46,1416586.26
292820,201806,746,602,144,572400.87,137080.80,709481.67
292830,201806,105,84,21,80136.00,20034.00,100170.00
292840,201806,655,541,114,515924.00,108741.69,624665.69
292850,201806,128,86,42,82044.00,40068.00,122112.00
292860,201806,2184,1271,913,1208462.94,871002.00,2079464.94
292870,201806,3431,2302,1129,2194845.80,1077056.46,3271902.26
292880,201806,1474,965,509,916843.86,484346.00,1401189.86
292890,201806,492,421,71,401606.00,67734.00,469340.00
292895,201806,134,89,45,83547.50,42930.00,126477.50
292900,201806,394,289,105,275706.00,100170.00,375876.00
292905,201806,451,234,217,223236.00,207018.00,430254.00
292910,201806,413,313,100,298269.00,95400.00,393669.00
292920,201806,544,240,304,228960.00,290016.00,518976.00
292925,201806,498,462,36,440070.66,34325.00,474395.66
292930,201806,576,358,218,341532.00,207972.00,549504.00
292935,201806,293,127,166,121158.00,158364.00,279522.00
292937,201806,237,162,75,154548.00,71550.00,226098.00
292940,201806,195,147,48,140238.00,45792.00,186030.00
292950,201806,1116,570,546,541634.50,519931.00,1061565.50
292960,201806,547,366,181,349164.00,172674.00,521838.00
292970,201806,269,189,80,179639.00,76320.00,255959.00
292975,201806,156,88,68,83952.00,64682.00,148634.00
292980,201806,251,169,82,160396.43,78228.00,238624.43
292990,201806,1315,972,343,919951.87,327034.93,1246986.80
293000,201806,104,76,28,72504.00,26712.00,99216.00
293010,201806,2691,1643,1048,1561947.12,995362.81,2557309.93
293015,201806,660,526,134,501586.49,127197.00,628783.49
293020,201806,334,274,60,261396.00,57240.00,318636.00
293030,201806,619,540,79,514588.00,75366.00,589954.00
293040,201806,343,270,73,257580.00,69642.00,327222.00
293050,201806,2734,1595,1139,1513075.79,1082467.38,2595543.17
293060,201806,255,205,50,194383.00,46746.80,241129.80
293070,201806,3421,1743,1678,1655255.68,1599353.82,3254609.50
293075,201806,90,58,32,55332.00,30528.00,85860.00
293076,201806,72,48,24,45792.00,22896.00,68688.00
293077,201806,441,271,170,254687.27,162180.00,416867.27
293080,201806,448,398,50,379692.00,47700.00,427392.00
293090,201806,130,114,16,108756.00,15264.00,124020.00
293100,201806,523,368,155,351072.00,147870.00,498942.00
293105,201806,342,236,106,224858.00,101124.00,325982.00
293110,201806,172,121,51,115434.00,48654.00,164088.00
293120,201806,318,215,103,205110.00,98071.20,303181.20
293130,201806,245,165,80,157410.00,76320.00,233730.00
293135,201806,7990,3152,4838,3000186.18,4607017.08,7607203.26
293140,201806,185,120,65,114480.00,61247.00,175727.00
293150,201806,328,280,48,266357.00,45792.00,312149.00
293160,201806,430,247,183,235638.00,174582.00,410220.00
293170,201806,191,132,59,125928.00,55428.00,181356.00
293180,201806,464,315,149,300224.00,142146.00,442370.00
293190,201806,1285,889,396,843456.73,377784.00,1221240.73
293200,201806,529,468,61,445392.00,58194.00,503586.00
293210,201806,354,266,88,253612.00,83236.50,336848.50
293220,201806,2670,1079,1591,1027432.41,1515667.97,2543100.38
293230,201806,1766,640,1126,609129.80,1074204.00,1683333.80
293240,201806,219,201,18,191754.00,17172.00,208926.00
293245,201806,112,94,18,89676.00,17172.00,106848.00
293250,201806,738,278,460,264964.00,438840.00,703804.00
293260,201806,310,261,49,248040.17,46746.00,294786.17
293270,201806,1181,561,620,533286.68,591480.00,1124766.68
293280,201806,243,136,107,129744.00,102078.00,231822.00
293290,201806,3074,2020,1054,1926063.00,1005217.00,2931280.00
293300,201806,714,508,206,482299.50,194043.60,676343.10
293305,201806,149,127,22,121158.00,20988.00,142146.00
293310,201806,138,104,34,99216.00,32436.00,131652.00
293315,201806,154,119,35,113526.00,33390.00,146916.00
293317,201806,98,69,29,65826.00,27666.00,93492.00
293320,201806,969,562,407,535194.50,388278.00,923472.50
293325,201806,188,65,123,62010.00,117303.84,179313.84
293330,201806,12956,6084,6872,5793930.04,6548088.75,12342018.79
293340,201806,252,182,70,173628.00,65826.00,239454.00
293345,201806,243,192,51,183168.00,48654.00,231822.00
293350,201806,640,347,293,331038.00,278043.30,609081.30
293360,201806,1572,1124,448,1071342.00,427105.80,1498447.80
310010,201806,150,77,73,73458.00,69356.00,142814.00
310020,201806,1055,580,475,551459.90,451242.12,1002702.02
310030,201806,329,267,62,253592.88,59148.00,312740.88
310040,201806,49,30,19,28620.00,18126.00,46746.00
310050,201806,186,124,62,117342.00,58862.00,176204.00
310060,201806,240,167,73,158841.00,69642.00,228483.00
310070,201806,16,8,8,7632.00,7632.00,15264.00
310080,201806,49,27,22,25758.00,20988.00,46746.00
310090,201806,973,518,455,488258.88,432925.60,921184.48
310100,201806,299,228,71,217512.00,67734.00,285246.00
310110,201806,731,391,340,371692.90,323120.00,694812.90
310120,201806,392,215,177,204442.20,168483.94,372926.14
310130,201806,33,21,12,20034.00,11448.00,31482.00
310140,201806,26,14,12,13356.00,11448.00,24804.00
310150,201806,1299,886,413,837376.30,393143.80,1230520.10
310160,201806,2106,1072,1034,1014778.65,983765.20,1998543.85
310163,201806,93,53,40,50562.00,38160.00,88722.00
310170,201806,2619,1107,1512,1055286.20,1439598.40,2494884.60
310180,201806,134,51,83,48654.00,78800.40,127454.40
310190,201806,491,331,160,315774.00,152067.60,467841.60
310200,201806,505,322,183,307188.00,174582.00,481770.00
310205,201806,59,46,13,43884.00,12402.00,56286.00
310210,201806,273,221,52,210834.00,49035.60,259869.60
310220,201806,58,34,24,32436.00,22896.00,55332.00
310230,201806,264,184,80,175345.20,76320.00,251665.20
310240,201806,104,90,14,85621.50,13356.00,98977.50
310250,201806,100,80,20,76320.00,19080.00,95400.00
310260,201806,794,427,367,404402.24,349383.42,753785.66
310270,201806,277,185,92,175937.00,87768.00,263705.00
310280,201806,361,272,89,258821.00,84906.00,343727.00
310285,201806,217,155,62,147561.86,59148.00,206709.86
310290,201806,255,148,107,141192.00,102078.00,243270.00
310300,201806,155,129,26,123066.00,24804.00,147870.00
310310,201806,8,6,2,5724.00,1908.00,7632.00
310320,201806,24,14,10,13356.00,9540.00,22896.00
310330,201806,32,24,8,22896.00,7632.00,30528.00
310340,201806,1718,1116,602,1056651.60,572210.50,1628862.10
310350,201806,2855,1552,1303,1476739.81,1242194.60,2718934.41
310360,201806,39,32,7,30528.00,6678.00,37206.00
310370,201806,127,105,22,100170.00,20702.00,120872.00
310375,201806,109,40,69,38160.00,65807.00,103967.00
310380,201806,53,31,22,28668.00,20988.00,49656.00
310390,201806,103,70,33,66780.00,31482.00,98262.00
310400,201806,2372,1539,833,1464296.00,794109.80,2258405.80
310410,201806,124,67,57,63918.00,54378.00,118296.00
310420,201806,664,351,313,333996.20,297639.06,631635.26
310430,201806,323,215,108,204871.50,103032.00,307903.50
310440,201806,71,41,30,39114.00,28620.00,67734.00
310445,201806,82,66,16,62964.00,15264.00,78228.00
310450,201806,855,536,319,511344.00,304047.66,815391.66
310460,201806,264,192,72,183168.00,68688.00,251856.00
310470,201806,504,324,180,309096.00,171720.00,480816.00
310480,201806,78,57,21,54378.00,20034.00,74412.00
310490,201806,515,244,271,231822.20,258534.00,490356.20
310500,201806,126,53,73,50562.00,69642.00,120204.00
310510,201806,603,395,208,375590.60,198423.00,574013.60
310520,201806,130,87,43,82998.00,41022.00,124020.00
310530,201806,87,39,48,37206.00,45505.80,82711.80
310540,201806,462,287,175,271414.60,166663.80,438078.40
310550,201806,87,58,29,55332.00,27666.00,82998.00
310560,201806,2966,2039,927,1934438.54,883733.13,2818171.67
310570,201806,120,81,39,77274.00,37206.00,114480.00
310590,201806,352,234,118,221853.80,112557.69,334411.49
310600,201806,161,91,70,84382.70,66780.00,151162.70
310610,201806,61,23,38,21942.00,36252.00,58194.00
310620,201806,46269,22208,24061,21107174.16,22912349.09,44019523.25
310630,201806,611,389,222,368387.60,210453.40,578841.00
310640,201806,142,116,26,110473.20,24804.00,135277.20
310650,201806,166,146,20,138044.00,19080.00,157124.00
310660,201806,91,57,34,54378.00,32436.00,86814.00
310665,201806,56,41,15,39114.00,14310.00,53424.00
310670,201806,6458,2942,3516,2798779.17,3350231.24,6149010.41
310680,201806,58,38,20,36252.00,19080.00,55332.00
310690,201806,615,448,167,421804.46,159318.00,581122.46
310700,201806,58,37,21,35298.00,19890.90,55188.90
310710,201806,1242,839,403,798608.45,383889.80,1182498.25
310720,201806,91,29,62,27666.00,59148.00,86814.00
310730,201806,1370,957,413,911738.50,393716.00,1305454.50
310740,201806,990,555,435,526322.40,414456.26,940778.66
310750,201806,245,144,101,136422.18,96354.00,232776.18
310760,201806,65,48,17,45792.00,15932.00,61724.00
310770,201806,91,44,47,41976.00,44838.00,86814.00
310780,201806,398,327,71,311376.60,67734.00,379110.60
310790,201806,99,81,18,77274.00,17172.00,94446.00
310800,201806,458,222,236,211311.00,224857.80,436168.80
310810,201806,170,120,50,113421.20,46746.00,160167.20
310820,201806,356,282,74,269028.00,70309.80,339337.80
310825,201806,200,163,37,155502.00,35298.00,190800.00
310830,201806,464,222,242,211127.94,230868.00,441995.94
310840,201806,384,220,164,209880.00,156456.00,366336.00
310850,201806,110,88,22,83952.00,20988.00,104940.00
310855,201806,380,301,79,287154.00,75366.00,362520.00
310860,201806,1407,1053,354,1000699.90,335980.90,1336680.80
310870,201806,54,42,12,40068.00,11448.00,51516.00
310880,201806,82,64,18,60769.80,17172.00,77941.80
310890,201806,313,185,128,176490.00,122112.00,298602.00
310900,201806,638,296,342,279746.27,325962.80,605709.07
310910,201806,246,168,78,158937.20,74412.00,233349.20
310920,201806,485,289,196,271891.20,186984.00,458875.20
310925,201806,39,32,7,30528.00,6392.00,36920.00
310930,201806,1093,659,434,628569.53,413941.07,1042510.60
310940,201806,683,348,335,331705.80,319590.00,651295.80
310945,201806,116,71,45,67734.00,42930.00,110664.00
310950,201806,252,200,52,190800.00,49608.00,240408.00
310960,201806,82,30,52,28620.00,49604.00,78224.00
310970,201806,168,104,64,99216.00,60133.76,159349.76
310980,201806,41,21,20,20034.00,19080.00,39114.00
310990,201806,152,86,66,81758.00,62964.00,144722.00
311000,201806,867,431,436,407645.69,415935.00,823580.69
311010,201806,39,32,7,30528.00,6678.00,37206.00
311020,201806,42,26,16,24804.00,15264.00,40068.00
311030,201806,382,230,152,217512.00,144913.00,362425.00
311040,201806,38,33,5,31482.00,4770.00,36252.00
311050,201806,464,193,271,183550.00,257961.60,441511.60
311060,201806,773,439,334,417375.40,318350.00,735725.40
311070,201806,334,153,181,145962.00,172674.00,318636.00
311080,201806,105,58,47,55332.00,44838.00,100170.00
311090,201806,391,185,206,175250.00,196524.00,371774.00
311100,201806,609,363,246,346015.80,234111.60,580127.40
311110,201806,680,471,209,449047.80,199377.00,648424.80
311115,201806,68,50,18,47700.00,17172.00,64872.00
311120,201806,1065,564,501,536679.58,477047.90,1013727.48
311130,201806,406,240,166,228769.20,158364.00,387133.20
311140,201806,164,83,81,78895.80,76463.10,155358.90
311150,201806,358,234,124,223236.00,118057.50,341293.50
311160,201806,746,538,208,510867.40,197955.00,708822.40
311170,201806,78,58,20,55332.00,18793.80,74125.80
311180,201806,349,234,115,222949.80,109424.00,332373.80
311190,201806,35,17,18,16218.00,17172.00,33390.00
311200,201806,341,238,103,225430.60,98262.00,323692.60
311205,201806,31,21,10,20034.00,9158.40,29192.40
311210,201806,49,41,8,38828.00,7632.00,46460.00
311220,201806,19,17,2,16218.00,1908.00,18126.00
311230,201806,1632,1071,561,1017368.74,535194.00,1552562.74
311240,201806,175,111,64,105690.33,61056.00,166746.33
311250,201806,88,30,58,28620.00,55332.00,83952.00
311260,201806,553,349,204,332946.00,194616.00,527562.00
311265,201806,116,81,35,77274.00,33390.00,110664.00
311270,201806,285,206,79,196524.00,75366.00,271890.00
311280,201806,213,97,116,92538.00,110091.60,202629.60
311290,201806,109,88,21,83952.00,19748.00,103700.00
311300,201806,552,350,202,333900.00,192422.00,526322.00
311310,201806,25,19,6,18126.00,5724.00,23850.00
311320,201806,672,498,174,474138.00,165996.00,640134.00
311330,201806,1042,764,278,728617.50,264258.40,992875.90
311340,201806,2653,1879,774,1783038.13,736756.66,2519794.79
311350,201806,275,209,66,199386.00,62964.00,262350.00
311360,201806,178,106,72,101124.00,68688.00,169812.00
311370,201806,1213,498,715,473098.50,681537.60,1154636.10
311380,201806,7,6,1,5724.00,954,6678.00
311390,201806,281,150,131,143100.00,124783.20,267883.20
311400,201806,151,99,52,94446.00,49608.00,144054.00
311410,201806,102,57,45,54092.00,42930.00,97022.00
311420,201806,301,168,133,158364.80,126882.00,285246.80
311430,201806,865,563,302,535195.20,287822.00,823017.20
311440,201806,488,340,148,324360.00,140905.80,465265.80
311450,201806,325,206,119,196524.00,113526.00,310050.00
311455,201806,302,205,97,195274.80,92251.80,287526.60
311460,201806,137,57,80,54378.00,75514.27,129892.27
311470,201806,23,13,10,12402.00,9540.00,21942.00
311480,201806,31,13,18,12402.00,17172.00,29574.00
311490,201806,16,10,6,9540.00,5724.00,15264.00
311500,201806,20,10,10,9540.00,9540.00,19080.00
311510,201806,622,435,187,413047.70,178111.80,591159.50
311520,201806,44,34,10,31768.20,9540.00,41308.20
311530,201806,1821,1366,455,1291067.46,434070.00,1725137.46
311535,201806,69,51,18,48654.00,17172.00,65826.00
311540,201806,34,29,5,27666.00,4770.00,32436.00
311545,201806,190,142,48,135468.00,45792.00,181260.00
311547,201806,33,24,9,22896.00,8586.00,31482.00
311550,201806,655,303,352,289062.00,335789.46,624851.46
311560,201806,42,27,15,25758.00,14310.00,40068.00
311570,201806,300,200,100,190227.60,95400.00,285627.60
311580,201806,313,185,128,176203.80,122112.00,298315.80
311590,201806,33,29,4,27666.00,3816.00,31482.00
311600,201806,91,73,18,69642.00,17172.00,86814.00
311610,201806,257,224,33,212742.50,31482.00,244224.50
311615,201806,105,88,17,83312.82,16027.20,99340.02
311620,201806,20,11,9,10494.00,8586.00,19080.00
311630,201806,86,72,14,68688.00,13356.00,82044.00
311640,201806,128,67,61,63918.00,58194.00,122112.00
311650,201806,129,95,34,89914.50,32436.00,122350.50
311660,201806,414,199,215,189846.00,205110.00,394956.00
311670,201806,168,108,60,102787.00,57240.00,160027.00
311680,201806,221,160,61,151738.95,57430.80,209169.75
311690,201806,18,11,7,10494.00,6678.00,17172.00
311700,201806,201,141,60,134227.80,56572.20,190800.00
311710,201806,212,135,77,128790.00,73458.00,202248.00
311720,201806,37,27,10,25758.00,9540.00,35298.00
311730,201806,559,364,195,346684.00,186030.00,532714.00
311740,201806,39,28,11,26712.00,10494.00,37206.00
311750,201806,713,483,230,458874.80,219420.00,678294.80
311760,201806,64,35,29,33390.00,27666.00,61056.00
311770,201806,400,192,208,181260.62,198432.00,379692.62
311780,201806,173,96,77,91298.00,73141.00,164439.00
311783,201806,83,74,9,70596.00,8586.00,79182.00
311787,201806,34,14,20,13356.00,19080.00,32436.00
311790,201806,266,127,139,121158.00,132606.00,253764.00
311800,201806,653,436,217,412558.30,206350.20,618908.50
311810,201806,43,36,7,34344.00,6678.00,41022.00
311820,201806,107,91,16,86814.00,15264.00,102078.00
311830,201806,1926,1216,710,1154259.30,673429.40,1827688.70
311840,201806,1027,571,456,539877.90,433555.54,973433.44
311850,201806,10,6,4,5724.00,3816.00,9540.00
311860,201806,9477,4303,5174,4088567.81,4929256.97,9017824.78
311870,201806,150,83,67,79182.00,63918.00,143100.00
311880,201806,950,706,244,671988.80,232776.00,904764.80
311890,201806,219,111,108,105894.00,103032.00,208926.00
311900,201806,82,35,47,33390.00,44838.00,78228.00
311910,201806,1406,865,541,823016.60,514015.40,1337032.00
311920,201806,230,149,81,142146.00,77274.00,219420.00
311930,201806,923,526,397,501518.00,378500.00,880018.00
311940,201806,2517,1309,1208,1246449.70,1148377.50,2394827.20
311950,201806,40,28,12,26712.00,11448.00,38160.00
311960,201806,65,46,19,43884.00,18126.00,62010.00
311970,201806,26,17,9,13928.40,8586.00,22514.40
311980,201806,42,32,10,30528.00,9540.00,40068.00
311990,201806,56,40,16,38160.00,15264.00,53424.00
311995,201806,64,45,19,42930.00,18126.00,61056.00
312000,201806,36,25,11,23563.80,10494.00,34057.80
312010,201806,82,60,22,57240.00,20988.00,78228.00
312015,201806,99,75,24,71264.00,22896.00,94160.00
312020,201806,140,87,53,82998.00,50562.00,133560.00
312030,201806,45,36,9,33677.00,8586.00,42263.00
312040,201806,84,53,31,50562.00,29574.00,80136.00
312050,201806,219,117,102,111618.00,97308.00,208926.00
312060,201806,68,41,27,39114.00,25090.20,64204.20
312070,201806,74,46,28,43884.00,26712.00,70596.00
312080,201806,531,241,290,229914.00,276660.00,506574.00
312083,201806,49,36,13,34344.00,12402.00,46746.00
312087,201806,115,93,22,88722.00,20988.00,109710.00
312090,201806,2921,1665,1256,1575249.50,1194842.35,2770091.85
312100,201806,158,112,46,106848.00,43102.00,149950.00
312110,201806,119,73,46,69642.00,43884.00,113526.00
312120,201806,143,106,37,99884.00,35298.00,135182.00
312125,201806,99,56,43,53233.20,41022.00,94255.20
312130,201806,121,81,40,77274.00,38160.00,115434.00
312140,201806,137,107,30,102078.00,28620.00,130698.00
312150,201806,47,36,11,34344.00,10494.00,44838.00
312160,201806,1535,1015,520,963827.20,494668.48,1458495.68
312170,201806,12,10,2,9540.00,1908.00,11448.00
312180,201806,101,62,39,58433.00,36920.00,95353.00
312190,201806,31,27,4,25758.00,3816.00,29574.00
312200,201806,738,636,102,604788.70,97308.00,702096.70
312210,201806,97,64,33,61056.00,31482.00,92538.00
312220,201806,121,88,33,83714.00,31482.00,115196.00
312230,201806,3553,1741,1812,1656556.48,1726983.08,3383539.56
312235,201806,157,104,53,99216.00,50562.00,149778.00
312240,201806,108,71,37,67734.00,35298.00,103032.00
312245,201806,169,115,54,109706.00,51516.00,161222.00
312247,201806,63,44,19,41213.00,18126.00,59339.00
312250,201806,184,85,99,81090.00,94446.00,175536.00
312260,201806,102,68,34,64013.40,32436.00,96449.40
312270,201806,137,86,51,82044.00,48654.00,130698.00
312280,201806,27,17,10,16218.00,9540.00,25758.00
312290,201806,163,112,51,106848.00,47701.00,154549.00
312300,201806,200,131,69,124974.00,65826.00,190800.00
312310,201806,58,53,5,50562.00,4770.00,55332.00
312320,201806,429,267,162,252810.00,152974.10,405784.10
312330,201806,90,79,11,74603.00,10207.80,84810.80
312340,201806,35,16,19,15264.00,18126.00,33390.00
312350,201806,17,11,6,10494.00,5724.00,16218.00
312352,201806,98,66,32,62964.00,30528.00,93492.00
312360,201806,557,252,305,239454.00,290970.00,530424.00
312370,201806,305,178,127,169525.80,121158.00,290683.80
312380,201806,139,90,49,85860.00,46746.00,132606.00
312385,201806,174,141,33,134227.80,31482.00,165709.80
312390,201806,303,190,113,181260.00,107135.00,288395.00
312400,201806,377,288,89,274752.00,84430.00,359182.00
312410,201806,882,287,595,273321.00,567054.00,840375.00
312420,201806,611,484,127,460782.20,121158.00,581940.20
312430,201806,870,642,228,610180.05,216558.20,826738.25
312440,201806,46,34,12,32436.00,11448.00,43884.00
312450,201806,212,130,82,124020.00,78228.00,202248.00
312460,201806,60,29,31,27666.00,29574.00,57240.00
312470,201806,55,36,19,34344.00,18126.00,52470.00
312480,201806,204,125,79,119250.00,75366.00,194616.00
312490,201806,270,186,84,177444.00,80136.00,257580.00
312500,201806,33,18,15,17172.00,14310.00,31482.00
312510,201806,439,167,272,159318.00,258872.39,418190.39
312520,201806,43,15,28,14310.00,26712.00,41022.00
312530,201806,49,37,12,35298.00,11448.00,46746.00
312540,201806,101,88,13,83952.00,12402.00,96354.00
312550,201806,38,30,8,28620.00,7632.00,36252.00
312560,201806,213,158,55,150446.00,52183.80,202629.80
312570,201806,441,264,177,251188.20,168166.45,419354.65
312580,201806,83,44,39,41976.00,37206.00,79182.00
312590,201806,265,209,56,199386.00,53424.00,252810.00
312595,201806,140,125,15,119250.00,14310.00,133560.00
312600,201806,77,46,31,43455.00,29574.00,73029.00
312610,201806,1627,858,769,811283.98,731909.60,1543193.58
312620,201806,192,136,56,129744.00,53419.23,183163.23
312630,201806,64,54,10,51516.00,9540.00,61056.00
312640,201806,47,13,34,12402.00,32436.00,44838.00
312650,201806,154,128,26,121826.00,24518.00,146344.00
312660,201806,72,54,18,51230.00,17172.00,68402.00
312670,201806,868,572,296,544735.00,282170.30,826905.30
312675,201806,41,31,10,29574.00,9540.00,39114.00
312680,201806,86,57,29,53996.40,27666.00,81662.40
312690,201806,238,126,112,120194.46,106561.80,226756.26
312695,201806,31,24,7,22896.00,6678.00,29574.00
312700,201806,213,122,91,116388.00,86814.00,203202.00
312705,201806,76,62,14,59148.00,13356.00,72504.00
312707,201806,96,70,26,66360.24,24804.00,91164.24
312710,201806,1891,1004,887,955215.60,845987.00,1801202.60
312720,201806,66,33,33,31482.00,31482.00,62964.00
312730,201806,288,168,120,159318.00,114480.00,273798.00
312733,201806,51,44,7,41690.00,6678.00,48368.00
312735,201806,22,16,6,15264.00,5724.00,20988.00
312737,201806,68,36,32,34344.00,30528.00,64872.00
312738,201806,52,37,15,35298.00,14310.00,49608.00
312740,201806,75,50,25,47414.00,23850.00,71264.00
312750,201806,70,52,18,49608.00,17172.00,66780.00
312760,201806,272,199,73,189846.00,69642.00,259488.00
312770,201806,7623,3532,4091,3346483.89,3894177.48,7240661.37
312780,201806,432,332,100,316441.80,95400.00,411841.80
312790,201806,21,16,5,15264.00,4770.00,20034.00
312800,201806,1603,1120,483,1062013.28,460782.00,1522795.28
312810,201806,367,238,129,226765.80,123066.00,349831.80
312820,201806,196,148,48,141192.00,45792.00,186984.00
312825,201806,27,18,9,17172.00,8586.00,25758.00
312830,201806,277,167,110,158079.00,104301.00,262380.00
312840,201806,148,109,39,103986.00,37206.00,141192.00
312850,201806,26,23,3,21942.00,2862.00,24804.00
312860,201806,170,103,67,97976.00,63918.00,161894.00
312870,201806,989,519,470,492232.24,448380.00,940612.24
312880,201806,151,103,48,98118.90,45696.60,143815.50
312890,201806,167,115,52,109710.00,49608.00,159318.00
312900,201806,209,156,53,148156.20,50562.00,198718.20
312910,201806,192,99,93,93277.72,88722.00,181999.72
312920,201806,157,88,69,83952.00,65826.00,149778.00
312930,201806,342,250,92,238500.00,87768.00,326268.00
312940,201806,109,73,36,69642.00,34344.00,103986.00
312950,201806,695,459,236,436836.60,225144.00,661980.60
312960,201806,174,135,39,128790.00,37206.00,165996.00
312965,201806,53,49,4,46746.00,3816.00,50562.00
312970,201806,296,236,60,224190.20,57240.00,281430.20
312980,201806,2331,1225,1106,1164159.40,1054547.60,2218707.00
312990,201806,49,28,21,26712.00,20034.00,46746.00
313000,201806,42,25,17,23850.00,16218.00,40068.00
313005,201806,168,129,39,122827.50,36920.00,159747.50
313010,201806,940,383,557,364141.80,531369.00,895510.80
313020,201806,189,100,89,94923.00,84906.00,179829.00
313030,201806,208,135,73,126883.00,69642.00,196525.00
313040,201806,66,26,40,24804.00,38160.00,62964.00
313050,201806,294,205,89,195570.00,84906.00,280476.00
313055,201806,47,35,12,33390.00,11448.00,44838.00
313060,201806,124,86,38,82044.00,35965.80,118009.80
313065,201806,60,39,21,37206.00,20034.00,57240.00
313070,201806,150,80,70,76320.00,66780.00,143100.00
313080,201806,42,18,24,17172.00,22896.00,40068.00
313090,201806,707,489,218,465218.30,207972.00,673190.30
313100,201806,163,63,100,60102.00,95392.00,155494.00
313110,201806,126,73,53,69642.00,50562.00,120204.00
313115,201806,164,90,74,85659.66,70596.00,156255.66
313120,201806,755,412,343,392762.00,325982.00,718744.00
313130,201806,5285,2866,2419,2709783.83,2299542.86,5009326.69
313140,201806,159,82,77,78228.00,73458.00,151686.00
313150,201806,312,247,65,235638.00,61723.80,297361.80
313160,201806,201,148,53,140906.00,50562.00,191468.00
313170,201806,1372,965,407,907321.93,387887.40,1295209.33
313180,201806,326,194,132,184427.28,125928.00,310355.28
313190,201806,742,441,301,418615.20,286391.00,705006.20
313200,201806,24,23,1,21942.00,954,22896.00
313210,201806,1043,879,164,835563.16,156451.23,992014.39
313220,201806,243,167,76,158364.00,71788.50,230152.50
313230,201806,267,197,70,186985.00,66780.00,253765.00
313240,201806,1921,1027,894,976697.73,849913.83,1826611.56
313250,201806,1266,944,322,895903.80,305281.80,1201185.60
313260,201806,98,55,43,52470.00,41022.00,93492.00
313270,201806,965,564,401,534384.10,382554.00,916938.10
313280,201806,61,52,9,49131.00,8586.00,57717.00
313290,201806,225,182,43,173342.00,40068.80,213410.80
313300,201806,381,197,184,184791.00,175536.00,360327.00
313310,201806,229,118,111,112572.00,105894.00,218466.00
313320,201806,374,286,88,270889.10,83952.00,354841.10
313330,201806,1365,836,529,796113.20,503474.50,1299587.70
313340,201806,336,233,103,222282.00,98262.00,320544.00
313350,201806,518,350,168,331992.10,160272.00,492264.10
313360,201806,116,69,47,65826.00,44552.00,110378.00
313370,201806,190,69,121,65826.00,115434.00,181260.00
313375,201806,275,165,110,157410.00,104940.00,262350.00
313380,201806,1325,680,645,646831.08,615040.00,1261871.08
313390,201806,47,41,6,38160.80,5724.00,43884.80
313400,201806,416,277,139,264258.00,132034.00,396292.00
313410,201806,20,12,8,11448.00,7632.00,19080.00
313420,201806,4695,2447,2248,2325073.90,2137517.79,4462591.69
313430,201806,143,66,77,62964.00,73172.00,136136.00
313440,201806,1480,1011,469,961394.90,446282.00,1407676.90
313450,201806,63,27,36,25758.00,34057.80,59815.80
313460,201806,373,176,197,167418.00,187938.00,355356.00
313470,201806,536,245,291,233730.00,276946.20,510676.20
313480,201806,157,107,50,101125.00,47700.00,148825.00
313490,201806,513,250,263,238495.23,250855.00,489350.23
313500,201806,21,14,7,13356.00,6678.00,20034.00
313505,201806,983,766,217,729810.20,206731.80,936542.00
313507,201806,96,57,39,54378.00,37206.00,91584.00
313510,201806,2790,1778,1012,1690419.44,964494.00,2654913.44
313520,201806,3629,2836,793,2693146.67,756518.00,3449664.67
313530,201806,44,29,15,27666.00,14310.00,41976.00
313535,201806,107,85,22,80423.00,20988.00,101411.00
313540,201806,71,54,17,51516.00,16218.00,67734.00
313545,201806,115,96,19,91584.00,18126.00,109710.00
313550,201806,234,193,41,184122.00,38828.00,222950.00
313560,201806,330,170,160,162180.00,152640.00,314820.00
313570,201806,61,32,29,30528.00,27666.00,58194.00
313580,201806,1317,725,592,688734.46,563910.00,1252644.46
313590,201806,80,48,32,45792.00,30528.00,76320.00
313600,201806,697,416,281,396578.00,267216.00,663794.00
313610,201806,61,49,12,46126.80,11448.00,57574.80
313620,201806,1362,722,640,677688.38,606677.00,1284365.38
313630,201806,1640,1252,388,1191144.40,369866.00,1561010.40
313640,201806,129,75,54,71550.00,51516.00,123066.00
313650,201806,238,110,128,104940.00,121540.00,226480.00
313652,201806,17,17,0,16218.00,0,16218.00
313655,201806,55,32,23,30528.00,21942.00,52470.00
313657,201806,47,44,3,41976.00,2862.00,44838.00
313660,201806,133,90,43,85860.00,41022.00,126882.00
313665,201806,651,316,335,301224.00,319351.50,620575.50
313670,201806,10347,7145,3202,6791600.28,3053149.60,9844749.88
313680,201806,42,31,11,29574.00,10390.00,39964.00
313690,201806,154,116,38,110664.00,36252.00,146916.00
313695,201806,78,59,19,56286.00,18126.00,74412.00
313700,201806,301,243,58,231536.00,55332.00,286868.00
313710,201806,148,101,47,96354.00,44838.00,141192.00
313720,201806,1101,523,578,496461.80,550067.86,1046529.66
313730,201806,61,42,19,40068.00,18126.00,58194.00
313740,201806,162,130,32,124020.00,30528.00,154548.00
313750,201806,443,323,120,308142.00,114480.00,422622.00
313753,201806,240,173,67,164374.20,63918.00,228292.20
313760,201806,1265,458,807,436646.00,767131.98,1203777.98
313770,201806,354,256,98,243032.20,93492.00,336524.20
313780,201806,765,397,368,378738.00,350785.80,729523.80
313790,201806,27,26,1,24804.00,954,25758.00
313800,201806,148,91,57,86814.00,54378.00,141192.00
313810,201806,69,41,28,39114.00,26712.00,65826.00
313820,201806,1286,639,647,608366.20,615975.00,1224341.20
313830,201806,67,49,18,46746.00,17172.00,63918.00
313835,201806,56,48,8,45792.00,7632.00,53424.00
313840,201806,1699,1047,652,993497.52,620482.00,1613979.52
313850,201806,184,63,121,60102.00,114854.06,174956.06
313860,201806,481,372,109,351407.30,103986.00,455393.30
313862,201806,173,115,58,109710.00,55332.00,165042.00
313865,201806,88,70,18,66780.00,17172.00,83952.00
313867,201806,48,37,11,35298.00,10494.00,45792.00
313868,201806,27,18,9,16409.00,8586.00,24995.00
313870,201806,128,65,63,62010.00,59816.00,121826.00
313880,201806,359,225,134,214650.00,127263.80,341913.80
313890,201806,324,172,152,163325.80,144435.60,307761.40
313900,201806,909,497,412,473184.50,393001.00,866185.50
313910,201806,138,99,39,94446.00,36252.20,130698.20
313920,201806,618,440,178,419569.20,169292.00,588861.20
313925,201806,32,28,4,26712.00,3816.00,30528.00
313930,201806,817,630,187,600734.00,178375.00,779109.00
313940,201806,1807,1138,669,1081740.80,637558.40,1719299.20
313950,201806,943,600,343,570588.60,326935.80,897524.40
313960,201806,1389,802,587,760844.30,558280.00,1319124.30
313970,201806,120,81,39,77274.00,37206.00,114480.00
313980,201806,215,139,76,132368.00,72504.00,204872.00
313990,201806,376,226,150,215604.00,143100.00,358704.00
314000,201806,928,626,302,593723.90,288103.23,881827.13
314010,201806,77,51,26,48654.00,24804.00,73458.00
314015,201806,51,16,35,15264.00,33390.00,48654.00
314020,201806,50,34,16,32436.00,15264.00,47700.00
314030,201806,85,38,47,36089.82,44838.00,80927.82
314040,201806,44,31,13,29574.00,12402.00,41976.00
314050,201806,319,188,131,179066.00,124163.10,303229.10
314053,201806,98,65,33,61056.40,31482.00,92538.40
314055,201806,305,181,124,172674.00,118296.00,290970.00
314060,201806,146,124,22,117342.00,20988.00,138330.00
314070,201806,1027,514,513,486551.14,488782.00,975333.14
314080,201806,220,143,77,135205.13,72408.88,207614.01
314085,201806,134,89,45,84906.00,42930.00,127836.00
314090,201806,358,258,100,246132.00,95395.23,341527.23
314100,201806,475,390,85,368245.00,80518.00,448763.00
314110,201806,705,385,320,365677.74,304707.60,670385.34
314120,201806,97,55,42,52470.00,40068.00,92538.00
314130,201806,25,12,13,11448.00,12402.00,23850.00
314140,201806,1102,667,435,632673.92,411842.46,1044516.38
314150,201806,163,104,59,99216.00,56286.00,155502.00
314160,201806,349,261,88,246132.80,83762.00,329894.80
314170,201806,76,58,18,55332.00,17172.00,72504.00
314180,201806,730,642,88,612182.00,82998.50,695180.50
314190,201806,103,61,42,58194.00,40068.00,98262.00
314200,201806,590,409,181,388915.60,171720.00,560635.60
314210,201806,282,212,70,201294.00,66494.00,267788.00
314220,201806,311,235,76,222283.00,72218.00,294501.00
314225,201806,65,47,18,44838.00,17172.00,62010.00
314230,201806,108,47,61,44838.00,58194.00,103032.00
314240,201806,139,107,32,102078.00,30528.00,132606.00
314250,201806,60,37,23,35298.00,21942.00,57240.00
314260,201806,189,95,94,90630.00,89676.00,180306.00
314270,201806,328,260,68,247277.00,64586.00,311863.00
314280,201806,697,390,307,372051.00,292878.00,664929.00
314290,201806,561,458,103,435692.50,97975.80,533668.30
314300,201806,407,290,117,273724.00,111571.00,385295.00
314310,201806,1459,985,474,937783.12,452160.01,1389943.13
314315,201806,36,30,6,28620.00,5724.00,34344.00
314320,201806,606,390,216,371487.80,205424.82,576912.62
314330,201806,10697,5389,5308,5129767.08,5059366.75,10189133.83
314340,201806,574,267,307,254145.80,292306.00,546451.80
314345,201806,32,25,7,23850.00,6678.00,30528.00
314350,201806,191,120,71,114480.00,67734.00,182214.00
314360,201806,78,49,29,46746.00,27666.00,74412.00
314370,201806,57,48,9,45792.00,8586.00,54378.00
314380,201806,94,67,27,63918.00,25758.00,89676.00
314390,201806,3264,2075,1189,1974017.30,1131349.40,3105366.70
314400,201806,683,490,193,464590.20,184122.00,648712.20
314410,201806,436,284,152,270936.00,145008.00,415944.00
314420,201806,19,9,10,8586.00,9540.00,18126.00
314430,201806,2513,899,1614,853798.43,1537244.47,2391042.90
314435,201806,272,157,115,149491.80,108756.00,258247.80
314437,201806,29,22,7,20988.00,6678.00,27666.00
314440,201806,98,71,27,67734.00,25758.00,93492.00
314450,201806,155,114,41,108756.00,39114.00,147870.00
314460,201806,655,306,349,291924.00,332946.00,624870.00
314465,201806,84,56,28,53424.00,26712.00,80136.00
314467,201806,69,58,11,55323.00,10494.00,65817.00
314470,201806,391,204,187,191164.52,177444.50,368609.02
314480,201806,1085,517,568,493218.00,541395.00,1034613.00
314490,201806,88,66,22,62964.00,20988.00,83952.00
314500,201806,313,208,105,198432.00,100170.00,298602.00
314505,201806,127,84,43,80136.00,41022.00,121158.00
314510,201806,232,190,42,181260.00,40068.00,221328.00
314520,201806,1262,654,608,616479.70,579173.80,1195653.50
314530,201806,737,581,156,553474.00,148824.00,702298.00
314535,201806,212,134,78,126786.60,74161.01,200947.61
314537,201806,64,39,25,37206.00,23850.00,61056.00
314540,201806,14,9,5,8586.00,4770.00,13356.00
314545,201806,49,31,18,29574.00,17172.00,46746.00
314550,201806,82,44,38,41976.00,36252.00,78228.00
314560,201806,815,438,377,415371.80,359658.00,775029.80
314570,201806,22,17,5,16218.00,4770.00,20988.00
314580,201806,17,8,9,7632.00,8586.00,16218.00
314585,201806,20,15,5,14310.00,4770.00,19080.00
314587,201806,84,73,11,69642.00,10494.00,80136.00
314590,201806,570,417,153,397818.00,145676.00,543494.00
314600,201806,984,643,341,609027.06,323978.60,933005.66
314610,201806,945,515,430,488448.70,410029.20,898477.90
314620,201806,152,113,39,106423.36,37206.00,143629.36
314625,201806,98,72,26,68116.00,24804.00,92920.00
314630,201806,1238,634,604,603357.30,575643.80,1179001.10
314640,201806,91,59,32,56286.00,30241.80,86527.80
314650,201806,197,115,82,109423.80,77751.00,187174.80
314655,201806,67,52,15,49608.00,14310.00,63918.00
314660,201806,20,16,4,15264.00,3816.00,19080.00
314670,201806,192,151,41,143768.00,39114.00,182882.00
314675,201806,218,127,91,121158.00,86814.00,207972.00
314690,201806,537,299,238,284959.80,227052.00,512011.80
314700,201806,2436,1339,1097,1272255.60,1045350.90,2317606.50
314710,201806,1627,948,679,899434.90,647146.10,1546581.00
314720,201806,409,245,164,232327.62,156456.00,388783.62
314730,201806,516,272,244,258058.00,232767.00,490825.00
314740,201806,691,341,350,323930.70,333900.00,657830.70
314750,201806,20,17,3,16218.00,2862.00,19080.00
314760,201806,327,156,171,148824.00,163124.46,311948.46
314770,201806,122,83,39,79182.00,37206.00,116388.00
314780,201806,21,6,15,5724.00,14310.00,20034.00
314790,201806,2369,1478,891,1402448.52,849336.66,2251785.18
314795,201806,53,45,8,42692.00,7632.00,50324.00
314800,201806,2947,1740,1207,1654674.66,1149416.40,2804091.06
314810,201806,1517,845,672,803793.50,639467.00,1443260.50
314820,201806,91,51,40,48654.00,38160.00,86814.00
314830,201806,207,164,43,155740.50,40736.00,196476.50
314840,201806,82,47,35,44838.00,33390.00,78228.00
314850,201806,353,171,182,163134.00,173628.00,336762.00
314860,201806,707,531,176,504570.86,165710.70,670281.56
314870,201806,1486,777,709,740304.00,676386.00,1416690.00
314875,201806,56,48,8,45792.00,7632.00,53424.00
314880,201806,46,33,13,31482.00,12402.00,43884.00
314890,201806,53,31,22,29574.00,20988.00,50562.00
314900,201806,34,27,7,25758.00,6678.00,32436.00
314910,201806,253,172,81,163801.80,77274.00,241075.80
314915,201806,158,139,19,132606.00,18126.00,150732.00
314920,201806,124,77,47,73458.00,44551.80,118009.80
314930,201806,1040,529,511,502802.33,486921.60,989723.93
314940,201806,52,40,12,38160.00,11448.00,49608.00
314950,201806,38,27,11,25758.00,10494.00,36252.00
314960,201806,55,42,13,40068.00,12402.00,52470.00
314970,201806,141,71,70,67734.00,66780.00,134514.00
314980,201806,304,194,110,182834.10,103986.00,286820.10
314990,201806,468,258,210,246132.00,199434.50,445566.50
314995,201806,207,64,143,61056.00,136412.46,197468.46
315000,201806,93,76,17,72504.00,16218.00,88722.00
315010,201806,46,30,16,28620.00,15264.00,43884.00
315015,201806,178,145,33,137604.96,31482.00,169086.96
315020,201806,72,62,10,59148.00,9540.00,68688.00
315030,201806,117,90,27,84906.00,25758.00,110664.00
315040,201806,66,48,18,45792.00,17172.00,62964.00
315050,201806,203,123,80,117342.00,76320.00,193662.00
315053,201806,40,35,5,33390.00,4492.77,37882.77
315057,201806,97,80,17,75938.40,16218.00,92156.40
315060,201806,72,64,8,59149.16,7632.00,66781.16
315070,201806,100,55,45,52470.00,42930.00,95400.00
315080,201806,373,306,67,291924.00,63918.00,355842.00
315090,201806,112,67,45,63918.00,42930.00,106848.00
315100,201806,80,41,39,39114.00,37206.00,76320.00
315110,201806,292,163,129,154644.00,123066.00,277710.00
315120,201806,1666,850,816,805387.18,776270.64,1581657.82
315130,201806,343,249,94,237546.00,89676.00,327222.00
315140,201806,531,311,220,295072.20,209880.00,504952.20
315150,201806,983,466,517,443611.00,492932.00,936543.00
315160,201806,213,109,104,103986.00,99216.00,203202.00
315170,201806,336,216,120,205111.00,114193.80,319304.80
315180,201806,3203,1359,1844,1293672.50,1755746.82,3049419.32
315190,201806,316,182,134,173247.00,127836.00,301083.00
315200,201806,1199,689,510,655684.20,485681.40,1141365.60
315210,201806,1557,890,667,845913.40,633898.20,1479811.60
315213,201806,44,25,19,23850.00,18126.00,41976.00
315217,201806,215,172,43,164088.00,41022.00,205110.00
315220,201806,1545,1183,362,1127676.40,344966.60,1472643.00
315230,201806,170,124,46,117342.20,43884.00,161226.20
315240,201806,428,277,151,264258.00,142852.50,407110.50
315250,201806,2562,1264,1298,1205278.83,1237233.86,2442512.69
315260,201806,150,91,59,85860.00,56286.00,142146.00
315270,201806,133,92,41,87195.60,38388.96,125584.56
315280,201806,695,455,240,433689.00,228950.46,662639.46
315290,201806,200,117,83,111618.00,78228.49,189846.49
315300,201806,73,49,24,46746.00,22896.00,69642.00
315310,201806,68,62,6,59148.00,5724.00,64872.00
315320,201806,163,93,70,88722.00,66780.00,155502.00
315330,201806,58,50,8,47700.00,7632.00,55332.00
315340,201806,423,299,124,284063.60,118296.00,402359.60
315350,201806,151,90,61,85860.00,58194.00,144054.00
315360,201806,96,52,44,49608.00,41976.00,91584.00
315370,201806,58,35,23,32675.00,21798.90,54473.90
315380,201806,12,7,5,6678.00,4770.00,11448.00
315390,201806,63,14,49,13356.00,46746.00,60102.00
315400,201806,828,620,208,586042.50,197764.20,783806.70
315410,201806,353,217,136,206732.00,129458.00,336190.00
315415,201806,62,47,15,44838.00,14310.00,59148.00
315420,201806,206,156,50,147728.00,47700.00,195428.00
315430,201806,678,393,285,373682.00,271413.80,645095.80
315440,201806,88,61,27,58194.00,25758.00,83952.00
315445,201806,258,206,52,196209.18,49608.00,245817.18
315450,201806,177,133,44,126882.00,41976.00,168858.00
315460,201806,3452,1725,1727,1642589.40,1644831.10,3287420.50
315470,201806,43,21,22,20034.00,20988.00,41022.00
315480,201806,62,24,38,22896.00,36252.00,59148.00
315490,201806,626,389,237,369054.90,226098.00,595152.90
315500,201806,22,14,8,13356.00,7632.00,20988.00
315510,201806,153,102,51,97308.00,48654.00,145962.00
315520,201806,71,62,9,59148.00,8586.00,67734.00
315530,201806,53,28,25,26712.00,23850.00,50562.00
315540,201806,236,155,81,147870.00,77274.00,225144.00
315550,201806,176,141,35,134514.00,33390.00,167904.00
315560,201806,742,593,149,564382.80,142146.00,706528.80
315570,201806,318,167,151,156123.50,144054.00,300177.50
315580,201806,672,441,231,420047.00,220374.00,640421.00
315590,201806,207,108,99,103032.00,94446.00,197478.00
315600,201806,298,218,80,207018.00,76130.00,283148.00
315610,201806,99,48,51,45792.00,48654.00,94446.00
315620,201806,33,27,6,25758.00,5724.00,31482.00
315630,201806,135,90,45,85860.00,42930.00,128790.00
315640,201806,64,38,26,36252.00,24804.00,61056.00
315645,201806,65,46,19,43884.00,17649.00,61533.00
315650,201806,168,122,46,115816.00,43311.60,159127.60
315660,201806,478,209,269,199386.00,256626.00,456012.00
315670,201806,2399,1201,1198,1142969.32,1141719.66,2284688.98
315680,201806,865,587,278,557517.60,265212.00,822729.60
315690,201806,688,470,218,448259.00,207972.00,656231.00
315700,201806,1922,1016,906,965392.37,864229.00,1829621.37
315710,201806,334,94,240,89676.00,228960.00,318636.00
315720,201806,438,282,156,269028.00,148824.00,417852.00
315725,201806,201,161,40,153594.00,38160.00,191754.00
315727,201806,43,22,21,20988.00,20034.00,41022.00
315730,201806,46,44,2,41976.00,1908.00,43884.00
315733,201806,87,57,30,54378.00,28620.00,82998.00
315737,201806,51,39,12,37206.00,11448.00,48654.00
315740,201806,48,40,8,38160.00,7632.00,45792.00
315750,201806,158,122,36,116388.00,34344.00,150732.00
315760,201806,47,34,13,32436.00,12402.00,44838.00
315765,201806,120,77,43,73458.00,41022.00,114480.00
315770,201806,233,143,90,136422.00,85574.00,221996.00
315780,201806,3295,1706,1589,1620951.94,1513522.58,3134474.52
315790,201806,211,160,51,152640.00,48081.60,200721.60
315800,201806,286,205,81,195570.00,77274.00,272844.00
315810,201806,95,57,38,54378.00,35966.00,90344.00
315820,201806,796,577,219,547883.34,208926.00,756809.34
315830,201806,141,81,60,77274.00,57240.00,134514.00
315840,201806,93,65,28,62010.00,26712.00,88722.00
315850,201806,259,194,65,185076.00,62010.00,247086.00
315860,201806,12,4,8,3816.00,7632.00,11448.00
315870,201806,35,27,8,25758.00,7632.00,33390.00
315880,201806,107,70,37,66780.00,35298.00,102078.00
315890,201806,82,61,21,58194.00,20034.00,78228.00
315895,201806,461,312,149,296599.00,141574.00,438173.00
315900,201806,71,34,37,32150.00,35298.00,67448.00
315910,201806,37,24,13,22657.50,12402.00,35059.50
315920,201806,184,118,66,112572.00,62010.90,174582.90
315930,201806,42,14,28,13356.00,26712.00,40068.00
315935,201806,150,118,32,112572.00,30519.00,143091.00
315940,201806,93,69,24,65826.00,22896.00,88722.00
315950,201806,64,45,19,42930.00,18126.00,61056.00
315960,201806,558,259,299,245817.58,284387.60,530205.18
315970,201806,38,30,8,28620.00,7632.00,36252.00
315980,201806,696,327,369,309721.00,352016.46,661737.46
315990,201806,254,152,102,144770.00,97013.00,241783.00
316000,201806,50,33,17,31195.80,15931.80,47127.60
316010,201806,75,63,12,60102.00,11448.00,71550.00
316020,201806,111,92,19,87768.00,18126.00,105894.00
316030,201806,406,215,191,204824.00,181690.00,386514.00
316040,201806,509,216,293,205110.20,279236.00,484346.20
316045,201806,60,53,7,50562.00,6678.00,57240.00
316050,201806,16,14,2,13356.00,1908.00,15264.00
316060,201806,94,61,33,58194.00,31482.00,89676.00
316070,201806,1072,697,375,658805.40,356987.00,1015792.40
316080,201806,103,65,38,61294.50,36252.00,97546.50
316090,201806,41,25,16,23182.20,15264.00,38446.20
316095,201806,73,61,12,57918.00,11448.00,69366.00
316100,201806,312,184,128,175011.30,122112.00,297123.30
316105,201806,34,23,11,21942.00,10494.00,32436.00
316110,201806,1922,1549,373,1467300.55,355174.20,1822474.75
316120,201806,80,60,20,57240.00,18793.80,76033.80
316130,201806,138,106,32,100457.00,30528.00,130985.00
316140,201806,26,19,7,18126.00,6678.00,24804.00
316150,201806,206,143,63,135706.50,60102.00,195808.50
316160,201806,84,50,34,47700.00,32436.00,80136.00
316165,201806,61,45,16,42740.00,14548.50,57288.50
316170,201806,205,139,66,131652.00,62964.00,194616.00
316180,201806,205,90,115,85526.10,109710.00,195236.10
316190,201806,140,103,37,97308.00,35298.00,132606.00
316200,201806,706,393,313,374922.00,297743.40,672665.40
316210,201806,769,516,253,491917.41,241362.00,733279.41
316220,201806,116,80,36,76320.00,34344.00,110664.00
316225,201806,24,14,10,13356.00,9540.00,22896.00
316230,201806,31,19,12,18126.00,11448.00,29574.00
316240,201806,628,505,123,481770.00,117342.00,599112.00
316245,201806,110,92,18,87768.00,17172.00,104940.00
316250,201806,1519,1060,459,1003398.88,436703.12,1440102.00
316255,201806,110,90,20,85478.40,19065.69,104544.09
316257,201806,186,96,90,91584.00,85573.80,177157.80
316260,201806,242,160,82,151343.06,78133.00,229476.06
316265,201806,27,18,9,17172.00,8586.00,25758.00
316270,201806,678,470,208,445094.40,198432.00,643526.40
316280,201806,539,330,209,313549.80,198718.60,512268.40
316290,201806,696,464,232,439604.18,221328.00,660932.18
316292,201806,516,205,311,195283.80,296456.00,491739.80
316294,201806,101,58,43,55332.00,41022.00,96354.00
316295,201806,297,133,164,124957.00,156456.00,281413.00
316300,201806,103,73,30,69642.00,28620.00,98262.00
316310,201806,38,20,18,18793.80,17172.00,35965.80
316320,201806,42,27,15,25758.00,14310.00,40068.00
316330,201806,131,85,46,80136.50,43597.80,123734.30
316340,201806,146,99,47,94446.00,44838.00,139284.00
316350,201806,193,140,53,133394.00,50562.00,183956.00
316360,201806,23,17,6,16218.00,5724.00,21942.00
316370,201806,1090,582,508,551432.50,484336.26,1035768.76
316380,201806,121,92,29,87768.00,27666.00,115434.00
316390,201806,124,89,35,84906.00,33390.00,118296.00
316400,201806,139,105,34,100170.00,32436.00,132606.00
316410,201806,306,225,81,213075.08,77274.00,290349.08
316420,201806,207,147,60,139522.50,57240.00,196762.50
316430,201806,156,80,76,76320.00,72504.00,148824.00
316440,201806,100,47,53,44838.00,50562.00,95400.00
316443,201806,39,35,4,33390.00,3816.00,37206.00
316447,201806,65,51,14,48654.00,13356.00,62010.00
316450,201806,222,166,56,158364.00,53424.00,211788.00
316460,201806,71,29,42,27666.00,40068.00,67734.00
316470,201806,1620,1167,453,1105612.44,430041.16,1535653.60
316480,201806,13,10,3,9540.00,2862.00,12402.00
316490,201806,18,7,11,6678.00,10494.00,17172.00
316500,201806,153,102,51,97021.80,48654.00,145675.80
316510,201806,164,125,39,118248.30,37206.00,155454.30
316520,201806,185,110,75,104940.00,71550.00,176490.00
316530,201806,158,113,45,107802.00,42643.80,150445.80
316540,201806,143,79,64,75366.00,61056.00,136422.00
316550,201806,139,99,40,94446.00,38160.00,132606.00
316553,201806,250,117,133,111395.53,126882.00,238277.53
316555,201806,34,27,7,24954.00,6678.00,31632.00
316556,201806,11,8,3,7632.00,2862.00,10494.00
316557,201806,18,14,4,13356.00,3816.00,17172.00
316560,201806,62,48,14,45792.00,13356.00,59148.00
316570,201806,243,220,23,209642.00,21942.00,231584.00
316580,201806,22,16,6,15264.00,5724.00,20988.00
316590,201806,114,98,16,93492.00,15264.00,108756.00
316600,201806,180,146,34,139095.00,32436.00,171531.00
316610,201806,66,47,19,44551.80,18126.00,62677.80
316620,201806,136,104,32,99216.00,30528.00,129744.00
316630,201806,43,31,12,29574.00,11448.00,41022.00
316640,201806,16,10,6,9540.00,5724.00,15264.00
316650,201806,70,52,18,49608.00,17172.00,66780.00
316660,201806,7,4,3,3816.00,2862.00,6678.00
316670,201806,445,158,287,150713.00,273225.80,423938.80
316680,201806,163,115,48,109710.00,45602.00,155312.00
316690,201806,194,124,70,118296.00,66780.00,185076.00
316695,201806,60,53,7,50562.00,6678.00,57240.00
316700,201806,15,8,7,7632.00,6678.00,14310.00
316710,201806,719,520,199,495842.00,189846.00,685688.00
316720,201806,4930,2509,2421,2379088.27,2304512.41,4683600.68
316730,201806,15,14,1,13356.00,954,14310.00
316740,201806,127,80,47,76320.00,44838.00,121158.00
316750,201806,21,14,7,13356.00,6678.00,20034.00
316760,201806,327,263,64,250902.00,61056.00,311958.00
316770,201806,143,80,63,76320.00,60102.00,136422.00
316780,201806,75,45,30,42624.72,28620.00,71244.72
316790,201806,56,43,13,41022.00,12402.00,53424.00
316800,201806,1799,1105,694,1053120.80,660646.20,1713767.00
316805,201806,18,10,8,9540.00,7632.00,17172.00
316810,201806,67,44,23,41976.00,21942.00,63918.00
316820,201806,41,20,21,19080.00,20034.00,39114.00
316830,201806,93,41,52,39114.00,49608.00,88722.00
316840,201806,507,306,201,291638.00,190800.00,482438.00
316850,201806,339,221,118,209450.70,112572.00,322022.70
316860,201806,6051,2686,3365,2548285.45,3205713.17,5753998.62
316870,201806,1474,960,514,906589.50,484920.20,1391509.70
316880,201806,116,65,51,61723.80,48654.00,110377.80
316890,201806,254,169,85,161179.00,81090.00,242269.00
316900,201806,425,292,133,276021.28,126882.00,402903.28
316905,201806,17,9,8,8586.00,7632.00,16218.00
316910,201806,52,25,27,23850.00,25758.00,49608.00
316920,201806,136,105,31,99455.00,29574.00,129029.00
316930,201806,1933,987,946,935828.20,900285.93,1836114.13
316935,201806,870,523,347,496795.20,330084.00,826879.20
316940,201806,1111,642,469,611514.40,446844.26,1058358.66
316950,201806,184,95,89,90630.00,84906.00,175536.00
316960,201806,1114,624,490,593960.80,467164.46,1061125.26
316970,201806,639,498,141,474806.00,134514.00,609320.00
316980,201806,109,67,42,63918.00,40058.46,103976.46
316990,201806,2213,1458,755,1383540.18,717074.57,2100614.75
317000,201806,335,257,78,244892.00,74412.00,319304.00
317005,201806,248,177,71,168858.00,67734.00,236592.00
317010,201806,6314,3473,2841,3293214.06,2708406.20,6001620.26
317020,201806,16309,7203,9106,6839912.83,8671880.47,15511793.30
317030,201806,82,33,49,31482.00,46529.26,78011.26
317040,201806,3109,1941,1168,1848405.28,1111506.61,2959911.89
317043,201806,75,54,21,51516.00,20034.00,71550.00
317047,201806,36,18,18,17172.00,17168.00,34340.00
317050,201806,180,134,46,127836.00,43884.00,171720.00
317052,201806,129,98,31,93492.00,29574.00,123066.00
317057,201806,204,153,51,145962.00,48082.00,194044.00
317060,201806,57,37,20,35298.00,18793.80,54091.80
317065,201806,58,45,13,42930.00,12402.00,55332.00
317070,201806,1995,940,1055,891991.70,1005325.60,1897317.30
317075,201806,108,57,51,54378.00,48654.00,103032.00
317080,201806,834,438,396,416754.90,377594.00,794348.90
317090,201806,635,509,126,483249.50,120204.00,603453.50
317100,201806,426,319,107,302418.00,102078.00,404496.00
317103,201806,110,96,14,91584.00,13356.00,104940.00
317107,201806,38,34,4,32436.00,3816.00,36252.00
317110,201806,105,44,61,41976.00,58194.00,100170.00
317115,201806,41,35,6,33390.00,5724.00,39114.00
317120,201806,1847,943,904,891718.62,861959.00,1753677.62
317130,201806,1949,1252,697,1189647.00,664271.00,1853918.00
317140,201806,10,7,3,6678.00,2862.00,9540.00
317150,201806,271,160,111,152354.00,105130.80,257484.80
317160,201806,310,224,86,213379.00,81758.00,295137.00
317170,201806,209,143,66,136422.00,62964.00,199386.00
317180,201806,435,313,122,297886.50,116388.00,414274.50
317190,201806,253,170,83,162180.00,78895.80,241075.80
317200,201806,816,574,242,535204.00,230630.00,765834.00
317210,201806,155,88,67,82998.20,63918.00,146916.20
317220,201806,19,13,6,12402.00,5724.00,18126.00
320010,201806,620,462,158,437410.50,150732.00,588142.50
320013,201806,133,98,35,93492.00,33390.00,126882.00
320016,201806,283,180,103,171720.00,98262.00,269982.00
320020,201806,722,432,290,409578.75,274752.32,684331.07
320030,201806,152,112,40,106848.00,37826.10,144674.10
320035,201806,137,101,36,96354.00,34344.00,130698.00
320040,201806,503,258,245,245273.80,233444.00,478717.80
320050,201806,119,89,30,84906.00,28620.00,113526.00
320060,201806,1578,747,831,712591.00,792097.60,1504688.60
320070,201806,105,70,35,66780.00,33390.00,100170.00
320080,201806,762,436,326,413113.00,311004.00,724117.00
320090,201806,1216,843,373,800868.86,354983.60,1155852.46
320100,201806,324,186,138,177444.00,131652.00,309096.00
320110,201806,136,87,49,81138.20,46460.00,127598.20
320115,201806,113,91,22,86814.00,20988.00,107802.00
320120,201806,3313,1842,1471,1746014.40,1400476.87,3146491.27
320130,201806,7460,3539,3921,3355493.66,3733843.85,7089337.51
320140,201806,418,271,147,257199.20,139994.00,397193.20
320150,201806,1925,1119,806,1059737.61,768628.26,1828365.87
320160,201806,683,310,373,293537.03,354576.05,648113.08
320170,201806,119,94,25,88913.00,23850.00,112763.00
320180,201806,52,30,22,28620.00,20988.00,49608.00
320190,201806,236,155,81,147097.26,76988.00,224085.26
320200,201806,57,45,12,42930.00,11448.00,54378.00
320210,201806,848,475,373,451624.60,354870.00,806494.60
320220,201806,306,114,192,108756.00,182882.00,291638.00
320225,201806,77,63,14,60102.00,13356.00,73458.00
320230,201806,564,366,198,347638.40,188082.00,535720.40
320240,201806,3148,1573,1575,1498162.80,1499883.78,2998046.58
320245,201806,458,314,144,298411.40,137376.00,435787.40
320250,201806,231,123,108,116388.60,103032.00,219420.60
320255,201806,145,114,31,107449.02,29431.00,136880.02
320260,201806,178,125,53,119250.00,50514.30,169764.30
320265,201806,160,127,33,120348.00,31482.00,151830.00
320270,201806,150,123,27,117342.00,25758.00,143100.00
320280,201806,969,577,392,545498.20,373682.00,919180.20
320290,201806,67,57,10,54378.00,9540.00,63918.00
320300,201806,541,385,156,364543.80,147775.10,512318.90
320305,201806,675,368,307,351072.00,292688.00,643760.00
320310,201806,215,120,95,112525.50,89874.00,202399.50
320313,201806,306,157,149,149778.00,141860.00,291638.00
320316,201806,107,88,19,83952.00,18126.00,102078.00
320320,201806,3342,1519,1823,1444062.00,1736161.80,3180223.80
320330,201806,256,189,67,179643.30,62010.80,241654.10
320332,201806,889,537,352,510441.60,334759.30,845200.90
320334,201806,239,144,95,137090.00,90630.00,227720.00
320335,201806,146,105,41,99216.40,39114.00,138330.40
320340,201806,587,405,182,385226.00,172961.00,558187.00
320350,201806,967,415,552,393431.67,525196.48,918628.15
320360,201806,169,92,77,87482.00,73458.00,160940.00
320370,201806,243,188,55,177660.00,51437.00,229097.00
320380,201806,285,195,90,184361.30,85860.00,270221.30
320390,201806,1134,689,445,654788.80,423910.13,1078698.93
320400,201806,317,228,89,216559.00,84906.00,301465.00
320405,201806,905,387,518,368621.60,493859.92,862481.52
320410,201806,985,503,482,478193.40,459457.34,937650.74
320420,201806,482,247,235,235161.40,224190.00,459351.40
320425,201806,192,104,88,99216.00,83952.00,183168.00
320430,201806,392,223,169,211120.70,161226.00,372346.70
320435,201806,170,114,56,107935.56,53424.00,161359.56
320440,201806,203,123,80,117055.80,76320.00,193375.80
320450,201806,130,77,53,73458.00,50562.00,124020.00
320455,201806,250,205,45,194617.00,42930.00,237547.00
320460,201806,235,149,86,142146.00,82044.00,224190.00
320465,201806,114,77,37,73095.48,35298.00,108393.48
320470,201806,639,407,232,387974.26,221324.00,609298.26
320480,201806,179,120,59,113669.10,56286.00,169955.10
320490,201806,3035,1518,1517,1445263.18,1443777.64,2889040.82
320495,201806,95,58,37,55313.00,35298.00,90611.00
320500,201806,9512,4787,4725,4538542.43,4495527.59,9034070.02
320501,201806,550,279,271,266166.00,258534.00,524700.00
320503,201806,288,204,84,193662.20,80136.00,273798.20
320506,201806,258,193,65,184122.00,62010.00,246132.00
320510,201806,960,451,509,426392.30,484060.10,910452.40
320515,201806,81,68,13,63918.90,12402.00,76320.90
320517,201806,207,147,60,140238.00,57240.00,197478.00
320520,201806,6918,3083,3835,2926821.69,3651027.42,6577849.11
320530,201806,5316,2659,2657,2528906.22,2531533.00,5060439.22
330010,201806,3138,1617,1521,1535244.16,1447473.17,2982717.33
330015,201806,159,66,93,61820.08,88722.00,150542.08
330020,201806,3643,1597,2046,1520944.56,1951312.00,3472256.56
330022,201806,231,130,101,123305.00,95400.80,218705.80
330023,201806,540,186,354,176394.80,337716.00,514110.80
330025,201806,578,120,458,114480.00,436359.80,550839.80
330030,201806,1943,1248,695,1182251.18,659761.68,1842012.86
330040,201806,2387,1229,1158,1169515.90,1102589.30,2272105.20
330045,201806,8338,2653,5685,2522834.82,5417205.34,7940040.16
330050,201806,825,526,299,501804.00,285246.00,787050.00
330060,201806,921,569,352,538535.10,334491.48,873026.58
330070,201806,3461,1318,2143,1250469.99,2043107.56,3293577.55
330080,201806,1497,703,794,666353.30,755950.40,1422303.70
330090,201806,358,213,145,203202.00,138330.00,341532.00
330093,201806,281,126,155,120204.00,147834.00,268038.00
330095,201806,102,54,48,50848.20,45792.00,96640.20
330100,201806,9475,4869,4606,4633998.80,4390832.90,9024831.70
330110,201806,485,215,270,202725.10,257580.00,460305.10
330115,201806,534,307,227,292878.00,216558.00,509436.00
330120,201806,375,194,181,183931.20,171720.40,355651.60
330130,201806,1546,424,1122,403770.96,1070370.00,1474140.96
330140,201806,596,314,282,299529.00,268075.00,567604.00
330150,201806,446,261,185,247086.00,175536.00,422622.00
330160,201806,210,130,80,124020.00,76320.00,200340.00
330170,201806,27020,9514,17506,9053987.94,16686721.81,25740709.75
330180,201806,235,149,86,139599.02,81328.50,220927.52
330185,201806,826,331,495,314238.60,470962.80,785201.40
330187,201806,306,95,211,90630.00,201294.00,291924.00
330190,201806,5585,2253,3332,2138283.30,3175718.68,5314001.98
330200,201806,4523,1513,3010,1437489.06,2866477.76,4303966.82
330205,201806,402,243,159,231392.70,151400.00,382792.70
330210,201806,1006,617,389,581688.02,369436.90,951124.92
330220,201806,2569,1536,1033,1461013.50,984528.20,2445541.70
330225,201806,566,303,263,288423.00,250234.20,538657.20
330227,201806,2425,771,1654,732376.46,1577560.23,2309936.69
330230,201806,203,122,81,115721.00,77274.00,192995.00
330240,201806,3679,1939,1740,1845162.28,1657023.44,3502185.72
330245,201806,155,67,88,63918.00,83188.80,147106.80
330250,201806,6526,3395,3131,3227197.60,2978307.32,6205504.92
330260,201806,565,163,402,155502.00,383508.00,539010.00
330270,201806,3410,1253,2157,1194505.00,2057207.20,3251712.20
330280,201806,452,289,163,273914.08,155493.00,429407.08
330285,201806,7098,2331,4767,2218417.20,4545132.32,6763549.52
330290,201806,564,216,348,206064.00,331992.00,538056.00
330300,201806,785,521,264,493218.70,251838.00,745056.70
330310,201806,421,241,180,228006.70,171720.00,399726.70
330320,201806,8273,3130,5143,2978058.10,4899769.24,7877827.34
330330,201806,9219,3633,5586,3457546.91,5325426.56,8782973.47
330340,201806,2652,1578,1074,1503376.83,1024576.92,2527953.75
330350,201806,18020,7108,10912,6752105.29,10389923.71,17142029.00
330360,201806,2501,1247,1254,1188665.20,1196307.00,2384972.20
330370,201806,1015,557,458,530424.00,434929.60,965353.60
330380,201806,852,363,489,345576.96,465409.80,810986.76
330385,201806,609,317,292,301465.00,278568.00,580033.00
330390,201806,5188,2876,2312,2728888.55,2202800.40,4931688.95
330395,201806,281,174,107,164279.10,100313.20,264592.30
330400,201806,699,366,333,345730.60,315211.08,660941.68
330410,201806,498,355,143,337002.00,135932.33,472934.33
330411,201806,231,131,100,124793.00,95352.30,220145.30
330412,201806,255,104,151,98930.00,144054.00,242984.00
330414,201806,6078,2484,3594,2365740.58,3426225.30,5791965.88
330415,201806,591,275,316,261396.00,300510.80,561906.80
330420,201806,2269,1190,1079,1131035.80,1026973.00,2158008.80
330430,201806,1793,838,955,797258.80,909067.80,1706326.60
330440,201806,268,123,145,117342.00,138330.00,255672.00
330450,201806,121,51,70,48654.00,66780.00,115434.00
330452,201806,1753,836,917,796077.80,874495.76,1670573.56
330455,201806,110862,39789,71073,37879383.68,67740212.52,105619596.20
330460,201806,261,106,155,101124.00,147870.00,248994.00
330470,201806,1232,670,562,632886.98,536138.46,1169025.44
330475,201806,1401,375,1026,356796.80,978231.60,1335028.40
330480,201806,761,404,357,384748.20,339625.00,724373.20
330490,201806,13724,4800,8924,4572585.23,8507310.16,13079895.39
330500,201806,1339,612,727,583704.90,693177.00,1276881.90
330510,201806,11254,3811,7443,3627215.12,7093931.34,10721146.46
330513,201806,105,52,53,49608.00,50562.00,100170.00
330515,201806,852,350,502,330829.00,478527.00,809356.00
330520,201806,2566,954,1612,909897.00,1537695.90,2447592.90
330530,201806,223,118,105,112334.00,99980.00,212314.00
330540,201806,349,175,174,166950.00,165519.00,332469.00
330550,201806,3045,1080,1965,1028126.20,1872320.80,2900447.00
330555,201806,763,288,475,274733.00,452196.80,726929.80
330560,201806,572,209,363,199386.00,346284.00,545670.00
330570,201806,254,177,77,168858.00,73458.00,242316.00
330575,201806,802,340,462,324122.00,438693.50,762815.50
330580,201806,3382,1899,1483,1805744.00,1413303.70,3219047.70
330590,201806,310,151,159,144054.00,151686.00,295740.00
330600,201806,1106,712,394,677111.24,374178.84,1051290.08
330610,201806,1533,840,693,794493.74,656973.90,1451467.64
330615,201806,191,142,49,135468.00,46746.00,182214.00
330620,201806,1068,437,631,414228.50,600543.80,1014772.30
330630,201806,3931,2504,1427,2373991.05,1354110.80,3728101.85
350010,201806,597,391,206,371154.67,196524.00,567678.67
350020,201806,39,19,20,18126.00,19080.00,37206.00
350030,201806,525,337,188,320354.00,178162.66,498516.66
350040,201806,127,51,76,48310.56,72504.00,120814.56
350050,201806,287,156,131,148824.00,124717.46,273541.46
350055,201806,87,50,37,47700.00,35298.00,82998.00
350060,201806,75,27,48,25758.00,45792.00,71550.00
350070,201806,812,472,340,444840.58,322693.56,767534.14
350075,201806,64,43,21,41022.00,20034.00,61056.00
350080,201806,53,33,20,30845.96,17839.80,48685.76
350090,201806,96,54,42,51516.00,40063.23,91579.23
350100,201806,292,184,108,174820.50,103032.00,277852.50
350110,201806,57,35,22,33390.00,20988.00,54378.00
350115,201806,160,98,62,92824.20,59148.00,151972.20
350120,201806,110,74,36,70596.00,34344.00,104940.00
350130,201806,354,173,181,164472.00,172674.00,337146.00
350140,201806,34,20,14,18317.00,13356.00,31673.00
350150,201806,70,54,16,51516.00,15264.00,66780.00
350160,201806,2559,992,1567,943299.16,1493845.91,2437145.07
350170,201806,412,249,163,235638.20,155216.00,390854.20
350180,201806,183,98,85,93492.00,81090.00,174582.00
350190,201806,991,517,474,491216.64,451895.49,943112.13
350200,201806,67,25,42,23850.00,39803.08,63653.08
350210,201806,1360,768,592,725639.13,564250.66,1289889.79
350220,201806,673,579,94,548228.73,89676.00,637904.73
350230,201806,84,60,24,57240.00,22896.00,80136.00
350240,201806,60,45,15,42930.00,14310.00,57240.00
350250,201806,1231,607,624,573737.00,594476.66,1168213.66
350260,201806,92,66,26,62964.00,24804.00,87768.00
350270,201806,827,538,289,512174.58,274256.92,786431.50
350275,201806,302,118,184,112191.00,175536.00,287727.00
350280,201806,4756,2438,2318,2312747.06,2208544.88,4521291.94
350290,201806,409,195,214,186025.23,203583.80,389609.03
350300,201806,49,24,25,22896.00,23850.00,46746.00
350310,201806,100,69,31,65826.00,29574.00,95400.00
350315,201806,39,24,15,22896.00,14310.00,37206.00
350320,201806,3298,1637,1661,1556337.70,1583813.26,3140150.96
350330,201806,1688,900,788,854500.92,750162.04,1604662.96
350335,201806,21,14,7,13356.00,6678.00,20034.00
350340,201806,132,62,70,59148.00,66447.00,125595.00
350350,201806,94,47,47,44838.00,44838.00,89676.00
350360,201806,127,83,44,79178.00,41976.00,121154.00
350370,201806,94,54,40,50562.96,38150.46,88713.42
350380,201806,757,324,433,308428.20,412318.80,720747.00
350390,201806,1425,576,849,548708.35,808801.40,1357509.75
350395,201806,25,20,5,19080.00,4770.00,23850.00
350400,201806,1677,893,784,842315.92,744384.16,1586700.08
350410,201806,2261,1020,1241,969990.96,1183000.03,2152990.99
350420,201806,233,142,91,134865.00,86814.00,221679.00
350430,201806,74,43,31,40450.00,29574.00,70024.00
350440,201806,147,108,39,102030.50,37206.00,139236.50
350450,201806,1603,978,625,926050.96,596155.00,1522205.96
350460,201806,333,122,211,116388.00,201007.80,317395.80
350470,201806,15,10,5,9540.00,4770.00,14310.00
350480,201806,164,88,76,83952.00,72504.00,156456.00
350490,201806,240,119,121,112572.80,115434.00,228006.80
350500,201806,38,19,19,18126.00,18126.00,36252.00
350510,201806,166,111,55,105894.00,52470.00,158364.00
350520,201806,454,215,239,201929.96,227369.96,429299.92
350530,201806,455,216,239,206064.00,228006.00,434070.00
350535,201806,69,54,15,51258.42,14310.00,65568.42
350540,201806,368,189,179,180306.00,170480.00,350786.00
350550,201806,2764,1638,1126,1555358.58,1073000.67,2628359.25
350560,201806,649,450,199,429295.23,189488.25,618783.48
350570,201806,4156,1736,2420,1650006.18,2306173.20,3956179.38
350580,201806,377,182,195,172675.00,186016.46,358691.46
350590,201806,894,489,405,465934.00,385416.00,851350.00
350600,201806,6225,3127,3098,2967240.08,2950460.38,5917700.46
350610,201806,1553,788,765,746186.36,729801.00,1475987.36
350620,201806,36,24,12,22896.00,11448.00,34344.00
350630,201806,241,136,105,128790.96,99217.00,228007.96
350635,201806,893,359,534,342200.00,508864.00,851064.00
350640,201806,118,86,32,82044.00,30528.00,112572.00
350650,201806,1890,1239,651,1177266.31,619609.53,1796875.84
350660,201806,751,339,412,322762.05,392090.00,714852.05
350670,201806,316,162,154,154310.00,146916.00,301226.00
350680,201806,176,94,82,89676.00,78228.00,167904.00
350690,201806,200,102,98,97308.00,93492.00,190800.00
350700,201806,718,345,373,326431.98,355842.00,682273.98
350710,201806,341,136,205,128535.56,195570.00,324105.56
350715,201806,52,44,8,41976.00,7632.00,49608.00
350720,201806,17,11,6,10494.00,5724.00,16218.00
350730,201806,42,27,15,25758.00,14310.00,40068.00
350740,201806,214,119,95,113230.26,90630.00,203860.26
350745,201806,19,9,10,8562.00,9540.00,18102.00
350750,201806,2153,1383,770,1311094.74,733943.96,2045038.70
350760,201806,3745,1627,2118,1549821.86,2016492.62,3566314.48
350770,201806,61,41,20,39114.00,19080.00,58194.00
350775,201806,49,36,13,34344.00,12393.00,46737.00
350780,201806,427,214,213,204156.00,203202.00,407358.00
350790,201806,362,155,207,147870.00,197478.00,345348.00
350800,201806,440,248,192,236592.00,183168.00,419760.00
350810,201806,519,419,100,398773.00,95400.00,494173.00
350820,201806,85,51,34,48654.00,32436.00,81090.00
350830,201806,80,45,35,42930.00,33390.00,76320.00
350840,201806,761,332,429,316489.50,407739.80,724229.30
350850,201806,1794,1038,756,985007.84,721183.46,1706191.30
350860,201806,600,352,248,331975.80,236592.00,568567.80
350870,201806,439,299,140,285246.00,133273.80,418519.80
350880,201806,283,152,131,142386.60,124306.20,266692.80
350890,201806,41,26,15,24804.00,14310.00,39114.00
350900,201806,1465,474,991,450729.93,944650.80,1395380.73
350910,201806,27,17,10,16218.00,9540.00,25758.00
350920,201806,606,336,270,320226.04,257580.00,577806.04
350925,201806,1196,639,557,606564.34,529661.40,1136225.74
350930,201806,98,58,40,55332.00,38160.00,93492.00
350940,201806,728,409,319,388919.34,302485.60,691404.94
350945,201806,104,77,27,72922.00,25758.00,98680.00
350950,201806,15548,7453,8095,7082413.23,7713908.29,14796321.52
350960,201806,1276,593,683,561803.96,651578.00,1213381.96
350970,201806,1116,596,520,565375.64,495784.46,1061160.10
350980,201806,94,64,30,61056.00,28620.00,89676.00
350990,201806,360,127,233,120204.72,222282.00,342486.72
350995,201806,32,17,15,16218.00,14310.00,30528.00
351000,201806,636,448,188,425168.07,179352.00,604520.07
351010,201806,46,27,19,25758.00,18126.00,43884.00
351015,201806,53,37,16,35298.00,15264.00,50562.00
351020,201806,1647,957,690,911554.45,656066.00,1567620.45
351030,201806,332,232,100,218752.20,95400.00,314152.20
351040,201806,853,453,400,432162.00,380646.66,812808.66
351050,201806,3307,1552,1755,1472323.01,1673608.30,3145931.31
351060,201806,5073,2073,3000,1965879.80,2858965.89,4824845.69
351070,201806,412,265,147,250505.92,140238.00,390743.92
351080,201806,811,586,225,559044.00,213696.00,772740.00
351090,201806,63,27,36,25758.00,34344.00,60102.00
351100,201806,456,265,191,250588.48,182209.23,432797.71
351110,201806,2113,1010,1103,958792.88,1049625.66,2008418.54
351120,201806,72,36,36,34344.00,34344.00,68688.00
351130,201806,175,60,115,57240.00,109423.80,166663.80
351140,201806,342,240,102,227719.84,97308.00,325027.84
351150,201806,404,207,197,196572.80,187938.00,384510.80
351160,201806,246,163,83,155502.00,79182.00,234684.00
351170,201806,190,101,89,96354.00,84143.00,180497.00
351190,201806,91,61,30,58194.00,28620.00,86814.00
351200,201806,374,247,127,235034.04,121158.00,356192.04
351210,201806,128,61,67,57939.38,63918.00,121857.38
351220,201806,531,320,211,301707.12,201294.00,503001.12
351230,201806,285,209,76,199386.00,72484.92,271870.92
351240,201806,230,98,132,93492.00,125928.00,219420.00
351250,201806,72,50,22,47476.00,20988.00,68464.00
351260,201806,153,111,42,105894.00,39782.00,145676.00
351270,201806,51,21,30,20034.00,28620.00,48654.00
351280,201806,1115,502,613,476048.46,583970.38,1060018.84
351290,201806,229,103,126,98262.00,119918.00,218180.00
351300,201806,3734,1737,1997,1650138.35,1904817.00,3554955.35
351310,201806,764,396,368,377784.00,350786.00,728570.00
351320,201806,109,67,42,63918.00,40068.00,103986.00
351330,201806,40,27,13,25758.00,12402.00,38160.00
351340,201806,1249,779,470,736896.93,447586.23,1184483.16
351350,201806,2519,1370,1149,1304453.20,1095568.83,2400022.03
351360,201806,790,391,399,372060.00,380328.04,752388.04
351370,201806,373,190,183,181255.23,173945.96,355201.19
351380,201806,8953,4093,4860,3889037.03,4626181.78,8515218.81
351385,201806,30,20,10,19080.00,9540.00,28620.00
351390,201806,286,212,74,201294.02,70596.00,271890.02
351400,201806,66,41,25,39114.00,23812.92,62926.92
351410,201806,449,277,172,262987.04,164088.00,427075.04
351420,201806,60,49,11,46746.00,10494.00,57240.00
351430,201806,70,38,32,36252.00,30528.00,66780.00
351440,201806,791,550,241,522218.76,229910.00,752128.76
351450,201806,257,128,129,122112.00,123066.00,245178.00
351460,201806,118,54,64,51516.00,61056.00,112572.00
351470,201806,137,72,65,67447.80,62010.00,129457.80
351480,201806,524,298,226,283052.96,215484.75,498537.71
351490,201806,288,107,181,102078.00,172674.00,274752.00
351492,201806,31,22,9,20988.00,8586.00,29574.00
351495,201806,28,19,9,18126.00,8586.00,26712.00
351500,201806,3542,1538,2004,1461604.39,1907190.41,3368794.80
351510,201806,1789,747,1042,712352.00,991864.26,1704216.26
351512,201806,21,18,3,17172.00,2862.00,20034.00
351515,201806,194,111,83,105894.00,79182.00,185076.00
351518,201806,778,479,299,456008.00,285246.00,741254.00
351519,201806,75,47,28,44838.00,26712.00,71550.00
351520,201806,142,87,55,82361.96,52470.00,134831.96
351530,201806,23,15,8,14310.00,7632.00,21942.00
351535,201806,135,77,58,73458.00,55332.00,128790.00
351540,201806,455,328,127,310529.00,121158.00,431687.00
351550,201806,1327,808,519,765777.92,493208.86,1258986.78
351560,201806,73,39,34,37206.00,32436.00,69642.00
351565,201806,11,7,4,6678.00,3816.00,10494.00
351570,201806,2558,1323,1235,1259818.35,1177519.65,2437338.00
351580,201806,39,35,4,33390.00,3816.00,37206.00
351590,201806,68,46,22,43884.00,20988.00,64872.00
351600,201806,193,146,47,139284.00,44838.00,184122.00
351610,201806,58,30,28,28620.00,26712.00,55332.00
351620,201806,5923,3395,2528,3228423.69,2409531.27,5637954.96
351630,201806,2554,1319,1235,1253174.11,1175705.23,2428879.34
351640,201806,1684,824,860,784211.38,817197.10,1601408.48
351650,201806,31,26,5,24804.00,4770.00,29574.00
351660,201806,158,102,56,96354.00,53424.00,149778.00
351670,201806,734,456,278,432688.00,265212.00,697900.00
351680,201806,71,58,13,55332.00,12402.00,67734.00
351685,201806,38,25,13,23850.00,12402.00,36252.00
351690,201806,312,221,91,208969.63,86814.00,295783.63
351700,201806,157,108,49,103032.00,46746.00,149778.00
351710,201806,76,53,23,50562.00,21942.00,72504.00
351720,201806,131,61,70,58194.00,66780.00,124974.00
351730,201806,101,72,29,67734.96,27661.23,95396.19
351740,201806,718,484,234,459485.37,223231.23,682716.60
351750,201806,366,155,211,147234.00,201294.00,348528.00
351760,201806,787,612,175,584087.00,166950.00,751037.00
351770,201806,294,249,45,237546.00,42930.00,280476.00
351780,201806,173,100,73,95391.00,69642.00,165033.00
351790,201806,236,122,114,116388.00,108756.00,225144.00
351800,201806,52,33,19,31482.00,18126.00,49608.00
351810,201806,127,85,42,81090.00,40068.00,121158.00
351820,201806,880,632,248,597206.60,236301.23,833507.83
351830,201806,515,184,331,174772.80,315774.00,490546.80
351840,201806,1880,951,929,898310.00,884764.94,1783074.94
351850,201806,232,171,61,162514.80,58194.00,220708.80
351860,201806,754,505,249,476048.84,237255.23,713304.07
351870,201806,5636,2652,2984,2517889.04,2839723.19,5357612.23
351880,201806,18890,8265,10625,7863780.37,10120801.16,17984581.53
351885,201806,89,60,29,56525.00,27666.00,84191.00
351890,201806,71,60,11,57240.00,10494.00,67734.00
351900,201806,227,134,93,127169.00,88722.00,215891.00
351905,201806,78,34,44,32436.00,41976.00,74412.00
351907,201806,3162,1380,1782,1313651.06,1697949.80,3011600.86
351910,201806,183,76,107,72504.00,102078.00,174582.00
351920,201806,132,74,58,70596.00,55309.69,125905.69
351925,201806,87,60,27,57240.00,25758.00,82998.00
351930,201806,380,257,123,245082.60,117342.00,362424.60
351940,201806,237,105,132,100170.00,125928.00,226098.00
351950,201806,141,82,59,78228.00,56286.00,134514.00
351960,201806,867,404,463,385234.73,439546.36,824781.09
351970,201806,1919,1031,888,981427.84,846571.00,1827998.84
351980,201806,149,75,74,69642.00,70596.00,140238.00
351990,201806,275,185,90,175536.00,85058.64,260594.64
352000,201806,363,223,140,212742.00,133560.00,346302.00
352010,201806,355,213,142,203202.00,135468.00,338670.00
352020,201806,202,68,134,64872.00,127836.00,192708.00
352030,201806,1033,529,504,503950.50,479225.96,983176.46
352040,201806,583,253,330,241362.00,314820.00,556182.00
352042,201806,282,97,185,92538.00,176303.00,268841.00
352044,201806,393,232,161,220173.86,153594.00,373767.86
352050,201806,3261,1311,1950,1242724.88,1858764.26,3101489.14
352060,201806,105,65,40,62010.00,37874.00,99884.00
352070,201806,105,76,29,71234.00,27666.00,98900.00
352080,201806,67,42,25,39114.00,23850.00,62964.00
352090,201806,172,116,56,110664.00,53424.00,164088.00
352100,201806,260,128,132,121822.00,124776.00,246598.00
352110,201806,111,31,80,29574.00,76320.00,105894.00
352115,201806,69,25,44,23850.00,41976.00,65826.00
352120,201806,97,65,32,60770.00,30528.00,91298.00
352130,201806,219,182,37,173628.00,35298.00,208926.00
352140,201806,183,75,108,71073.00,103032.00,174105.00
352150,201806,121,67,54,62964.04,51516.00,114480.04
352160,201806,130,84,46,80136.00,43884.00,124020.00
352170,201806,372,255,117,242316.04,111618.00,353934.04
352180,201806,620,417,203,396197.50,193658.00,589855.50
352190,201806,257,99,158,94436.46,150693.84,245130.30
352200,201806,31,16,15,15264.00,14310.00,29574.00
352210,201806,3824,1588,2236,1506675.87,2126196.94,3632872.81
352215,201806,55,30,25,28620.00,23392.08,52012.08
352220,201806,6940,2720,4220,2589459.44,4023379.39,6612838.83
352230,201806,3226,2053,1173,1944303.83,1114288.45,3058592.28
352240,201806,2244,1310,934,1247546.69,888739.08,2136285.77
352250,201806,2599,1339,1260,1272654.96,1197975.96,2470630.92
352260,201806,1069,586,483,557513.23,460496.00,1018009.23
352265,201806,59,26,33,24804.00,31482.00,56286.00
352270,201806,411,235,176,223236.92,167848.00,391084.92
352280,201806,407,255,152,241999.00,145003.23,387002.23
352290,201806,178,113,65,107802.00,62010.00,169812.00
352300,201806,101,76,25,72504.00,23850.00,96354.00
352310,201806,5782,2796,2986,2654465.07,2843061.94,5497527.01
352320,201806,955,493,462,466827.84,438697.10,905524.94
352330,201806,523,243,280,231488.10,266834.00,498322.10
352340,201806,1395,678,717,644637.00,681015.30,1325652.30
352350,201806,325,204,121,194616.00,115148.00,309764.00
352360,201806,227,96,131,90677.70,122377.52,213055.22
352370,201806,100,69,31,65826.00,29574.00,95400.00
352380,201806,123,74,49,70596.00,46746.00,117342.00
352390,201806,2450,1115,1335,1060447.82,1271188.56,2331636.38
352400,201806,481,207,274,196762.50,261109.80,457872.30
352410,201806,768,548,220,519002.88,209880.00,728882.88
352420,201806,105,68,37,64872.00,35298.00,100170.00
352430,201806,1767,785,982,743837.84,933591.50,1677429.34
352440,201806,3178,1612,1566,1528164.46,1492016.71,3020181.17
352450,201806,195,163,32,155502.00,30528.00,186030.00
352460,201806,578,292,286,278010.68,272129.20,550139.88
352470,201806,614,207,407,197478.00,388269.00,585747.00
352480,201806,1380,774,606,737123.96,577551.80,1314675.76
352490,201806,83,31,52,29574.00,49608.00,79182.00
352500,201806,1206,533,673,506956.60,641557.00,1148513.60
352510,201806,745,405,340,385416.96,324360.00,709776.96
352520,201806,553,247,306,235638.00,291780.90,527418.90
352530,201806,1728,919,809,876726.00,771404.60,1648130.60
352540,201806,74,49,25,46746.00,23850.00,70596.00
352550,201806,183,104,79,99216.00,74698.20,173914.20
352560,201806,50,40,10,38160.00,9540.00,47700.00
352570,201806,673,348,325,331675.00,310030.92,641705.92
352580,201806,55,37,18,34344.65,17172.00,51516.65
352585,201806,17,5,12,4770.00,11448.00,16218.00
352590,201806,4367,2218,2149,2109567.72,2049245.41,4158813.13
352600,201806,359,246,113,233730.96,107802.00,341532.96
352610,201806,934,432,502,409867.33,478908.00,888775.33
352620,201806,955,391,564,372060.20,538056.00,910116.20
352630,201806,169,66,103,62964.00,98252.46,161216.46
352640,201806,563,391,172,370716.02,164088.00,534804.02
352650,201806,89,59,30,56286.00,28620.00,84906.00
352660,201806,80,47,33,44838.00,31482.00,76320.00
352670,201806,1677,912,765,867517.89,728447.57,1595965.46
352680,201806,897,578,319,547894.36,302864.04,850758.40
352690,201806,4398,2022,2376,1920273.88,2263124.69,4183398.57
352700,201806,107,63,44,59815.80,41976.00,101791.80
352710,201806,1369,731,638,695179.80,605023.60,1300203.40
352720,201806,1345,644,701,612118.20,668177.03,1280295.23
352725,201806,25,23,2,21942.00,1908.00,23850.00
352730,201806,367,184,183,174357.81,174582.00,348939.81
352740,201806,427,270,157,255625.68,149778.00,405403.68
352750,201806,22,14,8,13069.80,7632.00,20701.80
352760,201806,201,145,56,138330.00,53424.00,191754.00
352770,201806,83,65,18,62010.00,17172.00,79182.00
352780,201806,80,45,35,42930.00,33390.00,76320.00
352790,201806,30,24,6,22896.00,5724.00,28620.00
352800,201806,248,172,76,164088.00,72217.80,236305.80
352810,201806,165,110,55,102429.42,52470.00,154899.42
352820,201806,66,51,15,48228.52,14310.00,62538.52
352830,201806,93,64,29,61056.00,27666.00,88722.00
352840,201806,608,314,294,298269.20,280476.00,578745.20
352850,201806,1383,494,889,470608.20,847469.96,1318078.16
352860,201806,134,89,45,84270.00,42930.00,127200.00
352870,201806,46,30,16,28620.00,15264.00,43884.00
352880,201806,190,128,62,122092.92,59148.00,181240.92
352885,201806,29,21,8,20034.00,7632.00,27666.00
352890,201806,57,39,18,37206.00,16886.00,54092.00
352900,201806,4845,2332,2513,2205357.09,2389861.51,4595218.60
352910,201806,39,32,7,30528.00,6678.00,37206.00
352920,201806,705,433,272,412128.00,259488.00,671616.00
352930,201806,1262,611,651,581461.82,618056.10,1199517.92
352940,201806,6390,2754,3636,2616853.36,3465010.44,6081863.80
352950,201806,93,38,55,36252.00,52470.00,88722.00
352960,201806,64,41,23,39114.00,21942.00,61056.00
352965,201806,19,8,11,7632.00,10494.00,18126.00
352970,201806,472,352,120,332600.97,113527.00,446127.97
352980,201806,177,96,81,91584.00,76988.00,168572.00
352990,201806,955,418,537,397769.27,511210.09,908979.36
353000,201806,68,32,36,30528.00,34344.00,64872.00
353010,201806,550,339,211,323406.00,201274.92,524680.92
353020,201806,285,208,77,198432.00,73458.00,271890.00
353030,201806,1217,552,665,525635.46,633723.66,1159359.12
353040,201806,88,54,34,51516.00,32436.00,83952.00
353050,201806,1351,861,490,814804.02,467173.80,1281977.82
353060,201806,7978,3633,4345,3450534.47,4138887.07,7589421.54
353070,201806,1656,1055,601,1000520.42,571893.56,1572413.98
353080,201806,1352,723,629,687405.55,599108.00,1286513.55
353090,201806,56,33,23,31482.00,21942.00,53424.00
353100,201806,61,50,11,47700.00,10494.00,58194.00
353110,201806,2062,623,1439,592610.88,1370837.26,1963448.14
353120,201806,82,44,38,41976.00,36252.00,78228.00
353130,201806,864,431,433,410848.02,412960.14,823808.16
353140,201806,570,223,347,212681.00,331038.00,543719.00
353150,201806,362,203,159,192708.00,151676.46,344384.46
353160,201806,102,83,19,79182.00,18126.00,97308.00
353170,201806,197,65,132,62010.00,125900.46,187910.46
353180,201806,958,442,516,419660.69,491740.00,911400.69
353190,201806,489,350,139,332844.90,132320.00,465164.90
353200,201806,196,99,97,94446.00,92538.00,186984.00
353205,201806,25,18,7,17172.00,6678.00,23850.00
353210,201806,86,51,35,48654.00,33390.00,82044.00
353215,201806,53,31,22,29574.00,20988.00,50562.00
353220,201806,85,47,38,44838.00,35298.27,80136.27
353230,201806,161,63,98,60102.00,93492.00,153594.00
353240,201806,303,166,137,158364.00,130698.00,289062.00
353250,201806,206,107,99,102078.00,94446.00,196524.00
353260,201806,462,332,130,315584.50,124010.46,439594.96
353270,201806,67,49,18,46746.00,16504.20,63250.20
353280,201806,95,49,46,46269.00,43884.00,90153.00
353282,201806,122,87,35,82998.00,33390.00,116388.00
353284,201806,25,20,5,19080.00,4770.00,23850.00
353286,201806,1,1,0,954,0,954
353290,201806,81,47,34,44838.00,32427.00,77265.00
353300,201806,401,222,179,210961.96,170766.00,381727.96
353310,201806,54,47,7,44838.00,6678.00,51516.00
353320,201806,62,38,24,36252.00,22896.00,59148.00
353325,201806,58,35,23,33381.00,21638.00,55019.00
353330,201806,67,50,17,47557.00,16218.00,63775.00
353340,201806,623,206,417,195841.89,397232.26,593074.15
353350,201806,915,430,485,409229.64,461525.00,870754.64
353360,201806,110,88,22,83634.04,20702.00,104336.04
353370,201806,121,68,53,64872.00,50562.00,115434.00
353380,201806,26,18,8,17168.00,7632.00,24800.00
353390,201806,1075,518,557,494172.00,531378.00,1025550.00
353400,201806,51,31,20,29574.00,19080.00,48654.00
353410,201806,113,71,42,67734.00,40021.00,107755.00
353420,201806,58,23,35,21942.00,33390.00,55332.00
353430,201806,563,372,191,351167.30,181927.80,533095.10
353440,201806,10280,4483,5797,4266179.28,5523515.26,9789694.54
353450,201806,56,31,25,29574.00,23850.00,53424.00
353460,201806,613,337,276,319282.83,262579.50,581862.33
353470,201806,2136,1163,973,1105549.85,925836.23,2031386.08
353475,201806,236,159,77,148996.96,73458.00,222454.96
353480,201806,189,153,36,145962.00,34344.00,180306.00
353490,201806,238,142,96,135468.00,91584.00,227052.00
353500,201806,191,111,80,104940.96,76320.00,181260.96
353510,201806,100,72,28,68669.46,26702.46,95371.92
353520,201806,205,139,66,132606.00,62964.00,195570.00
353530,201806,466,252,214,240408.00,204156.00,444564.00
353540,201806,363,239,124,227683.27,118296.00,345979.27
353550,201806,745,506,239,478910.88,228006.00,706916.88
353560,201806,635,269,366,255346.89,348564.06,603910.95
353570,201806,60,31,29,29574.00,27666.00,57240.00
353580,201806,359,278,81,264735.00,77274.00,342009.00
353590,201806,89,61,28,57876.04,26712.00,84588.04
353600,201806,270,154,116,146599.00,110028.00,256627.00
353610,201806,113,60,53,57240.00,50562.00,107802.00
353620,201806,581,313,268,296615.50,255385.80,552001.30
353625,201806,50,28,22,26712.00,20988.00,47700.00
353630,201806,237,170,67,157774.60,63918.00,221692.60
353640,201806,126,84,42,79659.00,40068.00,119727.00
353650,201806,892,347,545,328939.20,519930.00,848869.20
353657,201806,24,18,6,17172.00,5724.00,22896.00
353660,201806,254,143,111,136422.00,105711.97,242133.97
353670,201806,770,455,315,433116.20,300510.00,733626.20
353680,201806,101,72,29,68450.00,27666.00,96116.00
353690,201806,46,36,10,34070.00,9540.00,43610.00
353700,201806,280,199,81,189846.00,77274.00,267120.00
353710,201806,441,201,240,190800.80,228674.00,419474.80
353715,201806,46,34,12,32149.80,11448.00,43597.80
353720,201806,356,161,195,153576.00,186030.00,339606.00
353730,201806,1114,689,425,655350.90,405450.00,1060800.90
353740,201806,652,359,293,342199.80,279522.00,621721.80
353750,201806,89,55,34,51938.14,32436.00,84374.14
353760,201806,2773,1039,1734,988670.88,1650633.28,2639304.16
353770,201806,96,80,16,75843.00,15264.00,91107.00
353780,201806,1157,571,586,543017.96,556850.00,1099867.96
353790,201806,509,293,216,277453.50,203465.35,480918.85
353800,201806,3268,1664,1604,1579283.89,1528881.35,3108165.24
353810,201806,236,133,103,126028.71,98253.00,224281.71
353820,201806,188,92,96,87768.00,90959.41,178727.41
353830,201806,48,41,7,39114.00,6678.00,45792.00
353850,201806,168,86,82,82044.00,78228.00,160272.00
353860,201806,472,217,255,206302.50,242983.80,449286.30
353870,201806,5091,2552,2539,2416949.49,2410743.40,4827692.89
353880,201806,681,487,194,463262.40,184122.12,647384.52
353890,201806,585,328,257,312340.00,244892.00,557232.00
353900,201806,129,65,64,62010.00,61056.00,123066.00
353910,201806,177,87,90,82998.00,85860.00,168858.00
353920,201806,450,245,205,232538.40,195127.16,427665.56
353930,201806,1018,597,421,567845.79,400399.80,968245.59
353940,201806,186,100,86,94636.80,81186.00,175822.80
353950,201806,525,320,205,304993.80,195561.00,500554.80
353960,201806,69,56,13,53424.00,12402.00,65826.00
353970,201806,74,44,30,41976.00,28620.00,70596.00
353980,201806,1536,752,784,715034.95,746779.16,1461814.11
353990,201806,74,42,32,40068.00,30528.00,70596.00
354000,201806,372,183,189,173915.00,180111.20,354026.20
354010,201806,93,52,41,49608.00,38637.00,88245.00
354020,201806,540,342,198,325314.00,188892.00,514206.00
354025,201806,53,42,11,40068.00,10494.00,50562.00
354030,201806,63,35,28,33390.00,26712.00,60102.00
354040,201806,98,69,29,65444.40,27666.00,93110.40
354050,201806,192,105,87,99884.00,82998.00,182882.00
354060,201806,765,369,396,352026.00,375543.40,727569.40
354070,201806,873,510,363,485010.03,346302.00,831312.03
354075,201806,217,115,102,109710.00,96354.80,206064.80
354080,201806,291,125,166,118963.80,158364.00,277327.80
354085,201806,19,12,7,11448.00,6678.00,18126.00
354090,201806,315,174,141,165915.00,134514.00,300429.00
354100,201806,5566,2322,3244,2203639.76,3089238.25,5292878.01
354105,201806,85,42,43,40068.00,41022.00,81090.00
354110,201806,48,22,26,20988.00,24804.00,45792.00
354120,201806,147,102,45,97168.97,42930.00,140098.97
354130,201806,703,465,238,443372.00,226762.00,670134.00
354140,201806,3166,1483,1683,1411959.43,1604037.83,3015997.26
354150,201806,653,411,242,389881.04,229437.00,619318.04
354160,201806,714,452,262,430015.50,249662.00,679677.50
354165,201806,23,14,9,13356.00,8586.00,21942.00
354170,201806,177,119,58,112858.20,55332.00,168190.20
354180,201806,66,41,25,38788.00,23850.00,62638.00
354190,201806,211,98,113,91870.20,107802.00,199672.20
354200,201806,131,73,58,69165.00,55332.00,124497.00
354210,201806,68,34,34,32436.00,32436.00,64872.00
354220,201806,633,389,244,370438.20,231536.35,601974.55
354230,201806,164,68,96,64872.00,90630.60,155502.60
354240,201806,317,205,112,194616.49,106848.00,301464.49
354250,201806,94,56,38,53424.00,36252.00,89676.00
354260,201806,1967,918,1049,865411.04,997594.67,1863005.71
354270,201806,94,71,23,67734.00,21942.00,89676.00
354280,201806,39,22,17,20988.00,16218.00,37206.00
354290,201806,141,99,42,93635.10,40068.00,133703.10
354300,201806,420,285,135,271573.00,128632.00,400205.00
354310,201806,103,76,27,71550.20,25758.00,97308.20
354320,201806,180,97,83,92538.00,79182.00,171720.00
354323,201806,16,14,2,13356.00,1908.00,15264.00
354325,201806,107,62,45,58342.00,42930.00,101272.00
354330,201806,2635,877,1758,832023.26,1674966.18,2506989.44
354340,201806,10607,5183,5424,4932717.03,5167769.67,10100486.70
354350,201806,127,83,44,79182.00,41832.90,121014.90
354360,201806,88,49,39,46746.00,37206.00,83952.00
354370,201806,266,148,118,141192.00,112572.00,253764.00
354380,201806,211,126,85,119418.00,81090.00,200508.00
354390,201806,2777,1008,1769,959971.22,1686826.98,2646798.20
354400,201806,330,174,156,165329.00,148251.80,313580.80
354410,201806,621,299,322,283620.43,306234.20,589854.63
354420,201806,273,171,102,163134.00,97308.00,260442.00
354425,201806,314,182,132,173628.00,125928.00,299556.00
354430,201806,188,119,69,111951.90,65062.80,177014.70
354440,201806,40,28,12,26712.00,11448.00,38160.00
354450,201806,50,36,14,34344.00,13356.00,47700.00
354460,201806,106,61,45,58194.00,42838.00,101032.00
354470,201806,40,27,13,25758.00,12402.00,38160.00
354480,201806,118,59,59,56277.00,56276.46,112553.46
354490,201806,146,91,55,86654.97,52470.00,139124.97
354500,201806,394,195,199,186030.00,189846.00,375876.00
354510,201806,103,70,33,66780.00,31482.00,98262.00
354515,201806,39,14,25,13356.00,23850.00,37206.00
354520,201806,1643,718,925,683215.20,882011.56,1565226.76
354530,201806,676,356,320,337902.80,304136.00,642038.80
354540,201806,281,158,123,150732.00,117337.23,268069.23
354550,201806,42,25,17,23850.00,16218.00,40068.00
354560,201806,159,91,68,86528.00,64862.46,151390.46
354570,201806,136,87,49,82998.00,46746.00,129744.00
354580,201806,1977,934,1043,888459.00,994436.26,1882895.26
354600,201806,268,146,122,137030.12,116373.69,253403.81
354610,201806,71,65,6,61056.58,5724.00,66780.58
354620,201806,62,19,43,18126.00,41022.00,59148.00
354625,201806,18,11,7,10494.00,6674.00,17168.00
354630,201806,319,212,107,201873.34,102078.00,303951.34
354640,201806,806,525,281,496924.36,268074.00,764998.36
354650,201806,76,44,32,41680.80,30499.92,72180.72
354660,201806,805,595,210,563846.96,200340.00,764186.96
354670,201806,276,98,178,92300.00,168859.00,261159.00
354680,201806,1269,480,789,457920.00,752229.00,1210149.00
354690,201806,84,55,29,51517.00,27666.00,79183.00
354700,201806,77,55,22,52470.00,20988.00,73458.00
354710,201806,56,39,17,36569.96,16218.00,52787.96
354720,201806,20,19,1,18126.00,954,19080.00
354730,201806,1878,795,1083,756227.20,1032991.20,1789218.40
354740,201806,61,42,19,40068.00,18126.00,58194.00
354750,201806,433,255,178,243261.00,169812.00,413073.00
354760,201806,516,315,201,297949.00,191468.00,489417.00
354765,201806,12,5,7,4770.00,6678.00,11448.00
354770,201806,344,230,114,218596.03,107992.80,326588.83
354780,201806,8163,3328,4835,3162624.65,4608730.10,7771354.75
354790,201806,113,66,47,62964.00,44838.00,107802.00
354800,201806,436,239,197,228006.00,187632.92,415638.92
354805,201806,104,52,52,48972.00,49608.00,98580.00
354810,201806,136,78,58,74412.00,55332.00,129744.00
354820,201806,185,79,106,75157.00,101124.00,176281.00
354830,201806,42,23,19,21942.00,18126.00,40068.00
354840,201806,58,39,19,37206.00,18126.00,55332.00
354850,201806,4576,2032,2544,1930983.96,2422890.08,4353874.04
354860,201806,326,160,166,152640.00,156256.52,308896.52
354870,201806,12020,5453,6567,5174399.05,6254661.08,11429060.13
354880,201806,3028,1128,1900,1074474.46,1810480.90,2884955.36
354890,201806,2874,1591,1283,1511662.46,1222999.38,2734661.84
354900,201806,60,39,21,37206.00,20034.00,57240.00
354910,201806,1239,650,589,616532.24,561906.00,1178438.24
354920,201806,49,41,8,39114.00,7632.00,46746.00
354925,201806,13,7,6,6678.00,5724.00,12402.00
354930,201806,31,28,3,26442.00,2862.00,29304.00
354940,201806,813,596,217,565915.69,207018.00,772933.69
354950,201806,221,147,74,139571.00,70596.00,210167.00
354960,201806,164,64,100,61056.00,95114.00,156170.00
354970,201806,866,567,299,536059.10,284607.02,820666.12
354980,201806,8449,3120,5329,2969122.35,5081138.33,8050260.68
354990,201806,9198,4354,4844,4139936.65,4614711.96,8754648.61
354995,201806,519,183,336,174582.00,320229.18,494811.18
355000,201806,489,164,325,156451.23,309811.50,466262.73
355010,201806,623,393,230,374922.00,217208.48,592130.48
355020,201806,718,453,265,431203.59,252802.00,684005.59
355030,201806,205831,79813,126018,75914799.92,120122303.62,196037103.54
355040,201806,724,340,384,322309.60,366145.20,688454.80
355050,201806,155,103,52,96991.77,49608.00,146599.77
355060,201806,1549,768,781,727822.94,743882.30,1471705.24
355070,201806,1445,706,739,670654.16,704013.00,1374667.16
355080,201806,200,115,85,109710.00,80202.80,189912.80
355090,201806,298,197,101,185840.00,96354.00,282194.00
355100,201806,4858,2386,2472,2255778.40,2356076.66,4611855.06
355110,201806,269,170,99,161223.00,94446.00,255669.00
355120,201806,80,57,23,54378.00,21942.00,76320.00
355130,201806,54,30,24,28620.00,22896.00,51516.00
355140,201806,185,122,63,115672.50,60102.00,175774.50
355150,201806,684,412,272,391804.00,259011.00,650815.00
355160,201806,457,217,240,204633.96,228960.00,433593.96
355170,201806,2064,1069,995,1018842.27,947334.72,1966176.99
355180,201806,622,266,356,252810.00,338789.25,591599.25
355190,201806,222,151,71,144054.00,67734.00,211788.00
355200,201806,120,69,51,65826.00,48654.00,114480.00
355210,201806,724,412,312,393048.00,297629.46,690677.46
355220,201806,6760,3597,3163,3421051.76,3008003.80,6429055.56
355230,201806,107,63,44,60102.00,41971.23,102073.23
355240,201806,4350,1885,2465,1786037.12,2347414.87,4133451.99
355250,201806,5426,2614,2812,2487941.22,2679240.33,5167181.55
355255,201806,50,31,19,29574.00,18126.00,47700.00
355260,201806,187,113,74,106829.12,70568.46,177397.58
355270,201806,167,98,69,93492.00,65111.00,158603.00
355280,201806,6408,2679,3729,2550286.66,3552404.46,6102691.12
355290,201806,76,57,19,54378.00,18126.00,72504.00
355300,201806,185,119,66,112572.80,62964.00,175536.80
355310,201806,107,59,48,56286.00,45792.00,102078.00
355320,201806,90,47,43,44838.00,40074.60,84912.60
355330,201806,272,153,119,145962.00,113526.00,259488.00
355340,201806,1551,539,1012,511599.61,964419.97,1476019.58
355350,201806,142,72,70,68688.00,66780.00,135468.00
355360,201806,182,115,67,109500.12,63918.00,173418.12
355365,201806,25,20,5,19080.00,4770.00,23850.00
355370,201806,1054,605,449,571293.74,427078.55,998372.29
355380,201806,782,519,263,494534.52,250616.00,745150.52
355385,201806,63,44,19,41976.00,18126.00,60102.00
355390,201806,106,62,44,59148.00,41976.00,101124.00
355395,201806,186,113,73,106701.23,69642.00,176343.23
355400,201806,1552,960,592,912795.32,563241.80,1476037.12
355410,201806,4925,2332,2593,2207471.41,2464720.96,4672192.37
355420,201806,51,38,13,36252.00,12402.00,48654.00
355430,201806,348,210,138,199004.40,131652.00,330656.40
355440,201806,85,51,34,48654.00,32436.00,81090.00
355450,201806,460,225,235,211931.94,222854.60,434786.54
355460,201806,70,54,16,50562.42,15264.00,65826.42
355465,201806,52,33,19,31482.00,18126.00,49608.00
355470,201806,179,71,108,66780.10,103032.00,169812.10
355475,201806,13,8,5,7632.00,4770.00,12402.00
355480,201806,468,210,258,198442.34,245464.20,443906.54
355490,201806,115,81,34,77274.00,32436.00,109710.00
355495,201806,54,27,27,25758.00,25758.00,51516.00
355500,201806,1650,927,723,878778.66,689707.46,1568486.12
355510,201806,271,198,73,184193.63,69642.00,253835.63
355520,201806,33,26,7,24518.00,6678.00,31196.00
355530,201806,24,16,8,15264.00,7632.00,22896.00
355535,201806,78,38,40,36252.00,38160.00,74412.00
355540,201806,2376,934,1442,889577.53,1373751.96,2263329.49
355550,201806,65,39,26,37206.00,24804.00,62010.00
355560,201806,240,120,120,114480.00,113843.96,228323.96
355570,201806,31,21,10,20034.00,9540.00,29574.00
355580,201806,269,184,85,175536.00,80799.23,256335.23
355590,201806,24,15,9,14310.00,8586.00,22896.00
355600,201806,270,139,131,132606.00,124683.23,257289.23
355610,201806,216,143,73,136422.00,69642.00,206064.00
355620,201806,1274,591,683,563003.80,650900.19,1213903.99
355630,201806,415,302,113,288108.00,106848.96,394956.96
355635,201806,125,60,65,57240.00,61997.00,119237.00
355640,201806,577,333,244,316728.16,232776.00,549504.16
355645,201806,835,358,477,340053.30,453178.82,793232.12
355650,201806,2149,892,1257,846611.47,1199159.46,2045770.93
355660,201806,256,138,118,131652.00,112572.00,244224.00
355670,201806,500,199,301,189846.00,286867.80,476713.80
355680,201806,205,118,87,111619.00,82712.00,194331.00
355690,201806,86,40,46,38160.00,43540.00,81700.00
355695,201806,15,12,3,11448.00,2862.00,14310.00
355700,201806,1145,585,560,553020.60,533668.00,1086688.60
355710,201806,2198,1206,992,1146887.56,946177.20,2093064.76
355715,201806,20,18,2,17172.00,1908.00,19080.00
355720,201806,206,124,82,116706.08,78228.00,194934.08
355730,201806,93,53,40,49687.95,38160.00,87847.95
410010,201806,132,112,20,106848.00,19080.00,125928.00
410020,201806,104,92,12,87768.00,11448.00,99216.00
410030,201806,164,104,60,98548.40,57240.00,155788.40
410040,201806,976,534,442,508529.70,421478.00,930007.70
410045,201806,26,21,5,20034.00,4770.00,24804.00
410050,201806,481,267,214,254718.00,203488.20,458206.20
410060,201806,278,212,66,202248.00,62964.00,265212.00
410070,201806,311,258,53,246132.00,50562.00,296694.00
410080,201806,167,108,59,103032.00,56286.00,159318.00
410090,201806,74,66,8,62755.00,7632.00,70387.00
410100,201806,299,214,85,203841.18,80279.10,284120.28
410105,201806,46,27,19,25758.00,18126.00,43884.00
410110,201806,312,191,121,182214.00,115434.00,297648.00
410115,201806,28,19,9,18126.00,8586.00,26712.00
410120,201806,441,227,214,216271.80,204156.00,420427.80
410130,201806,45,28,17,26712.00,16218.00,42930.00
410140,201806,3107,1522,1585,1446205.00,1508369.60,2954574.60
410150,201806,2713,1091,1622,1039375.24,1546791.80,2586167.04
410160,201806,499,316,183,301177.80,174582.00,475759.80
410165,201806,65,43,22,41022.00,20988.00,62010.00
410170,201806,167,124,43,116871.00,41022.00,157893.00
410180,201806,2132,1239,893,1178017.19,850464.95,2028482.14
410185,201806,34,30,4,28620.00,3816.00,32436.00
410190,201806,446,279,167,266166.00,159318.00,425484.00
410200,201806,951,711,240,677349.54,228960.00,906309.54
410210,201806,559,292,267,278568.00,254432.00,533000.00
410220,201806,40,21,19,20034.00,18126.00,38160.00
410230,201806,130,70,60,66780.00,57240.00,124020.00
410240,201806,734,485,249,462117.80,237546.00,699663.80
410250,201806,376,278,98,264607.84,93487.23,358095.07
410260,201806,299,177,122,168572.00,116388.00,284960.00
410270,201806,30,19,11,18126.00,10494.00,28620.00
410275,201806,63,46,17,43884.00,16218.00,60102.00
410280,201806,325,188,137,179092.52,130698.00,309790.52
410290,201806,231,146,85,139284.00,81090.00,220374.00
410300,201806,80,64,16,61056.00,15264.00,76320.00
410302,201806,24,16,8,15264.00,7632.00,22896.00
410304,201806,46,32,14,30528.00,13356.00,43884.00
410305,201806,212,116,96,109996.20,91584.00,201580.20
410310,201806,264,168,96,160272.00,91564.92,251836.92
410315,201806,51,36,15,34320.00,14310.00,48630.00
410320,201806,141,98,43,93492.00,41022.00,134514.00
410322,201806,34,24,10,22896.00,9540.00,32436.00
410330,201806,168,120,48,114480.00,45602.00,160082.00
410335,201806,97,58,39,55332.00,37206.00,92538.00
410337,201806,39,34,5,32436.00,4770.00,37206.00
410340,201806,31,29,2,27666.00,1908.00,29574.00
410345,201806,220,139,81,132606.00,77274.00,209880.00
410347,201806,54,41,13,39114.00,12402.00,51516.00
410350,201806,228,137,91,130698.00,86814.00,217512.00
410360,201806,461,282,179,266484.40,170194.00,436678.40
410370,201806,2415,1037,1378,985703.32,1311832.82,2297536.14
410380,201806,218,142,76,135468.00,72504.00,207972.00
410390,201806,367,272,95,259484.00,90630.00,350114.00
410395,201806,34,22,12,20988.00,10781.00,31769.00
410400,201806,844,426,418,405075.20,397422.10,802497.30
410405,201806,93,71,22,67734.00,20988.00,88722.00
410410,201806,40,31,9,29574.00,8586.00,38160.00
410420,201806,1662,822,840,782093.89,800407.00,1582500.89
410425,201806,176,82,94,78038.00,89676.00,167714.00
410430,201806,2188,1288,900,1225604.00,857722.32,2083326.32
410440,201806,387,288,99,273799.00,94446.00,368245.00
410442,201806,356,240,116,228007.00,110664.00,338671.00
410445,201806,415,291,124,277614.00,118296.00,395910.00
410450,201806,410,209,201,199386.00,191754.00,391140.00
410460,201806,415,225,190,214354.26,181260.00,395614.26
410465,201806,187,120,67,113239.80,63918.00,177157.80
410470,201806,222,143,79,136422.00,75366.00,211788.00
410480,201806,5882,2903,2979,2752705.13,2836804.76,5589509.89
410490,201806,1398,923,475,879045.00,451243.00,1330288.00
410500,201806,268,151,117,144054.00,111618.00,255672.00
410510,201806,176,129,47,123066.00,44829.00,167895.00
410520,201806,253,190,63,181260.00,60102.00,241362.00
410530,201806,234,86,148,82044.00,141188.00,223232.00
410540,201806,315,227,88,215981.60,83947.23,299928.83
410550,201806,1614,698,916,665605.80,872664.36,1538270.16
410560,201806,144,112,32,106848.00,30528.00,137376.00
410570,201806,428,298,130,282204.20,124020.00,406224.20
410580,201806,3159,1422,1737,1354419.80,1656622.00,3011041.80
410590,201806,405,284,121,270936.00,115434.00,386370.00
410600,201806,187,160,27,152640.00,25758.00,178398.00
410610,201806,56,45,11,42930.00,10494.00,53424.00
410620,201806,241,173,68,165042.00,64872.00,229914.00
410630,201806,445,257,188,245178.00,178193.00,423371.00
410640,201806,993,617,376,584801.27,357097.28,941898.55
410645,201806,99,74,25,70215.00,23850.00,94065.00
410650,201806,365,249,116,236592.00,110664.00,347256.00
410655,201806,78,60,18,57240.00,17172.00,74412.00
410657,201806,43,18,25,17172.00,23850.00,41022.00
410660,201806,604,426,178,404875.00,169812.00,574687.00
410670,201806,76,63,13,60102.00,12402.00,72504.00
410680,201806,192,159,33,151018.20,31482.00,182500.20
410685,201806,15,10,5,9540.00,4770.00,14310.00
410690,201806,28207,12268,15939,11682335.46,15192431.42,26874766.88
410700,201806,322,235,87,223904.00,82998.00,306902.00
410710,201806,125,102,23,97308.00,21942.00,119250.00
410712,201806,23,15,8,14310.00,7632.00,21942.00
410715,201806,84,62,22,59148.00,20988.00,80136.00
410720,201806,604,361,243,344394.00,231813.00,576207.00
410725,201806,180,129,51,123066.00,48654.00,171720.00
410730,201806,86,52,34,49608.00,32436.00,82044.00
410740,201806,112,80,32,76320.00,30528.00,106848.00
410750,201806,213,158,55,150732.00,52465.23,203197.23
410752,201806,25,15,10,14310.00,9540.00,23850.00
410753,201806,53,23,30,21269.43,28620.00,49889.43
410754,201806,38,23,15,21561.00,14310.00,35871.00
410755,201806,80,55,25,52470.00,23850.00,76320.00
410760,201806,726,410,316,390829.56,301464.00,692293.56
410765,201806,1662,800,862,756482.68,821194.26,1577676.94
410770,201806,107,87,20,82998.00,19080.00,102078.00
410773,201806,48,35,13,33390.00,12402.00,45792.00
410775,201806,176,134,42,127168.20,40068.00,167236.20
410780,201806,78,42,36,40068.00,34344.00,74412.00
410785,201806,52,42,10,40068.00,9540.00,49608.00
410790,201806,72,34,38,32436.00,36252.00,68688.00
410800,201806,294,185,109,175537.00,103986.00,279523.00
410810,201806,26,22,4,20988.00,3530.00,24518.00
410820,201806,177,131,46,124831.00,43884.00,168715.00
410830,201806,8481,3857,4624,3669864.04,4408741.14,8078605.18
410832,201806,103,70,33,66780.00,31482.00,98262.00
410840,201806,1432,797,635,758070.08,604342.98,1362413.06
410845,201806,65,41,24,38828.00,22896.00,61724.00
410850,201806,191,132,59,125642.00,56286.00,181928.00
410855,201806,49,42,7,40068.00,6678.00,46746.00
410860,201806,664,387,277,368244.76,264258.00,632502.76
410865,201806,104,82,22,78228.00,20988.00,99216.00
410870,201806,160,135,25,128790.00,23850.00,152640.00
410880,201806,1128,567,561,540407.62,535130.00,1075537.62
410890,201806,77,54,23,51516.00,21942.00,73458.00
410895,201806,72,55,17,52470.00,16218.00,68688.00
410900,201806,20,12,8,11448.00,7632.00,19080.00
410910,201806,17,15,2,14310.00,1908.00,16218.00
410920,201806,33,22,11,20988.00,10494.00,31482.00
410930,201806,509,326,183,310792.98,174582.00,485374.98
410940,201806,4312,2556,1756,2428815.40,1671960.40,4100775.80
410950,201806,118,86,32,82044.00,30528.00,112572.00
410960,201806,769,344,425,327890.00,405260.00,733150.00
410965,201806,66,51,15,48367.80,14310.00,62677.80
410970,201806,624,447,177,425970.20,168858.00,594828.20
410975,201806,111,64,47,60545.00,44838.00,105383.00
410980,201806,1589,713,876,677655.82,834746.00,1512401.82
410990,201806,271,181,90,172674.00,85573.80,258247.80
411000,201806,62,39,23,37206.00,21942.00,59148.00
411005,201806,25,20,5,19080.00,4770.00,23850.00
411007,201806,243,140,103,133560.00,98262.00,231822.00
411010,201806,581,403,178,384462.00,169812.00,554274.00
411020,201806,294,203,91,193662.00,86814.00,280476.00
411030,201806,20,10,10,9540.00,9540.00,19080.00
411040,201806,50,36,14,34344.00,13356.00,47700.00
411050,201806,220,172,48,163473.72,45665.12,209138.84
411060,201806,513,345,168,329121.00,160272.00,489393.00
411065,201806,64,56,8,53424.00,7632.00,61056.00
411070,201806,1204,797,407,754478.31,387324.00,1141802.31
411080,201806,242,173,69,165042.00,65826.00,230868.00
411090,201806,115,87,28,82998.00,26712.00,109710.00
411095,201806,270,111,159,105417.00,151676.00,257093.00
411100,201806,115,96,19,91584.00,18126.00,109710.00
411110,201806,121,85,36,81090.00,34344.00,115434.00
411120,201806,184,136,48,129744.00,45792.00,175536.00
411125,201806,183,83,100,78533.28,95400.00,173933.28
411130,201806,125,106,19,100486.00,17839.80,118325.80
411140,201806,185,126,59,120182.12,55761.30,175943.42
411150,201806,1229,816,413,777786.66,394002.00,1171788.66
411155,201806,120,83,37,79182.00,35298.00,114480.00
411160,201806,20,9,11,8586.00,10494.00,19080.00
411170,201806,57,52,5,49321.80,4770.00,54091.80
411180,201806,956,630,326,599780.00,310999.23,910779.23
411190,201806,341,197,144,187270.20,137376.00,324646.20
411200,201806,673,442,231,420397.89,219230.30,639628.19
411210,201806,682,368,314,349522.21,299556.00,649078.21
411220,201806,146,109,37,103986.00,35298.00,139284.00
411230,201806,41,37,4,35298.00,3816.00,39114.00
411240,201806,123,84,39,80136.00,37206.00,117342.00
411250,201806,426,312,114,297648.00,108756.00,406404.00
411260,201806,21,14,7,13356.00,6678.00,20034.00
411270,201806,296,158,138,150732.00,131652.00,282384.00
411275,201806,203,179,24,170050.60,22896.00,192946.60
411280,201806,228,162,66,153277.12,62964.00,216241.12
411290,201806,58,43,15,41022.00,14310.00,55332.00
411295,201806,146,115,31,109710.00,29574.00,139284.00
411300,201806,70,36,34,34344.00,32436.00,66780.00
411310,201806,91,69,22,65826.00,20988.00,86814.00
411320,201806,757,548,209,520980.20,197783.28,718763.48
411325,201806,41,25,16,23850.00,15264.00,39114.00
411330,201806,919,592,327,563242.61,311227.60,874470.21
411340,201806,26,17,9,16218.00,8272.00,24490.00
411342,201806,73,54,19,51516.00,18126.00,69642.00
411345,201806,125,63,62,60102.00,59148.00,119250.00
411350,201806,491,391,100,371535.64,94437.20,465972.84
411360,201806,54,35,19,33390.00,18126.00,51516.00
411370,201806,14240,5818,8422,5528812.55,8019086.20,13547898.75
411373,201806,186,138,48,131652.00,45792.00,177444.00
411375,201806,72,60,12,57240.00,11448.00,68688.00
411380,201806,93,70,23,66780.00,21942.00,88722.00
411390,201806,135,90,45,85860.00,42930.00,128790.00
411400,201806,351,263,88,250893.00,83952.00,334845.00
411410,201806,447,232,215,220660.20,204824.00,425484.20
411420,201806,1028,474,554,449620.20,528039.20,977659.40
411430,201806,414,266,148,253096.20,141183.00,394279.20
411435,201806,36,25,11,23850.00,10494.00,34344.00
411440,201806,474,381,93,361601.34,88722.00,450323.34
411450,201806,425,354,71,337716.00,67734.00,405450.00
411460,201806,765,303,462,288165.64,439299.60,727465.24
411470,201806,86,64,22,61056.00,20988.00,82044.00
411480,201806,634,359,275,339937.40,262063.80,602001.20
411490,201806,293,182,111,173628.00,105894.00,279522.00
411500,201806,113,94,19,89472.33,17459.00,106931.33
411510,201806,217,176,41,167156.06,39114.00,206270.06
411520,201806,5917,2308,3609,2198010.80,3435982.76,5633993.56
411530,201806,112,78,34,74412.00,32436.00,106848.00
411535,201806,46,19,27,18126.00,25758.00,43884.00
411540,201806,352,245,107,232707.90,102078.00,334785.90
411545,201806,55,39,16,37206.00,15264.00,52470.00
411550,201806,73,56,17,53424.00,16218.00,69642.00
411560,201806,387,178,209,169148.38,199386.00,368534.38
411570,201806,780,299,481,284951.00,458684.00,743635.00
411573,201806,33,20,13,19080.00,12402.00,31482.00
411575,201806,265,164,101,156456.00,96354.00,252810.00
411580,201806,1251,502,749,476647.84,712698.40,1189346.24
411585,201806,81,41,40,39114.00,38160.00,77274.00
411590,201806,25,18,7,17172.00,6678.00,23850.00
411600,201806,28,12,16,11448.00,15264.00,26712.00
411605,201806,251,109,142,103820.00,135468.00,239288.00
411610,201806,235,161,74,153594.00,70596.00,224190.00
411620,201806,361,204,157,194139.00,149139.00,343278.00
411630,201806,58,39,19,37206.00,18126.00,55332.00
411640,201806,34,28,6,26712.00,5724.00,32436.00
411650,201806,12,8,4,7632.00,3816.00,11448.00
411660,201806,32,25,7,23850.00,6678.00,30528.00
411670,201806,245,186,59,177444.00,56286.00,233730.00
411680,201806,155,133,22,126882.00,20988.00,147870.00
411690,201806,600,317,283,301840.44,269636.32,571476.76
411695,201806,62,46,16,43884.00,15264.00,59148.00
411700,201806,163,141,22,134514.00,20988.00,155502.00
411705,201806,101,66,35,62964.00,33390.00,96354.00
411710,201806,302,203,99,192595.81,94446.00,287041.81
411720,201806,139,90,49,85860.00,46746.00,132606.00
411721,201806,64,53,11,50562.00,10494.00,61056.00
411722,201806,98,42,56,40068.00,53424.00,93492.00
411725,201806,151,118,33,111999.80,31482.00,143481.80
411727,201806,73,57,16,54378.00,14977.80,69355.80
411729,201806,33,26,7,24804.00,6678.00,31482.00
411730,201806,542,352,190,334217.96,180973.80,515191.76
411740,201806,37,23,14,21942.00,13356.00,35298.00
411745,201806,69,46,23,43093.00,21942.00,65035.00
411750,201806,865,414,451,393859.90,429285.69,823145.59
411760,201806,1191,896,295,853535.20,281421.00,1134956.20
411770,201806,447,299,148,285226.92,141192.00,426418.92
411780,201806,372,241,131,229914.00,124974.00,354888.00
411790,201806,533,300,233,284318.47,221978.34,506296.81
411800,201806,169,133,36,126882.00,34344.00,161226.00
411810,201806,164,126,38,120204.00,36252.00,156456.00
411820,201806,2087,1020,1067,970485.42,1017194.30,1987679.72
411830,201806,12,12,0,11448.00,0,11448.00
411840,201806,1955,1214,741,1155961.80,706421.00,1862382.80
411845,201806,50,19,31,18126.00,29574.00,47700.00
411850,201806,1232,705,527,671002.40,500805.02,1171807.42
411860,201806,43,28,15,26426.00,14310.00,40736.00
411870,201806,74,54,20,51516.00,18793.80,70309.80
411880,201806,427,273,154,260328.00,146171.88,406499.88
411885,201806,104,69,35,65826.00,33390.00,99216.00
411890,201806,322,205,117,193173.99,111608.46,304782.45
411900,201806,69,51,18,48654.00,17172.00,65826.00
411910,201806,177,141,36,134504.46,33504.48,168008.94
411915,201806,2112,912,1200,868895.57,1143498.05,2012393.62
411920,201806,125,104,21,99216.00,20034.00,119250.00
411925,201806,14,9,5,8586.00,4770.00,13356.00
411930,201806,801,588,213,559046.00,203202.00,762248.00
411940,201806,590,418,172,398295.00,164063.56,562358.56
411950,201806,900,479,421,456298.20,400966.20,857264.40
411960,201806,979,690,289,655405.69,275706.00,931111.69
411965,201806,25,17,8,16218.00,7632.00,23850.00
411970,201806,72,64,8,61056.00,7632.00,68688.00
411980,201806,198,127,71,120871.80,67734.00,188605.80
411990,201806,5024,2915,2109,2763772.43,2010265.41,4774037.84
411995,201806,457,172,285,164088.00,271890.00,435978.00
412000,201806,306,182,124,172722.76,118286.46,291009.22
412010,201806,47,28,19,26712.00,18126.00,44838.00
412015,201806,45,31,14,29574.00,13356.00,42930.00
412020,201806,26,23,3,21655.80,2862.00,24517.80
412030,201806,59,50,9,47700.00,8586.00,56286.00
412033,201806,55,36,19,34320.00,18126.00,52446.00
412035,201806,69,44,25,41976.00,23850.00,65826.00
412040,201806,37,26,11,24518.00,10494.00,35012.00
412050,201806,200,150,50,143100.00,47700.00,190800.00
412060,201806,747,582,165,552303.14,156419.80,708722.94
412065,201806,50,34,16,32436.00,15264.00,47700.00
412070,201806,159,107,52,101410.20,49608.00,151018.20
412080,201806,282,148,134,141192.00,127836.00,269028.00
412085,201806,33,16,17,15264.00,16218.00,31482.00
412090,201806,756,480,276,456251.20,263304.00,719555.20
412100,201806,249,209,40,198433.00,38160.00,236593.00
412110,201806,70,57,13,54378.00,12402.00,66780.00
412120,201806,310,205,105,194997.60,100170.00,295167.60
412125,201806,79,46,33,43597.80,31482.00,75079.80
412130,201806,47,36,11,33753.00,10494.00,44247.00
412135,201806,30,17,13,16218.00,12402.00,28620.00
412140,201806,318,225,93,214010.82,88722.00,302732.82
412150,201806,253,175,78,165996.04,74412.00,240408.04
412160,201806,85,51,34,48654.00,32436.00,81090.00
412170,201806,663,464,199,442369.80,189846.00,632215.80
412175,201806,38,28,10,26712.00,9540.00,36252.00
412180,201806,195,155,40,147270.61,37539.90,184810.51
412190,201806,332,264,68,251183.43,64872.00,316055.43
412200,201806,197,123,74,117342.00,70596.00,187938.00
412210,201806,74,57,17,54378.00,16218.00,70596.00
412215,201806,238,164,74,156169.80,70309.80,226479.60
412217,201806,71,55,16,52470.00,15264.00,67734.00
412220,201806,828,618,210,589572.00,200340.00,789912.00
412230,201806,337,205,132,193948.20,125891.46,319839.66
412240,201806,1328,648,680,615297.86,646544.04,1261841.90
412250,201806,383,246,137,234684.00,130698.00,365382.00
412260,201806,126,92,34,87768.00,32436.00,120204.00
412265,201806,170,134,36,127231.84,34344.00,161575.84
412270,201806,85,54,31,51516.00,29574.00,81090.00
412280,201806,92,73,19,69642.00,18126.00,87768.00
412290,201806,96,64,32,61056.00,30528.00,91584.00
412300,201806,215,140,75,133560.00,71406.90,204966.90
412310,201806,43,37,6,35298.00,5724.00,41022.00
412320,201806,92,78,14,74412.00,13356.00,87768.00
412330,201806,170,150,20,143100.00,19080.00,162180.00
412340,201806,148,103,45,98262.00,42644.00,140906.00
412350,201806,607,306,301,290636.30,287154.00,577790.30
412360,201806,28,25,3,23850.00,2862.00,26712.00
412370,201806,158,138,20,129935.00,19080.00,149015.00
412380,201806,252,191,61,181927.80,58090.00,240017.80
412382,201806,51,27,24,25758.00,22896.00,48654.00
412385,201806,142,102,40,97308.00,38160.00,135468.00
412390,201806,280,212,68,202248.00,64872.00,267120.00
412395,201806,67,52,15,49608.00,14310.00,63918.00
412400,201806,74,54,20,51516.00,19080.00,70596.00
412402,201806,253,120,133,114475.23,126595.80,241071.03
412405,201806,816,327,489,309264.04,465820.66,775084.70
412410,201806,945,595,350,564768.60,333900.00,898668.60
412420,201806,14,12,2,11448.00,1908.00,13356.00
412430,201806,21,15,6,14310.00,5724.00,20034.00
412440,201806,603,328,275,310623.94,260509.96,571133.90
412450,201806,80,68,12,64872.00,11448.00,76320.00
412460,201806,79,62,17,59148.00,16218.00,75366.00
412470,201806,265,210,55,199576.80,52470.00,252046.80
412480,201806,171,130,41,123066.90,39114.00,162180.90
412490,201806,166,142,24,135468.00,22896.00,158364.00
412500,201806,469,381,88,361899.80,83952.00,445851.80
412510,201806,185,153,32,145215.00,30528.00,175743.00
412520,201806,135,74,61,70596.00,58194.00,128790.00
412530,201806,107,57,50,54378.00,47413.80,101791.80
412535,201806,107,77,30,73440.00,28620.00,102060.00
412540,201806,68,34,34,32436.00,32436.00,64872.00
412545,201806,96,71,25,67734.00,23850.00,91584.00
412550,201806,3539,1598,1941,1519064.64,1849330.90,3368395.54
412555,201806,14,10,4,9540.00,3816.00,13356.00
412560,201806,587,439,148,416216.20,141192.00,557408.20
412570,201806,733,406,327,385473.24,311672.00,697145.24
412575,201806,83,58,25,55332.00,23850.00,79182.00
412580,201806,162,108,54,103032.00,51516.00,154548.00
412590,201806,32,30,2,28620.00,1908.00,30528.00
412600,201806,179,136,43,129744.00,41022.00,170766.00
412610,201806,31,19,12,18126.00,11448.00,29574.00
412620,201806,147,130,17,124020.00,16218.00,140238.00
412625,201806,2195,1174,1021,1116908.01,972156.59,2089064.60
412627,201806,70,56,14,53424.00,13356.00,66780.00
412630,201806,424,284,140,269402.43,133283.00,402685.43
412635,201806,66,20,46,19080.00,43884.00,62964.00
412640,201806,120,80,40,76320.00,38160.00,114480.00
412650,201806,348,218,130,207972.00,124015.23,331987.23
412660,201806,481,297,184,282623.00,175536.00,458159.00
412665,201806,51,45,6,42930.00,5724.00,48654.00
412667,201806,287,197,90,187119.10,85593.36,272712.46
412670,201806,60,51,9,48654.00,8586.00,57240.00
412680,201806,296,234,62,223236.00,59148.00,282384.00
412690,201806,116,74,42,70596.00,39782.00,110378.00
412700,201806,161,111,50,105894.00,47414.00,153308.00
412710,201806,1410,872,538,825594.60,511344.20,1336938.80
412720,201806,229,158,71,150732.00,67734.00,218466.00
412730,201806,199,160,39,152640.00,36252.00,188892.00
412740,201806,423,231,192,220230.90,183168.00,403398.90
412750,201806,469,269,200,255672.00,190630.97,446302.97
412760,201806,264,136,128,129744.00,122112.00,251856.00
412770,201806,2123,1200,923,1140416.94,878901.00,2019317.94
412780,201806,151,119,32,113526.00,30528.00,144054.00
412785,201806,273,139,134,132129.00,127836.00,259965.00
412788,201806,38,23,15,21942.00,14310.00,36252.00
412790,201806,137,113,24,107134.20,22896.00,130030.20
412795,201806,152,113,39,107802.00,37206.00,145008.00
412796,201806,298,211,87,200129.18,82864.44,282993.62
412800,201806,556,362,194,344788.39,185076.00,529864.39
412810,201806,3011,1664,1347,1581904.45,1283793.03,2865697.48
412820,201806,933,611,322,571961.79,305328.89,877290.68
412830,201806,15,12,3,11448.00,2862.00,14310.00
412840,201806,224,160,64,151686.20,61056.00,212742.20
412850,201806,781,531,250,504666.00,238500.00,743166.00
412853,201806,172,93,79,88722.00,75366.00,164088.00
412855,201806,215,117,98,110506.82,93492.00,203998.82
412860,201806,90,67,23,63918.00,21942.00,85860.00
412862,201806,59,43,16,41022.00,15264.00,56286.00
412863,201806,7,6,1,5724.00,954,6678.00
412865,201806,43,32,11,30528.00,10494.00,41022.00
412870,201806,107,71,36,67734.00,34344.00,102078.00
412880,201806,99,74,25,70596.00,23850.00,94446.00
420005,201806,39,34,5,32436.00,4198.00,36634.00
420010,201806,368,240,128,227772.34,121826.00,349598.34
420020,201806,76,64,12,61056.00,11448.00,72504.00
420030,201806,29,26,3,24804.00,2862.00,27666.00
420040,201806,106,81,25,77274.00,23850.00,101124.00
420050,201806,55,34,21,32436.00,20034.00,52470.00
420055,201806,20,19,1,18126.00,954,19080.00
420060,201806,33,24,9,22896.00,8586.00,31482.00
420070,201806,102,87,15,82998.00,14300.46,97298.46
420075,201806,12,11,1,10494.00,954,11448.00
420080,201806,50,44,6,40306.50,5724.00,46030.50
420090,201806,34,32,2,29750.49,1908.00,31658.49
420100,201806,165,137,28,129744.20,26712.00,156456.20
420110,201806,19,19,0,18126.00,0,18126.00
420120,201806,50,38,12,36252.00,11448.00,47700.00
420125,201806,86,69,17,65826.00,16218.00,82044.00
420127,201806,35,31,4,29574.00,3816.00,33390.00
420130,201806,392,246,146,234388.46,139035.96,373424.42
420140,201806,1286,744,542,708451.38,517002.00,1225453.38
420150,201806,45,40,5,38160.00,4770.00,42930.00
420160,201806,38,36,2,34344.00,1908.00,36252.00
420165,201806,19,14,5,13356.00,4770.00,18126.00
420170,201806,66,42,24,40068.00,22896.00,62964.00
420180,201806,22,21,1,20034.00,954,20988.00
420190,201806,31,28,3,26712.00,2862.00,29574.00
420195,201806,126,59,67,56286.00,63918.00,120204.00
420200,201806,1285,579,706,547025.60,672467.30,1219492.90
420205,201806,66,35,31,33390.00,29574.00,62964.00
420207,201806,107,61,46,58194.00,43874.46,102068.46
420208,201806,22,17,5,16218.00,3911.40,20129.40
420209,201806,20,16,4,15264.00,3816.00,19080.00
420210,201806,464,223,241,212455.80,229828.68,442284.48
420213,201806,44,35,9,33390.00,8586.00,41976.00
420215,201806,26,22,4,20988.00,3816.00,24804.00
420220,201806,67,43,24,41022.00,22896.00,63918.00
420230,201806,773,436,337,415181.00,320916.46,736097.46
420240,201806,2292,1542,750,1462116.81,715061.16,2177177.97
420243,201806,37,30,7,28620.00,6678.00,35298.00
420245,201806,114,63,51,60102.00,48654.00,108756.00
420250,201806,54,32,22,30528.00,20988.00,51516.00
420253,201806,41,33,8,31482.00,7632.00,39114.00
420257,201806,12,10,2,9540.00,1908.00,11448.00
420260,201806,99,86,13,82044.00,12402.00,94446.00
420270,201806,38,31,7,29570.00,6678.00,36248.00
420280,201806,282,208,74,197661.96,69338.10,267000.06
420285,201806,19,12,7,11448.00,6678.00,18126.00
420287,201806,49,30,19,28620.00,18126.00,46746.00
420290,201806,977,688,289,653524.96,275638.30,929163.26
420300,201806,1392,1105,287,1049592.40,271318.14,1320910.54
420310,201806,58,46,12,43884.00,11448.00,55332.00
420315,201806,35,31,4,29574.00,3816.00,33390.00
420320,201806,850,432,418,411150.15,398768.00,809918.15
420325,201806,0,0,0,0,0,0
420330,201806,124,84,40,80136.00,38045.52,118181.52
420340,201806,160,109,51,103024.00,48634.92,151658.92
420350,201806,251,185,66,174869.00,62964.00,237833.00
420360,201806,759,576,183,547578.16,172961.78,720539.94
420370,201806,110,71,39,67544.00,36920.00,104464.00
420380,201806,1136,814,322,772732.30,306151.04,1078883.34
420390,201806,256,165,91,156151.52,86098.50,242250.02
420395,201806,185,132,53,125928.00,49668.58,175596.58
420400,201806,243,182,61,172419.00,58194.00,230613.00
420410,201806,62,48,14,45792.00,13356.00,59148.00
420415,201806,33,31,2,29574.00,1908.00,31482.00
420417,201806,48,35,13,33390.00,12382.92,45772.92
420419,201806,12,12,0,11448.00,0,11448.00
420420,201806,2809,1724,1085,1632447.99,1032802.42,2665250.41
420425,201806,73,61,12,58185.00,11134.26,69319.26
420430,201806,1274,888,386,843444.62,366498.18,1209942.80
420435,201806,16,14,2,13356.00,1908.00,15264.00
420440,201806,106,72,34,68060.68,32284.60,100345.28
420445,201806,22,19,3,18126.00,2862.00,20988.00
420450,201806,79,37,42,35298.00,40068.00,75366.00
420455,201806,214,158,56,150694.92,53359.38,204054.30
420460,201806,2355,1565,790,1487390.76,753417.36,2240808.12
420470,201806,119,85,34,81090.00,32436.00,113526.00
420475,201806,6,6,0,5724.00,0,5724.00
420480,201806,872,652,220,616552.12,208831.00,825383.12
420490,201806,111,87,24,82998.00,22896.00,105894.00
420500,201806,669,291,378,275643.20,360612.00,636255.20
420510,201806,19,16,3,15264.00,2862.00,18126.00
420515,201806,26,20,6,19080.00,5724.00,24804.00
420517,201806,10,10,0,9540.00,0,9540.00
420519,201806,0,0,0,0,0,0
420520,201806,69,52,17,49608.00,16218.00,65826.00
420530,201806,169,114,55,107781.02,52470.00,160251.02
420535,201806,21,19,2,18126.00,1908.00,20034.00
420540,201806,4966,2931,2035,2784312.78,1936087.18,4720399.96
420543,201806,26,26,0,24804.00,0,24804.00
420545,201806,197,139,58,131652.00,55312.92,186964.92
420550,201806,851,684,167,649408.32,159160.73,808569.05
420555,201806,39,27,12,25758.00,11448.00,37206.00
420560,201806,66,53,13,50180.40,12402.00,62582.40
420570,201806,147,85,62,81090.00,59138.46,140228.46
420580,201806,294,132,162,125928.00,154262.00,280190.00
420590,201806,517,369,148,351739.80,140811.00,492550.80
420600,201806,97,48,49,45792.00,46746.00,92538.00
420610,201806,38,36,2,34058.00,1908.00,35966.00
420620,201806,76,62,14,59148.00,13356.00,72504.00
420630,201806,155,114,41,108747.23,39106.00,147853.23
420640,201806,94,83,11,78991.20,10494.00,89485.20
420650,201806,243,128,115,121444.20,109091.23,230535.43
420660,201806,53,41,12,38350.80,11448.00,49798.80
420665,201806,38,28,10,26426.00,9540.00,35966.00
420670,201806,321,242,79,230142.96,75347.46,305490.42
420675,201806,15,14,1,13356.00,954,14310.00
420680,201806,36,26,10,24804.00,9540.00,34344.00
420690,201806,176,145,31,138330.00,29574.00,167904.00
420700,201806,653,444,209,423474.30,199124.28,622598.58
420710,201806,151,89,62,84906.00,58861.80,143767.80
420720,201806,109,88,21,83942.46,20034.00,103976.46
420730,201806,547,348,199,330934.50,188560.12,519494.62
420740,201806,46,45,1,42930.00,954,43884.00
420750,201806,501,335,166,319303.80,158364.00,477667.80
420757,201806,19,16,3,14453.10,2862.00,17315.10
420760,201806,38,31,7,29574.00,6678.00,36252.00
420765,201806,70,57,13,54378.00,12402.00,66780.00
420768,201806,65,58,7,55332.00,6678.00,62010.00
420770,201806,84,70,14,66780.00,13356.00,80136.00
420775,201806,46,43,3,40068.00,2862.00,42930.00
420780,201806,241,189,52,180296.46,49608.00,229904.46
420785,201806,14,10,4,9540.00,3816.00,13356.00
420790,201806,176,146,30,139191.30,27638.46,166829.76
420800,201806,75,57,18,53614.80,17172.00,70786.80
420810,201806,253,217,36,207009.00,33533.10,240542.10
420820,201806,2335,1387,948,1317464.76,903043.80,2220508.56
420830,201806,588,329,259,311571.95,246122.46,557694.41
420840,201806,151,113,38,107802.00,35548.00,143350.00
420845,201806,451,198,253,188507.07,240122.00,428629.07
420850,201806,232,186,46,177444.00,43884.00,221328.00
420860,201806,63,54,9,51516.00,8586.00,60102.00
420870,201806,118,85,33,81090.00,31482.00,112572.00
420880,201806,172,121,51,115424.46,48654.00,164078.46
420890,201806,875,429,446,405224.84,424902.60,830127.44
420895,201806,10,10,0,9540.00,0,9540.00
420900,201806,425,331,94,313715.04,89638.38,403353.42
420910,201806,5820,3268,2552,3106799.19,2429898.27,5536697.46
420915,201806,78,71,7,67734.00,6678.00,74412.00
420917,201806,19,14,5,13356.00,4770.00,18126.00
420920,201806,23,16,7,15264.00,6678.00,21942.00
420930,201806,2713,1665,1048,1581889.74,993865.80,2575755.54
420940,201806,616,446,170,424139.60,160528.08,584667.68
420945,201806,8,6,2,5724.00,1908.00,7632.00
420950,201806,57,52,5,49608.00,4770.00,54378.00
420960,201806,114,89,25,84868.92,23841.00,108709.92
420970,201806,304,244,60,231100.85,57212.46,288313.31
420980,201806,23,23,0,21942.00,0,21942.00
420985,201806,63,55,8,52470.00,7632.00,60102.00
420990,201806,72,57,15,54378.00,14310.00,68688.00
421000,201806,34,23,11,21942.00,10494.00,32436.00
421003,201806,69,45,24,42930.00,22887.00,65817.00
421005,201806,8,5,3,4770.00,2862.00,7632.00
421010,201806,767,539,228,512957.00,216406.20,729363.20
421020,201806,30,25,5,23850.00,4770.00,28620.00
421030,201806,130,110,20,104320.00,19080.00,123400.00
421040,201806,70,60,10,57240.00,9540.00,66780.00
421050,201806,320,231,89,218275.20,84906.00,303181.20
421055,201806,24,20,4,19080.00,3816.00,22896.00
421060,201806,80,56,24,53424.00,22896.00,76320.00
421070,201806,51,46,5,43884.00,4770.00,48654.00
421080,201806,34,31,3,29574.00,2862.00,32436.00
421085,201806,25,20,5,19080.00,4770.00,23850.00
421090,201806,43,32,11,30528.00,10494.00,41022.00
421100,201806,129,96,33,91584.00,31482.00,123066.00
421105,201806,220,178,42,169382.80,40044.69,209427.49
421110,201806,112,91,21,86193.90,20034.00,106227.90
421120,201806,157,122,35,115892.46,33370.92,149263.38
421125,201806,16,12,4,11448.00,3816.00,15264.00
421130,201806,819,528,291,502582.05,276574.54,779156.59
421140,201806,32,23,9,21226.50,8586.00,29812.50
421145,201806,40,31,9,29574.00,8586.00,38160.00
421150,201806,108,79,29,75366.00,27666.00,103032.00
421160,201806,63,42,21,40058.46,20034.00,60092.46
421165,201806,17,16,1,15264.00,954,16218.00
421170,201806,192,167,25,158290.84,23841.00,182131.84
421175,201806,149,97,52,92538.00,49569.92,142107.92
421180,201806,57,36,21,33982.00,20034.00,54016.00
421185,201806,17,14,3,13356.00,2862.00,16218.00
421187,201806,0,0,0,0,0,0
421189,201806,38,30,8,28620.00,7622.46,36242.46
421190,201806,1552,957,595,912015.46,566361.58,1478377.04
421200,201806,89,68,21,63918.70,20034.00,83952.70
421205,201806,27,19,8,18126.00,7632.00,25758.00
421210,201806,184,124,60,118296.00,57240.00,175536.00
421220,201806,277,219,58,208305.90,55332.00,263637.90
421223,201806,55,46,9,43694.00,8586.00,52280.00
421225,201806,65,43,22,41022.00,20988.00,62010.00
421227,201806,95,71,24,67734.00,22896.00,90630.00
421230,201806,53,40,13,38160.00,12402.00,50562.00
421240,201806,18,18,0,17172.00,0,17172.00
421250,201806,356,221,135,209500.00,127998.18,337498.18
421260,201806,28,23,5,21942.00,4770.00,26712.00
421265,201806,0,0,0,0,0,0
421270,201806,53,47,6,44838.00,5724.00,50562.00
421280,201806,335,188,147,179352.00,138520.80,317872.80
421290,201806,322,209,113,199148.00,105676.26,304824.26
421300,201806,25,20,5,19080.00,4770.00,23850.00
421310,201806,55,42,13,39400.20,12402.00,51802.20
421315,201806,29,20,9,19080.00,8586.00,27666.00
421320,201806,133,93,40,88722.00,38160.00,126882.00
421330,201806,108,82,26,76110.12,24795.00,100905.12
421335,201806,38,25,13,23850.00,12402.00,36252.00
421340,201806,293,199,94,188082.05,89676.00,277758.05
421350,201806,178,105,73,99727.00,69642.00,169369.00
421360,201806,690,507,183,479418.68,173801.06,653219.74
421370,201806,195,150,45,143100.00,42596.10,185696.10
421380,201806,127,103,24,98257.23,22896.00,121153.23
421390,201806,15,11,4,10494.00,3816.00,14310.00
421400,201806,117,99,18,94446.00,17172.00,111618.00
421410,201806,23,19,4,18126.00,3816.00,21942.00
421415,201806,22,21,1,20034.00,954,20988.00
421420,201806,149,122,27,115815.60,25758.00,141573.60
421430,201806,15,11,4,10494.00,3816.00,14310.00
421440,201806,57,44,13,41976.00,12402.00,54378.00
421450,201806,97,84,13,80136.00,12402.00,92538.00
421460,201806,58,49,9,45941.77,8586.00,54527.77
421470,201806,69,45,24,42930.00,22896.00,65826.00
421480,201806,634,470,164,447617.00,156447.00,604064.00
421490,201806,22,21,1,19358.00,954,20312.00
421500,201806,518,331,187,313971.19,178110.90,492082.09
421505,201806,26,19,7,18126.00,6678.00,24804.00
421507,201806,33,27,6,25758.00,5724.00,31482.00
421510,201806,73,47,26,44838.00,24804.00,69642.00
421520,201806,67,58,9,54569.00,8586.00,63155.00
421530,201806,53,48,5,45792.00,4770.00,50562.00
421535,201806,27,26,1,24537.00,954,25491.00
421540,201806,57,49,8,46746.00,7632.00,54378.00
421545,201806,96,73,23,69156.00,21942.00,91098.00
421550,201806,289,210,79,199673.00,75366.00,275039.00
421555,201806,27,21,6,20034.00,5629.00,25663.00
421560,201806,8,7,1,6678.00,954,7632.00
421565,201806,124,91,33,86814.00,31482.00,118296.00
421567,201806,31,26,5,24804.00,4770.00,29574.00
421568,201806,32,30,2,28620.00,1908.00,30528.00
421569,201806,7,7,0,6678.00,0,6678.00
421570,201806,150,102,48,97308.00,45792.00,143100.00
421575,201806,27,22,5,20725.65,4770.00,25495.65
421580,201806,726,431,295,409553.00,280476.34,690029.34
421590,201806,22,21,1,20034.00,954,20988.00
421600,201806,109,75,34,71550.00,31197.00,102747.00
421605,201806,104,74,30,70263.00,28620.00,98883.00
421610,201806,186,148,38,140238.50,36252.00,176490.50
421620,201806,1101,660,441,627140.92,420694.92,1047835.84
421625,201806,22,20,2,19080.00,1908.00,20988.00
421630,201806,290,184,106,174725.80,100266.00,274991.80
421635,201806,16,8,8,7632.00,7632.00,15264.00
421640,201806,97,83,14,79182.00,13356.00,92538.00
421650,201806,280,165,115,157390.92,109690.92,267081.84
421660,201806,2135,1283,852,1220176.45,811636.26,2031812.71
421670,201806,186,130,56,124020.00,53424.00,177444.00
421680,201806,170,154,16,146916.00,15255.00,162171.00
421690,201806,360,248,112,235611.00,105884.58,341495.58
421700,201806,59,37,22,35298.00,20130.00,55428.00
421710,201806,24,24,0,22896.00,0,22896.00
421715,201806,8,7,1,6678.00,954,7632.00
421720,201806,590,426,164,403805.40,154729.26,558534.66
421725,201806,13,6,7,5724.00,6678.00,12402.00
421730,201806,40,28,12,26004.12,11448.00,37452.12
421740,201806,87,42,45,40068.00,42930.00,82998.00
421750,201806,224,167,57,156872.51,54378.00,211250.51
421755,201806,26,24,2,22896.00,1908.00,24804.00
421760,201806,106,76,30,72504.00,28620.00,101124.00
421770,201806,572,386,186,365760.38,177369.30,543129.68
421775,201806,29,19,10,18126.00,9540.00,27666.00
421780,201806,196,154,42,146916.00,40068.00,186984.00
421790,201806,160,133,27,125989.50,25758.00,151747.50
421795,201806,16,13,3,12402.00,2862.00,15264.00
421800,201806,486,314,172,298759.31,164088.00,462847.31
421810,201806,69,55,14,52470.00,13356.00,65826.00
421820,201806,315,217,98,206350.20,93492.00,299842.20
421825,201806,125,104,21,99216.00,20034.00,119250.00
421830,201806,129,98,31,93492.00,29574.00,123066.00
421835,201806,3,3,0,2862.00,0,2862.00
421840,201806,59,49,10,46737.00,9540.00,56277.00
421850,201806,77,67,10,63918.00,9536.00,73454.00
421860,201806,42,33,9,31482.00,8586.00,40068.00
421870,201806,975,744,231,700711.52,219589.42,920300.94
421875,201806,53,46,7,43884.00,6678.00,50562.00
421880,201806,164,121,43,115434.00,40736.00,156170.00
421885,201806,27,22,5,20988.00,4770.00,25758.00
421890,201806,119,83,36,79182.00,34344.00,113526.00
421895,201806,43,40,3,38160.00,2862.00,41022.00
421900,201806,153,124,29,117935.10,27630.00,145565.10
421910,201806,65,43,22,41022.00,20988.00,62010.00
421915,201806,33,28,5,26712.00,4770.00,31482.00
421917,201806,41,31,10,29574.00,9540.00,39114.00
421920,201806,33,30,3,28620.00,2862.00,31482.00
421930,201806,749,581,168,552247.26,160245.00,712492.26
421935,201806,57,50,7,47700.00,6678.00,54378.00
421940,201806,40,37,3,35298.00,2862.00,38160.00
421950,201806,834,551,283,518605.48,267508.20,786113.68
421960,201806,42,35,7,33104.00,6656.12,39760.12
421970,201806,373,235,138,223691.12,131621.12,355312.24
421985,201806,33,21,12,20034.00,11448.00,31482.00
422000,201806,0,0,0,0,0,0
430003,201806,208,52,156,48892.50,148824.00,197716.50
430005,201806,35,27,8,25758.00,7632.00,33390.00
430010,201806,276,193,83,183645.00,79182.00,262827.00
430020,201806,153,100,53,95114.00,50562.00,145676.00
430030,201806,132,104,28,98929.80,26712.00,125641.80
430040,201806,2989,1740,1249,1651861.84,1189840.58,2841702.42
430045,201806,68,59,9,55999.80,8586.00,64585.80
430047,201806,6,5,1,4770.00,954,5724.00
430050,201806,80,67,13,63918.00,12402.00,76320.00
430055,201806,17,14,3,13356.00,2862.00,16218.00
430057,201806,4,2,2,1908.00,1908.00,3816.00
430060,201806,3659,2186,1473,2078200.92,1401754.28,3479955.20
430063,201806,62,57,5,54378.00,4770.00,59148.00
430064,201806,150,124,26,118296.00,24804.00,143100.00
430066,201806,10,7,3,6678.00,2862.00,9540.00
430070,201806,43,33,10,31482.00,9540.00,41022.00
430080,201806,67,45,22,42230.33,20988.00,63218.33
430085,201806,34,12,22,11448.00,20988.00,32436.00
430087,201806,33,25,8,23707.00,7632.00,31339.00
430090,201806,72,65,7,61723.80,6678.00,68401.80
430100,201806,126,85,41,80136.00,39114.00,119250.00
430105,201806,143,72,71,68323.00,67428.72,135751.72
430107,201806,20,15,5,14310.00,4770.00,19080.00
430110,201806,413,242,171,230057.10,163067.22,393124.32
430120,201806,139,128,11,121158.00,10494.00,131652.00
430130,201806,798,500,298,476379.90,284005.80,760385.70
430140,201806,123,113,10,107802.00,9540.00,117342.00
430150,201806,112,72,40,67925.00,37206.00,105131.00
430155,201806,32,29,3,27666.00,2862.00,30528.00
430160,201806,3799,2253,1546,2130790.22,1472718.62,3603508.84
430163,201806,331,150,181,142051.34,172645.38,314696.72
430165,201806,25,17,8,16218.00,7632.00,23850.00
430170,201806,82,74,8,70596.00,7632.00,78228.00
430175,201806,84,65,19,62010.00,17458.20,79468.20
430180,201806,104,81,23,77274.00,21321.90,98595.90
430185,201806,34,25,9,23850.00,8586.00,32436.00
430187,201806,100,41,59,39114.00,55980.80,95094.80
430190,201806,220,125,95,119202.30,89953.46,209155.76
430192,201806,15,14,1,13356.00,954,14310.00
430195,201806,14,9,5,8586.00,4770.00,13356.00
430200,201806,167,148,19,140524.20,18126.00,158650.20
430205,201806,20,19,1,18126.00,954,19080.00
430210,201806,635,494,141,467555.40,132653.90,600209.30
430215,201806,16,11,5,10494.00,4770.00,15264.00
430220,201806,68,49,19,46746.00,18126.00,64872.00
430222,201806,12,7,5,6678.00,4770.00,11448.00
430223,201806,13,7,6,6678.00,5724.00,12402.00
430225,201806,4,3,1,2862.00,954,3816.00
430230,201806,296,182,114,172674.00,108756.00,281430.00
430235,201806,52,36,16,34344.00,15254.46,49598.46
430237,201806,29,22,7,20988.00,6678.00,27666.00
430240,201806,131,84,47,79945.20,44838.00,124783.20
430245,201806,71,60,11,57240.00,10494.00,67734.00
430250,201806,191,110,81,104930.46,77264.46,182194.92
430258,201806,13,11,2,10494.00,1908.00,12402.00
430260,201806,34,29,5,27666.00,4760.46,32426.46
430265,201806,34,29,5,27646.92,4770.00,32416.92
430270,201806,558,413,145,390898.74,137473.02,528371.76
430280,201806,1049,642,407,607993.74,385778.60,993772.34
430290,201806,376,218,158,206064.80,150732.00,356796.80
430300,201806,2132,1172,960,1113614.84,912790.35,2026405.19
430310,201806,1982,1045,937,990645.40,890865.93,1881511.33
430320,201806,50,42,8,40053.69,7632.00,47685.69
430330,201806,95,85,10,80613.00,9520.92,90133.92
430340,201806,67,59,8,56286.00,7632.00,63918.00
430350,201806,1680,1167,513,1101188.89,487628.64,1588817.53
430355,201806,26,23,3,21942.00,2862.00,24804.00
430360,201806,82,39,43,37206.00,41022.00,78228.00
430367,201806,28,19,9,18126.00,8586.00,26712.00
430370,201806,56,48,8,45792.00,7632.00,53424.00
430380,201806,129,96,33,91011.60,31482.00,122493.60
430390,201806,618,385,233,366956.10,221405.06,588361.16
430400,201806,140,108,32,101124.00,30508.92,131632.92
430410,201806,61,48,13,45792.00,12402.00,58194.00
430420,201806,497,326,171,308524.80,161637.56,470162.36
430430,201806,53,51,2,48018.63,1908.00,49926.63
430435,201806,156,116,40,109710.00,37444.50,147154.50
430440,201806,497,331,166,315774.00,158173.20,473947.20
430450,201806,1189,983,206,930799.46,196514.46,1127313.92
430460,201806,5103,2802,2301,2657848.49,2189213.83,4847062.32
430461,201806,17,15,2,14310.00,1908.00,16218.00
430462,201806,9,6,3,5724.00,2862.00,8586.00
430463,201806,1036,549,487,521322.92,464246.10,985569.02
430465,201806,26,14,12,13356.00,11448.00,24804.00
430466,201806,669,482,187,457920.20,178207.20,636127.40
430467,201806,99,57,42,53137.80,40058.46,93196.26
430468,201806,111,70,41,66780.00,38862.91,105642.91
430469,201806,22,17,5,16218.00,4770.00,20988.00
430470,201806,1160,641,519,605829.55,493170.30,1098999.85
430471,201806,49,37,12,35278.92,11448.00,46726.92
430480,201806,92,55,37,51611.40,35288.46,86899.86
430485,201806,6,6,0,5438.00,0,5438.00
430490,201806,88,71,17,66923.70,16218.00,83141.70
430495,201806,38,27,11,25758.00,10494.00,36252.00
430500,201806,193,129,64,123066.00,60680.46,183746.46
430510,201806,3155,2092,1063,1987850.73,1013025.01,3000875.74
430511,201806,16,16,0,15264.00,0,15264.00
430512,201806,137,96,41,91584.00,39114.00,130698.00
430513,201806,52,44,8,41499.00,7632.00,49131.00
430515,201806,32,30,2,28620.00,1908.00,30528.00
430517,201806,169,150,19,142146.00,18106.92,160252.92
430520,201806,371,260,111,247373.00,105865.38,353238.38
430530,201806,89,52,37,49608.00,35298.00,84906.00
430535,201806,477,318,159,302886.43,151658.15,454544.58
430537,201806,10,10,0,9540.00,0,9540.00
430540,201806,73,50,23,47700.00,21942.00,69642.00
430543,201806,368,112,256,106848.00,244224.00,351072.00
430544,201806,42,39,3,37206.00,2862.00,40068.00
430545,201806,354,170,184,161684.00,175005.58,336689.58
430550,201806,43,35,8,33390.00,7632.00,41022.00
430558,201806,5,3,2,2862.00,1908.00,4770.00
430560,201806,49,21,28,20034.00,26712.00,46746.00
430570,201806,104,45,59,42930.00,56228.76,99158.76
430580,201806,123,98,25,93492.00,22609.80,116101.80
430583,201806,14,14,0,13356.00,0,13356.00
430585,201806,8,3,5,2862.00,4770.00,7632.00
430587,201806,14,8,6,7632.00,5724.00,13356.00
430590,201806,154,124,30,117055.80,28620.00,145675.80
430593,201806,4,4,0,3816.00,0,3816.00
430595,201806,18,14,4,13356.00,3816.00,17172.00
430597,201806,51,27,24,25758.00,22896.00,48654.00
430600,201806,220,155,65,147860.46,61723.80,209584.26
430605,201806,160,101,59,96354.00,56276.46,152630.46
430607,201806,27,22,5,20988.00,4770.00,25758.00
430610,201806,1640,766,874,728036.26,829179.78,1557216.04
430613,201806,3,3,0,2862.00,0,2862.00
430620,201806,111,80,31,76176.90,29564.46,105741.36
430630,201806,45,39,6,37206.00,5724.00,42930.00
430632,201806,32,27,5,25758.00,4770.00,30528.00
430635,201806,41,37,4,35298.00,3816.00,39114.00
430637,201806,56,32,24,30528.00,22896.00,53424.00
430640,201806,207,114,93,107325.00,88722.00,196047.00
430642,201806,27,25,2,23850.00,1908.00,25758.00
430645,201806,35,29,6,27666.00,5724.00,33390.00
430650,201806,254,204,50,194330.00,47652.30,241982.30
430655,201806,4,4,0,3816.00,0,3816.00
430660,201806,969,474,495,450621.90,470703.80,921325.70
430670,201806,72,50,22,47700.00,20988.00,68688.00
430673,201806,69,38,31,36252.00,29574.00,65826.00
430675,201806,13,10,3,9540.00,2862.00,12402.00
430676,201806,492,299,193,284540.12,184051.07,468591.19
430680,201806,248,171,77,160653.80,73458.00,234111.80
430690,201806,535,319,216,303420.24,204389.06,507809.30
430692,201806,7,5,2,4770.00,1908.00,6678.00
430693,201806,146,98,48,93492.00,45782.46,139274.46
430695,201806,73,65,8,61075.08,7632.00,68707.08
430697,201806,57,35,22,33390.00,20988.00,54378.00
430700,201806,1582,1111,471,1048353.58,449047.80,1497401.38
430705,201806,19,18,1,17172.00,954,18126.00
430710,201806,262,170,92,162180.00,87768.00,249948.00
430720,201806,108,92,16,87577.20,15264.00,102841.20
430730,201806,119,102,17,96354.00,16218.00,112572.00
430740,201806,65,43,22,41022.00,20988.00,62010.00
430745,201806,36,29,7,27380.00,6678.00,34058.00
430750,201806,341,227,114,215614.64,107802.00,323416.64
430755,201806,83,47,36,44838.00,34344.00,79182.00
430760,201806,366,220,146,207209.72,139255.92,346465.64
430770,201806,1456,752,704,714737.70,666462.85,1381200.55
430780,201806,314,202,112,191726.72,106781.76,298508.48
430781,201806,28,23,5,21942.00,4770.00,26712.00
430783,201806,52,42,10,39750.13,9540.00,49290.13
430786,201806,6,3,3,2862.00,2862.00,5724.00
430790,201806,504,324,180,308205.72,171424.46,479630.18
430800,201806,158,130,28,124000.92,26712.00,150712.92
430805,201806,41,37,4,35298.00,3816.00,39114.00
430807,201806,38,25,13,23850.00,12402.00,36252.00
430810,201806,76,50,26,47700.00,24804.00,72504.00
430820,201806,136,85,51,81090.00,47986.20,129076.20
430825,201806,12,10,2,9540.00,1908.00,11448.00
430830,201806,234,221,13,210528.92,12402.00,222930.92
430840,201806,127,86,41,82044.00,38446.20,120490.20
430843,201806,5,3,2,2862.00,1908.00,4770.00
430845,201806,70,39,31,37206.00,29574.00,66780.00
430850,201806,570,396,174,375943.58,165892.76,541836.34
430860,201806,155,98,57,92824.20,53700.66,146524.86
430865,201806,67,37,30,34630.20,28305.18,62935.38
430870,201806,81,66,15,62296.20,14310.00,76606.20
430880,201806,161,120,41,114460.92,39114.00,153574.92
430885,201806,7,6,1,5724.00,954,6678.00
430890,201806,334,205,129,193910.04,123066.00,316976.04
430900,201806,538,370,168,348496.40,159785.46,508281.86
430905,201806,90,37,53,35298.00,50562.00,85860.00
430910,201806,265,147,118,140238.00,111896.00,252134.00
430912,201806,4,4,0,3816.00,0,3816.00
430915,201806,36,28,8,26712.00,7345.80,34057.80
430920,201806,4296,2383,1913,2266269.69,1822362.62,4088632.31
430925,201806,5,4,1,3567.96,954,4521.96
430930,201806,2104,1248,856,1183229.80,816373.43,1999603.23
430940,201806,249,157,92,149100.66,87748.92,236849.58
430950,201806,156,126,30,120204.00,28620.00,148824.00
430955,201806,22,14,8,13356.00,7632.00,20988.00
430957,201806,18,17,1,16218.00,954,17172.00
430960,201806,236,157,79,147345.30,75366.00,222711.30
430965,201806,108,68,40,64872.00,38160.00,103032.00
430970,201806,79,66,13,62964.00,11448.00,74412.00
430975,201806,36,32,4,30528.00,3816.00,34344.00
430980,201806,47,29,18,27666.00,17172.00,44838.00
430990,201806,117,89,28,84906.00,26712.00,111618.00
430995,201806,113,109,4,102745.80,3816.00,106561.80
431000,201806,300,136,164,127597.20,156456.00,284053.20
431010,201806,338,203,135,192803.40,128790.00,321593.40
431020,201806,1932,1127,805,1066882.62,763858.26,1830740.88
431030,201806,42,33,9,31482.00,8586.00,40068.00
431033,201806,385,194,191,184265.20,182214.00,366479.20
431036,201806,14,9,5,8586.00,4770.00,13356.00
431040,201806,131,79,52,74412.00,49498.29,123910.29
431041,201806,36,24,12,22896.00,11448.00,34344.00
431043,201806,46,26,20,24804.00,19080.00,43884.00
431046,201806,12,7,5,6678.00,4770.00,11448.00
431050,201806,204,129,75,122493.60,71263.80,193757.40
431053,201806,75,45,30,42166.80,28620.00,70786.80
431055,201806,64,43,21,41022.00,20014.92,61036.92
431057,201806,17,17,0,16218.00,0,16218.00
431060,201806,1672,1054,618,997571.36,587720.44,1585291.80
431065,201806,19,11,8,10494.00,7632.00,18126.00
431070,201806,71,66,5,62964.00,4770.00,67734.00
431075,201806,7,7,0,6678.00,0,6678.00
431080,201806,136,87,49,82711.80,46746.00,129457.80
431085,201806,30,27,3,25758.00,2862.00,28620.00
431087,201806,13,11,2,10494.00,1908.00,12402.00
431090,201806,55,43,12,41022.00,11448.00,52470.00
431100,201806,1234,737,497,692274.02,474138.00,1166412.02
431110,201806,245,155,90,147870.00,85564.46,233434.46
431112,201806,28,17,11,16218.00,10494.00,26712.00
431113,201806,32,22,10,20988.00,9540.00,30528.00
431115,201806,154,107,47,101441.87,44828.46,146270.33
431120,201806,614,363,251,344347.10,239396.92,583744.02
431123,201806,3,2,1,1908.00,954,2862.00
431125,201806,91,81,10,77274.00,9540.00,86814.00
431127,201806,8,4,4,3816.00,3816.00,7632.00
431130,201806,656,423,233,402015.60,221976.72,623992.32
431140,201806,733,497,236,471419.30,225067.68,696486.98
431142,201806,35,27,8,24546.00,7632.00,32178.00
431150,201806,204,149,55,142146.00,52460.46,194606.46
431160,201806,56,50,6,47700.00,5724.00,53424.00
431162,201806,19,14,5,13356.00,4770.00,18126.00
431164,201806,4,4,0,3816.00,0,3816.00
431170,201806,104,84,20,80136.00,19080.00,99216.00
431171,201806,58,33,25,31243.50,23840.46,55083.96
431173,201806,1,1,0,954,0,954
431175,201806,202,99,103,93206.00,98252.46,191458.46
431177,201806,75,56,19,53424.00,17439.92,70863.92
431179,201806,13,11,2,10494.00,1908.00,12402.00
431180,201806,448,274,174,260680.50,165977.46,426657.96
431190,201806,89,69,20,65826.00,19080.00,84906.00
431198,201806,70,48,22,45792.00,20988.00,66780.00
431200,201806,21,17,4,16218.00,3816.00,20034.00
431205,201806,23,23,0,21942.00,0,21942.00
431210,201806,90,56,34,53091.00,32436.00,85527.00
431213,201806,30,25,5,23850.00,4770.00,28620.00
431215,201806,25,22,3,20988.00,2862.00,23850.00
431217,201806,5,4,1,3816.00,954,4770.00
431220,201806,67,57,10,54378.00,9540.00,63918.00
431225,201806,149,99,50,94437.00,47680.92,142117.92
431230,201806,96,84,12,80136.00,11448.00,91584.00
431235,201806,8,8,0,7632.00,0,7632.00
431237,201806,26,18,8,17172.00,7632.00,24804.00
431238,201806,13,10,3,9254.00,2862.00,12116.00
431240,201806,1004,646,358,614624.64,341207.64,955832.28
431242,201806,36,36,0,34344.00,0,34344.00
431244,201806,11,8,3,7632.00,2862.00,10494.00
431245,201806,55,41,14,39114.00,13356.00,52470.00
431247,201806,12,10,2,9540.00,1908.00,11448.00
431250,201806,273,141,132,134447.22,125908.92,260356.14
431260,201806,62,46,16,43884.00,15264.00,59148.00
431261,201806,20,13,7,12402.00,6678.00,19080.00
431262,201806,15,15,0,14310.00,0,14310.00
431265,201806,159,83,76,79182.00,72504.00,151686.00
431267,201806,13,12,1,11448.00,954,12402.00
431270,201806,317,265,52,252810.00,49608.00,302418.00
431275,201806,40,38,2,36252.00,1908.00,38160.00
431280,201806,20,16,4,14429.25,3816.00,18245.25
431290,201806,23,19,4,18126.00,3816.00,21942.00
431295,201806,4,4,0,3816.00,0,3816.00
431300,201806,23,20,3,19080.00,2862.00,21942.00
431301,201806,7,7,0,6678.00,0,6678.00
431303,201806,52,35,17,33265.98,15931.80,49197.78
431306,201806,226,119,107,113069.98,102078.00,215147.98
431308,201806,7,5,2,4770.00,1908.00,6678.00
431310,201806,65,56,9,53424.00,8586.00,62010.00
431320,201806,121,72,49,68668.92,46450.26,115119.18
431330,201806,172,109,63,103986.00,60102.00,164088.00
431333,201806,33,27,6,25758.00,5724.00,31482.00
431335,201806,10,5,5,4770.00,4770.00,9540.00
431337,201806,327,156,171,147965.58,162094.14,310059.72
431339,201806,21,18,3,17172.00,2862.00,20034.00
431340,201806,3016,1739,1277,1654189.63,1215322.48,2869512.11
431342,201806,41,24,17,22896.00,16218.00,39114.00
431344,201806,18,17,1,16218.00,954,17172.00
431346,201806,4,4,0,3816.00,0,3816.00
431349,201806,35,32,3,30528.00,2862.00,33390.00
431350,201806,916,537,379,507749.66,359906.04,867655.70
431360,201806,46,41,5,39114.00,4770.00,43884.00
431365,201806,319,152,167,144988.92,158354.46,303343.38
431370,201806,1348,797,551,756703.93,525343.06,1282046.99
431380,201806,97,84,13,80136.00,12402.00,92538.00
431390,201806,500,277,223,263256.50,212436.72,475693.22
431395,201806,281,124,157,118296.00,149759.00,268055.00
431400,201806,39,29,10,27666.00,9540.00,37206.00
431402,201806,103,72,31,68688.00,29574.00,98262.00
431403,201806,20,12,8,11448.00,7632.00,19080.00
431405,201806,642,345,297,327490.02,283025.00,610515.02
431406,201806,31,27,4,25758.00,3816.00,29574.00
431407,201806,53,42,11,40068.00,10494.00,50562.00
431410,201806,3282,1968,1314,1863752.49,1249024.50,3112776.99
431413,201806,16,13,3,12402.00,2862.00,15264.00
431415,201806,70,51,19,48654.00,18126.00,66780.00
431417,201806,23,12,11,11448.00,10494.00,21942.00
431420,201806,304,214,90,203472.26,85860.00,289332.26
431430,201806,43,18,25,17172.00,23850.00,41022.00
431440,201806,8981,6386,2595,6022781.10,2467822.81,8490603.91
431442,201806,28,15,13,14310.00,12402.00,26712.00
431445,201806,26,20,6,19080.00,5724.00,24804.00
431446,201806,7,6,1,5724.00,954,6678.00
431447,201806,87,62,25,59148.00,23850.00,82998.00
431449,201806,51,45,6,42930.00,5724.00,48654.00
431450,201806,413,283,130,268932.60,123304.50,392237.10
431454,201806,0,0,0,0,0,0
431455,201806,50,40,10,38160.00,9540.00,47700.00
431460,201806,537,369,168,349974.90,159985.80,509960.70
431470,201806,115,89,26,84214.54,24554.00,108768.54
431475,201806,11,10,1,9540.00,954,10494.00
431477,201806,37,25,12,23850.00,11448.00,35298.00
431478,201806,8,7,1,6678.00,954,7632.00
431480,201806,507,319,188,302780.52,179304.30,482084.82
431490,201806,28236,16082,12154,15268901.00,11559989.95,26828890.95
431500,201806,79,54,25,51197.66,23850.00,75047.66
431505,201806,37,22,15,20988.00,14310.00,35298.00
431507,201806,12,10,2,9540.00,1908.00,11448.00
431510,201806,273,182,91,173199.00,85831.38,259030.38
431513,201806,23,19,4,18126.00,3816.00,21942.00
431514,201806,9,8,1,7632.00,954,8586.00
431515,201806,80,67,13,63918.00,12402.00,76320.00
431517,201806,4,2,2,1908.00,1908.00,3816.00
431520,201806,37,33,4,31482.00,3816.00,35298.00
431530,201806,1593,715,878,681728.64,837188.09,1518916.73
431531,201806,23,21,2,20034.00,1908.00,21942.00
431532,201806,26,18,8,17172.00,7632.00,24804.00
431535,201806,26,16,10,15264.00,9540.00,24804.00
431540,201806,140,124,16,117275.22,15264.00,132539.22
431545,201806,17,15,2,14310.00,1908.00,16218.00
431550,201806,353,202,151,192421.80,143958.60,336380.40
431555,201806,13,12,1,11448.00,954,12402.00
431560,201806,4535,3198,1337,3020029.27,1273132.98,4293162.25
431570,201806,806,429,377,405164.20,356787.46,761951.66
431575,201806,36,25,11,23850.00,10494.00,34344.00
431580,201806,93,66,27,62010.00,25758.00,87768.00
431590,201806,135,113,22,106848.00,20988.00,127836.00
431595,201806,11,10,1,9540.00,954,10494.00
431600,201806,216,124,92,118296.00,87768.00,206064.00
431610,201806,128,93,35,87481.80,33390.00,120871.80
431620,201806,43,35,8,33390.00,7632.00,41022.00
431630,201806,140,116,24,110664.00,22896.00,133560.00
431640,201806,1349,837,512,793346.82,486140.14,1279486.96
431642,201806,39,36,3,33867.00,2862.00,36729.00
431643,201806,44,20,24,19080.00,22896.00,41976.00
431645,201806,301,173,128,165042.00,121825.80,286867.80
431647,201806,10,10,0,9540.00,0,9540.00
431650,201806,36,27,9,25758.00,8586.00,34344.00
431660,201806,289,187,102,176490.00,97308.00,273798.00
431670,201806,225,107,118,99454.50,112543.38,211997.88
431673,201806,3,3,0,2862.00,0,2862.00
431675,201806,30,25,5,23563.80,4770.00,28333.80
431680,201806,1116,804,312,762150.60,296551.44,1058702.04
431690,201806,4816,2934,1882,2776297.60,1791223.76,4567521.36
431695,201806,26,20,6,19080.00,5724.00,24804.00
431697,201806,0,0,0,0,0,0
431700,201806,178,137,41,130698.00,39114.00,169812.00
431710,201806,4023,1734,2289,1651842.20,2182000.60,3833842.80
431720,201806,1394,836,558,788082.62,531364.46,1319447.08
431725,201806,1,1,0,954,0,954
431730,201806,1196,813,383,768241.28,365382.00,1133623.28
431740,201806,1370,685,685,648872.72,651699.38,1300572.10
431750,201806,1864,1207,657,1141201.50,624841.92,1766043.42
431755,201806,7,6,1,5724.00,954,6678.00
431760,201806,1072,689,383,656924.40,365153.58,1022077.98
431770,201806,394,289,105,275029.46,100150.92,375180.38
431775,201806,28,21,7,20034.00,6678.00,26712.00
431780,201806,561,352,209,334691.82,199376.46,534068.28
431790,201806,157,119,38,112572.00,36204.30,148776.30
431795,201806,14,12,2,11448.00,1908.00,13356.00
431800,201806,3376,1770,1606,1675290.02,1526378.62,3201668.64
431805,201806,17,15,2,14310.00,1908.00,16218.00
431810,201806,614,411,203,389460.96,193528.98,582989.94
431820,201806,310,175,135,166950.00,127836.00,294786.00
431830,201806,2332,1413,919,1344381.57,875465.65,2219847.22
431840,201806,521,350,171,330276.40,161894.00,492170.40
431842,201806,34,28,6,26712.00,5724.00,32436.00
431843,201806,12,8,4,7632.00,3816.00,11448.00
431844,201806,14,12,2,11448.00,1908.00,13356.00
431845,201806,29,26,3,24804.00,2862.00,27666.00
431846,201806,27,23,4,21942.00,3816.00,25758.00
431848,201806,15,12,3,11448.00,2862.00,14310.00
431849,201806,9,7,2,6678.00,1908.00,8586.00
431850,201806,813,673,140,640529.51,133321.50,773851.01
431860,201806,107,75,32,71550.00,29574.00,101124.00
431861,201806,4,2,2,1908.00,1908.00,3816.00
431862,201806,52,34,18,32436.00,17172.00,49608.00
431870,201806,3454,2038,1416,1934898.76,1347825.94,3282724.70
431880,201806,958,700,258,661761.80,245178.00,906939.80
431890,201806,1299,804,495,761407.34,470623.00,1232030.34
431900,201806,180,127,53,121158.00,49770.18,170928.18
431910,201806,56,43,13,41022.00,12402.00,53424.00
431912,201806,35,19,16,18126.00,15264.00,33390.00
431915,201806,125,99,26,94446.00,24804.00,119250.00
431920,201806,145,106,39,100837.80,37206.00,138043.80
431930,201806,85,69,16,65110.50,15264.00,80374.50
431935,201806,4,3,1,2862.00,954,3816.00
431936,201806,13,12,1,11448.00,954,12402.00
431937,201806,18,13,5,12402.00,4770.00,17172.00
431940,201806,461,311,150,293927.40,141850.96,435778.36
431950,201806,486,308,178,291438.08,169660.44,461098.52
431960,201806,732,425,307,401264.02,292716.90,693980.92
431970,201806,73,64,9,61056.00,8586.00,69642.00
431971,201806,3,3,0,2862.00,0,2862.00
431973,201806,22,17,5,16218.00,4770.00,20988.00
431975,201806,7,6,1,5724.00,954,6678.00
431980,201806,205,129,76,122255.10,72504.00,194759.10
431990,201806,1223,656,567,624303.29,540872.00,1165175.29
432000,201806,1677,911,766,860455.24,727199.24,1587654.48
432010,201806,281,185,96,175192.56,91584.00,266776.56
432020,201806,171,137,34,130698.00,32426.46,163124.46
432023,201806,18,14,4,13356.00,3816.00,17172.00
432026,201806,67,61,6,58194.00,5724.00,63918.00
432030,201806,64,28,36,26712.00,34344.00,61056.00
432032,201806,21,18,3,17172.00,2862.00,20034.00
432035,201806,50,39,11,37206.00,10494.00,47700.00
432040,201806,103,71,32,67734.00,30528.00,98262.00
432045,201806,8,7,1,6678.00,954,7632.00
432050,201806,67,40,27,38160.00,25758.00,63918.00
432055,201806,102,73,29,69642.00,27666.00,97308.00
432057,201806,1,0,1,0,954,954
432060,201806,35,32,3,30528.00,2862.00,33390.00
432065,201806,29,26,3,24804.00,2862.00,27666.00
432067,201806,87,77,10,73438.92,9540.00,82978.92
432070,201806,411,306,105,290027.39,100141.92,390169.31
432080,201806,812,562,250,534278.86,238404.68,772683.54
432085,201806,16,12,4,11448.00,3816.00,15264.00
432090,201806,258,160,98,152640.00,93492.00,246132.00
432100,201806,179,119,60,113192.10,57240.00,170432.10
432110,201806,623,425,198,395767.44,187938.00,583705.44
432120,201806,957,580,377,552652.20,359572.14,912224.34
432130,201806,508,369,139,350690.40,131508.90,482199.30
432132,201806,25,22,3,20988.00,2862.00,23850.00
432135,201806,79,65,14,62010.00,13356.00,75366.00
432140,201806,269,213,56,202906.26,53424.00,256330.26
432143,201806,192,123,69,117342.00,65826.00,183168.00
432145,201806,271,190,81,180020.60,76987.80,257008.40
432146,201806,14,13,1,12402.00,954,13356.00
432147,201806,136,62,74,59148.00,70572.15,129720.15
432149,201806,18,13,5,12402.00,4770.00,17172.00
432150,201806,833,523,310,498693.96,293718.17,792412.13
432160,201806,1384,718,666,682626.70,634458.44,1317085.14
432162,201806,4,3,1,2862.00,954,3816.00
432163,201806,18,14,4,13356.00,3816.00,17172.00
432166,201806,120,90,30,86338.00,28620.00,114958.00
432170,201806,223,122,101,115435.00,96354.00,211789.00
432180,201806,520,318,202,300605.58,192422.00,493027.58
432183,201806,10,7,3,6678.00,2862.00,9540.00
432185,201806,82,71,11,67734.00,10494.00,78228.00
432190,201806,458,256,202,243832.86,192585.06,436417.92
432195,201806,85,73,12,69642.00,11448.00,81090.00
432200,201806,412,267,145,254718.00,138282.84,393000.84
432210,201806,121,78,43,72647.10,41022.00,113669.10
432215,201806,60,56,4,53424.00,3816.00,57240.00
432218,201806,20,19,1,18126.00,954,19080.00
432220,201806,684,343,341,326230.64,324806.74,651037.38
432225,201806,14,8,6,7155.00,5724.00,12879.00
432230,201806,145,87,58,82759.50,55332.00,138091.50
432232,201806,16,14,2,13356.00,1908.00,15264.00
432234,201806,4,3,1,2862.00,954,3816.00
432235,201806,2,2,0,1908.00,0,1908.00
432237,201806,29,16,13,15264.00,12402.00,27666.00
432240,201806,4279,2384,1895,2264917.91,1799973.12,4064891.03
432250,201806,1040,665,375,631740.26,357559.20,989299.46
432252,201806,42,34,8,31691.88,7632.00,39323.88
432253,201806,58,46,12,43884.00,11448.00,55332.00
432254,201806,24,11,13,10494.00,12402.00,22896.00
432255,201806,14,13,1,12402.00,954,13356.00
432260,201806,879,691,188,657507.34,178398.50,835905.84
432270,201806,231,168,63,160272.00,60102.00,220374.00
432280,201806,123,90,33,85383.80,31482.00,116865.80
432285,201806,1,1,0,954,0,954
432290,201806,70,63,7,57907.80,6678.00,64585.80
432300,201806,4648,2659,1989,2517474.26,1893731.40,4411205.66
432310,201806,116,93,23,88722.00,21942.00,110664.00
432320,201806,20,16,4,15216.30,3816.00,19032.30
432330,201806,17,12,5,11448.00,4770.00,16218.00
432335,201806,7,6,1,5724.00,954,6678.00
432340,201806,40,37,3,35298.00,2862.00,38160.00
432345,201806,97,69,28,65826.00,26712.00,92538.00
432350,201806,23,22,1,20988.00,954,21942.00
432360,201806,6,4,2,3816.00,1908.00,5724.00
432370,201806,25,25,0,23850.00,0,23850.00
432375,201806,38,33,5,31482.00,4770.00,36252.00
432377,201806,7,7,0,6678.00,0,6678.00
432380,201806,168,76,92,71836.20,87720.30,159556.50
500020,201806,247,137,110,130698.00,104338.98,235036.98
500025,201806,117,58,59,54378.00,56286.00,110664.00
500060,201806,1393,857,536,817005.60,510729.61,1327735.21
500070,201806,775,370,405,352629.00,386360.46,738989.46
500080,201806,132,102,30,97308.00,28620.00,125928.00
500085,201806,138,112,26,106562.00,23969.25,130531.25
500090,201806,335,160,175,152640.00,166950.00,319590.00
500100,201806,700,379,321,358800.13,305662.00,664462.13
500110,201806,2233,1007,1226,960351.46,1168781.60,2129133.06
500124,201806,311,178,133,169812.00,126595.80,296407.80
500150,201806,330,131,199,124965.00,189476.46,314441.46
500190,201806,527,363,164,345634.20,155970.00,501604.20
500200,201806,198,168,30,159929.00,28620.00,188549.00
500210,201806,1451,520,931,494911.39,887001.45,1381912.84
500215,201806,242,139,103,131648.42,98262.00,229910.42
500220,201806,781,507,274,483433.84,260638.46,744072.30
500230,201806,260,176,84,167188.50,79659.00,246847.50
500240,201806,700,487,213,463834.80,202915.80,666750.60
500260,201806,577,217,360,207018.00,343440.00,550458.00
500270,201806,28439,12107,16332,11520217.21,15564763.92,27084981.13
500280,201806,190,71,119,67734.00,113526.00,181260.00
500290,201806,1189,705,484,671536.00,461727.00,1133263.00
500295,201806,414,251,163,239454.00,155492.46,394946.46
500310,201806,63,20,43,19080.00,41022.00,60102.00
500315,201806,707,424,283,404486.46,269972.46,674458.92
500320,201806,3611,1820,1791,1733853.38,1707233.94,3441087.32
500325,201806,925,514,411,489879.00,391119.44,880998.44
500330,201806,1476,684,792,650314.28,755234.64,1405548.92
500345,201806,320,238,82,226089.20,78228.00,304317.20
500348,201806,243,143,100,136422.00,95381.46,231803.46
500350,201806,139,66,73,62964.00,69642.00,132606.00
500370,201806,5414,2435,2979,2315462.10,2839773.90,5155236.00
500375,201806,352,255,97,243005.84,92538.00,335543.84
500380,201806,593,338,255,322294.59,243260.46,565555.05
500390,201806,72,36,36,34344.00,34344.00,68688.00
500400,201806,217,146,71,139264.92,67725.00,206989.92
500410,201806,558,219,339,208880.15,323258.22,532138.37
500430,201806,547,382,165,364428.00,157410.00,521838.00
500440,201806,204,105,99,99397.43,94446.00,193843.43
500450,201806,403,173,230,164336.80,219410.46,383747.26
500460,201806,309,157,152,149768.46,145008.00,294776.46
500470,201806,443,345,98,327629.67,92529.00,420158.67
500480,201806,113,67,46,63918.00,43884.00,107802.00
500490,201806,106,41,65,39109.23,62010.00,101119.23
500500,201806,1428,504,924,478798.90,880914.87,1359713.77
500510,201806,48,38,10,36252.00,9531.00,45783.00
500515,201806,109,77,32,73458.00,30242.00,103700.00
500520,201806,345,192,153,182691.00,145672.00,328363.00
500525,201806,87,49,38,46746.00,35965.80,82711.80
500540,201806,906,382,524,364361.76,498885.84,863247.60
500560,201806,882,499,383,474307.04,365057.84,839364.88
500568,201806,1004,579,425,548804.62,405159.23,953963.85
500570,201806,1221,683,538,648112.04,510358.72,1158470.76
500580,201806,339,173,166,164746.26,158351.00,323097.26
500600,201806,312,158,154,150021.27,146898.00,296919.27
500620,201806,929,653,276,617471.64,263113.20,880584.84
500625,201806,80,68,12,64165.19,11448.00,75613.19
500627,201806,26,13,13,12402.00,12402.00,24804.00
500630,201806,1561,830,731,791143.46,697087.80,1488231.26
500635,201806,521,297,224,282918.24,213552.90,496471.14
500640,201806,428,224,204,211122.00,194597.46,405719.46
500660,201806,5529,2109,3420,2008524.13,3257978.32,5266502.45
500690,201806,570,205,365,195213.24,346522.25,541735.49
500710,201806,358,172,186,163802.00,177426.00,341228.00
500720,201806,981,572,409,544004.69,389976.92,933981.61
500730,201806,199,119,80,113526.00,76315.23,189841.23
500740,201806,840,369,471,350738.95,449055.75,799794.70
500750,201806,142,48,94,45792.00,89647.92,135439.92
500755,201806,125,90,35,85574.00,33390.00,118964.00
500769,201806,746,427,319,407022.27,304313.00,711335.27
500770,201806,434,230,204,219410.46,194606.46,414016.92
500780,201806,171,114,57,108756.00,54378.00,163134.00
500790,201806,1034,516,518,491759.25,494131.46,985890.71
500793,201806,255,139,116,132606.00,110655.00,243261.00
500795,201806,177,126,51,120194.46,48645.00,168839.46
500797,201806,41,31,10,29574.00,9540.00,39114.00
500800,201806,410,178,232,169803.00,221041.80,390844.80
500830,201806,2215,1238,977,1177304.12,931018.68,2108322.80
500840,201806,140,105,35,100170.00,33381.00,133551.00
510010,201806,165,91,74,86804.46,70567.38,157371.84
510020,201806,490,230,260,219126.06,247503.96,466630.02
510025,201806,1681,955,726,910200.13,690077.08,1600277.21
510030,201806,674,350,324,333853.92,308326.69,642180.61
510035,201806,128,58,70,55304.46,66761.46,122065.92
510040,201806,387,174,213,165996.00,202755.26,368751.26
510050,201806,426,234,192,222485.66,182344.46,404830.12
510060,201806,114,57,57,54368.46,54368.46,108736.92
510080,201806,221,90,131,85827.69,124860.06,210687.75
510100,201806,76,34,42,32436.00,40048.92,72484.92
510120,201806,38,23,15,21942.00,14310.00,36252.00
510125,201806,393,241,152,229231.89,144984.92,374216.81
510130,201806,570,330,240,314414.81,228536.64,542951.45
510140,201806,392,129,263,123057.00,250897.23,373954.23
510160,201806,92,41,51,39114.00,48650.00,87764.00
510170,201806,868,526,342,501529.05,325635.38,827164.43
510180,201806,2868,1398,1470,1330697.18,1400465.86,2731163.04
510185,201806,11,6,5,5724.00,4770.00,10494.00
510190,201806,213,71,142,67734.00,135463.23,203197.23
510250,201806,2609,1539,1070,1467146.53,1019647.10,2486793.63
510260,201806,201,145,56,138147.84,53387.46,191535.30
510263,201806,452,248,204,235588.58,193860.59,429449.17
510267,201806,669,375,294,356241.76,280195.91,636437.67
510268,201806,55,29,26,27666.00,24804.00,52470.00
510269,201806,68,30,38,28611.00,36252.00,64863.00
510270,201806,407,206,201,196345.98,191327.94,387673.92
510279,201806,233,172,61,164061.00,57888.92,221949.92
510285,201806,168,73,95,69623.46,90630.00,160253.46
510300,201806,533,293,240,279090.14,228885.84,507975.98
510305,201806,210,99,111,94423.46,105818.22,200241.68
510310,201806,113,58,55,55332.00,52460.46,107792.46
510320,201806,873,546,327,520316.18,311808.38,832124.56
510325,201806,414,166,248,158354.46,236296.26,394650.72
510330,201806,425,238,187,227039.00,178378.92,405417.92
510335,201806,594,325,269,310003.38,255809.78,565813.16
510336,201806,48,35,13,33390.00,12402.00,45792.00
510337,201806,121,50,71,47690.46,67724.46,115414.92
510340,201806,17289,8279,9010,7876229.64,8585792.52,16462022.16
510343,201806,73,52,21,49598.46,20034.00,69632.46
510345,201806,159,106,53,101114.46,50256.92,151371.38
510350,201806,672,373,299,354900.07,285181.38,640081.45
510360,201806,199,117,82,111609.00,78145.92,189754.92
510370,201806,142,72,70,68659.38,66648.60,135307.98
510380,201806,90,63,27,60102.00,25749.00,85851.00
510385,201806,58,27,31,25758.00,29565.00,55323.00
510390,201806,122,52,70,49608.00,66741.84,116349.84
510395,201806,40,29,11,27666.00,10494.00,38160.00
510410,201806,706,471,235,449330.00,224166.69,673496.69
510420,201806,589,286,303,271898.80,287670.61,559569.41
510450,201806,52,30,22,28620.00,20988.00,49608.00
510452,201806,42,25,17,23850.00,16218.00,40068.00
510454,201806,59,26,33,24804.00,31472.46,56276.46
510455,201806,127,80,47,76300.92,44838.00,121138.92
510460,201806,186,100,86,95219.92,82006.38,177226.30
510480,201806,750,431,319,410047.81,303988.36,714036.17
510490,201806,359,184,175,175166.34,166464.16,341630.50
510500,201806,253,193,60,184112.46,57240.00,241352.46
510510,201806,796,456,340,434424.26,324350.46,758774.72
510515,201806,1151,614,537,585396.38,512251.38,1097647.76
510517,201806,247,105,142,99883.80,135444.69,235328.49
510520,201806,237,155,82,147776.76,77917.84,225694.60
510523,201806,93,66,27,62964.00,25748.46,88712.46
510525,201806,737,418,319,398017.84,304224.30,702242.14
510530,201806,15,11,4,10494.00,3816.00,14310.00
510550,201806,268,118,150,112563.00,143091.00,255654.00
510558,201806,270,134,136,127803.15,129715.92,257519.07
510560,201806,397,244,153,232490.00,145944.00,378434.00
510562,201806,636,446,190,424153.17,180773.46,604926.63
510590,201806,808,419,389,399669.84,371078.69,770748.53
510600,201806,259,142,117,135444.92,111580.92,247025.84
510610,201806,169,82,87,78208.92,82702.46,160911.38
510615,201806,198,83,115,79162.92,109710.00,188872.92
510617,201806,18,10,8,9540.00,7632.00,17172.00
510618,201806,117,54,63,51516.00,59625.00,111141.00
510619,201806,102,72,30,68679.00,28611.00,97290.00
510620,201806,183,101,82,96344.46,78228.00,174572.46
510621,201806,199,126,73,120185.46,69614.46,189799.92
510622,201806,453,291,162,277521.84,154224.38,431746.22
510623,201806,349,234,115,223179.84,109681.38,332861.22
510624,201806,88,44,44,41967.00,41976.00,83943.00
510625,201806,534,330,204,314619.30,194038.52,508657.82
510626,201806,106,68,38,64872.00,36252.00,101124.00
510627,201806,60,42,18,40068.00,17172.00,57240.00
510628,201806,164,100,64,95353.92,60998.76,156352.68
510629,201806,257,164,93,156456.00,87758.46,244214.46
510630,201806,467,237,230,226013.22,219073.95,445087.17
510631,201806,11,3,8,2862.00,7346.00,10208.00
510637,201806,343,192,151,182822.18,143916.84,326739.02
510642,201806,978,545,433,519588.18,412939.44,932527.62
510645,201806,0,0,0,0,0,0
510650,201806,1478,978,500,932867.92,476868.76,1409736.68
510665,201806,85,43,42,40966.00,40068.00,81034.00
510670,201806,65,37,28,35298.00,26712.00,62010.00
510675,201806,1166,700,466,667768.23,444541.23,1112309.46
510677,201806,356,175,181,165944.84,172544.22,338489.06
510680,201806,106,61,45,58176.00,42921.00,101097.00
510682,201806,200,96,104,91262.00,99216.00,190478.00
510685,201806,52,37,15,35298.00,14310.00,49608.00
510700,201806,620,359,261,342367.92,248860.76,591228.68
510704,201806,1081,585,496,555700.62,471608.36,1027308.98
510706,201806,129,64,65,61051.23,61972.92,123024.15
510710,201806,391,267,124,253728.24,118181.68,371909.92
510715,201806,65,47,18,44828.46,17172.00,62000.46
510718,201806,213,116,97,110570.76,92519.46,203090.22
510719,201806,36,19,17,18126.00,16218.00,34344.00
510720,201806,197,132,65,125919.00,61723.80,187642.80
510724,201806,90,36,54,34334.46,51483.38,85817.84
510726,201806,54,28,26,26702.46,24786.00,51488.46
510729,201806,75,34,41,32436.00,39075.84,71511.84
510730,201806,472,267,205,254700.00,195422.46,450122.46
510735,201806,109,42,67,40068.00,63918.00,103986.00
510740,201806,31,18,13,17172.00,12402.00,29574.00
510757,201806,20,16,4,15264.00,3816.00,19080.00
510760,201806,7050,3724,3326,3543147.37,3167723.11,6710870.48
510770,201806,715,341,374,325125.30,356601.30,681726.60
510774,201806,15,6,9,5724.00,8586.00,14310.00
510775,201806,112,84,28,80126.46,26702.46,106828.92
510776,201806,28,7,21,6678.00,20034.00,26712.00
510777,201806,185,81,104,77245.38,99187.38,176432.76
510779,201806,51,23,28,21933.00,26674.92,48607.92
510780,201806,294,165,129,157347.46,123001.00,280348.46
510785,201806,444,240,204,228903.30,194549.22,423452.52
510787,201806,191,96,95,91575.00,90612.23,182187.23
510788,201806,0,0,0,0,0,0
510790,201806,2418,1259,1159,1199205.40,1103668.74,2302874.14
510792,201806,1088,616,472,586881.47,449872.34,1036753.81
510794,201806,117,59,58,56286.00,55303.92,111589.92
510795,201806,2393,1387,1006,1316378.11,957060.80,2273438.91
510800,201806,187,113,74,107792.46,70587.00,178379.46
510805,201806,171,117,54,111618.00,51516.00,163134.00
510810,201806,97,40,57,38077.38,54253.98,92331.36
510820,201806,256,119,137,113099.46,129698.03,242797.49
510830,201806,66,40,26,38160.00,24795.00,62955.00
510835,201806,7,5,2,4770.00,1908.00,6678.00
510840,201806,9269,4574,4695,4348881.65,4471643.92,8820525.57
510850,201806,215,89,126,84896.46,120034.54,204931.00
510860,201806,384,167,217,159131.52,206346.88,365478.40
510880,201806,68,51,17,48635.46,16218.00,64853.46
510885,201806,71,43,28,41003.46,26683.38,67686.84
510890,201806,70,40,30,38160.00,28620.00,66780.00
510895,201806,184,108,76,103032.00,72195.46,175227.46
520005,201806,34,23,11,21942.00,10494.00,32436.00
520010,201806,275,122,153,116388.00,145867.00,262255.00
520013,201806,641,389,252,371078.00,240121.80,611199.80
520015,201806,51,37,14,35298.00,13356.00,48654.00
520017,201806,102,58,44,55046.00,41976.00,97022.00
520020,201806,25,13,12,12402.00,11448.00,23850.00
520025,201806,2008,1089,919,1037723.24,875286.40,1913009.64
520030,201806,792,408,384,388269.00,365715.90,753984.90
520050,201806,77,52,25,49608.00,23850.00,73458.00
520055,201806,44,30,14,28620.00,13356.00,41976.00
520060,201806,177,113,64,107802.00,61056.00,168858.00
520080,201806,600,421,179,401634.00,170766.00,572400.00
520082,201806,20,14,6,13356.00,5724.00,19080.00
520085,201806,102,74,28,70596.00,26712.00,97308.00
520090,201806,90,62,28,59148.00,26712.00,85860.00
520110,201806,9060,3937,5123,3750766.16,4884701.84,8635468.00
520120,201806,14,8,6,7431.66,5724.00,13155.66
520130,201806,765,531,234,506278.80,222941.00,729219.80
520140,201806,11744,6641,5103,6328261.40,4865900.23,11194161.63
520145,201806,45,34,11,32436.00,10494.00,42930.00
520150,201806,189,147,42,140238.00,40068.00,180306.00
520160,201806,30,23,7,21942.00,6678.00,28620.00
520170,201806,231,143,88,136390.00,83915.00,220305.00
520180,201806,126,66,60,62964.00,57240.00,120204.00
520215,201806,220,135,85,128503.80,80803.80,209307.60
520235,201806,70,53,17,50562.00,16218.00,66780.00
520250,201806,134,80,54,76320.00,51229.80,127549.80
520260,201806,111,68,43,64872.00,40068.00,104940.00
520280,201806,46,32,14,29861.00,13356.00,43217.00
520310,201806,37,25,12,23850.00,11448.00,35298.00
520320,201806,167,106,61,101114.46,58194.00,159308.46
520330,201806,784,412,372,393002.46,354861.00,747863.46
520340,201806,348,197,151,187938.00,144035.46,331973.46
520350,201806,524,238,286,227052.00,272797.00,499849.00
520355,201806,86,51,35,48654.00,33390.00,82044.00
520357,201806,25,18,7,17172.00,6678.00,23850.00
520360,201806,0,0,0,0,0,0
520380,201806,141,72,69,68688.00,65826.00,134514.00
520390,201806,282,118,164,112095.00,156193.50,268288.50
520393,201806,14,11,3,10494.00,2862.00,13356.00
520396,201806,99,59,40,56286.00,38160.00,94446.00
520400,201806,222,131,91,123353.20,86814.00,210167.20
520410,201806,199,101,98,96345.00,93483.00,189828.00
520420,201806,22,15,7,14310.00,6678.00,20988.00
520425,201806,298,130,168,123067.00,159796.20,282863.20
520430,201806,462,239,223,227719.80,212686.00,440405.80
520440,201806,610,413,197,394002.00,187918.92,581920.92
520450,201806,1928,866,1062,825335.46,1012215.78,1837551.24
520455,201806,59,42,17,40068.00,16218.00,56286.00
520460,201806,32,16,16,15264.00,15264.00,30528.00
520465,201806,25,21,4,20034.00,3816.00,23850.00
520470,201806,419,257,162,244872.63,154548.00,399420.63
520480,201806,80,46,34,43884.00,32391.00,76275.00
520485,201806,123,42,81,40068.00,76988.00,117056.00
520490,201806,409,298,111,284107.98,105894.00,390001.98
520495,201806,172,105,67,100170.00,63918.00,164088.00
520500,201806,173,130,43,124020.00,41022.00,165042.00
520505,201806,176,90,86,85855.23,82044.00,167899.23
520510,201806,1766,875,891,831415.28,847786.56,1679201.84
520520,201806,34,27,7,25758.00,6678.00,32436.00
520530,201806,228,170,58,160456.12,55322.46,215778.58
520540,201806,526,353,173,335455.02,165042.00,500497.02
520545,201806,156,89,67,84906.00,63918.00,148824.00
520547,201806,54,30,24,28620.00,22896.00,51516.00
520549,201806,1133,551,582,525330.00,555110.00,1080440.00
520551,201806,296,154,142,146916.00,135182.00,282098.00
520552,201806,45,26,19,24804.00,18126.00,42930.00
520570,201806,16,9,7,8586.00,6678.00,15264.00
520580,201806,284,171,113,163124.46,107802.00,270926.46
520590,201806,164,101,63,96354.00,59815.80,156169.80
520620,201806,1175,550,625,523842.48,595668.26,1119510.74
520630,201806,43,26,17,24804.00,16218.00,41022.00
520640,201806,412,234,178,223236.00,169812.00,393048.00
520650,201806,60,40,20,38160.00,19080.00,57240.00
520660,201806,36,19,17,18117.00,16218.00,34335.00
520670,201806,34,29,5,27666.00,4770.00,32436.00
520680,201806,57,37,20,35298.00,19080.00,54378.00
520690,201806,33,10,23,9540.00,21913.92,31453.92
520710,201806,40,36,4,34344.00,3816.00,38160.00
520725,201806,198,127,71,121158.00,67734.00,188892.00
520735,201806,60,42,18,40068.00,17172.00,57240.00
520740,201806,407,201,206,191039.40,196515.00,387554.40
520750,201806,37,27,10,25758.00,9540.00,35298.00
520753,201806,55,37,18,35298.00,17172.00,52470.00
520760,201806,111,75,36,71550.00,34344.00,105894.00
520780,201806,289,219,70,208926.00,66780.00,275706.00
520790,201806,163,82,81,77941.80,77274.00,155215.80
520800,201806,3460,1845,1615,1757638.06,1540032.90,3297670.96
520810,201806,172,125,47,119250.00,44838.00,164088.00
520815,201806,5,5,0,4770.00,0,4770.00
520830,201806,138,92,46,87768.00,43597.80,131365.80
520840,201806,348,230,118,218943.00,112572.00,331515.00
520850,201806,113,72,41,68669.46,38961.36,107630.82
520860,201806,1687,1079,608,1027945.54,578888.20,1606833.74
520870,201806,30850,15192,15658,14465790.72,14922425.36,29388216.08
520880,201806,1075,588,487,560952.00,464578.92,1025530.92
520890,201806,802,466,336,442933.40,320439.46,763372.86
520910,201806,1024,543,481,513777.94,458874.00,972651.94
520915,201806,102,77,25,73458.00,23840.46,97298.46
520920,201806,410,199,211,189273.60,201284.46,390558.06
520929,201806,16,15,1,14310.00,954,15264.00
520940,201806,75,48,27,45792.00,25758.00,71550.00
520945,201806,21,13,8,12402.00,7632.00,20034.00
520960,201806,45,29,16,27666.00,15264.00,42930.00
520970,201806,323,202,121,192079.00,115147.80,307226.80
520980,201806,84,64,20,61056.00,19080.00,80136.00
520990,201806,479,322,157,307188.00,149778.00,456966.00
520993,201806,129,62,67,59148.00,63918.00,123066.00
520995,201806,242,135,107,127837.00,101506.00,229343.00
521000,201806,1569,918,651,873769.60,620673.00,1494442.60
521010,201806,672,313,359,298275.36,342429.30,640704.66
521015,201806,17,10,7,9540.00,6678.00,16218.00
521020,201806,1461,1022,439,973691.10,418444.22,1392135.32
521030,201806,47,34,13,32436.00,12402.00,44838.00
521040,201806,942,579,363,552128.20,346016.00,898144.20
521056,201806,41,29,12,27666.00,11448.00,39114.00
521060,201806,132,83,49,79182.00,46746.00,125928.00
521080,201806,464,348,116,331983.00,110664.00,442647.00
521090,201806,529,319,210,302699.43,200340.00,503039.43
521100,201806,281,209,72,199377.00,68688.00,268065.00
521120,201806,1051,727,324,692985.80,308801.00,1001786.80
521130,201806,362,259,103,247076.46,97376.60,344453.06
521140,201806,186,106,80,101124.00,76320.00,177444.00
521150,201806,2800,1217,1583,1159436.88,1508887.49,2668324.37
521160,201806,32,16,16,15264.00,15264.00,30528.00
521170,201806,192,113,79,107792.46,75366.00,183158.46
521180,201806,1136,717,419,682387.26,399011.20,1081398.46
521190,201806,2534,1076,1458,1026484.92,1390054.72,2416539.64
521200,201806,47,34,13,32436.00,12402.00,44838.00
521205,201806,12,9,3,8586.00,2862.00,11448.00
521210,201806,145,83,62,79182.00,59148.00,138330.00
521220,201806,822,564,258,535423.76,246076.00,781499.76
521225,201806,32,21,11,20034.00,10494.00,30528.00
521230,201806,109,72,37,68401.80,35298.00,103699.80
521250,201806,6239,3583,2656,3411665.70,2531231.26,5942896.96
521260,201806,23,15,8,14310.00,7632.00,21942.00
521270,201806,142,110,32,104940.00,30528.00,135468.00
521280,201806,437,260,177,247372.20,168858.00,416230.20
521290,201806,32,12,20,11448.00,19080.00,30528.00
521295,201806,98,66,32,62735.04,30528.00,93263.04
521300,201806,225,115,110,109692.00,104589.38,214281.38
521305,201806,35,23,12,21942.00,11448.00,33390.00
521308,201806,1092,807,285,769627.68,271595.00,1041222.68
521310,201806,1353,797,556,759062.40,529232.92,1288295.32
521340,201806,18,15,3,14310.00,2862.00,17172.00
521350,201806,131,96,35,91584.00,33390.00,124974.00
521370,201806,189,123,66,117055.20,62677.80,179733.00
521375,201806,189,106,83,101124.00,78895.80,180019.80
521377,201806,52,35,17,33390.00,16218.00,49608.00
521380,201806,1101,718,383,680824.22,365382.00,1046206.22
521385,201806,15,8,7,7632.00,6678.00,14310.00
521390,201806,107,85,22,80772.04,20988.00,101760.04
521400,201806,325,208,117,198145.80,111570.30,309716.10
521405,201806,149,78,71,74412.00,67734.00,142146.00
521410,201806,63,42,21,40068.00,20034.00,60102.00
521440,201806,204,145,59,137519.10,56286.00,193805.10
521450,201806,719,396,323,377784.00,308142.00,685926.00
521460,201806,1190,735,455,700903.80,434050.92,1134954.72
521470,201806,14,9,5,8586.00,4770.00,13356.00
521480,201806,47,32,15,30501.00,14245.00,44746.00
521483,201806,315,171,144,162848.00,137376.00,300224.00
521486,201806,284,182,102,172836.18,96641.00,269477.18
521487,201806,21,10,11,9540.00,10494.00,20034.00
521490,201806,27,16,11,15264.00,10494.00,25758.00
521500,201806,120,78,42,74412.00,40068.00,114480.00
521520,201806,41,30,11,28620.00,10494.00,39114.00
521523,201806,616,380,236,359203.32,225144.00,584347.32
521525,201806,45,30,15,28620.00,14023.80,42643.80
521530,201806,248,132,116,125928.00,110664.00,236592.00
521540,201806,31,17,14,16218.00,13356.00,29574.00
521550,201806,90,42,48,39753.92,45736.92,85490.84
521560,201806,801,547,254,521552.00,242173.00,763725.00
521565,201806,53,36,17,34344.00,16218.00,50562.00
521570,201806,501,335,166,319580.46,158269.30,477849.76
521580,201806,60,37,23,35298.00,21942.00,57240.00
521590,201806,37,20,17,19080.00,16218.00,35298.00
521600,201806,28,16,12,15264.00,11448.00,26712.00
521630,201806,242,123,119,117332.46,112535.96,229868.42
521640,201806,302,154,148,146916.00,141192.00,288108.00
521645,201806,30,16,14,15264.00,13356.00,28620.00
521680,201806,222,141,81,134514.00,77274.00,211788.00
521690,201806,2,2,0,1908.00,0,1908.00
521710,201806,1191,557,634,530805.80,604540.80,1135346.60
521720,201806,540,367,173,350108.46,165004.46,515112.92
521730,201806,631,307,324,292878.00,307989.56,600867.56
521740,201806,917,372,545,354859.92,518739.32,873599.24
521760,201806,1623,895,728,852252.63,694198.00,1546450.63
521770,201806,808,513,295,489402.00,280962.54,770364.54
521800,201806,2069,1287,782,1223714.88,744476.68,1968191.56
521805,201806,34,19,15,18126.00,14310.00,32436.00
521810,201806,92,58,34,54187.80,32436.00,86623.80
521830,201806,957,679,278,645572.22,265203.00,910775.22
521839,201806,91,60,31,57240.00,29574.00,86814.00
521850,201806,1126,597,529,568118.92,504341.68,1072460.60
521860,201806,344,210,134,200340.00,127550.00,327890.00
521870,201806,73,42,31,40068.00,29574.00,69642.00
521878,201806,42,20,22,19080.00,20988.00,40068.00
521880,201806,4574,2063,2511,1965811.36,2393984.96,4359796.32
521890,201806,591,416,175,396864.00,166663.80,563527.80
521900,201806,293,236,57,224507.96,54378.00,278885.96
521910,201806,150,104,46,99216.00,43884.00,143100.00
521920,201806,54,27,27,25758.00,25758.00,51516.00
521925,201806,36,21,15,20034.00,14310.00,34344.00
521930,201806,1126,641,485,611317.98,461769.68,1073087.66
521935,201806,34,26,8,24804.00,7632.00,32436.00
521940,201806,191,96,95,91584.00,90625.23,182209.23
521945,201806,14,12,2,11448.00,1908.00,13356.00
521950,201806,9,5,4,4770.00,3816.00,8586.00
521960,201806,76,56,20,53424.00,19080.00,72504.00
521970,201806,420,269,151,256339.80,144054.00,400393.80
521971,201806,96,49,47,46746.00,44838.00,91584.00
521973,201806,28,13,15,12402.00,14310.00,26712.00
521975,201806,1160,588,572,560664.59,544772.66,1105437.25
521980,201806,243,167,76,159318.00,72504.00,231822.00
521990,201806,73,53,20,50562.00,19080.00,69642.00
522000,201806,286,180,106,171720.00,101124.00,272844.00
522005,201806,20,12,8,11448.00,7632.00,19080.00
522010,201806,1143,639,504,609597.00,480243.60,1089840.60
522015,201806,54,33,21,31473.00,20034.00,51507.00
522020,201806,859,464,395,441702.20,376048.12,817750.32
522026,201806,29,21,8,20034.00,7632.00,27666.00
522028,201806,16,12,4,11448.00,3816.00,15264.00
522040,201806,747,294,453,280458.00,432107.46,712565.46
522045,201806,2133,1352,781,1289058.26,744540.80,2033599.06
522050,201806,167,81,86,77274.00,82044.00,159318.00
522060,201806,558,351,207,334567.80,197382.60,531950.40
522068,201806,133,88,45,83665.80,42930.00,126595.80
522070,201806,11,11,0,10494.00,0,10494.00
522100,201806,47,26,21,24536.88,20034.00,44570.88
522108,201806,38,29,9,27666.00,8586.00,36252.00
522119,201806,55,29,26,27666.00,24804.00,52470.00
522130,201806,74,27,47,25749.00,44820.00,70569.00
522140,201806,3745,1896,1849,1804297.28,1761791.44,3566088.72
522145,201806,51,31,20,29574.00,19080.00,48654.00
522150,201806,65,51,14,48654.00,13356.00,62010.00
522155,201806,59,40,19,38151.00,18126.00,56277.00
522157,201806,4,3,1,2862.00,954,3816.00
522160,201806,1733,1011,722,963349.20,688492.80,1651842.00
522170,201806,392,263,129,250902.00,123066.00,373968.00
522180,201806,37,20,17,19080.00,16218.00,35298.00
522185,201806,1944,753,1191,715055.26,1135693.00,1850748.26
522190,201806,48,27,21,25758.00,19938.60,45696.60
522200,201806,295,178,117,169812.00,111618.00,281430.00
522205,201806,167,112,55,106848.00,52470.00,159318.00
522220,201806,162,116,46,110664.00,43884.00,154548.00
522230,201806,31,25,6,23850.00,5724.00,29574.00
530010,201806,55619,28556,27063,27104219.19,25765720.32,52869939.51
110001,201807,522,412,110,392084.46,104294.96,496379.42
110002,201807,2781,1688,1093,1609083.88,1041824.49,2650908.37
110003,201807,95,75,20,71550,19080,90630
110004,201807,2011,1298,713,1235412.9,679906.26,1915319.16
110005,201807,442,354,88,336560.9,83952,420512.9
110006,201807,452,349,103,332659.8,98242.92,430902.72
110007,201807,82,65,17,62010,16218,78228
110008,201807,240,134,106,126600.9,101124,227724.9
110009,201807,797,549,248,521838.86,236393,758231.86
110010,201807,1815,1119,696,1066390.52,663680.21,1730070.73
110011,201807,1865,1441,424,1373203.2,404486.46,1777689.66
110012,201807,4134,2399,1735,2283265.31,1654099.12,3937364.43
110013,201807,767,587,180,559988.46,171720,731708.46
110014,201807,376,322,54,307188,51516,358704
110015,201807,1432,1157,275,1100759.13,262044.72,1362803.85
110018,201807,1114,667,447,636004,426425.23,1062429.23
110020,201807,15410,9039,6371,8578066.01,6068795.19,14646861.20
110025,201807,655,484,171,459738.11,163125,622863.11
110026,201807,41,28,13,26712,12402,39114
110028,201807,1645,1194,451,1134474.59,426946.95,1561421.54
110029,201807,140,124,16,118296,15264,133560
110030,201807,2481,1676,805,1596160.81,767069.46,2363230.27
110032,201807,387,302,85,287799,81086,368885
110033,201807,680,506,174,479721,165709.8,645430.8
110034,201807,369,270,99,255268,93779,349047
110037,201807,104,87,17,82998,16218,99216
110040,201807,342,232,110,221328,104940,326268
110045,201807,949,642,307,610657,291174.39,901831.39
110050,201807,96,79,17,75366,16218,91584
110060,201807,86,46,40,43884,38160,82044
110070,201807,121,73,48,69642,45506,115148
110080,201807,406,247,159,233415.18,151662.15,385077.33
110090,201807,35,28,7,26712,6678,33390
110092,201807,109,61,48,58194,45722,103916
110094,201807,196,141,55,134514,52470,186984
110100,201807,29,23,6,21942,5724,27666
110110,201807,68,41,27,39114,25758,64872
110120,201807,72,59,13,56286,12402,68688
110130,201807,299,241,58,228439.12,55332,283771.12
110140,201807,243,158,85,150541.2,81080.46,231621.66
110143,201807,52,44,8,41976,7632,49608
110145,201807,26,20,6,19080,5724,24804
110146,201807,24,12,12,11448,11448,22896
110147,201807,38,30,8,28620,7632,36252
110148,201807,39,27,12,25706.57,11448,37154.57
110149,201807,297,213,84,202915.8,80136,283051.8
110150,201807,84,58,26,55332,24804,80136
110155,201807,8,7,1,6678,954,7632
110160,201807,70,59,11,56286,10494,66780
110170,201807,203,165,38,157410,36252,193662
110175,201807,43,31,12,29574,11448,41022
110180,201807,93,81,12,77274,11448,88722
120001,201807,136,93,43,88680,40993,129673
120005,201807,192,120,72,114437.12,68688,183125.12
120010,201807,1041,670,371,632488.54,352007.72,984496.26
120013,201807,146,102,44,97101.54,41785.2,138886.74
120017,201807,93,58,35,55245.36,33347.12,88592.48
120020,201807,3571,2854,717,2696224.84,681606.35,3377831.19
120025,201807,588,333,255,315208.1,242209.6,557417.7
120030,201807,1044,875,169,826742.34,160511,987253.34
120032,201807,49,41,8,39114,7632,46746
120033,201807,218,190,28,180912.75,26712,207624.75
120034,201807,156,113,43,105894,41000.12,146894.12
120035,201807,29,21,8,20034,7632,27666
120038,201807,387,250,137,237696.88,130654.24,368351.12
120039,201807,21,20,1,19080,954,20034
120040,201807,14095,9779,4316,9245059.81,4097297.77,13342357.58
120042,201807,46,40,6,38160,5724,43884
120043,201807,12,3,9,2862,8586,11448
120045,201807,541,350,191,331991.78,180880.06,512871.84
120050,201807,1266,963,303,912282.04,289014.35,1201296.39
120060,201807,1422,1156,266,1098943.24,252810,1351753.24
120070,201807,503,359,144,339213.4,136957.78,476171.18
120080,201807,169,106,63,100441.42,59732.22,160173.64
130002,201807,150,105,45,100170,42930,143100
130006,201807,74,41,33,39114,31482,70596
130008,201807,142,77,65,72737.72,61331.72,134069.44
130010,201807,139,75,64,71528.12,61056,132584.12
130014,201807,247,178,69,169812,65826,235638
130020,201807,94,50,44,47700,41976,89676
130030,201807,900,550,350,524700,333890.46,858590.46
130040,201807,323,163,160,155502,151686.28,307188.28
130050,201807,567,309,258,294499.8,246132,540631.8
130060,201807,878,601,277,568226.2,261854.72,830080.92
130063,201807,577,322,255,307188,243204.36,550392.36
130068,201807,186,122,64,116388,60769.8,177157.8
130070,201807,1328,919,409,863114.61,385331.52,1248446.13
130080,201807,666,437,229,416516.4,218457,634973.4
130083,201807,71,38,33,35988,31482,67470
130090,201807,373,193,180,182442.96,171720,354162.96
130100,201807,1129,511,618,487494,589285.8,1076779.8
130110,201807,702,311,391,296544,373014,669558
130115,201807,175,72,103,68688,98262,166950
130120,201807,1630,1018,612,971172,583848,1555020
130130,201807,633,435,198,414990,188892,603882
130140,201807,1508,1136,372,1083102.9,353934.2,1437037.1
130150,201807,422,358,64,341532,61056,402588
130160,201807,465,262,203,249948,193662,443610
130165,201807,26,19,7,18126,6678,24804
130170,201807,926,659,267,628615.4,254718,883333.4
130180,201807,149,91,58,86814,55332,142146
130185,201807,2305,1208,1097,1150524,1045946.92,2196470.92
130190,201807,3628,2267,1361,2157250.48,1297091.99,3454342.47
130195,201807,290,232,58,221328,55332,276660
130200,201807,175,81,94,77264.46,89676,166940.46
130210,201807,78,40,38,38160,36252,74412
130220,201807,184,127,57,121158,54378,175536
130230,201807,332,208,124,198432,118296,316728
130240,201807,1440,913,527,869662.4,502180.83,1371843.23
130250,201807,4778,3091,1687,2941760.51,1609264.57,4551025.08
130255,201807,426,208,218,198432,207685.8,406117.8
130260,201807,54079,26029,28050,24795812.42,26753020.92,51548833.34
130270,201807,1515,982,533,936351,508482,1444833
130280,201807,115,71,44,67734,41976,109710
130290,201807,2102,1523,579,1452942,552079.8,2005021.8
130300,201807,433,308,125,293545.8,119250,412795.8
130310,201807,883,460,423,438840,403542,842382
130320,201807,452,238,214,226098,204156,430254
130330,201807,702,422,280,402588,266833.8,669421.8
130340,201807,3322,1981,1341,1885581.4,1277597,3163178.4
130350,201807,467,300,167,286178.12,159318,445496.12
130353,201807,811,338,473,322166,451242,773408
130356,201807,794,363,431,346302,410887.8,757189.8
130360,201807,68,41,27,39114,25758,64872
130370,201807,684,509,175,485586,166950,652536
130380,201807,611,422,189,402588,180306,582894
130390,201807,490,389,101,371106,96354,467460
130395,201807,182,40,142,38160,135468,173628
130400,201807,70,45,25,42930,23850,66780
130406,201807,2085,1299,786,1235632.3,748612.76,1984245.06
130410,201807,501,214,287,204156,273778.92,477934.92
130420,201807,3176,2561,615,2439407.32,586710,3026117.32
130423,201807,161,74,87,70596,82998,153594
130426,201807,145,86,59,82044,56286,138330
130430,201807,406,270,136,257580,129744,387324
130440,201807,204,69,135,65826,128790,194616
140002,201807,35,14,21,13356,20034,33390
140005,201807,207,127,80,120919.5,76320,197239.5
140010,201807,10287,6934,3353,6578539.95,3196440.63,9774980.58
140015,201807,153,67,86,63918,82044,145962
140017,201807,118,79,39,75366,37206,112572
140020,201807,480,319,161,303372,153594,456966
140023,201807,32,18,14,16953,13356,30309
140028,201807,17,12,5,11448,4770,16218
140030,201807,350,251,99,239454,94446,333900
140040,201807,54,38,16,36252,15168.6,51420.6
140045,201807,246,113,133,107134.2,126882,234016.2
140047,201807,583,406,177,385312.39,168095,553407.39
140050,201807,150,97,53,91725,50562,142287
140060,201807,36,25,11,23115.42,10494,33609.42
140070,201807,32,29,3,27666,2862,30528
150010,201807,4710,2928,1782,2791404.4,1697528.29,4488932.69
150013,201807,151,106,45,101124,42930,144054
150020,201807,1054,568,486,541872,463644,1005516
150030,201807,718,294,424,280476,404496,684972
150034,201807,197,125,72,119250,68688,187938
150040,201807,1401,842,559,803268,533286,1336554
150050,201807,690,414,276,393954.8,263104,657058.8
150060,201807,4754,3079,1675,2934180.37,1597702.5,4531882.87
150070,201807,310,144,166,137376,158364,295740
150080,201807,14412,7269,7143,6924664.93,6807103.94,13731768.87
150085,201807,397,248,149,236582.46,142146,378728.46
150090,201807,758,644,114,614376,108756,723132
150095,201807,348,216,132,205294.12,125107.56,330401.68
150100,201807,55,38,17,36252,16218,52470
150110,201807,171,82,89,78228,84906,163134
150120,201807,433,320,113,305280,107802,413082
150125,201807,55,23,32,21942,30528,52470
150130,201807,1910,1026,884,978804,843331.23,1822135.23
150140,201807,54282,25400,28882,24198305.59,27538963.9,51737269.49
150145,201807,184,106,78,101124,74412,175536
150150,201807,2834,1296,1538,1236166.49,1463832.31,2699998.80
150157,201807,432,301,131,287154,124969.23,412123.23
150160,201807,121,97,24,92538,22896,115434
150170,201807,3654,2712,942,2586055.5,898381.8,3484437.3
150172,201807,326,223,103,212742,98262,311004
150175,201807,84,51,33,48654,31482,80136
150178,201807,762,513,249,488448,237546,725994
150180,201807,3079,1485,1594,1415879.6,1520361.38,2936240.98
150190,201807,331,213,118,203202,112572,315774
150195,201807,123,62,61,59148,58194,117342
150200,201807,200,96,104,91584,99216,190800
150210,201807,3166,2566,600,2446905.86,571394.5,3018300.36
150215,201807,515,335,180,319590,171434,491024
150220,201807,3856,2620,1236,2497920.8,1177026.32,3674947.12
150230,201807,1142,923,219,879962.04,208926,1088888.04
150240,201807,5794,3427,2367,3266202.73,2258109,5524311.73
150250,201807,33,16,17,15264,16218,31482
150260,201807,76,46,30,43884,28620,72504
150270,201807,2350,1535,815,1463384.32,776651.8,2240036.12
150275,201807,571,349,222,332946,211788,544734
150276,201807,112,49,63,46746,60102,106848
150277,201807,772,329,443,313847.46,422622,736469.46
150280,201807,339,209,130,199386,124020,323406
150285,201807,74,37,37,35298,35298,70596
150290,201807,967,592,375,564472.26,357464,921936.26
150293,201807,668,311,357,296684.46,340578,637262.46
150295,201807,472,215,257,205110,245025.44,450135.44
150300,201807,78,41,37,39114,35298,74412
150304,201807,147,100,47,95400,44838,140238
150307,201807,392,323,69,308142,65826,373968
150309,201807,562,411,151,392094,144054,536148
150310,201807,258,174,84,165996,80136,246132
150320,201807,1790,1240,550,1182678.57,524461.5,1707140.07
150330,201807,2065,1196,869,1140316.2,829026,1969342.2
150340,201807,201,136,65,129505.5,62010,191515.5
150345,201807,604,327,277,311776.74,264258,576034.74
150350,201807,410,321,89,303839.46,84906,388745.46
150360,201807,4569,2940,1629,2801169.46,1554056.46,4355225.92
150370,201807,764,541,223,515318,212446.8,727764.8
150375,201807,195,103,92,98262,87768,186030
150380,201807,1365,918,447,875772,426438,1302210
150390,201807,735,420,315,400676,300510,701186
150400,201807,104,86,18,82044,17172,99216
150405,201807,1244,819,425,780054.48,404877.6,1184932.08
150410,201807,137,90,47,85860,44838,130698
150420,201807,7429,4087,3342,3897625.28,3186596.2,7084221.48
150430,201807,508,341,167,325314,159318,484632
150440,201807,584,348,236,331229,225144,556373
150442,201807,2180,1180,1000,1121656.1,953709.03,2075365.13
150445,201807,524,336,188,320544,178398,498942
150450,201807,270,135,135,128790,128790,257580
150460,201807,761,576,185,547677.09,176470.92,724148.01
150470,201807,1332,808,524,769305.8,499896,1269201.8
150475,201807,42,32,10,30528,9540,40068
150480,201807,1255,874,381,833796,363187.8,1196983.8
150490,201807,607,333,274,317682,261396,579078
150495,201807,331,235,96,224190,91584,315774
150497,201807,301,207,94,197478,89666.46,287144.46
150500,201807,424,288,136,274752,129744,404496
150503,201807,896,438,458,417566,436914,854480
150506,201807,1020,672,348,641088,331982.46,973070.46
150510,201807,1236,696,540,663698,515160,1178858
150520,201807,273,183,90,174582,85860,260442
150530,201807,1585,864,721,821108.3,687834,1508942.3
150540,201807,239,167,72,159318,68688,228006
150543,201807,731,417,314,397226.52,299269.8,696496.32
150548,201807,493,344,149,328176,142146,470322
150549,201807,62,45,17,42930,16218,59148
150550,201807,2870,1511,1359,1439840.95,1296200,2736040.95
150553,201807,3149,1859,1290,1771674.6,1230650.46,3002325.06
150555,201807,145,77,68,73458,64872,138330
150560,201807,55,42,13,40068,12402,52470
150563,201807,75,41,34,39114,32436,71550
150565,201807,169,101,68,96354,64872,161226
150570,201807,406,269,137,256606.92,130698,387304.92
150580,201807,1569,694,875,661694.4,834750,1496444.4
150590,201807,793,493,300,470322,286200,756522
150600,201807,464,281,183,268074,174582,442656
150610,201807,144,123,21,116493,20034,136527
150611,201807,129,91,38,86814,36252,123066
150613,201807,3234,1993,1241,1901322,1183905,3085227
150616,201807,495,300,195,285962,186030,471992
150618,201807,1204,650,554,619871.58,528516,1148387.58
150619,201807,400,307,93,292878,88722,381600
150620,201807,1278,745,533,710730,508195.8,1218925.8
150630,201807,302,201,101,191754,96354,288108
150635,201807,488,205,283,195570,269982,465552
150640,201807,61,28,33,26712,31482,58194
150650,201807,2327,1381,946,1317150.34,902193.8,2219344.14
150655,201807,244,182,62,173628,59148,232776
150658,201807,107,61,46,58194,43884,102078
150660,201807,494,346,148,330084,141192,471276
150670,201807,1018,375,643,357454.8,613403.46,970858.26
150680,201807,9900,5435,4465,5177532.86,4257560.58,9435093.44
150690,201807,51,32,19,30528,18126,48654
150700,201807,530,341,189,325123.2,180306,505429.2
150710,201807,279,165,114,157410,108756,266166
150715,201807,860,524,336,498913.92,320515.38,819429.30
150720,201807,430,333,97,317682,92251.8,409933.8
150730,201807,941,502,439,478899,418519.8,897418.8
150740,201807,226,160,66,152640,62964,215604
150745,201807,786,431,355,411174,338670,749844
150746,201807,54,33,21,31482,20034,51516
150747,201807,259,205,54,195570,51516,247086
150750,201807,133,76,57,72504,54378,126882
150760,201807,1733,1135,598,1082790,570492,1653282
150770,201807,368,193,175,184122,166774.95,350896.95
150775,201807,96,44,52,41976,49608,91584
150780,201807,190,100,90,95400,85860,181260
150790,201807,870,472,398,450288,379692,829980
150795,201807,1465,855,610,815670,581940,1397610
150796,201807,387,224,163,213696,155502,369198
150797,201807,284,162,122,154548,116388,270936
150800,201807,1414,856,558,815665.23,532332,1347997.23
150803,201807,588,487,101,464598,96354,560952
150805,201807,187,120,67,114480,63904.46,178384.46
150808,201807,999,551,448,525654,427392,953046
150810,201807,3397,2355,1042,2243513.2,993181.18,3236694.38
150812,201807,428,228,200,217512,190800,408312
150815,201807,971,640,331,609181.47,315774,924955.47
150820,201807,1572,965,607,919656,579058.92,1498714.92
150830,201807,825,579,246,551412,234684,786096
150835,201807,187,111,76,105894,72504,178398
150840,201807,1342,860,482,820440,459828,1280268
160005,201807,50,29,21,27666,20034,47700
160010,201807,198,126,72,120204,68684,188888
160015,201807,114,66,48,62964,45792,108756
160020,201807,126,71,55,67734,52470,120204
160021,201807,43,23,20,21942,19080,41022
160023,201807,115,69,46,65826,43884,109710
160025,201807,31,14,17,13356,16218,29574
160027,201807,1471,833,638,792106.7,607898,1400004.7
160030,201807,15555,8012,7543,7635642.96,7190997.29,14826640.25
160040,201807,314,182,132,173628,125928,299556
160050,201807,679,341,338,325314,322452,647766
160053,201807,323,185,138,176204,131652,307856
160055,201807,25,18,7,17172,6678,23850
160060,201807,6473,3408,3065,3240450.6,2923052.2,6163502.8
160070,201807,166,102,64,97308,61056,158364
160080,201807,82,45,37,42930,35298,78228
170025,201807,24,15,9,14310,8586,22896
170030,201807,230,187,43,178201,41022,219223
170035,201807,225,107,118,102078,112572,214650
170040,201807,188,144,44,137089.8,41976,179065.8
170070,201807,324,195,129,186030,123066,309096
170100,201807,368,267,101,254718,96354,351072
170105,201807,62,51,11,48654,10494,59148
170110,201807,104,64,40,61056,38160,99216
170130,201807,66,32,34,30528,32150,62678
170190,201807,100,65,35,62010,33390,95400
170200,201807,391,263,128,250225.2,122007.76,372232.96
170210,201807,5999,3159,2840,3005876.74,2707043.86,5712920.60
170215,201807,99,46,53,43884,50562,94446
170220,201807,1410,1042,368,993781.8,350786,1344567.8
170230,201807,154,101,53,96354,50562,146916
170240,201807,539,357,182,340578,173628,514206
170255,201807,1104,885,219,844080.12,208639.8,1052719.92
170270,201807,38,28,10,26712,9349.2,36061.2
170290,201807,86,65,21,62010,20034,82044
170300,201807,85,57,28,53614.8,26712,80326.8
170305,201807,47,36,11,34344,10494,44838
170307,201807,65,49,16,46746,15264,62010
170310,201807,103,56,47,53424,44838,98262
170320,201807,21,17,4,16218,3816,20034
170330,201807,23,21,2,20034,1908,21942
170360,201807,23,13,10,12402,9540,21942
170370,201807,120,63,57,60102,54378,114480
170380,201807,83,61,22,58194,20988,79182
170382,201807,45,40,5,38160,4770,42930
170384,201807,136,101,35,96354,33390,129744
170386,201807,62,27,35,25758,33390,59148
170388,201807,49,19,30,18126,28620,46746
170389,201807,22,18,4,17172,3816,20988
170390,201807,57,33,24,31482,22896,54378
170410,201807,35,24,11,22896,10494,33390
170460,201807,17,13,4,12402,3816,16218
170510,201807,29,22,7,20988,6678,27666
170550,201807,1510,871,639,830934,608843,1439777
170555,201807,112,78,34,74412,32436,106848
170560,201807,98,72,26,68688,24804,93492
170600,201807,39,19,20,18126,19080,37206
170610,201807,189,100,89,95242.59,84418,179660.59
170625,201807,38,20,18,19080,17172,36252
170650,201807,82,62,20,59148,19080,78228
170700,201807,559,426,133,404575.5,126595.8,531171.3
170710,201807,159,98,61,93492,58185,151677
170720,201807,83,67,16,63918,15264,79182
170730,201807,62,37,25,35298,23850,59148
170740,201807,78,57,21,54378,20034,74412
170755,201807,69,36,33,34344,31482,65826
170765,201807,139,68,71,64586,67734,132320
170770,201807,224,132,92,124830.9,87768,212598.9
170820,201807,593,387,206,369198,196095,565293
170825,201807,32,20,12,19080,11448,30528
170830,201807,80,61,19,58003.2,18126,76129.2
170900,201807,198,151,47,144054,44838,188892
170930,201807,821,430,391,409896,372442,782338
170950,201807,3027,1319,1708,1257354.26,1627315.31,2884669.57
170980,201807,18,10,8,9540,7632,17172
171050,201807,136,106,30,101124,28620,129744
171070,201807,38,31,7,29574,6678,36252
171090,201807,41,30,11,28620,10494,39114
171110,201807,20,13,7,12402,6678,19080
171150,201807,40,19,21,18126,20034,38160
171180,201807,22,10,12,9540,11448,20988
171190,201807,140,81,59,77274,56286,133560
171195,201807,65,50,15,47700,14310,62010
171200,201807,46,19,27,18126,25758,43884
171215,201807,3,3,0,2862,0,2862
171240,201807,55,45,10,42930,9540,52470
171245,201807,56,51,5,48654,4770,53424
171250,201807,70,37,33,35298,31472.46,66770.46
171270,201807,17,13,4,12402,3816,16218
171280,201807,39,36,3,34201,2862,37063
171320,201807,993,564,429,538056,407086.44,945142.44
171330,201807,423,205,218,195570,207972,403542
171360,201807,90,65,25,62010,23850,85860
171370,201807,24,13,11,12402,10494,22896
171380,201807,136,110,26,104940,24804,129744
171395,201807,55,34,21,32436,20034,52470
171420,201807,306,201,105,191754,99883.8,291637.8
171430,201807,66,53,13,50562,12402,62964
171488,201807,198,106,92,101124,87768,188892
171500,201807,58,32,26,30528,24804,55332
171510,201807,68,45,23,42930,21942,64872
171515,201807,42,35,7,33390,6392,39782
171525,201807,31,27,4,25758,3816,29574
171550,201807,12,7,5,6678,4770,11448
171570,201807,59,30,29,28620,27666,56286
171575,201807,336,210,126,200340,120194.46,320534.46
171610,201807,1708,863,845,821402.99,804581.66,1625984.65
171620,201807,135,94,41,89122.68,39114,128236.68
171630,201807,50,27,23,25758,21942,47700
171650,201807,271,179,92,170766,87768,258534
171660,201807,267,143,124,136422,118292,254714
171665,201807,49,33,16,31482,15264,46746
171670,201807,432,251,181,236538.68,172387.8,408926.48
171700,201807,64,56,8,53424,7632,61056
171720,201807,25,9,16,8586,15264,23850
171750,201807,105,57,48,54378,45792,100170
171780,201807,74,59,15,56286,14310,70596
171790,201807,76,64,12,61056,11448,72504
171800,201807,36,28,8,26712,7632,34344
171820,201807,2065,1169,896,1112850.74,850176.82,1963027.56
171830,201807,38,31,7,29574,6678,36252
171840,201807,66,39,27,37206,25758,62964
171845,201807,33,20,13,19080,12402,31482
171850,201807,41,30,11,28620,10494,39114
171855,201807,78,61,17,58194,16218,74412
171865,201807,9,8,1,7632,954,8586
171870,201807,31,22,9,20988,8586,29574
171875,201807,79,54,25,51516,23850,75366
171880,201807,28,20,8,19080,7632,26712
171884,201807,47,24,23,22896,21942,44838
171886,201807,121,46,75,43884,71263.8,115147.8
171888,201807,24,18,6,17172,5724,22896
171889,201807,19,15,4,14310,3816,18126
171890,201807,57,47,10,44838,9540,54378
171900,201807,43,30,13,28620,12402,41022
172000,201807,38,33,5,31482,4770,36252
172010,201807,41,35,6,32579.1,5724,38303.1
172015,201807,25,16,9,15264,8299.8,23563.8
172020,201807,132,84,48,80136,45792,125928
172025,201807,32,21,11,20034,10494,30528
172030,201807,35,20,15,19080,14310,33390
172049,201807,72,44,28,41976,26712,68688
172065,201807,146,93,53,88672,50562,139234
172080,201807,90,64,26,59873.84,24804,84677.84
172085,201807,25,12,13,11448,12402,23850
172090,201807,409,313,96,298602,90821,389423
172093,201807,24,18,6,17172,5724,22896
172097,201807,16,8,8,7632,7346,14978
172100,201807,4753,2682,2071,2553429.8,1972597.2,4526027.0
172110,201807,81,54,27,51516,25758,77274
172120,201807,1708,1467,241,1393401.65,229511.5,1622913.15
172125,201807,4,4,0,3816,0,3816
172130,201807,17,13,4,12402,3816,16218
172208,201807,192,122,70,116388,66780,183168
172210,201807,412,199,213,189846,202916,392762
210005,201807,2961,1837,1124,1749445.22,1069150,2818595.22
210010,201807,187,96,91,91584,86814,178398
210015,201807,31,21,10,20034,9540,29574
210020,201807,345,184,161,175536,153594,329130
210030,201807,348,219,129,208926,123057,331983
210040,201807,151,117,34,111618,32436,144054
210043,201807,264,180,84,171720,80136,251856
210047,201807,596,319,277,303944.4,264248.46,568192.86
210050,201807,299,217,82,207018,78228,285246
210055,201807,43,33,10,31482,9540,41022
210060,201807,558,442,116,421568.79,110664,532232.79
210070,201807,415,307,108,292878,103032,395910
210080,201807,103,94,9,89676,8586,98262
210083,201807,308,135,173,128790,165042,293832
210087,201807,43,32,11,29726.64,10494,40220.64
210090,201807,489,339,150,323406,143100,466506
210095,201807,484,354,130,337706.46,124020,461726.46
210100,201807,697,531,166,506240.1,157410.02,663650.12
210110,201807,146,81,65,77274,62010,139284
210120,201807,5441,4108,1333,3912113,1270428.68,5182541.68
210125,201807,213,123,90,117342,85860,203202
210130,201807,541,286,255,271890,243250.92,515140.92
210135,201807,34,20,14,19080,13356,32436
210140,201807,4411,3462,949,3299810.75,905108,4204918.75
210150,201807,362,229,133,218466,126882,345348
210160,201807,3392,2853,539,2718902.78,513920,3232822.78
210170,201807,1153,904,249,862416,237546,1099962
210173,201807,124,103,21,98262,20034,118296
210177,201807,450,222,228,211788,217512,429300
210180,201807,33,17,16,16218,15264,31482
210190,201807,420,270,150,257580,143100,400680
210193,201807,1,1,0,954,0,954
210197,201807,80,53,27,50562,25739.88,76301.88
210200,201807,640,507,133,483239.16,126882,610121.16
210203,201807,259,174,85,165996,81090,247086
210207,201807,387,301,86,287154,82044,369198
210210,201807,778,710,68,677340,64872,742212
210215,201807,80,68,12,64872,11448,76320
210220,201807,394,325,69,310050,65539.8,375589.8
210230,201807,309,236,73,225144,69642,294786
210232,201807,1480,947,533,903152,508473,1411625
210235,201807,159,125,34,119060,32436,151496
210237,201807,45,24,21,22896,20034,42930
210240,201807,92,75,17,71550,16218,87768
210250,201807,185,149,36,142146,34344,176490
210255,201807,347,257,90,245178,85860,331038
210260,201807,418,267,151,254718,144054,398772
210270,201807,695,444,251,423576,239454,663030
210275,201807,49,37,12,35298,11448,46746
210280,201807,1046,676,370,642089.33,351644.5,993733.83
210290,201807,504,333,171,317682,163134,480816
210300,201807,6052,3545,2507,3377961.07,2390486.23,5768447.30
210310,201807,106,72,34,68688,32436,101124
210312,201807,124,81,43,77274,41022,118296
210315,201807,115,87,28,82998,26712,109710
210317,201807,125,87,38,82998,36252,119250
210320,201807,2384,1964,420,1871945.84,400680,2272625.84
210325,201807,128,89,39,83952,36920,120872
210330,201807,5431,2821,2610,2686697.83,2489930.46,5176628.29
210340,201807,1385,997,388,950338,370081.07,1320419.07
210350,201807,616,508,108,484393.5,103032,587425.5
210355,201807,137,110,27,104940,25758,130698
210360,201807,2625,1653,972,1573815.6,927002,2500817.6
210370,201807,1237,550,687,524700,655398,1180098
210375,201807,189,98,91,92949,86814,179763
210380,201807,734,548,186,522792,177444,700236
210390,201807,207,171,36,163134,34344,197478
210400,201807,424,357,67,340578,63899,404477
210405,201807,1018,690,328,658260,312912,971172
210407,201807,54,43,11,41022,10494,51516
210408,201807,64,57,7,54378,6678,61056
210409,201807,322,269,53,256626,50562,307188
210410,201807,440,341,99,325314,94437,419751
210420,201807,193,158,35,150732,33390,184122
210430,201807,37,27,10,25758,9540,35298
210440,201807,373,227,146,216558,139284,355842
210450,201807,150,112,38,106848,36252,143100
210455,201807,222,121,101,115434,96354,211788
210460,201807,344,218,126,207972,120204,328176
210462,201807,64,54,10,51516,9540,61056
210465,201807,174,126,48,120204,45792,165996
210467,201807,535,383,152,365382,145008,510390
210470,201807,45,35,10,33390,9540,42930
210480,201807,1318,936,382,892944,364428,1257372
210490,201807,222,136,86,129744,82044,211788
210500,201807,581,310,271,295740,258534,554274
210510,201807,556,430,126,410220,120204,530424
210515,201807,436,241,195,229914,186030,415944
210520,201807,407,356,51,339337.8,48654,387991.8
210530,201807,9453,5059,4394,4813065.32,4184404.23,8997469.55
210535,201807,131,93,38,88722,36252,124974
210540,201807,1548,946,602,901339.8,572877,1474216.8
210542,201807,1183,590,593,562478.4,565436,1127914.4
210545,201807,12,11,1,10494,954,11448
210547,201807,132,113,19,107802,18126,125928
210550,201807,742,523,219,497394,208926,706320
210560,201807,178,149,29,142146,27666,169812
210565,201807,30,22,8,20988,7632,28620
210570,201807,1372,1078,294,1027172.26,280476,1307648.26
210580,201807,110,96,14,91584,13356,104940
210590,201807,773,614,159,584992.8,151686,736678.8
210592,201807,31,27,4,25758,3816,29574
210594,201807,105,86,19,82044,18126,100170
210596,201807,90,75,15,71550,14310,85860
210598,201807,125,91,34,86814,32436,119250
210600,201807,333,281,52,268074,49608,317682
210610,201807,253,234,19,222282,18126,240408
210620,201807,47,27,20,25758,19080,44838
210630,201807,61,59,2,56286,1908,58194
210632,201807,1097,730,367,696420,349641,1046061
210635,201807,18,15,3,14310,2862,17172
210637,201807,105,73,32,69642,30528,100170
210640,201807,592,519,73,495126,69642,564768
210650,201807,413,332,81,315802.62,76320,392122.62
210660,201807,404,293,111,278855,105770,384625
210663,201807,19,11,8,10494,7632,18126
210667,201807,113,35,78,33390,74412,107802
210670,201807,267,235,32,223475,30528,254003
210675,201807,573,300,273,286200,260442,546642
210680,201807,210,132,78,125928,74412,200340
210690,201807,647,512,135,488448,128790,617238
210700,201807,191,141,50,134514,47700,182214
210710,201807,297,169,128,161035.2,122112,283147.2
210720,201807,129,108,21,103032,20034,123066
210725,201807,71,62,9,59148,8586,67734
210730,201807,25,18,7,17172,6678,23850
210735,201807,415,278,137,265212,130412,395624
210740,201807,554,466,88,444564,83952,528516
210745,201807,156,114,42,108756,40068,148824
210750,201807,2423,1094,1329,1041721,1267846.92,2309567.92
210760,201807,270,199,71,189846,67719.69,257565.69
210770,201807,405,312,93,297648,88435.8,386083.8
210780,201807,424,307,117,292878,111618,404496
210790,201807,189,146,43,139284,41022,180306
210800,201807,149,110,39,104940,37206,142146
210805,201807,45,41,4,39114,3816,42930
210810,201807,492,378,114,359944.2,108756,468700.2
210820,201807,2321,1840,481,1746915.41,458874,2205789.41
210825,201807,172,89,83,84906,79182,164088
210830,201807,799,492,307,468414,291924,760338
210840,201807,211,143,68,136422,64872,201294
210845,201807,251,159,92,151686,87768,239454
210850,201807,846,537,309,512298,294786,807084
210860,201807,4134,2143,1991,2042896.3,1899108.72,3942005.02
210870,201807,475,358,117,341532,111618,453150
210880,201807,62,44,18,41976,17172,59148
210890,201807,348,290,58,276660,55332,331992
210900,201807,585,380,205,362516,195570,558086
210905,201807,69,35,34,33390,32436,65826
210910,201807,2009,1486,523,1416353.99,498942,1915295.99
210920,201807,227,69,158,65826,150732,216558
210923,201807,80,58,22,55332,20988,76320
210927,201807,436,183,253,174582,241362,415944
210930,201807,63,49,14,46746,13356,60102
210940,201807,94,71,23,67734,21942,89676
210945,201807,197,92,105,87768,100170,187938
210950,201807,523,378,145,360612,138325.23,498937.23
210955,201807,75,50,25,47700,23850,71550
210960,201807,2442,1050,1392,1000078.4,1327682,2327760.4
210970,201807,116,100,16,95400,15264,110664
210975,201807,92,83,9,79182,8586,87768
210980,201807,1221,535,686,510275.52,654158,1164433.52
210990,201807,4352,2716,1636,2589963.13,1560744,4150707.13
211000,201807,1375,1089,286,1038620,272557.8,1311177.8
211003,201807,926,633,293,603882,279513,883395
211010,201807,492,433,59,413082,56286,469368
211020,201807,1614,591,1023,563814,975722.58,1539536.58
211023,201807,28,24,4,22609.8,3816,26425.8
211027,201807,66,44,22,41976,20988,62964
211030,201807,383,258,125,246132,119250,365382
211040,201807,323,249,74,237260,70596,307856
211050,201807,1185,759,426,724066.92,406113.23,1130180.15
211060,201807,691,584,107,555228,102078,657306
211065,201807,22,18,4,17172,3816,20988
211070,201807,928,754,174,717704.74,165996,883700.74
211080,201807,87,83,4,79182,3816,82998
211085,201807,60,32,28,30242,26712,56954
211090,201807,91,73,18,69642,17172,86814
211100,201807,506,405,101,386083.8,96354,482437.8
211102,201807,262,176,86,167904,82044,249948
211105,201807,220,149,71,142146,67734,209880
211107,201807,136,78,58,74412,55332,129744
211110,201807,825,529,296,504094,282375,786469
211120,201807,5784,2487,3297,2366934.14,3144246.23,5511180.37
211125,201807,34,27,7,25758,6678,32436
211130,201807,45822,19364,26458,18439988.69,25229104.32,43669093.01
211140,201807,428,362,66,344390,62964,407354
211150,201807,1292,823,469,784808.1,447136,1231944.1
211153,201807,167,99,68,94446,64872,159318
211157,201807,63,49,14,46746,13356,60102
211160,201807,711,591,120,563098.5,114480,677578.5
211163,201807,0,0,0,0,0,0
211167,201807,10,8,2,7632,1908,9540
211170,201807,447,311,136,296694,129744,426438
211172,201807,122,85,37,81090,35298,116388
211174,201807,270,161,109,153594,103986,257580
211176,201807,515,373,142,355842,135468,491310
211178,201807,96,62,34,59148,32436,91584
211180,201807,209,163,46,155502,43721.82,199223.82
211190,201807,67,61,6,58194,5724,63918
211195,201807,29,19,10,18126,9540,27666
211200,201807,156,136,20,129400.56,19080,148480.56
211210,201807,527,330,197,314152.2,187938,502090.2
211220,201807,4027,2270,1757,2157737.39,1669841.04,3827578.43
211223,201807,96,91,5,86632.74,4770,91402.74
211227,201807,68,48,20,45792,19080,64872
211230,201807,779,636,143,606744,136402.92,743146.92
211240,201807,415,313,102,298602,97308,395910
211245,201807,203,91,112,86814,106848,193662
211250,201807,1647,1408,239,1342240.12,228006,1570246.12
211260,201807,826,651,175,621054,166950,788004
211270,201807,2071,1635,436,1559790,414990.2,1974780.2
211280,201807,1851,1114,737,1061802.8,703098,1764900.8
211285,201807,206,121,85,115434,81090,196524
211290,201807,692,465,227,443419.2,216558,659977.2
211300,201807,813,625,188,595972.09,179352,775324.09
211400,201807,1600,911,689,869094,657306,1526400
220005,201807,18,17,1,16218,954,17172
220010,201807,88,68,20,64872,18793.8,83665.8
220020,201807,630,498,132,474107.04,125928,600035.04
220025,201807,107,103,4,98262,3816,102078
220027,201807,36,29,7,27666,6678,34344
220030,201807,98,81,17,77274,16218,93492
220040,201807,1134,856,278,815460.96,265212,1080672.96
220045,201807,38,28,10,26712,9540,36252
220050,201807,663,544,119,517814.96,113506.92,631321.88
220060,201807,174,148,26,141192,24804,165996
220070,201807,98,89,9,84906,8586,93492
220080,201807,12,10,2,9540,1908,11448
220090,201807,35,28,7,26712,6678,33390
220095,201807,2,1,1,954,954,1908
220100,201807,27,23,4,21942,3816,25758
220105,201807,26,24,2,22324,1908,24232
220110,201807,213,195,18,185743.8,17172,202915.8
220115,201807,50,47,3,44838,2862,47700
220117,201807,20,18,2,17172,1908,19080
220120,201807,1484,1073,411,1022255.24,392074.92,1414330.16
220130,201807,27,26,1,24804,954,25758
220140,201807,97,76,21,71550,20034,91584
220150,201807,463,332,131,317167.79,124974,442141.79
220155,201807,4,4,0,3816,0,3816
220157,201807,18,15,3,14310,2862,17172
220160,201807,73,62,11,59148,10494,69642
220170,201807,37,35,2,33390,1908,35298
220173,201807,7,7,0,6678,0,6678
220177,201807,5,5,0,4770,0,4770
220180,201807,64,63,1,60097.23,954,61051.23
220190,201807,1061,950,111,906300,105894,1012194
220191,201807,43,38,5,36252,4770,41022
220192,201807,67,64,3,61056,2862,63918
220194,201807,41,37,4,35298,3816,39114
220196,201807,102,84,18,80136,17172,97308
220198,201807,5,4,1,3816,954,4770
220200,201807,431,356,75,340356,71550,411906
220202,201807,36,32,4,30528,3816,34344
220205,201807,39,35,4,33390,3816,37206
220207,201807,18,17,1,16218,954,17172
220208,201807,83,44,39,41976,37206,79182
220209,201807,31,28,3,26712,2862,29574
220210,201807,15,13,2,12402,1908,14310
220211,201807,27,27,0,25758,0,25758
220213,201807,43,39,4,37206,3530,40736
220217,201807,37,29,8,27666,7632,35298
220220,201807,2055,1315,740,1250903.88,704557.92,1955461.80
220225,201807,16,8,8,7632,7632,15264
220230,201807,947,746,201,711235.62,191114.82,902350.44
220240,201807,147,134,13,127836,12402,140238
220245,201807,33,30,3,27917.04,2862,30779.04
220250,201807,112,101,11,96354,10494,106848
220253,201807,43,36,7,34344,6678,41022
220255,201807,28,25,3,23850,2862,26712
220260,201807,682,495,187,472230,178398,650628
220265,201807,14,11,3,10494,2862,13356
220270,201807,693,613,80,584076.96,75843,659919.96
220271,201807,43,36,7,34344,6678,41022
220272,201807,28,28,0,26712,0,26712
220273,201807,15,13,2,12402,1908,14310
220275,201807,58,47,11,44838,10494,55332
220277,201807,13,11,2,10494,1908,12402
220280,201807,15,12,3,11448,2862,14310
220285,201807,43,40,3,38160,2862,41022
220290,201807,1398,1195,203,1136738.8,193615,1330353.8
220300,201807,52,50,2,47700,1908,49608
220310,201807,316,266,50,253760,47691,301451
220320,201807,434,401,33,381124,31482,412606
220323,201807,0,0,0,0,0,0
220325,201807,16,11,5,10494,4770,15264
220327,201807,13,12,1,11448,954,12402
220330,201807,207,143,64,136422,61056,197478
220335,201807,137,119,18,113526,17172,130698
220340,201807,28,17,11,16218,10494,26712
220342,201807,57,49,8,46746,7632,54378
220345,201807,84,76,8,72504,7632,80136
220350,201807,428,374,54,354173.42,51516,405689.42
220360,201807,43,31,12,29574,11448,41022
220370,201807,1129,916,213,873100.8,202915.8,1076016.6
220375,201807,26,24,2,22896,1908,24804
220380,201807,39,32,7,30528,6678,37206
220385,201807,26,23,3,21942,2862,24804
220390,201807,2255,1280,975,1216426.55,929053.5,2145480.05
220400,201807,29,26,3,24804,2862,27666
220410,201807,16,15,1,14310,954,15264
220415,201807,14,13,1,12402,954,13356
220420,201807,125,103,22,98262,20701.8,118963.8
220430,201807,128,116,12,108995.8,11448,120443.8
220435,201807,21,15,6,14305.23,5724,20029.23
220440,201807,288,247,41,235638,39114,274752
220450,201807,338,171,167,161968.98,159318,321286.98
220455,201807,55,53,2,50562,1908,52470
220460,201807,18,18,0,16504.2,0,16504.2
220465,201807,106,69,37,65826,35298,101124
220470,201807,240,212,28,202248,26712,228960
220480,201807,72,61,11,58194,10494,68688
220490,201807,87,75,12,71550,11448,82998
220500,201807,100,84,16,80136,15264,95400
220510,201807,380,302,78,287345,74221.2,361566.2
220515,201807,22,18,4,17172,3816,20988
220520,201807,370,332,38,315413,36233,351646
220525,201807,25,17,8,16218,7632,23850
220527,201807,38,29,9,27666,7776,35442
220530,201807,34,14,20,13356,19080,32436
220535,201807,7,7,0,6678,0,6678
220540,201807,59,50,9,47700,8586,56286
220545,201807,57,39,18,37206,17172,54378
220550,201807,649,496,153,472420.8,145962,618382.8
220551,201807,26,19,7,18126,6678,24804
220552,201807,9,9,0,8586,0,8586
220553,201807,49,44,5,41976,4770,46746
220554,201807,13,8,5,7345.8,4770,12115.8
220555,201807,25,22,3,20988,2862,23850
220556,201807,51,47,4,44838,3816,48654
220557,201807,57,51,6,48654,5724,54378
220558,201807,7,2,5,1908,4770,6678
220559,201807,5,5,0,4770,0,4770
220560,201807,58,37,21,35107.2,20034,55141.2
220570,201807,792,480,312,456716.14,297648,754364.14
220580,201807,555,509,46,485566.92,43197.92,528764.84
220585,201807,6,5,1,4770,954,5724
220590,201807,14,14,0,13356,0,13356
220595,201807,59,44,15,41976,14310,56286
220600,201807,24,12,12,11448,11448,22896
220605,201807,20,19,1,18126,954,19080
220610,201807,63,54,9,51516,8586,60102
220620,201807,557,439,118,418567.5,112572,531139.5
220630,201807,6,4,2,3816,1908,5724
220635,201807,38,34,4,32436,3816,36252
220640,201807,97,76,21,72504,20034,92538
220650,201807,113,107,6,102078,5724,107802
220660,201807,32,26,6,24804,5724,30528
220665,201807,4,4,0,3816,0,3816
220667,201807,16,13,3,12402,2862,15264
220669,201807,28,25,3,23850,2862,26712
220670,201807,75,59,16,56095.2,15264,71359.2
220672,201807,65,44,21,41976,20034,62010
220675,201807,36,28,8,26712,7632,34344
220680,201807,37,31,6,29574,5724,35298
220690,201807,45,43,2,41022,1908,42930
220695,201807,58,27,31,25758,29574,55332
220700,201807,1566,1197,369,1140793.2,352026,1492819.2
220710,201807,5,3,2,2862,1908,4770
220720,201807,108,88,20,83713.5,18936.9,102650.4
220730,201807,19,18,1,17172,954,18126
220735,201807,3,1,2,954,1908,2862
220740,201807,47,42,5,40068,4770,44838
220750,201807,99,82,17,78228,16218,94446
220755,201807,14,14,0,13356,0,13356
220760,201807,52,49,3,46746,2862,49608
220770,201807,5670,2951,2719,2810998.83,2587789.41,5398788.24
220775,201807,23,11,12,10494,11448,21942
220777,201807,17,16,1,15264,954,16218
220779,201807,17,13,4,12402,3816,16218
220780,201807,879,752,127,716740.2,120872,837612.2
220785,201807,14,8,6,7632,5724,13356
220790,201807,1018,810,208,770338,198432,968770
220793,201807,12,12,0,11448,0,11448
220795,201807,21,20,1,19080,954,20034
220800,201807,3973,3036,937,2894137.93,892921.89,3787059.82
220810,201807,61,54,7,51516,6678,58194
220820,201807,241,220,21,209880,20034,229914
220830,201807,1185,1007,178,960673.23,169793,1130466.23
220840,201807,2347,1631,716,1544149.35,679916.94,2224066.29
220850,201807,53,45,8,42930,7632,50562
220855,201807,13,8,5,7632,4770,12402
220860,201807,8,7,1,6678,954,7632
220865,201807,23,21,2,20034,1908,21942
220870,201807,63,61,2,58194,1908,60102
220880,201807,320,245,75,233062.2,71264,304326.2
220885,201807,41,38,3,36252,2862,39114
220887,201807,19,18,1,17172,954,18126
220890,201807,101,89,12,84906,11448,96354
220900,201807,50,28,22,26712,20988,47700
220910,201807,55,47,8,44838,7632,52470
220915,201807,10,9,1,8586,954,9540
220920,201807,40,36,4,34344,3816,38160
220930,201807,41,40,1,38160,954,39114
220935,201807,15,15,0,14310,0,14310
220937,201807,44,41,3,39114,2862,41976
220940,201807,53,49,4,46746,3816,50562
220945,201807,0,0,0,0,0,0
220950,201807,48,44,4,41976,3816,45792
220955,201807,34,31,3,29574,2862,32436
220960,201807,1,1,0,954,0,954
220965,201807,29,26,3,24804,2862,27666
220970,201807,48,41,7,39114,6678,45792
220975,201807,9,8,1,7632,954,8586
220980,201807,33,31,2,29574,1908,31482
220985,201807,67,59,8,56286,7632,63918
220987,201807,31,29,2,27666,1908,29574
220990,201807,16,15,1,14310,954,15264
220995,201807,37,32,5,30528,4770,35298
220997,201807,48,38,10,36252,9540,45792
221000,201807,1137,1022,115,971965.85,109423.8,1081389.65
221005,201807,63,57,6,54378,5724,60102
221010,201807,17,14,3,13356,2862,16218
221020,201807,43,41,2,39114,1908,41022
221030,201807,30,24,6,22896,5724,28620
221035,201807,22,22,0,20988,0,20988
221037,201807,12,6,6,5724,5724,11448
221038,201807,26,23,3,21942,2862,24804
221039,201807,23,23,0,21942,0,21942
221040,201807,261,224,37,213696,35298,248994
221050,201807,234,199,35,189846,33390,223236
221060,201807,1757,1545,212,1471179.64,202248,1673427.64
221062,201807,29,28,1,26712,954,27666
221063,201807,14,10,4,9540,3816,13356
221065,201807,50,43,7,41022,6678,47700
221070,201807,140,121,19,115434,18126,133560
221080,201807,377,334,43,318636,40735.8,359371.8
221090,201807,34,33,1,31482,954,32436
221093,201807,56,36,20,34344,19080,53424
221095,201807,11,10,1,9540,954,10494
221097,201807,20,17,3,16218,2862,19080
221100,201807,24894,14368,10526,13685971.77,10035845.03,23721816.80
221110,201807,1046,772,274,736202,261396,997598
221120,201807,533,396,137,377498,130698,508196
221130,201807,943,769,174,732386.8,165996,898382.8
221135,201807,35,32,3,30528,2862,33390
221140,201807,40,33,7,31482,6678,38160
221150,201807,14,11,3,10494,2862,13356
221160,201807,12,12,0,11448,0,11448
221170,201807,13,13,0,12402,0,12402
230010,201807,167,153,14,145962,13356,159318
230015,201807,122,101,21,96354,20034,116388
230020,201807,1593,1353,240,1287833.82,228058.56,1515892.38
230030,201807,1639,1182,457,1122059.04,435978,1558037.04
230040,201807,206,181,25,171195.5,23850,195045.5
230050,201807,212,155,57,147870,54378,202248
230060,201807,155,126,29,119440.8,27666,147106.8
230070,201807,283,253,30,241362,28620,269982
230075,201807,832,727,105,691555,99883.8,791438.8
230080,201807,181,156,25,148824,23850,172674
230090,201807,100,69,31,65062.8,29574,94636.8
230100,201807,1944,1160,784,1104314.92,747917,1852231.92
230110,201807,2665,1710,955,1629227.4,910497.8,2539725.2
230120,201807,957,766,191,728361.14,182195,910556.14
230125,201807,146,120,26,114480,24804,139284
230130,201807,468,419,49,399726,46746,446472
230140,201807,203,176,27,167904,25758,193662
230150,201807,160,126,34,120204,32436,152640
230160,201807,920,792,128,755091,122112,877203
230170,201807,591,544,47,514463.7,44838,559301.7
230180,201807,78,73,5,69642,4770,74412
230185,201807,409,356,53,338526.9,50562,389088.9
230190,201807,2218,1793,425,1706542.48,405133,2111675.48
230195,201807,493,429,64,409266,61056,470322
230200,201807,374,325,49,309086.46,46746,355832.46
230205,201807,352,227,125,215074.53,119250,334324.53
230210,201807,1260,1006,254,957230.47,241533.8,1198764.27
230220,201807,1431,986,445,939880.8,424511,1364391.8
230230,201807,892,780,112,743929.2,106848,850777.2
230240,201807,1641,1416,225,1349942.7,214650,1564592.7
230250,201807,1777,1468,309,1396311.17,294786,1691097.17
230260,201807,2969,1817,1152,1729846.96,1098054.77,2827901.73
230270,201807,1350,1082,268,1030009.99,254479.5,1284489.49
230280,201807,2733,2030,703,1930221.26,669994.2,2600215.46
230290,201807,402,362,40,340278.71,38160,378438.71
230300,201807,516,384,132,365076.72,125928,491004.72
230310,201807,423,316,107,301316.13,102078,403394.13
230320,201807,924,787,137,747387.8,130698,878085.8
230330,201807,302,242,60,230104.8,57050,287154.8
230340,201807,453,364,89,346303,84906,431209
230350,201807,3045,1932,1113,1843061.22,1059227.28,2902288.50
230360,201807,270,215,55,204314,52470,256784
230365,201807,134,108,26,102317,24804,127121
230370,201807,9786,4812,4974,4581293.74,4741792.56,9323086.30
230380,201807,468,403,65,384176,61056.6,445232.6
230390,201807,515,286,229,271890,218466,490356
230393,201807,266,220,46,207786.96,43884,251670.96
230395,201807,337,274,63,261148,60102,321250
230400,201807,594,474,120,450288,113983.92,564271.92
230410,201807,2624,1639,985,1557215.75,938928,2496143.75
230420,201807,6103,4014,2089,3811153.08,1988329.14,5799482.22
230423,201807,314,273,41,260442,39114,299556
230425,201807,369,305,64,290369,61056,351425
230426,201807,112,98,14,92766.96,13069.8,105836.76
230427,201807,79,76,3,72504,2862,75366
230428,201807,1370,706,664,673275.96,633456,1306731.96
230430,201807,451,366,85,348969.2,81090,430059.2
230435,201807,810,571,239,543582.43,226766.61,770349.04
230440,201807,84263,37233,47030,35429652.59,44815926.23,80245578.82
230445,201807,271,189,82,180115.2,78228,258343.2
230450,201807,536,436,100,415944,95400,511344
230460,201807,59,49,10,46746,9540,56286
230465,201807,303,247,56,235638,53424,289062
230470,201807,1897,1492,405,1423368,385263.1,1808631.1
230480,201807,152,146,6,138997.8,5724,144721.8
230490,201807,284,229,55,218466,52470,270936
230495,201807,440,331,109,314891.38,103986,418877.38
230500,201807,955,713,242,679248,230868,910116
230510,201807,45,36,9,34344,8586,42930
230520,201807,385,306,79,291924,75366,367290
230523,201807,2103,1318,785,1255001.69,748422.92,2003424.61
230526,201807,298,250,48,238500,45001,283501
230530,201807,675,502,173,475895.59,164088.2,639983.79
230533,201807,182,173,9,165042,8586,173628
230535,201807,350,263,87,250902,82998,333900
230540,201807,1835,1607,228,1530435.04,216939.8,1747374.84
230550,201807,3660,2344,1316,2227182.86,1254686.49,3481869.35
230560,201807,580,444,136,422431.4,128790,551221.4
230565,201807,202,147,55,140238,51706.8,191944.8
230570,201807,302,267,35,254718,33390,288108
230580,201807,1106,817,289,776966.64,274752,1051718.64
230590,201807,961,748,213,710016.1,202725,912741.1
230600,201807,257,234,23,222492.07,21942,244434.07
230610,201807,335,267,68,254528,64872,319400
230620,201807,170,140,30,132606,28620,161226
230625,201807,722,525,197,499295.78,186784.68,686080.46
230630,201807,1283,1017,266,970218,253382.4,1223600.4
230640,201807,3653,3162,491,3009027.65,467636.57,3476664.22
230650,201807,401,349,52,332038.75,49593.69,381632.44
230655,201807,662,574,88,546642.8,83843.76,630486.56
230660,201807,349,294,55,280476,52183.8,332659.8
230670,201807,425,377,48,359658,45792,405450
230680,201807,197,180,17,171720,16218,187938
230690,201807,868,757,111,722178,105894,828072
230700,201807,710,602,108,574022,102726.8,676748.8
230710,201807,733,694,39,662076,37206,699282
230720,201807,151,128,23,121720.86,21942,143662.86
230725,201807,242,192,50,183168,47691,230859
230730,201807,11802,6406,5396,6095498.7,5138790.86,11234289.56
230740,201807,649,523,126,498656,119513.46,618169.46
230750,201807,811,691,120,658022.3,114480,772502.3
230760,201807,1328,1150,178,1093053.25,169812,1262865.25
230763,201807,317,263,54,248946.95,51516,300462.95
230765,201807,6971,3282,3689,3125621.72,3518139.22,6643760.94
230770,201807,4949,2540,2409,2413334.63,2296153.98,4709488.61
230780,201807,688,604,84,573314.1,80121.69,653435.79
230790,201807,205,170,35,162180,32589.4,194769.4
230800,201807,1117,816,301,778153.95,287154,1065307.95
230810,201807,1304,1159,145,1104684.3,138139.2,1242823.5
230820,201807,335,236,99,223905,94446,318351
230830,201807,938,812,126,771134.41,120204,891338.41
230835,201807,279,241,38,228960,35537,264497
230837,201807,164,139,25,132606,23850,156456
230840,201807,913,731,182,696134.5,173342,869476.5
230850,201807,1487,1297,190,1236861,180974,1417835
230860,201807,295,221,74,210834,70596,281430
230870,201807,1814,1544,270,1472003,257008,1729011
230880,201807,41,30,11,28620,10494,39114
230890,201807,566,519,47,495003.8,44824,539827.8
230900,201807,274,209,65,199386,61813,261199
230910,201807,198,160,38,151876.8,36252,188128.8
230920,201807,404,317,87,302418,82998,385416
230930,201807,928,653,275,620100.64,262350,882450.64
230940,201807,831,667,164,636318,156266,792584
230945,201807,483,403,80,383986,76320,460306
230950,201807,376,322,54,307188,51516,358704
230960,201807,2586,1749,837,1661799.76,798193,2459992.76
230970,201807,1754,988,766,941556.82,729848.24,1671405.06
230980,201807,213,180,33,171720,31482,203202
230990,201807,139,112,27,106848,25001.47,131849.47
231000,201807,207,187,20,176490,19080,195570
231010,201807,139,109,30,103699.8,28620,132319.8
231020,201807,1302,903,399,859841,380646,1240487
231025,201807,988,750,238,712382.2,225525.8,937908.0
231030,201807,1130,943,187,899618,177826,1077444
231040,201807,140,97,43,91793.88,40291,132084.88
231050,201807,987,879,108,836801.9,103032,939833.9
231060,201807,146,128,18,122112,17172,139284
231070,201807,1441,1014,427,966212,407358,1373570
231080,201807,261,244,17,231965.1,16218,248183.1
231085,201807,563,349,214,331993,204156,536149
231090,201807,240,199,41,189846,39114,228960
231095,201807,166,132,34,125928,32436,158364
231100,201807,127,107,20,102078,17839.8,119917.8
231110,201807,355,309,46,292596.1,43884,336480.1
231120,201807,293,251,42,238490.34,40068,278558.34
231123,201807,139,132,7,125928,6678,132606
231126,201807,302,249,53,237260,50562,287822
231130,201807,4565,3559,1006,3386344.5,958937.26,4345281.76
231135,201807,212,183,29,174582,26782,201364
231140,201807,3083,2276,807,2168451.54,768885.84,2937337.38
231150,201807,363,346,17,330084,16218,346302
231160,201807,1209,957,252,909887.54,240179.04,1150066.58
231170,201807,537,357,180,340578,171720,512298
231180,201807,1643,1396,247,1331020.8,235609.38,1566630.18
231190,201807,193,171,22,163134,20988,184122
231195,201807,213,183,30,173858,28620,202478
231200,201807,834,677,157,645858,148518,794376
231210,201807,606,507,99,482724.8,94446,577170.8
231220,201807,1040,750,290,713860.12,276660,990520.12
231230,201807,1405,1127,278,1073956.04,264448.8,1338404.84
231240,201807,1375,999,376,952759.8,357690.58,1310450.38
231250,201807,111,103,8,98262,7632,105894
231260,201807,290,186,104,177444,98930,276374
231270,201807,1005,836,169,791944.4,161226,953170.4
231280,201807,57,44,13,41976,12402,54378
231290,201807,7213,4029,3184,3836551.16,3034905.21,6871456.37
231300,201807,627,581,46,554274,43884,598158
231310,201807,711,660,51,628423,48654,677077
231320,201807,571,435,136,414514,129744,544258
231325,201807,88,79,9,75366,8586,83952
231330,201807,2026,1567,459,1489084.58,435883.6,1924968.18
231335,201807,249,221,28,210834,26712,237546
231340,201807,1629,1202,427,1145564.08,407071.8,1552635.88
231350,201807,1197,987,210,941598,199768,1141366
231355,201807,427,371,56,353934,53424,407358
231360,201807,478,377,101,356948.2,96354,453302.2
231370,201807,92,76,16,72504,15264,87768
231375,201807,291,213,78,203202,74412,277614
231380,201807,466,379,87,359970.69,82807.2,442777.89
231390,201807,197,161,36,153594,34344,187938
231395,201807,734,456,278,433726.56,265212,698938.56
231400,201807,1069,887,182,843640.84,173285.38,1016926.22
231410,201807,1320,1078,242,1024597.4,229896,1254493.4
240010,201807,393,180,213,170568.26,202906.8,373475.06
240020,201807,2199,1730,469,1647594.23,447422,2095016.23
240030,201807,133,113,20,107802,19080,126882
240040,201807,32,32,0,30528,0,30528
240050,201807,515,441,74,419860.45,70596,490456.45
240060,201807,66,62,4,59148,3816,62964
240070,201807,190,149,41,142146,39114,181260
240080,201807,453,304,149,290012,141102.71,431114.71
240090,201807,104,92,12,87462.72,11448,98910.72
240100,201807,1444,1362,82,1296375.55,78037.2,1374412.75
240110,201807,992,632,360,601956.26,343297,945253.26
240120,201807,139,118,21,112572,20034,132606
240130,201807,285,267,18,254001.54,17172,271173.54
240140,201807,81,64,17,61056,16218,77274
240145,201807,696,615,81,586185.3,77064.12,663249.42
240150,201807,20,15,5,14310,4741.38,19051.38
240160,201807,44,38,6,36252,5724,41976
240165,201807,35,29,6,27428,5724,33152
240170,201807,93,71,22,67257,20988,88245
240180,201807,78,64,14,61056,13356,74412
240185,201807,44,40,4,38150.46,3816,41966.46
240190,201807,12,10,2,9540,1908,11448
240200,201807,3018,1691,1327,1606947.67,1264719,2871666.67
240210,201807,168,131,37,124974,35298,160272
240220,201807,1090,787,303,750655,289052.46,1039707.46
240230,201807,834,774,60,735562.05,56592,792154.05
240240,201807,122,88,34,83952,32436,116388
240250,201807,88,78,10,74412,9540,83952
240260,201807,1803,1343,460,1280535.12,437571.18,1718106.30
240270,201807,190,167,23,158936.4,21942,180878.4
240280,201807,42,32,10,30528,9540,40068
240290,201807,50,49,1,46746,954,47700
240300,201807,177,99,78,94446,74412,168858
240310,201807,2025,1112,913,1050115.98,867498.37,1917614.35
240320,201807,206,196,10,186984,9540,196524
240325,201807,4307,2634,1673,2505365.46,1592919.86,4098285.32
240330,201807,66,62,4,59148,3816,62964
240340,201807,104,76,28,72504,26712,99216
240350,201807,89,79,10,75366,9540,84906
240360,201807,429,302,127,288108,121158,409266
240370,201807,41,39,2,37206,1908,39114
240375,201807,68,41,27,39114,25758,64872
240380,201807,230,188,42,179352,39973,219325
240390,201807,16,13,3,12402,2862,15264
240400,201807,76,72,4,68688,3816,72504
240410,201807,11,7,4,6678,3816,10494
240420,201807,898,696,202,661458.4,191658.6,853117.0
240430,201807,263,247,16,234727.89,15264,249991.89
240440,201807,76,43,33,41022,31482,72504
240450,201807,210,142,68,134895.8,64872,199767.8
240460,201807,60,47,13,44838,12402,57240
240470,201807,234,202,32,191864.66,30528,222392.66
240480,201807,14,14,0,13260.6,0,13260.6
240485,201807,75,64,11,61056,10494,71550
240490,201807,46,45,1,42720.12,954,43674.12
240500,201807,85,67,18,63918,17172,81090
240510,201807,50,35,15,33390,14310,47700
240520,201807,126,121,5,115434,4770,120204
240530,201807,54,48,6,45792,5724,51516
240540,201807,78,67,11,63918,10494,74412
240550,201807,15,13,2,12402,1908,14310
240560,201807,371,275,96,261723.23,91584,353307.23
240570,201807,470,293,177,278663.4,168858,447521.4
240580,201807,1258,1018,240,965687.9,227802.2,1193490.1
240590,201807,30,28,2,26712,1908,28620
240600,201807,110,107,3,102078,2862,104940
240610,201807,511,428,83,407955.7,78419,486374.7
240615,201807,19,18,1,17172,954,18126
240620,201807,96,92,4,87768,3816,91584
240630,201807,35,33,2,31482,1908,33390
240640,201807,26,22,4,20988,3816,24804
240650,201807,237,198,39,188033.9,37206,225239.9
240660,201807,99,87,12,82998,11448,94446
240670,201807,292,171,121,161035.3,115434,276469.3
240680,201807,49,38,11,36252,10494,46746
240690,201807,49,46,3,43884,2862,46746
240700,201807,192,158,34,150732,32436,183168
240710,201807,1936,1235,701,1176993.63,668735.46,1845729.09
240720,201807,1062,776,286,739149.86,272844,1011993.86
240725,201807,66,61,5,58194,4770,62964
240730,201807,134,116,18,110664,17172,127836
240740,201807,241,203,38,192297.78,35298.02,227595.80
240750,201807,38,26,12,24804,11448,36252
240760,201807,33,29,4,27666,3816,31482
240770,201807,151,116,35,110664,33390,144054
240780,201807,684,568,116,540431.46,110664,651095.46
240790,201807,39,38,1,36252,954,37206
240800,201807,8722,5925,2797,5613979.64,2661605.5,8275585.14
240810,201807,20084,11070,9014,10518591.93,8589008.25,19107600.18
240820,201807,210,135,75,128499.03,71550,200049.03
240830,201807,1612,1320,292,1253136.76,278568,1531704.76
240840,201807,82,72,10,68688,9540,78228
240850,201807,87,76,11,72504,10494,82998
240860,201807,115,112,3,106848,2862,109710
240870,201807,60,53,7,50562,6678,57240
240880,201807,29,26,3,24794.46,2862,27656.46
240890,201807,1177,702,475,665798.78,453146,1118944.78
240895,201807,47,34,13,32436,12402,44838
240910,201807,157,142,15,135468,14310,149778
240920,201807,16,13,3,12402,2862,15264
240930,201807,385,349,36,331992,34344,366336
240933,201807,31,24,7,22896,6678,29574
240940,201807,2438,2157,281,2044285.29,265192.92,2309478.21
240950,201807,51,48,3,45792,2862,48654
240960,201807,32,26,6,24804,5724,30528
240970,201807,126,89,37,84906,34544,119450
240980,201807,187,149,38,142146,36252,178398
240990,201807,119,78,41,74412,39114,113526
241000,201807,69,64,5,61056,4770,65826
241010,201807,60,48,12,45792,11448,57240
241020,201807,112,105,7,100170,6678,106848
241025,201807,10,4,6,3816,5724,9540
241030,201807,119,97,22,92538,20988,113526
241040,201807,35,29,6,27666,5724,33390
241050,201807,90,78,12,74412,11448,85860
241060,201807,28,24,4,22896,3816,26712
241070,201807,14,14,0,13356,0,13356
241080,201807,64,57,7,54091.8,6678,60769.8
241090,201807,49,41,8,39114,7617.69,46731.69
241100,201807,76,66,10,62964,9540,72504
241105,201807,6,2,4,1908,3816,5724
241110,201807,46,44,2,41976,1908,43884
241120,201807,1440,1113,327,1058816.8,311958,1370774.8
241140,201807,222,183,39,173629,37206,210835
241142,201807,42,40,2,38160,1908,40068
241150,201807,1225,1078,147,1025694,140238,1165932
241160,201807,22,21,1,20034,954,20988
241170,201807,43,39,4,37206,3816,41022
241180,201807,49,41,8,38939.42,7632,46571.42
241190,201807,38,37,1,35298,954,36252
241200,201807,3883,2121,1762,2017899.62,1679027.66,3696927.28
241210,201807,70,59,11,56286,9636,65922
241220,201807,1386,934,452,890571.04,431174.92,1321745.96
241230,201807,244,204,40,194425.2,38160,232585.2
241240,201807,53,40,13,38160,12402,50562
241250,201807,1096,1013,83,966116,79182,1045298
241255,201807,47,37,10,35298,9540,44838
241260,201807,638,503,135,479857.23,128790,608647.23
241270,201807,46,33,13,31482,12402,43884
241280,201807,98,85,13,81090,12402,93492
241290,201807,108,81,27,77274,25758,103032
241300,201807,79,56,23,53424,21942,75366
241310,201807,51,38,13,36109,12402,48511
241320,201807,28,14,14,13356,13356,26712
241330,201807,60,54,6,51516,5724,57240
241335,201807,62,55,7,51802.2,6678,58480.2
241340,201807,186,139,47,132606,44838,177444
241350,201807,61,56,5,53424,4770,58194
241355,201807,40,37,3,35298,2862,38160
241360,201807,47,47,0,44838,0,44838
241370,201807,45,38,7,36127.98,6678,42805.98
241380,201807,38,35,3,33390,2862,36252
241390,201807,74,59,15,56095.2,14310,70405.2
241400,201807,203,165,38,156742.2,36252,192994.2
241410,201807,179,162,17,154548,16122.6,170670.6
241415,201807,97,77,20,73458,19080,92538
241420,201807,99,75,24,71550,22725,94275
241430,201807,28,27,1,25758,954,26712
241440,201807,486,403,83,384448,79182,463630
241445,201807,38,36,2,34344,1908,36252
241450,201807,276,226,50,215604,47700,263304
241460,201807,135,123,12,117104,11448,128552
241470,201807,43,36,7,34344,6678,41022
241475,201807,64,62,2,59148,1908,61056
241480,201807,101,72,29,67734.69,27666,95400.69
241490,201807,8,7,1,6678,954,7632
241500,201807,47,34,13,32436,12402,44838
250010,201807,101,87,14,82854.9,13356,96210.9
250020,201807,30,26,4,24804,3816,28620
250030,201807,816,606,210,576779.2,199291.6,776070.8
250040,201807,335,281,54,268074,51229.8,319303.8
250050,201807,231,191,40,181923.8,38160,220083.8
250053,201807,54,41,13,39114,12402,51516
250057,201807,0,0,0,0,0,0
250060,201807,451,344,107,328176,101791.8,429967.8
250070,201807,706,586,120,557026,114480,671506
250073,201807,7,7,0,6678,0,6678
250077,201807,198,148,50,140800.86,47700,188500.86
250080,201807,425,331,94,314153.2,89676,403829.2
250090,201807,200,131,69,124020.4,65806.92,189827.32
250100,201807,513,422,91,402588,86433,489021
250110,201807,561,422,139,400804.02,132606,533410.02
250115,201807,25,8,17,7632,16218,23850
250120,201807,111,82,29,78228,27666,105894
250130,201807,574,462,112,440748,106658,547406
250135,201807,14,8,6,7632,5724,13356
250140,201807,80,72,8,68688,7632,76320
250150,201807,577,426,151,404850.58,143739.18,548589.76
250153,201807,10,9,1,8586,954,9540
250157,201807,28,23,5,21942,4770,26712
250160,201807,215,168,47,160272,44838,205110
250170,201807,63,44,19,41976,18126,60102
250180,201807,4045,2741,1304,2601851.13,1238918,3840769.13
250190,201807,865,570,295,542110.5,281430,823540.5
250200,201807,52,43,9,41022,8586,49608
250205,201807,23,20,3,19080,2862,21942
250210,201807,90,78,12,74412,11448,85860
250215,201807,63,54,9,51516,8586,60102
250220,201807,27,21,6,20034,5724,25758
250230,201807,78,71,7,67730,6678,74408
250240,201807,244,202,42,191897.1,40068,231965.1
250250,201807,401,342,59,326268,56286,382554
250260,201807,31,28,3,26712,2862,29574
250270,201807,58,45,13,42930,12402,55332
250280,201807,378,316,62,301464,59148,360612
250290,201807,94,89,5,84619.8,4770,89389.8
250300,201807,557,380,177,361872.71,168845,530717.71
250310,201807,45,41,4,39114,3816,42930
250320,201807,2002,1368,634,1299817.35,603281.8,1903099.15
250330,201807,81,72,9,68688,8586,77274
250340,201807,24,20,4,19080,3816,22896
250350,201807,137,87,50,82711.8,47127.6,129839.4
250355,201807,31,24,7,22896,6678,29574
250360,201807,201,164,37,156456,35298,191754
250370,201807,2385,1614,771,1534797.98,734931,2269728.98
250375,201807,15,11,4,10494,3816,14310
250380,201807,53,38,15,36252,14310,50562
250390,201807,41,34,7,32436,6678,39114
250400,201807,15802,8003,7799,7609200.29,7433797.55,15042997.84
250403,201807,419,342,77,326258.46,73458,399716.46
250407,201807,58,50,8,47700,7632,55332
250410,201807,33,28,5,26712,4770,31482
250415,201807,43,29,14,27646.92,13336.92,40983.84
250420,201807,47,39,8,37206,7632,44838
250430,201807,1528,1299,229,1237053,218466,1455519
250435,201807,16,13,3,12402,2862,15264
250440,201807,692,594,98,562940.22,93492,656432.22
250450,201807,89,73,16,69642,14596.2,84238.2
250460,201807,419,289,130,275706,124010.46,399716.46
250470,201807,86,63,23,60102,21942,82044
250480,201807,328,260,68,248040,64872,312912
250485,201807,2,1,1,954,954,1908
250490,201807,212,174,38,165996,36252,202248
250500,201807,79,58,21,55332,20034,75366
250510,201807,737,578,159,550649,150677.43,701326.43
250520,201807,175,121,54,115414.92,51511.23,166926.15
250523,201807,113,94,19,89676,18126,107802
250527,201807,102,81,21,77269.23,20034,97303.23
250530,201807,7,5,2,4770,1908,6678
250535,201807,25,21,4,20034,3816,23850
250540,201807,124,95,29,89914.5,27666,117580.5
250550,201807,71,68,3,64872,2862,67734
250560,201807,40,32,8,30528,7632,38160
250570,201807,152,122,30,116388,28620,145008
250580,201807,128,100,28,95175.8,26712,121887.8
250590,201807,20,16,4,15264,3816,19080
250600,201807,1252,846,406,805177.35,387324,1192501.35
250610,201807,150,130,20,124020,19080,143100
250620,201807,22,18,4,17172,3816,20988
250625,201807,66,50,16,47700,15264,62964
250630,201807,3022,1939,1083,1841768.42,1032125.05,2873893.47
250640,201807,205,171,34,163134,32436,195570
250650,201807,30,20,10,19080,9540,28620
250660,201807,45,35,10,33390,9540,42930
250670,201807,60,39,21,37206,20034,57240
250680,201807,382,315,67,300510,63918,364428
250690,201807,1854,1283,571,1220543.53,544352.8,1764896.33
250700,201807,932,819,113,777782.48,107592.12,885374.60
250710,201807,450,349,101,332946,96354,429300
250720,201807,106,83,23,79182,21942,101124
250730,201807,376,316,60,300510.6,57240,357750.6
250740,201807,52,48,4,45792,3816,49608
250750,201807,20572,12352,8220,11728527.27,7832223,19560750.27
250760,201807,74,55,19,52470,18126,70596
250770,201807,352,231,121,218466.14,113025.35,331491.49
250780,201807,54,41,13,39114,12402,51516
250790,201807,470,307,163,290970.92,154786.5,445757.42
250800,201807,154,142,12,134752.5,11448,146200.5
250810,201807,79,61,18,58194,17172,75366
250820,201807,158,129,29,123066,27666,150732
250830,201807,419,287,132,272796.5,125928,398724.5
250840,201807,52,50,2,47700,1908,49608
250850,201807,54,42,12,40068,11448,51516
250855,201807,14,12,2,11448,1908,13356
250860,201807,203,146,57,139284,54091.8,193375.8
250870,201807,33,30,3,28620,2862,31482
250880,201807,78,60,18,57230.46,17172,74402.46
250890,201807,2455,1820,635,1734753.6,604926.73,2339680.33
250900,201807,125,106,19,101124,18126,119250
250905,201807,123,95,28,90630,26712,117342
250910,201807,1181,843,338,803059.31,321879.8,1124939.11
250915,201807,111,76,35,72504,33390,105894
250920,201807,139,108,31,103032,29574,132606
250930,201807,165,102,63,97308,60102,157410
250933,201807,1,1,0,954,0,954
250937,201807,6,5,1,4770,954,5724
250939,201807,32,23,9,21942,8586,30528
250940,201807,103,77,26,73458,24804,98262
250950,201807,70,47,23,44838,21942,66780
250960,201807,91,50,41,47700,39114,86814
250970,201807,1212,866,346,824543,329130,1153673
250980,201807,92,65,27,62010,25758,87768
250990,201807,165,129,36,122593.77,34301.07,156894.84
251000,201807,76,68,8,64681.2,7632,72313.2
251010,201807,103,80,23,76316,21163.53,97479.53
251020,201807,78,68,10,64061.1,9540,73601.1
251030,201807,45,35,10,33390,9540,42930
251040,201807,53,38,15,36252,14310,50562
251050,201807,23,21,2,20034,1908,21942
251060,201807,49,38,11,35298,10494,45792
251065,201807,3,3,0,2862,0,2862
251070,201807,25,20,5,19071,4770,23841
251080,201807,4704,2280,2424,2164723.84,2306610.81,4471334.65
251090,201807,197,169,28,161226,26712,187938
251100,201807,18,17,1,16218,954,17172
251110,201807,45,36,9,34344,8586,42930
251120,201807,1819,1105,714,1049260.2,681156,1730416.2
251130,201807,383,313,70,298492.29,66780,365272.29
251140,201807,522,340,182,323216.8,173459.34,496676.14
251150,201807,296,257,39,244406,37206,281612
251160,201807,97,82,15,78224,14310,92534
251170,201807,98,78,20,74383.38,19075.23,93458.61
251180,201807,290,184,106,175527.23,101115.23,276642.46
251190,201807,191,130,61,123691.83,58194,181885.83
251200,201807,256,208,48,198432,45792,244224
251203,201807,34,32,2,30528,1908,32436
251207,201807,95,79,16,75366,15264,90630
251210,201807,1416,1018,398,969618.53,379024.2,1348642.73
251220,201807,47,37,10,35298,9540,44838
251230,201807,469,391,78,373014,74412,447426
251240,201807,99,72,27,67734,25758,93492
251250,201807,1339,957,382,910088.87,364285,1274373.87
251260,201807,13,8,5,7632,4770,12402
251270,201807,344,257,87,245178,82855,328033
251272,201807,63,58,5,55332,4770,60102
251274,201807,27,22,5,20988,4770,25758
251275,201807,23,16,7,15264,6678,21942
251276,201807,17,13,4,12402,3816,16218
251278,201807,8,7,1,6678,954,7632
251280,201807,101,96,5,91584,4770,96354
251290,201807,707,534,173,509436,165042,674478
251300,201807,17,14,3,13356,2862,16218
251310,201807,369,265,104,252806,99216,352022
251315,201807,19,18,1,17172,954,18126
251320,201807,61,50,11,47700,10494,58194
251330,201807,80,71,9,67734,8586,76320
251335,201807,12,7,5,6678,4770,11448
251340,201807,697,412,285,393048,270865.25,663913.25
251350,201807,37,35,2,33390,1908,35298
251360,201807,74,65,9,61803.94,8586,70389.94
251365,201807,15,14,1,13356,954,14310
251370,201807,5322,3617,1705,3446303.94,1625236,5071539.94
251380,201807,49,39,10,37206,9540,46746
251385,201807,3,3,0,2862,0,2862
251390,201807,686,543,143,516878.2,135182,652060.2
251392,201807,12,7,5,6678,4770,11448
251394,201807,10,10,0,9317.4,0,9317.4
251396,201807,15,10,5,9540,4770,14310
251398,201807,18,15,3,14310,2862,17172
251400,201807,41,34,7,32436,6678,39114
251410,201807,36,31,5,29574,4770,34344
251420,201807,104,78,26,74412,24804,99216
251430,201807,40,37,3,35298,2862,38160
251440,201807,33,22,11,20988,10494,31482
251445,201807,54,49,5,46746,4770,51516
251450,201807,416,367,49,348462.8,46746,395208.8
251455,201807,2,1,1,954,954,1908
251460,201807,16,12,4,11448,3816,15264
251465,201807,5,2,3,1908,2862,4770
251470,201807,47,37,10,35298,9540,44838
251480,201807,26,24,2,22896,1908,24804
251490,201807,123,85,38,80613,35299,115912
251500,201807,119,95,24,90630,22133,112763
251510,201807,37,28,9,26712,8586,35298
251520,201807,25,25,0,23850,0,23850
251530,201807,4531,3190,1341,3037021.24,1279018.26,4316039.50
251540,201807,75,66,9,62964,8586,71550
251550,201807,412,319,93,303372.2,88198,391570.2
251560,201807,24,17,7,16218,6678,22896
251570,201807,20,20,0,19080,0,19080
251580,201807,122,100,22,95400,20988,116388
251590,201807,123,91,32,86995,30528,117523
251593,201807,23,14,9,13356,8586,21942
251597,201807,53,44,9,41976,8586,50562
251600,201807,1095,776,319,738812.48,302717.92,1041530.40
251610,201807,209,158,51,150732,47987,198719
251615,201807,3,3,0,2862,0,2862
251620,201807,4244,2831,1413,2690933.84,1345237,4036170.84
251630,201807,449,331,118,315774,112563,428337
251640,201807,149,105,44,100170,41976,142146
251650,201807,270,197,73,186105.1,69642,255747.1
251660,201807,226,204,22,194616,20797.2,215413.2
251670,201807,359,278,81,263516,77274,340790
251675,201807,3,3,0,2862,0,2862
251680,201807,98,88,10,83952,9540,93492
251690,201807,343,287,56,272844,53073.89,325917.89
251700,201807,283,238,45,226465.29,42915.69,269380.98
251710,201807,21,14,7,13356,6678,20034
251720,201807,32,22,10,20988,9254,30242
251740,201807,10,8,2,7632,1908,9540
260005,201807,3180,1803,1377,1708973.34,1312777.1,3021750.44
260010,201807,1490,1064,426,1010297.48,404401.32,1414698.80
260020,201807,426,375,51,357750,48654,406404
260030,201807,580,420,160,399912.98,152640,552552.98
260040,201807,853,530,323,504532.44,308132.46,812664.90
260050,201807,1143,820,323,782042,307570,1089612
260060,201807,412,373,39,355078.8,37206,392284.8
260070,201807,1464,923,541,876420,513144.36,1389564.36
260080,201807,732,576,156,548693.1,148824,697517.1
260090,201807,576,361,215,344166.12,205110,549276.12
260100,201807,229,161,68,152784,64872,217656
260105,201807,232,131,101,124974,96354,221328
260110,201807,2770,2056,714,1961415,680346,2641761
260120,201807,2922,1460,1462,1383122.21,1392460.1,2775582.31
260130,201807,154,107,47,102078,44838,146916
260140,201807,2149,1408,741,1334740.76,705369.46,2040110.22
260150,201807,225,149,76,142146,72504,214650
260160,201807,300,257,43,245178,41022,286200
260170,201807,3399,2069,1330,1967066.58,1267436.9,3234503.48
260180,201807,141,119,22,113526,20988,134514
260190,201807,2296,1616,680,1538513.9,648720,2187233.9
260200,201807,901,739,162,704231.08,154262,858493.08
260210,201807,1415,1009,406,962435.27,385435.11,1347870.38
260220,201807,724,661,63,630594,60102,690696
260230,201807,1205,911,294,866902.99,280476,1147378.99
260240,201807,225,171,54,162180,51516,213696
260250,201807,76,60,16,57240,15264,72504
260260,201807,996,717,279,684018,266166,950184
260270,201807,428,346,82,328701.2,77941.8,406643.0
260280,201807,1403,888,515,846675,491024,1337699
260290,201807,6402,3428,2974,3251841.45,2830486,6082327.45
260300,201807,877,774,103,736327.6,97976,834303.6
260310,201807,509,406,103,385945.47,98262,484207.47
260320,201807,879,662,217,631261.2,207018,838279.2
260330,201807,36,27,9,25758,8586,34344
260340,201807,69,50,19,47700,18126,65826
260345,201807,5651,3176,2475,3022773.63,2360073.76,5382847.39
260350,201807,482,354,128,335972.08,122112,458084.08
260360,201807,284,146,138,139284,131652,270936
260370,201807,667,438,229,415242.4,218326,633568.4
260380,201807,604,434,170,414036,161035.56,575071.56
260390,201807,298,252,46,239329.98,42930,282259.98
260392,201807,100,88,12,83952,11448,95400
260400,201807,4067,2341,1726,2224696.86,1646233.22,3870930.08
260410,201807,14743,7729,7014,7358255.03,6688911.2,14047166.23
260415,201807,121,110,11,104940,10494,115434
260420,201807,1791,1072,719,1017611.04,684272.64,1701883.68
260430,201807,192,177,15,167646.66,14310,181956.66
260440,201807,227,164,63,155732,60102,215834
260450,201807,477,345,132,327845,125928,453773
260460,201807,849,452,397,428538.8,378733.23,807272.03
260470,201807,372,229,143,217702.8,136116,353818.8
260480,201807,207,130,77,124020,73458,197478
260490,201807,211,171,40,163134,38160,201294
260500,201807,1136,765,371,727522.2,353647.8,1081170.0
260510,201807,744,592,152,563814,144054,707868
260515,201807,259,231,28,220374,26235,246609
260520,201807,3338,1987,1351,1888298.52,1286651.62,3174950.14
260530,201807,795,645,150,612837.72,143100,755937.72
260540,201807,567,432,135,412128,127836.72,539964.72
260545,201807,13,10,3,9540,2862,12402
260550,201807,348,217,131,207018,124974,331992
260560,201807,521,390,131,371774,124687.8,496461.8
260570,201807,1018,835,183,793871.8,174295.8,968167.6
260580,201807,263,235,28,224190,26712,250902
260590,201807,659,378,281,359200.08,268074,627274.08
260600,201807,8212,4199,4013,3985268.06,3824533.53,7809801.59
260610,201807,492,332,160,316728,152353.8,469081.8
260620,201807,3668,1917,1751,1817367.29,1668522.17,3485889.46
260630,201807,78,75,3,71550,2862,74412
260640,201807,3723,2031,1692,1933810.63,1614111.3,3547921.93
260650,201807,324,231,93,220374,88106.67,308480.67
260660,201807,508,348,160,331610.4,152640,484250.4
260670,201807,103,76,27,72504,25758,98262
260680,201807,3670,2053,1617,1941678.32,1541988.84,3483667.16
260690,201807,121,95,26,90630,24804,115434
260700,201807,326,199,127,189082.8,120324,309406.8
260710,201807,38,35,3,33390,2862,36252
260720,201807,2248,1346,902,1277877.69,859716.18,2137593.87
260730,201807,611,463,148,441702,138997.8,580699.8
260740,201807,61,57,4,54378,3816,58194
260750,201807,633,440,193,419435.64,184122,603557.64
260760,201807,622,335,287,319590,273798,593388
260765,201807,987,520,467,492851.8,445279.5,938131.3
260770,201807,221,166,55,158364,52470,210834
260775,201807,819,488,331,464169.8,315765,779934.8
260780,201807,268,174,94,165996,89676,255672
260790,201807,12314,6779,5535,6440857.54,5272963.13,11713820.67
260795,201807,168,117,51,110454.12,48654,159108.12
260800,201807,283,235,48,223713,45792,269505
260805,201807,171,110,61,104211.14,58194,162405.14
260810,201807,742,648,94,616942.26,89676,706618.26
260820,201807,315,213,102,201872.79,97308,299180.79
260825,201807,201,137,64,130524.57,61056,191580.57
260830,201807,262,170,92,162180,87768,249948
260840,201807,234,168,66,159605,62964,222569
260845,201807,211,146,65,139284,62010,201294
260850,201807,504,365,139,346546.09,132606,479152.09
260860,201807,254,191,63,182016.34,60102,242118.34
260870,201807,375,273,102,259202.42,97308,356510.42
260875,201807,713,503,210,478748.69,200340,679088.69
260880,201807,1591,970,621,923707.29,592243.2,1515950.49
260890,201807,2436,1701,735,1615969.81,700237,2316206.81
260900,201807,1040,717,323,682715.79,308142,990857.79
260910,201807,279,219,60,208926,57240,266166
260915,201807,303,204,99,194616,94326,288942
260920,201807,178,101,77,96354,73458,169812
260930,201807,391,335,56,319590,53338.45,372928.45
260940,201807,2828,1547,1281,1471007.69,1221577.92,2692585.61
260950,201807,2037,1182,855,1121275.82,815670,1936945.82
260960,201807,14257,7425,6832,7049979.79,6509538.03,13559517.82
260970,201807,438,375,63,356961,60102,417063
260980,201807,194,171,23,162847.8,21942,184789.8
260990,201807,2577,2124,453,2024551.2,431494.2,2456045.4
261000,201807,4384,2590,1794,2458410.04,1709570.77,4167980.81
261010,201807,186,137,49,130698,45928.23,176626.23
261020,201807,610,456,154,434881,146916,581797
261030,201807,225,163,62,155502,58914.27,214416.27
261040,201807,365,325,40,310050,37873.8,347923.8
261050,201807,474,416,58,396864,55332,452196
261060,201807,1332,880,452,837088.55,431208,1268296.55
261070,201807,9077,4610,4467,4373623.81,4253695.53,8627319.34
261080,201807,407,296,111,281612,105894,387506
261090,201807,2246,1726,520,1637822.05,495308,2133130.05
261100,201807,1088,764,324,726805.8,307226.16,1034031.96
261110,201807,8120,4957,3163,4723899.09,3014820.55,7738719.64
261120,201807,274,229,45,218466,42925.23,261391.23
261130,201807,571,334,237,318112.1,225908,544020.1
261140,201807,191,125,66,119250,62964,182214
261150,201807,669,395,274,376830,260155.8,636985.8
261153,201807,74,70,4,65826.31,3816,69642.31
261160,201807,77351,39002,38349,37088407.47,36563518.41,73651925.88
261170,201807,449,337,112,320868.36,106848,427716.36
261180,201807,1791,1103,688,1047139.62,656352,1703491.62
261190,201807,618,429,189,408822.23,180297,589119.23
261200,201807,216,191,25,181449.3,23850,205299.3
261210,201807,34,31,3,29574,2862,32436
261220,201807,2598,1835,763,1744418.82,727329.8,2471748.62
261230,201807,332,244,88,232776,83937.69,316713.69
261240,201807,450,387,63,365184.95,60102,425286.95
261245,201807,224,188,36,179352,34344,213696
261247,201807,156,119,37,113526,35298,148824
261250,201807,2867,1462,1405,1393928.26,1339259.83,2733188.09
261255,201807,253,230,23,219420,21942,241362
261260,201807,869,749,120,714546,114480,829026
261270,201807,176,137,39,130698,37206,167904
261280,201807,161,134,27,127836,25758,153594
261290,201807,125,87,38,82759.5,36252,119011.5
261300,201807,1237,882,355,841428,338670,1180098
261310,201807,768,512,256,487711.31,243603.9,731315.21
261320,201807,541,364,177,346970,168858,515828
261330,201807,893,706,187,670525.5,177552.46,848077.96
261340,201807,306,173,133,165042,126882,291924
261350,201807,805,576,229,548550.2,218466,767016.2
261360,201807,1242,804,438,766614.37,417566,1184180.37
261370,201807,5028,3093,1935,2935606.62,1843068.45,4778675.07
261380,201807,576,424,152,402597.64,144722,547319.64
261390,201807,3462,2305,1157,2194992.2,1100489.5,3295481.7
261400,201807,278,251,27,238881.6,25758,264639.6
261410,201807,1078,715,363,682110,346297.23,1028407.23
261420,201807,891,563,328,535835.26,312893.46,848728.72
261430,201807,330,300,30,285354,28333.8,313687.8
261440,201807,118,107,11,102078,10494,112572
261450,201807,2501,2081,420,1982613.44,400432.04,2383045.48
261460,201807,721,577,144,549504.02,137376,686880.02
261470,201807,252,193,59,183312,56247.84,239559.84
261480,201807,363,293,70,278283,66776,345059
261485,201807,336,205,131,194902.2,124974,319876.2
261500,201807,624,423,201,403542,191754,595296
261510,201807,48,33,15,31482,14310,45792
261520,201807,109,96,13,91584,12402,103986
261530,201807,4185,2651,1534,2520857.94,1462182.69,3983040.63
261540,201807,1093,671,422,639670.36,402588,1042258.36
261550,201807,285,144,141,136280,134494.92,270774.92
261560,201807,801,533,268,505526.2,254518.6,760044.8
261570,201807,373,290,83,276660,79182,355842
261580,201807,379,297,82,282574,78228,360802
261590,201807,193,156,37,148824,35298,184122
261600,201807,295,237,58,225335,54855,280190
261610,201807,108,94,14,89199,13356,102555
261618,201807,65,51,14,48654,13356,62010
261620,201807,202,123,79,117342,75366,192708
261630,201807,586,452,134,428847.6,127836,556683.6
261640,201807,6376,3383,2993,3220020.59,2851707.92,6071728.51
261650,201807,493,313,180,297924.66,171720,469644.66
270010,201807,531,470,61,448094,57431,505525
270020,201807,308,246,62,234680,59148,293828
270030,201807,9224,5901,3323,5615638.07,3167412.96,8783051.03
270040,201807,2012,1240,772,1182759.66,735247.8,1918007.46
270050,201807,178,131,47,124974,44838,169812
270060,201807,117,65,52,62010,49608,111618
270070,201807,900,654,246,622592.62,234379.26,856971.88
270080,201807,38,32,6,30528,5724,36252
270090,201807,20,16,4,15264,3816,19080
270100,201807,1262,839,423,797407.51,401395.7,1198803.21
270110,201807,145,107,38,102078,36252,138330
270120,201807,228,187,41,177546.55,39114,216660.55
270130,201807,246,169,77,160653.6,73458,234111.6
270135,201807,101,63,38,60102,36252,96354
270140,201807,1307,792,515,755347.19,490347.2,1245694.39
270150,201807,267,213,54,203202,51516,254718
270160,201807,525,392,133,373968,126214.2,500182.2
270170,201807,735,474,261,451909.8,247753.8,699663.6
270180,201807,70,54,16,51198.04,15054.12,66252.16
270190,201807,101,89,12,84906,11448,96354
270200,201807,108,97,11,92347.2,10494,102841.2
270210,201807,483,249,234,237546,222949.8,460495.8
270220,201807,185,145,40,138330,38160,176490
270230,201807,2118,1267,851,1203975.31,809946.62,2013921.93
270235,201807,741,560,181,533969.59,172308.95,706278.54
270240,201807,3127,2434,693,2309379.48,658330,2967709.48
270250,201807,172,119,53,113526,50562,164088
270255,201807,224,192,32,183168,30146.4,213314.4
270260,201807,333,265,68,252810,64872,317682
270270,201807,113,47,66,44829,62964,107793
270280,201807,202,123,79,117342,75346.92,192688.92
270290,201807,1185,895,290,852594.42,275783.46,1128377.88
270300,201807,287,184,103,175536,97975.8,273511.8
270310,201807,919,739,180,702414.51,171015.12,873429.63
270320,201807,882,753,129,716690.8,122779.8,839470.6
270330,201807,274,228,46,216558,43884,260442
270340,201807,60,48,12,45792,11448,57240
270350,201807,91,46,45,43645.5,42930,86575.5
270360,201807,74,41,33,39114,31482,70596
270370,201807,51,39,12,37206,11448,48654
270375,201807,68,39,29,37206,27666,64872
270380,201807,1076,611,465,581940,443610,1025550
270390,201807,195,109,86,103986,82044,186030
270400,201807,706,515,191,490095.27,182214,672309.27
270410,201807,698,500,198,476682.04,188882.46,665564.50
270420,201807,405,264,141,250158,134429.38,384587.38
270430,201807,32736,23398,9338,22262889.75,8900693.33,31163583.08
270440,201807,492,385,107,367290,101791.8,469081.8
270450,201807,779,412,367,392809.5,349164.66,741974.16
270460,201807,198,152,46,145008,43884,188892
270470,201807,1383,926,457,882745.41,435978,1318723.41
270480,201807,532,429,103,406976.8,97546.5,504523.3
270490,201807,25,20,5,19080,4770,23850
270500,201807,512,420,92,400680,87768,488448
270510,201807,741,454,287,433116,273798,706914
270520,201807,365,224,141,213487,134514,348001
270530,201807,65,57,8,53710.2,7632,61342.2
270540,201807,122,93,29,88722,27666,116388
270550,201807,1736,1311,425,1250084.98,404968.23,1655053.21
270560,201807,313,146,167,139284,159318,298602
270570,201807,461,309,152,292796.56,144625.53,437422.09
270580,201807,82,61,21,58194,20034,78228
270590,201807,74,61,13,58194,12402,70596
270600,201807,181,149,32,142146,30528,172674
270610,201807,194,159,35,151677,33390,185067
270620,201807,30,29,1,27666,954,28620
270630,201807,3891,2960,931,2810883.63,886009.42,3696893.05
270640,201807,902,663,239,631452.6,227691.8,859144.4
270642,201807,213,181,32,172674,30528,203202
270644,201807,271,185,86,176299.74,82039.23,258338.97
270650,201807,263,153,110,145962,104940,250902
270660,201807,258,209,49,199386,46746,246132
270670,201807,3186,2426,760,2303795.43,722122.45,3025917.88
270680,201807,469,273,196,260433,186980,447413
270690,201807,1122,708,414,673679.88,394946.46,1068626.34
270700,201807,35,27,8,25758,7632,33390
270710,201807,890,672,218,639667,207972,847639
270720,201807,251,189,62,180306,58861.8,239167.8
270730,201807,1934,1128,806,1073012.8,766818.2,1839831.0
270740,201807,45,28,17,26712,16218,42930
270750,201807,643,472,171,450098,162467,612565
270760,201807,304,218,86,207972,82044,290016
270770,201807,2786,1773,1013,1684149,965448,2649597
270780,201807,91,56,35,53419.23,33372.46,86791.69
270790,201807,264,177,87,168858,82998,251856
270800,201807,1967,1576,391,1501711.25,372269.88,1873981.13
270810,201807,302,240,62,228945.69,59139.23,288084.92
270820,201807,159,104,55,99216,52375,151591
270830,201807,917,664,253,632689,241076,873765
270840,201807,1413,1038,375,989512.9,356082,1345594.9
270850,201807,1657,1013,644,960240.36,614357.46,1574597.82
270860,201807,2468,1604,864,1527886.4,821358.57,2349244.97
270870,201807,120,64,56,61056,53424,114480
270880,201807,916,681,235,647829.14,223305.58,871134.72
270890,201807,348,254,94,241867.62,89671.23,331538.85
270895,201807,73,63,10,60102,9540,69642
270900,201807,104,80,24,76320,22896,99216
270910,201807,325,258,67,244987.2,63918,308905.2
270915,201807,1848,1111,737,1055005.1,701377.4,1756382.5
270920,201807,482,406,76,387324,72504,459828
270930,201807,6181,4485,1696,4273013.31,1615307.24,5888320.55
270940,201807,2401,1823,578,1737172.88,550440,2287612.88
280010,201807,43,38,5,36252,4770,41022
280020,201807,710,616,94,584484.13,88722,673206.13
280030,201807,19705,12662,7043,11998158.28,6690486.02,18688644.30
280040,201807,338,215,123,205110,115911,321021
280050,201807,377,288,89,274465.8,84906,359371.8
280060,201807,332,220,112,207633.43,106848,314481.43
280067,201807,989,694,295,659317.94,280476.25,939794.19
280070,201807,130,109,21,103986,20034,124020
280100,201807,623,494,129,468245.47,122876,591121.47
280110,201807,75,70,5,66780,4770,71550
280120,201807,628,503,125,479862,119250,599112
280130,201807,1394,873,521,831411.8,496890.9,1328302.7
280140,201807,477,388,89,368339.4,83952,452291.4
280150,201807,330,244,86,231332.89,82044,313376.89
280160,201807,95,81,14,77274,13356,90630
280170,201807,598,396,202,376587.56,192708,569295.56
280190,201807,27,25,2,23850,1908,25758
280200,201807,27,19,8,18126,7632,25758
280210,201807,2775,1959,816,1850180.71,772896.51,2623077.22
280220,201807,41,31,10,29574,9540,39114
280230,201807,321,265,56,251975.63,53424,305399.63
280240,201807,115,110,5,104796.9,4770,109566.9
280250,201807,17,11,6,10494,5724,16218
280260,201807,80,69,11,65826,10494,76320
280270,201807,161,124,37,118296,35298,153594
280280,201807,193,125,68,119250,64872,184122
280290,201807,3127,2261,866,2145031.74,824853.25,2969884.99
280300,201807,1112,849,263,807498.99,250138.8,1057637.79
280310,201807,107,102,5,96977.29,4770,101747.29
280320,201807,654,447,207,426429,197478,623907
280330,201807,359,259,100,247086,95275.98,342361.98
280340,201807,426,341,85,323842.57,80327,404169.57
280350,201807,3463,2671,792,2536022.13,752829.09,3288851.22
280360,201807,464,291,173,277614,164088,441702
280370,201807,97,86,11,82044,10494,92538
280380,201807,56,43,13,41022,12402,53424
280390,201807,184,156,28,148824,26712,175536
280400,201807,344,235,109,223284.1,103986,327270.1
280410,201807,286,232,54,220375,51516,271891
280420,201807,174,146,28,139265,26712,165977
280430,201807,112,82,30,78228,28511.63,106739.63
280440,201807,688,533,155,504572.6,147669.66,652242.26
280445,201807,118,110,8,104940,7632,112572
280450,201807,1112,950,162,902905.46,154548,1057453.46
280460,201807,760,560,200,526330.04,190800,717130.04
280470,201807,189,173,16,165042,14311,179353
280480,201807,2294,1625,669,1535212.09,635281.79,2170493.88
280490,201807,353,326,27,309612,25758,335370
280500,201807,43,39,4,37206,3816,41022
280510,201807,142,111,31,105593.2,29288,134881.2
280520,201807,55,41,14,39114,13356,52470
280530,201807,77,54,23,51516,21942,73458
280540,201807,507,408,99,389096.74,94159.8,483256.54
280550,201807,712,658,54,627024.6,51516,678540.6
280560,201807,492,430,62,407501.1,59148,466649.1
280570,201807,1781,1355,426,1288464.47,405548.83,1694013.30
280580,201807,601,458,143,435361.6,136327,571688.6
280590,201807,167,104,63,98936.48,60102,159038.48
280600,201807,364,306,58,291924,55332,347256
280610,201807,139,105,34,99964,32436,132400
280620,201807,551,453,98,430445.5,93348.9,523794.4
280630,201807,165,137,28,130698,26712,157410
280640,201807,206,164,42,155627,40068,195695
280650,201807,78,53,25,50562,23850,74412
280660,201807,132,96,36,91584,34105.5,125689.5
280670,201807,1657,1032,625,976188.05,592505.95,1568694.00
280680,201807,183,158,25,148948.14,23850,172798.14
280690,201807,55,45,10,42930,9540,52470
280700,201807,19,19,0,18126,0,18126
280710,201807,1410,1074,336,1017521.39,320544,1338065.39
280720,201807,109,73,36,67082.4,34344,101426.4
280730,201807,26,22,4,20988,3816,24804
280740,201807,2435,1802,633,1712619.29,602776.46,2315395.75
280750,201807,301,261,40,248994,38160,287154
280760,201807,896,618,278,588236.4,265212,853448.4
290010,201807,206,139,67,132606,63918,196524
290020,201807,179,166,13,158364,12402,170766
290030,201807,597,388,209,369484.2,199386,568870.2
290035,201807,139,113,26,105313.2,24804,130117.2
290040,201807,276,173,103,165042,98262,263304
290050,201807,81,61,20,58194,19080,77274
290060,201807,255,114,141,108469.8,134514,242983.8
290070,201807,5622,2773,2849,2638003.67,2714662.7,5352666.37
290080,201807,496,222,274,211482.72,261377,472859.72
290090,201807,390,171,219,163134,208926,372060
290100,201807,1604,1061,543,1008142.2,517449.8,1525592.0
290110,201807,771,458,313,434841.2,298068.53,732909.73
290115,201807,213,195,18,185076,17172,202248
290120,201807,775,502,273,478240.2,260442,738682.2
290130,201807,415,246,169,234388.26,161226,395614.26
290135,201807,299,226,73,214926.66,69642,284568.66
290140,201807,301,250,51,238500,48463.2,286963.2
290150,201807,132,100,32,95400,30528,125928
290160,201807,251,191,60,180974.58,57240,238214.58
290170,201807,89,64,25,61056,23850,84906
290180,201807,157,124,33,118296,31482,149778
290190,201807,448,365,83,347924,78895.8,426819.8
290195,201807,314,187,127,178398,121158,299556
290200,201807,280,234,46,223236,43884,267120
290205,201807,145,88,57,83952,54378,138330
290210,201807,1139,826,313,786860.2,298602,1085462.2
290220,201807,224,125,99,118773,94446,213219
290225,201807,290,111,179,105894,170766,276660
290230,201807,65,43,22,41022,20988,62010
290240,201807,308,121,187,115147.8,178398,293545.8
290250,201807,270,246,24,233988,22896,256884
290260,201807,287,234,53,222187,50562,272749
290265,201807,183,152,31,144191,29574,173765
290270,201807,1396,1155,241,1100010.2,228765,1328775.2
290280,201807,469,344,125,328176,119250,447426
290290,201807,1237,725,512,685847.89,488448,1174295.89
290300,201807,452,381,71,363183.23,67734,430917.23
290310,201807,318,142,176,135468,167904,303372
290320,201807,4001,2484,1517,2365634.64,1445310.2,3810944.84
290323,201807,186,162,24,154544,22896,177440
290327,201807,155,122,33,116116.11,31482,147598.11
290330,201807,77,43,34,41022,32436,73458
290340,201807,904,363,541,345329,515828,861157
290350,201807,596,355,241,338670,229914,568584
290360,201807,368,276,92,261397.69,87768,349165.69
290370,201807,909,368,541,351072,516100,867172
290380,201807,310,190,120,181260,114480,295740
290390,201807,2502,1561,941,1486221.58,895520,2381741.58
290395,201807,243,135,108,128265.8,103032,231297.8
290400,201807,282,209,73,199100,69642,268742
290405,201807,250,218,32,207972,30528,238500
290410,201807,580,497,83,471133.64,79182,550315.64
290420,201807,239,188,51,179352,48654,228006
290430,201807,492,308,184,293832,175536,469368
290440,201807,73,65,8,62010,7632,69642
290450,201807,230,177,53,168858,50562,219420
290460,201807,1880,1119,761,1065657.8,725231.32,1790889.12
290470,201807,1441,608,833,578903.22,794367.36,1373270.58
290475,201807,588,548,40,521647,38160,559807
290480,201807,292,163,129,155502,123066,278568
290485,201807,231,215,16,205110,15264,220374
290490,201807,1172,842,330,803268,313866.2,1117134.2
290500,201807,690,352,338,334854,322452,657306
290510,201807,220,169,51,160558.2,48654,209212.2
290515,201807,135,80,55,76320,52470,128790
290520,201807,1421,922,499,877013.58,472518.22,1349531.80
290530,201807,314,285,29,271890,27666,299556
290540,201807,95,58,37,55332,35298,90630
290550,201807,152,127,25,121158,23783.22,144941.22
290560,201807,3350,1377,1973,1312360.76,1882047.59,3194408.35
290570,201807,6019,3070,2949,2925027.41,2810150.95,5735178.36
290580,201807,1282,761,521,724753.8,496318.5,1221072.3
290590,201807,541,446,95,424693,90630,515323
290600,201807,1728,1196,532,1136283.05,507499.38,1643782.43
290610,201807,218,196,22,186765,20988,207753
290620,201807,335,298,37,284292,35298,319590
290630,201807,2062,880,1182,836372.69,1123876.02,1960248.71
290640,201807,150,122,28,116388,26712,143100
290650,201807,1720,810,910,771777,868140,1639917
290660,201807,288,232,56,221328,53424,274752
290670,201807,1001,517,484,492646,461390.38,954036.38
290680,201807,1197,961,236,915553.8,224190,1139743.8
290682,201807,291,214,77,203845.3,73439.46,277284.76
290685,201807,232,149,83,141192,79182,220374
290687,201807,924,608,316,577516.1,301464,878980.1
290689,201807,131,75,56,71536,53409.69,124945.69
290690,201807,650,266,384,253735.92,365456.8,619192.72
290700,201807,246,117,129,111618,123066,234684
290710,201807,708,477,231,455058,220374,675432
290720,201807,1025,833,192,794396,182691,977087
290730,201807,1142,655,487,623010.5,463644,1086654.5
290740,201807,16,13,3,12402,2862,15264
290750,201807,1378,632,746,601015.23,710368.79,1311384.02
290755,201807,73,64,9,61056,8586,69642
290760,201807,303,261,42,248994,40068,289062
290770,201807,190,178,12,169802.46,11162,180964.46
290780,201807,986,789,197,750763.46,186125.4,936888.86
290790,201807,374,261,113,248994,107802,356796
290800,201807,2616,1058,1558,1006685.04,1485225.36,2491910.40
290810,201807,438,306,132,291638,125928,417566
290820,201807,388,236,152,224176,145008,369184
290830,201807,408,283,125,269982,119250,389232
290840,201807,1713,1056,657,1005278.8,624698.48,1629977.28
290850,201807,776,426,350,406404,332946,739350
290860,201807,644,289,355,275706,338384,614090
290870,201807,662,476,186,452883.8,177444,630327.8
290880,201807,125,68,57,64872,54378,119250
290890,201807,335,237,98,226098,93492,319590
290900,201807,171,129,42,123066,40068,163134
290910,201807,366,277,89,264258,84906,349164
290920,201807,232,198,34,188892,32436,221328
290930,201807,832,633,199,603882,189827,793709
290940,201807,250,206,44,195760.8,41976,237736.8
290950,201807,170,97,73,92538,69642,162180
290960,201807,449,303,146,287822.24,138997.8,426820.04
290970,201807,252,222,30,211597.2,28620,240217.2
290980,201807,1512,1068,444,1014703.76,422527.2,1437230.96
290990,201807,378,317,61,302389.92,58138.38,360528.30
291000,201807,868,244,624,232776,595009.8,827785.8
291005,201807,2150,908,1242,864171.76,1184091.03,2048262.79
291010,201807,155,139,16,132606,15264,147870
291020,201807,103,81,22,77274,20988,98262
291030,201807,96,70,26,66780,24804,91584
291040,201807,576,291,285,277614,271890,549504
291050,201807,1360,764,596,727497.43,568584,1296081.43
291060,201807,1506,830,676,791152.2,644904,1436056.2
291070,201807,1898,1401,497,1331462.53,472877.5,1804340.03
291072,201807,7390,2714,4676,2585501.35,4458720.42,7044221.77
291075,201807,209,170,39,161703,37206,198909
291077,201807,49,33,16,31482,15264,46746
291080,201807,19885,8769,11116,8343796.04,10592201.02,18935997.06
291085,201807,294,237,57,226098,54373.23,280471.23
291090,201807,305,120,185,114194,176480.46,290674.46
291100,201807,664,193,471,184122,449334,633456
291110,201807,403,302,101,288088.92,96354,384442.92
291120,201807,2521,1214,1307,1158013,1245863.46,2403876.46
291125,201807,61,31,30,29574,28620,58194
291130,201807,216,190,26,181260,24804,206064
291140,201807,137,102,35,97022,33104,130126
291150,201807,371,147,224,140238,213696,353934
291160,201807,372,309,63,293832.5,60102,353934.5
291165,201807,24,20,4,19080,3816,22896
291170,201807,2978,1490,1488,1417406.11,1416229.1,2833635.21
291180,201807,1320,511,809,487297.38,771671.76,1258969.14
291185,201807,75,73,2,69642,1908,71550
291190,201807,1269,553,716,524879.8,682234.8,1207114.6
291200,201807,168,124,44,118296,41976,160272
291210,201807,2221,877,1344,833519.34,1280364.14,2113883.48
291220,201807,275,206,69,195570.64,65826,261396.64
291230,201807,1026,351,675,334568,643950,978518
291240,201807,437,414,23,393716,21942,415658
291250,201807,436,356,80,339624,76320,415944
291260,201807,47,36,11,34344,10494,44838
291270,201807,1208,492,716,469368,682777.8,1152145.8
291280,201807,374,172,202,163882.89,192698.46,356581.35
291290,201807,1758,896,862,853353.2,821014,1674367.2
291300,201807,225,177,48,168190.2,45792,213982.2
291310,201807,227,203,24,193662,22896,216558
291320,201807,1402,1000,402,951138,382459.29,1333597.29
291330,201807,129,113,16,105989.4,15264,121253.4
291340,201807,155,88,67,83952,63918,147870
291345,201807,134,87,47,82998,44838,127836
291350,201807,1598,528,1070,503521.2,1020589.3,1524110.5
291360,201807,8615,4268,4347,4059611.84,4144516.75,8204128.59
291370,201807,1111,619,492,590240,469368,1059608
291380,201807,262,206,56,196524,53137.8,249661.8
291390,201807,3891,1704,2187,1620230.23,2084299.8,3704530.03
291400,201807,2083,1492,591,1419742.8,562131.51,1981874.31
291410,201807,153,133,20,125928,19080,145008
291420,201807,114,84,30,80136,28620,108756
291430,201807,167,95,72,89923,67734.53,157657.53
291440,201807,499,400,99,378876.3,94446,473322.3
291450,201807,899,565,334,537770.8,317682,855452.8
291460,201807,1749,1417,332,1350053.1,316728,1666781.1
291465,201807,2216,1033,1183,984879.33,1128262.06,2113141.39
291470,201807,2782,1411,1371,1342461.11,1307195,2649656.11
291480,201807,11810,5233,6577,4980466.89,6265891.81,11246358.70
291490,201807,559,237,322,226098,307188,533286
291500,201807,370,205,165,195570,157410,352980
291510,201807,1242,476,766,452942.99,730477.8,1183420.79
291520,201807,959,436,523,415944,498932.46,914876.46
291530,201807,1006,270,736,257580,701838.72,959418.72
291535,201807,117,98,19,93492,18126,111618
291540,201807,363,106,257,101124,244224.6,345348.6
291550,201807,1191,559,632,531380.1,602624,1134004.1
291560,201807,5509,2806,2703,2664273.63,2566286.72,5230560.35
291570,201807,203,102,101,97308,96354,193662
291580,201807,1232,750,482,714447.46,459814.23,1174261.69
291590,201807,85,34,51,32242.9,48654,80896.9
291600,201807,1374,631,743,601020,708518,1309538
291610,201807,1465,683,782,650408.58,746000,1396408.58
291620,201807,583,272,311,259488,296312.4,555800.4
291630,201807,496,165,331,157410,315774,473184
291640,201807,3905,1975,1930,1874768.72,1839862.52,3714631.24
291650,201807,417,279,138,265213,130852.73,396065.73
291660,201807,433,172,261,163395.96,247896.9,411292.86
291670,201807,224,143,81,135850,77274,213124
291680,201807,695,393,302,374922,288003.46,662925.46
291685,201807,592,323,269,307904,256435.2,564339.2
291690,201807,573,296,277,282384,263295,545679
291700,201807,936,737,199,702368.19,188892,891260.19
291710,201807,1698,797,901,759642.28,858677.06,1618319.34
291720,201807,402,264,138,251851.23,131652,383503.23
291730,201807,953,563,390,535146.7,372050.46,907197.16
291733,201807,265,183,82,174295.8,78228,252523.8
291735,201807,66,52,14,49608,13356,62964
291740,201807,352,269,83,256626,79182,335808
291750,201807,1977,1312,665,1244256.28,633588,1877844.28
291760,201807,3054,1676,1378,1593037,1312227,2905264
291770,201807,806,538,268,511153.26,255672,766825.26
291780,201807,46,28,18,26712,17172,43884
291790,201807,167,80,87,76320,82998,159318
291800,201807,10044,4066,5978,3867294.31,5698856.8,9566151.11
291810,201807,1136,818,318,779508.83,303372,1082880.83
291820,201807,267,192,75,183168,71550,254718
291830,201807,1092,420,672,399291,640125,1039416
291835,201807,603,554,49,528386,46746,575132
291840,201807,4681,2419,2262,2301773.17,2156432.22,4458205.39
291845,201807,296,101,195,96354,186001.38,282355.38
291850,201807,327,284,43,270697.5,41022,311719.5
291855,201807,269,106,163,101124,155502,256626
291860,201807,173,105,68,99216,64872,164088
291870,201807,85,35,50,33390,47700,81090
291875,201807,186,169,17,161226,16218,177444
291880,201807,490,386,104,367434,99216,466650
291890,201807,242,80,162,76310.46,153117.2,229427.66
291900,201807,55,32,23,30528,21942,52470
291905,201807,133,93,40,88436,38160,126596
291910,201807,177,144,33,137376,31482,168858
291915,201807,393,347,46,329370,43884,373254
291920,201807,5001,2598,2403,2475057.98,2290797.77,4765855.75
291930,201807,184,107,77,102078,73458,175536
291940,201807,321,176,145,167207.58,137376,304583.58
291950,201807,1149,935,214,891227,204156,1095383
291955,201807,1076,644,432,614376,411985,1026361
291960,201807,181,129,52,123066,49321.8,172387.8
291970,201807,776,589,187,561906,178398,740304
291980,201807,1509,1334,175,1269541.6,165996.4,1435538.0
291990,201807,129,120,9,114480,8586,123066
291992,201807,165,86,79,81280.8,75366,156646.8
291995,201807,144,101,43,96354,41022,137376
292000,201807,388,297,91,281144.95,86814,367958.95
292010,201807,288,204,84,193662.8,79182,272844.8
292020,201807,277,200,77,190800,73458,264258
292030,201807,139,108,31,103032,29574,132606
292040,201807,633,324,309,309096,294786,603882
292045,201807,95,86,9,82044,8586,90630
292050,201807,903,633,270,602872.67,257294,860166.67
292060,201807,937,776,161,738397.28,153594,891991.28
292070,201807,50,21,29,20034,27666,47700
292080,201807,117,82,35,78228,33390,111618
292090,201807,504,178,326,169621.2,311004,480625.2
292100,201807,1413,607,806,577504.7,767370.52,1344875.22
292105,201807,205,174,31,165996,29574,195570
292110,201807,2113,779,1334,742860.72,1270202.82,2013063.54
292120,201807,650,520,130,494947.79,124020,618967.79
292130,201807,453,265,188,252810,179352,432162
292140,201807,195,154,41,146916,38982.26,185898.26
292145,201807,162,86,76,81758,72461.07,154219.07
292150,201807,1428,1143,285,1090422,270862.16,1361284.16
292160,201807,180,145,35,138043.8,33390,171433.8
292170,201807,1205,1057,148,1006685.31,141134.76,1147820.07
292180,201807,208,148,60,141192,57240,198432
292190,201807,161,97,64,92538,61056,153594
292200,201807,1286,468,818,445500.71,779723.56,1225224.27
292205,201807,121,108,13,102745.8,12402,115147.8
292210,201807,367,255,112,241887,106848,348735
292220,201807,21,16,5,15264,4770,20034
292225,201807,38,35,3,33390,2862,36252
292230,201807,935,754,181,717762.23,172674,890436.23
292240,201807,621,449,172,427249,164088,591337
292250,201807,1730,1113,617,1061802,588332,1650134
292260,201807,445,251,194,239454,184312.8,423766.8
292265,201807,265,187,78,178111.8,74412,252523.8
292270,201807,775,341,434,325314,413082.8,738396.8
292273,201807,202,112,90,106070.49,85860,191930.49
292275,201807,169,86,83,82044,78895.8,160939.8
292280,201807,139,99,40,94446,38160,132606
292285,201807,64,54,10,50848.2,9540,60388.2
292290,201807,566,381,185,361089.41,176204,537293.41
292300,201807,1645,624,1021,595010,973200.58,1568210.58
292303,201807,97,68,29,64872,27666,92538
292305,201807,109,78,31,74412,29574,103986
292310,201807,823,527,296,502396,281086.15,783482.15
292320,201807,661,498,163,474805.8,155502,630307.8
292330,201807,185,100,85,95400,81090,176490
292335,201807,281,219,62,208926,59148,268074
292340,201807,579,403,176,383722.85,167904,551626.85
292350,201807,271,145,126,137519.1,119917.8,257436.9
292360,201807,705,534,171,507719,163134,670853
292370,201807,767,587,180,559998,171720,731718
292380,201807,651,505,146,480816.42,139284,620100.42
292390,201807,501,190,311,181260,294929.5,476189.5
292400,201807,3393,2088,1305,1973013.53,1241089.8,3214103.33
292405,201807,262,174,88,165519,83665.8,249184.8
292410,201807,150,88,62,83952,59148,143100
292420,201807,306,262,44,249661.8,41976,291637.8
292430,201807,528,412,116,393048,110187,503235
292440,201807,588,502,86,477400.8,81757.8,559158.6
292450,201807,249,192,57,183168,54378,237546
292460,201807,586,433,153,412023.8,145866.6,557890.4
292465,201807,205,170,35,162180,32652.09,194832.09
292467,201807,105,62,43,59148,41022,100170
292470,201807,267,180,87,171720,82998,254718
292480,201807,338,222,116,210834.5,110378,321212.5
292490,201807,223,149,74,142146,70596,212742
292500,201807,1157,502,655,478697,624526.28,1103223.28
292510,201807,3346,1517,1829,1446264.12,1741995.6,3188259.72
292520,201807,1079,519,560,493261.7,534231,1027492.7
292525,201807,387,278,109,265207.23,103986,369193.23
292530,201807,4258,1753,2505,1669683.04,2388559.92,4058242.96
292540,201807,476,256,220,244224,209880,454104
292550,201807,1060,574,486,546873.82,463082.48,1009956.30
292560,201807,322,303,19,289062,18126,307188
292570,201807,303,231,72,220045,68688,288733
292575,201807,466,298,168,284006,160272,444278
292580,201807,928,590,338,561429,322166,883595
292590,201807,522,448,74,427089.59,70596,497685.59
292593,201807,142,112,30,106848,28620,135468
292595,201807,183,141,42,134514,40068,174582
292600,201807,1243,923,320,880225,304612.2,1184837.2
292610,201807,130,100,30,95400,28362.42,123762.42
292620,201807,531,441,90,420419,85860,506279
292630,201807,1381,796,585,757796,556459.14,1314255.14
292640,201807,787,549,238,523412.1,227052,750464.1
292650,201807,176,149,27,141710,25758,167468
292660,201807,1999,1436,563,1365074.03,532904.83,1897978.86
292665,201807,140,103,37,98262,35298,133560
292670,201807,404,327,77,311954,73458,385412
292680,201807,259,201,58,191754,54855,246609
292690,201807,188,145,43,138330,41022,179352
292700,201807,929,618,311,588618.8,296694,885312.8
292710,201807,102,90,12,85860,11448,97308
292720,201807,844,478,366,455210.64,348974,804184.64
292730,201807,200,94,106,88722.5,101124,189846.5
292740,201807,67364,33328,34036,31722738.72,32441480.29,64164219.01
292750,201807,375,266,109,252810.94,103175.57,355986.51
292760,201807,324,262,62,248937.5,59148,308085.5
292770,201807,796,334,462,318350,440748,759098
292780,201807,412,155,257,147356.28,245178,392534.28
292790,201807,744,367,377,350118,359419.5,709537.5
292800,201807,1156,709,447,675432,426151.8,1101583.8
292805,201807,427,124,303,117771.3,289062,406833.3
292810,201807,1495,859,636,818627.8,606734.46,1425362.26
292820,201807,745,603,142,573354.87,135172.8,708527.67
292830,201807,103,82,21,78228,20034,98262
292840,201807,660,546,114,520694,108741.69,629435.69
292850,201807,130,87,43,82998,41022,124020
292860,201807,2209,1290,919,1226588.94,876726,2103314.94
292870,201807,3429,2306,1123,2198661.8,1071332.46,3269994.26
292880,201807,1471,965,506,916843.86,481558,1398401.86
292890,201807,492,421,71,401606,67734,469340
292895,201807,137,91,46,86123.3,43884,130007.3
292900,201807,394,288,106,274752,101124,375876
292905,201807,454,235,219,224190,208926,433116
292910,201807,418,316,102,301131,97308,398439
292920,201807,548,244,304,232776,290016,522792
292925,201807,501,464,37,441978.66,35279,477257.66
292930,201807,579,361,218,344394,207972,552366
292935,201807,291,126,165,120204,157410,277614
292937,201807,236,162,74,154548,70596,225144
292940,201807,195,148,47,141192,44838,186030
292950,201807,1126,578,548,548287.3,521839,1070126.3
292960,201807,555,375,180,357750,171720,529470
292970,201807,267,188,79,178685,75366,254051
292975,201807,155,87,68,82998,64682,147680
292980,201807,253,171,82,162304.43,78228,240532.43
292990,201807,1314,976,338,923767.87,322264.93,1246032.80
293000,201807,105,76,29,72504,27666,100170
293010,201807,2703,1648,1055,1566049.32,1002289.91,2568339.23
293015,201807,660,526,134,501586.49,127197,628783.49
293020,201807,334,274,60,261396,57240,318636
293030,201807,617,539,78,513634,74412,588046
293040,201807,342,269,73,256626,69642,326268
293050,201807,2745,1600,1145,1517845.79,1088477.38,2606323.17
293060,201807,256,206,50,195337,46746.8,242083.8
293070,201807,3439,1756,1683,1667657.68,1604361.82,3272019.50
293075,201807,91,59,32,56286,30528,86814
293076,201807,71,48,23,45792,21942,67734
293077,201807,445,275,170,258503.27,162180,420683.27
293080,201807,451,402,49,383508,46746,430254
293090,201807,131,115,16,109710,15264,124974
293100,201807,522,368,154,351072,146916,497988
293105,201807,340,236,104,224858,99216,324074
293110,201807,174,123,51,117342,48654,165996
293120,201807,318,215,103,205110,98071.2,303181.2
293130,201807,246,166,80,158364,76320,234684
293135,201807,8015,3162,4853,3009726.18,4621703.54,7631429.72
293140,201807,185,120,65,114480,61247,175727
293150,201807,329,281,48,267311,45792,313103
293160,201807,430,247,183,235638,174582,410220
293170,201807,190,131,59,124974,55428,180402
293180,201807,468,319,149,304040,142146,446186
293190,201807,1297,900,397,853950.73,378738,1232688.73
293200,201807,532,470,62,447300,58337.1,505637.1
293210,201807,357,267,90,254566,85144.5,339710.5
293220,201807,2672,1081,1591,1029340.41,1515667.97,2545008.38
293230,201807,1773,646,1127,614057.8,1075158,1689215.8
293240,201807,219,201,18,191754,17172,208926
293245,201807,112,94,18,89676,17172,106848
293250,201807,737,279,458,265918,436932,702850
293260,201807,310,261,49,248040.17,46746,294786.17
293270,201807,1175,560,615,532332.68,586710,1119042.68
293280,201807,249,141,108,134514,103032,237546
293290,201807,3075,2022,1053,1928034,1004549,2932583
293300,201807,714,507,207,481631.7,194997.6,676629.3
293305,201807,148,127,21,121158,20034,141192
293310,201807,138,104,34,99216,32436,131652
293315,201807,151,116,35,110664,33390,144054
293317,201807,96,68,28,64872,26712,91584
293320,201807,969,564,405,537102.5,386370,923472.5
293325,201807,188,64,124,61056,118257.84,179313.84
293330,201807,12999,6109,6890,5818161.04,6565513.75,12383674.79
293340,201807,255,184,71,175536,66780,242316
293345,201807,242,192,50,183168,47700,230868
293350,201807,641,348,293,331992,278043.3,610035.3
293360,201807,1575,1128,447,1075158,426151.8,1501309.8
310010,201807,153,79,74,75366,70310,145676
310020,201807,1056,582,474,553367.9,450001.92,1003369.82
310030,201807,334,272,62,258362.88,59148,317510.88
310040,201807,49,30,19,28620,18126,46746
310050,201807,187,124,63,117914.4,59816,177730.4
310060,201807,240,168,72,159795,68402,228197
310070,201807,16,8,8,7632,7632,15264
310080,201807,48,26,22,24804,20988,45792
310090,201807,972,520,452,490166.88,430063.6,920230.48
310100,201807,298,228,70,217512,66780,284292
310110,201807,736,394,342,374554.9,325018.46,699573.36
310120,201807,393,214,179,202916.2,170391.94,373308.14
310130,201807,33,21,12,20034,11448,31482
310140,201807,26,14,12,13356,11448,24804
310150,201807,1290,882,408,833560.3,388373.8,1221934.1
310160,201807,2101,1069,1032,1012005.73,981857.2,1993862.93
310163,201807,93,53,40,50562,38160,88722
310170,201807,2628,1117,1511,1064826.2,1438919.4,2503745.6
310180,201807,135,52,83,49608,78800.4,128408.4
310190,201807,490,332,158,316728,150159.6,466887.6
310200,201807,506,325,181,310050,172674,482724
310205,201807,58,45,13,42930,12402,55332
310210,201807,271,220,51,209880,48654,258534
310220,201807,58,35,23,33390,21942,55332
310230,201807,266,185,81,176299.2,77274,253573.2
310240,201807,100,87,13,82759.5,12402,95161.5
310250,201807,99,79,20,75366,19080,94446
310260,201807,793,427,366,404402.24,348429.42,752831.66
310270,201807,274,185,89,175937,84906,260843
310280,201807,361,272,89,258821,84906,343727
310285,201807,217,155,62,147561.86,59148,206709.86
310290,201807,255,146,109,139284,103986,243270
310300,201807,154,127,27,121158,25758,146916
310310,201807,9,7,2,6678,1908,8586
310320,201807,24,14,10,13356,9540,22896
310330,201807,32,24,8,22896,7632,30528
310340,201807,1726,1125,601,1065237.6,571256.5,1636494.1
310350,201807,2859,1551,1308,1475785.81,1246964.6,2722750.41
310360,201807,39,32,7,30528,6678,37206
310370,201807,127,104,23,99216,21656,120872
310375,201807,112,41,71,39114,67715,106829
310380,201807,53,31,22,28668,20988,49656
310390,201807,103,70,33,66780,31482,98262
310400,201807,2383,1548,835,1472596,796017.8,2268613.8
310410,201807,125,68,57,64872,54378,119250
310420,201807,667,354,313,336858.2,297639.06,634497.26
310430,201807,326,217,109,206779.5,103986,310765.5
310440,201807,70,41,29,39114,27666,66780
310445,201807,82,66,16,62964,15264,78228
310450,201807,854,537,317,512298,302418,814716
310460,201807,264,192,72,183168,68688,251856
310470,201807,506,326,180,311004,171720,482724
310480,201807,79,57,22,54378,20988,75366
310490,201807,515,244,271,231822,258534,490356
310500,201807,126,53,73,50562,69642,120204
310510,201807,600,396,204,376544.6,194607,571151.6
310520,201807,131,88,43,83952,41022,124974
310530,201807,87,39,48,37206,45505.8,82711.8
310540,201807,464,287,177,271414.6,168571.8,439986.4
310550,201807,86,57,29,54378,27666,82044
310560,201807,2988,2054,934,1948748.54,890415.9,2839164.44
310570,201807,120,81,39,77274,37206,114480
310590,201807,353,235,118,222235.8,112557.69,334793.49
310600,201807,161,91,70,84382.7,66780,151162.7
310610,201807,61,24,37,22896,35298,58194
310620,201807,46399,22279,24120,21175933.13,22969351.34,44145284.47
310630,201807,613,393,220,371631.2,208545.4,580176.6
310640,201807,146,120,26,114289.2,24804,139093.2
310650,201807,166,146,20,138044,19080,157124
310660,201807,94,58,36,55332,34344,89676
310665,201807,56,40,16,38160,15264,53424
310670,201807,6462,2938,3524,2795726.37,3358680,6154406.37
310680,201807,59,39,20,37206,19080,56286
310690,201807,617,449,168,421701.97,160272,581973.97
310700,201807,59,38,21,36252,19890.9,56142.9
310710,201807,1241,841,400,800516.45,381027.8,1181544.25
310720,201807,91,29,62,27666,59148,86814
310730,201807,1369,958,411,912692.5,391808,1304500.5
310740,201807,987,552,435,523460.4,414456.26,937916.66
310750,201807,245,143,102,135468.18,97308,232776.18
310760,201807,65,48,17,45792,15932,61724
310770,201807,95,44,51,41976,48654,90630
310780,201807,396,324,72,308514.6,68688,377202.6
310790,201807,99,81,18,77274,17172,94446
310800,201807,459,223,236,212265,224857.8,437122.8
310810,201807,169,118,51,111513.2,47700,159213.2
310820,201807,357,283,74,269982,70309.8,340291.8
310825,201807,200,163,37,155502,35298,190800
310830,201807,469,224,245,213035.94,233730,446765.94
310840,201807,380,218,162,207972,154548,362520
310850,201807,107,85,22,81090,20988,102078
310855,201807,380,300,80,286200,76320,362520
310860,201807,1407,1054,353,1001653.9,335026.9,1336680.8
310870,201807,54,42,12,40068,11448,51516
310880,201807,82,64,18,60769.8,17172,77941.8
310890,201807,314,186,128,177444,122112,299556
310900,201807,638,297,341,280700.27,325008.8,605709.07
310910,201807,244,166,78,157029.2,74412,231441.2
310920,201807,484,288,196,270937.2,186984,457921.2
310925,201807,42,34,8,32436,7346,39782
310930,201807,1093,662,431,631431.53,411078.3,1042509.83
310940,201807,682,350,332,333613.8,316728,650341.8
310945,201807,116,71,45,67734,42930,110664
310950,201807,252,200,52,190800,49608,240408
310960,201807,84,30,54,28620,51512,80132
310970,201807,168,104,64,99216,60133.76,159349.76
310980,201807,42,22,20,20988,19080,40068
310990,201807,153,86,67,81758,63918,145676
311000,201807,864,424,440,400967.69,419751,820718.69
311010,201807,39,32,7,30528,6678,37206
311020,201807,42,26,16,24804,15264,40068
311030,201807,384,230,154,217512,146535,364047
311040,201807,40,35,5,33390,4770,38160
311050,201807,465,192,273,182596,259869.6,442465.6
311060,201807,771,437,334,414799.6,318350,733149.6
311070,201807,336,155,181,147870,172674,320544
311080,201807,106,58,48,55332,45792,101124
311090,201807,390,185,205,175536,195570,371106
311100,201807,610,363,247,346015.8,235065.6,581081.4
311110,201807,681,470,211,448093.8,201285,649378.8
311115,201807,69,51,18,48654,17172,65826
311120,201807,1068,569,499,539628.2,475139.9,1014768.1
311130,201807,407,240,167,228769.2,159318,388087.2
311140,201807,163,83,80,78895.8,75509.1,154404.9
311150,201807,358,233,125,222282,119011.5,341293.5
311160,201807,743,536,207,508959.4,197001,705960.4
311170,201807,78,58,20,55332,18793.8,74125.8
311180,201807,352,235,117,223903.8,111332,335235.8
311190,201807,35,17,18,16218,17172,33390
311200,201807,339,238,101,225430.6,96354,321784.6
311205,201807,31,21,10,20034,9158.4,29192.4
311210,201807,49,42,7,39782,6678,46460
311220,201807,19,17,2,16218,1908,18126
311230,201807,1630,1069,561,1015460.74,535194,1550654.74
311240,201807,179,114,65,108552.33,62010,170562.33
311250,201807,89,30,59,28620,56286,84906
311260,201807,552,347,205,331038,195570,526608
311265,201807,114,80,34,76320,32436,108756
311270,201807,285,206,79,196524,75366,271890
311280,201807,214,97,117,92538,111045.6,203583.6
311290,201807,107,87,20,82998,18794,101792
311300,201807,554,353,201,336762,191468,528230
311310,201807,25,19,6,18126,5724,23850
311320,201807,671,498,173,474138,165042,639180
311330,201807,1046,766,280,730525.5,266166.4,996691.9
311340,201807,2656,1883,773,1786854.13,735802.66,2522656.79
311350,201807,275,209,66,199386,62964,262350
311360,201807,176,106,70,101124,66780,167904
311370,201807,1209,496,713,471190.5,679629.6,1150820.1
311380,201807,7,6,1,5724,954,6678
311390,201807,282,150,132,143100,125737.2,268837.2
311400,201807,150,99,51,94446,48654,143100
311410,201807,101,57,44,54092,41976,96068
311420,201807,300,167,133,157410.8,126882,284292.8
311430,201807,869,565,304,537103.2,289730,826833.2
311440,201807,490,342,148,326268,140905.8,467173.8
311450,201807,324,203,121,193662,115434,309096
311455,201807,305,207,98,197182.8,93373.45,290556.25
311460,201807,137,58,79,55332,74560.27,129892.27
311470,201807,23,13,10,12402,9540,21942
311480,201807,33,15,18,14310,17172,31482
311490,201807,16,10,6,9540,5724,15264
311500,201807,20,10,10,9540,9540,19080
311510,201807,630,439,191,416863.7,181729.09,598592.79
311520,201807,45,35,10,32722.2,9540,42262.2
311530,201807,1821,1366,455,1291165.12,434070,1725235.12
311535,201807,69,51,18,48654,17172,65826
311540,201807,34,29,5,27666,4770,32436
311545,201807,191,143,48,136422,45792,182214
311547,201807,33,24,9,22896,8586,31482
311550,201807,662,309,353,294786,336531.46,631317.46
311560,201807,43,28,15,26712,14310,41022
311570,201807,299,200,99,190227.6,94446,284673.6
311580,201807,314,186,128,177157.8,122112,299269.8
311590,201807,33,29,4,27666,3816,31482
311600,201807,92,74,18,70596,17172,87768
311610,201807,253,220,33,208926.5,31482,240408.5
311615,201807,106,89,17,84266.82,16027.2,100294.02
311620,201807,20,11,9,10494,8586,19080
311630,201807,85,71,14,67734,13356,81090
311640,201807,128,67,61,63918,58194,122112
311650,201807,129,95,34,89914.5,32436,122350.5
311660,201807,410,197,213,187938,203202,391140
311670,201807,167,107,60,101833,57240,159073
311680,201807,222,160,62,151738.95,58384.8,210123.75
311690,201807,18,11,7,10494,6678,17172
311700,201807,201,141,60,134227.8,56572.2,190800.0
311710,201807,210,133,77,126882,73458,200340
311720,201807,37,27,10,25472,9540,35012
311730,201807,564,367,197,349546,187938,537484
311740,201807,39,28,11,26712,10494,37206
311750,201807,712,480,232,456966.8,221328,678294.8
311760,201807,65,36,29,34344,27666,62010
311770,201807,395,191,204,180306.62,194616,374922.62
311780,201807,174,96,78,91298,74095,165393
311783,201807,84,75,9,71550,8586,80136
311787,201807,34,14,20,13356,19080,32436
311790,201807,264,126,138,120204,131652,251856
311800,201807,661,443,218,419236.3,207304.2,626540.5
311810,201807,45,38,7,36252,6678,42930
311820,201807,110,94,16,89676,15264,104940
311830,201807,1935,1219,716,1156835.1,679153.4,1835988.5
311840,201807,1031,573,458,542064.9,434223.34,976288.24
311850,201807,11,7,4,6678,3816,10494
311860,201807,9487,4317,5170,4101923.81,4925679.47,9027603.28
311870,201807,149,83,66,79182,62964,142146
311880,201807,951,707,244,672942.8,232776,905718.8
311890,201807,220,111,109,105894,103986,209880
311900,201807,83,35,48,33390,45792,79182
311910,201807,1409,867,542,824924.6,514969.4,1339894.0
311920,201807,230,149,81,142146,77274,219420
311930,201807,920,528,392,503426,373730,877156
311940,201807,2546,1326,1220,1262667.7,1160541,2423208.7
311950,201807,41,29,12,27666,11448,39114
311960,201807,65,46,19,43884,18126,62010
311970,201807,26,17,9,13928.4,8586,22514.4
311980,201807,43,33,10,31195.8,9540,40735.8
311990,201807,56,40,16,38160,15264,53424
311995,201807,64,45,19,42930,18126,61056
312000,201807,36,25,11,23563.8,10494,34057.8
312010,201807,83,61,22,58194,20988,79182
312015,201807,99,75,24,71264,22896,94160
312020,201807,140,87,53,82712,50562,133274
312030,201807,46,37,9,34631,8586,43217
312040,201807,82,52,30,49608,28620,78228
312050,201807,217,117,100,111618,95400,207018
312060,201807,68,41,27,39114,25090.2,64204.2
312070,201807,75,47,28,44838,26712,71550
312080,201807,536,244,292,232776,278568,511344
312083,201807,50,37,13,35298,12402,47700
312087,201807,114,92,22,87768,20988,108756
312090,201807,2947,1683,1264,1591659.5,1202474.35,2794133.85
312100,201807,158,111,47,105894,44056,149950
312110,201807,116,73,43,69642,41022,110664
312120,201807,143,106,37,100059,35298,135357
312125,201807,98,57,41,54187.2,39114,93301.2
312130,201807,121,81,40,77274,38160,115434
312140,201807,137,107,30,102078,28620,130698
312150,201807,48,37,11,35298,10494,45792
312160,201807,1539,1015,524,963731.8,498484.48,1462216.28
312170,201807,12,10,2,9540,1908,11448
312180,201807,102,63,39,59387,36920,96307
312190,201807,31,27,4,25758,3816,29574
312200,201807,743,640,103,608604.7,98262,706866.7
312210,201807,96,63,33,60102,31482,91584
312220,201807,125,91,34,86576,32436,119012
312230,201807,3576,1751,1825,1666096.48,1739680.62,3405777.10
312235,201807,156,103,53,98262,50562,148824
312240,201807,106,71,35,67734,33390,101124
312245,201807,168,115,53,109706,50562,160268
312247,201807,62,44,18,41213,17172,58385
312250,201807,184,85,99,81090,94446,175536
312260,201807,103,69,34,64968.2,32436,97404.2
312270,201807,138,85,53,81090,50562,131652
312280,201807,26,16,10,15264,9540,24804
312290,201807,162,111,51,105894,47701,153595
312300,201807,201,132,69,125928,65826,191754
312310,201807,57,52,5,49608,4770,54378
312320,201807,429,269,160,254718,151066.1,405784.1
312330,201807,88,77,11,73458,10207.8,83665.8
312340,201807,35,16,19,15264,18126,33390
312350,201807,18,11,7,10494,6678,17172
312352,201807,98,66,32,62964,30528,93492
312360,201807,559,254,305,241362,290970,532332
312370,201807,309,181,128,172387.8,122112,294499.8
312380,201807,138,90,48,85860,45792,131652
312385,201807,173,140,33,133273.8,31482,164755.8
312390,201807,301,189,112,180306,106181,286487
312400,201807,379,290,89,276660,84430,361090
312410,201807,891,287,604,273321,575640,848961
312420,201807,612,484,128,460782.2,122112,582894.2
312430,201807,868,641,227,609226.05,215604.2,824830.25
312440,201807,46,34,12,32436,11448,43884
312450,201807,214,132,82,125928,78228,204156
312460,201807,60,28,32,26712,30528,57240
312470,201807,55,36,19,34344,18126,52470
312480,201807,203,124,79,118296,75366,193662
312490,201807,271,187,84,178398,80136,258534
312500,201807,34,19,15,18126,14310,32436
312510,201807,445,170,275,162180,261734.39,423914.39
312520,201807,43,15,28,14310,26712,41022
312530,201807,49,37,12,35298,11448,46746
312540,201807,101,88,13,83952,12402,96354
312550,201807,39,31,8,29574,7632,37206
312560,201807,211,156,55,148538,52183.8,200721.8
312570,201807,440,262,178,249280.2,169263.45,418543.65
312580,201807,83,44,39,41976,37206,79182
312590,201807,267,211,56,201294,53424,254718
312595,201807,140,125,15,119250,14310,133560
312600,201807,75,46,29,43455,27666,71121
312610,201807,1624,858,766,811093.98,729047.6,1540141.58
312620,201807,193,138,55,131652,52465.23,184117.23
312630,201807,64,54,10,51516,9540,61056
312640,201807,47,13,34,12402,32436,44838
312650,201807,152,127,25,120872,23564,144436
312660,201807,72,54,18,51230,17172,68402
312670,201807,872,576,296,548551,282170.3,830721.3
312675,201807,41,32,9,30528,8586,39114
312680,201807,86,57,29,53996.4,27666,81662.4
312690,201807,237,125,112,119240.46,106561.8,225802.26
312695,201807,31,24,7,22896,6678,29574
312700,201807,215,123,92,117342,87768,205110
312705,201807,78,64,14,61056,13356,74412
312707,201807,109,80,29,75900.24,27666,103566.24
312710,201807,1888,1002,886,954261.6,845033,1799294.6
312720,201807,66,33,33,31482,31482,62964
312730,201807,289,169,120,160272,114480,274752
312733,201807,52,45,7,42644,6678,49322
312735,201807,22,16,6,15264,5724,20988
312737,201807,69,38,31,36252,29574,65826
312738,201807,53,38,15,36252,14310,50562
312740,201807,76,51,25,48368,23850,72218
312750,201807,70,52,18,49608,17172,66780
312760,201807,269,198,71,188892,67734,256626
312770,201807,7650,3549,4101,3363524.78,3903929.23,7267454.01
312780,201807,432,332,100,316441.8,95400,411841.8
312790,201807,21,16,5,15264,4770,20034
312800,201807,1604,1121,483,1063175.28,460591.2,1523766.48
312810,201807,371,241,130,229627.8,124020,353647.8
312820,201807,195,147,48,140238,45792,186030
312825,201807,26,17,9,16218,8586,24804
312830,201807,278,167,111,158079,105255,263334
312840,201807,150,109,41,103986,39114,143100
312850,201807,29,25,4,23850,3816,27666
312860,201807,169,102,67,97022,63918,160940
312870,201807,990,519,471,492232.24,449334,941566.24
312880,201807,151,103,48,98118.9,45696.6,143815.5
312890,201807,167,115,52,109710,49608,159318
312900,201807,209,156,53,148156.2,50562,198718.2
312910,201807,189,95,94,89539.72,89676,179215.72
312920,201807,158,88,70,83952,66780,150732
312930,201807,346,252,94,240408,89676,330084
312940,201807,109,74,35,70596,33390,103986
312950,201807,695,457,238,434928.6,227052,661980.6
312960,201807,174,134,40,127836,38160,165996
312965,201807,55,51,4,48654,3816,52470
312970,201807,297,237,60,225144.2,57240,282384.2
312980,201807,2344,1229,1115,1166736,1063133.6,2229869.6
312990,201807,49,28,21,26712,20034,46746
313000,201807,40,23,17,21942,16218,38160
313005,201807,168,129,39,122827.5,36920,159747.5
313010,201807,939,382,557,363187.8,531369,894556.8
313020,201807,191,100,91,94923,86814,181737
313030,201807,207,135,72,126883,68688,195571
313040,201807,68,26,42,24804,40068,64872
313050,201807,294,205,89,195570,84906,280476
313055,201807,47,35,12,33390,11448,44838
313060,201807,124,86,38,82044,35965.8,118009.8
313065,201807,60,39,21,37206,20034,57240
313070,201807,150,80,70,76320,66780,143100
313080,201807,42,18,24,17172,22896,40068
313090,201807,710,491,219,467126.3,208926,676052.3
313100,201807,165,64,101,61056,96346,157402
313110,201807,128,73,55,69642,52470,122112
313115,201807,171,94,77,89475.66,73458,162933.66
313120,201807,758,415,343,395624,325982,721606
313130,201807,5321,2883,2438,2726884.92,2316847.56,5043732.48
313140,201807,157,81,76,77274,72504,149778
313150,201807,313,248,65,236592,61723.8,298315.8
313160,201807,199,147,52,139952,49608,189560
313170,201807,1382,972,410,913999.93,390749.4,1304749.33
313180,201807,326,193,133,183473.28,126882,310355.28
313190,201807,743,444,299,420237,284483,704720
313200,201807,24,23,1,21942,954,22896
313210,201807,1046,881,165,837471.16,157405.23,994876.39
313220,201807,242,167,75,158364,70834.5,229198.5
313230,201807,267,197,70,186985,66780,253765
313240,201807,1934,1031,903,979941.73,858499.83,1838441.56
313250,201807,1270,949,321,900673.8,304327.8,1205001.6
313260,201807,98,55,43,52470,41022,93492
313270,201807,961,563,398,533430.1,379692,913122.1
313280,201807,60,52,8,49131,7632,56763
313290,201807,227,183,44,174296,41022.8,215318.8
313300,201807,382,198,184,185745,175536,361281
313310,201807,230,118,112,112572,106848,219420
313320,201807,375,286,89,270889.1,84906,355795.1
313330,201807,1365,838,527,798021.2,501566.5,1299587.7
313340,201807,334,233,101,222282,96354,318636
313350,201807,517,350,167,331992.1,159318,491310.1
313360,201807,114,69,45,65826,42644,108470
313370,201807,189,69,120,65826,114480,180306
313375,201807,274,163,111,155502,105894,261396
313380,201807,1339,692,647,657039.08,616948,1273987.08
313390,201807,49,44,5,41022.8,4770,45792.8
313400,201807,422,283,139,269982,132034,402016
313410,201807,21,13,8,12402,7632,20034
313420,201807,4698,2446,2252,2324204.38,2141445.56,4465649.94
313430,201807,142,66,76,62964,72307,135271
313440,201807,1485,1013,472,962933.9,449144,1412077.9
313450,201807,63,27,36,25758,34057.8,59815.8
313460,201807,377,177,200,168372,190800,359172
313470,201807,534,247,287,235638,273130.2,508768.2
313480,201807,156,108,48,102079,45792,147871
313490,201807,515,250,265,238495.23,252763,491258.23
313500,201807,21,14,7,13356,6678,20034
313505,201807,988,770,218,733158.74,207685.8,940844.54
313507,201807,99,60,39,57240,37206,94446
313510,201807,2788,1783,1005,1694904.04,957816,2652720.04
313520,201807,3626,2842,784,2699965.02,747932,3447897.02
313530,201807,45,30,15,28620,14310,42930
313535,201807,106,84,22,79469,20988,100457
313540,201807,72,54,18,51516,17172,68688
313545,201807,115,96,19,91584,18126,109710
313550,201807,233,192,41,183168,38828,221996
313560,201807,330,169,161,161226,153594,314820
313570,201807,60,32,28,30528,26712,57240
313580,201807,1325,732,593,695657,564864,1260521
313590,201807,79,47,32,44838,30528,75366
313600,201807,697,417,280,397532,266323,663855
313610,201807,59,47,12,44218.8,11448,55666.8
313620,201807,1368,722,646,678356.18,611351.6,1289707.78
313630,201807,1645,1257,388,1195580.4,369866,1565446.4
313640,201807,129,75,54,71550,51516,123066
313650,201807,237,109,128,103986,121540,225526
313652,201807,17,17,0,16218,0,16218
313655,201807,56,33,23,31482,21942,53424
313657,201807,47,44,3,41976,2862,44838
313660,201807,134,90,44,85860,41993.17,127853.17
313665,201807,658,317,341,302418,325075.5,627493.5
313670,201807,10318,7139,3179,6785876.88,3031621.6,9817498.48
313680,201807,41,30,11,28620,10390,39010
313690,201807,154,115,39,109710,37206,146916
313695,201807,78,59,19,56286,18126,74412
313700,201807,304,246,58,234398,55332,289730
313710,201807,145,99,46,94446,43884,138330
313720,201807,1104,527,577,500564,549113.86,1049677.86
313730,201807,61,42,19,40068,18126,58194
313740,201807,163,131,32,124974,30528,155502
313750,201807,441,322,119,307188,113526,420714
313753,201807,247,180,67,171052.2,63918,234970.2
313760,201807,1271,459,812,437600,771901.98,1209501.98
313770,201807,358,261,97,248024.2,92538,340562.2
313780,201807,766,397,369,378738,351739.8,730477.8
313790,201807,29,28,1,26712,954,27666
313800,201807,146,90,56,85860,53424,139284
313810,201807,69,41,28,39114,26712,65826
313820,201807,1280,639,641,608366.2,610251,1218617.2
313830,201807,68,49,19,46746,18126,64872
313835,201807,57,48,9,45792,8586,54378
313840,201807,1703,1053,650,999221.52,618574,1617795.52
313850,201807,183,62,121,59148,114854.06,174002.06
313860,201807,480,370,110,349499.3,104940,454439.3
313862,201807,174,115,59,109710,56286,165996
313865,201807,91,73,18,69642,17172,86814
313867,201807,48,37,11,35298,10494,45792
313868,201807,28,19,9,17363,8586,25949
313870,201807,127,65,62,62010,58862,120872
313880,201807,357,225,132,214650,125355.8,340005.8
313890,201807,325,173,152,164279.8,144435.6,308715.4
313900,201807,908,496,412,472230.5,393001,865231.5
313910,201807,139,100,39,95400,36252.2,131652.2
313920,201807,621,442,179,421477.2,170246,591723.2
313925,201807,32,28,4,26712,3816,30528
313930,201807,821,634,187,604550,178375,782925
313940,201807,1819,1149,670,1092234.8,638512.4,1730747.2
313950,201807,939,597,342,567726.6,325981.8,893708.4
313960,201807,1395,804,591,762752.3,560668,1323420.3
313970,201807,122,82,40,78228,38160,116388
313980,201807,215,139,76,132368,72504,204872
313990,201807,376,226,150,215604,143100,358704
314000,201807,928,626,302,593723.9,288103.23,881827.13
314010,201807,78,51,27,48654,25758,74412
314015,201807,53,16,37,15264,35298,50562
314020,201807,50,34,16,32436,15264,47700
314030,201807,83,37,46,35135.82,43884,79019.82
314040,201807,45,30,15,28620,14310,42930
314050,201807,314,187,127,178112,121158,299270
314053,201807,97,64,33,60102.4,31482,91584.4
314055,201807,300,179,121,170766,115434,286200
314060,201807,145,123,22,116388,20988,137376
314070,201807,1039,522,517,494183.14,492598,986781.14
314080,201807,220,143,77,135468,72408.88,207876.88
314085,201807,134,89,45,84906,42930,127836
314090,201807,357,258,99,246132,94441.23,340573.23
314100,201807,477,392,85,370153,80518,450671
314110,201807,716,391,325,371401.74,309477.6,680879.34
314120,201807,97,55,42,52470,40068,92538
314130,201807,24,11,13,10494,12402,22896
314140,201807,1107,672,435,637658,411842.46,1049500.46
314150,201807,163,104,59,99216,56286,155502
314160,201807,351,262,89,247086.8,84716,331802.8
314170,201807,78,60,18,57240,17172,74412
314180,201807,730,643,87,613136,82044.5,695180.5
314190,201807,101,60,41,57240,39114,96354
314200,201807,589,409,180,388915.6,170766,559681.6
314210,201807,282,214,68,203202,64586,267788
314220,201807,311,234,77,221329,73172,294501
314225,201807,65,47,18,44838,17172,62010
314230,201807,107,46,61,43884,58194,102078
314240,201807,139,107,32,102078,30528,132606
314250,201807,60,37,23,35298,21942,57240
314260,201807,188,95,93,90630,88722,179352
314270,201807,330,262,68,249948,64837,314785
314280,201807,696,389,307,371097,292878,663975
314290,201807,559,457,102,434738.5,97021.8,531760.3
314300,201807,403,288,115,272579.5,109663,382242.5
314310,201807,1449,977,472,930151.12,450267.97,1380419.09
314315,201807,35,29,6,27666,5724,33390
314320,201807,610,394,216,375303.8,205424.82,580728.62
314330,201807,10689,5394,5295,5135013.96,5046964.75,10181978.71
314340,201807,571,266,305,253191.8,290398,543589.8
314345,201807,33,26,7,24804,6678,31482
314350,201807,191,120,71,114480,67734,182214
314360,201807,80,50,30,47700,28620,76320
314370,201807,57,48,9,45792,8586,54378
314380,201807,92,66,26,62964,24804,87768
314390,201807,3293,2096,1197,1994051.3,1138981.4,3133032.7
314400,201807,687,493,194,467452.2,185076,652528.2
314410,201807,439,285,154,271890,146916,418806
314420,201807,18,9,9,8586,8586,17172
314430,201807,2512,901,1611,854466.69,1534382.47,2388849.16
314435,201807,273,159,114,151399.8,107802,259201.8
314437,201807,28,22,6,20988,5724,26712
314440,201807,97,71,26,67734,24804,92538
314450,201807,155,114,41,108756,39114,147870
314460,201807,652,305,347,290970,331038,622008
314465,201807,84,56,28,53424,26712,80136
314467,201807,70,57,13,54369,12402,66771
314470,201807,392,205,187,192118.52,177444.5,369563.02
314480,201807,1086,516,570,492264,543534.91,1035798.91
314490,201807,88,66,22,62964,20988,83952
314500,201807,314,208,106,198432,101124,299556
314505,201807,128,85,43,81090,41022,122112
314510,201807,231,191,40,182214,38160,220374
314520,201807,1270,659,611,619760.3,581749.8,1201510.1
314530,201807,735,582,153,554593,145962,700555
314535,201807,213,134,79,126786.6,75115.01,201901.61
314537,201807,64,39,25,37206,23850,61056
314540,201807,14,9,5,8586,4770,13356
314545,201807,49,31,18,29574,17172,46746
314550,201807,82,44,38,41976,36252,78228
314560,201807,822,443,379,420141.8,361566,781707.8
314570,201807,22,17,5,16218,4770,20988
314580,201807,16,8,8,7632,7632,15264
314585,201807,22,17,5,16218,4770,20988
314587,201807,84,73,11,69642,10494,80136
314590,201807,583,428,155,406705.5,147584,554289.5
314600,201807,975,638,337,604257.06,320162.6,924419.66
314610,201807,945,514,431,487494.7,410983.2,898477.9
314620,201807,151,112,39,105607.8,37206,142813.8
314625,201807,97,72,25,68116,23850,91966
314630,201807,1235,632,603,601449.3,574689.8,1176139.1
314640,201807,91,59,32,56286,30241.8,86527.8
314650,201807,195,112,83,106561.8,78705,185266.8
314655,201807,65,50,15,47700,14310,62010
314660,201807,20,16,4,15264,3816,19080
314670,201807,193,153,40,145676,38160,183836
314675,201807,219,129,90,123066,85860,208926
314690,201807,541,300,241,285913.8,229914,515827.8
314700,201807,2434,1337,1097,1270491.5,1045584.9,2316076.4
314710,201807,1625,945,680,897526.7,648100.1,1545626.8
314720,201807,413,248,165,235189.62,157410,392599.62
314730,201807,517,272,245,257772,233721,491493
314740,201807,690,341,349,323930.7,332946,656876.7
314750,201807,20,17,3,16218,2862,19080
314760,201807,328,157,171,149778,163124.46,312902.46
314770,201807,122,83,39,79182,37206,116388
314780,201807,21,6,15,5724,14310,20034
314790,201807,2376,1490,886,1414107.3,844414.02,2258521.32
314795,201807,55,47,8,44600,7632,52232
314800,201807,2954,1741,1213,1655628.66,1155198.6,2810827.26
314810,201807,1518,843,675,801885.5,642329,1444214.5
314820,201807,93,52,41,49608,39114,88722
314830,201807,208,166,42,157648.5,39782,197430.5
314840,201807,81,46,35,43884,33390,77274
314850,201807,352,171,181,163134,172674,335808
314860,201807,711,533,178,506478.86,167618.7,674097.56
314870,201807,1480,773,707,736488,674478,1410966
314875,201807,57,49,8,46746,7632,54378
314880,201807,47,34,13,32436,12402,44838
314890,201807,55,33,22,31482,20988,52470
314900,201807,33,26,7,24804,6678,31482
314910,201807,252,172,80,163801.8,76320,240121.8
314915,201807,162,142,20,135468,19080,154548
314920,201807,124,77,47,73458,44551.8,118009.8
314930,201807,1045,528,517,501848.33,492645.6,994493.93
314940,201807,51,40,11,38160,10494,48654
314950,201807,38,27,11,25758,10494,36252
314960,201807,54,41,13,39114,12402,51516
314970,201807,144,74,70,70596,66780,137376
314980,201807,305,195,110,183788.1,103986,287774.1
314990,201807,469,258,211,246132,200388.5,446520.5
314995,201807,204,64,140,61056,133550.46,194606.46
315000,201807,92,75,17,71550,16218,87768
315010,201807,46,30,16,28620,15264,43884
315015,201807,176,144,32,136650.96,30528,167178.96
315020,201807,72,62,10,59148,9540,68688
315030,201807,119,91,28,85860,26712,112572
315040,201807,66,48,18,45792,17172,62964
315050,201807,200,121,79,115434,75080,190514
315053,201807,40,35,5,33390,4626.9,38016.9
315057,201807,97,80,17,75938.4,16218,92156.4
315060,201807,73,64,9,59149.16,8586,67735.16
315070,201807,102,57,45,54378,42930,97308
315080,201807,374,307,67,292878,63918,356796
315090,201807,111,67,44,63918,41976,105894
315100,201807,82,41,41,39114,39114,78228
315110,201807,293,163,130,154644,124020,278664
315120,201807,1664,846,818,801571.18,778178.64,1579749.82
315130,201807,346,251,95,239454,90630,330084
315140,201807,533,312,221,296026.2,210834,506860.2
315150,201807,986,469,517,446473,492932,939405
315160,201807,215,109,106,103986,101124,205110
315170,201807,334,215,119,204157,113239.8,317396.8
315180,201807,3201,1352,1849,1286708.3,1760990.7,3047699.0
315190,201807,319,185,134,176109,127836,303945
315200,201807,1204,693,511,659500.2,486635.4,1146135.6
315210,201807,1568,892,676,847821.4,642484.2,1490305.6
315213,201807,44,25,19,23850,18126,41976
315217,201807,213,170,43,162180,41022,203202
315220,201807,1549,1188,361,1132062.4,344012.6,1476075.0
315230,201807,169,124,45,118010,42930,160940
315240,201807,424,274,150,261396,141898.5,403294.5
315250,201807,2562,1261,1301,1202416.83,1240572.86,2442989.69
315260,201807,150,91,59,85860,56286,142146
315270,201807,132,91,41,86241.6,38388.96,124630.56
315280,201807,693,452,241,430827,229904.46,660731.46
315290,201807,201,118,83,112572,78228.49,190800.49
315300,201807,72,50,22,47700,20988,68688
315310,201807,68,62,6,59148,5724,64872
315320,201807,163,93,70,88722,66780,155502
315330,201807,58,50,8,47700,7632,55332
315340,201807,416,297,119,282155.6,113526,395681.6
315350,201807,152,91,61,86814,58194,145008
315360,201807,96,52,44,49608,41976,91584
315370,201807,59,35,24,32675,22896,55571
315380,201807,12,7,5,6678,4770,11448
315390,201807,64,14,50,13356,47700,61056
315400,201807,837,629,208,594628.5,197764.2,792392.7
315410,201807,355,217,138,206732,131366,338098
315415,201807,63,48,15,45792,14310,60102
315420,201807,205,156,49,147728,46746,194474
315430,201807,677,393,284,373682,270459.8,644141.8
315440,201807,87,60,27,57240,25758,82998
315445,201807,256,206,50,196209.18,47700,243909.18
315450,201807,177,133,44,126882,41976,168858
315460,201807,3485,1755,1730,1671209.4,1647693.1,3318902.5
315470,201807,43,21,22,20034,20988,41022
315480,201807,64,25,39,23850,37206,61056
315490,201807,633,394,239,373824.9,228006,601830.9
315500,201807,22,14,8,13356,7632,20988
315510,201807,154,103,51,98262,48654,146916
315520,201807,74,65,9,62010,8586,70596
315530,201807,54,29,25,27666,23850,51516
315540,201807,235,155,80,147870,76320,224190
315550,201807,179,143,36,136422,34344,170766
315560,201807,742,592,150,563428.8,143100,706528.8
315570,201807,319,166,153,155169.5,145485,300654.5
315580,201807,672,440,232,419093,221328,640421
315590,201807,207,108,99,103032,94446,197478
315600,201807,293,216,77,205825.5,73458,279283.5
315610,201807,101,49,52,46746,49608,96354
315620,201807,33,27,6,25758,5724,31482
315630,201807,136,90,46,85860,43884,129744
315640,201807,65,39,26,37206,24804,62010
315645,201807,66,47,19,44838,17649,62487
315650,201807,169,123,46,116770,43311.6,160081.6
315660,201807,479,210,269,200340,256626,456966
315670,201807,2430,1206,1224,1147739.32,1166523.66,2314262.98
315680,201807,863,585,278,555609.6,265212,820821.6
315690,201807,684,471,213,449213,203202,652415
315700,201807,1914,1010,904,959668.37,862321,1821989.37
315710,201807,331,91,240,86814,228960,315774
315720,201807,439,284,155,270936,147870,418806
315725,201807,203,162,41,154548,39114,193662
315727,201807,44,22,22,20988,20988,41976
315730,201807,46,44,2,41976,1908,43884
315733,201807,90,59,31,56286,29574,85860
315737,201807,51,39,12,37206,11448,48654
315740,201807,47,39,8,37206,7632,44838
315750,201807,158,121,37,115434,35298,150732
315760,201807,48,34,14,32436,13356,45792
315765,201807,122,78,44,74412,41976,116388
315770,201807,231,142,89,135468,84620,220088
315780,201807,3321,1726,1595,1640031.94,1518960.38,3158992.32
315790,201807,212,161,51,153594,48081.6,201675.6
315800,201807,288,208,80,198432,76320,274752
315810,201807,99,59,40,56286,37874,94160
315820,201807,798,579,219,549791.34,208926,758717.34
315830,201807,142,82,60,78228,57240,135468
315840,201807,94,66,28,62964,26712,89676
315850,201807,258,194,64,185076,61056,246132
315860,201807,12,4,8,3816,7632,11448
315870,201807,36,28,8,26712,7632,34344
315880,201807,109,72,37,68688,35298,103986
315890,201807,82,61,21,58194,20034,78228
315895,201807,465,313,152,297553,144436,441989
315900,201807,72,34,38,32150,36252,68402
315910,201807,39,25,14,23611.5,13356,36967.5
315920,201807,178,117,61,111618,57240.9,168858.9
315930,201807,44,15,29,14310,27666,41976
315935,201807,151,118,33,112572,31473,144045
315940,201807,91,67,24,63918,22896,86814
315950,201807,64,45,19,42930,18126,61056
315960,201807,558,261,297,247725.38,282479.6,530204.98
315970,201807,38,30,8,28620,7632,36252
315980,201807,700,329,371,311551.76,353934,665485.76
315990,201807,255,150,105,142862,99875,242737
316000,201807,50,33,17,31195.8,15931.8,47127.6
316010,201807,76,64,12,61056,11448,72504
316020,201807,111,92,19,87768,18126,105894
316030,201807,407,217,190,206732,180736,387468
316040,201807,510,216,294,205110.2,280190,485300.2
316045,201807,61,54,7,51516,6678,58194
316050,201807,16,14,2,13356,1908,15264
316060,201807,96,62,34,59148,32436,91584
316070,201807,1079,699,380,660713.4,361757,1022470.4
316080,201807,103,65,38,61294.5,36252,97546.5
316090,201807,41,25,16,23182.2,15264,38446.2
316095,201807,73,61,12,57918,11448,69366
316100,201807,312,185,127,175965.3,121158,297123.3
316105,201807,35,24,11,22896,10494,33390
316110,201807,1917,1545,372,1463484.55,354220.2,1817704.75
316120,201807,79,59,20,56286,18793.8,75079.8
316130,201807,137,106,31,100457,29574,130031
316140,201807,26,19,7,18126,6678,24804
316150,201807,207,144,63,136660.5,60102,196762.5
316160,201807,86,52,34,49608,32436,82044
316165,201807,64,47,17,44648,15502.5,60150.5
316170,201807,204,138,66,130698,62964,193662
316180,201807,207,91,116,86480.1,110664,197144.1
316190,201807,139,102,37,96354,35298,131652
316200,201807,702,392,310,373968,294881.4,668849.4
316210,201807,769,517,252,494805.41,240408,735213.41
316220,201807,113,78,35,74412,33390,107802
316225,201807,25,14,11,13356,10494,23850
316230,201807,31,19,12,18126,11448,29574
316240,201807,633,509,124,485586,118296,603882
316245,201807,110,92,18,87768,17172,104940
316250,201807,1524,1062,462,1005244.49,439565.12,1444809.61
316255,201807,110,90,20,85478.4,19065.69,104544.09
316257,201807,185,97,88,92538,83665.8,176203.8
316260,201807,245,161,84,152297.06,80041,232338.06
316265,201807,27,18,9,17172,8586,25758
316270,201807,677,472,205,447283.4,195570,642853.4
316280,201807,542,331,211,314503.8,200626.6,515130.4
316290,201807,700,466,234,441512.18,223236,664748.18
316292,201807,518,207,311,197191.8,296456,493647.8
316294,201807,100,57,43,54378,41022,95400
316295,201807,300,133,167,125434,159318,284752
316300,201807,103,73,30,69642,28620,98262
316310,201807,38,20,18,18793.8,17172,35965.8
316320,201807,41,25,16,23850,15264,39114
316330,201807,130,85,45,80136.5,42643.8,122780.3
316340,201807,146,99,47,94446,44838,139284
316350,201807,194,141,53,134348,50562,184910
316360,201807,23,17,6,16218,5724,21942
316370,201807,1089,581,508,549810.7,484336.26,1034146.96
316380,201807,122,93,29,88722,27666,116388
316390,201807,125,89,36,84906,34344,119250
316400,201807,138,104,34,99216,32436,131652
316410,201807,308,225,83,213266.7,79182,292448.7
316420,201807,207,147,60,139522.5,57240,196762.5
316430,201807,154,79,75,75366,71550,146916
316440,201807,98,47,51,44838,48654,93492
316443,201807,38,35,3,33390,2862,36252
316447,201807,65,51,14,48654,13356,62010
316450,201807,223,167,56,159318,53424,212742
316460,201807,70,29,41,27666,39114,66780
316470,201807,1629,1178,451,1116106.44,428132.79,1544239.23
316480,201807,13,10,3,9540,2862,12402
316490,201807,18,7,11,6678,10494,17172
316500,201807,154,103,51,97975.8,48654,146629.8
316510,201807,164,125,39,118248.3,37206,155454.3
316520,201807,186,111,75,105894,71550,177444
316530,201807,161,113,48,107802,45505.8,153307.8
316540,201807,144,80,64,76320,61056,137376
316550,201807,137,98,39,93492,37206,130698
316553,201807,250,117,133,111395.53,126882,238277.53
316555,201807,35,27,8,24954,7632,32586
316556,201807,11,8,3,7632,2862,10494
316557,201807,18,14,4,13356,3816,17172
316560,201807,63,49,14,46746,13356,60102
316570,201807,243,220,23,209642,21942,231584
316580,201807,22,16,6,15264,5724,20988
316590,201807,114,98,16,93492,15264,108756
316600,201807,182,149,33,141383,31482,172865
316610,201807,68,48,20,45505.8,19080,64585.8
316620,201807,135,104,31,99216,29574,128790
316630,201807,45,33,12,31482,11448,42930
316640,201807,16,10,6,9540,5724,15264
316650,201807,70,53,17,50562,16218,66780
316660,201807,8,4,4,3816,3816,7632
316670,201807,445,159,286,151667,272271.8,423938.8
316680,201807,162,115,47,109710,44648,154358
316690,201807,193,124,69,118296,65826,184122
316695,201807,61,54,7,51516,6678,58194
316700,201807,15,8,7,7632,6678,14310
316710,201807,718,522,196,497750,186984,684734
316720,201807,4938,2513,2425,2382894.73,2308595.47,4691490.20
316730,201807,15,14,1,13356,954,14310
316740,201807,129,82,47,78228,44838,123066
316750,201807,21,14,7,13356,6678,20034
316760,201807,326,263,63,250902,60102,311004
316770,201807,140,77,63,73458,60102,133560
316780,201807,76,46,30,43578.72,28620,72198.72
316790,201807,57,44,13,41976,12402,54378
316800,201807,1797,1106,691,1054074.8,658738,1712812.8
316805,201807,18,10,8,9540,7632,17172
316810,201807,68,44,24,41976,22896,64872
316820,201807,42,20,22,19080,20988,40068
316830,201807,94,41,53,39114,50562,89676
316840,201807,506,306,200,291638,189846,481484
316850,201807,338,221,117,210166.2,111618,321784.2
316860,201807,6055,2693,3362,2554963.45,3201610.97,5756574.42
316870,201807,1479,964,515,910787.1,485874.2,1396661.3
316880,201807,118,65,53,61723.8,50562,112285.8
316890,201807,251,169,82,161179,78228,239407
316900,201807,422,291,131,275067.28,124974,400041.28
316905,201807,16,9,7,8586,6678,15264
316910,201807,52,25,27,23850,25758,49608
316920,201807,135,105,30,99455,28620,128075
316930,201807,1932,988,944,936781.5,898382.7,1835164.2
316935,201807,873,525,348,498942.72,331038,829980.72
316940,201807,1110,640,470,609606.4,447798.26,1057404.66
316950,201807,185,96,89,91584,84906,176490
316960,201807,1120,628,492,597776.8,469072.46,1066849.26
316970,201807,641,499,142,475560,135468,611028
316980,201807,110,67,43,63918,41012.46,104930.46
316990,201807,2207,1457,750,1382776.98,712582.76,2095359.74
317000,201807,333,256,77,243938,73458,317396
317005,201807,247,176,71,167904,67734,235638
317010,201807,6357,3492,2865,3311340.06,2731016,6042356.06
317020,201807,16342,7225,9117,6861714.73,8682457.47,15544172.20
317030,201807,81,32,49,30528,46529.26,77057.26
317040,201807,3115,1939,1176,1844467.23,1119138.61,2963605.84
317043,201807,75,54,21,51516,20034,71550
317047,201807,36,18,18,17172,17168,34340
317050,201807,180,135,45,128790,42930,171720
317052,201807,129,98,31,93492,29574,123066
317057,201807,198,148,50,141192,47128,188320
317060,201807,58,38,20,36252,18793.8,55045.8
317065,201807,58,46,12,43884,11448,55332
317070,201807,2008,948,1060,899623.7,1010095.6,1909719.3
317075,201807,108,57,51,54378,48654,103032
317080,201807,833,438,395,416754.9,376640,793394.9
317090,201807,636,508,128,482295.5,122112,604407.5
317100,201807,428,322,106,305280,101124,406404
317103,201807,110,96,14,91584,13356,104940
317107,201807,39,34,5,32436,4770,37206
317110,201807,105,44,61,41976,58194,100170
317115,201807,40,34,6,32436,5724,38160
317120,201807,1843,935,908,884086.62,865775,1749861.62
317130,201807,1957,1261,696,1196829.59,663317,1860146.59
317140,201807,9,7,2,6678,1908,8586
317150,201807,273,161,112,153308,106084.8,259392.8
317160,201807,311,226,85,215287,80804,296091
317170,201807,210,143,67,136422,63918,200340
317180,201807,436,316,120,300748.5,114480,415228.5
317190,201807,255,172,83,164088,78895.8,242983.8
317200,201807,821,576,245,536365.2,233492,769857.2
317210,201807,156,89,67,83952.2,63918,147870.2
317220,201807,19,13,6,12402,5724,18126
320010,201807,626,469,157,444088.5,149778,593866.5
320013,201807,134,99,35,94446,33390,127836
320016,201807,284,180,104,171720,99216,270936
320020,201807,722,431,291,408624.75,275706.32,684331.07
320030,201807,154,112,42,106848,39734.1,146582.1
320035,201807,138,102,36,97308,34344,131652
320040,201807,505,260,245,247181.8,233444,480625.8
320050,201807,119,89,30,84906,28620,113526
320060,201807,1574,747,827,712591,788281.6,1500872.6
320070,201807,105,70,35,66780,33390,100170
320080,201807,767,439,328,415975,312912,728887
320090,201807,1218,846,372,803730.86,354029.6,1157760.46
320100,201807,326,188,138,179352,131652,311004
320110,201807,138,89,49,83046.2,46460,129506.2
320115,201807,113,91,22,86814,20988,107802
320120,201807,3313,1843,1470,1746968.4,1399587.14,3146555.54
320130,201807,7469,3538,3931,3354568.82,3743383.85,7097952.67
320140,201807,424,276,148,262637,140948,403585
320150,201807,1931,1119,812,1059737.61,774352.26,1834089.87
320160,201807,683,310,373,293537.03,354726.99,648264.02
320170,201807,120,95,25,89867,23850,113717
320180,201807,51,29,22,27666,20988,48654
320190,201807,237,156,81,148051.26,76988,225039.26
320200,201807,56,44,12,41976,11448,53424
320210,201807,845,475,370,451624.6,352008,803632.6
320220,201807,307,115,192,109710,182882,292592
320225,201807,78,64,14,61056,13356,74412
320230,201807,570,370,200,351454.4,189990,541444.4
320240,201807,3151,1581,1570,1505794.8,1495113.78,3000908.58
320245,201807,458,315,143,299365.4,136422,435787.4
320250,201807,233,124,109,117342.6,103986,221328.6
320255,201807,147,114,33,107449.02,31339,138788.02
320260,201807,180,126,54,120204,51468.3,171672.3
320265,201807,160,127,33,120348,31482,151830
320270,201807,150,123,27,117342,25758,143100
320280,201807,978,581,397,549314.2,378452,927766.2
320290,201807,67,57,10,54378,9540,63918
320300,201807,547,389,158,368359.8,149683.1,518042.9
320305,201807,678,372,306,354888,291734,646622
320310,201807,214,119,95,111571.5,89874,201445.5
320313,201807,305,156,149,148824,141860,290684
320316,201807,107,88,19,83952,18126,102078
320320,201807,3348,1530,1818,1454556,1731391.8,3185947.8
320330,201807,256,189,67,179643.3,62010.8,241654.1
320332,201807,888,538,350,511395.6,332851.3,844246.9
320334,201807,241,146,95,138998,90630,229628
320335,201807,144,103,41,97308.4,39114,136422.4
320340,201807,587,406,181,386180,172007,558187
320350,201807,969,418,551,396511.67,524242.48,920754.15
320360,201807,170,92,78,87482,74412,161894
320370,201807,244,188,56,177660,52391,230051
320380,201807,285,195,90,184361.3,85860,270221.3
320390,201807,1136,689,447,654788.8,425818.13,1080606.93
320400,201807,319,230,89,217988,84906,302894
320405,201807,904,390,514,371483.6,490043.92,861527.52
320410,201807,987,505,482,480101.4,459495,939596.4
320420,201807,482,249,233,237069.4,222282,459351.4
320425,201807,193,104,89,99216,84906,184122
320430,201807,393,225,168,213028.7,160272,373300.7
320435,201807,171,115,56,108889.56,53424,162313.56
320440,201807,202,122,80,116388,76320,192708
320450,201807,132,77,55,73458,52470,125928
320455,201807,253,206,47,195571,44838,240409
320460,201807,242,153,89,145962,84906,230868
320465,201807,114,77,37,73095.48,35298,108393.48
320470,201807,643,409,234,389882.26,223232,613114.26
320480,201807,181,121,60,114623.1,57240,171863.1
320490,201807,3053,1527,1526,1453849.18,1452779.94,2906629.12
320495,201807,96,58,38,55313,36252,91565
320500,201807,9536,4797,4739,4548278.73,4508502.59,9056781.32
320501,201807,550,279,271,266166,258534,524700
320503,201807,286,203,83,192708.2,79182,271890.2
320506,201807,260,195,65,186030,62010,248040
320510,201807,966,454,512,429254.3,486922.1,916176.4
320515,201807,81,68,13,63918.9,12402,76320.9
320517,201807,207,147,60,140238,57240,197478
320520,201807,6954,3098,3856,2941131.69,3671061.42,6612193.11
320530,201807,5345,2675,2670,2543217.02,2543935,5087152.02
330010,201807,3143,1628,1515,1545738.16,1441558.17,2987296.33
330015,201807,158,66,92,61820.08,87768,149588.08
330020,201807,3658,1603,2055,1525672.72,1959612,3485284.72
330022,201807,233,132,101,125213,95400.8,220613.8
330023,201807,540,186,354,176394.8,337716,514110.8
330025,201807,592,119,473,113526,450870.8,564396.8
330030,201807,1954,1258,696,1191791.18,660715.68,1852506.86
330040,201807,2406,1243,1163,1183008.4,1107645.3,2290653.7
330045,201807,8376,2666,5710,2535236.82,5441050.57,7976287.39
330050,201807,835,534,301,509436,287154,796590
330060,201807,925,571,354,540443.1,336399.48,876842.58
330070,201807,3456,1316,2140,1248839.47,2040245.56,3289085.03
330080,201807,1496,702,794,664731.5,755950.4,1420681.9
330090,201807,362,215,147,205110,140238,345348
330093,201807,285,128,157,122112,149742,271854
330095,201807,101,53,48,49894.2,45792,95686.2
330100,201807,9533,4909,4624,4671078.48,4408004.9,9079083.38
330110,201807,485,215,270,202725.1,257580,460305.1
330115,201807,540,308,232,293832,221328,515160
330120,201807,376,195,181,184885.2,171720.4,356605.6
330130,201807,1545,420,1125,399954.96,1073232,1473186.96
330140,201807,600,318,282,303345,268075,571420
330150,201807,451,264,187,249948,178398,428346
330160,201807,211,132,79,125928,75366,201294
330170,201807,27076,9524,17552,9063896.77,16731776.61,25795673.38
330180,201807,234,148,86,138645.02,81328.5,219973.52
330185,201807,832,333,499,316146.6,474778.8,790925.4
330187,201807,306,94,212,89676,202248,291924
330190,201807,5597,2263,3334,2147823.3,3177626.68,5325449.98
330200,201807,4570,1508,3062,1433673.06,2916085.76,4349758.82
330205,201807,407,245,162,233300.7,154262,387562.7
330210,201807,1012,621,391,585504.02,371344.9,956848.92
330220,201807,2584,1549,1035,1473415.5,986436.2,2459851.7
330225,201807,565,302,263,287469,250234.2,537703.2
330227,201807,2431,773,1658,734284.46,1581376.23,2315660.69
330230,201807,204,123,81,116675,77274,193949
330240,201807,3690,1950,1740,1855647.28,1657007.51,3512654.79
330245,201807,155,68,87,64300,82234.8,146534.8
330250,201807,6536,3401,3135,3232921.6,2982123.32,6215044.92
330260,201807,565,163,402,155502,383508,539010
330270,201807,3430,1255,2175,1196413,2074379.2,3270792.2
330280,201807,452,289,163,273914.08,155493,429407.08
330285,201807,7134,2342,4792,2228911.2,4569461.32,6798372.52
330290,201807,566,216,350,206064,333900,539964
330300,201807,791,524,267,496080.7,254700,750780.7
330310,201807,423,242,181,228960.7,172674,401634.7
330320,201807,8324,3157,5167,3003816.1,4923523.84,7927339.94
330330,201807,9222,3645,5577,3469339,5316813.56,8786152.56
330340,201807,2650,1581,1069,1506357.26,1019806.92,2526164.18
330350,201807,18062,7113,10949,6755908.09,10425026.97,17180935.06
330360,201807,2487,1240,1247,1181987.2,1189629,2371616.2
330370,201807,1026,560,466,533286,442513.9,975799.9
330380,201807,855,364,491,346530.96,467376.8,813907.76
330385,201807,613,320,293,304327,279522,583849
330390,201807,5216,2883,2333,2735790.55,2222834.4,4958624.95
330395,201807,282,172,110,163134.3,103175.2,266309.5
330400,201807,708,372,336,351454.6,318426.88,669881.48
330410,201807,500,358,142,339864,134978.33,474842.33
330411,201807,234,132,102,125747,97260.3,223007.3
330412,201807,256,104,152,98930,145008,243938
330414,201807,6089,2493,3596,2374326.58,3427370.1,5801696.68
330415,201807,592,275,317,261368.34,301464.8,562833.14
330420,201807,2268,1186,1082,1127446.8,1029835,2157281.8
330430,201807,1791,839,952,797926.8,906205.8,1704132.6
330440,201807,269,124,145,118296,138330,256626
330450,201807,122,52,70,49608,66780,116388
330452,201807,1779,847,932,806571.8,888805.76,1695377.56
330455,201807,110922,39862,71060,37953026.5,67727011.98,105680038.48
330460,201807,260,108,152,103032,145008,248040
330470,201807,1239,677,562,639564.98,536138.46,1175703.44
330475,201807,1406,375,1031,356796.8,983001.6,1339798.4
330480,201807,775,409,366,389518.2,348211,737729.2
330490,201807,13826,4843,8983,4614560.73,8563615.24,13178175.97
330500,201807,1341,609,732,580842.9,697947,1278789.9
330510,201807,11286,3839,7447,3653879.42,7096841.44,10750720.86
330513,201807,104,52,52,49608,49608,99216
330515,201807,856,349,507,328634.8,483297,811931.8
330520,201807,2587,955,1632,910851,1556775.9,2467626.9
330530,201807,221,117,104,111380,99026,210406
330540,201807,352,176,176,167904,167427,335331
330550,201807,3032,1078,1954,1026218.2,1861826.8,2888045.0
330555,201807,768,290,478,276641,455058.8,731699.8
330560,201807,592,208,384,198432,366318,564750
330570,201807,256,179,77,170766,73458,244224
330575,201807,805,340,465,324122,441555.5,765677.5
330580,201807,3401,1907,1494,1813089.8,1423797.7,3236887.5
330590,201807,314,152,162,145008,154548,299556
330600,201807,1108,710,398,675203.24,377994.84,1053198.08
330610,201807,1543,842,701,796401.74,664605.9,1461007.64
330615,201807,191,143,48,136422,45792,182214
330620,201807,1075,434,641,411366.5,610083.8,1021450.3
330630,201807,3954,2519,1435,2387232.37,1361742.8,3748975.17
350010,201807,595,392,203,372108.67,193662,565770.67
350020,201807,38,19,19,18126,18126,36252
350030,201807,524,337,187,320354,177208.66,497562.66
350040,201807,126,51,75,48310.56,71550,119860.56
350050,201807,289,157,132,149778,125671.46,275449.46
350055,201807,88,50,38,47700,36252,83952
350060,201807,77,28,49,26712,46746,73458
350070,201807,817,479,338,451518.58,320785.56,772304.14
350075,201807,63,43,20,41022,19080,60102
350080,201807,52,33,19,30845.96,16974.16,47820.12
350090,201807,96,54,42,51516,40063.23,91579.23
350100,201807,294,186,108,176728.5,103032,279760.5
350110,201807,57,35,22,33390,20988,54378
350115,201807,163,100,63,94732.2,60102,154834.2
350120,201807,110,74,36,70596,34344,104940
350130,201807,354,173,181,164756,172674,337430
350140,201807,36,22,14,20225,13356,33581
350150,201807,69,54,15,51516,14310,65826
350160,201807,2580,1007,1573,957609.16,1499569.91,2457179.07
350170,201807,410,250,160,236592.2,152354,388946.2
350180,201807,183,98,85,93492,81090,174582
350190,201807,999,522,477,495986.64,454876.68,950863.32
350200,201807,68,25,43,23850,40757.08,64607.08
350210,201807,1355,763,592,720869.13,564250.66,1285119.79
350220,201807,676,580,96,549182.73,91584,640766.73
350230,201807,82,58,24,55332,22896,78228
350240,201807,60,45,15,42930,14310,57240
350250,201807,1236,609,627,575645,597528.66,1173173.66
350260,201807,93,66,27,62964,25758,88722
350270,201807,828,538,290,511697.58,275210.92,786908.50
350275,201807,302,119,183,113145,174582,287727
350280,201807,4746,2435,2311,2309966.06,2201871.65,4511837.71
350290,201807,410,198,212,188887.23,201675.8,390563.03
350300,201807,54,30,24,28620,22896,51516
350310,201807,101,70,31,66780,29574,96354
350315,201807,40,25,15,23850,14310,38160
350320,201807,3328,1656,1672,1574694.5,1594316.8,3169011.3
350330,201807,1689,901,788,855168.72,750576.04,1605744.76
350335,201807,21,14,7,13356,6678,20034
350340,201807,132,62,70,59148,66447,125595
350350,201807,95,48,47,45792,44838,90630
350360,201807,126,82,44,78224,41976,120200
350370,201807,93,54,39,50562.96,37196.46,87759.42
350380,201807,768,329,439,312912.2,418042.8,730955.0
350390,201807,1432,579,853,551570.35,812617.4,1364187.75
350395,201807,24,19,5,18126,4770,22896
350400,201807,1668,889,779,838500.02,739614.16,1578114.18
350410,201807,2261,1020,1241,969990.96,1183282.03,2153272.99
350420,201807,236,145,91,137727,86814,224541
350430,201807,73,42,31,39496,29574,69070
350440,201807,147,109,38,102984.5,36252,139236.5
350450,201807,1622,997,625,944972.95,596155,1541127.95
350460,201807,333,121,212,115434,201961.8,317395.8
350470,201807,15,10,5,9540,4770,14310
350480,201807,163,86,77,82044,73458,155502
350490,201807,239,119,120,112572.8,114480,227052.8
350500,201807,39,20,19,19080,18126,37206
350510,201807,166,111,55,105894,52470,158364
350520,201807,456,216,240,202883.96,228323.96,431207.92
350530,201807,451,213,238,203202,227052,430254
350535,201807,68,53,15,50304.42,14310,64614.42
350540,201807,370,191,179,182214,170479.8,352693.8
350550,201807,2772,1645,1127,1562036.58,1073668.47,2635705.05
350560,201807,650,451,199,430249.23,189488.25,619737.48
350570,201807,4153,1735,2418,1649052.18,2304265.2,3953317.38
350580,201807,376,182,194,172675,185062.46,357737.46
350590,201807,896,492,404,468796,384462,853258
350600,201807,6225,3130,3095,2969982.3,2947598.38,5917580.68
350610,201807,1559,790,769,748948.36,733617,1482565.36
350620,201807,35,23,12,21942,11448,33390
350630,201807,242,137,105,129744.96,99217,228961.96
350635,201807,903,366,537,348878,511726,860604
350640,201807,120,87,33,82998,31482,114480
350650,201807,1893,1242,651,1180128.31,619609.53,1799737.84
350660,201807,748,336,412,319900.05,393044,712944.05
350670,201807,322,168,154,159843.2,146916,306759.2
350680,201807,177,95,82,90630,78228,168858
350690,201807,202,104,98,99216,93492,192708
350700,201807,727,357,370,337243.94,352980,690223.94
350710,201807,341,136,205,128535.56,195570,324105.56
350715,201807,53,44,9,41976,8586,50562
350720,201807,17,11,6,10494,5724,16218
350730,201807,41,26,15,24804,14310,39114
350740,201807,214,118,96,112276.26,91584,203860.26
350745,201807,18,8,10,7608,9540,17148
350750,201807,2159,1381,778,1309186.74,741575.96,2050762.70
350760,201807,3760,1629,2131,1551729.86,2028894.22,3580624.08
350770,201807,60,40,20,38160,19080,57240
350775,201807,49,36,13,34344,12393,46737
350780,201807,427,212,215,202248,205093,407341
350790,201807,359,154,205,146916,195570,342486
350800,201807,443,251,192,239454,183168,422622
350810,201807,522,422,100,401635,95400,497035
350820,201807,86,52,34,49608,32436,82044
350830,201807,82,46,36,43884,34344,78228
350840,201807,765,330,435,314581.5,413454.8,728036.3
350850,201807,1793,1045,748,991685.84,713551.46,1705237.30
350860,201807,603,354,249,333883.8,237546,571429.8
350870,201807,439,298,141,284292,134227.8,418519.8
350880,201807,288,157,131,147156.6,124306.2,271462.8
350890,201807,41,26,15,24804,14310,39114
350900,201807,1465,475,990,451683.93,943696.8,1395380.73
350910,201807,26,16,10,15264,9540,24804
350920,201807,603,334,269,318318.04,256626,574944.04
350925,201807,1205,643,562,610380.34,534431.4,1144811.74
350930,201807,97,57,40,54378,38160,92538
350940,201807,724,408,316,387991.8,299623.6,687615.4
350945,201807,104,76,28,71968,26712,98680
350950,201807,15646,7480,8166,7108271.23,7782837.97,14891109.20
350960,201807,1279,594,685,562757.96,653486,1216243.96
350970,201807,1112,594,518,562828.46,493876.46,1056704.92
350980,201807,93,64,29,61056,27666,88722
350990,201807,363,129,234,122112.72,223236,345348.72
350995,201807,32,17,15,16218,14310,30528
351000,201807,636,446,190,423260.07,181260,604520.07
351010,201807,47,28,19,26712,18126,44838
351015,201807,54,38,16,36252,15264,51516
351020,201807,1648,959,689,913462.45,655112,1568574.45
351030,201807,332,231,101,217798.2,96354,314152.2
351040,201807,850,452,398,431208,378738.66,809946.66
351050,201807,3328,1558,1770,1478047.01,1687918.3,3165965.31
351060,201807,5068,2082,2986,1974594.74,2845609.89,4820204.63
351070,201807,416,266,150,251543.92,143100,394643.92
351080,201807,812,585,227,558090,215545.95,773635.95
351090,201807,63,28,35,26712,33390,60102
351100,201807,455,264,191,249634.48,182209.23,431843.71
351110,201807,2107,1003,1104,952591.88,1050579.66,2003171.54
351120,201807,73,37,36,35298,34344,69642
351130,201807,175,60,115,57240,109423.8,166663.8
351140,201807,342,239,103,226765.84,98262,325027.84
351150,201807,409,212,197,201342.8,187938,389280.8
351160,201807,249,165,84,157410,80136,237546
351170,201807,190,101,89,96354,84143,180497
351190,201807,91,61,30,58194,28620,86814
351200,201807,372,245,127,233126.04,121158,354284.04
351210,201807,128,61,67,57939.38,63918,121857.38
351220,201807,537,324,213,305523.12,203202,508725.12
351230,201807,286,210,76,200340,72484.92,272824.92
351240,201807,231,97,134,92538,127836,220374
351250,201807,73,51,22,48430,20988,69418
351260,201807,154,111,43,105894,40736,146630
351270,201807,51,21,30,20034,28620,48654
351280,201807,1116,504,612,477956.46,583016.38,1060972.84
351290,201807,230,104,126,99216,119918,219134
351300,201807,3734,1745,1989,1658255.99,1897185,3555440.99
351310,201807,770,400,370,381600,352694,734294
351320,201807,110,68,42,64872,40068,104940
351330,201807,40,27,13,25758,12402,38160
351340,201807,1254,780,474,737850.93,450293.41,1188144.34
351350,201807,2546,1400,1146,1333073.2,1092706.83,2425780.03
351360,201807,793,393,400,373968,381282.04,755250.04
351370,201807,373,190,183,181255.23,173945.96,355201.19
351380,201807,8965,4092,4873,3887096.99,4638201.98,8525298.97
351385,201807,30,20,10,19080,9540,28620
351390,201807,284,211,73,200340.02,69642,269982.02
351400,201807,66,41,25,39114,23812.92,62926.92
351410,201807,453,281,172,266803.04,164088,430891.04
351420,201807,60,49,11,46746,10494,57240
351430,201807,72,39,33,37206,31482,68688
351440,201807,796,555,241,527241.76,229910,757151.76
351450,201807,256,128,128,122112,122112,244224
351460,201807,118,54,64,51516,61056,112572
351470,201807,139,73,66,68401.8,62964,131365.8
351480,201807,525,297,228,282098.96,217392.75,499491.71
351490,201807,288,107,181,102078,172674,274752
351492,201807,31,22,9,20988,8586,29574
351495,201807,28,19,9,18126,8586,26712
351500,201807,3547,1538,2009,1461652.29,1911960.41,3373612.70
351510,201807,1796,751,1045,716168,994726.26,1710894.26
351512,201807,21,18,3,17172,2862,20034
351515,201807,195,112,83,106848,79182,186030
351518,201807,785,488,297,464594,283338,747932
351519,201807,74,48,26,45792,24804,70596
351520,201807,141,87,54,82361.96,51516,133877.96
351530,201807,23,15,8,14310,7632,21942
351535,201807,134,77,57,73458,54378,127836
351540,201807,457,329,128,311483,122112,433595
351550,201807,1329,807,522,764887.92,496070.86,1260958.78
351560,201807,73,39,34,37206,32436,69642
351565,201807,11,7,4,6678,3816,10494
351570,201807,2560,1326,1234,1262680.35,1176565.65,2439246.00
351580,201807,39,35,4,33390,3816,37206
351590,201807,69,46,23,43884,21942,65826
351600,201807,194,147,47,140238,44838,185076
351610,201807,58,30,28,28620,26712,55332
351620,201807,5922,3396,2526,3230427.14,2407776.27,5638203.41
351630,201807,2552,1321,1231,1255205.59,1172151.23,2427356.82
351640,201807,1686,826,860,785885.19,816911.1,1602796.29
351650,201807,32,27,5,25758,4770,30528
351660,201807,156,102,54,96354,51516,147870
351670,201807,732,454,278,430780,265212,695992
351680,201807,71,58,13,55332,12402,67734
351685,201807,38,25,13,23850,12402,36252
351690,201807,313,220,93,208968.93,88722,297690.93
351700,201807,158,109,49,103986,46746,150732
351710,201807,76,53,23,50562,21942,72504
351720,201807,130,61,69,58194,65826,124020
351730,201807,99,69,30,64586.96,28615.23,93202.19
351740,201807,715,482,233,457665.96,222277.23,679943.19
351750,201807,364,153,211,145326,201294,346620
351760,201807,783,608,175,580271,166950,747221
351770,201807,293,248,45,236592,42930,279522
351780,201807,175,101,74,96345,70596,166941
351790,201807,240,126,114,120204,108756,228960
351800,201807,52,33,19,31482,18126,49608
351810,201807,127,85,42,81090,40068,121158
351820,201807,878,629,249,594344.6,237255.23,831599.83
351830,201807,517,185,332,175726.8,316728,492454.8
351840,201807,1890,963,927,909758,882856.94,1792614.94
351850,201807,234,173,61,164422.8,58194,222616.8
351860,201807,751,505,246,476048.84,234393.23,710442.07
351870,201807,5656,2677,2979,2541765.04,2834953.19,5376718.23
351880,201807,18904,8262,10642,7861002.37,10137540.68,17998543.05
351885,201807,90,61,29,57479,27666,85145
351890,201807,71,60,11,57240,10494,67734
351900,201807,231,137,94,130031,89676,219707
351905,201807,79,33,46,31482,43884,75366
351907,201807,3174,1387,1787,1320329.06,1702433.6,3022762.66
351910,201807,182,75,107,71550,102078,173628
351920,201807,133,75,58,71550,55309.69,126859.69
351925,201807,88,60,28,57240,26712,83952
351930,201807,381,256,125,244128.6,119250,363378.6
351940,201807,237,105,132,100170,125928,226098
351950,201807,142,82,60,78228,57240,135468
351960,201807,874,406,468,387142.73,444316.36,831459.09
351970,201807,1921,1034,887,984289.84,845617,1829906.84
351980,201807,149,75,74,69642,70596,140238
351990,201807,276,185,91,175536,86012.64,261548.64
352000,201807,361,222,139,211788,132606,344394
352010,201807,361,219,142,208926,134991,343917
352020,201807,203,68,135,64872,128790,193662
352030,201807,1035,529,506,503950.5,481133.96,985084.46
352040,201807,581,252,329,240408,313866,554274
352042,201807,281,97,184,92538,175536,268074
352044,201807,394,234,160,222081.86,152640,374721.86
352050,201807,3282,1317,1965,1249154.28,1873074.26,3122228.54
352060,201807,106,66,40,62964,37874,100838
352070,201807,103,75,28,70280,26712,96992
352080,201807,67,42,25,39114,23850,62964
352090,201807,172,116,56,110664,53424,164088
352100,201807,262,131,131,124684,123822,248506
352110,201807,112,32,80,30528,76320,106848
352115,201807,69,25,44,23850,41976,65826
352120,201807,95,65,30,60770,28620,89390
352130,201807,219,182,37,173628,35298,208926
352140,201807,182,75,107,71073,101792,172865
352150,201807,121,67,54,62964.04,51516,114480.04
352160,201807,130,84,46,80136,43884,124020
352170,201807,373,257,116,244224.04,110664,354888.04
352180,201807,616,415,201,394289.5,191750,586039.5
352190,201807,258,100,158,95390.46,150693.84,246084.30
352200,201807,32,17,15,16218,14310,30528
352210,201807,3842,1597,2245,1514960.87,2134525.19,3649486.06
352215,201807,55,30,25,28620,23392.08,52012.08
352220,201807,6984,2735,4249,2604119.44,4050759.19,6654878.63
352230,201807,3245,2060,1185,1951890.33,1125736.45,3077626.78
352240,201807,2241,1308,933,1245638.69,887785.08,2133423.77
352250,201807,2605,1347,1258,1280397.96,1196092.67,2476490.63
352260,201807,1066,582,484,553697.23,461450,1015147.23
352265,201807,59,26,33,24804,31482,56286
352270,201807,410,234,176,222282.92,167848,390130.92
352280,201807,412,260,152,246769,145003.23,391772.23
352290,201807,177,112,65,106848,62010,168858
352300,201807,101,76,25,72504,23850,96354
352310,201807,5777,2800,2977,2657995.07,2834698.54,5492693.61
352320,201807,948,495,453,468735.84,430111.1,898846.94
352330,201807,519,241,278,229580.1,264926,494506.1
352340,201807,1390,679,711,645591,675290.5,1320881.5
352350,201807,325,204,121,194616,115148,309764
352360,201807,230,99,131,93539.7,122377.52,215917.22
352370,201807,100,68,32,64872,30528,95400
352380,201807,123,74,49,70596,46746,117342
352390,201807,2459,1115,1344,1060447.82,1279774.56,2340222.38
352400,201807,481,207,274,196762.5,261109.8,457872.3
352410,201807,774,554,220,524676.88,209880,734556.88
352420,201807,107,70,37,66780,35298,102078
352430,201807,1763,786,977,744791.84,928821.5,1673613.34
352440,201807,3191,1619,1572,1534400.48,1497740.71,3032141.19
352450,201807,195,163,32,155502,30528,186030
352460,201807,580,293,287,278964.68,273083.2,552047.88
352470,201807,628,213,415,203202,395901,599103
352480,201807,1382,779,603,741893.96,574689.8,1316583.76
352490,201807,83,31,52,29574,49608,79182
352500,201807,1209,533,676,506956.6,644419,1151375.6
352510,201807,745,406,339,386370.96,323406,709776.96
352520,201807,555,248,307,236592,292734.9,529326.9
352530,201807,1719,911,808,869094,770450.6,1639544.6
352540,201807,74,48,26,45792,24804,70596
352550,201807,182,105,77,100170,72790.2,172960.2
352560,201807,50,40,10,38160,9540,47700
352570,201807,672,349,323,332629,308122.92,640751.92
352580,201807,58,39,19,36252.65,18126,54378.65
352585,201807,16,5,11,4770,10494,15264
352590,201807,4382,2230,2152,2120332.98,2052097.87,4172430.85
352600,201807,365,250,115,237546.96,109710,347256.96
352610,201807,941,428,513,406051.33,489259.29,895310.62
352620,201807,963,393,570,373968.2,543144,917112.2
352630,201807,170,66,104,62964,99206.46,162170.46
352640,201807,564,394,170,373292.02,162180,535472.02
352650,201807,90,60,30,57240,28620,85860
352660,201807,80,47,33,44838,31482,76320
352670,201807,1699,919,780,874195.89,743016.29,1617212.18
352680,201807,899,577,322,546940.36,305726.04,852666.40
352690,201807,4427,2034,2393,1932007.88,2279342.69,4211350.57
352700,201807,107,63,44,59815.8,41976,101791.8
352710,201807,1366,732,634,696133.8,601207.6,1297341.4
352720,201807,1347,648,699,615934.2,666269.03,1282203.23
352725,201807,25,23,2,21942,1908,23850
352730,201807,368,185,183,175311.81,174582,349893.81
352740,201807,426,271,155,256579.68,147870,404449.68
352750,201807,22,14,8,13069.8,7632,20701.8
352760,201807,199,144,55,137376,52470,189846
352770,201807,82,65,17,62010,16218,78228
352780,201807,80,44,36,41976,34344,76320
352790,201807,31,25,6,23850,5724,29574
352800,201807,249,173,76,165042,72217.8,237259.8
352810,201807,167,112,55,104337.42,52470,156807.42
352820,201807,66,51,15,48228.52,14310,62538.52
352830,201807,93,64,29,61056,27666,88722
352840,201807,616,319,297,303039.2,283338,586377.2
352850,201807,1379,492,887,468700.2,845561.96,1314262.16
352860,201807,133,89,44,84270,41976,126246
352870,201807,47,31,16,29574,15264,44838
352880,201807,191,129,62,123046.92,59148,182194.92
352885,201807,29,21,8,20034,7632,27666
352890,201807,57,39,18,37206,16886,54092
352900,201807,4855,2339,2516,2212382.63,2392718.74,4605101.37
352910,201807,39,32,7,30528,6678,37206
352920,201807,703,430,273,409266,260442,669708
352930,201807,1256,610,646,580507.82,613286.1,1193793.92
352940,201807,6397,2749,3648,2612135.36,3476462.44,6088597.80
352950,201807,96,39,57,37206,54378,91584
352960,201807,64,41,23,39114,21942,61056
352965,201807,19,8,11,7632,10494,18126
352970,201807,478,360,118,340232.97,111619,451851.97
352980,201807,177,95,82,90630,77942,168572
352990,201807,973,424,549,403513.38,522678.2,926191.58
353000,201807,68,32,36,30528,34344,64872
353010,201807,553,339,214,323406,204136.92,527542.92
353020,201807,284,207,77,197478,73458,270936
353030,201807,1226,558,668,530546.99,636585.66,1167132.65
353040,201807,90,55,35,52470,33390,85860
353050,201807,1345,859,486,813084.02,463357.8,1276441.82
353060,201807,7951,3608,4343,3426353.47,4136979.07,7563332.54
353070,201807,1659,1058,601,1003382.42,571893.56,1575275.98
353080,201807,1358,731,627,695037.55,597200,1292237.55
353090,201807,55,32,23,30528,21942,52470
353100,201807,60,49,11,46746,10494,57240
353110,201807,2056,624,1432,593564.88,1364159.26,1957724.14
353120,201807,82,44,38,41976,36252,78228
353130,201807,875,436,439,414818.35,418684.14,833502.49
353140,201807,574,228,346,217451,330084,547535
353150,201807,360,201,159,190800,151676.46,342476.46
353160,201807,101,82,19,78228,18126,96354
353170,201807,196,65,131,62010,124946.46,186956.46
353180,201807,962,444,518,421282.49,493648,914930.49
353190,201807,491,349,142,331890.9,135182,467072.9
353200,201807,197,100,97,95400,92538,187938
353205,201807,26,19,7,18126,6678,24804
353210,201807,85,51,34,48654,32436,81090
353215,201807,53,31,22,29574,20988,50562
353220,201807,85,48,37,45792,34344.27,80136.27
353230,201807,159,63,96,60102,91584,151686
353240,201807,303,166,137,158364,130698,289062
353250,201807,205,106,99,101124,94446,195570
353260,201807,468,335,133,318446.5,126872.46,445318.96
353270,201807,66,48,18,45792,16504.2,62296.2
353280,201807,94,49,45,46556,42930,89486
353282,201807,124,89,35,84906,33390,118296
353284,201807,25,20,5,19080,4770,23850
353286,201807,1,1,0,954,0,954
353290,201807,79,45,34,42930,32427,75357
353300,201807,411,229,182,216924.46,173628,390552.46
353310,201807,55,48,7,45792,6678,52470
353320,201807,62,38,24,36252,22896,59148
353325,201807,58,35,23,33381,21638,55019
353330,201807,67,50,17,47557,16218,63775
353340,201807,623,206,417,195841.89,397232.26,593074.15
353350,201807,908,429,479,408275.64,455995,864270.64
353360,201807,111,90,21,85542.04,19748,105290.04
353370,201807,121,67,54,63918,51516,115434
353380,201807,26,18,8,17168,7632,24800
353390,201807,1090,521,569,497034,542826,1039860
353400,201807,51,31,20,29574,19080,48654
353410,201807,112,70,42,66780,40021,106801
353420,201807,59,24,35,22896,33390,56286
353430,201807,569,375,194,354029.3,184626.8,538656.1
353440,201807,10331,4500,5831,4282017.91,5555965.57,9837983.48
353450,201807,55,31,24,29574,22896,52470
353460,201807,617,339,278,321190.83,264487.5,585678.33
353470,201807,2137,1164,973,1106508.62,925836.23,2032344.85
353475,201807,236,159,77,148996.96,73458,222454.96
353480,201807,190,154,36,146916,34344,181260
353490,201807,237,141,96,134514,91584,226098
353500,201807,192,112,80,105894.96,76320,182214.96
353510,201807,99,72,27,68669.46,25748.46,94417.92
353520,201807,203,137,66,130698,62964,193662
353530,201807,467,253,214,241362,204156,445518
353540,201807,366,242,124,230545.27,118296,348841.27
353550,201807,744,505,239,477956.88,228006,705962.88
353560,201807,635,270,365,256300.89,347609.52,603910.41
353570,201807,61,31,30,29574,28620,58194
353580,201807,359,278,81,264735,77274,342009
353590,201807,89,61,28,57876.04,26712,84588.04
353600,201807,269,152,117,144691,110982,255673
353610,201807,115,60,55,57240,52470,109710
353620,201807,584,314,270,298285,257293.8,555578.8
353625,201807,52,30,22,28620,20988,49608
353630,201807,237,170,67,157774.6,63918,221692.6
353640,201807,127,85,42,80613,40068,120681
353650,201807,890,345,545,327031.2,519930,846961.2
353657,201807,24,18,6,17172,5724,22896
353660,201807,253,142,111,135468,105894,241362
353670,201807,772,457,315,435024.2,300510,735534.2
353680,201807,102,73,29,69404,27666,97070
353690,201807,45,36,9,34070,8586,42656
353700,201807,278,197,81,187938,77274,265212
353710,201807,445,204,241,193662.8,229628,423290.8
353715,201807,46,33,13,31195.8,12402,43597.8
353720,201807,359,164,195,156438,186030,342468
353730,201807,1108,683,425,648479.38,405445.23,1053924.61
353740,201807,656,358,298,341245.8,284292,625537.8
353750,201807,89,55,34,51938.14,32436,84374.14
353760,201807,2780,1041,1739,991055.88,1655403.78,2646459.66
353770,201807,97,80,17,75843,16218,92061
353780,201807,1165,572,593,543971.96,564747,1108718.96
353790,201807,506,294,212,278407.5,199649.35,478056.85
353800,201807,3273,1675,1598,1589300.89,1522875.92,3112176.81
353810,201807,235,133,102,126028.71,97299,223327.71
353820,201807,185,88,97,83952,91913.41,175865.41
353830,201807,47,40,7,38160,6678,44838
353850,201807,169,86,83,82044,79182,161226
353860,201807,472,217,255,206302.5,242983.8,449286.3
353870,201807,5131,2579,2552,2442825.93,2423542.39,4866368.32
353880,201807,683,489,194,465170.4,184122.12,649292.52
353890,201807,589,332,257,316156,244892,561048
353900,201807,129,64,65,61056,62010,123066
353910,201807,175,86,89,82044,84906,166950
353920,201807,450,245,205,232538.4,195127.16,427665.56
353930,201807,1024,603,421,573569.79,400938.8,974508.59
353940,201807,185,99,86,93682.8,81186,174868.8
353950,201807,529,323,206,307156.8,196515,503671.8
353960,201807,69,56,13,53424,12402,65826
353970,201807,74,43,31,41022,29574,70596
353980,201807,1539,755,784,717896.95,747001.76,1464898.71
353990,201807,73,42,31,40068,29574,69642
354000,201807,369,183,186,173915,177249.2,351164.2
354010,201807,93,52,41,49608,38637,88245
354020,201807,544,344,200,327222,190800,518022
354025,201807,53,42,11,40068,10494,50562
354030,201807,64,36,28,34344,26712,61056
354040,201807,97,68,29,64490.4,27666,92156.4
354050,201807,192,105,87,99884,82998,182882
354060,201807,767,370,397,352980,376497.4,729477.4
354070,201807,879,517,362,491688.03,345348,837036.03
354075,201807,219,117,102,111332,96354.8,207686.8
354080,201807,290,125,165,118963.8,157410,276373.8
354085,201807,19,12,7,11448,6678,18126
354090,201807,315,176,139,167823,132606,300429
354100,201807,5635,2352,3283,2233213.56,3126444.25,5359657.81
354105,201807,85,41,44,39114,41976,81090
354110,201807,50,23,27,21942,25758,47700
354120,201807,144,101,43,96345,41022,137367
354130,201807,700,465,235,443372,223900,667272
354140,201807,3152,1481,1671,1410051.43,1592598.83,3002650.26
354150,201807,661,413,248,391789.04,235161,626950.04
354160,201807,722,457,265,434785.5,252524,687309.5
354165,201807,23,14,9,13356,8586,21942
354170,201807,179,120,59,113812.2,56286,170098.2
354180,201807,68,42,26,39742,24804,64546
354190,201807,211,98,113,91870.2,107802,199672.2
354200,201807,130,72,58,68211,55332,123543
354210,201807,67,34,33,32436,31482,63918
354220,201807,636,391,245,372346.2,232490.35,604836.55
354230,201807,163,68,95,64872,89676.6,154548.6
354240,201807,316,205,111,194616.49,105894,300510.49
354250,201807,93,56,37,53424,35298,88722
354260,201807,1974,921,1053,868273.04,1001770.67,1870043.71
354270,201807,94,71,23,67734,21942,89676
354280,201807,40,22,18,20988,17172,38160
354290,201807,141,99,42,93635.1,40068,133703.1
354300,201807,420,286,134,272527,127678,400205
354310,201807,102,76,26,71550.2,24804,96354.2
354320,201807,179,97,82,92538,78228,170766
354323,201807,16,14,2,13356,1908,15264
354325,201807,109,63,46,59296,43884,103180
354330,201807,2644,880,1764,834885.26,1680976.18,2515861.44
354340,201807,10615,5203,5412,4951987.83,5155653.67,10107641.50
354350,201807,125,82,43,78228,40878.9,119106.9
354360,201807,88,49,39,46746,37206,83952
354370,201807,266,148,118,141192,112572,253764
354380,201807,212,126,86,119418,82044,201462
354390,201807,2790,1014,1776,965695.22,1693504.98,2659200.20
354400,201807,331,175,156,166283,148538,314821
354410,201807,620,296,324,280758.43,308810,589568.43
354420,201807,275,173,102,165042,97308,262350
354425,201807,316,184,132,175536,125928,301464
354430,201807,191,120,71,112905.9,66970.8,179876.7
354440,201807,40,28,12,26712,11448,38160
354450,201807,50,36,14,34344,13356,47700
354460,201807,104,60,44,57240,41976,99216
354470,201807,41,28,13,26712,12402,39114
354480,201807,118,60,58,57231,55322.46,112553.46
354490,201807,144,90,54,85700.97,51516,137216.97
354500,201807,394,196,198,186984,188892,375876
354510,201807,104,72,32,68688,30528,99216
354515,201807,39,14,25,13356,23850,37206
354520,201807,1647,723,924,688175.2,881057.56,1569232.76
354530,201807,675,354,321,335994.8,305376.2,641371.0
354540,201807,282,159,123,151686,117337.23,269023.23
354550,201807,40,23,17,21942,16218,38160
354560,201807,158,90,68,85574,64862.46,150436.46
354570,201807,136,87,49,82998,46746,129744
354580,201807,1981,938,1043,892275,994436.26,1886711.26
354600,201807,268,148,120,138978.92,114465.69,253444.61
354610,201807,74,65,9,61056.58,8577,69633.58
354620,201807,62,19,43,18126,41022,59148
354625,201807,18,11,7,10494,6674,17168
354630,201807,321,213,108,202827.34,103032,305859.34
354640,201807,808,525,283,496924.36,269982,766906.36
354650,201807,74,43,31,40753.02,29545.92,70298.94
354660,201807,809,597,212,565274.55,202248,767522.55
354670,201807,277,98,179,92300,169813,262113
354680,201807,1271,485,786,462690,749367,1212057
354690,201807,84,55,29,51517,27666,79183
354700,201807,78,56,22,53424,20988,74412
354710,201807,57,39,18,36569.96,17172,53741.96
354720,201807,20,19,1,18126,954,19080
354730,201807,1868,790,1078,750742.2,1028221.2,1778963.4
354740,201807,60,42,18,40068,17172,57240
354750,201807,433,256,177,244215,168858,413073
354760,201807,513,313,200,296041,190514,486555
354765,201807,12,5,7,4770,6678,11448
354770,201807,342,228,114,217512,107992.8,325504.8
354780,201807,8166,3333,4833,3167397.65,4606822.1,7774219.75
354790,201807,113,66,47,62964,44838,107802
354800,201807,442,243,199,231822,189540.92,421362.92
354805,201807,104,52,52,48972,49608,98580
354810,201807,135,77,58,73458,55332,128790
354820,201807,186,79,107,75157,102078,177235
354830,201807,42,23,19,21942,18126,40068
354840,201807,58,39,19,37206,18126,55332
354850,201807,4598,2045,2553,1943672.16,2431476.08,4375148.24
354860,201807,326,160,166,152640,156256.52,308896.52
354870,201807,12074,5469,6605,5190233.81,6291309.08,11481542.89
354880,201807,3048,1145,1903,1090692.46,1814168.8,2904861.26
354890,201807,2898,1610,1288,1529183.46,1227769.38,2756952.84
354900,201807,59,38,21,36252,20034,56286
354910,201807,1233,650,583,616532.24,556182,1172714.24
354920,201807,49,41,8,39114,7632,46746
354925,201807,13,7,6,6678,5724,12402
354930,201807,31,28,3,26442,2862,29304
354940,201807,820,601,219,570685.69,208926,779611.69
354950,201807,218,147,71,139571,67734,207305
354960,201807,164,64,100,61056,95114,156170
354970,201807,877,572,305,540829.1,290331.02,831160.12
354980,201807,8491,3141,5350,2988811.35,5101180.79,8089992.14
354990,201807,9166,4352,4814,4137313.15,4586101.5,8723414.65
354995,201807,520,181,339,172674,323091.18,495765.18
355000,201807,488,164,324,156451.23,308857.5,465308.73
355010,201807,619,390,229,372060,216254.48,588314.48
355020,201807,717,454,263,432157.59,250894,683051.59
355030,201807,206408,80133,126275,76217253.24,120367961.17,196585214.41
355040,201807,729,342,387,324217.6,369007.2,693224.8
355050,201807,154,102,52,96037.77,49608,145645.77
355060,201807,1571,781,790,740224.94,752468.3,1492693.24
355070,201807,1448,708,740,672562.16,704967,1377529.16
355080,201807,202,116,86,110664,81156.8,191820.8
355090,201807,300,199,101,187748,96354,284102
355100,201807,4900,2399,2501,2268181.3,2383826.66,4652007.96
355110,201807,272,173,99,164085,94446,258531
355120,201807,81,58,23,55332,21942,77274
355130,201807,54,30,24,28620,22896,51516
355140,201807,183,122,61,115672.5,58194,173866.5
355150,201807,689,414,275,393712,261873,655585
355160,201807,466,223,243,210357.96,231822,442179.96
355170,201807,2075,1080,995,1029054.94,947334.72,1976389.66
355180,201807,626,268,358,254718,340697.25,595415.25
355190,201807,222,151,71,144054,67734,211788
355200,201807,120,69,51,65826,48654,114480
355210,201807,719,407,312,388278,297629.46,685907.46
355220,201807,6796,3633,3163,3455395.66,3008957.2,6464352.86
355230,201807,107,63,44,60102,41971.23,102073.23
355240,201807,4393,1900,2493,1800347.12,2374184.11,4174531.23
355250,201807,5439,2608,2831,2482217.22,2697360.79,5179578.01
355255,201807,50,31,19,29574,18126,47700
355260,201807,187,113,74,106829.12,70568.46,177397.58
355270,201807,167,99,68,94446,64157,158603
355280,201807,6440,2684,3756,2555047.66,3578236.46,6133284.12
355290,201807,76,57,19,54378,18126,72504
355300,201807,186,121,65,114480.8,61724,176204.8
355310,201807,108,60,48,57240,45792,103032
355320,201807,91,48,43,45792,40074.6,85866.6
355330,201807,273,153,120,145962,114480,260442
355340,201807,1574,538,1036,510645.61,987315.97,1497961.58
355350,201807,140,72,68,68688,64872,133560
355360,201807,181,115,66,109500.12,62964,172464.12
355365,201807,25,20,5,19080,4770,23850
355370,201807,1057,610,447,576063.74,425161.01,1001224.75
355380,201807,785,521,264,496442.52,251677,748119.52
355385,201807,66,47,19,44838,18126,62964
355390,201807,105,62,43,59148,41022,100170
355395,201807,184,112,72,105747.23,68688,174435.23
355400,201807,1568,968,600,920427.32,570873.8,1491301.12
355410,201807,4930,2338,2592,2212997.56,2463845.2,4676842.76
355420,201807,51,38,13,36252,12402,48654
355430,201807,347,211,136,199958.4,129744,329702.4
355440,201807,85,51,34,48654,32436,81090
355450,201807,459,226,233,213172.14,221244.65,434416.79
355460,201807,70,54,16,50562.42,15264,65826.42
355465,201807,52,33,19,31482,18126,49608
355470,201807,181,73,108,68688.1,103032,171720.1
355475,201807,13,8,5,7632,4770,12402
355480,201807,469,209,260,197488.34,247372.2,444860.54
355490,201807,116,82,34,78228,32436,110664
355495,201807,53,26,27,24804,25758,50562
355500,201807,1653,929,724,880686.66,690661.46,1571348.12
355510,201807,273,198,75,184412.63,71550,255962.63
355520,201807,31,24,7,22610,6678,29288
355530,201807,24,16,8,15264,7632,22896
355535,201807,80,39,41,37206,39114,76320
355540,201807,2383,941,1442,896255.53,1373751.96,2270007.49
355550,201807,66,40,26,38160,24804,62964
355560,201807,240,120,120,114480,113844,228324
355570,201807,30,20,10,19080,9540,28620
355580,201807,266,183,83,174582,78891.23,253473.23
355590,201807,24,15,9,14310,8586,22896
355600,201807,267,137,130,130698,123729.23,254427.23
355610,201807,220,146,74,139284,70596,209880
355620,201807,1296,604,692,575643.8,659658.38,1235302.18
355630,201807,417,303,114,289062,107802.96,396864.96
355635,201807,123,59,64,56286,61043,117329
355640,201807,578,333,245,316728.16,233730,550458.16
355645,201807,834,358,476,340053.3,452224.82,792278.12
355650,201807,2148,898,1250,852469.6,1192481.46,2044951.06
355660,201807,256,138,118,131652,112572,244224
355670,201807,502,194,308,185076,293545.8,478621.8
355680,201807,206,118,88,111619,83952,195571
355690,201807,87,40,47,38160,44494,82654
355695,201807,13,10,3,9540,2862,12402
355700,201807,1137,585,552,552667.62,526036,1078703.62
355710,201807,2222,1216,1006,1156427.56,959533.2,2115960.76
355715,201807,20,18,2,17172,1908,19080
355720,201807,207,125,82,117660.08,78228,195888.08
355730,201807,94,53,41,49687.95,39114,88801.95
410010,201807,132,112,20,106848,19080,125928
410020,201807,106,93,13,88722,12402,101124
410030,201807,163,104,59,98548.4,56286,154834.4
410040,201807,980,537,443,511391.7,422432,933823.7
410045,201807,27,22,5,20988,4770,25758
410050,201807,481,269,212,256626,201580.2,458206.2
410060,201807,276,211,65,201294,62010,263304
410070,201807,310,257,53,245178,50562,295740
410080,201807,165,107,58,102078,55332,157410
410090,201807,74,65,9,61801,8586,70387
410100,201807,299,215,84,204795.18,79325.1,284120.28
410105,201807,48,29,19,27666,18126,45792
410110,201807,315,191,124,182214,118296,300510
410115,201807,29,20,9,19080,8586,27666
410120,201807,438,225,213,214363.8,203202,417565.8
410130,201807,46,29,17,27666,16218,43884
410140,201807,3117,1528,1589,1452143,1512281.6,2964424.6
410150,201807,2725,1101,1624,1048915.24,1548699.8,2597615.04
410160,201807,496,314,182,299269.8,173628,472897.8
410165,201807,64,42,22,40068,20988,61056
410170,201807,167,124,43,116871,41022,157893
410180,201807,2143,1246,897,1184695.19,854487.95,2039183.14
410185,201807,34,30,4,28620,3816,32436
410190,201807,450,283,167,269982,159318,429300
410200,201807,952,713,239,679257.54,228006,907263.54
410210,201807,559,293,266,279522,253478,533000
410220,201807,41,22,19,20988,18126,39114
410230,201807,130,70,60,66780,57240,124020
410240,201807,731,481,250,458301.8,238500,696801.8
410250,201807,371,274,97,260791.84,92533.23,353325.07
410260,201807,300,179,121,170480,115434,285914
410270,201807,30,19,11,18126,10494,28620
410275,201807,63,46,17,43884,16218,60102
410280,201807,324,187,137,178138.52,130698,308836.52
410290,201807,231,146,85,139284,81090,220374
410300,201807,81,65,16,62010,15264,77274
410302,201807,24,16,8,15264,7632,22896
410304,201807,46,32,14,30528,13356,43884
410305,201807,213,117,96,110950.2,91584,202534.2
410310,201807,263,168,95,160272,90610.92,250882.92
410315,201807,50,36,14,34320,13356,47676
410320,201807,140,98,42,93492,40068,133560
410322,201807,33,24,9,22896,8586,31482
410330,201807,169,120,49,114480,46556,161036
410335,201807,99,60,39,57240,37206,94446
410337,201807,40,35,5,33390,4770,38160
410340,201807,31,29,2,27666,1908,29574
410345,201807,221,140,81,133560,77274,210834
410347,201807,53,40,13,38160,12402,50562
410350,201807,230,139,91,132606,86814,219420
410360,201807,460,281,179,265530.4,170194,435724.4
410370,201807,2409,1036,1373,984749.32,1307062.82,2291812.14
410380,201807,216,140,76,133560,72504,206064
410390,201807,369,273,96,260438,91584,352022
410395,201807,34,22,12,20988,10781,31769
410400,201807,842,424,418,403167.2,397422.1,800589.3
410405,201807,93,71,22,67734,20988,88722
410410,201807,40,31,9,29574,8586,38160
410420,201807,1656,818,838,778177.89,798499,1576676.89
410425,201807,178,83,95,78992,90630,169622
410430,201807,2189,1290,899,1227259,856768.32,2084027.32
410440,201807,388,289,99,274753,94446,369199
410442,201807,355,239,116,227053,110664,337717
410445,201807,415,290,125,276660,119250,395910
410450,201807,407,209,198,199386,188892,388278
410460,201807,417,226,191,215308.26,182214,397522.26
410465,201807,191,121,70,114193.8,66780,180973.8
410470,201807,228,146,82,139284,78228,217512
410480,201807,5918,2922,2996,2767396.81,2853055.76,5620452.57
410490,201807,1407,927,480,882861,456013,1338874
410500,201807,269,153,116,145962,110664,256626
410510,201807,177,129,48,123066,45783,168849
410520,201807,251,188,63,179352,60102,239454
410530,201807,238,87,151,82998,144050,227048
410540,201807,315,227,88,215739.97,83947.23,299687.20
410550,201807,1606,694,912,661789.8,868848.36,1530638.16
410560,201807,143,112,31,106848,29574,136422
410570,201807,429,299,130,283158.2,124020,407178.2
410580,201807,3155,1427,1728,1359456.8,1648036,3007492.8
410590,201807,405,285,120,271890,114480,386370
410600,201807,187,160,27,152640,25758,178398
410610,201807,56,45,11,42930,10494,53424
410620,201807,239,173,66,165042,62964,228006
410630,201807,444,258,186,246132,177444,423576
410640,201807,991,620,371,587663.27,352327.28,939990.55
410645,201807,100,74,26,70215,24804,95019
410650,201807,365,248,117,235638,111618,347256
410655,201807,78,60,18,57240,17172,74412
410657,201807,43,18,25,17172,23850,41022
410660,201807,602,427,175,405829,166950,572779
410670,201807,75,63,12,60102,11448,71550
410680,201807,193,161,32,152926.2,30528,183454.2
410685,201807,14,9,5,8586,4770,13356
410690,201807,28163,12269,15894,11682776.08,15149181.77,26831957.85
410700,201807,324,239,85,227720,81090,308810
410710,201807,124,101,23,96354,21942,118296
410712,201807,21,14,7,13356,6678,20034
410715,201807,86,64,22,61056,20988,82044
410720,201807,605,361,244,344394,232767,577161
410725,201807,181,130,51,124020,48654,172674
410730,201807,83,51,32,48654,30528,79182
410740,201807,112,81,31,77274,29574,106848
410750,201807,216,160,56,152640,53419.23,206059.23
410752,201807,24,14,10,13356,9540,22896
410753,201807,53,23,30,21269.43,28620,49889.43
410754,201807,39,23,16,21561,15264,36825
410755,201807,80,55,25,52470,23850,76320
410760,201807,730,414,316,394645.56,301464,696109.56
410765,201807,1660,799,861,756272.8,820240.26,1576513.06
410770,201807,107,86,21,82044,20034,102078
410773,201807,48,35,13,33390,12402,45792
410775,201807,177,134,43,127168.2,41022,168190.2
410780,201807,78,42,36,40068,34344,74412
410785,201807,52,42,10,40068,9540,49608
410790,201807,73,35,38,33390,36252,69642
410800,201807,293,185,108,175537,103032,278569
410810,201807,25,21,4,20034,3530,23564
410820,201807,179,131,48,124831,45792,170623
410830,201807,8474,3842,4632,3655678.06,4415991.54,8071669.60
410832,201807,103,70,33,66780,31482,98262
410840,201807,1436,801,635,761886.08,604490.98,1366377.06
410845,201807,65,41,24,38828,22896,61724
410850,201807,194,135,59,128504,56286,184790
410855,201807,51,44,7,41976,6678,48654
410860,201807,672,395,277,375876.76,264258,640134.76
410865,201807,103,81,22,77274,20988,98262
410870,201807,161,135,26,128790,24804,153594
410880,201807,1122,565,557,538499.62,531314,1069813.62
410890,201807,79,54,25,51516,23850,75366
410895,201807,73,56,17,53424,16218,69642
410900,201807,20,12,8,11448,7632,19080
410910,201807,17,15,2,14310,1908,16218
410920,201807,32,22,10,20988,9540,30528
410930,201807,510,327,183,311746.98,174582,486328.98
410940,201807,4303,2547,1756,2420229.4,1671960.4,4092189.8
410950,201807,114,85,29,81090,27666,108756
410960,201807,773,349,424,332660,404306,736966
410965,201807,66,51,15,48367.8,14310,62677.8
410970,201807,629,453,176,431694.2,167904,599598.2
410975,201807,110,64,46,60545,43884,104429
410980,201807,1590,715,875,679563.82,833792,1513355.82
410990,201807,267,180,87,171720,82711.8,254431.8
411000,201807,63,39,24,37206,22896,60102
411005,201807,25,20,5,19080,4770,23850
411007,201807,244,142,102,135468,97308,232776
411010,201807,578,403,175,384462,166950,551412
411020,201807,292,201,91,191754,86814,278568
411030,201807,19,9,10,8586,9540,18126
411040,201807,51,36,15,34344,14310,48654
411050,201807,218,170,48,161565.72,45665.12,207230.84
411060,201807,512,345,167,329121,159318,488439
411065,201807,64,56,8,53424,7632,61056
411070,201807,1204,796,408,753524.31,388278,1141802.31
411080,201807,242,174,68,165996,64872,230868
411090,201807,115,87,28,82998,26712,109710
411095,201807,269,111,158,105417,150722,256139
411100,201807,114,95,19,90630,18126,108756
411110,201807,121,85,36,81090,34344,115434
411120,201807,184,135,49,128790,46746,175536
411125,201807,182,82,100,77579.28,95400,172979.28
411130,201807,127,108,19,102394,17919.37,120313.37
411140,201807,190,130,60,123998.12,56715.3,180713.42
411150,201807,1229,814,415,775878.66,395910,1171788.66
411155,201807,122,84,38,80136,36252,116388
411160,201807,20,9,11,8586,10494,19080
411170,201807,55,50,5,47413.8,4770,52183.8
411180,201807,961,639,322,608366,307183.23,915549.23
411190,201807,340,196,144,186316.2,137376,323692.2
411200,201807,676,441,235,419443.89,223046.3,642490.19
411210,201807,683,373,310,354292.21,295740,650032.21
411220,201807,145,109,36,103986,34344,138330
411230,201807,41,37,4,35298,3816,39114
411240,201807,124,85,39,81090,37206,118296
411250,201807,426,313,113,298602,107802,406404
411260,201807,21,14,7,13356,6678,20034
411270,201807,296,158,138,150732,131652,282384
411275,201807,205,180,25,171004.6,23850,194854.6
411280,201807,226,159,67,151369,63918,215287
411290,201807,58,43,15,41022,14310,55332
411295,201807,146,114,32,108756,30528,139284
411300,201807,69,35,34,33390,32436,65826
411310,201807,89,68,21,64872,20034,84906
411320,201807,753,544,209,517164.2,197783.28,714947.48
411325,201807,42,26,16,24804,15264,40068
411330,201807,921,596,325,566581.61,309319.6,875901.21
411340,201807,26,17,9,16218,8272,24490
411342,201807,72,54,18,51516,17172,68688
411345,201807,125,63,62,60102,59148,119250
411350,201807,488,388,100,368673.64,95105,463778.64
411360,201807,55,35,20,33390,19080,52470
411370,201807,14256,5832,8424,5542369.45,8022445.85,13564815.30
411373,201807,186,138,48,131652,45792,177444
411375,201807,71,59,12,56286,11448,67734
411380,201807,94,70,24,66780,22896,89676
411390,201807,134,89,45,84906,42930,127836
411400,201807,355,266,89,253755,84906,338661
411410,201807,443,231,212,219706.2,201962,421668.2
411420,201807,1024,472,552,447712.2,526131.2,973843.4
411430,201807,417,267,150,254050.2,143091,397141.2
411435,201807,36,25,11,23850,10494,34344
411440,201807,477,384,93,364644.99,88722,453366.99
411450,201807,427,355,72,338670,68688,407358
411460,201807,762,301,461,286306.08,438345.6,724651.68
411470,201807,85,63,22,60102,20988,81090
411480,201807,641,364,277,344776.4,263971.8,608748.2
411490,201807,294,184,110,175536,104940,280476
411500,201807,112,94,18,89472.33,16505,105977.33
411510,201807,217,176,41,167156.06,39114,206270.06
411520,201807,5923,2309,3614,2198964.8,3440857.76,5639822.56
411530,201807,115,80,35,76320,33390,109710
411535,201807,48,19,29,18126,27666,45792
411540,201807,354,246,108,233661.9,103032,336693.9
411545,201807,55,39,16,37206,15264,52470
411550,201807,74,56,18,53424,17172,70596
411560,201807,388,177,211,168194.38,201294,369488.38
411570,201807,777,298,479,283997,456766.46,740763.46
411573,201807,34,21,13,20034,12402,32436
411575,201807,266,166,100,158364,95400,253764
411580,201807,1253,499,754,473785.84,717468.4,1191254.24
411585,201807,79,40,39,38160,37206,75366
411590,201807,25,18,7,17172,6678,23850
411600,201807,28,12,16,11448,15264,26712
411605,201807,250,108,142,103006,135468,238474
411610,201807,236,160,76,152640,72504,225144
411620,201807,362,205,157,195093,149139,344232
411630,201807,57,40,17,38160,16218,54378
411640,201807,34,28,6,26712,5724,32436
411650,201807,13,8,5,7632,4770,12402
411660,201807,32,25,7,23850,6678,30528
411670,201807,245,185,60,176490,57240,233730
411680,201807,153,132,21,125928,20034,145962
411690,201807,596,315,281,299932.44,267728.32,567660.76
411695,201807,62,46,16,43884,15264,59148
411700,201807,162,140,22,133560,20988,154548
411705,201807,103,67,36,63918,34344,98262
411710,201807,303,204,99,193549.81,94446,287995.81
411720,201807,140,91,49,86814,46746,133560
411721,201807,66,55,11,52470,10494,62964
411722,201807,98,42,56,40068,53424,93492
411725,201807,149,116,33,110091.8,31482,141573.8
411727,201807,73,57,16,54378,14977.8,69355.8
411729,201807,32,26,6,24804,5724,30528
411730,201807,547,354,193,336125.96,183835.8,519961.76
411740,201807,37,23,14,21942,13356,35298
411745,201807,69,46,23,43093,21942,65035
411750,201807,869,413,456,392905.9,434055.69,826961.59
411760,201807,1202,908,294,864983.2,280467,1145450.2
411770,201807,446,299,147,285226.92,140238,425464.92
411780,201807,374,240,134,228960,127836,356796
411790,201807,538,302,236,286226.47,224840.34,511066.81
411800,201807,169,133,36,126882,34344,161226
411810,201807,166,126,40,120204,38160,158364
411820,201807,2085,1021,1064,971439.42,1014332.3,1985771.72
411830,201807,12,12,0,11448,0,11448
411840,201807,1956,1219,737,1160731.8,702605,1863336.8
411845,201807,51,20,31,19080,29574,48654
411850,201807,1238,704,534,670048.4,507482.48,1177530.88
411860,201807,45,29,16,27380,15264,42644
411870,201807,75,55,20,52470,18793.8,71263.8
411880,201807,425,271,154,258420,146171.88,404591.88
411885,201807,106,70,36,66780,34344,101124
411890,201807,321,204,117,192422.99,111608.46,304031.45
411900,201807,70,51,19,48654,18126,66780
411910,201807,178,141,37,134504.46,34458.48,168962.94
411915,201807,2108,910,1198,867273.77,1141590.05,2008863.82
411920,201807,127,105,22,100170,20988,121158
411925,201807,14,9,5,8586,4770,13356
411930,201807,800,587,213,558092,203202,761294
411940,201807,589,417,172,397341,164063.56,561404.56
411950,201807,898,479,419,456298.2,399058.2,855356.4
411960,201807,987,693,294,658267.69,280476,938743.69
411965,201807,25,17,8,16218,7632,23850
411970,201807,73,65,8,62010,7632,69642
411980,201807,201,128,73,121825.8,69642,191467.8
411990,201807,5057,2945,2112,2792569.35,2013127.41,4805696.76
411995,201807,457,172,285,164088,271890,435978
412000,201807,304,182,122,172747.2,116378.46,289125.66
412010,201807,51,29,22,27666,20988,48654
412015,201807,46,32,14,30528,13356,43884
412020,201807,27,23,4,21655.8,3816,25471.8
412030,201807,59,50,9,47700,8586,56286
412033,201807,54,36,18,34320,17172,51492
412035,201807,70,44,26,41976,24804,66780
412040,201807,37,26,11,24518,10494,35012
412050,201807,200,150,50,143100,47700,190800
412060,201807,754,585,169,555228.74,160235.8,715464.54
412065,201807,50,34,16,32436,15264,47700
412070,201807,160,108,52,102364.2,49608,151972.2
412080,201807,281,149,132,142146,125928,268074
412085,201807,32,16,16,15264,15264,30528
412090,201807,755,480,275,456251.2,262350,718601.2
412100,201807,248,208,40,197479,38160,235639
412110,201807,70,56,14,53424,13356,66780
412120,201807,309,205,104,194997.6,99216,294213.6
412125,201807,80,47,33,44551.8,31482,76033.8
412130,201807,45,33,12,30891,11448,42339
412135,201807,29,17,12,16218,11448,27666
412140,201807,319,226,93,214964.82,88722,303686.82
412150,201807,256,178,78,168858.04,74412,243270.04
412160,201807,85,51,34,48654,32436,81090
412170,201807,665,465,200,443323.8,190800,634123.8
412175,201807,38,28,10,26712,9540,36252
412180,201807,195,155,40,147270.61,37539.9,184810.51
412190,201807,336,267,69,254045.43,65826,319871.43
412200,201807,197,124,73,118296,69642,187938
412210,201807,75,58,17,55332,16218,71550
412215,201807,238,164,74,156456,70309.8,226765.8
412217,201807,72,56,16,53424,15264,68688
412220,201807,824,616,208,587664,198432,786096
412230,201807,336,204,132,192994.2,125891.46,318885.66
412240,201807,1334,652,682,618326.66,648452.04,1266778.70
412250,201807,383,246,137,234684,130698,365382
412260,201807,127,93,34,88722,32436,121158
412265,201807,171,135,36,128185.84,34344,162529.84
412270,201807,84,53,31,50562,29574,80136
412280,201807,92,73,19,69642,18126,87768
412290,201807,97,64,33,61056,31482,92538
412300,201807,213,138,75,131652,71406.9,203058.9
412310,201807,43,38,5,36252,4770,41022
412320,201807,93,79,14,75366,13356,88722
412330,201807,173,152,21,145008,20034,165042
412340,201807,148,103,45,98262,42644,140906
412350,201807,612,310,302,294738.3,288108,582846.3
412360,201807,29,25,4,23850,3816,27666
412370,201807,157,137,20,129104,19080,148184
412380,201807,261,194,67,184789.8,63814,248603.8
412382,201807,52,28,24,26712,22896,49608
412385,201807,143,103,40,98262,38160,136422
412390,201807,282,215,67,205110,63918,269028
412395,201807,69,54,15,51516,14310,65826
412400,201807,76,54,22,51516,20988,72504
412402,201807,254,121,133,115429.23,126595.8,242025.03
412405,201807,814,326,488,308568.52,464866.66,773435.18
412410,201807,947,594,353,563814.6,336762,900576.6
412420,201807,14,12,2,11448,1908,13356
412430,201807,21,15,6,14310,5724,20034
412440,201807,602,330,272,312507.5,257647.08,570154.58
412450,201807,80,68,12,64872,11448,76320
412460,201807,81,62,19,59148,18126,77274
412470,201807,264,210,54,199576.8,51516,251092.8
412480,201807,170,129,41,122112.9,39114,161226.9
412490,201807,165,141,24,134514,22896,157410
412500,201807,473,383,90,363807.8,85860,449667.8
412510,201807,185,153,32,145215,30528,175743
412520,201807,134,74,60,70596,57240,127836
412530,201807,106,56,50,53424,47413.8,100837.8
412535,201807,104,76,28,72486,26712,99198
412540,201807,69,35,34,33390,32436,65826
412545,201807,94,69,25,65826,23850,89676
412550,201807,3539,1602,1937,1524644.64,1845610.9,3370255.54
412555,201807,14,10,4,9540,3816,13356
412560,201807,587,438,149,415262.2,142146,557408.2
412570,201807,730,404,326,383587.39,310718,694305.39
412575,201807,80,57,23,54378,21942,76320
412580,201807,163,110,53,104940,50562,155502
412590,201807,33,31,2,29574,1908,31482
412600,201807,179,135,44,128790,41976,170766
412610,201807,31,19,12,18126,11448,29574
412620,201807,148,130,18,124020,17172,141192
412625,201807,2201,1177,1024,1120723.83,975018.59,2095742.42
412627,201807,71,56,15,53424,14310,67734
412630,201807,424,284,140,269402.43,133560,402962.43
412635,201807,68,20,48,19080,45792,64872
412640,201807,122,81,41,77274,39114,116388
412650,201807,346,217,129,207018,123061.23,330079.23
412660,201807,479,296,183,281669,174582,456251
412665,201807,51,45,6,42930,5724,48654
412667,201807,281,193,88,183327.54,83709.8,267037.34
412670,201807,60,51,9,48654,8586,57240
412680,201807,296,234,62,223236,59148,282384
412690,201807,119,77,42,73458,39782,113240
412700,201807,161,109,52,103986,49322,153308
412710,201807,1404,870,534,823686.6,507528.2,1331214.8
412720,201807,229,158,71,150732,67734,218466
412730,201807,198,159,39,151686,36252,187938
412740,201807,423,232,191,221184.9,182214,403398.9
412750,201807,468,270,198,256626,188892,445518
412760,201807,264,136,128,129744,122112,251856
412770,201807,2129,1205,924,1145186.94,879961,2025147.94
412780,201807,153,120,33,114480,31482,145962
412785,201807,271,136,135,129267,128790,258057
412788,201807,36,21,15,20034,14310,34344
412790,201807,136,112,24,106180.2,22896,129076.2
412795,201807,153,114,39,108756,37206,145962
412796,201807,298,210,88,199175.18,83818.44,282993.62
412800,201807,563,367,196,349558.39,186984,536542.39
412810,201807,3013,1668,1345,1586674.45,1281885.03,2868559.48
412820,201807,934,612,322,572915.79,306112,879027.79
412830,201807,15,12,3,11448,2862,14310
412840,201807,224,161,63,152640.2,60102,212742.2
412850,201807,784,532,252,505620,240408,746028
412853,201807,174,93,81,88722,77274,165996
412855,201807,216,117,99,110506.82,94446,204952.82
412860,201807,89,66,23,62964,21942,84906
412862,201807,60,44,16,41976,15264,57240
412863,201807,6,5,1,4770,954,5724
412865,201807,43,33,10,31482,9540,41022
412870,201807,109,73,36,69642,34344,103986
412880,201807,98,73,25,69642,23850,93492
420005,201807,39,34,5,32436,4198,36634
420010,201807,371,244,127,231588.34,120872,352460.34
420020,201807,77,65,12,62010,11448,73458
420030,201807,29,26,3,24804,2862,27666
420040,201807,106,81,25,77274,23850,101124
420050,201807,54,34,20,32436,19080,51516
420055,201807,20,19,1,18126,954,19080
420060,201807,33,24,9,22896,8586,31482
420070,201807,104,88,16,83952,15254.46,99206.46
420075,201807,11,10,1,9540,954,10494
420080,201807,51,45,6,41260.5,5724,46984.5
420090,201807,34,32,2,29750.49,1908,31658.49
420100,201807,166,138,28,130698.2,26712,157410.2
420110,201807,19,19,0,18126,0,18126
420120,201807,50,38,12,36252,11448,47700
420125,201807,85,68,17,64872,16218,81090
420127,201807,34,30,4,28620,3816,32436
420130,201807,392,245,147,233434.46,139989.96,373424.42
420140,201807,1289,742,547,706543.38,521772,1228315.38
420150,201807,45,40,5,38160,4770,42930
420160,201807,37,35,2,33390,1908,35298
420165,201807,19,14,5,13356,4770,18126
420170,201807,68,44,24,41976,22896,64872
420180,201807,24,22,2,20988,1908,22896
420190,201807,31,28,3,26712,2862,29574
420195,201807,127,62,65,59148,62010,121158
420200,201807,1277,575,702,543209.6,668670.38,1211879.98
420205,201807,67,36,31,34344,29574,63918
420207,201807,106,61,45,58194,42920.46,101114.46
420208,201807,23,18,5,17172,3911.4,21083.4
420209,201807,20,16,4,15264,3816,19080
420210,201807,468,226,242,215317.8,230782.68,446100.48
420213,201807,45,36,9,34344,8586,42930
420215,201807,27,23,4,21942,3816,25758
420220,201807,65,42,23,40068,21942,62010
420230,201807,775,441,334,419951,318149.46,738100.46
420240,201807,2295,1547,748,1467198.31,713153.16,2180351.47
420243,201807,38,31,7,29574,6678,36252
420245,201807,115,63,52,60102,49608,109710
420250,201807,54,32,22,30528,20988,51516
420253,201807,43,35,8,33390,7632,41022
420257,201807,13,11,2,10494,1908,12402
420260,201807,101,88,13,83952,12402,96354
420270,201807,38,31,7,29570,6678,36248
420280,201807,283,210,73,198471.06,68384.1,266855.16
420285,201807,19,12,7,11448,6678,18126
420287,201807,49,30,19,28620,18126,46746
420290,201807,981,693,288,657942.96,274684.3,932627.26
420300,201807,1384,1101,283,1046144.4,267502.14,1313646.54
420310,201807,59,47,12,44838,11448,56286
420315,201807,35,31,4,29574,3816,33390
420320,201807,849,432,417,411150.15,397814,808964.15
420325,201807,0,0,0,0,0,0
420330,201807,122,83,39,79182,37091.52,116273.52
420340,201807,163,111,52,104932,49588.92,154520.92
420350,201807,253,185,68,174935.78,64872,239807.78
420360,201807,760,580,180,550246.64,171053.78,721300.42
420370,201807,112,71,41,67544,38828,106372
420380,201807,1138,814,324,772446.1,308059.04,1080505.14
420390,201807,256,167,89,157487.52,84190.5,241678.02
420395,201807,187,134,53,127836,49676.8,177512.8
420400,201807,243,182,61,172675,58194,230869
420410,201807,60,46,14,43884,13356,57240
420415,201807,33,31,2,29574,1908,31482
420417,201807,50,37,13,35298,12382.92,47680.92
420419,201807,12,12,0,11448,0,11448
420420,201807,2811,1720,1091,1628375.22,1038525.88,2666901.10
420425,201807,74,62,12,59139,11134.26,70273.26
420430,201807,1273,888,385,843445.22,365536.12,1208981.34
420435,201807,16,14,2,13356,1908,15264
420440,201807,108,73,35,69014.68,33238.6,102253.28
420445,201807,22,19,3,18126,2862,20988
420450,201807,79,38,41,36252,39114,75366
420455,201807,211,158,53,150694.92,50506.38,201201.30
420460,201807,2350,1564,786,1486666.76,749591.82,2236258.58
420470,201807,118,84,34,80136,32436,112572
420475,201807,6,6,0,5724,0,5724
420480,201807,875,653,222,617660.33,210739,828399.33
420490,201807,112,88,24,83952,22896,106848
420500,201807,659,288,371,272781.2,353934,626715.2
420510,201807,19,16,3,15264,2862,18126
420515,201807,26,20,6,19080,5724,24804
420517,201807,10,10,0,9540,0,9540
420519,201807,0,0,0,0,0,0
420520,201807,69,52,17,49608,16218,65826
420530,201807,168,113,55,106827.02,52470,159297.02
420535,201807,21,19,2,18126,1908,20034
420540,201807,5000,2956,2044,2808162.78,1944682.18,4752844.96
420543,201807,26,26,0,24804,0,24804
420545,201807,197,139,58,131652,55312.92,186964.92
420550,201807,857,689,168,654408.32,160114.73,814523.05
420555,201807,39,27,12,25758,11448,37206
420560,201807,67,54,13,51134.4,12402,63536.4
420570,201807,152,90,62,85860,59138.46,144998.46
420580,201807,294,131,163,124974,155216,280190
420590,201807,521,369,152,351472.68,145008,496480.68
420600,201807,101,52,49,49608,46746,96354
420610,201807,37,35,2,33104,1908,35012
420620,201807,75,61,14,58194,13356,71550
420630,201807,159,117,42,111609.23,40060,151669.23
420640,201807,94,83,11,78991.2,10494,89485.2
420650,201807,242,128,114,121444.2,108137.23,229581.43
420660,201807,55,42,13,39304.8,12402,51706.8
420665,201807,38,28,10,26426,9540,35966
420670,201807,318,239,79,227280.96,75347.46,302628.42
420675,201807,15,14,1,13356,954,14310
420680,201807,36,26,10,24804,9540,34344
420690,201807,177,145,32,137566.8,30528,168094.8
420700,201807,663,453,210,432060.3,200087.82,632148.12
420710,201807,153,89,64,84906,60769.8,145675.8
420720,201807,109,89,20,84896.46,19080,103976.46
420730,201807,553,354,199,336649.5,188560.66,525210.16
420740,201807,46,45,1,42930,954,43884
420750,201807,502,336,166,320257.8,158364,478621.8
420757,201807,19,16,3,14453.1,2862,17315.1
420760,201807,38,31,7,29574,6678,36252
420765,201807,71,58,13,55332,12402,67734
420768,201807,66,58,8,55332,7632,62964
420770,201807,84,70,14,66780,13356,80136
420775,201807,45,41,4,39114,3816,42930
420780,201807,239,188,51,179342.46,48654,227996.46
420785,201807,15,11,4,10494,3816,14310
420790,201807,176,146,30,139191.3,27638.46,166829.76
420800,201807,75,57,18,53614.8,17172,70786.8
420810,201807,252,216,36,206055,33533.1,239588.1
420820,201807,2342,1392,950,1322259.41,904951.8,2227211.21
420830,201807,594,332,262,314433.95,248984.46,563418.41
420840,201807,151,113,38,107802,35548,143350
420845,201807,446,197,249,187553.07,236306,423859.07
420850,201807,234,186,48,177444,45792,223236
420860,201807,63,54,9,51516,8586,60102
420870,201807,117,84,33,80136,31482,111618
420880,201807,175,122,53,116378.46,49798.8,166177.26
420890,201807,876,429,447,405224.84,425856.6,831081.44
420895,201807,10,10,0,9540,0,9540
420900,201807,424,331,93,313715.04,88684.38,402399.42
420910,201807,5808,3257,2551,3096963.99,2428944.27,5525908.26
420915,201807,77,71,6,67734,5724,73458
420917,201807,20,14,6,13356,5724,19080
420920,201807,22,15,7,14310,6678,20988
420930,201807,2718,1670,1048,1588567.62,994465.74,2583033.36
420940,201807,618,446,172,424139.6,162436.08,586575.68
420945,201807,8,6,2,5724,1908,7632
420950,201807,57,52,5,49608,4770,54378
420960,201807,114,89,25,84868.92,23841,108709.92
420970,201807,303,243,60,230155.85,57212.46,287368.31
420980,201807,23,23,0,21942,0,21942
420985,201807,63,55,8,52470,7632,60102
420990,201807,75,59,16,56286,15264,71550
421000,201807,33,22,11,20988,10494,31482
421003,201807,69,45,24,42930,22887,65817
421005,201807,9,5,4,4770,3816,8586
421010,201807,762,534,228,508187,216406.2,724593.2
421020,201807,29,24,5,22896,4770,27666
421030,201807,130,110,20,104557,19080,123637
421040,201807,70,60,10,57240,9540,66780
421050,201807,319,231,88,218275.2,83952,302227.2
421055,201807,24,20,4,19080,3816,22896
421060,201807,81,55,26,52470,24804,77274
421070,201807,51,46,5,43884,4770,48654
421080,201807,34,31,3,29574,2862,32436
421085,201807,25,20,5,19080,4770,23850
421090,201807,43,32,11,30528,10494,41022
421100,201807,131,97,34,92538,32436,124974
421105,201807,219,177,42,168571.8,40044.69,208616.49
421110,201807,112,91,21,86193.9,20034,106227.9
421120,201807,156,121,35,114938.46,33370.92,148309.38
421125,201807,17,12,5,11448,4770,16218
421130,201807,818,529,289,503536.05,274666.54,778202.59
421140,201807,32,23,9,21226.5,8586,29812.5
421145,201807,40,31,9,29574,8586,38160
421150,201807,109,79,30,75366,28620,103986
421160,201807,65,43,22,41012.46,20988,62000.46
421165,201807,17,16,1,15264,954,16218
421170,201807,195,170,25,161267.84,23841,185108.84
421175,201807,152,100,52,95400,49560.38,144960.38
421180,201807,58,37,21,34936,20034,54970
421185,201807,17,14,3,13356,2862,16218
421187,201807,0,0,0,0,0,0
421189,201807,38,30,8,28620,7622.46,36242.46
421190,201807,1567,971,596,925371.46,567561.58,1492933.04
421200,201807,90,68,22,63918.7,20988,84906.7
421205,201807,27,19,8,18126,7632,25758
421210,201807,182,123,59,117342,56286,173628
421220,201807,278,221,57,210213.9,54378,264591.9
421223,201807,54,46,8,43694,7632,51326
421225,201807,68,43,25,41022,23850,64872
421227,201807,96,72,24,68688,22896,91584
421230,201807,54,41,13,39114,12402,51516
421240,201807,18,18,0,17172,0,17172
421250,201807,356,222,134,210454,127044.18,337498.18
421260,201807,27,22,5,20988,4770,25758
421265,201807,0,0,0,0,0,0
421270,201807,53,47,6,44838,5724,50562
421280,201807,339,191,148,182214,139474.8,321688.8
421290,201807,325,212,113,202010,105676.26,307686.26
421300,201807,25,20,5,19080,4770,23850
421310,201807,54,41,13,38446.2,12402,50848.2
421315,201807,30,20,10,19080,9540,28620
421320,201807,133,94,39,89676,37206,126882
421330,201807,108,82,26,76110.12,24795,100905.12
421335,201807,38,25,13,23850,12402,36252
421340,201807,294,199,95,188082.05,90630,278712.05
421350,201807,184,109,75,103543,71550,175093
421360,201807,691,512,179,484446.26,170175.06,654621.32
421370,201807,195,150,45,143100,42596.1,185696.1
421380,201807,127,102,25,97303.23,23850,121153.23
421390,201807,15,11,4,10494,3816,14310
421400,201807,116,98,18,93492,17172,110664
421410,201807,22,19,3,18126,2862,20988
421415,201807,22,21,1,20034,954,20988
421420,201807,151,124,27,117723.6,25758,143481.6
421430,201807,14,10,4,9540,3816,13356
421440,201807,56,43,13,41022,12402,53424
421450,201807,96,83,13,79182,12402,91584
421460,201807,57,48,9,44987.77,8586,53573.77
421470,201807,70,46,24,43884,22896,66780
421480,201807,637,474,163,451433,155493,606926
421490,201807,23,22,1,20312,954,21266
421500,201807,514,331,183,313991.3,174304.44,488295.74
421505,201807,28,19,9,18126,8586,26712
421507,201807,33,27,6,25758,5724,31482
421510,201807,74,48,26,45792,24804,70596
421520,201807,67,58,9,54569,8586,63155
421530,201807,54,49,5,46746,4770,51516
421535,201807,27,26,1,24537,954,25491
421540,201807,58,50,8,47700,7632,55332
421545,201807,96,73,23,69156,21942,91098
421550,201807,289,211,78,200627,74412,275039
421555,201807,26,21,5,20034,4675,24709
421560,201807,8,7,1,6678,954,7632
421565,201807,124,90,34,85860,32436,118296
421567,201807,31,26,5,24804,4770,29574
421568,201807,32,30,2,28620,1908,30528
421569,201807,7,7,0,6678,0,6678
421570,201807,153,104,49,99216,46746,145962
421575,201807,27,22,5,20988,4770,25758
421580,201807,722,430,292,409171.2,277614.34,686785.54
421590,201807,22,21,1,20034,954,20988
421600,201807,110,75,35,71550,32151,103701
421605,201807,105,75,30,71217,28620,99837
421610,201807,189,150,39,142146.2,37206,179352.2
421620,201807,1103,661,442,628094.92,421648.92,1049743.84
421625,201807,22,20,2,19080,1908,20988
421630,201807,292,185,107,175679.8,101220,276899.8
421635,201807,16,8,8,7632,7632,15264
421640,201807,99,85,14,80900,13356,94256
421650,201807,287,169,118,161206.92,112552.92,273759.84
421660,201807,2144,1290,854,1227085.9,813544.26,2040630.16
421670,201807,188,133,55,126882,52470,179352
421680,201807,170,153,17,145962,16209,162171
421690,201807,354,245,109,232657.38,103022.58,335679.96
421700,201807,59,37,22,35298,20130,55428
421710,201807,24,24,0,22896,0,22896
421715,201807,8,7,1,6678,954,7632
421720,201807,588,428,160,405579.15,150913.26,556492.41
421725,201807,12,5,7,4770,6678,11448
421730,201807,40,28,12,26004.12,11448,37452.12
421740,201807,88,42,46,40068,43884,83952
421750,201807,228,171,57,160688.51,54378,215066.51
421755,201807,26,24,2,22896,1908,24804
421760,201807,107,76,31,72504,29574,102078
421770,201807,580,391,189,370246.38,180041.3,550287.68
421775,201807,29,19,10,18126,9540,27666
421780,201807,195,153,42,145962,40068,186030
421790,201807,160,133,27,125989.5,25758,151747.5
421795,201807,17,13,4,12402,3816,16218
421800,201807,487,312,175,296851.31,166712,463563.31
421810,201807,70,55,15,52470,14310,66780
421820,201807,314,216,98,205396.2,93492,298888.2
421825,201807,128,107,21,102078,20034,122112
421830,201807,131,101,30,96354,28620,124974
421835,201807,3,3,0,2862,0,2862
421840,201807,59,49,10,46737,9540,56277
421850,201807,77,67,10,63918,9536,73454
421860,201807,42,33,9,31482,8586,40068
421870,201807,976,744,232,701350.76,220543.42,921894.18
421875,201807,54,46,8,43884,7632,51516
421880,201807,164,121,43,115434,40736,156170
421885,201807,27,22,5,20988,4770,25758
421890,201807,119,84,35,80136,33381,113517
421895,201807,43,40,3,38160,2862,41022
421900,201807,153,124,29,117935.1,27630,145565.1
421910,201807,67,44,23,41976,21942,63918
421915,201807,33,28,5,26712,4770,31482
421917,201807,41,31,10,29574,9540,39114
421920,201807,33,30,3,28620,2862,31482
421930,201807,748,582,166,553201.26,158337,711538.26
421935,201807,57,50,7,47700,6678,54378
421940,201807,40,37,3,35298,2862,38160
421950,201807,838,555,283,522682,267530.08,790212.08
421960,201807,42,35,7,33104,6656.12,39760.12
421970,201807,373,236,137,224645.12,130667.12,355312.24
421985,201807,33,21,12,20034,11448,31482
422000,201807,0,0,0,0,0,0
430003,201807,204,51,153,47938.5,145962,193900.5
430005,201807,36,28,8,26712,7632,34344
430010,201807,277,194,83,184599,79182,263781
430020,201807,153,100,53,95114,50562,145676
430030,201807,133,105,28,99883.8,26712,126595.8
430040,201807,2983,1736,1247,1646973.95,1187989.4,2834963.35
430045,201807,66,57,9,54091.8,8586,62677.8
430047,201807,6,5,1,4770,954,5724
430050,201807,79,66,13,62964,12402,75366
430055,201807,17,14,3,13356,2862,16218
430057,201807,5,3,2,2862,1908,4770
430060,201807,3651,2181,1470,2073430.92,1398939.74,3472370.66
430063,201807,59,54,5,51516,4770,56286
430064,201807,151,124,27,118296,25758,144054
430066,201807,10,7,3,6678,2862,9540
430070,201807,43,33,10,31482,9540,41022
430080,201807,68,45,23,42230.33,21942,64172.33
430085,201807,34,12,22,11448,20988,32436
430087,201807,32,23,9,21799,8586,30385
430090,201807,71,64,7,60769.8,6678,67447.8
430100,201807,129,87,42,82044,40068,122112
430105,201807,143,72,71,68498,67428.72,135926.72
430107,201807,20,15,5,14310,4770,19080
430110,201807,414,244,170,231907.86,162094.14,394002.00
430120,201807,140,129,11,122112,10494,132606
430130,201807,800,501,299,477333.9,284959.8,762293.7
430140,201807,122,114,8,108756,7632,116388
430150,201807,112,72,40,67925,37206,105131
430155,201807,32,29,3,27666,2862,30528
430160,201807,3795,2249,1546,2127975.92,1472718.62,3600694.54
430163,201807,333,151,182,143005.34,173599.38,316604.72
430165,201807,26,18,8,17172,7632,24804
430170,201807,84,74,10,70596,9540,80136
430175,201807,84,65,19,62010,17458.2,79468.2
430180,201807,107,84,23,80136,21321.9,101457.9
430185,201807,34,26,8,24804,7632,32436
430187,201807,99,41,58,39114,55026.8,94140.8
430190,201807,221,127,94,121110.3,88999.46,210109.76
430192,201807,15,14,1,13356,954,14310
430195,201807,14,9,5,8586,4770,13356
430200,201807,167,148,19,140524.2,18126,158650.2
430205,201807,20,19,1,18126,954,19080
430210,201807,636,493,143,466506,134561.9,601067.9
430215,201807,16,11,5,10494,4770,15264
430220,201807,68,49,19,46746,18126,64872
430222,201807,12,7,5,6678,4770,11448
430223,201807,13,7,6,6678,5724,12402
430225,201807,4,3,1,2862,954,3816
430230,201807,295,181,114,171720,108660.6,280380.6
430235,201807,52,36,16,34344,15254.46,49598.46
430237,201807,29,22,7,20988,6678,27666
430240,201807,130,84,46,79945.2,43884,123829.2
430245,201807,74,63,11,60102,10494,70596
430250,201807,190,111,79,105884.46,75356.46,181240.92
430258,201807,12,10,2,9540,1908,11448
430260,201807,34,29,5,27666,4760.46,32426.46
430265,201807,34,29,5,27646.92,4770,32416.92
430270,201807,551,412,139,389944.74,131749.02,521693.76
430280,201807,1049,645,404,610839.97,382916.6,993756.57
430290,201807,378,219,159,207018.8,151686,358704.8
430300,201807,2129,1178,951,1119339.44,904204.35,2023543.79
430310,201807,1981,1044,937,989691.4,890865.93,1880557.33
430320,201807,51,43,8,41007.69,7632,48639.69
430330,201807,94,84,10,79659,9520.92,89179.92
430340,201807,67,59,8,56286,7632,63918
430350,201807,1681,1170,511,1104050.89,485996.76,1590047.65
430355,201807,26,23,3,21942,2862,24804
430360,201807,82,39,43,37206,41022,78228
430367,201807,28,20,8,19080,7632,26712
430370,201807,56,48,8,45792,7632,53424
430380,201807,129,96,33,91011.6,31482,122493.6
430390,201807,617,385,232,367003.8,220736.02,587739.82
430400,201807,140,108,32,101124,30508.92,131632.92
430410,201807,61,48,13,45792,12402,58194
430420,201807,502,329,173,311386.8,163545.56,474932.36
430430,201807,52,49,3,46110.63,2051.1,48161.73
430435,201807,158,118,40,111618,37444.5,149062.5
430440,201807,502,334,168,318636,160081.2,478717.2
430450,201807,1188,979,209,927085.64,199376.46,1126462.10
430460,201807,5096,2803,2293,2659107.77,2181754.89,4840862.66
430461,201807,17,15,2,14310,1908,16218
430462,201807,9,6,3,5724,2862,8586
430463,201807,1025,542,483,515121.92,460430.1,975552.02
430465,201807,26,14,12,13356,11448,24804
430466,201807,666,483,183,458874.2,174391.2,633265.4
430467,201807,99,57,42,53137.8,40058.46,93196.26
430468,201807,110,68,42,64872,39816.91,104688.91
430469,201807,23,18,5,17172,4770,21942
430470,201807,1166,644,522,608691.55,496032.3,1104723.85
430471,201807,50,37,13,35278.92,12402,47680.92
430480,201807,97,60,37,56095.2,35288.46,91383.66
430485,201807,6,6,0,5438,0,5438
430490,201807,89,72,17,67877.7,16218,84095.7
430495,201807,37,27,10,25758,9540,35298
430500,201807,191,126,65,119917.8,61634.46,181552.26
430510,201807,3159,2090,1069,1985941.93,1018653.12,3004595.05
430511,201807,16,16,0,15264,0,15264
430512,201807,136,97,39,92538,37206,129744
430513,201807,52,43,9,40545,8586,49131
430515,201807,31,29,2,27666,1908,29574
430517,201807,167,148,19,140238,18106.92,158344.92
430520,201807,371,259,112,246419,106819.38,353238.38
430530,201807,89,52,37,49608,35298,84906
430535,201807,476,319,157,303840.43,149750.15,453590.58
430537,201807,10,10,0,9540,0,9540
430540,201807,73,50,23,47700,21942,69642
430543,201807,370,115,255,109710,243270,352980
430544,201807,43,40,3,38160,2862,41022
430545,201807,349,169,180,160730,171208.66,331938.66
430550,201807,42,34,8,32436,7632,40068
430558,201807,5,3,2,2862,1908,4770
430560,201807,50,22,28,20988,26712,47700
430570,201807,104,44,60,41976,57182.76,99158.76
430580,201807,123,99,24,94446,21655.8,116101.8
430583,201807,14,14,0,13356,0,13356
430585,201807,8,3,5,2862,4770,7632
430587,201807,14,7,7,6678,6678,13356
430590,201807,152,122,30,115147.8,28620,143767.8
430593,201807,4,4,0,3816,0,3816
430595,201807,18,14,4,13356,3816,17172
430597,201807,51,27,24,25758,22896,48654
430600,201807,221,155,66,147860.46,62677.8,210538.26
430605,201807,161,102,59,97308,56276.46,153584.46
430607,201807,28,23,5,21942,4770,26712
430610,201807,1640,769,871,731041.36,826334.32,1557375.68
430613,201807,3,3,0,2862,0,2862
430620,201807,114,82,32,78228,30518.46,108746.46
430630,201807,45,39,6,37206,5724,42930
430632,201807,32,27,5,25758,4770,30528
430635,201807,41,37,4,35298,3816,39114
430637,201807,56,32,24,30528,22896,53424
430640,201807,203,113,90,106371,85860,192231
430642,201807,27,25,2,23850,1908,25758
430645,201807,35,29,6,27666,5724,33390
430650,201807,255,206,49,196238,46698.3,242936.3
430655,201807,4,4,0,3816,0,3816
430660,201807,970,472,498,448713.9,473565.8,922279.7
430670,201807,73,50,23,47700,21942,69642
430673,201807,69,38,31,36252,29574,65826
430675,201807,13,10,3,9540,2862,12402
430676,201807,496,300,196,285494.12,186913.07,472407.19
430680,201807,250,172,78,161607.8,74412,236019.8
430690,201807,533,318,215,302466.24,203435.06,505901.30
430692,201807,7,5,2,4770,1908,6678
430693,201807,147,98,49,93492,46736.46,140228.46
430695,201807,75,65,10,61075.08,9540,70615.08
430697,201807,57,35,22,33390,20988,54378
430700,201807,1587,1113,474,1050296.16,451909.8,1502205.96
430705,201807,19,18,1,17172,954,18126
430710,201807,260,169,91,161226,86814,248040
430720,201807,107,91,16,86623.2,15264,101887.2
430730,201807,120,102,18,96354,17172,113526
430740,201807,67,43,24,41022,22896,63918
430745,201807,36,29,7,27380,6678,34058
430750,201807,343,229,114,217522.64,107802,325324.64
430755,201807,81,46,35,43884,33390,77274
430760,201807,366,220,146,207209.72,139255.92,346465.64
430770,201807,1456,754,702,716645.7,664602.55,1381248.25
430780,201807,316,202,114,191726.72,108689.76,300416.48
430781,201807,28,23,5,21942,4770,26712
430783,201807,53,42,11,39750.13,10494,50244.13
430786,201807,6,3,3,2862,2862,5724
430790,201807,503,325,178,308778.12,169516.46,478294.58
430800,201807,157,129,28,123046.92,26712,149758.92
430805,201807,43,39,4,37206,3816,41022
430807,201807,38,25,13,23850,12402,36252
430810,201807,75,49,26,46746,24804,71550
430820,201807,136,85,51,81090,47986.2,129076.2
430825,201807,12,10,2,9540,1908,11448
430830,201807,236,222,14,211482.92,13356,224838.92
430840,201807,126,86,40,82044,37492.2,119536.2
430843,201807,5,3,2,2862,1908,4770
430845,201807,70,39,31,37206,29574,66780
430850,201807,574,399,175,379119.6,166846.76,545966.36
430860,201807,158,99,59,93778.2,55608.66,149386.86
430865,201807,68,37,31,34630.2,29259.18,63889.38
430870,201807,82,66,16,62296.2,15264,77560.2
430880,201807,160,121,39,115414.92,37206,152620.92
430885,201807,7,6,1,5724,954,6678
430890,201807,334,207,127,195818.04,121158,316976.04
430900,201807,537,372,165,350404.2,156933,507337.2
430905,201807,90,37,53,35298,50562,85860
430910,201807,265,148,117,141192,110942,252134
430912,201807,4,4,0,3816,0,3816
430915,201807,35,27,8,25758,7345.8,33103.8
430920,201807,4286,2378,1908,2261130.81,1817494.62,4078625.43
430925,201807,5,4,1,3567.96,954,4521.96
430930,201807,2110,1252,858,1186762.88,818281.51,2005044.39
430940,201807,257,163,94,154824.66,89656.92,244481.58
430950,201807,156,125,31,119250,29574,148824
430955,201807,22,14,8,13356,7632,20988
430957,201807,18,17,1,16218,954,17172
430960,201807,238,158,80,148299.3,76320,224619.3
430965,201807,107,67,40,63918,38160,102078
430970,201807,83,69,14,65826,12402,78228
430975,201807,36,32,4,30528,3816,34344
430980,201807,47,29,18,27666,17172,44838
430990,201807,118,89,29,84906,27666,112572
430995,201807,115,110,5,103699.8,4770,108469.8
431000,201807,304,138,166,129505.2,158364,287869.2
431010,201807,337,203,134,192803.4,127816.92,320620.32
431020,201807,1940,1134,806,1073751.42,764812.26,1838563.68
431030,201807,42,33,9,31482,8586,40068
431033,201807,390,197,193,187127.2,184122,371249.2
431036,201807,14,9,5,8586,4770,13356
431040,201807,130,79,51,74412,48544.29,122956.29
431041,201807,37,25,12,23850,11448,35298
431043,201807,46,26,20,24804,19080,43884
431046,201807,12,7,5,6678,4770,11448
431050,201807,203,131,72,124401.6,68444.06,192845.66
431053,201807,76,45,31,42166.8,29574,71740.8
431055,201807,62,42,20,40068,19060.92,59128.92
431057,201807,17,17,0,16218,0,16218
431060,201807,1674,1058,616,1000239.84,585821.98,1586061.82
431065,201807,19,11,8,10494,7632,18126
431070,201807,70,65,5,62010,4770,66780
431075,201807,7,7,0,6678,0,6678
431080,201807,138,87,51,82711.8,48654,131365.8
431085,201807,31,28,3,26712,2862,29574
431087,201807,13,11,2,10494,1908,12402
431090,201807,55,43,12,41022,11448,52470
431100,201807,1230,734,496,689459.02,473184,1162643.02
431110,201807,247,157,90,149778,85564.46,235342.46
431112,201807,29,17,12,16218,11448,27666
431113,201807,30,21,9,20034,8586,28620
431115,201807,153,107,46,101441.87,43874.46,145316.33
431120,201807,614,361,253,342458.18,240100.14,582558.32
431123,201807,4,3,1,2862,954,3816
431125,201807,93,83,10,79182,9540,88722
431127,201807,9,4,5,3816,4770,8586
431130,201807,664,428,236,406785.6,224838.72,631624.32
431140,201807,733,501,232,476714,221251.68,697965.68
431142,201807,35,27,8,24546,7632,32178
431150,201807,203,148,55,141192,52460.46,193652.46
431160,201807,56,50,6,47700,5724,53424
431162,201807,19,14,5,13356,4770,18126
431164,201807,4,4,0,3816,0,3816
431170,201807,106,86,20,82044,19080,101124
431171,201807,58,33,25,31243.5,23840.46,55083.96
431173,201807,1,1,0,954,0,954
431175,201807,203,100,103,94160,98252.46,192412.46
431177,201807,75,56,19,53424,17439.92,70863.92
431179,201807,13,11,2,10494,1908,12402
431180,201807,450,276,174,263304,165977.46,429281.46
431190,201807,88,68,20,64872,19080,83952
431198,201807,70,48,22,45792,20988,66780
431200,201807,21,17,4,16218,3816,20034
431205,201807,23,23,0,21942,0,21942
431210,201807,89,55,34,52137,32436,84573
431213,201807,30,25,5,23850,4770,28620
431215,201807,25,22,3,20988,2862,23850
431217,201807,5,4,1,3816,954,4770
431220,201807,67,58,9,55332,8586,63918
431225,201807,150,99,51,94437,48634.92,143071.92
431230,201807,98,86,12,82044,11448,93492
431235,201807,8,8,0,7632,0,7632
431237,201807,26,18,8,17172,7632,24804
431238,201807,13,10,3,9254,2862,12116
431240,201807,1006,649,357,617486.64,340253.64,957740.28
431242,201807,36,36,0,34344,0,34344
431244,201807,11,8,3,7632,2862,10494
431245,201807,55,41,14,39114,13356,52470
431247,201807,14,12,2,11448,1908,13356
431250,201807,273,142,131,135401.22,124954.92,260356.14
431260,201807,61,46,15,43884,14310,58194
431261,201807,19,13,6,12402,5724,18126
431262,201807,15,15,0,14310,0,14310
431265,201807,159,84,75,80136,71550,151686
431267,201807,13,12,1,11448,954,12402
431270,201807,318,265,53,252810,50562,303372
431275,201807,40,38,2,36252,1908,38160
431280,201807,19,15,4,13475.25,3816,17291.25
431290,201807,23,19,4,18126,3816,21942
431295,201807,4,4,0,3816,0,3816
431300,201807,23,20,3,19080,2862,21942
431301,201807,7,7,0,6678,0,6678
431303,201807,53,35,18,33265.98,16885.8,50151.78
431306,201807,226,119,107,113069.98,102078,215147.98
431308,201807,7,5,2,4770,1908,6678
431310,201807,65,56,9,53424,8586,62010
431320,201807,121,71,50,67714.92,47404.26,115119.18
431330,201807,171,111,60,105894,57240,163134
431333,201807,33,27,6,25758,5724,31482
431335,201807,10,5,5,4770,4770,9540
431337,201807,326,155,171,147183.2,162094.14,309277.34
431339,201807,23,20,3,19080,2862,21942
431340,201807,3021,1746,1275,1659838.73,1213290.02,2873128.75
431342,201807,41,24,17,22896,16218,39114
431344,201807,17,17,0,16218,0,16218
431346,201807,4,4,0,3816,0,3816
431349,201807,35,32,3,30528,2862,33390
431350,201807,918,539,379,510878.25,359906.04,870784.29
431360,201807,47,42,5,40068,4770,44838
431365,201807,319,152,167,144988.92,158354.46,303343.38
431370,201807,1347,797,550,757820.11,524522.52,1282342.63
431380,201807,97,83,14,79182,13356,92538
431390,201807,499,275,224,261348.5,213390.72,474739.22
431395,201807,283,124,159,118296,151667,269963
431400,201807,39,29,10,27666,9540,37206
431402,201807,104,72,32,68688,30528,99216
431403,201807,20,12,8,11448,7632,19080
431405,201807,645,346,299,328444.02,284933,613377.02
431406,201807,31,27,4,25758,3816,29574
431407,201807,53,42,11,40068,10494,50562
431410,201807,3319,2008,1311,1902199.29,1246162.5,3148361.79
431413,201807,16,13,3,12402,2862,15264
431415,201807,71,52,19,49608,18126,67734
431417,201807,23,12,11,11448,10494,21942
431420,201807,306,215,91,204473.96,86814,291287.96
431430,201807,43,18,25,17172,23850,41022
431440,201807,8970,6390,2580,6027764.86,2453608.21,8481373.07
431442,201807,28,15,13,14310,12402,26712
431445,201807,27,21,6,20034,5724,25758
431446,201807,7,6,1,5724,954,6678
431447,201807,87,62,25,59148,23850,82998
431449,201807,52,45,7,42930,6678,49608
431450,201807,416,284,132,269886.6,125212.5,395099.1
431454,201807,0,0,0,0,0,0
431455,201807,48,38,10,36252,9540,45792
431460,201807,531,366,165,347112.9,157123.8,504236.7
431470,201807,117,91,26,86122.54,24554,110676.54
431475,201807,11,10,1,9540,954,10494
431477,201807,37,25,12,23850,11448,35298
431478,201807,8,7,1,6678,954,7632
431480,201807,507,319,188,302780.52,179304.3,482084.82
431490,201807,28210,16078,12132,15264991.18,11538953.67,26803944.85
431500,201807,78,53,25,50323.5,23850,74173.5
431505,201807,39,24,15,22896,14310,37206
431507,201807,12,10,2,9540,1908,11448
431510,201807,269,179,90,169926.41,84877.38,254803.79
431513,201807,23,19,4,18126,3816,21942
431514,201807,9,8,1,7632,954,8586
431515,201807,80,67,13,63918,12402,76320
431517,201807,3,2,1,1908,954,2862
431520,201807,37,33,4,31482,3816,35298
431530,201807,1594,716,878,682682.64,837188.09,1519870.73
431531,201807,24,22,2,20988,1908,22896
431532,201807,26,18,8,17172,7632,24804
431535,201807,25,16,9,15264,8586,23850
431540,201807,142,126,16,119183.22,15264,134447.22
431545,201807,17,15,2,14310,1908,16218
431550,201807,355,203,152,193375.8,144912.6,338288.4
431555,201807,13,12,1,11448,954,12402
431560,201807,4551,3212,1339,3033600.02,1275136.38,4308736.40
431570,201807,814,434,380,409934.2,359649.46,769583.66
431575,201807,36,25,11,23850,10494,34344
431580,201807,92,66,26,62010,24804,86814
431590,201807,137,114,23,107802,21942,129744
431595,201807,11,10,1,9540,954,10494
431600,201807,215,123,92,117322.92,87768,205090.92
431610,201807,127,92,35,86527.8,33390,119917.8
431620,201807,43,35,8,33390,7632,41022
431630,201807,140,116,24,110664,22896,133560
431640,201807,1352,841,511,797162.82,485233.84,1282396.66
431642,201807,39,36,3,33867,2862,36729
431643,201807,45,19,26,18126,24804,42930
431645,201807,299,173,126,165042,119917.8,284959.8
431647,201807,10,10,0,9540,0,9540
431650,201807,35,26,9,24804,8586,33390
431660,201807,292,187,105,176490,100170,276660
431670,201807,223,107,116,99454.5,110635.38,210089.88
431673,201807,3,3,0,2862,0,2862
431675,201807,30,25,5,23563.8,4770,28333.8
431680,201807,1119,809,310,767016,294691.14,1061707.14
431690,201807,4809,2929,1880,2771623,1789306.22,4560929.22
431695,201807,26,20,6,19080,5724,24804
431697,201807,0,0,0,0,0,0
431700,201807,179,139,40,132606,38160,170766
431710,201807,4021,1735,2286,1652457.03,2179400.48,3831857.51
431720,201807,1396,840,556,791992.78,529456.46,1321449.24
431725,201807,1,1,0,954,0,954
431730,201807,1205,818,387,772371.7,369198,1141569.7
431740,201807,1363,683,680,647060.12,646929.38,1293989.50
431750,201807,1872,1213,659,1146925.5,626749.92,1773675.42
431755,201807,6,5,1,4770,954,5724
431760,201807,1068,686,382,654062.4,364199.58,1018261.98
431770,201807,393,288,105,274075.46,100150.92,374226.38
431775,201807,28,21,7,20034,6678,26712
431780,201807,563,352,211,334978.02,201284.46,536262.48
431790,201807,158,120,38,113526,36204.3,149730.3
431795,201807,13,12,1,11448,954,12402
431800,201807,3387,1779,1608,1682117.02,1528427.16,3210544.18
431805,201807,17,15,2,14310,1908,16218
431810,201807,612,412,200,390414.96,190666.98,581081.94
431820,201807,311,177,134,168858,127836,296694
431830,201807,2335,1417,918,1348197.57,874511.65,2222709.22
431840,201807,523,353,170,333138.4,160883.38,494021.78
431842,201807,34,28,6,26712,5724,32436
431843,201807,12,8,4,7632,3816,11448
431844,201807,14,12,2,11448,1908,13356
431845,201807,29,26,3,24804,2862,27666
431846,201807,27,23,4,21942,3816,25758
431848,201807,15,12,3,11448,2862,14310
431849,201807,9,7,2,6678,1908,8586
431850,201807,809,669,140,636713.51,133321.5,770035.01
431860,201807,107,76,31,72504,28620,101124
431861,201807,3,2,1,1908,954,2862
431862,201807,52,33,19,31482,18126,49608
431870,201807,3458,2044,1414,1940622.76,1345783.76,3286406.52
431880,201807,958,700,258,661761.8,245178,906939.8
431890,201807,1299,804,495,761496.92,470623,1232119.92
431900,201807,180,128,52,122112,48816.18,170928.18
431910,201807,57,44,13,41976,12402,54378
431912,201807,37,20,17,19080,16218,35298
431915,201807,126,100,26,95400,24804,120204
431920,201807,145,107,38,101791.8,36252,138043.8
431930,201807,85,69,16,65110.5,15264,80374.5
431935,201807,4,3,1,2862,954,3816
431936,201807,14,13,1,12402,954,13356
431937,201807,18,13,5,12402,4770,17172
431940,201807,461,311,150,293927.4,141850.96,435778.36
431950,201807,494,317,177,300225.08,168706.44,468931.52
431960,201807,731,423,308,399642.22,293670.9,693313.12
431970,201807,72,64,8,61056,7632,68688
431971,201807,3,3,0,2862,0,2862
431973,201807,22,17,5,16218,4770,20988
431975,201807,7,6,1,5724,954,6678
431980,201807,205,129,76,122493.6,72504,194997.6
431990,201807,1226,663,563,631028.99,537056,1168084.99
432000,201807,1680,913,767,863049.24,728153.24,1591202.48
432010,201807,281,184,97,174238.56,92538,266776.56
432020,201807,169,137,32,130698,30528,161226
432023,201807,18,14,4,13356,3816,17172
432026,201807,67,61,6,58194,5724,63918
432030,201807,64,28,36,26712,34344,61056
432032,201807,22,19,3,18126,2862,20988
432035,201807,50,39,11,37206,10494,47700
432040,201807,105,73,32,69642,30528,100170
432045,201807,8,7,1,6678,954,7632
432050,201807,69,40,29,38160,27666,65826
432055,201807,101,74,27,70596,25758,96354
432057,201807,1,0,1,0,954,954
432060,201807,34,31,3,29574,2862,32436
432065,201807,30,27,3,25758,2862,28620
432067,201807,86,76,10,72484.92,9540,82024.92
432070,201807,411,307,104,290428.07,99187.92,389615.99
432080,201807,816,565,251,537330.96,239406.38,776737.34
432085,201807,16,12,4,11448,3816,15264
432090,201807,258,160,98,152640,93492,246132
432100,201807,175,117,58,111331.8,55332,166663.8
432110,201807,622,428,194,398212.99,184122,582334.99
432120,201807,955,579,376,551698.2,358618.14,910316.34
432130,201807,506,367,139,348782.4,131508.9,480291.3
432132,201807,24,21,3,20034,2862,22896
432135,201807,79,65,14,62010,13356,75366
432140,201807,264,209,55,199090.26,52470,251560.26
432143,201807,193,123,70,117342,66780,184122
432145,201807,273,188,85,178112.6,80803.8,258916.4
432146,201807,15,14,1,13356,954,14310
432147,201807,131,61,70,58194,66756.15,124950.15
432149,201807,17,13,4,12402,3816,16218
432150,201807,838,526,312,501555.96,295626.17,797182.13
432160,201807,1389,721,668,685488.7,636347.36,1321836.06
432162,201807,4,3,1,2862,954,3816
432163,201807,18,14,4,13356,3816,17172
432166,201807,120,90,30,86338,28620,114958
432170,201807,225,123,102,116389,97308,213697
432180,201807,525,324,201,306329.58,191468,497797.58
432183,201807,9,7,2,6678,1908,8586
432185,201807,82,71,11,67734,10494,78228
432190,201807,457,256,201,243832.86,191650.14,435483.00
432195,201807,84,72,12,68688,11448,80136
432200,201807,418,272,146,259488,139236.84,398724.84
432210,201807,122,79,43,73601.1,41022,114623.1
432215,201807,59,55,4,52470,3816,56286
432218,201807,20,19,1,18126,954,19080
432220,201807,688,347,341,330027.56,324806.74,654834.30
432225,201807,14,8,6,7155,5724,12879
432230,201807,143,87,56,82759.5,53424,136183.5
432232,201807,16,14,2,13356,1908,15264
432234,201807,4,3,1,2862,954,3816
432235,201807,2,2,0,1908,0,1908
432237,201807,30,17,13,16218,12402,28620
432240,201807,4286,2401,1885,2280825.04,1790621.38,4071446.42
432250,201807,1040,667,373,632932.76,355679.82,988612.58
432252,201807,41,35,6,32913,5724,38637
432253,201807,58,46,12,43884,11448,55332
432254,201807,24,11,13,10494,12402,22896
432255,201807,14,13,1,12402,954,13356
432260,201807,881,694,187,660369.34,177444.5,837813.84
432270,201807,232,169,63,161226,60102,221328
432280,201807,124,91,33,86337.8,31482,117819.8
432285,201807,1,1,0,954,0,954
432290,201807,70,63,7,58192.76,6678,64870.76
432300,201807,4648,2663,1985,2521356.02,1889963.1,4411319.12
432310,201807,115,92,23,87479.76,21942,109421.76
432320,201807,19,15,4,14310,3816,18126
432330,201807,18,13,5,12402,4770,17172
432335,201807,7,6,1,5724,954,6678
432340,201807,39,36,3,34344,2862,37206
432345,201807,98,69,29,65826,27666,93492
432350,201807,24,23,1,21942,954,22896
432360,201807,6,4,2,3816,1908,5724
432370,201807,25,25,0,23850,0,23850
432375,201807,36,32,4,30528,3816,34344
432377,201807,8,8,0,7632,0,7632
432380,201807,167,75,92,70882.2,87720.3,158602.5
500020,201807,249,139,110,132606,104338.98,236944.98
500025,201807,117,58,59,54378,56286,110664
500060,201807,1401,866,535,825591.6,509351.65,1334943.25
500070,201807,776,371,405,353583,386360.46,739943.46
500080,201807,132,102,30,97308,28620,125928
500085,201807,136,110,26,104654,23969.25,128623.25
500090,201807,334,160,174,152640,165996,318636
500100,201807,716,381,335,361280.13,319018,680298.13
500110,201807,2231,1011,1220,964167.46,1163057.6,2127225.06
500124,201807,312,178,134,169812,127549.8,297361.8
500150,201807,330,130,200,124011,190430.46,314441.46
500190,201807,532,364,168,346588.2,159786,506374.2
500200,201807,198,168,30,159929,28620,188549
500210,201807,1438,516,922,492049.39,878415.45,1370464.84
500215,201807,242,139,103,131648.42,98262,229910.42
500220,201807,786,509,277,485341.84,264248.46,749590.30
500230,201807,260,176,84,167188.5,79659,246847.5
500240,201807,701,487,214,463834.8,203869.8,667704.6
500260,201807,583,219,364,208926,347256,556182
500270,201807,28529,12201,16328,11609656.01,15559852.86,27169508.87
500280,201807,190,70,120,66780,114480,181260
500290,201807,1190,706,484,672571,461727,1134298
500295,201807,413,251,162,239454,154538.46,393992.46
500310,201807,63,20,43,19080,41022,60102
500315,201807,718,429,289,409256.46,275696.46,684952.92
500320,201807,3618,1824,1794,1737673.38,1710095.94,3447769.32
500325,201807,921,510,411,486063,390854.44,876917.44
500330,201807,1473,683,790,649360.28,753326.64,1402686.92
500345,201807,324,243,81,230859.2,77274,308133.2
500348,201807,245,146,99,139284,94427.46,233711.46
500350,201807,136,66,70,62964,66780,129744
500370,201807,5412,2441,2971,2321186.1,2832163.78,5153349.88
500375,201807,353,256,97,243959.84,92538,336497.84
500380,201807,598,342,256,326110.59,244214.46,570325.05
500390,201807,72,36,36,34344,34344,68688
500400,201807,215,146,69,139264.92,65817,205081.92
500410,201807,554,218,336,207926.15,320396.22,528322.37
500430,201807,548,381,167,363474,159318,522792
500440,201807,205,105,100,99397.43,95400,194797.43
500450,201807,404,174,230,165290.8,219410.46,384701.26
500460,201807,308,156,152,148814.46,144712.26,293526.72
500470,201807,446,348,98,331120.46,92529,423649.46
500480,201807,113,67,46,63918,43884,107802
500490,201807,105,42,63,40063.23,60102,100165.23
500500,201807,1428,505,923,479752.9,879965.1,1359718.0
500510,201807,50,38,12,36252,11439,47691
500515,201807,108,76,32,72504,30242,102746
500520,201807,343,190,153,179925,145672,325597
500525,201807,87,49,38,46746,35965.8,82711.8
500540,201807,912,383,529,365315.76,503655.84,868971.60
500560,201807,880,497,383,472399.04,365057.84,837456.88
500568,201807,1005,583,422,552620.62,402298,954918.62
500570,201807,1213,681,532,646204.04,504625.26,1150829.30
500580,201807,338,172,166,163792.26,158351,322143.26
500600,201807,309,157,152,149067.27,144990,294057.27
500620,201807,932,654,278,618425.64,265021.2,883446.84
500625,201807,79,67,12,63536.4,11448,74984.4
500627,201807,25,12,13,11448,12402,23850
500630,201807,1566,836,730,796199.66,696133.8,1492333.46
500635,201807,521,299,222,284826.24,211644.9,496471.14
500640,201807,432,226,206,213030,196505.46,409535.46
500660,201807,5546,2118,3428,2017138.7,3265610.32,5282749.02
500690,201807,568,205,363,195213.24,344623.25,539836.49
500710,201807,356,172,184,163802,175518,339320
500720,201807,979,571,408,543050.69,389022.92,932073.61
500730,201807,200,120,80,114480,76315.23,190795.23
500740,201807,843,371,472,352646.95,450009.75,802656.70
500750,201807,141,45,96,42930,91555.92,134485.92
500755,201807,126,90,36,85574,34344,119918
500769,201807,748,428,320,407976.27,305267,713243.27
500770,201807,434,230,204,219410.46,194606.46,414016.92
500780,201807,172,114,58,108470,55332,163802
500790,201807,1034,516,518,490901.25,494131.46,985032.71
500793,201807,258,141,117,134514,111609,246123
500795,201807,177,126,51,120194.46,48645,168839.46
500797,201807,43,32,11,30528,10494,41022
500800,201807,407,177,230,168849,219133.8,387982.8
500830,201807,2224,1245,979,1185318.12,932926.68,2118244.80
500840,201807,141,105,36,100170,34335,134505
510010,201807,169,94,75,89666.46,71521.38,161187.84
510020,201807,491,232,259,221034.06,246549.96,467584.02
510025,201807,1676,957,719,912098.59,683417.62,1595516.21
510030,201807,674,350,324,333853.92,308321.92,642175.84
510035,201807,133,60,73,57212.46,69623.46,126835.92
510040,201807,390,176,214,167904,203709.26,371613.26
510050,201807,424,233,191,221531.66,181390.46,402922.12
510060,201807,115,58,57,55322.46,54368.46,109690.92
510080,201807,223,90,133,85827.69,126768.06,212595.75
510100,201807,75,34,41,32436,39094.92,71530.92
510120,201807,38,23,15,21942,14310,36252
510125,201807,393,241,152,229231.89,144984.92,374216.81
510130,201807,569,332,237,316322.81,225684.18,542006.99
510140,201807,391,129,262,123057,249943.23,373000.23
510160,201807,92,41,51,39114,48650,87764
510170,201807,862,524,338,499621.05,321828.38,821449.43
510180,201807,2876,1399,1477,1331365.18,1407143.86,2738509.04
510185,201807,11,6,5,5724,4770,10494
510190,201807,220,71,149,67734,142141.23,209875.23
510250,201807,2612,1542,1070,1469998.99,1019638.1,2489637.09
510260,201807,202,146,56,139101.84,53387.46,192489.30
510263,201807,460,253,207,240358.58,196713.05,437071.63
510267,201807,665,373,292,354333.76,278287.91,632621.67
510268,201807,56,29,27,27666,25758,53424
510269,201807,69,32,37,30519,35298,65817
510270,201807,406,207,199,197299.98,189419.94,386719.92
510279,201807,231,171,60,163107,56934.92,220041.92
510285,201807,173,73,100,69623.46,95400,165023.46
510300,201807,528,292,236,278136.14,225069.84,503205.98
510305,201807,210,98,112,93469.46,106772.22,200241.68
510310,201807,113,58,55,55332,52460.46,107792.46
510320,201807,872,543,329,517454.18,313716.38,831170.56
510325,201807,415,166,249,158354.46,237259.8,395614.26
510330,201807,430,239,191,227993,182194.92,410187.92
510335,201807,596,326,270,310957.38,256847.58,567804.96
510336,201807,49,35,14,33390,13356,46746
510337,201807,120,49,71,46736.46,67724.46,114460.92
510340,201807,17323,8284,9039,7881003.64,8613844.88,16494848.52
510343,201807,72,51,21,48644.46,20034,68678.46
510345,201807,159,105,54,100160.46,51210.92,151371.38
510350,201807,673,375,298,356817.07,284227.38,641044.45
510360,201807,197,118,79,112563,75292.92,187855.92
510370,201807,144,73,71,69613.38,67611.6,137224.98
510380,201807,90,63,27,60102,25749,85851
510385,201807,58,27,31,25758,29565,55323
510390,201807,120,50,70,47700,66741.84,114441.84
510395,201807,42,31,11,29574,10494,40068
510410,201807,710,474,236,452192,225120.69,677312.69
510420,201807,583,281,302,267138.34,286726.15,553864.49
510450,201807,53,30,23,28620,21942,50562
510452,201807,44,26,18,24804,17172,41976
510454,201807,59,27,32,25758,30518.46,56276.46
510455,201807,128,80,48,76300.92,45792,122092.92
510460,201807,186,99,87,94265.92,82960.38,177226.30
510480,201807,752,433,319,411955.81,303988.36,715944.17
510490,201807,355,182,173,173258.34,164556.16,337814.50
510500,201807,253,192,61,183158.46,58194,241352.46
510510,201807,798,456,342,434423.72,326239.38,760663.10
510515,201807,1173,614,559,585396.38,533239.38,1118635.76
510517,201807,250,105,145,99883.8,138306.69,238190.49
510520,201807,238,156,82,148730.76,77917.84,226648.60
510523,201807,93,66,27,62964,25748.46,88712.46
510525,201807,742,421,321,400879.84,306123.3,707003.14
510530,201807,15,11,4,10494,3816,14310
510550,201807,268,118,150,112563,143091,255654
510558,201807,273,135,138,128757.15,131623.92,260381.07
510560,201807,402,245,157,233444,149760,383204
510562,201807,634,447,187,425107.17,177911.46,603018.63
510590,201807,804,418,386,398715.84,368216.69,766932.53
510600,201807,259,143,116,136398.92,110626.92,247025.84
510610,201807,172,83,89,79162.92,84610.46,163773.38
510615,201807,198,84,114,80116.92,108756,188872.92
510617,201807,19,11,8,10494,7632,18126
510618,201807,118,55,63,52470,59625,112095
510619,201807,102,72,30,68679,28611,97290
510620,201807,184,101,83,96344.46,79182,175526.46
510621,201807,198,125,73,119231.46,69614.46,188845.92
510622,201807,456,292,164,278475.84,156141.92,434617.76
510623,201807,349,236,113,225087.84,107773.38,332861.22
510624,201807,86,43,43,41013,41022,82035
510625,201807,536,330,206,314619.3,195946.52,510565.82
510626,201807,107,69,38,65826,36252,102078
510627,201807,61,43,18,41022,17172,58194
510628,201807,161,97,64,92491.92,60998.76,153490.68
510629,201807,257,164,93,156456,87758.46,244214.46
510630,201807,469,239,230,227921.22,219073.95,446995.17
510631,201807,11,3,8,2862,7346,10208
510637,201807,343,194,149,184730.18,142008.84,326739.02
510642,201807,975,545,430,519588.18,410077.44,929665.62
510645,201807,0,0,0,0,0,0
510650,201807,1475,978,497,932867.92,474006.76,1406874.68
510665,201807,86,43,43,40966,41022,81988
510670,201807,65,37,28,35298,26712,62010
510675,201807,1161,701,460,668722.23,438817.23,1107539.46
510677,201807,359,176,183,166898.84,174452.22,341351.06
510680,201807,102,60,42,57222,40059,97281
510682,201807,199,98,101,93170,96354,189524
510685,201807,53,38,15,36252,14310,50562
510700,201807,618,360,258,343283.92,245998.76,589282.68
510704,201807,1088,590,498,560452.08,473470.82,1033922.90
510706,201807,128,64,64,61051.23,61018.92,122070.15
510710,201807,392,266,126,252774.24,120089.68,372863.92
510715,201807,63,47,16,44828.46,15264,60092.46
510718,201807,210,116,94,110570.76,89666.46,200237.22
510719,201807,36,19,17,18126,16218,34344
510720,201807,197,132,65,125919,61723.8,187642.8
510724,201807,91,36,55,34334.46,52437.38,86771.84
510726,201807,55,28,27,26702.46,25740,52442.46
510729,201807,75,34,41,32436,39075.84,71511.84
510730,201807,471,266,205,253746,195422.46,449168.46
510735,201807,110,42,68,40068,64872,104940
510740,201807,30,17,13,16218,12402,28620
510757,201807,20,16,4,15264,3816,19080
510760,201807,7057,3725,3332,3544100.29,3173474.11,6717574.40
510770,201807,715,341,374,325116.3,356610.3,681726.6
510774,201807,16,6,10,5724,9540,15264
510775,201807,114,86,28,82034.46,26702.46,108736.92
510776,201807,28,7,21,6678,20034,26712
510777,201807,184,81,103,77245.38,98233.38,175478.76
510779,201807,50,23,27,21933,25720.92,47653.92
510780,201807,292,164,128,156393.46,122047,278440.46
510785,201807,446,241,205,229857.84,195503.22,425361.06
510787,201807,190,95,95,90621,90612.23,181233.23
510788,201807,0,0,0,0,0,0
510790,201807,2413,1258,1155,1198272.4,1099871.28,2298143.68
510792,201807,1095,622,473,592605.47,450826.34,1043431.81
510794,201807,119,60,59,57240,56257.92,113497.92
510795,201807,2391,1383,1008,1312562.11,958968.8,2271530.91
510800,201807,187,114,73,108737.46,69633,178370.46
510805,201807,170,116,54,110664,51516,162180
510810,201807,96,40,56,38077.38,53299.98,91377.36
510820,201807,257,120,137,114053.46,129698.03,243751.49
510830,201807,67,41,26,39114,24795,63909
510835,201807,7,5,2,4770,1908,6678
510840,201807,9280,4580,4700,4353904.88,4476417.92,8830322.80
510850,201807,213,88,125,83942.46,119212.38,203154.84
510860,201807,382,166,216,158186.52,205402.42,363588.94
510880,201807,66,50,16,47681.46,15264,62945.46
510885,201807,71,43,28,41003.46,26683.38,67686.84
510890,201807,70,40,30,38160,28620,66780
510895,201807,184,108,76,103032,72195.46,175227.46
520005,201807,35,24,11,22896,10494,33390
520010,201807,276,124,152,118296,144913,263209
520013,201807,643,391,252,372986,240121.8,613107.8
520015,201807,51,37,14,35298,13356,48654
520017,201807,99,58,41,55046,39114,94160
520020,201807,25,13,12,12402,11448,23850
520025,201807,2009,1088,921,1036769.24,877194.4,1913963.64
520030,201807,791,407,384,387315,365715.9,753030.9
520050,201807,77,52,25,49608,23850,73458
520055,201807,44,30,14,28620,13356,41976
520060,201807,176,113,63,107802,60102,167904
520080,201807,597,423,174,402619.1,165996,568615.1
520082,201807,20,14,6,13356,5724,19080
520085,201807,102,75,27,71550,25758,97308
520090,201807,91,63,28,60102,26712,86814
520110,201807,9065,3945,5120,3758388.68,4881841.18,8640229.86
520120,201807,14,8,6,7431.66,5724,13155.66
520130,201807,768,533,235,508186.8,223751.9,731938.7
520140,201807,11757,6650,5107,6336285.08,4869725.77,11206010.85
520145,201807,46,34,12,32436,11448,43884
520150,201807,189,147,42,140238,40068,180306
520160,201807,30,23,7,21942,6678,28620
520170,201807,230,143,87,136390,82961,219351
520180,201807,134,72,62,68688,59148,127836
520215,201807,217,134,83,127549.8,78895.8,206445.6
520235,201807,70,53,17,50562,16218,66780
520250,201807,135,81,54,77274,51229.8,128503.8
520260,201807,111,68,43,64872,40068,104940
520280,201807,46,32,14,29861,13356,43217
520310,201807,39,26,13,24804,12402,37206
520320,201807,168,106,62,101114.46,59148,160262.46
520330,201807,789,412,377,393002.46,359631,752633.46
520340,201807,348,197,151,187938,144035.46,331973.46
520350,201807,521,236,285,225144,271843,496987
520355,201807,86,51,35,48654,33390,82044
520357,201807,24,17,7,16218,6678,22896
520360,201807,1,1,0,954,0,954
520380,201807,141,72,69,68688,65826,134514
520390,201807,279,118,161,112095,153331.5,265426.5
520393,201807,14,11,3,10494,2862,13356
520396,201807,98,59,39,56286,37206,93492
520400,201807,222,131,91,123353.2,86814,210167.2
520410,201807,198,101,97,96345,92529,188874
520420,201807,22,15,7,14310,6678,20988
520425,201807,302,133,169,125929,160750.2,286679.2
520430,201807,459,236,223,224857.8,212686,437543.8
520440,201807,611,414,197,394956,187918.92,582874.92
520450,201807,1934,867,1067,826289.46,1016995.32,1843284.78
520455,201807,60,43,17,41022,16218,57240
520460,201807,32,16,16,15264,15264,30528
520465,201807,24,21,3,20034,2862,22896
520470,201807,419,259,160,246780.63,152640,399420.63
520480,201807,80,46,34,43884,32391,76275
520485,201807,124,43,81,41022,76988,118010
520490,201807,410,299,111,285061.98,105894,390955.98
520495,201807,172,105,67,100170,63918,164088
520500,201807,173,130,43,124020,41022,165042
520505,201807,177,91,86,86809.23,82044,168853.23
520510,201807,1765,875,890,832359.68,846832.02,1679191.70
520520,201807,34,27,7,25758,6678,32436
520530,201807,231,173,58,163318.12,55322.46,218640.58
520540,201807,524,351,173,333547.02,165042,498589.02
520545,201807,153,89,64,84906,61056,145962
520547,201807,54,30,24,28620,22896,51516
520549,201807,1150,560,590,533916,562742,1096658
520551,201807,292,152,140,145008,133274,278282
520552,201807,46,27,19,25758,18126,43884
520570,201807,16,9,7,8586,6678,15264
520580,201807,284,171,113,163124.46,107802,270926.46
520590,201807,163,99,64,94446,60769.8,155215.8
520620,201807,1175,550,625,523842.48,595954.26,1119796.74
520630,201807,43,26,17,24804,16218,41022
520640,201807,411,234,177,223236,168858,392094
520650,201807,60,40,20,38160,19080,57240
520660,201807,36,19,17,18117,16218,34335
520670,201807,35,30,5,28620,4770,33390
520680,201807,56,37,19,35298,18126,53424
520690,201807,32,10,22,9540,20959.92,30499.92
520710,201807,39,35,4,33390,3816,37206
520725,201807,196,125,71,119250,67734,186984
520735,201807,59,41,18,39114,17172,56286
520740,201807,410,202,208,191993.4,198423,390416.4
520750,201807,36,27,9,25758,8586,34344
520753,201807,55,37,18,35298,17172,52470
520760,201807,113,77,36,73458,34344,107802
520780,201807,291,220,71,209880,67715,277595
520790,201807,165,84,81,79849.8,77274,157123.8
520800,201807,3453,1848,1605,1760595.06,1530636,3291231.06
520810,201807,172,125,47,119090.6,44838,163928.6
520815,201807,5,5,0,4770,0,4770
520830,201807,138,92,46,87768,43597.8,131365.8
520840,201807,349,230,119,218943,113526,332469
520850,201807,113,72,41,68669.46,38961.36,107630.82
520860,201807,1691,1080,611,1028899.54,581750.2,1610649.74
520870,201807,30885,15203,15682,14476145.76,14944547.36,29420693.12
520880,201807,1084,590,494,562860,471256.92,1034116.92
520890,201807,804,469,335,445795.4,319485.46,765280.86
520910,201807,1028,544,484,514731.94,461736,976467.94
520915,201807,102,77,25,73458,23840.46,97298.46
520920,201807,405,199,206,189273.6,196514.46,385788.06
520929,201807,17,16,1,15264,954,16218
520940,201807,76,49,27,46746,25758,72504
520945,201807,21,13,8,12402,7632,20034
520960,201807,46,30,16,28620,15264,43884
520970,201807,319,200,119,189884.8,113239.8,303124.6
520980,201807,84,64,20,61056,19080,80136
520990,201807,479,322,157,307188,149778,456966
520993,201807,129,62,67,59148,63918,123066
520995,201807,242,135,107,127837,101506,229343
521000,201807,1582,929,653,884263.6,622581,1506844.6
521010,201807,669,312,357,297321.36,340511.76,637833.12
521015,201807,18,11,7,10494,6678,17172
521020,201807,1458,1021,437,973404.9,416484.7,1389889.6
521030,201807,46,33,13,31482,12402,43884
521040,201807,945,581,364,554036.2,346970,901006.2
521056,201807,41,29,12,27666,11448,39114
521060,201807,133,84,49,80136,46746,126882
521080,201807,464,348,116,331983,110664,442647
521090,201807,528,316,212,299837.43,202248,502085.43
521100,201807,277,206,71,196515,67734,264249
521120,201807,1056,732,324,697755.8,308801,1006556.8
521130,201807,363,260,103,248030.46,97376.6,345407.06
521140,201807,185,105,80,100170,76320,176490
521150,201807,2793,1218,1575,1160107.88,1501277.49,2661385.37
521160,201807,32,17,15,16218,14310,30528
521170,201807,195,115,80,109700.46,76320,186020.46
521180,201807,1139,719,420,684295.26,399965.2,1084260.46
521190,201807,2536,1074,1462,1024576.92,1393968.72,2418545.64
521200,201807,47,34,13,32436,12402,44838
521205,201807,12,9,3,8586,2862,11448
521210,201807,143,82,61,78228,58194,136422
521220,201807,820,562,258,533515.76,246076,779591.76
521225,201807,31,20,11,19080,10494,29574
521230,201807,109,72,37,68401.8,35298,103699.8
521250,201807,6240,3585,2655,3413574.3,2530277.26,5943851.56
521260,201807,23,15,8,14310,7632,21942
521270,201807,141,109,32,103986,30528,134514
521280,201807,437,260,177,246831.6,168858,415689.6
521290,201807,30,11,19,10494,18126,28620
521295,201807,98,66,32,62735.04,30528,93263.04
521300,201807,228,117,111,111600,105543.38,217143.38
521305,201807,35,24,11,22896,10494,33390
521308,201807,1096,814,282,776305.68,268733,1045038.68
521310,201807,1352,801,551,762106.4,524462.92,1286569.32
521340,201807,18,15,3,14310,2862,17172
521350,201807,131,96,35,91584,33390,124974
521370,201807,190,123,67,117055.8,63631.8,180687.6
521375,201807,190,107,83,102078,78895.8,180973.8
521377,201807,52,35,17,33390,16218,49608
521380,201807,1094,716,378,678678.22,360612,1039290.22
521385,201807,15,8,7,7632,6678,14310
521390,201807,106,85,21,80772.04,20034,100806.04
521400,201807,329,211,118,201007.8,112524.3,313532.1
521405,201807,149,78,71,74412,67734,142146
521410,201807,63,42,21,40068,20034,60102
521440,201807,204,145,59,137519.1,56286,193805.1
521450,201807,721,397,324,378738,309096,687834
521460,201807,1189,732,457,698041.8,435958.92,1134000.72
521470,201807,14,9,5,8586,4770,13356
521480,201807,47,32,15,30501,14245,44746
521483,201807,314,170,144,161894,137376,299270
521486,201807,284,182,102,172836.18,96641,269477.18
521487,201807,22,11,11,10494,10494,20988
521490,201807,27,16,11,15264,10494,25758
521500,201807,117,76,41,72504,39114,111618
521520,201807,41,29,12,27666,11448,39114
521523,201807,618,380,238,359203.32,227052,586255.32
521525,201807,45,30,15,28620,14023.8,42643.8
521530,201807,250,133,117,126882,111618,238500
521540,201807,31,17,14,16218,13356,29574
521550,201807,89,40,49,37845.92,46690.92,84536.84
521560,201807,804,545,259,519644,246943,766587
521565,201807,54,37,17,35298,16218,51516
521570,201807,503,338,165,322442.46,157315.3,479757.76
521580,201807,59,37,22,35298,20988,56286
521590,201807,38,20,18,19080,17172,36252
521600,201807,28,17,11,16218,10494,26712
521630,201807,242,123,119,117332.46,112535.96,229868.42
521640,201807,302,156,146,148824,139284,288108
521645,201807,30,16,14,15264,13356,28620
521680,201807,221,140,81,133560,77274,210834
521690,201807,2,2,0,1908,0,1908
521710,201807,1181,554,627,527943.8,597862.8,1125806.6
521720,201807,541,368,173,351062.46,165004.46,516066.92
521730,201807,630,304,326,289921,309897.56,599818.56
521740,201807,917,373,544,355528.46,517785.32,873313.78
521760,201807,1627,898,729,855114.63,695152,1550266.63
521770,201807,809,512,297,488448,282870.54,771318.54
521800,201807,2065,1286,779,1223302.02,741788.1,1965090.12
521805,201807,34,19,15,18126,14310,32436
521810,201807,92,58,34,54187.8,32436,86623.8
521830,201807,957,679,278,645572.22,265203,910775.22
521839,201807,91,60,31,57240,29574,86814
521850,201807,1127,599,528,570026.92,503387.68,1073414.60
521860,201807,347,213,134,203202,127550,330752
521870,201807,73,42,31,40068,29574,69642
521878,201807,42,20,22,19080,20988,40068
521880,201807,4569,2066,2503,1968694.36,2386352.96,4355047.32
521890,201807,588,414,174,394178.62,165709.8,559888.42
521900,201807,295,237,58,225461.96,55332,280793.96
521910,201807,150,104,46,99216,43884,143100
521920,201807,54,27,27,25758,25758,51516
521925,201807,36,21,15,20034,14310,34344
521930,201807,1123,639,484,609409.98,461101.88,1070511.86
521935,201807,34,26,8,24804,7632,32436
521940,201807,189,96,93,91584,88717.23,180301.23
521945,201807,14,12,2,11448,1908,13356
521950,201807,9,5,4,4770,3816,8586
521960,201807,77,57,20,54378,19080,73458
521970,201807,420,269,151,256339.8,144054,400393.8
521971,201807,96,49,47,46746,44838,91584
521973,201807,28,13,15,12402,14310,26712
521975,201807,1182,602,580,574117.2,552404.66,1126521.86
521980,201807,243,167,76,159318,72504,231822
521990,201807,73,53,20,50562,19080,69642
522000,201807,288,183,105,174582,100170,274752
522005,201807,20,12,8,11448,7632,19080
522010,201807,1139,635,504,605781,480243.6,1086024.6
522015,201807,54,33,21,31473,20034,51507
522020,201807,862,465,397,442656.2,377956.12,820612.32
522026,201807,28,20,8,19080,7632,26712
522028,201807,16,12,4,11448,3816,15264
522040,201807,747,297,450,283320,429245.46,712565.46
522045,201807,2147,1359,788,1295740.26,751218.8,2046959.06
522050,201807,167,81,86,77274,82044,159318
522060,201807,561,353,208,336475.8,198336.6,534812.4
522068,201807,134,89,45,84619.8,42930,127549.8
522070,201807,11,11,0,10494,0,10494
522100,201807,46,25,21,23850,20034,43884
522108,201807,38,29,9,27666,8586,36252
522119,201807,55,29,26,27666,24804,52470
522130,201807,75,28,47,26703,44811,71514
522140,201807,3765,1910,1855,1817653.28,1767515.44,3585168.72
522145,201807,52,32,20,30528,19080,49608
522150,201807,65,50,15,47700,14310,62010
522155,201807,58,39,19,37197,18126,55323
522157,201807,4,3,1,2862,954,3816
522160,201807,1739,1020,719,971935.2,685630.8,1657566.0
522170,201807,394,265,129,252810,123066,375876
522180,201807,37,20,17,19080,16218,35298
522185,201807,1967,762,1205,723641.26,1149049,1872690.26
522190,201807,49,28,21,26712,19938.6,46650.6
522200,201807,296,179,117,170766,111618,282384
522205,201807,167,113,54,107802,51516,159318
522220,201807,162,117,45,111618,42930,154548
522230,201807,32,26,6,24804,5724,30528
530010,201807,55619,28578,27041,27125362.26,25748134.67,52873496.93
110001,201808,520,411,109,391130.46,103340.96,494471.42
110002,201808,2787,1696,1091,1616737.76,1039916.49,2656654.25
110003,201808,95,75,20,71064,19080,90144
110004,201808,2010,1300,710,1238077.73,677044.26,1915121.99
110005,201808,438,353,85,335606.9,81090,416696.9
110006,201808,456,353,103,335721.75,98242.92,433964.67
110007,201808,82,65,17,62010,16218,78228
110008,201808,241,134,107,126600.9,102078,228678.9
110009,201808,800,553,247,525654.86,235439,761093.86
110010,201808,1808,1117,691,1064415.27,658910.21,1723325.48
110011,201808,1862,1443,419,1374968.2,399716.46,1774684.66
110012,201808,4140,2399,1741,2282227.42,1659823.12,3942050.54
110013,201808,771,591,180,563804.46,171720,735524.46
110014,201808,377,323,54,307378.8,51516,358894.8
110015,201808,1430,1154,276,1097897.13,263284.92,1361182.05
110018,201808,1123,678,445,646498,424517.23,1071015.23
110020,201808,15444,9060,6384,8599538.77,6081583.65,14681122.42
110025,201808,657,488,169,462361.02,161217,623578.02
110026,201808,41,28,13,26712,12402,39114
110028,201808,1642,1194,448,1134474.59,424370.95,1558845.54
110029,201808,138,122,16,116388,15264,131652
110030,201808,2478,1677,801,1597051.36,763253.46,2360304.82
110032,201808,389,304,85,289707,81086,370793
110033,201808,677,504,173,477813,164755.8,642568.8
110034,201808,371,272,99,257176,93779,350955
110037,201808,103,86,17,82044,16218,98262
110040,201808,347,238,109,227052,103986,331038
110045,201808,948,642,306,610943,290220.39,901163.39
110050,201808,96,79,17,75080,16218,91298
110060,201808,86,46,40,43884,38160,82044
110070,201808,119,72,47,68688,44552,113240
110080,201808,408,248,160,234082.98,152616.15,386699.13
110090,201808,34,28,6,26712,5724,32436
110092,201808,107,59,48,56286,45722,102008
110094,201808,195,140,55,133560,52470,186030
110100,201808,31,25,6,23850,5724,29574
110110,201808,65,40,25,38160,23850,62010
110120,201808,72,59,13,56286,12402,68688
110130,201808,300,244,56,231301.12,53424,284725.12
110140,201808,244,159,85,151495.2,81080.46,232575.66
110143,201808,52,44,8,41976,7632,49608
110145,201808,25,19,6,18126,5724,23850
110146,201808,24,12,12,11448,11448,22896
110147,201808,38,30,8,28620,7632,36252
110148,201808,40,28,12,26660.57,11448,38108.57
110149,201808,299,215,84,204823.8,80136,284959.8
110150,201808,86,60,26,57240,24804,82044
110155,201808,8,7,1,6678,954,7632
110160,201808,71,60,11,57240,10494,67734
110170,201808,204,165,39,157410,36919.8,194329.8
110175,201808,44,32,12,30528,11448,41976
110180,201808,94,81,13,77274,12402,89676
120001,201808,139,96,43,91584,41014,132598
120005,201808,192,120,72,114459,68688,183147
120010,201808,1034,668,366,633262.1,348639.8,981901.9
120013,201808,147,102,45,97232.82,42739.2,139972.02
120017,201808,92,57,35,54334.24,33369,87703.24
120020,201808,3584,2862,722,2708706.07,686398.23,3395104.30
120025,201808,586,332,254,314637.1,241424.48,556061.58
120030,201808,1038,869,169,821061.22,160511,981572.22
120032,201808,49,41,8,39114,7632,46746
120033,201808,219,191,28,181866.75,26712,208578.75
120034,201808,157,113,44,105894,41976,147870
120035,201808,30,22,8,20988,7632,28620
120038,201808,390,252,138,239646.88,131608.24,371255.12
120039,201808,22,21,1,20034,954,20988
120040,201808,14134,9800,4334,9286760.44,4124283.17,13411043.61
120042,201808,47,41,6,39114,5724,44838
120043,201808,12,3,9,2862,8586,11448
120045,201808,537,347,190,328468.8,180233.7,508702.5
120050,201808,1269,968,301,917161.44,287149.23,1204310.67
120060,201808,1433,1166,267,1108526.12,253764,1362290.12
120070,201808,506,363,143,342624.04,136412.46,479036.50
120080,201808,166,105,61,99661.58,57911.74,157573.32
130002,201808,149,104,45,99216,42930,142146
130006,201808,76,43,33,41022,31482,72504
130008,201808,143,76,67,71805.6,63239.72,135045.32
130010,201808,139,76,63,72482.12,60102,132584.12
130014,201808,245,177,68,168858,64872,233730
130020,201808,94,50,44,47700,41976,89676
130030,201808,907,549,358,523746,341522.46,865268.46
130040,201808,317,160,157,152640,148824.28,301464.28
130050,201808,569,309,260,294499.8,248040,542539.8
130060,201808,876,599,277,566318.2,261876.6,828194.8
130063,201808,581,325,256,310050,244158.36,554208.36
130068,201808,188,123,65,117342,61723.8,179065.8
130070,201808,1329,917,412,864799.42,389542.92,1254342.34
130080,201808,660,432,228,411746.4,217503,629249.4
130083,201808,72,39,33,36942,31482,68424
130090,201808,373,193,180,182442.96,171720,354162.96
130100,201808,1134,512,622,488448,593101.8,1081549.8
130110,201808,701,307,394,292728,375876,668604
130115,201808,175,72,103,68688,98262,166950
130120,201808,1633,1021,612,974034,583848,1557882
130130,201808,633,435,198,414990,188892,603882
130140,201808,1504,1132,372,1079307.9,353934.2,1433242.1
130150,201808,422,359,63,342486,60102,402588
130160,201808,471,269,202,256626,192708,449334
130165,201808,26,18,8,17172,7632,24804
130170,201808,971,700,271,667729.4,258534,926263.4
130180,201808,147,89,58,84906,55332,140238
130185,201808,2337,1211,1126,1153386,1073612.92,2226998.92
130190,201808,3616,2261,1355,2152194.28,1291367.99,3443562.27
130195,201808,290,232,58,221328,55332,276660
130200,201808,173,80,93,76310.46,88722,165032.46
130210,201808,80,40,40,38160,38160,76320
130220,201808,184,127,57,121158,54378,175536
130230,201808,333,208,125,198432,119250,317682
130240,201808,1435,908,527,864892.4,502180.83,1367073.23
130250,201808,4807,3117,1690,2966763.63,1612126.57,4578890.20
130255,201808,424,207,217,197478,206731.8,404209.8
130260,201808,54319,26193,28126,24952229.46,26825553.54,51777783.00
130270,201808,1524,990,534,943983,509436,1453419
130280,201808,115,71,44,67734,41976,109710
130290,201808,2109,1533,576,1461815,549217.8,2011032.8
130300,201808,433,308,125,293545.8,119250,412795.8
130310,201808,891,466,425,444564,405450,850014
130320,201808,455,244,211,231822,201294,433116
130330,201808,703,422,281,402588,267787.8,670375.8
130340,201808,3347,1997,1350,1900845.4,1286183,3187028.4
130350,201808,468,301,167,287132.12,159318,446450.12
130353,201808,821,342,479,325982,456966,782948
130356,201808,807,371,436,353934,415929.77,769863.77
130360,201808,67,41,26,39114,24804,63918
130370,201808,683,510,173,486540,165042,651582
130380,201808,612,423,189,403542,180306,583848
130390,201808,491,390,101,372060,96354,468414
130395,201808,181,40,141,38160,134514,172674
130400,201808,70,45,25,42930,23850,66780
130406,201808,2086,1293,793,1229908.3,755290.76,1985199.06
130410,201808,480,205,275,195570,262330.92,457900.92
130420,201808,3183,2571,612,2448947.32,583848,3032795.32
130423,201808,161,76,85,72504,81090,153594
130426,201808,147,87,60,82998,57240,140238
130430,201808,409,270,139,257580,132606,390186
130440,201808,203,68,135,64872,128790,193662
140002,201808,34,13,21,12402,20034,32436
140005,201808,205,126,79,119965.5,75366,195331.5
140010,201808,10288,6940,3348,6583588.52,3191984.83,9775573.35
140015,201808,151,66,85,62964,81090,144054
140017,201808,118,80,38,76320,36252,112572
140020,201808,478,321,157,305280,149778,455058
140023,201808,32,17,15,15999,14310,30309
140028,201808,19,12,7,11448,6678,18126
140030,201808,349,249,100,237546,94798.98,332344.98
140040,201808,57,40,17,38160,16122.6,54282.6
140045,201808,244,112,132,106848,125928,232776
140047,201808,596,410,186,389128.39,176681,565809.39
140050,201808,149,96,53,90771,50562,141333
140060,201808,37,26,11,24069.42,10494,34563.42
140070,201808,33,30,3,27866.05,2862,30728.05
150010,201808,4702,2923,1779,2786634.4,1694973,4481607.4
150013,201808,151,106,45,101124,42930,144054
150020,201808,1053,570,483,543780,460782,1004562
150030,201808,718,293,425,279522,405450,684972
150034,201808,199,127,72,121158,68688,189846
150040,201808,1402,842,560,803268,534240,1337508
150050,201808,679,404,275,384414.8,262150,646564.8
150060,201808,4742,3070,1672,2925594.37,1594840.5,4520434.87
150070,201808,315,144,171,137376,163134,300510
150080,201808,14414,7259,7155,6914838.73,6818633.81,13733472.54
150085,201808,397,248,149,236582.46,142146,378728.46
150090,201808,758,645,113,615330,107802,723132
150095,201808,345,216,129,205294.12,122245.56,327539.68
150100,201808,57,40,17,38160,16218,54378
150110,201808,173,83,90,79182,85860,165042
150120,201808,429,318,111,303372,105894,409266
150125,201808,55,23,32,21942,30528,52470
150130,201808,1915,1028,887,980712,846193.23,1826905.23
150140,201808,54302,25443,28859,24237865.06,27516793.26,51754658.32
150145,201808,183,105,78,100170,74412,174582
150150,201808,2832,1303,1529,1242844.49,1455246.31,2698090.80
150157,201808,428,299,129,285246,123061.23,408307.23
150160,201808,122,97,25,92538,23850,116388
150170,201808,3665,2721,944,2594641.5,900289.8,3494931.3
150172,201808,324,223,101,212742,96354,309096
150175,201808,84,51,33,48654,31482,80136
150178,201808,766,514,252,489402,240408,729810
150180,201808,3090,1499,1591,1429808,1517499.38,2947307.38
150190,201808,330,213,117,203202,111618,314820
150195,201808,124,62,62,59148,59148,118296
150200,201808,201,96,105,91584,100170,191754
150210,201808,3159,2562,597,2443089.86,568532.5,3011622.36
150215,201808,524,344,180,328176,171434,499610
150220,201808,3848,2618,1230,2496012.8,1171302.32,3667315.12
150230,201808,1145,927,218,883778.04,207972,1091750.04
150240,201808,5795,3433,2362,3271926.73,2253339,5525265.73
150250,201808,33,16,17,15264,16218,31482
150260,201808,77,47,30,44838,28620,73458
150270,201808,2353,1534,819,1462401.7,780448.72,2242850.42
150275,201808,561,347,214,331038,204156,535194
150276,201808,111,48,63,45792,60102,105894
150277,201808,770,328,442,312893.46,421668,734561.46
150280,201808,339,209,130,199386,124020,323406
150285,201808,75,38,37,36252,35298,71550
150290,201808,971,594,377,566380.26,359372,925752.26
150293,201808,666,312,354,297638.46,337716,635354.46
150295,201808,475,217,258,207018,245979.44,452997.44
150300,201808,77,40,37,38160,35298,73458
150304,201808,150,101,49,96354,46746,143100
150307,201808,391,322,69,307188,65826,373014
150309,201808,565,412,153,393048,145962,539010
150310,201808,258,174,84,165996,80136,246132
150320,201808,1778,1232,546,1175046.57,520645.5,1695692.07
150330,201808,2072,1201,871,1145086.2,830934,1976020.2
150340,201808,201,137,64,130459.5,61056,191515.5
150345,201808,606,328,278,312730.74,265212,577942.74
150350,201808,410,323,87,305747.46,82998,388745.46
150360,201808,4578,2951,1627,2811663.46,1552148.46,4363811.92
150370,201808,768,544,224,518210,213400.8,731610.8
150375,201808,196,104,92,99216,87768,186984
150380,201808,1381,935,446,891990,425484,1317474
150390,201808,735,421,314,401630,299556,701186
150400,201808,103,86,17,82044,16218,98262
150405,201808,1258,821,437,781962.48,416325.6,1198288.08
150410,201808,137,90,47,85860,44838,130698
150420,201808,7403,4074,3329,3885232.28,3174194.2,7059426.48
150430,201808,508,341,167,325314,159318,484632
150440,201808,574,342,232,325505,221328,546833
150442,201808,2183,1182,1001,1123564.1,954663.03,2078227.13
150445,201808,518,333,185,317682,175536,493218
150450,201808,263,129,134,123066,127836,250902
150460,201808,757,574,183,545769.09,174562.92,720332.01
150470,201808,1328,805,523,766443.8,498942,1265385.8
150475,201808,220,172,48,164088,45792,209880
150480,201808,1259,878,381,837612,363187.8,1200799.8
150490,201808,608,333,275,317682,262350,580032
150495,201808,332,236,96,225144,91584,316728
150497,201808,302,208,94,198432,89666.46,288098.46
150500,201808,425,289,136,275706,129744,405450
150503,201808,896,437,459,416612,437868,854480
150506,201808,1026,675,351,643950,334844.46,978794.46
150510,201808,1234,697,537,664652,512298,1176950
150520,201808,272,182,90,173628,85860,259488
150530,201808,1588,869,719,825878.3,685926,1511804.3
150540,201808,240,166,74,158364,70596,228960
150543,201808,730,418,312,398180.52,297361.8,695542.32
150548,201808,492,345,147,329130,140238,469368
150549,201808,62,46,16,43884,15264,59148
150550,201808,2865,1512,1353,1441495,1290476,2731971
150553,201808,3155,1868,1287,1780260.6,1227788.46,3008049.06
150555,201808,144,76,68,72504,64872,137376
150560,201808,56,43,13,41022,12402,53424
150563,201808,76,41,35,39114,33390,72504
150565,201808,169,101,68,96354,64872,161226
150570,201808,407,270,137,257560.92,130698,388258.92
150580,201808,1573,699,874,666846,833796,1500642
150590,201808,786,490,296,467460,282384,749844
150600,201808,463,282,181,269028,172674,441702
150610,201808,143,123,20,116493,19080,135573
150611,201808,129,91,38,86814,36252,123066
150613,201808,3235,1995,1240,1903230,1182951,3086181
150616,201808,496,299,197,285008,187938,472946
150618,201808,1219,658,561,627503.58,535194,1162697.58
150619,201808,402,307,95,292878,90630,383508
150620,201808,1273,743,530,708822,505333.8,1214155.8
150630,201808,304,203,101,193662,96354,290016
150635,201808,492,209,283,199386,269982,469368
150640,201808,61,28,33,26712,31482,58194
150650,201808,2328,1380,948,1316196.34,904101.8,2220298.14
150655,201808,245,183,62,174582,59148,233730
150658,201808,108,61,47,58194,44838,103032
150660,201808,496,346,150,330084,143100,473184
150670,201808,1016,376,640,358408.8,610541.46,968950.26
150680,201808,9698,5289,4409,5038248.86,4204136.58,9242385.44
150690,201808,52,32,20,30528,19080,49608
150700,201808,526,339,187,323215.2,178398,501613.2
150710,201808,279,165,114,157410,108756,266166
150715,201808,853,522,331,497005.92,315745.38,812751.30
150720,201808,427,331,96,315774,91297.8,407071.8
150730,201808,941,506,435,482715,414703.8,897418.8
150740,201808,224,158,66,150732,62964,213696
150745,201808,802,439,363,418806,346302,765108
150746,201808,54,33,21,31482,20034,51516
150747,201808,259,205,54,195570,51516,247086
150750,201808,132,75,57,71550,54378,125928
150760,201808,1739,1141,598,1088514,570492,1659006
150770,201808,369,194,175,185076,166774.95,351850.95
150775,201808,97,45,52,42930,49608,92538
150780,201808,189,99,90,94446,85860,180306
150790,201808,864,470,394,448380,375876,824256
150795,201808,1471,859,612,819486,583848,1403334
150796,201808,384,224,160,213696,152640,366336
150797,201808,284,162,122,154548,116388,270936
150800,201808,1414,854,560,813757.23,534226,1347983.23
150803,201808,590,490,100,467460,95400,562860
150805,201808,187,121,66,115434,62950.46,178384.46
150808,201808,998,551,447,525654,426438,952092
150810,201808,3402,2353,1049,2241605.2,999859.18,3241464.38
150812,201808,429,228,201,217512,191754,409266
150815,201808,968,640,328,609181.47,312912,922093.47
150820,201808,1562,959,603,913932,575242.92,1489174.92
150830,201808,824,579,245,550998.38,233730,784728.38
150835,201808,188,112,76,106848,72504,179352
150840,201808,1335,857,478,817578,456012,1273590
160005,201808,50,29,21,27666,20034,47700
160010,201808,199,128,71,122112,67730,189842
160015,201808,114,65,49,62010,46746,108756
160020,201808,127,72,55,68688,52470,121158
160021,201808,43,23,20,21942,19080,41022
160023,201808,115,69,46,65826,43884,109710
160025,201808,31,14,17,13356,16218,29574
160027,201808,1489,846,643,804508.7,612668,1417176.7
160030,201808,15579,8042,7537,7664012.41,7184796.29,14848808.70
160040,201808,314,182,132,173628,125928,299556
160050,201808,690,349,341,332946,324550.8,657496.8
160053,201808,323,187,136,178112,129744,307856
160055,201808,26,19,7,18126,6678,24804
160060,201808,6456,3397,3059,3229956.6,2917328.2,6147284.8
160070,201808,167,103,64,98262,61056,159318
160080,201808,82,44,38,41976,36252,78228
170025,201808,24,14,10,13356,9540,22896
170030,201808,230,188,42,179155,40068,219223
170035,201808,224,106,118,101124,112572,213696
170040,201808,186,142,44,135181.8,41976,177157.8
170070,201808,327,199,128,189846,122112,311958
170100,201808,367,267,100,254718,95400,350118
170105,201808,62,51,11,48654,10494,59148
170110,201808,106,66,40,62964,38160,101124
170130,201808,64,31,33,29574,31196,60770
170190,201808,101,66,35,62964,33390,96354
170200,201808,391,263,128,250225.2,122007.76,372232.96
170210,201808,6006,3160,2846,3005772,2713053.86,5718825.86
170215,201808,100,46,54,43884,51516,95400
170220,201808,1408,1037,371,989011.8,353648,1342659.8
170230,201808,155,101,54,96354,51516,147870
170240,201808,538,358,180,341532,171720,513252
170255,201808,1103,886,217,845034.12,206731.8,1051765.92
170270,201808,38,28,10,26712,9349.2,36061.2
170290,201808,90,66,24,62964,22896,85860
170300,201808,85,57,28,53614.8,26712,80326.8
170305,201808,47,36,11,34344,10494,44838
170307,201808,63,47,16,44838,15264,60102
170310,201808,103,56,47,53424,44838,98262
170320,201808,21,17,4,16218,3816,20034
170330,201808,24,22,2,20988,1908,22896
170360,201808,24,14,10,13356,9540,22896
170370,201808,121,63,58,60102,55332,115434
170380,201808,85,63,22,60102,20988,81090
170382,201808,44,39,5,37206,4770,41976
170384,201808,139,103,36,98262,34344,132606
170386,201808,62,27,35,25758,33390,59148
170388,201808,49,19,30,18126,28620,46746
170389,201808,23,19,4,18126,3816,21942
170390,201808,58,34,24,32427,22896,55323
170410,201808,34,24,10,22896,9540,32436
170460,201808,16,13,3,12402,2862,15264
170510,201808,29,22,7,20988,6678,27666
170550,201808,1515,873,642,832842,611705,1444547
170555,201808,113,79,34,75366,32436,107802
170560,201808,98,72,26,68688,24804,93492
170600,201808,39,19,20,18126,19080,37206
170610,201808,190,101,89,96196.59,84602,180798.59
170625,201808,38,20,18,19080,17172,36252
170650,201808,82,62,20,59148,19080,78228
170700,201808,564,431,133,407296.49,126595.8,533892.29
170710,201808,161,99,62,94446,59139,153585
170720,201808,83,67,16,63918,15264,79182
170730,201808,63,37,26,35298,24804,60102
170740,201808,80,59,21,56286,20034,76320
170755,201808,69,36,33,34344,31482,65826
170765,201808,137,68,69,64586,65826,130412
170770,201808,227,135,92,127692.9,87768,215460.9
170820,201808,595,390,205,372060,195141,567201
170825,201808,31,19,12,18126,11448,29574
170830,201808,81,62,19,59148,18126,77274
170900,201808,197,150,47,143100,44838,187938
170930,201808,822,431,391,410850,372442,783292
170950,201808,3029,1331,1698,1268516.26,1617775.31,2886291.57
170980,201808,18,10,8,9540,7632,17172
171050,201808,138,107,31,102078,29574,131652
171070,201808,38,31,7,29574,6678,36252
171090,201808,41,30,11,28620,10494,39114
171110,201808,20,13,7,12402,6678,19080
171150,201808,41,20,21,19080,20034,39114
171180,201808,22,10,12,9540,11448,20988
171190,201808,144,84,60,80136,57240,137376
171195,201808,64,50,14,47700,13356,61056
171200,201808,48,21,27,20034,25758,45792
171215,201808,3,3,0,2862,0,2862
171240,201808,55,45,10,42930,9540,52470
171245,201808,56,51,5,48654,4770,53424
171250,201808,71,37,34,35298,32426.46,67724.46
171270,201808,17,13,4,12402,3816,16218
171280,201808,39,36,3,34201,2862,37063
171320,201808,995,565,430,539010,408216.6,947226.6
171330,201808,425,205,220,195570,209880,405450
171360,201808,90,65,25,62010,23850,85860
171370,201808,25,13,12,12402,11448,23850
171380,201808,135,110,25,104940,23333.89,128273.89
171395,201808,55,34,21,32436,20034,52470
171420,201808,302,197,105,187938,99883.8,287821.8
171430,201808,66,53,13,50562,12402,62964
171488,201808,198,106,92,101124,87768,188892
171500,201808,58,32,26,30528,24804,55332
171510,201808,67,44,23,41976,21942,63918
171515,201808,43,36,7,34344,6392,40736
171525,201808,30,26,4,24804,3816,28620
171550,201808,12,7,5,6678,4770,11448
171570,201808,60,31,29,29574,27666,57240
171575,201808,335,209,126,199386,120194.46,319580.46
171610,201808,1715,864,851,822356.99,810305.66,1632662.65
171620,201808,133,92,41,87214.68,39114,126328.68
171630,201808,53,29,24,27666,22896,50562
171650,201808,271,180,91,171720,86814,258534
171660,201808,267,144,123,137376,117338,254714
171665,201808,50,34,16,32436,15264,47700
171670,201808,434,253,181,239492.66,172387.8,411880.46
171700,201808,65,57,8,54378,7632,62010
171720,201808,26,9,17,8586,16218,24804
171750,201808,105,57,48,54378,45792,100170
171780,201808,74,59,15,56286,14310,70596
171790,201808,75,64,11,61056,10494,71550
171800,201808,36,28,8,26712,7632,34344
171820,201808,2066,1171,895,1114758.74,849222.82,1963981.56
171830,201808,38,31,7,29574,6678,36252
171840,201808,65,38,27,36252,25758,62010
171845,201808,33,20,13,19080,12402,31482
171850,201808,41,30,11,28620,10494,39114
171855,201808,79,62,17,59148,16218,75366
171865,201808,9,8,1,7632,954,8586
171870,201808,31,22,9,20988,8586,29574
171875,201808,80,55,25,52470,23850,76320
171880,201808,29,19,10,18126,9540,27666
171884,201808,47,24,23,22896,21942,44838
171886,201808,124,46,78,43884,74125.8,118009.8
171888,201808,24,18,6,17172,5724,22896
171889,201808,20,16,4,15264,3816,19080
171890,201808,57,47,10,44838,9540,54378
171900,201808,43,30,13,28620,12402,41022
172000,201808,38,33,5,31482,4770,36252
172010,201808,40,34,6,31625.1,5724,37349.1
172015,201808,25,16,9,14790,8299.8,23089.8
172020,201808,133,85,48,81090,45792,126882
172025,201808,32,21,11,20034,10494,30528
172030,201808,37,22,15,20988,14310,35298
172049,201808,74,46,28,43884,26712,70596
172065,201808,146,93,53,88672,50562,139234
172080,201808,93,64,29,59873.84,27666,87539.84
172085,201808,25,12,13,11448,12402,23850
172090,201808,411,315,96,299713.41,90821,390534.41
172093,201808,24,18,6,17172,5724,22896
172097,201808,16,8,8,7632,7346,14978
172100,201808,4768,2697,2071,2566986.22,1972597.2,4539583.42
172110,201808,82,55,27,52470,25758,78228
172120,201808,1706,1465,241,1391493.65,228787.41,1620281.06
172125,201808,4,4,0,3816,0,3816
172130,201808,16,12,4,11448,3816,15264
172208,201808,193,123,70,117342,66780,184122
172210,201808,409,198,211,188892,201008,389900
210005,201808,2953,1841,1112,1753261.22,1057702,2810963.22
210010,201808,187,96,91,91584,86814,178398
210015,201808,31,21,10,20034,9540,29574
210020,201808,346,185,161,176490,153594,330084
210030,201808,347,219,128,208926,122103,331029
210040,201808,151,117,34,111618,32436,144054
210043,201808,266,183,83,174582,79182,253764
210047,201808,600,324,276,308714.4,263294.46,572008.86
210050,201808,300,219,81,208926,77274,286200
210055,201808,43,33,10,31482,9540,41022
210060,201808,559,443,116,422522.79,110664,533186.79
210070,201808,418,311,107,296694,102078,398772
210080,201808,104,94,10,89676,9540,99216
210083,201808,310,138,172,131652,164088,295740
210087,201808,43,32,11,29726.64,10494,40220.64
210090,201808,488,339,149,323406,142146,465552
210095,201808,487,357,130,340568.46,124020,464588.46
210100,201808,697,532,165,507194.1,156456.02,663650.12
210110,201808,149,84,65,80136,62010,142146
210120,201808,5442,4118,1324,3921653,1261842.68,5183495.68
210125,201808,213,125,88,119250,83952,203202
210130,201808,528,286,242,271890,230848.92,502738.92
210135,201808,34,20,14,19080,13356,32436
210140,201808,4410,3464,946,3301786.16,902246,4204032.16
210150,201808,363,230,133,219420,126882,346302
210160,201808,3398,2862,536,2727488.78,511058,3238546.78
210170,201808,1156,912,244,870048,232776,1102824
210173,201808,123,102,21,97308,20034,117342
210177,201808,448,222,226,211788,215604,427392
210180,201808,32,17,15,16218,14310,30528
210190,201808,419,272,147,259488,140238,399726
210193,201808,1,1,0,954,0,954
210197,201808,78,52,26,49608,24785.88,74393.88
210200,201808,645,511,134,487055.16,127836,614891.16
210203,201808,258,173,85,164756,81090,245846
210207,201808,387,303,84,289062,80136,369198
210210,201808,782,715,67,682110,63918,746028
210215,201808,80,68,12,64872,11448,76320
210220,201808,394,325,69,310050,65539.8,375589.8
210230,201808,310,237,73,226098,69642,295740
210232,201808,1480,949,531,905060,506565,1411625
210235,201808,158,125,33,119060,31482,150542
210237,201808,44,24,20,22896,19080,41976
210240,201808,92,75,17,71550,16218,87768
210250,201808,187,151,36,144054,34344,178398
210255,201808,348,257,91,245178,86814,331992
210260,201808,419,268,151,255672,144054,399726
210270,201808,692,444,248,423576,236592,660168
210275,201808,53,40,13,38160,12402,50562
210280,201808,1049,681,368,646859.33,349736.5,996595.83
210290,201808,501,329,172,313866,164088,477954
210300,201808,6040,3550,2490,3382063.27,2374268.23,5756331.50
210310,201808,106,73,33,69642,31482,101124
210312,201808,122,80,42,76320,40068,116388
210315,201808,115,87,28,82998,26712,109710
210317,201808,127,90,37,85860,35298,121158
210320,201808,2397,1975,422,1882439.84,402588,2285027.84
210325,201808,129,90,39,84906,36920,121826
210330,201808,5416,2820,2596,2685171.43,2476574.46,5161745.89
210340,201808,1379,994,385,947476,367219.07,1314695.07
210350,201808,614,507,107,483439.5,102078,585517.5
210355,201808,136,110,26,104940,24804,129744
210360,201808,2616,1650,966,1570953.6,921278,2492231.6
210370,201808,1245,555,690,529470,658260,1187730
210375,201808,188,97,91,91995,86814,178809
210380,201808,728,544,184,518976,175536,694512
210390,201808,206,171,35,163134,33390,196524
210400,201808,425,359,66,342486,62945,405431
210405,201808,1021,694,327,662076,311958,974034
210407,201808,55,43,12,41022,11448,52470
210408,201808,65,58,7,55332,6678,62010
210409,201808,323,270,53,257580,50562,308142
210410,201808,442,343,99,327222,94437,421659
210420,201808,197,161,36,153594,34344,187938
210430,201808,37,27,10,25758,9540,35298
210440,201808,371,227,144,216558,137376,353934
210450,201808,152,114,38,108756,36252,145008
210455,201808,224,121,103,115434,98262,213696
210460,201808,344,218,126,207972,120204,328176
210462,201808,62,52,10,49608,9540,59148
210465,201808,174,127,47,121158,44838,165996
210467,201808,534,382,152,364428,145008,509436
210470,201808,43,34,9,32436,8586,41022
210480,201808,1320,940,380,896760,362520,1259280
210490,201808,223,137,86,130698,82044,212742
210500,201808,585,310,275,295740,262350,558090
210510,201808,557,432,125,412128,119250,531378
210515,201808,434,243,191,231822,182214,414036
210520,201808,409,358,51,341245.8,48654,389899.8
210530,201808,9452,5053,4399,4808489.27,4188839.23,8997328.50
210535,201808,129,93,36,88722,34344,123066
210540,201808,1556,952,604,907063.8,574785,1481848.8
210542,201808,1191,591,600,563432.4,572114,1135546.4
210545,201808,12,11,1,10494,954,11448
210547,201808,131,112,19,106848,18126,124974
210550,201808,737,523,214,497375,204156,701531
210560,201808,179,150,29,143100,27666,170766
210565,201808,30,22,8,20988,7632,28620
210570,201808,1365,1076,289,1025264.26,275706,1300970.26
210580,201808,110,96,14,91584,13356,104940
210590,201808,774,616,158,586900.8,150732,737632.8
210592,201808,31,27,4,25758,3816,29574
210594,201808,107,88,19,83952,18126,102078
210596,201808,90,75,15,71550,14310,85860
210598,201808,128,92,36,87768,34344,122112
210600,201808,336,284,52,270936,49608,320544
210610,201808,254,235,19,223236,18126,241362
210620,201808,47,27,20,25758,19080,44838
210630,201808,63,60,3,57240,2862,60102
210632,201808,1099,734,365,700236,347733,1047969
210635,201808,18,15,3,14310,2862,17172
210637,201808,105,73,32,69642,30528,100170
210640,201808,592,519,73,495126,69642,564768
210650,201808,417,336,81,319618.62,76320,395938.62
210660,201808,404,295,109,280763,103862,384625
210663,201808,22,11,11,10494,10494,20988
210667,201808,113,36,77,34344,73458,107802
210670,201808,269,236,33,224429,31482,255911
210675,201808,567,299,268,285246,255672,540918
210680,201808,210,133,77,126882,73458,200340
210690,201808,645,514,131,490356,124974,615330
210700,201808,189,140,49,133560,46746,180306
210710,201808,295,168,127,160081.2,121158,281239.2
210720,201808,130,109,21,103986,20034,124020
210725,201808,71,62,9,59148,8586,67734
210730,201808,26,19,7,18126,6678,24804
210735,201808,415,278,137,265212,130412,395624
210740,201808,557,469,88,447426,83952,531378
210745,201808,157,115,42,109710,40068,149778
210750,201808,2438,1110,1328,1056985,1266892.92,2323877.92
210760,201808,270,200,70,190800,66765.69,257565.69
210770,201808,406,314,92,299556,87481.8,387037.8
210780,201808,425,309,116,294786,110664,405450
210790,201808,189,146,43,139284,41022,180306
210800,201808,152,112,40,106848,38160,145008
210805,201808,45,41,4,39114,3816,42930
210810,201808,493,379,114,360898.2,108756,469654.2
210820,201808,2330,1854,476,1760271.41,454104,2214375.41
210825,201808,171,89,82,84906,78228,163134
210830,201808,804,499,305,475092,290016,765108
210840,201808,210,142,68,135468,64872,200340
210845,201808,254,161,93,153594,88722,242316
210850,201808,842,538,304,513252,290016,803268
210860,201808,4127,2149,1978,2048620.3,1886706.72,3935327.02
210870,201808,477,360,117,343440,111618,455058
210880,201808,65,47,18,44838,17172,62010
210890,201808,348,290,58,276660,55332,331992
210900,201808,588,382,206,364424,196524,560948
210905,201808,67,34,33,32436,31482,63918
210910,201808,2012,1493,519,1423031.99,495126,1918157.99
210920,201808,225,68,157,64872,149778,214650
210923,201808,80,58,22,55332,20988,76320
210927,201808,433,184,249,175536,237546,413082
210930,201808,65,52,13,49608,12402,62010
210940,201808,93,71,22,67734,20988,88722
210945,201808,200,94,106,89676,101124,190800
210950,201808,521,377,144,359658,137371.23,497029.23
210955,201808,75,50,25,47700,23850,71550
210960,201808,2428,1055,1373,1004848.4,1309556,2314404.4
210970,201808,116,102,14,97308,13356,110664
210975,201808,91,82,9,78228,8586,86814
210980,201808,1209,533,676,508367.52,644618,1152985.52
210990,201808,4354,2724,1630,2597595.13,1555020,4152615.13
211000,201808,1383,1099,284,1048160,270649.8,1318809.8
211003,201808,928,636,292,606744,278559,885303
211010,201808,498,439,59,418806,56286,475092
211020,201808,1610,592,1018,564768,970952.58,1535720.58
211023,201808,28,24,4,22609.8,3816,26425.8
211027,201808,67,45,22,42930,20988,63918
211030,201808,384,259,125,247086,119250,366336
211040,201808,323,251,72,239168,68688,307856
211050,201808,1180,763,417,727882.92,397527.23,1125410.15
211060,201808,689,584,105,555228,100170,655398
211065,201808,22,18,4,17172,3816,20988
211070,201808,929,756,173,719612.74,165042,884654.74
211080,201808,87,83,4,79182,3816,82998
211085,201808,60,32,28,30242,26712,56954
211090,201808,91,73,18,69642,17172,86814
211100,201808,506,407,99,387991.8,94446,482437.8
211102,201808,263,177,86,168858,82044,250902
211105,201808,222,150,72,143100,68688,211788
211107,201808,136,78,58,74412,55332,129744
211110,201808,830,533,297,507910,283329,791239
211120,201808,5799,2515,3284,2393646.14,3131844.23,5525490.37
211125,201808,32,25,7,23850,6678,30528
211130,201808,45860,19467,26393,18539375.69,25167094.82,43706470.51
211140,201808,431,365,66,347252,62964,410216
211150,201808,1293,826,467,787670.1,445228,1232898.1
211153,201808,166,98,68,93492,64872,158364
211157,201808,64,50,14,47700,13356,61056
211160,201808,716,597,119,568822.5,113526,682348.5
211163,201808,0,0,0,0,0,0
211167,201808,10,8,2,7632,1908,9540
211170,201808,449,314,135,299556,128790,428346
211172,201808,122,85,37,81090,35298,116388
211174,201808,268,161,107,153594,102078,255672
211176,201808,517,374,143,356796,136422,493218
211178,201808,97,62,35,59148,33390,92538
211180,201808,209,164,45,156456,42767.82,199223.82
211190,201808,67,61,6,58194,5724,63918
211195,201808,30,19,11,18126,10494,28620
211200,201808,156,136,20,129400.56,19080,148480.56
211210,201808,521,331,190,315106.2,181260,496366.2
211220,201808,4055,2292,1763,2178725.39,1675565.04,3854290.43
211223,201808,96,91,5,86632.74,4770,91402.74
211227,201808,70,50,20,47700,19080,66780
211230,201808,785,640,145,610560,138310.92,748870.92
211240,201808,417,314,103,299202.86,98262,397464.86
211245,201808,199,89,110,84906,104940,189846
211250,201808,1643,1404,239,1338424.12,228006,1566430.12
211260,201808,828,654,174,623916,165996,789912
211270,201808,2067,1632,435,1556928,414036.2,1970964.2
211280,201808,1861,1125,736,1072296.8,702144,1774440.8
211285,201808,206,120,86,114480,82044,196524
211290,201808,690,465,225,443419.2,214650,658069.2
211300,201808,816,630,186,600742.09,177444,778186.09
211400,201808,1591,910,681,868140,649674,1517814
220005,201808,18,17,1,16218,954,17172
220010,201808,87,67,20,63918,18793.8,82711.8
220020,201808,631,499,132,475061.04,125928,600989.04
220025,201808,108,104,4,99216,3816,103032
220027,201808,37,30,7,28620,6678,35298
220030,201808,98,81,17,77274,16218,93492
220040,201808,1143,864,279,823092.96,266166,1089258.96
220045,201808,39,29,10,27666,9540,37206
220050,201808,671,553,118,526400.96,112552.92,638953.88
220060,201808,176,150,26,143100,24804,167904
220070,201808,99,90,9,85860,8586,94446
220080,201808,11,10,1,9540,954,10494
220090,201808,35,28,7,26712,6678,33390
220095,201808,2,1,1,954,954,1908
220100,201808,27,23,4,21942,3816,25758
220105,201808,26,24,2,22520,1908,24428
220110,201808,213,195,18,185743.8,17172,202915.8
220115,201808,49,46,3,43884,2862,46746
220117,201808,20,18,2,17172,1908,19080
220120,201808,1488,1079,409,1028030.4,390166.92,1418197.32
220130,201808,27,26,1,24804,954,25758
220140,201808,99,78,21,73458,20034,93492
220150,201808,469,336,133,320544,126882,447426
220155,201808,4,4,0,3816,0,3816
220157,201808,18,15,3,14310,2862,17172
220160,201808,76,65,11,62010,10494,72504
220170,201808,38,36,2,34344,1908,36252
220173,201808,7,7,0,6678,0,6678
220177,201808,5,5,0,4770,0,4770
220180,201808,65,64,1,61051.23,954,62005.23
220190,201808,1058,950,108,906300,103032,1009332
220191,201808,44,39,5,37206,4770,41976
220192,201808,68,65,3,62010,2862,64872
220194,201808,42,38,4,36252,3816,40068
220196,201808,104,86,18,82044,17172,99216
220198,201808,5,4,1,3816,954,4770
220200,201808,429,355,74,338337,70596,408933
220202,201808,37,33,4,31482,3816,35298
220205,201808,40,36,4,34344,3816,38160
220207,201808,18,17,1,16218,954,17172
220208,201808,84,45,39,42930,37206,80136
220209,201808,31,28,3,26712,2862,29574
220210,201808,15,13,2,12402,1908,14310
220211,201808,26,26,0,24804,0,24804
220213,201808,43,39,4,37206,3530,40736
220217,201808,37,29,8,27666,7632,35298
220220,201808,2064,1326,738,1261378.8,702649.92,1964028.72
220225,201808,14,7,7,6678,6678,13356
220230,201808,949,747,202,712189.62,192068.82,904258.44
220240,201808,148,135,13,128790,12402,141192
220245,201808,32,29,3,26963.04,2862,29825.04
220250,201808,113,102,11,97308,10494,107802
220253,201808,43,36,7,34344,6678,41022
220255,201808,28,25,3,23850,2862,26712
220260,201808,684,496,188,473184,179352,652536
220265,201808,12,9,3,8586,2862,11448
220270,201808,704,623,81,593616.96,76797,670413.96
220271,201808,43,36,7,34344,6678,41022
220272,201808,27,27,0,25758,0,25758
220273,201808,15,13,2,12402,1908,14310
220275,201808,59,48,11,45792,10494,56286
220277,201808,13,11,2,10494,1908,12402
220280,201808,15,12,3,11448,2862,14310
220285,201808,45,42,3,40068,2862,42930
220290,201808,1413,1207,206,1148186.8,196477,1344663.8
220300,201808,49,47,2,44838,1908,46746
220310,201808,313,264,49,251852,46737,298589
220320,201808,440,407,33,386848,31482,418330
220323,201808,0,0,0,0,0,0
220325,201808,16,11,5,10494,4770,15264
220327,201808,13,12,1,11448,954,12402
220330,201808,206,144,62,137376,59148,196524
220335,201808,134,116,18,110664,17172,127836
220340,201808,28,17,11,16218,10494,26712
220342,201808,56,48,8,45792,7632,53424
220345,201808,86,78,8,74412,7632,82044
220350,201808,431,376,55,356081.42,52470,408551.42
220360,201808,43,31,12,29574,11448,41022
220370,201808,1134,920,214,876916.8,203869.8,1080786.6
220375,201808,26,24,2,22896,1908,24804
220380,201808,40,33,7,31482,6678,38160
220385,201808,26,23,3,21942,2862,24804
220390,201808,2268,1291,977,1226920.55,930961.5,2157882.05
220400,201808,29,26,3,24804,2862,27666
220410,201808,16,15,1,14310,954,15264
220415,201808,14,13,1,12402,954,13356
220420,201808,125,103,22,98262,20701.8,118963.8
220430,201808,130,118,12,110903.8,11448,122351.8
220435,201808,21,15,6,14305.23,5724,20029.23
220440,201808,288,247,41,235638,39114,274752
220450,201808,339,171,168,161968.98,160272,322240.98
220455,201808,55,53,2,50562,1908,52470
220460,201808,18,18,0,16504.2,0,16504.2
220465,201808,106,69,37,65826,35298,101124
220470,201808,243,215,28,205110,26712,231822
220480,201808,72,62,10,59148,9540,68688
220490,201808,87,75,12,71550,11448,82998
220500,201808,100,84,16,80136,15264,95400
220510,201808,381,302,79,287345,75175.2,362520.2
220515,201808,22,19,3,18126,2862,20988
220520,201808,371,333,38,316367,36233,352600
220525,201808,25,17,8,16218,7632,23850
220527,201808,38,29,9,27666,7776,35442
220530,201808,36,14,22,13356,20988,34344
220535,201808,9,8,1,7632,954,8586
220540,201808,59,50,9,47700,8586,56286
220545,201808,57,39,18,37206,17172,54378
220550,201808,651,498,153,474328.8,145962,620290.8
220551,201808,25,19,6,18126,5724,23850
220552,201808,10,10,0,9540,0,9540
220553,201808,49,44,5,41976,4770,46746
220554,201808,13,8,5,7345.8,4770,12115.8
220555,201808,26,23,3,21942,2862,24804
220556,201808,52,48,4,45792,3816,49608
220557,201808,56,50,6,47700,5724,53424
220558,201808,7,2,5,1908,4770,6678
220559,201808,5,5,0,4770,0,4770
220560,201808,60,38,22,36061.2,20988,57049.2
220570,201808,794,483,311,459578.14,296694,756272.14
220580,201808,566,520,46,496060.92,43197.92,539258.84
220585,201808,6,5,1,4770,954,5724
220590,201808,14,14,0,13356,0,13356
220595,201808,59,44,15,41976,14310,56286
220600,201808,24,12,12,11448,11448,22896
220605,201808,20,19,1,18126,954,19080
220610,201808,62,53,9,50562,8586,59148
220620,201808,561,444,117,423337.5,111618,534955.5
220630,201808,6,4,2,3816,1908,5724
220635,201808,37,33,4,31482,3816,35298
220640,201808,97,76,21,72504,20034,92538
220650,201808,113,107,6,102078,5724,107802
220660,201808,33,27,6,25758,5724,31482
220665,201808,4,4,0,3816,0,3816
220667,201808,16,14,2,13356,1908,15264
220669,201808,29,26,3,24804,2862,27666
220670,201808,72,56,16,53424,15264,68688
220672,201808,67,45,22,42930,20988,63918
220675,201808,36,28,8,26712,7632,34344
220680,201808,37,32,5,30528,4770,35298
220690,201808,45,43,2,41022,1908,42930
220695,201808,57,26,31,24804,29574,54378
220700,201808,1576,1209,367,1151544.78,350118,1501662.78
220710,201808,4,2,2,1908,1908,3816
220720,201808,108,88,20,83713.5,18936.9,102650.4
220730,201808,19,18,1,17172,954,18126
220735,201808,3,1,2,954,1908,2862
220740,201808,47,42,5,40068,4770,44838
220750,201808,101,84,17,80136,16218,96354
220755,201808,14,14,0,13356,0,13356
220760,201808,52,49,3,46746,2862,49608
220770,201808,5666,2953,2713,2811872.63,2582078.41,5393951.04
220775,201808,23,11,12,10494,11448,21942
220777,201808,17,16,1,15264,954,16218
220779,201808,17,14,3,13356,2862,16218
220780,201808,878,752,126,716740.2,119918,836658.2
220785,201808,15,9,6,8586,5724,14310
220790,201808,1021,814,207,774154,197478,971632
220793,201808,12,12,0,11448,0,11448
220795,201808,21,20,1,19080,954,20034
220800,201808,3982,3045,937,2902723.93,892921.89,3795645.82
220810,201808,63,55,8,52470,7632,60102
220820,201808,241,219,22,208926,20988,229914
220830,201808,1192,1012,180,965443.23,171701,1137144.23
220840,201808,2356,1640,716,1553670.27,679850.76,2233521.03
220850,201808,53,45,8,42930,7632,50562
220855,201808,13,8,5,7632,4770,12402
220860,201808,8,7,1,6678,954,7632
220865,201808,22,20,2,19080,1908,20988
220870,201808,64,61,3,58194,2862,61056
220880,201808,319,245,74,233062.2,70310,303372.2
220885,201808,40,37,3,35298,2862,38160
220887,201808,17,17,0,16218,0,16218
220890,201808,102,90,12,85860,11448,97308
220900,201808,51,29,22,27666,20988,48654
220910,201808,55,47,8,44838,7632,52470
220915,201808,9,8,1,7632,954,8586
220920,201808,40,36,4,34344,3816,38160
220930,201808,41,40,1,38160,954,39114
220935,201808,16,16,0,15264,0,15264
220937,201808,44,41,3,39114,2862,41976
220940,201808,53,49,4,46746,3816,50562
220945,201808,0,0,0,0,0,0
220950,201808,48,44,4,41976,3816,45792
220955,201808,35,32,3,30528,2862,33390
220960,201808,2,2,0,1908,0,1908
220965,201808,30,27,3,25758,2862,28620
220970,201808,49,42,7,40068,6678,46746
220975,201808,10,9,1,8586,954,9540
220980,201808,32,30,2,28620,1908,30528
220985,201808,69,61,8,58194,7632,65826
220987,201808,31,29,2,27666,1908,29574
220990,201808,16,15,1,14310,954,15264
220995,201808,35,30,5,28620,4770,33390
220997,201808,48,38,10,36252,9540,45792
221000,201808,1142,1028,114,977279.6,108469.8,1085749.4
221005,201808,63,57,6,54378,5724,60102
221010,201808,17,14,3,13356,2862,16218
221020,201808,43,41,2,39114,1908,41022
221030,201808,30,24,6,22896,5724,28620
221035,201808,22,22,0,20988,0,20988
221037,201808,12,6,6,5724,5724,11448
221038,201808,26,23,3,21942,2862,24804
221039,201808,23,23,0,21942,0,21942
221040,201808,261,225,36,214650,34344,248994
221050,201808,235,200,35,190800,33390,224190
221060,201808,1762,1553,209,1479092.76,199386,1678478.76
221062,201808,30,29,1,27666,954,28620
221063,201808,14,10,4,9540,3816,13356
221065,201808,51,44,7,41976,6678,48654
221070,201808,139,120,19,114480,18126,132606
221080,201808,376,333,43,317682,40735.8,358417.8
221090,201808,34,33,1,31482,954,32436
221093,201808,56,37,19,35298,18126,53424
221095,201808,11,10,1,9540,954,10494
221097,201808,20,17,3,16218,2862,19080
221100,201808,24944,14443,10501,13757155.77,10011995.03,23769150.80
221110,201808,1054,780,274,743834,261396,1005230
221120,201808,536,398,138,379406,131652,511058
221130,201808,946,772,174,735248.8,165996,901244.8
221135,201808,36,33,3,31482,2862,34344
221140,201808,41,34,7,32436,6678,39114
221150,201808,14,11,3,10494,2862,13356
221160,201808,12,12,0,11448,0,11448
221170,201808,13,13,0,12402,0,12402
230010,201808,169,155,14,147870,13356,161226
230015,201808,120,100,20,95400,19080,114480
230020,201808,1602,1358,244,1292603.82,231888.56,1524492.38
230030,201808,1639,1184,455,1123967.04,434070,1558037.04
230040,201808,206,181,25,171195.5,23850,195045.5
230050,201808,211,155,56,147870,53424,201294
230060,201808,158,129,29,122302.8,27666,149968.8
230070,201808,284,253,31,241362,29574,270936
230075,201808,840,733,107,697279,101791.8,799070.8
230080,201808,184,158,26,150732,24804,175536
230090,201808,105,74,31,69832.8,29574,99406.8
230100,201808,1959,1167,792,1111012,755549,1866561
230110,201808,2677,1722,955,1640351.24,910497.8,2550849.04
230120,201808,962,768,194,730269.14,185057,915326.14
230125,201808,145,120,25,114480,23850,138330
230130,201808,473,424,49,404496,46746,451242
230140,201808,203,176,27,167904,25758,193662
230150,201808,159,125,34,119250,32436,151686
230160,201808,921,792,129,755091,123066,878157
230170,201808,595,547,48,517325.7,45792,563117.7
230180,201808,77,72,5,68688,4770,73458
230185,201808,405,354,51,336064.63,48654,384718.63
230190,201808,2231,1805,426,1717990.48,406087,2124077.48
230195,201808,493,429,64,409266,61056,470322
230200,201808,378,326,52,310040.46,49608,359648.46
230205,201808,359,234,125,221752.53,119250,341002.53
230210,201808,1265,1010,255,961212.92,242487.8,1203700.72
230220,201808,1448,994,454,947512.8,433097,1380609.8
230230,201808,891,779,112,742975.2,106848,849823.2
230240,201808,1651,1423,228,1356620.7,217512,1574132.7
230250,201808,1781,1472,309,1400127.17,294786,1694913.17
230260,201808,2997,1841,1156,1752742.96,1101870.77,2854613.73
230270,201808,1360,1091,269,1038595.99,255433.5,1294029.49
230280,201808,2739,2036,703,1935945.26,669994.2,2605939.46
230290,201808,402,363,39,341232.71,37206,378438.71
230300,201808,519,385,134,366030.72,127836,493866.72
230310,201808,424,318,106,303224.13,101124,404348.13
230320,201808,936,797,139,756488.01,132606,889094.01
230330,201808,304,244,60,232012.8,57050,289062.8
230340,201808,450,361,89,343441,84906,428347
230350,201808,3061,1942,1119,1852601.22,1064951.28,2917552.50
230360,201808,275,216,59,205268,56286,261554
230365,201808,136,109,27,103271,25758,129029
230370,201808,9794,4844,4950,4611695.94,4718511.88,9330207.82
230380,201808,469,402,67,383222,62964.6,446186.6
230390,201808,516,287,229,272844,218466,491310
230393,201808,266,220,46,208587.96,43884,252471.96
230395,201808,341,276,65,263056,62010,325066
230400,201808,595,472,123,448380,116845.92,565225.92
230410,201808,2626,1641,985,1559123.75,938978,2498101.75
230420,201808,6150,4054,2096,3847273.25,1994998.14,5842271.39
230423,201808,315,273,42,260442,40068,300510
230425,201808,375,310,65,295139,62010,357149
230426,201808,113,99,14,93720.96,13069.8,106790.76
230427,201808,79,76,3,72504,2862,75366
230428,201808,1371,706,665,673256.88,634410,1307666.88
230430,201808,456,371,85,353739.2,81090,434829.2
230435,201808,806,569,237,541674.43,224858.61,766533.04
230440,201808,84495,37437,47058,35625481.52,44841277.71,80466759.23
230445,201808,271,189,82,180115.2,78228,258343.2
230450,201808,541,438,103,417852,98262,516114
230460,201808,59,49,10,46746,9540,56286
230465,201808,305,248,57,236592,54378,290970
230470,201808,1906,1499,407,1430046,387171.1,1817217.1
230480,201808,153,146,7,138997.8,6678,145675.8
230490,201808,285,230,55,219420,52470,271890
230495,201808,438,329,109,312983.38,103986,416969.38
230500,201808,955,715,240,681156,228960,910116
230510,201808,47,38,9,36252,8586,44838
230520,201808,382,303,79,288675,75366,364041
230523,201808,2139,1346,793,1281713.69,756054.92,2037768.61
230526,201808,298,251,47,239454,44047,283501
230530,201808,672,499,173,473757.2,164088.2,637845.4
230533,201808,186,177,9,168858,8586,177444
230535,201808,350,264,86,251856,82044,333900
230540,201808,1837,1609,228,1532342.08,216939.8,1749281.88
230550,201808,3671,2354,1317,2236722.86,1255640.49,3492363.35
230560,201808,577,441,136,419569.4,128790,548359.4
230565,201808,205,150,55,143100,51706.8,194806.8
230570,201808,303,268,35,255672,33390,289062
230580,201808,1108,820,288,780028.64,273798,1053826.64
230590,201808,964,750,214,711924.1,203869.8,915793.9
230600,201808,258,235,23,223446.07,21942,245388.07
230610,201808,336,268,68,255482,64872,320354
230620,201808,170,140,30,132606,28620,161226
230625,201808,722,526,196,500230.7,186116.68,686347.38
230630,201808,1283,1019,264,971840,251474.4,1223314.4
230640,201808,3655,3167,488,3014369.65,464774.57,3479144.22
230650,201808,403,351,52,333932.44,49593.69,383526.13
230655,201808,663,577,86,549504.8,81935.76,631440.56
230660,201808,353,298,55,284292,52183.8,336475.8
230670,201808,427,380,47,362520,44838,407358
230680,201808,198,180,18,171720,17172,188892
230690,201808,871,758,113,723112.92,107802,830914.92
230700,201808,717,609,108,580986,102726.8,683712.8
230710,201808,733,694,39,661599,37206,698805
230720,201808,151,128,23,121720.86,21942,143662.86
230725,201808,248,197,51,187938,48645,236583
230730,201808,11845,6427,5418,6115246.5,5160127.12,11275373.62
230740,201808,647,522,125,497702,118559.46,616261.46
230750,201808,815,693,122,659930.3,116388,776318.3
230760,201808,1341,1159,182,1100953.25,173608.92,1274562.17
230763,201808,316,264,52,249900.95,49608,299508.95
230765,201808,7016,3300,3716,3142612.62,3543802.22,6686414.84
230770,201808,4942,2545,2397,2418175.08,2284706.3,4702881.38
230780,201808,689,605,84,574268.1,80121.69,654389.79
230790,201808,212,177,35,168858,32589.4,201447.4
230800,201808,1127,825,302,786739.95,288108,1074847.95
230810,201808,1308,1163,145,1108500.3,138139.2,1246639.5
230820,201808,339,241,98,228675,93492,322167
230830,201808,937,811,126,770180.41,120204,890384.41
230835,201808,280,241,39,228960,36491,265451
230837,201808,165,140,25,133560,23850,157410
230840,201808,914,734,180,698996.5,171434,870430.5
230850,201808,1489,1302,187,1241631,178112,1419743
230860,201808,297,224,73,213696,69642,283338
230870,201808,1820,1551,269,1478681,256054,1734735
230880,201808,44,33,11,31482,10494,41976
230890,201808,564,516,48,492141.8,45778,537919.8
230900,201808,273,209,64,199386,60859,260245
230910,201808,198,159,39,150922.8,37206,188128.8
230920,201808,402,316,86,301464,82044,383508
230930,201808,927,653,274,620100.64,261396,881496.64
230940,201808,841,674,167,642519,159128,801647
230945,201808,491,411,80,391618,76320,467938
230950,201808,376,322,54,307188,51516,358704
230960,201808,2581,1752,829,1664375.76,790561,2454936.76
230970,201808,1757,991,766,944323.66,729791.08,1674114.74
230980,201808,211,178,33,169812,31482,201294
230990,201808,140,113,27,107802,25001.47,132803.47
231000,201808,213,193,20,182214,19080,201294
231010,201808,141,111,30,105607.8,28620,134227.8
231020,201808,1305,905,400,861749,381600,1243349
231025,201808,995,753,242,715244.2,229341.8,944586.0
231030,201808,1131,946,185,902480,176204,1078684
231040,201808,140,97,43,91793.88,40291,132084.88
231050,201808,988,881,107,838709.9,102078,940787.9
231060,201808,144,126,18,120204,17172,137376
231070,201808,1454,1026,428,976563.1,408293,1384856.1
231080,201808,260,243,17,231011.1,16218,247229.1
231085,201808,568,354,214,336763,204156,540919
231090,201808,240,198,42,188892,40068,228960
231095,201808,164,132,32,125928,30528,156456
231100,201808,129,109,20,103986,17839.8,121825.8
231110,201808,355,308,47,291642.1,44838,336480.1
231120,201808,293,252,41,240403.23,39114,279517.23
231123,201808,141,134,7,127836,6678,134514
231126,201808,304,250,54,238213.8,51516,289729.8
231130,201808,4569,3560,1009,3387012.3,961799.26,4348811.56
231135,201808,212,183,29,174582,26782,201364
231140,201808,3099,2286,813,2177305.61,774628.92,2951934.53
231150,201808,364,347,17,331038,16218,347256
231160,201808,1210,957,253,910097.42,241133.04,1151230.46
231170,201808,533,355,178,338670,169812,508482
231180,201808,1656,1410,246,1344376.8,234655.38,1579032.18
231190,201808,193,170,23,162180,21942,184122
231195,201808,217,187,30,177674,28620,206294
231200,201808,832,677,155,645858,146610,792468
231210,201808,608,509,99,484632.8,94446,579078.8
231220,201808,1041,752,289,714728.07,275706,990434.07
231230,201808,1405,1127,278,1074204.04,264448.8,1338652.84
231240,201808,1389,1008,381,961345.8,362491.58,1323837.38
231250,201808,112,104,8,99216,7632,106848
231260,201808,289,187,102,178398,97022,275420
231270,201808,1010,838,172,793852.4,164088,957940.4
231280,201808,59,45,14,42215,13356,55571
231290,201808,7252,4053,3199,3860401.16,3049215.01,6909616.17
231300,201808,627,581,46,554274,43884,598158
231310,201808,713,661,52,629377,49608,678985
231320,201808,570,435,135,414514,128770.92,543284.92
231325,201808,91,82,9,78228,8586,86814
231330,201808,2027,1563,464,1485268.58,441130.6,1926399.18
231335,201808,248,221,27,210834,25758,236592
231340,201808,1634,1205,429,1148426.08,408979.8,1557405.88
231350,201808,1213,999,214,952474,203584,1156058
231355,201808,427,371,56,353934,53424,407358
231360,201808,482,379,103,359086.2,98262,457348.2
231370,201808,89,75,14,71550,13356,84906
231375,201808,290,212,78,202248,74412,276660
231380,201808,469,384,85,364740.69,80899.2,445639.89
231390,201808,199,162,37,154548,35298,189846
231395,201808,736,459,277,437294.52,264258,701552.52
231400,201808,1074,891,183,847456.84,174239.38,1021696.22
231410,201808,1323,1079,244,1025551.4,231804,1257355.4
240010,201808,393,178,215,168660.26,204867.09,373527.35
240020,201808,2215,1746,469,1662858.23,447422,2110280.23
240030,201808,134,113,21,107802,20034,127836
240040,201808,31,31,0,29574,0,29574
240050,201808,516,442,74,420814.45,70596,491410.45
240060,201808,67,63,4,60102,3816,63918
240070,201808,195,152,43,145008,41022,186030
240080,201808,460,308,152,293828,144054.71,437882.71
240090,201808,103,92,11,87462.72,10494,97956.72
240100,201808,1453,1371,82,1304961.55,78037.2,1382998.75
240110,201808,1003,637,366,606726.26,349021,955747.26
240120,201808,138,118,20,112572,19080,131652
240130,201808,286,268,18,254955.54,17172,272127.54
240140,201808,82,64,18,61056,17172,78228
240145,201808,701,620,81,590955.3,77274,668229.3
240150,201808,20,15,5,14310,4741.38,19051.38
240160,201808,42,37,5,35298,4770,40068
240165,201808,36,30,6,28382,5724,34106
240170,201808,93,71,22,67257,20988,88245
240180,201808,78,64,14,61056,13356,74412
240185,201808,44,40,4,38150.46,3816,41966.46
240190,201808,13,10,3,9540,2862,12402
240200,201808,3029,1703,1326,1618586.67,1263765,2882351.67
240210,201808,169,131,38,124974,36252,161226
240220,201808,1100,790,310,753517,295730.46,1049247.46
240230,201808,833,773,60,734608.05,56592,791200.05
240240,201808,123,88,35,83252.35,33390,116642.35
240250,201808,87,77,10,73458,9540,82998
240260,201808,1801,1342,459,1279581.12,436617.18,1716198.30
240270,201808,191,167,24,158936.4,22610,181546.4
240280,201808,43,33,10,30719,9540,40259
240290,201808,50,49,1,46746,954,47700
240300,201808,178,100,78,94827.6,74412,169239.6
240310,201808,2030,1118,912,1056436.98,866544.37,1922981.35
240320,201808,206,196,10,186703.76,9540,196243.76
240325,201808,4306,2636,1670,2507273.46,1590057.86,4097331.32
240330,201808,66,62,4,59148,3816,62964
240340,201808,106,76,30,72504,28620,101124
240350,201808,90,80,10,76320,9540,85860
240360,201808,443,317,126,302418,120204,422622
240370,201808,41,39,2,37206,1908,39114
240375,201808,69,41,28,39114,26712,65826
240380,201808,228,186,42,177444,39973,217417
240390,201808,15,12,3,11448,2862,14310
240400,201808,76,72,4,68688,3816,72504
240410,201808,11,7,4,6678,3816,10494
240420,201808,901,697,204,662412.4,193566.6,855979.0
240430,201808,264,248,16,235681.89,15264,250945.89
240440,201808,78,45,33,42930,31482,74412
240450,201808,213,144,69,136803.8,65826,202629.8
240460,201808,61,48,13,45792,12402,58194
240470,201808,237,205,32,194726.66,30528,225254.66
240480,201808,15,14,1,13260.6,954,14214.6
240485,201808,76,65,11,62010,10494,72504
240490,201808,48,47,1,44628.12,954,45582.12
240500,201808,85,67,18,63918,17172,81090
240510,201808,50,35,15,33390,14310,47700
240520,201808,124,119,5,113526,4770,118296
240530,201808,55,49,6,46746,5724,52470
240540,201808,78,67,11,63918,10494,74412
240550,201808,15,13,2,12402,1908,14310
240560,201808,372,276,96,262200.23,91584,353784.23
240570,201808,473,294,179,279172.2,170766,449938.2
240580,201808,1253,1014,239,961871.9,226848.2,1188720.1
240590,201808,30,28,2,26712,1908,28620
240600,201808,111,108,3,103032,2862,105894
240610,201808,510,426,84,406047.7,79373,485420.7
240615,201808,20,19,1,18126,954,19080
240620,201808,97,93,4,88722,3816,92538
240630,201808,35,33,2,31482,1908,33390
240640,201808,26,22,4,20988,3816,24804
240650,201808,238,198,40,188033.9,38160,226193.9
240660,201808,99,87,12,82998,11448,94446
240670,201808,293,172,121,161989.3,115434,277423.3
240680,201808,49,38,11,36252,10494,46746
240690,201808,49,46,3,43884,2862,46746
240700,201808,190,157,33,149778,31482,181260
240710,201808,1931,1233,698,1175085.63,665873.46,1840959.09
240720,201808,1067,782,285,744873.86,271890,1016763.86
240725,201808,66,61,5,58194,4770,62964
240730,201808,133,115,18,109710,17172,126882
240740,201808,243,205,38,194205.78,35298.02,229503.80
240750,201808,38,26,12,24804,11448,36252
240760,201808,33,30,3,28620,2862,31482
240770,201808,147,114,33,108756,31482,140238
240780,201808,685,570,115,542339.46,109710,652049.46
240790,201808,37,36,1,34344,954,35298
240800,201808,8762,5963,2799,5650231.64,2663227.5,8313459.14
240810,201808,20128,11113,9015,10559707.42,8590025.73,19149733.15
240820,201808,214,136,78,129453.03,74412,203865.03
240830,201808,1629,1332,297,1264584.76,283338,1547922.76
240840,201808,81,71,10,67734,9540,77274
240850,201808,86,75,11,71550,10494,82044
240860,201808,114,111,3,105894,2862,108756
240870,201808,61,54,7,51516,6678,58194
240880,201808,30,27,3,25748.46,2862,28610.46
240890,201808,1194,708,486,671522.78,463640,1135162.78
240895,201808,47,34,13,32436,12402,44838
240910,201808,159,144,15,137376,14310,151686
240920,201808,15,12,3,11448,2862,14310
240930,201808,386,350,36,332946,34344,367290
240933,201808,32,25,7,23850,6678,30528
240940,201808,2436,2153,283,2038997.45,267100.92,2306098.37
240950,201808,53,50,3,47700,2862,50562
240960,201808,32,26,6,24804,5724,30528
240970,201808,127,90,37,85860,34544,120404
240980,201808,187,149,38,142146,35679.6,177825.6
240990,201808,119,78,41,74412,39114,113526
241000,201808,68,63,5,60102,4770,64872
241010,201808,62,50,12,47700,11448,59148
241020,201808,111,104,7,99216,6678,105894
241025,201808,10,4,6,3816,5724,9540
241030,201808,119,97,22,92538,20988,113526
241040,201808,35,29,6,27666,5724,33390
241050,201808,89,78,11,74412,10494,84906
241060,201808,28,24,4,22896,3816,26712
241070,201808,14,14,0,13356,0,13356
241080,201808,64,57,7,54091.8,6678,60769.8
241090,201808,51,42,9,40068,8571.69,48639.69
241100,201808,75,65,10,62010,9540,71550
241105,201808,6,2,4,1908,3816,5724
241110,201808,45,43,2,41022,1908,42930
241120,201808,1440,1111,329,1056431.8,313866,1370297.8
241140,201808,222,183,39,173629,37206,210835
241142,201808,41,39,2,37206,1908,39114
241150,201808,1230,1081,149,1028556,142146,1170702
241160,201808,22,21,1,20034,954,20988
241170,201808,43,39,4,37206,3816,41022
241180,201808,48,40,8,37985.42,7632,45617.42
241190,201808,38,37,1,35298,954,36252
241200,201808,3891,2120,1771,2016945.62,1687613.66,3704559.28
241210,201808,71,60,11,57240,9636,66876
241220,201808,1393,935,458,891525.04,436898.92,1328423.96
241230,201808,243,203,40,193471.2,38160,231631.2
241240,201808,53,40,13,38160,12402,50562
241250,201808,1102,1018,84,970314,80136,1050450
241255,201808,47,37,10,35298,9540,44838
241260,201808,639,502,137,478903.23,130698,609601.23
241270,201808,47,34,13,32436,12402,44838
241280,201808,99,86,13,82044,12402,94446
241290,201808,109,82,27,78228,25758,103986
241300,201808,79,56,23,53424,21942,75366
241310,201808,52,39,13,37063,12402,49465
241320,201808,28,14,14,13356,13356,26712
241330,201808,62,56,6,53424,5724,59148
241335,201808,62,55,7,51802.2,6678,58480.2
241340,201808,186,139,47,132606,44838,177444
241350,201808,61,56,5,53424,4770,58194
241355,201808,40,37,3,35298,2862,38160
241360,201808,49,48,1,45792,954,46746
241370,201808,45,38,7,36127.98,6678,42805.98
241380,201808,38,35,3,33390,2862,36252
241390,201808,76,61,15,58003.2,14310,72313.2
241400,201808,208,169,39,160558.2,37206,197764.2
241410,201808,178,161,17,153594,16122.6,169716.6
241415,201808,98,78,20,74412,19080,93492
241420,201808,102,77,25,73458,23679,97137
241430,201808,28,27,1,25758,954,26712
241440,201808,489,406,83,387310,79182,466492
241445,201808,38,36,2,34344,1908,36252
241450,201808,278,228,50,217512,47700,265212
241460,201808,136,125,11,119012,10494,129506
241470,201808,43,36,7,34344,6678,41022
241475,201808,64,62,2,59148,1908,61056
241480,201808,101,72,29,67734.69,27666,95400.69
241490,201808,8,7,1,6678,954,7632
241500,201808,47,34,13,32436,12402,44838
250010,201808,101,87,14,82854.9,13356,96210.9
250020,201808,31,27,4,25758,3816,29574
250030,201808,819,610,209,580595.2,198337.6,778932.8
250040,201808,339,284,55,270936,52183.8,323119.8
250050,201808,234,194,40,184785.8,38160,222945.8
250053,201808,54,41,13,39114,12402,51516
250057,201808,0,0,0,0,0,0
250060,201808,456,348,108,331992,102745.8,434737.8
250070,201808,701,583,118,554164,112572,666736
250073,201808,7,7,0,6678,0,6678
250077,201808,197,146,51,138892.86,48654,187546.86
250080,201808,424,331,93,314153.2,88722,402875.2
250090,201808,199,131,68,124020,64852.92,188872.92
250100,201808,513,422,91,402588,86433,489021
250110,201808,561,422,139,400804.02,132606,533410.02
250115,201808,24,7,17,6678,16218,22896
250120,201808,111,83,28,79182,26712,105894
250130,201808,573,462,111,440748,105704,546452
250135,201808,14,8,6,7632,5724,13356
250140,201808,79,71,8,67734,7632,75366
250150,201808,580,429,151,407712.58,143739.18,551451.76
250153,201808,10,9,1,8586,954,9540
250157,201808,28,23,5,21942,4770,26712
250160,201808,215,168,47,160272,44838,205110
250170,201808,62,44,18,41976,17172,59148
250180,201808,4086,2777,1309,2636195.13,1243688,3879883.13
250190,201808,870,574,296,545926.5,282384,828310.5
250200,201808,52,43,9,41022,8586,49608
250205,201808,23,20,3,19080,2862,21942
250210,201808,89,77,12,73458,11448,84906
250215,201808,63,54,9,51516,8586,60102
250220,201808,27,21,6,20034,5724,25758
250230,201808,77,70,7,66776,6678,73454
250240,201808,243,201,42,190943.1,40068,231011.1
250250,201808,398,340,58,324360,55332,379692
250260,201808,32,29,3,27666,2862,30528
250270,201808,59,46,13,43884,12402,56286
250280,201808,375,312,63,297648,60102,357750
250290,201808,93,88,5,83665.8,4770,88435.8
250300,201808,555,379,176,360918.71,167891,528809.71
250310,201808,45,41,4,39114,3816,42930
250320,201808,2010,1373,637,1304587.35,606143.8,1910731.15
250330,201808,82,72,10,68688,9540,78228
250340,201808,24,20,4,19080,3816,22896
250350,201808,139,89,50,84619.8,47127.6,131747.4
250355,201808,33,25,8,23850,7632,31482
250360,201808,203,166,37,158364,35298,193662
250370,201808,2386,1617,769,1536419.98,733023,2269442.98
250375,201808,14,10,4,9540,3816,13356
250380,201808,53,38,15,36252,14310,50562
250390,201808,42,35,7,33390,6678,40068
250400,201808,15858,8043,7815,7648928.59,7449204.65,15098133.24
250403,201808,404,329,75,313384.23,71550,384934.23
250407,201808,60,52,8,49608,7632,57240
250410,201808,33,28,5,26712,4770,31482
250415,201808,43,29,14,27646.92,13336.92,40983.84
250420,201808,47,39,8,37206,7632,44838
250430,201808,1523,1296,227,1234191,216558,1450749
250435,201808,16,13,3,12402,2862,15264
250440,201808,690,591,99,561121.38,94446,655567.38
250450,201808,88,72,16,68688,14596.2,83284.2
250460,201808,423,290,133,276660,126872.46,403532.46
250470,201808,86,63,23,60102,21942,82044
250480,201808,328,261,67,248994,63918,312912
250485,201808,1,1,0,954,0,954
250490,201808,212,176,36,167904,34344,202248
250500,201808,79,58,21,55332,20034,75366
250510,201808,736,576,160,548741,151631.43,700372.43
250520,201808,176,122,54,116368.92,51511.23,167880.15
250523,201808,116,97,19,92538,18126,110664
250527,201808,101,80,21,76315.23,20034,96349.23
250530,201808,7,5,2,4770,1908,6678
250535,201808,24,20,4,19080,3816,22896
250540,201808,127,98,29,92776.5,27666,120442.5
250550,201808,71,68,3,64872,2862,67734
250560,201808,41,33,8,31482,7632,39114
250570,201808,151,121,30,115434,28620,144054
250580,201808,124,98,26,93267.8,24804,118071.8
250590,201808,20,16,4,15264,3816,19080
250600,201808,1243,841,402,800407.35,383508,1183915.35
250610,201808,150,130,20,124020,19080,143100
250620,201808,22,18,4,17172,3816,20988
250625,201808,67,50,17,47700,16218,63918
250630,201808,3026,1946,1080,1848443.96,1029253.51,2877697.47
250640,201808,205,171,34,163134,32436,195570
250650,201808,30,20,10,19080,9540,28620
250660,201808,44,34,10,32436,9540,41976
250670,201808,60,40,20,38160,19080,57240
250680,201808,387,318,69,303372,65826,369198
250690,201808,1857,1287,570,1224359.53,543398.8,1767758.33
250700,201808,929,816,113,775065.62,107592.12,882657.74
250710,201808,448,347,101,331038,96354,427392
250720,201808,106,83,23,79182,21942,101124
250730,201808,382,320,62,304326.6,59148,363474.6
250740,201808,51,47,4,44838,3816,48654
250750,201808,20652,12425,8227,11799743.47,7839183,19638926.47
250760,201808,76,56,20,53424,19080,72504
250770,201808,350,230,120,217483.52,112071.35,329554.87
250780,201808,55,41,14,39114,13356,52470
250790,201808,473,307,166,290970.92,157648.5,448619.42
250800,201808,153,141,12,133798.5,11448,145246.5
250810,201808,79,61,18,58194,17172,75366
250820,201808,157,129,28,123066,26712,149778
250830,201808,420,288,132,273750.5,125928,399678.5
250840,201808,52,50,2,47700,1908,49608
250850,201808,53,41,12,39114,11448,50562
250855,201808,14,12,2,11448,1908,13356
250860,201808,202,147,55,140238,52183.8,192421.8
250870,201808,34,31,3,29574,2862,32436
250880,201808,78,60,18,57230.46,17172,74402.46
250890,201808,2482,1844,638,1757649.6,607793.5,2365443.1
250900,201808,128,109,19,103986,18126,122112
250905,201808,123,96,27,91584,25758,117342
250910,201808,1179,839,340,799443.65,323969.8,1123413.45
250915,201808,110,77,33,73458,31482,104940
250920,201808,138,107,31,102078,29574,131652
250930,201808,167,103,64,98262,61056,159318
250933,201808,1,1,0,954,0,954
250937,201808,6,5,1,4770,954,5724
250939,201808,32,24,8,22896,7632,30528
250940,201808,101,76,25,72504,23850,96354
250950,201808,70,47,23,44838,21942,66780
250960,201808,92,51,41,48654,39114,87768
250970,201808,1205,858,347,816911,330084,1146995
250980,201808,92,65,27,62010,25758,87768
250990,201808,166,129,37,122593.77,35255.07,157848.84
251000,201808,76,68,8,64681.2,7632,72313.2
251010,201808,101,79,22,75362,20209.53,95571.53
251020,201808,82,72,10,67877.1,9540,77417.1
251030,201808,44,34,10,32436,9540,41976
251040,201808,53,38,15,36252,14310,50562
251050,201808,23,21,2,20034,1908,21942
251060,201808,49,38,11,35298,10494,45792
251065,201808,3,3,0,2862,0,2862
251070,201808,25,20,5,19071,4770,23841
251080,201808,4743,2299,2444,2181740.64,2325023.01,4506763.65
251090,201808,199,171,28,163134,26712,189846
251100,201808,17,16,1,15264,954,16218
251110,201808,45,36,9,34344,8586,42930
251120,201808,1829,1116,713,1059754.2,680202,1739956.2
251130,201808,382,312,70,297648,66780,364428
251140,201808,524,342,182,325124.8,173459.34,498584.14
251150,201808,301,262,39,249176,37206,286382
251160,201808,97,82,15,78224,14310,92534
251170,201808,100,80,20,76291.38,19075.23,95366.61
251180,201808,292,185,107,176481.23,102069.23,278550.46
251190,201808,189,129,60,122737.83,57240,179977.83
251200,201808,255,207,48,197478,45792,243270
251203,201808,34,32,2,30528,1908,32436
251207,201808,95,79,16,75366,15264,90630
251210,201808,1423,1027,396,978204.53,377116.2,1355320.73
251220,201808,47,37,10,35298,9540,44838
251230,201808,467,390,77,372060,73458,445518
251240,201808,100,72,28,67734,26712,94446
251250,201808,1346,963,383,915812.87,365239,1281051.87
251260,201808,13,8,5,7632,4770,12402
251270,201808,343,257,86,245178,81901,327079
251272,201808,64,59,5,56286,4770,61056
251274,201808,27,22,5,20988,4770,25758
251275,201808,24,16,8,15264,7632,22896
251276,201808,17,13,4,12402,3816,16218
251278,201808,8,7,1,6678,954,7632
251280,201808,100,95,5,90630,4770,95400
251290,201808,711,539,172,514206,164088,678294
251300,201808,17,14,3,13356,2862,16218
251310,201808,371,266,105,253760,100170,353930
251315,201808,19,18,1,17172,954,18126
251320,201808,59,48,11,45792,10494,56286
251330,201808,80,71,9,67734,8586,76320
251335,201808,12,7,5,6678,4770,11448
251340,201808,696,413,283,394002,268957.25,662959.25
251350,201808,37,35,2,33390,1908,35298
251360,201808,74,65,9,61803.94,8586,70389.94
251365,201808,14,14,0,13356,0,13356
251370,201808,5351,3639,1712,3467291.94,1631914,5099205.94
251380,201808,50,40,10,38160,9540,47700
251385,201808,3,3,0,2862,0,2862
251390,201808,692,547,145,520694.2,137090,657784.2
251392,201808,12,6,6,5724,5724,11448
251394,201808,9,9,0,8586,0,8586
251396,201808,15,10,5,9540,4770,14310
251398,201808,18,15,3,14310,2862,17172
251400,201808,42,35,7,33390,6678,40068
251410,201808,34,29,5,27666,4770,32436
251420,201808,104,78,26,74412,24804,99216
251430,201808,40,37,3,35298,2862,38160
251440,201808,33,22,11,20988,10494,31482
251445,201808,55,50,5,47700,4770,52470
251450,201808,414,364,50,345600.8,47700,393300.8
251455,201808,2,1,1,954,954,1908
251460,201808,16,12,4,11448,3816,15264
251465,201808,5,2,3,1908,2862,4770
251470,201808,47,37,10,35298,9540,44838
251480,201808,26,24,2,22896,1908,24804
251490,201808,123,85,38,80613,35299,115912
251500,201808,119,95,24,90630,22133,112763
251510,201808,39,30,9,28620,8586,37206
251520,201808,25,25,0,23850,0,23850
251530,201808,4514,3178,1336,3025786.5,1274248.26,4300034.76
251540,201808,74,65,9,62010,8586,70596
251550,201808,415,320,95,304326.2,90106,394432.2
251560,201808,24,17,7,16218,6678,22896
251570,201808,20,20,0,19080,0,19080
251580,201808,124,102,22,97308,20988,118296
251590,201808,121,90,31,86041,29574,115615
251593,201808,24,14,10,13356,9540,22896
251597,201808,55,45,10,42930,9540,52470
251600,201808,1091,777,314,739766.48,297947.92,1037714.40
251610,201808,209,159,50,151686,47033,198719
251615,201808,3,3,0,2862,0,2862
251620,201808,4261,2839,1422,2698565.84,1353823,4052388.84
251630,201808,448,331,117,315774,111609,427383
251640,201808,150,106,44,101124,41976,143100
251650,201808,271,198,73,187059.1,69642,256701.1
251660,201808,226,204,22,194616,20797.2,215413.2
251670,201808,359,279,80,264470,76320,340790
251675,201808,3,3,0,2862,0,2862
251680,201808,98,88,10,83952,9540,93492
251690,201808,344,288,56,273798,53073.89,326871.89
251700,201808,285,240,45,228373.29,42915.69,271288.98
251710,201808,22,15,7,14310,6678,20988
251720,201808,31,21,10,20034,9254,29288
251740,201808,10,8,2,7632,1908,9540
260005,201808,3194,1806,1388,1711835.34,1323271.1,3035106.44
260010,201808,1518,1085,433,1030331.48,411079.32,1441410.80
260020,201808,426,376,50,358704,47700,406404
260030,201808,580,419,161,398958.98,153594,552552.98
260040,201808,854,531,323,505486.44,308132.46,813618.90
260050,201808,1154,828,326,789674,309764.2,1099438.2
260060,201808,413,374,39,356032.8,37206,393238.8
260070,201808,1463,925,538,878328,510282.36,1388610.36
260080,201808,733,578,155,550601.1,147870,698471.1
260090,201808,570,359,211,342258.12,201294,543552.12
260100,201808,231,162,69,153738,65826,219564
260105,201808,234,133,101,126882,96354,223236
260110,201808,2768,2051,717,1956645,683208,2639853
260120,201808,2935,1458,1477,1381214.21,1406770.1,2787984.31
260130,201808,156,110,46,104940,43884,148824
260140,201808,2161,1421,740,1347152.3,704415.46,2051567.76
260150,201808,226,149,77,142146,73458,215604
260160,201808,300,256,44,244224,41976,286200
260170,201808,3402,2079,1323,1976606.58,1260758.9,3237365.48
260180,201808,143,121,22,115434,20988,136422
260190,201808,2300,1612,688,1534697.9,656066,2190763.9
260200,201808,905,741,164,706139.08,156170,862309.08
260210,201808,1418,1010,408,963389.27,388269.11,1351658.38
260220,201808,726,663,63,632502,60102,692604
260230,201808,1209,919,290,874534.99,276660,1151194.99
260240,201808,227,173,54,164088,51516,215604
260250,201808,79,61,18,58194,17172,75366
260260,201808,1000,720,280,686880,267120,954000
260270,201808,427,345,82,327747.2,77941.8,405689.0
260280,201808,1413,901,512,859077,488162,1347239
260290,201808,6419,3443,2976,3265864.9,2832394,6098258.9
260300,201808,885,781,104,743005.6,98930,841935.6
260310,201808,516,410,106,389761.47,101124,490885.47
260320,201808,883,661,222,630307.2,211788,842095.2
260330,201808,36,27,9,25758,8586,34344
260340,201808,71,52,19,49608,18126,67734
260345,201808,5663,3183,2480,3030405.63,2364862.76,5395268.39
260350,201808,486,357,129,338834.08,123066,461900.08
260360,201808,284,145,139,138330,132577.38,270907.38
260370,201808,668,439,229,416186.86,218326,634512.86
260380,201808,605,434,171,414036,161989.56,576025.56
260390,201808,297,252,45,239329.98,41976,281305.98
260392,201808,101,89,12,84906,11448,96354
260400,201808,4081,2350,1731,2233282.86,1651003.22,3884286.08
260410,201808,14810,7733,7077,7361467.03,6749013.2,14110480.23
260415,201808,123,112,11,106848,10494,117342
260420,201808,1787,1073,714,1018565.04,679502.64,1698067.68
260430,201808,192,176,16,166692.66,15264,181956.66
260440,201808,226,163,63,154778,60102,214880
260450,201808,476,344,132,326891,125928,452819
260460,201808,844,447,397,423768.8,378733.23,802502.03
260470,201808,370,230,140,218656.8,133465,352121.8
260480,201808,211,135,76,128790,72504,201294
260490,201808,216,175,41,166950,39114,206064
260500,201808,1138,768,370,730384.2,352693.8,1083078.0
260510,201808,747,594,153,565722,145008,710730
260515,201808,259,232,27,221328,25281,246609
260520,201808,3341,1990,1351,1891160.52,1286174.62,3177335.14
260530,201808,798,647,151,614745.64,144054,758799.64
260540,201808,568,432,136,412128,128790.72,540918.72
260545,201808,12,9,3,8586,2862,11448
260550,201808,348,216,132,206064,125928,331992
260560,201808,527,397,130,378452,123733.8,502185.8
260570,201808,1018,834,184,792917.8,175249.8,968167.6
260580,201808,262,234,28,223236,26712,249948
260590,201808,662,382,280,363016.08,267120,630136.08
260600,201808,8216,4207,4009,3992900.06,3820717.53,7813617.59
260610,201808,493,332,161,316728,153307.8,470035.8
260620,201808,3669,1927,1742,1826888.21,1658695.97,3485584.18
260630,201808,78,75,3,71550,2862,74412
260640,201808,3727,2034,1693,1936672.63,1615065.3,3551737.93
260650,201808,317,229,88,218466,83336.67,301802.67
260660,201808,510,350,160,333518.4,152640,486158.4
260670,201808,103,76,27,72504,25758,98262
260680,201808,3685,2070,1615,1957886.78,1540080.84,3497967.62
260690,201808,122,96,26,91584,24804,116388
260700,201808,327,201,126,190990.8,120204,311194.8
260710,201808,37,34,3,32436,2862,35298
260720,201808,2260,1354,906,1285509.69,861977.16,2147486.85
260730,201808,617,467,150,445518,140905.8,586423.8
260740,201808,59,55,4,52470,3816,56286
260750,201808,638,443,195,422297.64,186030,608327.64
260760,201808,615,331,284,315774,270936,586710
260765,201808,987,521,466,493985.8,444325.5,938311.3
260770,201808,223,168,55,160272,52470,212742
260775,201808,825,492,333,467985.8,317673,785658.8
260780,201808,270,176,94,167904,89676,257580
260790,201808,12285,6785,5500,6446798.63,5239286.93,11686085.56
260795,201808,167,116,51,109500.12,48654,158154.12
260800,201808,287,239,48,227529,45792,273321
260805,201808,173,112,61,106119.14,58194,164313.14
260810,201808,739,648,91,616942.26,86814,703756.26
260820,201808,317,214,103,202826.79,98262,301088.79
260825,201808,199,137,62,130524.57,59148,189672.57
260830,201808,265,171,94,163134,89676,252810
260840,201808,233,169,64,160559,61056,221615
260845,201808,211,145,66,138330,62964,201294
260850,201808,506,367,139,348454.09,132606,481060.09
260860,201808,256,192,64,182970.34,61056,244026.34
260870,201808,378,274,104,260156.42,99216,359372.42
260875,201808,721,510,211,485426.69,201294,686720.69
260880,201808,1597,977,620,930385.29,591289.2,1521674.49
260890,201808,2433,1704,729,1619843.86,694513,2314356.86
260900,201808,1039,720,319,685577.79,304326,989903.79
260910,201808,280,219,61,208926,58194,267120
260915,201808,306,208,98,198432,93492,291924
260920,201808,177,99,78,94446,74412,168858
260930,201808,389,333,56,317682,53338.45,371020.45
260940,201808,2872,1568,1304,1491963.89,1243519.92,2735483.81
260950,201808,2036,1181,855,1120321.82,815670,1935991.82
260960,201808,14241,7415,6826,7039200.13,6503795.03,13542995.16
260970,201808,440,377,63,358869,60102,418971
260980,201808,193,171,22,162847.8,20988,183835.8
260990,201808,2580,2123,457,2023025,435310.2,2458335.2
261000,201808,4376,2582,1794,2450778.04,1709688.05,4160466.09
261010,201808,185,137,48,130698,44974.23,175672.23
261020,201808,612,459,153,437743,145962,583705
261030,201808,226,165,61,157396,57945.96,215341.96
261040,201808,368,328,40,312912,37873.8,350785.8
261050,201808,476,417,59,397818,56286,454104
261060,201808,1332,883,449,840086.53,428346,1268432.53
261070,201808,9086,4617,4469,4379809.8,4255643.37,8635453.17
261080,201808,389,295,94,280658,89676,370334
261090,201808,2266,1739,527,1650426.05,501986,2152412.05
261100,201808,1089,766,323,728713.8,306272.16,1034985.96
261110,201808,8174,5006,3168,4770389.05,3019304.55,7789693.60
261120,201808,274,230,44,219420,41971.23,261391.23
261130,201808,573,337,236,320974.1,224954,545928.1
261140,201808,190,124,66,118296,62964,181260
261150,201808,680,407,273,388278,259388.73,647666.73
261153,201808,73,69,4,64872.31,3816,68688.31
261160,201808,77562,39080,38482,37162280.34,36690554.62,73852834.96
261170,201808,456,342,114,325638.36,108756,434394.36
261180,201808,1810,1119,691,1062403.62,659214,1721617.62
261190,201808,613,428,185,407875.12,176481,584356.12
261200,201808,217,191,26,181449.3,24804,206253.3
261210,201808,34,31,3,29574,2862,32436
261220,201808,2607,1838,769,1747280.82,733053.8,2480334.62
261230,201808,329,245,84,233730,80121.69,313851.69
261240,201808,453,391,62,369000.95,59148,428148.95
261245,201808,225,189,36,180019.8,34344,214363.8
261247,201808,159,122,37,116388,35298,151686
261250,201808,2868,1462,1406,1393928.26,1340213.83,2734142.09
261255,201808,256,232,24,221041.8,22896,243937.8
261260,201808,871,752,119,717408,113526,830934
261270,201808,179,139,40,132606,38160,170766
261280,201808,164,136,28,129744,26712,156456
261290,201808,125,87,38,82759.5,36252,119011.5
261300,201808,1242,884,358,843336,341532,1184868
261310,201808,769,511,258,486921.8,245511.9,732433.7
261320,201808,554,372,182,354719,173628,528347
261330,201808,930,732,198,695329.5,188046.46,883375.96
261340,201808,301,169,132,161226,125928,287154
261350,201808,810,580,230,552366.2,219420,771786.2
261360,201808,1244,807,437,769476.37,416612,1186088.37
261370,201808,5037,3094,1943,2937233.35,1850700.45,4787933.80
261380,201808,577,426,151,404505.64,143768,548273.64
261390,201808,3463,2305,1158,2194963.2,1101443.5,3296406.7
261400,201808,281,254,27,241743.6,25758,267501.6
261410,201808,1086,723,363,689742,346297.23,1036039.23
261420,201808,893,561,332,533927.26,316709.46,850636.72
261430,201808,329,299,30,284400,28333.8,312733.8
261440,201808,122,111,11,105894,10494,116388
261450,201808,2497,2076,421,1977844.24,401386.04,2379230.28
261460,201808,728,583,145,555228.02,138330,693558.02
261470,201808,256,197,59,187128,56247.84,243375.84
261480,201808,366,294,72,279237,68684,347921
261485,201808,339,206,133,195856.2,126882,322738.2
261500,201808,625,423,202,403542,192708,596250
261510,201808,48,32,16,30528,15264,45792
261520,201808,109,96,13,91584,12402,103986
261530,201808,4193,2661,1532,2529940.02,1460246.07,3990186.09
261540,201808,1098,676,422,644440.36,402588,1047028.36
261550,201808,287,144,143,136280,136402.92,272682.92
261560,201808,803,534,269,506480.2,255472.6,761952.8
261570,201808,374,292,82,278568,78228,356796
261580,201808,378,295,83,280666,79182,359848
261590,201808,194,158,36,150732,34344,185076
261600,201808,299,241,58,229151,54855,284006
261610,201808,104,92,12,87291,11448,98739
261618,201808,65,51,14,48654,13356,62010
261620,201808,201,122,79,116388,75366,191754
261630,201808,585,452,133,428847.6,126882,555729.6
261640,201808,6409,3399,3010,3235284.59,2867925.92,6103210.51
261650,201808,494,317,177,301740.66,168858,470598.66
270010,201808,532,471,61,449048,57431,506479
270020,201808,305,244,61,232421.38,58194,290615.38
270030,201808,9245,5932,3313,5643012.03,3157881.96,8800893.99
270040,201808,2019,1249,770,1191058.99,733339.8,1924398.79
270050,201808,178,130,48,124020,45792,169812
270060,201808,116,65,51,62010,48654,110664
270070,201808,902,656,246,624300.62,234379.26,858679.88
270080,201808,38,32,6,30528,5724,36252
270090,201808,20,16,4,15264,3816,19080
270100,201808,1252,831,421,789775.51,399487.7,1189263.21
270110,201808,143,107,36,102078,34344,136422
270120,201808,228,187,41,177546.55,39114,216660.55
270130,201808,248,172,76,163515.6,72504,236019.6
270135,201808,102,63,39,60102,37206,97308
270140,201808,1318,801,517,763297.19,492255.2,1255552.39
270150,201808,267,213,54,203202,51516,254718
270160,201808,529,397,132,378738,125260.2,503998.2
270170,201808,742,480,262,456775.2,248707.8,705483.0
270180,201808,71,55,16,52152.04,15054.12,67206.16
270190,201808,101,90,11,85860,10494,96354
270200,201808,107,96,11,91393.2,10494,101887.2
270210,201808,482,251,231,239454,220087.8,459541.8
270220,201808,185,145,40,138330,38160,176490
270230,201808,2120,1276,844,1210907.71,803268.62,2014176.33
270235,201808,735,556,179,530172.67,170400.95,700573.62
270240,201808,3146,2454,692,2328497.38,657376,2985873.38
270250,201808,174,121,53,115434,50562,165996
270255,201808,223,192,31,183168,29192.4,212360.4
270260,201808,340,270,70,257580,66780,324360
270270,201808,112,47,65,44829,62010,106839
270280,201808,197,121,76,115434,72484.92,187918.92
270290,201808,1191,901,290,858318.42,275783.46,1134101.88
270300,201808,287,185,102,176490,97021.8,273511.8
270310,201808,920,738,182,701655.15,172923.12,874578.27
270320,201808,885,755,130,718598.8,123733.8,842332.6
270330,201808,275,230,45,218466,42930,261396
270340,201808,60,48,12,45792,11448,57240
270350,201808,90,46,44,43645.5,41976,85621.5
270360,201808,73,41,32,39114,30528,69642
270370,201808,53,41,12,39114,11448,50562
270375,201808,70,41,29,39114,27666,66780
270380,201808,1078,614,464,584802,442656,1027458
270390,201808,196,110,86,104940,82044,186984
270400,201808,707,516,191,491049.27,182214,673263.27
270410,201808,697,502,195,478590.04,186020.46,664610.50
270420,201808,409,270,139,255882,132530.92,388412.92
270430,201808,32873,23517,9356,22378117.08,8917865.33,31295982.41
270440,201808,492,385,107,367290,101791.8,469081.8
270450,201808,782,414,368,394074.51,350118.66,744193.17
270460,201808,200,155,45,147870,42930,190800
270470,201808,1397,936,461,892136.41,439794,1331930.41
270480,201808,535,433,102,410792.8,96592.5,507385.3
270490,201808,25,20,5,19080,4770,23850
270500,201808,512,420,92,400680,87768,488448
270510,201808,744,454,290,433116,276660,709776
270520,201808,360,221,139,210625,132606,343231
270530,201808,65,57,8,53972.91,7632,61604.91
270540,201808,123,94,29,89676,27666,117342
270550,201808,1736,1314,422,1252946.98,402106.23,1655053.21
270560,201808,313,146,167,139284,159318,298602
270570,201808,466,313,153,296677.56,145762.05,442439.61
270580,201808,83,62,21,59148,20034,79182
270590,201808,73,60,13,57240,12402,69642
270600,201808,179,147,32,140238,30528,170766
270610,201808,194,159,35,151677,33390,185067
270620,201808,30,29,1,27666,954,28620
270630,201808,3902,2972,930,2823285.83,885055.42,3708341.25
270640,201808,899,661,238,628790.6,226737.8,855528.4
270642,201808,215,182,33,173628,31482,205110
270644,201808,268,181,87,172483.74,82993.23,255476.97
270650,201808,272,160,112,152640,106848,259488
270660,201808,259,210,49,200340,46746,247086
270670,201808,3188,2429,759,2307211.22,721168.45,3028379.67
270680,201808,469,270,199,257571,189841.23,447412.23
270690,201808,1127,713,414,678449.88,394946.46,1073396.34
270700,201808,36,27,9,25758,8586,34344
270710,201808,896,678,218,644468.3,207972,852440.3
270720,201808,253,191,62,182214,58861.8,241075.8
270730,201808,1945,1133,812,1078641.4,772542.2,1851183.6
270740,201808,44,27,17,25758,16218,41976
270750,201808,647,474,173,452006,164375,616381
270760,201808,304,217,87,207018,82998,290016
270770,201808,2799,1789,1010,1700366.8,962586,2662952.8
270780,201808,91,56,35,53419.23,33372.46,86791.69
270790,201808,262,177,85,168858,81090,249948
270800,201808,1992,1600,392,1524607.25,372469.83,1897077.08
270810,201808,299,238,61,227037.69,58185.23,285222.92
270820,201808,159,104,55,99216,52375,151591
270830,201808,910,662,248,630781,236302,867083
270840,201808,1422,1048,374,999052.9,355128,1354180.9
270850,201808,1653,1010,643,957378.36,613403.46,1570781.82
270860,201808,2474,1609,865,1532656.4,822312.57,2354968.97
270870,201808,122,66,56,62964,53424,116388
270880,201808,920,686,234,652599.14,222351.58,874950.72
270890,201808,339,247,92,235151.06,87763.23,322914.29
270895,201808,72,62,10,59148,9540,68688
270900,201808,104,79,25,75366,23850,99216
270910,201808,327,260,67,246895.2,63918,310813.2
270915,201808,1861,1125,736,1068647.74,700137.2,1768784.94
270920,201808,492,414,78,394956,74412,469368
270930,201808,6178,4493,1685,4280741.15,1604813.24,5885554.39
270940,201808,2395,1823,572,1736886.68,544716,2281602.68
280010,201808,43,38,5,36252,4770,41022
280020,201808,719,623,96,591162.13,90630,681792.13
280030,201808,19861,12805,7056,12133207.67,6701102.01,18834309.68
280040,201808,339,216,123,206064,115911,321975
280050,201808,379,290,89,276373.8,84906,361279.8
280060,201808,330,218,112,205725.43,106848,312573.43
280067,201808,988,698,290,663133.94,275706.25,938840.19
280070,201808,133,111,22,105894,20988,126882
280100,201808,625,494,131,468245.47,124784,593029.47
280110,201808,75,70,5,66780,4770,71550
280120,201808,626,500,126,477000,120204,597204
280130,201808,1401,885,516,842859.8,492120.9,1334980.7
280140,201808,481,390,91,370247.4,85860,456107.4
280150,201808,333,245,88,232286.89,83952,316238.89
280160,201808,95,82,13,78228,12402,90630
280170,201808,594,397,197,377541.56,187938,565479.56
280190,201808,27,25,2,23850,1908,25758
280200,201808,27,20,7,19080,6678,25758
280210,201808,2786,1974,812,1864490.71,769080.51,2633571.22
280220,201808,43,33,10,31482,9540,41022
280230,201808,324,268,56,254837.63,53424,308261.63
280240,201808,116,110,6,104796.9,5724,110520.9
280250,201808,17,11,6,10494,5724,16218
280260,201808,79,69,10,65826,9540,75366
280270,201808,162,125,37,119250,35298,154548
280280,201808,192,125,67,119250,63918,183168
280290,201808,3137,2267,870,2151709.74,828573.85,2980283.59
280300,201808,1118,855,263,813222.99,250138.8,1063361.79
280310,201808,107,102,5,96977.29,4770,101747.29
280320,201808,654,449,205,428337,195570,623907
280330,201808,360,261,99,248994,94321.98,343315.98
280340,201808,423,339,84,321934.57,79373,401307.57
280350,201808,3484,2686,798,2550332.13,758267.51,3308599.64
280360,201808,457,287,170,273798,161226,435024
280370,201808,99,88,11,83952,10494,94446
280380,201808,56,43,13,41022,12402,53424
280390,201808,187,158,29,150732,27666,178398
280400,201808,344,232,112,220422.1,106848,327270.1
280410,201808,286,233,53,221329,50562,271891
280420,201808,173,145,28,138311,26712,165023
280430,201808,113,84,29,80136,27557.63,107693.63
280440,201808,692,536,156,507434.6,148623.66,656058.26
280445,201808,118,110,8,104940,7632,112572
280450,201808,1122,958,164,910537.46,156456,1066993.46
280460,201808,763,562,201,528238.04,191754,719992.04
280470,201808,190,174,16,165996,14311,180307
280480,201808,2307,1633,674,1542844.09,640051.79,2182895.88
280490,201808,350,323,27,306750,25758,332508
280500,201808,42,38,4,36252,3816,40068
280510,201808,142,111,31,105593.2,29288,134881.2
280520,201808,55,41,14,39114,13356,52470
280530,201808,78,54,24,51516,22896,74412
280540,201808,511,412,99,392912.74,94159.8,487072.54
280550,201808,720,665,55,633321,52470,685791
280560,201808,495,432,63,410363.1,60102,470465.1
280570,201808,1793,1365,428,1297851.47,407456.83,1705308.30
280580,201808,605,462,143,439177.6,136327,575504.6
280590,201808,168,106,62,100844.48,59148,159992.48
280600,201808,368,310,58,295740,55332,351072
280610,201808,136,101,35,96148,33390,129538
280620,201808,551,453,98,430445.5,93348.9,523794.4
280630,201808,164,137,27,130698,25758,156456
280640,201808,205,163,42,154673,40068,194741
280650,201808,78,53,25,50562,23850,74412
280660,201808,137,100,37,95400,35059.5,130459.5
280670,201808,1663,1037,626,980384.15,593459.95,1573844.10
280680,201808,182,158,24,148948.14,22896,171844.14
280690,201808,57,46,11,43884,10494,54378
280700,201808,22,22,0,20988,0,20988
280710,201808,1420,1085,335,1026107.79,319590,1345697.79
280720,201808,111,74,37,68036.4,35298,103334.4
280730,201808,26,22,4,20988,3816,24804
280740,201808,2436,1806,630,1715910.59,599976.46,2315887.05
280750,201808,302,264,38,251856,36252,288108
280760,201808,903,625,278,594914.4,265212,860126.4
290010,201808,206,139,67,132606,62995.8,195601.8
290020,201808,179,166,13,158364,12402,170766
290030,201808,597,391,206,372346.2,196524,568870.2
290035,201808,141,114,27,106267.2,25758,132025.2
290040,201808,280,177,103,168858,98262,267120
290050,201808,80,60,20,57240,19080,76320
290060,201808,254,115,139,109423.8,132606,242029.8
290070,201808,5647,2802,2845,2665669.67,2712097.1,5377766.77
290080,201808,493,219,274,208563.64,261358,469921.64
290090,201808,390,172,218,164088,207972,372060
290100,201808,1605,1063,542,1010050.2,516495.8,1526546.0
290110,201808,817,490,327,464659.25,311424.53,776083.78
290115,201808,210,192,18,182214,17172,199386
290120,201808,773,501,272,477286.2,259488,736774.2
290130,201808,415,246,169,234388.26,161226,395614.26
290135,201808,303,229,74,217788.66,70596,288384.66
290140,201808,302,251,51,239454,48463.2,287917.2
290150,201808,131,99,32,94446,30528,124974
290160,201808,251,190,61,180020.58,58194,238214.58
290170,201808,89,64,25,61056,23850,84906
290180,201808,159,125,34,119250,32436,151686
290190,201808,446,364,82,346970,77941.8,424911.8
290195,201808,319,192,127,183168,121158,304326
290200,201808,279,233,46,222282,43884,266166
290205,201808,149,91,58,86814,55332,142146
290210,201808,1143,827,316,787814.2,301464,1089278.2
290220,201808,225,126,99,119727,94446,214173
290225,201808,291,113,178,107802,169812,277614
290230,201808,65,43,22,41022,20988,62010
290240,201808,305,119,186,113239.8,177444,290683.8
290250,201808,267,245,22,233034,20988,254022
290260,201808,291,236,55,224095,52470,276565
290265,201808,186,154,32,146099,30528,176627
290270,201808,1402,1161,241,1106402.2,228765,1335167.2
290280,201808,467,342,125,326268,119250,445518
290290,201808,1237,723,514,683939.89,490356,1174295.89
290300,201808,453,382,71,364137.23,67734,431871.23
290310,201808,316,141,175,134514,166950,301464
290320,201808,4015,2492,1523,2373711.84,1451034.2,3824746.04
290323,201808,187,163,24,155502,22896,178398
290327,201808,156,123,33,117070.11,31482,148552.11
290330,201808,79,44,35,41976,33390,75366
290340,201808,903,362,541,344375,515828,860203
290350,201808,599,358,241,341532,229914,571446
290360,201808,369,277,92,263304.81,87768,351072.81
290370,201808,906,368,538,351072,513238,864310
290380,201808,313,193,120,184122,114480,298602
290390,201808,2507,1566,941,1490705.38,895520,2386225.38
290395,201808,245,136,109,129219.8,103986,233205.8
290400,201808,286,211,75,201008,71550,272558
290405,201808,248,216,32,206064,30528,236592
290410,201808,589,504,85,477811.64,81090,558901.64
290420,201808,238,187,51,178398,48654,227052
290430,201808,495,312,183,297648,174582,472230
290440,201808,72,64,8,61056,7632,68688
290450,201808,232,179,53,170766,50562,221328
290460,201808,1886,1123,763,1069473.8,727139.32,1796613.12
290470,201808,1444,612,832,582719.22,793413.36,1376132.58
290475,201808,589,549,40,522879,38160,561039
290480,201808,292,164,128,156456,122112,278568
290485,201808,230,215,15,205110,14310,219420
290490,201808,1172,843,329,804222,312912.2,1117134.2
290500,201808,702,358,344,340578,328176,668754
290510,201808,219,168,51,159322.54,48654,207976.54
290515,201808,136,81,55,77274,52470,129744
290520,201808,1426,930,496,884645.58,469836.36,1354481.94
290530,201808,314,285,29,271890,27666,299556
290540,201808,96,58,38,55332,36252,91584
290550,201808,152,127,25,121158,23783.22,144941.22
290560,201808,3348,1389,1959,1323930.76,1868405.59,3192336.35
290570,201808,6027,3075,2952,2929797.21,2813008.18,5742805.39
290580,201808,1279,761,518,724753.8,493456.5,1218210.3
290590,201808,543,449,94,427555,89676,517231
290600,201808,1736,1200,536,1141053.05,511315.38,1652368.43
290610,201808,218,196,22,186765,20988,207753
290620,201808,340,302,38,288108,36252,324360
290630,201808,2065,886,1179,842096.69,1121014.02,1963110.71
290640,201808,150,122,28,116388,26712,143100
290650,201808,1718,813,905,774639,863370,1638009
290660,201808,286,231,55,220374,52470,272844
290670,201808,1004,518,486,493600,463298.38,956898.38
290680,201808,1209,975,234,928909.8,222282,1151191.8
290682,201808,290,213,77,202891.3,73439.46,276330.76
290685,201808,233,151,82,143100,78228,221328
290687,201808,933,613,320,582286.1,305280,887566.1
290689,201808,131,75,56,71536,53409.69,124945.69
290690,201808,653,267,386,254689.92,367364.8,622054.72
290700,201808,246,120,126,114480,120204,234684
290710,201808,712,482,230,459828,219420,679248
290720,201808,1019,830,189,791719,179829,971548
290730,201808,1149,657,492,624918.5,468414,1093332.5
290740,201808,16,13,3,12402,2862,15264
290750,201808,1384,633,751,601969.23,714342.79,1316312.02
290755,201808,74,65,9,62010,8586,70596
290760,201808,302,261,41,248994,39114,288108
290770,201808,190,178,12,169802.46,11162,180964.46
290780,201808,996,793,203,754769.46,191849.4,946618.86
290790,201808,374,263,111,250902,105894,356796
290800,201808,2619,1063,1556,1011455.04,1483470,2494925.04
290810,201808,441,309,132,294500,125928,420428
290820,201808,394,238,156,226084,148824,374908
290830,201808,410,288,122,274752,116388,391140
290840,201808,1719,1058,661,1007186.8,628514.48,1635701.28
290850,201808,782,430,352,410220,334854,745074
290860,201808,643,290,353,276660,336476,613136
290870,201808,661,474,187,450975.6,178398,629373.6
290880,201808,124,67,57,63918,54378,118296
290890,201808,339,241,98,229914,93492,323406
290900,201808,171,129,42,123066,40068,163134
290910,201808,365,276,89,263304,84906,348210
290920,201808,230,196,34,186984,32436,219420
290930,201808,833,636,197,606744,187919,794663
290940,201808,249,208,41,197668.8,39114,236782.8
290950,201808,170,97,73,92538,69642,162180
290960,201808,453,306,147,290684.24,139951.8,430636.04
290970,201808,251,221,30,210643.2,28620,239263.2
290980,201808,1505,1063,442,1009933.76,420619.2,1430552.96
290990,201808,380,318,62,303343.92,59092.38,362436.30
291000,201808,867,246,621,234684,592165.94,826849.94
291005,201808,2151,914,1237,869895.76,1179321.03,2049216.79
291010,201808,153,138,15,131652,14310,145962
291020,201808,102,80,22,76320,20988,97308
291030,201808,98,72,26,68688,24804,93492
291040,201808,576,294,282,280476,269028,549504
291050,201808,1377,775,602,737991.43,574308,1312299.43
291060,201808,1510,833,677,794014.2,645858,1439872.2
291070,201808,1907,1409,498,1340048.53,473831.5,1813880.03
291072,201808,7397,2717,4680,2588651.43,4462536.42,7051187.85
291075,201808,209,170,39,161703,37206,198909
291077,201808,49,33,16,31482,15264,46746
291080,201808,19849,8775,11074,8347995.64,10552877.14,18900872.78
291085,201808,298,241,57,229914,54373.23,284287.23
291090,201808,304,120,184,114194,175526.46,289720.46
291100,201808,660,193,467,184122,445518,629640
291110,201808,403,301,102,287134.92,97308,384442.92
291120,201808,2529,1223,1306,1166599,1243477.99,2410076.99
291125,201808,60,30,30,28620,28620,57240
291130,201808,216,190,26,181260,24804,206064
291140,201808,139,104,35,99216,33104,132320
291150,201808,371,147,224,140238,213696,353934
291160,201808,371,308,63,292878.5,60102,352980.5
291165,201808,25,21,4,20034,3816,23850
291170,201808,3004,1503,1501,1429808.11,1428901.8,2858709.91
291180,201808,1322,514,808,490159.38,770717.76,1260877.14
291185,201808,76,74,2,70596,1908,72504
291190,201808,1269,553,716,525019.13,682234.8,1207253.93
291200,201808,163,124,39,118296,37206,155502
291210,201808,2224,886,1338,842105.34,1274640.14,2116745.48
291220,201808,275,206,69,195570.64,65826,261396.64
291230,201808,1027,353,674,335904,642996,978900
291240,201808,435,412,23,391808,21942,413750
291250,201808,436,356,80,339624,76320,415944
291260,201808,48,36,12,34344,11448,45792
291270,201808,1214,497,717,474138,683731.8,1157869.8
291280,201808,374,173,201,164550.89,191744.46,356295.35
291290,201808,1764,897,867,854307.2,825784,1680091.2
291300,201808,228,178,50,169144.2,47700,216844.2
291310,201808,228,204,24,194616,22896,217512
291320,201808,1400,1001,399,952092,379597.29,1331689.29
291330,201808,129,111,18,104081.4,17172,121253.4
291340,201808,162,91,71,86814,67734,154548
291345,201808,134,87,47,82998,44838,127836
291350,201808,1589,528,1061,503521.2,1012003.3,1515524.5
291360,201808,8611,4277,4334,4068196.88,4131242.35,8199439.23
291370,201808,1117,628,489,598826,466506,1065332
291380,201808,261,206,55,196524,52183.8,248707.8
291390,201808,3878,1706,2172,1622138.23,2070207.8,3692346.03
291400,201808,2083,1491,592,1418788.8,564039.51,1982828.31
291410,201808,154,134,20,126882,19080,145962
291420,201808,114,84,30,80136,28620,108756
291430,201808,167,94,73,88969,68688.53,157657.53
291440,201808,498,400,98,378590.3,93492,472082.3
291450,201808,905,572,333,544448.8,316442,860890.8
291460,201808,1763,1430,333,1362455.1,317682,1680137.1
291465,201808,2213,1033,1180,984888.33,1125419.06,2110307.39
291470,201808,2790,1409,1381,1340553.11,1316735,2657288.11
291480,201808,11810,5240,6570,4987144.89,6259213.27,11246358.16
291490,201808,558,237,321,226098,305947.8,532045.8
291500,201808,369,204,165,194616,157410,352026
291510,201808,1240,477,763,453896.99,727615.8,1181512.79
291520,201808,960,434,526,414036,501794.46,915830.46
291530,201808,1000,269,731,256626,697068.72,953694.72
291535,201808,118,100,18,95400,17172,112572
291540,201808,363,108,255,103032,242316.6,345348.6
291550,201808,1199,569,630,540920.1,600716,1141636.1
291560,201808,5493,2793,2700,2651530.55,2563570.55,5215101.10
291570,201808,205,104,101,99216,96354,195570
291580,201808,1241,755,486,719217.46,463630.23,1182847.69
291590,201808,86,35,51,33196.9,48654,81850.9
291600,201808,1363,631,732,601020,698024,1299044
291610,201808,1461,679,782,646592.58,746000,1392592.58
291620,201808,584,276,308,263304,293450.4,556754.4
291630,201808,493,163,330,155502,314820,470322
291640,201808,3908,1977,1931,1875651.46,1840816.52,3716467.98
291650,201808,416,278,138,264259,130852.73,395111.73
291660,201808,428,170,258,161487.96,245034.9,406522.86
291670,201808,222,142,80,134896,76320,211216
291680,201808,692,391,301,373014,287049.46,660063.46
291685,201808,594,326,268,310766,255481.2,566247.2
291690,201808,573,296,277,282384,263295,545679
291700,201808,941,741,200,706184.19,189846,896030.19
291710,201808,1700,795,905,758020.28,862493.06,1620513.34
291720,201808,402,265,137,252805.23,130698,383503.23
291730,201808,952,563,389,535146.5,371096.46,906242.96
291733,201808,265,183,82,174295.8,78228,252523.8
291735,201808,66,52,14,49608,13356,62964
291740,201808,354,270,84,257580,80136,337716
291750,201808,1981,1309,672,1241394.28,640266,1881660.28
291760,201808,3060,1684,1376,1601623,1310319,2911942
291770,201808,810,544,266,516877.26,253764,770641.26
291780,201808,46,28,18,26712,17172,43884
291790,201808,168,81,87,77274,82998,160272
291800,201808,10054,4086,5968,3887507.31,5689562.8,9577070.11
291810,201808,1134,815,319,776646.83,304326,1080972.83
291820,201808,269,195,74,186030,70596,256626
291830,201808,1088,421,667,400245,635355,1035600
291835,201808,601,553,48,527432,45792,573224
291840,201808,4672,2417,2255,2300073.17,2149754.22,4449827.39
291845,201808,297,101,196,96354,186955.38,283309.38
291850,201808,328,285,43,271651.5,41022,312673.5
291855,201808,269,108,161,103032,153594,256626
291860,201808,174,106,68,100170,64872,165042
291870,201808,87,36,51,34344,48654,82998
291875,201808,187,170,17,162180,16218,178398
291880,201808,490,385,105,366480,100170,466650
291890,201808,245,81,164,77264.46,155025.2,232289.66
291900,201808,55,32,23,30528,21942,52470
291905,201808,133,93,40,88436,38160,126596
291910,201808,175,142,33,135468,31482,166950
291915,201808,394,348,46,330324,43884,374208
291920,201808,5006,2605,2401,2481752.2,2288893.77,4770645.97
291930,201808,184,107,77,102078,73458,175536
291940,201808,322,178,144,169115.58,136422,305537.58
291950,201808,1149,938,211,894089,201294,1095383
291955,201808,1088,650,438,620100,417709,1037809
291960,201808,181,129,52,123066,49321.8,172387.8
291970,201808,777,591,186,563814,177444,741258
291980,201808,1512,1339,173,1273151.7,164088.4,1437240.1
291990,201808,130,120,10,114480,9540,124020
291992,201808,172,89,83,84142.8,79182,163324.8
291995,201808,144,101,43,96354,41022,137376
292000,201808,387,297,90,281144.95,85860,367004.95
292010,201808,287,202,85,191754.8,80136,271890.8
292020,201808,280,203,77,193662,73458,267120
292030,201808,141,109,32,103986,30528,134514
292040,201808,636,324,312,309096,297648,606744
292045,201808,95,86,9,82044,8586,90630
292050,201808,907,639,268,608596.67,255386,863982.67
292060,201808,938,774,164,736489.28,156456,892945.28
292070,201808,49,20,29,19080,27666,46746
292080,201808,119,83,36,79182,34344,113526
292090,201808,505,181,324,172483.2,309096,481579.2
292100,201808,1419,614,805,584182.7,766438.52,1350621.22
292105,201808,207,177,30,168858,28620,197478
292110,201808,2116,782,1334,745722.72,1271037.26,2016759.98
292120,201808,655,524,131,498763.79,124974,623737.79
292130,201808,448,261,187,248994,178398,427392
292140,201808,198,157,41,149778,38315.26,188093.26
292145,201808,165,87,78,82712,74369.07,157081.07
292150,201808,1438,1153,285,1099962,270862.16,1370824.16
292160,201808,177,143,34,136135.8,32436,168571.8
292170,201808,1215,1068,147,1017179.31,140180.76,1157360.07
292180,201808,206,147,59,140238,56286,196524
292190,201808,159,96,63,91584,60102,151686
292200,201808,1292,469,823,446454.71,784493.56,1230948.27
292205,201808,124,110,14,104653.8,13356,118009.8
292210,201808,371,258,113,244749,107086.5,351835.5
292220,201808,21,16,5,15264,4770,20034
292225,201808,37,34,3,32436,2862,35298
292230,201808,944,758,186,721578.23,177444,899022.23
292240,201808,618,447,171,425341,163134,588475
292250,201808,1734,1118,616,1066572,587378,1653950
292260,201808,445,253,192,241362,182404.8,423766.8
292265,201808,265,187,78,178111.8,74412,252523.8
292270,201808,778,343,435,327222,414036.8,741258.8
292273,201808,204,113,91,107024.49,86814,193838.49
292275,201808,171,88,83,83952,78895.8,162847.8
292280,201808,140,99,41,94446,39114,133560
292285,201808,67,57,10,53710.2,9540,63250.2
292290,201808,567,384,183,363951.41,174296,538247.41
292300,201808,1645,626,1019,596631.8,971292.58,1567924.38
292303,201808,101,70,31,66780,29574,96354
292305,201808,108,77,31,73458,29574,103032
292310,201808,826,531,295,506212,280322.15,786534.15
292320,201808,663,502,161,478621.8,153594,632215.8
292330,201808,185,101,84,96354,80136,176490
292335,201808,279,218,61,207972,58194,266166
292340,201808,578,405,173,385630.85,165042,550672.85
292350,201808,272,147,125,139427.1,118963.8,258390.9
292360,201808,708,536,172,509627,164088,673715
292370,201808,767,587,180,559998,171720,731718
292380,201808,647,503,144,478908.42,137376,616284.42
292390,201808,502,193,309,184122,293021.5,477143.5
292400,201808,3411,2106,1305,1990185.53,1241089.8,3231275.33
292405,201808,265,177,88,168381,83665.8,252046.8
292410,201808,148,88,60,83952,57240,141192
292420,201808,305,261,44,248707.8,41976,290683.8
292430,201808,527,412,115,393048,109233,502281
292440,201808,589,502,87,477400.8,82711.8,560112.6
292450,201808,251,194,57,185076,54378,239454
292460,201808,586,432,154,410584.14,146820.6,557404.74
292465,201808,207,172,35,164088,32652.09,196740.09
292467,201808,107,65,42,62010,40068,102078
292470,201808,270,182,88,173628,83952,257580
292480,201808,340,224,116,212742.5,110378,323120.5
292490,201808,224,150,74,143100,70596,213696
292500,201808,1157,500,657,476789,626606.28,1103395.28
292510,201808,3362,1531,1831,1459620.12,1743903.6,3203523.72
292520,201808,1086,528,558,501847.7,532323,1034170.7
292525,201808,385,276,109,263299.23,103986,367285.23
292530,201808,4251,1754,2497,1670637.04,2380918.38,4051555.42
292540,201808,474,257,217,245178,207018,452196
292550,201808,1054,571,483,543992.74,460239.56,1004232.30
292560,201808,323,303,20,289062,19080,308142
292570,201808,306,234,72,222907,68688,291595
292575,201808,467,300,167,285914,159318,445232
292580,201808,933,593,340,564291,324074,888365
292590,201808,527,453,74,431859.59,70596,502455.59
292593,201808,142,112,30,106848,28620,135468
292595,201808,186,144,42,137376,40068,177444
292600,201808,1243,925,318,882133,302704.2,1184837.2
292610,201808,129,99,30,94446,28362.42,122808.42
292620,201808,531,443,88,422327,83952,506279
292630,201808,1379,796,583,757796,554551.14,1312347.14
292640,201808,785,546,239,520550.1,228006,748556.1
292650,201808,178,150,28,142664,26712,169376
292660,201808,2013,1446,567,1374614.03,536720.83,1911334.86
292665,201808,140,103,37,98262,35298,133560
292670,201808,405,327,78,311954,74412,386366
292680,201808,259,201,58,191754,54855,246609
292690,201808,189,146,43,139284,41022,180306
292700,201808,931,617,314,587664.8,299556,887220.8
292710,201808,105,92,13,87768,12402,100170
292720,201808,849,480,369,457118.64,351836,808954.64
292730,201808,202,96,106,90630.5,101124,191754.5
292740,201808,67528,33378,34150,31770130.46,32549016.08,64319146.54
292750,201808,375,267,108,253764.94,102221.57,355986.51
292760,201808,324,262,62,248937.5,59148,308085.5
292770,201808,797,334,463,318350,441702,760052
292780,201808,416,157,259,149264.28,247086,396350.28
292790,201808,740,365,375,348210,357511.5,705721.5
292800,201808,1170,716,454,682110,432829.8,1114939.8
292805,201808,425,123,302,116817.3,288108,404925.3
292810,201808,1500,865,635,824351.8,605780.46,1430132.26
292820,201808,743,606,137,576216.87,130402.8,706619.67
292830,201808,103,83,20,79182,19080,98262
292840,201808,663,550,113,524510,107787.69,632297.69
292850,201808,132,89,43,84906,41022,125928
292860,201808,2224,1307,917,1242091.94,874818,2116909.94
292870,201808,3431,2305,1126,2197707.8,1074194.46,3271902.26
292880,201808,1477,970,507,921613.86,482724,1404337.86
292890,201808,496,425,71,405422,67734,473156
292895,201808,137,92,45,86409.5,42930,129339.5
292900,201808,392,288,104,274752,99216,373968
292905,201808,454,235,219,224190,208926,433116
292910,201808,417,314,103,299223,98262,397485
292920,201808,549,244,305,232776,290970,523746
292925,201808,504,465,39,442932.66,37187,480119.66
292930,201808,577,359,218,342486,207972,550458
292935,201808,293,128,165,122112,157401,279513
292937,201808,239,162,77,154548,73458,228006
292940,201808,196,150,46,143100,43884,186984
292950,201808,1136,585,551,554991.3,524701,1079692.3
292960,201808,561,380,181,362520,172674,535194
292970,201808,267,189,78,179639,74412,254051
292975,201808,153,87,66,82519.91,62774,145293.91
292980,201808,257,175,82,166120.43,78228,244348.43
292990,201808,1318,981,337,928537.87,321310.93,1249848.80
293000,201808,108,78,30,74412,28620,103032
293010,201808,2711,1645,1066,1563187.32,1013642.51,2576829.83
293015,201808,662,529,133,504448.49,126243,630691.49
293020,201808,334,275,59,262350,56286,318636
293030,201808,618,538,80,512680,76320,589000
293040,201808,337,265,72,252810,68688,321498
293050,201808,2740,1602,1138,1519753.79,1081799.38,2601553.17
293060,201808,255,203,52,192475,48654.8,241129.8
293070,201808,3447,1758,1689,1669565.68,1609608.82,3279174.50
293075,201808,91,59,32,56286,30528,86814
293076,201808,70,47,23,44838,21942,66780
293077,201808,455,282,173,265181.27,165042,430223.27
293080,201808,453,405,48,386084,45792,431876
293090,201808,131,115,16,109710,15264,124974
293100,201808,526,371,155,353934,147870,501804
293105,201808,340,237,103,225812,98262,324074
293110,201808,173,122,51,116388,48654,165042
293120,201808,320,216,104,206064,99025.2,305089.2
293130,201808,243,163,80,155502,76320,231822
293135,201808,8038,3176,4862,3023072.72,4629955.11,7653027.83
293140,201808,185,121,64,115434,61056,176490
293150,201808,331,282,49,268265,46746,315011
293160,201808,431,247,184,235638,175536,411174
293170,201808,145,100,45,95400,42072,137472
293180,201808,472,322,150,306902,143100,450002
293190,201808,1307,903,404,856812.23,385416,1242228.23
293200,201808,530,468,62,445392,58337.1,503729.1
293210,201808,352,266,86,253612,81328.5,334940.5
293220,201808,2689,1090,1599,1037926.41,1523299.97,2561226.38
293230,201808,1774,648,1126,615965.8,1074204,1690169.8
293240,201808,220,202,18,192708,17172,209880
293245,201808,113,95,18,90630,17172,107802
293250,201808,736,277,459,264010,437886,701896
293260,201808,311,262,49,248994.17,46746,295740.17
293270,201808,1172,561,611,533286.68,582894,1116180.68
293280,201808,252,144,108,137376,103032,240408
293290,201808,3067,2011,1056,1917540,1007411,2924951
293300,201808,709,506,203,480377.5,191181.6,671559.1
293305,201808,151,129,22,123066,20988,144054
293310,201808,139,105,34,100170,32436,132606
293315,201808,152,117,35,111618,33390,145008
293317,201808,95,67,28,63918,26712,90630
293320,201808,975,567,408,539964.5,389232,929196.5
293325,201808,189,66,123,62964,117303.84,180267.84
293330,201808,13014,6127,6887,5834951.44,6562661.29,12397612.73
293340,201808,254,184,70,175536,65826,241362
293345,201808,244,194,50,185076,47700,232776
293350,201808,641,350,291,333900,276135.3,610035.3
293360,201808,1582,1132,450,1078974,429013.8,1507987.8
310010,201808,151,78,73,74412,69356,143768
310020,201808,1062,587,475,558137.9,450955.92,1009093.82
310030,201808,335,272,63,258362.88,60102,318464.88
310040,201808,49,30,19,28620,18126,46746
310050,201808,186,123,63,116960.4,59816,176776.4
310060,201808,240,168,72,159795,68562,228357
310070,201808,16,8,8,7632,7632,15264
310080,201808,48,26,22,24804,20988,45792
310090,201808,973,519,454,489212.88,432257.8,921470.68
310100,201808,296,226,70,215604,66780,282384
310110,201808,738,395,343,375508.9,325972.46,701481.36
310120,201808,391,211,180,200191.2,171345.94,371537.14
310130,201808,33,21,12,20034,11448,31482
310140,201808,26,14,12,13356,11448,24804
310150,201808,1295,885,410,836422.8,390281.8,1226704.6
310160,201808,2096,1066,1030,1009143.73,980035.3,1989179.03
310163,201808,93,53,40,50562,38160,88722
310170,201808,2636,1129,1507,1076274.2,1435103.4,2511377.6
310180,201808,135,51,84,48654,79754.4,128408.4
310190,201808,488,331,157,315774,149205.6,464979.6
310200,201808,504,322,182,307188,173628,480816
310205,201808,57,44,13,41976,12402,54378
310210,201808,274,222,52,211788,49608,261396
310220,201808,58,35,23,33390,21942,55332
310230,201808,268,187,81,178207.2,77274,255481.2
310240,201808,104,90,14,85621.5,13356,98977.5
310250,201808,99,79,20,75366,19080,94446
310260,201808,788,427,361,404402.24,343659.42,748061.66
310270,201808,276,186,90,176891,85860,262751
310280,201808,359,271,88,257867,83952,341819
310285,201808,217,155,62,147561.86,59148,206709.86
310290,201808,256,146,110,139284,104940,244224
310300,201808,153,126,27,120204,25758,145962
310310,201808,9,7,2,6678,1908,8586
310320,201808,24,14,10,13356,9540,22896
310330,201808,32,24,8,22896,7632,30528
310340,201808,1726,1127,599,1067398.99,570587.8,1637986.79
310350,201808,2869,1562,1307,1486279.81,1246010.6,2732290.41
310360,201808,39,32,7,30528,6678,37206
310370,201808,127,105,22,100170,20702,120872
310375,201808,112,42,70,40068,66761,106829
310380,201808,53,31,22,28668,20988,49656
310390,201808,103,70,33,66780,31482,98262
310400,201808,2393,1563,830,1487124,791247.8,2278371.8
310410,201808,125,69,56,65826,53424,119250
310420,201808,669,353,316,335904.2,300501.06,636405.26
310430,201808,325,216,109,205825.5,103986,309811.5
310440,201808,70,41,29,39114,27666,66780
310445,201808,82,66,16,62964,15264,78228
310450,201808,856,537,319,512298,304326,816624
310460,201808,263,191,72,182214,68688,250902
310470,201808,506,327,179,311958,170766,482724
310480,201808,80,58,22,55332,20988,76320
310490,201808,515,244,271,231822,258534,490356
310500,201808,124,52,72,49608,68688,118296
310510,201808,602,400,202,380360.6,192699,573059.6
310520,201808,133,91,42,86814,40068,126882
310530,201808,88,39,49,37206,46459.8,83665.8
310540,201808,472,290,182,274276.6,173341.8,447618.4
310550,201808,87,57,30,54378,28620,82998
310560,201808,2985,2057,928,1951610.54,884691.9,2836302.44
310570,201808,120,81,39,77274,37206,114480
310590,201808,351,232,119,219382.8,113511.69,332894.49
310600,201808,159,91,68,84382.7,64872,149254.7
310610,201808,61,24,37,22896,35298,58194
310620,201808,46522,22352,24170,21246757.8,23016221.07,44262978.87
310630,201808,615,393,222,371631.2,210453.4,582084.6
310640,201808,142,117,25,111141,23850,134991
310650,201808,166,146,20,138044,19080,157124
310660,201808,92,57,35,54378,33390,87768
310665,201808,58,41,17,39114,16218,55332
310670,201808,6466,2931,3535,2789000.67,3368994.18,6157994.85
310680,201808,58,38,20,36252,19080,55332
310690,201808,622,450,172,422328.53,164088,586416.53
310700,201808,59,38,21,36252,19890.9,56142.9
310710,201808,1238,837,401,797244.23,381992,1179236.23
310720,201808,91,29,62,27666,59148,86814
310730,201808,1377,966,411,919209.83,391808,1311017.83
310740,201808,989,556,433,527276.4,412548.26,939824.66
310750,201808,248,145,103,137376.18,98262,235638.18
310760,201808,65,48,17,45792,15932,61724
310770,201808,96,45,51,42930,48654,91584
310780,201808,398,325,73,309468.6,69642,379110.6
310790,201808,98,80,18,76320,17172,93492
310800,201808,456,220,236,209403,224857.8,434260.8
310810,201808,170,119,51,112467.2,47700,160167.2
310820,201808,357,283,74,269982,70309.8,340291.8
310825,201808,199,163,36,155502,34344,189846
310830,201808,470,223,247,212081.94,235638,447719.94
310840,201808,377,218,159,207972,151686,359658
310850,201808,107,85,22,81090,20988,102078
310855,201808,384,303,81,289062,77274,366336
310860,201808,1411,1059,352,1005183.7,334072.9,1339256.6
310870,201808,53,41,12,39114,11448,50562
310880,201808,83,65,18,61723.8,17172,78895.8
310890,201808,310,184,126,175536,120204,295740
310900,201808,635,294,341,278569.8,325008.8,603578.6
310910,201808,243,165,78,156075.2,74412,230487.2
310920,201808,484,288,196,270937.2,186984,457921.2
310925,201808,43,35,8,33390,7346,40736
310930,201808,1094,662,432,631431.53,412032.3,1043463.83
310940,201808,686,353,333,336762,317682,654444
310945,201808,116,71,45,67734,42930,110664
310950,201808,254,202,52,192708,49608,242316
310960,201808,84,30,54,28620,51512,80132
310970,201808,166,104,62,99216,58225.76,157441.76
310980,201808,44,23,21,21942,20034,41976
310990,201808,150,83,67,78896,63918,142814
311000,201808,854,421,433,398105.69,413073,811178.69
311010,201808,39,32,7,30528,6678,37206
311020,201808,42,26,16,24804,15264,40068
311030,201808,386,231,155,218466,147489,365955
311040,201808,40,35,5,33390,4770,38160
311050,201808,465,193,272,183550,258915.6,442465.6
311060,201808,765,435,330,412891.6,314534,727425.6
311070,201808,339,156,183,148824,174582,323406
311080,201808,106,58,48,55332,45792,101124
311090,201808,391,185,206,175536,196524,372060
311100,201808,606,361,245,344107.8,233157.6,577265.4
311110,201808,672,462,210,440461.8,200331,640792.8
311115,201808,70,51,19,48654,18126,66780
311120,201808,1067,568,499,538674.2,475139.9,1013814.1
311130,201808,404,241,163,229723.2,155502,385225.2
311140,201808,165,85,80,80803.8,75509.1,156312.9
311150,201808,359,234,125,223236,119011.5,342247.5
311160,201808,741,533,208,506097.4,197955,704052.4
311170,201808,78,58,20,55332,18793.8,74125.8
311180,201808,351,234,117,222949.8,111332,334281.8
311190,201808,35,17,18,16218,17172,33390
311200,201808,338,237,101,224476.6,96354,320830.6
311205,201808,33,22,11,20988,10112.4,31100.4
311210,201808,50,42,8,39782,7632,47414
311220,201808,19,17,2,16218,1908,18126
311230,201808,1637,1072,565,1018322.74,539010,1557332.74
311240,201808,179,114,65,108552.33,62010,170562.33
311250,201808,89,29,60,27666,57240,84906
311260,201808,548,347,201,331038,191754,522792
311265,201808,114,80,34,76320,32436,108756
311270,201808,285,207,78,197478,74412,271890
311280,201808,213,97,116,92538,110091.6,202629.6
311290,201808,108,88,20,83952,18794,102746
311300,201808,557,355,202,338670,192422,531092
311310,201808,25,19,6,18126,5724,23850
311320,201808,671,497,174,473184,165996,639180
311330,201808,1049,770,279,734341.5,265212.4,999553.9
311340,201808,2659,1887,772,1790975.41,734848.66,2525824.07
311350,201808,276,210,66,200340,62964,263304
311360,201808,175,105,70,100170,66780,166950
311370,201808,1207,497,710,472405.5,676767.6,1149173.1
311380,201808,7,6,1,5724,954,6678
311390,201808,281,147,134,140238,127645.2,267883.2
311400,201808,152,101,51,96354,48654,145008
311410,201808,101,57,44,54092,41976,96068
311420,201808,299,167,132,158364.8,125928,284292.8
311430,201808,868,566,302,538057.2,287822,825879.2
311440,201808,491,343,148,327222,140905.8,468127.8
311450,201808,325,204,121,194616,115434,310050
311455,201808,305,207,98,197182.8,93492,290674.8
311460,201808,135,56,79,53424,74560.27,127984.27
311470,201808,23,13,10,12402,9540,21942
311480,201808,32,14,18,13356,17172,30528
311490,201808,17,11,6,10494,5724,16218
311500,201808,20,10,10,9540,9540,19080
311510,201808,633,443,190,420393.3,181260,601653.3
311520,201808,45,35,10,32722.2,9540,42262.2
311530,201808,1813,1363,450,1287686.39,429300,1716986.39
311535,201808,72,51,21,48654,20034,68688
311540,201808,34,29,5,27666,4770,32436
311545,201808,190,141,49,134514,46746,181260
311547,201808,34,26,8,24804,7632,32436
311550,201808,660,307,353,292192,336743.46,628935.46
311560,201808,43,28,15,26712,14310,41022
311570,201808,295,199,96,189273.6,91584,280857.6
311580,201808,319,188,131,179065.8,124974,304039.8
311590,201808,32,28,4,26712,3816,30528
311600,201808,94,75,19,71550,18126,89676
311610,201808,254,222,32,210834.5,30528,241362.5
311615,201808,106,89,17,84906,16027.2,100933.2
311620,201808,22,12,10,11448,9540,20988
311630,201808,84,70,14,66780,13356,80136
311640,201808,131,67,64,63918,61056,124974
311650,201808,128,95,33,89914.5,31482,121396.5
311660,201808,413,200,213,190800,203202,394002
311670,201808,168,109,59,103741,56286,160027
311680,201808,223,162,61,153646.95,57430.8,211077.75
311690,201808,18,11,7,10494,6678,17172
311700,201808,201,141,60,134227.8,56851.81,191079.61
311710,201808,211,134,77,127836,73458,201294
311720,201808,36,26,10,24518,9540,34058
311730,201808,569,373,196,355270,186984,542254
311740,201808,39,28,11,26712,10494,37206
311750,201808,705,477,228,454104.8,217512,671616.8
311760,201808,64,36,28,34344,26712,61056
311770,201808,392,194,198,183168.62,188892,372060.62
311780,201808,176,97,79,92252,75049,167301
311783,201808,83,74,9,70596,8586,79182
311787,201808,34,14,20,13356,19080,32436
311790,201808,263,126,137,120204,130698,250902
311800,201808,666,446,220,422098.3,209056.07,631154.37
311810,201808,45,38,7,36252,6678,42930
311820,201808,112,95,17,90630,16218,106848
311830,201808,1953,1234,719,1171145.1,681729.2,1852874.3
311840,201808,1036,575,461,543972.9,437286.61,981259.51
311850,201808,11,7,4,6678,3816,10494
311860,201808,9513,4326,5187,4110939.11,4942046.47,9052985.58
311870,201808,146,82,64,78228,61056,139284
311880,201808,948,706,242,671988.8,230868,902856.8
311890,201808,219,110,109,104940,103986,208926
311900,201808,83,35,48,33390,45792,79182
311910,201808,1416,875,541,832556.6,514015.4,1346572.0
311920,201808,233,153,80,145962,76320,222282
311930,201808,920,527,393,502472,374684,877156
311940,201808,2554,1338,1216,1274115.7,1156725,2430840.7
311950,201808,42,30,12,28620,11448,40068
311960,201808,66,47,19,44838,18126,62964
311970,201808,27,17,10,13928.4,9540,23468.4
311980,201808,43,33,10,31195.8,9540,40735.8
311990,201808,56,40,16,38160,15264,53424
311995,201808,63,44,19,41976,18126,60102
312000,201808,35,25,10,23563.8,9540,33103.8
312010,201808,84,62,22,58862,20988,79850
312015,201808,100,75,25,71264,23850,95114
312020,201808,141,88,53,83666,50562,134228
312030,201808,46,37,9,34631,8586,43217
312040,201808,82,52,30,49608,28620,78228
312050,201808,214,116,98,110664,93492,204156
312060,201808,67,40,27,38160,25090.2,63250.2
312070,201808,75,47,28,44838,26712,71550
312080,201808,535,244,291,232776,277614,510390
312083,201808,50,36,14,34344,13356,47700
312087,201808,114,93,21,88722,20034,108756
312090,201808,2955,1699,1256,1606923.5,1194842.35,2801765.85
312100,201808,156,109,47,103766.58,44056,147822.58
312110,201808,116,73,43,69355.8,41022,110377.8
312120,201808,145,108,37,102079,35298,137377
312125,201808,97,56,41,53424,39114,92538
312130,201808,121,81,40,77274,38160,115434
312140,201808,140,109,31,103414,29574,132988
312150,201808,48,37,11,35298,10494,45792
312160,201808,1544,1020,524,968353.6,498484.48,1466838.08
312170,201808,12,10,2,9540,1908,11448
312180,201808,104,63,41,59387,38828,98215
312190,201808,31,27,4,25758,3816,29574
312200,201808,743,641,102,609558.7,97308,706866.7
312210,201808,94,63,31,60102,29574,89676
312220,201808,128,94,34,89438,32436,121874
312230,201808,3579,1754,1825,1668958.48,1739680.62,3408639.10
312235,201808,155,103,52,98262,49608,147870
312240,201808,107,71,36,67734,34344,102078
312245,201808,172,118,54,112568,51516,164084
312247,201808,63,45,18,42167,17172,59339
312250,201808,182,85,97,81090,92538,173628
312260,201808,103,70,33,65922.2,31482,97404.2
312270,201808,137,85,52,81090,49608,130698
312280,201808,26,16,10,15264,9540,24804
312290,201808,161,109,52,103986,48655,152641
312300,201808,201,133,68,126882,64872,191754
312310,201808,57,52,5,49608,4770,54378
312320,201808,434,272,162,257580,152974.1,410554.1
312330,201808,89,79,10,74602.8,9253.8,83856.6
312340,201808,35,16,19,15264,18126,33390
312350,201808,18,11,7,10494,6678,17172
312352,201808,99,67,32,63918,30528,94446
312360,201808,560,256,304,243270,290016,533286
312370,201808,309,181,128,172387.8,122112,294499.8
312380,201808,138,91,47,86814,44838,131652
312385,201808,172,140,32,133273.8,30528,163801.8
312390,201808,303,190,113,180592.2,107135,287727.2
312400,201808,380,291,89,277614,84430,362044
312410,201808,899,291,608,277137,579456,856593
312420,201808,618,485,133,461736.2,126882,588618.2
312430,201808,865,639,226,607318.05,214650.2,821968.25
312440,201808,46,34,12,32436,11448,43884
312450,201808,213,132,81,125928,77274,203202
312460,201808,61,29,32,27666,30528,58194
312470,201808,55,36,19,34344,18126,52470
312480,201808,203,123,80,117342,76320,193662
312490,201808,272,187,85,178398,81090,259488
312500,201808,33,18,15,17172,14310,31482
312510,201808,452,176,276,167904,262974.59,430878.59
312520,201808,43,15,28,14310,26712,41022
312530,201808,50,37,13,35298,12402,47700
312540,201808,100,87,13,82998,12402,95400
312550,201808,40,32,8,30528,7632,38160
312560,201808,213,158,55,150446,52183.8,202629.8
312570,201808,442,265,177,252142.2,168309.45,420451.65
312580,201808,85,44,41,41976,39114,81090
312590,201808,268,212,56,202248,53424,255672
312595,201808,139,124,15,118296,14310,132606
312600,201808,75,46,29,43455,27666,71121
312610,201808,1633,856,777,809375.98,739541.6,1548917.58
312620,201808,193,138,55,131652,52465.23,184117.23
312630,201808,65,55,10,52470,9540,62010
312640,201808,47,13,34,12402,32436,44838
312650,201808,151,126,25,119918,23694,143612
312660,201808,72,54,18,51230,17172,68402
312670,201808,870,573,297,545689,283124.3,828813.3
312675,201808,41,32,9,30528,8586,39114
312680,201808,85,56,29,53042.4,27666,80708.4
312690,201808,236,125,111,119240.46,105607.8,224848.26
312695,201808,33,26,7,24804,6678,31482
312700,201808,220,126,94,120204,89676,209880
312705,201808,78,64,14,61056,13356,74412
312707,201808,118,88,30,83532.24,28620,112152.24
312710,201808,1896,1006,890,958650,847863,1806513
312720,201808,66,33,33,31482,31482,62964
312730,201808,288,169,119,160272,113526,273798
312733,201808,53,45,8,42644,7632,50276
312735,201808,22,16,6,15264,5724,20988
312737,201808,70,38,32,36252,30528,66780
312738,201808,54,38,16,36252,15264,51516
312740,201808,76,51,25,48368,23850,72218
312750,201808,69,51,18,48654,17172,65826
312760,201808,271,199,72,189846,68688,258534
312770,201808,7649,3560,4089,3374963.24,3896297.23,7271260.47
312780,201808,430,330,100,314533.8,95400,409933.8
312790,201808,21,16,5,15264,4770,20034
312800,201808,1605,1123,482,1065161.28,459637.2,1524798.48
312810,201808,377,243,134,231535.8,127836,359371.8
312820,201808,193,145,48,138330,45792,184122
312825,201808,26,17,9,16218,8586,24804
312830,201808,275,164,111,155217,105255,260472
312840,201808,151,110,41,104940,39114,144054
312850,201808,28,25,3,23850,2862,26712
312860,201808,165,100,65,95114,62010,157124
312870,201808,991,522,469,495380.44,447426,942806.44
312880,201808,152,104,48,99072.9,45696.6,144769.5
312890,201808,168,116,52,109854,49608,159462
312900,201808,208,157,51,149110.2,48654,197764.2
312910,201808,190,98,92,92328.72,87768,180096.72
312920,201808,158,87,71,82998,67734,150732
312930,201808,346,250,96,238500,91584,330084
312940,201808,111,76,35,72504,33390,105894
312950,201808,697,458,239,435882.6,228006,663888.6
312960,201808,173,133,40,126882,38160,165042
312965,201808,55,51,4,48654,3816,52470
312970,201808,294,236,58,224190.2,55332,279522.2
312980,201808,2341,1229,1112,1166736,1060557.8,2227293.8
312990,201808,49,28,21,26712,20034,46746
313000,201808,41,23,18,21942,17172,39114
313005,201808,170,132,38,125689.5,35966,161655.5
313010,201808,944,384,560,365095.8,534231,899326.8
313020,201808,190,99,91,93969,86814,180783
313030,201808,205,134,71,125929,67734,193663
313040,201808,69,27,42,25758,40068,65826
313050,201808,297,208,89,198432,84906,283338
313055,201808,47,35,12,33390,11448,44838
313060,201808,121,84,37,80136,35011.8,115147.8
313065,201808,61,40,21,38160,20034,58194
313070,201808,149,79,70,75366,66780,142146
313080,201808,42,18,24,17172,22896,40068
313090,201808,714,497,217,472850.3,207018,679868.3
313100,201808,165,64,101,61056,96346,157402
313110,201808,131,75,56,71550,53424,124974
313115,201808,173,95,78,90429.66,74412,164841.66
313120,201808,765,421,344,401348,326936,728284
313130,201808,5349,2908,2441,2751411.72,2319815.56,5071227.28
313140,201808,156,81,75,77274,71550,148824
313150,201808,312,248,64,236592,60769.8,297361.8
313160,201808,202,148,54,140906,51516,192422
313170,201808,1376,966,410,908544.1,390749.4,1299293.5
313180,201808,322,193,129,183473.28,122780,306253.28
313190,201808,754,457,297,432824.1,282575,715399.1
313200,201808,24,23,1,21942,954,22896
313210,201808,1048,883,165,838663.66,157405.23,996068.89
313220,201808,245,168,77,159318,72456.3,231774.3
313230,201808,269,197,72,186985,68688,255673
313240,201808,1927,1031,896,979655.73,851821.83,1831477.56
313250,201808,1276,953,323,904489.8,307189,1211678.8
313260,201808,96,54,42,51516,40068,91584
313270,201808,957,564,393,534384.1,374922,909306.1
313280,201808,60,51,9,48177,8586,56763
313290,201808,226,182,44,173342,41022.8,214364.8
313300,201808,379,198,181,185745,172674,358419
313310,201808,229,117,112,111618,106848,218466
313320,201808,375,288,87,272797.1,82998,355795.1
313330,201808,1366,841,525,800883.2,499658.5,1300541.7
313340,201808,334,232,102,221328,97308,318636
313350,201808,517,351,166,332946.1,158364,491310.1
313360,201808,116,70,46,66780,43598,110378
313370,201808,193,68,125,64872,119250,184122
313375,201808,278,168,110,160272,104940,265212
313380,201808,1342,695,647,659901.08,617234,1277135.08
313390,201808,52,47,5,43884.8,4770,48654.8
313400,201808,421,283,138,269982,131080,401062
313410,201808,21,13,8,12402,7632,20034
313420,201808,4690,2445,2245,2323536.38,2134099.76,4457636.14
313430,201808,143,67,76,63918,72504,136422
313440,201808,1508,1037,471,985245.03,447904,1433149.03
313450,201808,63,27,36,25758,34057.8,59815.8
313460,201808,377,176,201,167418,191754,359172
313470,201808,533,244,289,232776,275038.2,507814.2
313480,201808,156,108,48,102079,45792,147871
313490,201808,517,250,267,238495.23,254671,493166.23
313500,201808,21,14,7,13356,6678,20034
313505,201808,993,773,220,736231.4,209695.21,945926.61
313507,201808,100,60,40,57240,38160,95400
313510,201808,2801,1800,1001,1710320.68,954000,2664320.68
313520,201808,3619,2838,781,2694639.97,745070,3439709.97
313530,201808,45,30,15,28620,14310,42930
313535,201808,109,87,22,82331,20988,103319
313540,201808,74,55,19,52470,18126,70596
313545,201808,115,96,19,91584,18126,109710
313550,201808,234,193,41,184122,38828,222950
313560,201808,328,167,161,159318,153594,312912
313570,201808,60,32,28,30528,26712,57240
313580,201808,1324,732,592,695657,563910,1259567
313590,201808,78,46,32,43884,30528,74412
313600,201808,697,420,277,400394,263972,664366
313610,201808,60,47,13,44218.8,12402,56620.8
313620,201808,1375,725,650,681218.18,615167.6,1296385.78
313630,201808,1642,1256,386,1194865.4,367958,1562823.4
313640,201808,128,75,53,71550,50562,122112
313650,201808,240,111,129,105894,122494,228388
313652,201808,18,18,0,17172,0,17172
313655,201808,56,32,24,30528,22896,53424
313657,201808,47,44,3,41976,2862,44838
313660,201808,135,91,44,86814,41993.17,128807.17
313665,201808,656,315,341,300510,325075.5,625585.5
313670,201808,10300,7137,3163,6783825.28,3016643.8,9800469.08
313680,201808,42,31,11,29574,10390,39964
313690,201808,154,115,39,109710,37206,146916
313695,201808,80,61,19,58194,18126,76320
313700,201808,307,249,58,237260,55332,292592
313710,201808,145,98,47,93492,44838,138330
313720,201808,1107,531,576,504380,548159.86,1052539.86
313730,201808,61,42,19,40068,18126,58194
313740,201808,162,132,30,125928,28620,154548
313750,201808,441,322,119,307188,113526,420714
313753,201808,245,178,67,169144.2,63918,233062.2
313760,201808,1263,455,808,433784,768372.18,1202156.18
313770,201808,361,262,99,249042.2,94446,343488.2
313780,201808,762,395,367,376830,349831.8,726661.8
313790,201808,30,29,1,27666,954,28620
313800,201808,149,94,55,89676,52470,142146
313810,201808,68,39,29,37206,27666,64872
313820,201808,1285,642,643,611896,612159,1224055
313830,201808,66,48,18,45792,17172,62964
313835,201808,58,49,9,46746,8586,55332
313840,201808,1720,1065,655,1010669.52,623630.2,1634299.72
313850,201808,183,62,121,59148,114854.06,174002.06
313860,201808,479,369,110,348545.3,104940,453485.3
313862,201808,174,116,58,110664,55332,165996
313865,201808,92,73,19,69642,18126,87768
313867,201808,47,36,11,34344,10494,44838
313868,201808,29,20,9,18317,8586,26903
313870,201808,127,65,62,62010,58862,120872
313880,201808,357,223,134,212742,127550,340292
313890,201808,327,176,151,167141.8,143481.6,310623.4
313900,201808,904,495,409,471276.5,390139,861415.5
313910,201808,139,100,39,95400,36252.2,131652.2
313920,201808,622,443,179,422431.2,170246,592677.2
313925,201808,32,28,4,26712,3816,30528
313930,201808,824,636,188,606458,179329,785787
313940,201808,1823,1150,673,1093188.8,641374.4,1734563.2
313950,201808,940,598,342,568730.6,325981.8,894712.4
313960,201808,1399,802,597,760844.3,566392,1327236.3
313970,201808,122,83,39,79182,37206,116388
313980,201808,213,139,74,132368,70596,202964
313990,201808,377,227,150,216558,143100,359658
314000,201808,929,627,302,594677.9,288103.23,882781.13
314010,201808,79,52,27,49608,25758,75366
314015,201808,53,16,37,15264,35298,50562
314020,201808,53,37,16,35298,15264,50562
314030,201808,82,37,45,35135.82,42930,78065.82
314040,201808,45,30,15,28620,14310,42930
314050,201808,313,186,127,177158,121158,298316
314053,201808,98,64,34,60102.4,32436,92538.4
314055,201808,297,178,119,169812,113526,283338
314060,201808,146,124,22,117342,20988,138330
314070,201808,1049,535,514,507538.34,489736,997274.34
314080,201808,219,143,76,135468,71454.88,206922.88
314085,201808,138,91,47,86814,44838,131652
314090,201808,355,258,97,246132,92533.23,338665.23
314100,201808,477,392,85,370153,81090,451243
314110,201808,723,391,332,371382.66,316155.6,687538.26
314120,201808,97,56,41,53424,39114,92538
314130,201808,24,11,13,10494,12402,22896
314140,201808,1105,673,432,637443.92,408980.46,1046424.38
314150,201808,164,104,60,99216,57240,156456
314160,201808,351,263,88,248040.8,83762,331802.8
314170,201808,79,61,18,58194,17172,75366
314180,201808,737,651,86,620768,81090.5,701858.5
314190,201808,100,59,41,56286,39114,95400
314200,201808,588,408,180,387961.6,170766,558727.6
314210,201808,280,212,68,201294,64586,265880
314220,201808,312,235,77,222283,73172,295455
314225,201808,65,47,18,44838,17172,62010
314230,201808,106,46,60,43884,57240,101124
314240,201808,142,110,32,104940,30528,135468
314250,201808,60,37,23,35298,21942,57240
314260,201808,190,96,94,91584,89676,181260
314270,201808,325,260,65,248040,62010,310050
314280,201808,693,388,305,370143,290970,661113
314290,201808,565,462,103,439508.5,97975.8,537484.3
314300,201808,403,288,115,271387,109663,381050
314310,201808,1445,974,471,927289.12,449313.97,1376603.09
314315,201808,37,30,7,28620,6678,35298
314320,201808,612,396,216,377211.8,205424.82,582636.62
314330,201808,10681,5402,5279,5142168.96,5031700.75,10173869.71
314340,201808,573,268,305,255179.8,290398,545577.8
314345,201808,37,27,10,25758,9540,35298
314350,201808,191,121,70,115434,66780,182214
314360,201808,82,52,30,49608,28620,78228
314370,201808,57,48,9,45792,8586,54378
314380,201808,92,66,26,62964,24804,87768
314390,201808,3293,2090,1203,1988542.31,1144705.4,3133247.71
314400,201808,690,493,197,467452.2,187938,655390.2
314410,201808,446,291,155,277614,147870,425484
314420,201808,18,9,9,8586,8586,17172
314430,201808,2503,902,1601,855000.59,1524842.47,2379843.06
314435,201808,274,160,114,152353.8,107802,260155.8
314437,201808,27,21,6,20034,5724,25758
314440,201808,96,70,26,66780,24804,91584
314450,201808,155,114,41,108756,39114,147870
314460,201808,653,306,347,291924,331038,622962
314465,201808,87,57,30,54378,28620,82998
314467,201808,70,57,13,54369,12402,66771
314470,201808,392,204,188,191164.52,178398.5,369563.02
314480,201808,1083,516,567,492264,540727.2,1032991.2
314490,201808,87,65,22,62010,20988,82998
314500,201808,313,208,105,198432,100170,298602
314505,201808,128,85,43,81090,41022,122112
314510,201808,230,190,40,181260,38160,219420
314520,201808,1268,658,610,618961.3,580795.8,1199757.1
314530,201808,737,584,153,556501,145962,702463
314535,201808,212,135,77,127740.6,73458,201198.6
314537,201808,64,39,25,37206,23850,61056
314540,201808,14,9,5,8586,4770,13356
314545,201808,48,31,17,29574,16218,45792
314550,201808,82,44,38,41976,36252,78228
314560,201808,825,445,380,422049.8,362520,784569.8
314570,201808,21,17,4,16218,3816,20034
314580,201808,16,8,8,7632,7632,15264
314585,201808,22,17,5,16218,4770,20988
314587,201808,84,73,11,69642,10494,80136
314590,201808,582,428,154,406786.5,146630,553416.5
314600,201808,970,636,334,602349.06,317109.8,919458.86
314610,201808,947,514,433,487494.7,412605,900099.7
314620,201808,151,112,39,105607.8,37206,142813.8
314625,201808,99,73,26,69070,24804,93874
314630,201808,1234,638,596,607173.3,568011.8,1175185.1
314640,201808,89,57,32,54378,30241.8,84619.8
314650,201808,195,113,82,107515.8,77751,185266.8
314655,201808,66,50,16,47700,15264,62964
314660,201808,20,16,4,15264,3816,19080
314670,201808,193,153,40,145676,38160,183836
314675,201808,218,129,89,123066,84906,207972
314690,201808,545,299,246,284959.8,234684,519643.8
314700,201808,2419,1324,1095,1258089.5,1043563.9,2301653.4
314710,201808,1633,954,679,905826.5,647146.1,1552972.6
314720,201808,413,248,165,235189.62,157410,392599.62
314730,201808,517,270,247,255864,235342.8,491206.8
314740,201808,691,342,349,324884.7,332946,657830.7
314750,201808,20,17,3,16218,2862,19080
314760,201808,332,160,172,152640,164078.46,316718.46
314770,201808,121,82,39,78228,37206,115434
314780,201808,21,6,15,5724,14310,20034
314790,201808,2385,1496,889,1419831.3,847285.56,2267116.86
314795,201808,55,47,8,44600,7632,52232
314800,201808,2958,1744,1214,1657250.86,1156152.6,2813403.46
314810,201808,1508,841,667,799548.2,634697,1434245.2
314820,201808,93,51,42,48654,40068,88722
314830,201808,209,167,42,158602.5,39782,198384.5
314840,201808,81,46,35,43884,33390,77274
314850,201808,352,171,181,163134,172674,335808
314860,201808,713,535,178,508386.86,167618.7,676005.56
314870,201808,1487,779,708,742212,675432,1417644
314875,201808,57,49,8,46746,7632,54378
314880,201808,47,34,13,32436,12402,44838
314890,201808,57,34,23,32436,21942,54378
314900,201808,33,26,7,24804,6678,31482
314910,201808,250,169,81,160939.8,77274,238213.8
314915,201808,164,144,20,137376,19080,156456
314920,201808,123,76,47,72504,44551.8,117055.8
314930,201808,1040,530,510,503756.33,485967.6,989723.93
314940,201808,52,40,12,38160,11448,49608
314950,201808,38,27,11,25758,10494,36252
314960,201808,55,41,14,39114,13356,52470
314970,201808,144,74,70,70596,66780,137376
314980,201808,301,191,110,179972.1,103986,283958.1
314990,201808,467,256,211,244224,200388.5,444612.5
314995,201808,207,63,144,60102,137366.46,197468.46
315000,201808,92,75,17,71550,16218,87768
315010,201808,46,30,16,28620,15264,43884
315015,201808,178,146,32,138558.96,30528,169086.96
315020,201808,73,63,10,60102,9540,69642
315030,201808,117,91,26,85860,24804,110664
315040,201808,67,48,19,45792,18126,63918
315050,201808,199,119,80,113526,76034,189560
315053,201808,41,36,5,34344,4626.9,38970.9
315057,201808,97,80,17,75938.4,16218,92156.4
315060,201808,74,65,9,60103.16,8586,68689.16
315070,201808,102,57,45,54378,42930,97308
315080,201808,376,309,67,294786,63918,358704
315090,201808,110,66,44,62964,41976,104940
315100,201808,83,42,41,40068,39114,79182
315110,201808,293,163,130,154644,124020,278664
315120,201808,1668,845,823,801284.98,782948.64,1584233.62
315130,201808,343,249,94,237546,89676,327222
315140,201808,528,310,218,294118.2,207972,502090.2
315150,201808,982,471,511,448381,487208,935589
315160,201808,217,108,109,103032,103986,207018
315170,201808,332,214,118,203203,112285.8,315488.8
315180,201808,3203,1353,1850,1287662.3,1761969.48,3049631.78
315190,201808,323,188,135,178971,128790,307761
315200,201808,1200,694,506,660454.2,481865.4,1142319.6
315210,201808,1561,884,677,840761.8,643438.2,1484200.0
315213,201808,44,25,19,23850,18126,41976
315217,201808,216,173,43,165042,41022,206064
315220,201808,1549,1185,364,1129432.4,346970,1476402.4
315230,201808,171,125,46,118964,43884,162848
315240,201808,424,273,151,260442,142852.5,403294.5
315250,201808,2550,1259,1291,1200508.83,1231223.66,2431732.49
315260,201808,149,90,59,84906,56286,141192
315270,201808,132,91,41,86241.6,38388.96,124630.56
315280,201808,701,456,245,434643,233720.46,668363.46
315290,201808,200,118,82,112572,77274.49,189846.49
315300,201808,72,50,22,47700,20988,68688
315310,201808,68,62,6,59148,5724,64872
315320,201808,165,95,70,90630,66780,157410
315330,201808,59,51,8,48654,7632,56286
315340,201808,413,296,117,281201.6,111618,392819.6
315350,201808,151,90,61,85860,58194,144054
315360,201808,95,51,44,48654,41976,90630
315370,201808,59,34,25,31721,23850,55571
315380,201808,12,7,5,6678,4770,11448
315390,201808,65,14,51,13356,48654,62010
315400,201808,837,631,206,596536.5,195856.2,792392.7
315410,201808,357,218,139,207686,132320,340006
315415,201808,64,49,15,46746,14310,61056
315420,201808,203,154,49,145820,46746,192566
315430,201808,672,391,281,370629.2,267597.8,638227.0
315440,201808,88,60,28,57240,26712,83952
315445,201808,257,207,50,197163.18,47700,244863.18
315450,201808,177,133,44,126882,41976,168858
315460,201808,3498,1771,1727,1686473.4,1644830.9,3331304.3
315470,201808,43,21,22,20034,20988,41022
315480,201808,65,26,39,24804,37206,62010
315490,201808,638,400,238,379548.9,227052,606600.9
315500,201808,22,14,8,13356,7632,20988
315510,201808,154,103,51,98262,48654,146916
315520,201808,74,65,9,62010,8586,70596
315530,201808,54,29,25,27666,23850,51516
315540,201808,236,156,80,148824,76320,225144
315550,201808,178,142,36,135468,34344,169812
315560,201808,739,590,149,561520.8,142146,703666.8
315570,201808,317,165,152,154215.5,144781,298996.5
315580,201808,675,442,233,421001,222282,643283
315590,201808,206,109,97,103986,92538,196524
315600,201808,293,217,76,206779.5,72504,279283.5
315610,201808,101,49,52,46746,49608,96354
315620,201808,33,27,6,25758,5724,31482
315630,201808,136,90,46,85860,43884,129744
315640,201808,64,39,25,37206,23850,61056
315645,201808,66,47,19,44838,17649,62487
315650,201808,168,122,46,115816,43311.6,159127.6
315660,201808,478,212,266,202248,253764,456012
315670,201808,2437,1207,1230,1148693.32,1172247.66,2320940.98
315680,201808,858,583,275,553389.66,262350,815739.66
315690,201808,681,469,212,447305,202248,649553
315700,201808,1918,1010,908,959668.37,866137,1825805.37
315710,201808,331,90,241,85860,229914,315774
315720,201808,441,285,156,271890,148824,420714
315725,201808,202,162,40,154262,38160,192422
315727,201808,42,22,20,20988,19080,40068
315730,201808,47,45,2,42930,1908,44838
315733,201808,91,60,31,57240,29574,86814
315737,201808,50,39,11,37206,10494,47700
315740,201808,47,39,8,37206,7632,44838
315750,201808,157,120,37,114480,35298,149778
315760,201808,48,34,14,32436,13356,45792
315765,201808,122,78,44,74412,41976,116388
315770,201808,233,143,90,136422,85574,221996
315780,201808,3334,1727,1607,1640985.94,1531284.16,3172270.10
315790,201808,209,159,50,151686,47127.6,198813.6
315800,201808,289,210,79,200340,75366,275706
315810,201808,97,57,40,54378,37874,92252
315820,201808,800,581,219,551699.34,208926,760625.34
315830,201808,141,82,59,78228,56286,134514
315840,201808,94,66,28,62964,26712,89676
315850,201808,257,194,63,185076,60102,245178
315860,201808,13,5,8,4770,7632,12402
315870,201808,36,28,8,26712,7632,34344
315880,201808,110,71,39,67734,37206,104940
315890,201808,83,62,21,59148,20034,79182
315895,201808,468,317,151,301369,143482,444851
315900,201808,71,34,37,32150,35298,67448
315910,201808,39,25,14,23611.5,13356,36967.5
315920,201808,178,117,61,111618,57240.9,168858.9
315930,201808,45,15,30,14310,28620,42930
315935,201808,151,118,33,112572,31473,144045
315940,201808,90,66,24,62964,22896,85860
315950,201808,64,46,18,43884,17172,61056
315960,201808,559,262,297,248679.38,282479.6,531158.98
315970,201808,37,30,7,28620,6678,35298
315980,201808,699,329,370,311624.4,352980,664604.4
315990,201808,256,150,106,142862,100829,243691
316000,201808,50,33,17,31195.8,15931.8,47127.6
316010,201808,76,64,12,61056,11448,72504
316020,201808,114,94,20,89676,19080,108756
316030,201808,407,217,190,206732,180736,387468
316040,201808,512,214,298,203202.2,284006,487208.2
316045,201808,61,54,7,51516,6678,58194
316050,201808,16,14,2,13356,1908,15264
316060,201808,99,64,35,61056,33390,94446
316070,201808,1081,704,377,666294.3,358895,1025189.3
316080,201808,104,66,38,62677.8,36252,98929.8
316090,201808,41,25,16,23182.2,15264,38446.2
316095,201808,74,62,12,58872,11448,70320
316100,201808,313,183,130,174057.3,124020,298077.3
316105,201808,35,24,11,22896,10494,33390
316110,201808,1920,1548,372,1466346.55,354220.2,1820566.75
316120,201808,79,59,20,56286,18793.8,75079.8
316130,201808,136,105,31,99503,29574,129077
316140,201808,27,20,7,19080,6678,25758
316150,201808,208,145,63,137614.5,60102,197716.5
316160,201808,84,50,34,47700,32436,80136
316165,201808,65,48,17,45602,15502.5,61104.5
316170,201808,204,138,66,130698,62964,193662
316180,201808,209,93,116,88388.1,110664,199052.1
316190,201808,142,105,37,99216,35298,134514
316200,201808,701,393,308,374922,292973.4,667895.4
316210,201808,772,518,254,495759.41,242316,738075.41
316220,201808,113,77,36,73458,34344,107802
316225,201808,26,15,11,14310,10494,24804
316230,201808,31,19,12,18126,11448,29574
316240,201808,635,511,124,487494,118296,605790
316245,201808,110,92,18,87768,17172,104940
316250,201808,1521,1059,462,1002923.5,439565.12,1442488.62
316255,201808,111,90,21,85478.4,20019.69,105498.09
316257,201808,183,95,88,90630,83665.8,174295.8
316260,201808,246,161,85,152297.06,80995,233292.06
316265,201808,28,19,9,18126,8586,26712
316270,201808,674,470,204,445375.4,194616,639991.4
316280,201808,540,331,209,314503.8,198718.6,513222.4
316290,201808,706,468,238,443420.18,227052,670472.18
316292,201808,520,208,312,198145.8,297410,495555.8
316294,201808,99,57,42,54378,40068,94446
316295,201808,303,135,168,126865,160272,287137
316300,201808,102,72,30,68688,28620,97308
316310,201808,38,20,18,18793.8,17172,35965.8
316320,201808,41,25,16,23850,15264,39114
316330,201808,132,85,47,80136.5,44551.8,124688.3
316340,201808,147,101,46,96354,43884,140238
316350,201808,193,140,53,133394,50562,183956
316360,201808,25,18,7,17172,6678,23850
316370,201808,1080,575,505,544086.7,481474.26,1025560.96
316380,201808,124,95,29,90630,27666,118296
316390,201808,125,89,36,84906,34344,119250
316400,201808,139,105,34,100170,32436,132606
316410,201808,308,226,82,214220.7,78228,292448.7
316420,201808,206,147,59,139522.5,56286,195808.5
316430,201808,154,79,75,75366,71550,146916
316440,201808,98,47,51,44838,48654,93492
316443,201808,38,35,3,33390,2862,36252
316447,201808,63,49,14,46746,13356,60102
316450,201808,224,167,57,159318,54378,213696
316460,201808,70,30,40,28620,38160,66780
316470,201808,1641,1192,449,1128222.64,426224.79,1554447.43
316480,201808,13,10,3,9540,2862,12402
316490,201808,18,7,11,6678,10494,17172
316500,201808,154,103,51,97975.8,48654,146629.8
316510,201808,163,124,39,117294.3,37206,154500.3
316520,201808,186,114,72,108756,68688,177444
316530,201808,160,113,47,107802,44551.8,152353.8
316540,201808,143,81,62,77274,59148,136422
316550,201808,134,96,38,91584,36252,127836
316553,201808,250,120,130,114480,124020,238500
316555,201808,33,26,7,24000,6678,30678
316556,201808,11,8,3,7632,2862,10494
316557,201808,17,13,4,12402,3816,16218
316560,201808,63,49,14,46746,13356,60102
316570,201808,243,220,23,209260,21942,231202
316580,201808,22,16,6,15264,5724,20988
316590,201808,114,99,15,94446,14310,108756
316600,201808,183,150,33,142337,31482,173819
316610,201808,69,48,21,45505.8,20034,65539.8
316620,201808,137,106,31,101124,29574,130698
316630,201808,45,33,12,31482,11448,42930
316640,201808,16,10,6,9540,5724,15264
316650,201808,70,54,16,51516,15264,66780
316660,201808,8,4,4,3816,3816,7632
316670,201808,442,157,285,149759,271317.8,421076.8
316680,201808,163,115,48,109710,45602,155312
316690,201808,194,125,69,119250,65826,185076
316695,201808,61,54,7,51516,6678,58194
316700,201808,15,8,7,7632,6678,14310
316710,201808,735,539,196,513648.88,186984,700632.88
316720,201808,4939,2516,2423,2387663.23,2306931.43,4694594.66
316730,201808,15,14,1,13356,954,14310
316740,201808,127,81,46,77274,43884,121158
316750,201808,21,14,7,13356,6678,20034
316760,201808,326,264,62,251856,59148,311004
316770,201808,140,77,63,73458,60102,133560
316780,201808,76,47,29,44532.72,27666,72198.72
316790,201808,57,44,13,41976,12402,54378
316800,201808,1801,1105,696,1053120.8,663508,1716628.8
316805,201808,18,10,8,9540,7632,17172
316810,201808,71,47,24,44838,22896,67734
316820,201808,42,20,22,19080,20988,40068
316830,201808,94,42,52,40068,49608,89676
316840,201808,507,306,201,291638,190800,482438
316850,201808,343,225,118,213982.2,112572,326554.2
316860,201808,6019,2680,3339,2543176.66,3179668.97,5722845.63
316870,201808,1480,963,517,909833.1,487782.2,1397615.3
316880,201808,120,65,55,61723.8,52470,114193.8
316890,201808,251,169,82,161179,78228,239407
316900,201808,421,290,131,274113.28,124974,399087.28
316905,201808,19,9,10,8586,9540,18126
316910,201808,52,25,27,23850,25758,49608
316920,201808,136,105,31,99455,29574,129029
316930,201808,1918,979,939,930103.5,893612.7,1823716.2
316935,201808,874,530,344,503712.72,327222,830934.72
316940,201808,1112,639,473,608652.4,450660.26,1059312.66
316950,201808,184,95,89,90630,84906,175536
316960,201808,1122,625,497,594914.8,473842.46,1068757.26
316970,201808,648,505,143,481284,136422,617706
316980,201808,110,66,44,62964,41966.46,104930.46
316990,201808,2208,1455,753,1380582.31,715158.56,2095740.87
317000,201808,331,254,77,242057,73458,315515
317005,201808,250,178,72,169812,68688,238500
317010,201808,6383,3511,2872,3329341.93,2737694,6067035.93
317020,201808,16386,7264,9122,6898805.03,8686571.67,15585376.70
317030,201808,80,31,49,29574,46529.26,76103.26
317040,201808,3133,1951,1182,1857068.23,1124862.61,2981930.84
317043,201808,77,56,21,53424,20034,73458
317047,201808,35,17,18,16218,17168,33386
317050,201808,180,135,45,128790,42930,171720
317052,201808,129,99,30,94446,28620,123066
317057,201808,195,147,48,140238,45220,185458
317060,201808,58,38,20,36252,18793.8,55045.8
317065,201808,57,45,12,42930,11448,54378
317070,201808,2000,943,1057,894853.7,1007233.6,1902087.3
317075,201808,108,57,51,54378,48654,103032
317080,201808,841,439,402,417708.9,383318,801026.9
317090,201808,636,508,128,482295.5,122112,604407.5
317100,201808,428,321,107,304326,102078,406404
317103,201808,108,93,15,88722,14310,103032
317107,201808,38,34,4,32436,3816,36252
317110,201808,104,44,60,41976,57240,99216
317115,201808,42,36,6,34344,5724,40068
317120,201808,1848,942,906,890477.62,863867,1754344.62
317130,201808,1957,1265,692,1200062,659501,1859563
317140,201808,10,8,2,7632,1908,9540
317150,201808,273,161,112,153308,106084.8,259392.8
317160,201808,313,226,87,215287,82898,298185
317170,201808,212,143,69,136422,65826,202248
317180,201808,437,318,119,302656.5,113526,416182.5
317190,201808,254,173,81,165042,76987.8,242029.8
317200,201808,819,575,244,535411.2,232538,767949.2
317210,201808,157,89,68,83952.2,64872,148824.2
317220,201808,19,13,6,12402,5724,18126
320010,201808,628,468,160,443324.5,152640,595964.5
320013,201808,135,100,35,95400,33390,128790
320016,201808,282,178,104,169812,99216,269028
320020,201808,732,438,294,414952.32,278568.32,693520.64
320030,201808,154,114,40,108756,37826.1,146582.1
320035,201808,141,104,37,99216,35298,134514
320040,201808,507,258,249,245273.8,236973.8,482247.6
320050,201808,119,89,30,84906,28620,113526
320060,201808,1591,750,841,715357.6,801628.06,1516985.66
320070,201808,104,68,36,64872,34344,99216
320080,201808,773,444,329,420745,313866,734611
320090,201808,1226,857,369,814224.86,351167.6,1165392.46
320100,201808,324,186,138,177444,131652,309096
320110,201808,135,88,47,82092.2,44552,126644.2
320115,201808,113,93,20,88722,19080,107802
320120,201808,3344,1877,1467,1779404.4,1396820.54,3176224.94
320130,201808,7489,3545,3944,3360539.34,3755657.15,7116196.49
320140,201808,428,277,151,263591,143810,407401
320150,201808,1953,1130,823,1070231.61,784846.26,1855077.87
320160,201808,676,307,369,290388.83,350910.99,641299.82
320170,201808,120,95,25,89867,23850,113717
320180,201808,50,29,21,27666,20034,47700
320190,201808,237,156,81,148051.26,76988,225039.26
320200,201808,57,45,12,42930,11448,54378
320210,201808,846,474,372,450670.6,353916,804586.6
320220,201808,310,116,194,110664,184790,295454
320225,201808,79,64,15,61056,14310,75366
320230,201808,579,376,203,357178.4,192852,550030.4
320240,201808,3171,1591,1580,1514476.8,1504605.78,3019082.58
320245,201808,465,318,147,302227.4,140238,442465.4
320250,201808,236,126,110,119250.6,104940,224190.6
320255,201808,147,114,33,107449.02,31339,138788.02
320260,201808,180,126,54,120204,51468.3,171672.3
320265,201808,164,130,34,123210,32436,155646
320270,201808,152,124,28,118296,26712,145008
320280,201808,979,581,398,549314.2,379406,928720.2
320290,201808,67,56,11,53424,10494,63918
320300,201808,550,391,159,370428.8,150637.1,521065.9
320305,201808,676,369,307,352026,292688,644714
320310,201808,215,120,95,112525.5,89874,202399.5
320313,201808,307,158,149,150732,141860,292592
320316,201808,108,88,20,83952,19080,103032
320320,201808,3367,1538,1829,1462188,1741885.8,3204073.8
320330,201808,258,191,67,181551.3,62010.8,243562.1
320332,201808,891,540,351,513303.6,333805.3,847108.9
320334,201808,241,147,94,139952,89676,229628
320335,201808,148,106,42,100170.4,40068,140238.4
320340,201808,588,409,179,389042,170099,559141
320350,201808,972,421,551,399441.67,524242.48,923684.15
320360,201808,169,91,78,86814,74412,161226
320370,201808,245,188,57,177660,53345,231005
320380,201808,288,196,92,185315.3,87768,273083.3
320390,201808,1146,699,447,663755.8,425818.13,1089573.93
320400,201808,318,229,89,217036.2,84906,301942.2
320405,201808,914,395,519,376253.6,494813.92,871067.52
320410,201808,988,507,481,482009.4,458541,940550.4
320420,201808,481,247,234,235161.4,223236,458397.4
320425,201808,201,109,92,103986,87768,191754
320430,201808,393,226,167,213982.7,159318,373300.7
320435,201808,172,116,56,109843.56,53424,163267.56
320440,201808,200,119,81,113526,77274,190800
320450,201808,131,76,55,72504,52470,124974
320455,201808,251,207,44,196525,41976,238501
320460,201808,247,154,93,146916,88722,235638
320465,201808,115,78,37,74049.48,35298,109347.48
320470,201808,649,416,233,396560.26,222278,618838.26
320480,201808,181,120,61,113669.1,58194,171863.1
320490,201808,3061,1526,1535,1452895.18,1461666.84,2914562.02
320495,201808,96,57,39,54359,37206,91565
320500,201808,9565,4814,4751,4563915.63,4519931.51,9083847.14
320501,201808,549,278,271,265212,258534,523746
320503,201808,288,204,84,193662.2,80136,273798.2
320506,201808,259,194,65,185076,62010,247086
320510,201808,976,462,514,437649.3,488830.1,926479.4
320515,201808,82,69,13,64872.9,12402,77274.9
320517,201808,210,150,60,143100,57240,200340
320520,201808,6988,3106,3882,2949211.15,3695397.15,6644608.30
320530,201808,5395,2707,2688,2573468.56,2558618.64,5132087.20
330010,201808,3165,1633,1532,1550508.16,1457776.17,3008284.33
330015,201808,157,66,91,61820.08,86814,148634.08
330020,201808,3648,1603,2045,1525715.72,1950072,3475787.72
330022,201808,237,133,104,126167,98262.8,224429.8
330023,201808,547,191,356,181164.6,339624,520788.6
330025,201808,588,120,468,114480,446185.8,560665.8
330030,201808,1966,1268,698,1201331.18,662623.68,1863954.86
330040,201808,2412,1246,1166,1185870.2,1110507.3,2296377.5
330045,201808,8393,2678,5715,2546684.82,5445820.57,7992505.39
330050,201808,842,538,304,513252,290016,803268
330060,201808,933,578,355,547121.1,337353.48,884474.58
330070,201808,3456,1322,2134,1254563.47,2034521.56,3289085.03
330080,201808,1495,701,794,662600.35,755949.6,1418549.95
330090,201808,366,216,150,206064,143100,349164
330093,201808,287,131,156,124974,148788,273762
330095,201808,102,54,48,50848.2,45792,96640.2
330100,201808,9563,4921,4642,4681621.42,4425176.9,9106798.32
330110,201808,488,216,272,203679.1,259488,463167.1
330115,201808,544,311,233,296694,222282,518976
330120,201808,377,196,181,185839.2,171720.8,357560.0
330130,201808,1545,420,1125,399954.96,1073232,1473186.96
330140,201808,605,319,286,304299,271891,576190
330150,201808,455,265,190,250902,181260,432162
330160,201808,210,131,79,124974,75366,200340
330170,201808,27177,9550,17627,9087909.26,16803396.41,25891305.67
330180,201808,235,149,86,139599.02,81328.5,220927.52
330185,201808,845,336,509,319008.6,484318.8,803327.4
330187,201808,315,97,218,92538,207972,300510
330190,201808,5600,2263,3337,2148109.3,3180488.68,5328597.98
330200,201808,4625,1512,3113,1437611.63,2964931.76,4402543.39
330205,201808,408,244,164,232346.7,156170,388516.7
330210,201808,1020,630,390,594090.02,370390.9,964480.92
330220,201808,2594,1557,1037,1479989.3,988344.2,2468333.5
330225,201808,571,306,265,291285,252142.2,543427.2
330227,201808,2425,772,1653,733330.46,1576320.23,2309650.69
330230,201808,207,124,83,117629,79182,196811
330240,201808,3714,1967,1747,1871856.28,1663576.11,3535432.39
330245,201808,155,68,87,64300,82234.8,146534.8
330250,201808,6580,3405,3175,3237690.8,3020473.32,6258164.12
330260,201808,566,163,403,155502,384462,539964
330270,201808,3435,1251,2184,1192597,2082679,3275276
330280,201808,464,300,164,284408.08,156447,440855.08
330285,201808,7171,2355,4816,2241313.2,4592338.24,6833651.44
330290,201808,566,216,350,206064,333900,539964
330300,201808,789,524,265,496080.7,252783,748863.7
330310,201808,431,244,187,230868.7,178398,409266.7
330320,201808,8400,3198,5202,3042930.1,4956913.84,7999843.94
330330,201808,9208,3641,5567,3465532,5307273.56,8772805.56
330340,201808,2649,1581,1068,1505199.24,1018852.92,2524052.16
330350,201808,18163,7180,10983,6820207.09,10458333.79,17278540.88
330360,201808,2476,1234,1242,1176263.2,1184859,2361122.2
330370,201808,1032,564,468,537102,444421.9,981523.9
330380,201808,853,363,490,345576.96,466650.8,812227.76
330385,201808,613,320,293,304327,279522,583849
330390,201808,5248,2891,2357,2743422.55,2246016.4,4989438.95
330395,201808,284,173,111,164088.3,104129.2,268217.5
330400,201808,713,377,336,356224.6,318549.88,674774.48
330410,201808,505,359,146,339577.8,138794.33,478372.13
330411,201808,232,131,101,124793,96306.3,221099.3
330412,201808,255,105,150,99884,143100,242984
330414,201808,6070,2491,3579,2372418.58,3411247.1,5783665.68
330415,201808,598,279,319,265184.34,303372.8,568557.14
330420,201808,2279,1192,1087,1132752.8,1034605,2167357.8
330430,201808,1801,850,951,808441.19,905251.8,1713692.99
330440,201808,271,124,147,118296,140238,258534
330450,201808,123,53,70,50562,66780,117342
330452,201808,1791,853,938,812295.8,894547.88,1706843.68
330455,201808,111042,39953,71089,38035181.52,67757982.56,105793164.08
330460,201808,260,109,151,103986,144054,248040
330470,201808,1241,676,565,638610.78,538714.46,1177325.24
330475,201808,1409,375,1034,356796.8,985038.39,1341835.19
330480,201808,781,412,369,392380.2,351073,743453.2
330490,201808,13897,4870,9027,4640003.72,8605591.24,13245594.96
330500,201808,1339,609,730,580842.9,695712,1276554.9
330510,201808,11271,3851,7420,3665327.42,7071083.24,10736410.66
330513,201808,103,51,52,48654,49608,98262
330515,201808,857,350,507,329588.8,483297,812885.8
330520,201808,2593,968,1625,923253,1549811.9,2473064.9
330530,201808,222,117,105,111380,99980,211360
330540,201808,350,176,174,167904,165519,333423
330550,201808,3029,1083,1946,1030988.2,1854194.8,2885183.0
330555,201808,773,291,482,277595,458874.8,736469.8
330560,201808,606,207,399,197478,380619,578097
330570,201808,253,177,76,168858,72504,241362
330575,201808,806,339,467,323168,443463.5,766631.5
330580,201808,3427,1918,1509,1823583.8,1438107.7,3261691.5
330590,201808,312,151,161,144054,153594,297648
330600,201808,1117,716,401,680927.24,380856.84,1061784.08
330610,201808,1554,850,704,804033.74,667467.9,1471501.64
330615,201808,193,145,48,137471.4,45792,183263.4
330620,201808,1072,432,640,409458.5,609129.8,1018588.3
330630,201808,3992,2535,1457,2403732.27,1382730.8,3786463.07
350010,201808,594,391,203,371154.67,193662,564816.67
350020,201808,42,20,22,19080,20988,40068
350030,201808,523,337,186,320354,176254.66,496608.66
350040,201808,127,52,75,49264.56,71550,120814.56
350050,201808,292,159,133,151686,126863.46,278549.46
350055,201808,87,49,38,46746,36252,82998
350060,201808,73,26,47,24804,44838,69642
350070,201808,820,482,338,454551.58,320809.56,775361.14
350075,201808,65,45,20,42930,19080,62010
350080,201808,52,33,19,30845.96,17172,48017.96
350090,201808,93,52,41,49608,39109.23,88717.23
350100,201808,295,187,108,177682.5,103032,280714.5
350110,201808,57,35,22,33390,20988,54378
350115,201808,165,102,63,96640.2,60102,156742.2
350120,201808,109,73,36,69642,34344,103986
350130,201808,354,173,181,164756,172674,337430
350140,201808,36,22,14,20225,13356,33581
350150,201808,67,52,15,49608,14310,63918
350160,201808,2592,1013,1579,963333.16,1505298.68,2468631.84
350170,201808,412,252,160,238500.2,152354,390854.2
350180,201808,180,97,83,92538,79182,171720
350190,201808,1026,540,486,513158.64,463343.49,976502.13
350200,201808,68,24,44,22896,41711.08,64607.08
350210,201808,1353,763,590,720869.13,561706.66,1282575.79
350220,201808,677,581,96,550136.73,91584,641720.73
350230,201808,82,58,24,55332,22896,78228
350240,201808,60,45,15,42930,14310,57240
350250,201808,1238,614,624,579747.2,594666.66,1174413.86
350260,201808,93,67,26,63918,24804,88722
350270,201808,831,541,290,514559.58,275210.92,789770.50
350275,201808,306,123,183,116961,174582,291543
350280,201808,4751,2436,2315,2311124.76,2206323.65,4517448.41
350290,201808,410,197,213,187933.23,202629.8,390563.03
350300,201808,55,30,25,28620,23850,52470
350310,201808,99,67,32,63918,30528,94446
350315,201808,39,25,14,23850,13356,37206
350320,201808,3310,1650,1660,1568951.42,1582868.8,3151820.22
350330,201808,1702,909,793,863534.72,755346.04,1618880.76
350335,201808,21,14,7,13356,6678,20034
350340,201808,132,62,70,59148,66447,125595
350350,201808,97,50,47,47700,44838,92538
350360,201808,126,82,44,78224,41976,120200
350370,201808,89,53,36,49608.96,34334.46,83943.42
350380,201808,773,332,441,315774.2,419950.8,735725.0
350390,201808,1443,583,860,555386.35,819295.4,1374681.75
350395,201808,25,20,5,19080,4770,23850
350400,201808,1659,880,779,829914.02,740568.16,1570482.18
350410,201808,2283,1020,1263,969990.96,1204270.03,2174260.99
350420,201808,237,146,91,138681,86814,225495
350430,201808,73,43,30,40450,28620,69070
350440,201808,149,111,38,104892.5,36252,141144.5
350450,201808,1617,991,626,939248.95,597109,1536357.95
350460,201808,330,122,208,116388,198145.8,314533.8
350470,201808,15,10,5,9540,4770,14310
350480,201808,164,87,77,82998,73458,156456
350490,201808,240,119,121,112572.8,115434,228006.8
350500,201808,41,20,21,19080,20034,39114
350510,201808,166,111,55,105894,52470,158364
350520,201808,457,218,239,205109.92,227369.96,432479.88
350530,201808,445,208,237,198432,226098,424530
350535,201808,70,55,15,52212.42,14310,66522.42
350540,201808,370,191,179,182214,170479.8,352693.8
350550,201808,2760,1630,1130,1547730.58,1076530.47,2624261.05
350560,201808,649,452,197,431203.23,187580.25,618783.48
350570,201808,4165,1740,2425,1653250.18,2310943.2,3964193.38
350580,201808,378,182,196,172675,186970.46,359645.46
350590,201808,900,501,399,477562,379692,857254
350600,201808,6227,3139,3088,2978558.6,2940820.61,5919379.21
350610,201808,1552,791,761,749902.36,725985,1475887.36
350620,201808,36,24,12,22896,11448,34344
350630,201808,241,138,103,130698.96,97309,228007.96
350635,201808,903,366,537,348878,511726,860604
350640,201808,120,88,32,83952,30528,114480
350650,201808,1896,1246,650,1183658.31,618651.53,1802309.84
350660,201808,749,335,414,318946.05,394952,713898.05
350670,201808,320,165,155,156981.2,147870,304851.2
350680,201808,176,94,82,89676,78228,167904
350690,201808,203,106,97,101124,92538,193662
350700,201808,736,363,373,342967.94,355842,698809.94
350710,201808,342,134,208,126627.56,198432,325059.56
350715,201808,54,43,11,41022,10494,51516
350720,201808,17,11,6,10494,5724,16218
350730,201808,41,25,16,23850,15264,39114
350740,201808,212,116,96,110378.65,91584,201962.65
350745,201808,18,9,9,8562,8586,17148
350750,201808,2153,1372,781,1300600.74,744437.96,2045038.70
350760,201808,3763,1627,2136,1549821.83,2033866.62,3583688.45
350770,201808,59,40,19,38160,18126,56286
350775,201808,49,36,13,34344,12393,46737
350780,201808,426,213,213,203202,203185,406387
350790,201808,362,156,206,148824,196524,345348
350800,201808,447,254,193,242316,184122,426438
350810,201808,518,417,101,396865,96354,493219
350820,201808,88,54,34,51516,32436,83952
350830,201808,82,46,36,43884,34344,78228
350840,201808,762,332,430,316489.5,408398.8,724888.3
350850,201808,1796,1042,754,988823.84,719275.46,1708099.30
350860,201808,603,354,249,333883.8,237546,571429.8
350870,201808,440,299,141,285246,134227.8,419473.8
350880,201808,286,156,130,146869.6,123352.2,270221.8
350890,201808,42,26,16,24804,15264,40068
350900,201808,1468,474,994,450729.93,947512.8,1398242.73
350910,201808,26,16,10,15264,9540,24804
350920,201808,609,340,269,324042.04,256339.8,580381.84
350925,201808,1208,644,564,611334.34,536339.4,1147673.74
350930,201808,98,58,40,55332,38160,93492
350940,201808,718,406,312,386083.8,295807.6,681891.4
350945,201808,104,77,27,72922,25758,98680
350950,201808,15730,7508,8222,7134782.36,7836449.91,14971232.27
350960,201808,1283,597,686,565906.16,654440,1220346.16
350970,201808,1105,590,515,559012.46,491014.46,1050026.92
350980,201808,92,63,29,60102,27666,87768
350990,201808,364,129,235,122112.72,224190,346302.72
350995,201808,32,16,16,15264,15264,30528
351000,201808,628,442,186,419444.07,177444,596888.07
351010,201808,48,29,19,27666,18126,45792
351015,201808,54,38,16,36252,15264,51516
351020,201808,1650,963,687,917278.45,653204,1570482.45
351030,201808,338,234,104,220374.2,99216,319590.2
351040,201808,852,455,397,434070,377784.66,811854.66
351050,201808,3333,1565,1768,1484152.61,1686010.3,3170162.91
351060,201808,5085,2087,2998,1979522,2857044.12,4836566.12
351070,201808,416,266,150,252496.96,143100,395596.96
351080,201808,808,583,225,555705,213696,769401
351090,201808,64,28,36,26712,34344,61056
351100,201808,451,264,187,249634.48,178393.23,428027.71
351110,201808,2110,1011,1099,959565.88,1045799.58,2005365.46
351120,201808,73,37,36,35298,34344,69642
351130,201808,174,59,115,56286,109423.8,165709.8
351140,201808,340,239,101,226765.84,96354,323119.84
351150,201808,413,215,198,204204.8,188892,393096.8
351160,201808,250,165,85,157410,81090,238500
351170,201808,187,100,87,95400,82235,177635
351190,201808,89,61,28,58194,26712,84906
351200,201808,372,244,128,232172.04,122112,354284.04
351210,201808,129,62,67,58893.38,63918,122811.38
351220,201808,539,327,212,308385.12,202248,510633.12
351230,201808,290,211,79,201294,75346.92,276640.92
351240,201808,233,98,135,93492,128790,222282
351250,201808,73,51,22,48430,20988,69418
351260,201808,155,112,43,106848,40736,147584
351270,201808,52,21,31,20034,29574,49608
351280,201808,1115,504,611,477956.46,582062.38,1060018.84
351290,201808,233,107,126,102078,119918,221996
351300,201808,3730,1751,1979,1663312.99,1887645,3550957.99
351310,201808,770,400,370,381600,352694,734294
351320,201808,110,68,42,64872,40068,104940
351330,201808,40,27,13,25758,12402,38160
351340,201808,1250,778,472,735942.93,448254.03,1184196.96
351350,201808,2549,1422,1127,1354061.2,1074576.06,2428637.26
351360,201808,794,393,401,373968,382236.04,756204.04
351370,201808,373,191,182,182209.23,172991.96,355201.19
351380,201808,8921,4062,4859,3859169.43,4624845.98,8484015.41
351385,201808,30,20,10,19080,9540,28620
351390,201808,285,212,73,201294.02,69642,270936.02
351400,201808,66,41,25,39114,23812.92,62926.92
351410,201808,449,280,169,265849.04,161226,427075.04
351420,201808,61,49,12,46746,11448,58194
351430,201808,72,39,33,37206,31482,68688
351440,201808,793,554,239,526321.76,228002,754323.76
351450,201808,257,129,128,123066,122112,245178
351460,201808,116,54,62,51516,59148,110664
351470,201808,138,72,66,67705,62964,130669
351480,201808,525,295,230,280190.96,219300.75,499491.71
351490,201808,286,103,183,98262,174582,272844
351492,201808,31,22,9,20988,8586,29574
351495,201808,27,18,9,17172,8586,25758
351500,201808,3558,1543,2015,1466422.29,1917684.41,3384106.70
351510,201808,1807,755,1052,719984,1001664.98,1721648.98
351512,201808,21,18,3,17172,2862,20034
351515,201808,194,111,83,105894,79182,185076
351518,201808,789,489,300,466502,286200,752702
351519,201808,74,48,26,45792,24804,70596
351520,201808,141,87,54,82361.96,51516,133877.96
351530,201808,23,15,8,14310,7632,21942
351535,201808,135,76,59,72504,56286,128790
351540,201808,453,325,128,307667,122112,429779
351550,201808,1319,801,518,759163.92,492254.86,1251418.78
351560,201808,73,39,34,37206,32417,69623
351565,201808,11,7,4,6678,3816,10494
351570,201808,2594,1350,1244,1285577.12,1186105.65,2471682.77
351580,201808,39,35,4,33390,3816,37206
351590,201808,69,46,23,43884,21942,65826
351600,201808,194,146,48,139284,45792,185076
351610,201808,57,29,28,27666,26712,54378
351620,201808,5903,3390,2513,3223395.68,2395397.27,5618792.95
351630,201808,2567,1330,1237,1263791.59,1177899.23,2441690.82
351640,201808,1688,825,863,785004.03,820026.19,1605030.22
351650,201808,33,28,5,26712,4770,31482
351660,201808,153,100,53,95400,50562,145962
351670,201808,737,455,282,431734,269028,700762
351680,201808,71,58,13,55332,12402,67734
351685,201808,39,25,14,23850,13356,37206
351690,201808,312,219,93,206798.28,88722,295520.28
351700,201808,159,112,47,106848,44838,151686
351710,201808,75,52,23,49608,21942,71550
351720,201808,128,61,67,58194,63918,122112
351730,201808,100,70,30,65595.96,28615.23,94211.19
351740,201808,720,487,233,462690.96,222277.23,684968.19
351750,201808,363,152,211,144372,201294,345666
351760,201808,783,607,176,579078,167904,746982
351770,201808,298,252,46,240408,43884,284292
351780,201808,173,99,74,94437,70596,165033
351790,201808,245,130,115,124020,109710,233730
351800,201808,50,32,18,30528,17172,47700
351810,201808,125,84,41,80136,39114,119250
351820,201808,874,626,248,591482.6,236301.23,827783.83
351830,201808,516,184,332,174772.8,316728,491500.8
351840,201808,1893,962,931,908803.2,886672.94,1795476.14
351850,201808,234,173,61,164422.8,58194,222616.8
351860,201808,748,503,245,474140.84,233439.23,707580.07
351870,201808,5648,2686,2962,2551316.84,2818735.19,5370052.03
351880,201808,18952,8270,10682,7869587.57,10176207.04,18045794.61
351885,201808,90,61,29,57479,27666,85145
351890,201808,69,58,11,55332,10494,65826
351900,201808,229,136,93,129077,88722,217799
351905,201808,81,33,48,31482,45792,77274
351907,201808,3193,1400,1793,1332731.06,1708157.6,3040888.66
351910,201808,181,75,106,71550,101124,172674
351920,201808,132,75,57,71550,54355.69,125905.69
351925,201808,87,59,28,56286,26712,82998
351930,201808,384,256,128,244128.6,122112,366240.6
351940,201808,237,105,132,100170,125928,226098
351950,201808,143,83,60,79182,57240,136422
351960,201808,876,406,470,387142.73,446224.36,833367.09
351970,201808,1934,1038,896,988105.84,854203,1842308.84
351980,201808,152,77,75,71550,71550,143100
351990,201808,273,184,89,174582,84104.64,258686.64
352000,201808,360,224,136,213124,129744,342868
352010,201808,366,224,142,213696,134991,348687
352020,201808,201,68,133,64872,126882,191754
352030,201808,1043,535,508,509674.5,483995.96,993670.46
352040,201808,581,250,331,238500,315774,554274
352042,201808,280,98,182,93492,173628,267120
352044,201808,387,229,158,217597.86,150732,368329.86
352050,201808,3290,1319,1971,1251348.48,1878798.26,3130146.74
352060,201808,106,66,40,62964,37874,100838
352070,201808,104,76,28,71234,26712,97946
352080,201808,68,43,25,40068,23850,63918
352090,201808,171,116,55,110664,52470,163134
352100,201808,263,130,133,123730,125730,249460
352110,201808,114,34,80,32436,76320,108756
352115,201808,69,25,44,23850,41976,65826
352120,201808,95,65,30,60770,28620,89390
352130,201808,220,182,38,173628,36252,209880
352140,201808,182,75,107,71073,101792,172865
352150,201808,122,68,54,63918.04,51516,115434.04
352160,201808,132,85,47,81090,44838,125928
352170,201808,375,260,115,247086.04,109710,356796.04
352180,201808,617,416,201,395243.5,191750,586993.5
352190,201808,260,101,159,96344.46,151647.84,247992.30
352200,201808,32,17,15,16218,14310,30528
352210,201808,3860,1607,2253,1524500.87,2142628.97,3667129.84
352215,201808,56,31,25,29574,23392.08,52966.08
352220,201808,6974,2731,4243,2600303.44,4045035.19,6645338.63
352230,201808,3250,2071,1179,1962521.23,1120016.45,3082537.68
352240,201808,2251,1312,939,1249454.69,893509.08,2142963.77
352250,201808,2604,1350,1254,1282768.16,1192312.06,2475080.22
352260,201808,1052,570,482,542249.23,459542,1001791.23
352265,201808,60,26,34,24804,32436,57240
352270,201808,416,238,178,226098.92,169756,395854.92
352280,201808,415,262,153,248677,145957.23,394634.23
352290,201808,176,111,65,105894,62010,167904
352300,201808,100,75,25,71550,23850,95400
352310,201808,5776,2797,2979,2655133.04,2836749.64,5491882.68
352320,201808,959,504,455,477321.84,432019.1,909340.94
352330,201808,521,246,275,234350.1,262064,496414.1
352340,201808,1393,685,708,651315,672428.5,1323743.5
352350,201808,334,209,125,199386,118964,318350
352360,201808,234,100,134,94493.7,125239.52,219733.22
352370,201808,101,69,32,65826,30528,96354
352380,201808,123,73,50,69642,47700,117342
352390,201808,2477,1128,1349,1072849.82,1284544.56,2357394.38
352400,201808,482,208,274,197716.5,261109.8,458826.3
352410,201808,788,562,226,531068.72,215604,746672.72
352420,201808,107,70,37,66780,35298,102078
352430,201808,1763,789,974,747653.84,925968.5,1673622.34
352440,201808,3199,1625,1574,1539583.48,1499648.67,3039232.15
352450,201808,194,162,32,154548,30528,185076
352460,201808,582,295,287,280872.68,273083.2,553955.88
352470,201808,626,212,414,202248,394947,597195
352480,201808,1373,770,603,733307.96,574689.8,1307997.76
352490,201808,84,31,53,29574,50562,80136
352500,201808,1209,537,672,510772.6,640603,1151375.6
352510,201808,750,408,342,388278.96,326268,714546.96
352520,201808,571,254,317,242316,302274.9,544590.9
352530,201808,1721,906,815,864324,777128.6,1641452.6
352540,201808,74,49,25,46746,23850,70596
352550,201808,182,105,77,100170,72790.2,172960.2
352560,201808,51,41,10,39114,9540,48654
352570,201808,668,346,322,329767,307168.92,636935.92
352580,201808,60,41,19,38160.65,18126,56286.65
352585,201808,16,5,11,4770,10494,15264
352590,201808,4402,2242,2160,2131945.11,2058480.73,4190425.84
352600,201808,358,247,111,234446.46,105894,340340.46
352610,201808,949,430,519,408169.33,495126,903295.33
352620,201808,963,395,568,375876.2,541236,917112.2
352630,201808,168,64,104,61056,99206.46,160262.46
352640,201808,561,390,171,369898.16,163134,533032.16
352650,201808,90,60,30,57240,28620,85860
352660,201808,82,48,34,45792,32436,78228
352670,201808,1693,917,776,872287.89,739201.06,1611488.95
352680,201808,903,581,322,550392.88,305726.04,856118.92
352690,201808,4456,2054,2402,1950782.8,2288595.73,4239378.53
352700,201808,108,65,43,61723.8,41022,102745.8
352710,201808,1349,722,627,686593.8,595196.6,1281790.4
352720,201808,1350,651,699,618796.2,666269.03,1285065.23
352725,201808,25,23,2,21942,1908,23850
352730,201808,374,190,184,180081.81,175536,355617.81
352740,201808,425,273,152,258487.68,145008,403495.68
352750,201808,22,14,8,13069.8,7632,20701.8
352760,201808,200,145,55,138330,52470,190800
352770,201808,83,65,18,62010,17172,79182
352780,201808,80,44,36,41976,34344,76320
352790,201808,32,26,6,24804,5724,30528
352800,201808,249,174,75,165996,71263.8,237259.8
352810,201808,168,112,56,104337.42,53424,157761.42
352820,201808,63,50,13,47274.52,12402,59676.52
352830,201808,92,63,29,60102,27666,87768
352840,201808,628,326,302,310098.2,288108,598206.2
352850,201808,1385,489,896,465838.2,854147.96,1319986.16
352860,201808,135,90,45,85224,42930,128154
352870,201808,46,30,16,28620,15264,43884
352880,201808,192,130,62,124000.92,59148,183148.92
352885,201808,29,21,8,20034,7632,27666
352890,201808,58,40,18,38160,16886,55046
352900,201808,4838,2337,2501,2210558.03,2378407.97,4588966.00
352910,201808,39,32,7,30528,6678,37206
352920,201808,698,431,267,410220,254718,664938
352930,201808,1248,610,638,579840.82,605682.18,1185523.00
352940,201808,6432,2759,3673,2620911.66,3499924.44,6120836.10
352950,201808,96,39,57,37206,54378,91584
352960,201808,63,41,22,39114,20988,60102
352965,201808,19,8,11,7632,10494,18126
352970,201808,482,365,117,345165.15,110665,455830.15
352980,201808,177,95,82,90630,77942,168572
352990,201808,978,429,549,408283.38,522678.2,930961.58
353000,201808,68,32,36,30528,34344,64872
353010,201808,555,341,214,325314,204136.92,529450.92
353020,201808,286,209,77,199386,73458,272844
353030,201808,1232,565,667,537224.99,635631.66,1172856.65
353040,201808,92,56,36,53424,34344,87768
353050,201808,1332,851,481,805550.02,458587.8,1264137.82
353060,201808,8018,3621,4397,3439872.09,4188495.07,7628367.16
353070,201808,1661,1065,596,1010059.46,567123.56,1577183.02
353080,201808,1349,725,624,689365.55,594338,1283703.55
353090,201808,55,32,23,30528,21942,52470
353100,201808,61,50,11,47700,10494,58194
353110,201808,2053,629,1424,598334.88,1355459.46,1953794.34
353120,201808,82,44,38,41976,36252,78228
353130,201808,868,431,437,409470.43,416785.68,826256.11
353140,201808,575,230,345,219359,329130,548489
353150,201808,360,203,157,192708,149768.46,342476.46
353160,201808,101,82,19,78228,18126,96354
353170,201808,195,65,130,62010,123992.46,186002.46
353180,201808,961,445,516,422236.49,491740,913976.49
353190,201808,492,353,139,335706.9,132320,468026.9
353200,201808,200,103,97,98262,92538,190800
353205,201808,27,20,7,19080,6678,25758
353210,201808,85,52,33,49608,31482,81090
353215,201808,54,31,23,29574,21942,51516
353220,201808,83,47,36,44838,33390.27,78228.27
353230,201808,157,62,95,59148,90630,149778
353240,201808,301,163,138,155502,131652,287154
353250,201808,207,108,99,103032,94446,197478
353260,201808,464,333,131,316538.5,124964.46,441502.96
353270,201808,67,49,18,46746,16504.2,63250.2
353280,201808,92,48,44,45602,41976,87578
353282,201808,125,91,34,86814,32436,119250
353284,201808,25,20,5,19080,4770,23850
353286,201808,1,1,0,954,0,954
353290,201808,78,44,34,41976,32427,74403
353300,201808,416,235,181,221408.42,172674,394082.42
353310,201808,52,45,7,42930,6678,49608
353320,201808,64,39,25,37206,23850,61056
353325,201808,58,35,23,33381,21638,55019
353330,201808,67,50,17,47557,16218,63775
353340,201808,628,208,420,197749.89,400094.26,597844.15
353350,201808,909,431,478,410193.18,455041,865234.18
353360,201808,109,88,21,83634.04,19748,103382.04
353370,201808,122,68,54,64872,51516,116388
353380,201808,26,17,9,16214,8586,24800
353390,201808,1095,525,570,500850,543780,1044630
353400,201808,49,30,19,28620,18126,46746
353410,201808,112,70,42,66780,40021,106801
353420,201808,59,24,35,22896,33390,56286
353430,201808,573,380,193,358799.3,183835.8,542635.1
353440,201808,10349,4515,5834,4296714.99,5558590.41,9855305.40
353450,201808,55,31,24,29574,22896,52470
353460,201808,618,343,275,325006.83,261634.5,586641.33
353470,201808,2124,1156,968,1098876.62,922020.23,2020896.85
353475,201808,240,161,79,150904.96,75366,226270.96
353480,201808,188,152,36,145008,34344,179352
353490,201808,236,140,96,133560,91584,225144
353500,201808,193,112,81,105894.96,77274,183168.96
353510,201808,99,72,27,68669.46,25748.46,94417.92
353520,201808,202,138,64,131652,61056,192708
353530,201808,466,250,216,238500,206064,444564
353540,201808,364,242,122,230545.27,116388,346933.27
353550,201808,744,505,239,476717.22,228006,704723.22
353560,201808,633,269,364,255060.69,346655.52,601716.21
353570,201808,62,32,30,30528,28620,59148
353580,201808,356,276,80,262827,76320,339147
353590,201808,89,61,28,57876.04,26712,84588.04
353600,201808,268,151,117,143737,110982,254719
353610,201808,113,59,54,56286,51516,107802
353620,201808,587,311,276,295423,263017.8,558440.8
353625,201808,51,30,21,28620,20034,48654
353630,201808,238,170,68,158803.56,64872,223675.56
353640,201808,127,84,43,79659,41022,120681
353650,201808,895,351,544,332755.2,518976,851731.2
353657,201808,24,18,6,17172,5724,22896
353660,201808,252,141,111,134514,105894,240408
353670,201808,772,457,315,435024.2,300510,735534.2
353680,201808,101,72,29,68450,27666,96116
353690,201808,45,36,9,34070,8586,42656
353700,201808,277,196,81,186984,77274,264258
353710,201808,449,208,241,197478.8,229628,427106.8
353715,201808,47,33,14,31195.8,13356,44551.8
353720,201808,356,164,192,156447,183168,339615
353730,201808,1104,679,425,645810.9,404251.64,1050062.54
353740,201808,655,358,297,340959.6,283338,624297.6
353750,201808,87,54,33,51516,31482,82998
353760,201808,2793,1055,1738,1004411.88,1654449.78,2658861.66
353770,201808,96,79,17,74889,16218,91107
353780,201808,1176,578,598,550649,568488.37,1119137.37
353790,201808,505,295,210,279361.5,197741.35,477102.85
353800,201808,3269,1672,1597,1586127.91,1522000.88,3108128.79
353810,201808,233,133,100,126009.63,95391,221400.63
353820,201808,192,93,99,88722,93821.41,182543.41
353830,201808,47,40,7,38160,6678,44838
353850,201808,171,88,83,83952,79182,163134
353860,201808,479,218,261,207256.5,248612.4,455868.9
353870,201808,5163,2601,2562,2464935.73,2433257.8,4898193.53
353880,201808,689,491,198,467078.4,187938.12,655016.52
353890,201808,589,332,257,316394.3,244892,561286.3
353900,201808,132,65,67,62010,63918,125928
353910,201808,175,86,89,82044,84906,166950
353920,201808,452,248,204,235400.4,194173.16,429573.56
353930,201808,1029,610,419,580247.79,398903.36,979151.15
353940,201808,185,100,85,94636.8,80232,174868.8
353950,201808,530,324,206,308110.8,196515,504625.8
353960,201808,70,57,13,54378,12402,66780
353970,201808,76,44,32,41976,30528,72504
353980,201808,1539,754,785,716942.95,747951.76,1464894.71
353990,201808,75,43,32,41022,30528,71550
354000,201808,371,184,187,174869,178203.2,353072.2
354010,201808,92,52,40,49608,37683,87291
354020,201808,548,350,198,332946,188892,521838
354025,201808,51,40,11,38160,10494,48654
354030,201808,64,36,28,34344,26712,61056
354040,201808,96,68,28,64490.4,26712,91202.4
354050,201808,191,104,87,98930,82998,181928
354060,201808,756,365,391,348210,370773.4,718983.4
354070,201808,880,514,366,488826.03,349164,837990.03
354075,201808,219,116,103,110378,97308.8,207686.8
354080,201808,291,127,164,120871.8,156456,277327.8
354085,201808,18,11,7,10494,6678,17172
354090,201808,317,177,140,168777,133560,302337
354100,201808,5643,2377,3266,2255970.76,3110544.21,5366514.97
354105,201808,87,43,44,41022,41976,82998
354110,201808,50,23,27,21942,25758,47700
354120,201808,144,101,43,96084.62,41022,137106.62
354130,201808,705,469,236,447188,224854,672042
354140,201808,3148,1483,1665,1411959.43,1587065.63,2999025.06
354150,201808,653,407,246,386065.04,233253,619318.04
354160,201808,718,460,258,437647.5,245846,683493.5
354165,201808,23,14,9,13356,8586,21942
354170,201808,178,120,58,113812.2,55332,169144.2
354180,201808,69,43,26,40696,24804,65500
354190,201808,211,97,114,90916.2,108756,199672.2
354200,201808,131,72,59,68211,56286,124497
354210,201808,67,35,32,33390,30528,63918
354220,201808,633,392,241,373300.2,228674.35,601974.55
354230,201808,163,68,95,64872,89676.6,154548.6
354240,201808,318,208,110,197478.49,104940,302418.49
354250,201808,91,55,36,52470,34344,86814
354260,201808,1982,929,1053,874593.84,1001982.67,1876576.51
354270,201808,95,71,24,67734,22896,90630
354280,201808,41,22,19,20988,18126,39114
354290,201808,141,97,44,91727.1,41976,133703.1
354300,201808,418,286,132,272527,125770,398297
354310,201808,99,73,26,68688.2,24804,93492.2
354320,201808,180,97,83,92538,79182,171720
354323,201808,16,14,2,13356,1908,15264
354325,201808,109,63,46,59296,43884,103180
354330,201808,2645,887,1758,840991.26,1674818.31,2515809.57
354340,201808,10597,5201,5396,4950190.83,5140396.39,10090587.22
354350,201808,127,84,43,80136,40878.9,121014.9
354360,201808,90,50,40,47700,38160,85860
354370,201808,264,146,118,139284,112572,251856
354380,201808,211,125,86,118464,82044,200508
354390,201808,2794,1013,1781,964741.22,1698656.58,2663397.80
354400,201808,339,177,162,168858,153976,322834
354410,201808,620,294,326,278850.43,310050.2,588900.63
354420,201808,275,173,102,165042,97308,262350
354425,201808,311,183,128,174582,122112,296694
354430,201808,191,121,70,113859.9,66016.8,179876.7
354440,201808,40,28,12,26712,11448,38160
354450,201808,49,35,14,33390,13356,46746
354460,201808,103,60,43,57240,41022,98262
354470,201808,40,27,13,25758,12402,38160
354480,201808,115,58,57,55323,54368.46,109691.46
354490,201808,140,86,54,81884.97,51516,133400.97
354500,201808,396,197,199,187938,189846,377784
354510,201808,104,72,32,68688,30528,99216
354515,201808,37,14,23,13356,21942,35298
354520,201808,1643,722,921,687507.4,878195.56,1565702.96
354530,201808,679,357,322,338856.8,306330.2,645187.0
354540,201808,281,158,123,150732,117337.23,268069.23
354550,201808,44,27,17,25758,16218,41976
354560,201808,157,89,68,84620,64862.46,149482.46
354570,201808,133,86,47,82044,44838,126882
354580,201808,1980,936,1044,889730.96,995390.26,1885121.22
354600,201808,265,148,117,138978.92,111603.69,250582.61
354610,201808,74,65,9,61056.58,8577,69633.58
354620,201808,61,19,42,18126,40068,58194
354625,201808,19,12,7,11448,6674,18122
354630,201808,321,213,108,202827.34,103032,305859.34
354640,201808,808,526,282,497592.16,269028,766620.16
354650,201808,75,43,32,41013,30499.92,71512.92
354660,201808,813,602,211,570286.46,201294,771580.46
354670,201808,273,96,177,90392,167905,258297
354680,201808,1272,482,790,459828,753183,1213011
354690,201808,84,54,30,50563,28620,79183
354700,201808,76,55,21,52470,20034,72504
354710,201808,57,39,18,36569.96,17172,53741.96
354720,201808,20,19,1,18126,954,19080
354730,201808,1859,796,1063,756466.2,1013911.2,1770377.4
354740,201808,61,43,18,41022,17172,58194
354750,201808,432,256,176,244215,167904,412119
354760,201808,512,315,197,297949,187652,485601
354765,201808,12,5,7,4770,6678,11448
354770,201808,345,228,117,216688.03,111618,328306.03
354780,201808,8173,3327,4846,3161670.65,4619224.1,7780894.75
354790,201808,112,65,47,62010,44838,106848
354800,201808,440,241,199,229914,189540.92,419454.92
354805,201808,104,52,52,48972,49608,98580
354810,201808,133,76,57,72504,54378,126882
354820,201808,187,80,107,76111,102078,178189
354830,201808,42,23,19,21942,18126,40068
354840,201808,59,39,20,37206,19080,56286
354850,201808,4612,2052,2560,1951299.39,2438274.54,4389573.93
354860,201808,327,161,166,153594,156256.52,309850.52
354870,201808,12109,5477,6632,5198152.01,6316974.1,11515126.11
354880,201808,3072,1162,1910,1106910.46,1821113.03,2928023.49
354890,201808,2901,1606,1295,1525002.98,1234447.38,2759450.36
354900,201808,59,38,21,36252,20034,56286
354910,201808,1241,654,587,620348.24,559998,1180346.24
354920,201808,49,41,8,39114,7632,46746
354925,201808,13,7,6,6678,5724,12402
354930,201808,31,28,3,26442,2862,29304
354940,201808,816,601,215,570685.69,205110,775795.69
354950,201808,218,146,72,138617,68688,207305
354960,201808,163,64,99,61056,94160,155216
354970,201808,887,581,306,549414.14,291285.02,840699.16
354980,201808,8506,3140,5366,2988415.33,5116454.87,8104870.20
354990,201808,9158,4358,4800,4143037.15,4572459.84,8715496.99
354995,201808,526,184,342,175536,325953.18,501489.18
355000,201808,490,167,323,159313.23,307903.5,467216.73
355010,201808,621,391,230,373014,217208.48,590222.48
355020,201808,726,457,269,435019.59,256618,691637.59
355030,201808,207060,80470,126590,76531545.12,120666331.47,197197876.59
355040,201808,731,342,389,324217.6,370915.2,695132.8
355050,201808,151,101,50,95083.77,47700,142783.77
355060,201808,1583,788,795,746902.94,757238.3,1504141.24
355070,201808,1449,707,742,670807.16,706714.26,1377521.42
355080,201808,202,116,86,110664,81156.8,191820.8
355090,201808,297,195,102,183932,96241,280173
355100,201808,4936,2434,2502,2300188,2383642.29,4683830.29
355110,201808,271,172,99,163131,94446,257577
355120,201808,81,58,23,55332,21942,77274
355130,201808,53,30,23,28620,21942,50562
355140,201808,185,123,62,116626.5,59148,175774.5
355150,201808,697,417,280,396574,266643,663217
355160,201808,470,226,244,213219.96,232776,445995.96
355170,201808,2064,1079,985,1028100.94,937795.55,1965896.49
355180,201808,624,267,357,253764,339743.25,593507.25
355190,201808,223,152,71,145008,67734,212742
355200,201808,121,69,52,65826,49608,115434
355210,201808,723,406,317,387324,302399.46,689723.46
355220,201808,6823,3636,3187,3458830.06,3029643.11,6488473.17
355230,201808,107,64,43,60483.6,41017.23,101500.83
355240,201808,4417,1903,2514,1803209.12,2394218.11,4197427.23
355250,201808,5453,2614,2839,2487941.22,2705629.6,5193570.82
355255,201808,50,31,19,29574,18126,47700
355260,201808,187,113,74,106829.12,70568.46,177397.58
355270,201808,168,99,69,94446,65111,159557
355280,201808,6431,2695,3736,2565541.66,3560110.46,6125652.12
355290,201808,76,57,19,54378,18126,72504
355300,201808,188,121,67,114480.8,63632,178112.8
355310,201808,108,61,47,58194,44838,103032
355320,201808,91,49,42,46746,39120.6,85866.6
355330,201808,277,155,122,147870,116388,264258
355340,201808,1598,542,1056,514461.81,1006395.97,1520857.78
355350,201808,141,72,69,68688,65826,134514
355360,201808,182,116,66,110454.12,62964,173418.12
355365,201808,25,20,5,19080,4770,23850
355370,201808,1048,601,447,567487.28,425161.01,992648.29
355380,201808,790,524,266,499304.52,253764,753068.52
355385,201808,66,47,19,44838,18126,62964
355390,201808,103,62,41,59148,39114,98262
355395,201808,184,112,72,105747.23,68688,174435.23
355400,201808,1577,975,602,926075.52,571923.2,1497998.72
355410,201808,4917,2336,2581,2211110.84,2453241.36,4664352.20
355420,201808,51,38,13,36252,12402,48654
355430,201808,352,213,139,201866.4,132606,334472.4
355440,201808,83,50,33,47700,31482,79182
355450,201808,462,229,233,215987.14,221328.2,437315.34
355460,201808,67,51,16,47700.42,15264,62964.42
355465,201808,52,33,19,31482,18126,49608
355470,201808,181,73,108,68688.1,103032,171720.1
355475,201808,13,8,5,7632,4770,12402
355480,201808,467,208,259,196534.34,246418.2,442952.54
355490,201808,116,82,34,78228,32436,110664
355495,201808,54,26,28,24804,26712,51516
355500,201808,1651,927,724,878778.46,690661.46,1569439.92
355510,201808,275,200,75,186388.63,71550,257938.63
355520,201808,32,25,7,23564,6678,30242
355530,201808,24,17,7,16218,6678,22896
355535,201808,80,39,41,37206,39114,76320
355540,201808,2388,955,1433,909611.53,1366119.96,2275731.49
355550,201808,67,41,26,39114,24804,63918
355560,201808,240,119,121,113526,114797.96,228323.96
355570,201808,29,19,10,18126,9540,27666
355580,201808,265,182,83,173628,78891.23,252519.23
355590,201808,23,14,9,13356,8586,21942
355600,201808,268,138,130,131652,123729.23,255381.23
355610,201808,226,150,76,143100,72504,215604
355620,201808,1320,625,695,595677.8,662520.38,1258198.18
355630,201808,424,310,114,295740,107802.96,403542.96
355635,201808,123,59,64,56286,61043,117329
355640,201808,578,331,247,314820.16,235638,550458.16
355645,201808,845,365,480,346731.3,456040.82,802772.12
355650,201808,2152,905,1247,859147.6,1189619.46,2048767.06
355660,201808,255,137,118,130698,112572,243270
355670,201808,509,199,310,189210,295453.8,484663.8
355680,201808,207,118,89,111619,84906,196525
355690,201808,88,41,47,39114,44494,83608
355695,201808,14,11,3,10494,2862,13356
355700,201808,1137,589,548,556483.62,521934,1078417.62
355710,201808,2217,1212,1005,1152611.36,958579.2,2111190.56
355715,201808,20,18,2,17172,1908,19080
355720,201808,206,124,82,116706.08,78228,194934.08
355730,201808,97,55,42,51595.95,40068,91663.95
410010,201808,132,112,20,106848,19080,125928
410020,201808,107,94,13,89676,12402,102078
410030,201808,162,104,58,98548.4,55332,153880.4
410040,201808,983,540,443,514253.7,422432,936685.7
410045,201808,28,23,5,21942,4770,26712
410050,201808,480,268,212,255672,201580.2,457252.2
410060,201808,275,211,64,201294,61056,262350
410070,201808,309,256,53,244224,50562,294786
410080,201808,165,107,58,102078,55332,157410
410090,201808,74,65,9,61801,8586,70387
410100,201808,297,214,83,203841.18,79086.6,282927.78
410105,201808,48,29,19,27666,18126,45792
410110,201808,324,195,129,186030,123066,309096
410115,201808,31,21,10,20034,9540,29574
410120,201808,431,222,209,211501.8,199386,410887.8
410130,201808,45,29,16,27666,15264,42930
410140,201808,3133,1540,1593,1463378,1514571.4,2977949.4
410150,201808,2712,1096,1616,1044145.24,1541067.8,2585213.04
410160,201808,498,316,182,301177.8,173628,474805.8
410165,201808,66,44,22,41976,20988,62964
410170,201808,168,123,45,115917,42930,158847
410180,201808,2141,1244,897,1182787.19,854566.95,2037354.14
410185,201808,34,30,4,28620,3816,32436
410190,201808,446,281,165,268074,157410,425484
410200,201808,958,713,245,679352.94,233730,913082.94
410210,201808,564,297,267,282736.98,254432,537168.98
410220,201808,42,22,20,20988,19080,40068
410230,201808,128,68,60,64872,57240,122112
410240,201808,731,481,250,458301.8,238500,696801.8
410250,201808,369,274,95,260791.84,90625.23,351417.07
410260,201808,303,180,123,171614,117342,288956
410270,201808,30,19,11,18126,10494,28620
410275,201808,63,46,17,43884,16218,60102
410280,201808,323,186,137,177184.52,130698,307882.52
410290,201808,235,147,88,140238,82762.83,223000.83
410300,201808,81,64,17,61056,16218,77274
410302,201808,24,16,8,15264,7632,22896
410304,201808,45,32,13,30528,12402,42930
410305,201808,216,119,97,112858.2,92538,205396.2
410310,201808,264,168,96,160272,91564.92,251836.92
410315,201808,49,35,14,33366,13356,46722
410320,201808,138,96,42,91584,40068,131652
410322,201808,33,24,9,22896,8586,31482
410330,201808,171,123,48,117342,45602,162944
410335,201808,98,59,39,56286,37206,93492
410337,201808,40,35,5,33390,4770,38160
410340,201808,31,29,2,27666,1908,29574
410345,201808,221,140,81,132959,77274,210233
410347,201808,52,39,13,37206,12402,49608
410350,201808,233,142,91,135468,86814,222282
410360,201808,464,284,180,268392.4,171148,439540.4
410370,201808,2402,1034,1368,984053.32,1302292.82,2286346.14
410380,201808,219,140,79,133560,75366,208926
410390,201808,375,276,99,263300,94446,357746
410395,201808,34,22,12,20988,10865,31853
410400,201808,836,424,412,403167.2,391698.1,794865.3
410405,201808,94,71,23,67734,21942,89676
410410,201808,38,29,9,27666,8586,36252
410420,201808,1650,820,830,780085.89,790230.96,1570316.85
410425,201808,175,82,93,78038,88722,166760
410430,201808,2198,1291,907,1227512.74,864400.32,2091913.06
410440,201808,388,288,100,273799,95400,369199
410442,201808,354,238,116,226099,110664,336763
410445,201808,415,291,124,277614,118296,395910
410450,201808,404,209,195,199386,186030,385416
410460,201808,417,226,191,215308.26,182214,397522.26
410465,201808,196,123,73,116101.8,69642,185743.8
410470,201808,232,148,84,141192,80136,221328
410480,201808,5946,2949,2997,2794201.81,2853022.56,5647224.37
410490,201808,1404,921,483,877137,458875,1336012
410500,201808,269,156,113,148824,107802,256626
410510,201808,177,130,47,124020,44829,168849
410520,201808,254,189,65,180306,62010,242316
410530,201808,239,88,151,83952,144050,228002
410540,201808,317,229,88,217647.97,83947.23,301595.20
410550,201808,1609,694,915,661789.8,871710.36,1533500.16
410560,201808,147,113,34,107802,32436,140238
410570,201808,429,297,132,281250.2,125928,407178.2
410580,201808,3160,1433,1727,1365180.8,1647082,3012262.8
410590,201808,402,284,118,270936,112572,383508
410600,201808,190,162,28,154548,26712,181260
410610,201808,57,46,11,43884,10494,54378
410620,201808,240,175,65,166950,62010,228960
410630,201808,444,259,185,247086,176490,423576
410640,201808,1004,629,375,596249.27,356143.28,952392.55
410645,201808,100,74,26,70215,24804,95019
410650,201808,370,252,118,239454,112572,352026
410655,201808,78,60,18,57240,17172,74412
410657,201808,43,18,25,17172,23850,41022
410660,201808,604,427,177,405829,168858,574687
410670,201808,75,63,12,60102,11448,71550
410680,201808,195,162,33,153880.2,31482,185362.2
410685,201808,15,10,5,9540,4770,14310
410690,201808,28136,12286,15850,11698904.08,15107836.85,26806740.93
410700,201808,328,242,86,230582,82044,312626
410710,201808,126,103,23,98262,21942,120204
410712,201808,21,14,7,13356,6678,20034
410715,201808,85,63,22,60102,20988,81090
410720,201808,604,363,241,346302,229905,576207
410725,201808,178,129,49,123066,46746,169812
410730,201808,83,52,31,49608,29574,79182
410740,201808,113,81,32,77274,30528,107802
410750,201808,218,160,58,152640,55327.23,207967.23
410752,201808,24,14,10,13356,9540,22896
410753,201808,53,23,30,21269.43,28620,49889.43
410754,201808,39,22,17,20607,16218,36825
410755,201808,80,55,25,52470,23850,76320
410760,201808,728,414,314,394645.56,299556,694201.56
410765,201808,1661,803,858,760088.8,817378.26,1577467.06
410770,201808,107,85,22,81090,20988,102078
410773,201808,53,39,14,37206,13356,50562
410775,201808,176,134,42,127168.2,40068,167236.2
410780,201808,80,44,36,41976,34344,76320
410785,201808,53,43,10,41022,9540,50562
410790,201808,73,34,39,32436,37206,69642
410800,201808,291,184,107,174583,102078,276661
410810,201808,24,20,4,19080,3530,22610
410820,201808,181,133,48,126739,45792,172531
410830,201808,8470,3829,4641,3643056.74,4424978.14,8068034.88
410832,201808,103,70,33,66780,31482,98262
410840,201808,1433,799,634,759978.08,603922.48,1363900.56
410845,201808,65,41,24,38828,22896,61724
410850,201808,195,135,60,127927.12,57240,185167.12
410855,201808,52,45,7,42930,6678,49608
410860,201808,678,399,279,379692.76,266166,645858.76
410865,201808,103,81,22,77274,20988,98262
410870,201808,161,135,26,128790,24804,153594
410880,201808,1123,567,556,540251.82,530360,1070611.82
410890,201808,80,55,25,52470,23850,76320
410895,201808,73,56,17,53424,16218,69642
410900,201808,20,12,8,11448,7632,19080
410910,201808,17,15,2,14310,1908,16218
410920,201808,33,22,11,20988,10494,31482
410930,201808,508,327,181,311746.98,172674,484420.98
410940,201808,4312,2555,1757,2427193.6,1672914.4,4100108.0
410950,201808,113,85,28,81090,26712,107802
410960,201808,773,347,426,331008,406214,737222
410965,201808,68,52,16,49321.8,15264,64585.8
410970,201808,638,460,178,438372.2,169812,608184.2
410975,201808,109,64,45,60545,42930,103475
410980,201808,1590,718,872,681185.62,829689.8,1510875.42
410990,201808,269,183,86,174582,81757.8,256339.8
411000,201808,63,38,25,36252,23850,60102
411005,201808,25,20,5,19080,4770,23850
411007,201808,242,139,103,132319.8,98262,230581.8
411010,201808,576,403,173,384462,165042,549504
411020,201808,295,202,93,192708,88722,281430
411030,201808,18,8,10,7632,9540,17172
411040,201808,51,36,15,34344,14310,48654
411050,201808,222,173,49,164427.72,46619.12,211046.84
411060,201808,509,343,166,327213,158364,485577
411065,201808,65,57,8,54378,7632,62010
411070,201808,1211,798,413,755432.31,394002,1149434.31
411080,201808,242,175,67,166950,63918,230868
411090,201808,113,85,28,81090,26712,107802
411095,201808,274,113,161,107802,153584,261386
411100,201808,112,93,19,88722,18126,106848
411110,201808,120,85,35,81090,33390,114480
411120,201808,184,136,48,129744,45792,175536
411125,201808,186,85,101,80441.28,96354,176795.28
411130,201808,126,107,19,101440,18126,119566
411140,201808,191,131,60,124952.12,56715.3,181667.42
411150,201808,1225,812,413,773970.66,394002,1167972.66
411155,201808,124,84,40,80136,38160,118296
411160,201808,20,8,12,7632,11448,19080
411170,201808,54,49,5,46459.8,4770,51229.8
411180,201808,965,643,322,612182,307183.23,919365.23
411190,201808,340,196,144,186316.2,137376,323692.2
411200,201808,675,443,232,421351.89,220308.18,641660.07
411210,201808,694,379,315,360016.21,300510,660526.21
411220,201808,147,110,37,104940,35298,140238
411230,201808,41,37,4,35298,3816,39114
411240,201808,125,86,39,82044,37206,119250
411250,201808,431,317,114,302418,108756,411174
411260,201808,21,14,7,13356,6678,20034
411270,201808,294,159,135,151686,128790,280476
411275,201808,206,182,24,172912.6,22896,195808.6
411280,201808,228,161,67,153277,63918,217195
411290,201808,58,43,15,41022,14310,55332
411295,201808,151,117,34,111618,32436,144054
411300,201808,70,35,35,33390,33390,66780
411310,201808,89,68,21,64872,20034,84906
411320,201808,750,541,209,514302.2,197783.28,712085.48
411325,201808,43,26,17,24804,15931.8,40735.8
411330,201808,924,597,327,567535.61,311227.6,878763.21
411340,201808,26,17,9,16218,8272,24490
411342,201808,71,54,17,51516,16218,67734
411345,201808,127,64,63,61056,60102,121158
411350,201808,488,389,99,369627.64,94151,463778.64
411360,201808,55,35,20,33390,19080,52470
411370,201808,14266,5843,8423,5553201.99,8019965.65,13573167.64
411373,201808,186,139,47,132606,44838,177444
411375,201808,70,59,11,56286,10494,66780
411380,201808,95,72,23,68688,21942,90630
411390,201808,132,89,43,83983.8,41022,125005.8
411400,201808,360,270,90,257571,85860,343431
411410,201808,443,231,212,219706.2,201962,421668.2
411420,201808,1032,472,560,447998.4,533368.6,981367.0
411430,201808,416,266,150,253096.2,143091,396187.2
411435,201808,36,25,11,23850,10494,34344
411440,201808,477,384,93,364644.99,88722,453366.99
411450,201808,421,353,68,336762,64872,401634
411460,201808,765,304,461,289168.08,438345.6,727513.68
411470,201808,86,64,22,61056,20988,82044
411480,201808,643,366,277,346684.4,263971.8,610656.2
411490,201808,295,186,109,177444,103699.8,281143.8
411500,201808,111,93,18,88518.33,16505,105023.33
411510,201808,218,178,40,169064.06,38160,207224.06
411520,201808,5931,2312,3619,2201349.8,3445627.76,5646977.56
411530,201808,116,80,36,76320,34344,110664
411535,201808,50,21,29,20034,27666,47700
411540,201808,351,245,106,232707.9,101124,333831.9
411545,201808,55,39,16,37206,15264,52470
411550,201808,75,57,18,54378,17172,71550
411560,201808,390,180,210,171056.38,200340,371396.38
411570,201808,777,300,477,284665.44,454858.46,739523.90
411573,201808,35,22,13,20988,12402,33390
411575,201808,273,173,100,165042,95400,260442
411580,201808,1257,499,758,473785.84,721284.4,1195070.24
411585,201808,80,41,39,39114,37206,76320
411590,201808,23,17,6,16218,5724,21942
411600,201808,28,12,16,11448,15264,26712
411605,201808,251,108,143,103032,136422,239454
411610,201808,236,158,78,150732,74412,225144
411620,201808,367,210,157,199863,149139,349002
411630,201808,57,40,17,38160,16218,54378
411640,201808,34,28,6,26712,5724,32436
411650,201808,13,8,5,7632,4770,12402
411660,201808,33,25,8,23850,7632,31482
411670,201808,244,184,60,175536,57240,232776
411680,201808,154,133,21,126882,20034,146916
411690,201808,595,315,280,299932.44,266774.32,566706.76
411695,201808,62,46,16,43884,15264,59148
411700,201808,161,140,21,133560,20034,153594
411705,201808,102,66,36,62964,34344,97308
411710,201808,302,204,98,193549.81,93492,287041.81
411720,201808,140,90,50,85860,47700,133560
411721,201808,67,56,11,53424,10494,63918
411722,201808,98,42,56,40068,53424,93492
411725,201808,149,115,34,109137.8,32436,141573.8
411727,201808,75,60,15,57240,14023.8,71263.8
411729,201808,34,27,7,25758,6678,32436
411730,201808,550,354,196,336125.96,186697.8,522823.76
411740,201808,37,23,14,21942,13356,35298
411745,201808,71,48,23,45001,21942,66943
411750,201808,882,414,468,393859.9,445503.69,839363.59
411760,201808,1196,907,289,864029.2,275697,1139726.2
411770,201808,448,299,149,285226.92,142146,427372.92
411780,201808,372,240,132,228960,125928,354888
411790,201808,531,301,230,285272.47,219116.34,504388.81
411800,201808,169,133,36,126882,34344,161226
411810,201808,165,126,39,120204,37206,157410
411820,201808,2083,1019,1064,969531.42,1014332.3,1983863.72
411830,201808,12,12,0,11448,0,11448
411840,201808,1954,1218,736,1159777.8,700411.2,1860189.0
411845,201808,51,20,31,19080,29574,48654
411850,201808,1238,704,534,670048.4,507482.48,1177530.88
411860,201808,46,30,16,28334,15264,43598
411870,201808,77,54,23,51516,21655.8,73171.8
411880,201808,428,274,154,261282,146171.88,407453.88
411885,201808,106,70,36,66780,34344,101124
411890,201808,319,202,117,190514.99,111608.46,302123.45
411900,201808,70,51,19,48654,18126,66780
411910,201808,180,141,39,134504.46,36366.48,170870.94
411915,201808,2111,913,1198,869210.57,1141590.05,2010800.62
411920,201808,127,103,24,98262,22896,121158
411925,201808,13,9,4,8586,3816,12402
411930,201808,799,588,211,559046,201294,760340
411940,201808,594,417,177,397341,168833.56,566174.56
411950,201808,896,483,413,460114.2,392730.04,852844.24
411960,201808,994,698,296,663037.69,282384,945421.69
411965,201808,26,18,8,17172,7632,24804
411970,201808,75,67,8,63918,7632,71550
411980,201808,200,128,72,121825.8,68688,190513.8
411990,201808,5077,2969,2108,2815465.35,2009134.44,4824599.79
411995,201808,459,172,287,164088,273798,437886
412000,201808,305,184,121,174655.2,115424.46,290079.66
412010,201808,50,29,21,27666,20034,47700
412015,201808,47,33,14,31482,13356,44838
412020,201808,27,23,4,21655.8,3816,25471.8
412030,201808,60,51,9,48654,8586,57240
412033,201808,54,36,18,34320,17172,51492
412035,201808,75,47,28,44838,26712,71550
412040,201808,36,25,11,23564,10494,34058
412050,201808,199,149,50,142146,47700,189846
412060,201808,758,588,170,558090.74,161189.8,719280.54
412065,201808,49,34,15,32436,14310,46746
412070,201808,158,107,51,101410.2,48654,150064.2
412080,201808,286,154,132,146916,125928,272844
412085,201808,32,16,16,15264,15264,30528
412090,201808,761,482,279,458159.2,266166,724325.2
412100,201808,251,210,41,199387,39114,238501
412110,201808,69,55,14,52470,13356,65826
412120,201808,316,208,108,197859.6,103032,300891.6
412125,201808,81,47,34,44551.8,32436,76987.8
412130,201808,45,33,12,30891,11448,42339
412135,201808,29,17,12,16218,11448,27666
412140,201808,316,227,89,215918.82,84906,300824.82
412150,201808,253,177,76,167904.04,72504,240408.04
412160,201808,88,52,36,49608,34344,83952
412170,201808,662,464,198,442369.8,188892,631261.8
412175,201808,38,28,10,26712,9540,36252
412180,201808,194,154,40,146316.61,37539.9,183856.51
412190,201808,336,267,69,254045.43,65826,319871.43
412200,201808,197,124,73,118296,69642,187938
412210,201808,76,59,17,56286,16218,72504
412215,201808,234,164,70,156456,66493.8,222949.8
412217,201808,76,60,16,57240,15264,72504
412220,201808,817,615,202,586710,192708,779418
412230,201808,335,204,131,192994.2,124937.46,317931.66
412240,201808,1335,650,685,616417.34,651338.04,1267755.38
412250,201808,385,245,140,233730,133560,367290
412260,201808,124,91,33,86814,31482,118296
412265,201808,171,135,36,128185.84,34344,162529.84
412270,201808,84,53,31,50562,29574,80136
412280,201808,92,73,19,69642,18126,87768
412290,201808,97,65,32,62010,30528,92538
412300,201808,213,138,75,131652,71406.9,203058.9
412310,201808,43,38,5,36252,4770,41022
412320,201808,93,79,14,75366,13356,88722
412330,201808,174,152,22,145008,20988,165996
412340,201808,147,103,44,98262,41690,139952
412350,201808,608,307,301,291876.3,287154,579030.3
412360,201808,29,25,4,23850,3816,27666
412370,201808,158,138,20,130221,19080,149301
412380,201808,263,197,66,187651.8,62860,250511.8
412382,201808,52,28,24,26712,22896,49608
412385,201808,142,102,40,97308,38160,135468
412390,201808,283,216,67,206064,63918,269982
412395,201808,69,54,15,51516,14310,65826
412400,201808,76,53,23,50562,21942,72504
412402,201808,258,125,133,119245.23,126595.8,245841.03
412405,201808,823,328,495,310504.24,471544.66,782048.90
412410,201808,957,597,360,566676.6,343440,910116.6
412420,201808,14,12,2,11448,1908,13356
412430,201808,21,15,6,14310,5724,20034
412440,201808,608,333,275,315378.5,260509.52,575888.02
412450,201808,81,69,12,65826,11448,77274
412460,201808,80,61,19,58194,18126,76320
412470,201808,262,208,54,197668.8,51516,249184.8
412480,201808,166,126,40,119250.9,38160,157410.9
412490,201808,163,140,23,133560,21942,155502
412500,201808,469,381,88,361899.8,83952,445851.8
412510,201808,185,154,31,146169,29574,175743
412520,201808,136,75,61,71550,58194,129744
412530,201808,106,56,50,53424,47413.8,100837.8
412535,201808,104,76,28,72486,26712,99198
412540,201808,71,36,35,34344,33390,67734
412545,201808,95,70,25,66780,23850,90630
412550,201808,3522,1597,1925,1519874.64,1834352.9,3354227.54
412555,201808,14,10,4,9540,3816,13356
412560,201808,585,439,146,416211.4,139284,555495.4
412570,201808,731,405,326,384805.44,310984,695789.44
412575,201808,82,59,23,56286,21942,78228
412580,201808,164,110,54,104940,51516,156456
412590,201808,33,31,2,29574,1908,31482
412600,201808,177,134,43,127836,41022,168858
412610,201808,32,20,12,19080,11448,30528
412620,201808,149,130,19,124020,18126,142146
412625,201808,2206,1175,1031,1117537.47,981696.59,2099234.06
412627,201808,71,56,15,53424,14310,67734
412630,201808,425,284,141,269402.43,134514,403916.43
412635,201808,66,19,47,18126,44838,62964
412640,201808,122,82,40,78228,38160,116388
412650,201808,351,221,130,210834,124015.23,334849.23
412660,201808,480,299,181,284531,172674,457205
412665,201808,51,45,6,42930,5724,48654
412667,201808,282,194,88,184281.54,83709.8,267991.34
412670,201808,60,51,9,48654,8586,57240
412680,201808,296,234,62,223236,59148,282384
412690,201808,122,77,45,73458,42644,116102
412700,201808,159,107,52,102078,49322,151400
412710,201808,1401,870,531,823686.6,504666.2,1328352.8
412720,201808,233,159,74,151686,70596,222282
412730,201808,197,158,39,150732,36252,186984
412740,201808,423,233,190,222138.9,181260,403398.9
412750,201808,468,272,196,258534,186984,445518
412760,201808,262,135,127,128790,121158,249948
412770,201808,2127,1209,918,1149002.94,874237,2023239.94
412780,201808,154,121,33,115434,31482,146916
412785,201808,256,128,128,121635,122112,243747
412788,201808,36,21,15,20034,14310,34344
412790,201808,135,111,24,105226.2,22896,128122.2
412795,201808,153,114,39,108756,37206,145962
412796,201808,298,208,90,197267.18,85726.44,282993.62
412800,201808,568,371,197,353374.39,187938,541312.39
412810,201808,3013,1669,1344,1587628.45,1280931.03,2868559.48
412820,201808,939,615,324,575777.79,307724.01,883501.80
412830,201808,15,12,3,11448,2862,14310
412840,201808,222,158,64,149778.2,61056,210834.2
412850,201808,790,535,255,508482,243270,751752
412853,201808,175,94,81,89676,77274,166950
412855,201808,218,119,99,112414.82,94446,206860.82
412860,201808,90,66,24,62964,22896,85860
412862,201808,59,44,15,41976,14310,56286
412863,201808,6,5,1,4770,954,5724
412865,201808,42,32,10,30528,9540,40068
412870,201808,108,72,36,68688,34344,103032
412880,201808,99,73,26,69642,24804,94446
420005,201808,39,34,5,32436,4770,37206
420010,201808,375,249,126,236072.14,119918,355990.14
420020,201808,77,64,13,61056,12402,73458
420030,201808,29,26,3,24804,2862,27666
420040,201808,105,80,25,76320,23850,100170
420050,201808,54,34,20,32436,19080,51516
420055,201808,20,19,1,18126,954,19080
420060,201808,33,24,9,22896,8586,31482
420070,201808,104,87,17,82998,16208.46,99206.46
420075,201808,11,10,1,9540,954,10494
420080,201808,49,43,6,39352.5,5724,45076.5
420090,201808,34,32,2,29750.49,1908,31658.49
420100,201808,167,138,29,130698.2,27666,158364.2
420110,201808,19,19,0,18126,0,18126
420120,201808,51,39,12,37206,11448,48654
420125,201808,87,70,17,66780,16218,82998
420127,201808,33,29,4,27666,3816,31482
420130,201808,395,250,145,238378.46,138081.96,376460.42
420140,201808,1291,744,547,708451.38,521772,1230223.38
420150,201808,46,41,5,39114,4770,43884
420160,201808,37,35,2,33390,1908,35298
420165,201808,19,14,5,13356,4770,18126
420170,201808,68,44,24,41976,22896,64872
420180,201808,24,22,2,20988,1908,22896
420190,201808,31,28,3,26712,2862,29574
420195,201808,129,64,65,61056,62010,123066
420200,201808,1278,575,703,542904.52,669624.38,1212528.90
420205,201808,67,37,30,35298,28620,63918
420207,201808,106,60,46,57240,43874.46,101114.46
420208,201808,23,18,5,17172,3911.4,21083.4
420209,201808,20,16,4,15264,3816,19080
420210,201808,464,224,240,213409.8,228874.68,442284.48
420213,201808,45,36,9,34344,8586,42930
420215,201808,28,24,4,22896,3816,26712
420220,201808,65,42,23,40068,21942,62010
420230,201808,789,445,344,423767,327689.46,751456.46
420240,201808,2301,1553,748,1473182.31,713153.16,2186335.47
420243,201808,39,31,8,29574,7632,37206
420245,201808,117,64,53,61056,50562,111618
420250,201808,54,32,22,30528,20988,51516
420253,201808,43,35,8,33390,7632,41022
420257,201808,13,11,2,10494,1908,12402
420260,201808,101,88,13,83952,12402,96354
420270,201808,38,31,7,29570,6678,36248
420280,201808,284,212,72,200524.06,67430.1,267954.16
420285,201808,19,12,7,11448,6678,18126
420287,201808,50,31,19,29574,18126,47700
420290,201808,984,695,289,659978.59,275638.3,935616.89
420300,201808,1387,1101,286,1046329.4,270582.65,1316912.05
420310,201808,60,47,13,44838,12402,57240
420315,201808,35,30,5,28620,4770,33390
420320,201808,857,437,420,415920.15,400676,816596.15
420325,201808,0,0,0,0,0,0
420330,201808,122,83,39,79182,37091.52,116273.52
420340,201808,163,112,51,105886,48634.92,154520.92
420350,201808,257,189,68,178751.78,64872,243623.78
420360,201808,751,574,177,544716.16,168573.38,713289.54
420370,201808,113,72,41,68498,38828,107326
420380,201808,1142,815,327,773400.1,310921.04,1084321.14
420390,201808,256,168,88,158441.52,83236.5,241678.02
420395,201808,189,136,53,129744,49698.63,179442.63
420400,201808,247,186,61,176491,58194,234685
420410,201808,61,47,14,44838,13356,58194
420415,201808,33,31,2,29574,1908,31482
420417,201808,51,38,13,36252,12382.92,48634.92
420419,201808,12,12,0,11448,0,11448
420420,201808,2810,1729,1081,1638439.92,1028976.88,2667416.80
420425,201808,74,61,13,58185,12087.72,70272.72
420430,201808,1269,894,375,849169.22,355987.97,1205157.19
420435,201808,16,14,2,13356,1908,15264
420440,201808,109,73,36,69015.56,34192.6,103208.16
420445,201808,21,19,2,18126,1908,20034
420450,201808,76,37,39,35298,37206,72504
420455,201808,211,160,51,152602.92,48598.38,201201.30
420460,201808,2358,1569,789,1492390.56,752453.82,2244844.38
420470,201808,120,86,34,82044,32436,114480
420475,201808,6,6,0,5724,0,5724
420480,201808,873,653,220,618196.44,208831,827027.44
420490,201808,112,88,24,83952,22896,106848
420500,201808,652,288,364,272781.2,347256,620037.2
420510,201808,19,16,3,15264,2862,18126
420515,201808,26,20,6,19080,5724,24804
420517,201808,10,10,0,9540,0,9540
420519,201808,0,0,0,0,0,0
420520,201808,70,53,17,50562,16218,66780
420530,201808,167,111,56,104919.02,53424,158343.02
420535,201808,21,19,2,18126,1908,20034
420540,201808,5024,2978,2046,2828549.78,1946590.18,4775139.96
420543,201808,26,26,0,24804,0,24804
420545,201808,203,144,59,136422,56266.92,192688.92
420550,201808,862,695,167,660132.32,159160.73,819293.05
420555,201808,37,25,12,23850,11448,35298
420560,201808,68,55,13,52088.4,12402,64490.4
420570,201808,153,90,63,85860,60092.46,145952.46
420580,201808,300,132,168,125928,159986,285914
420590,201808,518,366,152,348610.68,145008,493618.68
420600,201808,101,53,48,50562,45792,96354
420610,201808,38,36,2,34058,1908,35966
420620,201808,76,62,14,59148,13356,72504
420630,201808,159,117,42,111609.23,40060,151669.23
420640,201808,95,84,11,79945.2,10494,90439.2
420650,201808,241,128,113,121444.2,107183.23,228627.43
420660,201808,56,43,13,40258.8,12402,52660.8
420665,201808,38,29,9,27666,8586,36252
420670,201808,320,240,80,228234.96,76301.46,304536.42
420675,201808,15,14,1,13356,954,14310
420680,201808,36,26,10,24804,9540,34344
420690,201808,175,144,31,136612.8,29574,166186.8
420700,201808,659,454,205,433014.3,195317.82,628332.12
420710,201808,152,88,64,83952,60769.8,144721.8
420720,201808,110,89,21,84896.46,20034,104930.46
420730,201808,558,360,198,342373.5,187606.66,529980.16
420740,201808,46,45,1,42930,954,43884
420750,201808,497,331,166,315487.8,158364,473851.8
420757,201808,18,15,3,14310,2862,17172
420760,201808,37,30,7,28620,6678,35298
420765,201808,70,58,12,55332,11448,66780
420768,201808,66,58,8,55332,7632,62964
420770,201808,85,71,14,67734,13356,81090
420775,201808,46,42,4,38832.73,3816,42648.73
420780,201808,242,190,52,181250.46,49608,230858.46
420785,201808,14,10,4,9540,3816,13356
420790,201808,177,146,31,139191.3,28592.46,167783.76
420800,201808,77,59,18,55522.8,17172,72694.8
420810,201808,252,218,34,207963,31625.1,239588.1
420820,201808,2352,1395,957,1325120.61,911629.8,2236750.41
420830,201808,595,335,260,317295.95,247076.46,564372.41
420840,201808,150,113,37,107802,34594,142396
420845,201808,446,197,249,187553.07,236306,423859.07
420850,201808,237,189,48,180306,45792,226098
420860,201808,63,54,9,51516,8586,60102
420870,201808,119,85,34,80851.5,31959,112810.5
420880,201808,175,121,54,115424.46,50752.8,166177.26
420890,201808,880,432,448,408086.84,426810.6,834897.44
420895,201808,9,9,0,8586,0,8586
420900,201808,420,329,91,312073.08,86776.38,398849.46
420910,201808,5808,3269,2539,3107168.99,2417496.27,5524665.26
420915,201808,77,71,6,67734,5724,73458
420917,201808,20,14,6,13356,5724,19080
420920,201808,22,15,7,14310,6678,20988
420930,201808,2745,1685,1060,1601704.74,1005913.2,2607617.94
420940,201808,616,447,169,425093.6,159574.08,584667.68
420945,201808,9,7,2,6678,1908,8586
420950,201808,56,51,5,48654,4770,53424
420960,201808,113,88,25,83914.92,23841,107755.92
420970,201808,303,242,61,229201.85,58166.46,287368.31
420980,201808,23,23,0,21942,0,21942
420985,201808,63,55,8,52470,7632,60102
420990,201808,75,59,16,56286,15264,71550
421000,201808,34,23,11,21942,10494,32436
421003,201808,68,46,22,43884,20979,64863
421005,201808,8,5,3,4770,2862,7632
421010,201808,758,532,226,506279,214498.2,720777.2
421020,201808,29,24,5,22896,4770,27666
421030,201808,129,109,20,103653,19080,122733
421040,201808,71,61,10,58194,9540,67734
421050,201808,319,231,88,219229.2,83952,303181.2
421055,201808,24,20,4,19080,3816,22896
421060,201808,80,54,26,51516,24804,76320
421070,201808,50,45,5,42930,4770,47700
421080,201808,34,31,3,29574,2862,32436
421085,201808,25,20,5,19080,4770,23850
421090,201808,43,32,11,30528,10494,41022
421100,201808,130,96,34,91584,32436,124020
421105,201808,218,176,42,167617.8,40044.69,207662.49
421110,201808,112,91,21,86193.9,20034,106227.9
421120,201808,154,119,35,113030.46,33361.38,146391.84
421125,201808,17,12,5,11448,4770,16218
421130,201808,815,529,286,503536.05,272028.54,775564.59
421140,201808,32,23,9,21226.5,8586,29812.5
421145,201808,40,31,9,29574,8586,38160
421150,201808,108,78,30,74412,28620,103032
421160,201808,65,43,22,41012.46,20988,62000.46
421165,201808,17,16,1,15264,954,16218
421170,201808,198,169,29,160313.84,27657,187970.84
421175,201808,149,97,52,92538,49560.38,142098.38
421180,201808,58,37,21,34936,20034,54970
421185,201808,17,14,3,13356,2862,16218
421187,201808,0,0,0,0,0,0
421189,201808,39,30,9,28620,8576.46,37196.46
421190,201808,1587,991,596,944451.46,567601.58,1512053.04
421200,201808,91,69,22,64872.7,20988,85860.7
421205,201808,27,18,9,17172,8586,25758
421210,201808,184,125,59,119250,56286,175536
421220,201808,281,223,58,212121.9,55332,267453.9
421223,201808,54,46,8,43694,7632,51326
421225,201808,69,43,26,40832,24804,65636
421227,201808,96,72,24,68688,22896,91584
421230,201808,53,40,13,38160,12402,50562
421240,201808,18,18,0,17172,0,17172
421250,201808,356,224,132,212362,125136.18,337498.18
421260,201808,27,22,5,20988,4770,25758
421265,201808,0,0,0,0,0,0
421270,201808,53,47,6,44838,5724,50562
421280,201808,336,188,148,179352,139474.8,318826.8
421290,201808,328,215,113,204872,105676.26,310548.26
421300,201808,26,21,5,20034,4770,24804
421310,201808,54,41,13,38446.2,12402,50848.2
421315,201808,30,20,10,19080,9540,28620
421320,201808,134,93,41,88722,39114,127836
421330,201808,111,85,26,79182,24795,103977
421335,201808,39,27,12,25758,11448,37206
421340,201808,295,202,93,190944.05,88722,279666.05
421350,201808,187,108,79,102589,75366,177955
421360,201808,692,511,181,483492.26,172083.06,655575.32
421370,201808,195,150,45,143100,42596.1,185696.1
421380,201808,128,103,25,98257.23,23850,122107.23
421390,201808,16,12,4,11448,3816,15264
421400,201808,118,100,18,95400,17172,112572
421410,201808,22,19,3,18126,2862,20988
421415,201808,22,21,1,20034,954,20988
421420,201808,149,122,27,115815.6,25758,141573.6
421430,201808,14,10,4,9540,3816,13356
421440,201808,54,42,12,40068,11448,51516
421450,201808,95,82,13,78228,12402,90630
421460,201808,57,48,9,44987.77,8586,53573.77
421470,201808,70,46,24,43884,22896,66780
421480,201808,643,481,162,458397,154539,612936
421490,201808,22,21,1,19358,954,20312
421500,201808,515,331,184,313982.3,175258.44,489240.74
421505,201808,27,19,8,18126,7632,25758
421507,201808,35,29,6,27666,5724,33390
421510,201808,73,47,26,44838,24804,69642
421520,201808,67,58,9,54569,8586,63155
421530,201808,55,49,6,46746,5724,52470
421535,201808,27,26,1,24537,954,25491
421540,201808,58,50,8,47700,7632,55332
421545,201808,97,74,23,70110,21942,92052
421550,201808,297,217,80,206351,76320,282671
421555,201808,26,21,5,20034,4675,24709
421560,201808,8,7,1,6678,954,7632
421565,201808,124,90,34,85860,32436,118296
421567,201808,31,26,5,24804,4770,29574
421568,201808,32,30,2,28620,1908,30528
421569,201808,7,7,0,6678,0,6678
421570,201808,151,104,47,99216,44838,144054
421575,201808,27,22,5,20988,4770,25758
421580,201808,726,434,292,412987.2,277614.34,690601.54
421590,201808,22,21,1,20034,954,20988
421600,201808,110,75,35,71550,32151,103701
421605,201808,106,76,30,72171,28620,100791
421610,201808,189,150,39,142146.2,37206,179352.2
421620,201808,1103,660,443,627093.22,422602.92,1049696.14
421625,201808,22,20,2,19080,1908,20988
421630,201808,290,183,107,173771.8,101220,274991.8
421635,201808,16,8,8,7632,7632,15264
421640,201808,101,87,14,82808,13356,96164
421650,201808,284,166,118,158344.92,112552.92,270897.84
421660,201808,2149,1292,857,1229220.9,816406.06,2045626.96
421670,201808,189,134,55,127836,52470,180306
421680,201808,171,155,16,147870,15264,163134
421690,201808,351,244,107,231728.22,101114.58,332842.80
421700,201808,59,37,22,35298,20130,55428
421710,201808,24,24,0,22896,0,22896
421715,201808,8,7,1,6678,954,7632
421720,201808,590,428,162,406506.3,152821.26,559327.56
421725,201808,12,5,7,4770,6678,11448
421730,201808,39,27,12,25050.12,11448,36498.12
421740,201808,88,42,46,40068,43884,83952
421750,201808,228,171,57,160689.2,54378,215067.2
421755,201808,27,25,2,23850,1908,25758
421760,201808,105,74,31,70596,29574,100170
421770,201808,584,394,190,372631.38,180899.9,553531.28
421775,201808,29,19,10,18126,9540,27666
421780,201808,196,154,42,146916,40068,186984
421790,201808,159,132,27,125035.5,25758,150793.5
421795,201808,18,14,4,13356,3816,17172
421800,201808,492,317,175,301621.31,166712,468333.31
421810,201808,71,56,15,53424,14310,67734
421820,201808,314,216,98,204909.2,93492,298401.2
421825,201808,128,107,21,102078,20034,122112
421830,201808,133,102,31,97308,29574,126882
421835,201808,3,3,0,2862,0,2862
421840,201808,59,49,10,46737,9540,56277
421850,201808,78,68,10,64872,9536,74408
421860,201808,40,32,8,30528,7632,38160
421870,201808,977,747,230,704236.32,218635.86,922872.18
421875,201808,54,46,8,43884,7632,51516
421880,201808,165,120,45,114480,42644,157124
421885,201808,29,23,6,21942,5724,27666
421890,201808,120,85,35,81090,32142,113232
421895,201808,43,40,3,38160,2862,41022
421900,201808,155,125,30,118889.1,28584,147473.1
421910,201808,66,43,23,41022,21942,62964
421915,201808,31,26,5,24804,4770,29574
421917,201808,43,32,11,30528,10494,41022
421920,201808,33,30,3,28620,2862,31482
421930,201808,747,581,166,551007.06,158337,709344.06
421935,201808,57,50,7,47700,6678,54378
421940,201808,41,37,4,35298,3816,39114
421950,201808,842,557,285,524611,269438.08,794049.08
421960,201808,41,35,6,33104,5702.12,38806.12
421970,201808,371,238,133,226553.12,126851.12,353404.24
421985,201808,32,21,11,20034,10494,30528
422000,201808,0,0,0,0,0,0
430003,201808,204,51,153,47938.5,145962,193900.5
430005,201808,37,28,9,26712,8586,35298
430010,201808,278,195,83,185553,79182,264735
430020,201808,152,98,54,93206,51516,144722
430030,201808,134,106,28,100837.8,26712,127549.8
430040,201808,2987,1743,1244,1653893.86,1185117.4,2839011.26
430045,201808,65,56,9,53137.8,8586,61723.8
430047,201808,6,5,1,4770,954,5724
430050,201808,79,66,13,62964,12402,75366
430055,201808,16,14,2,13356,1908,15264
430057,201808,5,3,2,2862,1908,4770
430060,201808,3659,2188,1471,2078610.7,1399560.74,3478171.44
430063,201808,59,55,4,52470,3816,56286
430064,201808,150,122,28,116388,26712,143100
430066,201808,9,6,3,5724,2862,8586
430070,201808,43,33,10,31482,9540,41022
430080,201808,69,47,22,44138.33,20988,65126.33
430085,201808,35,13,22,12402,20988,33390
430087,201808,32,23,9,21799,8586,30385
430090,201808,72,65,7,61723.8,6678,68401.8
430100,201808,132,90,42,84906,40068,124974
430105,201808,145,73,72,69452,68382.72,137834.72
430107,201808,20,15,5,14310,4770,19080
430110,201808,415,244,171,231907.86,163048.14,394956.00
430120,201808,141,130,11,123066,10494,133560
430130,201808,802,503,299,479241.9,284959.8,764201.7
430140,201808,122,115,7,109710,6678,116388
430150,201808,112,72,40,67925,37206,105131
430155,201808,32,29,3,27666,2862,30528
430160,201808,3799,2257,1542,2130425.16,1468902.62,3599327.78
430163,201808,329,147,182,139189.34,173599.38,312788.72
430165,201808,26,18,8,17172,7632,24804
430170,201808,89,77,12,73458,11448,84906
430175,201808,85,66,19,62964,17458.2,80422.2
430180,201808,106,83,23,79182,21321.9,100503.9
430185,201808,34,26,8,24804,7632,32436
430187,201808,98,41,57,39114,54072.8,93186.8
430190,201808,221,128,93,122064.3,88045.46,210109.76
430192,201808,15,14,1,13356,954,14310
430195,201808,15,10,5,9540,4770,14310
430200,201808,166,148,18,140524.2,17172,157696.2
430205,201808,20,19,1,18126,954,19080
430210,201808,647,502,145,475187.4,136565.3,611752.7
430215,201808,17,12,5,11448,4770,16218
430220,201808,70,49,21,46746,20034,66780
430222,201808,12,7,5,6678,4770,11448
430223,201808,12,7,5,6678,4770,11448
430225,201808,4,3,1,2862,954,3816
430230,201808,301,184,117,174582,111522.6,286104.6
430235,201808,53,37,16,35298,15254.46,50552.46
430237,201808,31,22,9,20988,8586,29574
430240,201808,131,85,46,80899.2,43884,124783.2
430245,201808,73,62,11,59148,10494,69642
430250,201808,192,113,79,107792.46,75356.46,183148.92
430258,201808,12,10,2,9540,1908,11448
430260,201808,34,29,5,27666,4760.46,32426.46
430265,201808,34,29,5,27646.92,4770,32416.92
430270,201808,551,412,139,389944.74,131740.02,521684.76
430280,201808,1046,644,402,609901.74,381962.6,991864.34
430290,201808,379,218,161,206064.8,153594,359658.8
430300,201808,2128,1183,945,1124128.44,898480.35,2022608.79
430310,201808,1982,1047,935,992524.7,888957.93,1881482.63
430320,201808,50,42,8,40053.69,7632,47685.69
430330,201808,97,86,11,81567,10474.92,92041.92
430340,201808,67,59,8,56286,7632,63918
430350,201808,1680,1168,512,1103096.89,486950.76,1590047.65
430355,201808,24,21,3,20034,2862,22896
430360,201808,81,39,42,37206,40068,77274
430367,201808,28,20,8,19080,7632,26712
430370,201808,55,47,8,44838,7632,52470
430380,201808,129,97,32,91965.6,30528,122493.6
430390,201808,608,382,226,364141.8,215013.26,579155.06
430400,201808,143,110,33,103032,31462.92,134494.92
430410,201808,60,47,13,44838,12402,57240
430420,201808,502,331,171,313294.8,161637.56,474932.36
430430,201808,54,51,3,48018.63,2051.1,50069.73
430435,201808,155,117,38,110664,35536.5,146200.5
430440,201808,510,340,170,324360,161979.66,486339.66
430450,201808,1188,980,208,928414.46,198422.46,1126836.92
430460,201808,5072,2796,2276,2652973.55,2164809.97,4817783.52
430461,201808,17,15,2,14310,1908,16218
430462,201808,9,6,3,5724,2862,8586
430463,201808,1026,545,481,517983.92,458522.1,976506.02
430465,201808,26,14,12,13356,11448,24804
430466,201808,664,479,185,455058.2,176299.2,631357.4
430467,201808,100,57,43,53137.8,41012.46,94150.26
430468,201808,108,65,43,62010,40770.91,102780.91
430469,201808,23,18,5,17172,4770,21942
430470,201808,1170,648,522,612507.55,496032.3,1108539.85
430471,201808,49,36,13,34324.92,12402,46726.92
430480,201808,98,60,38,56381.4,36242.46,92623.86
430485,201808,6,6,0,5438,0,5438
430490,201808,87,71,16,66923.7,15264,82187.7
430495,201808,38,28,10,26712,9540,36252
430500,201808,191,126,65,119917.8,61634.46,181552.26
430510,201808,3192,2103,1089,1996054.53,1037733.12,3033787.65
430511,201808,17,16,1,15264,954,16218
430512,201808,138,97,41,92538,39114,131652
430513,201808,53,44,9,41499,8586,50085
430515,201808,31,29,2,27666,1908,29574
430517,201808,169,150,19,142146,18106.92,160252.92
430520,201808,376,264,112,251189,106819.38,358008.38
430530,201808,88,51,37,48654,35298,83952
430535,201808,474,320,154,304794.23,146888.15,451682.38
430537,201808,10,10,0,9540,0,9540
430540,201808,74,50,24,47700,22896,70596
430543,201808,369,116,253,110664,241362,352026
430544,201808,43,40,3,38160,2862,41022
430545,201808,350,171,179,162638,170254.66,332892.66
430550,201808,42,35,7,33390,6678,40068
430558,201808,5,3,2,2862,1908,4770
430560,201808,51,23,28,21942,26712,48654
430570,201808,106,45,61,42930,58136.76,101066.76
430580,201808,123,99,24,94446,21655.8,116101.8
430583,201808,14,14,0,13356,0,13356
430585,201808,8,3,5,2862,4770,7632
430587,201808,15,7,8,6678,7632,14310
430590,201808,151,122,29,115147.8,27666,142813.8
430593,201808,4,4,0,3816,0,3816
430595,201808,18,14,4,13356,3816,17172
430597,201808,51,27,24,25758,22896,48654
430600,201808,221,155,66,147860.46,62677.8,210538.26
430605,201808,160,100,60,95400,57230.46,152630.46
430607,201808,28,23,5,21942,4770,26712
430610,201808,1622,763,859,725889.76,815165.32,1541055.08
430613,201808,3,3,0,2862,0,2862
430620,201808,113,82,31,78228,29564.46,107792.46
430630,201808,44,38,6,36252,5724,41976
430632,201808,33,28,5,26712,4770,31482
430635,201808,41,37,4,35298,3816,39114
430637,201808,56,32,24,30528,22896,53424
430640,201808,200,114,86,107325,82044,189369
430642,201808,26,24,2,22896,1908,24804
430645,201808,35,29,6,27666,5724,33390
430650,201808,260,211,49,201008,46698.3,247706.3
430655,201808,4,4,0,3816,0,3816
430660,201808,965,474,491,450621.9,466887.8,917509.7
430670,201808,74,51,23,48654,21942,70596
430673,201808,68,37,31,35298,29574,64872
430675,201808,13,10,3,9540,2862,12402
430676,201808,499,304,195,289310.12,185959.07,475269.19
430680,201808,247,172,75,161607.8,71550,233157.8
430690,201808,536,320,216,304374.24,204389.06,508763.30
430692,201808,7,5,2,4770,1908,6678
430693,201808,146,98,48,93492,45782.46,139274.46
430695,201808,75,65,10,61075.08,9540,70615.08
430697,201808,58,36,22,34344,20988,55332
430700,201808,1586,1109,477,1047399.58,454771.8,1502171.38
430705,201808,20,19,1,18126,954,19080
430710,201808,259,169,90,161226,85860,247086
430720,201808,107,91,16,86623.2,15264,101887.2
430730,201808,120,102,18,96354,17172,113526
430740,201808,65,41,24,39114,22896,62010
430745,201808,36,29,7,27380,6678,34058
430750,201808,345,230,115,218476.64,108756,327232.64
430755,201808,83,48,35,45792,33390,79182
430760,201808,363,217,146,204347.72,139255.92,343603.64
430770,201808,1456,761,695,723323.7,657895.93,1381219.63
430780,201808,318,203,115,192680.72,109653.3,302334.02
430781,201808,29,24,5,22896,4770,27666
430783,201808,52,41,11,38796.13,10494,49290.13
430786,201808,6,3,3,2862,2862,5724
430790,201808,504,327,177,310686.12,168562.46,479248.58
430800,201808,157,130,27,124000.92,25758,149758.92
430805,201808,42,38,4,36252,3816,40068
430807,201808,39,25,14,23850,13356,37206
430810,201808,75,49,26,46746,24804,71550
430820,201808,137,84,53,80136,49894.2,130030.2
430825,201808,12,10,2,9540,1908,11448
430830,201808,233,220,13,209574.92,12402,221976.92
430840,201808,127,86,41,82044,38255.4,120299.4
430843,201808,5,3,2,2862,1908,4770
430845,201808,70,39,31,37206,29574,66780
430850,201808,576,400,176,379262.7,167800.76,547063.46
430860,201808,161,102,59,96640.2,55608.66,152248.86
430865,201808,68,39,29,36538.2,27360.72,63898.92
430870,201808,82,66,16,62296.2,15264,77560.2
430880,201808,160,120,40,114460.92,38160,152620.92
430885,201808,7,6,1,5724,954,6678
430890,201808,333,205,128,193910.04,122112,316022.04
430900,201808,538,374,164,352312.2,155979,508291.2
430905,201808,94,40,54,38160,51516,89676
430910,201808,267,149,118,142146,111896,254042
430912,201808,4,4,0,3816,0,3816
430915,201808,34,26,8,24804,7345.8,32149.8
430920,201808,4275,2374,1901,2257683.61,1810913.92,4068597.53
430925,201808,5,4,1,3567.96,954,4521.96
430930,201808,2110,1252,858,1186434.54,818271.97,2004706.51
430940,201808,258,164,94,155778.66,89656.92,245435.58
430950,201808,156,125,31,119250,29574,148824
430955,201808,21,13,8,12402,7632,20034
430957,201808,18,17,1,16218,954,17172
430960,201808,238,158,80,148442.4,75652.2,224094.6
430965,201808,107,67,40,63918,38160,102078
430970,201808,83,69,14,65826,12402,78228
430975,201808,38,34,4,32436,3816,36252
430980,201808,47,29,18,27666,17172,44838
430990,201808,117,88,29,83952,27666,111618
430995,201808,116,111,5,104653.8,4770,109423.8
431000,201808,302,136,166,127597.2,158364,285961.2
431010,201808,337,203,134,193089.6,127816.92,320906.52
431020,201808,1956,1140,816,1079475.42,774352.26,1853827.68
431030,201808,42,33,9,31482,8586,40068
431033,201808,388,194,194,184265.2,185076,369341.2
431036,201808,14,9,5,8586,4770,13356
431040,201808,131,79,52,74412,49498.29,123910.29
431041,201808,39,27,12,25758,11448,37206
431043,201808,48,28,20,26712,19080,45792
431046,201808,12,7,5,6678,4770,11448
431050,201808,204,132,72,125355.6,68688,194043.6
431053,201808,76,45,31,42166.8,29574,71740.8
431055,201808,61,41,20,39114,19060.92,58174.92
431057,201808,17,17,0,16218,0,16218
431060,201808,1668,1056,612,998525.36,581996.44,1580521.80
431065,201808,19,11,8,10494,7632,18126
431070,201808,70,65,5,62010,4770,66780
431075,201808,7,7,0,6678,0,6678
431080,201808,138,87,51,82425.6,48654,131079.6
431085,201808,31,28,3,26712,2862,29574
431087,201808,13,11,2,10494,1908,12402
431090,201808,55,43,12,41022,11448,52470
431100,201808,1230,734,496,689459.02,473184,1162643.02
431110,201808,247,156,91,148824,86518.46,235342.46
431112,201808,29,17,12,16218,11448,27666
431113,201808,31,24,7,22896,6678,29574
431115,201808,159,112,47,106211.87,44828.46,151040.33
431120,201808,608,361,247,342458.18,234626.92,577085.10
431123,201808,4,3,1,2862,954,3816
431125,201808,94,84,10,80136,9540,89676
431127,201808,9,4,5,3816,4770,8586
431130,201808,662,426,236,405059.79,224838.72,629898.51
431140,201808,737,506,231,481484,220297.68,701781.68
431142,201808,35,27,8,24546,7632,32178
431150,201808,202,147,55,140238,52460.46,192698.46
431160,201808,56,50,6,47700,5724,53424
431162,201808,19,14,5,13356,4770,18126
431164,201808,4,4,0,3816,0,3816
431170,201808,108,88,20,83952,19080,103032
431171,201808,59,34,25,32197.5,23840.46,56037.96
431173,201808,1,1,0,954,0,954
431175,201808,202,101,101,95114,96344.46,191458.46
431177,201808,77,57,20,54378,18393.92,72771.92
431179,201808,13,11,2,10494,1908,12402
431180,201808,452,280,172,267120,164069.46,431189.46
431190,201808,87,67,20,63918,19080,82998
431198,201808,70,49,21,46746,20034,66780
431200,201808,21,17,4,16218,3816,20034
431205,201808,23,23,0,21942,0,21942
431210,201808,88,54,34,51516,32436,83952
431213,201808,30,25,5,23850,4770,28620
431215,201808,26,23,3,21942,2862,24804
431217,201808,5,4,1,3816,954,4770
431220,201808,66,57,9,54378,8586,62964
431225,201808,151,99,52,94437,49588.92,144025.92
431230,201808,99,86,13,82044,12402,94446
431235,201808,8,8,0,7632,0,7632
431237,201808,26,18,8,17172,7632,24804
431238,201808,11,8,3,7346,2862,10208
431240,201808,1004,649,355,617264.04,338345.64,955609.68
431242,201808,37,36,1,34344,954,35298
431244,201808,11,8,3,7632,2862,10494
431245,201808,55,41,14,39114,13356,52470
431247,201808,14,12,2,11448,1908,13356
431250,201808,272,143,129,136355.22,123046.92,259402.14
431260,201808,61,46,15,43884,14310,58194
431261,201808,19,13,6,12402,5724,18126
431262,201808,16,16,0,15264,0,15264
431265,201808,157,83,74,79182,70596,149778
431267,201808,14,13,1,12402,954,13356
431270,201808,320,266,54,253764,51516,305280
431275,201808,40,37,3,35298,2862,38160
431280,201808,20,16,4,14429.25,3816,18245.25
431290,201808,23,19,4,18126,3816,21942
431295,201808,4,4,0,3816,0,3816
431300,201808,23,20,3,19080,2862,21942
431301,201808,7,7,0,6678,0,6678
431303,201808,53,35,18,33265.98,16885.8,50151.78
431306,201808,225,117,108,111448.18,103032,214480.18
431308,201808,7,5,2,4770,1908,6678
431310,201808,66,58,8,55332,7632,62964
431320,201808,124,74,50,70576.92,47404.26,117981.18
431330,201808,171,112,59,106848,56286,163134
431333,201808,33,27,6,25758,5724,31482
431335,201808,10,5,5,4770,4770,9540
431337,201808,325,153,172,145275.2,163048.14,308323.34
431339,201808,23,20,3,19080,2862,21942
431340,201808,3022,1746,1276,1660282.13,1214539.76,2874821.89
431342,201808,40,23,17,21942,16218,38160
431344,201808,18,18,0,17172,0,17172
431346,201808,4,4,0,3816,0,3816
431349,201808,35,32,3,30528,2862,33390
431350,201808,916,540,376,511851.86,357044.04,868895.90
431360,201808,48,43,5,41022,4770,45792
431365,201808,319,152,167,144988.92,158354.46,303343.38
431370,201808,1336,792,544,753050.11,518808.06,1271858.17
431380,201808,96,82,14,78228,13356,91584
431390,201808,501,275,226,260680.5,215298.72,475979.22
431395,201808,286,126,160,120204,152621,272825
431400,201808,39,29,10,27666,9540,37206
431402,201808,104,72,32,68688,30528,99216
431403,201808,20,12,8,11448,7632,19080
431405,201808,651,350,301,331973.82,286841,618814.82
431406,201808,31,27,4,25758,3816,29574
431407,201808,52,41,11,39114,10494,49608
431410,201808,3335,2029,1306,1921708.29,1241621.46,3163329.75
431413,201808,16,13,3,12402,2862,15264
431415,201808,72,52,20,49608,19080,68688
431417,201808,23,12,11,11448,10494,21942
431420,201808,307,215,92,204473.96,87768,292241.96
431430,201808,44,19,25,18126,23850,41976
431440,201808,8976,6398,2578,6036613.1,2451700.21,8488313.31
431442,201808,28,15,13,14310,12402,26712
431445,201808,28,23,5,21942,4770,26712
431446,201808,8,7,1,6678,954,7632
431447,201808,88,63,25,60102,23850,83952
431449,201808,52,45,7,42930,6678,49608
431450,201808,413,281,132,267787.8,125212.5,393000.3
431454,201808,0,0,0,0,0,0
431455,201808,49,39,10,37206,9540,46746
431460,201808,534,369,165,349974.9,157123.8,507098.7
431470,201808,116,90,26,85860,24554,110414
431475,201808,11,10,1,9540,954,10494
431477,201808,36,24,12,22896,11448,34344
431478,201808,8,7,1,6678,954,7632
431480,201808,501,316,185,299918.52,176423.22,476341.74
431490,201808,28217,16137,12080,15319800.35,11489355.41,26809155.76
431500,201808,79,55,24,52231.5,22896,75127.5
431505,201808,38,23,15,21942,14310,36252
431507,201808,12,10,2,9540,1908,11448
431510,201808,268,179,89,169383,83923.38,253306.38
431513,201808,22,18,4,17172,3816,20988
431514,201808,9,8,1,7632,954,8586
431515,201808,80,67,13,63918,12402,76320
431517,201808,4,3,1,2862,954,3816
431520,201808,37,33,4,31482,3816,35298
431530,201808,1595,718,877,684590.64,836234.09,1520824.73
431531,201808,24,22,2,20988,1908,22896
431532,201808,25,17,8,16218,7632,23850
431535,201808,25,16,9,15264,8586,23850
431540,201808,138,122,16,115462.62,15264,130726.62
431545,201808,16,14,2,13356,1908,15264
431550,201808,358,203,155,193375.8,147774.6,341150.4
431555,201808,13,12,1,11448,954,12402
431560,201808,4534,3203,1331,3024594.74,1267504.38,4292099.12
431570,201808,807,432,375,408026.2,355832.46,763858.66
431575,201808,36,25,11,23850,10494,34344
431580,201808,92,66,26,62010,24804,86814
431590,201808,136,113,23,106848,21942,128790
431595,201808,11,10,1,9540,954,10494
431600,201808,219,125,94,119230.92,89676,208906.92
431610,201808,126,92,34,86527.8,32436,118963.8
431620,201808,43,35,8,33390,7632,41022
431630,201808,140,117,23,111618,21942,133560
431640,201808,1354,845,509,800978.82,483297.22,1284276.04
431642,201808,39,36,3,33867,2862,36729
431643,201808,46,20,26,19080,24804,43884
431645,201808,302,176,126,167904,119917.8,287821.8
431647,201808,10,10,0,9540,0,9540
431650,201808,35,26,9,24804,8586,33390
431660,201808,290,186,104,175536,99216,274752
431670,201808,226,107,119,99454.5,113497.38,212951.88
431673,201808,3,3,0,2862,0,2862
431675,201808,30,25,5,23563.8,4770,28333.8
431680,201808,1121,810,311,767970,295645.14,1063615.14
431690,201808,4793,2923,1870,2764129.04,1779766.22,4543895.26
431695,201808,25,20,5,19080,4770,23850
431697,201808,0,0,0,0,0,0
431700,201808,180,140,40,133560,38160,171720
431710,201808,4023,1743,2280,1660237.4,2174620.94,3834858.34
431720,201808,1387,836,551,788178.02,524686.46,1312864.48
431725,201808,1,1,0,954,0,954
431730,201808,1210,821,389,775233.7,371106,1146339.7
431740,201808,1362,685,677,648968.12,644067.38,1293035.50
431750,201808,1877,1217,660,1150741.5,627703.92,1778445.42
431755,201808,6,5,1,4770,954,5724
431760,201808,1061,683,378,651200.4,360383.58,1011583.98
431770,201808,396,291,105,276936.66,100150.92,377087.58
431775,201808,29,21,8,20034,7632,27666
431780,201808,567,352,215,334978.02,205100.46,540078.48
431790,201808,158,120,38,113526,36204.3,149730.3
431795,201808,13,12,1,11448,954,12402
431800,201808,3377,1780,1597,1682631.52,1518161.7,3200793.22
431805,201808,18,15,3,14310,2862,17172
431810,201808,612,413,199,391368.96,189712.98,581081.94
431820,201808,315,180,135,171720,128790,300510
431830,201808,2336,1418,918,1349151.57,874511.65,2223663.22
431840,201808,523,352,171,332470.6,161865.38,494335.98
431842,201808,34,28,6,26712,5724,32436
431843,201808,13,9,4,8586,3816,12402
431844,201808,14,12,2,11448,1908,13356
431845,201808,30,27,3,25758,2862,28620
431846,201808,28,22,6,20988,5724,26712
431848,201808,14,12,2,11448,1908,13356
431849,201808,9,7,2,6678,1908,8586
431850,201808,812,671,141,638621.31,134275.5,772896.81
431860,201808,108,77,31,73458,28620,102078
431861,201808,3,2,1,1908,954,2862
431862,201808,51,32,19,30528,18126,48654
431870,201808,3445,2039,1406,1935871.76,1337969.16,3273840.92
431880,201808,958,701,257,662715.8,244224,906939.8
431890,201808,1305,812,493,769325.54,468715,1238040.54
431900,201808,177,125,52,119250,48816.18,168066.18
431910,201808,54,41,13,39114,12402,51516
431912,201808,37,20,17,19060.92,16218,35278.92
431915,201808,129,103,26,98262,24804,123066
431920,201808,146,108,38,102745.8,36252,138997.8
431930,201808,84,68,16,64156.5,15264,79420.5
431935,201808,4,3,1,2862,954,3816
431936,201808,15,14,1,13356,954,14310
431937,201808,19,14,5,13356,4770,18126
431940,201808,462,312,150,294881.4,141943.96,436825.36
431950,201808,492,314,178,297363.08,169660.44,467023.52
431960,201808,728,420,308,397762.84,293670.9,691433.74
431970,201808,72,64,8,61056,7632,68688
431971,201808,3,3,0,2862,0,2862
431973,201808,22,17,5,16218,4770,20988
431975,201808,7,6,1,5724,954,6678
431980,201808,202,127,75,120585.6,71550,192135.6
431990,201808,1213,659,554,627212.99,528470,1155682.99
432000,201808,1673,913,760,863030.16,721475.24,1584505.40
432010,201808,280,184,96,174238.56,91584,265822.56
432020,201808,168,136,32,129744,30528,160272
432023,201808,18,14,4,13356,3816,17172
432026,201808,67,61,6,58194,5724,63918
432030,201808,63,28,35,26712,33390,60102
432032,201808,21,18,3,17172,2862,20034
432035,201808,52,41,11,39114,10494,49608
432040,201808,106,73,33,69642,31482,101124
432045,201808,8,7,1,6678,954,7632
432050,201808,70,41,29,39114,27666,66780
432055,201808,103,76,27,72504,25758,98262
432057,201808,1,0,1,0,954,954
432060,201808,34,31,3,29574,2862,32436
432065,201808,30,27,3,25758,2862,28620
432067,201808,87,77,10,73438.92,9540,82978.92
432070,201808,410,307,103,290428.07,98233.92,388661.99
432080,201808,815,567,248,539238.96,236544.38,775783.34
432085,201808,16,12,4,11448,3816,15264
432090,201808,261,163,98,155502,93492,248994
432100,201808,175,118,57,112285.8,54378,166663.8
432110,201808,622,426,196,396012.44,186030,582042.44
432120,201808,952,574,378,547596,360526.14,908122.14
432130,201808,507,370,137,351644.4,129600.9,481245.3
432132,201808,24,21,3,20034,2862,22896
432135,201808,79,65,14,62010,13356,75366
432140,201808,269,215,54,204814.26,51516,256330.26
432143,201808,192,122,70,116388,66780,183168
432145,201808,270,186,84,176204.6,79849.8,256054.4
432146,201808,15,14,1,13356,954,14310
432147,201808,129,60,69,57240,65802.15,123042.15
432149,201808,16,12,4,11448,3816,15264
432150,201808,843,526,317,501555.96,300396.17,801952.13
432160,201808,1402,731,671,695028.7,639209.36,1334238.06
432162,201808,4,3,1,2862,954,3816
432163,201808,18,14,4,13356,3816,17172
432166,201808,121,91,30,87292,28620,115912
432170,201808,222,121,101,114481,96354,210835
432180,201808,530,328,202,310034.37,192422,502456.37
432183,201808,8,7,1,6678,954,7632
432185,201808,81,70,11,66780,10494,77274
432190,201808,459,259,200,246694.86,190695.6,437390.46
432195,201808,85,73,12,69642,11448,81090
432200,201808,419,273,146,260442,139236.84,399678.84
432210,201808,120,76,44,71550,41976,113526
432215,201808,57,53,4,50562,3816,54378
432218,201808,20,19,1,18126,954,19080
432220,201808,688,349,339,331935.56,322898.74,654834.30
432225,201808,13,7,6,6678,5724,12402
432230,201808,145,89,56,84667.5,53424,138091.5
432232,201808,15,13,2,12402,1908,14310
432234,201808,4,3,1,2862,954,3816
432235,201808,2,2,0,1908,0,1908
432237,201808,30,17,13,16218,12402,28620
432240,201808,4293,2403,1890,2281586.29,1796345.38,4077931.67
432250,201808,1048,671,377,636748.76,359495.82,996244.58
432252,201808,42,36,6,33867,5724,39591
432253,201808,59,47,12,44838,11448,56286
432254,201808,24,11,13,10494,12402,22896
432255,201808,14,13,1,12402,954,13356
432260,201808,876,692,184,658461.34,174582.5,833043.84
432270,201808,235,170,65,162180,62010,224190
432280,201808,127,94,33,89199.8,31482,120681.8
432285,201808,1,1,0,954,0,954
432290,201808,70,63,7,58194,6678,64872
432300,201808,4634,2658,1976,2516639.32,1881166.68,4397806.00
432310,201808,117,96,21,91440.9,20034,111474.9
432320,201808,18,15,3,14310,2862,17172
432330,201808,17,12,5,11448,4770,16218
432335,201808,7,6,1,5724,954,6678
432340,201808,39,36,3,34344,2862,37206
432345,201808,99,70,29,66780,27666,94446
432350,201808,24,23,1,21942,954,22896
432360,201808,6,4,2,3816,1908,5724
432370,201808,25,25,0,23850,0,23850
432375,201808,36,32,4,30528,3816,34344
432377,201808,8,8,0,7632,0,7632
432380,201808,167,74,93,69928.2,88674.3,158602.5
500020,201808,255,143,112,136422,106246.98,242668.98
500025,201808,117,58,59,54378,56286,110664
500060,201808,1407,868,539,827499.6,512637.61,1340137.21
500070,201808,781,375,406,357399,387314.46,744713.46
500080,201808,133,103,30,98262,28620,126882
500085,201808,136,109,27,103413.8,24923.25,128337.05
500090,201808,333,161,172,153594,164088,317682
500100,201808,726,387,339,367576.53,322834,690410.53
500110,201808,2231,1017,1214,969872.92,1157352.14,2127225.06
500124,201808,311,176,135,167904,128503.8,296407.8
500150,201808,326,131,195,124965,185660.46,310625.46
500190,201808,532,365,167,347542.2,158832,506374.2
500200,201808,196,166,30,158021,28620,186641
500210,201808,1433,515,918,491095.39,874496.37,1365591.76
500215,201808,243,140,103,132602.42,98262,230864.42
500220,201808,789,512,277,486964.34,264248.46,751212.80
500230,201808,258,173,85,164326.5,80613,244939.5
500240,201808,703,487,216,463834.8,205777.8,669612.6
500260,201808,584,219,365,208926,348210,557136
500270,201808,28632,12281,16351,11685577.81,15580574.04,27266151.85
500280,201808,192,72,120,68688,114480,183168
500290,201808,1192,710,482,676387,459819,1136206
500295,201808,414,253,161,241362,153584.46,394946.46
500310,201808,63,20,43,19080,41022,60102
500315,201808,723,430,293,410210.46,279512.46,689722.92
500320,201808,3619,1824,1795,1737673.38,1712003.94,3449677.32
500325,201808,922,508,414,484155,393716.44,877871.44
500330,201808,1470,684,786,650314.28,749510.64,1399824.92
500345,201808,323,244,79,231813.2,75366,307179.2
500348,201808,244,146,98,139284,93473.46,232757.46
500350,201808,135,66,69,62964,65826,128790
500370,201808,5405,2442,2963,2322140.1,2824522.78,5146662.88
500375,201808,354,257,97,244913.84,92538,337451.84
500380,201808,602,347,255,330880.59,243260.46,574141.05
500390,201808,71,36,35,34344,33390,67734
500400,201808,215,146,69,139264.92,65817,205081.92
500410,201808,549,216,333,206018.15,317538.22,523556.37
500430,201808,542,379,163,361566,155502,517068
500440,201808,205,103,102,97871.03,97308,195179.03
500450,201808,407,175,232,166244.8,221318.46,387563.26
500460,201808,306,155,151,147860.46,143758.26,291618.72
500470,201808,443,347,96,330166.46,90621,420787.46
500480,201808,113,67,46,63918,43884,107802
500490,201808,108,44,64,41971.23,61056,103027.23
500500,201808,1428,507,921,481670.44,878080.18,1359750.62
500510,201808,48,37,11,35298,10485,45783
500515,201808,107,76,31,72504,29288,101792
500520,201808,344,189,155,178971,147580,326551
500525,201808,88,50,38,47700,35965.8,83665.8
500540,201808,915,384,531,366269.76,505568.61,871838.37
500560,201808,882,497,385,472399.04,366965.84,839364.88
500568,201808,995,582,413,551666.62,393712,945378.62
500570,201808,1213,684,529,649066.04,501771.18,1150837.22
500580,201808,337,171,166,162838.26,158351,321189.26
500600,201808,306,158,148,150021.27,141174,291195.27
500620,201808,933,656,277,620333.64,264067.2,884400.84
500625,201808,80,68,12,64490.4,11448,75938.4
500627,201808,24,12,12,11448,11448,22896
500630,201808,1565,840,725,800015.66,691363.8,1491379.46
500635,201808,523,299,224,284826.24,213552.9,498379.14
500640,201808,431,225,206,212076,196505.46,408581.46
500660,201808,5543,2117,3426,2016184.7,3263702.32,5279887.02
500690,201808,573,206,367,196167.24,348450.71,544617.95
500710,201808,357,173,184,164756,175518,340274
500720,201808,979,573,406,544958.69,387124.46,932083.15
500730,201808,202,120,82,114480,78223.23,192703.23
500740,201808,846,371,475,352646.95,452871.75,805518.70
500750,201808,142,45,97,42930,92509.92,135439.92
500755,201808,127,91,36,86528,34344,120872
500769,201808,761,433,328,412460.27,312899,725359.27
500770,201808,434,230,204,219410.46,194606.46,414016.92
500780,201808,171,113,58,107516,55332,162848
500790,201808,1041,520,521,494717.25,496984.46,991701.71
500793,201808,261,143,118,136422,112563,248985
500795,201808,179,128,51,122102.46,48645,170747.46
500797,201808,44,33,11,31482,10494,41976
500800,201808,409,177,232,168849,221041.8,389890.8
500830,201808,2227,1246,981,1186272.12,934834.68,2121106.80
500840,201808,142,107,35,102078,33381,135459
510010,201808,169,94,75,89666.46,71521.38,161187.84
510020,201808,488,231,257,220080.06,244642.5,464722.56
510025,201808,1670,958,712,913052.59,676739.62,1589792.21
510030,201808,674,352,322,335761.92,306413.92,642175.84
510035,201808,133,60,73,57212.46,69623.46,126835.92
510040,201808,389,174,215,165996,204663.26,370659.26
510050,201808,423,233,190,221531.66,180436.46,401968.12
510060,201808,113,58,55,55322.46,52460.46,107782.92
510080,201808,222,90,132,85827.69,125814.06,211641.75
510100,201808,75,34,41,32436,39094.92,71530.92
510120,201808,39,24,15,22896,14310,37206
510125,201808,395,242,153,230185.89,145929.38,376115.27
510130,201808,571,332,239,316322.81,227592.18,543914.99
510140,201808,394,129,265,123057,252805.23,375862.23
510160,201808,93,42,51,40068,48650,88718
510170,201808,861,522,339,497694.51,322782.38,820476.89
510180,201808,2881,1403,1478,1334913.72,1408115.86,2743029.58
510185,201808,11,6,5,5724,4770,10494
510190,201808,219,72,147,68688,140233.23,208921.23
510250,201808,2606,1546,1060,1473815.53,1010098.1,2483913.63
510260,201808,203,147,56,140055.84,53387.46,193443.30
510263,201808,454,248,206,235610.46,196495.92,432106.38
510267,201808,667,376,291,357195.76,277343.45,634539.21
510268,201808,58,30,28,28620,26712,55332
510269,201808,70,33,37,31473,35298,66771
510270,201808,404,205,199,195391.98,189419.94,384811.92
510279,201808,230,171,59,163107,55980.92,219087.92
510285,201808,172,73,99,69623.46,94446,164069.46
510300,201808,526,292,234,278136.14,223161.84,501297.98
510305,201808,208,97,111,92515.46,105818.22,198333.68
510310,201808,113,59,54,56286,51506.46,107792.46
510320,201808,873,546,327,520316.18,311808.38,832124.56
510325,201808,412,164,248,156446.46,236305.8,392752.26
510330,201808,438,245,193,233717,184102.92,417819.92
510335,201808,603,330,273,314763.84,259709.58,574473.42
510336,201808,48,34,14,32436,13356,45792
510337,201808,120,50,70,47690.46,66770.46,114460.92
510340,201808,17311,8277,9034,7874860.33,8609042.03,16483902.36
510343,201808,70,50,20,47690.46,19080,66770.46
510345,201808,160,106,54,101114.46,51210.92,152325.38
510350,201808,675,377,298,358725.07,284227.38,642952.45
510360,201808,198,121,77,115425,73384.92,188809.92
510370,201808,140,72,68,68659.38,64759.14,133418.52
510380,201808,91,64,27,61056,25749,86805
510385,201808,57,27,30,25758,28611,54369
510390,201808,119,50,69,47700,65787.84,113487.84
510395,201808,43,32,11,30528,10494,41022
510410,201808,707,474,233,452192,222258.69,674450.69
510420,201808,578,280,298,266175.34,282901.69,549077.03
510450,201808,52,29,23,27666,21942,49608
510452,201808,43,25,18,23850,17172,41022
510454,201808,59,27,32,25758,30518.46,56276.46
510455,201808,124,77,47,73438.92,44838,118276.92
510460,201808,188,100,88,95219.92,83914.38,179134.30
510480,201808,747,434,313,412919.35,298264.36,711183.71
510490,201808,354,182,172,172386.3,163602.16,335988.46
510500,201808,253,192,61,183158.46,58194,241352.46
510510,201808,797,461,336,439193.72,320515.38,759709.10
510515,201808,1164,611,553,582534.38,527515.38,1110049.76
510517,201808,252,106,146,100837.8,139260.69,240098.49
510520,201808,239,158,81,150638.76,77180.84,227819.60
510523,201808,92,65,27,62010,25748.46,87758.46
510525,201808,738,423,315,402787.84,300398.76,703186.60
510530,201808,15,11,4,10494,3816,14310
510550,201808,267,118,149,112563,142137,254700
510558,201808,275,138,137,131619.15,130679.46,262298.61
510560,201808,395,240,155,228674,147852,376526
510562,201808,635,448,187,426061.17,177911.46,603972.63
510590,201808,801,418,383,398715.84,365354.69,764070.53
510600,201808,260,144,116,137352.92,110626.92,247979.84
510610,201808,170,82,88,78208.92,83656.46,161865.38
510615,201808,197,83,114,79162.92,108756,187918.92
510617,201808,18,11,7,10494,6678,17172
510618,201808,118,55,63,52470,59625,112095
510619,201808,101,71,30,67725,28611,96336
510620,201808,182,100,82,95390.46,78228,173618.46
510621,201808,199,127,72,121139.46,68660.46,189799.92
510622,201808,457,292,165,278475.84,157381.92,435857.76
510623,201808,348,235,113,224143.38,107773.38,331916.76
510624,201808,85,42,43,40059,41022,81081
510625,201808,538,329,209,313665.3,198799.52,512464.82
510626,201808,108,70,38,66780,36252,103032
510627,201808,58,43,15,41022,14310,55332
510628,201808,161,97,64,92491.92,60998.76,153490.68
510629,201808,253,161,92,153594,86794.92,240388.92
510630,201808,462,237,225,226022.76,214303.95,440326.71
510631,201808,10,3,7,2862,6392,9254
510637,201808,347,195,152,185684.18,144870.84,330555.02
510642,201808,965,540,425,514818.18,405307.44,920125.62
510645,201808,0,0,0,0,0,0
510650,201808,1473,977,496,931913.92,473061.76,1404975.68
510665,201808,88,45,43,42874,41022,83896
510670,201808,65,37,28,35298,26712,62010
510675,201808,1157,705,452,671298.43,431185.23,1102483.66
510677,201808,359,177,182,167861.84,173498.22,341360.06
510680,201808,102,60,42,57222,40059,97281
510682,201808,200,100,100,95078,95400,190478
510685,201808,54,40,14,38160,13356,51516
510700,201808,616,362,254,345191.92,242182.76,587374.68
510704,201808,1094,595,499,565176,474424.82,1039600.82
510706,201808,126,64,62,61051.23,59110.92,120162.15
510710,201808,395,268,127,254682.24,121043.68,375725.92
510715,201808,63,47,16,44828.46,15264,60092.46
510718,201808,209,114,95,108662.76,90620.46,199283.22
510719,201808,36,19,17,18126,16218,34344
510720,201808,198,133,65,126873,61723.8,188596.8
510724,201808,89,35,54,33380.46,51483.38,84863.84
510726,201808,54,28,26,26702.46,24786,51488.46
510729,201808,72,32,40,30528,38121.84,68649.84
510730,201808,478,271,207,258516,197330.46,455846.46
510735,201808,113,44,69,41976,65826,107802
510740,201808,29,16,13,15264,12402,27666
510757,201808,20,16,4,15264,3816,19080
510760,201808,7067,3723,3344,3542851.17,3184912.03,6727763.20
510770,201808,722,341,381,325116.3,363288.3,688404.6
510774,201808,16,6,10,5724,9540,15264
510775,201808,116,88,28,83942.46,26702.46,110644.92
510776,201808,28,7,21,6678,20034,26712
510777,201808,185,82,103,78199.38,98233.38,176432.76
510779,201808,49,22,27,20979,25720.92,46699.92
510780,201808,295,165,130,157347.46,123955,281302.46
510785,201808,440,238,202,227004.84,192641.22,419646.06
510787,201808,191,95,96,90621,91566.23,182187.23
510788,201808,0,0,0,0,0,0
510790,201808,2369,1250,1119,1190658.94,1065546.36,2256205.30
510792,201808,1083,622,461,592615.01,439378.34,1031993.35
510794,201808,118,60,58,57240,55303.92,112543.92
510795,201808,2379,1379,1000,1307505.95,951336.8,2258842.75
510800,201808,182,112,70,106829.46,66771,173600.46
510805,201808,171,115,56,109710,53424,163134
510810,201808,97,40,57,38077.38,54253.98,92331.36
510820,201808,258,121,137,115007.46,129698.03,244705.49
510830,201808,68,41,27,39114,25749,64863
510835,201808,8,6,2,5724,1908,7632
510840,201808,9254,4564,4690,4339998.77,4466609.92,8806608.69
510850,201808,210,86,124,82034.46,118258.38,200292.84
510860,201808,385,171,214,162956.52,203494.42,366450.94
510880,201808,66,50,16,47681.46,15264,62945.46
510885,201808,73,44,29,41957.46,27637.38,69594.84
510890,201808,71,41,30,39114,28620,67734
510895,201808,181,106,75,101124,71241.46,172365.46
520005,201808,37,26,11,24804,10494,35298
520010,201808,277,125,152,119250,144913,264163
520013,201808,645,393,252,374894,240121.8,615015.8
520015,201808,52,38,14,36252,13356,49608
520017,201808,99,58,41,55046,39114,94160
520020,201808,24,13,11,12402,10494,22896
520025,201808,2009,1093,916,1041525.24,872996.4,1914521.64
520030,201808,799,413,386,393039,367623.9,760662.9
520050,201808,77,52,25,49608,23850,73458
520055,201808,46,30,16,28620,15264,43884
520060,201808,178,116,62,110664,59148,169812
520080,201808,595,421,174,401634,165996,567630
520082,201808,20,14,6,13356,5724,19080
520085,201808,101,74,27,70596,25758,96354
520090,201808,91,63,28,60102,26712,86814
520110,201808,9074,3951,5123,3764113.16,4884703.18,8648816.34
520120,201808,14,8,6,7431.66,5724,13155.66
520130,201808,763,532,231,507232.8,219935.9,727168.7
520140,201808,11748,6646,5102,6332741.64,4864955.77,11197697.41
520145,201808,45,33,12,31482,11448,42930
520150,201808,188,146,42,139284,40068,179352
520160,201808,31,24,7,22896,6678,29574
520170,201808,232,143,89,136390,84869,221259
520180,201808,135,73,62,69642,59148,128790
520215,201808,219,138,81,131365.8,76987.8,208353.6
520235,201808,71,53,18,50562,17172,67734
520250,201808,132,81,51,77274,48367.8,125641.8
520260,201808,112,69,43,65826,40068,105894
520280,201808,46,32,14,29861,13356,43217
520310,201808,38,26,12,24804,11448,36252
520320,201808,168,106,62,101114.46,59148,160262.46
520330,201808,787,414,373,394910.46,355833,750743.46
520340,201808,349,196,153,186984,145943.46,332927.46
520350,201808,523,239,284,228006,270889,498895
520355,201808,86,51,35,48654,33390,82044
520357,201808,24,17,7,16218,6678,22896
520360,201808,1,1,0,954,0,954
520380,201808,140,72,68,68688,64872,133560
520390,201808,281,120,161,114003,153584.46,267587.46
520393,201808,15,11,4,10494,3816,14310
520396,201808,96,57,39,54378,37206,91584
520400,201808,219,129,90,121445.2,85860,207305.2
520410,201808,198,101,97,96345,92529,188874
520420,201808,22,15,7,14310,6678,20988
520425,201808,300,132,168,124975,159796.2,284771.2
520430,201808,464,239,225,227719.8,214594,442313.8
520440,201808,608,413,195,394002,186010.92,580012.92
520450,201808,1933,869,1064,828197.46,1014133.32,1842330.78
520455,201808,59,42,17,40068,16218,56286
520460,201808,32,16,16,15264,15264,30528
520465,201808,24,21,3,20034,2862,22896
520470,201808,418,259,159,246780.63,151686,398466.63
520480,201808,80,47,33,44838,31437,76275
520485,201808,124,43,81,41022,76988,118010
520490,201808,415,302,113,287923.98,107802,395725.98
520495,201808,173,106,67,101124,63918,165042
520500,201808,174,131,43,124974,41022,165996
520505,201808,176,90,86,85855.23,82044,167899.23
520510,201808,1767,876,891,833322.14,847785.48,1681107.62
520520,201808,34,27,7,25758,6678,32436
520530,201808,231,174,57,164272.12,54368.46,218640.58
520540,201808,528,354,174,336409.02,165996,502405.02
520545,201808,154,89,65,84906,62010,146916
520547,201808,52,30,22,28620,20988,49608
520549,201808,1152,561,591,534870,563696,1098566
520551,201808,293,152,141,145008,134228,279236
520552,201808,47,28,19,26712,18126,44838
520570,201808,16,9,7,8586,6678,15264
520580,201808,285,171,114,163124.46,108756,271880.46
520590,201808,165,101,64,96354,60769.8,157123.8
520620,201808,1165,544,621,518118.48,592138.26,1110256.74
520630,201808,43,26,17,24804,16218,41022
520640,201808,407,235,172,224190,164088,388278
520650,201808,62,42,20,40068,19080,59148
520660,201808,36,19,17,18117,16218,34335
520670,201808,35,30,5,28620,4770,33390
520680,201808,55,37,18,35298,17172,52470
520690,201808,32,10,22,9540,20959.92,30499.92
520710,201808,38,34,4,32436,3816,36252
520725,201808,197,126,71,120204,67734,187938
520735,201808,59,41,18,39114,17172,56286
520740,201808,410,202,208,191993.4,198423,390416.4
520750,201808,36,28,8,26712,7632,34344
520753,201808,56,38,18,36252,17172,53424
520760,201808,114,77,37,73458,35298,108756
520780,201808,293,222,71,211788,67715,279503
520790,201808,164,83,81,78895.8,77274,156169.8
520800,201808,3455,1850,1605,1762503.06,1530636,3293139.06
520810,201808,171,124,47,118296,44838,163134
520815,201808,5,5,0,4770,0,4770
520830,201808,140,95,45,90630,42643.8,133273.8
520840,201808,347,229,118,217989,112572,330561
520850,201808,113,73,40,69623.46,38007.36,107630.82
520860,201808,1701,1086,615,1034623.54,585566.2,1620189.74
520870,201808,30891,15204,15687,14476401.32,14949057.36,29425458.68
520880,201808,1084,588,496,560666,473164.92,1033830.92
520890,201808,799,465,334,441979.4,318531.46,760510.86
520910,201808,1025,542,483,512823.94,460782,973605.94
520915,201808,102,77,25,73458,23840.46,97298.46
520920,201808,404,198,206,188319.6,196514.46,384834.06
520929,201808,15,14,1,13356,954,14310
520940,201808,76,49,27,46746,25758,72504
520945,201808,20,12,8,11448,7632,19080
520960,201808,46,30,16,28620,15264,43884
520970,201808,319,200,119,189884.8,113239.8,303124.6
520980,201808,84,64,20,61056,19080,80136
520990,201808,479,324,155,308173.46,147870,456043.46
520993,201808,129,62,67,59148,63918,123066
520995,201808,242,136,106,128791,100552,229343
521000,201808,1585,930,655,885217.6,624488.8,1509706.4
521010,201808,668,312,356,297321.36,339557.76,636879.12
521015,201808,18,11,7,10494,6678,17172
521020,201808,1467,1024,443,976266.9,422260.22,1398527.12
521030,201808,46,33,13,31482,12402,43884
521040,201808,954,589,365,561668.2,347924,909592.2
521056,201808,41,29,12,27666,11448,39114
521060,201808,134,85,49,81090,46746,127836
521080,201808,465,350,115,333891,109710,443601
521090,201808,531,318,213,300852.58,203202,504054.58
521100,201808,277,208,69,198423,65826,264249
521120,201808,1055,736,319,701571.8,304031,1005602.8
521130,201808,362,259,103,247076.46,97376.6,344453.06
521140,201808,181,102,79,97308,75366,172674
521150,201808,2795,1221,1574,1163252.88,1500323.49,2663576.37
521160,201808,32,17,15,16218,14310,30528
521170,201808,196,115,81,109700.46,77274,186974.46
521180,201808,1137,718,419,683341.26,399011.2,1082352.46
521190,201808,2542,1074,1468,1024576.92,1399880.72,2424457.64
521200,201808,47,34,13,32436,12402,44838
521205,201808,12,9,3,8586,2862,11448
521210,201808,146,84,62,80136,59148,139284
521220,201808,820,563,257,534469.76,245122,779591.76
521225,201808,32,21,11,20034,10494,30528
521230,201808,110,74,36,70309.8,34344,104653.8
521250,201808,6252,3597,2655,3424659.78,2530277.26,5954937.04
521260,201808,23,15,8,14310,7632,21942
521270,201808,139,108,31,103032,29574,132606
521280,201808,436,258,178,244797.2,169812,414609.2
521290,201808,30,11,19,10494,18126,28620
521295,201808,97,65,32,61781.04,30528,92309.04
521300,201808,226,117,109,111600,103635.38,215235.38
521305,201808,34,23,11,21942,10494,32436
521308,201808,1096,812,284,774397.68,270641,1045038.68
521310,201808,1358,802,556,763060.4,529232.92,1292293.32
521340,201808,19,16,3,15264,2862,18126
521350,201808,131,97,34,92538,32436,124974
521370,201808,188,122,66,116101.8,62677.8,178779.6
521375,201808,189,105,84,100170,79849.8,180019.8
521377,201808,52,35,17,33390,16218,49608
521380,201808,1091,712,379,674862.22,361566,1036428.22
521385,201808,15,8,7,7632,6678,14310
521390,201808,106,85,21,80772.04,20034,100806.04
521400,201808,330,212,118,201961.8,112524.3,314486.1
521405,201808,150,79,71,75366,67734,143100
521410,201808,62,41,21,39114,20034,59148
521440,201808,201,144,57,136565.1,54378,190943.1
521450,201808,720,395,325,376830,310050,686880
521460,201808,1191,733,458,698995.8,436912.92,1135908.72
521470,201808,12,8,4,7632,3816,11448
521480,201808,47,32,15,30501,14245,44746
521483,201808,310,169,141,160940,134514,295454
521486,201808,286,182,104,172882.85,98549,271431.85
521487,201808,22,11,11,10494,10494,20988
521490,201808,26,15,11,14310,10494,24804
521500,201808,118,78,40,74412,38160,112572
521520,201808,40,28,12,26712,11448,38160
521523,201808,621,380,241,359203.32,229914,589117.32
521525,201808,46,30,16,28620,14977.8,43597.8
521530,201808,251,133,118,126882,112572,239454
521540,201808,32,18,14,17172,13356,30528
521550,201808,90,40,50,37845.92,47644.92,85490.84
521560,201808,806,549,257,523460,245035,768495
521565,201808,54,37,17,35298,16218,51516
521570,201808,503,339,164,323396.46,156361.3,479757.76
521580,201808,59,37,22,35298,20988,56286
521590,201808,38,20,18,19080,17172,36252
521600,201808,28,17,11,16218,10494,26712
521630,201808,241,123,118,117332.46,111581.96,228914.42
521640,201808,302,155,147,147870,140238,288108
521645,201808,30,16,14,15264,13356,28620
521680,201808,220,140,80,133560,76320,209880
521690,201808,2,2,0,1908,0,1908
521710,201808,1181,555,626,528738.8,596908.8,1125647.6
521720,201808,544,370,174,352970.46,165958.46,518928.92
521730,201808,631,303,328,288967,311805.56,600772.56
521740,201808,908,368,540,350758.46,513969.32,864727.78
521760,201808,1634,902,732,858930.12,698014,1556944.12
521770,201808,809,508,301,484632,286686.54,771318.54
521800,201808,2061,1288,773,1225210.02,736064.1,1961274.12
521805,201808,34,19,15,18126,14310,32436
521810,201808,93,59,34,55141.8,32436,87577.8
521830,201808,955,678,277,644792.88,264249,909041.88
521839,201808,90,59,31,56286,29574,85860
521850,201808,1121,597,524,568118.92,499571.68,1067690.60
521860,201808,356,220,136,209880,129458,339338
521870,201808,73,42,31,40068,29574,69642
521878,201808,43,20,23,19080,21942,41022
521880,201808,4587,2068,2519,1970602.36,2401616.96,4372219.32
521890,201808,588,414,174,394956,165709.8,560665.8
521900,201808,294,236,58,224507.96,55332,279839.96
521910,201808,151,105,46,100170,43884,144054
521920,201808,54,27,27,25758,25758,51516
521925,201808,35,21,14,20034,13356,33390
521930,201808,1120,641,479,611317.98,456331.88,1067649.86
521935,201808,34,26,8,24804,7632,32436
521940,201808,188,98,90,93492,85855.23,179347.23
521945,201808,15,13,2,12402,1908,14310
521950,201808,9,5,4,4770,3816,8586
521960,201808,77,57,20,54378,19080,73458
521970,201808,419,270,149,257293.8,142146,399439.8
521971,201808,93,47,46,44838,43884,88722
521973,201808,28,13,15,12402,14310,26712
521975,201808,1187,610,577,581749.2,549542.66,1131291.86
521980,201808,243,167,76,159318,72504,231822
521990,201808,73,54,19,51516,18126,69642
522000,201808,291,185,106,176490,101124,277614
522005,201808,20,12,8,11448,7632,19080
522010,201808,1148,643,505,613413,481197.6,1094610.6
522015,201808,54,33,21,31473,20034,51507
522020,201808,862,467,395,444564.2,376048.12,820612.32
522026,201808,28,20,8,19080,7632,26712
522028,201808,16,12,4,11448,3816,15264
522040,201808,745,294,451,280458,430199.46,710657.46
522045,201808,2167,1372,795,1308445.26,757896.8,2066342.06
522050,201808,165,80,85,76320,81090,157410
522060,201808,561,353,208,336475.8,198336.6,534812.4
522068,201808,133,89,44,84619.8,41976,126595.8
522070,201808,10,10,0,9540,0,9540
522100,201808,45,25,20,23850,19080,42930
522108,201808,38,29,9,27666,8586,36252
522119,201808,56,30,26,28620,24804,53424
522130,201808,74,27,47,25749,44811,70560
522140,201808,3786,1922,1864,1829101.28,1776101.44,3605202.72
522145,201808,52,32,20,30528,19080,49608
522150,201808,65,50,15,47700,14310,62010
522155,201808,55,37,18,35289,17172,52461
522157,201808,4,3,1,2862,954,3816
522160,201808,1735,1016,719,967451.09,685630.8,1653081.89
522170,201808,395,266,129,253764,123066,376830
522180,201808,37,20,17,19080,16218,35298
522185,201808,1970,769,1201,730319.26,1145233,1875552.26
522190,201808,47,28,19,26712,18030.6,44742.6
522200,201808,301,182,119,173628,113526,287154
522205,201808,165,112,53,106848,50562,157410
522220,201808,162,117,45,111618,42930,154548
522230,201808,31,26,5,24804,4770,29574
530010,201808,55587,28569,27018,27114940.42,25725239.47,52840179.89
110001,201809,519,410,109,390176.46,103340.96,493517.42
110002,201809,2799,1709,1090,1628853.76,1038962.49,2667816.25
110003,201809,94,75,19,71064,18126,89190
110004,201809,2001,1297,704,1235222.1,671320.26,1906542.36
110005,201809,439,355,84,337514.9,80136,417650.9
110006,201809,457,352,105,334767.75,100150.92,434918.67
110007,201809,82,65,17,62010,16218,78228
110008,201809,239,135,104,127554.9,99216,226770.9
110009,201809,810,561,249,533143.86,237347,770490.86
110010,201809,1807,1119,688,1066676.52,656048.21,1722724.73
110011,201809,1869,1445,424,1376385.2,404486.46,1780871.66
110012,201809,4144,2400,1744,2283489.42,1662685.12,3946174.54
110013,201809,772,591,181,563804.46,172007,735811.46
110014,201809,377,324,53,308046.8,50562,358608.8
110015,201809,1432,1158,274,1101713.13,261376.92,1363090.05
110018,201809,1123,680,443,648406,422609.23,1071015.23
110020,201809,15440,9077,6363,8616738.34,6062701.88,14679440.22
110025,201809,656,488,168,462600.11,160263,622863.11
110026,201809,41,28,13,26712,12402,39114
110028,201809,1638,1191,447,1131612.59,423416.95,1555029.54
110029,201809,138,122,16,116388,15264,131652
110030,201809,2475,1678,797,1598058.36,759437.46,2357495.82
110032,201809,394,309,85,294477,81086,375563
110033,201809,676,503,173,477620.5,164755.8,642376.3
110034,201809,370,271,99,256222,93779,350001
110037,201809,104,87,17,82998,16218,99216
110040,201809,348,238,110,227052,104940,331992
110045,201809,947,645,302,613805,286404.39,900209.39
110050,201809,95,79,16,75080,15264,90344
110060,201809,84,46,38,43884,36252,80136
110070,201809,118,72,46,68688,43598,112286
110080,201809,411,251,160,236944.98,152616.15,389561.13
110090,201809,34,28,6,26712,5724,32436
110092,201809,106,58,48,55332,45722,101054
110094,201809,194,139,55,132606,52470,185076
110100,201809,30,25,5,23850,4770,28620
110110,201809,65,40,25,38160,23850,62010
110120,201809,72,59,13,56286,12402,68688
110130,201809,302,246,56,233209.12,53424,286633.12
110140,201809,244,159,85,151495.2,81080.46,232575.66
110143,201809,52,43,9,41022,8586,49608
110145,201809,24,18,6,17172,5724,22896
110146,201809,24,12,12,11448,11448,22896
110147,201809,38,30,8,28620,7632,36252
110148,201809,40,28,12,26660.57,11448,38108.57
110149,201809,304,216,88,205777.8,83952,289729.8
110150,201809,87,61,26,58194,24804,82998
110155,201809,8,7,1,6678,954,7632
110160,201809,69,58,11,55332,10494,65826
110170,201809,205,166,39,158364,36919.8,195283.8
110175,201809,45,33,12,31482,11448,42930
110180,201809,94,81,13,77274,12402,89676
120001,201809,140,97,43,92538,41014,133552
120005,201809,193,121,72,115434,68688,184122
120010,201809,1030,668,362,633761.15,345277.12,979038.27
120013,201809,148,102,46,97298.46,43693.2,140991.66
120017,201809,92,57,35,54378,33390,87768
120020,201809,3597,2879,718,2724777.03,682582.23,3407359.26
120025,201809,584,330,254,312800.1,241445.48,554245.58
120030,201809,1052,884,168,835413.22,159557,994970.22
120032,201809,49,41,8,39114,7632,46746
120033,201809,217,190,27,180912.75,25758,206670.75
120034,201809,159,113,46,105894,43884,149778
120035,201809,32,23,9,21942,8586,30528
120038,201809,395,255,140,242550.88,133560,376110.88
120039,201809,23,22,1,20988,954,21942
120040,201809,14151,9815,4336,9304910.2,4129051.1,13433961.3
120042,201809,48,42,6,40068,5724,45792
120043,201809,12,3,9,2862,8586,11448
120045,201809,541,351,190,332327.68,180297.58,512625.26
120050,201809,1270,971,299,920310.65,285241.23,1205551.88
120060,201809,1426,1164,262,1106618.12,248994,1355612.12
120070,201809,506,363,143,342782.13,136412.46,479194.59
120080,201809,165,104,61,98729.46,57955.5,156684.96
130002,201809,150,105,45,100170,42930,143100
130006,201809,77,44,33,41976,31482,73458
130008,201809,143,76,67,71805.6,63239.72,135045.32
130010,201809,140,77,63,73436.12,60102,133538.12
130014,201809,250,181,69,172674,65826,238500
130020,201809,94,50,44,47700,41976,89676
130030,201809,910,552,358,526608,341522.46,868130.46
130040,201809,312,157,155,149778,146916.28,296694.28
130050,201809,573,311,262,296407.8,249948,546355.8
130060,201809,877,600,277,567273.08,261876.6,829149.68
130063,201809,575,322,253,307188,241296.36,548484.36
130068,201809,191,125,66,119250,62677.8,181927.8
130070,201809,1329,913,416,867550.7,395488.2,1263038.9
130080,201809,661,432,229,411746.4,218457,630203.4
130083,201809,73,40,33,37896,31482,69378
130090,201809,372,191,181,180534.96,172674,353208.96
130100,201809,1142,513,629,489402,599779.8,1089181.8
130110,201809,704,310,394,295740,375876,671616
130115,201809,178,73,105,69642,100170,169812
130120,201809,1638,1028,610,980712,581940,1562652
130130,201809,621,428,193,408312,184122,592434
130140,201809,1506,1130,376,1077399.9,357750.2,1435150.1
130150,201809,421,358,63,341532,60102,401634
130160,201809,470,269,201,256626,191754,448380
130165,201809,28,20,8,19080,7632,26712
130170,201809,975,703,272,670591.4,259488,930079.4
130180,201809,147,89,58,84906,55332,140238
130185,201809,2369,1210,1159,1152432,1105094.92,2257526.92
130190,201809,3605,2261,1344,2153147.48,1280873.99,3434021.47
130195,201809,289,232,57,221328,54378,275706
130200,201809,174,80,94,76310.46,89676,165986.46
130210,201809,78,39,39,37206,37206,74412
130220,201809,181,126,55,120204,52470,172674
130230,201809,331,207,124,197478,118296,315774
130240,201809,1431,904,527,861076.4,502180.83,1363257.23
130250,201809,4811,3122,1689,2971774.44,1611172.57,4582947.01
130255,201809,426,207,219,197478,208639.8,406117.8
130260,201809,54503,26310,28193,25064205.92,26889471.54,51953677.46
130270,201809,1593,1057,536,1007986.86,511344,1519330.86
130280,201809,118,73,45,69642,42930,112572
130290,201809,2107,1530,577,1458953,550171.8,2009124.8
130300,201809,431,308,123,293545.8,117342,410887.8
130310,201809,889,464,425,442656,405450,848106
130320,201809,456,246,210,233730,200340,434070
130330,201809,733,450,283,429300,269695.8,698995.8
130340,201809,3363,2000,1363,1903707.4,1298585,3202292.4
130350,201809,466,300,166,286200,158364,444564
130353,201809,820,342,478,325982,456012,781994
130356,201809,811,373,438,355842,417852,773694
130360,201809,66,41,25,39114,23850,62964
130370,201809,680,510,170,486540,162180,648720
130380,201809,609,424,185,404496,176490,580986
130390,201809,490,389,101,371106,96354,467460
130395,201809,180,39,141,37206,134514,171720
130400,201809,70,45,25,42930,23850,66780
130406,201809,2085,1293,792,1229908.3,754336.76,1984245.06
130410,201809,479,206,273,196524,260422.92,456946.92
130420,201809,3191,2579,612,2455656.61,583848,3039504.61
130423,201809,161,76,85,72504,81090,153594
130426,201809,152,87,65,82998,62010,145008
130430,201809,408,269,139,256626,132606,389232
130440,201809,202,69,133,65826,126882,192708
140002,201809,34,12,22,11448,20988,32436
140005,201809,206,127,79,120919.5,75366,196285.5
140010,201809,10366,6965,3401,6608416.34,3242551.6,9850967.94
140015,201809,150,65,85,62010,81090,143100
140017,201809,118,80,38,76320,36252,112572
140020,201809,473,317,156,301464,148824,450288
140023,201809,32,17,15,15999,14310,30309
140028,201809,19,12,7,11448,6678,18126
140030,201809,349,249,100,237546,94798.98,332344.98
140040,201809,56,39,17,37206,16122.6,53328.6
140045,201809,247,112,135,106848,128790,235638
140047,201809,603,416,187,394852.39,177635,572487.39
140050,201809,149,96,53,90771,50562,141333
140060,201809,39,28,11,25977.42,10494,36471.42
140070,201809,33,30,3,27866.05,2862,30728.05
150010,201809,4704,2936,1768,2799036.4,1684612,4483648.4
150013,201809,151,106,45,100666.08,42930,143596.08
150020,201809,1056,571,485,544734,462690,1007424
150030,201809,716,294,422,280476,402588,683064
150034,201809,198,127,71,121158,67734,188892
150040,201809,1402,844,558,805176,532332,1337508
150050,201809,677,401,276,381552.8,263104,644656.8
150060,201809,4747,3066,1681,2921778.37,1603426.5,4525204.87
150070,201809,317,146,171,139284,163134,302418
150080,201809,14346,7217,7129,6875247.73,6794033.34,13669281.07
150085,201809,396,246,150,234674.46,143100,377774.46
150090,201809,763,648,115,618192,109710,727902
150095,201809,347,216,131,205294.12,124153.56,329447.68
150100,201809,57,40,17,38160,16218,54378
150110,201809,174,84,90,80136,85860,165996
150120,201809,427,317,110,302418,104940,407358
150125,201809,55,23,32,21942,30528,52470
150130,201809,1927,1035,892,986636.34,850963.23,1837599.57
150140,201809,54198,25443,28755,24237267.93,27417423.07,51654691.00
150145,201809,184,105,79,100170,75366,175536
150150,201809,2834,1306,1528,1245706.49,1455041.2,2700747.69
150157,201809,426,299,127,285246,121153.23,406399.23
150160,201809,121,97,24,92538,22896,115434
150170,201809,3678,2739,939,2611813.5,895519.8,3507333.3
150172,201809,324,223,101,212742,96354,309096
150175,201809,85,51,34,48654,32436,81090
150178,201809,766,511,255,486540,243270,729810
150180,201809,3109,1512,1597,1442210,1523223.38,2965433.38
150190,201809,330,211,119,201294,113526,314820
150195,201809,124,62,62,59148,59148,118296
150200,201809,201,96,105,91584,100170,191754
150210,201809,3163,2567,596,2447859.86,567578.5,3015438.36
150215,201809,525,342,183,326268,174296,500564
150220,201809,3842,2612,1230,2490288.8,1171302.32,3661591.12
150230,201809,1143,926,217,882824.04,207018,1089842.04
150240,201809,5813,3429,2384,3268110.73,2274327,5542437.73
150250,201809,33,16,17,15264,16218,31482
150260,201809,77,47,30,44838,28620,73458
150270,201809,2364,1541,823,1469079.7,784255.18,2253334.88
150275,201809,561,347,214,331038,204156,535194
150276,201809,111,49,62,46746,59148,105894
150277,201809,768,328,440,312893.46,419760,732653.46
150280,201809,340,209,131,199386,124974,324360
150285,201809,76,39,37,37206,35298,72504
150290,201809,970,595,375,567334.26,357464,924798.26
150293,201809,663,311,352,296684.46,335808,632492.46
150295,201809,472,214,258,204156,245979.44,450135.44
150300,201809,77,40,37,38160,35298,73458
150304,201809,153,104,49,99216,46746,145962
150307,201809,389,322,67,307188,63918,371106
150309,201809,565,413,152,393973.92,144981,538954.92
150310,201809,258,173,85,165042,81090,246132
150320,201809,1784,1236,548,1178862.57,522553.5,1701416.07
150330,201809,2069,1199,870,1143178.2,829980,1973158.2
150340,201809,198,135,63,128551.5,60102,188653.5
150345,201809,611,332,279,316546.74,266166,582712.74
150350,201809,409,323,86,305747.46,82044,387791.46
150360,201809,4572,2950,1622,2810709.46,1547378.46,4358087.92
150370,201809,770,546,224,520160,213400.8,733560.8
150375,201809,197,105,92,100170,87768,187938
150380,201809,1381,936,445,892594.07,424530,1317124.07
150390,201809,735,422,313,402584,298602,701186
150400,201809,104,87,17,82998,16218,99216
150405,201809,1260,820,440,781008.48,419187.6,1200196.08
150410,201809,136,90,46,85860,43884,129744
150420,201809,7416,4082,3334,3892864.28,3178954.66,7071818.94
150430,201809,517,347,170,331038,162180,493218
150440,201809,572,340,232,323597,221328,544925
150442,201809,2181,1183,998,1124518.1,951801.03,2076319.13
150445,201809,514,328,186,312912,176490,489402
150450,201809,261,129,132,123066,125928,248994
150460,201809,752,570,182,541953.09,173608.92,715562.01
150470,201809,1331,808,523,769389.25,498942,1268331.25
150475,201809,221,172,49,164088,46746,210834
150480,201809,1259,881,378,840474,360325.8,1200799.8
150490,201809,607,332,275,316728,262350,579078
150495,201809,332,237,95,226098,90630,316728
150497,201809,302,208,94,198432,89666.46,288098.46
150500,201809,428,293,135,279522,128790,408312
150503,201809,900,441,459,420428,437868,858296
150506,201809,1020,669,351,638226,334844.46,973070.46
150510,201809,1235,699,536,666560,511344,1177904
150520,201809,270,181,89,172674,84906,257580
150530,201809,1591,872,719,828740.3,685926,1514666.3
150540,201809,242,166,76,158364,72504,230868
150543,201809,735,419,316,399134.52,301177.8,700312.32
150548,201809,492,344,148,328176,141192,469368
150549,201809,61,45,16,42930,15264,58194
150550,201809,2867,1518,1349,1447219,1286660,2733879
150553,201809,3159,1870,1289,1781500.8,1229696.46,3011197.26
150555,201809,144,77,67,73458,63918,137376
150560,201809,56,43,13,41022,12402,53424
150563,201809,76,41,35,39114,33390,72504
150565,201809,168,101,67,96354,63918,160272
150570,201809,406,270,136,257560.92,129744,387304.92
150580,201809,1576,704,872,671616,831888,1503504
150590,201809,787,492,295,469368,281430,750798
150600,201809,460,280,180,267120,171720,438840
150610,201809,144,124,20,117447,19080,136527
150611,201809,129,91,38,86814,36252,123066
150613,201809,3238,2000,1238,1908000,1181043,3089043
150616,201809,497,300,197,285962,187938,473900
150618,201809,1222,661,561,630365.58,535194,1165559.58
150619,201809,402,307,95,292878,90630,383508
150620,201809,1278,748,530,713592,505333.8,1218925.8
150630,201809,303,203,100,193662,95400,289062
150635,201809,492,210,282,200340,269028,469368
150640,201809,62,28,34,26712,32436,59148
150650,201809,2337,1380,957,1316196.34,912687.8,2228884.14
150655,201809,245,183,62,174582,59148,233730
150658,201809,106,60,46,57240,43884,101124
150660,201809,495,345,150,329130,143100,472230
150670,201809,1009,369,640,351730.8,610541.46,962272.26
150680,201809,9688,5299,4389,5047788.86,4185050.26,9232839.12
150690,201809,54,33,21,31482,20034,51516
150700,201809,521,338,183,322261.2,174582,496843.2
150710,201809,284,167,117,159318,111618,270936
150715,201809,847,519,328,494143.92,312883.38,807027.30
150720,201809,427,331,96,315774,91297.8,407071.8
150730,201809,943,508,435,484623,414703.8,899326.8
150740,201809,226,159,67,151686,63918,215604
150745,201809,802,439,363,418806,346302,765108
150746,201809,55,33,22,31482,20988,52470
150747,201809,255,200,55,190800,52470,243270
150750,201809,132,74,58,70596,55332,125928
150760,201809,1741,1139,602,1086606,574308,1660914
150770,201809,371,195,176,186030,167728.95,353758.95
150775,201809,95,44,51,41976,48654,90630
150780,201809,190,100,90,95400,85860,181260
150790,201809,864,468,396,446472,377784,824256
150795,201809,1477,864,613,823683.59,584802,1408485.59
150796,201809,387,223,164,212742,156456,369198
150797,201809,287,163,124,155502,118296,273798
150800,201809,1424,857,567,816619.23,540904,1357523.23
150803,201809,592,490,102,467460,97308,564768
150805,201809,187,121,66,115434,62950.46,178384.46
150808,201809,1001,550,451,524700,430254,954954
150810,201809,3401,2353,1048,2241605.2,998609.44,3240214.64
150812,201809,431,229,202,218466,192708,411174
150815,201809,969,641,328,610135.47,312912,923047.47
150820,201809,1555,953,602,908208,574288.92,1482496.92
150830,201809,824,579,245,551412,233730,785142
150835,201809,188,112,76,106848,72504,179352
150840,201809,1339,863,476,823302,454104,1277406
160005,201809,51,29,22,27666,20988,48654
160010,201809,194,125,69,119250,65822,185072
160015,201809,114,65,49,62010,46746,108756
160020,201809,128,72,56,68688,53424,122112
160021,201809,43,23,20,21942,19080,41022
160023,201809,115,69,46,65826,43884,109710
160025,201809,31,14,17,13356,16218,29574
160027,201809,1494,850,644,808324.7,613622,1421946.7
160030,201809,15585,8048,7537,7669032.16,7184748.39,14853780.55
160040,201809,310,180,130,171720,124020,295740
160050,201809,695,355,340,338670,323596.8,662266.8
160053,201809,321,185,136,176204,129744,305948
160055,201809,26,19,7,18126,6678,24804
160060,201809,6474,3409,3065,3241404.6,2923052.2,6164456.8
160070,201809,169,104,65,99216,62010,161226
160080,201809,83,44,39,41976,37206,79182
170025,201809,24,14,10,13356,9540,22896
170030,201809,228,186,42,177247,40068,217315
170035,201809,225,106,119,101124,113526,214650
170040,201809,186,144,42,137089.8,40068,177157.8
170070,201809,327,200,127,190800,121158,311958
170100,201809,361,262,99,249948,94446,344394
170105,201809,62,51,11,48654,10494,59148
170110,201809,106,66,40,62964,38160,101124
170130,201809,64,31,33,29574,31196,60770
170190,201809,100,66,34,62964,32436,95400
170200,201809,392,264,128,251179.2,122007.76,373186.96
170210,201809,5998,3152,2846,2997644.69,2713053.86,5710698.55
170215,201809,102,48,54,45792,51516,97308
170220,201809,1413,1042,371,992193.46,353648,1345841.46
170230,201809,155,102,53,97308,50562,147870
170240,201809,538,358,180,341532,171720,513252
170255,201809,1106,887,219,845988.12,208639.8,1054627.92
170270,201809,39,28,11,26712,10303.2,37015.2
170290,201809,93,69,24,65826,22896,88722
170300,201809,83,56,27,53424,25758,79182
170305,201809,47,36,11,34344,10494,44838
170307,201809,63,47,16,44838,15264,60102
170310,201809,105,58,47,55332,44838,100170
170320,201809,21,17,4,16218,3816,20034
170330,201809,24,22,2,20988,1908,22896
170360,201809,25,15,10,14310,9540,23850
170370,201809,119,63,56,60102,53424,113526
170380,201809,86,64,22,61056,20988,82044
170382,201809,45,40,5,38160,4770,42930
170384,201809,142,106,36,101124,34344,135468
170386,201809,62,27,35,25758,33390,59148
170388,201809,49,19,30,18126,28620,46746
170389,201809,25,21,4,20034,3816,23850
170390,201809,60,35,25,33381,23850,57231
170410,201809,34,24,10,22896,9540,32436
170460,201809,16,13,3,12402,2862,15264
170510,201809,29,22,7,20988,6678,27666
170550,201809,1521,876,645,835704,614567,1450271
170555,201809,114,80,34,76320,32436,108756
170560,201809,97,71,26,67734,24804,92538
170600,201809,39,19,20,18126,19080,37206
170610,201809,190,101,89,96196.59,84602,180798.59
170625,201809,36,20,16,19080,15264,34344
170650,201809,82,62,20,59148,19080,78228
170700,201809,566,432,134,408250.49,127549.8,535800.29
170710,201809,162,99,63,94446,60084,154530
170720,201809,84,67,17,63918,16218,80136
170730,201809,67,39,28,37206,26712,63918
170740,201809,81,60,21,57240,20034,77274
170755,201809,69,36,33,34344,31482,65826
170765,201809,138,69,69,65540,65826,131366
170770,201809,226,134,92,126738.9,87768,214506.9
170820,201809,595,392,203,373968,192947,566915
170825,201809,31,19,12,18126,11448,29574
170830,201809,79,61,18,58194,17172,75366
170900,201809,194,150,44,143100,41976,185076
170930,201809,828,433,395,413082,376258,789340
170950,201809,3034,1333,1701,1269215.28,1620637.31,2889852.59
170980,201809,18,10,8,9540,7632,17172
171050,201809,141,110,31,104940,29574,134514
171070,201809,38,31,7,29574,6678,36252
171090,201809,40,29,11,27666,10494,38160
171110,201809,20,13,7,12402,6678,19080
171150,201809,41,20,21,19080,20034,39114
171180,201809,22,10,12,9540,11448,20988
171190,201809,145,85,60,81090,57240,138330
171195,201809,64,50,14,47700,13356,61056
171200,201809,47,20,27,19080,25758,44838
171215,201809,3,3,0,2862,0,2862
171240,201809,55,45,10,42930,9540,52470
171245,201809,56,51,5,48654,4770,53424
171250,201809,70,37,33,35298,31472.46,66770.46
171270,201809,17,13,4,12402,3816,16218
171280,201809,40,36,4,34201,3816,38017
171320,201809,990,565,425,539010,404400.6,943410.6
171330,201809,426,205,221,195570,210834,406404
171360,201809,91,65,26,62010,24804,86814
171370,201809,25,13,12,12402,11448,23850
171380,201809,135,111,24,105894,22379.89,128273.89
171395,201809,55,34,21,32436,20034,52470
171420,201809,302,196,106,186984,100845.12,287829.12
171430,201809,67,53,14,50562,13356,63918
171488,201809,199,107,92,102078,87768,189846
171500,201809,57,32,25,30528,23850,54378
171510,201809,68,45,23,42930,21942,64872
171515,201809,43,36,7,34344,6392,40736
171525,201809,30,26,4,24804,3816,28620
171550,201809,12,7,5,6678,4770,11448
171570,201809,60,31,29,29574,27666,57240
171575,201809,336,214,122,204156,116378.46,320534.46
171610,201809,1714,863,851,821402.99,810324.2,1631727.19
171620,201809,132,92,40,87214.68,38160,125374.68
171630,201809,53,29,24,27666,22896,50562
171650,201809,270,180,90,171720,85860,257580
171660,201809,264,143,121,136422,115430,251852
171665,201809,52,36,16,34344,15264,49608
171670,201809,432,252,180,239168.3,171433.8,410602.1
171700,201809,65,57,8,54378,7632,62010
171720,201809,27,10,17,9540,16218,25758
171750,201809,104,57,47,54378,44838,99216
171780,201809,76,61,15,58194,14310,72504
171790,201809,75,64,11,61056,10494,71550
171800,201809,37,29,8,27666,7632,35298
171820,201809,2063,1170,893,1113834.74,847314.82,1961149.56
171830,201809,36,29,7,27666,6678,34344
171840,201809,66,39,27,37206,25758,62964
171845,201809,33,20,13,19080,12402,31482
171850,201809,42,30,12,28620,11448,40068
171855,201809,79,62,17,59148,16218,75366
171865,201809,8,7,1,6678,954,7632
171870,201809,31,22,9,20988,8586,29574
171875,201809,81,56,25,53424,23850,77274
171880,201809,30,20,10,19080,9540,28620
171884,201809,49,26,23,24804,21942,46746
171886,201809,124,46,78,43884,74125.8,118009.8
171888,201809,25,19,6,18126,5724,23850
171889,201809,19,15,4,14310,3816,18126
171890,201809,57,47,10,44838,9540,54378
171900,201809,43,30,13,28620,12402,41022
172000,201809,38,33,5,31482,4770,36252
172010,201809,40,34,6,31625.1,5724,37349.1
172015,201809,25,16,9,15064,8299.8,23363.8
172020,201809,136,87,49,82998,46746,129744
172025,201809,32,21,11,20034,10494,30528
172030,201809,38,23,15,21942,14310,36252
172049,201809,75,47,28,44838,26712,71550
172065,201809,146,94,52,89626,49608,139234
172080,201809,96,65,31,60827.84,29574,90401.84
172085,201809,25,12,13,11448,12402,23850
172090,201809,414,316,98,300667.41,92729,393396.41
172093,201809,25,19,6,18126,5724,23850
172097,201809,16,8,8,7632,7346,14978
172100,201809,4782,2701,2081,2570802.22,1982137.2,4552939.42
172110,201809,82,55,27,52470,25758,78228
172120,201809,1704,1463,241,1391493.99,228787.41,1620281.40
172125,201809,4,4,0,3816,0,3816
172130,201809,16,12,4,11448,3816,15264
172208,201809,194,124,70,118296,66780,185076
172210,201809,406,197,209,187938,199100,387038
210005,201809,2965,1848,1117,1759939.22,1062472,2822411.22
210010,201809,186,95,91,90630,86814,177444
210015,201809,31,21,10,20034,9540,29574
210020,201809,346,186,160,177444,152640,330084
210030,201809,347,220,127,209880,121149,331029
210040,201809,150,116,34,110664,32436,143100
210043,201809,267,184,83,175536,79182,254718
210047,201809,597,323,274,307760.4,261386.46,569146.86
210050,201809,301,220,81,209880,77274,287154
210055,201809,42,33,9,31482,8586,40068
210060,201809,562,447,115,426338.79,109423.8,535762.59
210070,201809,418,311,107,296694,102078,398772
210080,201809,106,95,11,90630,10494,101124
210083,201809,307,139,168,132606,160272,292878
210087,201809,42,31,11,28772.64,10494,39266.64
210090,201809,483,338,145,322452,138330,460782
210095,201809,484,358,126,341522.46,120204,461726.46
210100,201809,700,534,166,509102.1,157410.02,666512.12
210110,201809,148,83,65,79182,62010,141192
210120,201809,5435,4116,1319,3919745,1257077.45,5176822.45
210125,201809,209,121,88,115434,83952,199386
210130,201809,530,287,243,272844,231802.92,504646.92
210135,201809,34,20,14,19080,13356,32436
210140,201809,4408,3459,949,3297321.44,905346,4202667.44
210150,201809,365,230,135,219420,128790,348210
210160,201809,3403,2866,537,2731304.78,512012,3243316.78
210170,201809,1157,912,245,870048,233730,1103778
210173,201809,126,105,21,100170,20034,120204
210177,201809,444,221,223,210834,212742,423576
210180,201809,32,17,15,16218,14310,30528
210190,201809,420,273,147,260442,140238,400680
210193,201809,1,1,0,954,0,954
210197,201809,79,53,26,50562,24785.88,75347.88
210200,201809,649,515,134,490871.16,127836,618707.16
210203,201809,258,174,84,165710,80136,245846
210207,201809,387,303,84,289062,80136,369198
210210,201809,785,719,66,685926,62964,748890
210215,201809,81,69,12,65826,11448,77274
210220,201809,397,327,70,311958,66493.8,378451.8
210230,201809,309,236,73,225144,69642,294786
210232,201809,1474,948,526,904106,501804,1405910
210235,201809,158,125,33,119060,31482,150542
210237,201809,43,24,19,22896,18126,41022
210240,201809,92,76,16,72504,15264,87768
210250,201809,187,151,36,144054,34344,178398
210255,201809,347,256,91,244224,86814,331038
210260,201809,420,268,152,255672,145008,400680
210270,201809,695,445,250,424530,238500,663030
210275,201809,52,39,13,37206,12402,49608
210280,201809,1056,687,369,652587.33,350690.5,1003277.83
210290,201809,505,333,172,317682,164088,481770
210300,201809,6012,3546,2466,3377180.22,2351372.23,5728552.45
210310,201809,108,75,33,71550,31482,103032
210312,201809,121,80,41,76320,39114,115434
210315,201809,115,87,28,82998,26712,109710
210317,201809,129,92,37,87768,35298,123066
210320,201809,2384,1963,421,1870991.84,401634,2272625.84
210325,201809,129,90,39,84906,36920,121826
210330,201809,5365,2823,2542,2688318.92,2425058.46,5113377.38
210340,201809,1368,985,383,938890,365311.07,1304201.07
210350,201809,615,508,107,484393.5,102078,586471.5
210355,201809,139,113,26,107802,24804,132606
210360,201809,2606,1653,953,1573815.6,908876,2482691.6
210370,201809,1256,561,695,535194,663030,1198224
210375,201809,191,98,93,92949,88722,181671
210380,201809,726,544,182,518976,173628,692604
210390,201809,202,168,34,160272,32436,192708
210400,201809,425,359,66,342486,62945,405431
210405,201809,1019,693,326,661122,311004,972126
210407,201809,55,43,12,41022,11448,52470
210408,201809,66,59,7,56286,6678,62964
210409,201809,324,271,53,258534,50562,309096
210410,201809,443,344,99,328176,94437,422613
210420,201809,196,160,36,152640,34344,186984
210430,201809,38,27,11,25758,10494,36252
210440,201809,373,228,145,217512,138330,355842
210450,201809,155,117,38,111618,36252,147870
210455,201809,224,122,102,116388,97308,213696
210460,201809,345,218,127,207972,121158,329130
210462,201809,65,54,11,51516,10494,62010
210465,201809,172,125,47,119250,44838,164088
210467,201809,544,389,155,371102,147870,518972
210470,201809,44,35,9,33390,8586,41976
210480,201809,1317,938,379,894852,361566,1256418
210490,201809,220,136,84,129744,80136,209880
210500,201809,581,309,272,294786,259488,554274
210510,201809,558,434,124,414036,118296,532332
210515,201809,434,242,192,230868,183168,414036
210520,201809,410,358,52,341245.8,49608,390853.8
210530,201809,9457,5062,4395,4815882.77,4184404.59,9000287.36
210535,201809,129,93,36,88722,34344,123066
210540,201809,1554,952,602,907063.8,572877,1479940.8
210542,201809,1195,592,603,564386.4,574976,1139362.4
210545,201809,12,11,1,10494,954,11448
210547,201809,132,113,19,107802,18126,125928
210550,201809,734,523,211,497375,201294,698669
210560,201809,177,148,29,141192,27666,168858
210565,201809,30,22,8,20988,7632,28620
210570,201809,1371,1081,290,1030034.26,276660,1306694.26
210580,201809,108,94,14,89676,13356,103032
210590,201809,775,618,157,588808.8,149778,738586.8
210592,201809,33,29,4,27666,3816,31482
210594,201809,106,87,19,82998,18126,101124
210596,201809,92,77,15,73458,14310,87768
210598,201809,128,92,36,87768,34344,122112
210600,201809,336,284,52,270936,49608,320544
210610,201809,258,239,19,227052,18126,245178
210620,201809,46,27,19,25758,18126,43884
210630,201809,63,60,3,57240,2862,60102
210632,201809,1094,729,365,695466,347733,1043199
210635,201809,19,16,3,15264,2862,18126
210637,201809,104,72,32,68688,30528,99216
210640,201809,591,518,73,494172,69642,563814
210650,201809,416,336,80,319618.62,75366,394984.62
210660,201809,407,296,111,280954,105770,386724
210663,201809,22,11,11,10494,10494,20988
210667,201809,113,36,77,34344,73458,107802
210670,201809,269,236,33,224429,31482,255911
210675,201809,569,303,266,289062,253764,542826
210680,201809,209,132,77,125928,73458,199386
210690,201809,643,515,128,491310,122112,613422
210700,201809,188,140,48,133560,45792,179352
210710,201809,294,168,126,160081.2,120204,280285.2
210720,201809,130,110,20,104940,19080,124020
210725,201809,70,61,9,58194,8586,66780
210730,201809,26,19,7,18126,6678,24804
210735,201809,411,277,134,264258,127550,391808
210740,201809,561,473,88,451242,83952,535194
210745,201809,157,116,41,110664,39114,149778
210750,201809,2442,1111,1331,1057939,1269754.92,2327693.92
210760,201809,269,200,69,190800,65811.69,256611.69
210770,201809,404,313,91,298554.3,86527.8,385082.1
210780,201809,423,309,114,294786,108756,403542
210790,201809,189,145,44,138330,41976,180306
210800,201809,156,115,41,109710,39114,148824
210805,201809,46,42,4,40068,3816,43884
210810,201809,490,378,112,359944.2,106848,466792.2
210820,201809,2336,1862,474,1767903.41,452196,2220099.41
210825,201809,170,88,82,83952,78228,162180
210830,201809,800,501,299,477000,284292,761292
210840,201809,210,142,68,135468,64872,200340
210845,201809,254,161,93,153594,88722,242316
210850,201809,838,536,302,511344,288108,799452
210860,201809,4109,2143,1966,2042896.3,1875258.72,3918155.02
210870,201809,477,360,117,343440,111618,455058
210880,201809,68,50,18,47700,17172,64872
210890,201809,348,291,57,277614,54378,331992
210900,201809,588,382,206,364424,196524,560948
210905,201809,67,34,33,32436,31482,63918
210910,201809,2011,1494,517,1423985.99,493218,1917203.99
210920,201809,221,68,153,64872,145962,210834
210923,201809,80,58,22,55332,20988,76320
210927,201809,432,188,244,179352,232776,412128
210930,201809,66,52,14,49608,13356,62964
210940,201809,93,71,22,67734,20988,88722
210945,201809,198,94,104,89676,99216,188892
210950,201809,514,375,139,357750,132601.23,490351.23
210955,201809,74,49,25,46746,23850,70596
210960,201809,2431,1067,1364,1016296.4,1300970,2317266.4
210970,201809,115,101,14,96354,13356,109710
210975,201809,92,83,9,79182,8586,87768
210980,201809,1204,534,670,509321.52,638894,1148215.52
210990,201809,4363,2742,1621,2614767.13,1546434,4161201.13
211000,201809,1385,1099,286,1048160,272557.8,1320717.8
211003,201809,926,634,292,604836,278559,883395
211010,201809,498,438,60,417852,57240,475092
211020,201809,1614,599,1015,571446,968090.58,1539536.58
211023,201809,28,24,4,22609.8,3816,26425.8
211027,201809,67,45,22,42930,20988,63918
211030,201809,386,262,124,249948,118296,368244
211040,201809,325,254,71,242030,67734,309764
211050,201809,1178,762,416,726928.92,396573.23,1123502.15
211060,201809,688,583,105,554274,100170,654444
211065,201809,22,18,4,17172,3816,20988
211070,201809,933,761,172,724382.74,164088,888470.74
211080,201809,87,83,4,79182,3816,82998
211085,201809,61,32,29,30242,27666,57908
211090,201809,91,73,18,69642,17172,86814
211100,201809,503,405,98,386083.8,93492,479575.8
211102,201809,261,176,85,167904,81090,248994
211105,201809,224,152,72,145008,68688,213696
211107,201809,136,78,58,74412,55332,129744
211110,201809,833,538,295,512680,281421,794101
211120,201809,5805,2544,3261,2421312.14,3109902.23,5531214.37
211125,201809,32,25,7,23850,6678,30528
211130,201809,45804,19514,26290,18584470.99,25068832.82,43653303.81
211140,201809,430,365,65,347252,62010,409262
211150,201809,1296,831,465,792440.1,443320,1235760.1
211153,201809,166,98,68,93492,64872,158364
211157,201809,64,50,14,47700,13356,61056
211160,201809,715,596,119,567868.5,113526,681394.5
211163,201809,0,0,0,0,0,0
211167,201809,10,9,1,8586,954,9540
211170,201809,446,312,134,297648,127836,425484
211172,201809,122,85,37,81090,35298,116388
211174,201809,265,159,106,151686,101124,252810
211176,201809,513,372,141,354888,134514,489402
211178,201809,96,62,34,59148,32436,91584
211180,201809,209,164,45,156456,42767.82,199223.82
211190,201809,66,61,5,58194,4770,62964
211195,201809,30,19,11,18126,10494,28620
211200,201809,155,135,20,128446.56,19080,147526.56
211210,201809,517,330,187,314152.2,178398,492550.2
211220,201809,4055,2295,1760,2181608.39,1672703.04,3854311.43
211223,201809,96,91,5,86632.74,4770,91402.74
211227,201809,70,50,20,47700,19080,66780
211230,201809,786,640,146,610130.7,139264.92,749395.62
211240,201809,416,314,102,299269.8,97308,396577.8
211245,201809,199,89,110,84906,104940,189846
211250,201809,1640,1400,240,1334608.12,228960,1563568.12
211260,201809,828,655,173,624870,165042,789912
211270,201809,2063,1634,429,1558836,408312.2,1967148.2
211280,201809,1865,1133,732,1079928.8,698328,1778256.8
211285,201809,209,123,86,117342,82044,199386
211290,201809,693,468,225,446281.2,214650,660931.2
211300,201809,815,629,186,599788.09,177444,777232.09
211400,201809,1596,916,680,873864,648720,1522584
220005,201809,18,17,1,16218,954,17172
220010,201809,87,67,20,63918,18793.8,82711.8
220020,201809,631,501,130,476386.12,124020,600406.12
220025,201809,109,105,4,100170,3816,103986
220027,201809,37,30,7,28620,6678,35298
220030,201809,100,83,17,79182,16218,95400
220040,201809,1147,867,280,825954.96,267120,1093074.96
220045,201809,39,29,10,27666,9540,37206
220050,201809,672,555,117,528308.96,111598.92,639907.88
220060,201809,176,150,26,143100,24804,167904
220070,201809,101,91,10,86814,9540,96354
220080,201809,12,11,1,10494,954,11448
220090,201809,35,28,7,26712,6678,33390
220095,201809,2,1,1,954,954,1908
220100,201809,27,23,4,21942,3816,25758
220105,201809,27,25,2,23564,1908,25472
220110,201809,214,196,18,186697.8,17172,203869.8
220115,201809,51,48,3,45792,2862,48654
220117,201809,20,18,2,17172,1908,19080
220120,201809,1491,1084,407,1032800.4,388258.92,1421059.32
220130,201809,27,26,1,24804,954,25758
220140,201809,99,78,21,73458,20034,93492
220150,201809,470,335,135,319590,128790,448380
220155,201809,4,4,0,3816,0,3816
220157,201809,18,15,3,14310,2862,17172
220160,201809,76,65,11,62010,10494,72504
220170,201809,38,36,2,34344,1908,36252
220173,201809,7,7,0,6678,0,6678
220177,201809,5,5,0,4770,0,4770
220180,201809,66,65,1,62005.23,954,62959.23
220190,201809,1060,952,108,908208,103032,1011240
220191,201809,43,38,5,36252,4770,41022
220192,201809,68,65,3,62010,2862,64872
220194,201809,43,40,3,38160,2862,41022
220196,201809,104,86,18,82044,17172,99216
220198,201809,5,4,1,3816,954,4770
220200,201809,427,353,74,336429,70596,407025
220202,201809,37,33,4,31482,3816,35298
220205,201809,41,37,4,35298,3816,39114
220207,201809,18,17,1,16218,954,17172
220208,201809,86,46,40,43884,38160,82044
220209,201809,31,28,3,26712,2862,29574
220210,201809,15,13,2,12402,1908,14310
220211,201809,26,26,0,24804,0,24804
220213,201809,43,39,4,37206,3530,40736
220217,201809,37,29,8,27666,7632,35298
220220,201809,2080,1338,742,1272826.8,706465.92,1979292.72
220225,201809,14,7,7,6678,6678,13356
220230,201809,952,751,201,716005.62,191114.82,907120.44
220240,201809,148,135,13,128790,12402,141192
220245,201809,32,29,3,26963.04,2862,29825.04
220250,201809,112,101,11,96354,10494,106848
220253,201809,42,36,6,34344,5724,40068
220255,201809,29,26,3,24804,2862,27666
220260,201809,688,498,190,475092,181260,656352
220265,201809,14,10,4,9540,3816,13356
220270,201809,709,628,81,598386.96,76797,675183.96
220271,201809,43,36,7,34344,6678,41022
220272,201809,26,26,0,24804,0,24804
220273,201809,15,13,2,12402,1908,14310
220275,201809,60,49,11,46746,10494,57240
220277,201809,13,11,2,10494,1908,12402
220280,201809,15,12,3,11448,2862,14310
220285,201809,45,42,3,40068,2862,42930
220290,201809,1417,1212,205,1152956.8,195523,1348479.8
220300,201809,50,48,2,45792,1908,47700
220310,201809,314,265,49,252806,46737,299543
220320,201809,437,404,33,383986,31482,415468
220323,201809,0,0,0,0,0,0
220325,201809,16,11,5,10494,4770,15264
220327,201809,13,12,1,11448,954,12402
220330,201809,211,147,64,140238,61056,201294
220335,201809,134,116,18,110664,17172,127836
220340,201809,27,16,11,15264,10494,25758
220342,201809,58,50,8,47700,7632,55332
220345,201809,86,78,8,74412,7632,82044
220350,201809,429,375,54,355127.42,51516,406643.42
220360,201809,43,31,12,29574,11448,41022
220370,201809,1136,922,214,878824.8,203869.8,1082694.6
220375,201809,27,25,2,23850,1908,25758
220380,201809,40,33,7,31482,6678,38160
220385,201809,26,23,3,21942,2862,24804
220390,201809,2280,1302,978,1237414.55,931915.5,2169330.05
220400,201809,30,27,3,25758,2862,28620
220410,201809,16,15,1,14310,954,15264
220415,201809,13,12,1,11448,954,12402
220420,201809,127,104,23,99216,21655.8,120871.8
220430,201809,130,119,11,111857.8,10494,122351.8
220435,201809,21,15,6,14305.23,5724,20029.23
220440,201809,292,250,42,238500,40068,278568
220450,201809,338,172,166,162922.98,158364,321286.98
220455,201809,56,54,2,51516,1908,53424
220460,201809,19,19,0,17458.2,0,17458.2
220465,201809,104,68,36,64872,34344,99216
220470,201809,242,214,28,204156,26712,230868
220480,201809,74,64,10,61056,9540,70596
220490,201809,89,77,12,73458,11448,84906
220500,201809,98,83,15,79182,14310,93492
220510,201809,380,302,78,287345,74221.2,361566.2
220515,201809,21,19,2,18126,1908,20034
220520,201809,368,331,37,313854.8,35279,349133.8
220525,201809,25,17,8,16218,7632,23850
220527,201809,38,29,9,27666,7776,35442
220530,201809,36,14,22,13356,20988,34344
220535,201809,8,8,0,7632,0,7632
220540,201809,61,52,9,49608,8586,58194
220545,201809,56,38,18,36252,17172,53424
220550,201809,648,496,152,472420.8,145008,617428.8
220551,201809,27,20,7,19080,6678,25758
220552,201809,10,10,0,9540,0,9540
220553,201809,48,43,5,41022,4770,45792
220554,201809,13,8,5,7345.8,4770,12115.8
220555,201809,27,24,3,22896,2862,25758
220556,201809,52,48,4,45792,3816,49608
220557,201809,55,49,6,46746,5724,52470
220558,201809,6,2,4,1908,3816,5724
220559,201809,5,5,0,4770,0,4770
220560,201809,62,40,22,37969.2,20988,58957.2
220570,201809,795,484,311,460531.71,296694,757225.71
220580,201809,567,521,46,497014.92,43197.92,540212.84
220585,201809,6,5,1,4770,954,5724
220590,201809,14,14,0,13356,0,13356
220595,201809,59,44,15,41976,14310,56286
220600,201809,24,12,12,11448,11448,22896
220605,201809,20,19,1,18126,954,19080
220610,201809,63,54,9,51516,8586,60102
220620,201809,563,448,115,427153.5,109710,536863.5
220630,201809,5,4,1,3816,954,4770
220635,201809,37,33,4,31482,3816,35298
220640,201809,97,76,21,72504,20034,92538
220650,201809,112,106,6,101124,5724,106848
220660,201809,35,29,6,27666,5724,33390
220665,201809,4,4,0,3816,0,3816
220667,201809,15,13,2,12402,1908,14310
220669,201809,29,26,3,24804,2862,27666
220670,201809,71,55,16,52470,15264,67734
220672,201809,68,46,22,43884,20988,64872
220675,201809,37,29,8,27666,7632,35298
220680,201809,37,32,5,30528,4770,35298
220690,201809,45,43,2,41022,1908,42930
220695,201809,55,24,31,22896,29574,52470
220700,201809,1588,1217,371,1159176.78,353934,1513110.78
220710,201809,5,3,2,2862,1908,4770
220720,201809,108,88,20,83713.5,18936.9,102650.4
220730,201809,19,18,1,17172,954,18126
220735,201809,3,1,2,954,1908,2862
220740,201809,48,43,5,41022,4770,45792
220750,201809,100,84,16,80136,15264,95400
220755,201809,16,15,1,14310,954,15264
220760,201809,54,51,3,48654,2862,51516
220770,201809,5675,2968,2707,2825023.83,2576627.41,5401651.24
220775,201809,24,12,12,11448,11448,22896
220777,201809,17,16,1,15264,954,16218
220779,201809,17,14,3,13356,2862,16218
220780,201809,880,754,126,718648.2,119918,838566.2
220785,201809,16,10,6,9540,5724,15264
220790,201809,1028,821,207,780832,197478,978310
220793,201809,12,12,0,11448,0,11448
220795,201809,21,20,1,19080,954,20034
220800,201809,4008,3069,939,2925619.93,894829.89,3820449.82
220810,201809,63,55,8,52470,7632,60102
220820,201809,241,219,22,208926,20988,229914
220830,201809,1195,1016,179,969259.23,170747,1140006.23
220840,201809,2367,1646,721,1559394.27,684906.96,2244301.23
220850,201809,54,46,8,43884,7632,51516
220855,201809,13,8,5,7632,4770,12402
220860,201809,8,7,1,6678,954,7632
220865,201809,21,19,2,18126,1908,20034
220870,201809,65,61,4,58194,3816,62010
220880,201809,322,248,74,235924.2,70310,306234.2
220885,201809,39,36,3,34344,2862,37206
220887,201809,17,17,0,16218,0,16218
220890,201809,102,90,12,85860,11448,97308
220900,201809,52,29,23,27666,21942,49608
220910,201809,56,48,8,45792,7632,53424
220915,201809,9,8,1,7632,954,8586
220920,201809,42,38,4,36252,3816,40068
220930,201809,41,40,1,38160,954,39114
220935,201809,17,17,0,16218,0,16218
220937,201809,44,41,3,39114,2862,41976
220940,201809,53,49,4,46746,3816,50562
220945,201809,0,0,0,0,0,0
220950,201809,49,45,4,42930,3816,46746
220955,201809,36,33,3,31482,2862,34344
220960,201809,2,2,0,1908,0,1908
220965,201809,30,27,3,25758,2862,28620
220970,201809,52,45,7,42930,6678,49608
220975,201809,10,9,1,8586,954,9540
220980,201809,32,30,2,28620,1908,30528
220985,201809,68,60,8,57240,7632,64872
220987,201809,31,29,2,27666,1908,29574
220990,201809,15,14,1,13356,954,14310
220995,201809,35,30,5,28620,4770,33390
220997,201809,50,40,10,38160,9540,47700
221000,201809,1147,1034,113,983059.56,107515.8,1090575.36
221005,201809,62,56,6,53424,5724,59148
221010,201809,17,14,3,13356,2862,16218
221020,201809,44,42,2,40068,1908,41976
221030,201809,31,25,6,23850,5724,29574
221035,201809,22,22,0,20988,0,20988
221037,201809,12,6,6,5724,5724,11448
221038,201809,26,23,3,21942,2862,24804
221039,201809,23,23,0,21942,0,21942
221040,201809,255,219,36,208926,34344,243270
221050,201809,236,201,35,191754,33390,225144
221060,201809,1773,1561,212,1486724.76,202248,1688972.76
221062,201809,29,28,1,26712,954,27666
221063,201809,14,10,4,9540,3816,13356
221065,201809,51,44,7,41976,6678,48654
221070,201809,141,122,19,116388,18126,134514
221080,201809,377,334,43,318636,40735.8,359371.8
221090,201809,34,33,1,31482,954,32436
221093,201809,56,37,19,35298,18126,53424
221095,201809,10,9,1,8586,954,9540
221097,201809,19,16,3,15264,2862,18126
221100,201809,25032,14514,10518,13825079.77,10028452.23,23853532.00
221110,201809,1053,781,272,744788,259488,1004276
221120,201809,533,397,136,378452,129744,508196
221130,201809,947,775,172,738110.8,164088,902198.8
221135,201809,37,34,3,32436,2862,35298
221140,201809,41,34,7,32436,6678,39114
221150,201809,14,11,3,10494,2862,13356
221160,201809,14,14,0,13356,0,13356
221170,201809,13,13,0,12402,0,12402
230010,201809,169,155,14,147870,13356,161226
230015,201809,120,100,20,95400,19080,114480
230020,201809,1605,1359,246,1293557.82,233796.56,1527354.38
230030,201809,1645,1192,453,1132552.38,432162,1564714.38
230040,201809,207,181,26,171195.5,24804,195999.5
230050,201809,212,156,56,148824,53424,202248
230060,201809,158,129,29,122302.8,27666,149968.8
230070,201809,284,253,31,241362,29574,270936
230075,201809,843,736,107,700141,101203.5,801344.5
230080,201809,185,158,27,150732,25758,176490
230090,201809,107,75,32,70786.8,30528,101314.8
230100,201809,1963,1171,792,1114819,755540,1870359
230110,201809,2688,1732,956,1649872.16,911451.8,2561323.96
230120,201809,961,767,194,729305.6,185057,914362.6
230125,201809,146,121,25,115434,23850,139284
230130,201809,470,421,49,401634,46746,448380
230140,201809,205,179,26,170766,24804,195570
230150,201809,156,123,33,117342,31482,148824
230160,201809,926,797,129,759861,123066,882927
230170,201809,594,546,48,516371.7,45792,562163.7
230180,201809,78,73,5,69642,4770,74412
230185,201809,408,355,53,337018.63,50562,387580.63
230190,201809,2235,1808,427,1720852.48,407041,2127893.48
230195,201809,494,429,65,409266,62010,471276
230200,201809,386,333,53,316718.46,50562,367280.46
230205,201809,364,237,127,224042.13,121158,345200.13
230210,201809,1260,1004,256,955747.12,243432.8,1199179.92
230220,201809,1470,1004,466,957052.8,444517,1401569.8
230230,201809,895,780,115,743929.2,109710,853639.2
230240,201809,1656,1425,231,1358528.7,220354.92,1578883.62
230250,201809,1780,1471,309,1399173.17,294786,1693959.17
230260,201809,3004,1851,1153,1761615.16,1099008.77,2860623.93
230270,201809,1365,1095,270,1041744.19,256387.5,1298131.69
230280,201809,2733,2038,695,1937853.26,662362.2,2600215.46
230290,201809,405,365,40,343751.55,38160,381911.55
230300,201809,516,384,132,365076.72,125928,491004.72
230310,201809,417,312,105,297500.13,100170,397670.13
230320,201809,939,800,139,759350.01,131868.74,891218.75
230330,201809,305,244,61,232012.8,58004,290016.8
230340,201809,451,363,88,345349,83952,429301
230350,201809,3065,1947,1118,1857342.6,1063997.28,2921339.88
230360,201809,280,217,63,206222,60102,266324
230365,201809,137,109,28,103271,26712,129983
230370,201809,9794,4843,4951,4610428.75,4719015.78,9329444.53
230380,201809,473,405,68,386084,63918.6,450002.6
230390,201809,512,287,225,273798,214650,488448
230393,201809,265,219,46,207881.83,43884,251765.83
230395,201809,340,276,64,263056,61056,324112
230400,201809,598,474,124,450288,117799.92,568087.92
230410,201809,2637,1655,982,1572479.75,936352,2508831.75
230420,201809,6200,4092,2108,3883515.71,2006446.14,5889961.85
230423,201809,316,274,42,261396,40068,301464
230425,201809,376,310,66,295139,62964,358103
230426,201809,115,100,15,94674.96,14023.8,108698.76
230427,201809,80,77,3,73458,2862,76320
230428,201809,1384,715,669,681823.8,638207,1320030.8
230430,201809,460,375,85,357555.2,81090,438645.2
230435,201809,810,573,237,545490.43,224858.61,770349.04
230440,201809,84709,37597,47112,35777382.36,44889687.06,80667069.42
230445,201809,273,189,84,180115.2,80136,260251.2
230450,201809,543,440,103,419760,98262,518022
230460,201809,59,49,10,46746,9540,56286
230465,201809,304,248,56,236592,53424,290016
230470,201809,1922,1511,411,1441494,390987.1,1832481.1
230480,201809,156,149,7,141859.8,6678,148537.8
230490,201809,285,229,56,218466,53424,271890
230495,201809,448,336,112,319661.38,106848,426509.38
230500,201809,963,721,242,686880,230868,917748
230510,201809,48,39,9,37206,8586,45792
230520,201809,383,304,79,289817,75366,365183
230523,201809,2146,1353,793,1288382.15,755282.38,2043664.53
230526,201809,299,250,49,238500,45955,284455
230530,201809,672,497,175,471849.2,165996.2,637845.4
230533,201809,187,177,10,168858,9540,178398
230535,201809,349,264,85,251856,81090,332946
230540,201809,1847,1621,226,1543790.08,215031.8,1758821.88
230550,201809,3685,2363,1322,2245289.86,1260410.49,3505700.35
230560,201809,578,442,136,420523.4,128790,549313.4
230565,201809,205,150,55,143100,51706.8,194806.8
230570,201809,301,266,35,253764,33390,287154
230580,201809,1108,820,288,780010.1,273798,1053808.1
230590,201809,966,751,215,712878.1,204823.8,917701.9
230600,201809,259,236,23,224400.07,21942,246342.07
230610,201809,343,272,71,259298,67734,327032
230620,201809,171,140,31,132606,29574,162180
230625,201809,720,526,194,500221.16,184208.68,684429.84
230630,201809,1285,1018,267,970886,254336.4,1225222.4
230640,201809,3650,3164,486,3011488.57,462414.57,3473903.14
230650,201809,407,355,52,337739.44,49593.69,387333.13
230655,201809,666,579,87,551393.8,82889.76,634283.56
230660,201809,357,301,56,287154,53137.8,340291.8
230670,201809,429,381,48,363474,45792,409266
230680,201809,197,179,18,170766,17172,187938
230690,201809,877,761,116,725965.38,110664,836629.38
230700,201809,718,609,109,580986,103671.8,684657.8
230710,201809,737,698,39,665605,37206,702811
230720,201809,151,128,23,121720.86,21942,143662.86
230725,201809,250,200,50,190800,47691,238491
230730,201809,11886,6451,5435,6138142.5,5177161.88,11315304.38
230740,201809,648,523,125,498656,118559.46,617215.46
230750,201809,816,696,120,662792.3,114480,777272.3
230760,201809,1353,1171,182,1112401.25,173580.3,1285981.55
230763,201809,316,264,52,249900.95,49608,299508.95
230765,201809,7048,3307,3741,3149225.3,3567588.76,6716814.06
230770,201809,4946,2549,2397,2421896.22,2284687.22,4706583.44
230780,201809,691,607,84,576176.1,80121.69,656297.79
230790,201809,215,179,36,170766,33543.4,204309.4
230800,201809,1128,824,304,785785.95,290016,1075801.95
230810,201809,1303,1159,144,1104684.3,137185.2,1241869.5
230820,201809,341,243,98,230599,93492,324091
230830,201809,943,815,128,773996.41,122112,896108.41
230835,201809,281,242,39,229914,36491,266405
230837,201809,165,140,25,133560,23850,157410
230840,201809,916,735,181,699950.5,172388,872338.5
230850,201809,1502,1312,190,1251171,180974,1432145
230860,201809,298,225,73,214650,69356,284006
230870,201809,1815,1549,266,1476764,253192,1729956
230880,201809,42,31,11,29574,10494,40068
230890,201809,561,514,47,490233.8,44824,535057.8
230900,201809,274,210,64,200340,60859,261199
230910,201809,200,161,39,152830.8,37206,190036.8
230920,201809,404,317,87,302418,82998,385416
230930,201809,929,659,270,625824.64,257580,883404.64
230940,201809,840,673,167,641735.72,159128,800863.72
230945,201809,490,409,81,389710,77274,466984
230950,201809,378,323,55,308142,52470,360612
230960,201809,2584,1757,827,1669136.22,788644,2457780.22
230970,201809,1758,993,765,946129.42,728752.46,1674881.88
230980,201809,211,178,33,169812,31482,201294
230990,201809,140,114,26,108756,24047.47,132803.47
231000,201809,212,192,20,181260,19080,200340
231010,201809,140,109,31,103699.8,29574,133273.8
231020,201809,1306,909,397,865565,378738,1244303
231025,201809,999,757,242,719060.2,229341.8,948402.0
231030,201809,1126,942,184,898272.86,175536,1073808.86
231040,201809,142,97,45,91793.88,42199,133992.88
231050,201809,992,884,108,841571.9,103032,944603.9
231060,201809,147,129,18,123066,17172,140238
231070,201809,1468,1036,432,986246.1,412100,1398346.1
231080,201809,260,243,17,231011.1,16218,247229.1
231085,201809,574,358,216,340579,206064,546643
231090,201809,241,199,42,189846,40068,229914
231095,201809,166,133,33,126882,31482,158364
231100,201809,131,111,20,105894,17839.8,123733.8
231110,201809,359,311,48,294504.1,45792,340296.1
231120,201809,294,253,41,241357.23,39114,280471.23
231123,201809,144,137,7,130698,6678,137376
231126,201809,304,250,54,238500,51516,290016
231130,201809,4575,3560,1015,3387012.3,967523.26,4354535.56
231135,201809,211,182,29,173628,26782,200410
231140,201809,3119,2291,828,2181968.46,788938.92,2970907.38
231150,201809,363,346,17,330084,16218,346302
231160,201809,1208,957,251,910087.88,239216.04,1149303.92
231170,201809,536,358,178,341532,169812,511344
231180,201809,1671,1425,246,1358686.8,234655.38,1593342.18
231190,201809,195,170,25,162180,23850,186030
231195,201809,218,188,30,178628,28620,207248
231200,201809,832,676,156,644904,147564,792468
231210,201809,605,506,99,481770.8,94446,576216.8
231220,201809,1039,753,286,715682.07,272844,988526.07
231230,201809,1409,1127,282,1074204.04,268264.8,1342468.84
231240,201809,1396,1015,381,968023.8,362491.58,1330515.38
231250,201809,113,105,8,100170,7632,107802
231260,201809,290,188,102,179352,97022,276374
231270,201809,1014,841,173,796704.86,164442,961146.86
231280,201809,60,46,14,43455,13356,56811
231290,201809,7282,4072,3210,3878546.24,3059709.01,6938255.25
231300,201809,627,581,46,554274,43884,598158
231310,201809,718,666,52,634147,49608,683755
231320,201809,575,441,134,420238,127807.38,548045.38
231325,201809,92,83,9,79182,8586,87768
231330,201809,2038,1572,466,1493845.04,442752.4,1936597.44
231335,201809,248,221,27,210834,25758,236592
231340,201809,1644,1212,432,1155104.08,411841.8,1566945.88
231350,201809,1225,1011,214,963922,203584,1167506
231355,201809,424,369,55,352026,52470,404496
231360,201809,487,383,104,362902.2,99216,462118.2
231370,201809,87,74,13,70596,12402,82998
231375,201809,291,213,78,203202,74412,277614
231380,201809,465,381,84,362682.92,79945.2,442628.12
231390,201809,197,160,37,152640,35298,187938
231395,201809,731,458,273,436340.52,260442,696782.52
231400,201809,1073,885,188,841732.84,179009.38,1020742.22
231410,201809,1330,1085,245,1031275.4,232749,1264024.4
240010,201809,396,178,218,168660.26,207963,376623.26
240020,201809,2233,1764,469,1680030.23,447422,2127452.23
240030,201809,133,113,20,107802,19080,126882
240040,201809,31,31,0,29574,0,29574
240050,201809,518,445,73,423676.45,69642,493318.45
240060,201809,67,63,4,60102,3816,63918
240070,201809,196,152,44,145008,41976,186984
240080,201809,463,308,155,293828,146916.71,440744.71
240090,201809,102,90,12,85554.72,11448,97002.72
240100,201809,1449,1368,81,1302099.55,77083.2,1379182.75
240110,201809,1005,638,367,607680.26,349975,957655.26
240120,201809,138,118,20,112572,19080,131652
240130,201809,285,267,18,254001.54,17172,271173.54
240140,201809,81,63,18,60102,17172,77274
240145,201809,705,624,81,594365.85,77274,671639.85
240150,201809,19,15,4,14310,3787.38,18097.38
240160,201809,43,38,5,36252,4770,41022
240165,201809,37,31,6,29336,5724,35060
240170,201809,93,71,22,67257,20988,88245
240180,201809,79,65,14,62010,13356,75366
240185,201809,44,40,4,38150.46,3816,41966.46
240190,201809,13,10,3,9540,2862,12402
240200,201809,3034,1704,1330,1619254.67,1267581,2886835.67
240210,201809,169,132,37,125928,35298,161226
240220,201809,1098,790,308,753517,293822.46,1047339.46
240230,201809,839,779,60,740332.05,56592,796924.05
240240,201809,121,85,36,81090,34344,115434
240250,201809,89,78,11,74412,10494,84906
240260,201809,1800,1343,457,1280544.66,434882.42,1715427.08
240270,201809,192,168,24,159890.4,22610,182500.4
240280,201809,43,33,10,30719,9540,40259
240290,201809,50,49,1,46746,954,47700
240300,201809,178,100,78,95007.89,74412,169419.89
240310,201809,2036,1117,919,1055743.98,873222.37,1928966.35
240320,201809,205,195,10,185880.04,9540,195420.04
240325,201809,4296,2624,1672,2497164.02,1591965.86,4089129.88
240330,201809,66,62,4,59148,3816,62964
240340,201809,108,78,30,74412,28620,103032
240350,201809,92,81,11,77274,10494,87768
240360,201809,454,316,138,301464,131652,433116
240370,201809,41,39,2,37206,1908,39114
240375,201809,70,41,29,39114,27666,66780
240380,201809,227,185,42,176490,39973,216463
240390,201809,14,12,2,11448,1908,13356
240400,201809,77,73,4,69642,3816,73458
240410,201809,11,7,4,6678,3816,10494
240420,201809,903,697,206,662412.4,195474.6,857887.0
240430,201809,265,249,16,236635.89,15264,251899.89
240440,201809,80,45,35,42930,33390,76320
240450,201809,218,147,71,139665.8,67734,207399.8
240460,201809,61,48,13,45792,12402,58194
240470,201809,238,206,32,195680.66,30528,226208.66
240480,201809,15,14,1,13260.6,954,14214.6
240485,201809,76,66,10,62964,9540,72504
240490,201809,48,47,1,44628.12,954,45582.12
240500,201809,85,68,17,64872,16218,81090
240510,201809,51,36,15,34344,14310,48654
240520,201809,121,116,5,110664,4770,115434
240530,201809,55,49,6,46746,5724,52470
240540,201809,78,67,11,63918,10494,74412
240550,201809,15,13,2,12402,1908,14310
240560,201809,374,276,98,262200.23,93492,355692.23
240570,201809,476,297,179,282479.4,170766,453245.4
240580,201809,1250,1012,238,959963.9,225903.2,1185867.1
240590,201809,28,26,2,24804,1908,26712
240600,201809,110,107,3,102078,2862,104940
240610,201809,511,426,85,406047.7,81090,487137.7
240615,201809,19,18,1,17172,954,18126
240620,201809,96,92,4,87768,3816,91584
240630,201809,36,34,2,32436,1908,34344
240640,201809,26,22,4,20988,3816,24804
240650,201809,240,200,40,189941.9,38160,228101.9
240660,201809,99,87,12,82998,11448,94446
240670,201809,296,176,120,165805.3,114480,280285.3
240680,201809,49,38,11,36252,10494,46746
240690,201809,49,46,3,43884,2862,46746
240700,201809,190,157,33,149778,31482,181260
240710,201809,1927,1228,699,1170315.63,666827.46,1837143.09
240720,201809,1072,784,288,746781.86,274752,1021533.86
240725,201809,66,61,5,58194,4770,62964
240730,201809,135,116,19,110664,18126,128790
240740,201809,242,204,38,193251.78,35298.02,228549.80
240750,201809,38,26,12,24804,11448,36252
240760,201809,34,31,3,29574,2862,32436
240770,201809,148,115,33,109710,31482,141192
240780,201809,684,569,115,541385.46,109710,651095.46
240790,201809,37,36,1,34344,954,35298
240800,201809,8813,6000,2813,5685529.64,2677123.5,8362653.14
240810,201809,20154,11143,9011,10588492.33,8587092.45,19175584.78
240820,201809,217,135,82,128499.03,78228,206727.03
240830,201809,1632,1336,296,1268400.76,282384,1550784.76
240840,201809,81,71,10,67734,9540,77274
240850,201809,88,77,11,73458,10494,83952
240860,201809,113,110,3,104940,2862,107802
240870,201809,62,54,8,51516,7632,59148
240880,201809,30,27,3,25748.46,2862,28610.46
240890,201809,1199,711,488,674384.78,465548,1139932.78
240895,201809,47,34,13,32436,12402,44838
240910,201809,159,144,15,137376,14310,151686
240920,201809,15,12,3,11448,2862,14310
240930,201809,389,354,35,336762,33390,370152
240933,201809,33,25,8,23850,7632,31482
240940,201809,2447,2163,284,2049205.25,268054.92,2317260.17
240950,201809,52,49,3,46746,2862,49608
240960,201809,32,26,6,24804,5724,30528
240970,201809,123,87,36,82998,33590,116588
240980,201809,191,153,38,145962,35679.6,181641.6
240990,201809,120,79,41,75366,39114,114480
241000,201809,67,62,5,59148,4770,63918
241010,201809,63,51,12,48654,11448,60102
241020,201809,110,103,7,98262,6678,104940
241025,201809,10,4,6,3816,5724,9540
241030,201809,121,98,23,93492,21942,115434
241040,201809,35,29,6,27666,5724,33390
241050,201809,89,78,11,74412,10494,84906
241060,201809,28,24,4,22896,3816,26712
241070,201809,14,14,0,13356,0,13356
241080,201809,63,56,7,53137.8,6678,59815.8
241090,201809,52,43,9,41022,8571.69,49593.69
241100,201809,73,63,10,60102,9540,69642
241105,201809,6,2,4,1908,3816,5724
241110,201809,47,45,2,42930,1908,44838
241120,201809,1440,1110,330,1055749.45,314820,1370569.45
241140,201809,222,182,40,172675,38160,210835
241142,201809,41,39,2,37206,1908,39114
241150,201809,1233,1087,146,1034280,139284,1173564
241160,201809,22,21,1,20034,954,20988
241170,201809,44,40,4,38160,3816,41976
241180,201809,48,40,8,37985.42,7632,45617.42
241190,201809,38,37,1,35298,954,36252
241200,201809,3915,2130,1785,2026485.62,1700969.66,3727455.28
241210,201809,71,60,11,57240,9636,66876
241220,201809,1397,935,462,891525.04,440714.92,1332239.96
241230,201809,241,202,39,192708,37206,229914
241240,201809,54,41,13,39114,12402,51516
241250,201809,1106,1019,87,971369.36,82998,1054367.36
241255,201809,49,39,10,37206,9540,46746
241260,201809,637,502,135,478903.23,128790,607693.23
241270,201809,46,33,13,31482,12402,43884
241280,201809,101,88,13,83952,12402,96354
241290,201809,109,83,26,79182,24804,103986
241300,201809,77,55,22,52470,20988,73458
241310,201809,51,39,12,37063,11448,48511
241320,201809,27,14,13,13356,12402,25758
241330,201809,62,56,6,53424,5724,59148
241335,201809,63,56,7,52756.2,6678,59434.2
241340,201809,186,139,47,132606,44838,177444
241350,201809,62,57,5,54378,4770,59148
241355,201809,40,37,3,35298,2862,38160
241360,201809,49,48,1,45792,954,46746
241370,201809,45,37,8,35173.98,7632,42805.98
241380,201809,39,35,4,33390,3816,37206
241390,201809,78,63,15,59911.2,14310,74221.2
241400,201809,206,167,39,158650.2,37206,195856.2
241410,201809,180,163,17,155502,16122.6,171624.6
241415,201809,99,78,21,74412,20034,94446
241420,201809,100,74,26,70596,24633,95229
241430,201809,28,27,1,25758,954,26712
241440,201809,498,414,84,394942,80136,475078
241445,201809,38,36,2,34344,1908,36252
241450,201809,279,230,49,219420,46746,266166
241460,201809,136,125,11,119012,10494,129506
241470,201809,43,36,7,34344,6678,41022
241475,201809,65,62,3,59148,2862,62010
241480,201809,99,71,28,66780.69,26712,93492.69
241490,201809,8,7,1,6678,954,7632
241500,201809,47,34,13,32436,12402,44838
250010,201809,102,87,15,82926.45,14310,97236.45
250020,201809,31,27,4,25758,3816,29574
250030,201809,821,610,211,580595.2,200245.6,780840.8
250040,201809,341,284,57,270936,54091.8,325027.8
250050,201809,234,193,41,183831.8,39114,222945.8
250053,201809,54,41,13,39114,12402,51516
250057,201809,0,0,0,0,0,0
250060,201809,461,352,109,335808,103699.8,439507.8
250070,201809,704,585,119,556072,113526,669598
250073,201809,7,7,0,6678,0,6678
250077,201809,197,146,51,138892.86,48654,187546.86
250080,201809,426,333,93,316729,88722,405451
250090,201809,198,130,68,123066,64852.92,187918.92
250100,201809,507,417,90,397506.36,85479,482985.36
250110,201809,559,422,137,400804.02,130698,531502.02
250115,201809,24,7,17,6678,16218,22896
250120,201809,113,85,28,81090,26712,107802
250130,201809,571,461,110,439794,104750,544544
250135,201809,14,8,6,7632,5724,13356
250140,201809,79,71,8,67734,7632,75366
250150,201809,577,427,150,405804.58,142785.18,548589.76
250153,201809,8,7,1,6678,954,7632
250157,201809,28,23,5,21942,4770,26712
250160,201809,216,170,46,162180,43884,206064
250170,201809,62,44,18,41976,17172,59148
250180,201809,4081,2781,1300,2640011.13,1235102,3875113.13
250190,201809,867,572,295,544304.7,281430,825734.7
250200,201809,53,44,9,41976,8586,50562
250205,201809,23,20,3,19080,2862,21942
250210,201809,90,78,12,74412,11448,85860
250215,201809,62,53,9,50562,8586,59148
250220,201809,27,21,6,20034,5724,25758
250230,201809,78,71,7,67730,6678,74408
250240,201809,245,203,42,192851.1,40068,232919.1
250250,201809,397,340,57,324360,54378,378738
250260,201809,33,30,3,28620,2862,31482
250270,201809,60,47,13,44838,12402,57240
250280,201809,375,312,63,297648,60102,357750
250290,201809,94,89,5,84619.8,4770,89389.8
250300,201809,554,379,175,360918.71,166937,527855.71
250310,201809,45,41,4,39114,3816,42930
250320,201809,1999,1368,631,1299817.35,600438.8,1900256.15
250330,201809,84,74,10,70596,9540,80136
250340,201809,24,20,4,19080,3816,22896
250350,201809,141,91,50,86527.8,47127.6,133655.4
250355,201809,35,27,8,25758,7632,33390
250360,201809,202,165,37,157410,35298,192708
250370,201809,2387,1620,767,1539281.98,731115,2270396.98
250375,201809,13,9,4,8586,3816,12402
250380,201809,53,38,15,36252,14310,50562
250390,201809,42,35,7,33390,6678,40068
250400,201809,15936,8094,7842,7697581.79,7475156.51,15172738.30
250403,201809,394,320,74,305077.34,70596,375673.34
250407,201809,60,52,8,49608,7632,57240
250410,201809,33,28,5,26712,4770,31482
250415,201809,43,29,14,27646.92,13336.92,40983.84
250420,201809,46,39,7,37206,6678,43884
250430,201809,1525,1297,228,1235145,217512,1452657
250435,201809,16,13,3,12402,2862,15264
250440,201809,689,590,99,560167.38,94446,654613.38
250450,201809,89,73,16,69642,14596.2,84238.2
250460,201809,429,295,134,281430,127826.46,409256.46
250470,201809,86,63,23,60102,21942,82044
250480,201809,330,262,68,249948,64872,314820
250485,201809,1,1,0,954,0,954
250490,201809,220,183,37,174582,35298,209880
250500,201809,77,56,21,53424,20034,73458
250510,201809,734,576,158,548741,149723.43,698464.43
250520,201809,173,119,54,113511.69,51511.23,165022.92
250523,201809,116,97,19,92538,18126,110664
250527,201809,101,80,21,76315.23,20034,96349.23
250530,201809,7,5,2,4770,1908,6678
250535,201809,24,20,4,19080,3816,22896
250540,201809,127,98,29,92776.5,27666,120442.5
250550,201809,71,68,3,64872,2862,67734
250560,201809,39,31,8,29574,7632,37206
250570,201809,151,121,30,115434,28620,144054
250580,201809,124,98,26,93267.8,24804,118071.8
250590,201809,19,15,4,14310,3816,18126
250600,201809,1242,839,403,798499.35,384462,1182961.35
250610,201809,151,131,20,124974,19080,144054
250620,201809,22,18,4,17172,3816,20988
250625,201809,67,50,17,47700,16218,63918
250630,201809,3033,1952,1081,1854167.19,1030207.51,2884374.70
250640,201809,204,170,34,162180,32436,194616
250650,201809,29,20,9,19080,8586,27666
250660,201809,45,35,10,33390,9540,42930
250670,201809,60,40,20,38160,19080,57240
250680,201809,389,321,68,306234,64872,371106
250690,201809,1862,1287,575,1224359.53,548168.8,1772528.33
250700,201809,926,813,113,772951.56,107592.12,880543.68
250710,201809,445,346,99,330084,94446,424530
250720,201809,108,85,23,81090,21942,103032
250730,201809,383,323,60,307188.6,57240,364428.6
250740,201809,51,47,4,44838,3816,48654
250750,201809,20683,12460,8223,11830455.53,7836305.8,19666761.33
250760,201809,74,56,18,53424,17172,70596
250770,201809,350,230,120,217483.52,112071.35,329554.87
250780,201809,55,41,14,39114,13356,52470
250790,201809,475,310,165,293832.92,156694.5,450527.42
250800,201809,153,141,12,133798.5,11448,145246.5
250810,201809,81,63,18,60102,17172,77274
250820,201809,157,129,28,123066,26712,149778
250830,201809,421,289,132,274704.5,125928,400632.5
250840,201809,52,50,2,47700,1908,49608
250850,201809,54,42,12,40068,11448,51516
250855,201809,13,11,2,10494,1908,12402
250860,201809,203,147,56,140238,53137.8,193375.8
250870,201809,33,30,3,28620,2862,31482
250880,201809,80,61,19,58184.46,18126,76310.46
250890,201809,2497,1853,644,1765960.85,613517.5,2379478.35
250900,201809,126,108,18,103032,17172,120204
250905,201809,124,97,27,92538,25758,118296
250910,201809,1170,833,337,793719.65,321211.8,1114931.45
250915,201809,111,78,33,74412,31482,105894
250920,201809,138,107,31,102078,29574,131652
250930,201809,166,104,62,99216,59148,158364
250933,201809,1,1,0,954,0,954
250937,201809,6,5,1,4770,954,5724
250939,201809,31,24,7,22896,6678,29574
250940,201809,106,81,25,77274,23850,101124
250950,201809,70,47,23,44838,21942,66780
250960,201809,92,51,41,48654,39114,87768
250970,201809,1210,862,348,820727,331038,1151765
250980,201809,92,65,27,62010,25758,87768
250990,201809,166,129,37,122593.77,35255.07,157848.84
251000,201809,77,69,8,65635.2,7632,73267.2
251010,201809,102,80,22,76316,20209.53,96525.53
251020,201809,82,72,10,67877.1,9540,77417.1
251030,201809,42,32,10,30528,9540,40068
251040,201809,53,38,15,36252,14310,50562
251050,201809,23,21,2,20034,1908,21942
251060,201809,50,39,11,36252,10494,46746
251065,201809,3,3,0,2862,0,2862
251070,201809,25,20,5,19071,4770,23841
251080,201809,4768,2308,2460,2191706.46,2340287.01,4531993.47
251090,201809,199,171,28,163134,26712,189846
251100,201809,18,17,1,16218,954,17172
251110,201809,45,36,9,34344,8586,42930
251120,201809,1831,1120,711,1063634.54,678008,1741642.54
251130,201809,386,316,70,301464,66780,368244
251140,201809,527,344,183,327032.8,174413.34,501446.14
251150,201809,303,262,41,249176,39114,288290
251160,201809,98,83,15,79178,14310,93488
251170,201809,100,80,20,76291.38,19075.23,95366.61
251180,201809,291,184,107,175527.23,102069.23,277596.46
251190,201809,190,130,60,123691.83,57240,180931.83
251200,201809,253,205,48,195570,45792,241362
251203,201809,36,34,2,32436,1908,34344
251207,201809,95,79,16,75366,15264,90630
251210,201809,1421,1029,392,980112.53,373300.2,1353412.73
251220,201809,47,37,10,35298,9540,44838
251230,201809,465,388,77,370152,73458,443610
251240,201809,102,74,28,69642,26712,96354
251250,201809,1350,965,385,917720.87,367147,1284867.87
251260,201809,13,8,5,7632,4770,12402
251270,201809,342,257,85,245178,80947,326125
251272,201809,65,60,5,57240,4770,62010
251274,201809,29,23,6,21942,5724,27666
251275,201809,24,16,8,15264,7632,22896
251276,201809,17,13,4,12402,3816,16218
251278,201809,8,7,1,6678,954,7632
251280,201809,101,96,5,91584,4770,96354
251290,201809,721,544,177,518976,168858,687834
251300,201809,16,13,3,12402,2862,15264
251310,201809,374,269,105,256622,100170,356792
251315,201809,19,18,1,17172,954,18126
251320,201809,59,48,11,45792,10494,56286
251330,201809,79,70,9,66780,8586,75366
251335,201809,12,7,5,6678,4770,11448
251340,201809,698,414,284,394956,269911.25,664867.25
251350,201809,37,35,2,33390,1908,35298
251360,201809,73,64,9,61056,8586,69642
251365,201809,14,14,0,13356,0,13356
251370,201809,5392,3668,1724,3494957.94,1643362,5138319.94
251380,201809,50,40,10,38160,9540,47700
251385,201809,3,3,0,2862,0,2862
251390,201809,696,549,147,522602.2,138998,661600.2
251392,201809,12,6,6,5724,5724,11448
251394,201809,9,9,0,8586,0,8586
251396,201809,15,10,5,9540,4770,14310
251398,201809,19,16,3,15264,2862,18126
251400,201809,42,35,7,33390,6678,40068
251410,201809,37,31,6,29574,5724,35298
251420,201809,104,78,26,74412,24804,99216
251430,201809,40,37,3,35298,2862,38160
251440,201809,33,22,11,20988,10494,31482
251445,201809,56,51,5,48654,4770,53424
251450,201809,412,363,49,344646.8,46746,391392.8
251455,201809,2,1,1,954,954,1908
251460,201809,17,13,4,12402,3816,16218
251465,201809,4,1,3,954,2862,3816
251470,201809,47,37,10,35298,9540,44838
251480,201809,26,24,2,22896,1908,24804
251490,201809,120,83,37,78705,34345,113050
251500,201809,123,99,24,94446,22133,116579
251510,201809,40,31,9,29574,8586,38160
251520,201809,25,25,0,23850,0,23850
251530,201809,4511,3176,1335,3024326.9,1273294.26,4297621.16
251540,201809,74,65,9,62010,8586,70596
251550,201809,414,320,94,304326.2,89152,393478.2
251560,201809,24,17,7,16218,6678,22896
251570,201809,21,21,0,20034,0,20034
251580,201809,124,102,22,97308,20988,118296
251590,201809,121,90,31,86041,29574,115615
251593,201809,26,16,10,15264,9540,24804
251597,201809,56,46,10,43884,9540,53424
251600,201809,1091,778,313,740720.48,296993.92,1037714.40
251610,201809,212,162,50,154548,47033,201581
251615,201809,3,3,0,2862,0,2862
251620,201809,4270,2842,1428,2701427.84,1359547,4060974.84
251630,201809,443,325,118,310050,112563,422613
251640,201809,149,106,43,101124,41022,142146
251650,201809,271,198,73,187059.1,69642,256701.1
251660,201809,226,204,22,194616,20797.2,215413.2
251670,201809,358,278,80,263516,76320,339836
251675,201809,4,4,0,3816,0,3816
251680,201809,97,87,10,82998,9540,92538
251690,201809,344,288,56,273798,53073.89,326871.89
251700,201809,284,240,44,228373.29,41961.69,270334.98
251710,201809,22,15,7,14310,6678,20988
251720,201809,31,21,10,20034,9254,29288
251740,201809,10,8,2,7632,1908,9540
260005,201809,3205,1815,1390,1720421.34,1325179.1,3045600.44
260010,201809,1538,1102,436,1046549.48,413941.32,1460490.80
260020,201809,429,379,50,361566,47700,409266
260030,201809,578,418,160,398004.98,152640,550644.98
260040,201809,860,532,328,506440.44,312902.46,819342.90
260050,201809,1152,828,324,789674,307856.2,1097530.2
260060,201809,411,372,39,354124.8,37206,391330.8
260070,201809,1459,921,538,874512,510282.36,1384794.36
260080,201809,731,577,154,549647.1,146916,696563.1
260090,201809,574,361,213,344166.12,203202,547368.12
260100,201809,234,164,70,155646,66780,222426
260105,201809,232,131,101,124974,96354,221328
260110,201809,2768,2050,718,1955691,684162,2639853
260120,201809,2939,1451,1488,1374536.21,1417264.1,2791800.31
260130,201809,157,112,45,106848,42930,149778
260140,201809,2163,1425,738,1350968.3,702507.46,2053475.76
260150,201809,228,151,77,144054,73458,217512
260160,201809,299,254,45,242316,42930,285246
260170,201809,3421,2095,1326,1991870.58,1263620.9,3255491.48
260180,201809,146,123,23,117342,21942,139284
260190,201809,2304,1611,693,1533743.9,661122,2194865.9
260200,201809,912,745,167,709251.08,159032,868283.08
260210,201809,1422,1010,412,963389.27,392085.11,1355474.38
260220,201809,726,663,63,632502,60102,692604
260230,201809,1211,921,290,876442.99,276660,1153102.99
260240,201809,227,173,54,164088,51516,215604
260250,201809,81,62,19,59148,18126,77274
260260,201809,1003,723,280,689742,267120,956862
260270,201809,428,344,84,326793.2,79849.8,406643.0
260280,201809,1430,908,522,865755,497415.8,1363170.8
260290,201809,6450,3467,2983,3289619.85,2839072,6128691.85
260300,201809,891,785,106,746821.6,100838,847659.6
260310,201809,517,409,108,388807.47,103032,491839.47
260320,201809,877,658,219,627445.2,208926,836371.2
260330,201809,37,28,9,26712,8586,35298
260340,201809,76,55,21,52470,20034,72504
260345,201809,5647,3177,2470,3024941.55,2355322.76,5380264.31
260350,201809,490,357,133,338834.08,126882,465716.08
260360,201809,284,145,139,138330,132577.38,270907.38
260370,201809,675,445,230,421910.86,219280,641190.86
260380,201809,613,441,172,420714,162943.56,583657.56
260390,201809,300,255,45,242191.98,41976,284167.98
260392,201809,101,88,13,83952,12402,96354
260400,201809,4084,2348,1736,2231374.86,1655773.22,3887148.08
260410,201809,14895,7742,7153,7369791.03,6821517.2,14191308.23
260415,201809,122,112,10,106848,9540,116388
260420,201809,1796,1076,720,1021617.04,685226.64,1706843.68
260430,201809,190,174,16,164784.66,15264,180048.66
260440,201809,225,162,63,153824,60102,213926
260450,201809,477,344,133,326891,126882,453773
260460,201809,847,449,398,425676.8,379083.03,804759.83
260470,201809,370,228,142,216748.8,135373,352121.8
260480,201809,212,136,76,129744,72504,202248
260490,201809,215,175,40,166950,38160,205110
260500,201809,1140,773,367,735154.2,349831.8,1084986.0
260510,201809,746,590,156,561858.01,147870,709728.01
260515,201809,256,229,27,218466,25281,243747
260520,201809,3354,2000,1354,1900700.52,1289036.62,3189737.14
260530,201809,798,648,150,615699.64,143100,758799.64
260540,201809,565,431,134,411174,126882.72,538056.72
260545,201809,12,9,3,8586,2862,11448
260550,201809,348,218,130,207972,124020,331992
260560,201809,532,402,130,383222,123733.8,506955.8
260570,201809,1014,831,183,790055.8,174295.8,964351.6
260580,201809,259,231,28,220374,26712,247086
260590,201809,658,382,276,363016.08,263304,626320.08
260600,201809,8221,4206,4015,3992899.26,3825869.33,7818768.59
260610,201809,497,336,161,320544,153307.8,473851.8
260620,201809,3681,1927,1754,1825648.01,1670333.97,3495981.98
260630,201809,78,75,3,71550,2862,74412
260640,201809,3732,2040,1692,1942396.63,1614111.3,3556507.93
260650,201809,316,228,88,217512,83336.67,300848.67
260660,201809,511,349,162,332564.4,154548,487112.4
260670,201809,103,76,27,72504,25758,98262
260680,201809,3693,2072,1621,1959794.78,1545804.84,3505599.62
260690,201809,122,95,27,90630,25758,116388
260700,201809,328,202,126,191944.8,120204,312148.8
260710,201809,37,34,3,32436,2862,35298
260720,201809,2266,1361,905,1292187.69,861023.16,2153210.85
260730,201809,620,471,149,449334,139951.8,589285.8
260740,201809,61,57,4,54378,3816,58194
260750,201809,641,446,195,425159.64,186030,611189.64
260760,201809,617,333,284,317682,270936,588618
260765,201809,986,519,467,492183.8,445279.5,937463.3
260770,201809,224,170,54,162180,51516,213696
260775,201809,826,493,333,468939.8,317673,786612.8
260780,201809,271,177,94,168858,89676,258534
260790,201809,12274,6756,5518,6418830.13,5256172.73,11675002.86
260795,201809,168,116,52,109500.12,49608,159108.12
260800,201809,288,240,48,228483,45792,274275
260805,201809,172,112,60,106119.14,57240,163359.14
260810,201809,738,646,92,615034.26,87768,702802.26
260820,201809,319,215,104,203780.79,99216,302996.79
260825,201809,200,138,62,131478.57,59148,190626.57
260830,201809,265,172,93,164088,88722,252810
260840,201809,234,170,64,161513,61056,222569
260845,201809,214,145,69,138330,65826,204156
260850,201809,506,368,138,349408.09,131652,481060.09
260860,201809,255,191,64,182016.34,61056,243072.34
260870,201809,377,274,103,260157,98262,358419
260875,201809,724,511,213,486380.69,203202,689582.69
260880,201809,1611,987,624,939925.29,595105.2,1535030.49
260890,201809,2430,1704,726,1620161.82,691364.8,2311526.62
260900,201809,1038,721,317,686531.79,302418,988949.79
260910,201809,282,220,62,209880,59148,269028
260915,201809,308,211,97,201294,92538,293832
260920,201809,178,101,77,96354,73458,169812
260930,201809,394,338,56,322452,53338.45,375790.45
260940,201809,2879,1575,1304,1498641.89,1243519.92,2742161.81
260950,201809,2042,1183,859,1122229.82,819486,1941715.82
260960,201809,14219,7395,6824,7021072.59,6501838.93,13522911.52
260970,201809,440,379,61,360777,58194,418971
260980,201809,198,175,23,166663.8,21942,188605.8
260990,201809,2589,2128,461,2027537.86,439126.2,2466664.06
261000,201809,4383,2584,1799,2454431.76,1714458.05,4168889.81
261010,201809,183,136,47,129744,44020.23,173764.23
261020,201809,612,458,154,436789,146916,583705
261030,201809,227,168,59,160257.69,56037.96,216295.65
261040,201809,371,329,42,313866,39781.8,353647.8
261050,201809,481,421,60,401634,57240,458874
261060,201809,1338,888,450,845006.75,429300,1274306.75
261070,201809,9148,4621,4527,4383625.8,4311471.37,8695097.17
261080,201809,387,294,93,279704,88722,368426
261090,201809,2270,1740,530,1651380.05,503644,2155024.05
261100,201809,1088,763,325,725851.8,308180.16,1034031.96
261110,201809,8179,5007,3172,4771894.09,3023111.78,7795005.87
261120,201809,272,229,43,218466,41017.23,259483.23
261130,201809,571,336,235,320020.1,224000,544020.1
261140,201809,189,123,66,117342,62964,180306
261150,201809,687,414,273,394956,259488.21,654444.21
261153,201809,72,68,4,63918.31,3816,67734.31
261160,201809,77807,39165,38642,37243749.66,36844715.5,74088465.16
261170,201809,455,341,114,324684.36,108756,433440.36
261180,201809,1810,1116,694,1059541.62,662076,1721617.62
261190,201809,613,427,186,406921.12,177435,584356.12
261200,201809,220,192,28,182403.3,26712,209115.3
261210,201809,35,31,4,29574,3816,33390
261220,201809,2618,1844,774,1753004.82,737823.8,2490828.62
261230,201809,336,247,89,235638,84891.69,320529.69
261240,201809,454,393,61,370908.95,58194,429102.95
261245,201809,225,188,37,179065.8,35298,214363.8
261247,201809,161,125,36,119250,34344,153594
261250,201809,2871,1465,1406,1396542.26,1339927.63,2736469.89
261255,201809,256,231,25,220087.8,23850,243937.8
261260,201809,869,750,119,715500,113526,829026
261270,201809,179,139,40,132606,38160,170766
261280,201809,167,139,28,132606,26712,159318
261290,201809,126,88,38,83713.5,36252,119965.5
261300,201809,1257,901,356,859268,339624,1198892
261310,201809,778,518,260,493599.8,247419.9,741019.7
261320,201809,555,373,182,355842,173628,529470
261330,201809,960,753,207,715363.5,196632.46,911995.96
261340,201809,304,171,133,163134,126882,290016
261350,201809,816,585,231,557136.2,220374,777510.2
261360,201809,1242,805,437,767568.37,416612,1184180.37
261370,201809,5031,3091,1940,2933893.73,1847838.45,4781732.18
261380,201809,574,423,151,401643.64,143768,545411.64
261390,201809,3468,2315,1153,2204330.72,1096673.5,3301004.22
261400,201809,284,257,27,244605.6,25758,270363.6
261410,201809,1091,729,362,695466,345343.23,1040809.23
261420,201809,891,558,333,531065.26,317663.46,848728.72
261430,201809,329,299,30,284400,28333.8,312733.8
261440,201809,121,110,11,104940,10494,115434
261450,201809,2502,2078,424,1979752.24,404248.04,2384000.28
261460,201809,729,584,145,556182.02,138330,694512.02
261470,201809,256,196,60,186174,57201.84,243375.84
261480,201809,370,295,75,280191,71546,351737
261485,201809,340,208,132,197764.2,125928,323692.2
261500,201809,626,423,203,403542,193662,597204
261510,201809,49,33,16,31482,15264,46746
261520,201809,110,97,13,92538,12402,104940
261530,201809,4191,2653,1538,2522308.02,1465970.07,3988278.09
261540,201809,1112,689,423,656842.36,403542,1060384.36
261550,201809,294,144,150,136280,143080.92,279360.92
261560,201809,808,537,271,509364.2,257380.6,766744.8
261570,201809,377,294,83,280476,79182,359658
261580,201809,377,293,84,278758,80136,358894
261590,201809,195,159,36,151686,34344,186030
261600,201809,300,241,59,229151,55809,284960
261610,201809,105,92,13,87291,12402,99693
261618,201809,64,50,14,47700,13356,61056
261620,201809,203,125,78,119250,74412,193662
261630,201809,582,451,131,427893.6,124974,552867.6
261640,201809,6428,3415,3013,3250548.59,2870787.92,6121336.51
261650,201809,497,318,179,302694.66,170766,473460.66
270010,201809,536,475,61,452864,57431,510295
270020,201809,303,241,62,229910,59148,289058
270030,201809,9260,5953,3307,5663046.03,3151981.39,8815027.42
270040,201809,2020,1250,770,1192204.26,733339.8,1925544.06
270050,201809,177,129,48,123066,45792,168858
270060,201809,116,65,51,62010,48654,110664
270070,201809,905,658,247,626208.62,235333.26,861541.88
270080,201809,38,32,6,30528,5724,36252
270090,201809,20,16,4,15264,3816,19080
270100,201809,1243,824,419,783097.51,397579.7,1180677.21
270110,201809,144,108,36,103032,34344,137376
270120,201809,225,185,40,175638.55,38160,213798.55
270130,201809,246,171,75,162726.97,71550,234276.97
270135,201809,102,62,40,59148,38160,97308
270140,201809,1323,804,519,766795.19,494163.2,1260958.39
270150,201809,266,212,54,202248,51516,253764
270160,201809,527,396,131,377784,124306.2,502090.2
270170,201809,745,483,262,459637.2,248707.8,708345.0
270180,201809,70,55,15,52152.04,14100.12,66252.16
270190,201809,101,90,11,85860,10494,96354
270200,201809,106,95,11,90439.2,10494,100933.2
270210,201809,481,253,228,241362,217225.8,458587.8
270220,201809,185,145,40,138330,38160,176490
270230,201809,2119,1281,838,1216085.84,798384.14,2014469.98
270235,201809,729,551,178,525430.67,169652.06,695082.73
270240,201809,3152,2463,689,2336165.27,654514,2990679.27
270250,201809,174,122,52,116388,49608,165996
270255,201809,224,193,31,184122,29192.4,213314.4
270260,201809,341,271,70,258534,66780,325314
270270,201809,111,46,65,43875,62010,105885
270280,201809,193,119,74,113526,70576.92,184102.92
270290,201809,1193,907,286,864042.42,271967.46,1136009.88
270300,201809,287,186,101,177444,96067.8,273511.8
270310,201809,915,736,179,699838.71,170061.12,869899.83
270320,201809,892,761,131,724322.8,124687.8,849010.6
270330,201809,275,230,45,218466,42930,261396
270340,201809,61,49,12,46746,11448,58194
270350,201809,92,47,45,44599.5,42930,87529.5
270360,201809,72,40,32,38160,30528,68688
270370,201809,54,42,12,40068,11448,51516
270375,201809,71,42,29,40068,27666,67734
270380,201809,1078,618,460,588618,438840,1027458
270390,201809,194,111,83,105894,79182,185076
270400,201809,713,522,191,496773.27,182214,678987.27
270410,201809,700,505,195,481452.04,186020.46,667472.50
270420,201809,410,272,138,257790,131576.92,389366.92
270430,201809,32980,23617,9363,22471830.21,8924543.33,31396373.54
270440,201809,494,387,107,369198,101791.8,470989.8
270450,201809,783,416,367,395385.3,349164.66,744549.96
270460,201809,197,153,44,145962,41976,187938
270470,201809,1411,946,465,901825.41,443610,1345435.41
270480,201809,541,440,101,417470.8,95638.5,513109.3
270490,201809,25,20,5,19080,4770,23850
270500,201809,512,420,92,400680,87768,488448
270510,201809,742,454,288,433116,274752,707868
270520,201809,354,219,135,208717,128790,337507
270530,201809,66,58,8,54950.4,7632,62582.4
270540,201809,123,94,29,89676,27666,117342
270550,201809,1740,1318,422,1256762.5,402101.46,1658863.96
270560,201809,313,147,166,140238,158364,298602
270570,201809,466,314,152,297631.56,144808.05,442439.61
270580,201809,84,63,21,60102,20034,80136
270590,201809,74,60,14,57240,13356,70596
270600,201809,181,147,34,140238,32436,172674
270610,201809,196,162,34,154539,32436,186975
270620,201809,30,29,1,27666,954,28620
270630,201809,3896,2972,924,2823341.56,879331.42,3702672.98
270640,201809,905,667,238,634514.6,226737.8,861252.4
270642,201809,214,181,33,172674,31482,204156
270644,201809,268,181,87,172483.74,82993.23,255476.97
270650,201809,274,161,113,153594,107802,261396
270660,201809,255,207,48,197478,45792,243270
270670,201809,3186,2427,759,2305303.22,721282.52,3026585.74
270680,201809,466,269,197,256617,187933.23,444550.23
270690,201809,1129,718,411,683219.88,392084.46,1075304.34
270700,201809,36,27,9,25758,8586,34344
270710,201809,901,681,220,648253,209880,858133
270720,201809,257,195,62,186030,58861.8,244891.8
270730,201809,1955,1142,813,1087227.4,773496.2,1860723.6
270740,201809,44,27,17,25758,16218,41976
270750,201809,655,477,178,454868,169145,624013
270760,201809,300,214,86,204156,82044,286200
270770,201809,2817,1802,1015,1712768.8,967337,2680105.8
270780,201809,90,56,34,53419.23,32418.46,85837.69
270790,201809,262,177,85,168858,81090,249948
270800,201809,1998,1607,391,1531285.25,371515.83,1902801.08
270810,201809,296,237,59,226083.69,56277.23,282360.92
270820,201809,161,106,55,101124,52375,153499
270830,201809,906,662,244,630781,232486,863267
270840,201809,1417,1049,368,1000006.9,349404,1349410.9
270850,201809,1646,1007,639,954516.36,609587.46,1564103.82
270860,201809,2483,1616,867,1538411.75,824220.57,2362632.32
270870,201809,123,67,56,63918,53424,117342
270880,201809,920,687,233,653553.14,221397.58,874950.72
270890,201809,338,247,91,235294.56,86809.23,322103.79
270895,201809,72,62,10,59148,9540,68688
270900,201809,104,79,25,75366,23850,99216
270910,201809,326,258,68,244987.2,64872,309859.2
270915,201809,1873,1140,733,1082957.74,697536.9,1780494.64
270920,201809,494,417,77,397818,73458,471276
270930,201809,6201,4519,1682,4305535.61,1601947.24,5907482.85
270940,201809,2393,1819,574,1733070.68,546624,2279694.68
280010,201809,43,38,5,36252,4770,41022
280020,201809,724,628,96,596208.13,90630,686838.13
280030,201809,19963,12885,7078,12209294.31,6721395.92,18930690.23
280040,201809,340,218,122,207972,114957,322929
280050,201809,380,291,89,277327.8,84906,362233.8
280060,201809,331,220,111,207633.43,105894,313527.43
280067,201809,991,702,289,666949.94,274752.25,941702.19
280070,201809,134,112,22,106848,20988,127836
280100,201809,624,493,131,467467.59,124784,592251.59
280110,201809,76,71,5,67734,4770,72504
280120,201809,633,505,128,481770,122112,603882
280130,201809,1409,886,523,843813.8,498798.9,1342612.7
280140,201809,479,390,89,370247.4,83952,454199.4
280150,201809,337,247,90,234194.89,85860,320054.89
280160,201809,97,84,13,80136,12402,92538
280170,201809,595,399,196,379449.56,186984,566433.56
280190,201809,27,25,2,23850,1908,25758
280200,201809,29,22,7,20988,6678,27666
280210,201809,2802,1989,813,1878800.71,770034.51,2648835.22
280220,201809,42,32,10,30528,9540,40068
280230,201809,328,272,56,258653.63,53424,312077.63
280240,201809,116,110,6,104796.9,5724,110520.9
280250,201809,17,11,6,10494,5724,16218
280260,201809,81,72,9,68688,8586,77274
280270,201809,164,127,37,121158,35298,156456
280280,201809,195,128,67,122112,63918,186030
280290,201809,3163,2289,874,2172697.74,832617.94,3005315.68
280300,201809,1122,860,262,817992.99,249184.8,1067177.79
280310,201809,106,102,4,96977.29,3816,100793.29
280320,201809,658,452,206,431199,196524,627723
280330,201809,362,262,100,249948,95275.98,345223.98
280340,201809,421,338,83,320980.57,78419,399399.57
280350,201809,3519,2716,803,2578475.13,763037.51,3341512.64
280360,201809,450,283,167,269982,158364,428346
280370,201809,99,88,11,83952,10494,94446
280380,201809,56,43,13,41022,12402,53424
280390,201809,186,157,29,149778,27666,177444
280400,201809,347,235,112,223234.1,106848,330082.1
280410,201809,288,234,54,222283,51516,273799
280420,201809,172,144,28,137357,26712,164069
280430,201809,112,85,27,81090,25649.63,106739.63
280440,201809,694,538,156,509342.6,148623.66,657966.26
280445,201809,117,110,7,104940,6678,111618
280450,201809,1135,972,163,923893.46,155502,1079395.46
280460,201809,763,561,202,527284.04,192708,719992.04
280470,201809,192,176,16,167904,14311,182215
280480,201809,2333,1654,679,1562210.29,644821.79,2207032.08
280490,201809,351,324,27,307704,25758,333462
280500,201809,42,38,4,36252,3816,40068
280510,201809,141,110,31,104639.2,29288,133927.2
280520,201809,55,41,14,39114,13356,52470
280530,201809,76,52,24,49608,22896,72504
280540,201809,512,413,99,393866.74,94159.8,488026.54
280550,201809,729,674,55,641195.13,52470,693665.13
280560,201809,499,435,64,412196.69,61056,473252.69
280570,201809,1800,1373,427,1305637.47,406502.83,1712140.30
280580,201809,604,462,142,439177.6,135373,574550.6
280590,201809,171,109,62,103986,59148,163134
280600,201809,370,310,60,295740,57240,352980
280610,201809,135,100,35,95194,33390,128584
280620,201809,550,454,96,431399.5,91440.9,522840.4
280630,201809,161,135,26,128790,24804,153594
280640,201809,203,163,40,154673,38160,192833
280650,201809,78,54,24,51516,22896,74412
280660,201809,137,99,38,94446,36013.5,130459.5
280670,201809,1690,1050,640,991692.78,606815.95,1598508.73
280680,201809,185,158,27,148948.14,25758,174706.14
280690,201809,58,48,10,45792,9540,55332
280700,201809,20,20,0,19080,0,19080
280710,201809,1425,1090,335,1030114.39,319590,1349704.39
280720,201809,119,80,39,73760.4,37206,110966.4
280730,201809,26,22,4,20988,3816,24804
280740,201809,2447,1815,632,1723924.59,602108.46,2326033.05
280750,201809,301,263,38,250902,36252,287154
280760,201809,909,631,278,600638.4,265212,865850.4
290010,201809,205,139,66,132606,62964,195570
290020,201809,178,165,13,157410,12402,169812
290030,201809,599,392,207,373300.2,197478,570778.2
290035,201809,139,112,27,104359.2,25758,130117.2
290040,201809,282,180,102,171720,97308,269028
290050,201809,81,62,19,59148,18126,77274
290060,201809,255,116,139,110377.8,132606,242983.8
290070,201809,5632,2799,2833,2662807.67,2700734.1,5363541.77
290080,201809,495,221,274,210471.64,261358,471829.64
290090,201809,391,173,218,165042,207972,373014
290100,201809,1605,1063,542,1010050.2,516495.8,1526546.0
290110,201809,816,488,328,462968.25,312378.53,775346.78
290115,201809,209,191,18,181260,17172,198432
290120,201809,774,501,273,477286.2,260442,737728.2
290130,201809,417,248,169,236296.26,161226,397522.26
290135,201809,302,228,74,216834.66,70596,287430.66
290140,201809,302,252,50,240408,47700,288108
290150,201809,129,96,33,91584,31482,123066
290160,201809,251,190,61,180020.58,58194,238214.58
290170,201809,87,62,25,59148,23850,82998
290180,201809,162,126,36,120204,34344,154548
290190,201809,445,364,81,346970,76987.8,423957.8
290195,201809,313,188,125,179352,119250,298602
290200,201809,276,230,46,219420,43884,263304
290205,201809,148,90,58,85860,55332,141192
290210,201809,1145,828,317,788768.2,302418,1091186.2
290220,201809,226,127,99,120681,94446,215127
290225,201809,287,110,177,104940,168858,273798
290230,201809,64,42,22,40068,20988,61056
290240,201809,307,118,189,112285.8,180306,292591.8
290250,201809,268,246,22,233988,20988,254976
290260,201809,294,238,56,226003,53424,279427
290265,201809,187,155,32,147053,30528,177581
290270,201809,1401,1162,239,1107356.2,226856.71,1334212.91
290280,201809,468,342,126,325521.01,120204,445725.01
290290,201809,1250,729,521,689663.89,497034,1186697.89
290300,201809,452,383,69,365091.23,65826,430917.23
290310,201809,316,142,174,135468,165996,301464
290320,201809,4009,2485,1524,2367033.84,1451988.2,3819022.04
290323,201809,187,163,24,155502,22896,178398
290327,201809,157,124,33,118024.11,31482,149506.11
290330,201809,82,47,35,44838,33390,78228
290340,201809,902,362,540,344375,514874,859249
290350,201809,596,357,239,340578,228006,568584
290360,201809,372,278,94,264258.81,89676,353934.81
290370,201809,904,369,535,352026,510376,862402
290380,201809,311,190,121,181260,115434,296694
290390,201809,2505,1563,942,1487225.38,896577,2383802.38
290395,201809,243,136,107,129219.8,102078,231297.8
290400,201809,282,207,75,197192,71550,268742
290405,201809,245,213,32,203202,30528,233730
290410,201809,592,506,86,479719.64,82044,561763.64
290420,201809,237,186,51,177444,48654,226098
290430,201809,495,313,182,298602,173628,472230
290440,201809,72,64,8,61056,7632,68688
290450,201809,234,181,53,172674,50562,223236
290460,201809,1889,1125,764,1071381.8,728093.32,1799475.12
290470,201809,1438,607,831,577949.22,792459.36,1370408.58
290475,201809,588,548,40,521925,38160,560085
290480,201809,292,164,128,156456,122112,278568
290485,201809,231,217,14,207018,13356,220374
290490,201809,1176,849,327,809946,311004.2,1120950.2
290500,201809,701,359,342,341246,326268,667514
290510,201809,220,168,52,160272,49608,209880
290515,201809,137,82,55,78228,52470,130698
290520,201809,1428,934,494,888461.58,468034.42,1356496.00
290530,201809,316,288,28,274752,26712,301464
290540,201809,98,57,41,54378,39114,93492
290550,201809,152,127,25,121158,23783.22,144941.22
290560,201809,3335,1387,1948,1322186.76,1858054.49,3180241.25
290570,201809,6045,3080,2965,2934567.21,2825410.18,5759977.39
290580,201809,1280,764,516,727615.8,491548.5,1219164.3
290590,201809,548,452,96,430417,91298,521715
290600,201809,1750,1210,540,1150593.05,515131.38,1665724.43
290610,201809,219,197,22,187719,20988,208707
290620,201809,340,302,38,288108,36252,324360
290630,201809,2060,888,1172,844004.69,1114336.02,1958340.71
290640,201809,148,121,27,115434,25758,141192
290650,201809,1723,817,906,778455,864324,1642779
290660,201809,281,229,52,218466,49608,268074
290670,201809,1013,521,492,496462,469022.38,965484.38
290680,201809,1211,978,233,931771.8,221328,1153099.8
290682,201809,292,215,77,204799.3,73439.46,278238.76
290685,201809,234,150,84,142146,80136,222282
290687,201809,944,618,326,587056.1,311004,898060.1
290689,201809,131,75,56,71536,53409.69,124945.69
290690,201809,648,265,383,252781.92,364502.8,617284.72
290700,201809,246,119,127,113526,121158,234684
290710,201809,711,480,231,457920,220374,678294
290720,201809,1027,838,189,799452,179829,979281
290730,201809,1151,660,491,627780.5,467460,1095240.5
290740,201809,16,13,3,12402,2862,15264
290750,201809,1382,633,749,601969.23,712434.79,1314404.02
290755,201809,74,65,9,62010,8586,70596
290760,201809,304,263,41,250902,39114,290016
290770,201809,186,174,12,165986.46,11162,177148.46
290780,201809,1002,797,205,758585.46,193757.4,952342.86
290790,201809,372,262,110,249948,104940,354888
290800,201809,2617,1061,1556,1009547.04,1483603.56,2493150.60
290810,201809,444,311,133,296408,126882,423290
290820,201809,394,237,157,225130,149778,374908
290830,201809,408,287,121,273798,115434,389232
290840,201809,1718,1061,657,1010048.8,624698.48,1634747.28
290850,201809,780,429,351,409266,333900,743166
290860,201809,646,292,354,278568,337430,615998
290870,201809,657,470,187,447159.6,178398,625557.6
290880,201809,123,67,56,63918,53424,117342
290890,201809,339,240,99,228960,94446,323406
290900,201809,169,127,42,121158,40068,161226
290910,201809,365,275,90,262350,85860,348210
290920,201809,230,196,34,186984,32436,219420
290930,201809,833,635,198,605790,188873,794663
290940,201809,248,207,41,196714.8,39114,235828.8
290950,201809,170,98,72,93492,68688,162180
290960,201809,452,306,146,290684.24,138997.8,429682.04
290970,201809,253,223,30,212551.2,28620,241171.2
290980,201809,1511,1068,443,1014703.76,421573.2,1436276.96
290990,201809,383,321,62,306205.92,59092.38,365298.30
291000,201809,865,245,620,233730,591480,825210
291005,201809,2155,919,1236,874665.76,1178367.03,2053032.79
291010,201809,154,139,15,132606,14310,146916
291020,201809,102,80,22,76320,20988,97308
291030,201809,98,72,26,68688,24804,93492
291040,201809,577,295,282,281430,269028,550458
291050,201809,1378,771,607,734175.43,579078,1313253.43
291060,201809,1506,834,672,794968.2,641088,1436056.2
291070,201809,1924,1424,500,1354358.53,475739.5,1830098.03
291072,201809,7393,2719,4674,2590576.43,4456812.42,7047388.85
291075,201809,209,170,39,161703,37206,198909
291077,201809,51,34,17,32436,16218,48654
291080,201809,19844,8778,11066,8349332.28,10546681.64,18896013.92
291085,201809,299,241,58,229914,55327.23,285241.23
291090,201809,299,117,182,111332,173618.46,284950.46
291100,201809,665,197,468,187938,446472,634410
291110,201809,402,302,100,288088.92,95400,383488.92
291120,201809,2527,1229,1298,1172323,1236037.26,2408360.26
291125,201809,60,30,30,28620,28620,57240
291130,201809,215,190,25,181260,23850,205110
291140,201809,140,106,34,101124,32150,133274
291150,201809,369,147,222,140238,211788,352026
291160,201809,373,308,65,292878.5,62010,354888.5
291165,201809,25,21,4,20034,3816,23850
291170,201809,3016,1507,1509,1433624.11,1435961.8,2869585.91
291180,201809,1325,517,808,493021.38,770717.76,1263739.14
291185,201809,76,74,2,70596,1908,72504
291190,201809,1277,557,720,529094.13,686050.8,1215144.93
291200,201809,163,125,38,119250,36252,155502
291210,201809,2223,891,1332,846589.34,1268916.14,2115505.48
291220,201809,274,204,70,193662.64,66780,260442.64
291230,201809,1028,353,675,335904,643950,979854
291240,201809,437,414,23,393716,21942,415658
291250,201809,438,359,79,342486,75366,417852
291260,201809,48,36,12,34344,11448,45792
291270,201809,1218,500,718,477000,684685.8,1161685.8
291280,201809,371,171,200,162642.89,190790.46,353433.35
291290,201809,1770,902,868,859077.2,826738,1685815.2
291300,201809,229,179,50,170098.2,47700,217798.2
291310,201809,228,204,24,194616,22896,217512
291320,201809,1403,1004,399,954954,379597.29,1334551.29
291330,201809,129,111,18,103795.2,17172,120967.2
291340,201809,163,92,71,87768,67734,155502
291345,201809,133,86,47,82044,44838,126882
291350,201809,1596,533,1063,508291.2,1013911.3,1522202.5
291360,201809,8596,4274,4322,4065049.38,4119794.35,8184843.73
291370,201809,1122,629,493,599780,470322,1070102
291380,201809,261,205,56,195570,53137.8,248707.8
291390,201809,3877,1714,2163,1629770.23,2061403.8,3691174.03
291400,201809,2086,1496,590,1423558.8,562131.51,1985690.31
291410,201809,154,134,20,126882,19080,145962
291420,201809,115,85,30,81090,28620,109710
291430,201809,165,92,73,87061,68688.53,155749.53
291440,201809,507,409,98,387176.3,93492,480668.3
291450,201809,903,568,335,540632.8,318350,858982.8
291460,201809,1772,1436,336,1368179.1,320544,1688723.1
291465,201809,2217,1034,1183,985842.33,1128281.06,2114123.39
291470,201809,2802,1415,1387,1346277.11,1322459,2668736.11
291480,201809,11807,5233,6574,4979226.69,6263066.35,11242293.04
291490,201809,564,239,325,228006,309763.8,537769.8
291500,201809,368,204,164,194616,156456,351072
291510,201809,1236,475,761,451988.99,725707.8,1177696.79
291520,201809,957,432,525,412128,500840.46,912968.46
291530,201809,998,269,729,256626,695160.72,951786.72
291535,201809,119,100,19,95400,18126,113526
291540,201809,359,106,253,101124,240408.6,341532.6
291550,201809,1203,573,630,544736.1,600716,1145452.1
291560,201809,5476,2783,2693,2642236.95,2558281.84,5200518.79
291570,201809,205,104,101,99216,96354,195570
291580,201809,1243,759,484,723033.46,461731.23,1184764.69
291590,201809,88,36,52,34150.9,49608,83758.9
291600,201809,1364,636,728,605790,694494,1300284
291610,201809,1461,680,781,647217.45,745046,1392263.45
291620,201809,580,272,308,259488,293450.4,552938.4
291630,201809,493,164,329,156456,313866,470322
291640,201809,3898,1971,1927,1870818.66,1837000.52,3707819.18
291650,201809,419,279,140,265213,132760.73,397973.73
291660,201809,424,170,254,161487.96,241218.9,402706.86
291670,201809,223,142,81,134896,77274,212170
291680,201809,689,391,298,373014,284187.46,657201.46
291685,201809,597,330,267,314582,254527.2,569109.2
291690,201809,577,297,280,283338,266157,549495
291700,201809,943,743,200,708092.19,189846,897938.19
291710,201809,1704,794,910,757066.28,867263.06,1624329.34
291720,201809,398,264,134,251851.23,127836,379687.23
291730,201809,954,561,393,533293.94,374912.46,908206.40
291733,201809,267,184,83,175249.8,79182,254431.8
291735,201809,67,53,14,50562,13356,63918
291740,201809,353,269,84,256626,80136,336762
291750,201809,1992,1319,673,1250934.28,641220,1892154.28
291760,201809,3054,1681,1373,1598761,1307457,2906218
291770,201809,809,543,266,515923.26,253764,769687.26
291780,201809,46,28,18,26712,17172,43884
291790,201809,168,80,88,76320,83952,160272
291800,201809,10101,4117,5984,3917779.74,5704522.8,9622302.54
291810,201809,1138,820,318,781450.42,303372,1084822.42
291820,201809,270,194,76,185076,72504,257580
291830,201809,1089,419,670,398337,638217,1036554
291835,201809,604,555,49,529340,46746,576086
291840,201809,4683,2424,2259,2306751.17,2153570.22,4460321.39
291845,201809,295,100,195,95400,186001.38,281401.38
291850,201809,325,284,41,270697.5,39114,309811.5
291855,201809,265,108,157,103032,149778,252810
291860,201809,175,107,68,101124,64872,165996
291870,201809,84,34,50,32436,47700,80136
291875,201809,188,172,16,164088,15264,179352
291880,201809,486,382,104,363618,99216,462834
291890,201809,245,80,165,76310.46,155979.2,232289.66
291900,201809,55,31,24,29574,22896,52470
291905,201809,133,94,39,89390,37206,126596
291910,201809,174,142,32,135468,30528,165996
291915,201809,399,353,46,335094,43884,378978
291920,201809,5011,2606,2405,2482863.61,2292709.77,4775573.38
291930,201809,184,106,78,101124,74412,175536
291940,201809,327,182,145,172931.58,137376,310307.58
291950,201809,1150,935,215,891227,205110,1096337
291955,201809,1084,648,436,617702.08,415801,1033503.08
291960,201809,182,129,53,123066,50275.8,173341.8
291970,201809,772,587,185,559998,176490,736488
291980,201809,1518,1345,173,1279081.7,164088.4,1443170.1
291990,201809,128,118,10,112572,9540,122112
291992,201809,172,89,83,84142.8,79182,163324.8
291995,201809,143,99,44,94446,41976,136422
292000,201809,386,297,89,281768.59,84906,366674.59
292010,201809,289,203,86,192708.8,81090,273798.8
292020,201809,280,204,76,194616,72504,267120
292030,201809,142,109,33,103986,31482,135468
292040,201809,633,320,313,305280,298602,603882
292045,201809,95,86,9,82044,8586,90630
292050,201809,911,643,268,612412.67,255386,867798.67
292060,201809,939,770,169,732673.28,161226,893899.28
292070,201809,49,20,29,19080,27666,46746
292080,201809,118,81,37,77274,35298,112572
292090,201809,507,183,324,174391.2,309096,483487.2
292100,201809,1423,620,803,589906.7,764794.52,1354701.22
292105,201809,207,177,30,168858,28620,197478
292110,201809,2118,783,1335,746676.72,1271991.06,2018667.78
292120,201809,660,524,136,498763.79,129744,628507.79
292130,201809,447,258,189,246132,180306,426438
292140,201809,197,156,41,148824,38315.26,187139.26
292145,201809,165,87,78,82712,74369.07,157081.07
292150,201809,1440,1159,281,1105686,266759.96,1372445.96
292160,201809,177,143,34,136135.8,32436,168571.8
292170,201809,1211,1065,146,1014317.31,139226.76,1153544.07
292180,201809,205,147,58,140238,55332,195570
292190,201809,158,94,64,89676,61056,150732
292200,201809,1300,471,829,448362.71,790217.56,1238580.27
292205,201809,123,109,14,103699.8,13356,117055.8
292210,201809,371,258,113,244749,107086.5,351835.5
292220,201809,21,16,5,15264,4770,20034
292225,201809,37,34,3,32436,2862,35298
292230,201809,950,763,187,726348.23,178398,904746.23
292240,201809,617,447,170,425341,162180,587521
292250,201809,1726,1112,614,1060848,585470,1646318
292260,201809,443,253,190,241362,180496.8,421858.8
292265,201809,262,184,78,175249.8,74412,249661.8
292270,201809,768,337,431,321498,410220.8,731718.8
292273,201809,206,114,92,107978.49,87768,195746.49
292275,201809,172,89,83,84906,78895.8,163801.8
292280,201809,138,98,40,93492,38160,131652
292285,201809,67,57,10,53710.2,9540,63250.2
292290,201809,564,382,182,362997,173342,536339
292300,201809,1648,630,1018,600447.8,970338.58,1570786.38
292303,201809,103,72,31,68688,29574,98262
292305,201809,109,78,31,74412,29574,103986
292310,201809,824,531,293,506212,278414.15,784626.15
292320,201809,666,502,164,478621.8,156456,635077.8
292330,201809,185,101,84,96354,80136,176490
292335,201809,282,221,61,210834,58194,269028
292340,201809,578,405,173,385630.85,165042,550672.85
292350,201809,271,147,124,139427.1,118009.8,257436.9
292360,201809,705,533,172,506765,164088,670853
292370,201809,764,584,180,557136,171720,728856
292380,201809,648,504,144,479146.92,137376,616522.92
292390,201809,498,193,305,184122,290016.4,474138.4
292400,201809,3410,2106,1304,1989136.83,1240135.8,3229272.63
292405,201809,266,178,88,169335,83665.8,253000.8
292410,201809,147,87,60,82998,57240,140238
292420,201809,303,258,45,245845.8,42930,288775.8
292430,201809,528,415,113,395910,107325,503235
292440,201809,586,499,87,474538.8,82711.8,557250.6
292450,201809,258,198,60,188892,57240,246132
292460,201809,590,438,152,415906.38,144912.6,560818.98
292465,201809,208,173,35,165042,32652.09,197694.09
292467,201809,108,65,43,62010,41022,103032
292470,201809,270,182,88,173628,83952,257580
292480,201809,346,226,120,214650.5,114194,328844.5
292490,201809,224,150,74,143100,70596,213696
292500,201809,1159,500,659,476789,628514.28,1105303.28
292510,201809,3362,1532,1830,1460574.12,1742949.6,3203523.72
292520,201809,1088,528,560,501847.7,534231,1036078.7
292525,201809,383,273,110,260437.23,104940,365377.23
292530,201809,4238,1748,2490,1664913.04,2374478.38,4039391.42
292540,201809,471,253,218,241362,207972,449334
292550,201809,1052,572,480,544946.74,457396.64,1002343.38
292560,201809,322,303,19,289062,18126,307188
292570,201809,306,234,72,223236,68688,291924
292575,201809,467,300,167,285914,159318,445232
292580,201809,939,599,340,570015,324074,894089
292590,201809,530,455,75,433767.59,71550,505317.59
292593,201809,143,113,30,107802,28620,136422
292595,201809,186,144,42,137376,40068,177444
292600,201809,1248,924,324,881179,308428.2,1189607.2
292610,201809,129,100,29,95400,27408.42,122808.42
292620,201809,534,445,89,424235,84906,509141
292630,201809,1382,795,587,756842,558367.14,1315209.14
292640,201809,789,548,241,522458.1,229914,752372.1
292650,201809,179,151,28,143618,26712,170330
292660,201809,2013,1451,562,1379384.03,531950.83,1911334.86
292665,201809,143,104,39,99216,37206,136422
292670,201809,404,327,77,311954,73458,385412
292680,201809,257,199,58,189846,54855,244701
292690,201809,190,146,44,139284,41976,181260
292700,201809,931,617,314,587664.8,299556,887220.8
292710,201809,106,93,13,88722,12402,101124
292720,201809,853,481,372,458072.64,354698,812770.64
292730,201809,199,94,105,88722.5,100170,188892.5
292740,201809,67583,33382,34201,31772613.5,32596843.49,64369456.99
292750,201809,375,267,108,253764.94,102221.57,355986.51
292760,201809,328,267,61,252467.3,58194,310661.3
292770,201809,789,330,459,314534,437886,752420
292780,201809,417,158,259,150218.28,247086,397304.28
292790,201809,738,364,374,347256,356557.5,703813.5
292800,201809,1168,714,454,680202,432829.8,1113031.8
292805,201809,425,125,300,118725.3,286200,404925.3
292810,201809,1488,857,631,816719.8,601964.46,1418684.26
292820,201809,747,609,138,579078.87,131356.26,710435.13
292830,201809,103,83,20,79182,19080,98262
292840,201809,662,551,111,525464,105879.69,631343.69
292850,201809,133,90,43,85860,41022,126882
292860,201809,2222,1303,919,1238275.94,876726,2115001.94
292870,201809,3442,2313,1129,2205339.8,1077056.46,3282396.26
292880,201809,1473,966,507,917797.86,482724,1400521.86
292890,201809,498,426,72,406376,68688,475064
292895,201809,136,91,45,85455.5,42930,128385.5
292900,201809,390,286,104,272844,99216,372060
292905,201809,458,232,226,221328,215604,436932
292910,201809,417,316,101,301131,96354,397485
292920,201809,547,243,304,231822,290016,521838
292925,201809,503,465,38,442932.66,36233,479165.66
292930,201809,576,358,218,341532,207972,549504
292935,201809,293,127,166,121158,158355,279513
292937,201809,245,166,79,158364,75366,233730
292940,201809,195,150,45,143100,42930,186030
292950,201809,1147,593,554,562623.3,528421,1091044.3
292960,201809,577,393,184,374922,175536,550458
292970,201809,261,184,77,174869,73458,248327
292975,201809,150,86,64,81805.5,60866,142671.5
292980,201809,260,178,82,168982.43,78228,247210.43
292990,201809,1314,977,337,924721.87,321310.93,1246032.80
293000,201809,107,77,30,73458,28620,102078
293010,201809,2734,1649,1085,1567003.32,1031768.51,2598771.83
293015,201809,661,529,132,504448.49,125289,629737.49
293020,201809,335,276,59,263304,56286,319590
293030,201809,614,535,79,509818,75366,585184
293040,201809,341,267,74,254718,70596,325314
293050,201809,2740,1599,1141,1516891.79,1084661.38,2601553.17
293060,201809,250,199,51,188659,47700.8,236359.8
293070,201809,3455,1759,1696,1670519.68,1616525.82,3287045.50
293075,201809,92,60,32,57240,30528,87768
293076,201809,72,48,24,45792,22896,68688
293077,201809,458,282,176,265429.31,167904,433333.31
293080,201809,454,407,47,387992,44838,432830
293090,201809,130,114,16,108756,15264,124020
293100,201809,526,370,156,352980,148824,501804
293105,201809,338,236,102,224858,97308,322166
293110,201809,171,120,51,114480,48654,163134
293120,201809,323,217,106,207018,100933.2,307951.2
293130,201809,242,163,79,155502,75366,230868
293135,201809,8026,3187,4839,3033566.72,4608260.54,7641827.26
293140,201809,185,121,64,115434,61056,176490
293150,201809,329,281,48,267311,45792,313103
293160,201809,431,249,182,237546,173628,411174
293170,201809,144,100,44,95400,41118,136518
293180,201809,473,325,148,309764,141192,450956
293190,201809,1316,910,406,863490.23,387038,1250528.23
293200,201809,535,471,64,448254,60245.1,508499.1
293210,201809,355,268,87,255520,82282.5,337802.5
293220,201809,2694,1095,1599,1042696.41,1523299.97,2565996.38
293230,201809,1772,649,1123,616327.8,1071342,1687669.8
293240,201809,221,202,19,192708,18126,210834
293245,201809,111,93,18,88722,17172,105894
293250,201809,733,277,456,264010,435024,699034
293260,201809,310,262,48,248994.17,45792,294786.17
293270,201809,1169,565,604,537102.68,576216,1113318.68
293280,201809,249,142,107,135468,102078,237546
293290,201809,3054,2003,1051,1909908,1002641,2912549
293300,201809,715,509,206,482953.3,194043.6,676996.9
293305,201809,151,130,21,124020,20034,144054
293310,201809,142,109,33,103986,31482,135468
293315,201809,150,116,34,110664,32436,143100
293317,201809,94,66,28,62964,26712,89676
293320,201809,973,564,409,537102.5,390186,927288.5
293325,201809,189,66,123,62964,117303.84,180267.84
293330,201809,13004,6126,6878,5834019.32,6554408.29,12388427.61
293340,201809,252,184,68,175536,63918,239454
293345,201809,241,190,51,181260,48654,229914
293350,201809,644,353,291,336762,276135.3,612897.3
293360,201809,1590,1136,454,1082790,432829.8,1515619.8
310010,201809,150,77,73,73458,69356,142814
310020,201809,1065,590,475,560999.9,451909.92,1012909.82
310030,201809,334,272,62,258362.88,59148,317510.88
310040,201809,48,29,19,27666,18126,45792
310050,201809,186,122,64,116388,60770,177158
310060,201809,239,168,71,159795,67734,227529
310070,201809,17,9,8,8586,7632,16218
310080,201809,47,26,21,24804,20034,44838
310090,201809,975,518,457,488258.88,435119.8,923378.68
310100,201809,304,232,72,221328,68688,290016
310110,201809,736,395,341,375795.1,324064.46,699859.56
310120,201809,392,211,181,200340.2,172299.94,372640.14
310130,201809,33,21,12,20034,11448,31482
310140,201809,24,13,11,12402,10494,22896
310150,201809,1300,888,412,839284.8,392189.8,1231474.6
310160,201809,2095,1061,1034,1004373.73,984051.4,1988425.13
310163,201809,94,54,40,51516,38160,89676
310170,201809,2630,1131,1499,1078182.2,1427471.4,2505653.6
310180,201809,133,51,82,48654,77846.4,126500.4
310190,201809,488,332,156,316728,148251.6,464979.6
310200,201809,506,323,183,308142,174582,482724
310205,201809,57,43,14,41022,13356,54378
310210,201809,278,226,52,215604,49608,265212
310220,201809,58,35,23,33390,21942,55332
310230,201809,268,187,81,178207.2,77274,255481.2
310240,201809,106,92,14,87529.5,13356,100885.5
310250,201809,101,81,20,77274,19080,96354
310260,201809,784,425,359,402494.24,341751.42,744245.66
310270,201809,278,186,92,176891,87768,264659
310280,201809,363,273,90,259775,85860,345635
310285,201809,216,154,62,146607.86,59148,205755.86
310290,201809,256,147,109,140238,103986,244224
310300,201809,151,124,27,118296,25758,144054
310310,201809,10,8,2,7632,1908,9540
310320,201809,24,14,10,13356,9540,22896
310330,201809,33,25,8,23850,7632,31482
310340,201809,1736,1138,598,1077925.8,569633.8,1647559.6
310350,201809,2878,1570,1308,1493911.81,1247250.8,2741162.61
310360,201809,40,33,7,31482,6678,38160
310370,201809,127,105,22,100170,20702,120872
310375,201809,110,41,69,39114,65807,104921
310380,201809,51,29,22,27666,20988,48654
310390,201809,102,69,33,65826,31482,97308
310400,201809,2388,1562,826,1486524,787689.8,2274213.8
310410,201809,125,69,56,65826,53424,119250
310420,201809,674,359,315,341628.2,299547.06,641175.26
310430,201809,325,216,109,205825.5,103700,309525.5
310440,201809,70,41,29,39114,27666,66780
310445,201809,81,65,16,62010,15264,77274
310450,201809,857,540,317,515160,302418,817578
310460,201809,260,188,72,179352,68688,248040
310470,201809,507,329,178,313866,169812,483678
310480,201809,80,59,21,56286,20034,76320
310490,201809,517,246,271,233730,258534,492264
310500,201809,127,53,74,50562,70596,121158
310510,201809,603,401,202,381314.6,192699,574013.6
310520,201809,132,90,42,85860,40068,125928
310530,201809,88,39,49,37206,46459.8,83665.8
310540,201809,468,287,181,271414.6,172387.8,443802.4
310550,201809,88,57,31,54378,29574,83952
310560,201809,2987,2063,924,1957334.54,880255.8,2837590.34
310570,201809,120,80,40,76320,38160,114480
310590,201809,355,234,121,221567.8,115419.69,336987.49
310600,201809,162,93,69,86290.7,65826,152116.7
310610,201809,61,24,37,22896,35298,58194
310620,201809,46678,22445,24233,21336708.57,23078584.67,44415293.24
310630,201809,616,392,224,371249.6,212361.4,583611.0
310640,201809,142,117,25,111141,23850,134991
310650,201809,165,145,20,138044,19080,157124
310660,201809,91,57,34,54378,32436,86814
310665,201809,60,42,18,40068,17172,57240
310670,201809,6499,2935,3564,2792816.67,3396660.18,6189476.85
310680,201809,57,37,20,35298,19080,54378
310690,201809,625,451,174,423377.16,165996,589373.16
310700,201809,60,39,21,37206,19890.9,57096.9
310710,201809,1236,834,402,794382.23,383222,1177604.23
310720,201809,91,29,62,27666,59148,86814
310730,201809,1378,967,411,920324.5,391808,1312132.5
310740,201809,993,555,438,526322.4,417318.26,943640.66
310750,201809,248,146,102,138330.18,97308,235638.18
310760,201809,65,48,17,45792,15932,61724
310770,201809,96,45,51,42930,48654,91584
310780,201809,400,326,74,310422.6,70596,381018.6
310790,201809,98,80,18,76320,17172,93492
310800,201809,454,217,237,206541,225811.8,432352.8
310810,201809,171,119,52,112467.2,48654,161121.2
310820,201809,356,283,73,269982,69642,339624
310825,201809,200,164,36,156456,34344,190800
310830,201809,470,225,245,213989.94,233730,447719.94
310840,201809,379,217,162,207018,154548,361566
310850,201809,109,87,22,82998,20988,103986
310855,201809,384,304,80,290016,76320,366336
310860,201809,1419,1063,356,1008999.7,337888.9,1346888.6
310870,201809,53,41,12,39114,11448,50562
310880,201809,85,66,19,62677.8,18126,80803.8
310890,201809,306,181,125,172674,119250,291924
310900,201809,637,295,342,279523.8,325962.8,605486.6
310910,201809,242,164,78,155121.2,74412,229533.2
310920,201809,488,291,197,273799.2,187938,461737.2
310925,201809,45,36,9,34344,8300,42644
310930,201809,1091,660,431,629523.53,411078.3,1040601.83
310940,201809,682,351,331,334281.6,315774,650055.6
310945,201809,117,72,45,68688,42930,111618
310950,201809,250,198,52,188892,49608,238500
310960,201809,83,29,54,27666,51512,79178
310970,201809,167,104,63,99216,59179.76,158395.76
310980,201809,46,24,22,22896,20988,43884
310990,201809,149,83,66,78896,62964,141860
311000,201809,855,421,434,398105.69,414027,812132.69
311010,201809,40,33,7,31482,6678,38160
311020,201809,42,26,16,24804,15264,40068
311030,201809,388,233,155,220374,147489,367863
311040,201809,39,34,5,32436,4770,37206
311050,201809,468,195,273,185458,259869.6,445327.6
311060,201809,765,435,330,412891.6,314534,727425.6
311070,201809,340,157,183,149778,174582,324360
311080,201809,108,59,49,56286,46746,103032
311090,201809,391,184,207,174582,197478,372060
311100,201809,604,359,245,342199.8,233157.6,575357.4
311110,201809,678,469,209,447328.48,199377,646705.48
311115,201809,70,51,19,48654,18126,66780
311120,201809,1077,573,504,543663.2,479909.9,1023573.1
311130,201809,403,239,164,227815.2,156456,384271.2
311140,201809,165,86,79,81757.8,74555.1,156312.9
311150,201809,355,231,124,220374,118057.5,338431.5
311160,201809,739,532,207,505143.4,197001,702144.4
311170,201809,79,59,20,56286,18793.8,75079.8
311180,201809,353,237,116,225811.8,110378,336189.8
311190,201809,35,17,18,16218,17172,33390
311200,201809,336,236,100,223522.6,95400,318922.6
311205,201809,33,22,11,20988,10112.4,31100.4
311210,201809,50,42,8,39782,7632,47414
311220,201809,20,18,2,17172,1908,19080
311230,201809,1640,1072,568,1017654.94,541872,1559526.94
311240,201809,179,114,65,108552.33,62010,170562.33
311250,201809,93,30,63,28620,60102,88722
311260,201809,547,345,202,329130,192708,521838
311265,201809,113,79,34,75366,32436,107802
311270,201809,285,206,79,196524,75366,271890
311280,201809,215,98,117,93492,111045.6,204537.6
311290,201809,110,89,21,84906,19748,104654
311300,201809,564,358,206,341532,196238,537770
311310,201809,25,19,6,18126,5724,23850
311320,201809,670,496,174,472230,165996,638226
311330,201809,1052,772,280,736249.5,266166.4,1002415.9
311340,201809,2669,1894,775,1798330.75,737710.66,2536041.41
311350,201809,276,209,67,199386,63918,263304
311360,201809,177,107,70,102078,66780,168858
311370,201809,1210,497,713,472430.5,679629.6,1152060.1
311380,201809,7,6,1,5724,954,6678
311390,201809,269,142,127,135468,120967.2,256435.2
311400,201809,152,101,51,96354,48654,145008
311410,201809,101,57,44,54092,41976,96068
311420,201809,304,171,133,162180.8,126882,289062.8
311430,201809,861,564,297,536149.2,283052,819201.2
311440,201809,493,343,150,327222,142813.8,470035.8
311450,201809,326,205,121,195570,115434,311004
311455,201809,304,206,98,196228.8,93492,289720.8
311460,201809,136,58,78,55332,73606.27,128938.27
311470,201809,23,13,10,12402,9540,21942
311480,201809,32,14,18,13356,17172,30528
311490,201809,17,11,6,10494,5724,16218
311500,201809,20,10,10,9540,9540,19080
311510,201809,634,447,187,424209.3,178398,602607.3
311520,201809,45,35,10,32722.2,9540,42262.2
311530,201809,1800,1356,444,1281105.42,423576,1704681.42
311535,201809,73,52,21,49608,20034,69642
311540,201809,34,29,5,27666,4770,32436
311545,201809,194,145,49,138330,46746,185076
311547,201809,33,25,8,23850,7632,31482
311550,201809,663,306,357,291238,340559.46,631797.46
311560,201809,42,27,15,25758,14310,40068
311570,201809,296,200,96,190227.6,91584,281811.6
311580,201809,320,188,132,179065.8,125928,304993.8
311590,201809,34,30,4,28620,3816,32436
311600,201809,95,76,19,72504,18126,90630
311610,201809,257,225,32,213696.5,30528,244224.5
311615,201809,106,88,18,83952,16981.2,100933.2
311620,201809,22,12,10,11448,9540,20988
311630,201809,85,71,14,67734,13356,81090
311640,201809,134,70,64,66780,61056,127836
311650,201809,129,96,33,90868.5,31482,122350.5
311660,201809,413,200,213,190800,203202,394002
311670,201809,166,107,59,101833,56286,158119
311680,201809,224,162,62,152973.95,58384.8,211358.75
311690,201809,18,11,7,10494,6678,17172
311700,201809,201,141,60,134227.8,56858.4,191086.2
311710,201809,213,134,79,127836,75366,203202
311720,201809,36,26,10,24518,9540,34058
311730,201809,575,377,198,359086,188892,547978
311740,201809,39,28,11,26712,10494,37206
311750,201809,708,481,227,456800.8,216558,673358.8
311760,201809,65,36,29,34344,27666,62010
311770,201809,394,195,199,183550.62,189846,373396.62
311780,201809,173,96,77,91298,73141,164439
311783,201809,83,74,9,70596,8586,79182
311787,201809,35,14,21,13356,20034,33390
311790,201809,264,126,138,120204,131652,251856
311800,201809,670,453,217,428776.3,206350.2,635126.5
311810,201809,45,38,7,36252,6678,42930
311820,201809,112,96,16,91584,15264,106848
311830,201809,1955,1233,722,1170191.1,684205,1854396.1
311840,201809,1035,573,462,542064.9,438325.54,980390.44
311850,201809,11,7,4,6678,3816,10494
311860,201809,9529,4331,5198,4115709.11,4952391.47,9068100.58
311870,201809,146,82,64,78228,61056,139284
311880,201809,955,708,247,673896.8,235638,909534.8
311890,201809,221,111,110,105894,104940,210834
311900,201809,82,34,48,32436,45792,78228
311910,201809,1420,880,540,837326.6,513061.4,1350388.0
311920,201809,236,155,81,147870,77274,225144
311930,201809,916,524,392,499610,373730,873340
311940,201809,2557,1343,1214,1278885.7,1154817,2433702.7
311950,201809,45,32,13,30528,12402,42930
311960,201809,67,49,18,46746,17172,63918
311970,201809,28,18,10,14882.4,9540,24422.4
311980,201809,43,33,10,31195.8,9540,40735.8
311990,201809,53,39,14,37206,13356,50562
311995,201809,63,44,19,41976,18126,60102
312000,201809,35,25,10,23563.8,9540,33103.8
312010,201809,83,62,21,58924,20034,78958
312015,201809,100,74,26,70310,24804,95114
312020,201809,137,86,51,82044,48654,130698
312030,201809,46,37,9,34631,8586,43217
312040,201809,83,52,31,49608,29574,79182
312050,201809,210,115,95,109710,90630,200340
312060,201809,66,40,26,38160,24323.6,62483.6
312070,201809,74,46,28,43884,26712,70596
312080,201809,538,247,291,235638,277614,513252
312083,201809,52,38,14,36252,13356,49608
312087,201809,116,95,21,90630,20034,110664
312090,201809,2990,1727,1263,1634207.9,1201615.9,2835823.8
312100,201809,157,109,48,103766.58,45010,148776.58
312110,201809,116,74,42,70309.8,40068,110377.8
312120,201809,146,110,36,103987,34344,138331
312125,201809,94,53,41,50562,39114,89676
312130,201809,120,80,40,76320,38160,114480
312140,201809,142,109,33,103414,31482,134896
312150,201809,46,36,10,34344,9540,43884
312160,201809,1545,1020,525,968501.6,499438.48,1467940.08
312170,201809,12,10,2,9540,1908,11448
312180,201809,106,65,41,61295,38828,100123
312190,201809,30,26,4,24804,3816,28620
312200,201809,738,635,103,603834.7,98262,702096.7
312210,201809,94,61,33,58194,31482,89676
312220,201809,130,94,36,89438,34344,123782
312230,201809,3609,1764,1845,1679118.58,1758760.62,3437879.20
312235,201809,157,106,51,101124,48654,149778
312240,201809,106,71,35,67734,33390,101124
312245,201809,173,119,54,113522,51516,165038
312247,201809,60,43,17,40259,16218,56477
312250,201809,182,85,97,81090,92538,173628
312260,201809,103,68,35,64014.2,33390,97404.2
312270,201809,138,86,52,82044,49608,131652
312280,201809,26,16,10,15264,9540,24804
312290,201809,159,107,52,102078,48655,150733
312300,201809,203,134,69,127836,65826,193662
312310,201809,56,52,4,49608,3816,53424
312320,201809,440,279,161,264258,152020.1,416278.1
312330,201809,89,79,10,74602.8,9253.8,83856.6
312340,201809,36,17,19,16218,18126,34344
312350,201809,18,11,7,10494,6678,17172
312352,201809,99,67,32,63918,30528,94446
312360,201809,563,257,306,244224,291924,536148
312370,201809,310,181,129,172387.8,123066,295453.8
312380,201809,139,92,47,87768,44838,132606
312385,201809,171,139,32,132319.8,30528,162847.8
312390,201809,304,191,113,181546.2,107135,288681.2
312400,201809,379,290,89,276660,84430,361090
312410,201809,904,291,613,277137,584226,861363
312420,201809,618,483,135,459828.2,128790,588618.2
312430,201809,864,641,223,609226.05,212742,821968.05
312440,201809,46,34,12,32436,11448,43884
312450,201809,212,132,80,125928,76320,202248
312460,201809,61,29,32,27666,30528,58194
312470,201809,54,35,19,33390,18126,51516
312480,201809,201,121,80,115434,76320,191754
312490,201809,272,187,85,178398,81090,259488
312500,201809,33,18,15,17172,14310,31482
312510,201809,453,176,277,167904,263642.39,431546.39
312520,201809,42,15,27,14310,25758,40068
312530,201809,50,37,13,35298,12402,47700
312540,201809,100,87,13,82998,12402,95400
312550,201809,40,32,8,30528,7632,38160
312560,201809,213,159,54,151400,51229.8,202629.8
312570,201809,443,262,181,249661.8,172125.45,421787.25
312580,201809,85,44,41,41976,39114,81090
312590,201809,267,211,56,201294,53424,254718
312595,201809,140,125,15,119250,14310,133560
312600,201809,75,46,29,43455,27666,71121
312610,201809,1639,862,777,814622.98,739541.6,1554164.58
312620,201809,192,137,55,130698,52465.23,183163.23
312630,201809,65,55,10,52470,9540,62010
312640,201809,47,13,34,12402,32436,44838
312650,201809,152,126,26,119918,24804,144722
312660,201809,71,53,18,50276,17172,67448
312670,201809,873,576,297,548550.1,283124.3,831674.4
312675,201809,41,32,9,30528,8586,39114
312680,201809,85,56,29,53042.4,27666,80708.4
312690,201809,234,124,110,118286.46,104653.8,222940.26
312695,201809,35,28,7,26712,6678,33390
312700,201809,221,124,97,118296,92538,210834
312705,201809,80,66,14,62964,13356,76320
312707,201809,120,88,32,83532.24,30528,114060.24
312710,201809,1905,1017,888,969144,845988,1815132
312720,201809,66,33,33,31482,31482,62964
312730,201809,288,169,119,160272,113526,273798
312733,201809,55,46,9,43598,8586,52184
312735,201809,22,16,6,15264,5724,20988
312737,201809,71,38,33,36252,31482,67734
312738,201809,56,40,16,38160,15264,53424
312740,201809,75,50,25,47414,23850,71264
312750,201809,70,52,18,49608,17172,66780
312760,201809,276,201,75,191754,71550,263304
312770,201809,7632,3551,4081,3366710.34,3887501.35,7254211.69
312780,201809,428,328,100,312625.8,95400,408025.8
312790,201809,22,17,5,16218,4770,20988
312800,201809,1614,1127,487,1068862.8,464407.2,1533270.0
312810,201809,377,243,134,231535.8,127836,359371.8
312820,201809,192,144,48,137376,45792,183168
312825,201809,26,17,9,16218,8586,24804
312830,201809,273,162,111,153309,105255,258564
312840,201809,151,110,41,104940,39114,144054
312850,201809,28,24,4,22896,3816,26712
312860,201809,167,101,66,96068,62964,159032
312870,201809,994,525,469,498242.44,447426,945668.44
312880,201809,153,104,49,99072.9,46650.6,145723.5
312890,201809,168,116,52,109854,49608,159462
312900,201809,209,157,52,149110.2,49608,198718.2
312910,201809,191,98,93,92328.72,88722,181050.72
312920,201809,156,86,70,82044,66780,148824
312930,201809,350,251,99,239454,94446,333900
312940,201809,112,77,35,73458,33390,106848
312950,201809,698,461,237,438744.6,226098,664842.6
312960,201809,172,132,40,125928,38160,164088
312965,201809,56,52,4,49608,3816,53424
312970,201809,292,235,57,223236.2,54378,277614.2
312980,201809,2335,1226,1109,1164125,1057695.8,2221820.8
312990,201809,50,29,21,27666,20034,47700
313000,201809,42,24,18,22896,17172,40068
313005,201809,173,134,39,127597.5,36920,164517.5
313010,201809,947,387,560,367948.8,534231,902179.8
313020,201809,189,99,90,93969,85860,179829
313030,201809,208,137,71,128791,67734,196525
313040,201809,70,28,42,26712,40068,66780
313050,201809,296,206,90,196524,85860,282384
313055,201809,47,35,12,33390,11448,44838
313060,201809,121,84,37,80136,35011.8,115147.8
313065,201809,60,40,20,38160,19080,57240
313070,201809,149,79,70,75366,66780,142146
313080,201809,42,18,24,17172,22896,40068
313090,201809,715,497,218,472252.46,207972,680224.46
313100,201809,164,64,100,61056,95392,156448
313110,201809,133,77,56,73458,53424,126882
313115,201809,180,98,82,93291.66,78228,171519.66
313120,201809,765,421,344,401348,326936,728284
313130,201809,5389,2928,2461,2770491.72,2338895.56,5109387.28
313140,201809,156,81,75,77274,71550,148824
313150,201809,311,247,64,235638,60769.8,296407.8
313160,201809,202,148,54,140906,51516,192422
313170,201809,1390,975,415,917130.1,395519.4,1312649.5
313180,201809,317,190,127,180611.28,120872,301483.28
313190,201809,757,461,296,436741.2,281621,718362.2
313200,201809,25,24,1,22896,954,23850
313210,201809,1049,884,165,839808.46,157405.23,997213.69
313220,201809,247,169,78,160272,73010.52,233282.52
313230,201809,277,204,73,193663,69642,263305
313240,201809,1937,1037,900,985379.73,855637.83,1841017.56
313250,201809,1284,960,324,910404.6,306998.8,1217403.4
313260,201809,97,55,42,52470,40068,92538
313270,201809,959,563,396,533430.1,377784,911214.1
313280,201809,61,51,10,48177,9540,57717
313290,201809,226,182,44,173342,41022.8,214364.8
313300,201809,378,198,180,185745,171720,357465
313310,201809,230,117,113,111618,107802,219420
313320,201809,375,288,87,272797.1,82998,355795.1
313330,201809,1363,838,525,798021.2,499658.5,1297679.7
313340,201809,336,232,104,221328,99216,320544
313350,201809,516,352,164,333900.1,156456,490356.1
313360,201809,116,70,46,66780,43598,110378
313370,201809,191,68,123,64872,117342,182214
313375,201809,278,168,110,160272,104940,265212
313380,201809,1340,698,642,663041.08,612464,1275505.08
313390,201809,51,46,5,42930.8,4770,47700.8
313400,201809,416,279,137,266166,130126,396292
313410,201809,22,14,8,13356,7632,20988
313420,201809,4679,2438,2241,2316858.38,2130283.76,4447142.14
313430,201809,143,67,76,63918,72217.8,136135.8
313440,201809,1504,1032,472,980609.03,448858,1429467.03
313450,201809,64,28,36,26712,34057.8,60769.8
313460,201809,377,175,202,166464,191659.56,358123.56
313470,201809,534,245,289,233730,275038.2,508768.2
313480,201809,156,108,48,102079,45792,147871
313490,201809,512,247,265,235633.23,252763,488396.23
313500,201809,21,14,7,13356,6678,20034
313505,201809,997,779,218,742030.94,207972,950002.94
313507,201809,101,60,41,57240,39114,96354
313510,201809,2814,1809,1005,1718906.68,957816,2676722.68
313520,201809,3614,2833,781,2691586.97,745070,3436656.97
313530,201809,45,30,15,28620,14310,42930
313535,201809,110,88,22,83285,20988,104273
313540,201809,73,55,18,52470,17172,69642
313545,201809,116,97,19,92538,18126,110664
313550,201809,232,191,41,182214,38828,221042
313560,201809,327,165,162,157410,154548,311958
313570,201809,59,31,28,29574,26712,56286
313580,201809,1330,735,595,698519,566772,1265291
313590,201809,78,46,32,43884,30528,74412
313600,201809,695,420,275,400394,262064,662458
313610,201809,60,47,13,44218.8,12402,56620.8
313620,201809,1376,727,649,683698.18,614213.6,1297911.78
313630,201809,1648,1262,386,1200159.4,368180,1568339.4
313640,201809,129,76,53,72504,50562,123066
313650,201809,241,112,129,106848,122494,229342
313652,201809,19,19,0,18126,0,18126
313655,201809,58,34,24,32436,22896,55332
313657,201809,47,44,3,41976,2862,44838
313660,201809,136,92,44,87768,41993.17,129761.17
313665,201809,661,318,343,303372,326983.5,630355.5
313670,201809,10293,7134,3159,6779724.28,3012827.8,9792552.08
313680,201809,43,32,11,30528,10390,40918
313690,201809,154,115,39,109710,37206,146916
313695,201809,79,60,19,57240,18126,75366
313700,201809,307,249,58,237260,55332,292592
313710,201809,146,99,47,94446,44838,139284
313720,201809,1119,536,583,509150,554837.86,1063987.86
313730,201809,61,42,19,40068,18126,58194
313740,201809,160,131,29,124974,27666,152640
313750,201809,441,322,119,307188,113526,420714
313753,201809,246,178,68,169144.2,64872,234016.2
313760,201809,1271,460,811,438554,771234.18,1209788.18
313770,201809,359,263,96,249996.2,91584,341580.2
313780,201809,762,394,368,375876,350785.8,726661.8
313790,201809,31,30,1,28620,954,29574
313800,201809,150,94,56,89676,53424,143100
313810,201809,68,39,29,37206,27666,64872
313820,201809,1285,643,642,612850,611205,1224055
313830,201809,67,48,19,45792,18126,63918
313835,201809,57,48,9,45792,8586,54378
313840,201809,1723,1071,652,1016393.52,620768.2,1637161.72
313850,201809,185,63,122,60102,115808.06,175910.06
313860,201809,479,368,111,347686.3,105894,453580.3
313862,201809,175,117,58,111618,55332,166950
313865,201809,93,74,19,70596,18126,88722
313867,201809,47,36,11,34344,10494,44838
313868,201809,29,19,10,17363,9540,26903
313870,201809,127,65,62,62010,58862,120872
313880,201809,361,227,134,216558,127550,344108
313890,201809,327,177,150,168095.8,142527.6,310623.4
313900,201809,907,497,410,473184.5,391093,864277.5
313910,201809,140,101,39,96354,36252.2,132606.2
313920,201809,625,443,182,422431.2,173108,595539.2
313925,201809,32,28,4,26712,3816,30528
313930,201809,827,639,188,609319.8,179329,788648.8
313940,201809,1820,1149,671,1092902.6,639466.4,1732369.0
313950,201809,938,599,339,569348.2,323119.8,892468.0
313960,201809,1398,804,594,762752.3,564340,1327092.3
313970,201809,127,86,41,82044,39114,121158
313980,201809,212,139,73,132368,69642,202010
313990,201809,383,230,153,219420,145962,365382
314000,201809,927,623,304,590861.9,290011.23,880873.13
314010,201809,79,52,27,49608,25758,75366
314015,201809,53,16,37,15264,35298,50562
314020,201809,51,35,16,33390,15264,48654
314030,201809,82,37,45,35135.82,42930,78065.82
314040,201809,45,30,15,28620,14310,42930
314050,201809,310,184,126,175250,120204,295454
314053,201809,99,64,35,60102.4,33390,93492.4
314055,201809,301,181,120,172674,114480,287154
314060,201809,147,125,22,118296,20988,139284
314070,201809,1045,532,513,505343.34,488782,994125.34
314080,201809,218,142,76,134514,71454.88,205968.88
314085,201809,138,91,47,86814,44838,131652
314090,201809,356,260,96,247993,91579.23,339572.23
314100,201809,476,392,84,370153,80136,450289
314110,201809,737,402,335,381876.66,319017.6,700894.26
314120,201809,96,55,41,52470,39114,91584
314130,201809,24,11,13,10494,12402,22896
314140,201809,1107,675,432,639374.4,408980.46,1048354.86
314150,201809,163,103,60,98262,57240,155502
314160,201809,349,260,89,245178.8,84716,329894.8
314170,201809,79,61,18,58194,17172,75366
314180,201809,735,648,87,617906,82044.5,699950.5
314190,201809,101,60,41,57240,39114,96354
314200,201809,587,408,179,387961.6,169812,557773.6
314210,201809,281,214,67,203202,63632,266834
314220,201809,310,234,76,221329,72218,293547
314225,201809,65,47,18,44838,17172,62010
314230,201809,107,47,60,44838,57240,102078
314240,201809,141,109,32,103986,30528,134514
314250,201809,60,37,23,35298,21942,57240
314260,201809,192,97,95,92538,90630,183168
314270,201809,327,262,65,249948,62010,311958
314280,201809,694,390,304,372051,290016,662067
314290,201809,561,459,102,436646.5,97021.8,533668.3
314300,201809,398,284,114,267810,108709,376519
314310,201809,1443,975,468,928243.12,446451.97,1374695.09
314315,201809,37,30,7,28620,6678,35298
314320,201809,613,399,214,380192.8,203516.82,583709.62
314330,201809,10692,5423,5269,5162175.96,5022160.75,10184336.71
314340,201809,576,271,305,258247.8,290398,548645.8
314345,201809,38,28,10,26712,9540,36252
314350,201809,192,120,72,114480,68688,183168
314360,201809,82,52,30,49608,28620,78228
314370,201809,58,48,10,45792,9540,55332
314380,201809,93,66,27,62964,25758,88722
314390,201809,3309,2100,1209,1998153.5,1150429.4,3148582.9
314400,201809,689,492,197,466498.2,187938,654436.2
314410,201809,452,296,156,282384,148824,431208
314420,201809,18,9,9,8586,8586,17172
314430,201809,2501,905,1596,858186.26,1520072.47,2378258.73
314435,201809,275,162,113,154261.8,106848,261109.8
314437,201809,27,21,6,20034,5724,25758
314440,201809,97,71,26,67734,24804,92538
314450,201809,157,115,42,109710,40068,149778
314460,201809,655,308,347,293832,331038,624870
314465,201809,85,57,28,54378,26712,81090
314467,201809,70,57,13,54369,12402,66771
314470,201809,393,203,190,190210.52,180306.5,370517.02
314480,201809,1075,515,560,491310,534049.2,1025359.2
314490,201809,86,64,22,61056,20988,82044
314500,201809,311,207,104,197478,99216,296694
314505,201809,128,85,43,81090,41022,122112
314510,201809,230,189,41,180306,39114,219420
314520,201809,1269,660,609,620510.9,579841.8,1200352.7
314530,201809,746,592,154,564133,146916,711049
314535,201809,212,134,78,127072.64,74412,201484.64
314537,201809,66,39,27,37206,25758,62964
314540,201809,13,9,4,8586,3816,12402
314545,201809,49,32,17,30528,16218,46746
314550,201809,83,45,38,42930,36252,79182
314560,201809,824,445,379,421763.6,361566,783329.6
314570,201809,21,17,4,16218,3816,20034
314580,201809,16,8,8,7632,7632,15264
314585,201809,22,17,5,16218,4770,20988
314587,201809,83,72,11,68688,10494,79182
314590,201809,587,434,153,412510.5,145676,558186.5
314600,201809,964,633,331,599487.06,314094.83,913581.89
314610,201809,950,514,436,487494.7,415467,902961.7
314620,201809,148,109,39,102745.8,37206,139951.8
314625,201809,97,71,26,67734,24804,92538
314630,201809,1234,637,597,606219.3,568965.8,1175185.1
314640,201809,88,58,30,55332,28333.8,83665.8
314650,201809,196,113,83,107515.8,78705,186220.8
314655,201809,67,51,16,48654,15264,63918
314660,201809,20,16,4,15264,3816,19080
314670,201809,193,152,41,144722,39114,183836
314675,201809,219,130,89,124020,84906,208926
314690,201809,546,300,246,285913.8,234684,520597.8
314700,201809,2419,1318,1101,1252097.5,1049733.9,2301831.4
314710,201809,1633,960,673,911550.5,641422.1,1552972.6
314720,201809,411,247,164,234235.62,156456,390691.62
314730,201809,521,270,251,255577.8,239158.8,494736.6
314740,201809,693,342,351,324884.7,334854,659738.7
314750,201809,21,18,3,17172,2862,20034
314760,201809,328,157,171,149778,163124.46,312902.46
314770,201809,122,82,40,78228,38160,116388
314780,201809,20,6,14,5724,13356,19080
314790,201809,2406,1518,888,1441772.5,846331.56,2288104.06
314795,201809,56,48,8,45554,7632,53186
314800,201809,2960,1746,1214,1659262.86,1157202,2816464.86
314810,201809,1511,843,668,801711.21,635651,1437362.21
314820,201809,95,51,44,48654,41976,90630
314830,201809,209,167,42,158602.5,39782,198384.5
314840,201809,82,47,35,44838,33390,78228
314850,201809,352,170,182,162180,173628,335808
314860,201809,717,539,178,512488.86,167618.7,680107.56
314870,201809,1487,778,709,741258,676386,1417644
314875,201809,57,49,8,46746,7632,54378
314880,201809,48,34,14,32436,13356,45792
314890,201809,55,32,23,30528,21942,52470
314900,201809,33,26,7,24804,6678,31482
314910,201809,252,169,83,160939.8,79182,240121.8
314915,201809,163,143,20,136422,19080,155502
314920,201809,123,75,48,71550,45505.8,117055.8
314930,201809,1042,531,511,504710.33,486921.6,991631.93
314940,201809,52,40,12,38160,11448,49608
314950,201809,38,26,12,24804,11448,36252
314960,201809,54,40,14,38160,13356,51516
314970,201809,144,73,71,69642,67734,137376
314980,201809,298,191,107,179972.1,101124,281096.1
314990,201809,466,257,209,245178,198480.5,443658.5
314995,201809,213,64,149,61056,142136.46,203192.46
315000,201809,93,77,16,73458,15264,88722
315010,201809,46,30,16,28620,15264,43884
315015,201809,179,147,32,139512.96,30528,170040.96
315020,201809,74,64,10,61056,9540,70596
315030,201809,118,92,26,86814,24804,111618
315040,201809,66,47,19,44838,18126,62964
315050,201809,198,119,79,113526,75080,188606
315053,201809,42,37,5,35298,4626.9,39924.9
315057,201809,98,81,17,76892.4,16218,93110.4
315060,201809,75,66,9,61057.16,8586,69643.16
315070,201809,103,57,46,54378,43884,98262
315080,201809,380,311,69,296694,65826,362520
315090,201809,109,65,44,62010,41976,103986
315100,201809,85,43,42,41022,40068,81090
315110,201809,294,163,131,154644,124974,279618
315120,201809,1668,842,826,797755.18,785998.64,1583753.82
315130,201809,344,249,95,237546,90630,328176
315140,201809,528,310,218,294118.2,207972,502090.2
315150,201809,988,475,513,452197,489116,941313
315160,201809,219,109,110,103986,104940,208926
315170,201809,332,215,117,204157,111331.8,315488.8
315180,201809,3236,1364,1872,1297870.3,1782932.7,3080803.0
315190,201809,326,190,136,180879,129744,310623
315200,201809,1203,694,509,660454.2,484727.4,1145181.6
315210,201809,1571,889,682,845531.8,648208.2,1493740.0
315213,201809,44,25,19,23850,18126,41976
315217,201809,216,173,43,165042,41022,206064
315220,201809,1548,1187,361,1131340.4,344108,1475448.4
315230,201809,169,123,46,117056,43884,160940
315240,201809,425,273,152,260442,143806.5,404248.5
315250,201809,2560,1263,1297,1204324.83,1236947.66,2441272.49
315260,201809,148,89,59,84906,56286,141192
315270,201809,134,93,41,88149.6,38388.96,126538.56
315280,201809,700,456,244,434643,232766.46,667409.46
315290,201809,203,121,82,115434,77274.49,192708.49
315300,201809,74,52,22,49608,20988,70596
315310,201809,70,64,6,61056,5724,66780
315320,201809,169,98,71,93492,67734,161226
315330,201809,59,51,8,48654,7632,56286
315340,201809,413,294,119,279293.6,113526,392819.6
315350,201809,152,91,61,86814,58194,145008
315360,201809,93,50,43,47700,41022,88722
315370,201809,63,38,25,35536.5,23850,59386.5
315380,201809,11,7,4,6678,3816,10494
315390,201809,65,15,50,14310,47700,62010
315400,201809,838,632,206,597490.5,195856.2,793346.7
315410,201809,357,219,138,208640,131366,340006
315415,201809,64,49,15,46746,14310,61056
315420,201809,202,153,49,144866,46746,191612
315430,201809,672,391,281,370820.2,267597.8,638418.0
315440,201809,89,61,28,58194,26712,84906
315445,201809,255,206,49,196209.18,46746,242955.18
315450,201809,180,136,44,129744,41976,171720
315460,201809,3514,1776,1738,1691243.4,1655113.63,3346357.03
315470,201809,43,21,22,20034,20988,41022
315480,201809,65,26,39,24804,37206,62010
315490,201809,639,401,238,380502.9,227052,607554.9
315500,201809,24,16,8,15264,7632,22896
315510,201809,154,103,51,98262,48654,146916
315520,201809,74,65,9,62010,8586,70596
315530,201809,53,28,25,26712,23850,50562
315540,201809,237,157,80,149778,76320,226098
315550,201809,178,141,37,134514,35298,169812
315560,201809,741,592,149,563428.8,142146,705574.8
315570,201809,321,167,154,156123.5,146726,302849.5
315580,201809,679,446,233,424817,222282,647099
315590,201809,204,107,97,102078,92538,194616
315600,201809,297,221,76,210595.5,72504,283099.5
315610,201809,99,47,52,44838,49608,94446
315620,201809,33,27,6,25758,5724,31482
315630,201809,137,90,47,85860,44838,130698
315640,201809,63,38,25,36252,23850,60102
315645,201809,66,47,19,44838,17649,62487
315650,201809,168,122,46,115816,43311.6,159127.6
315660,201809,476,210,266,200340,253764,454104
315670,201809,2432,1202,1230,1143923.32,1171961.66,2315884.98
315680,201809,854,579,275,549694.8,262350,812044.8
315690,201809,678,466,212,444443,202248,646691
315700,201809,1923,1011,912,959954.57,869953,1829907.57
315710,201809,333,90,243,85860,231822,317682
315720,201809,446,287,159,273798,151686,425484
315725,201809,203,162,41,154262,39114,193376
315727,201809,42,22,20,20988,19080,40068
315730,201809,48,46,2,43884,1908,45792
315733,201809,93,61,32,58194,30528,88722
315737,201809,50,39,11,37206,10494,47700
315740,201809,46,38,8,36252,7632,43884
315750,201809,157,120,37,114480,35298,149778
315760,201809,46,34,12,32436,11448,43884
315765,201809,123,79,44,75366,41976,117342
315770,201809,233,144,89,137376,84620,221996
315780,201809,3347,1738,1609,1651193.74,1533270.38,3184464.12
315790,201809,209,159,50,151686,47127.6,198813.6
315800,201809,291,212,79,202248,75366,277614
315810,201809,97,57,40,54378,37874,92252
315820,201809,797,578,219,548551.34,208926,757477.34
315830,201809,140,82,58,78228,55332,133560
315840,201809,93,65,28,62010,26712,88722
315850,201809,263,196,67,186984,63918,250902
315860,201809,13,5,8,4770,7632,12402
315870,201809,34,27,7,25758,6678,32436
315880,201809,111,71,40,67734,38160,105894
315890,201809,82,61,21,58194,20034,78228
315895,201809,471,322,149,306139,141574,447713
315900,201809,71,34,37,32150,35298,67448
315910,201809,39,25,14,23611.5,13356,36967.5
315920,201809,179,116,63,110664,59148.9,169812.9
315930,201809,43,14,29,13356,27666,41022
315935,201809,150,117,33,111618,31473,143091
315940,201809,91,68,23,64872,21942,86814
315950,201809,65,46,19,43884,18126,62010
315960,201809,555,262,293,248679.38,278663.6,527342.98
315970,201809,36,29,7,27666,6678,34344
315980,201809,700,329,371,311624.4,353934,665558.4
315990,201809,259,152,107,144770,101783,246553
316000,201809,51,34,17,32149.8,15931.8,48081.6
316010,201809,76,64,12,61056,11448,72504
316020,201809,114,94,20,89676,19080,108756
316030,201809,406,218,188,207686,178828,386514
316040,201809,513,214,299,203202.2,284960,488162.2
316045,201809,61,54,7,51516,6678,58194
316050,201809,16,14,2,13356,1908,15264
316060,201809,99,64,35,61056,33390,94446
316070,201809,1084,704,380,666294.3,361757,1028051.3
316080,201809,103,65,38,61723.8,36252,97975.8
316090,201809,41,25,16,23182.2,15264,38446.2
316095,201809,74,62,12,59148,11448,70596
316100,201809,313,185,128,175965.8,122112,298077.8
316105,201809,35,24,11,22896,10494,33390
316110,201809,1928,1556,372,1473692.35,354220.2,1827912.55
316120,201809,79,59,20,56286,18793.8,75079.8
316130,201809,137,105,32,99503,30528,130031
316140,201809,27,20,7,19080,6678,25758
316150,201809,210,146,64,138568.5,61056,199624.5
316160,201809,82,49,33,46746,31482,78228
316165,201809,66,49,17,46556,15502.5,62058.5
316170,201809,202,136,66,128790,62964,191754
316180,201809,205,90,115,85860,109710,195570
316190,201809,142,105,37,99216,35298,134514
316200,201809,699,390,309,372060,293927.4,665987.4
316210,201809,782,523,259,500529.41,247086,747615.41
316220,201809,113,76,37,72504,35298,107802
316225,201809,26,15,11,14310,10494,24804
316230,201809,31,19,12,18126,11448,29574
316240,201809,642,516,126,492264,120204,612468
316245,201809,110,91,19,86814,18126,104940
316250,201809,1516,1055,461,999107.5,438611.12,1437718.62
316255,201809,117,96,21,91202.4,20019.69,111222.09
316257,201809,184,96,88,91584,83665.8,175249.8
316260,201809,246,161,85,152297.06,80995,233292.06
316265,201809,28,19,9,18126,8586,26712
316270,201809,676,472,204,447283.4,194616,641899.4
316280,201809,541,332,209,315457.8,198718.6,514176.4
316290,201809,705,466,239,441512.18,228006,669518.18
316292,201809,519,207,312,197191.8,297410,494601.8
316294,201809,101,59,42,56286,40068,96354
316295,201809,301,134,167,125911,159318,285229
316300,201809,102,72,30,68688,28620,97308
316310,201809,38,20,18,18793.8,17172,35965.8
316320,201809,43,26,17,24804,16218,41022
316330,201809,134,86,48,81090.5,45505.8,126596.3
316340,201809,146,100,46,95400,43884,139284
316350,201809,192,139,53,131986,50562,182548
316360,201809,25,18,7,17172,6678,23850
316370,201809,1076,574,502,543132.7,478612.26,1021744.96
316380,201809,124,95,29,90630,27666,118296
316390,201809,124,89,35,84906,33390,118296
316400,201809,139,105,34,100170,32436,132606
316410,201809,307,227,80,215174.7,76320,291494.7
316420,201809,206,146,60,138568.5,57240,195808.5
316430,201809,154,79,75,75366,71550,146916
316440,201809,97,46,51,43884,48654,92538
316443,201809,38,35,3,33390,2862,36252
316447,201809,64,48,16,45792,15264,61056
316450,201809,227,170,57,162180,54378,216558
316460,201809,74,31,43,29574,41022,70596
316470,201809,1636,1191,445,1127268.64,422408.79,1549677.43
316480,201809,13,10,3,9540,2862,12402
316490,201809,18,7,11,6678,10494,17172
316500,201809,153,102,51,97021.8,48654,145675.8
316510,201809,163,124,39,117294.3,37206,154500.3
316520,201809,188,114,74,108756,70596,179352
316530,201809,163,115,48,109710,45630.37,155340.37
316540,201809,141,80,61,76320,58194,134514
316550,201809,135,96,39,91584,37206,128790
316553,201809,252,120,132,114480,125928,240408
316555,201809,32,25,7,23046,6678,29724
316556,201809,11,8,3,7632,2862,10494
316557,201809,17,13,4,12402,3816,16218
316560,201809,63,49,14,46746,13356,60102
316570,201809,243,220,23,209260,21942,231202
316580,201809,21,16,5,15264,4770,20034
316590,201809,115,99,16,94446,15264,109710
316600,201809,179,146,33,138521,31482,170003
316610,201809,68,48,20,45505.8,19080,64585.8
316620,201809,135,104,31,99216,29574,128790
316630,201809,44,33,11,31482,10494,41976
316640,201809,16,10,6,9540,5724,15264
316650,201809,71,55,16,52470,15264,67734
316660,201809,8,4,4,3816,3816,7632
316670,201809,443,158,285,150713,271317.8,422030.8
316680,201809,163,114,49,108756,46556,155312
316690,201809,192,124,68,118296,64872,183168
316695,201809,61,54,7,51516,6678,58194
316700,201809,15,8,7,7632,6678,14310
316710,201809,744,546,198,518929,188892,707821
316720,201809,4966,2518,2448,2388617.73,2330781.43,4719399.16
316730,201809,15,14,1,13356,954,14310
316740,201809,127,81,46,77274,43884,121158
316750,201809,21,14,7,13356,6678,20034
316760,201809,324,261,63,248994,60102,309096
316770,201809,138,75,63,71550,60102,131652
316780,201809,76,47,29,44532.72,27666,72198.72
316790,201809,57,44,13,41976,12402,54378
316800,201809,1807,1106,701,1054074.8,668278,1722352.8
316805,201809,18,10,8,9540,7632,17172
316810,201809,71,47,24,44838,22896,67734
316820,201809,42,20,22,19080,20988,40068
316830,201809,95,43,52,41022,49608,90630
316840,201809,507,304,203,289730,192708,482438
316850,201809,344,225,119,213982.2,113526,327508.2
316860,201809,6006,2677,3329,2539699.65,3170212.25,5709911.90
316870,201809,1481,965,516,911741.1,486828.2,1398569.3
316880,201809,124,65,59,61723.8,56286,118009.8
316890,201809,250,168,82,160272,78228,238500
316900,201809,422,290,132,274113.28,125928,400041.28
316905,201809,18,8,10,7632,9540,17172
316910,201809,52,25,27,23850,25758,49608
316920,201809,138,107,31,101363,29574,130937
316930,201809,1911,974,937,925523.5,891704.7,1817228.2
316935,201809,881,538,343,511344.72,325982,837326.72
316940,201809,1115,646,469,615330.4,446844.26,1062174.66
316950,201809,184,94,90,89676,85860,175536
316960,201809,1119,623,496,593006.8,472888.46,1065895.26
316970,201809,655,512,143,488216,136422,624638
316980,201809,112,67,45,63918,42920.46,106838.46
316990,201809,2205,1455,750,1381011.15,712296.56,2093307.71
317000,201809,333,256,77,244224,73458,317682
317005,201809,253,180,73,171720,69642,241362
317010,201809,6403,3532,2871,3349375.93,2736740,6086115.93
317020,201809,16442,7298,9144,6930954.83,8707845.11,15638799.94
317030,201809,80,30,50,28620,47483.26,76103.26
317040,201809,3133,1957,1176,1862975.23,1119138.61,2982113.84
317043,201809,79,57,22,54378,20988,75366
317047,201809,36,18,18,17172,17168,34340
317050,201809,180,135,45,128790,42930,171720
317052,201809,131,100,31,95400,29574,124974
317057,201809,195,146,49,139284,46174,185458
317060,201809,57,38,19,36252,17839.8,54091.8
317065,201809,57,45,12,42930,11448,54378
317070,201809,2006,950,1056,901531.7,1005993.4,1907525.1
317075,201809,109,58,51,55332,48654,103986
317080,201809,846,442,404,419807.7,385226,805033.7
317090,201809,638,511,127,485157.5,121158,606315.5
317100,201809,431,324,107,307188,102078,409266
317103,201809,109,93,16,88722,15264,103986
317107,201809,38,34,4,32436,3816,36252
317110,201809,106,46,60,43884,57240,101124
317115,201809,42,36,6,34344,5724,40068
317120,201809,1856,944,912,891653.15,869591,1761244.15
317130,201809,1959,1269,690,1204482.2,657593,1862075.2
317140,201809,11,9,2,8586,1908,10494
317150,201809,269,159,110,151400,104176.8,255576.8
317160,201809,313,226,87,215287,82998,298285
317170,201809,210,142,68,135468,64872,200340
317180,201809,435,316,119,300748.5,113526,414274.5
317190,201809,255,174,81,165996,76987.8,242983.8
317200,201809,817,576,241,536444.2,229676,766120.2
317210,201809,158,89,69,83952.2,65826,149778.2
317220,201809,20,13,7,12402,6678,19080
320010,201809,632,472,160,447140.5,152640,599780.5
320013,201809,136,101,35,96354,33390,129744
320016,201809,280,176,104,167904,99216,267120
320020,201809,738,442,296,418566.35,280476.32,699042.67
320030,201809,154,113,41,107802,38780.1,146582.1
320035,201809,143,106,37,101124,35298,136422
320040,201809,510,261,249,248135.8,236973.8,485109.6
320050,201809,117,87,30,82998,28620,111618
320060,201809,1585,749,836,714403.6,796858.06,1511261.66
320070,201809,105,69,36,65205.9,34344,99549.9
320080,201809,777,445,332,421699,316728,738427
320090,201809,1228,864,364,820902.86,345587.6,1166490.46
320100,201809,326,188,138,179352,131652,311004
320110,201809,132,87,45,81138.2,42644,123782.2
320115,201809,112,92,20,87768,19080,106848
320120,201809,3361,1876,1485,1779690.4,1413992.54,3193682.94
320130,201809,7538,3563,3975,3377234.54,3784172.95,7161407.49
320140,201809,426,279,147,265499,139994,405493
320150,201809,1974,1145,829,1084352.99,790570.26,1874923.25
320160,201809,676,308,368,291342.83,349956.99,641299.82
320170,201809,120,95,25,89867,23850,113717
320180,201809,49,30,19,28620,18126,46746
320190,201809,239,159,80,151676.46,76034,227710.46
320200,201809,56,45,11,42930,10494,53424
320210,201809,855,480,375,456394.6,356778,813172.6
320220,201809,314,117,197,111618,187652,299270
320225,201809,81,66,15,62964,14310,77274
320230,201809,579,376,203,357178.4,192852,550030.4
320240,201809,3178,1595,1583,1518292.8,1507515.78,3025808.58
320245,201809,470,324,146,307951.4,139284,447235.4
320250,201809,238,126,112,119250.6,106848,226098.6
320255,201809,146,114,32,107449.02,30385,137834.02
320260,201809,183,129,54,123066,51468.3,174534.3
320265,201809,164,130,34,123210,32436,155646
320270,201809,152,124,28,118296,26712,145008
320280,201809,986,583,403,551222.2,384176,935398.2
320290,201809,67,56,11,53424,10494,63918
320300,201809,554,393,161,372461.8,152545.1,525006.9
320305,201809,673,368,305,351072,290780,641852
320310,201809,218,123,95,115387.5,89874,205261.5
320313,201809,312,160,152,152640,144722,297362
320316,201809,109,89,20,84906,19080,103986
320320,201809,3385,1550,1835,1473016,1747609.8,3220625.8
320330,201809,261,194,67,184413.3,62010.8,246424.1
320332,201809,889,541,348,514257.6,330943.3,845200.9
320334,201809,243,149,94,141860,89676,231536
320335,201809,146,104,42,98262.4,40068,138330.4
320340,201809,589,409,180,388422,171053,559475
320350,201809,983,426,557,403925.67,529680.48,933606.15
320360,201809,169,91,78,86814,74412,161226
320370,201809,247,190,57,179568,53345,232913
320380,201809,291,199,92,188177.3,87768,275945.3
320390,201809,1147,702,445,666809.8,423910.13,1090719.93
320400,201809,320,230,90,217990.2,85860,303850.2
320405,201809,914,394,520,375299.6,495767.92,871067.52
320410,201809,985,507,478,482009.4,455679,937688.4
320420,201809,484,249,235,237069.4,224190,461259.4
320425,201809,199,108,91,103032,86814,189846
320430,201809,396,228,168,215890.7,160272,376162.7
320435,201809,172,116,56,109843.56,53424,163267.56
320440,201809,204,121,83,115434,79182,194616
320450,201809,133,77,56,73458,53424,126882
320455,201809,252,208,44,197479,41976,239455
320460,201809,249,155,94,147870,88817.6,236687.6
320465,201809,113,76,37,72504,35298,107802
320470,201809,655,421,234,400395.74,223232,623627.74
320480,201809,181,120,61,113669.1,58194,171863.1
320490,201809,3070,1533,1537,1459573.28,1463860.84,2923434.12
320495,201809,98,59,39,56267,36634,92901
320500,201809,9578,4814,4764,4563966.63,4532380.51,9096347.14
320501,201809,546,275,271,262350,258534,520884
320503,201809,290,206,84,195570.2,80136,275706.2
320506,201809,260,194,66,185076,62964,248040
320510,201809,929,440,489,416661.3,464980.1,881641.4
320515,201809,82,69,13,64872.9,12402,77274.9
320517,201809,210,150,60,143100,57240,200340
320520,201809,6999,3108,3891,2950179.15,3704031.66,6654210.81
320530,201809,5444,2737,2707,2602040.86,2576744.44,5178785.30
330010,201809,3157,1632,1525,1549600.87,1450897.71,3000498.58
330015,201809,155,64,91,59912.08,86814,146726.08
330020,201809,3651,1608,2043,1530485.72,1948334,3478819.72
330022,201809,241,135,106,128075,100170.8,228245.8
330023,201809,549,191,358,181164.6,341532,522696.6
330025,201809,594,122,472,116388,450001.8,566389.8
330030,201809,1976,1282,694,1214687.18,658807.68,1873494.86
330040,201809,2423,1253,1170,1192548.2,1114037.3,2306585.5
330045,201809,8415,2689,5726,2557178.82,5456028.57,8013207.39
330050,201809,853,544,309,518976,294786,813762
330060,201809,933,581,352,550173.9,334491.48,884665.38
330070,201809,3466,1327,2139,1259333.47,2039291.56,3298625.03
330080,201809,1486,697,789,659666.3,751179.6,1410845.9
330090,201809,366,215,151,204919.2,144054,348973.2
330093,201809,288,131,157,124974,149733,274707
330095,201809,101,53,48,49894.2,45792,95686.2
330100,201809,9579,4937,4642,4698061.41,4425176.9,9123238.31
330110,201809,488,216,272,203679.1,259488,463167.1
330115,201809,556,310,246,295740,234684,530424
330120,201809,379,197,182,186793.2,172674.8,359468.0
330130,201809,1537,419,1118,399000.96,1066554,1465554.96
330140,201809,602,315,287,300483,272845,573328
330150,201809,458,269,189,253844.14,179065.8,432909.94
330160,201809,209,131,78,124974,74412,199386
330170,201809,27177,9553,17624,9090866.86,16800648.81,25891515.67
330180,201809,235,149,86,139599.02,81328.5,220927.52
330185,201809,852,332,520,315192.6,494812.8,810005.4
330187,201809,321,99,222,94446,211788,306234
330190,201809,5615,2268,3347,2152879.3,3190028.68,5342907.98
330200,201809,4626,1506,3120,1432051.26,2971703.76,4403755.02
330205,201809,415,246,169,234540.9,160940,395480.9
330210,201809,1023,632,391,596188.02,371344.9,967532.92
330220,201809,2595,1559,1036,1482331.17,987390.2,2469721.37
330225,201809,573,309,264,294147,251188.2,545335.2
330227,201809,2426,771,1655,732376.46,1578228.23,2310604.69
330230,201809,211,125,86,118583,82044,200627
330240,201809,3713,1958,1755,1863261.94,1671051.91,3534313.85
330245,201809,155,68,87,64758,82234.8,146992.8
330250,201809,6597,3415,3182,3247230.8,3027151.32,6274382.12
330260,201809,568,164,404,156456,385416,541872
330270,201809,3464,1263,2201,1204045,2098897,3302942
330280,201809,465,301,164,285362.08,156447,441809.08
330285,201809,7223,2368,4855,2253715.2,4628972.04,6882687.24
330290,201809,577,218,359,207972,342486,550458
330300,201809,793,528,265,499896.7,252783,752679.7
330310,201809,436,246,190,232776.7,181260,414036.7
330320,201809,8417,3204,5213,3048654.1,4967407.84,8016061.94
330330,201809,9183,3628,5555,3452558,5295825.56,8748383.56
330340,201809,2667,1589,1078,1513035.46,1028392.92,2541428.38
330350,201809,18197,7202,10995,6841622.39,10469814.99,17311437.38
330360,201809,2451,1222,1229,1164815.2,1172457,2337272.2
330370,201809,1039,565,474,538056,450145.9,988201.9
330380,201809,849,362,487,344622.96,464075,808697.96
330385,201809,610,318,292,302419,278568,580987
330390,201809,5262,2899,2363,2750387.55,2251498.4,5001885.95
330395,201809,283,175,108,165996.3,101267.2,267263.5
330400,201809,712,379,333,358132.6,315687.88,673820.48
330410,201809,502,356,146,336715.8,138794.33,475510.13
330411,201809,236,133,103,126701,98214.3,224915.3
330412,201809,256,106,150,100074.8,143100,243174.8
330414,201809,6063,2494,3569,2375470.62,3401707.1,5777177.72
330415,201809,593,276,317,262322.34,301464.8,563787.14
330420,201809,2277,1195,1082,1135368.55,1030121,2165489.55
330430,201809,1801,852,949,810615.2,903343.8,1713959.0
330440,201809,274,128,146,122112,139284,261396
330450,201809,121,53,68,50562,64872,115434
330452,201809,1803,856,947,815157.8,903124.34,1718282.14
330455,201809,111021,39978,71043,38060893.09,67715102.46,105775995.55
330460,201809,260,109,151,103986,144054,248040
330470,201809,1239,677,562,639564.78,535852.46,1175417.24
330475,201809,1412,374,1038,355842.8,988854.39,1344697.19
330480,201809,789,415,374,395242.2,355843,751085.2
330490,201809,13874,4840,9034,4611507.93,8611983.04,13223490.97
330500,201809,1339,606,733,577980.9,698772,1276752.9
330510,201809,11259,3852,7407,3665987.59,7060029.18,10726016.77
330513,201809,103,51,52,48654,49608,98262
330515,201809,845,348,497,327537.8,473757,801294.8
330520,201809,2579,963,1616,918483,1541234.9,2459717.9
330530,201809,224,118,106,112047.8,100934,212981.8
330540,201809,348,177,171,168858,162657,331515
330550,201809,3017,1082,1935,1030034.2,1843700.8,2873735.0
330555,201809,780,294,486,280457,462690.8,743147.8
330560,201809,609,208,401,198432,382527,580959
330570,201809,252,178,74,169812,70596,240408
330575,201809,799,338,461,322214,437739.5,759953.5
330580,201809,3449,1923,1526,1828353.8,1454325.7,3282679.5
330590,201809,311,151,160,144054,152640,296694
330600,201809,1123,721,402,685697.24,381810.84,1067508.08
330610,201809,1556,853,703,806895.74,667467.9,1474363.64
330615,201809,192,143,49,135563.4,46746,182309.4
330620,201809,1074,440,634,417280.5,603405.8,1020686.3
330630,201809,3994,2534,1460,2402888.9,1385592.8,3788481.7
350010,201809,598,396,202,375924.67,192708,568632.67
350020,201809,42,20,22,19080,20988,40068
350030,201809,525,340,185,323216,175300.66,498516.66
350040,201809,128,51,77,48310.56,73458,121768.56
350050,201809,292,161,131,153594,124955.46,278549.46
350055,201809,87,49,38,46746,36252,82998
350060,201809,72,26,46,24804,43884,68688
350070,201809,826,489,337,461368.14,319855.56,781223.70
350075,201809,68,47,21,44838,20034,64872
350080,201809,51,32,19,29891.96,17172,47063.96
350090,201809,93,51,42,48654,40063.23,88717.23
350100,201809,292,185,107,175774.5,102078,277852.5
350110,201809,56,35,21,33390,20034,53424
350115,201809,167,104,63,98548.2,60102,158650.2
350120,201809,108,73,35,69642,33390,103032
350130,201809,355,170,185,161894,176490,338384
350140,201809,36,22,14,20225,13356,33581
350150,201809,67,52,15,49608,14310,63918
350160,201809,2589,1014,1575,964000.96,1501482.68,2465483.64
350170,201809,416,254,162,240408.2,153498.8,393907.0
350180,201809,182,98,84,93492,80136,173628
350190,201809,1036,548,488,520790.64,464965.49,985756.13
350200,201809,68,24,44,22896,41711.08,64607.08
350210,201809,1350,758,592,716099.13,563614.66,1279713.79
350220,201809,678,581,97,550136.73,92538,642674.73
350230,201809,84,58,26,55332,24804,80136
350240,201809,60,45,15,42930,14310,57240
350250,201809,1248,622,626,586330.6,596574.66,1182905.26
350260,201809,92,66,26,62964,24804,87768
350270,201809,834,546,288,519329.58,273302.92,792632.50
350275,201809,307,126,181,119823,172674,292497
350280,201809,4739,2433,2306,2307157.04,2197743.19,4504900.23
350290,201809,414,200,214,190795.23,203583.8,394379.03
350300,201809,56,30,26,28620,24804,53424
350310,201809,98,67,31,63918,29574,93492
350315,201809,39,24,15,22896,14310,37206
350320,201809,3313,1656,1657,1574674.6,1580006.8,3154681.4
350330,201809,1690,901,789,855902.72,751530.04,1607432.76
350335,201809,21,14,7,13356,6678,20034
350340,201809,133,63,70,60102,66447,126549
350350,201809,95,49,46,46746,43884,90630
350360,201809,129,84,45,80132,42930,123062
350370,201809,89,53,36,49608.96,34334.46,83943.42
350380,201809,774,334,440,317682.2,418996.8,736679.0
350390,201809,1456,588,868,560156.35,826927.4,1387083.75
350395,201809,25,20,5,19080,4770,23850
350400,201809,1654,877,777,827052.02,738660.16,1565712.18
350410,201809,2288,1016,1272,966174.96,1212837.03,2179011.99
350420,201809,240,148,92,140589,87768,228357
350430,201809,74,43,31,40450,29574,70024
350440,201809,149,111,38,104892.5,36252,141144.5
350450,201809,1624,996,628,944018.95,599017,1543035.95
350460,201809,331,122,209,116388,199099.8,315487.8
350470,201809,16,10,6,9540,5724,15264
350480,201809,166,89,77,84906,73458,158364
350490,201809,239,119,120,112572.8,114480,227052.8
350500,201809,40,20,20,19080,19080,38160
350510,201809,165,110,55,104940,52470,157410
350520,201809,458,220,238,206843.06,226415.96,433259.02
350530,201809,448,211,237,201294,226098,427392
350535,201809,70,55,15,52212.42,14310,66522.42
350540,201809,372,192,180,183168,171433.8,354601.8
350550,201809,2750,1619,1131,1537236.76,1076254.67,2613491.43
350560,201809,649,453,196,432157.23,186626.25,618783.48
350570,201809,4169,1749,2420,1661836.18,2306173.2,3968009.38
350580,201809,382,183,199,173629,189832.46,363461.46
350590,201809,900,501,399,477668,379692,857360
350600,201809,6230,3142,3088,2980717.73,2940820.61,5921538.34
350610,201809,1551,794,757,752828,722169,1474997
350620,201809,36,24,12,22896,11448,34344
350630,201809,242,139,103,131652.96,97309,228961.96
350635,201809,896,362,534,345062,508564.66,853626.66
350640,201809,120,88,32,83952,30528,114480
350650,201809,1899,1250,649,1187970.03,617697.53,1805667.56
350660,201809,745,333,412,317038.05,393044,710082.05
350670,201809,316,161,155,153165.2,147870,301035.2
350680,201809,177,94,83,89676,79182,168858
350690,201809,201,104,97,99216,92538,191754
350700,201809,747,360,387,340105.94,369198,709303.94
350710,201809,345,135,210,127581.56,200340,327921.56
350715,201809,55,44,11,41976,10494,52470
350720,201809,17,11,6,10494,5724,16218
350730,201809,41,25,16,23850,15264,39114
350740,201809,212,116,96,110654.46,91584,202238.46
350745,201809,18,9,9,8562,8586,17148
350750,201809,2159,1375,784,1303781.1,747299.96,2051081.06
350760,201809,3764,1636,2128,1558407.83,2026318.42,3584726.25
350770,201809,58,40,18,38160,17172,55332
350775,201809,48,35,13,33390,12393,45783
350780,201809,423,213,210,203202,200323,403525
350790,201809,363,156,207,148824,197478,346302
350800,201809,446,253,193,241362,184122,425484
350810,201809,522,420,102,399727,97308,497035
350820,201809,91,55,36,52470,34344,86814
350830,201809,82,46,36,43884,34344,78228
350840,201809,774,336,438,320305.5,416030.8,736336.3
350850,201809,1815,1054,761,999508.64,725953.46,1725462.10
350860,201809,599,352,247,331975.8,235638,567613.8
350870,201809,436,296,140,282384,133273.8,415657.8
350880,201809,285,155,130,145915.6,123352.2,269267.8
350890,201809,42,26,16,24804,15264,40068
350900,201809,1468,471,997,447867.93,950374.8,1398242.73
350910,201809,25,15,10,14310,9540,23850
350920,201809,613,340,273,324042.04,260155.8,584197.84
350925,201809,1206,647,559,614196.34,531569.4,1145765.74
350930,201809,96,59,37,56286,35298,91584
350940,201809,724,404,320,384175.8,303439.6,687615.4
350945,201809,103,76,27,71968,25758,97726
350950,201809,15745,7505,8240,7132120.23,7853626.14,14985746.37
350960,201809,1281,598,683,566860.16,651578,1218438.16
350970,201809,1103,591,512,559966.46,488152.46,1048118.92
350980,201809,92,64,28,61056,26712,87768
350990,201809,367,130,237,123066.72,226098,349164.72
350995,201809,33,16,17,15264,16218,31482
351000,201809,629,440,189,417536.07,180306,597842.07
351010,201809,48,29,19,27666,18126,45792
351015,201809,55,39,16,37206,15264,52470
351020,201809,1657,971,686,924910.45,652250,1577160.45
351030,201809,345,236,109,222282,103986,326268
351040,201809,853,456,397,435024,377784.66,812808.66
351050,201809,3321,1565,1756,1484438.1,1674848.3,3159286.4
351060,201809,5079,2084,2995,1976635.73,2853609.72,4830245.45
351070,201809,417,266,151,252496.96,144054,396550.96
351080,201809,800,576,224,549027,212742,761769
351090,201809,64,28,36,26712,34344,61056
351100,201809,451,264,187,249634.48,178393.23,428027.71
351110,201809,2115,1009,1106,957084.4,1052477.58,2009561.98
351120,201809,73,37,36,35298,34344,69642
351130,201809,176,59,117,56286,111331.8,167617.8
351140,201809,337,235,102,222949.84,97308,320257.84
351150,201809,420,221,199,209928.8,189846,399774.8
351160,201809,253,167,86,159032,82044,241076
351170,201809,188,100,88,95400,83189,178589
351190,201809,89,60,29,57240,27666,84906
351200,201809,371,245,126,233039.07,120204,353243.07
351210,201809,128,61,67,57939.38,63918,121857.38
351220,201809,537,324,213,305523.12,203202,508725.12
351230,201809,292,211,81,201294,77254.92,278548.92
351240,201809,232,99,133,94446,126882,221328
351250,201809,73,51,22,48430,20988,69418
351260,201809,152,111,41,105894,38828,144722
351270,201809,51,21,30,20034,28620,48654
351280,201809,1106,504,602,477956.46,573476.38,1051432.84
351290,201809,232,107,125,102078,118964,221042
351300,201809,3710,1747,1963,1659686.99,1872381,3532067.99
351310,201809,767,399,368,380646,350786,731432
351320,201809,112,68,44,64872,41976,106848
351330,201809,38,26,12,24804,11448,36252
351340,201809,1251,777,474,734934.93,450162.03,1185096.96
351350,201809,2563,1440,1123,1371233.2,1070760.06,2441993.26
351360,201809,792,392,400,373014,381282.04,754296.04
351370,201809,376,190,186,181255.23,176807.96,358063.19
351380,201809,8944,4055,4889,3853643.23,4653465.21,8507108.44
351385,201809,29,19,10,18126,9540,27666
351390,201809,283,210,73,200340,69642,269982
351400,201809,67,42,25,40068,23812.92,63880.92
351410,201809,445,276,169,262207.9,161226,423433.9
351420,201809,61,49,12,46746,11448,58194
351430,201809,71,39,32,37206,30528,67734
351440,201809,794,554,240,526321.76,228956,755277.76
351450,201809,258,129,129,123066,123066,246132
351460,201809,117,55,62,52470,59148,111618
351470,201809,137,71,66,66780,62964,129744
351480,201809,531,299,232,284006.96,221208.75,505215.71
351490,201809,284,105,179,100170,170766,270936
351492,201809,31,22,9,20988,8586,29574
351495,201809,27,18,9,17172,8586,25758
351500,201809,3560,1530,2030,1453585.33,1931994.41,3385579.74
351510,201809,1808,757,1051,721892,1000736.46,1722628.46
351512,201809,21,18,3,17172,2862,20034
351515,201809,197,113,84,107802,80136,187938
351518,201809,786,483,303,460778,289062,749840
351519,201809,74,48,26,45792,24804,70596
351520,201809,141,87,54,82361.96,51516,133877.96
351530,201809,23,15,8,14310,7632,21942
351535,201809,132,75,57,71550,54378,125928
351540,201809,455,326,129,308621,123066,431687
351550,201809,1323,801,522,759799.96,496070.86,1255870.82
351560,201809,73,39,34,37206,32417,69623
351565,201809,11,7,4,6678,3816,10494
351570,201809,2623,1365,1258,1299887.12,1199461.65,2499348.77
351580,201809,39,35,4,33390,3816,37206
351590,201809,69,46,23,43884,21942,65826
351600,201809,195,147,48,140238,45792,186030
351610,201809,58,29,29,27666,27666,55332
351620,201809,5935,3390,2545,3222396.21,2424559.87,5646956.08
351630,201809,2582,1341,1241,1274285.59,1181293.88,2455579.47
351640,201809,1688,827,861,786912.03,817435.8,1604347.83
351650,201809,34,29,5,27666,4770,32436
351660,201809,155,101,54,96354,51516,147870
351670,201809,736,454,282,430780,269028,699808
351680,201809,72,59,13,56286,12402,68688
351685,201809,39,25,14,23850,13356,37206
351690,201809,311,218,93,206107.28,88722,294829.28
351700,201809,160,113,47,107802,44838,152640
351710,201809,75,52,23,49608,21942,71550
351720,201809,128,61,67,58194,63918,122112
351730,201809,99,70,29,65826.96,27661.23,93488.19
351740,201809,724,487,237,462690.96,226093.23,688784.19
351750,201809,360,149,211,141510,201008,342518
351760,201809,782,604,178,576216,169812,746028
351770,201809,302,256,46,244224,43884,288108
351780,201809,169,97,72,92529,68688,161217
351790,201809,247,130,117,124020,111618,235638
351800,201809,50,32,18,30528,17172,47700
351810,201809,124,83,41,79182,39114,118296
351820,201809,873,629,244,594344.6,232485.23,826829.83
351830,201809,517,185,332,175726.8,316728,492454.8
351840,201809,1900,966,934,913382.4,889534.94,1802917.34
351850,201809,231,171,60,162514.8,57240,219754.8
351860,201809,743,503,240,473028.8,228669.23,701698.03
351870,201809,5633,2681,2952,2547499.84,2808315.98,5355815.82
351880,201809,18905,8226,10679,7826943.77,10173344.3,18000288.07
351885,201809,92,61,31,57479,29574,87053
351890,201809,68,57,11,54378,10494,64872
351900,201809,227,134,93,127169,88722,215891
351905,201809,81,33,48,31482,45792,77274
351907,201809,3199,1406,1793,1338103.06,1708157.6,3046260.66
351910,201809,179,74,105,70596,100170,170766
351920,201809,132,75,57,71550,54355.69,125905.69
351925,201809,88,60,28,57240,26712,83952
351930,201809,385,256,129,244128.6,123066,367194.6
351940,201809,239,107,132,102078,125928,228006
351950,201809,142,83,59,79182,56286,135468
351960,201809,883,415,468,395728.73,444490.26,840218.99
351970,201809,1942,1046,896,995737.84,854203,1849940.84
351980,201809,153,77,76,71550,72504,144054
351990,201809,272,183,89,173628,84104.64,257732.64
352000,201809,365,227,138,216272,131652,347924
352010,201809,371,229,142,218466,134991,353457
352020,201809,202,71,131,67734,124974,192708
352030,201809,1042,540,502,514444.5,478271.96,992716.46
352040,201809,580,251,329,239454,313866,553320
352042,201809,282,97,185,92538,176490,269028
352044,201809,378,223,155,211873.86,147870,359743.86
352050,201809,3315,1323,1992,1255355.18,1898832.26,3154187.44
352060,201809,106,66,40,62964,37874,100838
352070,201809,102,74,28,69326,26712,96038
352080,201809,69,43,26,40068,24804,64872
352090,201809,174,117,57,111618,54378,165996
352100,201809,269,130,139,123730,131454,255184
352110,201809,112,33,79,31482,75366,106848
352115,201809,69,25,44,23850,41976,65826
352120,201809,96,66,30,61724,28620,90344
352130,201809,224,185,39,176490,37206,213696
352140,201809,187,79,108,74889,102746,177635
352150,201809,121,67,54,62964.04,51516,114480.04
352160,201809,130,84,46,80136,43884,124020
352170,201809,373,258,115,245178.04,109710,354888.04
352180,201809,620,418,202,397151.5,192704,589855.5
352190,201809,262,102,160,97298.46,152601.84,249900.30
352200,201809,32,17,15,16218,14310,30528
352210,201809,3882,1624,2258,1540718.87,2147785.59,3688504.46
352215,201809,55,30,25,28620,23392.08,52012.08
352220,201809,7003,2739,4264,2607935.44,4065069.19,6673004.63
352230,201809,3262,2084,1178,1974689.13,1119205.45,3093894.58
352240,201809,2260,1308,952,1245638.69,905911.08,2151549.77
352250,201809,2610,1348,1262,1280860.16,1199912.57,2480772.73
352260,201809,1048,565,483,537756.23,460496,998252.23
352265,201809,59,25,34,23850,32436,56286
352270,201809,418,240,178,228006.92,169756,397762.92
352280,201809,424,267,157,253447,149773.23,403220.23
352290,201809,173,109,64,103986,61056,165042
352300,201809,100,75,25,71550,23850,95400
352310,201809,5788,2805,2983,2662192.64,2840565.64,5502758.28
352320,201809,966,508,458,481137.84,434881.1,916018.94
352330,201809,521,247,274,235304.1,261110,496414.1
352340,201809,1399,685,714,651315,678152.5,1329467.5
352350,201809,336,209,127,199386,120872,320258
352360,201809,233,98,135,92585.7,126193.52,218779.22
352370,201809,102,69,33,65826,31482,97308
352380,201809,119,71,48,67734,45792,113526
352390,201809,2493,1132,1361,1076380.32,1295706.36,2372086.68
352400,201809,482,206,276,195808.5,263017.8,458826.3
352410,201809,795,569,226,538032.72,215604,753636.72
352420,201809,108,70,38,66780,36252,103032
352430,201809,1771,791,980,749561.84,931684.3,1681246.14
352440,201809,3191,1623,1568,1537835.48,1493924.67,3031760.15
352450,201809,195,161,34,153594,32436,186030
352460,201809,585,297,288,282780.68,274037.2,556817.88
352470,201809,636,221,415,210830,395901,606731
352480,201809,1364,766,598,728855.92,570206,1299061.92
352490,201809,84,31,53,29574,50562,80136
352500,201809,1205,535,670,508864.6,638695,1147559.6
352510,201809,755,412,343,392094.96,327222,719316.96
352520,201809,579,256,323,244224,307998.9,552222.9
352530,201809,1722,902,820,860508,781898.6,1642406.6
352540,201809,74,49,25,46746,23850,70596
352550,201809,184,107,77,102078,72790.2,174868.2
352560,201809,51,41,10,39114,9540,48654
352570,201809,670,346,324,329767,309076.92,638843.92
352580,201809,62,43,19,40068.65,18126,58194.65
352585,201809,17,6,11,5724,10494,16218
352590,201809,4404,2240,2164,2130037.11,2062485.98,4192523.09
352600,201809,355,247,108,234446.46,103032,337478.46
352610,201809,951,429,522,407291.33,497988,905279.33
352620,201809,960,396,564,376830.2,537420,914250.2
352630,201809,168,64,104,61056,99206.46,160262.46
352640,201809,562,392,170,371670.02,162180,533850.02
352650,201809,89,59,30,56286,28620,84906
352660,201809,82,48,34,45792,32436,78228
352670,201809,1690,915,775,870379.89,738242.29,1608622.18
352680,201809,908,583,325,552300.68,308588.04,860888.72
352690,201809,4477,2068,2409,1964138.8,2295595.25,4259734.05
352700,201809,111,67,44,63631.8,41976,105607.8
352710,201809,1342,719,623,683731.8,591667.6,1275399.4
352720,201809,1356,651,705,618796.2,671993.03,1290789.23
352725,201809,25,23,2,21942,1908,23850
352730,201809,378,192,186,181989.81,177444,359433.81
352740,201809,425,273,152,258487.68,145008,403495.68
352750,201809,23,15,8,14023.8,7632,21655.8
352760,201809,198,142,56,135468,53424,188892
352770,201809,81,64,17,61056,16218,77274
352780,201809,80,44,36,41976,34344,76320
352790,201809,32,26,6,24804,5724,30528
352800,201809,248,173,75,165042,71263.8,236305.8
352810,201809,170,113,57,105291.42,54378,159669.42
352820,201809,63,50,13,47274.52,12402,59676.52
352830,201809,92,63,29,60102,27666,87768
352840,201809,634,329,305,312960.2,290970,603930.2
352850,201809,1384,488,896,464884.2,854147.96,1319032.16
352860,201809,134,89,45,84270,42930,127200
352870,201809,46,30,16,28620,15264,43884
352880,201809,190,128,62,122092.92,59148,181240.92
352885,201809,29,21,8,20034,7632,27666
352890,201809,58,40,18,38160,16886,55046
352900,201809,4837,2334,2503,2208611.03,2380125.17,4588736.20
352910,201809,39,32,7,30528,6678,37206
352920,201809,695,426,269,405450,256626,662076
352930,201809,1250,609,641,578886.82,608839.18,1187726.00
352940,201809,6442,2744,3698,2606778.32,3524396.17,6131174.49
352950,201809,96,39,57,37206,54378,91584
352960,201809,62,41,21,39114,20034,59148
352965,201809,19,8,11,7632,10494,18126
352970,201809,487,370,117,348740.15,110665,459405.15
352980,201809,176,94,82,89676,77942,167618
352990,201809,983,433,550,412099.38,523632.2,935731.58
353000,201809,71,33,38,31482,36252,67734
353010,201809,555,339,216,323406,206044.92,529450.92
353020,201809,285,208,77,198432,73458,271890
353030,201809,1232,562,670,534362.17,638493.66,1172855.83
353040,201809,92,56,36,53424,34344,87768
353050,201809,1335,852,483,807458.02,460495.8,1267953.82
353060,201809,8088,3639,4449,3457376.09,4238103.07,7695479.16
353070,201809,1665,1066,599,1011013.46,569985.56,1580999.02
353080,201809,1337,716,621,681013.55,591476,1272489.55
353090,201809,56,33,23,31482,21942,53424
353100,201809,61,50,11,47700,10494,58194
353110,201809,2048,631,1417,600243.54,1348895.46,1949139.00
353120,201809,83,44,39,41976,37206,79182
353130,201809,868,431,437,409088.63,416785.68,825874.31
353140,201809,575,232,343,221267,327222,548489
353150,201809,359,203,156,192708,148814.46,341522.46
353160,201809,101,82,19,78228,18126,96354
353170,201809,196,65,131,62010,124946.46,186956.46
353180,201809,962,443,519,420328.49,494602,914930.49
353190,201809,495,357,138,339522.9,131366,470888.9
353200,201809,201,106,95,101124,90630,191754
353205,201809,27,20,7,19080,6678,25758
353210,201809,86,53,33,50562,31482,82044
353215,201809,54,31,23,29574,21942,51516
353220,201809,84,47,37,44838,34344.27,79182.27
353230,201809,156,63,93,60102,88722,148824
353240,201809,300,164,136,156456,129744,286200
353250,201809,206,107,99,102078,94446,196524
353260,201809,466,333,133,316538.5,126872.46,443410.96
353270,201809,66,48,18,45792,16504.2,62296.2
353280,201809,94,50,44,47510,41976,89486
353282,201809,127,91,36,86814,34344,121158
353284,201809,25,20,5,19080,4770,23850
353286,201809,1,1,0,954,0,954
353290,201809,79,44,35,41976,33381,75357
353300,201809,417,234,183,220454.42,174582,395036.42
353310,201809,52,45,7,42930,6678,49608
353320,201809,63,39,24,37206,22896,60102
353325,201809,58,35,23,33381,21638,55019
353330,201809,67,50,17,47557,16218,63775
353340,201809,626,208,418,197749.89,398191.03,595940.92
353350,201809,907,429,478,408285.18,455041,863326.18
353360,201809,109,88,21,83634.04,19748,103382.04
353370,201809,123,69,54,65826,51516,117342
353380,201809,27,18,9,17168,8586,25754
353390,201809,1113,531,582,506574,555228,1061802
353400,201809,48,30,18,28620,17172,45792
353410,201809,113,71,42,67734,40021,107755
353420,201809,60,25,35,23850,33390,57240
353430,201809,571,379,192,357845.55,182881.8,540727.35
353440,201809,10344,4515,5829,4297177.31,5553820.41,9850997.72
353450,201809,55,31,24,29574,22896,52470
353460,201809,616,340,276,322144.83,262588.5,584733.33
353470,201809,2129,1155,974,1097922.62,927744.23,2025666.85
353475,201809,238,159,79,148999.6,75366,224365.6
353480,201809,188,153,35,145962,33390,179352
353490,201809,237,141,96,134514,91584,226098
353500,201809,190,110,80,103986.96,76320,180306.96
353510,201809,100,73,27,69623.46,25748.46,95371.92
353520,201809,201,137,64,130698,61056,191754
353530,201809,465,249,216,237546,206064,443610
353540,201809,365,242,123,230545.27,117342,347887.27
353550,201809,737,497,240,470224.86,228960,699184.86
353560,201809,633,268,365,254106.69,347609.52,601716.21
353570,201809,62,32,30,30528,28620,59148
353580,201809,354,275,79,261873,75366,337239
353590,201809,87,59,28,55968.04,26712,82680.04
353600,201809,269,152,117,144691,110982,255673
353610,201809,115,61,54,57876.04,51516,109392.04
353620,201809,582,310,272,295423,259201.8,554624.8
353625,201809,49,29,20,27666,19080,46746
353630,201809,245,176,69,164527.56,65826,230353.56
353640,201809,127,84,43,79659,41022,120681
353650,201809,904,355,549,336571.2,523746,860317.2
353657,201809,24,18,6,17172,5724,22896
353660,201809,255,141,114,134514,108756,243270
353670,201809,775,459,316,436932.2,301464,738396.2
353680,201809,102,72,30,68450,28620,97070
353690,201809,44,35,9,33116,8586,41702
353700,201809,278,198,80,188892,76320,265212
353710,201809,452,213,239,202248.8,227720,429968.8
353715,201809,46,33,13,31195.8,12402,43597.8
353720,201809,357,165,192,157401,183168,340569
353730,201809,1107,681,426,647718.9,405445.23,1053164.13
353740,201809,656,359,297,341913.6,283338,625251.6
353750,201809,89,55,34,51938.14,32436,84374.14
353760,201809,2799,1062,1737,1011089.88,1653495.28,2664585.16
353770,201809,96,79,17,74889,16218,91107
353780,201809,1190,583,607,554178.96,577170,1131348.96
353790,201809,509,296,213,280315.5,200603.35,480918.85
353800,201809,3273,1674,1599,1588804.41,1523934.96,3112739.37
353810,201809,231,132,99,125055.63,94437,219492.63
353820,201809,197,96,101,91584,95729.41,187313.41
353830,201809,47,40,7,38160,6678,44838
353850,201809,168,88,80,83952,76320,160272
353860,201809,483,218,265,207256.5,252428.4,459684.9
353870,201809,5205,2624,2581,2486591.73,2451951.43,4938543.16
353880,201809,687,493,194,468986.4,184122.12,653108.52
353890,201809,585,329,256,313532.3,243938,557470.3
353900,201809,135,66,69,62964,65826,128790
353910,201809,176,86,90,82044,85860,167904
353920,201809,450,246,204,233492.4,194173.16,427665.56
353930,201809,1031,612,419,582155.79,398954.48,981110.27
353940,201809,186,101,85,95590.8,80232,175822.8
353950,201809,526,322,204,306202.8,194607,500809.8
353960,201809,70,57,13,54378,12402,66780
353970,201809,76,44,32,41976,30528,72504
353980,201809,1546,755,791,717896.95,753675.76,1471572.71
353990,201809,74,42,32,40068,30528,70596
354000,201809,369,183,186,173915,177249.2,351164.2
354010,201809,93,52,41,49608,38637,88245
354020,201809,549,352,197,334854,187938,522792
354025,201809,51,40,11,38160,10494,48654
354030,201809,65,37,28,35298,26712,62010
354040,201809,96,68,28,64490.4,26712,91202.4
354050,201809,194,105,89,99884,84906,184790
354060,201809,750,364,386,347256,366003.4,713259.4
354070,201809,886,516,370,490633.03,352980,843613.03
354075,201809,218,115,103,109424,97308.8,206732.8
354080,201809,293,127,166,120871.8,158364,279235.8
354085,201809,18,11,7,10494,6678,17172
354090,201809,319,178,141,169731,134514,304245
354100,201809,5671,2405,3266,2282973.46,3109654.05,5392627.51
354105,201809,87,42,45,40068,42930,82998
354110,201809,49,22,27,20988,25758,46746
354120,201809,143,100,43,95260.97,41022,136282.97
354130,201809,702,469,233,447188,221992,669180
354140,201809,3167,1477,1690,1406350.81,1610915.63,3017266.44
354150,201809,656,409,247,387687.04,234207,621894.04
354160,201809,726,464,262,441463.5,249662,691125.5
354165,201809,23,14,9,13356,8586,21942
354170,201809,181,122,59,115720.2,56286,172006.2
354180,201809,69,43,26,40696,24804,65500
354190,201809,211,97,114,90916.2,108756,199672.2
354200,201809,130,71,59,67257,56286,123543
354210,201809,66,33,33,31482,31482,62964
354220,201809,635,394,241,375876,228674.35,604550.35
354230,201809,161,67,94,63918,88722.6,152640.6
354240,201809,319,208,111,197478.49,105894,303372.49
354250,201809,90,54,36,51516,34344,85860
354260,201809,1999,940,1059,885731.84,1007706.67,1893438.51
354270,201809,95,70,25,66780,23850,90630
354280,201809,41,22,19,20988,18126,39114
354290,201809,143,99,44,93635.1,41976,135611.1
354300,201809,419,285,134,271573,127678,399251
354310,201809,100,73,27,68688.2,25758,94446.2
354320,201809,185,99,86,94446,82044,176490
354323,201809,16,14,2,13356,1908,15264
354325,201809,110,64,46,60250,43884,104134
354330,201809,2645,886,1759,840323.26,1675819.81,2516143.07
354340,201809,10622,5223,5399,4971353.83,5143710.73,10115064.56
354350,201809,125,82,43,78228,40878.9,119106.9
354360,201809,90,50,40,47700,38160,85860
354370,201809,266,148,118,141192,112572,253764
354380,201809,210,124,86,117510,82044,199554
354390,201809,2796,1014,1782,964846.16,1698505.81,2663351.97
354400,201809,336,176,160,167904,152068,319972
354410,201809,615,294,321,278850.43,305280.2,584130.63
354420,201809,279,176,103,167904,98262,266166
354425,201809,308,181,127,172674,121158,293832
354430,201809,189,119,70,111951.9,66016.8,177968.7
354440,201809,40,28,12,26712,11448,38160
354450,201809,50,36,14,34344,13356,47700
354460,201809,103,60,43,57240,41022,98262
354470,201809,40,27,13,25758,12402,38160
354480,201809,115,58,57,55323,54368.46,109691.46
354490,201809,142,88,54,83792.97,51516,135308.97
354500,201809,395,197,198,187938,188892,376830
354510,201809,103,72,31,68688,29574,98262
354515,201809,39,14,25,13356,23850,37206
354520,201809,1633,712,921,677967.4,878195.56,1556162.96
354530,201809,678,355,323,336948.8,307284.2,644233.0
354540,201809,280,156,124,148824,118291.23,267115.23
354550,201809,44,27,17,25758,16218,41976
354560,201809,157,88,69,83666,65816.46,149482.46
354570,201809,131,86,45,82044,42930,124974
354580,201809,1978,936,1042,889730.96,993482.26,1883213.22
354600,201809,266,149,117,139932.92,111603.69,251536.61
354610,201809,73,64,9,60103,8577,68680
354620,201809,61,18,43,17172,41022,58194
354625,201809,19,12,7,11448,6674,18122
354630,201809,318,214,104,203781.34,99216,302997.34
354640,201809,803,522,281,493776.16,268074,761850.16
354650,201809,75,43,32,41013,30499.92,71512.92
354660,201809,811,603,208,571240.46,198432,769672.46
354670,201809,274,99,175,93254,165997,259251
354680,201809,1275,484,791,461736,754137,1215873
354690,201809,84,54,30,50563,28620,79183
354700,201809,75,54,21,51516,20034,71550
354710,201809,58,40,18,37523.96,17172,54695.96
354720,201809,20,19,1,18126,954,19080
354730,201809,1855,794,1061,754558.2,1012003.2,1766561.4
354740,201809,62,43,19,41022,18126,59148
354750,201809,432,257,175,245169,166950,412119
354760,201809,515,316,199,298903,189560,488463
354765,201809,12,5,7,4770,6678,11448
354770,201809,345,227,118,215734.03,112572,328306.03
354780,201809,8176,3333,4843,3167394.65,4616381.18,7783775.83
354790,201809,112,65,47,62010,44838,106848
354800,201809,439,240,199,228960,189540.92,418500.92
354805,201809,103,51,52,48018,49608,97626
354810,201809,132,76,56,72504,53424,125928
354820,201809,187,80,107,76111,102078,178189
354830,201809,41,23,18,21942,17172,39114
354840,201809,59,40,19,38160,18126,56286
354850,201809,4636,2082,2554,1979251.59,2432706.54,4411958.13
354860,201809,326,160,166,152640,156256.52,308896.52
354870,201809,12146,5478,6668,5199044.01,6351873.64,11550917.65
354880,201809,3081,1162,1919,1106624.26,1829412.83,2936037.09
354890,201809,2916,1612,1304,1530939.93,1243033.38,2773973.31
354900,201809,59,38,21,36252,20034,56286
354910,201809,1243,655,588,621302.24,560952,1182254.24
354920,201809,50,42,8,40068,7632,47700
354925,201809,14,8,6,7632,5724,13356
354930,201809,31,28,3,26442,2862,29304
354940,201809,825,611,214,580066.69,204156,784222.69
354950,201809,216,144,72,136709,68688,205397
354960,201809,163,64,99,61056,94160,155216
354970,201809,894,590,304,558000.14,289377.02,847377.16
354980,201809,8525,3136,5389,2984595.35,5138396.33,8122991.68
354990,201809,9130,4345,4785,4130634.61,4558140.3,8688774.91
354995,201809,531,186,345,177444,328815.18,506259.18
355000,201809,488,167,321,159313.23,305995.5,465308.73
355010,201809,621,389,232,371106,219116.48,590222.48
355020,201809,728,458,270,435973.59,257572,693545.59
355030,201809,207804,80827,126977,76871085.27,121036513.65,197907598.92
355040,201809,732,344,388,326125.6,369961.2,696086.8
355050,201809,150,101,49,95083.77,46746,141829.77
355060,201809,1583,793,790,751672.94,752468.3,1504141.24
355070,201809,1447,707,740,670807.16,705634,1376441.16
355080,201809,200,114,86,108756,81156.8,189912.8
355090,201809,297,193,104,182024,98263,280287
355100,201809,4923,2429,2494,2295521.9,2375915.29,4671437.19
355110,201809,271,173,98,164085,93492,257577
355120,201809,83,59,24,56286,22887,79173
355130,201809,54,31,23,29574,21942,51516
355140,201809,184,123,61,116626.5,58194,174820.5
355150,201809,695,416,279,395620,265689,661309
355160,201809,467,223,244,210357.96,232776,443133.96
355170,201809,2076,1090,986,1038594.94,938925.65,1977520.59
355180,201809,624,270,354,256626,336881.25,593507.25
355190,201809,222,152,70,145008,66780,211788
355200,201809,121,69,52,65826,49608,115434
355210,201809,724,406,318,387324,303353.46,690677.46
355220,201809,6869,3664,3205,3484275.06,3046021.1,6530296.16
355230,201809,109,65,44,61437.6,41971.23,103408.83
355240,201809,4434,1910,2524,1809887.12,2403758.11,4213645.23
355250,201809,5461,2621,2840,2494679.22,2705951.56,5200630.78
355255,201809,50,31,19,29574,18126,47700
355260,201809,185,111,74,104921.12,70568.46,175489.58
355270,201809,168,99,69,94446,65111,159557
355280,201809,6421,2691,3730,2561725.66,3554386.46,6116112.12
355290,201809,75,58,17,55332,16218,71550
355300,201809,190,121,69,114480.8,65540,180020.8
355310,201809,105,59,46,56286,43884,100170
355320,201809,89,49,40,46746,37212.6,83958.6
355330,201809,278,155,123,147870,117342,265212
355340,201809,1602,544,1058,516369.81,1008303.97,1524673.78
355350,201809,139,72,67,68688,63918,132606
355360,201809,180,115,65,109500.12,62010,171510.12
355365,201809,25,20,5,19080,4770,23850
355370,201809,1041,599,442,565569.74,420409.01,985978.75
355380,201809,790,520,270,495488.52,257166.6,752655.12
355385,201809,66,46,20,43884,19080,62964
355390,201809,103,62,41,59148,39114,98262
355395,201809,183,111,72,104793.23,68688,173481.23
355400,201809,1586,975,611,926151.52,580223,1506374.52
355410,201809,4926,2352,2574,2226660.84,2447205.92,4673866.76
355420,201809,50,37,13,35298,12402,47700
355430,201809,354,213,141,201866.4,134514,336380.4
355440,201809,83,50,33,47700,31482,79182
355450,201809,457,226,231,213125.14,219420.2,432545.34
355460,201809,68,52,16,48654.42,15264,63918.42
355465,201809,52,33,19,31482,18126,49608
355470,201809,182,74,108,69642.1,103032,172674.1
355475,201809,13,8,5,7632,4770,12402
355480,201809,466,206,260,195580.34,247372.2,442952.54
355490,201809,116,82,34,78228,32436,110664
355495,201809,54,26,28,24804,26712,51516
355500,201809,1647,923,724,874967.23,690664.69,1565631.92
355510,201809,272,199,73,185434.63,69642,255076.63
355520,201809,30,23,7,21656,6678,28334
355530,201809,25,18,7,17172,6678,23850
355535,201809,82,39,43,37206,41022,78228
355540,201809,2386,952,1434,906749.53,1367073.96,2273823.49
355550,201809,67,41,26,39114,24804,63918
355560,201809,244,121,123,115434,116705.96,232139.96
355570,201809,29,19,10,18126,9540,27666
355580,201809,265,181,84,172674,79846,252520
355590,201809,24,15,9,14310,8586,22896
355600,201809,271,140,131,133560,124683.23,258243.23
355610,201809,227,151,76,144054,72504,216558
355620,201809,1333,639,694,609298.11,661566.38,1270864.49
355630,201809,423,310,113,295740,106848.96,402588.96
355635,201809,125,59,66,56286,62951,119237
355640,201809,575,327,248,311004.16,236592,547596.16
355645,201809,843,363,480,344823.3,456040.82,800864.12
355650,201809,2143,907,1236,861055.6,1179125.46,2040181.06
355660,201809,256,138,118,131652,112572,244224
355670,201809,509,204,305,193980,290683.8,484663.8
355680,201809,206,117,89,110665,84238.2,194903.2
355690,201809,88,41,47,39114,44494,83608
355695,201809,14,11,3,10494,2862,13356
355700,201809,1139,588,551,555529.62,524795.8,1080325.42
355710,201809,2230,1220,1010,1160310.46,963349.2,2123659.66
355715,201809,19,17,2,16218,1908,18126
355720,201809,206,125,81,117660.08,77274,194934.08
355730,201809,96,56,40,52549.95,38160,90709.95
410010,201809,134,113,21,107802,20034,127836
410020,201809,107,94,13,89676,12402,102078
410030,201809,163,104,59,98549,56286,154835
410040,201809,987,543,444,517079.44,423386,940465.44
410045,201809,29,24,5,22896,4770,27666
410050,201809,476,267,209,254718,198909,453627
410060,201809,278,214,64,204156,61056,265212
410070,201809,310,257,53,245178,50562,295740
410080,201809,164,106,58,101124,55332,156456
410090,201809,72,64,8,60847,7632,68479
410100,201809,298,215,83,204900.12,79086.6,283986.72
410105,201809,48,29,19,27666,18126,45792
410110,201809,322,195,127,186030,121158,307188
410115,201809,31,21,10,20034,9540,29574
410120,201809,429,222,207,211501.8,197478,408979.8
410130,201809,46,29,17,27666,16218,43884
410140,201809,3134,1535,1599,1457367.8,1520295.4,2977663.2
410150,201809,2716,1099,1617,1047007.24,1542021.8,2589029.04
410160,201809,499,315,184,300223.8,175536,475759.8
410165,201809,66,44,22,41976,20988,62964
410170,201809,169,123,46,115917,43884,159801
410180,201809,2150,1252,898,1189313.19,855520.95,2044834.14
410185,201809,34,30,4,28620,3816,32436
410190,201809,491,321,170,305470.8,162180,467650.8
410200,201809,971,726,245,691754.94,233730,925484.94
410210,201809,567,299,268,284644.98,255386,540030.98
410220,201809,43,22,21,20988,20012.12,41000.12
410230,201809,129,69,60,65826,57240,123066
410240,201809,732,480,252,457347.8,240408,697755.8
410250,201809,367,272,95,258883.84,90625.23,349509.07
410260,201809,302,178,124,169812,118296,288108
410270,201809,30,19,11,18126,10494,28620
410275,201809,62,45,17,42930,16218,59148
410280,201809,329,191,138,181954.52,131652,313606.52
410290,201809,238,150,88,143100,82998,226098
410300,201809,80,63,17,60102,16218,76320
410302,201809,25,16,9,15264,8586,23850
410304,201809,44,31,13,29574,12402,41976
410305,201809,215,119,96,112858.2,91584,204442.2
410310,201809,262,167,95,159318,90610.92,249928.92
410315,201809,49,35,14,33366,13356,46722
410320,201809,138,96,42,91584,40068,131652
410322,201809,34,24,10,22896,9540,32436
410330,201809,170,121,49,115434,46556,161990
410335,201809,100,61,39,58194,37206,95400
410337,201809,39,34,5,32436,4770,37206
410340,201809,31,29,2,27666,1908,29574
410345,201809,220,140,80,132959,76320,209279
410347,201809,52,39,13,37206,12402,49608
410350,201809,230,139,91,132606,86814,219420
410360,201809,467,285,182,269346.4,173056,442402.4
410370,201809,2401,1029,1372,979283.32,1306298.82,2285582.14
410380,201809,223,141,82,134514,78228,212742
410390,201809,372,275,97,262346,92538,354884
410395,201809,35,23,12,21942,11067,33009
410400,201809,835,423,412,402213.2,391698.1,793911.3
410405,201809,96,74,22,70596,20988,91584
410410,201809,37,28,9,26712,8586,35298
410420,201809,1646,823,823,782947.89,783552.96,1566500.85
410425,201809,176,82,94,78038,89676,167714
410430,201809,2199,1294,905,1230374.74,862492.32,2092867.06
410440,201809,384,285,99,271890,94446,366336
410442,201809,357,241,116,228961,110664,339625
410445,201809,416,293,123,279522,117342,396864
410450,201809,394,205,189,195570,180306,375876
410460,201809,456,243,213,231240.06,203202,434442.06
410465,201809,199,125,74,118009.8,70596,188605.8
410470,201809,231,148,83,141192,79182,220374
410480,201809,5957,2952,3005,2797387.98,2860654.56,5658042.54
410490,201809,1400,917,483,873321,458388.85,1331709.85
410500,201809,271,156,115,148824,109710,258534
410510,201809,176,129,47,123066,44829,167895
410520,201809,252,189,63,180306,60102,240408
410530,201809,237,88,149,83952,142142,226094
410540,201809,314,226,88,214805.99,83947.23,298753.22
410550,201809,1669,737,932,702811.8,887928.36,1590740.16
410560,201809,130,100,30,95400,28620,124020
410570,201809,432,299,133,283158.2,126882,410040.2
410580,201809,3165,1432,1733,1364192.8,1652806,3016998.8
410590,201809,404,284,120,270936,114480,385416
410600,201809,190,162,28,154548,26712,181260
410610,201809,57,46,11,43884,10494,54378
410620,201809,237,174,63,165996,60102,226098
410630,201809,441,257,184,245178,175536,420714
410640,201809,1018,639,379,605789.27,359959.28,965748.55
410645,201809,102,76,26,72123,24804,96927
410650,201809,370,252,118,239454,112572,352026
410655,201809,77,59,18,56286,17172,73458
410657,201809,43,18,25,17172,23850,41022
410660,201809,606,429,177,407737,168858,576595
410670,201809,75,63,12,60102,11448,71550
410680,201809,196,163,33,154834.2,31482,186316.2
410685,201809,15,10,5,9540,4770,14310
410690,201809,28148,12281,15867,11695540.88,15124681.24,26820222.12
410700,201809,331,244,87,232490,82998,315488
410710,201809,125,103,22,98262,20988,119250
410712,201809,20,14,6,13356,5724,19080
410715,201809,85,63,22,60102,20988,81090
410720,201809,609,365,244,348210,232767,580977
410725,201809,175,127,48,121158,45792,166950
410730,201809,85,54,31,51516,29574,81090
410740,201809,113,82,31,78228,29574,107802
410750,201809,220,161,59,153594,56281.23,209875.23
410752,201809,25,16,9,15264,8586,23850
410753,201809,52,22,30,20315.43,28620,48935.43
410754,201809,38,21,17,19748,16218,35966
410755,201809,80,55,25,51897.6,23850,75747.6
410760,201809,725,413,312,393667.12,297648,691315.12
410765,201809,1657,804,853,760670.8,812608.26,1573279.06
410770,201809,105,83,22,79182,20988,100170
410773,201809,53,39,14,37206,13356,50562
410775,201809,178,137,41,130030.2,39114,169144.2
410780,201809,80,44,36,41976,34344,76320
410785,201809,54,43,11,41022,10494,51516
410790,201809,73,34,39,32436,37206,69642
410800,201809,291,182,109,172675,103986,276661
410810,201809,23,19,4,18126,3530,21656
410820,201809,181,133,48,126739,45792,172531
410830,201809,8466,3824,4642,3638286.74,4425941.14,8064227.88
410832,201809,102,69,33,65826,31482,97308
410840,201809,1431,802,629,762840.08,599152.48,1361992.56
410845,201809,65,42,23,39782,21942,61724
410850,201809,195,136,59,128949.52,56286,185235.52
410855,201809,53,46,7,43884,6678,50562
410860,201809,673,395,278,375876.76,265212,641088.76
410865,201809,104,82,22,78228,20988,99216
410870,201809,160,134,26,127836,24804,152640
410880,201809,1126,565,561,538343.82,535130,1073473.82
410890,201809,82,56,26,53424,24804,78228
410895,201809,73,56,17,53424,16218,69642
410900,201809,21,13,8,12402,7632,20034
410910,201809,15,13,2,12402,1908,14310
410920,201809,34,22,12,20988,11448,32436
410930,201809,510,328,182,312700.98,173628,486328.98
410940,201809,4319,2554,1765,2426239.6,1680546.4,4106786.0
410950,201809,113,85,28,81090,26712,107802
410960,201809,769,345,424,329130,404306,733436
410965,201809,69,53,16,50275.8,15264,65539.8
410970,201809,630,455,175,433602.2,166950,600552.2
410975,201809,110,65,45,61499,42930,104429
410980,201809,1608,726,882,688817.62,838943.6,1527761.22
410990,201809,268,183,85,174582,80803.8,255385.8
411000,201809,64,39,25,37206,23564,60770
411005,201809,23,18,5,17172,4770,21942
411007,201809,245,139,106,132319.8,101124,233443.8
411010,201809,577,404,173,385416,165042,550458
411020,201809,291,200,91,190800,86814,277614
411030,201809,19,9,10,8586,9540,18126
411040,201809,51,36,15,34344,14310,48654
411050,201809,223,173,50,164427.72,47573.12,212000.84
411060,201809,511,343,168,327213,160272,487485
411065,201809,66,57,9,54378,8586,62964
411070,201809,1215,799,416,756386.31,396864,1153250.31
411080,201809,233,165,68,157410,64872,222282
411090,201809,113,85,28,81090,26712,107802
411095,201809,275,112,163,106848,155492,262340
411100,201809,113,93,20,88722,19080,107802
411110,201809,121,85,36,81090,34344,115434
411120,201809,189,139,50,132606,47700,180306
411125,201809,192,90,102,85211.28,97260.3,182471.58
411130,201809,126,107,19,101440,18126,119566
411140,201809,192,131,61,124952.12,57669.3,182621.42
411150,201809,1225,815,410,776832.66,391140,1167972.66
411155,201809,124,84,40,80136,38160,118296
411160,201809,20,8,12,7632,11448,19080
411170,201809,54,49,5,46459.8,4770,51229.8
411180,201809,972,649,323,616666.2,308137.23,924803.43
411190,201809,340,194,146,184408.2,139284,323692.2
411200,201809,676,443,233,421351.89,221262.18,642614.07
411210,201809,694,379,315,360016.21,300510,660526.21
411220,201809,147,110,37,104940,35298,140238
411230,201809,40,36,4,34344,3816,38160
411240,201809,125,86,39,82044,37206,119250
411250,201809,430,315,115,300510,109710,410220
411260,201809,20,13,7,12402,6678,19080
411270,201809,292,158,134,150732,127836,278568
411275,201809,206,182,24,172912.6,22896,195808.6
411280,201809,226,159,67,151369,63918,215287
411290,201809,57,42,15,40068,14310,54378
411295,201809,150,117,33,111618,31482,143100
411300,201809,69,34,35,32436,33390,65826
411310,201809,92,71,21,67734,20034,87768
411320,201809,745,537,208,510667.75,196829.28,707497.03
411325,201809,43,26,17,24804,16218,41022
411330,201809,921,592,329,562765.61,313126.06,875891.67
411340,201809,27,18,9,17172,8272,25444
411342,201809,70,54,16,51516,15264,66780
411345,201809,126,63,63,60102,60102,120204
411350,201809,492,390,102,370581.64,97013,467594.64
411360,201809,54,34,20,32436,19080,51516
411370,201809,14320,5861,8459,5570097.79,8054100.14,13624197.93
411373,201809,180,133,47,126882,44838,171720
411375,201809,70,59,11,56286,10494,66780
411380,201809,94,72,22,68688,20988,89676
411390,201809,133,90,43,85860,41022,126882
411400,201809,359,270,89,257571,84906,342477
411410,201809,443,231,212,219706.2,201962,421668.2
411420,201809,1035,470,565,446090.4,538008.3,984098.7
411430,201809,417,266,151,253096.2,144045,397141.2
411435,201809,37,26,11,24804,10494,35298
411440,201809,476,382,94,362736.99,89676,452412.99
411450,201809,421,354,67,337716,63918,401634
411460,201809,765,305,460,290405.64,437415.6,727821.24
411470,201809,85,63,22,60102,20988,81090
411480,201809,644,365,279,345730.4,265593.6,611324.0
411490,201809,295,186,109,177444,103699.8,281143.8
411500,201809,110,92,18,87564.33,16505,104069.33
411510,201809,218,178,40,169064.06,38160,207224.06
411520,201809,5948,2318,3630,2205968.83,3454695.22,5660664.05
411530,201809,115,79,36,75366,34344,109710
411535,201809,51,22,29,20988,27666,48654
411540,201809,354,247,107,234615.9,102078,336693.9
411545,201809,54,39,15,37206,14310,51516
411550,201809,74,56,18,53424,17172,70596
411560,201809,390,178,212,169148.38,202248,371396.38
411570,201809,774,301,473,285619.44,451042.46,736661.90
411573,201809,29,18,11,17172,10494,27666
411575,201809,278,177,101,168858,96354,265212
411580,201809,1256,500,756,474739.84,719376.4,1194116.24
411585,201809,80,41,39,39114,37206,76320
411590,201809,23,17,6,16218,5724,21942
411600,201809,27,12,15,11448,14310,25758
411605,201809,250,109,141,103986,134514,238500
411610,201809,237,159,78,151686,74412,226098
411620,201809,366,210,156,199863,148185,348048
411630,201809,57,40,17,38160,16218,54378
411640,201809,34,28,6,26712,5724,32436
411650,201809,13,8,5,7632,4770,12402
411660,201809,34,26,8,24804,7632,32436
411670,201809,249,185,64,176490,61056,237546
411680,201809,157,137,20,130698,19080,149778
411690,201809,594,315,279,299932.44,265842.2,565774.64
411695,201809,61,45,16,42930,15264,58194
411700,201809,159,138,21,131652,20034,151686
411705,201809,102,66,36,62964,34344,97308
411710,201809,301,201,100,190687.81,95400,286087.81
411720,201809,135,87,48,82998,45792,128790
411721,201809,60,51,9,48654,8586,57240
411722,201809,99,43,56,41022,53424,94446
411725,201809,147,113,34,107229.8,32436,139665.8
411727,201809,75,60,15,57240,14023.8,71263.8
411729,201809,35,27,8,25758,7632,33390
411730,201809,547,351,196,333263.96,186697.8,519961.76
411740,201809,39,23,16,21942,15264,37206
411745,201809,71,48,23,45001,21942,66943
411750,201809,885,416,469,395767.9,446457.69,842225.59
411760,201809,1210,920,290,876431.2,276651,1153082.2
411770,201809,445,296,149,282364.92,142146,424510.92
411780,201809,375,241,134,229914,127836,357750
411790,201809,529,300,229,284318.47,218171.34,502489.81
411800,201809,169,133,36,126882,34344,161226
411810,201809,164,126,38,120204,36252,156456
411820,201809,2088,1019,1069,969028.51,1019102.3,1988130.81
411830,201809,12,12,0,11448,0,11448
411840,201809,1949,1214,735,1155961.8,699457.2,1855419.0
411845,201809,51,20,31,19080,29574,48654
411850,201809,1228,695,533,661462.4,506528.48,1167990.88
411860,201809,46,31,15,29288,14310,43598
411870,201809,78,54,24,51516,22609.8,74125.8
411880,201809,426,272,154,259278.6,146171.88,405450.48
411885,201809,106,70,36,66780,34344,101124
411890,201809,319,203,116,191468.99,110654.46,302123.45
411900,201809,68,49,19,46746,18126,64872
411910,201809,181,141,40,134504.46,37320.48,171824.94
411915,201809,2112,914,1198,869497.57,1141590.05,2011087.62
411920,201809,126,103,23,98262,21942,120204
411925,201809,12,8,4,7632,3816,11448
411930,201809,799,587,212,558092,202248,760340
411940,201809,594,417,177,397341,168833.56,566174.56
411950,201809,895,481,414,458112.07,393684.04,851796.11
411960,201809,1025,718,307,682117.69,292878,974995.69
411965,201809,26,18,8,17172,7632,24804
411970,201809,75,67,8,63918,7632,71550
411980,201809,166,117,49,111618,46746,158364
411990,201809,5093,2978,2115,2823384.43,2016098.44,4839482.87
411995,201809,457,171,286,163134,272844,435978
412000,201809,306,186,120,177253.2,114470.46,291723.66
412010,201809,51,30,21,28620,20034,48654
412015,201809,46,33,13,31482,12402,43884
412020,201809,27,23,4,21655.8,3816,25471.8
412030,201809,59,51,8,48654,7632,56286
412033,201809,54,36,18,34320,17172,51492
412035,201809,75,47,28,44838,26712,71550
412040,201809,36,24,12,22610,11448,34058
412050,201809,199,149,50,142146,47700,189846
412060,201809,753,583,170,553320.74,161189.8,714510.54
412065,201809,48,33,15,31482,14310,45792
412070,201809,160,108,52,102364.2,49608,151972.2
412080,201809,287,155,132,147870,125928,273798
412085,201809,32,16,16,15264,15264,30528
412090,201809,768,485,283,461021.2,269982,731003.2
412100,201809,250,209,41,198433,39114,237547
412110,201809,69,55,14,52470,13356,65826
412120,201809,317,206,111,195951.6,105894,301845.6
412125,201809,81,47,34,44551.8,32436,76987.8
412130,201809,43,31,12,28992,11448,40440
412135,201809,28,17,11,16218,10494,26712
412140,201809,315,224,91,212888.92,86814,299702.92
412150,201809,252,176,76,166950.04,72504,239454.04
412160,201809,86,51,35,48654,33390,82044
412170,201809,663,463,200,441415.8,190800,632215.8
412175,201809,39,29,10,27666,9540,37206
412180,201809,196,156,40,148224.61,37539.9,185764.51
412190,201809,334,265,69,252137.43,65826,317963.43
412200,201809,198,124,74,118296,70596,188892
412210,201809,77,60,17,57240,16218,73458
412215,201809,236,166,70,158364,66493.8,224857.8
412217,201809,76,60,16,57240,15264,72504
412220,201809,818,615,203,586710,193662,780372
412230,201809,336,205,131,193948.2,124937.46,318885.66
412240,201809,1335,652,683,618489.02,649429.16,1267918.18
412250,201809,368,237,131,226098,124974,351072
412260,201809,106,76,30,72504,28620,101124
412265,201809,171,135,36,128355.22,34344,162699.22
412270,201809,80,52,28,49608,26712,76320
412280,201809,92,73,19,69642,18126,87768
412290,201809,97,66,31,62964,29574,92538
412300,201809,214,139,75,132606,71406.9,204012.9
412310,201809,43,38,5,36252,4770,41022
412320,201809,94,80,14,76320,13356,89676
412330,201809,174,152,22,145008,20988,165996
412340,201809,147,104,43,99216,40736,139952
412350,201809,602,306,296,290922.3,282384,573306.3
412360,201809,28,24,4,22896,3816,26712
412370,201809,160,139,21,131175,20034,151209
412380,201809,264,197,67,187651.8,63814,251465.8
412382,201809,53,28,25,26712,23850,50562
412385,201809,139,102,37,97308,35298,132606
412390,201809,283,217,66,207018,62964,269982
412395,201809,69,54,15,51516,14310,65826
412400,201809,76,53,23,50562,21942,72504
412402,201809,257,125,132,119245.23,125641.8,244887.03
412405,201809,824,330,494,312412.24,470590.66,783002.90
412410,201809,961,601,360,570492.6,343440,913932.6
412420,201809,14,12,2,11448,1908,13356
412430,201809,21,15,6,14310,5724,20034
412440,201809,609,331,278,313494.94,263371.08,576866.02
412450,201809,80,68,12,64872,11448,76320
412460,201809,80,60,20,57240,19080,76320
412470,201809,228,178,50,169812,47700,217512
412480,201809,164,124,40,117342.9,38160,155502.9
412490,201809,161,138,23,131652,21942,153594
412500,201809,464,380,84,360945.8,80136,441081.8
412510,201809,186,155,31,147298,29574,176872
412520,201809,136,74,62,70596,59148,129744
412530,201809,105,55,50,52470,47413.8,99883.8
412535,201809,107,78,29,74394,27666,102060
412540,201809,70,36,34,34344,32436,66780
412545,201809,96,70,26,66780,24804,91584
412550,201809,3519,1591,1928,1514150.64,1837214.9,3351365.54
412555,201809,14,10,4,9540,3816,13356
412560,201809,584,437,147,415085.4,140238,555323.4
412570,201809,741,409,332,388621.44,316728,705349.44
412575,201809,84,60,24,57240,22896,80136
412580,201809,167,111,56,105894,53424,159318
412590,201809,33,31,2,29574,1908,31482
412600,201809,175,133,42,126882,40068,166950
412610,201809,31,19,12,18126,11448,29574
412620,201809,147,129,18,123066,17172,140238
412625,201809,2199,1172,1027,1114370.47,977594.39,2091964.86
412627,201809,71,56,15,53424,14310,67734
412630,201809,425,285,140,270356.43,133560,403916.43
412635,201809,67,19,48,18126,45792,63918
412640,201809,120,80,40,76320,38160,114480
412650,201809,352,222,130,211788,124015.23,335803.23
412660,201809,476,295,181,280715,172674,453389
412665,201809,51,45,6,42930,5724,48654
412667,201809,284,195,89,185259.54,84663.8,269923.34
412670,201809,61,52,9,49608,8586,58194
412680,201809,298,236,62,225144,59148,284292
412690,201809,109,68,41,64872,38828,103700
412700,201809,157,106,51,101124,48368,149492
412710,201809,1401,869,532,822732.6,505620.2,1328352.8
412720,201809,232,157,75,149778,71550,221328
412730,201809,196,156,40,148824,37206,186030
412740,201809,423,235,188,224046.9,179352,403398.9
412750,201809,468,272,196,258534,186984,445518
412760,201809,267,138,129,131652,123066,254718
412770,201809,2128,1208,920,1147924.92,876145,2024069.92
412780,201809,154,121,33,115434,31482,146916
412785,201809,256,130,126,123543,120204,243747
412788,201809,38,23,15,21942,14310,36252
412790,201809,138,112,26,106180.2,24804,130984.2
412795,201809,154,115,39,109710,37206,146916
412796,201809,298,209,89,198221.18,84772.44,282993.62
412800,201809,569,372,197,354592.26,187938,542530.26
412810,201809,3005,1663,1342,1581904.45,1279023.03,2860927.48
412820,201809,941,613,328,573869.79,311549,885418.79
412830,201809,15,12,3,11448,2862,14310
412840,201809,222,158,64,149778.2,61056,210834.2
412850,201809,788,532,256,505620,244224,749844
412853,201809,174,92,82,87768,78228,165996
412855,201809,219,119,100,112414.82,95400,207814.82
412860,201809,90,66,24,62964,22896,85860
412862,201809,58,43,15,41022,14310,55332
412863,201809,6,5,1,4770,954,5724
412865,201809,41,31,10,29574,9540,39114
412870,201809,108,71,37,67734,35298,103032
412880,201809,99,73,26,69642,24804,94446
420005,201809,39,34,5,32436,4770,37206
420010,201809,377,249,128,236094.02,121826,357920.02
420020,201809,78,65,13,62010,12402,74412
420030,201809,29,26,3,24804,2862,27666
420040,201809,105,80,25,76320,23850,100170
420050,201809,54,34,20,32436,19080,51516
420055,201809,20,19,1,18126,954,19080
420060,201809,33,24,9,22896,8586,31482
420070,201809,105,88,17,83952,16208.46,100160.46
420075,201809,11,10,1,9540,954,10494
420080,201809,47,42,5,39114,4770,43884
420090,201809,34,32,2,29750.49,1908,31658.49
420100,201809,167,139,28,130793.6,26712,157505.6
420110,201809,20,20,0,19080,0,19080
420120,201809,52,40,12,38160,11448,49608
420125,201809,86,69,17,65826,16218,82044
420127,201809,33,29,4,27666,3816,31482
420130,201809,398,251,147,239444.46,139989.96,379434.42
420140,201809,1298,746,552,710359.38,526542,1236901.38
420150,201809,45,40,5,38160,4770,42930
420160,201809,37,35,2,33390,1908,35298
420165,201809,19,14,5,13356,4770,18126
420170,201809,69,44,25,41976,23850,65826
420180,201809,25,23,2,21942,1908,23850
420190,201809,30,27,3,25758,2862,28620
420195,201809,125,61,64,58194,61056,119250
420200,201809,1268,571,697,539755.52,663900.38,1203655.90
420205,201809,68,38,30,36252,28620,64872
420207,201809,109,62,47,58910,44828.46,103738.46
420208,201809,23,18,5,17172,3911.4,21083.4
420209,201809,20,16,4,15264,3816,19080
420210,201809,464,225,239,214363.8,227930.22,442294.02
420213,201809,44,36,8,34344,7632,41976
420215,201809,29,25,4,23850,3816,27666
420220,201809,66,43,23,41022,21942,62964
420230,201809,796,449,347,427583,330551.46,758134.46
420240,201809,2300,1552,748,1471647.31,713153.16,2184800.47
420243,201809,39,31,8,29574,7632,37206
420245,201809,118,63,55,60102,52470,112572
420250,201809,54,32,22,30528,20988,51516
420253,201809,44,36,8,34344,7632,41976
420257,201809,13,11,2,10494,1908,12402
420260,201809,101,88,13,83952,12402,96354
420270,201809,38,31,7,29570,6678,36248
420280,201809,280,209,71,197662.06,66476.1,264138.16
420285,201809,19,12,7,11448,6678,18126
420287,201809,51,31,20,29574,19080,48654
420290,201809,978,689,289,654412.18,275638.3,930050.48
420300,201809,1390,1105,285,1049421.95,269696.34,1319118.29
420310,201809,60,47,13,44838,12402,57240
420315,201809,33,29,4,27666,3816,31482
420320,201809,856,436,420,414966.15,400676,815642.15
420325,201809,0,0,0,0,0,0
420330,201809,123,84,39,80136,37091.52,117227.52
420340,201809,164,113,51,106840,48634.92,155474.92
420350,201809,257,190,67,179705.78,63918,243623.78
420360,201809,760,580,180,550440.16,171435.38,721875.54
420370,201809,115,73,42,69452,39782,109234
420380,201809,1142,814,328,772446.1,311875.04,1084321.14
420390,201809,258,172,86,162257.52,81328.5,243586.02
420395,201809,187,135,52,128790,48744.63,177534.63
420400,201809,248,187,61,177445,58194,235639
420410,201809,61,47,14,44838,13356,58194
420415,201809,33,31,2,29574,1908,31482
420417,201809,52,39,13,37206,12382.92,49588.92
420419,201809,12,12,0,11448,0,11448
420420,201809,2812,1729,1083,1638869.02,1030894.42,2669763.44
420425,201809,78,64,14,61047,13041.72,74088.72
420430,201809,1265,890,375,845328.22,355987.97,1201316.19
420435,201809,16,14,2,13356,1908,15264
420440,201809,105,72,33,68060.68,31330.6,99391.28
420445,201809,21,19,2,18126,1908,20034
420450,201809,75,37,38,35298,36252,71550
420455,201809,213,161,52,153547.92,49552.38,203100.30
420460,201809,2363,1573,790,1496196.56,753416.82,2249613.38
420470,201809,121,87,34,82998,32436,115434
420475,201809,6,6,0,5724,0,5724
420480,201809,876,656,220,621303.44,208831,830134.44
420490,201809,113,88,25,83952,23850,107802
420500,201809,647,286,361,270873.2,344394,615267.2
420510,201809,18,15,3,14310,2862,17172
420515,201809,26,20,6,19080,5724,24804
420517,201809,10,10,0,9540,0,9540
420519,201809,0,0,0,0,0,0
420520,201809,69,52,17,49608,16218,65826
420530,201809,165,110,55,103986.9,52470,156456.9
420535,201809,21,19,2,18126,1908,20034
420540,201809,5028,2972,2056,2822966.78,1956130.18,4779096.96
420543,201809,27,27,0,25758,0,25758
420545,201809,197,139,58,132606,55312.92,187918.92
420550,201809,869,702,167,666810.32,159160.73,825971.05
420555,201809,40,28,12,26712,11448,38160
420560,201809,67,54,13,51134.4,12402,63536.4
420570,201809,157,92,65,87768,62000.46,149768.46
420580,201809,299,132,167,125928,159032,284960
420590,201809,517,365,152,347656.68,145008,492664.68
420600,201809,102,53,49,50562,46746,97308
420610,201809,39,37,2,35298,1908,37206
420620,201809,76,62,14,59148,13356,72504
420630,201809,160,117,43,111609.23,41014,152623.23
420640,201809,95,84,11,79945.2,10494,90439.2
420650,201809,240,127,113,120490.2,107183.23,227673.43
420660,201809,55,42,13,39304.8,12402,51706.8
420665,201809,37,28,9,26712,8586,35298
420670,201809,317,237,80,225382.5,76301.46,301683.96
420675,201809,15,14,1,13356,954,14310
420680,201809,38,28,10,26712,9540,36252
420690,201809,174,145,29,137566.8,27666,165232.8
420700,201809,663,458,205,435581.01,195326.82,630907.83
420710,201809,154,88,66,83952,62677.8,146629.8
420720,201809,112,91,21,86804.46,20034,106838.46
420730,201809,565,366,199,348116.58,188560.66,536677.24
420740,201809,47,46,1,43884,954,44838
420750,201809,499,334,165,318349.8,157410,475759.8
420757,201809,19,16,3,15264,2862,18126
420760,201809,37,30,7,28620,6678,35298
420765,201809,70,58,12,55332,11448,66780
420768,201809,66,58,8,55332,7632,62964
420770,201809,82,69,13,65826,12402,78228
420775,201809,46,42,4,39114,3816,42930
420780,201809,243,190,53,181250.46,50562,231812.46
420785,201809,14,10,4,9540,3816,13356
420790,201809,177,146,31,139191.3,28592.46,167783.76
420800,201809,77,59,18,55522.8,17172,72694.8
420810,201809,251,218,33,207963,30671.1,238634.1
420820,201809,2353,1398,955,1327982.61,909721.8,2237704.41
420830,201809,598,336,262,318271.83,248984.46,567256.29
420840,201809,151,114,37,108756,34594,143350
420845,201809,444,196,248,186599.07,235352,421951.07
420850,201809,238,190,48,181260,45792,227052
420860,201809,64,54,10,51516,9540,61056
420870,201809,120,86,34,81805.5,31959,113764.5
420880,201809,174,120,54,114470.46,51030.09,165500.55
420890,201809,883,430,453,407131.84,431580.6,838712.44
420895,201809,9,9,0,8586,0,8586
420900,201809,421,330,91,312085.69,86785.92,398871.61
420910,201809,5828,3286,2542,3122943.49,2419786.07,5542729.56
420915,201809,76,70,6,66780,5724,72504
420917,201809,18,13,5,12402,4770,17172
420920,201809,22,15,7,14310,6678,20988
420930,201809,2758,1699,1059,1614379.74,1004941.2,2619320.94
420940,201809,613,443,170,421277.6,160528.08,581805.68
420945,201809,10,8,2,7632,1908,9540
420950,201809,56,51,5,48654,4770,53424
420960,201809,115,91,24,86776.92,22887,109663.92
420970,201809,300,241,59,228247.85,56258.46,284506.31
420980,201809,22,22,0,20988,0,20988
420985,201809,64,56,8,53424,7632,61056
420990,201809,74,59,15,56286,14310,70596
421000,201809,33,22,11,20988,10494,31482
421003,201809,67,46,21,43884,20034,63918
421005,201809,8,5,3,4770,2862,7632
421010,201809,758,533,225,507233,213544.2,720777.2
421020,201809,29,24,5,22896,4770,27666
421030,201809,128,108,20,102699,19080,121779
421040,201809,72,62,10,57907.8,9540,67447.8
421050,201809,319,230,89,218275.2,84906,303181.2
421055,201809,24,20,4,19080,3816,22896
421060,201809,77,52,25,49608,23850,73458
421070,201809,50,45,5,42930,4770,47700
421080,201809,34,31,3,29574,2862,32436
421085,201809,25,20,5,19080,4770,23850
421090,201809,43,32,11,30528,10494,41022
421100,201809,128,93,35,88722,33390,122112
421105,201809,216,174,42,165709.8,40044.69,205754.49
421110,201809,111,90,21,85239.9,20034,105273.9
421120,201809,155,120,35,113984.46,33361.38,147345.84
421125,201809,17,12,5,11448,4770,16218
421130,201809,807,524,283,498766.05,269228.54,767994.59
421140,201809,30,22,8,20272.5,7632,27904.5
421145,201809,39,30,9,28620,8586,37206
421150,201809,107,77,30,73458,28620,102078
421160,201809,65,43,22,41012.46,20988,62000.46
421165,201809,17,16,1,15264,954,16218
421170,201809,199,169,30,160313.84,28611,188924.84
421175,201809,152,100,52,95400,49560.38,144960.38
421180,201809,60,39,21,36844,20034,56878
421185,201809,17,14,3,13356,2862,16218
421187,201809,0,0,0,0,0,0
421189,201809,40,30,10,28620,9530.46,38150.46
421190,201809,1608,1012,596,964485.46,567601.58,1532087.04
421200,201809,90,69,21,64872.7,20034,84906.7
421205,201809,28,19,9,18126,8586,26712
421210,201809,181,124,57,118296,54378,172674
421220,201809,281,224,57,213075.9,54378,267453.9
421223,201809,53,45,8,42740,7632,50372
421225,201809,67,43,24,40832,22896,63728
421227,201809,96,72,24,68688,22896,91584
421230,201809,53,40,13,38160,12402,50562
421240,201809,18,18,0,17172,0,17172
421250,201809,356,224,132,212362,125136.18,337498.18
421260,201809,27,22,5,20988,4770,25758
421265,201809,0,0,0,0,0,0
421270,201809,53,47,6,44838,5724,50562
421280,201809,340,192,148,183168,139474.8,322642.8
421290,201809,332,219,113,208688,105676.26,314364.26
421300,201809,26,21,5,20034,4770,24804
421310,201809,52,39,13,36538.2,12402,48940.2
421315,201809,30,20,10,19080,9540,28620
421320,201809,136,95,41,90630,39114,129744
421330,201809,109,83,26,77274,24795,102069
421335,201809,40,28,12,26712,11448,38160
421340,201809,295,203,92,191898.05,87768,279666.05
421350,201809,189,110,79,104497,75366,179863
421360,201809,682,507,175,479676.26,166931.46,646607.72
421370,201809,194,150,44,143100,41642.1,184742.1
421380,201809,128,103,25,98257.23,23850,122107.23
421390,201809,16,12,4,11448,3816,15264
421400,201809,118,101,17,96354,16218,112572
421410,201809,22,19,3,18126,2862,20988
421415,201809,22,21,1,20034,954,20988
421420,201809,148,122,26,115815.6,24804,140619.6
421430,201809,15,11,4,10494,3816,14310
421440,201809,55,42,13,40068,12402,52470
421450,201809,95,82,13,78228,12402,90630
421460,201809,57,48,9,44987.77,8586,53573.77
421470,201809,71,46,25,43884,23850,67734
421480,201809,647,483,164,460019,156447,616466
421490,201809,22,21,1,20025,954,20979
421500,201809,512,328,184,311120.3,175239.9,486360.2
421505,201809,27,19,8,18126,7632,25758
421507,201809,36,30,6,28620,5724,34344
421510,201809,73,47,26,44838,24804,69642
421520,201809,66,57,9,53615,8586,62201
421530,201809,55,49,6,46746,5724,52470
421535,201809,27,26,1,24537,954,25491
421540,201809,59,50,9,47700,8586,56286
421545,201809,96,73,23,69156,21942,91098
421550,201809,299,220,79,209213,75366,284579
421555,201809,25,20,5,19080,4675,23755
421560,201809,8,7,1,6678,954,7632
421565,201809,123,88,35,83952,33390,117342
421567,201809,29,24,5,22896,4770,27666
421568,201809,33,31,2,29574,1908,31482
421569,201809,7,7,0,6678,0,6678
421570,201809,152,105,47,100170,44838,145008
421575,201809,27,22,5,20988,4770,25758
421580,201809,722,432,290,410213.2,275706.34,685919.54
421590,201809,22,21,1,20034,954,20988
421600,201809,111,75,36,71550,33105,104655
421605,201809,105,75,30,71217,28620,99837
421610,201809,189,150,39,142146.2,37206,179352.2
421620,201809,1097,653,444,620406.22,423261.38,1043667.60
421625,201809,23,21,2,20034,1908,21942
421630,201809,288,179,109,169955.8,103128,273083.8
421635,201809,16,8,8,7632,7632,15264
421640,201809,100,86,14,81854,13356,95210
421650,201809,287,167,120,159298.92,114460.92,273759.84
421660,201809,2152,1299,853,1235898.9,812590.06,2048488.96
421670,201809,189,134,55,127836,52470,180306
421680,201809,173,157,16,149778,15264,165042
421690,201809,351,246,105,233636.22,99206.58,332842.80
421700,201809,59,37,22,35298,20130,55428
421710,201809,25,25,0,23850,0,23850
421715,201809,8,7,1,6678,954,7632
421720,201809,589,430,159,408652.8,149959.26,558612.06
421725,201809,12,5,7,4770,6678,11448
421730,201809,40,28,12,26004.12,11448,37452.12
421740,201809,86,41,45,39114,42930,82044
421750,201809,232,174,58,163551.2,55332,218883.2
421755,201809,26,24,2,22896,1908,24804
421760,201809,105,74,31,70596,29574,100170
421770,201809,588,395,193,373109.38,183562.9,556672.28
421775,201809,29,19,10,18126,9540,27666
421780,201809,194,153,41,145962,39114,185076
421790,201809,159,132,27,125035.5,25758,150793.5
421795,201809,17,14,3,13356,2862,16218
421800,201809,494,316,178,300667.31,169574,470241.31
421810,201809,73,58,15,55332,14310,69642
421820,201809,310,212,98,201294.2,93492,294786.2
421825,201809,128,107,21,102078,20034,122112
421830,201809,131,100,31,95400,29574,124974
421835,201809,3,3,0,2862,0,2862
421840,201809,59,49,10,46737,9540,56277
421850,201809,79,68,11,64872,10490,75362
421860,201809,40,32,8,30528,7632,38160
421870,201809,979,752,227,709005.44,215773.86,924779.30
421875,201809,54,46,8,43884,7632,51516
421880,201809,168,122,46,116388,43598,159986
421885,201809,29,23,6,21942,5724,27666
421890,201809,122,86,36,82044,33192,115236
421895,201809,44,41,3,39114,2862,41976
421900,201809,159,128,31,121751.1,29538,151289.1
421910,201809,68,44,24,41976,22896,64872
421915,201809,31,26,5,24804,4770,29574
421917,201809,43,32,11,30528,10494,41022
421920,201809,33,30,3,28620,2862,31482
421930,201809,744,578,166,548145.06,158337,706482.06
421935,201809,56,49,7,46746,6678,53424
421940,201809,41,37,4,35298,3816,39114
421950,201809,842,557,285,526628.12,270326.8,796954.92
421960,201809,40,34,6,32150,5702.12,37852.12
421970,201809,370,235,135,223691.12,128781,352472.12
421985,201809,32,21,11,20034,10494,30528
422000,201809,0,0,0,0,0,0
430003,201809,202,51,151,47938.5,144054,191992.5
430005,201809,38,28,10,26712,9540,36252
430010,201809,278,197,81,187461,77274,264735
430020,201809,152,98,54,93206,51516,144722
430030,201809,133,105,28,99883.8,26712,126595.8
430040,201809,2972,1742,1230,1652873.08,1172438.2,2825311.28
430045,201809,64,55,9,52183.8,8586,60769.8
430047,201809,7,5,2,4770,1908,6678
430050,201809,79,66,13,62964,12402,75366
430055,201809,14,12,2,11448,1908,13356
430057,201809,5,3,2,2862,1908,4770
430060,201809,3655,2185,1470,2075997.38,1398606.74,3474604.12
430063,201809,59,55,4,52470,3816,56286
430064,201809,150,122,28,116388,26712,143100
430066,201809,9,6,3,5724,2862,8586
430070,201809,43,33,10,31482,9540,41022
430080,201809,69,47,22,44138.33,20988,65126.33
430085,201809,35,13,22,12402,20988,33390
430087,201809,33,23,10,21799,9540,31339
430090,201809,72,65,7,61723.8,6678,68401.8
430100,201809,131,89,42,83952,40068,124020
430105,201809,143,72,71,68498,67428.72,135926.72
430107,201809,20,15,5,14310,4770,19080
430110,201809,416,247,169,234769.86,161140.14,395910.00
430120,201809,144,132,12,124974,11448,136422
430130,201809,803,503,300,479241.9,285913.8,765155.7
430140,201809,120,113,7,107802,6678,114480
430150,201809,112,72,40,67925,37206,105131
430155,201809,32,29,3,27666,2862,30528
430160,201809,3776,2249,1527,2122920.52,1454831.12,3577751.64
430163,201809,328,149,179,141097.34,170737.38,311834.72
430165,201809,26,18,8,17172,7632,24804
430170,201809,90,78,12,74412,11448,85860
430175,201809,85,66,19,62964,17458.2,80422.2
430180,201809,105,83,22,79182,20367.9,99549.9
430185,201809,34,26,8,24804,7632,32436
430187,201809,97,41,56,39114,53118.8,92232.8
430190,201809,220,128,92,122064.3,87091.46,209155.76
430192,201809,15,14,1,13356,954,14310
430195,201809,15,10,5,9540,4770,14310
430200,201809,166,147,19,139570.2,17553.6,157123.8
430205,201809,19,18,1,17172,954,18126
430210,201809,650,501,149,474233.4,140381.3,614614.7
430215,201809,17,12,5,11448,4770,16218
430220,201809,69,49,20,46746,19080,65826
430222,201809,12,7,5,6678,4770,11448
430223,201809,11,6,5,5724,4770,10494
430225,201809,4,3,1,2862,954,3816
430230,201809,303,184,119,174582,113430.6,288012.6
430235,201809,54,38,16,36252,15254.46,51506.46
430237,201809,30,23,7,21942,6678,28620
430240,201809,133,85,48,80899.2,45792,126691.2
430245,201809,74,62,12,59148,11448,70596
430250,201809,191,112,79,106838.46,75356.46,182194.92
430258,201809,12,10,2,9540,1908,11448
430260,201809,34,29,5,27666,4760.46,32426.46
430265,201809,34,29,5,27646.92,4770,32416.92
430270,201809,545,407,138,385841.74,130786.02,516627.76
430280,201809,1040,644,396,609901.74,376238.6,986140.34
430290,201809,382,219,163,207018.8,155502,362520.8
430300,201809,2131,1185,946,1126036.44,899434.35,2025470.79
430310,201809,1975,1044,931,988931.3,885141.93,1874073.23
430320,201809,50,42,8,40053.69,7632,47685.69
430330,201809,96,85,11,80613,10474.92,91087.92
430340,201809,66,59,7,56286,6678,62964
430350,201809,1672,1165,507,1100234.89,481627.44,1581862.33
430355,201809,24,21,3,20034,2862,22896
430360,201809,82,40,42,38160,40068,78228
430367,201809,28,20,8,19080,7632,26712
430370,201809,55,47,8,44838,7632,52470
430380,201809,131,99,32,93873.6,30528,124401.6
430390,201809,609,383,226,365095.8,215013.26,580109.06
430400,201809,144,111,33,103986,31462.92,135448.92
430410,201809,60,47,13,44838,12402,57240
430420,201809,500,329,171,311386.8,161637.56,473024.36
430430,201809,54,51,3,48018.63,2051.1,50069.73
430435,201809,153,116,37,109710,35298,145008
430440,201809,518,348,170,331801.2,161989.2,493790.4
430450,201809,1191,985,206,933184.46,196514.46,1129698.92
430460,201809,5057,2793,2264,2650111.55,2153323.81,4803435.36
430461,201809,17,15,2,14310,1908,16218
430462,201809,9,6,3,5724,2862,8586
430463,201809,1030,548,482,520845.92,459476.1,980322.02
430465,201809,25,14,11,13356,10494,23850
430466,201809,665,480,185,456012.2,176299.2,632311.4
430467,201809,100,57,43,53137.8,41012.46,94150.26
430468,201809,107,65,42,62010,39816.91,101826.91
430469,201809,23,18,5,17172,4770,21942
430470,201809,1173,651,522,615560.35,496032.3,1111592.65
430471,201809,49,36,13,34324.92,12402,46726.92
430480,201809,98,60,38,56381.4,36242.46,92623.86
430485,201809,6,6,0,5438,0,5438
430490,201809,86,71,15,66923.7,14310,81233.7
430495,201809,37,27,10,25758,9540,35298
430500,201809,190,126,64,119917.8,60680.46,180598.26
430510,201809,3220,2116,1104,2008218.03,1051775.46,3059993.49
430511,201809,17,16,1,15264,954,16218
430512,201809,138,98,40,93492,38160,131652
430513,201809,53,44,9,41499,8586,50085
430515,201809,33,31,2,29574,1908,31482
430517,201809,168,150,18,142146,17152.92,159298.92
430520,201809,376,264,112,251189,106819.38,358008.38
430530,201809,89,52,37,49608,35298,84906
430535,201809,474,321,153,305748.23,145934.15,451682.38
430537,201809,10,10,0,9540,0,9540
430540,201809,74,50,24,47700,22896,70596
430543,201809,369,117,252,111618,240408,352026
430544,201809,43,40,3,38160,2862,41022
430545,201809,350,171,179,162237.32,170254.66,332491.98
430550,201809,42,35,7,33390,6678,40068
430558,201809,5,3,2,2862,1908,4770
430560,201809,52,24,28,22896,26712,49608
430570,201809,107,44,63,41976,60044.76,102020.76
430580,201809,123,99,24,94446,21655.8,116101.8
430583,201809,14,14,0,13356,0,13356
430585,201809,9,4,5,3816,4770,8586
430587,201809,15,7,8,6678,7632,14310
430590,201809,153,124,29,117055.8,27666,144721.8
430593,201809,4,4,0,3816,0,3816
430595,201809,17,13,4,12402,3816,16218
430597,201809,53,28,25,26712,23850,50562
430600,201809,221,155,66,147860.46,62677.8,210538.26
430605,201809,160,100,60,95400,57230.46,152630.46
430607,201809,28,23,5,21942,4770,26712
430610,201809,1625,765,860,727225.36,816119.32,1543344.68
430613,201809,3,3,0,2862,0,2862
430620,201809,116,85,31,81090,29564.46,110654.46
430630,201809,46,40,6,38160,5724,43884
430632,201809,33,28,5,26712,4770,31482
430635,201809,42,37,5,35298,4770,40068
430637,201809,57,32,25,30528,23850,54378
430640,201809,200,112,88,105417,83952,189369
430642,201809,25,23,2,21942,1908,23850
430645,201809,35,29,6,27666,5724,33390
430650,201809,261,211,50,201008,47652.3,248660.3
430655,201809,4,4,0,3816,0,3816
430660,201809,968,477,491,453483.9,466887.8,920371.7
430670,201809,74,52,22,49608,20988,70596
430673,201809,68,37,31,35298,29574,64872
430675,201809,13,10,3,9540,2862,12402
430676,201809,501,307,194,292172.12,185005.07,477177.19
430680,201809,249,175,74,164541.35,70310,234851.35
430690,201809,535,323,212,306950.24,200573.06,507523.30
430692,201809,7,5,2,4770,1908,6678
430693,201809,144,97,47,92538,44828.46,137366.46
430695,201809,76,64,12,60121.08,11448,71569.08
430697,201809,60,38,22,36252,20988,57240
430700,201809,1584,1110,474,1047247.78,451909.8,1499157.58
430705,201809,22,20,2,19080,1908,20988
430710,201809,259,170,89,162180,84906,247086
430720,201809,108,92,16,87577.2,15264,102841.2
430730,201809,121,103,18,97308,17172,114480
430740,201809,64,41,23,39114,21942,61056
430745,201809,36,29,7,27380,6678,34058
430750,201809,347,232,115,220384.64,108756,329140.64
430755,201809,85,50,35,47700,33390,81090
430760,201809,360,216,144,203393.72,137347.92,340741.64
430770,201809,1450,756,694,718553.7,656941.93,1375495.63
430780,201809,314,201,113,190772.72,107745.3,298518.02
430781,201809,30,25,5,23850,4770,28620
430783,201809,52,41,11,38796.13,10494,49290.13
430786,201809,6,3,3,2862,2862,5724
430790,201809,508,327,181,310686.12,172378.46,483064.58
430800,201809,157,131,26,124954.92,24804,149758.92
430805,201809,42,38,4,36252,3816,40068
430807,201809,40,25,15,23850,14310,38160
430810,201809,76,50,26,47700,24804,72504
430820,201809,138,84,54,80136,50848.2,130984.2
430825,201809,12,10,2,9540,1908,11448
430830,201809,233,218,15,207329.84,14310,221639.84
430840,201809,128,86,42,82044,39209.4,121253.4
430843,201809,5,3,2,2862,1908,4770
430845,201809,70,39,31,37206,29574,66780
430850,201809,572,399,173,378308.7,164938.76,543247.46
430860,201809,163,102,61,96640.2,57516.66,154156.86
430865,201809,71,40,31,37492.2,29259.18,66751.38
430870,201809,83,67,16,63250.2,15264,78514.2
430880,201809,160,120,40,114460.92,38160,152620.92
430885,201809,7,6,1,5724,954,6678
430890,201809,336,205,131,193910.04,124974,318884.04
430900,201809,542,377,165,355174.2,156933,512107.2
430905,201809,103,42,61,40068,58194,98262
430910,201809,269,151,118,144054,111896,255950
430912,201809,4,4,0,3816,0,3816
430915,201809,33,26,7,24804,6678,31482
430920,201809,4257,2370,1887,2253867.61,1798224.92,4052092.53
430925,201809,6,5,1,4521.96,954,5475.96
430930,201809,2111,1249,862,1184506.66,822087.97,2006594.63
430940,201809,260,165,95,156732.66,90610.92,247343.58
430950,201809,154,123,31,117342,29574,146916
430955,201809,22,14,8,13356,7632,20988
430957,201809,18,17,1,16218,954,17172
430960,201809,242,162,80,152258.4,75652.2,227910.6
430965,201809,108,68,40,64872,38160,103032
430970,201809,83,69,14,65826,12402,78228
430975,201809,36,33,3,31482,2862,34344
430980,201809,46,29,17,27666,16218,43884
430990,201809,117,89,28,84906,26712,111618
430995,201809,117,112,5,105607.8,4770,110377.8
431000,201809,303,136,167,127597.2,159318,286915.2
431010,201809,341,204,137,194043.6,130678.92,324722.52
431020,201809,1954,1143,811,1082337.42,768885.84,1851223.26
431030,201809,42,33,9,31482,8586,40068
431033,201809,388,194,194,184265.2,185076,369341.2
431036,201809,14,9,5,8586,4770,13356
431040,201809,131,77,54,72504,50738.49,123242.49
431041,201809,39,27,12,25758,11448,37206
431043,201809,50,29,21,27666,20034,47700
431046,201809,12,7,5,6678,4770,11448
431050,201809,204,131,73,124401.6,69642,194043.6
431053,201809,76,46,30,43120.8,28620,71740.8
431055,201809,61,41,20,39114,19060.92,58174.92
431057,201809,16,16,0,15264,0,15264
431060,201809,1662,1056,606,997380.96,576272.44,1573653.40
431065,201809,19,11,8,10494,7632,18126
431070,201809,70,65,5,62010,4770,66780
431075,201809,7,7,0,6678,0,6678
431080,201809,140,88,52,83379.6,49608,132987.6
431085,201809,32,29,3,27666,2862,30528
431087,201809,13,11,2,10494,1908,12402
431090,201809,55,43,12,41022,11448,52470
431100,201809,1228,733,495,688505.02,472230,1160735.02
431110,201809,248,157,91,149778,86518.46,236296.46
431112,201809,29,17,12,16218,11448,27666
431113,201809,32,24,8,22896,7632,30528
431115,201809,160,113,47,107165.87,44828.46,151994.33
431120,201809,607,361,246,342458.18,233673.72,576131.90
431123,201809,4,3,1,2862,954,3816
431125,201809,97,87,10,82998,9540,92538
431127,201809,9,4,5,3816,4770,8586
431130,201809,672,431,241,409933.8,229608.72,639542.52
431140,201809,738,505,233,480530,222205.68,702735.68
431142,201809,36,28,8,25500,7632,33132
431150,201809,200,147,53,140238,50552.46,190790.46
431160,201809,56,50,6,47700,5724,53424
431162,201809,19,14,5,13356,4770,18126
431164,201809,5,5,0,4770,0,4770
431170,201809,106,87,19,82998,18126,101124
431171,201809,61,35,26,33151.5,24794.46,57945.96
431173,201809,2,1,1,954,954,1908
431175,201809,205,103,102,97022,97298.46,194320.46
431177,201809,76,57,19,54378,17439.92,71817.92
431179,201809,13,11,2,10494,1908,12402
431180,201809,448,277,171,264258,163115.46,427373.46
431190,201809,89,68,21,64872,20034,84906
431198,201809,69,48,21,45792,20034,65826
431200,201809,20,16,4,15264,3816,19080
431205,201809,23,23,0,21942,0,21942
431210,201809,89,54,35,51516,33390,84906
431213,201809,30,25,5,23850,4770,28620
431215,201809,26,23,3,21942,2862,24804
431217,201809,6,5,1,4770,954,5724
431220,201809,66,57,9,54378,8586,62964
431225,201809,151,100,51,95391,48634.92,144025.92
431230,201809,99,87,12,82998,11448,94446
431235,201809,8,8,0,7632,0,7632
431237,201809,25,16,9,15264,8586,23850
431238,201809,11,8,3,7346,2862,10208
431240,201809,999,647,352,615578.64,335483.64,951062.28
431242,201809,37,36,1,34344,954,35298
431244,201809,11,8,3,7632,2862,10494
431245,201809,56,41,15,39114,14310,53424
431247,201809,13,11,2,10494,1908,12402
431250,201809,274,145,129,138263.22,123046.92,261310.14
431260,201809,61,46,15,43884,14310,58194
431261,201809,20,14,6,13356,5724,19080
431262,201809,16,16,0,15264,0,15264
431265,201809,159,85,74,81090,70596,151686
431267,201809,14,13,1,12402,954,13356
431270,201809,323,267,56,254718,53424,308142
431275,201809,41,38,3,36252,2862,39114
431280,201809,18,14,4,12521.25,3816,16337.25
431290,201809,23,19,4,18126,3816,21942
431295,201809,4,4,0,3816,0,3816
431300,201809,24,21,3,20034,2862,22896
431301,201809,7,7,0,6678,0,6678
431303,201809,53,35,18,33265.98,16885.8,50151.78
431306,201809,226,118,108,112402.18,103032,215434.18
431308,201809,7,5,2,4770,1908,6678
431310,201809,66,58,8,55332,7632,62964
431320,201809,124,74,50,70576.92,47404.26,117981.18
431330,201809,172,113,59,107802,56286,164088
431333,201809,32,26,6,24804,5724,30528
431335,201809,10,5,5,4770,4770,9540
431337,201809,328,154,174,146229.2,164956.14,311185.34
431339,201809,23,20,3,19080,2862,21942
431340,201809,3025,1751,1274,1665342.43,1212631.76,2877974.19
431342,201809,39,22,17,20988,16218,37206
431344,201809,18,18,0,17172,0,17172
431346,201809,4,4,0,3816,0,3816
431349,201809,35,32,3,30528,2862,33390
431350,201809,918,542,376,513759.86,357044.04,870803.90
431360,201809,49,43,6,41022,5724,46746
431365,201809,319,152,167,144988.92,158354.46,303343.38
431370,201809,1333,790,543,751142.11,517854.06,1268996.17
431380,201809,97,83,14,79182,13356,92538
431390,201809,504,277,227,262588.5,216252.72,478841.22
431395,201809,286,127,159,121158,151667,272825
431400,201809,39,29,10,27666,9540,37206
431402,201809,105,73,32,69642,30528,100170
431403,201809,22,14,8,13356,7632,20988
431405,201809,643,347,296,329111.82,282071,611182.82
431406,201809,31,27,4,25758,3816,29574
431407,201809,52,41,11,39114,10494,49608
431410,201809,3360,2044,1316,1935064.29,1251161.46,3186225.75
431413,201809,16,13,3,12402,2862,15264
431415,201809,72,52,20,49608,19080,68688
431417,201809,23,12,11,11448,10494,21942
431420,201809,309,218,91,207335.96,86814,294149.96
431430,201809,44,19,25,18126,23850,41976
431440,201809,8980,6392,2588,6032224.3,2461240.21,8493464.51
431442,201809,28,15,13,14310,12402,26712
431445,201809,26,21,5,20034,4770,24804
431446,201809,8,7,1,6678,954,7632
431447,201809,87,63,24,60102,22896,82998
431449,201809,52,45,7,42930,6678,49608
431450,201809,412,281,131,267787.8,124258.5,392046.3
431454,201809,0,0,0,0,0,0
431455,201809,49,39,10,37206,9540,46746
431460,201809,527,365,162,346158.9,154261.8,500420.7
431470,201809,117,90,27,85860,25508,111368
431475,201809,11,10,1,9540,954,10494
431477,201809,36,24,12,22896,11448,34344
431478,201809,8,7,1,6678,954,7632
431480,201809,504,317,187,300872.52,178331.22,479203.74
431490,201809,28127,16097,12030,15281729.2,11441205.05,26722934.25
431500,201809,79,56,23,53185.5,21942,75127.5
431505,201809,37,22,15,20988,14310,35298
431507,201809,12,10,2,9540,1908,11448
431510,201809,270,180,90,170337,84877.38,255214.38
431513,201809,22,18,4,17172,3816,20988
431514,201809,9,8,1,7632,954,8586
431515,201809,81,68,13,64872,12402,77274
431517,201809,4,3,1,2862,954,3816
431520,201809,37,33,4,31482,3816,35298
431530,201809,1592,718,874,684304.44,833372.09,1517676.53
431531,201809,24,22,2,20988,1908,22896
431532,201809,26,18,8,17172,7632,24804
431535,201809,25,16,9,15264,8586,23850
431540,201809,139,123,16,116616.03,15264,131880.03
431545,201809,16,14,2,13356,1908,15264
431550,201809,359,203,156,193375.8,148728.6,342104.4
431555,201809,13,12,1,11448,954,12402
431560,201809,4517,3194,1323,3016218.74,1259872.38,4276091.12
431570,201809,809,437,372,413750,352970.46,766720.46
431575,201809,35,24,11,22896,10494,33390
431580,201809,96,69,27,64872,25758,90630
431590,201809,137,115,22,108756,20988,129744
431595,201809,11,10,1,9540,954,10494
431600,201809,218,124,94,118276.92,89676,207952.92
431610,201809,125,92,33,86527.8,31482,118009.8
431620,201809,43,35,8,33390,7632,41022
431630,201809,140,117,23,111618,21942,133560
431640,201809,1350,845,505,800692.82,479481.22,1280174.04
431642,201809,39,36,3,33867,2862,36729
431643,201809,46,20,26,19080,24804,43884
431645,201809,304,178,126,169812,119917.8,289729.8
431647,201809,10,10,0,9540,0,9540
431650,201809,36,26,10,24804,9540,34344
431660,201809,293,188,105,178398,100170,278568
431670,201809,227,108,119,100408.5,113497.38,213905.88
431673,201809,4,3,1,2862,954,3816
431675,201809,30,25,5,23563.8,4770,28333.8
431680,201809,1120,810,310,768924,294691.14,1063615.14
431690,201809,4784,2924,1860,2765428.89,1768987.62,4534416.51
431695,201809,24,19,5,18126,4770,22896
431697,201809,0,0,0,0,0,0
431700,201809,179,138,41,131652,39114,170766
431710,201809,4020,1753,2267,1669110.4,2162218.94,3831329.34
431720,201809,1379,832,547,784075.82,520870.46,1304946.28
431725,201809,1,1,0,954,0,954
431730,201809,1208,821,387,775299.52,369198,1144497.52
431740,201809,1363,685,678,648968.12,644735.18,1293703.30
431750,201809,1875,1219,656,1153603.5,623887.92,1777491.42
431755,201809,6,5,1,4770,954,5724
431760,201809,1048,680,368,648338.4,350843.58,999181.98
431770,201809,395,291,104,276555.06,98557.74,375112.80
431775,201809,29,21,8,20034,7632,27666
431780,201809,568,354,214,336886.02,204146.46,541032.48
431790,201809,160,122,38,115434,36204.3,151638.3
431795,201809,13,12,1,11448,954,12402
431800,201809,3377,1781,1596,1682920.13,1517520.7,3200440.83
431805,201809,18,15,3,14310,2862,17172
431810,201809,610,410,200,388526.04,190657.44,579183.48
431820,201809,317,182,135,173628,128790,302418
431830,201809,2327,1414,913,1345335.57,869770.27,2215105.84
431840,201809,513,344,169,324838.6,159986,484824.6
431842,201809,34,28,6,26712,5724,32436
431843,201809,13,9,4,8586,3816,12402
431844,201809,15,13,2,12402,1908,14310
431845,201809,30,27,3,25758,2862,28620
431846,201809,27,22,5,20988,4770,25758
431848,201809,14,12,2,11448,1908,13356
431849,201809,9,7,2,6678,1908,8586
431850,201809,814,672,142,639575.31,135229.5,774804.81
431860,201809,108,77,31,73458,28620,102078
431861,201809,3,2,1,1908,954,2862
431862,201809,51,32,19,30528,18126,48654
431870,201809,3438,2042,1396,1938733.84,1328429.16,3267163.00
431880,201809,957,701,256,662862.25,243270,906132.25
431890,201809,1307,813,494,770279.54,469067.98,1239347.52
431900,201809,180,126,54,120204,50724.18,170928.18
431910,201809,56,43,13,41022,12402,53424
431912,201809,37,20,17,19060.92,16027.2,35088.12
431915,201809,130,104,26,99216,24804,124020
431920,201809,147,109,38,103699.8,36252,139951.8
431930,201809,84,69,15,65110.5,14310,79420.5
431935,201809,3,3,0,2862,0,2862
431936,201809,15,14,1,13356,954,14310
431937,201809,19,14,5,13356,4770,18126
431940,201809,463,312,151,294881.4,143090.96,437972.36
431950,201809,493,314,179,297362.54,170614.44,467976.98
431960,201809,730,422,308,398592.82,293680.44,692273.26
431970,201809,72,64,8,61056,7632,68688
431971,201809,3,3,0,2862,0,2862
431973,201809,22,17,5,16218,4770,20988
431975,201809,7,6,1,5724,954,6678
431980,201809,201,126,75,119631.6,71550,191181.6
431990,201809,1208,655,553,623396.99,527516,1150912.99
432000,201809,1675,913,762,863030.24,723383.24,1586413.48
432010,201809,282,186,96,176146.56,91584,267730.56
432020,201809,166,134,32,127836,30528,158364
432023,201809,18,14,4,13356,3816,17172
432026,201809,65,59,6,56286,5724,62010
432030,201809,63,28,35,26712,33390,60102
432032,201809,20,17,3,16218,2862,19080
432035,201809,52,41,11,39114,10494,49608
432040,201809,105,73,32,69642,30528,100170
432045,201809,8,7,1,6678,954,7632
432050,201809,74,43,31,41022,29574,70596
432055,201809,106,79,27,75366,25758,101124
432057,201809,1,0,1,0,954,954
432060,201809,34,31,3,29574,2862,32436
432065,201809,30,27,3,25758,2862,28620
432067,201809,88,78,10,74392.92,9540,83932.92
432070,201809,413,311,102,294244.07,97279.92,391523.99
432080,201809,821,574,247,545897.88,235590.38,781488.26
432085,201809,17,12,5,11448,4770,16218
432090,201809,265,165,100,157410,95400,252810
432100,201809,177,118,59,112285.8,56286,168571.8
432110,201809,618,425,193,394882.82,183168,578050.82
432120,201809,950,574,376,547596,358599.06,906195.06
432130,201809,507,371,136,352598.4,128646.9,481245.3
432132,201809,24,21,3,20034,2862,22896
432135,201809,80,65,15,62010,14310,76320
432140,201809,269,215,54,204814.26,51516,256330.26
432143,201809,192,121,71,115434,67734,183168
432145,201809,271,187,84,177158.6,79849.8,257008.4
432146,201809,15,14,1,13356,954,14310
432147,201809,131,61,70,58194,66756.15,124950.15
432149,201809,16,12,4,11448,3816,15264
432150,201809,842,521,321,496785.96,304447.51,801233.47
432160,201809,1401,732,669,695954.08,637301.36,1333255.44
432162,201809,4,3,1,2862,954,3816
432163,201809,18,14,4,13356,3816,17172
432166,201809,121,91,30,87292,28620,115912
432170,201809,221,120,101,113527,96354,209881
432180,201809,533,329,204,310721.62,194330,505051.62
432183,201809,8,7,1,6678,954,7632
432185,201809,81,70,11,66780,10494,77274
432190,201809,462,261,201,248602.86,191649.6,440252.46
432195,201809,87,75,12,70834.5,11448,82282.5
432200,201809,415,268,147,255672,140190.84,395862.84
432210,201809,123,78,45,73458,42930,116388
432215,201809,57,53,4,50562,3816,54378
432218,201809,20,19,1,18126,954,19080
432220,201809,686,350,336,332870.48,320027.2,652897.68
432225,201809,13,7,6,6678,5724,12402
432230,201809,144,90,54,85621.5,51516,137137.5
432232,201809,14,12,2,11448,1908,13356
432234,201809,4,3,1,2862,954,3816
432235,201809,2,2,0,1908,0,1908
432237,201809,30,17,13,16218,12402,28620
432240,201809,4282,2394,1888,2272572.94,1794437.38,4067010.32
432250,201809,1056,677,379,642472.76,361403.82,1003876.58
432252,201809,43,37,6,34821,5724,40545
432253,201809,60,48,12,45792,11448,57240
432254,201809,24,11,13,10494,12402,22896
432255,201809,14,13,1,12402,954,13356
432260,201809,884,699,185,665139.34,175536,840675.34
432270,201809,238,173,65,165042,62010,227052
432280,201809,127,94,33,89199.8,31482,120681.8
432285,201809,1,1,0,954,0,954
432290,201809,69,62,7,57240,6678,63918
432300,201809,4600,2651,1949,2510915.32,1855360.98,4366276.30
432310,201809,117,96,21,91440.9,20034,111474.9
432320,201809,18,15,3,14310,2862,17172
432330,201809,17,12,5,11448,4770,16218
432335,201809,7,6,1,5724,954,6678
432340,201809,39,36,3,34344,2862,37206
432345,201809,98,69,29,65826,27666,93492
432350,201809,24,23,1,21942,954,22896
432360,201809,6,4,2,3816,1908,5724
432370,201809,26,26,0,24804,0,24804
432375,201809,35,32,3,30528,2862,33390
432377,201809,8,8,0,7632,0,7632
432380,201809,167,75,92,70882.2,87720.3,158602.5
500020,201809,254,142,112,135468,106246.98,241714.98
500025,201809,119,58,61,54378,58194,112572
500060,201809,1454,896,558,854211.6,530763.61,1384975.21
500070,201809,784,372,412,354537,393038.46,747575.46
500080,201809,133,104,29,99216,27666,126882
500085,201809,135,108,27,102459.8,24923.25,127383.05
500090,201809,332,161,171,153594,163134,316728
500100,201809,736,391,345,370820.13,328558,699378.13
500110,201809,2233,1023,1210,975596.92,1153544.94,2129141.86
500124,201809,269,157,112,149778,106561.8,256339.8
500150,201809,328,132,196,125919,186614.46,312533.46
500190,201809,534,368,166,350404.2,157878,508282.2
500200,201809,197,168,29,159929,27666,187595
500210,201809,1432,517,915,493003.39,871634.37,1364637.76
500215,201809,243,140,103,132602.42,98262,230864.42
500220,201809,785,507,278,482194.34,265202.46,747396.80
500230,201809,261,176,85,167188.5,80613,247801.5
500240,201809,702,486,216,462880.8,205777.8,668658.6
500260,201809,587,220,367,209880,350118,559998
500270,201809,28786,12317,16469,11719908.81,15693327.44,27413236.25
500280,201809,191,70,121,66780,115434,182214
500290,201809,1199,714,485,680203,462681,1142884
500295,201809,420,259,161,247086,153584.46,400670.46
500310,201809,60,19,41,18126,39114,57240
500315,201809,727,430,297,410210.46,283328.46,693538.92
500320,201809,3635,1830,1805,1742157.31,1720589.94,3462747.25
500325,201809,920,509,411,485109,390854.44,875963.44
500330,201809,1483,690,793,656038.28,756188.64,1412226.92
500345,201809,321,243,78,230859.2,74412,305271.2
500348,201809,242,146,96,139284,91565.46,230849.46
500350,201809,133,65,68,62010,64872,126882
500370,201809,5414,2439,2975,2320074.69,2835874.46,5155949.15
500375,201809,355,259,96,246821.84,91584,338405.84
500380,201809,600,345,255,329130,243260.46,572390.46
500390,201809,71,36,35,34344,33390,67734
500400,201809,214,147,67,140218.92,63909,204127.92
500410,201809,554,218,336,207898.15,320400.22,528298.37
500430,201809,541,379,162,361566,154548,516114
500440,201809,204,103,101,97203.23,96354,193557.23
500450,201809,407,175,232,166244.8,221318.46,387563.26
500460,201809,307,157,150,149768.46,142804.26,292572.72
500470,201809,446,351,95,333696.26,89667,423363.26
500480,201809,114,68,46,64872,43884,108756
500490,201809,108,44,64,41971.23,61056,103027.23
500500,201809,1438,512,926,486449.98,882850.18,1369300.16
500510,201809,48,37,11,35298,10485,45783
500515,201809,108,76,32,72504,30242,102746
500520,201809,350,191,159,181156,151396,332552
500525,201809,87,50,37,47700,35011.8,82711.8
500540,201809,914,383,531,365315.76,505568.61,870884.37
500560,201809,889,501,388,476215.04,369827.84,846042.88
500568,201809,990,582,408,551666.62,388942,940608.62
500570,201809,1207,683,524,648112.04,497277.84,1145389.88
500580,201809,339,173,166,164746.26,158323,323069.26
500600,201809,311,162,149,153837.27,142128,295965.27
500620,201809,934,658,276,622241.64,263113.2,885354.84
500625,201809,79,67,12,63536.4,11448,74984.4
500627,201809,24,12,12,11448,11448,22896
500630,201809,1573,844,729,803831.66,695179.8,1499011.46
500635,201809,526,302,224,287688.24,213266.9,500955.14
500640,201809,430,224,206,211122,196505.46,407627.46
500660,201809,5528,2116,3412,2015230.7,3251109.52,5266340.22
500690,201809,574,205,369,195213.24,350358.71,545571.95
500710,201809,361,176,185,167618,176472,344090
500720,201809,973,574,399,545912.69,380636.46,926549.15
500730,201809,203,120,83,114480,79177.23,193657.23
500740,201809,846,369,477,350738.95,454779.75,805518.70
500750,201809,144,46,98,43884,93463.92,137347.92
500755,201809,126,90,36,85574,34344,119918
500769,201809,764,429,335,408644.27,319577,728221.27
500770,201809,427,226,201,215594.46,191744.46,407338.92
500780,201809,172,114,58,108470,55332,163802
500790,201809,1060,535,525,509304.25,500800.46,1010104.71
500793,201809,266,146,120,139284,114471,253755
500795,201809,177,128,49,122102.46,46737,168839.46
500797,201809,44,33,11,31482,10494,41976
500800,201809,412,179,233,170757,222135.74,392892.74
500830,201809,2241,1245,996,1185318.12,949144.68,2134462.80
500840,201809,143,107,36,102078,34335,136413
510010,201809,170,95,75,90620.46,71521.38,162141.84
510020,201809,488,230,258,219126.06,245596.5,464722.56
510025,201809,1676,961,715,915914.59,679601.62,1595516.21
510030,201809,676,353,323,336715.92,307367.92,644083.84
510035,201809,132,60,72,57212.46,68669.46,125881.92
510040,201809,388,175,213,166950,202755.26,369705.26
510050,201809,421,232,189,220577.66,179482.46,400060.12
510060,201809,113,58,55,55322.46,52460.46,107782.92
510080,201809,223,92,131,87735.69,124860.06,212595.75
510100,201809,75,34,41,32436,39094.92,71530.92
510120,201809,39,24,15,22896,14310,37206
510125,201809,396,244,152,232093.89,144975.38,377069.27
510130,201809,576,332,244,316322.81,232075.98,548398.79
510140,201809,398,129,269,123057,256621.23,379678.23
510160,201809,93,42,51,40068,48650,88718
510170,201809,865,528,337,503399.97,320846.3,824246.27
510180,201809,2880,1395,1485,1327281.72,1415098.32,2742380.04
510185,201809,11,6,5,5724,4770,10494
510190,201809,218,71,147,67734,140233.23,207967.23
510250,201809,2597,1541,1056,1469045.53,1006282.1,2475327.63
510260,201809,200,144,56,137184.84,53387.46,190572.30
510263,201809,455,250,205,237518.46,195541.92,433060.38
510267,201809,668,375,293,356241.76,279251.45,635493.21
510268,201809,58,30,28,28620,26712,55332
510269,201809,70,33,37,31473,35298,66771
510270,201809,401,203,198,193483.98,188465.94,381949.92
510279,201809,226,167,59,159291,55980.92,215271.92
510285,201809,174,75,99,71531.46,94446,165977.46
510300,201809,527,293,234,279094.91,223161.84,502256.75
510305,201809,208,97,111,92515.46,105818.22,198333.68
510310,201809,111,57,54,54378,51506.46,105884.46
510320,201809,868,542,326,516500.18,310854.38,827354.56
510325,201809,415,164,251,156446.46,239167.8,395614.26
510330,201809,438,247,191,235625,182194.92,417819.92
510335,201809,603,331,272,315717.84,258755.58,574473.42
510336,201809,48,34,14,32436,13356,45792
510337,201809,117,48,69,45782.46,65816.46,111598.92
510340,201809,17310,8263,9047,7861530.59,8621129.95,16482660.54
510343,201809,69,49,20,46736.46,19080,65816.46
510345,201809,164,110,54,104930.46,51210.92,156141.38
510350,201809,673,374,299,355863.07,285181.38,641044.45
510360,201809,199,123,76,117333,72421.92,189754.92
510370,201809,142,73,69,69613.38,65713.14,135326.52
510380,201809,90,63,27,60102,25749,85851
510385,201809,56,27,29,25758,27657,53415
510390,201809,119,50,69,47700,65787.84,113487.84
510395,201809,42,31,11,29574,10494,40068
510410,201809,710,476,234,454100,223212.69,677312.69
510420,201809,578,279,299,265230.34,283836.07,549066.41
510450,201809,52,29,23,27666,21942,49608
510452,201809,42,25,17,23850,16218,40068
510454,201809,58,28,30,26712,28610.46,55322.46
510455,201809,124,77,47,73438.92,44838,118276.92
510460,201809,183,99,84,94265.92,80098.38,174364.30
510480,201809,748,437,311,415781.35,296356.36,712137.71
510490,201809,353,181,172,172323.34,163602.16,335925.50
510500,201809,253,192,61,183158.46,58194,241352.46
510510,201809,799,459,340,437286.26,324331.38,761617.64
510515,201809,1151,607,544,578718.38,518929.38,1097647.76
510517,201809,254,106,148,100837.8,141168.69,242006.49
510520,201809,237,156,81,148721.22,77180.84,225902.06
510523,201809,90,63,27,60102,25748.46,85850.46
510525,201809,740,426,314,405649.84,299453.76,705103.60
510530,201809,17,13,4,12402,3816,16218
510550,201809,266,117,149,111609,142137,253746
510558,201809,277,140,137,133527.15,130678.92,264206.07
510560,201809,399,240,159,228674,151668,380342
510562,201809,635,449,186,427015.17,176957.46,603972.63
510590,201809,806,420,386,400623.84,368216.69,768840.53
510600,201809,258,142,116,135448.92,110626.92,246075.84
510610,201809,169,81,88,77254.92,83656.46,160911.38
510615,201809,197,82,115,78208.92,109710,187918.92
510617,201809,19,11,8,10494,7632,18126
510618,201809,118,56,62,53424,58671,112095
510619,201809,101,71,30,67725,28611,96336
510620,201809,181,99,82,94436.46,78228,172664.46
510621,201809,199,127,72,121139.46,68660.46,189799.92
510622,201809,463,295,168,281337.84,160243.92,441581.76
510623,201809,346,235,111,224143.38,105865.38,330008.76
510624,201809,92,44,48,41967,45792,87759
510625,201809,535,327,208,311757.3,197845.52,509602.82
510626,201809,112,70,42,66780,40068,106848
510627,201809,56,42,14,40068,13356,53424
510628,201809,160,96,64,91546.92,60998.76,152545.68
510629,201809,254,162,92,154548,86794.92,241342.92
510630,201809,461,235,226,224114.76,215257.95,439372.71
510631,201809,10,3,7,2862,6392,9254
510637,201809,346,197,149,187601.72,142008.84,329610.56
510642,201809,966,539,427,513864.18,407215.44,921079.62
510645,201809,0,0,0,0,0,0
510650,201809,1471,977,494,931913.92,471153.76,1403067.68
510665,201809,84,44,40,41920,38160,80080
510670,201809,65,37,28,35298,26712,62010
510675,201809,1160,708,452,674160.43,431185.23,1105345.66
510677,201809,357,177,180,167861.84,171599.76,339461.60
510680,201809,104,60,44,57222,41967,99189
510682,201809,200,100,100,95078,95400,190478
510685,201809,54,40,14,38160,13356,51516
510700,201809,619,363,256,346145.92,244090.76,590236.68
510704,201809,1095,596,499,566103.54,474434.36,1040537.90
510706,201809,125,64,61,61051.23,58156.92,119208.15
510710,201809,393,265,128,251839.24,121997.68,373836.92
510715,201809,63,47,16,44828.46,15264,60092.46
510718,201809,209,115,94,109616.76,89666.46,199283.22
510719,201809,36,19,17,18126,16218,34344
510720,201809,198,133,65,126873,61723.8,188596.8
510724,201809,89,35,54,33380.46,51483.38,84863.84
510726,201809,53,27,26,25748.46,24786,50534.46
510729,201809,72,32,40,30528,38121.84,68649.84
510730,201809,478,270,208,257562,198294,455856
510735,201809,110,44,66,41976,62964,104940
510740,201809,29,16,13,15264,12402,27666
510757,201809,20,16,4,15264,3816,19080
510760,201809,7049,3706,3343,3526631.93,3184097.49,6710729.42
510770,201809,721,339,382,323208.3,364261.3,687469.6
510774,201809,16,6,10,5724,9540,15264
510775,201809,117,89,28,84896.46,26702.46,111598.92
510776,201809,28,7,21,6678,20034,26712
510777,201809,186,83,103,79153.38,98233.38,177386.76
510779,201809,48,22,26,20979,24766.92,45745.92
510780,201809,295,165,130,157347.46,123955,281302.46
510785,201809,433,234,199,223188.84,189779.22,412968.06
510787,201809,190,95,95,90621,90612.23,181233.23
510788,201809,0,0,0,0,0,0
510790,201809,2380,1256,1124,1196373.94,1070325.36,2266699.30
510792,201809,1089,626,463,596440.55,441286.34,1037726.89
510794,201809,119,61,58,58194,55303.92,113497.92
510795,201809,2380,1380,1000,1307919.04,951317.8,2259236.84
510800,201809,183,113,70,107783.46,66771,174554.46
510805,201809,172,116,56,110664,53424,164088
510810,201809,96,39,57,37123.38,54253.98,91377.36
510820,201809,257,120,137,114053.46,129698.03,243751.49
510830,201809,68,41,27,39114,25749,64863
510835,201809,9,7,2,6678,1908,8586
510840,201809,9254,4561,4693,4337650.69,4469462.92,8807113.61
510850,201809,210,86,124,82034.46,118258.38,200292.84
510860,201809,389,173,216,164864.52,205402.42,370266.94
510880,201809,65,50,15,47681.46,14310,61991.46
510885,201809,73,44,29,41957.46,27637.38,69594.84
510890,201809,71,41,30,39114,28620,67734
510895,201809,181,106,75,101124,71241.46,172365.46
520005,201809,38,25,13,23850,12402,36252
520010,201809,274,124,150,118296,143005,261301
520013,201809,648,395,253,376802,241075.8,617877.8
520015,201809,52,38,14,36252,13356,49608
520017,201809,98,57,41,54092,39114,93206
520020,201809,23,13,10,12402,9540,21942
520025,201809,2017,1097,920,1045466.37,876821.4,1922287.77
520030,201809,799,413,386,393039,367623.9,760662.9
520050,201809,78,53,25,50562,23850,74412
520055,201809,46,30,16,28620,15264,43884
520060,201809,187,125,62,119250,59148,178398
520080,201809,591,418,173,398772,165042,563814
520082,201809,20,14,6,13356,5724,19080
520085,201809,101,74,27,70596,25758,96354
520090,201809,92,63,29,60102,27666,87768
520110,201809,9107,3970,5137,3782248.16,4898059.18,8680307.34
520120,201809,14,8,6,7431.66,5724,13155.66
520130,201809,768,535,233,510094.8,221843.9,731938.7
520140,201809,11764,6657,5107,6343525.94,4869820.77,11213346.71
520145,201809,45,33,12,31482,11448,42930
520150,201809,190,147,43,140238,41022,181260
520160,201809,31,24,7,22896,6678,29574
520170,201809,238,146,92,139252,87731,226983
520180,201809,136,74,62,70596,59148,129744
520215,201809,218,139,79,132319.8,75079.8,207399.6
520235,201809,71,53,18,50562,17172,67734
520250,201809,133,81,52,77274,49321.8,126595.8
520260,201809,113,70,43,66780,40068,106848
520280,201809,47,33,14,30815,13356,44171
520310,201809,39,26,13,24804,12402,37206
520320,201809,167,105,62,100160.46,59148,159308.46
520330,201809,789,415,374,395864.46,356787,752651.46
520340,201809,348,196,152,186984,144989.46,331973.46
520350,201809,525,241,284,229914,270889,500803
520355,201809,86,51,35,48654,33390,82044
520357,201809,24,17,7,16218,6678,22896
520360,201809,1,1,0,954,0,954
520380,201809,143,74,69,70596,65826,136422
520390,201809,278,119,159,113049,151676.46,264725.46
520393,201809,15,11,4,10494,3816,14310
520396,201809,97,58,39,55332,37206,92538
520400,201809,219,129,90,121445.2,85860,207305.2
520410,201809,197,100,97,95391,92529,187920
520420,201809,22,15,7,14310,6678,20988
520425,201809,322,145,177,137377,168382.2,305759.2
520430,201809,465,241,224,229627.8,213640,443267.8
520440,201809,615,417,198,397818,188872.92,586690.92
520450,201809,1937,872,1065,831059.46,1015107.56,1846167.02
520455,201809,59,42,17,40068,16218,56286
520460,201809,32,16,16,15264,15264,30528
520465,201809,24,21,3,20034,2862,22896
520470,201809,419,260,159,247734.63,151686,399420.63
520480,201809,81,47,34,44838,32391,77229
520485,201809,124,44,80,41976,76034,118010
520490,201809,416,304,112,289831.98,106848,396679.98
520495,201809,173,106,67,101124,63918,165042
520500,201809,175,130,45,124020,42930,166950
520505,201809,177,92,85,87763.23,81090,168853.23
520510,201809,1769,876,893,833285.6,849693.48,1682979.08
520520,201809,35,28,7,26712,6678,33390
520530,201809,233,176,57,166180.12,54368.46,220548.58
520540,201809,528,355,173,337363.02,165042,502405.02
520545,201809,150,86,64,82044,61056,143100
520547,201809,52,30,22,28620,20988,49608
520549,201809,1157,568,589,541548,561779,1103327
520551,201809,294,153,141,145962,134228,280190
520552,201809,47,28,19,26712,18126,44838
520570,201809,16,9,7,8586,6678,15264
520580,201809,286,172,114,164078.46,108756,272834.46
520590,201809,161,97,64,92538,60769.8,153307.8
520620,201809,1168,549,619,522888.48,590230.26,1113118.74
520630,201809,43,26,17,24804,16218,41022
520640,201809,404,233,171,222282,163134,385416
520650,201809,62,41,21,39114,20034,59148
520660,201809,36,19,17,18117,16218,34335
520670,201809,35,30,5,28620,4770,33390
520680,201809,55,37,18,35298,17172,52470
520690,201809,32,10,22,9540,20959.92,30499.92
520710,201809,38,34,4,32436,3816,36252
520725,201809,196,125,71,119250,67734,186984
520735,201809,59,41,18,39114,17172,56286
520740,201809,412,204,208,193901.4,198423,392324.4
520750,201809,36,28,8,26712,7632,34344
520753,201809,56,38,18,36252,17172,53424
520760,201809,113,76,37,72504,35298,107802
520780,201809,295,223,72,212742,68669,281411
520790,201809,166,85,81,80803.8,77274,158077.8
520800,201809,3448,1849,1599,1761549.06,1524912,3286461.06
520810,201809,172,124,48,118296,45792,164088
520815,201809,5,5,0,4770,0,4770
520830,201809,145,101,44,96354,41689.8,138043.8
520840,201809,349,229,120,217989,114480,332469
520850,201809,111,72,39,68669.46,37053.36,105722.82
520860,201809,1694,1080,614,1028899.54,584612.2,1613511.74
520870,201809,31096,15268,15828,14537888.25,15083719.56,29621607.81
520880,201809,1086,592,494,564482,471256.92,1035738.92
520890,201809,793,463,330,440071.4,314715.46,754786.86
520910,201809,1023,543,480,513777.94,457920,971697.94
520915,201809,102,76,26,72504,24794.46,97298.46
520920,201809,403,199,204,189273.6,194606.46,383880.06
520929,201809,15,14,1,13356,954,14310
520940,201809,76,49,27,46746,25758,72504
520945,201809,20,12,8,11448,7632,19080
520960,201809,46,29,17,27666,16218,43884
520970,201809,320,202,118,191792.8,112285.8,304078.6
520980,201809,83,63,20,60102,19080,79182
520990,201809,477,323,154,308142,146916,455058
520993,201809,129,62,67,59148,63918,123066
520995,201809,242,135,107,127837,101506,229343
521000,201809,1587,930,657,885217.6,626396.8,1511614.4
521010,201809,667,311,356,296081.36,339557.76,635639.12
521015,201809,18,11,7,10494,6678,17172
521020,201809,1464,1024,440,976266.9,419398.22,1395665.12
521030,201809,47,34,13,32436,12402,44838
521040,201809,955,592,363,564530.2,346016,910546.2
521056,201809,41,29,12,27666,11448,39114
521060,201809,134,85,49,81090,46746,127836
521080,201809,466,349,117,332937,111618,444555
521090,201809,529,315,214,298983.6,204156,503139.6
521100,201809,278,208,70,197754.4,66780,264534.4
521120,201809,1051,734,317,699663.8,302122.8,1001786.6
521130,201809,366,261,105,248984.46,99284.6,348269.06
521140,201809,179,99,80,94446,76320,170766
521150,201809,2765,1207,1558,1149896.88,1485069.03,2634965.91
521160,201809,32,17,15,16218,14310,30528
521170,201809,197,115,82,109700.46,78228,187928.46
521180,201809,1144,723,421,688111.26,400919.2,1089030.46
521190,201809,2529,1074,1455,1024576.92,1387478.72,2412055.64
521200,201809,48,35,13,33390,12402,45792
521205,201809,12,9,3,8586,2862,11448
521210,201809,145,83,62,79182,59148,138330
521220,201809,823,564,259,536148.8,247030,783178.8
521225,201809,33,22,11,20988,10494,31482
521230,201809,111,74,37,70309.8,35298,105607.8
521250,201809,6245,3600,2645,3426984.38,2520743.26,5947727.64
521260,201809,23,15,8,14310,7632,21942
521270,201809,138,108,30,103032,28620,131652
521280,201809,437,259,178,245751.2,169812,415563.2
521290,201809,31,12,19,11448,18126,29574
521295,201809,97,65,32,62010,30528,92538
521300,201809,230,120,110,114462,104589.38,219051.38
521305,201809,34,23,11,21942,10494,32436
521308,201809,1094,811,283,773443.14,269687,1043130.14
521310,201809,1352,798,554,759244.4,527324.92,1286569.32
521340,201809,20,16,4,15264,3816,19080
521350,201809,132,98,34,93492,32436,125928
521370,201809,190,123,67,117055.8,63631.8,180687.6
521375,201809,187,104,83,99216,78895.8,178111.8
521377,201809,53,36,17,34344,16218,50562
521380,201809,1091,709,382,672000.22,364428,1036428.22
521385,201809,16,8,8,7632,7632,15264
521390,201809,105,84,21,79818.04,20034,99852.04
521400,201809,331,213,118,202915.8,112524.3,315440.1
521405,201809,150,80,70,76320,66780,143100
521410,201809,62,41,21,39114,20034,59148
521440,201809,200,144,56,136565.1,53424,189989.1
521450,201809,720,397,323,378738,308142,686880
521460,201809,1190,733,457,699107.48,435958.92,1135066.40
521470,201809,12,8,4,7632,3816,11448
521480,201809,44,29,15,27639,14245,41884
521483,201809,309,169,140,160940,133560,294500
521486,201809,285,180,105,171214.38,99503,270717.38
521487,201809,22,11,11,10494,10494,20988
521490,201809,26,15,11,14310,10494,24804
521500,201809,117,79,38,75366,36252,111618
521520,201809,40,28,12,26712,11448,38160
521523,201809,619,377,242,356341.32,230868,587209.32
521525,201809,45,30,15,28620,14023.8,42643.8
521530,201809,249,131,118,124974,112572,237546
521540,201809,30,17,13,16218,12402,28620
521550,201809,89,39,50,36882.92,47653.92,84536.84
521560,201809,805,549,256,523460,244081,767541
521565,201809,54,37,17,35298,16218,51516
521570,201809,505,341,164,325304.46,156361.3,481665.76
521580,201809,58,36,22,34344,20988,55332
521590,201809,38,20,18,19080,17172,36252
521600,201809,28,17,11,16218,10494,26712
521630,201809,241,124,117,118286.46,110627.96,228914.42
521640,201809,298,155,143,147870,136422,284292
521645,201809,30,16,14,15264,13356,28620
521680,201809,219,138,81,131652,77274,208926
521690,201809,2,2,0,1908,0,1908
521710,201809,1172,555,617,528897.8,588506.02,1117403.82
521720,201809,544,370,174,352970.46,165958.46,518928.92
521730,201809,633,302,331,288013,314667.56,602680.56
521740,201809,904,366,538,348849.92,512156.72,861006.64
521760,201809,1633,902,731,858930.63,697060,1555990.63
521770,201809,809,508,301,484632,286686.54,771318.54
521800,201809,2053,1284,769,1221394.02,732248.1,1953642.12
521805,201809,34,19,15,18126,14310,32436
521810,201809,92,59,33,55141.8,31482,86623.8
521830,201809,954,677,277,643950.42,264249,908199.42
521839,201809,89,58,31,55332,29574,84906
521850,201809,1111,589,522,560486.92,497663.68,1058150.60
521860,201809,357,222,135,211788,128504,340292
521870,201809,73,42,31,40068,29574,69642
521878,201809,43,20,23,19080,21942,41022
521880,201809,4590,2076,2514,1978234.36,2396846.96,4375081.32
521890,201809,585,413,172,394002,163801.8,557803.8
521900,201809,296,236,60,224507.96,57240,281747.96
521910,201809,151,105,46,100170,43884,144054
521920,201809,54,27,27,25758,25758,51516
521925,201809,35,21,14,20034,13356,33390
521930,201809,1115,638,477,608455.98,454423.88,1062879.86
521935,201809,34,26,8,24804,7632,32436
521940,201809,187,97,90,92538,85855.23,178393.23
521945,201809,15,13,2,12402,1908,14310
521950,201809,9,5,4,4770,3816,8586
521960,201809,76,57,19,54378,18126,72504
521970,201809,423,273,150,260155.8,143100,403255.8
521971,201809,93,47,46,44838,43884,88722
521973,201809,28,13,15,12402,14310,26712
521975,201809,1189,614,575,585565.2,547634.66,1133199.86
521980,201809,245,169,76,161226,72504,233730
521990,201809,72,53,19,50562,18126,68688
522000,201809,290,186,104,177444,99216,276660
522005,201809,20,12,8,11448,7632,19080
522010,201809,1149,646,503,616275,479289.6,1095564.6
522015,201809,57,35,22,33381,20988,54369
522020,201809,862,467,395,444564.2,376048.12,820612.32
522026,201809,28,20,8,19080,7632,26712
522028,201809,15,11,4,10494,3816,14310
522040,201809,742,293,449,279504,428291.46,707795.46
522045,201809,2191,1379,812,1315123.26,773828.8,2088952.06
522050,201809,164,79,85,75366,81090,156456
522060,201809,553,350,203,333613.8,193566.6,527180.4
522068,201809,132,88,44,83665.8,41976,125641.8
522070,201809,10,10,0,9540,0,9540
522100,201809,45,25,20,23850,19080,42930
522108,201809,40,31,9,29574,8586,38160
522119,201809,56,30,26,28620,24804,53424
522130,201809,74,27,47,25749,44811,70560
522140,201809,3810,1927,1883,1833871.28,1794227.44,3628098.72
522145,201809,51,32,19,30528,18126,48654
522150,201809,63,48,15,45792,14310,60102
522155,201809,54,36,18,34335,17172,51507
522157,201809,4,3,1,2862,954,3816
522160,201809,1730,1013,717,965257.2,683995.05,1649252.25
522170,201809,392,264,128,251856,122112,373968
522180,201809,37,20,17,19080,16218,35298
522185,201809,1974,774,1200,735089.26,1144279,1879368.26
522190,201809,47,27,20,25758,18984.6,44742.6
522200,201809,302,185,117,176490,111618,288108
522205,201809,165,113,52,107802,49608,157410
522220,201809,161,116,45,110664,42930,153594
522230,201809,31,26,5,24804,4770,29574
530010,201809,55575,28608,26967,27153214.99,25677005.23,52830220.22
110001,201810,520,412,108,392084.46,102386.96,494471.42
110002,201810,2791,1708,1083,1627899.76,1032284.49,2660184.25
110003,201810,91,74,17,70146,16218,86364
110004,201810,2003,1295,708,1233314.1,675136.26,1908450.36
110005,201810,439,356,83,338468.9,79182,417650.9
110006,201810,458,351,107,333813.75,102058.92,435872.67
110007,201810,83,66,17,62964,16218,79182
110008,201810,236,133,103,125646.9,98262,223908.9
110009,201810,817,566,251,537913.86,239255,777168.86
110010,201810,1803,1119,684,1066728.12,652232.21,1718960.33
110011,201810,1873,1445,428,1376385.2,408302.46,1784687.66
110012,201810,4172,2431,1741,2313146.42,1659823.12,3972969.54
110013,201810,769,588,181,560942.46,172007,732949.46
110014,201810,382,327,55,310908.8,52470,363378.8
110015,201810,1434,1159,275,1102667.13,262330.92,1364998.05
110018,201810,1119,680,439,648406,418793.23,1067199.23
110020,201810,15497,9112,6385,8650796.23,6083542.01,14734338.24
110025,201810,660,491,169,465462.11,161217,626679.11
110026,201810,41,28,13,26712,12402,39114
110028,201810,1636,1190,446,1130658.59,422462.95,1553121.54
110029,201810,136,122,14,116388,13356,129744
110030,201810,2468,1676,792,1596282.36,754667.46,2350949.82
110032,201810,395,311,84,296385,80132,376517
110033,201810,677,504,173,478520.98,164755.8,643276.78
110034,201810,368,271,97,256222,91871,348093
110037,201810,104,87,17,82998,16218,99216
110040,201810,352,240,112,228960,106848,335808
110045,201810,953,648,305,616667,289266.39,905933.39
110050,201810,97,81,16,76988,15264,92252
110060,201810,87,49,38,46746,36252,82998
110070,201810,118,72,46,68688,43598,112286
110080,201810,411,250,161,235990.98,153570.15,389561.13
110090,201810,34,28,6,26712,5724,32436
110092,201810,106,58,48,55332,45722,101054
110094,201810,196,141,55,134514,52470,186984
110100,201810,30,25,5,23850,4770,28620
110110,201810,65,40,25,38160,23850,62010
110120,201810,72,59,13,56286,12402,68688
110130,201810,301,246,55,233209.12,52470,285679.12
110140,201810,244,160,84,152449.2,80126.46,232575.66
110143,201810,51,42,9,40068,8586,48654
110145,201810,24,18,6,17172,5724,22896
110146,201810,24,12,12,11448,11448,22896
110147,201810,38,30,8,28620,7632,36252
110148,201810,40,28,12,26660.57,11448,38108.57
110149,201810,308,219,89,208639.8,84906,293545.8
110150,201810,88,62,26,59148,24804,83952
110155,201810,8,7,1,6678,954,7632
110160,201810,69,58,11,55332,10494,65826
110170,201810,205,164,41,156456,38827.8,195283.8
110175,201810,47,34,13,32436,12402,44838
110180,201810,94,81,13,77274,12402,89676
120001,201810,142,98,44,93492,41968,135460
120005,201810,192,121,71,115434,67734,183168
120010,201810,1033,671,362,636623.15,345277.12,981900.27
120013,201810,147,101,46,96344.46,43693.2,140037.66
120017,201810,94,57,37,54378,35298,89676
120020,201810,3591,2872,719,2714556.78,683536.23,3398093.01
120025,201810,581,329,252,311846.1,239537.48,551383.58
120030,201810,1053,886,167,837321.22,158603,995924.22
120032,201810,48,41,7,39114,6678,45792
120033,201810,220,192,28,182820.75,26712,209532.75
120034,201810,159,114,45,106848,42930,149778
120035,201810,34,25,9,23850,8586,32436
120038,201810,396,255,141,242550.88,134514,377064.88
120039,201810,23,22,1,20988,954,21942
120040,201810,14182,9832,4350,9323626.63,4141626.85,13465253.48
120042,201810,46,40,6,38160,5724,43884
120043,201810,12,3,9,2862,8586,11448
120045,201810,540,351,189,332327.68,179343.58,511671.26
120050,201810,1271,973,298,922218.65,284287.23,1206505.88
120060,201810,1432,1169,263,1111410,249948,1361358
120070,201810,504,362,142,342020.12,135458.46,477478.58
120080,201810,167,105,62,99683.46,58909.5,158592.96
130002,201810,151,105,46,100170,43884,144054
130006,201810,77,44,33,41976,31482,73458
130008,201810,144,77,67,72759.6,63239.72,135999.32
130010,201810,142,79,63,75344.12,60102,135446.12
130014,201810,250,181,69,172674,65826,238500
130020,201810,94,50,44,47700,41976,89676
130030,201810,910,552,358,526608,341522.46,868130.46
130040,201810,312,158,154,150732,145962.28,296694.28
130050,201810,573,309,264,294499.8,251856,546355.8
130060,201810,875,595,280,562524.96,264738.6,827263.56
130063,201810,580,326,254,311004,242250.36,553254.36
130068,201810,190,124,66,118296,62677.8,180973.8
130070,201810,1329,913,416,870840.5,396842.12,1267682.62
130080,201810,678,445,233,424148.4,222273,646421.4
130083,201810,74,41,33,38850,31482,70332
130090,201810,371,190,181,179580.96,172674,352254.96
130100,201810,1144,515,629,491310,599779.8,1091089.8
130110,201810,700,309,391,294786,373014,667800
130115,201810,178,73,105,69642,100170,169812
130120,201810,1644,1035,609,987390,580986,1568376
130130,201810,618,427,191,407358,182214,589572
130140,201810,1513,1132,381,1079307.9,362520.2,1441828.1
130150,201810,424,361,63,344394,60102,404496
130160,201810,467,266,201,253764,191754,445518
130165,201810,28,20,8,19080,7632,26712
130170,201810,972,701,271,668683.4,258534,927217.4
130180,201810,146,88,58,83952,55332,139284
130185,201810,2379,1204,1175,1146708,1120358.92,2267066.92
130190,201810,3604,2263,1341,2155127.46,1278011.99,3433139.45
130195,201810,289,232,57,221328,54378,275706
130200,201810,173,80,93,76310.46,88722,165032.46
130210,201810,78,39,39,37206,37206,74412
130220,201810,179,125,54,119250,51516,170766
130230,201810,332,207,125,197478,119250,316728
130240,201810,1426,905,521,862030.4,496456.83,1358487.23
130250,201810,4809,3124,1685,2973660.56,1607356.57,4581017.13
130255,201810,431,208,223,198432,212455.8,410887.8
130260,201810,54618,26370,28248,25120730.84,26942046.48,52062777.32
130270,201810,1598,1060,538,1010848.86,513252,1524100.86
130280,201810,119,74,45,70596,42930,113526
130290,201810,2113,1532,581,1460861,553987.8,2014848.8
130300,201810,430,307,123,292591.8,117342,409933.8
130310,201810,889,466,423,444564,403542,848106
130320,201810,454,244,210,231822,200340,432162
130330,201810,737,454,283,433116,269695.8,702811.8
130340,201810,3363,1996,1367,1899891.4,1302401,3202292.4
130350,201810,465,300,165,286200,157410,443610
130353,201810,825,344,481,327890,458874,786764
130356,201810,811,373,438,355842,417852,773694
130360,201810,66,41,25,39114,23850,62964
130370,201810,681,511,170,487494,162180,649674
130380,201810,607,422,185,402559.38,176490,579049.38
130390,201810,490,389,101,371106,96354,467460
130395,201810,181,39,142,37206,135468,172674
130400,201810,70,45,25,42930,23850,66780
130406,201810,2083,1290,793,1227046.3,755290.76,1982337.06
130410,201810,478,204,274,194616,261376.92,455992.92
130420,201810,3193,2583,610,2461349.32,581940,3043289.32
130423,201810,159,75,84,71550,80136,151686
130426,201810,154,89,65,84906,62010,146916
130430,201810,409,270,139,257580,132606,390186
130440,201810,201,68,133,64872,126882,191754
140002,201810,33,12,21,11448,20034,31482
140005,201810,207,129,78,122827.5,74412,197239.5
140010,201810,10434,6987,3447,6631890.69,3286435.6,9918326.29
140015,201810,149,65,84,62010,80136,142146
140017,201810,119,81,38,77274,36252,113526
140020,201810,468,313,155,297648,147870,445518
140023,201810,33,17,16,15999,15264,31263
140028,201810,20,13,7,12402,6678,19080
140030,201810,350,249,101,237546,95752.98,333298.98
140040,201810,58,40,18,38160,17076.6,55236.6
140045,201810,247,111,136,105894,129744,235638
140047,201810,615,428,187,406300.39,177635,583935.39
140050,201810,150,97,53,91725,50562,142287
140060,201810,40,29,11,26931.42,10494,37425.42
140070,201810,33,30,3,27866.05,2862,30728.05
150010,201810,4713,2941,1772,2803806.4,1688581,4492387.4
150013,201810,153,107,46,101791.8,43884,145675.8
150020,201810,1057,573,484,546642,461736,1008378
150030,201810,718,297,421,283338,401634,684972
150034,201810,197,127,70,121158,66780,187938
150040,201810,1413,849,564,809946,538056,1348002
150050,201810,672,397,275,377736.8,262150,639886.8
150060,201810,4747,3066,1681,2921778.37,1603426.5,4525204.87
150070,201810,317,145,172,138330,164088,302418
150080,201810,14336,7212,7124,6870239.73,6789219.65,13659459.38
150085,201810,395,245,150,233720.46,143100,376820.46
150090,201810,759,647,112,617238,106848,724086
150095,201810,348,216,132,205294.12,125107.56,330401.68
150100,201810,58,40,18,38160,17172,55332
150110,201810,172,84,88,80136,83952,164088
150120,201810,426,316,110,301464,104940,406404
150125,201810,55,23,32,21942,30528,52470
150130,201810,1933,1044,889,995222.34,848101.23,1843323.57
150140,201810,54210,25463,28747,24254075.29,27409380.24,51663455.53
150145,201810,184,105,79,100170,75366,175536
150150,201810,2833,1312,1521,1251430.49,1448363.2,2699793.69
150157,201810,422,299,123,285246,117337.23,402583.23
150160,201810,120,96,24,91584,22896,114480
150170,201810,3664,2728,936,2601319.5,892657.8,3493977.3
150172,201810,324,221,103,210834,98262,309096
150175,201810,85,51,34,48654,32436,81090
150178,201810,774,515,259,490069.8,247086,737155.8
150180,201810,3112,1515,1597,1444499.6,1523194.76,2967694.36
150190,201810,329,212,117,202248,111618,313866
150195,201810,123,62,61,59148,58194,117342
150200,201810,200,95,105,90630,100170,190800
150210,201810,3155,2559,596,2440227.86,567578.5,3007806.36
150215,201810,524,341,183,325314,174296,499610
150220,201810,3834,2611,1223,2489334.8,1163384.92,3652719.72
150230,201810,1148,929,219,885686.04,208926,1094612.04
150240,201810,5851,3451,2400,3289098.73,2289591,5578689.73
150250,201810,33,16,17,15264,16218,31482
150260,201810,79,48,31,45792,29574,75366
150270,201810,2368,1541,827,1469323.66,788071.18,2257394.84
150275,201810,557,345,212,329130,202248,531378
150276,201810,111,49,62,46746,59148,105894
150277,201810,766,328,438,312893.46,417852,730745.46
150280,201810,338,212,126,202248,120204,322452
150285,201810,80,40,40,38160,38160,76320
150290,201810,974,597,377,569242.26,359372,928614.26
150293,201810,664,312,352,297638.46,335808,633446.46
150295,201810,471,213,258,203202,245979.44,449181.44
150300,201810,77,40,37,38160,35298,73458
150304,201810,153,105,48,100170,45792,145962
150307,201810,386,321,65,306234,62010,368244
150309,201810,565,411,154,392065.92,146190,538255.92
150310,201810,257,172,85,164088,81090,245178
150320,201810,1774,1229,545,1172184.57,519691.5,1691876.07
150330,201810,2074,1195,879,1139362.2,838566,1977928.2
150340,201810,197,134,63,127597.5,60102,187699.5
150345,201810,611,332,279,316546.74,266166,582712.74
150350,201810,408,323,85,305747.46,81090,386837.46
150360,201810,4575,2949,1626,2809755.46,1551194.46,4360949.92
150370,201810,772,546,226,520160,215463.19,735623.19
150375,201810,198,105,93,100170,88722,188892
150380,201810,1380,937,443,893898,422622,1316520
150390,201810,738,424,314,404492,299556,704048
150400,201810,103,87,16,82998,15264,98262
150405,201810,1260,821,439,781962.48,418233.6,1200196.08
150410,201810,135,91,44,86814,41976,128790
150420,201810,7417,4085,3332,3895726.28,3177046.66,7072772.94
150430,201810,520,349,171,332946,163134,496080
150440,201810,574,342,232,325505,221328,546833
150442,201810,2182,1182,1000,1123564.1,953709.03,2077273.13
150445,201810,512,326,186,310876.57,176490,487366.57
150450,201810,259,127,132,121158,125928,247086
150460,201810,748,568,180,540045.09,171700.92,711746.01
150470,201810,1335,810,525,771786,500850,1272636
150475,201810,220,172,48,164088,45792,209880
150480,201810,1259,881,378,840474,360325.8,1200799.8
150490,201810,607,332,275,316728,262350,579078
150495,201810,331,236,95,225144,90630,315774
150497,201810,302,208,94,198432,89666.46,288098.46
150500,201810,429,292,137,278568,130698,409266
150503,201810,899,443,456,422336,435006,857342
150506,201810,1018,666,352,635364,335798.46,971162.46
150510,201810,1231,697,534,664652,509436,1174088
150520,201810,271,181,90,172674,85860,258534
150530,201810,1591,874,717,830648.3,684018,1514666.3
150540,201810,243,167,76,159318,72504,231822
150543,201810,746,424,322,403904.52,306901.8,710806.32
150548,201810,493,346,147,330084,140238,470322
150549,201810,60,44,16,41976,15264,57240
150550,201810,2874,1520,1354,1449127,1291430,2740557
150553,201810,3159,1868,1291,1779592.8,1231604.46,3011197.26
150555,201810,144,78,66,74412,62964,137376
150560,201810,56,43,13,41022,12402,53424
150563,201810,77,41,36,39114,34344,73458
150565,201810,167,101,66,96354,62964,159318
150570,201810,411,274,137,261376.92,130698,392074.92
150580,201810,1575,705,870,671902.2,829980,1501882.2
150590,201810,787,492,295,469368,281430,750798
150600,201810,460,280,180,267120,171720,438840
150610,201810,144,124,20,117447,19080,136527
150611,201810,128,91,37,86814,35298,122112
150613,201810,3228,1996,1232,1904184,1175319,3079503
150616,201810,495,296,199,282146,189846,471992
150618,201810,1223,663,560,632273.58,534240,1166513.58
150619,201810,404,309,95,294786,90630,385416
150620,201810,1281,753,528,718362,503425.8,1221787.8
150630,201810,301,201,100,191754,95400,287154
150635,201810,489,210,279,200340,266166,466506
150640,201810,61,28,33,26712,31482,58194
150650,201810,2358,1386,972,1321920.34,926711.8,2248632.14
150655,201810,244,183,61,174582,58194,232776
150658,201810,104,58,46,55332,43884,99216
150660,201810,497,347,150,331038,143100,474138
150670,201810,1008,372,636,354592.8,606725.46,961318.26
150680,201810,9684,5298,4386,5047120.86,4183147.98,9230268.84
150690,201810,55,34,21,32436,20034,52470
150700,201810,514,337,177,321307.2,168858,490165.2
150710,201810,287,168,119,160272,113526,273798
150715,201810,845,519,326,494143.92,310975.38,805119.30
150720,201810,425,331,94,315774,89389.8,405163.8
150730,201810,950,512,438,488439,417565.8,906004.8
150740,201810,225,157,68,149778,64872,214650
150745,201810,804,440,364,419760,347256,767016
150746,201810,51,31,20,29574,19080,48654
150747,201810,252,197,55,187938,52470,240408
150750,201810,131,74,57,70596,54378,124974
150760,201810,1739,1138,601,1085652,573354,1659006
150770,201810,373,197,176,187938,167728.95,355666.95
150775,201810,95,44,51,41976,48654,90630
150780,201810,190,100,90,95400,85860,181260
150790,201810,864,469,395,447426,376830,824256
150795,201810,1477,863,614,823302,585756,1409058
150796,201810,387,223,164,212742,156456,369198
150797,201810,285,162,123,154548,117342,271890
150800,201810,1422,858,564,817573.23,538042,1355615.23
150803,201810,591,489,102,466506,97308,563814
150805,201810,187,120,67,114480,63904.46,178384.46
150808,201810,1004,554,450,528516,429300,957816
150810,201810,3396,2349,1047,2236549.75,997138.56,3233688.31
150812,201810,431,231,200,220374,190800,411174
150815,201810,968,640,328,609181.47,312912,922093.47
150820,201810,1561,954,607,909162,579058.92,1488220.92
150830,201810,824,579,245,551412,233730,785142
150835,201810,189,113,76,107802,72504,180306
150840,201810,1332,860,472,820440,450288,1270728
160005,201810,51,29,22,27666,20988,48654
160010,201810,193,124,69,118296,65822,184118
160015,201810,114,65,49,62010,46746,108756
160020,201810,130,74,56,70596,53424,124020
160021,201810,43,23,20,21942,19080,41022
160023,201810,115,69,46,65826,43884,109710
160025,201810,30,13,17,12402,16218,28620
160027,201810,1501,857,644,815002.7,613622,1428624.7
160030,201810,15605,8066,7539,7685651.96,7186723.73,14872375.69
160040,201810,305,175,130,166950,124020,290970
160050,201810,700,356,344,339624,327412.8,667036.8
160053,201810,321,184,137,175250,130698,305948
160055,201810,27,20,7,19080,6678,25758
160060,201810,6502,3433,3069,3264586.8,2926868.2,6191455.0
160070,201810,173,107,66,102078,62964,165042
160080,201810,84,44,40,41976,38160,80136
170025,201810,25,14,11,13356,10494,23850
170030,201810,226,186,40,177247,38160,215407
170035,201810,225,105,120,100170,114480,214650
170040,201810,188,145,43,138024.72,41022,179046.72
170070,201810,327,200,127,190800,121158,311958
170100,201810,361,263,98,250902,93492,344394
170105,201810,61,50,11,47700,10494,58194
170110,201810,110,69,41,65826,39114,104940
170130,201810,64,32,32,30528,30242,60770
170190,201810,100,66,34,62964,32436,95400
170200,201810,392,265,127,252133.2,121053.76,373186.96
170210,201810,5999,3150,2849,2995957.6,2715924.86,5711882.46
170215,201810,104,48,56,45792,53424,99216
170220,201810,1417,1043,374,993147.46,356510,1349657.46
170230,201810,156,102,54,97308,51516,148824
170240,201810,539,359,180,342486,171720,514206
170255,201810,1107,887,220,845988.12,209593.8,1055581.92
170270,201810,38,27,11,25758,10303.2,36061.2
170290,201810,96,72,24,68688,22896,91584
170300,201810,85,57,28,53614.8,26712,80326.8
170305,201810,48,37,11,35298,10494,45792
170307,201810,63,47,16,44838,15264,60102
170310,201810,109,60,49,57240,46746,103986
170320,201810,21,17,4,16218,3816,20034
170330,201810,24,22,2,20988,1908,22896
170360,201810,25,15,10,14310,9540,23850
170370,201810,118,63,55,60102,52470,112572
170380,201810,85,63,22,60102,20988,81090
170382,201810,45,40,5,38160,4770,42930
170384,201810,141,105,36,100170,34344,134514
170386,201810,62,27,35,25758,33390,59148
170388,201810,49,19,30,18126,28620,46746
170389,201810,28,22,6,20988,5724,26712
170390,201810,59,34,25,32427,23850,56277
170410,201810,33,24,9,22896,8586,31482
170460,201810,16,13,3,12402,2862,15264
170510,201810,30,23,7,21942,6678,28620
170550,201810,1534,888,646,846597.91,615501.92,1462099.83
170555,201810,112,79,33,75366,31482,106848
170560,201810,96,70,26,66780,24804,91584
170600,201810,39,19,20,18126,19080,37206
170610,201810,189,100,89,95242.59,84602,179844.59
170625,201810,36,20,16,19080,15264,34344
170650,201810,82,61,21,58194,20034,78228
170700,201810,567,431,136,407296.49,129457.8,536754.29
170710,201810,162,99,63,94446,60084,154530
170720,201810,83,66,17,62964,16218,79182
170730,201810,68,40,28,38160,26712,64872
170740,201810,85,62,23,59148,21942,81090
170755,201810,69,36,33,34344,31482,65826
170765,201810,139,70,69,66494,65826,132320
170770,201810,225,135,90,127692.9,85860,213552.9
170820,201810,594,391,203,373014,192947,565961
170825,201810,32,19,13,18126,12402,30528
170830,201810,80,62,18,59148,17172,76320
170900,201810,194,151,43,144054,41022,185076
170930,201810,830,435,395,414990,376258,791248
170950,201810,3045,1341,1704,1277770.06,1623499.31,2901269.37
170980,201810,18,10,8,9540,7632,17172
171050,201810,141,110,31,104940,29574,134514
171070,201810,39,32,7,30528,6678,37206
171090,201810,42,31,11,29574,10494,40068
171110,201810,20,13,7,12402,6678,19080
171150,201810,41,20,21,19080,20034,39114
171180,201810,22,10,12,9540,11448,20988
171190,201810,146,85,61,81090,58194,139284
171195,201810,64,50,14,47700,13356,61056
171200,201810,46,20,26,19080,24804,43884
171215,201810,3,3,0,2862,0,2862
171240,201810,55,45,10,42930,9540,52470
171245,201810,55,50,5,47700,4770,52470
171250,201810,70,37,33,35298,31472.46,66770.46
171270,201810,17,13,4,12402,3816,16218
171280,201810,40,36,4,34201,3816,38017
171320,201810,990,566,424,539964,403446.6,943410.6
171330,201810,426,206,220,196524,209880,406404
171360,201810,92,65,27,62010,25758,87768
171370,201810,25,13,12,12402,11448,23850
171380,201810,134,109,25,103986,23333.89,127319.89
171395,201810,55,34,21,32436,20034,52470
171420,201810,307,197,110,187938,104940,292878
171430,201810,68,54,14,51516,13356,64872
171488,201810,198,106,92,101124,87768,188892
171500,201810,58,32,26,30528,24804,55332
171510,201810,68,45,23,42930,21942,64872
171515,201810,43,36,7,34344,6392,40736
171525,201810,30,26,4,24804,3816,28620
171550,201810,12,7,5,6678,4770,11448
171570,201810,59,31,28,29574,26712,56286
171575,201810,334,212,122,202248,116378.46,318626.46
171610,201810,1719,869,850,827126.99,809370.2,1636497.19
171620,201810,133,92,41,87214.68,39114,126328.68
171630,201810,56,28,28,26712,26712,53424
171650,201810,269,180,89,171720,84906,256626
171660,201810,262,142,120,135468,114476,249944
171665,201810,52,36,16,34344,15264,49608
171670,201810,428,249,179,236306.3,170479.8,406786.1
171700,201810,66,58,8,55332,7632,62964
171720,201810,27,10,17,9540,16218,25758
171750,201810,104,57,47,54378,44838,99216
171780,201810,77,62,15,59148,14310,73458
171790,201810,75,64,11,61056,10494,71550
171800,201810,38,30,8,28620,7632,36252
171820,201810,2058,1165,893,1109320.74,847315.02,1956635.76
171830,201810,36,29,7,27666,6678,34344
171840,201810,67,40,27,38160,25758,63918
171845,201810,32,19,13,18126,12402,30528
171850,201810,41,30,11,28620,10494,39114
171855,201810,80,63,17,60102,16218,76320
171865,201810,8,7,1,6678,954,7632
171870,201810,31,22,9,20988,8586,29574
171875,201810,81,56,25,53424,23850,77274
171880,201810,30,20,10,19080,9540,28620
171884,201810,49,26,23,24804,21942,46746
171886,201810,125,46,79,43884,75079.8,118963.8
171888,201810,25,19,6,18126,5724,23850
171889,201810,19,15,4,14310,3816,18126
171890,201810,58,48,10,45792,9540,55332
171900,201810,44,31,13,29574,12402,41976
172000,201810,40,34,6,32436,5724,38160
172010,201810,42,36,6,33533.1,5724,39257.1
172015,201810,25,16,9,15064,8299.8,23363.8
172020,201810,138,88,50,83952,47700,131652
172025,201810,32,21,11,20034,10494,30528
172030,201810,39,24,15,22896,14310,37206
172049,201810,74,46,28,43884,26712,70596
172065,201810,148,96,52,91534,49608,141142
172080,201810,97,66,31,61781.84,29574,91355.84
172085,201810,25,12,13,11448,12402,23850
172090,201810,415,319,96,303529.41,90821,394350.41
172093,201810,26,20,6,19080,5724,24804
172097,201810,17,9,8,8586,7346,15932
172100,201810,4809,2713,2096,2580437.62,1997401.2,4577838.82
172110,201810,82,55,27,52470,25758,78228
172120,201810,1699,1460,239,1388059.99,226879.41,1614939.40
172125,201810,4,4,0,3816,0,3816
172130,201810,16,12,4,11448,3816,15264
172208,201810,193,123,70,117342,66780,184122
172210,201810,397,196,201,186984,191468,378452
210005,201810,2935,1838,1097,1750399.22,1043392,2793791.22
210010,201810,186,95,91,90630,86814,177444
210015,201810,33,23,10,21942,9540,31482
210020,201810,350,188,162,179352,154548,333900
210030,201810,346,219,127,208926,121149,330075
210040,201810,149,115,34,109710,32436,142146
210043,201810,271,189,82,180306,78228,258534
210047,201810,592,322,270,306806.4,257580,564386.4
210050,201810,301,220,81,209880,77274,287154
210055,201810,41,32,9,30528,8586,39114
210060,201810,562,448,114,427292.79,108469.8,535762.59
210070,201810,415,311,104,296694,99216,395910
210080,201810,106,96,10,91584,9540,101124
210083,201810,307,139,168,132606,160272,292878
210087,201810,41,31,10,28772.64,9540,38312.64
210090,201810,485,338,147,322452,140238,462690
210095,201810,479,355,124,338660.46,118296,456956.46
210100,201810,693,531,162,506240.1,153594.02,659834.12
210110,201810,145,83,62,79182,59148,138330
210120,201810,5424,4118,1306,3921653,1244675.45,5166328.45
210125,201810,209,123,86,117342,82044,199386
210130,201810,526,287,239,272844,227986.92,500830.92
210135,201810,33,20,13,19080,12402,31482
210140,201810,4394,3451,943,3289689.44,899622,4189311.44
210150,201810,367,231,136,220374,129744,350118
210160,201810,3414,2879,535,2743706.78,510104,3253810.78
210170,201810,1155,912,243,870048,231822,1101870
210173,201810,125,104,21,99216,20034,119250
210177,201810,443,223,220,212742,209880,422622
210180,201810,31,17,14,16218,13356,29574
210190,201810,419,276,143,263304,136422,399726
210193,201810,1,1,0,954,0,954
210197,201810,79,53,26,50562,24785.88,75347.88
210200,201810,650,518,132,494007.54,125928,619935.54
210203,201810,257,173,84,164756,80136,244892
210207,201810,386,303,83,289062,79182,368244
210210,201810,788,723,65,689742,62010,751752
210215,201810,81,69,12,65826,11448,77274
210220,201810,396,326,70,311004,66493.8,377497.8
210230,201810,310,238,72,227052,68688,295740
210232,201810,1475,952,523,907922,498942,1406864
210235,201810,158,125,33,119060,31482,150542
210237,201810,43,25,18,23850,17172,41022
210240,201810,92,76,16,72504,15264,87768
210250,201810,188,152,36,145008,34344,179352
210255,201810,351,259,92,247086,87768,334854
210260,201810,420,268,152,255672,145008,400680
210270,201810,694,445,249,424530,237546,662076
210275,201810,53,40,13,38160,12402,50562
210280,201810,1067,688,379,653541.33,360230.5,1013771.83
210290,201810,511,340,171,324360,163134,487494
210300,201810,6007,3555,2452,3385861.14,2338016.23,5723877.37
210310,201810,108,76,32,72504,30528,103032
210312,201810,120,80,40,76320,38160,114480
210315,201810,116,89,27,84906,25758,110664
210317,201810,128,92,36,87768,34344,122112
210320,201810,2385,1970,415,1877669.84,395910,2273579.84
210325,201810,130,90,40,84906,37874,122780
210330,201810,5353,2833,2520,2696888.46,2404070.46,5100958.92
210340,201810,1367,985,382,938890,364357.07,1303247.07
210350,201810,617,511,106,487255.5,101124,588379.5
210355,201810,140,114,26,108756,24804,133560
210360,201810,2612,1660,952,1580493.6,907922,2488415.6
210370,201810,1259,566,693,539964,661122,1201086
210375,201810,191,98,93,92949,88722,181671
210380,201810,725,542,183,517068,174582,691650
210390,201810,201,167,34,159318,32436,191754
210400,201810,426,363,63,346302,60083,406385
210405,201810,1015,691,324,659214,309096,968310
210407,201810,55,43,12,41022,11448,52470
210408,201810,67,60,7,57240,6678,63918
210409,201810,325,272,53,259488,50562,310050
210410,201810,442,343,99,327222,94437,421659
210420,201810,196,161,35,153594,33390,186984
210430,201810,41,28,13,26712,12402,39114
210440,201810,369,228,141,217512,134514,352026
210450,201810,155,118,37,112572,35298,147870
210455,201810,227,124,103,118296,98262,216558
210460,201810,345,218,127,207972,121158,329130
210462,201810,66,55,11,52470,10494,62964
210465,201810,171,124,47,118296,44838,163134
210467,201810,541,388,153,370148,145962,516110
210470,201810,44,35,9,33390,8586,41976
210480,201810,1314,935,379,891990,361566,1253556
210490,201810,218,136,82,129744,78228,207972
210500,201810,580,311,269,296694,256626,553320
210510,201810,565,440,125,419760,119250,539010
210515,201810,431,241,190,229914,181260,411174
210520,201810,410,359,51,342199.8,48654,390853.8
210530,201810,9449,5060,4389,4814403.77,4178680.59,8993084.36
210535,201810,129,93,36,88722,34344,123066
210540,201810,1554,956,598,910879.8,569728.8,1480608.6
210542,201810,1207,595,612,567248.4,583562,1150810.4
210545,201810,12,11,1,10494,954,11448
210547,201810,132,113,19,107802,18126,125928
210550,201810,732,521,211,495467,201294,696761
210560,201810,178,149,29,142146,27666,169812
210565,201810,30,22,8,20988,7632,28620
210570,201810,1366,1079,287,1028126.26,273798,1301924.26
210580,201810,109,95,14,90630,13356,103986
210590,201810,770,619,151,589762.8,144054,733816.8
210592,201810,33,29,4,27666,3816,31482
210594,201810,106,87,19,82998,18126,101124
210596,201810,92,77,15,73458,14310,87768
210598,201810,128,92,36,87768,34344,122112
210600,201810,339,287,52,273798,49608,323406
210610,201810,258,239,19,227052,18126,245178
210620,201810,47,27,20,25758,19080,44838
210630,201810,64,61,3,58194,2862,61056
210632,201810,1086,727,359,693558,342009,1035567
210635,201810,20,17,3,16218,2862,19080
210637,201810,104,72,32,68688,30528,99216
210640,201810,592,519,73,495126,69642,564768
210650,201810,415,336,79,319618.62,74412,394030.62
210660,201810,404,293,111,278092,105770,383862
210663,201810,23,12,11,11448,10494,21942
210667,201810,113,36,77,34344,73458,107802
210670,201810,270,236,34,224429,32436,256865
210675,201810,567,303,264,289062,251856,540918
210680,201810,209,132,77,125928,73458,199386
210690,201810,639,515,124,491310,118296,609606
210700,201810,188,139,49,132606,46746,179352
210710,201810,292,167,125,159127.2,119250,278377.2
210720,201810,136,116,20,110664,19080,129744
210725,201810,70,61,9,58194,8586,66780
210730,201810,27,20,7,19080,6678,25758
210735,201810,412,280,132,267120,125642,392762
210740,201810,563,475,88,453150,83952,537102
210745,201810,156,115,41,109710,39114,148824
210750,201810,2426,1118,1308,1064617,1247812.92,2312429.92
210760,201810,265,198,67,188892,63903.69,252795.69
210770,201810,403,312,91,297600.3,86527.8,384128.1
210780,201810,423,309,114,294786,108756,403542
210790,201810,189,145,44,138330,41976,180306
210800,201810,159,118,41,112572,39114,151686
210805,201810,47,43,4,41022,3816,44838
210810,201810,490,379,111,360898.2,105894,466792.2
210820,201810,2341,1868,473,1774390.61,451242,2225632.61
210825,201810,173,91,82,86814,78228,165042
210830,201810,797,499,298,475092,283338,758430
210840,201810,211,142,69,135468,65826,201294
210845,201810,254,161,93,153594,88722,242316
210850,201810,832,534,298,509436,284292,793728
210860,201810,4096,2154,1942,2053390.3,1852362.72,3905753.02
210870,201810,477,361,116,344394,110664,455058
210880,201810,68,50,18,47700,17172,64872
210890,201810,351,294,57,280476,54378,334854
210900,201810,590,385,205,367286,195570,562856
210905,201810,67,34,33,32436,31482,63918
210910,201810,2009,1492,517,1422077.99,493218,1915295.99
210920,201810,217,68,149,64872,142146,207018
210923,201810,81,59,22,56286,20988,77274
210927,201810,432,188,244,179352,232776,412128
210930,201810,67,53,14,50562,13356,63918
210940,201810,95,73,22,69642,20988,90630
210945,201810,199,94,105,89676,100170,189846
210950,201810,516,377,139,359658,132601.23,492259.23
210955,201810,74,49,25,46746,23850,70596
210960,201810,2404,1067,1337,1016296.4,1275498,2291794.4
210970,201810,115,101,14,96354,13356,109710
210975,201810,93,84,9,80136,8586,88722
210980,201810,1194,533,661,508367.52,630308,1138675.52
210990,201810,4350,2737,1613,2609997.13,1538802,4148799.13
211000,201810,1387,1101,286,1050068,272557.8,1322625.8
211003,201810,925,635,290,605790,276651,882441
211010,201810,499,440,59,419760,56286,476046
211020,201810,1601,600,1001,572400,954734.58,1527134.58
211023,201810,28,24,4,22609.8,3816,26425.8
211027,201810,69,47,22,44838,20988,65826
211030,201810,386,263,123,250902,117342,368244
211040,201810,325,256,69,243938,65826,309764
211050,201810,1183,768,415,732652.92,395619.23,1128272.15
211060,201810,690,585,105,556182,100170,656352
211065,201810,22,18,4,17172,3816,20988
211070,201810,931,760,171,723428.74,163134,886562.74
211080,201810,87,83,4,79182,3816,82998
211085,201810,61,32,29,30242,27666,57908
211090,201810,90,72,18,68688,17172,85860
211100,201810,502,404,98,385129.8,93492,478621.8
211102,201810,259,176,83,167904,79182,247086
211105,201810,224,153,71,145962,67734,213696
211107,201810,137,79,58,75366,55332,130698
211110,201810,833,539,294,513634,280467,794101
211120,201810,5773,2570,3203,2446565.4,3054570.23,5501135.63
211125,201810,33,26,7,24804,6678,31482
211130,201810,45587,19562,26025,18629499.99,24816308.37,43445808.36
211140,201810,428,365,63,347252,60102,407354
211150,201810,1300,834,466,795302.1,444274,1239576.1
211153,201810,168,98,70,93492,66780,160272
211157,201810,65,51,14,48654,13356,62010
211160,201810,717,599,118,570730.5,112572,683302.5
211163,201810,0,0,0,0,0,0
211167,201810,11,9,2,8586,1908,10494
211170,201810,442,315,127,300510,121158,421668
211172,201810,122,85,37,81090,35298,116388
211174,201810,264,158,106,150732,101124,251856
211176,201810,513,370,143,352980,136422,489402
211178,201810,96,62,34,59148,32436,91584
211180,201810,211,166,45,158364,42767.82,201131.82
211190,201810,65,60,5,57240,4770,62010
211195,201810,30,19,11,18126,10494,28620
211200,201810,155,135,20,128446.56,19080,147526.56
211210,201810,513,329,184,313198.2,175536,488734.2
211220,201810,4069,2304,1765,2190194.39,1677473.04,3867667.43
211223,201810,95,90,5,85678.74,4770,90448.74
211227,201810,70,50,20,47700,19080,66780
211230,201810,783,637,146,607554.9,139264.92,746819.82
211240,201810,417,314,103,299269.8,98262,397531.8
211245,201810,198,90,108,85860,103032,188892
211250,201810,1641,1402,239,1336516.12,228006,1564522.12
211260,201810,830,659,171,628686,163134,791820
211270,201810,2064,1640,424,1564560,403542.2,1968102.2
211280,201810,1863,1134,729,1080882.8,695466,1776348.8
211285,201810,206,122,84,116388,80136,196524
211290,201810,691,470,221,448189.2,210834,659023.2
211300,201810,817,633,184,603604.09,175536,779140.09
211400,201810,1595,918,677,875772,645858,1521630
220005,201810,17,16,1,15264,954,16218
220010,201810,89,67,22,63918,20701.8,84619.8
220020,201810,636,507,129,482375.08,123066,605441.08
220025,201810,108,105,3,100170,2862,103032
220027,201810,38,31,7,29574,6678,36252
220030,201810,102,85,17,81090,16218,97308
220040,201810,1150,869,281,827882.04,268074,1095956.04
220045,201810,39,28,11,26712,10494,37206
220050,201810,672,556,116,529262.96,110664,639926.96
220060,201810,175,149,26,142146,24804,166950
220070,201810,104,94,10,89676,9540,99216
220080,201810,12,11,1,10494,954,11448
220090,201810,35,28,7,26712,6678,33390
220095,201810,2,1,1,954,954,1908
220100,201810,27,23,4,21942,3816,25758
220105,201810,27,25,2,23564,1908,25472
220110,201810,214,196,18,186697.8,17172,203869.8
220115,201810,52,49,3,46746,2862,49608
220117,201810,21,19,2,18126,1908,20034
220120,201810,1490,1087,403,1035662.4,384462,1420124.4
220130,201810,27,26,1,24804,954,25758
220140,201810,99,78,21,73458,20034,93492
220150,201810,472,338,134,322452,127836,450288
220155,201810,4,4,0,3816,0,3816
220157,201810,18,15,3,14310,2862,17172
220160,201810,77,66,11,62964,10494,73458
220170,201810,38,36,2,34344,1908,36252
220173,201810,6,6,0,5724,0,5724
220177,201810,5,5,0,4770,0,4770
220180,201810,65,65,0,62005.23,0,62005.23
220190,201810,1065,954,111,910116,105894,1016010
220191,201810,43,38,5,36252,4770,41022
220192,201810,68,65,3,62010,2862,64872
220194,201810,42,39,3,37206,2862,40068
220196,201810,104,86,18,82044,17172,99216
220198,201810,5,4,1,3816,954,4770
220200,201810,426,352,74,335475,70596,406071
220202,201810,37,33,4,31482,3816,35298
220205,201810,40,36,4,34344,3816,38160
220207,201810,18,17,1,16218,954,17172
220208,201810,86,46,40,43884,38160,82044
220209,201810,31,28,3,26712,2862,29574
220210,201810,15,13,2,12402,1908,14310
220211,201810,26,26,0,24804,0,24804
220213,201810,42,38,4,36252,3530,39782
220217,201810,37,29,8,27666,7632,35298
220220,201810,2080,1339,741,1273780.8,705531,1979311.8
220225,201810,14,7,7,6678,6678,13356
220230,201810,954,754,200,718867.62,190160.82,909028.44
220240,201810,151,139,12,132606,11448,144054
220245,201810,32,29,3,26963.04,2862,29825.04
220250,201810,113,102,11,97308,10494,107802
220253,201810,42,36,6,34344,5724,40068
220255,201810,29,26,3,24804,2862,27666
220260,201810,691,501,190,477954,181260,659214
220265,201810,15,11,4,10494,3816,14310
220270,201810,709,629,80,599340.96,75843,675183.96
220271,201810,42,35,7,33390,6678,40068
220272,201810,26,26,0,24804,0,24804
220273,201810,15,13,2,12402,1908,14310
220275,201810,59,47,12,44838,11448,56286
220277,201810,13,11,2,10494,1908,12402
220280,201810,14,11,3,10494,2862,13356
220285,201810,46,43,3,41022,2862,43884
220290,201810,1428,1218,210,1158680.8,200293,1358973.8
220300,201810,51,49,2,46746,1908,48654
220310,201810,315,265,50,252806,47691,300497
220320,201810,436,403,33,383032,31482,414514
220323,201810,0,0,0,0,0,0
220325,201810,16,11,5,10494,4770,15264
220327,201810,13,12,1,11448,954,12402
220330,201810,212,147,65,140238,62010,202248
220335,201810,134,116,18,110664,17172,127836
220340,201810,29,18,11,17172,10494,27666
220342,201810,59,51,8,48654,7632,56286
220345,201810,86,78,8,74412,7632,82044
220350,201810,429,376,53,356081.42,50562,406643.42
220360,201810,42,31,11,29574,10494,40068
220370,201810,1139,925,214,881686.8,203869.8,1085556.6
220375,201810,27,25,2,23850,1908,25758
220380,201810,40,33,7,31482,6678,38160
220385,201810,22,19,3,18126,2862,20988
220390,201810,2286,1305,981,1240276.55,934777.5,2175054.05
220400,201810,30,27,3,25758,2862,28620
220410,201810,17,16,1,15264,954,16218
220415,201810,13,12,1,11448,954,12402
220420,201810,130,107,23,102078,21655.8,123733.8
220430,201810,130,119,11,111857.8,10494,122351.8
220435,201810,21,15,6,14305.23,5724,20029.23
220440,201810,299,254,45,242316,42930,285246
220450,201810,339,173,166,163876.98,158364,322240.98
220455,201810,56,54,2,51516,1908,53424
220460,201810,19,19,0,17458.2,0,17458.2
220465,201810,104,68,36,64872,34344,99216
220470,201810,240,212,28,202248,26712,228960
220480,201810,73,64,9,61056,8586,69642
220490,201810,88,76,12,72504,11448,83952
220500,201810,98,83,15,79182,14310,93492
220510,201810,380,303,77,288299,73267.2,361566.2
220515,201810,20,18,2,17172,1908,19080
220520,201810,369,332,37,315556,35298,350854
220525,201810,23,16,7,15264,6678,21942
220527,201810,37,29,8,27666,6822,34488
220530,201810,35,14,21,13356,20034,33390
220535,201810,7,7,0,6678,0,6678
220540,201810,60,51,9,48654,8586,57240
220545,201810,55,37,18,35298,17172,52470
220550,201810,648,495,153,471466.8,145962,617428.8
220551,201810,27,21,6,20034,5724,25758
220552,201810,11,11,0,10494,0,10494
220553,201810,47,42,5,40068,4770,44838
220554,201810,11,7,4,6391.8,3816,10207.8
220555,201810,27,24,3,22896,2862,25758
220556,201810,52,48,4,45792,3816,49608
220557,201810,56,50,6,47700,5724,53424
220558,201810,6,2,4,1908,3816,5724
220559,201810,5,5,0,4770,0,4770
220560,201810,63,41,22,38923.2,20988,59911.2
220570,201810,794,484,310,460531.88,295740,756271.88
220580,201810,565,519,46,495126,43217,538343
220585,201810,6,5,1,4770,954,5724
220590,201810,14,14,0,13356,0,13356
220595,201810,60,45,15,42930,14310,57240
220600,201810,23,12,11,11448,10494,21942
220605,201810,20,19,1,18126,954,19080
220610,201810,65,57,8,54378,7632,62010
220620,201810,563,448,115,427153.5,109710,536863.5
220630,201810,5,4,1,3816,954,4770
220635,201810,38,34,4,32436,3816,36252
220640,201810,96,75,21,71550,20034,91584
220650,201810,110,104,6,99216,5724,104940
220660,201810,35,29,6,27666,5724,33390
220665,201810,4,4,0,3816,0,3816
220667,201810,14,13,1,12402,954,13356
220669,201810,29,26,3,24804,2862,27666
220670,201810,69,55,14,52470,13356,65826
220672,201810,66,44,22,41976,20988,62964
220675,201810,38,30,8,28620,7632,36252
220680,201810,37,32,5,30528,4770,35298
220690,201810,44,42,2,40068,1908,41976
220695,201810,54,24,30,22896,28620,51516
220700,201810,1603,1227,376,1168716.78,358704,1527420.78
220710,201810,5,3,2,2862,1908,4770
220720,201810,108,88,20,83713.5,19080,102793.5
220730,201810,19,18,1,17172,954,18126
220735,201810,3,1,2,954,1908,2862
220740,201810,50,45,5,42930,4770,47700
220750,201810,100,84,16,80136,15264,95400
220755,201810,15,15,0,14310,0,14310
220760,201810,56,53,3,50562,2862,53424
220770,201810,5678,2979,2699,2835755.83,2568976.41,5404732.24
220775,201810,22,10,12,9540,11448,20988
220777,201810,17,16,1,15264,954,16218
220779,201810,16,13,3,12402,2862,15264
220780,201810,877,752,125,716740.2,118964,835704.2
220785,201810,16,10,6,9540,5724,15264
220790,201810,1035,827,208,786575,198432,985007
220793,201810,12,12,0,11448,0,11448
220795,201810,21,20,1,19080,954,20034
220800,201810,4017,3071,946,2927527.93,901718.89,3829246.82
220810,201810,65,57,8,54378,7632,62010
220820,201810,243,221,22,210834,20988,231822
220830,201810,1198,1018,180,970881.03,171720,1142601.03
220840,201810,2382,1658,724,1570842.27,687816.66,2258658.93
220850,201810,54,46,8,43884,7632,51516
220855,201810,14,9,5,8586,4770,13356
220860,201810,9,8,1,7632,954,8586
220865,201810,21,19,2,18126,1908,20034
220870,201810,66,62,4,59148,3816,62964
220880,201810,322,248,74,235924.2,70310,306234.2
220885,201810,39,36,3,34344,2862,37206
220887,201810,17,17,0,16218,0,16218
220890,201810,101,89,12,84906,11448,96354
220900,201810,53,30,23,28620,21942,50562
220910,201810,56,48,8,45792,7632,53424
220915,201810,9,8,1,7632,954,8586
220920,201810,41,37,4,35298,3816,39114
220930,201810,41,40,1,38160,954,39114
220935,201810,17,17,0,16218,0,16218
220937,201810,43,40,3,38160,2862,41022
220940,201810,55,50,5,47700,4770,52470
220945,201810,0,0,0,0,0,0
220950,201810,47,43,4,41022,3816,44838
220955,201810,37,34,3,32436,2862,35298
220960,201810,2,2,0,1908,0,1908
220965,201810,30,27,3,25758,2862,28620
220970,201810,54,46,8,43884,7632,51516
220975,201810,10,9,1,8586,954,9540
220980,201810,32,30,2,28620,1908,30528
220985,201810,67,59,8,56286,7632,63918
220987,201810,33,31,2,29574,1908,31482
220990,201810,15,14,1,13356,954,14310
220995,201810,35,30,5,28620,4770,33390
220997,201810,52,42,10,40068,9540,49608
221000,201810,1144,1032,112,981381.8,106561.8,1087943.6
221005,201810,61,55,6,52470,5724,58194
221010,201810,17,14,3,13356,2862,16218
221020,201810,46,44,2,41976,1908,43884
221030,201810,31,25,6,23850,5724,29574
221035,201810,22,22,0,20988,0,20988
221037,201810,12,6,6,5724,5724,11448
221038,201810,26,23,3,21942,2862,24804
221039,201810,22,22,0,20988,0,20988
221040,201810,255,219,36,208926,34344,243270
221050,201810,237,202,35,192708,33390,226098
221060,201810,1783,1569,214,1494311.61,204156,1698467.61
221062,201810,31,30,1,28620,954,29574
221063,201810,13,9,4,8586,3816,12402
221065,201810,52,45,7,42930,6678,49608
221070,201810,141,122,19,116102,18126,134228
221080,201810,376,333,43,317682,40735.8,358417.8
221090,201810,34,33,1,31482,954,32436
221093,201810,56,37,19,35298,18126,53424
221095,201810,10,9,1,8586,954,9540
221097,201810,20,17,3,16218,2862,19080
221100,201810,25084,14560,10524,13868725.77,10032506.23,23901232.00
221110,201810,1053,782,271,745742,258534,1004276
221120,201810,532,400,132,381314,125928,507242
221130,201810,954,781,173,743834.6,165042,908876.6
221135,201810,36,33,3,31482,2862,34344
221140,201810,40,33,7,31482,6678,38160
221150,201810,14,11,3,10494,2862,13356
221160,201810,14,14,0,13356,0,13356
221170,201810,14,14,0,13356,0,13356
230010,201810,169,155,14,147870,13356,161226
230015,201810,122,102,20,97308,19080,116388
230020,201810,1613,1367,246,1301189.82,234442.9,1535632.72
230030,201810,1648,1193,455,1133506.38,434070,1567576.38
230040,201810,208,182,26,172149.5,24804,196953.5
230050,201810,210,155,55,147870,52470,200340
230060,201810,159,130,29,123256.8,27666,150922.8
230070,201810,284,254,30,242316,28620,270936
230075,201810,844,740,104,703957,98929.8,802886.8
230080,201810,186,159,27,151686,25758,177444
230090,201810,108,76,32,71740.8,30528,102268.8
230100,201810,1959,1165,794,1109095,757448,1866543
230110,201810,2701,1740,961,1657504.16,916221.8,2573725.96
230120,201810,968,774,194,735983.6,185057,921040.6
230125,201810,147,122,25,116388,23850,140238
230130,201810,470,420,50,400680,47700,448380
230140,201810,206,180,26,171720,24804,196524
230150,201810,157,122,35,116388,33390,149778
230160,201810,928,799,129,761769,123066,884835
230170,201810,590,543,47,513724.7,44838,558562.7
230180,201810,78,73,5,69642,4770,74412
230185,201810,409,356,53,338020.46,50562,388582.46
230190,201810,2249,1819,430,1731346.48,409903,2141249.48
230195,201810,496,431,65,411174,62010,473184
230200,201810,388,333,55,316718.46,52470,369188.46
230205,201810,368,241,127,227858.13,121158,349016.13
230210,201810,1258,1002,256,953839.12,243432.8,1197271.92
230220,201810,1485,1011,474,964494,452149,1416643
230230,201810,896,780,116,743929.2,110664,854593.2
230240,201810,1657,1426,231,1359482.7,220354.92,1579837.62
230250,201810,1793,1483,310,1410144.17,295740,1705884.17
230260,201810,3022,1867,1155,1776879.16,1100916.77,2877795.93
230270,201810,1376,1106,270,1052238.19,256387.5,1308625.69
230280,201810,2739,2041,698,1940715.26,665224.2,2605939.46
230290,201810,405,364,41,342797.55,39114,381911.55
230300,201810,516,385,131,366030.72,124974,491004.72
230310,201810,417,311,106,296546.13,101124,397670.13
230320,201810,943,804,139,763331.38,131868.74,895200.12
230330,201810,303,241,62,229150.8,58958,288108.8
230340,201810,450,363,87,345349,82998,428347
230350,201810,3076,1952,1124,1862093.52,1069702.2,2931795.72
230360,201810,278,216,62,205268,59148,264416
230365,201810,138,109,29,103271,27666,130937
230370,201810,9810,4863,4947,4629397.85,4715379.92,9344777.77
230380,201810,477,409,68,389900,63918.6,453818.6
230390,201810,511,287,224,273798,213696,487494
230393,201810,262,217,45,206012.16,42930,248942.16
230395,201810,342,277,65,264010,62010,326020
230400,201810,599,474,125,451242,118753.92,569995.92
230410,201810,2644,1658,986,1575341.75,940168,2515509.75
230420,201810,6233,4117,2116,3906221.71,2014078.14,5920299.85
230423,201810,313,272,41,259488,39114,298602
230425,201810,375,309,66,294311,62964,357275
230426,201810,116,101,15,95628.96,14023.8,109652.76
230427,201810,81,78,3,74412,2862,77274
230428,201810,1389,712,677,678961.8,645839,1324800.8
230430,201810,461,377,84,359463.2,80136,439599.2
230435,201810,814,577,237,548739.43,224858.61,773598.04
230440,201810,84853,37724,47129,35897163.06,44906210.84,80803373.90
230445,201810,273,188,85,179352,81090,260442
230450,201810,547,440,107,419760,102078,521838
230460,201810,59,49,10,46746,9540,56286
230465,201810,304,248,56,236592,53424,290016
230470,201810,1924,1510,414,1440540,393849.1,1834389.1
230480,201810,157,150,7,142813.8,6678,149491.8
230490,201810,285,229,56,218466,53424,271890
230495,201810,449,337,112,319693.18,106848,426541.18
230500,201810,967,726,241,691650,229914,921564
230510,201810,48,39,9,37206,8586,45792
230520,201810,385,305,80,290771,76320,367091
230523,201810,2161,1363,798,1297031.75,760052.38,2057084.13
230526,201810,297,249,48,237546,45001,282547
230530,201810,678,501,177,475665.2,167904.2,643569.4
230533,201810,187,177,10,168858,9540,178398
230535,201810,348,263,85,250902,81090,331992
230540,201810,1843,1620,223,1542836.08,212169.8,1755005.88
230550,201810,3699,2373,1326,2254848.86,1264226.49,3519075.35
230560,201810,579,441,138,419569.4,130679,550248.4
230565,201810,205,150,55,143100,51706.8,194806.8
230570,201810,300,266,34,253764,32436,286200
230580,201810,1111,822,289,781918.1,274752,1056670.1
230590,201810,969,754,215,715740.1,204823.8,920563.9
230600,201810,257,234,23,222492.07,21942,244434.07
230610,201810,342,271,71,258344,67734,326078
230620,201810,172,141,31,133560,29574,163134
230625,201810,721,526,195,500221.16,185162.68,685383.84
230630,201810,1285,1019,266,971840,253382.4,1225222.4
230640,201810,3682,3191,491,3037246.57,466449.67,3503696.24
230650,201810,408,357,51,339633.13,48639.69,388272.82
230655,201810,668,580,88,553301,83543.76,636844.76
230660,201810,358,302,56,288108,53137.8,341245.8
230670,201810,429,380,49,362520,46746,409266
230680,201810,197,179,18,170766,17172,187938
230690,201810,880,764,116,728827.38,110664,839491.38
230700,201810,721,613,108,584802,102717.8,687519.8
230710,201810,739,699,40,666656,38160,704816
230720,201810,151,129,22,122674.86,20988,143662.86
230725,201810,252,202,50,192708,47691,240399
230730,201810,11919,6465,5454,6151498.5,5195287.88,11346786.38
230740,201810,654,529,125,504380,118559.46,622939.46
230750,201810,820,699,121,665654.3,115434,781088.3
230760,201810,1362,1177,185,1118125.25,176442.3,1294567.55
230763,201810,314,263,51,248946.95,48654,297600.95
230765,201810,7106,3339,3767,3179659.14,3592039.9,6771699.04
230770,201810,4971,2564,2407,2436187.14,2294227.22,4730414.36
230780,201810,685,604,81,573314.1,77259.69,650573.79
230790,201810,215,178,37,169812,34497.4,204309.4
230800,201810,1127,823,304,784831.95,290016,1074847.95
230810,201810,1309,1165,144,1110408.3,137185.2,1247593.5
230820,201810,341,243,98,230869,93492,324361
230830,201810,943,815,128,773996.41,122112,896108.41
230835,201810,285,246,39,233730,36491,270221
230837,201810,167,141,26,134514,24804,159318
230840,201810,920,736,184,700904.5,175250,876154.5
230850,201810,1506,1313,193,1252125,183808,1435933
230860,201810,300,227,73,216558,69355.8,285913.8
230870,201810,1825,1557,268,1484396,255100,1739496
230880,201810,41,30,11,28620,10494,39114
230890,201810,559,511,48,487371.8,45778,533149.8
230900,201810,273,207,66,197478,62767,260245
230910,201810,202,162,40,153784.8,38160,191944.8
230920,201810,407,319,88,304326,83952,388278
230930,201810,928,659,269,625824.64,256626,882450.64
230940,201810,847,678,169,646621.2,161036,807657.2
230945,201810,497,416,81,396388,77274,473662
230950,201810,383,328,55,312912,52470,365382
230960,201810,2581,1757,824,1669117.14,785763,2454880.14
230970,201810,1767,996,771,948991.42,734457.46,1683448.88
230980,201810,209,176,33,167904,31482,199386
230990,201810,140,114,26,108756,24047.47,132803.47
231000,201810,212,192,20,181260,19080,200340
231010,201810,141,110,31,104653.8,29574,134227.8
231020,201810,1308,915,393,871289,374903,1246192
231025,201810,1005,759,246,720930.04,233157.8,954087.84
231030,201810,1124,943,181,899331.8,172674,1072005.8
231040,201810,142,97,45,91793.88,42199,133992.88
231050,201810,994,886,108,843479.9,103032,946511.9
231060,201810,144,126,18,120204,17172,137376
231070,201810,1475,1042,433,991970.1,413035,1405005.1
231080,201810,258,241,17,229103.1,16218,245321.1
231085,201810,580,363,217,345349,207018,552367
231090,201810,243,201,42,191754,40068,231822
231095,201810,166,133,33,126882,31482,158364
231100,201810,133,112,21,106848,18793.8,125641.8
231110,201810,360,312,48,295458.1,45792,341250.1
231120,201810,296,255,41,243265.23,39114,282379.23
231123,201810,146,139,7,132606,6678,139284
231126,201810,315,251,64,239454,61056,300510
231130,201810,4580,3563,1017,3389874.3,969422.26,4359296.56
231135,201810,213,184,29,175536,26782,202318
231140,201810,3130,2296,834,2186929.26,794662.92,2981592.18
231150,201810,365,348,17,331992,16218,348210
231160,201810,1207,956,251,908943.08,239216.04,1148159.12
231170,201810,535,358,177,341532,168858,510390
231180,201810,1674,1427,247,1360594.8,235609.38,1596204.18
231190,201810,195,170,25,162180,23850,186030
231195,201810,219,189,30,179582,28620,208202
231200,201810,832,676,156,644904,147871,792775
231210,201810,603,506,97,481770.8,92538,574308.8
231220,201810,1042,754,288,716636.07,274752,991388.07
231230,201810,1411,1125,286,1072296.04,272557.8,1344853.84
231240,201810,1401,1019,382,971820.8,363426.5,1335247.3
231250,201810,112,104,8,99216,7632,106848
231260,201810,290,189,101,180306,96068,276374
231270,201810,1008,837,171,792901.84,163134,956035.84
231280,201810,60,46,14,43455,13356,56811
231290,201810,7284,4071,3213,3876900.49,3063699.14,6940599.63
231300,201810,628,581,47,554274,44838,599112
231310,201810,724,671,53,638917,50562,689479
231320,201810,575,439,136,418330,129715.38,548045.38
231325,201810,92,83,9,79182,8586,87768
231330,201810,2045,1578,467,1499569.04,443706.4,1943275.44
231335,201810,249,222,27,211788,25758,237546
231340,201810,1642,1210,432,1153196.08,411841.8,1565037.88
231350,201810,1230,1014,216,966959,205492,1172451
231355,201810,426,371,55,353934,52470,406404
231360,201810,489,385,104,364810.2,99216,464026.2
231370,201810,90,76,14,72504,13356,85860
231375,201810,291,213,78,203202,74412,277614
231380,201810,469,384,85,365544.92,80899.2,446444.12
231390,201810,197,161,36,153594,34344,187938
231395,201810,725,455,270,433478.52,257580,691058.52
231400,201810,1073,887,186,843626.53,177101.38,1020727.91
231410,201810,1330,1087,243,1033183.4,230841,1264024.4
240010,201810,398,179,219,169614.26,208917,378531.26
240020,201810,2233,1761,472,1677168.23,450284,2127452.23
240030,201810,133,113,20,107802,19080,126882
240040,201810,31,31,0,29574,0,29574
240050,201810,514,443,71,422622,67734,490356
240060,201810,66,62,4,59148,3816,62964
240070,201810,195,151,44,144054,41976,186030
240080,201810,462,308,154,293828,145962.71,439790.71
240090,201810,101,90,11,85554.72,10494,96048.72
240100,201810,1463,1383,80,1315334.55,76129.2,1391463.75
240110,201810,1020,652,368,621036.26,350929,971965.26
240120,201810,139,119,20,113526,19080,132606
240130,201810,286,268,18,254955.54,17172,272127.54
240140,201810,82,63,19,60102,18126,78228
240145,201810,710,628,82,598348.8,78228,676576.8
240150,201810,19,15,4,14310,3787.38,18097.38
240160,201810,43,38,5,36252,4770,41022
240165,201810,36,30,6,28382,5724,34106
240170,201810,93,71,22,67257,20988,88245
240180,201810,80,66,14,62964,13356,76320
240185,201810,44,40,4,38150.46,3816,41966.46
240190,201810,14,11,3,10494,2862,13356
240200,201810,3037,1711,1326,1625932.67,1263765,2889697.67
240210,201810,168,131,37,124974,35298,160272
240220,201810,1103,792,311,755425,296684.46,1052109.46
240230,201810,841,780,61,741286.05,57546,798832.05
240240,201810,124,87,37,82998,35298,118296
240250,201810,88,78,10,74412,9540,83952
240260,201810,1798,1342,456,1279590.66,434041.38,1713632.04
240270,201810,192,168,24,159890.4,22734.7,182625.1
240280,201810,42,32,10,29765,9540,39305
240290,201810,50,49,1,46746,954,47700
240300,201810,179,100,79,95113.8,75366,170479.8
240310,201810,2043,1119,924,1057651.98,877992.37,1935644.35
240320,201810,206,196,10,186834.04,9540,196374.04
240325,201810,4276,2608,1668,2481159.08,1588149.86,4069308.94
240330,201810,67,63,4,60102,3816,63918
240340,201810,109,78,31,74412,29574,103986
240350,201810,90,80,10,76320,9540,85860
240360,201810,451,313,138,298602,131652,430254
240370,201810,41,39,2,37206,1908,39114
240375,201810,70,41,29,39114,27666,66780
240380,201810,227,184,43,175536,40927,216463
240390,201810,14,12,2,11448,1908,13356
240400,201810,77,73,4,69642,3816,73458
240410,201810,11,7,4,6678,3816,10494
240420,201810,910,700,210,665274.4,199290.6,864565.0
240430,201810,264,247,17,234727.89,16218,250945.89
240440,201810,82,46,36,43884,34344,78228
240450,201810,217,148,69,140619.8,65826,206445.8
240460,201810,62,49,13,46746,12402,59148
240470,201810,238,206,32,195680.66,30528,226208.66
240480,201810,15,14,1,13260.6,954,14214.6
240485,201810,76,66,10,62964,9540,72504
240490,201810,49,48,1,45582.12,954,46536.12
240500,201810,85,68,17,64872,16218,81090
240510,201810,51,36,15,34344,14310,48654
240520,201810,120,115,5,109710,4770,114480
240530,201810,54,48,6,45792,5724,51516
240540,201810,77,66,11,62964,10494,73458
240550,201810,15,13,2,12402,1908,14310
240560,201810,377,276,101,262200.23,96354,358554.23
240570,201810,471,293,178,278663.4,169812,448475.4
240580,201810,1250,1012,238,959963.9,225903.2,1185867.1
240590,201810,28,26,2,24804,1908,26712
240600,201810,110,107,3,102078,2862,104940
240610,201810,512,427,85,407001.7,81090,488091.7
240615,201810,20,19,1,18126,954,19080
240620,201810,96,92,4,87768,3816,91584
240630,201810,36,34,2,32436,1908,34344
240640,201810,27,22,5,20988,4770,25758
240650,201810,239,199,40,188987.9,38160,227147.9
240660,201810,99,87,12,82998,11448,94446
240670,201810,298,178,120,167713.3,114480,282193.3
240680,201810,49,38,11,36252,10494,46746
240690,201810,48,45,3,42930,2862,45792
240700,201810,191,157,34,149778,32436,182214
240710,201810,1930,1229,701,1170983.43,668735.46,1839718.89
240720,201810,1078,787,291,749643.86,277614,1027257.86
240725,201810,65,61,4,58194,3816,62010
240730,201810,136,117,19,111618,18126,129744
240740,201810,241,203,38,192297.78,35298.02,227595.80
240750,201810,38,26,12,24804,11448,36252
240760,201810,35,32,3,30528,2862,33390
240770,201810,150,117,33,111618,31482,143100
240780,201810,684,569,115,542339.46,109710,652049.46
240790,201810,37,36,1,34344,954,35298
240800,201810,8868,6043,2825,5726441.83,2688603.5,8415045.33
240810,201810,20158,11149,9009,10594622.18,8585184.45,19179806.63
240820,201810,223,136,87,129453.03,82998,212451.03
240830,201810,1633,1340,293,1272216.76,279522,1551738.76
240840,201810,82,72,10,68688,9540,78228
240850,201810,86,76,10,72504,9540,82044
240860,201810,111,108,3,103032,2862,105894
240870,201810,61,53,8,50562,7632,58194
240880,201810,30,27,3,25748.46,2862,28610.46
240890,201810,1194,709,485,672476.78,462686,1135162.78
240895,201810,51,36,15,34344,14310,48654
240910,201810,161,146,15,139284,14310,153594
240920,201810,15,12,3,11448,2862,14310
240930,201810,392,357,35,339624,33390,373014
240933,201810,34,26,8,24804,7632,32436
240940,201810,2455,2170,285,2056193.58,269008.92,2325202.50
240950,201810,53,50,3,47700,2862,50562
240960,201810,31,25,6,23850,5724,29574
240970,201810,122,87,35,82998,32636,115634
240980,201810,191,153,38,145962,35679.6,181641.6
240990,201810,123,82,41,78228,39114,117342
241000,201810,66,61,5,58194,4770,62964
241010,201810,64,52,12,49608,11448,61056
241020,201810,111,104,7,99216,6678,105894
241025,201810,10,4,6,3816,5724,9540
241030,201810,119,97,22,92538,20988,113526
241040,201810,35,29,6,27666,5724,33390
241050,201810,89,78,11,74412,10494,84906
241060,201810,28,24,4,22896,3816,26712
241070,201810,14,14,0,13356,0,13356
241080,201810,64,57,7,54091.8,6678,60769.8
241090,201810,49,41,8,39114,7617.69,46731.69
241100,201810,72,62,10,59148,9540,68688
241105,201810,6,2,4,1908,3816,5724
241110,201810,47,45,2,42930,1908,44838
241120,201810,1443,1110,333,1055287,317682,1372969
241140,201810,224,184,40,174583,38160,212743
241142,201810,42,39,3,37206,2862,40068
241150,201810,1230,1080,150,1028556,143100,1171656
241160,201810,23,22,1,20988,954,21942
241170,201810,44,40,4,38160,3816,41976
241180,201810,48,40,8,37985.42,7632,45617.42
241190,201810,38,37,1,35298,954,36252
241200,201810,3915,2127,1788,2023766.72,1703831.66,3727598.38
241210,201810,70,59,11,56286,9636,65922
241220,201810,1412,952,460,907743.04,438806.92,1346549.96
241230,201810,242,202,40,192708,38160,230868
241240,201810,54,41,13,39114,12402,51516
241250,201810,1109,1022,87,974511.2,82998,1057509.2
241255,201810,49,39,10,37206,9540,46746
241260,201810,633,497,136,474133.23,129744,603877.23
241270,201810,46,34,12,32436,11448,43884
241280,201810,101,88,13,83952,12402,96354
241290,201810,109,83,26,79182,24804,103986
241300,201810,77,55,22,52470,20988,73458
241310,201810,49,38,11,36109,10494,46603
241320,201810,27,14,13,13356,12402,25758
241330,201810,63,57,6,54378,5724,60102
241335,201810,63,56,7,52756.2,6678,59434.2
241340,201810,187,140,47,133560,44838,178398
241350,201810,62,57,5,54378,4770,59148
241355,201810,40,37,3,35298,2862,38160
241360,201810,49,48,1,45792,954,46746
241370,201810,46,38,8,36127.98,7632,43759.98
241380,201810,39,35,4,33390,3816,37206
241390,201810,79,64,15,60865.2,14310,75175.2
241400,201810,205,166,39,157696.2,37206,194902.2
241410,201810,181,164,17,156456,16122.6,172578.6
241415,201810,100,79,21,75366,20034,95400
241420,201810,100,75,25,71550,23679,95229
241430,201810,28,27,1,25758,954,26712
241440,201810,497,413,84,393988,80136,474124
241445,201810,38,36,2,34344,1908,36252
241450,201810,280,231,49,220374,46746,267120
241460,201810,136,125,11,119012,10494,129506
241470,201810,44,37,7,35298,6678,41976
241475,201810,64,61,3,58194,2862,61056
241480,201810,99,72,27,67734.69,25758,93492.69
241490,201810,8,7,1,6678,954,7632
241500,201810,46,33,13,31482,12402,43884
250010,201810,104,89,15,84834.45,14310,99144.45
250020,201810,32,28,4,26712,3816,30528
250030,201810,825,614,211,584411.2,200245.6,784656.8
250040,201810,342,285,57,271890,54091.8,325981.8
250050,201810,236,195,41,185739.8,39114,224853.8
250053,201810,54,41,13,39114,12402,51516
250057,201810,0,0,0,0,0,0
250060,201810,461,353,108,336762,102745.8,439507.8
250070,201810,706,586,120,557026,114480,671506
250073,201810,7,7,0,6678,0,6678
250077,201810,197,146,51,138892.86,48654,187546.86
250080,201810,426,332,94,315107.2,89676,404783.2
250090,201810,202,133,69,125928,65806.92,191734.92
250100,201810,509,419,90,398772,85479,484251
250110,201810,563,427,136,405574.02,129744,535318.02
250115,201810,24,7,17,6678,16218,22896
250120,201810,113,85,28,81090,26712,107802
250130,201810,572,462,110,440748,104750,545498
250135,201810,13,8,5,7632,4770,12402
250140,201810,81,73,8,69642,7632,77274
250150,201810,580,425,155,403896.58,147555.18,551451.76
250153,201810,8,7,1,6678,954,7632
250157,201810,28,23,5,21942,4770,26712
250160,201810,216,170,46,162180,43884,206064
250170,201810,64,44,20,41976,19080,61056
250180,201810,4089,2795,1294,2650127.13,1229378,3879505.13
250190,201810,872,576,296,547834.5,282384,830218.5
250200,201810,53,45,8,42930,7632,50562
250205,201810,23,20,3,19080,2862,21942
250210,201810,88,76,12,72504,11448,83952
250215,201810,62,53,9,50562,8586,59148
250220,201810,27,21,6,20034,5724,25758
250230,201810,77,70,7,66776,6678,73454
250240,201810,243,201,42,190943.1,40068,231011.1
250250,201810,399,341,58,325314,55332,380646
250260,201810,34,30,4,28620,3816,32436
250270,201810,61,47,14,44838,13356,58194
250280,201810,374,313,61,298602,58194,356796
250290,201810,92,87,5,82711.8,4770,87481.8
250300,201810,558,384,174,365688.71,165983,531671.71
250310,201810,45,41,4,39114,3816,42930
250320,201810,1994,1365,629,1296955.35,598530.8,1895486.15
250330,201810,86,76,10,72504,9540,82044
250340,201810,24,20,4,19080,3816,22896
250350,201810,143,92,51,87481.8,48081.6,135563.4
250355,201810,35,27,8,25758,7632,33390
250360,201810,203,166,37,158364,35298,193662
250370,201810,2390,1623,767,1542143.98,731115,2273258.98
250375,201810,11,7,4,6678,3816,10494
250380,201810,54,39,15,37206,14310,51516
250390,201810,42,35,7,33390,6678,40068
250400,201810,16019,8149,7870,7750051.79,7501960.85,15252012.64
250403,201810,394,320,74,305084.43,70596,375680.43
250407,201810,60,52,8,49608,7632,57240
250410,201810,32,27,5,25758,4770,30528
250415,201810,43,29,14,27646.92,13336.92,40983.84
250420,201810,47,40,7,38160,6678,44838
250430,201810,1517,1290,227,1228467,216558,1445025
250435,201810,16,13,3,12402,2862,15264
250440,201810,690,589,101,559213.38,96354,655567.38
250450,201810,89,73,16,69642,14596.2,84238.2
250460,201810,423,290,133,276660,126872.46,403532.46
250470,201810,86,63,23,60102,21942,82044
250480,201810,329,261,68,248994,64872,313866
250485,201810,1,1,0,954,0,954
250490,201810,227,190,37,181260,35298,216558
250500,201810,79,58,21,55332,20034,75366
250510,201810,727,572,155,544925,146861.43,691786.43
250520,201810,173,119,54,113511.69,51511.23,165022.92
250523,201810,117,98,19,93492,18126,111618
250527,201810,100,79,21,75361.23,20034,95395.23
250530,201810,7,5,2,4770,1908,6678
250535,201810,23,19,4,18126,3816,21942
250540,201810,126,97,29,91822.5,27666,119488.5
250550,201810,71,68,3,64872,2862,67734
250560,201810,40,31,9,29574,8586,38160
250570,201810,153,123,30,117342,28620,145962
250580,201810,124,98,26,93267.8,24804,118071.8
250590,201810,20,15,5,14310,4770,19080
250600,201810,1248,843,405,802315.35,386370,1188685.35
250610,201810,151,131,20,124974,19080,144054
250620,201810,23,19,4,18126,3816,21942
250625,201810,68,51,17,48654,16218,64872
250630,201810,3035,1954,1081,1856075.96,1030207.51,2886283.47
250640,201810,204,170,34,162180,32436,194616
250650,201810,29,20,9,19080,8586,27666
250660,201810,46,36,10,34344,9540,43884
250670,201810,61,41,20,39114,19080,58194
250680,201810,390,321,69,306234,65826,372060
250690,201810,1866,1291,575,1228175.53,548168.8,1776344.33
250700,201810,929,815,114,774859.56,108546.12,883405.68
250710,201810,444,344,100,328176,95400,423576
250720,201810,110,86,24,82044,22896,104940
250730,201810,386,326,60,310050.6,57240,367290.6
250740,201810,53,49,4,46746,3816,50562
250750,201810,20796,12556,8240,11922201.53,7852495.8,19774697.33
250760,201810,75,57,18,54378,17172,71550
250770,201810,350,230,120,217483.52,112289.97,329773.49
250780,201810,54,41,13,39114,12402,51516
250790,201810,474,308,166,291924.92,157648.5,449573.42
250800,201810,152,140,12,132844.5,11448,144292.5
250810,201810,81,63,18,60102,17172,77274
250820,201810,159,131,28,124974,26712,151686
250830,201810,421,288,133,273750.5,126882,400632.5
250840,201810,52,50,2,47700,1908,49608
250850,201810,55,43,12,41022,11448,52470
250855,201810,13,11,2,10494,1908,12402
250860,201810,202,146,56,139284,53137.8,192421.8
250870,201810,35,32,3,30528,2862,33390
250880,201810,81,62,19,59138.46,18126,77264.46
250890,201810,2514,1866,648,1778465.88,617333.5,2395799.38
250900,201810,125,108,17,103032,16218,119250
250905,201810,125,98,27,93492,25758,119250
250910,201810,1172,836,336,795808.91,320257.8,1116066.71
250915,201810,113,79,34,75366,32436,107802
250920,201810,136,105,31,100170,29574,129744
250930,201810,167,105,62,100170,59148,159318
250933,201810,1,1,0,954,0,954
250937,201810,6,5,1,4770,954,5724
250939,201810,31,24,7,22896,6678,29574
250940,201810,109,82,27,78228,25758,103986
250950,201810,70,47,23,44838,21942,66780
250960,201810,91,51,40,48654,38160,86814
250970,201810,1214,865,349,823589,332278.2,1155867.2
250980,201810,91,65,26,62010,24804,86814
250990,201810,167,129,38,122593.77,36209.07,158802.84
251000,201810,76,68,8,64681.2,7632,72313.2
251010,201810,102,80,22,76316,20209.53,96525.53
251020,201810,82,72,10,67877.1,9540,77417.1
251030,201810,45,33,12,31482,11448,42930
251040,201810,52,37,15,35298,14310,49608
251050,201810,23,21,2,20034,1908,21942
251060,201810,50,39,11,36252,10494,46746
251065,201810,3,3,0,2862,0,2862
251070,201810,25,20,5,19071,4770,23841
251080,201810,4785,2318,2467,2201251.94,2346965.01,4548216.95
251090,201810,198,170,28,162180,26712,188892
251100,201810,18,17,1,16218,954,17172
251110,201810,44,35,9,33390,8586,41976
251120,201810,1830,1117,713,1060994.4,679916,1740910.4
251130,201810,387,317,70,302418,66780,369198
251140,201810,527,344,183,327032.8,174413.34,501446.14
251150,201810,303,262,41,249176,39114,288290
251160,201810,97,82,15,78224,14310,92534
251170,201810,100,79,21,75337.38,20029.23,95366.61
251180,201810,290,182,108,173619.23,103023.23,276642.46
251190,201810,187,128,59,121783.83,56286,178069.83
251200,201810,252,205,47,195570,44838,240408
251203,201810,37,35,2,33390,1908,35298
251207,201810,95,79,16,75366,15264,90630
251210,201810,1431,1038,393,988698.53,374635.8,1363334.33
251220,201810,47,37,10,35298,9540,44838
251230,201810,463,388,75,370152,71550,441702
251240,201810,101,73,28,68688,26712,95400
251250,201810,1349,964,385,916766.87,367147,1283913.87
251260,201810,13,8,5,7632,4770,12402
251270,201810,339,255,84,243270,79993,323263
251272,201810,64,59,5,56286,4770,61056
251274,201810,28,22,6,20988,5724,26712
251275,201810,24,16,8,15264,7632,22896
251276,201810,17,13,4,12402,3816,16218
251278,201810,8,7,1,6678,954,7632
251280,201810,101,96,5,91584,4770,96354
251290,201810,721,544,177,518976,168858,687834
251300,201810,16,13,3,12402,2862,15264
251310,201810,373,268,105,255668,100170,355838
251315,201810,19,18,1,17172,954,18126
251320,201810,60,48,12,45792,11448,57240
251330,201810,79,70,9,66780,8586,75366
251335,201810,12,7,5,6678,4770,11448
251340,201810,702,416,286,396864,271819.25,668683.25
251350,201810,37,35,2,33390,1908,35298
251360,201810,73,64,9,61056,8586,69642
251365,201810,14,14,0,13356,0,13356
251370,201810,5417,3688,1729,3513331.98,1648132,5161463.98
251380,201810,50,40,10,38160,9540,47700
251385,201810,3,3,0,2862,0,2862
251390,201810,702,553,149,526418.2,140906,667324.2
251392,201810,12,6,6,5724,5724,11448
251394,201810,9,9,0,8586,0,8586
251396,201810,14,9,5,8586,4770,13356
251398,201810,18,15,3,14310,2862,17172
251400,201810,42,35,7,33390,6678,40068
251410,201810,37,31,6,29574,5724,35298
251420,201810,103,77,26,73458,24804,98262
251430,201810,41,38,3,36252,2862,39114
251440,201810,33,22,11,20988,10494,31482
251445,201810,56,51,5,48654,4770,53424
251450,201810,410,361,49,342738.8,46746,389484.8
251455,201810,2,1,1,954,954,1908
251460,201810,17,13,4,12402,3816,16218
251465,201810,5,2,3,1908,2862,4770
251470,201810,47,37,10,35298,9540,44838
251480,201810,27,24,3,22896,2862,25758
251490,201810,120,83,37,78705,34345,113050
251500,201810,125,100,25,95400,23087,118487
251510,201810,39,31,8,29574,7632,37206
251520,201810,25,25,0,23850,0,23850
251530,201810,4510,3176,1334,3023264.22,1272340.26,4295604.48
251540,201810,74,65,9,62010,8586,70596
251550,201810,411,317,94,301464.2,89152,390616.2
251560,201810,23,16,7,15264,6678,21942
251570,201810,21,21,0,20034,0,20034
251580,201810,125,103,22,98262,20988,119250
251590,201810,121,90,31,86041,29574,115615
251593,201810,26,16,10,15264,9540,24804
251597,201810,58,48,10,45792,9540,55332
251600,201810,1091,778,313,740720.48,296993.92,1037714.40
251610,201810,213,163,50,155502,47033,202535
251615,201810,3,3,0,2862,0,2862
251620,201810,4279,2851,1428,2710013.84,1359547,4069560.84
251630,201810,444,325,119,310050,113517,423567
251640,201810,149,107,42,102078,40068,142146
251650,201810,272,198,74,187059.1,70596,257655.1
251660,201810,226,204,22,194616,20797.2,215413.2
251670,201810,361,281,80,266378,76320,342698
251675,201810,4,4,0,3816,0,3816
251680,201810,97,87,10,82998,9540,92538
251690,201810,341,285,56,270936,53073.89,324009.89
251700,201810,282,240,42,228373.29,40053.69,268426.98
251710,201810,23,15,8,14310,7632,21942
251720,201810,31,21,10,20034,9254,29288
251740,201810,10,8,2,7632,1908,9540
260005,201810,3194,1806,1388,1711835.34,1323280.1,3035115.44
260010,201810,1542,1106,436,1051001.48,413655.12,1464656.60
260020,201810,427,378,49,360612,46746,407358
260030,201810,581,420,161,399912.98,153594,553506.98
260040,201810,859,533,326,507394.44,310994.46,818388.90
260050,201810,1151,828,323,789674,306902.2,1096576.2
260060,201810,411,370,41,352216.8,39114,391330.8
260070,201810,1458,916,542,869742,514098.36,1383840.36
260080,201810,731,576,155,548693.1,147870,696563.1
260090,201810,578,360,218,343212.12,207972,551184.12
260100,201810,237,168,69,159462,65826,225288
260105,201810,232,131,101,124974,96354,221328
260110,201810,2776,2054,722,1959507,688788,2648295
260120,201810,2945,1459,1486,1382168.21,1415356.1,2797524.31
260130,201810,161,114,47,108756,44838,153594
260140,201810,2166,1426,740,1350682.1,703652.26,2054334.36
260150,201810,229,151,78,144054,74412,218466
260160,201810,302,255,47,243270,44838,288108
260170,201810,3429,2099,1330,1995400.58,1267436.9,3262837.48
260180,201810,148,124,24,118296,22896,141192
260190,201810,2317,1616,701,1538513.9,668754,2207267.9
260200,201810,922,750,172,714021.08,163802,877823.08
260210,201810,1428,1015,413,968159.27,393039.11,1361198.38
260220,201810,725,658,67,627732,63918,691650
260230,201810,1217,925,292,880258.99,278568,1158826.99
260240,201810,230,175,55,165996,52470,218466
260250,201810,82,63,19,60102,18126,78228
260260,201810,1000,721,279,687834,266166,954000
260270,201810,430,347,83,329655.2,78895.8,408551.0
260280,201810,1428,914,514,871479,489798.5,1361277.5
260290,201810,6460,3476,2984,3298205.85,2840026,6138231.85
260300,201810,892,784,108,745867.6,102746,848613.6
260310,201810,520,411,109,390715.47,103986,494701.47
260320,201810,884,665,219,634123.2,208926,843049.2
260330,201810,37,28,9,26712,8586,35298
260340,201810,75,54,21,51516,20034,71550
260345,201810,5641,3173,2468,3021133.01,2353414.76,5374547.77
260350,201810,490,356,134,337880.08,127836,465716.08
260360,201810,285,146,139,139284,132577.38,271861.38
260370,201810,680,450,230,426680.86,219280,645960.86
260380,201810,617,444,173,423576,163897.56,587473.56
260390,201810,302,257,45,244099.98,41976,286075.98
260392,201810,103,90,13,85860,12402,98262
260400,201810,4076,2343,1733,2226794.86,1652911.22,3879706.08
260410,201810,14915,7764,7151,7390956.03,6819323.2,14210279.23
260415,201810,123,112,11,106848,10494,117342
260420,201810,1800,1084,716,1029249.04,681526.22,1710775.26
260430,201810,192,175,17,165738.66,16218,181956.66
260440,201810,226,162,64,153824,61056,214880
260450,201810,474,343,131,325937,124974,450911
260460,201810,849,451,398,427584.8,379687.23,807272.03
260470,201810,372,231,141,218943,134419,353362
260480,201810,216,139,77,132606,73458,206064
260490,201810,216,176,40,167904,38160,206064
260500,201810,1137,768,369,730384.2,351739.8,1082124.0
260510,201810,755,599,156,570464.17,147870,718334.17
260515,201810,256,230,26,219420,24327,243747
260520,201810,3354,2001,1353,1901626.52,1288082.62,3189709.14
260530,201810,800,649,151,616653.64,144054,760707.64
260540,201810,567,434,133,414036,125928.72,539964.72
260545,201810,12,9,3,8586,2862,11448
260550,201810,350,219,131,208926,124974,333900
260560,201810,528,399,129,380360,122779.8,503139.8
260570,201810,1015,831,184,790055.8,175249.8,965305.6
260580,201810,258,230,28,219420,26712,246132
260590,201810,650,376,274,357292.08,261396,618688.08
260600,201810,8227,4209,4018,3995761.26,3828731.13,7824492.39
260610,201810,503,339,164,323406,156169.8,479575.8
260620,201810,3718,1948,1770,1845789.6,1685694.97,3531484.57
260630,201810,78,75,3,71550,2862,74412
260640,201810,3741,2042,1699,1944304.63,1620789.3,3565093.93
260650,201810,319,232,87,221328,82382.67,303710.67
260660,201810,512,348,164,331610.4,156456,488066.4
260670,201810,104,76,28,72504,26712,99216
260680,201810,3686,2071,1615,1958840.78,1540080.84,3498921.62
260690,201810,124,95,29,90630,27666,118296
260700,201810,329,202,127,191944.8,121158,313102.8
260710,201810,38,35,3,33390,2862,36252
260720,201810,2268,1367,901,1297911.69,857207.16,2155118.85
260730,201810,623,472,151,450288,141859.8,592147.8
260740,201810,60,56,4,53424,3816,57240
260750,201810,641,447,194,426113.64,185076,611189.64
260760,201810,620,335,285,319590,271890,591480
260765,201810,986,516,470,489321.8,448141.5,937463.3
260770,201810,225,170,55,162180,52470,214650
260775,201810,824,492,332,467985.8,316719,784704.8
260780,201810,270,176,94,167904,89676,257580
260790,201810,12266,6756,5510,6419752.73,5248715.01,11668467.74
260795,201810,167,116,51,109500.12,48654,158154.12
260800,201810,288,241,47,229437,44838,274275
260805,201810,175,114,61,108027.14,58194,166221.14
260810,201810,736,645,91,614080.26,86814,700894.26
260820,201810,321,215,106,203780.79,101124,304904.79
260825,201810,203,140,63,133386.57,60102,193488.57
260830,201810,265,172,93,164088,88722,252810
260840,201810,236,171,65,162467,62010,224477
260845,201810,217,147,70,140238,66780,207018
260850,201810,510,372,138,353224.09,131652,484876.09
260860,201810,257,191,66,182016.34,62964,244980.34
260870,201810,378,275,103,261111,98262,359373
260875,201810,731,515,216,490196.69,206064,696260.69
260880,201810,1619,997,622,949465.29,593197.2,1542662.49
260890,201810,2423,1703,720,1619207.82,685640.8,2304848.62
260900,201810,1032,714,318,679853.79,303372,983225.79
260910,201810,280,219,61,208926,58194,267120
260915,201810,309,214,95,204156,90630,294786
260920,201810,180,101,79,96354,75366,171720
260930,201810,394,339,55,323406,52384.45,375790.45
260940,201810,2888,1587,1301,1510089.89,1240657.92,2750747.81
260950,201810,2045,1179,866,1118413.82,826164,1944577.82
260960,201810,14220,7400,6820,7026814.67,6498090.03,13524904.70
260970,201810,440,380,60,361540.2,57240,418780.2
260980,201810,196,173,23,164755.8,21942,186697.8
260990,201810,2586,2123,463,2023060.86,441034.2,2464095.06
261000,201810,4383,2588,1795,2458247.76,1710642.05,4168889.81
261010,201810,183,137,46,130698,43066.23,173764.23
261020,201810,611,459,152,437743,145008,582751
261030,201810,226,168,58,160257.69,55083.96,215341.65
261040,201810,368,326,42,311004,39781.8,350785.8
261050,201810,484,422,62,402588,59148,461736
261060,201810,1342,889,453,845960.75,432162,1278122.75
261070,201810,9143,4606,4537,4369306.26,4321964.78,8691271.04
261080,201810,389,295,94,280658,89676,370334
261090,201810,2282,1747,535,1658058.05,508664.9,2166722.95
261100,201810,1090,763,327,725851.8,310088.16,1035939.96
261110,201810,8224,5034,3190,4797662.4,3040319.63,7837982.03
261120,201810,270,228,42,217512,40063.23,257575.23
261130,201810,574,337,237,320974.1,225908,546882.1
261140,201810,188,123,65,117342,62010,179352
261150,201810,684,412,272,392562,258534.21,651096.21
261153,201810,73,69,4,64872.31,3816,68688.31
261160,201810,77933,39216,38717,37293735.98,36913401.34,74207137.32
261170,201810,456,343,113,326592.36,107802,434394.36
261180,201810,1824,1126,698,1069081.62,665892,1734973.62
261190,201810,609,424,185,404059.12,176481,580540.12
261200,201810,219,191,28,181449.3,26712,208161.3
261210,201810,34,30,4,28620,3816,32436
261220,201810,2624,1850,774,1758442.82,737823.8,2496266.62
261230,201810,336,248,88,236592,83937.69,320529.69
261240,201810,456,394,62,371862.95,59148,431010.95
261245,201810,227,190,37,181260,35298,216558
261247,201810,161,126,35,120204,33390,153594
261250,201810,2878,1468,1410,1399404.26,1343743.63,2743147.89
261255,201810,258,232,26,221041.8,24804,245845.8
261260,201810,868,750,118,715500,112572,828072
261270,201810,179,138,41,131652,39114,170766
261280,201810,167,140,27,133560,25758,159318
261290,201810,126,88,38,83713.5,36252,119965.5
261300,201810,1257,900,357,858557.85,340578,1199135.85
261310,201810,780,520,260,495507.8,247419.9,742927.7
261320,201810,562,381,181,363474,172674,536148
261330,201810,979,760,219,722041.5,208080.46,930121.96
261340,201810,301,171,130,163134,124020,287154
261350,201810,820,585,235,557136.2,224190,781326.2
261360,201810,1249,811,438,773292.37,417566,1190858.37
261370,201810,5015,3080,1935,2924353.55,1843068.45,4767422.00
261380,201810,574,423,151,401643.64,143768,545411.64
261390,201810,3477,2320,1157,2209120.56,1100489.5,3309610.06
261400,201810,285,258,27,245559.6,25758,271317.6
261410,201810,1094,732,362,698328,345343.23,1043671.23
261420,201810,889,557,332,530111.26,316709.46,846820.72
261430,201810,328,298,30,283446,28333.8,311779.8
261440,201810,122,111,11,105894,10494,116388
261450,201810,2505,2077,428,1978798.24,408064.04,2386862.28
261460,201810,732,583,149,555228.02,142146,697374.02
261470,201810,257,198,59,188082,56247.84,244329.84
261480,201810,369,294,75,279237,71546,350783
261485,201810,339,208,131,197764.2,124974,322738.2
261500,201810,625,423,202,403542,192708,596250
261510,201810,49,32,17,30528,16218,46746
261520,201810,111,98,13,93492,12402,105894
261530,201810,4185,2648,1537,2517778.57,1463913.76,3981692.33
261540,201810,1120,691,429,658750.36,409266,1068016.36
261550,201810,293,144,149,136280,142126.92,278406.92
261560,201810,812,540,272,512490.2,258334.6,770824.8
261570,201810,383,299,84,285246,80136,365382
261580,201810,381,296,85,281620,81090,362710
261590,201810,195,159,36,151686,34344,186030
261600,201810,301,242,59,230105,55809,285914
261610,201810,104,92,12,87291,11448,98739
261618,201810,64,50,14,47700,13356,61056
261620,201810,203,125,78,119250,74412,193662
261630,201810,582,451,131,427893.6,124974,552867.6
261640,201810,6459,3437,3022,3271536.59,2879087.92,6150624.51
261650,201810,501,319,182,303648.66,173628,477276.66
270010,201810,539,478,61,455726,57431,513157
270020,201810,304,242,62,230864,59148,290012
270030,201810,9287,5973,3314,5680278.36,3158668.93,8838947.29
270040,201810,2030,1254,776,1196020.26,739063.8,1935084.06
270050,201810,174,127,47,121158,44838,165996
270060,201810,116,65,51,62010,48654,110664
270070,201810,904,658,246,626208.62,234379.26,860587.88
270080,201810,38,32,6,30528,5724,36252
270090,201810,20,16,4,15264,3816,19080
270100,201810,1243,825,418,784241.51,396625.7,1180867.21
270110,201810,144,108,36,103032,34344,137376
270120,201810,224,184,40,174684.55,38160,212844.55
270130,201810,249,173,76,164755.8,72504,237259.8
270135,201810,101,61,40,58194,38160,96354
270140,201810,1329,810,519,772519.19,494163.2,1266682.39
270150,201810,267,212,55,202248,52470,254718
270160,201810,528,396,132,377784,125260.2,503044.2
270170,201810,754,487,267,463453.2,253477.8,716931.0
270180,201810,71,55,16,52152.04,15054.12,67206.16
270190,201810,101,90,11,85860,10494,96354
270200,201810,106,95,11,90439.2,10494,100933.2
270210,201810,482,256,226,244224,215317.8,459541.8
270220,201810,185,145,40,138330,38160,176490
270230,201810,2127,1284,843,1219233.84,803154.14,2022387.98
270235,201810,728,551,177,524362.72,168698.06,693060.78
270240,201810,3143,2458,685,2331395.95,650698,2982093.95
270250,201810,174,122,52,116388,49608,165996
270255,201810,224,193,31,184122,29192.4,213314.4
270260,201810,342,273,69,260442,65826,326268
270270,201810,110,46,64,43875,61056,104931
270280,201810,189,117,72,111618,68668.92,180286.92
270290,201810,1198,913,285,869766.42,271013.46,1140779.88
270300,201810,286,184,102,175536,97021.8,272557.8
270310,201810,918,739,179,702700.71,170061.12,872761.83
270320,201810,890,760,130,723473.8,123733.8,847207.6
270330,201810,275,230,45,218466,42930,261396
270340,201810,60,49,11,46746,10494,57240
270350,201810,92,47,45,44599.5,42930,87529.5
270360,201810,71,39,32,37206,30528,67734
270370,201810,55,44,11,41053.33,10494,51547.33
270375,201810,69,41,28,39114,26712,65826
270380,201810,1078,619,459,589572,437886,1027458
270390,201810,192,111,81,105894,77274,183168
270400,201810,711,522,189,496105.47,180306,676411.47
270410,201810,702,507,195,483358.78,186020.46,669379.24
270420,201810,412,273,139,258744,132530.92,391274.92
270430,201810,33052,23685,9367,22536579.36,8928340.25,31464919.61
270440,201810,495,388,107,370152,101791.8,471943.8
270450,201810,782,416,366,396028.29,348210.66,744238.95
270460,201810,196,153,43,145962,41022,186984
270470,201810,1427,957,470,912319.41,448380,1360699.41
270480,201810,540,440,100,417470.8,94684.5,512155.3
270490,201810,25,20,5,19080,4770,23850
270500,201810,513,421,92,401634,87768,489402
270510,201810,741,455,286,434070,272844,706914
270520,201810,348,217,131,206809,124974,331783
270530,201810,66,58,8,54950.4,7632,62582.4
270540,201810,122,93,29,88722,27666,116388
270550,201810,1735,1313,422,1251992.98,402101.46,1654094.44
270560,201810,310,147,163,140238,155502,295740
270570,201810,475,324,151,307171.56,143854.05,451025.61
270580,201810,86,65,21,62010,20034,82044
270590,201810,74,60,14,57240,13356,70596
270600,201810,182,148,34,141192,32436,173628
270610,201810,200,166,34,158355,32436,190791
270620,201810,30,29,1,27666,954,28620
270630,201810,3918,2991,927,2841698.03,882193.42,3723891.45
270640,201810,903,665,238,632606.6,226737.8,859344.4
270642,201810,219,185,34,176490,32436,208926
270644,201810,265,180,85,171529.74,81085.23,252614.97
270650,201810,279,165,114,157410,108756,266166
270660,201810,255,207,48,197478,45792,243270
270670,201810,3182,2424,758,2301837.02,720328.52,3022165.54
270680,201810,466,268,198,255663,188887.23,444550.23
270690,201810,1144,729,415,693713.88,395900.46,1089614.34
270700,201810,36,27,9,25758,8586,34344
270710,201810,902,681,221,648253,210834,859087
270720,201810,259,198,61,188892,57907.8,246799.8
270730,201810,1963,1152,811,1096124.41,771111.2,1867235.61
270740,201810,44,27,17,25758,16218,41976
270750,201810,663,485,178,462500,169145,631645
270760,201810,299,214,85,204156,81090,285246
270770,201810,2826,1809,1017,1719446.8,969245,2688691.8
270780,201810,91,56,35,53419.23,33372.46,86791.69
270790,201810,261,176,85,167904,81090,248994
270800,201810,2000,1607,393,1531285.25,373423.83,1904709.08
270810,201810,296,237,59,226083.69,56277.23,282360.92
270820,201810,160,106,54,101124,51421,152545
270830,201810,902,658,244,626965,232486,859451
270840,201810,1427,1058,369,1008592.9,350358,1358950.9
270850,201810,1645,1010,635,957378.36,605771.46,1563149.82
270860,201810,2497,1633,864,1555392.9,821358.57,2376751.47
270870,201810,125,69,56,65826,53424,119250
270880,201810,922,690,232,656415.14,220462.58,876877.72
270890,201810,337,246,91,234340.56,86809.23,321149.79
270895,201810,70,60,10,57240,9540,66780
270900,201810,104,80,24,76320,22896,99216
270910,201810,324,255,69,242125.2,65826,307951.2
270915,201810,1893,1155,738,1096917.94,702340.94,1799258.88
270920,201810,496,419,77,399566.29,73458,473024.29
270930,201810,6211,4532,1679,4317958.61,1599085.24,5917043.85
270940,201810,2392,1822,570,1735932.68,542808,2278740.68
280010,201810,43,38,5,36252,4770,41022
280020,201810,725,629,96,597172.13,90630,687802.13
280030,201810,20040,12956,7084,12276703.49,6727469.72,19004173.21
280040,201810,339,219,120,208926,113049,321975
280050,201810,382,293,89,279235.8,84906,364141.8
280060,201810,332,222,110,209541.43,104940,314481.43
280067,201810,989,699,290,664904,275706.25,940610.25
280070,201810,136,113,23,107802,21942,129744
280100,201810,620,490,130,464715.67,123830,588545.67
280110,201810,77,72,5,68688,4770,73458
280120,201810,632,505,127,481770,121158,602928
280130,201810,1421,891,530,848583.8,505476.9,1354060.7
280140,201810,481,392,89,372155.4,83952,456107.4
280150,201810,343,250,93,237056.89,88722,325778.89
280160,201810,95,82,13,78228,12402,90630
280170,201810,589,394,195,374679.56,186030,560709.56
280190,201810,27,25,2,23850,1908,25758
280200,201810,28,22,6,20988,5724,26712
280210,201810,2812,1998,814,1887768.31,770988.51,2658756.82
280220,201810,42,32,10,30528,9540,40068
280230,201810,326,271,55,257699.63,52470,310169.63
280240,201810,117,111,6,105750.9,5724,111474.9
280250,201810,18,12,6,11448,5724,17172
280260,201810,82,72,10,68688,9540,78228
280270,201810,160,124,36,118296,34344,152640
280280,201810,195,127,68,121158,64872,186030
280290,201810,3176,2300,876,2183621.04,834584.05,3018205.09
280300,201810,1124,864,260,821522.99,247276.8,1068799.79
280310,201810,106,102,4,96907.29,3816,100723.29
280320,201810,662,455,207,434070,197478,631548
280330,201810,366,264,102,251856,97183.98,349039.98
280340,201810,417,334,83,317921,78419,396340
280350,201810,3534,2734,800,2595761.1,760372.51,3356133.61
280360,201810,449,283,166,269982,157410,427392
280370,201810,99,88,11,83952,10494,94446
280380,201810,57,44,13,41976,12402,54378
280390,201810,185,157,28,149778,26712,176490
280400,201810,346,235,111,223234.1,105894,329128.1
280410,201810,289,235,54,223237,51516,274753
280420,201810,174,146,28,139265,26712,165977
280430,201810,112,86,26,82044,24695.63,106739.63
280440,201810,696,541,155,511250.6,147669.66,658920.26
280445,201810,119,112,7,106848,6678,113526
280450,201810,1141,981,160,932479.46,152640,1085119.46
280460,201810,761,561,200,527410.2,190800,718210.2
280470,201810,191,176,15,167904,13357,181261
280480,201810,2347,1666,681,1573452.48,647349.89,2220802.37
280490,201810,352,325,27,308658,25758,334416
280500,201810,42,38,4,36252,3816,40068
280510,201810,142,111,31,105593.2,29288,134881.2
280520,201810,55,41,14,39114,13356,52470
280530,201810,76,52,24,49608,22896,72504
280540,201810,518,418,100,397635.84,95113.8,492749.64
280550,201810,732,676,56,643148.2,53424,696572.2
280560,201810,501,437,64,414179.1,61056,475235.1
280570,201810,1798,1373,425,1304664.84,404594.83,1709259.67
280580,201810,604,463,141,440268.6,134419,574687.6
280590,201810,170,108,62,103032,59148,162180
280600,201810,376,316,60,301464,57240,358704
280610,201810,134,102,32,97102,30528,127630
280620,201810,544,449,95,426629.5,90486.9,517116.4
280630,201810,162,136,26,129744,24804,154548
280640,201810,202,163,39,154673,37206,191879
280650,201810,78,54,24,51516,22896,74412
280660,201810,136,98,38,93492,36013.5,129505.5
280670,201810,1707,1071,636,1011915.15,602999.95,1614915.10
280680,201810,184,157,27,147994.14,25758,173752.14
280690,201810,59,49,10,46746,9540,56286
280700,201810,19,19,0,18126,0,18126
280710,201810,1432,1094,338,1033930.39,322452,1356382.39
280720,201810,117,79,38,72806.4,36252,109058.4
280730,201810,26,22,4,20988,3816,24804
280740,201810,2465,1827,638,1735788.44,607832.46,2343620.90
280750,201810,301,263,38,250902,36252,287154
280760,201810,918,640,278,609224.4,265212,874436.4
290010,201810,206,140,66,133560,62964,196524
290020,201810,176,163,13,155502,12402,167904
290030,201810,599,393,206,373681.8,196524,570205.8
290035,201810,134,109,25,101497.2,23850,125347.2
290040,201810,280,178,102,169812,97308,267120
290050,201810,81,62,19,59148,18126,77274
290060,201810,257,117,140,111331.8,133560,244891.8
290070,201810,5630,2795,2835,2658991.67,2702642.1,5361633.77
290080,201810,494,220,274,209517.64,261358,470875.64
290090,201810,391,170,221,162180,210834,373014
290100,201810,1611,1067,544,1013866.2,518403.8,1532270.0
290110,201810,818,490,328,464875.48,312378.53,777254.01
290115,201810,206,188,18,178398,17172,195570
290120,201810,774,503,271,479194.2,258534,737728.2
290130,201810,418,249,169,237250.26,161226,398476.26
290135,201810,299,226,73,214926.66,69642,284568.66
290140,201810,303,253,50,241362,47700,289062
290150,201810,129,96,33,91584,31482,123066
290160,201810,251,190,61,180020.58,58194,238214.58
290170,201810,88,63,25,60102,23850,83952
290180,201810,164,128,36,122112,34344,156456
290190,201810,444,364,80,346970,76033.8,423003.8
290195,201810,312,190,122,181260,116388,297648
290200,201810,276,229,47,218466,44838,263304
290205,201810,151,93,58,88722,55332,144054
290210,201810,1145,829,316,789722.2,301464,1091186.2
290220,201810,227,128,99,121635,94446,216081
290225,201810,288,110,178,104940,169812,274752
290230,201810,64,42,22,40068,20988,61056
290240,201810,307,119,188,113239.8,179352,292591.8
290250,201810,268,246,22,233988,20988,254976
290260,201810,296,238,58,226003,55332,281335
290265,201810,189,157,32,148961,30528,179489
290270,201810,1411,1171,240,1115942.2,227810.71,1343752.91
290280,201810,465,340,125,323613.01,119250,442863.01
290290,201810,1248,728,520,688142.89,496080,1184222.89
290300,201810,455,385,70,366999.23,66780,433779.23
290310,201810,314,141,173,134514,165042,299556
290320,201810,4015,2487,1528,2368941.84,1455673.2,3824615.04
290323,201810,182,159,23,151686,21942,173628
290327,201810,158,124,34,118024.11,32436,150460.11
290330,201810,85,48,37,45792,35298,81090
290340,201810,905,362,543,344375,517736,862111
290350,201810,595,355,240,338670,228960,567630
290360,201810,374,280,94,266166.81,89676,355842.81
290370,201810,905,371,534,353934,509422,863356
290380,201810,307,187,120,178398,114480,292878
290390,201810,2494,1559,935,1483409.38,890082,2373491.38
290395,201810,244,136,108,129219.8,103032,232251.8
290400,201810,283,207,76,197192,72504,269696
290405,201810,243,213,30,203202,28620,231822
290410,201810,592,506,86,479719.64,82044,561763.64
290420,201810,242,188,54,179352,51516,230868
290430,201810,491,311,180,296694,171720,468414
290440,201810,72,64,8,61056,7632,68688
290450,201810,236,182,54,173628,51516,225144
290460,201810,1892,1131,761,1077105.8,725245.98,1802351.78
290470,201810,1435,605,830,576041.22,791505.36,1367546.58
290475,201810,588,548,40,521925,38160,560085
290480,201810,292,165,127,157410,121158,278568
290485,201810,231,217,14,207018,13356,220374
290490,201810,1189,855,334,815670,317682.2,1133352.2
290500,201810,708,362,346,344108,330084,674192
290510,201810,223,171,52,163134,49608,212742
290515,201810,137,82,55,78228,52470,130698
290520,201810,1439,941,498,895139.58,471850.42,1366990.00
290530,201810,316,287,29,273798,27666,301464
290540,201810,100,57,43,54378,41022,95400
290550,201810,151,126,25,120204,23783.22,143987.22
290560,201810,3326,1387,1939,1322186.76,1849468.49,3171655.25
290570,201810,6053,3083,2970,2937429.21,2829465.18,5766894.39
290580,201810,1273,762,511,725707.8,486778.5,1212486.3
290590,201810,553,457,96,435187,91298,526485
290600,201810,1754,1213,541,1151451.65,516085.38,1667537.03
290610,201810,220,198,22,188673,20988,209661
290620,201810,339,302,37,288108,35298,323406
290630,201810,2056,885,1171,841142.69,1113382.02,1954524.71
290640,201810,146,121,25,115434,23850,139284
290650,201810,1722,817,905,778455,863370,1641825
290660,201810,281,229,52,218466,49608,268074
290670,201810,1020,522,498,497416,474746.38,972162.38
290680,201810,1219,983,236,936541.8,224190,1160731.8
290682,201810,294,216,78,205753.3,74393.46,280146.76
290685,201810,234,151,83,143100,79182,222282
290687,201810,949,622,327,590872.1,311958,902830.1
290689,201810,132,75,57,71536,54363.69,125899.69
290690,201810,645,262,383,249919.92,364502.8,614422.72
290700,201810,246,120,126,114480,120204,234684
290710,201810,708,479,229,456966,218466,675432
290720,201810,1033,841,192,802314,182691,985005
290730,201810,1152,661,491,628162.1,467460,1095622.1
290740,201810,16,13,3,12402,2862,15264
290750,201810,1386,638,748,606739.23,710241.79,1316981.02
290755,201810,74,65,9,62010,8586,70596
290760,201810,304,263,41,250902,39114,290016
290770,201810,190,178,12,169802.46,11162,180964.46
290780,201810,1005,801,204,762401.46,192803.4,955204.86
290790,201810,374,265,109,252810,103986,356796
290800,201810,2620,1057,1563,1005731.04,1490281.56,2496012.60
290810,201810,446,313,133,298316,126882,425198
290820,201810,393,238,155,226084,147870,373954
290830,201810,407,285,122,271890,116388,388278
290840,201810,1725,1069,656,1017680.8,623744.48,1641425.28
290850,201810,783,432,351,412128,333900,746028
290860,201810,648,294,354,280476,337430,617906
290870,201810,656,470,186,447521.6,177444,624965.6
290880,201810,122,67,55,63918,52470,116388
290890,201810,337,241,96,229914,91584,321498
290900,201810,170,128,42,122112,40068,162180
290910,201810,365,276,89,263304,84906,348210
290920,201810,228,194,34,185076,32436,217512
290930,201810,837,634,203,604550,193643,798193
290940,201810,250,208,42,197668.8,40068,237736.8
290950,201810,171,99,72,94446,68688,163134
290960,201810,454,308,146,292592.24,138997.8,431590.04
290970,201810,253,224,29,213505.2,27666,241171.2
290980,201810,1513,1069,444,1015657.76,422527.2,1438184.96
290990,201810,388,324,64,309077.46,61000.38,370077.84
291000,201810,865,246,619,234684,590526,825210
291005,201810,2188,939,1249,893745.76,1189744.87,2083490.63
291010,201810,153,138,15,131652,14310,145962
291020,201810,102,80,22,76320,20988,97308
291030,201810,99,72,27,68688,25758,94446
291040,201810,576,296,280,282384,267120,549504
291050,201810,1374,771,603,734175.43,575262,1309437.43
291060,201810,1507,833,674,793347.2,642996,1436343.2
291070,201810,1925,1427,498,1356648.13,473831.5,1830479.63
291072,201810,7408,2727,4681,2598208.43,4463204.42,7061412.85
291075,201810,209,170,39,161703,37206,198909
291077,201810,51,34,17,32436,16218,48654
291080,201810,19864,8810,11054,8379221.1,10534070.08,18913291.18
291085,201810,298,241,57,229914,54373.23,284287.23
291090,201810,303,117,186,111332,177434.46,288766.46
291100,201810,662,196,466,186984,444564,631548
291110,201810,402,302,100,288088.92,95400,383488.92
291120,201810,2519,1223,1296,1166599,1234129.26,2400728.26
291125,201810,60,30,30,28620,28620,57240
291130,201810,214,189,25,180306,23850,204156
291140,201810,141,107,34,102078,32150,134228
291150,201810,369,147,222,140238,211788,352026
291160,201810,374,310,64,294786.5,61056,355842.5
291165,201810,25,21,4,20034,3816,23850
291170,201810,3028,1517,1511,1443164.11,1437869.8,2881033.91
291180,201810,1320,514,806,490159.38,768809.76,1258969.14
291185,201810,77,75,2,71550,1908,73458
291190,201810,1280,560,720,531983.13,686050.8,1218033.93
291200,201810,163,125,38,119250,36252,155502
291210,201810,2230,898,1332,853267.34,1268916.14,2122183.48
291220,201810,275,205,70,194616.64,66780,261396.64
291230,201810,1024,355,669,337812,638226,976038
291240,201810,437,414,23,393716,21942,415658
291250,201810,440,361,79,344394,75366,419760
291260,201810,48,36,12,34344,11448,45792
291270,201810,1215,496,719,473184,685639.8,1158823.8
291280,201810,369,171,198,162642.89,188882.46,351525.35
291290,201810,1765,901,864,858123.2,822974,1681097.2
291300,201810,229,179,50,170098.2,47700,217798.2
291310,201810,229,204,25,194616,23850,218466
291320,201810,1401,1003,398,954000,378643.29,1332643.29
291330,201810,132,112,20,104749.2,19080,123829.2
291340,201810,166,94,72,89676,68688,158364
291345,201810,131,87,44,82998,41976,124974
291350,201810,1600,534,1066,509245.2,1016773.3,1526018.5
291360,201810,8593,4268,4325,4060088.66,4122090.25,8182178.91
291370,201810,1131,635,496,605504,473175,1078679
291380,201810,262,205,57,195570,54091.8,249661.8
291390,201810,3869,1720,2149,1635684.23,2048047.8,3683732.03
291400,201810,2100,1506,594,1434052.8,565947.51,2000000.31
291410,201810,155,135,20,127836,19080,146916
291420,201810,115,85,30,81090,28620,109710
291430,201810,164,92,72,87061,67734.53,154795.53
291440,201810,506,408,98,386222.3,93492,479714.3
291450,201810,910,570,340,541301.48,323120,864421.48
291460,201810,1771,1435,336,1367225.1,320544,1687769.1
291465,201810,2216,1033,1183,984335.41,1128281.06,2112616.47
291470,201810,2810,1421,1389,1351695.83,1324367,2676062.83
291480,201810,11804,5228,6576,4975410.69,6265011.43,11240422.12
291490,201810,569,240,329,228960,313579.8,542539.8
291500,201810,368,204,164,194616,156456,351072
291510,201810,1237,478,759,454850.99,723799.8,1178650.79
291520,201810,957,432,525,411023.49,500840.46,911863.95
291530,201810,1000,273,727,260442,693252.72,953694.72
291535,201810,118,101,17,96354,16218,112572
291540,201810,359,106,253,101124,240408.6,341532.6
291550,201810,1200,572,628,543782.1,598817,1142599.1
291560,201810,5478,2784,2694,2642860.17,2559158.74,5202018.91
291570,201810,205,104,101,99216,96354,195570
291580,201810,1246,760,486,724464.46,463639.23,1188103.69
291590,201810,86,35,51,33196.9,48654,81850.9
291600,201810,1366,639,727,608652,693540,1302192
291610,201810,1466,686,780,653160.87,744092,1397252.87
291620,201810,578,270,308,257580,293450.4,551030.4
291630,201810,496,166,330,158364,314820,473184
291640,201810,3897,1968,1929,1868557.68,1838632.06,3707189.74
291650,201810,422,283,139,269029,131806.73,400835.73
291660,201810,422,170,252,161487.96,239310.9,400798.86
291670,201810,226,143,83,135850,79182,215032
291680,201810,690,393,297,374922,283233.46,658155.46
291685,201810,600,332,268,316490,255481.2,571971.2
291690,201810,585,308,277,293832,263295,557127
291700,201810,943,742,201,707138.19,190800,897938.19
291710,201810,1699,793,906,756112.28,863447.06,1619559.34
291720,201810,401,265,136,252805.23,129744,382549.23
291730,201810,949,558,391,530472.7,373004.46,903477.16
291733,201810,267,184,83,175249.8,79182,254431.8
291735,201810,67,53,14,50562,13356,63918
291740,201810,351,269,82,256626,78228,334854
291750,201810,1990,1320,670,1251888.28,638358,1890246.28
291760,201810,3055,1682,1373,1599715,1307457,2907172
291770,201810,810,541,269,514015.26,256626,770641.26
291780,201810,46,28,18,26712,17172,43884
291790,201810,166,80,86,76320,82044,158364
291800,201810,10102,4134,5968,3933997.74,5689258.8,9623256.54
291810,201810,1141,825,316,786477.8,301464,1087941.8
291820,201810,269,193,76,184122,72504,256626
291830,201810,1096,423,673,402153,641079,1043232
291835,201810,600,553,47,527432,44838,572270
291840,201810,4715,2440,2275,2322005.63,2168843.76,4490849.39
291845,201810,292,100,192,95400,183139.38,278539.38
291850,201810,326,286,40,272605.5,38160,310765.5
291855,201810,265,108,157,103032,149778,252810
291860,201810,175,108,67,102078,63918,165996
291870,201810,84,34,50,32436,47700,80136
291875,201810,188,172,16,164088,15264,179352
291880,201810,487,383,104,364572,99216,463788
291890,201810,245,80,165,76310.46,156265.4,232575.86
291900,201810,56,32,24,30528,22896,53424
291905,201810,132,94,38,89390,36252,125642
291910,201810,176,142,34,135468,32436,167904
291915,201810,400,354,46,336048,43884,379932
291920,201810,5022,2603,2419,2480001.61,2306065.77,4786067.38
291930,201810,184,107,77,102078,73458,175536
291940,201810,327,182,145,173151,137376,310527
291950,201810,1151,935,216,891227,206064,1097291
291955,201810,1096,658,438,627524.99,417709,1045233.99
291960,201810,183,129,54,123066,51229.8,174295.8
291970,201810,773,587,186,559998,177444,737442
291980,201810,1519,1345,174,1279081.7,165042.4,1444124.1
291990,201810,130,120,10,114480,9540,124020
291992,201810,172,90,82,85096.8,78228,163324.8
291995,201810,144,99,45,94446,42930,137376
292000,201810,384,295,89,279860.59,84906,364766.59
292010,201810,289,203,86,192708.8,81090,273798.8
292020,201810,281,204,77,194616,73458,268074
292030,201810,141,108,33,103032,31482,134514
292040,201810,631,318,313,303372,298602,601974
292045,201810,96,88,8,83952,7632,91584
292050,201810,922,653,269,621952.67,256340,878292.67
292060,201810,937,772,165,734581.28,157410,891991.28
292070,201810,49,20,29,19080,27666,46746
292080,201810,122,83,39,79182,37206,116388
292090,201810,509,183,326,174391.2,311004,485395.2
292100,201810,1427,621,806,590860.7,767929.25,1358789.95
292105,201810,209,180,29,171720,27666,199386
292110,201810,2129,793,1336,756202.72,1272963.6,2029166.32
292120,201810,662,524,138,498763.79,131652,630415.79
292130,201810,449,260,189,248040,180306,428346
292140,201810,197,155,42,147870,39269.26,187139.26
292145,201810,165,87,78,82712,74369.07,157081.07
292150,201810,1445,1166,279,1112364,264851.96,1377215.96
292160,201810,177,143,34,136135.8,32436,168571.8
292170,201810,1208,1062,146,1011455.31,139226.76,1150682.07
292180,201810,209,150,59,143100,56286,199386
292190,201810,160,96,64,91584,61056,152640
292200,201810,1299,476,823,453132.71,784512.64,1237645.35
292205,201810,123,109,14,103699.8,13356,117055.8
292210,201810,371,258,113,244749,107086.5,351835.5
292220,201810,21,16,5,15264,4770,20034
292225,201810,36,33,3,31482,2862,34344
292230,201810,956,768,188,731118.23,179352,910470.23
292240,201810,616,445,171,423433,163134,586567
292250,201810,1723,1106,617,1055124,588332,1643456
292260,201810,442,254,188,242316,178588.8,420904.8
292265,201810,258,181,77,172387.8,73458,245845.8
292270,201810,763,337,426,321498,405450.8,726948.8
292273,201810,206,114,92,107978.49,87768,195746.49
292275,201810,174,90,84,85860,79849.8,165709.8
292280,201810,139,99,40,94446,38160,132606
292285,201810,67,57,10,53710.2,9540,63250.2
292290,201810,572,386,186,365573.41,177158,542731.41
292300,201810,1647,633,1014,603596,966522.58,1570118.58
292303,201810,104,73,31,69642,29574,99216
292305,201810,110,79,31,75366,29574,104940
292310,201810,831,539,292,513844,277460.15,791304.15
292320,201810,667,503,164,479671.2,156456,636127.2
292330,201810,184,101,83,96354,79182,175536
292335,201810,282,222,60,211788,57240,269028
292340,201810,585,408,177,388492.85,168858,557350.85
292350,201810,269,145,124,137519.1,118009.8,255528.9
292360,201810,707,536,171,509627,163134,672761
292370,201810,763,584,179,557136,170766,727902
292380,201810,649,504,145,479146.92,138330,617476.92
292390,201810,499,195,304,186030,289062.4,475092.4
292400,201810,3420,2114,1306,1996958.93,1242043.8,3239002.73
292405,201810,269,177,92,168381,87481.8,255862.8
292410,201810,146,87,59,82998,56286,139284
292420,201810,302,259,43,246799.8,41022,287821.8
292430,201810,532,417,115,397818,109233,507051
292440,201810,584,499,85,474538.8,80803.8,555342.6
292450,201810,257,196,61,186984,58194,245178
292460,201810,587,435,152,413273.34,144912.6,558185.94
292465,201810,212,177,35,168241.82,32652.09,200893.91
292467,201810,108,65,43,62010,41022,103032
292470,201810,269,182,87,173628,82998,256626
292480,201810,345,227,118,215604.5,112286,327890.5
292490,201810,226,151,75,144054,71550,215604
292500,201810,1146,497,649,473927,618974.28,1092901.28
292510,201810,3365,1526,1839,1454850.12,1751535.6,3206385.72
292520,201810,1091,532,559,505663.7,533277,1038940.7
292525,201810,380,272,108,259483.23,103032,362515.23
292530,201810,4227,1741,2486,1658226.04,2370701.38,4028927.42
292540,201810,471,253,218,241362,207972,449334
292550,201810,1048,570,478,543038.74,455479.18,998517.92
292560,201810,322,303,19,289062,18126,307188
292570,201810,308,235,73,224190,69642,293832
292575,201810,466,300,166,285914,158364,444278
292580,201810,942,603,339,573831,323120,896951
292590,201810,534,458,76,436629.59,72504,509133.59
292593,201810,142,113,29,107802,27666,135468
292595,201810,184,143,41,136422,39114,175536
292600,201810,1251,925,326,882133,310336.2,1192469.2
292610,201810,129,100,29,95400,27408.42,122808.42
292620,201810,535,446,89,425189,84906,510095
292630,201810,1391,794,597,755888,567907.14,1323795.14
292640,201810,796,553,243,527228.1,231822,759050.1
292650,201810,180,152,28,144572,26712,171284
292660,201810,2016,1456,560,1384154.03,530042.83,1914196.86
292665,201810,144,104,40,99216,38160,137376
292670,201810,402,326,76,311000,72504,383504
292680,201810,257,199,58,189846,54855,244701
292690,201810,191,147,44,140238,41976,182214
292700,201810,936,621,315,591480.8,300510,891990.8
292710,201810,106,93,13,88722,12402,101124
292720,201810,854,483,371,459980.64,353934,813914.64
292730,201810,201,95,106,89676.5,101124,190800.5
292740,201810,67773,33494,34279,31879611.69,32670507.79,64550119.48
292750,201810,375,268,107,254718.94,101267.57,355986.51
292760,201810,329,269,60,254375.3,57240,311615.3
292770,201810,786,329,457,313580,435978,749558
292780,201810,418,159,259,151172.28,247086,398258.28
292790,201810,738,364,374,347256,356557.5,703813.5
292800,201810,1172,714,458,680202,436645.8,1116847.8
292805,201810,424,124,300,117771.3,286200,403971.3
292810,201810,1484,849,635,809087.8,605780.46,1414868.26
292820,201810,742,607,135,577170.87,128494.26,705665.13
292830,201810,104,84,20,80136,19080,99216
292840,201810,666,552,114,526418,108741.69,635159.69
292850,201810,134,90,44,85860,41976,127836
292860,201810,2235,1316,919,1250677.94,876726,2127403.94
292870,201810,3453,2324,1129,2215261.4,1077056.46,3292317.86
292880,201810,1480,972,508,923521.86,483344,1406865.86
292890,201810,502,430,72,410192,68688,478880
292895,201810,136,90,46,84501.5,43884,128385.5
292900,201810,391,287,104,273798,99216,373014
292905,201810,461,235,226,224190,215604,439794
292910,201810,419,317,102,302085,97308,399393
292920,201810,545,243,302,231822,288108,519930
292925,201810,500,463,37,441024.66,35279,476303.66
292930,201810,573,356,217,339624,207018,546642
292935,201810,294,127,167,121158,159309,280467
292937,201810,241,164,77,156456,73458,229914
292940,201810,197,152,45,145008,42930,187938
292950,201810,1147,594,553,563577.3,527467,1091044.3
292960,201810,586,397,189,378738,180306,559044
292970,201810,257,182,75,172961,71550,244511
292975,201810,147,83,64,78943.5,60866,139809.5
292980,201810,266,182,84,172798.43,80136,252934.43
292990,201810,1315,976,339,923767.87,322217.93,1245985.80
293000,201810,105,76,29,72504,27666,100170
293010,201810,2740,1657,1083,1574635.32,1029860.51,2604495.83
293015,201810,660,528,132,503494.49,125289,628783.49
293020,201810,338,277,61,264258,58194,322452
293030,201810,612,534,78,508864,74412,583276
293040,201810,342,268,74,255672,70596,326268
293050,201810,2757,1616,1141,1533109.79,1084661.38,2617771.17
293060,201810,252,201,51,190567,47700.8,238267.8
293070,201810,3477,1775,1702,1685171.68,1622069.36,3307241.04
293075,201810,92,60,32,57240,30528,87768
293076,201810,71,48,23,45792,21942,67734
293077,201810,462,282,180,265429.31,171720,437149.31
293080,201810,454,408,46,388946,43884,432830
293090,201810,130,114,16,108756,15264,124020
293100,201810,522,368,154,351072,146916,497988
293105,201810,338,236,102,224858,97308,322166
293110,201810,173,122,51,116388,48654,165042
293120,201810,325,217,108,207018,102841.2,309859.2
293130,201810,244,165,79,157410,75366,232776
293135,201810,8022,3194,4828,3040244.72,4597902.04,7638146.76
293140,201810,186,122,64,116388,61056,177444
293150,201810,329,280,49,266357,46746,313103
293160,201810,432,250,182,238500,173628,412128
293170,201810,144,99,45,94446,42072,136518
293180,201810,470,323,147,307856,140238,448094
293190,201810,1328,924,404,876846.23,385130,1261976.23
293200,201810,534,471,63,448254,59291.1,507545.1
293210,201810,361,272,89,259336,84190.5,343526.5
293220,201810,2698,1100,1598,1047466.41,1522345.97,2569812.38
293230,201810,1764,647,1117,615215.8,1065618,1680833.8
293240,201810,221,202,19,192708,18126,210834
293245,201810,113,95,18,90630,17172,107802
293250,201810,733,273,460,260194,438840,699034
293260,201810,312,263,49,249948.17,46746,296694.17
293270,201810,1162,563,599,535194.68,571446,1106640.68
293280,201810,250,140,110,133560,104940,238500
293290,201810,3049,2001,1048,1908000,999779,2907779
293300,201810,716,510,206,484193.5,193599.99,677793.49
293305,201810,151,129,22,123066,20988,144054
293310,201810,139,107,32,102078,30528,132606
293315,201810,152,117,35,111618,33390,145008
293317,201810,93,65,28,62010,26712,88722
293320,201810,978,569,409,541872.5,390186,932058.5
293325,201810,194,67,127,63918,121158,185076
293330,201810,13035,6142,6893,5850494.9,6568718.29,12419213.19
293340,201810,252,185,67,176490,62964,239454
293345,201810,244,192,52,183168,49608,232776
293350,201810,645,355,290,338670,275181.3,613851.3
293360,201810,1587,1135,452,1081836,430921.8,1512757.8
310010,201810,150,77,73,73458,69356,142814
310020,201810,1071,593,478,563861.9,454889.47,1018751.37
310030,201810,334,273,61,259316.88,58194,317510.88
310040,201810,48,29,19,27666,18126,45792
310050,201810,188,124,64,117914.4,60770,178684.4
310060,201810,244,169,75,160749,71550,232299
310070,201810,16,8,8,7632,7632,15264
310080,201810,47,26,21,24804,20034,44838
310090,201810,980,520,460,490166.88,437981.8,928148.68
310100,201810,307,232,75,221328,71550,292878
310110,201810,731,395,336,375508.9,319294.46,694803.36
310120,201810,393,214,179,203202.2,170766,373968.2
310130,201810,33,21,12,20034,11448,31482
310140,201810,23,12,11,11448,10494,21942
310150,201810,1302,891,411,842146.8,391235.8,1233382.6
310160,201810,2093,1063,1030,1006281.73,980235.4,1986517.13
310163,201810,94,54,40,51516,38160,89676
310170,201810,2628,1133,1495,1080090.2,1423083.4,2503173.6
310180,201810,134,51,83,48654,78800.4,127454.4
310190,201810,490,334,156,318636,148251.6,466887.6
310200,201810,504,321,183,306234,174582,480816
310205,201810,56,42,14,40068,13356,53424
310210,201810,282,230,52,219420,49608,269028
310220,201810,57,34,23,32436,21942,54378
310230,201810,270,189,81,180115.2,77274,257389.2
310240,201810,107,93,14,88483.5,13356,101839.5
310250,201810,101,81,20,77274,19080,96354
310260,201810,775,421,354,398678.24,336981.42,735659.66
310270,201810,277,184,93,174983,88722,263705
310280,201810,364,274,90,260729,85860,346589
310285,201810,216,154,62,146607.86,59148,205755.86
310290,201810,257,147,110,140238,104940,245178
310300,201810,149,122,27,116388,25758,142146
310310,201810,10,8,2,7632,1908,9540
310320,201810,24,14,10,13356,9540,22896
310330,201810,33,25,8,23850,7632,31482
310340,201810,1745,1146,599,1085557.8,570587.6,1656145.4
310350,201810,2888,1572,1316,1495819.81,1254882.8,2750702.61
310360,201810,41,34,7,32436,6678,39114
310370,201810,127,106,21,101124,19748,120872
310375,201810,113,42,71,40068,67715,107783
310380,201810,50,29,21,27666,20034,47700
310390,201810,102,69,33,65826,31482,97308
310400,201810,2398,1573,825,1497018,786763.8,2283781.8
310410,201810,126,70,56,66780,53424,120204
310420,201810,683,362,321,344490.2,305271.06,649761.26
310430,201810,323,215,108,204871.5,102746,307617.5
310440,201810,70,42,28,40068,26712,66780
310445,201810,80,65,15,62010,14310,76320
310450,201810,861,543,318,518022,303372,821394
310460,201810,262,190,72,180497,68688,249185
310470,201810,505,329,176,313866,167904,481770
310480,201810,81,60,21,57240,20034,77274
310490,201810,525,251,274,238500,261396,499896
310500,201810,128,53,75,50562,71550,122112
310510,201810,603,401,202,381314.6,192699,574013.6
310520,201810,133,91,42,86814,40068,126882
310530,201810,89,39,50,37206,47413.8,84619.8
310540,201810,466,287,179,271414.6,170479.8,441894.4
310550,201810,88,57,31,54378,29574,83952
310560,201810,2981,2060,921,1954472.54,877393.8,2831866.34
310570,201810,116,78,38,74412,36252,110664
310590,201810,360,238,122,225383.8,116373.69,341757.49
310600,201810,162,93,69,86290.7,65826,152116.7
310610,201810,61,24,37,22896,35298,58194
310620,201810,46883,22583,24300,21467609.37,23142724.1,44610333.47
310630,201810,629,406,223,384033.2,211597.4,595630.6
310640,201810,145,120,25,114003,23850,137853
310650,201810,166,146,20,138998,19080,158078
310660,201810,91,57,34,54378,32436,86814
310665,201810,59,41,18,39114,17172,56286
310670,201810,6533,2936,3597,2793770.67,3427855.98,6221626.65
310680,201810,57,37,20,35298,19080,54378
310690,201810,624,450,174,422423.16,165996,588419.16
310700,201810,60,39,21,37206,19890.9,57096.9
310710,201810,1244,841,403,801060.23,384176,1185236.23
310720,201810,92,29,63,27666,60102,87768
310730,201810,1382,969,413,922232.5,393716,1315948.5
310740,201810,992,556,436,527276.4,415410.26,942686.66
310750,201810,247,146,101,138330.18,96354,234684.18
310760,201810,63,46,17,43884,15932,59816
310770,201810,95,44,51,41976,48654,90630
310780,201810,398,325,73,309468.6,69642,379110.6
310790,201810,98,80,18,76320,17172,93492
310800,201810,450,216,234,205587,222949.8,428536.8
310810,201810,173,120,53,113421.2,49608,163029.2
310820,201810,354,281,73,268074,69642,337716
310825,201810,202,166,36,158364,34344,192708
310830,201810,466,223,243,212081.94,231822,443903.94
310840,201810,380,219,161,208926,153594,362520
310850,201810,109,87,22,82998,20988,103986
310855,201810,386,306,80,291924,76320,368244
310860,201810,1439,1076,363,1021116.3,344566.9,1365683.2
310870,201810,54,42,12,40068,11448,51516
310880,201810,84,65,19,61723.8,18126,79849.8
310890,201810,307,182,125,173628,119250,292878
310900,201810,637,297,340,280764,324054.8,604818.8
310910,201810,240,164,76,155121.2,72504,227625.2
310920,201810,482,288,194,270937.2,185076,456013.2
310925,201810,47,37,10,35298,9254,44552
310930,201810,1090,662,428,631431.53,408216.3,1039647.83
310940,201810,677,348,329,331705.8,313866,645571.8
310945,201810,118,72,46,68688,43884,112572
310950,201810,251,199,52,189846,49608,239454
310960,201810,83,29,54,27666,51512,79178
310970,201810,164,103,61,98262,57907.8,156169.8
310980,201810,47,25,22,23850,20988,44838
310990,201810,151,85,66,80804,62964,143768
311000,201810,849,418,431,395624.69,411165,806789.69
311010,201810,42,35,7,33390,6678,40068
311020,201810,42,26,16,24804,15264,40068
311030,201810,391,235,156,222282,148443,370725
311040,201810,39,34,5,32436,4770,37206
311050,201810,470,197,273,187366,259869.6,447235.6
311060,201810,763,436,327,413845.6,311672,725517.6
311070,201810,342,160,182,152640,173628,326268
311080,201810,108,58,50,55332,47700,103032
311090,201810,390,185,205,175536,195570,371106
311100,201810,604,360,244,343153.8,232203.6,575357.4
311110,201810,688,476,212,454104,202239,656343
311115,201810,72,52,20,49608,19080,68688
311120,201810,1088,579,509,549454.2,484679.9,1034134.1
311130,201810,400,238,162,226861.2,154548,381409.2
311140,201810,165,86,79,81757.8,74555.1,156312.9
311150,201810,359,233,126,222282,119965.5,342247.5
311160,201810,741,531,210,504189.4,199863,704052.4
311170,201810,80,60,20,57240,18793.8,76033.8
311180,201810,352,237,115,225811.8,109424,335235.8
311190,201810,35,17,18,16218,17172,33390
311200,201810,336,237,99,224476.6,94446,318922.6
311205,201810,33,22,11,20988,10494,31482
311210,201810,50,42,8,39782,7632,47414
311220,201810,20,18,2,17172,1908,19080
311230,201810,1643,1073,570,1018608.94,543780,1562388.94
311240,201810,177,112,65,106644.33,62010,168654.33
311250,201810,97,30,67,28620,63918,92538
311260,201810,550,345,205,329130,195570,524700
311265,201810,113,79,34,75366,32436,107802
311270,201810,288,206,82,196524,78228,274752
311280,201810,216,99,117,94446,111045.6,205491.6
311290,201810,110,90,20,85860,18794,104654
311300,201810,567,360,207,343440,197192,540632
311310,201810,25,19,6,18126,5724,23850
311320,201810,674,501,173,477000,165042,642042
311330,201810,1073,790,283,753421.5,269028.4,1022449.9
311340,201810,2672,1890,782,1794514.75,744388.66,2538903.41
311350,201810,275,209,66,199386,62964,262350
311360,201810,179,109,70,103986,66207.6,170193.6
311370,201810,1213,501,712,476246.5,678675.6,1154922.1
311380,201810,7,6,1,5724,954,6678
311390,201810,269,143,126,136422,120013.2,256435.2
311400,201810,150,100,50,95400,47700,143100
311410,201810,101,57,44,54092,41976,96068
311420,201810,305,172,133,162848.8,126882,289730.8
311430,201810,867,568,299,539965.2,284960,824925.2
311440,201810,494,346,148,330084,140905.8,470989.8
311450,201810,326,206,120,196524,114480,311004
311455,201810,305,207,98,197182.8,93492,290674.8
311460,201810,137,58,79,55332,74560.27,129892.27
311470,201810,24,14,10,13356,9540,22896
311480,201810,32,14,18,13356,17172,30528
311490,201810,17,11,6,10494,5724,16218
311500,201810,20,10,10,9540,9540,19080
311510,201810,637,449,188,426117.3,179352,605469.3
311520,201810,45,35,10,32722.2,9540,42262.2
311530,201810,1796,1355,441,1278954.42,420714,1699668.42
311535,201810,74,53,21,50562,20034,70596
311540,201810,34,29,5,27666,4770,32436
311545,201810,195,146,49,139284,46746,186030
311547,201810,34,25,9,23850,8586,32436
311550,201810,671,314,357,299556,340559.46,640115.46
311560,201810,44,29,15,27666,14310,41976
311570,201810,294,200,94,190227.6,89676,279903.6
311580,201810,325,192,133,182595.6,126882,309477.6
311590,201810,34,30,4,28620,3816,32436
311600,201810,95,76,19,72504,18126,90630
311610,201810,258,226,32,214650.5,30528,245178.5
311615,201810,109,90,19,85860,17935.2,103795.2
311620,201810,22,12,10,11448,9540,20988
311630,201810,85,71,14,67734,13356,81090
311640,201810,134,69,65,65826,62010,127836
311650,201810,130,96,34,90868.5,32436,123304.5
311660,201810,415,202,213,192708,203202,395910
311670,201810,165,106,59,100879,56286,157165
311680,201810,224,163,61,153927.95,57430.8,211358.75
311690,201810,18,11,7,10494,6678,17172
311700,201810,199,141,58,134227.8,54950.4,189178.2
311710,201810,213,133,80,126882,76320,203202
311720,201810,36,26,10,24518,9540,34058
311730,201810,579,382,197,363152,187938,551090
311740,201810,38,28,10,26712,9540,36252
311750,201810,708,479,229,455059.8,218466,673525.8
311760,201810,63,34,29,32436,27666,60102
311770,201810,399,198,201,185753.82,191754,377507.82
311780,201810,172,96,76,91298,72504,163802
311783,201810,83,74,9,70596,8586,79182
311787,201810,35,14,21,13356,20034,33390
311790,201810,262,123,139,117342,132606,249948
311800,201810,672,454,218,429730.3,207304.2,637034.5
311810,201810,45,38,7,36252,6678,42930
311820,201810,111,95,16,90630,15264,105894
311830,201810,1959,1235,724,1171232.1,686142.96,1857375.06
311840,201810,1037,574,463,543018.9,439279.54,982298.44
311850,201810,11,7,4,6678,3816,10494
311860,201810,9561,4343,5218,4126895.11,4970899.27,9097794.38
311870,201810,145,81,64,77274,61056,138330
311880,201810,957,708,249,673896.8,237546,911442.8
311890,201810,220,110,110,104940,104940,209880
311900,201810,81,34,47,32436,44838,77274
311910,201810,1423,885,538,842096.6,511153.4,1353250.0
311920,201810,236,155,81,147870,77274,225144
311930,201810,924,525,399,500564,380408,880972
311940,201810,2562,1351,1211,1286517.7,1151955,2438472.7
311950,201810,46,33,13,31482,12402,43884
311960,201810,67,49,18,46746,17172,63918
311970,201810,28,18,10,14882.4,9540,24422.4
311980,201810,42,32,10,30241.8,9540,39781.8
311990,201810,52,38,14,36252,13356,49608
311995,201810,64,44,20,41976,19080,61056
312000,201810,35,25,10,23563.8,9540,33103.8
312010,201810,84,63,21,60102,20034,80136
312015,201810,99,74,25,70310,23850,94160
312020,201810,140,88,52,83666,49608,133274
312030,201810,47,38,9,35585,8586,44171
312040,201810,84,53,31,50562,29574,80136
312050,201810,209,114,95,108756,90630,199386
312060,201810,66,40,26,38160,24323.6,62483.6
312070,201810,74,46,28,43884,26712,70596
312080,201810,543,249,294,237546,280476,518022
312083,201810,52,38,14,36252,13356,49608
312087,201810,117,95,22,90630,20988,111618
312090,201810,3012,1759,1253,1664735.9,1193124.95,2857860.85
312100,201810,159,110,49,104434.38,45964,150398.38
312110,201810,118,74,44,70309.8,41976,112285.8
312120,201810,147,111,36,104941,34344,139285
312125,201810,94,53,41,50562,39114,89676
312130,201810,122,81,41,77274,39114,116388
312140,201810,141,108,33,102460,31482,133942
312150,201810,46,36,10,34344,9540,43884
312160,201810,1548,1022,526,970695.6,500392.48,1471088.08
312170,201810,12,10,2,9540,1908,11448
312180,201810,104,65,39,61295,36920,98215
312190,201810,30,26,4,24804,3816,28620
312200,201810,744,642,102,610798.7,97308,708106.7
312210,201810,94,61,33,58194,31482,89676
312220,201810,132,94,38,89438,36252,125690
312230,201810,3620,1773,1847,1687704.58,1760897.58,3448602.16
312235,201810,158,106,52,101124,49608,150732
312240,201810,107,72,35,68688,33390,102078
312245,201810,175,120,55,114476,52470,166946
312247,201810,60,43,17,40259,16218,56477
312250,201810,184,86,98,82044,93492,175536
312260,201810,107,71,36,66876.2,34344,101220.2
312270,201810,138,86,52,82044,49608,131652
312280,201810,26,16,10,15264,9540,24804
312290,201810,159,107,52,102078,48655,150733
312300,201810,202,134,68,127836,64872,192708
312310,201810,56,52,4,49608,3816,53424
312320,201810,441,280,161,264496.5,152020.1,416516.6
312330,201810,88,78,10,73648.8,9253.8,82902.6
312340,201810,37,17,20,16218,19080,35298
312350,201810,18,11,7,10494,6678,17172
312352,201810,99,68,31,64872,29574,94446
312360,201810,563,257,306,244224,291924,536148
312370,201810,311,181,130,172387.8,124020,296407.8
312380,201810,140,95,45,90630,42930,133560
312385,201810,172,140,32,133273.8,30528,163801.8
312390,201810,306,192,114,182500.2,108089,290589.2
312400,201810,379,292,87,278568,82522,361090
312410,201810,909,293,616,279045,587034,866079
312420,201810,621,485,136,461736.2,129744,591480.2
312430,201810,862,642,220,610074.05,209880,819954.05
312440,201810,46,34,12,32436,11448,43884
312450,201810,209,129,80,123066,76320,199386
312460,201810,61,29,32,27666,30528,58194
312470,201810,55,35,20,33390,19080,52470
312480,201810,200,120,80,114480,76320,190800
312490,201810,270,185,85,176490,81090,257580
312500,201810,32,18,14,17172,13356,30528
312510,201810,457,178,279,169812,265550.39,435362.39
312520,201810,42,15,27,14310,25758,40068
312530,201810,50,37,13,35298,12402,47700
312540,201810,101,88,13,83952,12402,96354
312550,201810,40,32,8,30528,7632,38160
312560,201810,216,162,54,154262,51229.8,205491.8
312570,201810,445,263,182,250902,173079.45,423981.45
312580,201810,87,45,42,42930,40068,82998
312590,201810,267,212,55,202248,52470,254718
312595,201810,140,125,15,119250,14310,133560
312600,201810,75,46,29,43455,27666,71121
312610,201810,1642,865,777,817484.98,739541.6,1557026.58
312620,201810,192,138,54,131652,51511.23,183163.23
312630,201810,67,56,11,53424,10494,63918
312640,201810,47,13,34,12402,32436,44838
312650,201810,153,128,25,121826,23850,145676
312660,201810,71,53,18,50419,17172,67591
312670,201810,872,576,296,548550.1,282170.3,830720.4
312675,201810,39,31,8,29574,7632,37206
312680,201810,83,55,28,52088.4,26712,78800.4
312690,201810,236,125,111,119240.46,105607.8,224848.26
312695,201810,35,28,7,26712,6678,33390
312700,201810,224,127,97,121158,92538,213696
312705,201810,80,66,14,62964,13356,76320
312707,201810,124,91,33,86394.24,31482,117876.24
312710,201810,1911,1022,889,973914,846942,1820856
312720,201810,67,33,34,31482,32436,63918
312730,201810,288,169,119,160272,113526,273798
312733,201810,55,46,9,43884,8586,52470
312735,201810,22,16,6,15264,5724,20988
312737,201810,72,38,34,36252,32436,68688
312738,201810,55,39,16,37206,15264,52470
312740,201810,75,50,25,47414,23850,71264
312750,201810,70,52,18,49608,17172,66780
312760,201810,276,202,74,192708,70596,263304
312770,201810,7621,3554,4067,3369572.8,3873401.23,7242974.03
312780,201810,430,330,100,314533.8,95400,409933.8
312790,201810,22,17,5,16218,4770,20988
312800,201810,1613,1126,487,1067622.6,463167.78,1530790.38
312810,201810,377,243,134,230963.4,127836,358799.4
312820,201810,194,145,49,138330,46746,185076
312825,201810,26,17,9,16218,8586,24804
312830,201810,274,164,110,155217,104301,259518
312840,201810,152,111,41,105894,39114,145008
312850,201810,28,25,3,23850,2862,26712
312860,201810,166,101,65,96068,62010,158078
312870,201810,992,524,468,497288.44,446472,943760.44
312880,201810,153,104,49,99072.9,46650.6,145723.5
312890,201810,170,117,53,110808,50562,161370
312900,201810,207,156,51,148156.2,48654,196810.2
312910,201810,190,97,93,91755.72,88722,180477.72
312920,201810,156,87,69,82998,65826,148824
312930,201810,350,250,100,238500,95400,333900
312940,201810,115,80,35,76320,33390,109710
312950,201810,709,472,237,449238.6,226098,675336.6
312960,201810,171,133,38,126386,36252,162638
312965,201810,59,52,7,49608,6678,56286
312970,201810,291,234,57,222282.2,54378,276660.2
312980,201810,2347,1234,1113,1171792,1061511.8,2233303.8
312990,201810,47,28,19,26712,18126,44838
313000,201810,44,26,18,24804,17172,41976
313005,201810,173,134,39,127597.5,36920,164517.5
313010,201810,942,386,556,366994.26,530415,897409.26
313020,201810,188,98,90,93015,85860,178875
313030,201810,209,138,71,129459,67734,197193
313040,201810,68,26,42,24804,40068,64872
313050,201810,294,204,90,194616,85860,280476
313055,201810,47,35,12,33390,11448,44838
313060,201810,121,84,37,80136,35011.8,115147.8
313065,201810,61,40,21,38160,20034,58194
313070,201810,148,79,69,75366,65826,141192
313080,201810,42,18,24,17172,22896,40068
313090,201810,719,497,222,472468.7,211788,684256.7
313100,201810,166,64,102,61056,97300,158356
313110,201810,133,76,57,72504,54378,126882
313115,201810,182,100,82,95199.66,78228,173427.66
313120,201810,773,430,343,409934,325982,735916
313130,201810,5415,2952,2463,2790021.04,2341639.97,5131661.01
313140,201810,153,81,72,77274,68688,145962
313150,201810,311,248,63,236592,59815.8,296407.8
313160,201810,200,147,53,139952,50562,190514
313170,201810,1406,985,421,926670.1,401243.4,1327913.5
313180,201810,313,187,126,177749.28,119918,297667.28
313190,201810,755,459,296,434833.2,281621,716454.2
313200,201810,26,25,1,23850,954,24804
313210,201810,1051,886,165,841716.46,157405.23,999121.69
313220,201810,246,168,78,159318,73222.9,232540.9
313230,201810,275,204,71,193663,67734,261397
313240,201810,1939,1032,907,980895.93,862375.24,1843271.17
313250,201810,1287,965,322,915174.6,305281.8,1220456.4
313260,201810,97,55,42,52470,40068,92538
313270,201810,962,564,398,534384.1,379692,914076.1
313280,201810,62,52,10,49131,9540,58671
313290,201810,225,181,44,172292.6,41023,213315.6
313300,201810,361,190,171,178113,163134,341247
313310,201810,244,124,120,118296,114480,232776
313320,201810,376,287,89,271843.1,84906,356749.1
313330,201810,1374,848,526,807561.2,500612.5,1308173.7
313340,201810,337,233,104,222282,99216,321498
313350,201810,516,350,166,331992.1,158364,490356.1
313360,201810,116,70,46,66780,43598,110378
313370,201810,191,69,122,65826,116388,182214
313375,201810,278,169,109,161226,103986,265212
313380,201810,1349,703,646,667819.08,616280,1284099.08
313390,201810,52,46,6,42930.8,5724,48654.8
313400,201810,414,278,136,265212,129172,394384
313410,201810,22,14,8,13356,7632,20988
313420,201810,4684,2449,2235,2327352.38,2124559.76,4451912.14
313430,201810,144,67,77,63918,73362.6,137280.6
313440,201810,1502,1030,472,978853.03,448858,1427711.03
313450,201810,63,27,36,25758,34057.8,59815.8
313460,201810,379,176,203,167418,192708,360126
313470,201810,534,245,289,233730,275038.2,508768.2
313480,201810,155,108,47,102079,44838,146917
313490,201810,514,248,266,236301.23,253717,490018.23
313500,201810,21,14,7,13356,6678,20034
313505,201810,1003,781,222,743938.94,211788,955726.94
313507,201810,102,61,41,58194,39114,97308
313510,201810,2815,1810,1005,1719860.68,957816,2677676.68
313520,201810,3607,2827,780,2685873.97,744116,3429989.97
313530,201810,45,30,15,28620,14310,42930
313535,201810,110,87,23,82331,21942,104273
313540,201810,75,57,18,54378,17172,71550
313545,201810,113,95,18,90630,17172,107802
313550,201810,236,195,41,186030,38828,224858
313560,201810,328,166,162,158364,154548,312912
313570,201810,61,31,30,29574,28620,58194
313580,201810,1330,735,595,698519,566772,1265291
313590,201810,77,46,31,43884,29574,73458
313600,201810,694,420,274,400394,261110,661504
313610,201810,59,47,12,44218.8,11448,55666.8
313620,201810,1380,733,647,689422.18,612592.34,1302014.52
313630,201810,1647,1261,386,1199205.4,368244,1567449.4
313640,201810,128,76,52,72504,49608,122112
313650,201810,242,113,129,107802,122494,230296
313652,201810,19,19,0,18126,0,18126
313655,201810,58,34,24,32436,22896,55332
313657,201810,48,44,4,41976,3816,45792
313660,201810,137,93,44,88722,41993.17,130715.17
313665,201810,658,315,343,300510,326983.5,627493.5
313670,201810,10286,7139,3147,6784015.48,3001379.8,9785395.28
313680,201810,43,32,11,30528,10390,40918
313690,201810,155,116,39,110664,37206,147870
313695,201810,79,60,19,57240,18126,75366
313700,201810,307,248,59,236306,56286,292592
313710,201810,145,98,47,93492,44838,138330
313720,201810,1131,547,584,519358,555791.86,1075149.86
313730,201810,61,42,19,40068,18126,58194
313740,201810,161,131,30,124974,28620,153594
313750,201810,444,325,119,310050,113526,423576
313753,201810,248,180,68,171052.2,64872,235924.2
313760,201810,1266,461,805,439508,765510.18,1205018.18
313770,201810,362,265,97,251904.2,92538,344442.2
313780,201810,763,395,368,376830,350785.8,727615.8
313790,201810,31,30,1,28047.6,954,29001.6
313800,201810,153,96,57,91584,54378,145962
313810,201810,68,39,29,37206,27666,64872
313820,201810,1291,648,643,616952.2,612159,1229111.2
313830,201810,67,48,19,45792,18126,63918
313835,201810,61,50,11,47700,10494,58194
313840,201810,1723,1072,651,1017347.52,619814.2,1637161.72
313850,201810,184,63,121,60102,115434,175536
313860,201810,476,366,110,345778.3,104940,450718.3
313862,201810,175,116,59,110664,55999.8,166663.8
313865,201810,93,74,19,70596,18126,88722
313867,201810,48,37,11,35298,10494,45792
313868,201810,31,20,11,18317,10494,28811
313870,201810,127,65,62,62010,58862,120872
313880,201810,369,233,136,222282,129458,351740
313890,201810,327,175,152,166187.8,144435.6,310623.4
313900,201810,909,501,408,477000.5,389185,866185.5
313910,201810,137,99,38,94446,35298.2,129744.2
313920,201810,632,446,186,425293.2,176924,602217.2
313925,201810,33,29,4,27666,3816,31482
313930,201810,831,640,191,610273.8,182191,792464.8
313940,201810,1823,1154,669,1097672.6,637558.4,1735231.0
313950,201810,932,597,335,567440.2,319303.8,886744.0
313960,201810,1396,804,592,763038.5,562432,1325470.5
313970,201810,126,85,41,81090,39114,120204
313980,201810,212,139,73,132368,69642,202010
313990,201810,381,229,152,218466,145008,363474
314000,201810,936,628,308,595631.9,293827.23,889459.13
314010,201810,80,53,27,50562,25758,76320
314015,201810,53,16,37,15264,35298,50562
314020,201810,52,37,15,35298,14310,49608
314030,201810,82,37,45,35135.82,42930,78065.82
314040,201810,45,30,15,28620,14310,42930
314050,201810,310,183,127,174296,121158,295454
314053,201810,99,64,35,60102.4,33390,93492.4
314055,201810,303,183,120,174582,114480,289062
314060,201810,147,124,23,116817.3,21942,138759.3
314070,201810,1049,538,511,510144.48,486874,997018.48
314080,201810,219,143,76,135468,71454.88,206922.88
314085,201810,140,91,49,86814,46746,133560
314090,201810,362,265,97,252763,92533.23,345296.23
314100,201810,477,394,83,372061,78610,450671
314110,201810,743,406,337,385692.66,320925.6,706618.26
314120,201810,94,54,40,51516,38160,89676
314130,201810,24,11,13,10494,12402,22896
314140,201810,1117,681,436,645362.12,412796.46,1058158.58
314150,201810,166,106,60,100837.8,57240,158077.8
314160,201810,349,260,89,245178.8,84716,329894.8
314170,201810,78,61,17,57335.4,16218,73553.4
314180,201810,736,647,89,616952,83952.5,700904.5
314190,201810,99,59,40,56286,38160,94446
314200,201810,588,408,180,388595.7,170766,559361.7
314210,201810,283,215,68,204156,64586,268742
314220,201810,311,235,76,222283,72218,294501
314225,201810,66,48,18,45792,17172,62964
314230,201810,111,50,61,47700,58194,105894
314240,201810,141,109,32,103986,30528,134514
314250,201810,61,38,23,36252,21942,58194
314260,201810,193,96,97,91584,92538,184122
314270,201810,330,263,67,250902,63918,314820
314280,201810,695,391,304,373005,290016,663021
314290,201810,560,458,102,435692.5,97021.8,532714.3
314300,201810,398,286,112,269718,106801,376519
314310,201810,1445,977,468,930151.12,446442.43,1376593.55
314315,201810,38,31,7,29574,6678,36252
314320,201810,615,400,215,381313.8,204470.82,585784.62
314330,201810,10695,5418,5277,5158073.36,5029792.75,10187866.11
314340,201810,577,270,307,257293.8,292306,549599.8
314345,201810,38,28,10,26712,9540,36252
314350,201810,192,120,72,114480,68688,183168
314360,201810,84,54,30,51516,28620,80136
314370,201810,57,47,10,44838,9540,54378
314380,201810,93,66,27,62964,25758,88722
314390,201810,3324,2114,1210,2011509.5,1151383.4,3162892.9
314400,201810,693,496,197,470314.2,187938,658252.2
314410,201810,454,298,156,284292,148824,433116
314420,201810,19,10,9,9540,8586,18126
314430,201810,2492,904,1588,856994.79,1512440.47,2369435.26
314435,201810,277,164,113,156169.8,106848,263017.8
314437,201810,28,22,6,20988,5724,26712
314440,201810,99,72,27,68688,25758,94446
314450,201810,153,112,41,106848,39114,145962
314460,201810,652,306,346,291924,330084,622008
314465,201810,88,59,29,56286,27666,83952
314467,201810,70,57,13,54369,12402,66771
314470,201810,398,205,193,192118.52,183168.5,375287.02
314480,201810,1082,517,565,493218,538819.2,1032037.2
314490,201810,86,64,22,61056,20988,82044
314500,201810,311,207,104,197478,99216,296694
314505,201810,130,87,43,82998,41022,124020
314510,201810,236,194,42,185076,40068,225144
314520,201810,1267,659,608,619533.5,578887.8,1198421.3
314530,201810,747,595,152,566995,145008,712003
314535,201810,212,134,78,127072.8,74412,201484.8
314537,201810,66,39,27,37206,25758,62964
314540,201810,13,8,5,7632,4770,12402
314545,201810,47,30,17,28620,16218,44838
314550,201810,83,45,38,42930,36252,79182
314560,201810,825,446,379,422813,361566,784379
314570,201810,21,17,4,16218,3816,20034
314580,201810,15,8,7,7632,6678,14310
314585,201810,22,17,5,16218,4770,20988
314587,201810,82,72,10,68688,9540,78228
314590,201810,585,433,152,411556.5,144721.8,556278.3
314600,201810,969,636,333,601586.86,316104.81,917691.67
314610,201810,955,515,440,488448.7,419283,907731.7
314620,201810,148,108,40,101791.8,38160,139951.8
314625,201810,96,70,26,66780,24804,91584
314630,201810,1231,638,593,607173.3,565149.8,1172323.1
314640,201810,88,58,30,55332,28333.8,83665.8
314650,201810,193,112,81,106561.8,76797,183358.8
314655,201810,66,50,16,47700,15264,62964
314660,201810,19,15,4,14310,3816,18126
314670,201810,194,153,41,145676,39114,184790
314675,201810,216,128,88,122112,83952,206064
314690,201810,552,302,250,287821.8,238500,526321.8
314700,201810,2423,1316,1107,1250324.26,1055457.9,2305782.16
314710,201810,1629,957,672,908688.5,640182.1,1548870.6
314720,201810,409,245,164,232327.62,156456,388783.62
314730,201810,521,271,250,256531.8,238204.8,494736.6
314740,201810,693,342,351,324598.5,334854,659452.5
314750,201810,21,18,3,17172,2862,20034
314760,201810,328,158,170,150732,162170.46,312902.46
314770,201810,121,83,38,79182,36252,115434
314780,201810,20,6,14,5724,13356,19080
314790,201810,2426,1535,891,1457990.5,849193.56,2307184.06
314795,201810,56,48,8,45554,7632,53186
314800,201810,2959,1742,1217,1655628.86,1159396.2,2815025.06
314810,201810,1513,844,669,802982.6,636605,1439587.6
314820,201810,98,54,44,51516,41976,93492
314830,201810,211,169,42,160510.5,39782,200292.5
314840,201810,83,48,35,45792,33390,79182
314850,201810,353,170,183,162180,174582,336762
314860,201810,716,539,177,512202.86,167237.1,679439.96
314870,201810,1495,782,713,745074,680202,1425276
314875,201810,58,50,8,47700,7632,55332
314880,201810,46,32,14,30528,13356,43884
314890,201810,54,31,23,29574,21942,51516
314900,201810,33,26,7,24804,6678,31482
314910,201810,253,170,83,161893.8,79182,241075.8
314915,201810,161,141,20,134514,19080,153594
314920,201810,121,74,47,70596,44551.8,115147.8
314930,201810,1044,532,512,505664.33,487875.6,993539.93
314940,201810,52,40,12,38160,11448,49608
314950,201810,39,27,12,25758,11448,37206
314960,201810,54,40,14,38160,13356,51516
314970,201810,144,73,71,69642,67734,137376
314980,201810,299,192,107,180926.1,101124,282050.1
314990,201810,463,256,207,244224,196572.5,440796.5
314995,201810,214,64,150,61056,143090.46,204146.46
315000,201810,95,79,16,75366,15264,90630
315010,201810,46,30,16,28620,15264,43884
315015,201810,179,147,32,139512.96,30528,170040.96
315020,201810,73,64,9,61056,8586,69642
315030,201810,116,90,26,84906,24804,109710
315040,201810,67,49,18,46746,17172,63918
315050,201810,197,118,79,112572,75080,187652
315053,201810,42,37,5,35298,4626.9,39924.9
315057,201810,98,80,18,75938.4,17172,93110.4
315060,201810,74,65,9,60103.16,8586,68689.16
315070,201810,106,59,47,56286,44838,101124
315080,201810,377,309,68,294786,64872,359658
315090,201810,111,66,45,62964,42930,105894
315100,201810,83,43,40,41022,38160,79182
315110,201810,294,164,130,155598,124020,279618
315120,201810,1662,836,826,792655.15,786096.64,1578751.79
315130,201810,345,250,95,238500,90630,329130
315140,201810,532,315,217,298888.2,207018,505906.2
315150,201810,990,477,513,454105,488830,942935
315160,201810,222,111,111,105894,105894,211788
315170,201810,333,218,115,206065.2,109423.8,315489.0
315180,201810,3271,1376,1895,1308091.02,1804874.7,3112965.72
315190,201810,326,191,135,181833,128790,310623
315200,201810,1213,703,510,669040.2,485681.4,1154721.6
315210,201810,1577,894,683,850301.8,649162.2,1499464.0
315213,201810,43,25,18,23850,17172,41022
315217,201810,215,172,43,164088,41022,205110
315220,201810,1558,1192,366,1136110.4,348878,1484988.4
315230,201810,167,121,46,115148,43884,159032
315240,201810,425,272,153,259488,144760.5,404248.5
315250,201810,2554,1264,1290,1205278.83,1230269.66,2435548.49
315260,201810,147,90,57,85860,54378,140238
315270,201810,132,92,40,87195.6,37434.96,124630.56
315280,201810,698,455,243,433403,231812.46,665215.46
315290,201810,205,123,82,117342,77274.49,194616.49
315300,201810,73,52,21,49608,20034,69642
315310,201810,69,63,6,60102,5724,65826
315320,201810,168,97,71,92538,67734,160272
315330,201810,58,50,8,47700,7632,55332
315340,201810,410,291,119,276431.6,113526,389957.6
315350,201810,153,91,62,86814,59148,145962
315360,201810,94,50,44,47700,41976,89676
315370,201810,58,34,24,31720.5,22896,54616.5
315380,201810,11,7,4,6678,3816,10494
315390,201810,67,15,52,14310,49608,63918
315400,201810,840,634,206,599398.5,195856.2,795254.7
315410,201810,357,219,138,208640,131366,340006
315415,201810,64,49,15,46746,14310,61056
315420,201810,202,153,49,144866,46746,191612
315430,201810,675,391,284,371774,270459.8,642233.8
315440,201810,88,61,27,58194,25758,83952
315445,201810,255,206,49,196209.18,46746,242955.18
315450,201810,183,138,45,131652,42930,174582
315460,201810,3511,1775,1736,1690289.4,1653417.1,3343706.5
315470,201810,43,20,23,19080,21942,41022
315480,201810,65,26,39,24804,37206,62010
315490,201810,638,400,238,379548.9,227052,606600.9
315500,201810,23,15,8,14310,7632,21942
315510,201810,152,100,52,95400,49608,145008
315520,201810,74,65,9,62010,8586,70596
315530,201810,53,28,25,26712,23850,50562
315540,201810,239,159,80,151686,76320,228006
315550,201810,178,141,37,134514,35298,169812
315560,201810,743,593,150,564382.8,143100,707482.8
315570,201810,318,166,152,155169.5,144818,299987.5
315580,201810,682,448,234,426725,223236,649961
315590,201810,203,106,97,101124,92538,193662
315600,201810,295,220,75,209641.5,71550,281191.5
315610,201810,97,48,49,45792,46746,92538
315620,201810,34,28,6,26712,5724,32436
315630,201810,138,90,48,85860,45792,131652
315640,201810,65,40,25,38160,23850,62010
315645,201810,66,47,19,44838,17649,62487
315650,201810,171,123,48,116770,45219.6,161989.6
315660,201810,477,214,263,204156,250902,455058
315670,201810,2441,1207,1234,1148693.32,1176159.26,2324852.58
315680,201810,854,579,275,549694.8,262350,812044.8
315690,201810,681,467,214,445397,204156,649553
315700,201810,1918,1013,905,961862.57,863275,1825137.57
315710,201810,335,92,243,87768,231822,319590
315720,201810,448,290,158,276660,150732,427392
315725,201810,203,162,41,154262,39114,193376
315727,201810,42,22,20,20988,19080,40068
315730,201810,49,47,2,44838,1908,46746
315733,201810,90,60,30,57240,28620,85860
315737,201810,50,39,11,37206,10494,47700
315740,201810,47,39,8,37206,7632,44838
315750,201810,157,121,36,115434,34344,149778
315760,201810,45,34,11,32436,10494,42930
315765,201810,124,79,45,75366,42930,118296
315770,201810,233,144,89,137376,84620,221996
315780,201810,3368,1746,1622,1658825.74,1545672.38,3204498.12
315790,201810,209,159,50,151686,47127.6,198813.6
315800,201810,292,213,79,203202,75366,278568
315810,201810,95,57,38,54378,35966,90344
315820,201810,801,581,220,551413.34,209880,761293.34
315830,201810,139,81,58,77274,55332,132606
315840,201810,93,65,28,62010,26712,88722
315850,201810,265,196,69,186984,65826,252810
315860,201810,13,5,8,4770,7632,12402
315870,201810,34,27,7,25758,6678,32436
315880,201810,109,70,39,66780,37206,103986
315890,201810,84,63,21,60102,20034,80136
315895,201810,473,322,151,306139,143337.95,449476.95
315900,201810,72,35,37,33104,35298,68402
315910,201810,39,25,14,23611.5,13356,36967.5
315920,201810,178,113,65,107802,61056.9,168858.9
315930,201810,45,16,29,15264,27666,42930
315935,201810,148,115,33,109710,31473,141183
315940,201810,92,69,23,65826,21942,87768
315950,201810,66,47,19,44838,18126,62964
315960,201810,554,261,293,247725.38,278663.6,526388.98
315970,201810,36,29,7,27666,6678,34344
315980,201810,700,329,371,312395.51,353934,666329.51
315990,201810,261,153,108,145724,102737,248461
316000,201810,51,34,17,32149.8,15931.8,48081.6
316010,201810,77,65,12,62010,11448,73458
316020,201810,114,94,20,89676,19080,108756
316030,201810,408,219,189,208354,179782,388136
316040,201810,515,216,299,205110.2,284960,490070.2
316045,201810,62,55,7,52470,6678,59148
316050,201810,16,14,2,13356,1908,15264
316060,201810,99,64,35,61056,33390,94446
316070,201810,1085,706,379,668202.3,360803,1029005.3
316080,201810,103,65,38,61723.8,36252,97975.8
316090,201810,41,25,16,23182.2,15264,38446.2
316095,201810,73,61,12,58194,11448,69642
316100,201810,317,185,132,175965.8,125928,301893.8
316105,201810,37,26,11,24804,10494,35298
316110,201810,1932,1557,375,1474646.35,357082.2,1831728.55
316120,201810,79,58,21,55332,19747.8,75079.8
316130,201810,137,105,32,98931,30528,129459
316140,201810,28,21,7,20034,6678,26712
316150,201810,210,146,64,138568.5,61056,199624.5
316160,201810,82,49,33,46746,31482,78228
316165,201810,68,50,18,47510,16456.5,63966.5
316170,201810,201,136,65,128790,62010,190800
316180,201810,202,87,115,82998,109424,192422
316190,201810,141,104,37,98262,35298,133560
316200,201810,700,392,308,373968,292973.4,666941.4
316210,201810,778,519,259,496713.41,247086,743799.41
316220,201810,114,78,36,74412,34344,108756
316225,201810,26,15,11,14310,10494,24804
316230,201810,31,19,12,18126,11448,29574
316240,201810,640,515,125,491310,119250,610560
316245,201810,111,92,19,87768,18126,105894
316250,201810,1521,1057,464,1001015.5,441473.12,1442488.62
316255,201810,118,95,23,90248.4,21927.69,112176.09
316257,201810,184,96,88,91584,83665.8,175249.8
316260,201810,245,161,84,152297.06,80041,232338.06
316265,201810,28,19,9,18126,8586,26712
316270,201810,680,475,205,450145.4,195570,645715.4
316280,201810,544,333,211,316411.8,200626.6,517038.4
316290,201810,708,467,241,443419.38,229914,673333.38
316292,201810,519,207,312,197191.8,297410,494601.8
316294,201810,102,59,43,56286,41022,97308
316295,201810,303,136,167,127819,159318,287137
316300,201810,102,72,30,68688,28620,97308
316310,201810,38,20,18,18793.8,17172,35965.8
316320,201810,43,26,17,24804,16218,41022
316330,201810,136,87,49,82044.5,46459.8,128504.3
316340,201810,145,99,46,94446,43884,138330
316350,201810,192,139,53,131986,50562,182548
316360,201810,25,18,7,17172,6678,23850
316370,201810,1080,578,502,546948.7,478612.26,1025560.96
316380,201810,125,96,29,91584,27666,119250
316390,201810,124,89,35,84906,33390,118296
316400,201810,139,105,34,100170,32436,132606
316410,201810,308,227,81,215174.7,77274,292448.7
316420,201810,207,147,60,139522.5,57240,196762.5
316430,201810,155,80,75,76320,71550,147870
316440,201810,96,46,50,43884,47700,91584
316443,201810,38,35,3,33390,2862,36252
316447,201810,67,51,16,48654,15264,63918
316450,201810,226,170,56,162180,53424,215604
316460,201810,74,31,43,29574,41022,70596
316470,201810,1650,1200,450,1136072.64,427178.79,1563251.43
316480,201810,12,10,2,9540,1908,11448
316490,201810,18,7,11,6678,10494,17172
316500,201810,153,102,51,97021.8,48654,145675.8
316510,201810,163,124,39,117294.3,37206,154500.3
316520,201810,194,120,74,114480,70596,185076
316530,201810,163,115,48,109710,45792,155502
316540,201810,141,80,61,76320,58194,134514
316550,201810,135,96,39,91584,37206,128790
316553,201810,252,121,131,115434,124974,240408
316555,201810,33,26,7,24000,6678,30678
316556,201810,11,8,3,7632,2862,10494
316557,201810,17,13,4,12402,3816,16218
316560,201810,65,51,14,48654,13356,62010
316570,201810,244,221,23,210214,21942,232156
316580,201810,21,16,5,15264,4770,20034
316590,201810,115,99,16,94446,15264,109710
316600,201810,178,145,33,137567,31482,169049
316610,201810,67,47,20,44551.8,19080,63631.8
316620,201810,136,105,31,100170,29574,129744
316630,201810,45,34,11,32436,10494,42930
316640,201810,16,10,6,9540,5724,15264
316650,201810,71,55,16,52470,15264,67734
316660,201810,9,4,5,3363,4770,8133
316670,201810,444,157,287,149759,273225.8,422984.8
316680,201810,163,114,49,108756,46556,155312
316690,201810,190,123,67,117342,63918,181260
316695,201810,63,55,8,52470,7632,60102
316700,201810,15,8,7,7632,6678,14310
316710,201810,747,548,199,520837,189846,710683
316720,201810,4982,2530,2452,2402207.83,2334311.23,4736519.06
316730,201810,15,14,1,13356,954,14310
316740,201810,126,81,45,77274,42930,120204
316750,201810,21,14,7,13356,6678,20034
316760,201810,323,261,62,248994,59148,308142
316770,201810,139,76,63,72504,60102,132606
316780,201810,77,48,29,45486.72,27666,73152.72
316790,201810,56,43,13,41022,12402,53424
316800,201810,1793,1105,688,1053120.8,655876,1708996.8
316805,201810,18,10,8,9540,7632,17172
316810,201810,71,47,24,44838,22896,67734
316820,201810,41,19,22,18126,20988,39114
316830,201810,95,43,52,41022,49608,90630
316840,201810,510,305,205,290684,195570,486254
316850,201810,346,227,119,215890.2,113526,329416.2
316860,201810,6017,2682,3335,2544469.65,3176139.17,5720608.82
316870,201810,1476,963,513,909833.1,483966.2,1393799.3
316880,201810,125,66,59,62677.8,56286,118963.8
316890,201810,250,168,82,160272,78228,238500
316900,201810,422,290,132,274113.28,125928,400041.28
316905,201810,18,8,10,7632,9540,17172
316910,201810,53,25,28,23850,26712,50562
316920,201810,136,106,30,100409,28620,129029
316930,201810,1916,978,938,929339.5,892658.7,1821998.2
316935,201810,886,543,343,516114.72,325982,842096.72
316940,201810,1113,645,468,614376.4,445890.26,1060266.66
316950,201810,184,94,90,89676,85860,175536
316960,201810,1118,624,494,593960.8,470980.46,1064941.26
316970,201810,655,513,142,489202,135468,624670
316980,201810,112,67,45,63918,42920.46,106838.46
316990,201810,2209,1458,751,1383921.78,713250.56,2097172.34
317000,201810,335,258,77,246132,73458,319590
317005,201810,253,180,73,171720,69642,241362
317010,201810,6447,3582,2865,3397743.73,2731970,6129713.73
317020,201810,16485,7339,9146,6968924.23,8709562.71,15678486.94
317030,201810,79,30,49,28620,46529.26,75149.26
317040,201810,3125,1959,1166,1864597.03,1109598.61,2974195.64
317043,201810,82,59,23,56286,21942,78228
317047,201810,36,18,18,17172,17168,34340
317050,201810,181,137,44,130698,41976,172674
317052,201810,132,100,32,95400,30528,125928
317057,201810,193,145,48,138330,45220,183550
317060,201810,58,39,19,37206,17839.8,55045.8
317065,201810,59,47,12,44838,11448,56286
317070,201810,2007,949,1058,900577.7,1007901.4,1908479.1
317075,201810,109,57,52,54378,49608,103986
317080,201810,854,444,410,421858.8,390950,812808.8
317090,201810,639,511,128,485157.5,122112,607269.5
317100,201810,433,326,107,309096,102078,411174
317103,201810,111,95,16,90630,15264,105894
317107,201810,39,34,5,32436,4770,37206
317110,201810,107,46,61,43884,58194,102078
317115,201810,43,37,6,35298,5724,41022
317120,201810,1872,951,921,898395.82,878177,1776572.82
317130,201810,1961,1272,689,1208297.8,656639,1864936.8
317140,201810,11,9,2,8586,1908,10494
317150,201810,268,158,110,150446,104176.8,254622.8
317160,201810,313,227,86,216241,82044,298285
317170,201810,209,141,68,134514,64872,199386
317180,201810,438,320,118,304564.5,112572,417136.5
317190,201810,256,176,80,167904,76033.8,243937.8
317200,201810,819,577,242,537398.2,230630,768028.2
317210,201810,156,88,68,82998.2,64872,147870.2
317220,201810,20,13,7,12402,6678,19080
320010,201810,631,471,160,445709.5,152640,598349.5
320013,201810,135,100,35,95400,33390,128790
320016,201810,283,177,106,168858,101124,269982
320020,201810,743,445,298,420931.55,282384.32,703315.87
320030,201810,153,112,41,106848,38780.1,145628.1
320035,201810,144,107,37,102078,35298,137376
320040,201810,511,262,249,249089.8,236973.8,486063.6
320050,201810,118,88,30,83952,28620,112572
320060,201810,1602,758,844,722989.6,804490.06,1527479.66
320070,201810,106,70,36,66159.9,34344,100503.9
320080,201810,783,446,337,422653,321498,744151
320090,201810,1239,872,367,828534.86,348449.6,1176984.46
320100,201810,332,193,139,184122,132606,316728
320110,201810,132,87,45,81138.2,42644,123782.2
320115,201810,112,92,20,87768,19080,106848
320120,201810,3373,1887,1486,1790184.4,1413706.34,3203890.74
320130,201810,7561,3582,3979,3396262.57,3787988.95,7184251.52
320140,201810,425,279,146,265499,139040,404539
320150,201810,1982,1153,829,1093602.8,790570.26,1884173.06
320160,201810,680,307,373,290388.83,354440.79,644829.62
320170,201810,117,92,25,87005,23850,110855
320180,201810,52,30,22,28620,20988,49608
320190,201810,241,161,80,153584.46,76034,229618.46
320200,201810,58,46,12,43884,11448,55332
320210,201810,867,486,381,462118.6,362502,824620.6
320220,201810,317,118,199,112572,189560,302132
320225,201810,85,70,15,66780,14310,81090
320230,201810,583,380,203,360994.4,192852,553846.4
320240,201810,3186,1600,1586,1523062.8,1511044.78,3034107.58
320245,201810,474,327,147,310617.68,140238,450855.68
320250,201810,238,125,113,118296.6,107802,226098.6
320255,201810,145,114,31,107449.02,29431,136880.02
320260,201810,182,130,52,124020,49560.3,173580.3
320265,201810,165,131,34,124164,32436,156600
320270,201810,154,125,29,119250,27666,146916
320280,201810,996,595,401,562670.2,382554,945224.2
320290,201810,67,56,11,53424,10494,63918
320300,201810,554,392,162,371507.8,153499.1,525006.9
320305,201810,673,368,305,351072,290780,641852
320310,201810,221,124,97,115673.7,91782,207455.7
320313,201810,317,163,154,155502,146630,302132
320316,201810,109,89,20,84906,19080,103986
320320,201810,3404,1551,1853,1473970,1764891.8,3238861.8
320330,201810,261,196,65,186321.3,60102.8,246424.1
320332,201810,891,540,351,513303.6,333805.3,847108.9
320334,201810,246,154,92,146630,87768,234398
320335,201810,144,102,42,96354.4,40068,136422.4
320340,201810,592,412,180,391284,171053,562337
320350,201810,986,425,561,403249.67,533496.48,936746.15
320360,201810,170,92,78,87768,74412,162180
320370,201810,246,189,57,178614,53345,231959
320380,201810,294,201,93,190085.3,88722,278807.3
320390,201810,1151,707,444,671579.8,422956.13,1094535.93
320400,201810,319,231,88,218944.2,83952,302896.2
320405,201810,916,394,522,375299.6,497675.92,872975.52
320410,201810,983,504,479,479147.4,456633,935780.4
320420,201810,485,248,237,236115.4,226098,462213.4
320425,201810,200,108,92,103032,87768,190800
320430,201810,400,228,172,215890.7,164088,379978.7
320435,201810,173,117,56,110797.56,53424,164221.56
320440,201810,204,121,83,115434,79182,194616
320450,201810,132,77,55,73458,52470,125928
320455,201810,253,209,44,198433,41976,240409
320460,201810,248,154,94,146916,88817.6,235733.6
320465,201810,114,77,37,73458,35298,108756
320470,201810,662,423,239,402303.74,228002,630305.74
320480,201810,182,121,61,114623.1,58194,172817.1
320490,201810,3072,1528,1544,1455470.98,1470538.84,2926009.82
320495,201810,98,60,38,57221,35680,92901
320500,201810,9595,4829,4766,4577465.73,4533899.81,9111365.54
320501,201810,544,273,271,260442,258534,518976
320503,201810,291,207,84,196524.2,80136,276660.2
320506,201810,261,195,66,186030,62964,248994
320510,201810,938,446,492,422456.3,467842.1,890298.4
320515,201810,81,68,13,63918.9,12402,76320.9
320517,201810,211,150,61,143100,58194,201294
320520,201810,7024,3119,3905,2960946.15,3717583.66,6678529.81
320530,201810,5494,2762,2732,2625890.86,2600594.44,5226485.30
330010,201810,3158,1635,1523,1552472.6,1448989.71,3001462.31
330015,201810,155,64,91,59912.08,86814,146726.08
330020,201810,3650,1609,2041,1531439.72,1946542,3477981.72
330022,201810,243,134,109,127121,103032.8,230153.8
330023,201810,547,189,358,179256.6,341532,520788.6
330025,201810,602,122,480,116388,457633.8,574021.8
330030,201810,1992,1291,701,1223273.18,665485.68,1888758.86
330040,201810,2442,1264,1178,1202782.2,1121669.3,2324451.5
330045,201810,8510,2724,5786,2590568.82,5513268.57,8103837.39
330050,201810,861,550,311,524700,296694,821394
330060,201810,933,581,352,550329.62,334491.48,884821.10
330070,201810,3474,1337,2137,1268873.47,2037383.56,3306257.03
330080,201810,1486,699,787,660700.44,749271.6,1409972.04
330090,201810,365,212,153,202057.2,145962,348019.2
330093,201810,287,131,156,124974,148779,273753
330095,201810,100,53,47,49894.2,44838,94732.2
330100,201810,9615,4968,4647,4727753.13,4430088.54,9157841.67
330110,201810,506,220,286,207495.1,272844,480339.1
330115,201810,567,311,256,296694,244224,540918
330120,201810,379,193,186,182977.2,176490.8,359468.0
330130,201810,1549,416,1133,396138.96,1080864,1477002.96
330140,201810,599,315,284,300483,269983,570466
330150,201810,466,274,192,259488,182022.63,441510.63
330160,201810,209,131,78,124974,74412,199386
330170,201810,27284,9589,17695,9124151.46,16868764.81,25992916.27
330180,201810,242,154,88,144369.02,83236.5,227605.52
330185,201810,870,334,536,317100.6,509781.6,826882.2
330187,201810,324,99,225,94446,214650,309096
330190,201810,5631,2268,3363,2153832.3,3205292.68,5359124.98
330200,201810,4678,1506,3172,1432051.26,3021025.76,4453077.02
330205,201810,416,248,168,236448.9,159986,396434.9
330210,201810,1026,635,391,597945.14,371344.9,969290.04
330220,201810,2604,1565,1039,1488055.17,990252.2,2478307.37
330225,201810,576,310,266,295101,253096.2,548197.2
330227,201810,2428,768,1660,729514.46,1583109.23,2312623.69
330230,201810,215,126,89,119537,84906,204443
330240,201810,3715,1966,1749,1869606.78,1665410.05,3535016.83
330245,201810,153,68,85,64758,81090,145848
330250,201810,6640,3425,3215,3256627.7,3058633.32,6315261.02
330260,201810,567,163,404,155502,385416,540918
330270,201810,3481,1263,2218,1204045,2115115.8,3319160.8
330280,201810,468,302,166,286316.08,158355,444671.08
330285,201810,7242,2371,4871,2257244.2,4644236.04,6901480.24
330290,201810,578,218,360,207972,343440,551412
330300,201810,794,527,267,498942.7,254691,753633.7
330310,201810,440,244,196,230868.7,186984,417852.7
330320,201810,8421,3210,5211,3054378.1,4965499.84,8019877.94
330330,201810,9176,3636,5540,3460190,5281515.56,8741705.56
330340,201810,2680,1596,1084,1519713.26,1034116.92,2553830.18
330350,201810,18258,7229,11029,6865715.59,10502251.79,17367967.38
330360,201810,2436,1217,1219,1160045.2,1162917,2322962.2
330370,201810,1049,563,486,536148,461593.9,997741.9
330380,201810,852,366,486,348438.96,463121,811559.96
330385,201810,610,315,295,299557,281430,580987
330390,201810,5300,2919,2381,2768037.27,2268531,5036568.27
330395,201810,286,178,108,168858.3,101267.2,270125.5
330400,201810,715,382,333,360994.6,315687.88,676682.48
330410,201810,506,360,146,340531.8,138794.33,479326.13
330411,201810,234,131,103,124793,98214.3,223007.3
330412,201810,253,103,150,97212.8,143100,240312.8
330414,201810,6065,2498,3567,2379382.78,3399818.1,5779200.88
330415,201810,593,274,319,260414.34,303372.8,563787.14
330420,201810,2280,1191,1089,1131770.98,1036799,2168569.98
330430,201810,1801,852,949,810615.2,903343.8,1713959.0
330440,201810,275,129,146,123066,139284,262350
330450,201810,121,53,68,50562,64872,115434
330452,201810,1805,859,946,818019.8,902170.34,1720190.14
330455,201810,111237,40076,71161,38150684.13,67829343.06,105980027.19
330460,201810,261,110,151,104940,144027,248967
330470,201810,1245,679,566,642426.78,539668.46,1182095.24
330475,201810,1413,378,1035,359658.8,985700.95,1345359.75
330480,201810,795,421,374,400966.2,355843,756809.2
330490,201810,13897,4832,9065,4603599.27,8642510.64,13246109.91
330500,201810,1338,605,733,577026.9,699025,1276051.9
330510,201810,11275,3870,7405,3683806.28,7059537.84,10743344.12
330513,201810,104,51,53,48654,50562,99216
330515,201810,842,346,496,324947.9,472803,797750.9
330520,201810,2577,957,1620,912759,1545050.9,2457809.9
330530,201810,221,117,104,111093.8,99026,210119.8
330540,201810,350,178,172,169812,163611,333423
330550,201810,3007,1083,1924,1030988.2,1833206.8,2864195.0
330555,201810,784,296,488,282365,464598.8,746963.8
330560,201810,609,210,399,200340,380619,580959
330570,201810,249,176,73,167904,69642,237546
330575,201810,795,335,460,319352,436785.5,756137.5
330580,201810,3451,1922,1529,1827399.14,1457187.7,3284586.84
330590,201810,319,157,162,149778,154548,304326
330600,201810,1112,718,394,682835.24,374178.84,1057014.08
330610,201810,1556,859,697,812619.74,661743.9,1474363.64
330615,201810,193,143,50,135563.4,47700,183263.4
330620,201810,1067,443,624,420191.26,592625.6,1012816.86
330630,201810,4019,2547,1472,2414850.47,1397040.8,3811891.27
350010,201810,597,396,201,376592.47,191754,568346.47
350020,201810,42,20,22,19080,20988,40068
350030,201810,531,342,189,325124,179116.66,504240.66
350040,201810,129,51,78,48310.56,74412,122722.56
350050,201810,295,161,134,153594,127817.46,281411.46
350055,201810,87,49,38,46746,36252,82998
350060,201810,72,26,46,24804,43884,68688
350070,201810,822,487,335,459460.14,317947.56,777407.70
350075,201810,69,48,21,45792,20034,65826
350080,201810,51,32,19,29891.96,17172,47063.96
350090,201810,92,51,41,48654,39109.23,87763.23
350100,201810,291,184,107,174820.5,102078,276898.5
350110,201810,56,36,20,34344,19080,53424
350115,201810,165,101,64,95686.2,61056,156742.2
350120,201810,108,73,35,69642,33390,103032
350130,201810,351,169,182,160940,173628,334568
350140,201810,36,22,14,20225,13356,33581
350150,201810,67,52,15,49608,14310,63918
350160,201810,2588,1013,1575,963047.93,1501482.68,2464530.61
350170,201810,414,256,158,242316.2,149682.8,391999.0
350180,201810,184,99,85,94446,81090,175536
350190,201810,1037,550,487,522698.64,464011.49,986710.13
350200,201810,68,24,44,22896,41711.08,64607.08
350210,201810,1348,759,589,717053.13,560752.66,1277805.79
350220,201810,679,582,97,551090.73,92538,643628.73
350230,201810,84,58,26,55332,24804,80136
350240,201810,60,45,15,42930,14310,57240
350250,201810,1242,618,624,582752.5,594591.66,1177344.16
350260,201810,91,65,26,62010,24804,86814
350270,201810,839,550,289,523336.38,274256.92,797593.30
350275,201810,311,128,183,121731,174582,296313
350280,201810,4742,2426,2316,2300631.04,2207473.99,4508105.03
350290,201810,420,203,217,193657.23,206445.8,400103.03
350300,201810,57,31,26,29574,24804,54378
350310,201810,100,67,33,63918,31482,95400
350315,201810,39,24,15,22896,14310,37206
350320,201810,3316,1655,1661,1573720.6,1583822.8,3157543.4
350330,201810,1692,905,787,860957.96,749622.04,1610580.00
350335,201810,21,14,7,13356,6678,20034
350340,201810,134,63,71,60102,67401,127503
350350,201810,95,49,46,46746,43884,90630
350360,201810,129,84,45,80132,42930,123062
350370,201810,90,54,36,50562.96,34334.46,84897.42
350380,201810,779,336,443,319590.2,421858.8,741449.0
350390,201810,1476,598,878,569691.58,836467.4,1406158.98
350395,201810,25,20,5,19080,4770,23850
350400,201810,1667,884,783,833410.43,744384.16,1577794.59
350410,201810,2296,1021,1275,970944.96,1215699.03,2186643.99
350420,201810,238,147,91,139635,86814,226449
350430,201810,73,43,30,40450,28620,69070
350440,201810,149,111,38,104892.5,36252,141144.5
350450,201810,1626,999,627,946880.95,598063,1544943.95
350460,201810,332,122,210,116388,200053.8,316441.8
350470,201810,16,10,6,9540,5724,15264
350480,201810,167,90,77,85860,73458,159318
350490,201810,238,120,118,113526.8,112572,226098.8
350500,201810,41,20,21,19080,20034,39114
350510,201810,165,111,54,105894,51516,157410
350520,201810,455,219,236,205889.06,224507.96,430397.02
350530,201810,446,212,234,202248,223236,425484
350535,201810,72,56,16,53166.42,15264,68430.42
350540,201810,380,194,186,185076,177157.8,362233.8
350550,201810,2745,1620,1125,1538186.76,1070806.67,2608993.43
350560,201810,651,455,196,434065.23,186626.25,620691.48
350570,201810,4167,1755,2412,1667560.18,2298541.2,3966101.38
350580,201810,380,182,198,172675,188878.46,361553.46
350590,201810,901,498,403,474806,383508,858314
350600,201810,6235,3142,3093,2981216.25,2945304.41,5926520.66
350610,201810,1548,793,755,751874,720261,1472135
350620,201810,36,24,12,22896,11448,34344
350630,201810,242,140,102,132606.96,96355,228961.96
350635,201810,908,369,539,351740,513559.21,865299.21
350640,201810,119,88,31,83952,29574,113526
350650,201810,1903,1248,655,1186397.03,623480.1,1809877.13
350660,201810,746,333,413,317038.05,393998,711036.05
350670,201810,316,159,157,151257.2,149778,301035.2
350680,201810,177,94,83,89676,79182,168858
350690,201810,203,104,99,99216,94446,193662
350700,201810,751,361,390,341059.94,372060,713119.94
350710,201810,346,133,213,125673.56,203202,328875.56
350715,201810,55,44,11,41976,10494,52470
350720,201810,17,11,6,10494,5724,16218
350730,201810,42,26,16,24804,15264,40068
350740,201810,213,117,96,111608.46,91584,203192.46
350745,201810,18,9,9,8562,8586,17148
350750,201810,2161,1379,782,1307597.1,745391.96,2052989.06
350760,201810,3757,1638,2119,1560315.83,2017732.42,3578048.25
350770,201810,59,41,18,39114,17172,56286
350775,201810,49,36,13,34344,12393,46737
350780,201810,423,214,209,204156,199369,403525
350790,201810,366,155,211,147870,201294,349164
350800,201810,447,254,193,242316,184122,426438
350810,201810,523,420,103,399727,98262,497989
350820,201810,92,56,36,53424,34344,87768
350830,201810,83,46,37,43884,35298,79182
350840,201810,771,336,435,320544,413168.8,733712.8
350850,201810,1812,1051,761,996169.64,725953.46,1722123.10
350860,201810,602,353,249,332929.8,237546,570475.8
350870,201810,436,296,140,282384,133273.8,415657.8
350880,201810,284,153,131,144007.6,124306.2,268313.8
350890,201810,42,26,16,24804,15264,40068
350900,201810,1475,473,1002,449775.93,955144.8,1404920.73
350910,201810,25,15,10,14310,9540,23850
350920,201810,618,341,277,324996.04,263208.6,588204.64
350925,201810,1208,646,562,613976.26,534431.4,1148407.66
350930,201810,98,60,38,57240,36252,93492
350940,201810,729,404,325,384175.8,308209.6,692385.4
350945,201810,106,78,28,73876,26712,100588
350950,201810,15844,7566,8278,7191744.93,7890736.94,15082481.87
350960,201810,1284,601,683,569722.16,651578,1221300.16
350970,201810,1116,588,528,558379.96,503416.46,1061796.42
350980,201810,93,64,29,61056,27666,88722
350990,201810,367,132,235,124974.72,224190,349164.72
350995,201810,33,16,17,15264,16218,31482
351000,201810,626,440,186,417536.07,177444,594980.07
351010,201810,49,30,19,28620,18126,46746
351015,201810,54,38,16,36252,15264,51516
351020,201810,1659,973,686,926818.45,652440.8,1579259.25
351030,201810,345,237,108,223236,103032,326268
351040,201810,859,458,401,436932,381600.66,818532.66
351050,201810,3342,1562,1780,1481581.58,1697744.3,3179325.88
351060,201810,5073,2087,2986,1979522.22,2845926.01,4825448.23
351070,201810,418,267,151,253450.96,144054,397504.96
351080,201810,796,574,222,547119,210834,757953
351090,201810,62,28,34,26712,32436,59148
351100,201810,451,264,187,249634.48,178393.23,428027.71
351110,201810,2107,1005,1102,952115.2,1048633.5,2000748.7
351120,201810,73,37,36,35298,34344,69642
351130,201810,175,59,116,56286,110377.8,166663.8
351140,201810,338,232,106,220087.84,101124,321211.84
351150,201810,422,223,199,211836.8,189846,401682.8
351160,201810,255,167,88,159032,83952,242984
351170,201810,189,101,88,96354,83189,179543
351190,201810,89,60,29,57240,27666,84906
351200,201810,370,243,127,231154.4,121158,352312.4
351210,201810,127,60,67,56985.38,63918,120903.38
351220,201810,537,327,210,308385.12,200340,508725.12
351230,201810,289,208,81,198432,77254.92,275686.92
351240,201810,234,101,133,96354,126882,223236
351250,201810,73,51,22,48430,20988,69418
351260,201810,151,111,40,105894,37874,143768
351270,201810,51,21,30,20034,28620,48654
351280,201810,1107,504,603,477956.46,574430.38,1052386.84
351290,201810,234,110,124,104940,118010,222950
351300,201810,3717,1752,1965,1664552.99,1874289,3538841.99
351310,201810,764,396,368,377784,350925,728709
351320,201810,111,67,44,63918,41976,105894
351330,201810,40,27,13,25758,12402,38160
351340,201810,1246,773,473,731458.93,449208.03,1180666.96
351350,201810,2565,1456,1109,1385806.2,1057404.06,2443210.26
351360,201810,785,392,393,373014,374604.04,747618.04
351370,201810,377,190,187,181255.23,177761.96,359017.19
351380,201810,8952,4062,4890,3860044.17,4654438.29,8514482.46
351385,201810,29,19,10,18126,9540,27666
351390,201810,284,211,73,201294,69642,270936
351400,201810,67,42,25,40068,23803.92,63871.92
351410,201810,448,280,168,266023.9,160272,426295.9
351420,201810,59,47,12,44838,11448,56286
351430,201810,71,39,32,37206,30528,67734
351440,201810,794,555,239,527275.76,228002,755277.76
351450,201810,263,132,131,125928,124974,250902
351460,201810,117,55,62,52470,59148,111618
351470,201810,137,72,65,67734,62010,129744
351480,201810,533,301,232,285914.96,221328,507242.96
351490,201810,289,105,184,100170,175536,275706
351492,201810,31,22,9,20988,8586,29574
351495,201810,26,18,8,17172,7632,24804
351500,201810,3574,1530,2044,1453066.33,1945536.41,3398602.74
351510,201810,1817,758,1059,722559.8,1008368.46,1730928.26
351512,201810,22,18,4,17172,3816,20988
351515,201810,197,114,83,108756,79182,187938
351518,201810,795,493,302,470318,288108,758426
351519,201810,74,48,26,45792,24804,70596
351520,201810,141,87,54,82361.96,51516,133877.96
351530,201810,23,15,8,14310,7632,21942
351535,201810,132,75,57,71550,54378,125928
351540,201810,459,330,129,312437,123066,435503
351550,201810,1337,809,528,767431.96,501794.86,1269226.82
351560,201810,73,40,33,38160,31463,69623
351565,201810,10,6,4,5724,3816,9540
351570,201810,2632,1362,1270,1297025.12,1210909.65,2507934.77
351580,201810,39,35,4,33390,3816,37206
351590,201810,69,46,23,43884,21942,65826
351600,201810,197,146,51,139284,48654,187938
351610,201810,60,29,31,27666,29574,57240
351620,201810,5931,3381,2550,3213020.07,2429338.53,5642358.60
351630,201810,2599,1346,1253,1279532.39,1192638.53,2472170.92
351640,201810,1699,825,874,785004.03,830738.8,1615742.83
351650,201810,35,30,5,28620,4770,33390
351660,201810,156,101,55,96354,52470,148824
351670,201810,721,440,281,417424,268074,685498
351680,201810,72,59,13,56286,12402,68688
351685,201810,36,22,14,20988,13356,34344
351690,201810,312,218,94,206107.28,89676,295783.28
351700,201810,159,112,47,106848,44838,151686
351710,201810,75,52,23,49608,21942,71550
351720,201810,127,61,66,58194,62964,121158
351730,201810,96,67,29,62964.96,27661.23,90626.19
351740,201810,728,486,242,461736.96,230863.23,692600.19
351750,201810,357,150,207,142464,197192,339656
351760,201810,789,607,182,579078,173628,752706
351770,201810,302,257,45,245178,42930,288108
351780,201810,167,96,71,91575,67734,159309
351790,201810,248,130,118,124020,112572,236592
351800,201810,50,32,18,30528,17172,47700
351810,201810,123,83,40,79182,38160,117342
351820,201810,868,626,242,591482.6,230577.23,822059.83
351830,201810,518,184,334,174772.8,318636,493408.8
351840,201810,1893,963,930,910520.4,885718.94,1796239.34
351850,201810,234,173,61,164422.8,58194,222616.8
351860,201810,744,506,238,475286.6,226766,702052.6
351870,201810,5646,2689,2957,2554845.84,2813214.94,5368060.78
351880,201810,18893,8232,10661,7832667.77,10156144.22,17988811.99
351885,201810,92,61,31,57479,29574,87053
351890,201810,68,56,12,53424,11448,64872
351900,201810,226,133,93,126215,88722,214937
351905,201810,81,33,48,31482,45792,77274
351907,201810,3202,1409,1793,1341317.06,1707615.6,3048932.66
351910,201810,180,74,106,70596,101124,171720
351920,201810,131,76,55,72504,52447.69,124951.69
351925,201810,88,60,28,57240,26712,83952
351930,201810,392,257,135,245082.6,128790,373872.6
351940,201810,239,107,132,102078,125928,228006
351950,201810,140,82,58,78228,55332,133560
351960,201810,889,418,471,398590.73,447521.6,846112.33
351970,201810,1935,1046,889,995737.84,847525,1843262.84
351980,201810,154,78,76,72504,72504,145008
351990,201810,273,182,91,172674,86012.64,258686.64
352000,201810,365,226,139,215318,132606,347924
352010,201810,375,232,143,221328,135945,357273
352020,201810,201,69,132,65826,125928,191754
352030,201810,1047,548,499,522076.5,475409.96,997486.46
352040,201810,580,250,330,238500,314820,553320
352042,201810,280,93,187,88722,177826,266548
352044,201810,378,223,155,212541.66,147870,360411.66
352050,201810,3319,1319,2000,1251539.18,1906464.26,3158003.44
352060,201810,106,67,39,63918,36920,100838
352070,201810,102,74,28,69326,26712,96038
352080,201810,69,43,26,40068,24804,64872
352090,201810,176,118,58,112572,55332,167904
352100,201810,269,128,141,121822,133362,255184
352110,201810,114,34,80,32436,76320,108756
352115,201810,70,27,43,25758,41022,66780
352120,201810,95,66,29,61724,27666,89390
352130,201810,223,186,37,177444,35298,212742
352140,201810,187,79,108,74889,102746,177635
352150,201810,119,66,53,62010.04,50562,112572.04
352160,201810,133,85,48,81090,45792,126882
352170,201810,372,258,114,245178.04,108756,353934.04
352180,201810,621,419,202,398105.5,192704,590809.5
352190,201810,265,103,162,98252.46,154509.84,252762.30
352200,201810,32,17,15,16218,14310,30528
352210,201810,3894,1634,2260,1550258.87,2149169.59,3699428.46
352215,201810,54,30,24,28620,22438.08,51058.08
352220,201810,7025,2731,4294,2600589.44,4094328.37,6694917.81
352230,201810,3288,2103,1185,1991809.33,1126026.45,3117835.78
352240,201810,2267,1308,959,1245638.69,912589.08,2158227.77
352250,201810,2621,1354,1267,1287057.16,1204475.56,2491532.72
352260,201810,1058,572,486,544157.23,463358,1007515.23
352265,201810,58,25,33,23850,31482,55332
352270,201810,419,242,177,229914.92,168802,398716.92
352280,201810,423,267,156,253447,148819.23,402266.23
352290,201810,174,109,65,103986,62010,165996
352300,201810,99,75,24,71550,22896,94446
352310,201810,5814,2818,2996,2675215.29,2852967.64,5528182.93
352320,201810,966,507,459,480183.84,435835.1,916018.94
352330,201810,525,249,276,237212.1,263018,500230.1
352340,201810,1397,688,709,653433,673382.5,1326815.5
352350,201810,338,210,128,200340,121826,322166
352360,201810,232,97,135,91631.7,126193.52,217825.22
352370,201810,103,69,34,65826,32436,98262
352380,201810,119,71,48,67734,45792,113526
352390,201810,2488,1132,1356,1075617.32,1290936.36,2366553.68
352400,201810,479,206,273,196524,259869.6,456393.6
352410,201810,795,570,225,539939.76,214650,754589.76
352420,201810,107,70,37,66780,35298,102078
352430,201810,1774,792,982,750515.84,934546.3,1685062.14
352440,201810,3187,1621,1566,1535927.48,1492016.67,3027944.15
352450,201810,194,162,32,154548,30528,185076
352460,201810,596,302,294,287550.68,279761.2,567311.88
352470,201810,639,223,416,212742,396855,609597
352480,201810,1368,769,599,731717.96,571160,1302877.96
352490,201810,84,31,53,29574,50562,80136
352500,201810,1211,542,669,515542.6,637741,1153283.6
352510,201810,758,415,343,394956.96,327222,722178.96
352520,201810,582,260,322,248040,307044.9,555084.9
352530,201810,1717,899,818,857646,779990.6,1637636.6
352540,201810,74,49,25,46746,23850,70596
352550,201810,185,107,78,102078,73744.2,175822.2
352560,201810,51,41,10,39114,9540,48654
352570,201810,671,350,321,333583,306214.92,639797.92
352580,201810,61,42,19,39114.65,18126,57240.65
352585,201810,17,6,11,5724,10494,16218
352590,201810,4416,2251,2165,2140531.11,2062487.43,4203018.54
352600,201810,352,245,107,232538.46,102078,334616.46
352610,201810,956,430,526,408245.33,501804,910049.33
352620,201810,968,400,568,380646.2,541236,921882.2
352630,201810,168,64,104,61056,99206.46,160262.46
352640,201810,560,390,170,370048.02,162180,532228.02
352650,201810,89,59,30,56286,28620,84906
352660,201810,81,47,34,44838,32436,77274
352670,201810,1689,913,776,868471.89,739201.06,1607672.95
352680,201810,906,582,324,550470.26,307634.04,858104.30
352690,201810,4488,2080,2408,1976063.8,2294849,4270912.8
352700,201810,115,71,44,67447.8,41976,109423.8
352710,201810,1338,711,627,677053.8,595483.6,1272537.4
352720,201810,1355,650,705,617842.2,671993.03,1289835.23
352725,201810,25,23,2,21942,1908,23850
352730,201810,378,191,187,181035.81,178398,359433.81
352740,201810,424,272,152,257533.68,145008,402541.68
352750,201810,24,16,8,14977.8,7632,22609.8
352760,201810,195,138,57,131652,54378,186030
352770,201810,82,65,17,62010,16218,78228
352780,201810,80,44,36,41976,34344,76320
352790,201810,32,26,6,24804,5724,30528
352800,201810,249,174,75,165996,71263.8,237259.8
352810,201810,170,111,59,103383.42,56286,159669.42
352820,201810,62,49,13,46320.52,12402,58722.52
352830,201810,92,63,29,60102,27666,87768
352840,201810,640,333,307,316776.2,292878,609654.2
352850,201810,1385,488,897,464884.2,855356.4,1320240.6
352860,201810,134,88,46,83316,43884,127200
352870,201810,45,28,17,26712,16218,42930
352880,201810,191,128,63,122092.92,60102,182194.92
352885,201810,29,21,8,20034,7632,27666
352890,201810,58,41,17,39114,15932,55046
352900,201810,4854,2343,2511,2217197.03,2387757.17,4604954.20
352910,201810,39,32,7,30528,6678,37206
352920,201810,693,426,267,405450,254718,660168
352930,201810,1248,608,640,577932.82,607599.18,1185532.00
352940,201810,6477,2755,3722,2617791.88,3547446.17,6165238.05
352950,201810,95,39,56,37206,53424,90630
352960,201810,63,42,21,40068,20034,60102
352965,201810,19,8,11,7632,10494,18126
352970,201810,489,373,116,352547.15,109711,462258.15
352980,201810,178,95,83,90630,78896,169526
352990,201810,984,433,551,412099.38,524586.2,936685.58
353000,201810,70,33,37,31482,35298,66780
353010,201810,557,344,213,328176,203182.92,531358.92
353020,201810,285,208,77,198432,73458,271890
353030,201810,1239,565,674,537224.17,642309.66,1179533.83
353040,201810,92,56,36,53424,34344,87768
353050,201810,1343,859,484,814136.02,461449.8,1275585.82
353060,201810,8189,3686,4503,3500580.01,4289619.07,7790199.08
353070,201810,1680,1071,609,1015783.46,579525.56,1595309.02
353080,201810,1336,715,621,680059.55,591476,1271535.55
353090,201810,57,33,24,31482,22896,54378
353100,201810,62,50,12,47700,11448,59148
353110,201810,2058,632,1426,601197.54,1357486.23,1958683.77
353120,201810,83,45,38,42930,36252,79182
353130,201810,870,433,437,410987.09,416776.14,827763.23
353140,201810,577,230,347,219359,331038,550397
353150,201810,357,203,154,192708,146906.46,339614.46
353160,201810,101,82,19,78228,18126,96354
353170,201810,195,64,131,61056,124946.46,186002.46
353180,201810,968,450,518,427006.49,493495,920501.49
353190,201810,498,359,139,341532.9,132320,473852.9
353200,201810,205,108,97,102365,92538,194903
353205,201810,27,20,7,19080,6678,25758
353210,201810,85,52,33,49608,31482,81090
353215,201810,54,31,23,29574,21942,51516
353220,201810,82,47,35,44838,33390,78228
353230,201810,156,63,93,60102,88722,148824
353240,201810,302,165,137,157410,130698,288108
353250,201810,203,107,96,102078,91584,193662
353260,201810,471,335,136,318446.5,129734.46,448180.96
353270,201810,67,49,18,46746,16504.2,63250.2
353280,201810,97,52,45,49418,42930,92348
353282,201810,125,88,37,83952,35298,119250
353284,201810,25,20,5,19080,4770,23850
353286,201810,0,0,0,0,0,0
353290,201810,80,45,35,42930,33381,76311
353300,201810,417,234,183,219911.42,174582,394493.42
353310,201810,52,45,7,42930,6678,49608
353320,201810,63,39,24,37206,22896,60102
353325,201810,57,34,23,32427,21638,54065
353330,201810,67,49,18,46603,17172,63775
353340,201810,627,209,418,198703.89,398191.03,596894.92
353350,201810,910,428,482,407331.18,458857,866188.18
353360,201810,108,87,21,82998,19748,102746
353370,201810,123,69,54,65826,51516,117342
353380,201810,29,20,9,19076,8586,27662
353390,201810,1112,531,581,506574,554274,1060848
353400,201810,49,31,18,29574,17172,46746
353410,201810,112,71,41,67734,39067,106801
353420,201810,60,25,35,23850,33390,57240
353430,201810,570,380,190,358958.59,180973.8,539932.39
353440,201810,10339,4520,5819,4300453.61,5544271.41,9844725.02
353450,201810,55,31,24,29574,22896,52470
353460,201810,610,339,271,321190.83,257818.5,579009.33
353470,201810,2128,1153,975,1096014.62,927458.03,2023472.65
353475,201810,238,158,80,148846.96,76320,225166.96
353480,201810,188,153,35,145962,33390,179352
353490,201810,237,141,96,134514,91584,226098
353500,201810,192,111,81,104940.96,77274,182214.96
353510,201810,100,73,27,69623.46,25748.46,95371.92
353520,201810,202,138,64,131652,61056,192708
353530,201810,469,250,219,238500,208926,447426
353540,201810,367,245,122,233407.27,116388,349795.27
353550,201810,733,493,240,466508.62,228960,695468.62
353560,201810,626,266,360,252198.69,342839.52,595038.21
353570,201810,62,32,30,30528,28620,59148
353580,201810,352,273,79,259965,75366,335331
353590,201810,87,60,27,56922.04,25758,82680.04
353600,201810,269,151,118,143737,111936,255673
353610,201810,116,62,54,58830.04,51516,110346.04
353620,201810,586,311,275,296694,262063.8,558757.8
353625,201810,50,30,20,28620,19080,47700
353630,201810,245,175,70,164527.36,66780,231307.36
353640,201810,126,85,41,80613,39114,119727
353650,201810,903,354,549,336094.2,523746,859840.2
353657,201810,23,18,5,17172,4770,21942
353660,201810,257,142,115,135468,109710,245178
353670,201810,776,463,313,440748.2,298602,739350.2
353680,201810,103,72,31,68450,29574,98024
353690,201810,44,35,9,33116,8586,41702
353700,201810,279,198,81,188892,77274,266166
353710,201810,456,216,240,205110.8,228674,433784.8
353715,201810,47,34,13,32149.8,12402,44551.8
353720,201810,354,164,190,156447,181260,337707
353730,201810,1104,678,426,644856.9,405445.23,1050302.13
353740,201810,654,359,295,342199.8,281430,623629.8
353750,201810,91,58,33,54800.14,31482,86282.14
353760,201810,2794,1059,1735,1008227.88,1651401.28,2659629.16
353770,201810,97,80,17,75843,16218,92061
353780,201810,1208,590,618,560510.94,587187,1147697.94
353790,201810,513,297,216,281269.5,203465.35,484734.85
353800,201810,3284,1674,1610,1588287.01,1534428.96,3122715.97
353810,201810,231,133,98,126009.63,93483,219492.63
353820,201810,198,96,102,91584,96683.41,188267.41
353830,201810,47,40,7,38160,6678,44838
353850,201810,168,88,80,83952,76320,160272
353860,201810,489,218,271,207256.5,258152.4,465408.9
353870,201810,5243,2633,2610,2496410.73,2480428.33,4976839.06
353880,201810,688,493,195,468986.4,186030,655016.4
353890,201810,588,330,258,314486.3,245846,560332.3
353900,201810,137,68,69,64872,65826,130698
353910,201810,174,84,90,80136,85860,165996
353920,201810,451,248,203,235400.4,193219.16,428619.56
353930,201810,1031,611,420,581201.79,399908.48,981110.27
353940,201810,183,98,85,93492,80232,173724
353950,201810,526,322,204,306202.8,194607,500809.8
353960,201810,70,57,13,54378,12402,66780
353970,201810,75,43,32,41022,30528,71550
353980,201810,1555,761,794,723620.95,756537.76,1480158.71
353990,201810,75,42,33,40068,31482,71550
354000,201810,368,181,187,172007,178203.2,350210.2
354010,201810,93,52,41,49608,38637,88245
354020,201810,546,352,194,334854,185076,519930
354025,201810,51,40,11,38160,10494,48654
354030,201810,66,38,28,36252,26712,62964
354040,201810,95,67,28,63536.4,26712,90248.4
354050,201810,195,105,90,99884,85860,185744
354060,201810,755,363,392,346302,371727.4,718029.4
354070,201810,889,524,365,498265.03,348210,846475.03
354075,201810,218,115,103,109424,97308.8,206732.8
354080,201810,300,130,170,123733.8,162180,285913.8
354085,201810,18,11,7,10494,6678,17172
354090,201810,316,175,141,166869,134514,301383
354100,201810,5659,2407,3252,2284924.46,3096137.75,5381062.21
354105,201810,89,43,46,41022,43884,84906
354110,201810,49,22,27,20988,25758,46746
354120,201810,141,99,42,94306.97,40068,134374.97
354130,201810,706,472,234,450288,222946,673234
354140,201810,3161,1469,1692,1398860.81,1612823.63,3011684.44
354150,201810,656,410,246,388641.04,233253,621894.04
354160,201810,727,463,264,440509.5,251570,692079.5
354165,201810,23,14,9,13356,8586,21942
354170,201810,181,122,59,115720.2,56286,172006.2
354180,201810,67,42,25,39742,23850,63592
354190,201810,210,96,114,89962.2,108756,198718.2
354200,201810,130,71,59,67257,56286,123543
354210,201810,70,33,37,31482,35298,66780
354220,201810,633,394,239,375876,226766.35,602642.35
354230,201810,162,67,95,63918,89676.6,153594.6
354240,201810,318,207,111,196524.49,105894,302418.49
354250,201810,89,54,35,51516,33390,84906
354260,201810,2006,940,1066,885731.84,1014384.67,1900116.51
354270,201810,96,71,25,67734,23850,91584
354280,201810,45,23,22,21942,20988,42930
354290,201810,144,100,44,94589.1,41976,136565.1
354300,201810,418,285,133,271573,126724,398297
354310,201810,102,75,27,70596.2,25758,96354.2
354320,201810,186,100,86,95400,82044,177444
354323,201810,15,14,1,13356,954,14310
354325,201810,110,64,46,60250,43884,104134
354330,201810,2647,884,1763,838415.26,1679635.81,2518051.07
354340,201810,10627,5239,5388,4986617.83,5133502.93,10120120.76
354350,201810,126,82,44,78228,41832.9,120060.9
354360,201810,90,50,40,47700,38160,85860
354370,201810,265,148,117,141192,111618,252810
354380,201810,209,123,86,116556,82044,198600
354390,201810,2784,1010,1774,960394.16,1690639.21,2651033.37
354400,201810,328,172,156,164088,148252,312340
354410,201810,618,295,323,279804.43,307188.2,586992.63
354420,201810,279,176,103,167904,98262,266166
354425,201810,310,183,127,174582,121158,295740
354430,201810,188,118,70,111951.9,66016.8,177968.7
354440,201810,36,26,10,24804,9540,34344
354450,201810,50,36,14,34344,13356,47700
354460,201810,104,60,44,57240,41976,99216
354470,201810,41,27,14,25758,13356,39114
354480,201810,114,57,57,54369,54368.46,108737.46
354490,201810,141,88,53,83792.97,50562,134354.97
354500,201810,394,196,198,186984,188892,375876
354510,201810,104,73,31,69642,29574,99216
354515,201810,38,14,24,13356,22896,36252
354520,201810,1630,710,920,676059.4,877241.56,1553300.96
354530,201810,678,355,323,336948.8,307284.2,644233.0
354540,201810,280,157,123,149778,117337.23,267115.23
354550,201810,44,27,17,25758,16218,41976
354560,201810,158,89,69,84620,65816.46,150436.46
354570,201810,133,88,45,82759,42930,125689
354580,201810,1974,943,1031,896408.96,982988.26,1879397.22
354600,201810,263,148,115,138978.92,109695.69,248674.61
354610,201810,73,64,9,60103,8577,68680
354620,201810,60,18,42,17172,40063.23,57235.23
354625,201810,19,12,7,11448,6674,18122
354630,201810,322,216,106,205737.04,101124,306861.04
354640,201810,804,523,281,494730.16,268074,762804.16
354650,201810,77,44,33,41967,31453.92,73420.92
354660,201810,812,603,209,571240.46,199386,770626.46
354670,201810,271,95,176,89994,166951,256945
354680,201810,1277,482,795,459828,757953,1217781
354690,201810,84,55,29,51517,27666,79183
354700,201810,74,53,21,50562,20034,70596
354710,201810,59,41,18,38477.96,17172,55649.96
354720,201810,20,19,1,18126,954,19080
354730,201810,1849,790,1059,751457.7,1010095.2,1761552.9
354740,201810,62,43,19,41022,18126,59148
354750,201810,432,257,175,245169,166950,412119
354760,201810,512,314,198,296995,188606,485601
354765,201810,11,5,6,4770,5724,10494
354770,201810,348,226,122,214780.03,116388,331168.03
354780,201810,8183,3338,4845,3172158.21,4618298.72,7790456.93
354790,201810,111,64,47,61056,44838,105894
354800,201810,439,239,200,228006,190494.92,418500.92
354805,201810,104,51,53,48018,50562,98580
354810,201810,132,76,56,72504,53424,125928
354820,201810,188,80,108,76111,103032,179143
354830,201810,41,23,18,21942,17172,39114
354840,201810,60,41,19,39114,18126,57240
354850,201810,4644,2084,2560,1981159.59,2438425.77,4419585.36
354860,201810,330,160,170,152640,160072.52,312712.52
354870,201810,12235,5521,6714,5238762.37,6395766.48,11634528.85
354880,201810,3093,1164,1929,1108532.26,1838952.83,2947485.09
354890,201810,2922,1617,1305,1536419.63,1243987.38,2780407.01
354900,201810,58,38,20,36252,19080,55332
354910,201810,1254,657,597,623210.24,569538,1192748.24
354920,201810,50,42,8,40068,7632,47700
354925,201810,14,8,6,7632,5724,13356
354930,201810,31,28,3,26442,2862,29304
354940,201810,826,611,215,580225.69,205110,785335.69
354950,201810,217,144,73,136709,69642,206351
354960,201810,162,63,99,60102,94160,154262
354970,201810,896,594,302,561816.14,287469.02,849285.16
354980,201810,8536,3152,5384,2997852.05,5133635.87,8131487.92
354990,201810,9083,4316,4767,4102968.61,4541237.3,8644205.91
354995,201810,531,185,346,176490,330084,506574
355000,201810,488,169,319,161221.23,304087.5,465308.73
355010,201810,619,390,229,372060,216254.48,588314.48
355020,201810,738,463,275,440743.59,262342,703085.59
355030,201810,208304,81128,127176,77163049.91,121225744.18,198388794.09
355040,201810,739,348,391,329941.6,372823.2,702764.8
355050,201810,153,103,50,96991.77,47700,144691.77
355060,201810,1596,805,791,763120.94,753422.3,1516543.24
355070,201810,1447,707,740,670807.16,705634,1376441.16
355080,201810,202,116,86,110664,81156.8,191820.8
355090,201810,303,195,108,183932,102079,286011
355100,201810,4921,2433,2488,2299548.9,2370238.99,4669787.89
355110,201810,271,174,97,165039,92538,257577
355120,201810,85,61,24,58194,22887,81081
355130,201810,56,31,25,29574,23850,53424
355140,201810,185,121,64,114718.5,61056,175774.5
355150,201810,696,417,279,396574,265689,662263
355160,201810,470,226,244,213219.96,232776,445995.96
355170,201810,2085,1093,992,1041455.98,944759.73,1986215.71
355180,201810,627,271,356,257580,339616,597196
355190,201810,224,153,71,145962,67734,213696
355200,201810,120,69,51,65826,48654,114480
355210,201810,713,400,313,381600,298583.46,680183.46
355220,201810,6921,3692,3229,3511396.86,3068916.9,6580313.76
355230,201810,109,65,44,61437.6,41971.23,103408.83
355240,201810,4446,1911,2535,1810841.74,2414414.29,4225256.03
355250,201810,5483,2629,2854,2503265.22,2719307.56,5222572.78
355255,201810,50,31,19,29574,18126,47700
355260,201810,185,111,74,104921.12,70568.46,175489.58
355270,201810,171,102,69,97308,65111,162419
355280,201810,6417,2691,3726,2561459.72,3550786.46,6112246.18
355290,201810,76,59,17,56286,16218,72504
355300,201810,191,122,69,115434.8,65540,180974.8
355310,201810,106,59,47,56286,44838,101124
355320,201810,88,48,40,45792,37212.6,83004.6
355330,201810,281,158,123,150064.2,117342,267406.2
355340,201810,1609,539,1070,511599.81,1019751.97,1531351.78
355350,201810,136,69,67,65826,63918,129744
355360,201810,180,115,65,109500.12,62010,171510.12
355365,201810,24,19,5,18126,4770,22896
355370,201810,1037,597,440,563661.74,418510.55,982172.29
355380,201810,784,516,268,491672.52,255672,747344.52
355385,201810,66,46,20,43884,19080,62964
355390,201810,103,62,41,59148,39114,98262
355395,201810,182,111,71,104615.23,67734,172349.23
355400,201810,1601,978,623,927773.72,591671,1519444.72
355410,201810,4922,2352,2570,2226720.84,2442722.92,4669443.76
355420,201810,51,38,13,36252,12402,48654
355430,201810,352,211,141,199958.4,134514,334472.4
355440,201810,82,49,33,46746,31482,78228
355450,201810,457,225,232,212218.14,220374.2,432592.34
355460,201810,67,52,15,48654.42,14310,62964.42
355465,201810,51,32,19,30528,18126,48654
355470,201810,183,74,109,69642.1,103986,173628.1
355475,201810,13,8,5,7632,4770,12402
355480,201810,467,208,259,197553.47,246418.2,443971.67
355490,201810,115,81,34,77274,32436,109710
355495,201810,55,27,28,25758,26712,52470
355500,201810,1651,925,726,876876.03,692572.69,1569448.72
355510,201810,268,196,72,183525.63,68688,252213.63
355520,201810,29,22,7,20702,6678,27380
355530,201810,25,18,7,17172,6678,23850
355535,201810,81,39,42,37206,40068,77274
355540,201810,2379,949,1430,903887.53,1363257.96,2267145.49
355550,201810,66,40,26,38160,24804,62964
355560,201810,241,120,121,114480,114798,229278
355570,201810,28,19,9,18126,8586,26712
355580,201810,261,177,84,168858,79846,248704
355590,201810,24,15,9,14310,8586,22896
355600,201810,270,139,131,132606,124683.23,257289.23
355610,201810,227,153,74,145962,70596,216558
355620,201810,1332,637,695,607412,662520.38,1269932.38
355630,201810,422,310,112,295740,105894.96,401634.96
355635,201810,126,60,66,57240,62951,120191
355640,201810,581,329,252,312912.16,240408,553320.16
355645,201810,846,367,479,348353.3,455086.82,803440.12
355650,201810,2133,900,1233,854377.6,1176263.46,2030641.06
355660,201810,256,138,118,131652,112572,244224
355670,201810,513,204,309,193980,294499.8,488479.8
355680,201810,207,118,89,111619,84238.2,195857.2
355690,201810,88,41,47,39114,44494,83608
355695,201810,14,11,3,10494,2862,13356
355700,201810,1148,592,556,559345.62,529565.8,1088911.42
355710,201810,2233,1225,1008,1165299.56,961155,2126454.56
355715,201810,19,16,3,15264,2862,18126
355720,201810,206,125,81,117660.08,77274,194934.08
355730,201810,97,57,40,53503.95,38160,91663.95
410010,201810,134,113,21,107802,20034,127836
410020,201810,106,92,14,87768,13356,101124
410030,201810,163,104,59,98549,56286,154835
410040,201810,994,545,449,518987.44,428156,947143.44
410045,201810,29,24,5,22896,4770,27666
410050,201810,476,267,209,254718,198909,453627
410060,201810,278,214,64,204156,61056,265212
410070,201810,310,257,53,245178,50562,295740
410080,201810,165,106,59,101124,56286,157410
410090,201810,75,66,9,62755,8586,71341
410100,201810,296,212,84,202248,80040.6,282288.6
410105,201810,50,29,21,27666,20034,47700
410110,201810,327,196,131,186984,124974,311958
410115,201810,31,21,10,20034,9540,29574
410120,201810,432,221,211,210547.8,201294,411841.8
410130,201810,46,29,17,27666,16218,43884
410140,201810,3135,1535,1600,1457367.8,1521249.4,2978617.2
410150,201810,2723,1106,1617,1053685.24,1542021.8,2595707.04
410160,201810,503,319,184,304039.8,175536,479575.8
410165,201810,66,44,22,41976,20988,62964
410170,201810,167,121,46,114009,43884,157893
410180,201810,2159,1259,900,1196983.71,857428.95,2054412.66
410185,201810,36,31,5,29574,4770,34344
410190,201810,493,323,170,307378.8,162180,469558.8
410200,201810,969,729,240,694616.94,228960,923576.94
410210,201810,568,298,270,283696.62,257294,540990.62
410220,201810,43,22,21,20988,20012.12,41000.12
410230,201810,130,70,60,66780,57240,124020
410240,201810,735,481,254,458301.8,242316,700617.8
410250,201810,370,276,94,262699.84,89671.23,352371.07
410260,201810,302,176,126,167904,120204,288108
410270,201810,29,19,10,18126,9540,27666
410275,201810,61,45,16,42930,15264,58194
410280,201810,328,192,136,182908.52,129744,312652.52
410290,201810,238,150,88,143100,82998,226098
410300,201810,80,63,17,60102,16218,76320
410302,201810,25,16,9,15264,8586,23850
410304,201810,44,31,13,29574,12402,41976
410305,201810,219,123,96,116674.2,91584,208258.2
410310,201810,262,167,95,159318,90610.92,249928.92
410315,201810,48,35,13,33366,12402,45768
410320,201810,138,95,43,90630,41022,131652
410322,201810,35,24,11,22896,10494,33390
410330,201810,171,122,49,116388,46556,162944
410335,201810,101,62,39,59148,37206,96354
410337,201810,41,35,6,33390,5724,39114
410340,201810,31,29,2,27666,1908,29574
410345,201810,222,140,82,133560,78228,211788
410347,201810,51,38,13,36252,12402,48654
410350,201810,233,141,92,134514,87768,222282
410360,201810,470,288,182,272208.4,171834,444042.4
410370,201810,2407,1031,1376,981191.32,1310414.82,2291606.14
410380,201810,225,142,83,135468,79182,214650
410390,201810,375,277,98,264254,93492,357746
410395,201810,37,24,13,22896,12021,34917
410400,201810,838,426,412,405075.2,391698.1,796773.3
410405,201810,94,72,22,68688,20988,89676
410410,201810,37,28,9,26712,8586,35298
410420,201810,1650,824,826,783901.89,786414.96,1570316.85
410425,201810,174,82,92,78038,87768,165806
410430,201810,2194,1284,910,1220834.74,867263.2,2088097.94
410440,201810,386,286,100,272844,95400,368244
410442,201810,359,243,116,230869,110664,341533
410445,201810,415,292,123,278568,117342,395910
410450,201810,387,203,184,193662,175536,369198
410460,201810,460,247,213,235056.06,203202,438258.06
410465,201810,198,124,74,118009.8,70596,188605.8
410470,201810,230,147,83,140238,79182,219420
410480,201810,5961,2951,3010,2796433.98,2865712.33,5662146.31
410490,201810,1415,924,491,879999,465266.85,1345265.85
410500,201810,271,157,114,149778,108756,258534
410510,201810,174,128,46,122112,43875,165987
410520,201810,252,189,63,180306,60102,240408
410530,201810,238,88,150,83252.4,143096,226348.4
410540,201810,317,228,89,216753.95,84901.23,301655.18
410550,201810,1668,738,930,703765.8,886020.36,1589786.16
410560,201810,132,102,30,97308,28620,125928
410570,201810,432,299,133,283158.2,126882,410040.2
410580,201810,3168,1435,1733,1366131.89,1652806,3018937.89
410590,201810,404,286,118,272844,112572,385416
410600,201810,190,161,29,153594,27666,181260
410610,201810,58,48,10,45792,9540,55332
410620,201810,242,177,65,168858,62010,230868
410630,201810,440,257,183,245178,174582,419760
410640,201810,1028,646,382,612467.27,362821.28,975288.55
410645,201810,103,77,26,73077,24804,97881
410650,201810,366,250,116,237546,110664,348210
410655,201810,78,59,19,56286,18126,74412
410657,201810,43,18,25,17172,23850,41022
410660,201810,612,432,180,410599,171720,582319
410670,201810,74,63,11,60102,10494,70596
410680,201810,199,166,33,157696.2,31482,189178.2
410685,201810,15,10,5,9540,4770,14310
410690,201810,28111,12252,15859,11667059.68,15118871.39,26785931.07
410700,201810,327,242,85,230582,81090,311672
410710,201810,126,104,22,99216,20988,120204
410712,201810,20,14,6,13356,5724,19080
410715,201810,87,64,23,61056,21942,82998
410720,201810,610,363,247,346302,235629,581931
410725,201810,177,130,47,124020,44838,168858
410730,201810,87,54,33,51516,31482,82998
410740,201810,113,83,30,79182,28620,107802
410750,201810,222,160,62,152640,59143.23,211783.23
410752,201810,25,16,9,15264,8586,23850
410753,201810,51,22,29,20315.43,27666,47981.43
410754,201810,38,21,17,19748,16218,35966
410755,201810,81,55,26,51897.6,24804,76701.6
410760,201810,731,416,315,396529.12,300510,697039.12
410765,201810,1671,810,861,765927,820240.26,1586167.26
410770,201810,105,83,22,79182,20988,100170
410773,201810,52,38,14,36252,13356,49608
410775,201810,175,135,40,128122.2,38160,166282.2
410780,201810,80,44,36,41976,34344,76320
410785,201810,54,43,11,41022,10494,51516
410790,201810,72,33,39,31482,37206,68688
410800,201810,291,181,110,171721,104940,276661
410810,201810,23,19,4,18126,3530,21656
410820,201810,179,131,48,124974,45792,170766
410830,201810,8472,3818,4654,3630082.55,4437255.14,8067337.69
410832,201810,103,70,33,66780,31482,98262
410840,201810,1433,803,630,763794.08,600106.48,1363900.56
410845,201810,66,43,23,40736,21942,62678
410850,201810,197,138,59,130857.52,56286,187143.52
410855,201810,54,47,7,44838,6678,51516
410860,201810,682,398,284,378452.76,270936,649388.76
410865,201810,104,81,23,77274,21942,99216
410870,201810,159,134,25,127836,23850,151686
410880,201810,1119,561,558,534527.82,532268,1066795.82
410890,201810,83,57,26,54378,24804,79182
410895,201810,72,55,17,52470,16218,68688
410900,201810,21,13,8,12402,7632,20034
410910,201810,15,13,2,12402,1908,14310
410920,201810,35,23,12,21942,11448,33390
410930,201810,513,330,183,314608.98,174582,489190.98
410940,201810,4354,2558,1796,2430055.6,1710120.4,4140176.0
410950,201810,112,85,27,81090,25758,106848
410960,201810,771,346,425,330084,405260,735344
410965,201810,70,54,16,51229.8,15264,66493.8
410970,201810,636,460,176,438372.2,167904,606276.2
410975,201810,109,65,44,61499,41976,103475
410980,201810,1614,731,883,693620.6,839897.6,1533518.2
410990,201810,269,185,84,176490,79849.8,256339.8
411000,201810,64,39,25,37206,23564,60770
411005,201810,23,18,5,17172,4770,21942
411007,201810,245,139,106,132319.8,101124,233443.8
411010,201810,580,406,174,387324,165996,553320
411020,201810,294,202,92,192708,87768,280476
411030,201810,17,8,9,7632,8586,16218
411040,201810,52,37,15,35298,14310,49608
411050,201810,222,173,49,164425.96,46619.12,211045.08
411060,201810,516,345,171,329121,163134,492255
411065,201810,67,58,9,55332,8586,63918
411070,201810,1211,796,415,753524.31,395910,1149434.31
411080,201810,231,166,65,158364,62010,220374
411090,201810,113,85,28,81090,26712,107802
411095,201810,280,113,167,107802,159308,267110
411100,201810,112,92,20,87768,19080,106848
411110,201810,122,86,36,82044,34344,116388
411120,201810,190,140,50,133560,47700,181260
411125,201810,191,90,101,85211.28,96306.3,181517.58
411130,201810,127,108,19,102394,18126,120520
411140,201810,190,129,61,123044.12,57669.3,180713.42
411150,201810,1238,823,415,784464.66,395910,1180374.66
411155,201810,124,83,41,79182,39114,118296
411160,201810,22,10,12,9540,11448,20988
411170,201810,54,49,5,46746,4770,51516
411180,201810,972,646,326,614090.63,310999.23,925089.86
411190,201810,337,192,145,182500.2,138330,320830.2
411200,201810,679,445,234,423259.89,222216.18,645476.07
411210,201810,698,378,320,359062.21,305280,664342.21
411220,201810,149,110,39,104940,37206,142146
411230,201810,40,36,4,34344,3816,38160
411240,201810,126,87,39,82998,37206,120204
411250,201810,429,314,115,299556,109710,409266
411260,201810,20,13,7,12402,6678,19080
411270,201810,292,157,135,149778,128790,278568
411275,201810,209,184,25,174820.6,23850,198670.6
411280,201810,224,158,66,150415,62964,213379
411290,201810,57,42,15,40068,14310,54378
411295,201810,150,117,33,111618,31482,143100
411300,201810,69,35,34,33390,32436,65826
411310,201810,92,71,21,67734,20034,87768
411320,201810,745,539,206,512585,194921.28,707506.28
411325,201810,64,41,23,39114,21942,61056
411330,201810,925,595,330,565627.61,314080.06,879707.67
411340,201810,26,17,9,16218,8272,24490
411342,201810,69,53,16,50562,15264,65826
411345,201810,126,63,63,60102,60102,120204
411350,201810,495,391,104,371535.64,98921,470456.64
411360,201810,55,35,20,33390,19080,52470
411370,201810,14346,5861,8485,5570439.59,8078928.28,13649367.87
411373,201810,179,132,47,125928,44838,170766
411375,201810,70,58,12,55332,11448,66780
411380,201810,94,72,22,68688,20988,89676
411390,201810,134,90,44,85860,41976,127836
411400,201810,360,271,89,258525,84906,343431
411410,201810,440,230,210,218752.2,200054,418806.2
411420,201810,1051,476,575,451814.4,547548.3,999362.7
411430,201810,418,268,150,255004.2,143091,398095.2
411435,201810,37,26,11,24804,10494,35298
411440,201810,476,382,94,362736.99,89676,452412.99
411450,201810,423,355,68,338670,64872,403542
411460,201810,767,306,461,290791.64,438083.6,728875.24
411470,201810,85,63,22,60102,20988,81090
411480,201810,646,366,280,346684.4,266547.6,613232.0
411490,201810,297,188,109,179352,103699.8,283051.8
411500,201810,110,92,18,87564.33,16745,104309.33
411510,201810,217,177,40,168110.06,38160,206270.06
411520,201810,5971,2327,3644,2214897.4,3468047.46,5682944.86
411530,201810,113,78,35,74412,33390,107802
411535,201810,51,22,29,20988,27666,48654
411540,201810,354,247,107,234615.9,102078,336693.9
411545,201810,55,40,15,38160,14310,52470
411550,201810,76,57,19,54378,18126,72504
411560,201810,389,177,212,168194.38,202248,370442.38
411570,201810,776,300,476,284904.44,453904.46,738808.90
411573,201810,30,19,11,18126,10494,28620
411575,201810,281,177,104,168858,99216,268074
411580,201810,1255,499,756,473785.84,719376.4,1193162.24
411585,201810,79,40,39,38160,37206,75366
411590,201810,23,17,6,16218,5724,21942
411600,201810,27,12,15,11448,14310,25758
411605,201810,246,108,138,103032,131652,234684
411610,201810,238,160,78,152640,74412,227052
411620,201810,367,210,157,199863,149139,349002
411630,201810,57,40,17,38160,16218,54378
411640,201810,34,28,6,26712,5724,32436
411650,201810,13,8,5,7632,4770,12402
411660,201810,33,25,8,23850,7632,31482
411670,201810,248,185,63,176490,60102,236592
411680,201810,157,137,20,130698,19080,149778
411690,201810,589,314,275,298978.44,262026.2,561004.64
411695,201810,61,45,16,42930,15264,58194
411700,201810,157,136,21,129744,20034,149778
411705,201810,102,66,36,62964,34344,97308
411710,201810,300,199,101,188779.81,96354,285133.81
411720,201810,136,89,47,84906,44838,129744
411721,201810,60,51,9,48654,8586,57240
411722,201810,99,43,56,41022,53424,94446
411725,201810,147,113,34,107229.8,32436,139665.8
411727,201810,75,60,15,57240,14023.8,71263.8
411729,201810,34,27,7,25758,6678,32436
411730,201810,540,348,192,330401.96,182881.8,513283.76
411740,201810,40,24,16,22896,15264,38160
411745,201810,69,46,23,43093,21942,65035
411750,201810,876,410,466,390043.9,443319.23,833363.13
411760,201810,1216,925,291,881201.2,277605,1158806.2
411770,201810,450,298,152,284272.92,145008,429280.92
411780,201810,336,218,118,207972,112572,320544
411790,201810,533,304,229,288134.47,218171.34,506305.81
411800,201810,169,133,36,126882,34344,161226
411810,201810,164,125,39,119250,37206,156456
411820,201810,2074,1012,1062,962491.7,1012424.3,1974916.0
411830,201810,13,13,0,12402,0,12402
411840,201810,1945,1209,736,1151193.17,700562.2,1851755.37
411845,201810,50,20,30,19080,28620,47700
411850,201810,1228,692,536,658600.4,509390.48,1167990.88
411860,201810,47,32,15,30242,14310,44552
411870,201810,77,54,23,51516,21655.8,73171.8
411880,201810,425,271,154,258420,146171.88,404591.88
411885,201810,106,69,37,65826,35298,101124
411890,201810,321,205,116,193376.99,110654.46,304031.45
411900,201810,69,50,19,47700,18126,65826
411910,201810,183,143,40,136412.46,37320.48,173732.94
411915,201810,2121,917,1204,872359.57,1147314.05,2019673.62
411920,201810,124,102,22,97308,20988,118296
411925,201810,12,8,4,7632,3816,11448
411930,201810,799,588,211,559046,201294,760340
411940,201810,595,416,179,396387,170766,567153
411950,201810,901,482,419,459083.88,398454.04,857537.92
411960,201810,1045,726,319,689749.69,304326,994075.69
411965,201810,26,18,8,17172,7632,24804
411970,201810,77,69,8,65826,7632,73458
411980,201810,168,118,50,112572,47700,160272
411990,201810,5107,2990,2117,2833762.43,2018006.44,4851768.87
411995,201810,457,170,287,162180,273798,435978
412000,201810,305,187,118,178207.2,112562.46,290769.66
412010,201810,51,30,21,28620,20034,48654
412015,201810,45,33,12,31482,11448,42930
412020,201810,27,23,4,21655.8,3816,25471.8
412030,201810,59,51,8,48654,7632,56286
412033,201810,54,37,17,35274,16218,51492
412035,201810,75,48,27,45792,25758,71550
412040,201810,36,24,12,22610,11448,34058
412050,201810,199,149,50,142146,47700,189846
412060,201810,758,584,174,554274.74,165005.8,719280.54
412065,201810,48,33,15,31482,14310,45792
412070,201810,158,106,52,101124,49608,150732
412080,201810,284,155,129,147870,123066,270936
412085,201810,33,16,17,15264,16218,31482
412090,201810,766,486,280,461975.2,267120,729095.2
412100,201810,251,211,40,200341,38160,238501
412110,201810,68,54,14,51516,13356,64872
412120,201810,317,206,111,195951.6,105894,301845.6
412125,201810,81,47,34,44551.8,32436,76987.8
412130,201810,43,31,12,29269,11448,40717
412135,201810,27,16,11,15264,10494,25758
412140,201810,320,227,93,216272,88722,304994
412150,201810,251,175,76,165996.04,72504,238500.04
412160,201810,88,52,36,49608,34344,83952
412170,201810,669,469,200,447139.8,190800,637939.8
412175,201810,40,30,10,28620,9540,38160
412180,201810,199,158,41,150132.61,38493.9,188626.51
412190,201810,333,265,68,252137.43,64872,317009.43
412200,201810,200,125,75,119250,71550,190800
412210,201810,79,61,18,58194,17172,75366
412215,201810,232,163,69,155502,65539.8,221041.8
412217,201810,75,59,16,56286,15264,71550
412220,201810,818,613,205,584802,195570,780372
412230,201810,335,204,131,192994.2,124937.46,317931.66
412240,201810,1338,655,683,621473.54,649429.16,1270902.70
412250,201810,368,238,130,227052,124020,351072
412260,201810,106,76,30,72504,28620,101124
412265,201810,174,137,37,130380.04,35298,165678.04
412270,201810,81,53,28,50562,26712,77274
412280,201810,91,72,19,68688,18126,86814
412290,201810,99,68,31,64872,29574,94446
412300,201810,212,137,75,130698,71406.9,202104.9
412310,201810,43,38,5,36252,4770,41022
412320,201810,94,79,15,75366,14310,89676
412330,201810,176,153,23,145962,21942,167904
412340,201810,150,106,44,101124,41690,142814
412350,201810,596,306,290,290922.3,276660,567582.3
412360,201810,29,25,4,23850,3816,27666
412370,201810,162,141,21,133083,20034,153117
412380,201810,264,197,67,187651.8,63814,251465.8
412382,201810,53,28,25,26712,23850,50562
412385,201810,139,103,36,98262,34344,132606
412390,201810,287,221,66,210834,62964,273798
412395,201810,71,56,15,53424,14310,67734
412400,201810,75,52,23,49608,21942,71550
412402,201810,258,126,132,120199.23,125641.8,245841.03
412405,201810,827,331,496,313366.24,472498.66,785864.90
412410,201810,972,606,366,575548.6,349164,924712.6
412420,201810,14,12,2,11448,1908,13356
412430,201810,21,15,6,14310,5724,20034
412440,201810,608,333,275,315403.38,260606.4,576009.78
412450,201810,79,67,12,63918,11448,75366
412460,201810,80,60,20,57240,19080,76320
412470,201810,231,180,51,171720,48654,220374
412480,201810,166,125,41,118296.9,39114,157410.9
412490,201810,160,138,22,131652,20988,152640
412500,201810,461,377,84,358083.8,80136,438219.8
412510,201810,185,154,31,146630,29574,176204
412520,201810,135,73,62,69642,59148,128790
412530,201810,106,55,51,52470,48367.8,100837.8
412535,201810,108,79,29,75348,27666,103014
412540,201810,70,35,35,33390,33390,66780
412545,201810,96,70,26,66780,24804,91584
412550,201810,3534,1608,1926,1530368.64,1835306.9,3365675.54
412555,201810,14,10,4,9540,3816,13356
412560,201810,583,436,147,413845.2,140238,554083.2
412570,201810,742,409,333,388621.44,317682,706303.44
412575,201810,83,59,24,56286,22896,79182
412580,201810,165,110,55,104940,52470,157410
412590,201810,33,31,2,29574,1908,31482
412600,201810,174,132,42,125928,40068,165996
412610,201810,31,19,12,18126,11448,29574
412620,201810,147,129,18,123066,17172,140238
412625,201810,2194,1168,1026,1111212.65,976640.39,2087853.04
412627,201810,71,57,14,54378,13356,67734
412630,201810,422,284,138,269402.43,131652,401054.43
412635,201810,67,19,48,18126,45792,63918
412640,201810,124,83,41,79182,39114,118296
412650,201810,349,219,130,208926,124015.23,332941.23
412660,201810,477,297,180,282623,171720,454343
412665,201810,51,45,6,42930,5724,48654
412667,201810,287,197,90,187167.54,85617.8,272785.34
412670,201810,61,52,9,49608,8586,58194
412680,201810,298,236,62,225144,59148,284292
412690,201810,107,67,40,63918,37874,101792
412700,201810,156,105,51,100170,48368,148538
412710,201810,1397,867,530,819584.4,503712.2,1323296.6
412720,201810,231,155,76,147870,72504,220374
412730,201810,195,157,38,149778,35298,185076
412740,201810,425,234,191,223092.9,182214,405306.9
412750,201810,471,274,197,260442,187938,448380
412760,201810,267,138,129,131652,123066,254718
412770,201810,2134,1211,923,1150786.92,879007,2029793.92
412780,201810,155,121,34,115434,32436,147870
412785,201810,257,131,126,124497,120204,244701
412788,201810,37,22,15,20988,14310,35298
412790,201810,138,112,26,106180.2,24804,130984.2
412795,201810,155,116,39,110664,37206,147870
412796,201810,301,211,90,200129.18,85726.44,285855.62
412800,201810,573,375,198,357454.26,188892,546346.26
412810,201810,3008,1660,1348,1578565.45,1284747.03,2863312.48
412820,201810,947,616,331,578185.69,314411,892596.69
412830,201810,15,12,3,11448,2862,14310
412840,201810,221,157,64,148824.2,61056,209880.2
412850,201810,785,529,256,502758,244224,746982
412853,201810,171,91,80,86814,76320,163134
412855,201810,219,119,100,112414.82,95400,207814.82
412860,201810,92,67,25,63918,23850,87768
412862,201810,58,43,15,41022,14310,55332
412863,201810,6,5,1,4770,954,5724
412865,201810,40,30,10,28620,9540,38160
412870,201810,108,71,37,67734,35298,103032
412880,201810,100,74,26,70596,24804,95400
420005,201810,41,36,5,34344,4770,39114
420010,201810,377,251,126,238002.02,119918,357920.02
420020,201810,81,66,15,62964,14310,77274
420030,201810,28,26,2,24804,1908,26712
420040,201810,106,81,25,77274,23850,101124
420050,201810,55,34,21,32436,20034,52470
420055,201810,19,18,1,17172,954,18126
420060,201810,32,24,8,22896,7632,30528
420070,201810,106,89,17,84906,16208.46,101114.46
420075,201810,11,10,1,9540,954,10494
420080,201810,47,43,4,40068,3816,43884
420090,201810,34,32,2,29750.49,1908,31658.49
420100,201810,165,139,26,130793.6,24804,155597.6
420110,201810,20,20,0,19080,0,19080
420120,201810,52,40,12,38160,11448,49608
420125,201810,87,70,17,66780,16218,82998
420127,201810,33,29,4,27666,3816,31482
420130,201810,397,250,147,238490.46,139989.96,378480.42
420140,201810,1293,744,549,708451.38,523680,1232131.38
420150,201810,45,40,5,38160,4770,42930
420160,201810,37,35,2,33390,1908,35298
420165,201810,20,15,5,14310,4770,19080
420170,201810,71,46,25,43884,23850,67734
420180,201810,25,24,1,22896,954,23850
420190,201810,30,27,3,25758,2862,28620
420195,201810,122,60,62,57240,59148,116388
420200,201810,1263,568,695,535559.52,661973.38,1197532.90
420205,201810,70,40,30,38160,28620,66780
420207,201810,107,61,46,57956,43874.46,101830.46
420208,201810,23,18,5,17172,3911.4,21083.4
420209,201810,20,16,4,15264,3816,19080
420210,201810,460,222,238,211501.8,226976.22,438478.02
420213,201810,43,35,8,33390,7632,41022
420215,201810,28,24,4,22896,3816,26712
420220,201810,66,43,23,41022,21942,62964
420230,201810,803,455,348,433307,331505.46,764812.46
420240,201810,2289,1541,748,1461534.91,713153.16,2174688.07
420243,201810,39,31,8,29574,7632,37206
420245,201810,120,62,58,59148,55332,114480
420250,201810,54,32,22,30528,20988,51516
420253,201810,44,36,8,34344,7632,41976
420257,201810,13,11,2,10494,1908,12402
420260,201810,100,87,13,82998,12402,95400
420270,201810,39,32,7,30524,6678,37202
420280,201810,279,208,71,196708.06,66476.1,263184.16
420285,201810,19,12,7,11448,6678,18126
420287,201810,54,34,20,32436,19080,51516
420290,201810,973,686,287,651550.18,272971.1,924521.28
420300,201810,1398,1114,284,1057748.78,268742.34,1326491.12
420310,201810,60,47,13,44838,12402,57240
420315,201810,33,29,4,27666,3816,31482
420320,201810,852,435,417,414012.15,397814,811826.15
420325,201810,0,0,0,0,0,0
420330,201810,124,85,39,81090,37091.52,118181.52
420340,201810,164,112,52,105886,49579.38,155465.38
420350,201810,256,190,66,179705.78,62964,242669.78
420360,201810,764,582,182,552348.16,173343.38,725691.54
420370,201810,114,72,42,68498,39782,108280
420380,201810,1138,810,328,768630.1,312828.84,1081458.94
420390,201810,258,173,85,163211.52,80374.5,243586.02
420395,201810,184,133,51,126882,47790.63,174672.63
420400,201810,249,188,61,178323,58194,236517
420410,201810,60,46,14,43884,13356,57240
420415,201810,32,30,2,28620,1908,30528
420417,201810,52,38,14,36252,13336.92,49588.92
420419,201810,11,11,0,10494,0,10494
420420,201810,2822,1736,1086,1645573.69,1033756.42,2679330.11
420425,201810,77,63,14,60093,13041.72,73134.72
420430,201810,1267,891,376,845996.22,356941.97,1202938.19
420435,201810,16,14,2,13356,1908,15264
420440,201810,105,72,33,68060.68,31330.6,99391.28
420445,201810,21,19,2,18126,1908,20034
420450,201810,70,34,36,32436,34344,66780
420455,201810,215,162,53,154501.92,50506.38,205008.30
420460,201810,2347,1562,785,1486284.96,748656.36,2234941.32
420470,201810,119,87,32,82959.84,30528,113487.84
420475,201810,6,6,0,5724,0,5724
420480,201810,879,660,219,624375.32,207877,832252.32
420490,201810,116,89,27,84906,25758,110664
420500,201810,643,289,354,273735.2,337716,611451.2
420510,201810,18,15,3,14310,2862,17172
420515,201810,26,20,6,19080,5724,24804
420517,201810,10,10,0,9540,0,9540
420519,201810,0,0,0,0,0,0
420520,201810,70,53,17,50562,16218,66780
420530,201810,167,112,55,105894.9,52470,158364.9
420535,201810,20,19,1,18126,954,19080
420540,201810,5038,2979,2059,2828551.08,1958992.18,4787543.26
420543,201810,26,26,0,24804,0,24804
420545,201810,199,140,59,133560,56266.92,189826.92
420550,201810,873,706,167,670626.32,159160.73,829787.05
420555,201810,40,28,12,26712,11448,38160
420560,201810,66,53,13,50180.4,12402,62582.4
420570,201810,157,93,64,88722,61046.46,149768.46
420580,201810,297,132,165,125928,157124,283052
420590,201810,512,362,150,345061.8,143100,488161.8
420600,201810,101,53,48,50562,45792,96354
420610,201810,40,38,2,36252,1908,38160
420620,201810,77,63,14,60102,13356,73458
420630,201810,162,118,44,112563.23,41968,154531.23
420640,201810,94,84,10,79945.2,9540,89485.2
420650,201810,227,121,106,114766.2,101114.46,215880.66
420660,201810,56,43,13,40258.8,12402,52660.8
420665,201810,38,29,9,27666,8586,36252
420670,201810,322,242,80,230152.5,76301.46,306453.96
420675,201810,16,15,1,14310,954,15264
420680,201810,38,28,10,26712,9540,36252
420690,201810,174,146,28,138520.8,26712,165232.8
420700,201810,668,462,206,439388.01,196280.82,635668.83
420710,201810,152,86,66,82044,62677.8,144721.8
420720,201810,112,91,21,86804.46,20034,106838.46
420730,201810,568,369,199,350978.58,188551.66,539530.24
420740,201810,47,46,1,43884,954,44838
420750,201810,501,336,165,320257.8,157410,477667.8
420757,201810,19,16,3,15264,2862,18126
420760,201810,36,30,6,28620,5724,34344
420765,201810,72,58,14,55332,13356,68688
420768,201810,66,58,8,55332,7632,62964
420770,201810,83,70,13,66780,12402,79182
420775,201810,46,42,4,39114,3816,42930
420780,201810,243,190,53,181250.46,50562,231812.46
420785,201810,14,10,4,9540,3816,13356
420790,201810,175,145,30,138237.3,27638.46,165875.76
420800,201810,68,52,16,48844.8,15264,64108.8
420810,201810,251,218,33,207963,30671.1,238634.1
420820,201810,2342,1394,948,1324166.61,903043.8,2227210.41
420830,201810,607,338,269,320179.83,255662.46,575842.29
420840,201810,152,114,38,108756,35548,144304
420845,201810,442,193,249,183737.07,236306,420043.07
420850,201810,236,188,48,179352,45792,225144
420860,201810,64,54,10,51516,9540,61056
420870,201810,121,86,35,81805.5,32913,114718.5
420880,201810,176,122,54,116378.46,51039,167417.46
420890,201810,886,438,448,414763.84,426810.6,841574.44
420895,201810,9,9,0,8586,0,8586
420900,201810,417,327,90,309087.46,85831.92,394919.38
420910,201810,5846,3303,2543,3138143.43,2420930.87,5559074.30
420915,201810,76,70,6,66780,5724,72504
420917,201810,18,13,5,12402,4770,17172
420920,201810,22,15,7,14310,6678,20988
420930,201810,2776,1709,1067,1622874.84,1012454.84,2635329.68
420940,201810,611,443,168,421286.6,158620.08,579906.68
420945,201810,10,8,2,7632,1908,9540
420950,201810,57,52,5,49608,4770,54378
420960,201810,117,93,24,88684.92,22887,111571.92
420970,201810,300,241,59,228247.85,56258.46,284506.31
420980,201810,22,22,0,20988,0,20988
420985,201810,64,56,8,53424,7632,61056
420990,201810,74,59,15,56286,14310,70596
421000,201810,32,21,11,20034,10494,30528
421003,201810,69,47,22,44838,20988,65826
421005,201810,8,5,3,4770,2862,7632
421010,201810,761,534,227,508187,215452.2,723639.2
421020,201810,29,24,5,22896,4770,27666
421030,201810,128,108,20,102699,19080,121779
421040,201810,70,59,11,55045.8,10494,65539.8
421050,201810,320,230,90,218275.2,85860,304135.2
421055,201810,24,20,4,19080,3816,22896
421060,201810,78,53,25,50562,23850,74412
421070,201810,50,45,5,42930,4770,47700
421080,201810,34,32,2,30528,1908,32436
421085,201810,25,20,5,19080,4770,23850
421090,201810,43,32,11,30528,10494,41022
421100,201810,128,93,35,88722,33390,122112
421105,201810,216,175,41,166663.8,39090.69,205754.49
421110,201810,112,90,22,85239.9,20988,106227.9
421120,201810,155,120,35,113984.46,33361.38,147345.84
421125,201810,17,12,5,11448,4770,16218
421130,201810,807,526,281,500674.05,266572.54,767246.59
421140,201810,31,23,8,21226.5,7632,28858.5
421145,201810,38,30,8,28620,7632,36252
421150,201810,106,77,29,73458,27666,101124
421160,201810,64,42,22,40058.46,20988,61046.46
421165,201810,17,16,1,15264,954,16218
421170,201810,198,168,30,159359.84,28611,187970.84
421175,201810,152,101,51,96354,48606.38,144960.38
421180,201810,60,39,21,36844,20034,56878
421185,201810,17,14,3,13356,2862,16218
421187,201810,0,0,0,0,0,0
421189,201810,38,29,9,27666,8576.46,36242.46
421190,201810,1613,1019,594,971163.46,565693.58,1536857.04
421200,201810,89,67,22,62964.7,20988,83952.7
421205,201810,29,19,10,18126,9540,27666
421210,201810,170,121,49,115434,46746,162180
421220,201810,286,226,60,214983.9,57240,272223.9
421223,201810,53,44,9,41786,8586,50372
421225,201810,68,43,25,40832,23850,64682
421227,201810,96,72,24,68688,22896,91584
421230,201810,53,40,13,38160,12402,50562
421240,201810,19,19,0,18126,0,18126
421250,201810,359,226,133,214270,126090.18,340360.18
421260,201810,27,22,5,20988,4770,25758
421265,201810,0,0,0,0,0,0
421270,201810,53,47,6,44838,5724,50562
421280,201810,340,192,148,183168,140238,323406
421290,201810,329,217,112,206780,104722.26,311502.26
421300,201810,26,21,5,20034,4770,24804
421310,201810,54,40,14,37492.2,13356,50848.2
421315,201810,30,20,10,19080,9540,28620
421320,201810,137,97,40,92538,38160,130698
421330,201810,109,83,26,76777.92,24795,101572.92
421335,201810,39,27,12,25758,11448,37206
421340,201810,297,205,92,193806.05,87768,281574.05
421350,201810,190,110,80,104497,76320,180817
421360,201810,678,505,173,478222.36,165023.46,643245.82
421370,201810,195,151,44,144054,41642.1,185696.1
421380,201810,130,104,26,99211.23,24804,124015.23
421390,201810,16,12,4,11448,3816,15264
421400,201810,120,103,17,98262,16218,114480
421410,201810,23,19,4,18126,3816,21942
421415,201810,22,21,1,20034,954,20988
421420,201810,148,122,26,115815.6,24804,140619.6
421430,201810,15,11,4,10494,3816,14310
421440,201810,57,44,13,41976,12402,54378
421450,201810,95,81,14,77274,13356,90630
421460,201810,57,48,9,44987.77,8586,53573.77
421470,201810,68,45,23,42930,21942,64872
421480,201810,649,487,162,463834.8,154539,618373.8
421490,201810,22,21,1,20025,954,20979
421500,201810,508,327,181,310166.3,172396.44,482562.74
421505,201810,27,19,8,18126,7632,25758
421507,201810,36,30,6,28620,5724,34344
421510,201810,73,47,26,44838,24804,69642
421520,201810,66,57,9,53615,8586,62201
421530,201810,53,47,6,44838,5724,50562
421535,201810,27,26,1,24537,954,25491
421540,201810,59,50,9,47700,8586,56286
421545,201810,96,73,23,69156,21942,91098
421550,201810,299,218,81,207305,77274,284579
421555,201810,25,20,5,19080,4675,23755
421560,201810,8,7,1,6678,954,7632
421565,201810,123,88,35,83952,33390,117342
421567,201810,30,26,4,24804,3816,28620
421568,201810,33,31,2,29574,1908,31482
421569,201810,7,7,0,6678,0,6678
421570,201810,163,111,52,105894,49608,155502
421575,201810,27,22,5,20988,4770,25758
421580,201810,720,432,288,410213.2,273798.34,684011.54
421590,201810,22,21,1,20034,954,20988
421600,201810,130,81,49,77274,45507,122781
421605,201810,105,75,30,71217,28620,99837
421610,201810,188,150,38,142146.2,36252,178398.2
421620,201810,1093,651,442,618545.92,421353.38,1039899.30
421625,201810,23,21,2,20034,1908,21942
421630,201810,288,180,108,170909.8,102174,273083.8
421635,201810,17,8,9,7632,8586,16218
421640,201810,100,86,14,81854,13356,95210
421650,201810,286,165,121,157390.92,115414.92,272805.84
421660,201810,2161,1303,858,1239714.9,817360.06,2057074.96
421670,201810,191,134,57,127836,54378,182214
421680,201810,174,158,16,150732,15264,165996
421690,201810,350,244,106,231728.22,100160.58,331888.80
421700,201810,59,37,22,35298,20130,55428
421710,201810,26,25,1,23850,954,24804
421715,201810,8,7,1,6678,954,7632
421720,201810,595,436,159,414376.8,149959.26,564336.06
421725,201810,12,5,7,4770,6678,11448
421730,201810,39,27,12,25050.12,11448,36498.12
421740,201810,87,42,45,40068,42930,82998
421750,201810,224,170,54,159735.2,51516,211251.2
421755,201810,26,24,2,22896,1908,24804
421760,201810,106,75,31,71550,29574,101124
421770,201810,595,399,196,376973.38,186424.9,563398.28
421775,201810,29,19,10,18126,9540,27666
421780,201810,195,153,42,145962,40068,186030
421790,201810,159,132,27,125035.5,25758,150793.5
421795,201810,17,14,3,13356,2862,16218
421800,201810,495,317,178,301621.31,169574,471195.31
421810,201810,73,58,15,55332,14310,69642
421820,201810,310,212,98,201294.2,93492,294786.2
421825,201810,127,106,21,101124,20034,121158
421830,201810,132,100,32,95400,30528,125928
421835,201810,3,3,0,2862,0,2862
421840,201810,59,49,10,46737,9540,56277
421850,201810,81,70,11,66780,10490,77270
421860,201810,40,32,8,30528,7632,38160
421870,201810,983,756,227,712823.2,215773.86,928597.06
421875,201810,54,46,8,43884,7632,51516
421880,201810,169,122,47,116388,44552,160940
421885,201810,29,23,6,21942,5724,27666
421890,201810,122,86,36,82044,33382,115426
421895,201810,45,41,4,39114,3816,42930
421900,201810,160,128,32,121751.1,30492,152243.1
421910,201810,67,43,24,41022,22896,63918
421915,201810,31,26,5,24804,4770,29574
421917,201810,43,32,11,30528,10494,41022
421920,201810,33,30,3,28620,2862,31482
421930,201810,740,577,163,547191.06,155475,702666.06
421935,201810,55,48,7,45792,6678,52470
421940,201810,41,37,4,35298,3816,39114
421950,201810,844,559,285,531019.64,271529.85,802549.49
421960,201810,41,34,7,32150,6678,38828
421970,201810,370,235,135,223691.12,128781,352472.12
421985,201810,32,21,11,20034,10494,30528
422000,201810,0,0,0,0,0,0
430003,201810,197,49,148,46030.5,141192,187222.5
430005,201810,39,29,10,27666,9540,37206
430010,201810,279,198,81,188415,77274,265689
430020,201810,153,98,55,93206,52470,145676
430030,201810,133,105,28,99883.8,26712,126595.8
430040,201810,2973,1742,1231,1651632.88,1173392.2,2825025.08
430045,201810,65,56,9,53137.8,8586,61723.8
430047,201810,6,5,1,4770,954,5724
430050,201810,79,66,13,62964,12402,75366
430055,201810,14,12,2,11448,1908,13356
430057,201810,5,3,2,2862,1908,4770
430060,201810,3640,2173,1467,2064558.38,1396460.04,3461018.42
430063,201810,60,55,5,52470,4770,57240
430064,201810,151,124,27,118296,25758,144054
430066,201810,9,6,3,5724,2862,8586
430070,201810,43,33,10,31482,9540,41022
430080,201810,68,46,22,43184.33,20988,64172.33
430085,201810,35,13,22,12402,20988,33390
430087,201810,32,23,9,21799,8586,30385
430090,201810,72,65,7,61723.8,6678,68401.8
430100,201810,130,88,42,82998,40068,123066
430105,201810,144,73,71,69452,67428.72,136880.72
430107,201810,20,15,5,14310,4770,19080
430110,201810,416,247,169,234769.86,161140.14,395910.00
430120,201810,142,130,12,123066,11448,134514
430130,201810,801,500,301,476379.9,285627.6,762007.5
430140,201810,120,113,7,107516,6678,114194
430150,201810,112,72,40,67925,37206,105131
430155,201810,32,29,3,27666,2862,30528
430160,201810,3773,2248,1525,2121966.52,1452159.92,3574126.44
430163,201810,330,149,181,141097.34,172297.84,313395.18
430165,201810,26,18,8,17172,7632,24804
430170,201810,94,80,14,76320,13356,89676
430175,201810,86,66,20,62964,18412.2,81376.2
430180,201810,104,83,21,79182,19413.9,98595.9
430185,201810,34,26,8,24804,7632,32436
430187,201810,97,41,56,39114,53118.8,92232.8
430190,201810,220,128,92,122064.3,87758.46,209822.76
430192,201810,15,14,1,13356,954,14310
430195,201810,15,10,5,9540,4770,14310
430200,201810,168,147,21,139570.2,19747.8,159318.0
430205,201810,19,18,1,17172,954,18126
430210,201810,651,504,147,477095.4,138473.3,615568.7
430215,201810,17,12,5,11448,4770,16218
430220,201810,70,49,21,46746,20034,66780
430222,201810,12,7,5,6678,4770,11448
430223,201810,12,7,5,6678,4770,11448
430225,201810,3,2,1,1908,954,2862
430230,201810,302,182,120,172674,114384.6,287058.6
430235,201810,55,39,16,37206,15254.46,52460.46
430237,201810,30,23,7,21942,6678,28620
430240,201810,132,84,48,79945.2,45792,125737.2
430245,201810,71,59,12,56286,11448,67734
430250,201810,194,114,80,108746.46,76310.46,185056.92
430258,201810,12,10,2,9540,1908,11448
430260,201810,34,29,5,27666,4760.46,32426.46
430265,201810,35,29,6,27646.92,5724,33370.92
430270,201810,550,414,136,389371.54,128878.02,518249.56
430280,201810,1041,646,395,611275.5,375284.6,986560.1
430290,201810,382,219,163,207018.8,155502,362520.8
430300,201810,2133,1191,942,1131760.44,896095.35,2027855.79
430310,201810,1956,1025,931,971536.7,885141.93,1856678.63
430320,201810,51,43,8,41007.69,7632,48639.69
430330,201810,96,85,11,80613,10474.92,91087.92
430340,201810,66,59,7,56286,6678,62964
430350,201810,1676,1166,510,1101188.89,484756.56,1585945.45
430355,201810,23,21,2,20034,1908,21942
430360,201810,85,42,43,40068,41022,81090
430367,201810,28,20,8,19080,7632,26712
430370,201810,56,48,8,45792,7632,53424
430380,201810,133,99,34,93873.6,32436,126309.6
430390,201810,610,385,225,367003.8,214059.26,581063.06
430400,201810,144,111,33,103986,31462.92,135448.92
430410,201810,59,46,13,43884,12402,56286
430420,201810,505,334,171,316156.8,161637.56,477794.36
430430,201810,54,52,2,48972.63,1097.1,50069.73
430435,201810,154,117,37,110664,35298,145962
430440,201810,513,344,169,327985.2,161035.2,489020.4
430450,201810,1189,983,206,931276.46,196514.46,1127790.92
430460,201810,5060,2795,2265,2652048.17,2154448.99,4806497.16
430461,201810,17,15,2,14310,1908,16218
430462,201810,9,6,3,5724,2862,8586
430463,201810,1035,552,483,524471.92,460430.1,984902.02
430465,201810,25,14,11,13356,10494,23850
430466,201810,674,486,188,461736.2,179161.2,640897.4
430467,201810,99,57,42,53137.8,40058.46,93196.26
430468,201810,105,63,42,60102,39816.91,99918.91
430469,201810,24,19,5,18126,4770,22896
430470,201810,1171,651,520,615560.35,494124.3,1109684.65
430471,201810,49,36,13,34324.92,12402,46726.92
430480,201810,102,62,40,58289.4,38150.46,96439.86
430485,201810,6,6,0,5438,0,5438
430490,201810,90,73,17,68831.7,16218,85049.7
430495,201810,37,26,11,24804,10494,35298
430500,201810,190,126,64,119917.8,60680.46,180598.26
430510,201810,3229,2118,1111,2009384.09,1058453.46,3067837.55
430511,201810,17,16,1,15264,954,16218
430512,201810,137,97,40,92538,38160,130698
430513,201810,52,43,9,40545,8586,49131
430515,201810,33,30,3,28620,2862,31482
430517,201810,167,149,18,141192,17152.92,158344.92
430520,201810,363,254,109,241649,103957.38,345606.38
430530,201810,91,53,38,50562,36252,86814
430535,201810,474,322,152,306702.23,144980.15,451682.38
430537,201810,10,10,0,9540,0,9540
430540,201810,74,50,24,47700,22896,70596
430543,201810,371,118,253,112572,241362,353934
430544,201810,42,40,2,38160,1908,40068
430545,201810,353,173,180,164526.92,171475.78,336002.70
430550,201810,42,35,7,33390,6678,40068
430558,201810,5,3,2,2862,1908,4770
430560,201810,53,25,28,23850,26712,50562
430570,201810,106,44,62,41976,59090.76,101066.76
430580,201810,124,100,24,95400,21942.8,117342.8
430583,201810,14,14,0,13356,0,13356
430585,201810,9,4,5,3816,4770,8586
430587,201810,15,7,8,6678,7632,14310
430590,201810,152,124,28,117055.8,26712,143767.8
430593,201810,3,3,0,2862,0,2862
430595,201810,18,14,4,13356,3816,17172
430597,201810,54,29,25,27666,23850,51516
430600,201810,221,156,65,148814.46,61723.8,210538.26
430605,201810,161,101,60,96354,56562.66,152916.66
430607,201810,28,23,5,21942,4770,26712
430610,201810,1625,765,860,727225.36,815814.04,1543039.40
430613,201810,3,3,0,2862,0,2862
430620,201810,117,85,32,81090,30518.46,111608.46
430630,201810,47,41,6,39114,5724,44838
430632,201810,33,28,5,26712,4770,31482
430635,201810,42,37,5,35298,4770,40068
430637,201810,57,32,25,30528,23850,54378
430640,201810,201,112,89,105417,84906,190323
430642,201810,24,22,2,20988,1908,22896
430645,201810,36,29,7,27666,6678,34344
430650,201810,258,208,50,198146,47652.3,245798.3
430655,201810,4,4,0,3816,0,3816
430660,201810,968,477,491,453483.9,466410.8,919894.7
430670,201810,72,51,21,48654,20034,68688
430673,201810,71,38,33,36252,31482,67734
430675,201810,14,11,3,10494,2862,13356
430676,201810,505,312,193,296933.12,184051.07,480984.19
430680,201810,246,174,72,163802,68401.8,232203.8
430690,201810,535,325,210,308858.24,198665.06,507523.30
430692,201810,7,5,2,4770,1908,6678
430693,201810,144,98,46,93492,43874.46,137366.46
430695,201810,76,64,12,60121.08,11448,71569.08
430697,201810,59,38,21,36252,20034,56286
430700,201810,1576,1103,473,1040721.78,451167.17,1491888.95
430705,201810,22,20,2,19080,1908,20988
430710,201810,256,168,88,160272,83952,244224
430720,201810,107,91,16,86623.2,15264,101887.2
430730,201810,124,106,18,100170,17172,117342
430740,201810,64,42,22,40068,20988,61056
430745,201810,36,29,7,27595,6678,34273
430750,201810,348,232,116,220384.64,109710,330094.64
430755,201810,83,49,34,46746,32436,79182
430760,201810,358,215,143,202439.72,136393.92,338833.64
430770,201810,1439,754,685,716407.2,648288.55,1364695.75
430780,201810,321,205,116,194588.72,110607.3,305196.02
430781,201810,30,25,5,23850,4770,28620
430783,201810,53,42,11,39750.13,10494,50244.13
430786,201810,6,3,3,2862,2862,5724
430790,201810,516,330,186,313548.12,177148.46,490696.58
430800,201810,157,130,27,123241.92,25758,148999.92
430805,201810,42,38,4,36252,3816,40068
430807,201810,41,25,16,23850,15264,39114
430810,201810,77,51,26,48654,24804,73458
430820,201810,137,84,53,80136,49894.2,130030.2
430825,201810,12,10,2,9540,1908,11448
430830,201810,230,215,15,204480.45,14310,218790.45
430840,201810,127,85,42,81090,39209.4,120299.4
430843,201810,5,3,2,2862,1908,4770
430845,201810,70,39,31,37206,29574,66780
430850,201810,578,405,173,384032.7,164938.76,548971.46
430860,201810,166,104,62,98548.2,58470.66,157018.86
430865,201810,73,42,31,39400.2,29259.18,68659.38
430870,201810,83,67,16,63250.2,15264,78514.2
430880,201810,158,119,39,113506.92,37206,150712.92
430885,201810,7,6,1,5724,954,6678
430890,201810,340,209,131,197726.04,124974,322700.04
430900,201810,541,377,164,355431.78,155979,511410.78
430905,201810,105,44,61,41976,58194,100170
430910,201810,270,151,119,144054,112850,256904
430912,201810,5,5,0,4770,0,4770
430915,201810,34,28,6,26712,5724,32436
430920,201810,4253,2368,1885,2251988.23,1796316.92,4048305.15
430925,201810,6,5,1,4521.96,954,5475.96
430930,201810,2100,1243,857,1178782.66,817317.97,1996100.63
430940,201810,259,163,96,154824.66,91564.92,246389.58
430950,201810,150,120,30,114480,28620,143100
430955,201810,23,14,9,13356,8586,21942
430957,201810,18,17,1,16218,954,17172
430960,201810,245,162,83,151439.24,78514.2,229953.44
430965,201810,108,68,40,64872,38160,103032
430970,201810,83,69,14,65826,12402,78228
430975,201810,36,33,3,31482,2862,34344
430980,201810,46,29,17,27666,16218,43884
430990,201810,119,90,29,85860,27666,113526
430995,201810,117,112,5,105607.8,4770,110377.8
431000,201810,304,136,168,127597.2,160272,287869.2
431010,201810,341,204,137,194043.6,130678.92,324722.52
431020,201810,1954,1144,810,1083291.42,767931.84,1851223.26
431030,201810,41,32,9,30528,8586,39114
431033,201810,389,197,192,187127.2,183168,370295.2
431036,201810,14,9,5,8586,4770,13356
431040,201810,129,77,52,72504,48830.49,121334.49
431041,201810,41,29,12,27666,11448,39114
431043,201810,49,28,21,26712,20034,46746
431046,201810,11,6,5,5724,4770,10494
431050,201810,202,130,72,123447.6,68688,192135.6
431053,201810,78,47,31,44074.8,29574,73648.8
431055,201810,62,42,20,40068,19060.92,59128.92
431057,201810,16,16,0,15264,0,15264
431060,201810,1663,1055,608,995814.85,578180.44,1573995.29
431065,201810,19,11,8,10494,7632,18126
431070,201810,70,65,5,62010,4770,66780
431075,201810,7,7,0,6678,0,6678
431080,201810,140,87,53,82425.6,50562,132987.6
431085,201810,32,29,3,27666,2862,30528
431087,201810,13,11,2,10494,1908,12402
431090,201810,55,43,12,41022,11448,52470
431100,201810,1227,730,497,685643.02,474138,1159781.02
431110,201810,247,156,91,148824,86518.46,235342.46
431112,201810,28,17,11,16218,10494,26712
431113,201810,34,24,10,22896,9540,32436
431115,201810,159,111,48,105257.87,45782.46,151040.33
431120,201810,601,360,241,341504.18,228903.72,570407.90
431123,201810,4,3,1,2862,954,3816
431125,201810,99,88,11,83952,10494,94446
431127,201810,9,4,5,3816,4770,8586
431130,201810,675,434,241,412318.8,229608.72,641927.52
431140,201810,744,511,233,486254,222205.68,708459.68
431142,201810,36,28,8,25500,7632,33132
431150,201810,200,148,52,141192,49598.46,190790.46
431160,201810,56,50,6,47700,5724,53424
431162,201810,19,14,5,13356,4770,18126
431164,201810,5,5,0,4770,0,4770
431170,201810,105,86,19,82044,18126,100170
431171,201810,61,35,26,33151.5,24794.46,57945.96
431173,201810,2,1,1,954,954,1908
431175,201810,204,103,101,97022,96344.46,193366.46
431177,201810,76,57,19,54378,17439.92,71817.92
431179,201810,14,12,2,11448,1908,13356
431180,201810,448,277,171,263542.5,163115.46,426657.96
431190,201810,87,66,21,62964,20034,82998
431198,201810,68,47,21,44838,20034,64872
431200,201810,20,16,4,15264,3816,19080
431205,201810,24,24,0,22896,0,22896
431210,201810,86,52,34,49608,32436,82044
431213,201810,30,25,5,23850,4770,28620
431215,201810,26,23,3,21942,2862,24804
431217,201810,6,5,1,4770,954,5724
431220,201810,68,58,10,55332,9540,64872
431225,201810,152,100,52,95391,49588.92,144979.92
431230,201810,98,86,12,82044,11448,93492
431235,201810,8,8,0,7632,0,7632
431237,201810,25,17,8,16218,7632,23850
431238,201810,10,7,3,6392,2862,9254
431240,201810,1002,653,349,621274.02,332621.64,953895.66
431242,201810,38,37,1,35298,954,36252
431244,201810,11,8,3,7632,2862,10494
431245,201810,55,41,14,39114,13356,52470
431247,201810,12,10,2,9540,1908,11448
431250,201810,276,146,130,139217.22,124000.92,263218.14
431260,201810,61,46,15,43884,14310,58194
431261,201810,20,14,6,13356,5724,19080
431262,201810,16,16,0,15264,0,15264
431265,201810,159,85,74,81090,70596,151686
431267,201810,13,12,1,11448,954,12402
431270,201810,320,264,56,251856,53424,305280
431275,201810,40,37,3,35298,2862,38160
431280,201810,18,14,4,12521.25,3816,16337.25
431290,201810,24,19,5,18126,4770,22896
431295,201810,4,4,0,3816,0,3816
431300,201810,23,20,3,19080,2862,21942
431301,201810,7,7,0,6678,0,6678
431303,201810,53,35,18,33265.98,16885.8,50151.78
431306,201810,227,118,109,112402.18,103986,216388.18
431308,201810,7,5,2,4770,1908,6678
431310,201810,66,57,9,54378,8586,62964
431320,201810,127,77,50,73438.92,47404.26,120843.18
431330,201810,169,113,56,107802,53424,161226
431333,201810,32,26,6,24804,5724,30528
431335,201810,9,4,5,3816,4770,8586
431337,201810,328,152,176,144321.2,166864.14,311185.34
431339,201810,23,20,3,19080,2862,21942
431340,201810,3021,1747,1274,1661526.43,1212631.76,2874158.19
431342,201810,38,22,16,20988,15264,36252
431344,201810,18,18,0,17172,0,17172
431346,201810,4,4,0,3816,0,3816
431349,201810,35,32,3,30528,2862,33390
431350,201810,912,539,373,510897.86,354182.04,865079.90
431360,201810,50,44,6,41976,5724,47700
431365,201810,318,151,167,144034.92,158354.46,302389.38
431370,201810,1332,791,541,752096.11,515946.06,1268042.17
431380,201810,97,83,14,79182,13356,92538
431390,201810,512,282,230,267358.5,219172.28,486530.78
431395,201810,293,131,162,124974,154529,279503
431400,201810,40,30,10,28620,9540,38160
431402,201810,105,73,32,69642,30528,100170
431403,201810,22,14,8,13356,7632,20988
431405,201810,644,350,294,331973.82,280449,612422.82
431406,201810,31,27,4,25758,3816,29574
431407,201810,51,41,10,39114,9540,48654
431410,201810,3369,2051,1318,1942791.69,1252860.46,3195652.15
431413,201810,16,13,3,12402,2862,15264
431415,201810,72,53,19,50562,18126,68688
431417,201810,23,12,11,11448,10494,21942
431420,201810,309,220,89,209243.96,84906,294149.96
431430,201810,45,20,25,19080,23850,42930
431440,201810,8971,6384,2587,6026787.1,2460286.21,8487073.31
431442,201810,28,15,13,14310,12402,26712
431445,201810,26,21,5,20034,4770,24804
431446,201810,8,7,1,6678,954,7632
431447,201810,85,61,24,58194,22896,81090
431449,201810,52,45,7,42930,6678,49608
431450,201810,414,282,132,268741.8,125212.5,393954.3
431454,201810,0,0,0,0,0,0
431455,201810,50,39,11,37206,10494,47700
431460,201810,523,362,161,343296.9,153307.8,496604.7
431470,201810,120,93,27,88722,25508,114230
431475,201810,11,10,1,9540,954,10494
431477,201810,36,24,12,22896,11448,34344
431478,201810,8,7,1,6678,954,7632
431480,201810,503,315,188,298945.44,179285.22,478230.66
431490,201810,28106,16090,12016,15276933.81,11428674.69,26705608.50
431500,201810,79,56,23,53185.5,21942,75127.5
431505,201810,36,21,15,20034,14310,34344
431507,201810,12,10,2,9540,1908,11448
431510,201810,270,183,87,173199,82015.38,255214.38
431513,201810,22,18,4,17172,3816,20988
431514,201810,9,8,1,7632,954,8586
431515,201810,80,67,13,63918,12402,76320
431517,201810,5,3,2,2862,1908,4770
431520,201810,37,33,4,31482,3816,35298
431530,201810,1585,718,867,684304.44,826694.09,1510998.53
431531,201810,24,22,2,20988,1908,22896
431532,201810,26,18,8,17172,7632,24804
431535,201810,25,16,9,15264,8586,23850
431540,201810,141,125,16,118610.82,15264,133874.82
431545,201810,16,14,2,13356,1908,15264
431550,201810,358,202,156,192421.8,148728.6,341150.4
431555,201810,13,12,1,11448,954,12402
431560,201810,4506,3186,1320,3008300.54,1257010.38,4265310.92
431570,201810,812,437,375,412510.2,355832.46,768342.66
431575,201810,35,24,11,22896,10494,33390
431580,201810,97,70,27,65826,25758,91584
431590,201810,140,118,22,111618,20988,132606
431595,201810,11,10,1,9540,954,10494
431600,201810,217,123,94,117322.92,89676,206998.92
431610,201810,126,93,33,87481.8,31482,118963.8
431620,201810,43,35,8,33390,7632,41022
431630,201810,139,117,22,111618,20988,132606
431640,201810,1350,847,503,801360.62,477572.68,1278933.30
431642,201810,39,36,3,33867,2862,36729
431643,201810,46,20,26,19080,24804,43884
431645,201810,300,175,125,166950,118963.8,285913.8
431647,201810,9,9,0,8586,0,8586
431650,201810,37,27,10,25758,9540,35298
431660,201810,297,186,111,176490,105894,282384
431670,201810,228,109,119,101362.5,113497.38,214859.88
431673,201810,4,3,1,2862,954,3816
431675,201810,30,25,5,23563.8,4770,28333.8
431680,201810,1130,819,311,776842.2,295378.22,1072220.42
431690,201810,4798,2930,1868,2770096.58,1776830.48,4546927.06
431695,201810,24,19,5,18126,4770,22896
431697,201810,0,0,0,0,0,0
431700,201810,176,135,41,128790,39114,167904
431710,201810,4025,1753,2272,1669110.4,2166988.4,3836098.8
431720,201810,1380,835,545,787891.02,518962.46,1306853.48
431725,201810,1,1,0,954,0,954
431730,201810,1206,820,386,774346.32,368244,1142590.32
431740,201810,1361,682,679,646106.12,645698.72,1291804.84
431750,201810,1881,1226,655,1160280.7,622933.92,1783214.62
431755,201810,6,5,1,4770,954,5724
431760,201810,1039,675,364,643568.4,347027.58,990595.98
431770,201810,395,292,103,276936.66,97603.74,374540.40
431775,201810,29,21,8,20034,7632,27666
431780,201810,567,354,213,336886.02,203192.46,540078.48
431790,201810,161,122,39,115434,37158.3,152592.3
431795,201810,13,12,1,11448,954,12402
431800,201810,3379,1782,1597,1685305.36,1518474.7,3203780.06
431805,201810,17,15,2,14310,1908,16218
431810,201810,611,410,201,388526.04,191611.44,580137.48
431820,201810,321,184,137,175536,130698,306234
431830,201810,2335,1421,914,1352013.57,870724.27,2222737.84
431840,201810,509,340,169,321022.6,160940,481962.6
431842,201810,34,28,6,26712,5724,32436
431843,201810,12,9,3,8586,2862,11448
431844,201810,15,13,2,12402,1908,14310
431845,201810,30,27,3,25758,2862,28620
431846,201810,27,22,5,20988,4770,25758
431848,201810,15,13,2,12402,1908,14310
431849,201810,9,7,2,6678,1908,8586
431850,201810,815,670,145,637667.31,138091.5,775758.81
431860,201810,107,76,31,72504,28620,101124
431861,201810,3,2,1,1908,954,2862
431862,201810,51,32,19,30528,18126,48654
431870,201810,3425,2036,1389,1933228.22,1321732.08,3254960.30
431880,201810,953,700,253,662048,240408,902456
431890,201810,1318,822,496,777626.04,470975.98,1248602.02
431900,201810,178,125,53,119250,49770.18,169020.18
431910,201810,56,42,14,40068,13356,53424
431912,201810,38,21,17,20014.92,16027.2,36042.12
431915,201810,130,104,26,99216,24804,124020
431920,201810,149,110,39,104653.8,37206,141859.8
431930,201810,84,69,15,65110.5,14310,79420.5
431935,201810,3,3,0,2862,0,2862
431936,201810,15,14,1,13356,954,14310
431937,201810,17,12,5,11448,4770,16218
431940,201810,467,314,153,297457.2,144998.96,442456.16
431950,201810,497,318,179,301178.54,170614.44,471792.98
431960,201810,732,421,311,397734.22,296542.44,694276.66
431970,201810,72,64,8,61056,7632,68688
431971,201810,3,3,0,2862,0,2862
431973,201810,22,17,5,16218,4770,20988
431975,201810,7,6,1,5724,954,6678
431980,201810,202,126,76,119106.9,72504,191610.9
431990,201810,1215,655,560,623396.99,534194,1157590.99
432000,201810,1673,915,758,864919.16,720501.16,1585420.32
432010,201810,283,186,97,176146.56,92538,268684.56
432020,201810,169,138,31,131652,29574,161226
432023,201810,17,14,3,13356,2862,16218
432026,201810,66,60,6,57240,5724,62964
432030,201810,65,29,36,27666,34344,62010
432032,201810,20,17,3,16218,2862,19080
432035,201810,53,42,11,40068,10494,50562
432040,201810,106,74,32,70596,30528,101124
432045,201810,8,7,1,6678,954,7632
432050,201810,75,44,31,41976,29574,71550
432055,201810,107,79,28,75366,26712,102078
432057,201810,1,0,1,0,954,954
432060,201810,36,33,3,31482,2862,34344
432065,201810,31,27,4,25758,3816,29574
432067,201810,87,78,9,74392.92,8586,82978.92
432070,201810,414,313,101,296152.07,96325.92,392477.99
432080,201810,820,571,249,543035.88,237498.38,780534.26
432085,201810,17,12,5,11448,4770,16218
432090,201810,264,165,99,157410,94446,251856
432100,201810,176,118,58,112285.8,55332,167617.8
432110,201810,611,421,190,391199.04,180306,571505.04
432120,201810,946,573,373,546642,355737.06,902379.06
432130,201810,510,375,135,356414.4,127692.9,484107.3
432132,201810,24,21,3,20034,2862,22896
432135,201810,80,65,15,62010,14310,76320
432140,201810,266,212,54,201952.26,51516,253468.26
432143,201810,193,121,72,115434,68688,184122
432145,201810,274,190,84,180020.6,79849.8,259870.4
432146,201810,15,14,1,13356,954,14310
432147,201810,130,62,68,59148,64848.15,123996.15
432149,201810,14,11,3,10494,2862,13356
432150,201810,838,520,318,495831.96,301636.37,797468.33
432160,201810,1403,728,675,692138.08,643025.36,1335163.44
432162,201810,4,3,1,2862,954,3816
432163,201810,18,14,4,13356,3816,17172
432166,201810,121,91,30,87292,28620,115912
432170,201810,227,121,106,114480.8,101124,215604.8
432180,201810,543,336,207,316537.2,197192,513729.2
432183,201810,8,7,1,6678,954,7632
432185,201810,81,71,10,67734,9540,77274
432190,201810,461,261,200,248602.86,190695.6,439298.46
432195,201810,87,75,12,70834.5,11448,82282.5
432200,201810,413,267,146,254718,139236.84,393954.84
432210,201810,121,77,44,71693.1,41976,113669.1
432215,201810,57,53,4,50562,3816,54378
432218,201810,20,19,1,18126,954,19080
432220,201810,684,352,332,334778.48,316230.28,651008.76
432225,201810,13,7,6,6678,5724,12402
432230,201810,146,92,54,87529.5,51516,139045.5
432232,201810,14,12,2,11448,1908,13356
432234,201810,4,3,1,2862,954,3816
432235,201810,2,2,0,1908,0,1908
432237,201810,30,17,13,16218,12402,28620
432240,201810,4306,2418,1888,2295754.94,1794628.46,4090383.40
432250,201810,1063,682,381,647241.8,363311.82,1010553.62
432252,201810,43,37,6,34821,5724,40545
432253,201810,59,47,12,44838,11448,56286
432254,201810,24,11,13,10494,12402,22896
432255,201810,14,13,1,12402,954,13356
432260,201810,881,696,185,662258.26,175536,837794.26
432270,201810,239,172,67,164088,63908.46,227996.46
432280,201810,129,96,33,91107.8,31482,122589.8
432285,201810,1,1,0,954,0,954
432290,201810,69,62,7,57240,6678,63918
432300,201810,4579,2638,1941,2497346.15,1847681.28,4345027.43
432310,201810,116,97,19,92394.9,18126,110520.9
432320,201810,19,16,3,15264,2862,18126
432330,201810,18,13,5,12402,4770,17172
432335,201810,7,6,1,5724,954,6678
432340,201810,40,36,4,34344,3816,38160
432345,201810,97,68,29,64872,27666,92538
432350,201810,22,21,1,20034,954,20988
432360,201810,6,4,2,3816,1908,5724
432370,201810,25,25,0,23850,0,23850
432375,201810,35,32,3,30528,2862,33390
432377,201810,8,8,0,7632,0,7632
432380,201810,169,77,92,72790.2,87720.3,160510.5
500020,201810,250,142,108,135468,102430.98,237898.98
500025,201810,118,58,60,54378,57240,111618
500060,201810,1470,908,562,865659.6,534579.61,1400239.21
500070,201810,786,372,414,354537,394956,749493
500080,201810,134,105,29,100170,27666,127836
500085,201810,137,110,27,104367.8,24923.25,129291.05
500090,201810,330,161,169,153594,161226,314820
500100,201810,739,391,348,370820.13,331420,702240.13
500110,201810,2240,1026,1214,978449.38,1156819.07,2135268.45
500124,201810,269,156,113,148824,107515.8,256339.8
500150,201810,329,134,195,127827,185660.46,313487.46
500190,201810,529,364,165,346588.2,156924,503512.2
500200,201810,198,168,30,159929,28620,188549
500210,201810,1449,523,926,498727.39,882128.37,1380855.76
500215,201810,240,138,102,130698.42,97308,228006.42
500220,201810,780,503,277,478378.34,264248.46,742626.80
500230,201810,259,175,84,166234.5,79659,245893.5
500240,201810,698,483,215,460018.8,204823.8,664842.6
500260,201810,593,225,368,214650,351072,565722
500270,201810,28903,12355,16548,11755667.8,15769332.62,27525000.42
500280,201810,192,71,121,67734,115434,183168
500290,201810,1200,715,485,681157,462681,1143838
500295,201810,419,260,159,248040,151676.46,399716.46
500310,201810,60,19,41,18126,39114,57240
500315,201810,729,433,296,413072.46,282374.46,695446.92
500320,201810,3651,1842,1809,1753888.31,1724405.94,3478294.25
500325,201810,921,508,413,484155,392762.44,876917.44
500330,201810,1487,690,797,655838.28,760004.64,1415842.92
500345,201810,324,247,77,234675.2,73458,308133.2
500348,201810,244,146,98,139284,93473.46,232757.46
500350,201810,133,66,67,62964,63918,126882
500370,201810,5440,2444,2996,2324844.69,2855909.38,5180754.07
500375,201810,355,259,96,247076.46,91584,338660.46
500380,201810,603,345,258,329130,246122.46,575252.46
500390,201810,71,35,36,33390,34344,67734
500400,201810,213,147,66,140218.92,62955,203173.92
500410,201810,558,220,338,209806.15,322308.22,532114.37
500430,201810,540,379,161,361566,153594,515160
500440,201810,203,103,100,97393.75,95400,192793.75
500450,201810,405,173,232,164336.8,221318.46,385655.26
500460,201810,305,155,150,147860.46,142804.26,290664.72
500470,201810,449,352,97,334650.26,91575,426225.26
500480,201810,112,66,46,62964,43884,106848
500490,201810,108,44,64,41971.23,61056,103027.23
500500,201810,1443,521,922,495037.98,879034.95,1374072.93
500510,201810,48,37,11,35298,10485,45783
500515,201810,108,75,33,71550,31369,102919
500520,201810,353,193,160,183073,152350,335423
500525,201810,88,51,37,48654,35011.8,83665.8
500540,201810,914,384,530,366269.76,504614.61,870884.37
500560,201810,892,506,386,480985.04,367929.38,848914.42
500568,201810,988,583,405,553606.2,386080,939686.2
500570,201810,1208,684,524,649066.04,497250.3,1146316.34
500580,201810,340,172,168,163792.26,160231,324023.26
500600,201810,312,163,149,154791.27,142128,296919.27
500620,201810,935,661,274,626485.64,261205.2,887690.84
500625,201810,79,67,12,63536.4,11448,74984.4
500627,201810,24,12,12,11448,11448,22896
500630,201810,1575,846,729,805739.66,695179.8,1500919.46
500635,201810,529,304,225,289596.24,214475.9,504072.14
500640,201810,430,227,203,213697.8,193643.46,407341.26
500660,201810,5522,2117,3405,2016184.7,3244431.52,5260616.22
500690,201810,581,206,375,196167.24,356091.71,552258.95
500710,201810,367,180,187,171434,178380,349814
500720,201810,970,575,395,546866.69,376820.46,923687.15
500730,201810,203,120,83,114480,79177.23,193657.23
500740,201810,850,373,477,354554.95,454774.98,809329.93
500750,201810,145,46,99,43884,94417.92,138301.92
500755,201810,126,90,36,85574,34344,119918
500769,201810,762,428,334,407690.27,318623,726313.27
500770,201810,426,225,201,214640.46,191744.46,406384.92
500780,201810,171,114,57,108470,54378,162848
500790,201810,1067,540,527,514083.25,502708.46,1016791.71
500793,201810,268,148,120,141192,114471,255663
500795,201810,176,128,48,122102.46,45783,167885.46
500797,201810,45,33,12,31482,11448,42930
500800,201810,412,181,231,172665,220374,393039
500830,201810,2249,1250,999,1190088.12,952025.76,2142113.88
500840,201810,144,107,37,102078,35289,137367
510010,201810,168,95,73,90620.46,69613.38,160233.84
510020,201810,487,230,257,219126.06,244641.96,463768.02
510025,201810,1680,963,717,917813.05,681500.08,1599313.13
510030,201810,674,352,322,335761.92,306413.92,642175.84
510035,201810,132,60,72,57212.46,68669.46,125881.92
510040,201810,386,175,211,166950,200837.72,367787.72
510050,201810,419,230,189,218660.66,179482.46,398143.12
510060,201810,112,58,54,55322.46,51506.46,106828.92
510080,201810,225,92,133,87735.69,126768.06,214503.75
510100,201810,76,35,41,33390,39094.92,72484.92
510120,201810,39,24,15,22896,14310,37206
510125,201810,396,245,151,233047.89,144021.38,377069.27
510130,201810,575,332,243,316322.81,231122.52,547445.33
510140,201810,404,129,275,123057,262345.23,385402.23
510160,201810,93,42,51,40068,48650,88718
510170,201810,860,525,335,500537.97,318928.76,819466.73
510180,201810,2888,1395,1493,1327281.18,1422739.78,2750020.96
510185,201810,10,6,4,5724,3816,9540
510190,201810,220,75,145,71550,138325.23,209875.23
510250,201810,2597,1538,1059,1466183.53,1009144.1,2475327.63
510260,201810,199,143,56,136230.84,53387.46,189618.30
510263,201810,453,250,203,237518.46,193633.92,431152.38
510267,201810,670,374,296,355278.22,282113.45,637391.67
510268,201810,58,30,28,28620,26712,55332
510269,201810,70,33,37,31473,35298,66771
510270,201810,402,205,197,195400.98,187511.94,382912.92
510279,201810,228,168,60,160245,56934.92,217179.92
510285,201810,178,75,103,71531.46,98262,169793.46
510300,201810,523,293,230,279094.91,219345.84,498440.75
510305,201810,205,95,110,90607.46,104864.22,195471.68
510310,201810,109,56,53,53424,50552.46,103976.46
510320,201810,865,541,324,515546.18,308946.38,824492.56
510325,201810,413,164,249,156446.46,237259.8,393706.26
510330,201810,438,248,190,236579,181240.92,417819.92
510335,201810,603,334,269,318579.84,255952.47,574532.31
510336,201810,49,35,14,33390,13356,46746
510337,201810,117,49,68,46736.46,64862.46,111598.92
510340,201810,17260,8242,9018,7841718.43,8593489.04,16435207.47
510343,201810,69,49,20,46736.46,19080,65816.46
510345,201810,164,111,53,105884.46,50247.38,156131.84
510350,201810,672,371,301,353001.07,287089.38,640090.45
510360,201810,200,124,76,118287,72421.92,190708.92
510370,201810,141,73,68,69613.38,64759.14,134372.52
510380,201810,91,64,27,61056,25749,86805
510385,201810,57,27,30,25758,28611,54369
510390,201810,119,50,69,47700,65787.84,113487.84
510395,201810,45,34,11,32436,10494,42930
510410,201810,709,477,232,455054,221304.69,676358.69
510420,201810,577,279,298,265248.88,282853.45,548102.33
510450,201810,54,30,24,28620,22896,51516
510452,201810,42,25,17,23850,16218,40068
510454,201810,57,26,31,24804,29564.46,54368.46
510455,201810,126,78,48,74392.92,45792,120184.92
510460,201810,184,99,85,94265.92,81052.38,175318.30
510480,201810,744,435,309,413873.35,294448.36,708321.71
510490,201810,353,181,172,172323.34,163611.7,335935.04
510500,201810,250,191,59,182204.46,56286,238490.46
510510,201810,803,462,341,440148.26,325285.38,765433.64
510515,201810,1156,612,544,583488.38,518929.38,1102417.76
510517,201810,252,105,147,99883.8,140214.69,240098.49
510520,201810,237,156,81,148721.22,77180.84,225902.06
510523,201810,93,66,27,62964,25748.46,88712.46
510525,201810,743,427,316,406603.84,301361.76,707965.60
510530,201810,17,13,4,12402,3816,16218
510550,201810,266,117,149,111609,142137,253746
510558,201810,280,140,140,133527.15,133540.92,267068.07
510560,201810,406,241,165,229628,157392,387020
510562,201810,636,451,185,428923.17,176003.46,604926.63
510590,201810,803,419,384,399669.84,366308.69,765978.53
510600,201810,259,143,116,136402.92,110626.92,247029.84
510610,201810,169,81,88,77254.92,83656.46,160911.38
510615,201810,195,81,114,77254.92,108756,186010.92
510617,201810,19,11,8,10494,7632,18126
510618,201810,118,56,62,53424,58671,112095
510619,201810,101,71,30,67725,28611,96336
510620,201810,180,98,82,93482.46,78228,171710.46
510621,201810,196,125,71,119231.46,67706.46,186937.92
510622,201810,470,301,169,287061.84,161197.92,448259.76
510623,201810,346,235,111,224143.38,105865.38,330008.76
510624,201810,92,45,47,42921,44838,87759
510625,201810,539,328,211,312720.3,200707.52,513427.82
510626,201810,113,70,43,66780,41022,107802
510627,201810,60,44,16,41976,15264,57240
510628,201810,159,95,64,90592.92,60998.76,151591.68
510629,201810,254,164,90,156456,84886.92,241342.92
510630,201810,458,237,221,226013.76,210487.95,436501.71
510631,201810,10,3,7,2862,6392,9254
510637,201810,344,197,147,187601.72,140100.84,327702.56
510642,201810,968,540,428,514818.18,408169.44,922987.62
510645,201810,0,0,0,0,0,0
510650,201810,1467,976,491,930196.72,468291.76,1398488.48
510665,201810,81,43,38,40966,36252,77218
510670,201810,65,37,28,35298,26712,62010
510675,201810,1160,709,451,676354.23,430231.23,1106585.46
510677,201810,355,177,178,167861.84,169691.76,337553.60
510680,201810,105,60,45,57222,42921,100143
510682,201810,199,100,99,95078,94446,189524
510685,201810,52,39,13,37206,12402,49608
510700,201810,615,362,253,345229.92,241228.76,586458.68
510704,201810,1094,593,501,563243.16,476314.82,1039557.98
510706,201810,125,64,61,61051.23,58156.92,119208.15
510710,201810,398,267,131,253747.24,124859.68,378606.92
510715,201810,63,47,16,44828.46,15264,60092.46
510718,201810,208,115,93,109616.76,88712.46,198329.22
510719,201810,36,19,17,18126,16218,34344
510720,201810,196,132,64,125919,60769.8,186688.8
510724,201810,89,34,55,32426.46,52437.38,84863.84
510726,201810,55,28,27,26702.46,25740,52442.46
510729,201810,72,32,40,30528,38121.84,68649.84
510730,201810,478,271,207,258516,197340,455856
510735,201810,109,44,65,41976,62010,103986
510740,201810,29,16,13,15264,12402,27666
510757,201810,20,16,4,15264,3816,19080
510760,201810,7073,3734,3339,3552095.13,3180437.03,6732532.16
510770,201810,718,339,379,323208.3,361399.3,684607.6
510774,201810,16,6,10,5724,9540,15264
510775,201810,116,88,28,83942.46,26702.46,110644.92
510776,201810,29,7,22,6678,20988,27666
510777,201810,186,83,103,79153.38,98233.38,177386.76
510779,201810,48,22,26,20979,24766.92,45745.92
510780,201810,293,164,129,156393.46,123001,279394.46
510785,201810,434,233,201,222234.84,191687.22,413922.06
510787,201810,190,94,96,89667,91566.23,181233.23
510788,201810,0,0,0,0,0,0
510790,201810,2389,1262,1127,1202088.94,1073178.36,2275267.30
510792,201810,1100,634,466,604072.55,444139.34,1048211.89
510794,201810,119,60,59,57240,56257.92,113497.92
510795,201810,2375,1380,995,1308315.87,946547.8,2254863.67
510800,201810,183,115,68,109155.46,64863,174018.46
510805,201810,172,116,56,110664,53424,164088
510810,201810,98,40,58,38067.84,55207.98,93275.82
510820,201810,259,121,138,115007.46,130652.03,245659.49
510830,201810,68,41,27,39114,25749,64863
510835,201810,10,8,2,7632,1908,9540
510840,201810,9239,4555,4684,4331927.23,4460914,8792841.23
510850,201810,210,86,124,82034.46,118258.38,200292.84
510860,201810,392,173,219,164864.52,208264.42,373128.94
510880,201810,64,49,15,46727.46,14310,61037.46
510885,201810,73,44,29,41957.46,27637.38,69594.84
510890,201810,71,41,30,39114,28620,67734
510895,201810,181,106,75,101124,71241.46,172365.46
520005,201810,40,28,12,26712,11448,38160
520010,201810,276,125,151,119250,143959,263209
520013,201810,662,408,254,389204,242029.8,631233.8
520015,201810,52,38,14,36252,13356,49608
520017,201810,96,55,41,52184,39114,91298
520020,201810,23,13,10,12402,9540,21942
520025,201810,2023,1101,922,1049443.44,878729.4,1928172.84
520030,201810,811,419,392,398763,373347.9,772110.9
520050,201810,77,52,25,49608,23850,73458
520055,201810,46,30,16,28620,15264,43884
520060,201810,191,128,63,122112,60102,182214
520080,201810,592,420,172,400680,164088,564768
520082,201810,20,14,6,13356,5724,19080
520085,201810,101,74,27,70596,25758,96354
520090,201810,91,62,29,59148,27666,86814
520110,201810,9151,3991,5160,3801532.76,4919982.64,8721515.40
520120,201810,14,8,6,7431.66,5724,13155.66
520130,201810,776,543,233,517726.8,221843.9,739570.7
520140,201810,11773,6655,5118,6341617.94,4880314.77,11221932.71
520145,201810,45,33,12,31482,11448,42930
520150,201810,190,147,43,140238,41022,181260
520160,201810,32,24,8,22896,7632,30528
520170,201810,242,149,93,142114,88685,230799
520180,201810,140,74,66,70596,62964,133560
520215,201810,216,139,77,132319.8,73171.8,205491.6
520235,201810,70,52,18,49608,17172,66780
520250,201810,131,80,51,76320,48367.8,124687.8
520260,201810,113,70,43,66780,40068,106848
520280,201810,46,32,14,29861,13356,43217
520310,201810,38,26,12,24804,11448,36252
520320,201810,168,107,61,102068.46,58194,160262.46
520330,201810,788,415,373,395864.46,355833,751697.46
520340,201810,349,197,152,187938,144989.46,332927.46
520350,201810,528,242,286,230868,272797,503665
520355,201810,87,52,35,49608,33390,82998
520357,201810,24,17,7,16218,6678,22896
520360,201810,1,1,0,954,0,954
520380,201810,143,74,69,70596,65826,136422
520390,201810,276,119,157,113049,149768.46,262817.46
520393,201810,16,12,4,11448,3816,15264
520396,201810,99,60,39,57240,37206,94446
520400,201810,218,128,90,120491.2,85860,206351.2
520410,201810,197,100,97,95391,92529,187920
520420,201810,23,16,7,15264,6678,21942
520425,201810,316,143,173,136422,164566.2,300988.2
520430,201810,464,241,223,229627.8,212686,442313.8
520440,201810,612,416,196,396864,186964.92,583828.92
520450,201810,1931,872,1059,831059.46,1009649.52,1840708.98
520455,201810,59,42,17,40068,16218,56286
520460,201810,32,16,16,15264,15264,30528
520465,201810,24,21,3,20034,2862,22896
520470,201810,420,261,159,248688.63,151686,400374.63
520480,201810,80,47,33,44838,31437,76275
520485,201810,124,44,80,41976,76034,118010
520490,201810,419,307,112,292693.98,106848,399541.98
520495,201810,171,104,67,99216,63918,163134
520500,201810,178,133,45,126882,42930,169812
520505,201810,175,91,84,86809.23,80136,166945.23
520510,201810,1761,873,888,830432.06,844877.4,1675309.46
520520,201810,36,29,7,27666,6678,34344
520530,201810,231,175,56,165226.12,53414.46,218640.58
520540,201810,527,356,171,338317.02,163134,501451.02
520545,201810,148,85,63,81090,60102,141192
520547,201810,53,31,22,29574,20988,50562
520549,201810,1160,569,591,542502,563687,1106189
520551,201810,293,152,141,145008,134228,279236
520552,201810,47,28,19,26712,18126,44838
520570,201810,16,9,7,8586,6678,15264
520580,201810,288,173,115,165032.46,109710,274742.46
520590,201810,161,98,63,93492,59815.8,153307.8
520620,201810,1163,549,614,522888.48,585460.26,1108348.74
520630,201810,42,25,17,23850,16218,40068
520640,201810,405,233,172,222282,164079,386361
520650,201810,62,41,21,39114,20034,59148
520660,201810,35,19,16,18117,15264,33381
520670,201810,35,30,5,28620,4770,33390
520680,201810,55,37,18,35298,17172,52470
520690,201810,32,10,22,9540,20959.92,30499.92
520710,201810,38,34,4,32436,3816,36252
520725,201810,194,125,69,119250,65826,185076
520735,201810,59,41,18,39114,17172,56286
520740,201810,413,204,209,193901.4,199377,393278.4
520750,201810,36,28,8,26712,7632,34344
520753,201810,57,39,18,37206,17172,54378
520760,201810,113,76,37,72504,35298,107802
520780,201810,294,220,74,209880,70577,280457
520790,201810,165,84,81,79849.8,77274,157123.8
520800,201810,3447,1848,1599,1760576.06,1524912,3285488.06
520810,201810,171,124,47,118296,44838,163134
520815,201810,5,5,0,4770,0,4770
520830,201810,149,105,44,100170,41689.8,141859.8
520840,201810,350,230,120,218943,114480,333423
520850,201810,110,72,38,68669.46,36099.36,104768.82
520860,201810,1698,1083,615,1031761.54,585566.2,1617327.74
520870,201810,31272,15346,15926,14613843.66,15177167.68,29791011.34
520880,201810,1091,597,494,568965.8,471256.92,1040222.72
520890,201810,795,465,330,441979.4,314715.46,756694.86
520910,201810,1022,542,480,512823.94,457920,970743.94
520915,201810,102,76,26,72504,24794.46,97298.46
520920,201810,407,200,207,190227.6,197468.46,387696.06
520929,201810,15,14,1,13356,954,14310
520940,201810,76,49,27,46746,25758,72504
520945,201810,20,12,8,11448,7632,19080
520960,201810,46,29,17,27666,16218,43884
520970,201810,323,201,122,190838.8,116101.8,306940.6
520980,201810,83,63,20,60102,19080,79182
520990,201810,476,322,154,307188,146916,454104
520993,201810,128,61,67,58194,63918,122112
520995,201810,240,136,104,128791,98644,227435
521000,201810,1585,932,653,887409.15,622580.8,1509989.95
521010,201810,665,310,355,295127.36,338603.76,633731.12
521015,201810,19,12,7,11448,6678,18126
521020,201810,1456,1021,435,973404.9,414628.22,1388033.12
521030,201810,47,34,13,32436,12402,44838
521040,201810,948,590,358,562622.2,341246,903868.2
521056,201810,41,29,12,27666,11448,39114
521060,201810,133,83,50,79182,47700,126882
521080,201810,464,347,117,331029,111618,442647
521090,201810,534,320,214,303753.6,204156,507909.6
521100,201810,277,207,70,197469,66780,264249
521120,201810,1060,743,317,708249.8,302122.8,1010372.6
521130,201810,366,262,104,249938.46,98330.6,348269.06
521140,201810,178,98,80,93492,76320,169812
521150,201810,2769,1209,1560,1151804.88,1486977.03,2638781.91
521160,201810,32,17,15,16218,14310,30528
521170,201810,198,116,82,110654.46,78228,188882.46
521180,201810,1143,722,421,687157.26,400919.2,1088076.46
521190,201810,2539,1078,1461,1028392.92,1393437.72,2421830.64
521200,201810,48,35,13,33390,12402,45792
521205,201810,12,9,3,8586,2862,11448
521210,201810,146,83,63,79182,60102,139284
521220,201810,825,567,258,539010.8,245503.6,784514.4
521225,201810,32,21,11,20034,10494,30528
521230,201810,111,74,37,70309.8,35298,105607.8
521250,201810,6232,3592,2640,3419566.1,2516253.26,5935819.36
521260,201810,23,15,8,14310,7632,21942
521270,201810,138,108,30,103032,28620,131652
521280,201810,437,260,177,246705.2,168858,415563.2
521290,201810,30,12,18,11448,17172,28620
521295,201810,98,66,32,62964,30528,93492
521300,201810,224,118,106,112554,100773.38,213327.38
521305,201810,34,23,11,21942,10494,32436
521308,201810,1099,814,285,775484.99,271595,1047079.99
521310,201810,1354,801,553,762105.8,526370.92,1288476.72
521340,201810,20,16,4,15264,3816,19080
521350,201810,134,100,34,95400,32436,127836
521370,201810,190,125,65,118963.8,61723.8,180687.6
521375,201810,186,103,83,98262,78895.8,177157.8
521377,201810,54,37,17,35298,16218,51516
521380,201810,1089,709,380,672207.22,362520,1034727.22
521385,201810,15,8,7,7632,6678,14310
521390,201810,105,84,21,79818.04,20034,99852.04
521400,201810,327,209,118,199099.8,112524.3,311624.1
521405,201810,149,80,69,76320,65826,142146
521410,201810,61,40,21,38160,20034,58194
521440,201810,201,146,55,138473.1,52470,190943.1
521450,201810,725,400,325,381600,310050,691650
521460,201810,1192,734,458,700236,436912.92,1137148.92
521470,201810,12,8,4,7632,3816,11448
521480,201810,44,29,15,27639,14245,41884
521483,201810,309,170,139,161894,132606,294500
521486,201810,287,182,105,173122.38,99503,272625.38
521487,201810,22,11,11,10494,10494,20988
521490,201810,26,15,11,14310,10494,24804
521500,201810,115,77,38,73458,36252,109710
521520,201810,41,29,12,27666,11448,39114
521523,201810,631,387,244,365881.32,232776,598657.32
521525,201810,46,30,16,28620,14977.8,43597.8
521530,201810,251,133,118,126882,112572,239454
521540,201810,30,16,14,15264,13356,28620
521550,201810,89,39,50,36882.92,47653.92,84536.84
521560,201810,803,549,254,523460,242173,765633
521565,201810,54,37,17,35298,16218,51516
521570,201810,500,336,164,320534.46,156361.3,476895.76
521580,201810,59,37,22,35298,20988,56286
521590,201810,39,21,18,20034,17172,37206
521600,201810,27,16,11,15264,10494,25758
521630,201810,242,126,116,120194.46,109673.96,229868.42
521640,201810,301,156,145,148824,138330,287154
521645,201810,29,16,13,15264,12402,27666
521680,201810,221,140,81,133560,77274,210834
521690,201810,2,2,0,1908,0,1908
521710,201810,1169,555,614,528897.8,585747,1114644.8
521720,201810,544,369,175,352016.46,166912.46,518928.92
521730,201810,636,304,332,289921,315621.56,605542.56
521740,201810,902,365,537,348177.92,511107.32,859285.24
521760,201810,1640,908,732,864654.63,698014,1562668.63
521770,201810,814,511,303,487494,288594.54,776088.54
521800,201810,2046,1283,763,1220430.48,726524.1,1946954.58
521805,201810,34,19,15,18126,14310,32436
521810,201810,91,59,32,55141.8,30528,85669.8
521830,201810,951,677,274,643951,261387,905338
521839,201810,87,57,30,54378,28620,82998
521850,201810,1111,589,522,560486.92,497672.68,1058159.60
521860,201810,359,225,134,214650,127550,342200
521870,201810,74,43,31,41022,29574,70596
521878,201810,42,20,22,19080,20988,40068
521880,201810,4614,2090,2524,1991590.36,2406100.96,4397691.32
521890,201810,583,414,169,394956,160939.8,555895.8
521900,201810,295,234,61,222599.96,58194,280793.96
521910,201810,150,104,46,99216,43884,143100
521920,201810,54,27,27,25758,25758,51516
521925,201810,35,21,14,20034,13356,33390
521930,201810,1119,641,478,611317.98,455377.88,1066695.86
521935,201810,35,27,8,25758,7632,33390
521940,201810,188,98,90,93492,85855.23,179347.23
521945,201810,15,13,2,12402,1908,14310
521950,201810,9,5,4,4770,3816,8586
521960,201810,76,57,19,54378,18126,72504
521970,201810,422,273,149,260155.8,142146,402301.8
521971,201810,94,47,47,44838,44838,89676
521973,201810,28,13,15,12402,14310,26712
521975,201810,1188,609,579,579745.16,551545.66,1131290.82
521980,201810,248,172,76,164088,72504,236592
521990,201810,72,53,19,50562,18126,68688
522000,201810,290,186,104,177444,99216,276660
522005,201810,19,11,8,10494,7632,18126
522010,201810,1148,647,501,617229,477381.6,1094610.6
522015,201810,57,36,21,34335,20034,54369
522020,201810,865,470,395,447426.2,376048.12,823474.32
522026,201810,28,20,8,19080,7632,26712
522028,201810,15,11,4,10494,3816,14310
522040,201810,753,296,457,282366,435923.46,718289.46
522045,201810,2226,1384,842,1319893.26,802448.6,2122341.86
522050,201810,164,79,85,75366,81090,156456
522060,201810,550,349,201,332659.8,191658.6,524318.4
522068,201810,131,88,43,83665.8,41022,124687.8
522070,201810,10,10,0,9540,0,9540
522100,201810,46,26,20,24804,19080,43884
522108,201810,41,31,10,29574,9540,39114
522119,201810,56,30,26,28620,24804,53424
522130,201810,74,27,47,25749,44820,70569
522140,201810,3833,1932,1901,1839277.5,1810741.98,3650019.48
522145,201810,53,34,19,32436,18126,50562
522150,201810,63,48,15,45792,14310,60102
522155,201810,54,36,18,34335,17172,51507
522157,201810,4,3,1,2862,954,3816
522160,201810,1730,1014,716,966211.2,683055,1649266.2
522170,201810,395,266,129,253764,123066,376830
522180,201810,38,20,18,19080,17172,36252
522185,201810,1972,777,1195,737951.26,1139499.46,1877450.72
522190,201810,47,27,20,25758,18984.6,44742.6
522200,201810,304,186,118,177444,112572,290016
522205,201810,164,112,52,106848,49608,156456
522220,201810,161,116,45,110664,42930,153594
522230,201810,31,26,5,24804,4770,29574
530010,201810,55465,28564,26901,27107647.21,25613325.51,52720972.72
110001,201811,519,413,106,393986.3,100470.03,494456.33
110002,201811,2798,1713,1085,1632585.47,1034155.01,2666740.48
110003,201811,93,76,17,72302.21,16218,88520.21
110004,201811,2002,1298,704,1236131.91,671316.19,1907448.10
110005,201811,442,358,84,340365.69,80132.43,420498.12
110006,201811,457,351,106,333796.31,101099.6,434895.91
110007,201811,81,65,16,62008.03,15263.7,77271.73
110008,201811,234,131,103,123870.35,98257.8,222128.15
110009,201811,819,571,248,542653.38,236367.89,779021.27
110010,201811,1803,1113,690,1060971.7,657926.33,1718898.03
110011,201811,1878,1455,423,1385876.26,403526.27,1789402.53
110012,201811,4178,2432,1746,2313995.17,1664512.42,3978507.59
110013,201811,769,591,178,563793.64,169141.46,732935.10
110014,201811,376,322,54,306132.71,51515.16,357647.87
110015,201811,1432,1156,276,1099741.86,263279.76,1363021.62
110018,201811,1131,687,444,655062.57,423538.75,1078601.32
110020,201811,15589,9153,6436,8687994.37,6131465.42,14819459.79
110025,201811,660,490,170,464496.67,162160.82,626657.49
110026,201811,41,28,13,26712,12402,39114
110028,201811,1635,1188,447,1129675.35,423401.6,1553076.95
110029,201811,138,124,14,118294.6,13356,131650.6
110030,201811,2465,1671,794,1591414.88,756531.97,2347946.85
110032,201811,402,318,84,303043.68,80121.27,383164.95
110033,201811,678,501,177,475693.71,168563.42,644257.13
110034,201811,372,274,98,259057.44,92811.39,351868.83
110037,201811,104,87,17,82997.27,16218,99215.27
110040,201811,353,240,113,228948.08,107796.88,336744.96
110045,201811,957,650,307,618531.77,291157.38,909689.15
110050,201811,93,80,13,76031.37,12402,88433.37
110060,201811,87,49,38,46745.91,36251.24,82997.15
110070,201811,118,72,46,68687.44,43595.03,112282.47
110080,201811,409,247,162,233121.7,154518.68,387640.38
110090,201811,34,28,6,26711.26,5723.03,32434.29
110092,201811,104,56,48,53422.6,45720.49,99143.09
110094,201811,195,140,55,133551.74,52469.35,186021.09
110100,201811,31,26,5,24803.59,4770,29573.59
110110,201811,66,40,26,38159.36,24803.33,62962.69
110120,201811,72,59,13,56285.61,12402,68687.61
110130,201811,303,248,55,235110.45,52468.13,287578.58
110140,201811,247,162,85,154354.5,81078.15,235432.65
110143,201811,50,41,9,39109.78,8585.07,47694.85
110145,201811,24,18,6,17171.56,5724,22895.56
110146,201811,24,12,12,11447.25,11447.69,22894.94
110147,201811,39,30,9,28619.93,8586,37205.93
110148,201811,40,28,12,26660.57,11448,38108.57
110149,201811,316,225,91,214354.53,86809.43,301163.96
110150,201811,89,62,27,59142.8,25757.06,84899.86
110155,201811,8,7,1,6678,954,7632
110160,201811,69,58,11,55329.5,10494,65823.5
110170,201811,204,162,42,154542.98,39778.58,194321.56
110175,201811,48,35,13,33385.84,12401.26,45787.10
110180,201811,94,82,12,78224.77,11447.36,89672.13
120001,201811,142,98,44,93468.9,41943.46,135412.36
120005,201811,192,121,71,115424.43,67730.96,183155.39
120010,201811,1035,669,366,634282.59,348860.03,983142.62
120013,201811,148,101,47,96325.7,44645.63,140971.33
120017,201811,94,57,37,54368.85,35279.05,89647.90
120020,201811,3618,2899,719,2740349.74,683502.84,3423852.58
120025,201811,578,329,249,311758.27,236612.04,548370.31
120030,201811,1057,890,167,841053.3,158586.18,999639.48
120032,201811,48,41,7,39114,6678,45792
120033,201811,220,192,28,182818.42,26710.98,209529.40
120034,201811,161,116,45,108752.85,42929.38,151682.23
120035,201811,35,26,9,24800.63,8586,33386.63
120038,201811,396,255,141,242504.3,134501.58,377005.88
120039,201811,21,20,1,19080,954,20034
120040,201811,14198,9838,4360,9313247.55,4146221,13459468.55
120042,201811,48,42,6,40066.3,5724,45790.3
120043,201811,11,3,8,2862,7632,10494
120045,201811,549,355,194,336068.42,184055.12,520123.54
120050,201811,1269,974,295,923175.08,281401.24,1204576.32
120060,201811,1435,1172,263,1113703.23,249870.51,1363573.74
120070,201811,503,361,142,340546.93,135279.78,475826.71
120080,201811,168,105,63,99671.09,59851.12,159522.21
130002,201811,149,104,45,99213.71,42929.47,142143.18
130006,201811,76,44,32,41975.57,30528,72503.57
130008,201811,144,77,67,72738.53,63237.99,135976.52
130010,201811,142,79,63,75342.47,60100.84,135443.31
130014,201811,250,181,69,172668.14,65822.45,238490.59
130020,201811,96,53,43,50558.34,41017.86,91576.20
130030,201811,921,552,369,526598.76,352000.25,878599.01
130040,201811,313,159,154,151683.64,145956.88,297640.52
130050,201811,578,314,264,299267.89,251853.66,551121.55
130060,201811,886,604,282,574182.88,268565.6,842748.48
130063,201811,579,325,254,310005.6,242238.01,552243.61
130068,201811,191,125,66,119248.03,62676.09,181924.12
130070,201811,1328,912,416,868963.5,396479.11,1265442.61
130080,201811,685,453,232,431772.6,221308.36,653080.96
130083,201811,73,41,32,38848.85,30528,69376.85
130090,201811,371,190,181,179580.19,172672.03,352252.22
130100,201811,1139,513,626,489396.41,596902.75,1086299.16
130110,201811,704,308,396,293826.27,377764.85,671591.12
130115,201811,176,72,104,68686.64,99212.65,167899.29
130120,201811,1639,1034,605,986403.34,577150.96,1563554.30
130130,201811,616,427,189,407332.38,180294.76,587627.14
130140,201811,1519,1140,379,1086924.1,360603.88,1447527.98
130150,201811,421,358,63,341530.39,60102,401632.39
130160,201811,468,267,201,254714.04,191752.99,446467.03
130165,201811,28,20,8,19080,7632,26712
130170,201811,970,700,270,667724.07,257579.55,925303.62
130180,201811,150,91,59,86813.73,56285.33,143099.06
130185,201811,2392,1193,1199,1136731.39,1143212.88,2279944.27
130190,201811,3590,2260,1330,2151494.87,1267502.92,3418997.79
130195,201811,287,230,57,219420,54378,273798
130200,201811,172,80,92,76309.75,87767.66,164077.41
130210,201811,77,39,38,37204.43,36251.24,73455.67
130220,201811,177,124,53,118296,50561.06,168857.06
130230,201811,332,208,124,198430.45,118295.9,316726.35
130240,201811,1423,904,519,861058.58,494825.62,1355884.20
130250,201811,4824,3124,1700,2973597.92,1621620.05,4595217.97
130255,201811,433,210,223,200337.33,212450.67,412788.00
130260,201811,54756,26477,28279,25220155.22,26970550.39,52190705.61
130270,201811,1598,1061,537,1010522.45,512276.33,1522798.78
130280,201811,120,74,46,70593.46,43882.62,114476.08
130290,201811,2113,1529,584,1457967.14,556829.9,2014797.04
130300,201811,431,310,121,295726.9,115426.84,411153.74
130310,201811,890,466,424,444562.68,404484.26,849046.94
130320,201811,460,246,214,233718.09,204147.2,437865.29
130330,201811,737,453,284,432150.95,270641.75,702792.70
130340,201811,3373,2005,1368,1908435.66,1303284.93,3211720.59
130350,201811,462,298,164,284290.94,156455.8,440746.74
130353,201811,832,349,483,332649.94,460769.44,793419.38
130356,201811,821,376,445,358682.53,424510.42,783192.95
130360,201811,66,41,25,39114,23848.92,62962.92
130370,201811,678,511,167,487489.69,159316.93,646806.62
130380,201811,610,422,188,402554.47,179349.09,581903.56
130390,201811,494,393,101,374920.3,96351.11,471271.41
130395,201811,179,39,140,37204.53,133554.25,170758.78
130400,201811,69,45,24,42929.1,22893.6,65822.7
130406,201811,2086,1294,792,1230843.92,754361.72,1985205.64
130410,201811,476,204,272,194614.95,259464.39,454079.34
130420,201811,3188,2581,607,2459140.01,579064.03,3038204.04
130423,201811,160,76,84,72503.8,80134.6,152638.4
130426,201811,154,88,66,83949.84,62961.5,146911.34
130430,201811,411,271,140,258529.31,133554.8,392084.11
130440,201811,201,68,133,64872,126878.99,191750.99
140002,201811,34,12,22,11448,20986.02,32434.02
140005,201811,205,128,77,121870.05,73455.39,195325.44
140010,201811,10544,7030,3514,6672061.05,3350020.84,10022081.89
140015,201811,149,66,83,62962.37,79180.33,142142.70
140017,201811,119,81,38,77272.01,36248.33,113520.34
140020,201811,470,315,155,299550.55,147866.1,447416.65
140023,201811,36,18,18,16947.42,17170.02,34117.44
140028,201811,19,12,7,11448,6678,18126
140030,201811,346,246,100,234678.91,94797.16,329476.07
140040,201811,57,39,18,37204.97,17075.48,54280.45
140045,201811,246,109,137,103985.59,130692.41,234678.00
140047,201811,624,430,194,408195.38,184320.53,592515.91
140050,201811,149,96,53,90765,50561,141326
140060,201811,41,30,11,27882.9,10494,38376.9
140070,201811,34,31,3,28819.38,2861.13,31680.51
150010,201811,4732,2960,1772,2821841.33,1688505.38,4510346.71
150013,201811,154,108,46,102740.46,43882.42,146622.88
150020,201811,1062,577,485,550442.77,462680.78,1013123.55
150030,201811,718,297,421,283335.48,401633.33,684968.81
150034,201811,198,128,70,122108.07,66776.47,188884.54
150040,201811,1419,854,565,814694.44,538996.49,1353690.93
150050,201811,666,390,276,371049.89,263099.14,634149.03
150060,201811,4760,3074,1686,2929355.62,1608146.95,4537502.57
150070,201811,316,143,173,136417.61,165033.11,301450.72
150080,201811,14336,7217,7119,6871936.28,6782965.11,13654901.39
150085,201811,390,247,143,235623.39,136413.92,372037.31
150090,201811,753,641,112,611507.51,106842.58,718350.09
150095,201811,346,214,132,204147.55,125104.62,329252.17
150100,201811,57,39,18,37203.36,17171.02,54374.38
150110,201811,170,84,86,80134.45,82042.28,162176.73
150120,201811,428,317,111,302410.53,105891.57,408302.10
150125,201811,54,23,31,21941.29,29572.96,51514.25
150130,201811,1940,1047,893,998054.28,851888.76,1849943.04
150140,201811,54399,25544,28855,24331600.88,27511584.07,51843184.95
150145,201811,186,105,81,100165.05,77271.79,177436.84
150150,201811,2826,1301,1525,1240916.31,1452156.21,2693072.52
150157,201811,421,299,122,285238.9,116381.19,401620.09
150160,201811,121,96,25,91581.2,23850,115431.2
150170,201811,3678,2736,942,2608910,898355.89,3507265.89
150172,201811,320,220,100,209873.24,95396.4,305269.64
150175,201811,84,50,34,47699.67,32434.63,80134.30
150178,201811,778,519,259,493868.11,247077.96,740946.07
150180,201811,3112,1519,1593,1448248.05,1519322.64,2967570.69
150190,201811,331,213,118,203200.9,112570.5,315771.4
150195,201811,122,62,60,59146.66,57240,116386.66
150200,201811,199,96,103,91583.34,98262,189845.34
150210,201811,3155,2558,597,2439220.39,568509.08,3007729.47
150215,201811,528,341,187,325305.57,178102.26,503407.83
150220,201811,3837,2608,1229,2486422.08,1168517.38,3654939.46
150230,201811,1155,935,220,891388.54,209877.02,1101265.56
150240,201811,5865,3460,2405,3297519.69,2294279.38,5591799.07
150250,201811,33,16,17,15263.66,16218,31481.66
150260,201811,79,48,31,45789.52,29571.95,75361.47
150270,201811,2367,1538,829,1466573.85,789961.59,2256535.44
150275,201811,562,348,214,331985.86,204153.4,536139.26
150276,201811,112,50,62,47698.67,59144.43,106843.10
150277,201811,765,330,435,314791.38,414978.81,729770.19
150280,201811,338,212,126,202244.53,120201.7,322446.23
150285,201811,83,42,41,40063.42,39113.2,79176.62
150290,201811,972,593,379,565414.27,361270.67,926684.94
150293,201811,661,313,348,298588.27,331991.23,630579.50
150295,201811,475,214,261,204150.74,248834.78,452985.52
150300,201811,77,40,37,38158.16,35297.16,73455.32
150304,201811,153,105,48,100163.79,45789.1,145952.89
150307,201811,389,323,66,308134.89,62963.08,371097.97
150309,201811,569,415,154,395877.6,145643,541520.6
150310,201811,253,171,82,163133.53,78226.63,241360.16
150320,201811,1771,1228,543,1171210.1,517775.72,1688985.82
150330,201811,2087,1207,880,1150786.34,839498.61,1990284.95
150340,201811,198,135,63,128540.31,60097.64,188637.95
150345,201811,614,334,280,318441.93,267108.93,585550.86
150350,201811,408,322,86,304790.65,82044,386834.65
150360,201811,4582,2949,1633,2809674.32,1557828.58,4367502.90
150370,201811,779,549,230,522993.82,219392.57,742386.39
150375,201811,195,103,92,98258.48,87764.25,186022.73
150380,201811,1383,941,442,897675.39,421659.48,1319334.87
150390,201811,742,429,313,409242.49,298592.46,707834.95
150400,201811,102,86,16,82042.89,15264,97306.89
150405,201811,1264,826,438,786903.93,417267.59,1204171.52
150410,201811,135,92,43,87764.87,41021.65,128786.52
150420,201811,7425,4096,3329,3906042.27,3173865.96,7079908.23
150430,201811,522,348,174,331980.94,165985.3,497966.24
150440,201811,578,344,234,327402.84,223234.19,550637.03
150442,201811,2207,1191,1016,1132099.17,968932.76,2101031.93
150445,201811,519,330,189,314814.1,179348.02,494162.12
150450,201811,258,127,131,121157.11,124972.38,246129.49
150460,201811,745,565,180,537179.56,171699.2,708878.76
150470,201811,1341,812,529,773684,504654.05,1278338.05
150475,201811,224,176,48,167897,45792,213689
150480,201811,1264,887,377,846169.11,359356.58,1205525.69
150490,201811,606,330,276,314817.41,263299.65,578117.06
150495,201811,330,236,94,225137.67,89674.42,314812.09
150497,201811,300,204,96,194611.12,91571.9,286183.02
150500,201811,426,293,133,279517.32,126880.96,406398.28
150503,201811,896,440,456,419456.21,434694.49,854150.70
150506,201811,1009,663,346,632479.36,330063.21,962542.57
150510,201811,1237,700,537,667498.48,512286.86,1179785.34
150520,201811,270,180,90,171713.9,85854.98,257568.88
150530,201811,1603,885,718,841098.56,684961.06,1526059.62
150540,201811,242,167,75,159314.89,71549.5,230864.39
150543,201811,752,427,325,406751.92,309755.94,716507.86
150548,201811,493,344,149,328169.56,142140.39,470309.95
150549,201811,60,43,17,41020.05,16218,57238.05
150550,201811,2877,1521,1356,1450027.67,1293273.47,2743301.14
150553,201811,3175,1879,1296,1790994.16,1236343.06,3027337.22
150555,201811,145,79,66,75364.48,62962.32,138326.80
150560,201811,59,45,14,42928.05,13356,56284.05
150563,201811,78,42,36,40067.66,34341.56,74409.22
150565,201811,170,103,67,98255.35,63915.03,162170.38
150570,201811,414,275,139,262325.49,132603.09,394928.58
150580,201811,1576,705,871,671867.01,830916.42,1502783.43
150590,201811,792,500,292,476978.01,278547.51,755525.52
150600,201811,462,284,178,270926.48,169805.84,440732.32
150610,201811,145,125,20,118396.59,19080,137476.59
150611,201811,128,90,38,85855.74,36250.62,122106.36
150613,201811,3227,1998,1229,1906057.88,1172433.41,3078491.29
150616,201811,499,299,200,284992.56,190787.41,475779.97
150618,201811,1233,669,564,637382.41,538024.47,1175406.88
150619,201811,400,307,93,292873.87,88722,381595.87
150620,201811,1275,750,525,715485.84,500550.44,1216036.28
150630,201811,307,202,105,192706.78,100166.38,292873.16
150635,201811,486,208,278,198422.91,265205.74,463628.65
150640,201811,57,28,29,26712,27666,54378
150650,201811,2386,1404,982,1338556.66,936223.4,2274780.06
150655,201811,249,184,65,175531.24,62009,237540.24
150658,201811,103,58,45,55331.91,42929,98260.91
150660,201811,496,347,149,331029.1,142139.63,473168.73
150670,201811,1017,376,641,358397.28,611475.06,969872.34
150680,201811,9689,5307,4382,5054516.01,4178969.18,9233485.19
150690,201811,54,34,20,32433.12,19079.65,51512.77
150700,201811,509,336,173,320348.42,165040.34,485388.76
150710,201811,287,168,119,160267.33,113520.88,273788.21
150715,201811,844,519,325,494133.19,310016.85,804150.04
150720,201811,421,329,92,313861.98,87479.05,401341.03
150730,201811,951,514,437,490332.95,416606.9,906939.85
150740,201811,223,156,67,148815.67,63910.62,212726.29
150745,201811,810,445,365,424512.24,348204.96,772717.20
150746,201811,51,31,20,29573.85,19077.87,48651.72
150747,201811,258,200,58,190796.41,55331.06,246127.47
150750,201811,133,76,57,72501.77,54373.52,126875.29
150760,201811,1740,1144,596,1091336.88,568573.12,1659910.00
150770,201811,377,200,177,190791.6,168679.3,359470.9
150775,201811,95,44,51,41974,48653.03,90627.03
150780,201811,191,102,89,97306.04,84902.82,182208.86
150790,201811,860,469,391,447421.81,373007.19,820429.00
150795,201811,1480,869,611,829001.18,582886.61,1411887.79
150796,201811,384,222,162,211786.11,154542.72,366328.83
150797,201811,292,164,128,156449.02,122106.94,278555.96
150800,201811,1431,865,566,824232.67,539933.61,1364166.28
150803,201811,590,486,104,463634.06,99212.7,562846.76
150805,201811,188,121,67,115430.72,63895.26,179325.98
150808,201811,1010,554,456,528508.06,435015.74,963523.80
150810,201811,3392,2348,1044,2235516.26,994978.61,3230494.87
150812,201811,434,234,200,223232.11,190796.29,414028.40
150815,201811,969,641,328,610120.98,312895.05,923016.03
150820,201811,1568,955,613,910102.39,584772.66,1494875.05
150830,201811,816,577,239,549496.2,228003.05,777499.25
150835,201811,189,114,75,108750.41,71547.33,180297.74
150840,201811,1338,865,473,825195.14,451235.58,1276430.72
160005,201811,52,30,22,28620,20986.36,49606.36
160010,201811,195,123,72,117340.53,68674.04,186014.57
160015,201811,113,65,48,62005.36,45789.93,107795.29
160020,201811,131,75,56,71542.13,53419.35,124961.48
160021,201811,43,23,20,21941,19079.82,41020.82
160023,201811,115,69,46,65823.39,43882.41,109705.80
160025,201811,30,13,17,12402,16218,28620
160027,201811,1508,864,644,821638.46,613595.81,1435234.27
160030,201811,15632,8079,7553,7697760.22,7200049.82,14897810.04
160040,201811,303,173,130,165039.47,124018.15,289057.62
160050,201811,707,359,348,342474.63,331217.47,673692.10
160053,201811,320,183,137,174293.53,130696.83,304990.36
160055,201811,27,20,7,19079.4,6677.13,25756.53
160060,201811,6520,3449,3071,3279707.06,2928694.46,6208401.52
160070,201811,174,108,66,102341.37,62960.69,165302.06
160080,201811,82,43,39,41019.45,37200.41,78219.86
170025,201811,25,14,11,13356,10494,23850
170030,201811,223,183,40,174369.66,38159.41,212529.07
170035,201811,225,105,120,100170,114480,214650
170040,201811,182,140,42,133251.76,40063.6,173315.36
170070,201811,329,202,127,192706.7,121157.8,313864.5
170100,201811,362,265,97,252803.32,92537.56,345340.88
170105,201811,61,50,11,47700,10494,58194
170110,201811,109,68,41,64869.3,39112.95,103982.25
170130,201811,65,33,32,31482,30240,61722
170190,201811,98,65,33,62009.5,31481.06,93490.56
170200,201811,389,263,126,250211.69,120088.62,370300.31
170210,201811,6006,3165,2841,3009834.46,2708209.85,5718044.31
170215,201811,104,48,56,45791.7,53424,99215.7
170220,201811,1419,1047,372,996953.67,354592.92,1351546.59
170230,201811,156,102,54,97307.68,51515.1,148822.78
170240,201811,538,356,182,339617.02,173622.82,513239.84
170255,201811,1110,891,219,849795.58,208637.31,1058432.89
170270,201811,38,27,11,25756.35,10302.56,36058.91
170290,201811,95,72,23,68682.03,21940.24,90622.27
170300,201811,87,58,29,54565.65,27665.71,82231.36
170305,201811,48,37,11,35296.08,10493.76,45789.84
170307,201811,63,47,16,44835.1,15263.33,60098.43
170310,201811,108,60,48,57239.32,45789.87,103029.19
170320,201811,21,17,4,16216.66,3815.28,20031.94
170330,201811,23,21,2,20033.75,1908,21941.75
170360,201811,26,16,10,15264,9540,24804
170370,201811,119,63,56,60102,53422.17,113524.17
170380,201811,85,63,22,60099.27,20986.48,81085.75
170382,201811,44,39,5,37203.91,4770,41973.91
170384,201811,140,105,35,100161.38,33389.6,133550.98
170386,201811,62,27,35,25758,33388.28,59146.28
170388,201811,51,20,31,19078.55,29571.72,48650.27
170389,201811,26,20,6,19078.48,5724,24802.48
170390,201811,59,34,25,32423.88,23845.59,56269.47
170410,201811,33,24,9,22895.79,8586,31481.79
170460,201811,16,13,3,12402,2862,15264
170510,201811,33,26,7,24804,6678,31482
170550,201811,1532,890,642,848473.94,611697.48,1460171.42
170555,201811,112,79,33,75363.07,31480.84,106843.91
170560,201811,97,71,26,67733.42,24804,92537.42
170600,201811,38,18,20,17172,19078.5,36250.5
170610,201811,191,101,90,96196.59,85541.99,181738.58
170625,201811,36,20,16,19080,15262.9,34342.9
170650,201811,80,59,21,56283.62,20033.25,76316.87
170700,201811,571,435,136,411134.86,129451.97,540586.83
170710,201811,162,99,63,94444,60076.2,154520.2
170720,201811,84,67,17,63917.27,16217.74,80135.01
170730,201811,69,40,29,38157.12,27664.48,65821.60
170740,201811,86,65,21,62005.79,20033.4,82039.19
170755,201811,68,35,33,33390,31482,64872
170765,201811,138,69,69,65537.49,65824.63,131362.12
170770,201811,225,134,91,126735.1,86813.23,213548.33
170820,201811,601,398,203,379681.85,192938.39,572620.24
170825,201811,32,19,13,18126,12402,30528
170830,201811,83,65,18,62006.04,17172,79178.04
170900,201811,194,151,43,144053.07,41022,185075.07
170930,201811,830,437,393,416877.58,374332.74,791210.32
170950,201811,3060,1350,1710,1286314.04,1629187.02,2915501.06
170980,201811,16,9,7,8586,6678,15264
171050,201811,143,110,33,104933.14,31481.06,136414.20
171070,201811,38,32,6,30527.58,5724,36251.58
171090,201811,44,33,11,31480.96,10493.61,41974.57
171110,201811,20,13,7,12402,6678,19080
171150,201811,41,20,21,19078.98,20032.26,39111.24
171180,201811,22,10,12,9540,11446.94,20986.94
171190,201811,150,86,64,82038.43,61048.73,143087.16
171195,201811,65,51,14,48654,13356,62010
171200,201811,46,21,25,20034,23848.62,43882.62
171215,201811,4,3,1,2861.49,954,3815.49
171240,201811,54,44,10,41975.96,9540,51515.96
171245,201811,55,50,5,47700,4769,52469
171250,201811,69,37,32,35297.95,30518.46,65816.41
171270,201811,16,12,4,11448,3816,15264
171280,201811,40,36,4,34198.06,3816,38014.06
171320,201811,991,569,422,542814.88,401145.06,943959.94
171330,201811,420,205,215,195564.13,205103.84,400667.97
171360,201811,91,64,27,61053.17,25756.28,86809.45
171370,201811,25,13,12,12402,11448,23850
171380,201811,133,109,24,103979.51,22592.17,126571.68
171395,201811,55,34,21,32433.7,20033.26,52466.96
171420,201811,306,197,109,187937.06,103984.07,291921.13
171430,201811,68,54,14,51514.61,13355.6,64870.21
171488,201811,197,106,91,101123.53,86813.06,187936.59
171500,201811,56,31,25,29573.33,23849.17,53422.50
171510,201811,68,45,23,42929.05,21941.13,64870.18
171515,201811,42,35,7,33389.29,6390,39779.29
171525,201811,30,26,4,24803.18,3816,28619.18
171550,201811,12,7,5,6678,4770,11448
171570,201811,59,31,28,29573.37,26710.39,56283.76
171575,201811,333,210,123,200337.35,117331.38,317668.73
171610,201811,1719,870,849,828017.71,808323.86,1636341.57
171620,201811,132,93,39,88428.09,37205.04,125633.13
171630,201811,55,28,27,26711.16,25757.8,52468.96
171650,201811,270,180,90,171717.49,85858.72,257576.21
171660,201811,265,144,121,137374.06,115134.56,252508.62
171665,201811,53,37,16,35296.61,15264,50560.61
171670,201811,429,248,181,235343.83,172384.32,407728.15
171700,201811,66,59,7,56283.35,6677.8,62961.15
171720,201811,26,10,16,9539.86,15263.34,24803.20
171750,201811,105,57,48,54378,45792,100170
171780,201811,77,62,15,59146.6,14309.6,73456.2
171790,201811,76,65,11,62009.09,10494,72503.09
171800,201811,38,30,8,28617.03,7632,36249.03
171820,201811,2070,1182,888,1125520.03,844309.93,1969829.96
171830,201811,34,27,7,25757.51,6678,32435.51
171840,201811,66,41,25,39111.83,23850,62961.83
171845,201811,31,19,12,18126,11448,29574
171850,201811,40,30,10,28618.97,9540,38158.97
171855,201811,79,62,17,59144.46,16217.09,75361.55
171865,201811,7,6,1,5724,954,6678
171870,201811,30,22,8,20988,7632,28620
171875,201811,82,56,26,53423.2,24803.8,78227.0
171880,201811,30,20,10,19079.09,9539.84,28618.93
171884,201811,48,25,23,23847.64,21941.56,45789.20
171886,201811,126,47,79,44831.21,75075.49,119906.70
171888,201811,24,19,5,18125.59,4770,22895.59
171889,201811,19,15,4,14310,3816,18126
171890,201811,59,49,10,46745.13,9540,56285.13
171900,201811,43,30,13,28620,12402,41022
172000,201811,40,33,7,31480.4,6676.77,38157.17
172010,201811,42,36,6,33532.16,5723.8,39255.96
172015,201811,26,16,10,15062,9253.8,24315.8
172020,201811,139,88,51,83946.77,48652.98,132599.75
172025,201811,32,21,11,20033.23,10494,30527.23
172030,201811,41,26,15,24802.52,14309.01,39111.53
172049,201811,73,45,28,42929.74,26710.56,69640.30
172065,201811,148,96,52,91532.45,49608,141140.45
172080,201811,96,65,31,60814.93,29571.49,90386.42
172085,201811,25,12,13,11447.3,12401.26,23848.56
172090,201811,415,321,94,305428.35,88907.71,394336.06
172093,201811,26,20,6,19079.56,5724,24803.56
172097,201811,17,9,8,8586,7342.46,15928.46
172100,201811,4821,2718,2103,2585019.05,2002930.63,4587949.68
172110,201811,82,55,27,52469.66,25757.98,78227.64
172120,201811,1696,1457,239,1384747.49,226878.09,1611625.58
172125,201811,3,3,0,2862,0,2862
172130,201811,16,12,4,11447.27,3815.1,15262.37
172208,201811,193,122,71,116384.01,67732.7,184116.71
172210,201811,397,198,199,188890.93,189556.13,378447.06
210005,201811,2943,1842,1101,1754189.09,1047166.93,2801356.02
210010,201811,185,95,90,90628.99,85860,176488.99
210015,201811,35,25,10,23846.54,9539.66,33386.20
210020,201811,349,189,160,180300.64,152634.95,332935.59
210030,201811,344,219,125,208925,119232.4,328157.4
210040,201811,148,115,33,109708.14,31482,141190.14
210043,201811,273,192,81,183156.82,77273.16,260429.98
210047,201811,591,322,269,306795.12,256623.99,563419.11
210050,201811,301,220,81,209873.61,77273.51,287147.12
210055,201811,42,32,10,30527.33,9540,40067.33
210060,201811,561,448,113,427289.5,107514.8,534804.3
210070,201811,418,313,105,298589.02,100168.16,398757.18
210080,201811,107,97,10,92535.51,9539.59,102075.10
210083,201811,305,139,166,132599.39,158362.72,290962.11
210087,201811,41,31,10,28772.64,9540,38312.64
210090,201811,481,336,145,320538.34,138329.33,458867.67
210095,201811,480,356,124,339608.49,118295.06,457903.55
210100,201811,694,535,159,510041.28,150731.24,660772.52
210110,201811,145,84,61,80135.23,58193.2,138328.43
210120,201811,5419,4133,1286,3935841.63,1225576.76,5161418.39
210125,201811,210,123,87,117336.86,82995.12,200331.98
210130,201811,529,290,239,275702.61,227986.22,503688.83
210135,201811,33,20,13,19080,12402,31482
210140,201811,4402,3459,943,3297153.08,899603.1,4196756.18
210150,201811,367,232,135,221324.34,128789.33,350113.67
210160,201811,3425,2890,535,2754105.29,510096.06,3264201.35
210170,201811,1162,917,245,874787.93,233726.18,1108514.11
210173,201811,127,107,20,102072.5,19080,121152.5
210177,201811,442,224,218,213695.8,207972,421667.8
210180,201811,32,17,15,16217.08,14309.82,30526.90
210190,201811,415,273,142,260432.02,135464.32,395896.34
210193,201811,1,1,0,954,0,954
210197,201811,80,54,26,51515.26,24783.55,76298.81
210200,201811,647,516,131,492094.61,124972.89,617067.50
210203,201811,257,173,84,164750.39,80134.54,244884.93
210207,201811,388,305,83,290956.46,79182,370138.46
210210,201811,784,721,63,687821.16,60100.56,747921.72
210215,201811,81,69,12,65823.8,11448,77271.8
210220,201811,400,330,70,314812.21,66492.49,381304.70
210230,201811,308,238,70,227046.46,66780,293826.46
210232,201811,1475,955,520,910749.39,496078.07,1406827.46
210235,201811,159,126,33,120000.51,31481.58,151482.09
210237,201811,43,25,18,23850,17172,41022
210240,201811,90,75,15,71550,14309.42,85859.42
210250,201811,187,152,35,145003.65,33390,178393.65
210255,201811,356,264,92,251847.42,87767.73,339615.15
210260,201811,418,268,150,255668.11,143099.12,398767.23
210270,201811,694,444,250,423572.22,238498.73,662070.95
210275,201811,53,40,13,38156.61,12401.03,50557.64
210280,201811,1073,694,379,659228.68,360212.65,1019441.33
210290,201811,513,343,170,327210.67,162178.96,489389.63
210300,201811,5974,3561,2413,3391523.65,2300766.88,5692290.53
210310,201811,108,76,32,72497.94,30526.33,103024.27
210312,201811,120,80,40,76319,38160,114479
210315,201811,116,89,27,84904.31,25758,110662.31
210317,201811,125,92,33,87758.73,31481.21,119239.94
210320,201811,2381,1975,406,1882386.97,387320.73,2269707.70
210325,201811,131,91,40,85856.74,37870.34,123727.08
210330,201811,5323,2837,2486,2700663.21,2371612.99,5072276.20
210340,201811,1355,979,376,933127.18,358624.76,1291751.94
210350,201811,617,512,105,488194.99,100169.71,588364.70
210355,201811,141,115,26,109704.52,24802.35,134506.87
210360,201811,2602,1659,943,1580440.46,899328.61,2479769.07
210370,201811,1257,569,688,542813.35,656342.37,1199155.72
210375,201811,191,98,93,93488.92,88720.72,182209.64
210380,201811,726,543,183,518000.68,174581.24,692581.92
210390,201811,203,169,34,161223.15,32436,193659.15
210400,201811,426,363,63,346289.79,60083,406372.79
210405,201811,1020,696,324,663953.7,309088.69,973042.39
210407,201811,54,43,11,41019.6,10494,51513.6
210408,201811,66,59,7,56286,6678,62964
210409,201811,326,273,53,260433.09,50559.29,310992.38
210410,201811,445,347,98,331027.86,93475.6,424503.46
210420,201811,196,161,35,153590.31,33389.4,186979.71
210430,201811,41,28,13,26710.69,12398.92,39109.61
210440,201811,368,228,140,217504.66,133556.86,351061.52
210450,201811,155,120,35,114472.7,33388.5,147861.2
210455,201811,227,124,103,118290.61,98258.53,216549.14
210460,201811,342,216,126,206060.6,120202.48,326263.08
210462,201811,67,56,11,53419.2,10493.86,63913.06
210465,201811,169,123,46,117338.47,43884,161222.47
210467,201811,537,387,150,369176.92,143098.2,512275.12
210470,201811,44,36,8,34342.75,7632,41974.75
210480,201811,1310,929,381,886231.38,363463.79,1249695.17
210490,201811,216,135,81,128782.39,77273.46,206055.85
210500,201811,581,317,264,302405.32,251854.45,554259.77
210510,201811,575,449,126,428332.02,120202.31,548534.33
210515,201811,430,242,188,230862.09,179352,410214.09
210520,201811,409,358,51,341234.68,48653.1,389887.78
210530,201811,9467,5080,4387,4833722.04,4176667.51,9010389.55
210535,201811,129,94,35,89674.11,33389.94,123064.05
210540,201811,1541,954,587,908942.74,559227.55,1468170.29
210542,201811,1212,595,617,567234.58,588315.6,1155550.18
210545,201811,12,11,1,10494,954,11448
210547,201811,133,114,19,108754.77,18126,126880.77
210550,201811,737,526,211,500682.37,201290,701972.37
210560,201811,178,149,29,142143.55,27666,169809.55
210565,201811,30,22,8,20988,7632,28620
210570,201811,1369,1083,286,1031927.06,272844,1304771.06
210580,201811,109,95,14,90628.37,13355.4,103983.77
210590,201811,775,622,153,592606.23,145962,738568.23
210592,201811,33,29,4,27665.14,3816,31481.14
210594,201811,106,87,19,82994.75,18124.4,101119.15
210596,201811,92,77,15,73455.04,14308.38,87763.42
210598,201811,129,93,36,88721.57,34343,123064.57
210600,201811,338,286,52,272839.79,49608,322447.79
210610,201811,257,238,19,226091.63,18124.52,244216.15
210620,201811,46,27,19,25758,18126,43884
210630,201811,66,63,3,60100.17,2862,62962.17
210632,201811,1083,729,354,695451.64,337236.51,1032688.15
210635,201811,20,17,3,16218,2862,19080
210637,201811,102,71,31,67733.2,29574,97307.2
210640,201811,593,520,73,496067.24,69640.99,565708.23
210650,201811,414,335,79,318651.62,74410.34,393061.96
210660,201811,402,292,110,277125.45,104938.3,382063.75
210663,201811,23,12,11,11447.22,10494,21941.22
210667,201811,113,36,77,34342.35,73458,107800.35
210670,201811,270,236,34,224419.81,32434.73,256854.54
210675,201811,567,303,264,289057.1,251855.45,540912.55
210680,201811,210,133,77,126880.76,73455.17,200335.93
210690,201811,641,517,124,493208.6,118294.38,611502.98
210700,201811,186,138,48,131646.85,45791.4,177438.25
210710,201811,287,164,123,156261.48,117342,273603.48
210720,201811,137,118,19,112563.69,18124.44,130688.13
210725,201811,70,61,9,58190,8586,66776
210730,201811,26,19,7,18124.37,6678,24802.37
210735,201811,412,280,132,267114.31,125639.22,392753.53
210740,201811,559,473,86,451225.49,82041.05,533266.54
210745,201811,157,116,41,110659.5,39113.19,149772.69
210750,201811,2437,1139,1298,1084616.16,1238253.2,2322869.36
210760,201811,264,198,66,188887.62,62949.62,251837.24
210770,201811,402,312,90,297597.02,85573.8,383170.82
210780,201811,426,312,114,297638.91,108755.83,406394.74
210790,201811,190,146,44,139279.54,41976,181255.54
210800,201811,159,117,42,111611.11,40067.2,151678.31
210805,201811,47,43,4,41016.33,3815.68,44832.01
210810,201811,490,379,111,360886,105893.86,466779.86
210820,201811,2344,1875,469,1781007.09,447424.2,2228431.29
210825,201811,170,91,79,86813.54,75365,162178.54
210830,201811,793,499,294,475083.7,279520.68,754604.38
210840,201811,210,143,67,136419.54,63917.65,200337.19
210845,201811,258,167,91,159313.4,86812.64,246126.04
210850,201811,829,536,293,511336.06,279520.01,790856.07
210860,201811,4085,2159,1926,2058114.88,1837089.05,3895203.93
210870,201811,480,365,115,348207.2,109708.93,457916.13
210880,201811,68,50,18,47697.95,17171.2,64869.15
210890,201811,352,297,55,283334.54,52468.26,335802.80
210900,201811,594,384,210,366321.66,200337.66,566659.32
210905,201811,67,34,33,32436,31481.8,63917.8
210910,201811,2022,1504,518,1433492.97,494168.46,1927661.43
210920,201811,209,68,141,64871.37,134514,199385.37
210923,201811,82,59,23,56283.91,21941.89,78225.80
210927,201811,433,189,244,180298.13,232772.48,413070.61
210930,201811,67,53,14,50557.2,13355.33,63912.53
210940,201811,95,73,22,69641.02,20988,90629.02
210945,201811,201,95,106,90623.96,101123.19,191747.15
210950,201811,522,378,144,360599.23,137367.47,497966.70
210955,201811,75,50,25,47699.44,23849.32,71548.76
210960,201811,2393,1078,1315,1026746.82,1254496.44,2281243.26
210970,201811,115,101,14,96349.31,13356,109705.31
210975,201811,93,84,9,80133.57,8586,88719.57
210980,201811,1188,531,657,506450.2,626484.69,1132934.89
210990,201811,4337,2734,1603,2607052.65,1529250.37,4136303.02
211000,201811,1383,1098,285,1047174.85,271600.52,1318775.37
211003,201811,922,635,287,605778.5,273776.81,879555.31
211010,201811,499,440,59,419744.65,56286,476030.65
211020,201811,1598,602,996,574294.53,949954.09,1524248.62
211023,201811,29,25,4,23563.67,3816,27379.67
211027,201811,69,47,22,44836.76,20988,65824.76
211030,201811,387,266,121,253757.55,115431.86,369189.41
211040,201811,325,256,69,243925.76,65826,309751.76
211050,201811,1180,770,410,734543.87,390842.91,1125386.78
211060,201811,687,584,103,555222,98262,653484
211065,201811,22,18,4,17172,3816,20988
211070,201811,930,760,170,723408.7,162178.92,885587.62
211080,201811,88,84,4,80134.38,3816,83950.38
211085,201811,60,31,29,29285.4,27665.4,56950.8
211090,201811,89,71,18,67734,17172,84906
211100,201811,503,404,99,385399.77,94445.26,479845.03
211102,201811,261,178,83,169810.55,79181.16,248991.71
211105,201811,223,153,70,145956.59,66778.08,212734.67
211107,201811,137,79,58,75360.26,55329.55,130689.81
211110,201811,835,543,292,517437.65,278551.38,795989.03
211120,201811,5781,2625,3156,2498529.44,3009700.5,5508229.94
211125,201811,32,25,7,23850,6678,30528
211130,201811,45432,19568,25864,18631576.37,24662063.56,43293639.93
211140,201811,433,370,63,352004.06,60101.68,412105.74
211150,201811,1302,831,471,792420.26,449025.05,1241445.31
211153,201811,167,98,69,93490.6,65825.11,159315.71
211157,201811,64,50,14,47696.06,13355.36,61051.42
211160,201811,716,598,118,569749.78,112568.01,682317.79
211163,201811,0,0,0,0,0,0
211167,201811,10,9,1,8583.92,954,9537.92
211170,201811,443,314,129,299546.14,123063.85,422609.99
211172,201811,123,86,37,82039.35,35296.94,117336.29
211174,201811,267,160,107,152638.13,102076.3,254714.43
211176,201811,508,368,140,351059.77,133558.99,484618.76
211178,201811,97,63,34,60100.62,32435.23,92535.85
211180,201811,210,166,44,158361.69,41813.82,200175.51
211190,201811,67,62,5,59145.89,4769.33,63915.22
211195,201811,30,19,11,18126,10494,28620
211200,201811,154,134,20,127490.22,19079.43,146569.65
211210,201811,513,331,182,315098.11,173625.63,488723.74
211220,201811,4077,2309,1768,2194556.69,1681099.8,3875656.49
211223,201811,95,90,5,85677.74,4770,90447.74
211227,201811,68,50,18,47697.57,17172,64869.57
211230,201811,783,636,147,606592.47,140218.08,746810.55
211240,201811,416,314,102,299259.23,97306.59,396565.82
211245,201811,194,90,104,85857.42,99215.83,185073.25
211250,201811,1648,1410,238,1344092.16,227050.99,1571143.15
211260,201811,829,661,168,630580.04,160270.42,790850.46
211270,201811,2063,1641,422,1565487.37,401628.44,1967115.81
211280,201811,1865,1142,723,1088464.67,689729.17,1778193.84
211285,201811,207,122,85,116385.54,81088.69,197474.23
211290,201811,694,472,222,450090.79,211787.17,661877.96
211300,201811,821,637,184,607414.2,175533.56,782947.76
211400,201811,1591,917,674,874799.15,642991.46,1517790.61
220005,201811,17,16,1,15264,954,16218
220010,201811,90,68,22,64869.62,20701.8,85571.42
220020,201811,639,511,128,485865.94,122107.99,607973.93
220025,201811,109,106,3,101119.36,2862,103981.36
220027,201811,38,31,7,29572.2,6678,36250.2
220030,201811,103,85,18,81081.31,17170.05,98251.36
220040,201811,1165,883,282,841206.64,269021.61,1110228.25
220045,201811,41,30,11,28620,10494,39114
220050,201811,677,563,114,535909.99,108754.39,644664.38
220060,201811,172,147,25,140234.83,23850,164084.83
220070,201811,103,93,10,88717.17,9539.4,98256.57
220080,201811,13,12,1,11444.18,954,12398.18
220090,201811,34,28,6,26709.47,5722.84,32432.31
220095,201811,2,1,1,954,954,1908
220100,201811,26,22,4,20987.56,3816,24803.56
220105,201811,26,24,2,22607,1908,24515
220110,201811,216,197,19,187643.12,18125.33,205768.45
220115,201811,50,47,3,44834.51,2862,47696.51
220117,201811,22,20,2,19078.58,1908,20986.58
220120,201811,1487,1090,397,1038488.01,378730.9,1417218.91
220130,201811,27,27,0,25756.77,0,25756.77
220140,201811,101,80,21,75363.04,20033.26,95396.30
220150,201811,472,339,133,323399.71,126878.81,450278.52
220155,201811,4,4,0,3816,0,3816
220157,201811,18,15,3,14309,2862,17171
220160,201811,80,69,11,65823.27,10493.11,76316.38
220170,201811,37,35,2,33385.27,1908,35293.27
220173,201811,6,6,0,5724,0,5724
220177,201811,5,5,0,4770,0,4770
220180,201811,64,64,0,61046.99,0,61046.99
220190,201811,1063,953,110,909151.9,104934.85,1014086.75
220191,201811,43,38,5,36252,4770,41022
220192,201811,69,66,3,62955.67,2862,65817.67
220194,201811,44,41,3,39102.6,2862,41964.6
220196,201811,104,87,17,82998,16218,99216
220198,201811,6,4,2,3816,1908,5724
220200,201811,425,352,73,335453.72,69642,405095.72
220202,201811,37,33,4,31481.06,3816,35297.06
220205,201811,40,36,4,34340.63,3815.06,38155.69
220207,201811,16,15,1,14310,954,15264
220208,201811,84,45,39,42928.53,37205.8,80134.33
220209,201811,31,28,3,26712,2862,29574
220210,201811,15,13,2,12401.86,1907.27,14309.13
220211,201811,26,26,0,24802.73,0,24802.73
220213,201811,43,39,4,37204.72,3528,40732.72
220217,201811,37,29,8,27663.44,7631.66,35295.10
220220,201811,2087,1350,737,1284220.18,701683.4,1985903.58
220225,201811,12,5,7,4770,6678,11448
220230,201811,953,754,199,718854.37,189202.04,908056.41
220240,201811,155,142,13,135461.91,12402,147863.91
220245,201811,32,29,3,27104.04,2862,29966.04
220250,201811,115,103,12,98257,11448,109705
220253,201811,42,36,6,34341.38,5724,40065.38
220255,201811,28,25,3,23850,2862,26712
220260,201811,694,504,190,480809.56,181257.82,662067.38
220265,201811,13,9,4,8586,3816,12402
220270,201811,715,635,80,605031.63,75840.27,680871.90
220271,201811,43,36,7,34343.2,6678,41021.2
220272,201811,26,26,0,24802.6,0,24802.6
220273,201811,15,13,2,12401.8,1908,14309.8
220275,201811,59,47,12,44834.14,11448,56282.14
220277,201811,13,11,2,10492.57,1908,12400.57
220280,201811,14,11,3,10492.36,2862,13354.36
220285,201811,46,43,3,41019.7,2862,43881.7
220290,201811,1440,1230,210,1170110.46,200279.46,1370389.92
220300,201811,50,48,2,45790.82,1906.57,47697.39
220310,201811,314,266,48,253748.11,45776.33,299524.44
220320,201811,434,402,32,382057.39,30527.42,412584.81
220323,201811,0,0,0,0,0,0
220325,201811,16,11,5,10494,4770,15264
220327,201811,12,11,1,10494,954,11448
220330,201811,213,148,65,141184.8,62005.58,203190.38
220335,201811,134,116,18,110654.91,17170.98,127825.89
220340,201811,29,18,11,17167.79,10492.88,27660.67
220342,201811,59,51,8,48654,7632,56286
220345,201811,86,78,8,74409.23,7632,82041.23
220350,201811,429,376,53,356063.46,50558.55,406622.01
220360,201811,42,31,11,29570.89,10492.59,40063.48
220370,201811,1154,939,215,895003.43,204815.99,1099819.42
220375,201811,27,25,2,23847.73,1908,25755.73
220380,201811,40,33,7,31475.61,6678,38153.61
220385,201811,19,16,3,15264,2862,18126
220390,201811,2312,1323,989,1257406.72,942362.82,2199769.54
220400,201811,30,27,3,25758,2861.8,28619.8
220410,201811,19,18,1,17169.19,954,18123.19
220415,201811,13,12,1,11447,954,12401
220420,201811,130,107,23,102074.86,21655.06,123729.92
220430,201811,127,116,11,109655.98,10494,120149.98
220435,201811,21,15,6,14301.03,5724,20025.03
220440,201811,298,253,45,241359.77,42929.82,284289.59
220450,201811,339,174,165,164823.27,157406.94,322230.21
220455,201811,56,54,2,51511.96,1908,53419.96
220460,201811,19,19,0,17457.6,0,17457.6
220465,201811,105,69,36,65825.61,34344,100169.61
220470,201811,239,211,28,201289.14,26712,228001.14
220480,201811,76,67,9,63911.82,8585.26,72497.08
220490,201811,88,76,12,72498.3,11447.94,83946.24
220500,201811,96,81,15,77267.54,14307.51,91575.05
220510,201811,382,305,77,290201.79,73265.32,363467.11
220515,201811,20,18,2,17171.76,1908,19079.76
220520,201811,373,335,38,318528.75,36248.15,354776.90
220525,201811,19,14,5,13356,4770,18126
220527,201811,37,29,8,27666,6811.71,34477.71
220530,201811,35,14,21,13354.55,20032.22,33386.77
220535,201811,7,7,0,6678,0,6678
220540,201811,59,50,9,47697.64,8586,56283.64
220545,201811,55,37,18,35298,17172,52470
220550,201811,653,498,155,474317.91,147866.07,622183.98
220551,201811,26,21,5,20034,4770,24804
220552,201811,12,12,0,11447.28,0,11447.28
220553,201811,50,45,5,42928.93,4770,47698.93
220554,201811,11,7,4,6391.8,3816,10207.8
220555,201811,29,26,3,24802.62,2862,27664.62
220556,201811,53,49,4,46746,3816,50562
220557,201811,55,50,5,47698.46,4770,52468.46
220558,201811,6,2,4,1908,3816,5724
220559,201811,7,7,0,6678,0,6678
220560,201811,64,41,23,38918.63,21940.48,60859.11
220570,201811,796,486,310,462422.36,295736.76,758159.12
220580,201811,560,516,44,492258.48,41298.23,533556.71
220585,201811,6,5,1,4770,954,5724
220590,201811,16,16,0,15264,0,15264
220595,201811,62,47,15,44835.49,14310,59145.49
220600,201811,21,13,8,12400.35,7631.42,20031.77
220605,201811,20,19,1,18124.34,954,19078.34
220610,201811,66,58,8,55329.05,7632,62961.05
220620,201811,564,449,115,428101.39,109710,537811.39
220630,201811,5,4,1,3816,954,4770
220635,201811,36,32,4,30528,3815.93,34343.93
220640,201811,97,76,21,72502.82,20034,92536.82
220650,201811,112,105,7,100164.88,6677.64,106842.52
220660,201811,36,30,6,28617.95,5724,34341.95
220665,201811,4,4,0,3816,0,3816
220667,201811,14,13,1,12402,954,13356
220669,201811,29,26,3,24803.2,2862,27665.2
220670,201811,69,55,14,52467.83,13355.6,65823.43
220672,201811,68,46,22,43880.35,20985.83,64866.18
220675,201811,36,28,8,26709.34,7632,34341.34
220680,201811,39,33,6,31479.95,5724,37203.95
220690,201811,45,43,2,41022,1908,42930
220695,201811,54,24,30,22896,28620,51516
220700,201811,1623,1250,373,1190586.38,355825.85,1546412.23
220710,201811,5,3,2,2862,1908,4770
220720,201811,107,87,20,82758.1,19080,101838.1
220730,201811,19,18,1,17171.11,954,18125.11
220735,201811,3,1,2,954,1908,2862
220740,201811,50,45,5,42929.84,4769.2,47699.04
220750,201811,101,85,16,81088.09,15262.62,96350.71
220755,201811,15,15,0,14310,0,14310
220760,201811,57,53,4,50559.17,3816,54375.17
220770,201811,5690,2997,2693,2852631.57,2564139.96,5416771.53
220775,201811,22,10,12,9540,11448,20988
220777,201811,17,16,1,15262.73,954,16216.73
220779,201811,16,13,3,12402,2862,15264
220780,201811,882,757,125,721491.94,118959.51,840451.45
220785,201811,16,10,6,9535.59,5722.41,15258.00
220790,201811,1043,833,210,792264.46,200336.45,992600.91
220793,201811,12,12,0,11448,0,11448
220795,201811,21,20,1,19080,954,20034
220800,201811,4021,3082,939,2937855.36,895051.51,3832906.87
220810,201811,66,58,8,55329.25,7630.43,62959.68
220820,201811,244,223,21,212737.16,20033.32,232770.48
220830,201811,1206,1029,177,981333.77,168851.16,1150184.93
220840,201811,2385,1662,723,1574238.18,686829.17,2261067.35
220850,201811,54,46,8,43879.08,7631.2,51510.28
220855,201811,14,9,5,8586,4770,13356
220860,201811,10,9,1,8586,954,9540
220865,201811,24,22,2,20987.33,1908,22895.33
220870,201811,67,63,4,60097.77,3816,63913.77
220880,201811,325,250,75,237826.27,71259.81,309086.08
220885,201811,40,37,3,35298,2862,38160
220887,201811,17,17,0,16218,0,16218
220890,201811,102,90,12,85860,11448,97308
220900,201811,53,30,23,28616.53,21940.59,50557.12
220910,201811,57,49,8,46745,7632,54377
220915,201811,9,8,1,7632,954,8586
220920,201811,42,38,4,36247.57,3815.95,40063.52
220930,201811,42,41,1,39112.21,954,40066.21
220935,201811,17,17,0,16218,0,16218
220937,201811,40,37,3,35296.52,2862,38158.52
220940,201811,56,51,5,48650.47,4770,53420.47
220945,201811,0,0,0,0,0,0
220950,201811,47,43,4,41020.3,3816,44836.3
220955,201811,37,34,3,32434,2862,35296
220960,201811,2,2,0,1908,0,1908
220965,201811,30,27,3,25755.46,2861.8,28617.26
220970,201811,54,46,8,43879.96,7632,51511.96
220975,201811,10,9,1,8586,954,9540
220980,201811,32,30,2,28619.31,1908,30527.31
220985,201811,67,59,8,56281.89,7631.73,63913.62
220987,201811,33,31,2,29573.21,1908,31481.21
220990,201811,15,14,1,13352.88,954,14306.88
220995,201811,32,27,5,25757.83,4770,30527.83
220997,201811,53,43,10,41017.31,9539.4,50556.71
221000,201811,1144,1030,114,979427.59,108466.05,1087893.64
221005,201811,62,56,6,53422.76,5723.83,59146.59
221010,201811,17,14,3,13355.37,2861.11,16216.48
221020,201811,46,44,2,41976,1908,43884
221030,201811,31,25,6,23846.25,5722.83,29569.08
221035,201811,22,22,0,20986,0,20986
221037,201811,12,6,6,5724,5724,11448
221038,201811,27,24,3,22895.59,2861.6,25757.19
221039,201811,22,22,0,20983.85,0,20983.85
221040,201811,255,219,36,208925.29,34343.54,243268.83
221050,201811,235,199,36,189842.86,34344,224186.86
221060,201811,1792,1576,216,1501777.53,206056.51,1707834.04
221062,201811,32,31,1,29572,954,30526
221063,201811,13,9,4,8584.32,3816,12400.32
221065,201811,53,46,7,43880.19,6676.7,50556.89
221070,201811,144,125,19,118961.62,18126,137087.62
221080,201811,375,332,43,316721.63,40734.46,357456.09
221090,201811,34,33,1,31482,954,32436
221093,201811,53,35,18,33390,17172,50562
221095,201811,10,9,1,8586,954,9540
221097,201811,18,15,3,14310,2862,17172
221100,201811,25158,14638,10520,13941741.78,10028428.5,23970170.28
221110,201811,1054,782,272,744920.47,259484.35,1004404.82
221120,201811,531,399,132,380338.94,125921.58,506260.52
221130,201811,955,781,174,743800.44,165990.28,909790.72
221135,201811,36,33,3,31480.83,2862,34342.83
221140,201811,42,35,7,33388.3,6678,40066.3
221150,201811,13,10,3,9540,2862,12402
221160,201811,13,13,0,12402,0,12402
221170,201811,14,14,0,13355.36,0,13355.36
230010,201811,168,154,14,146912.91,13355.8,160268.71
230015,201811,123,103,20,98230.38,19079.2,117309.58
230020,201811,1612,1364,248,1299212.12,236306.15,1535518.27
230030,201811,1644,1190,454,1130602.1,433094.67,1563696.77
230040,201811,207,181,26,171187.54,24804,195991.54
230050,201811,209,153,56,145955.85,53422.16,199378.01
230060,201811,160,131,29,124202.1,27664.02,151866.12
230070,201811,286,256,30,244221.86,28620,272841.86
230075,201811,849,743,106,706508.87,100834.74,807343.61
230080,201811,185,159,26,151679.74,24801.6,176481.34
230090,201811,110,78,32,73644.35,30526.09,104170.44
230100,201811,1972,1169,803,1112867.82,765996,1878863.82
230110,201811,2717,1750,967,1667009.18,921926.23,2588935.41
230120,201811,970,776,194,737867.99,185073.75,922941.74
230125,201811,146,123,23,117335.91,21942,139277.91
230130,201811,477,424,53,404486.81,50556.62,455043.43
230140,201811,204,179,25,170765.05,23850,194615.05
230150,201811,159,120,39,114478.08,37202.6,151680.68
230160,201811,924,797,127,759831.56,121147.22,880978.78
230170,201811,596,549,47,519478.48,44835.84,564314.32
230180,201811,80,75,5,71547.47,4770,76317.47
230185,201811,410,356,54,338251.79,51514.3,389766.09
230190,201811,2258,1824,434,1735835.43,413694.49,2149529.92
230195,201811,497,432,65,412119.68,62009.02,474128.70
230200,201811,389,336,53,319572.67,50558.82,370131.49
230205,201811,372,242,130,228799.83,124015.87,352815.70
230210,201811,1266,1007,259,958568.43,246287.4,1204855.83
230220,201811,1520,1034,486,986413.65,463566.09,1449979.74
230230,201811,895,777,118,741061.02,112569.51,853630.53
230240,201811,1665,1435,230,1368031.17,219384.76,1587415.93
230250,201811,1795,1486,309,1413041.9,294780.13,1707822.03
230260,201811,3029,1875,1154,1784413.42,1099920.88,2884334.30
230270,201811,1386,1113,273,1058879.27,259239.23,1318118.50
230280,201811,2746,2050,696,1949157.18,663295.06,2612452.24
230290,201811,409,366,43,344654.27,41019.31,385673.58
230300,201811,516,384,132,365067.43,125924.38,490991.81
230310,201811,423,318,105,303216.79,100168.33,403385.12
230320,201811,946,808,138,767237.31,130911.29,898148.60
230330,201811,302,241,61,229148.19,57993.25,287141.44
230340,201811,455,367,88,348670.59,83947.74,432618.33
230350,201811,3097,1967,1130,1875917.44,1075350.92,2951268.36
230360,201811,283,219,64,208120.88,61042.21,269163.09
230365,201811,142,112,30,106119.69,28618.23,134737.92
230370,201811,9838,4881,4957,4644094.02,4724726.74,9368820.76
230380,201811,477,408,69,388930.51,64862.37,453792.88
230390,201811,512,287,225,273785.74,214645.61,488431.35
230393,201811,264,219,45,207919.41,42927.38,250846.79
230395,201811,347,280,67,266870.22,63918,330788.22
230400,201811,605,479,126,456005.26,119704.85,575710.11
230410,201811,2652,1663,989,1580824.57,942711.04,2523535.61
230420,201811,6240,4125,2115,3913863.87,2013055.67,5926919.54
230423,201811,314,273,41,260432.92,39113,299545.92
230425,201811,378,310,68,295420.06,64867.07,360287.13
230426,201811,122,101,21,95627.99,19741.6,115369.59
230427,201811,81,78,3,74408.01,2862,77270.01
230428,201811,1410,721,689,687530.79,657218.47,1344749.26
230430,201811,463,379,84,361333.79,80133,441466.79
230435,201811,833,586,247,557417.2,234376.37,791793.57
230440,201811,85284,37935,47349,36094354.09,45108726.16,81203080.25
230445,201811,274,188,86,179344.65,82040.11,261384.76
230450,201811,548,438,110,417845.98,104936.12,522782.10
230460,201811,60,50,10,47697.25,9539.73,57236.98
230465,201811,305,250,55,238493.35,52468.34,290961.69
230470,201811,1934,1517,417,1447149.44,396695.27,1843844.71
230480,201811,157,150,7,142811.96,6677,149488.96
230490,201811,287,231,56,220370.71,53422.15,273792.86
230495,201811,453,342,111,325381,105889.1,431270.1
230500,201811,966,725,241,690679.01,229616.9,920295.91
230510,201811,49,40,9,38158.57,8585.6,46744.17
230520,201811,385,302,83,287903.54,79179.5,367083.04
230523,201811,2176,1371,805,1305373.57,766617.47,2071991.04
230526,201811,299,250,49,238476.86,45944.32,284421.18
230530,201811,678,505,173,479465.06,164080.72,643545.78
230533,201811,190,180,10,171714.45,9537.71,181252.16
230535,201811,348,263,85,250900.85,81090,331990.85
230540,201811,1846,1626,220,1548521.32,209586.28,1758107.60
230550,201811,3730,2404,1326,2283782.48,1263920.98,3547703.46
230560,201811,584,446,138,424518.6,130667.75,555186.35
230565,201811,208,152,56,145003.74,52658.05,197661.79
230570,201811,298,263,35,250898.68,33386.96,284285.64
230580,201811,1115,825,290,784763.4,275697.34,1060460.74
230590,201811,970,754,216,715709.95,205774.39,921484.34
230600,201811,256,233,23,221535.18,21942,243477.18
230610,201811,346,274,72,261192.05,68685.4,329877.45
230620,201811,172,141,31,133556.36,29572.17,163128.53
230625,201811,723,526,197,500187.24,187025.99,687213.23
230630,201811,1289,1020,269,972776.98,256236.63,1229013.61
230640,201811,3686,3195,491,3041028.28,466650.35,3507678.63
230650,201811,412,361,51,343440.19,48637.76,392077.95
230655,201811,666,579,87,551174.47,82780.44,633954.91
230660,201811,359,302,57,288092.13,54088.24,342180.37
230670,201811,429,381,48,363469.04,45788.56,409257.60
230680,201811,198,180,18,171718.33,17171.82,188890.15
230690,201811,885,766,119,730716.33,113520.7,844237.03
230700,201811,731,621,110,592104.01,104620.61,696724.62
230710,201811,745,706,39,672549.48,37205.06,709754.54
230720,201811,150,129,21,122670.69,20034,142704.69
230725,201811,255,204,51,194610.03,48636.32,243246.35
230730,201811,11956,6491,5465,6176137.11,5205657.7,11381794.81
230740,201811,658,532,126,507223.74,119502.44,626726.18
230750,201811,825,705,120,671075.83,114478.04,785553.87
230760,201811,1375,1188,187,1128585.37,178337.09,1306922.46
230763,201811,317,265,52,250843.15,49578.68,300421.83
230765,201811,7161,3393,3768,3230655.96,3592638.05,6823294.01
230770,201811,4985,2566,2419,2437987.22,2305595.74,4743582.96
230780,201811,689,605,84,574252.53,80115.89,654368.42
230790,201811,225,185,40,176475.4,37359.4,213834.8
230800,201811,1138,833,305,793790.28,290957.27,1084747.55
230810,201811,1307,1163,144,1108473.68,137181.5,1245655.18
230820,201811,343,245,98,232755.1,93486.59,326241.69
230830,201811,947,816,131,774935.52,124969.2,899904.72
230835,201811,286,247,39,234681.36,36485,271166.36
230837,201811,168,141,27,134509.78,25757,160266.78
230840,201811,923,739,184,703894.67,175242.45,879137.12
230850,201811,1510,1315,195,1254008.47,185702.45,1439710.92
230860,201811,298,225,73,214642.97,69477.88,284120.85
230870,201811,1831,1564,267,1491045.75,254136.29,1745182.04
230880,201811,44,32,12,30525.07,11446.58,41971.65
230890,201811,565,515,50,491182.51,47678.14,538860.65
230900,201811,276,208,68,198427.85,64665.96,263093.81
230910,201811,203,164,39,155690.19,37202.12,192892.31
230920,201811,409,321,88,306228.48,83949.69,390178.17
230930,201811,935,664,271,631532.5,258526.1,890058.6
230940,201811,847,675,172,643723.16,163881.63,807604.79
230945,201811,501,420,81,400184.47,77273.41,477457.88
230950,201811,387,331,56,315770.87,53422.02,369192.89
230960,201811,2582,1758,824,1670181.39,785739.01,2455920.40
230970,201811,1775,998,777,950690.44,740044.72,1690735.16
230980,201811,209,176,33,167901.41,31482,199383.41
230990,201811,140,114,26,108754.45,24046.54,132800.99
231000,201811,211,191,20,180298.88,19079.59,199378.47
231010,201811,141,110,31,104653.03,29572.41,134225.44
231020,201811,1312,918,394,873460.29,375843.87,1249304.16
231025,201811,1014,762,252,723768.66,238075.61,961844.27
231030,201811,1123,944,179,900263.35,170758.7,1071022.05
231040,201811,143,98,45,92744.24,42190.43,134934.67
231050,201811,990,883,107,840596.68,102076.2,942672.88
231060,201811,147,128,19,122108.77,18124.04,140232.81
231070,201811,1474,1040,434,990038.38,413990.52,1404028.90
231080,201811,261,244,17,231964.25,16215.97,248180.22
231085,201811,582,364,218,346278.95,207963.46,554242.41
231090,201811,243,201,42,191747.3,40064.87,231812.17
231095,201811,162,129,33,123064.79,31481.2,154545.99
231100,201811,137,115,22,109707.7,19747.2,129454.9
231110,201811,360,312,48,295444.94,45790.39,341235.33
231120,201811,294,253,41,241356.71,39110.85,280467.56
231123,201811,145,139,6,132601.88,5723.99,138325.87
231126,201811,317,254,63,242309.88,60096,302405.88
231130,201811,4598,3585,1013,3410782.04,965553.52,4376335.56
231135,201811,215,186,29,177439.45,26780.76,204220.21
231140,201811,3126,2293,833,2183996.54,793678.01,2977674.55
231150,201811,367,350,17,333895.57,16217.43,350113.00
231160,201811,1209,960,249,912739.53,237280.32,1150019.85
231170,201811,533,360,173,343436.75,165041.31,508478.06
231180,201811,1663,1418,245,1351946.19,233696.14,1585642.33
231190,201811,199,173,26,165035.69,24800.59,189836.28
231195,201811,220,189,31,179578.33,29572.99,209151.32
231200,201811,830,678,152,646807.95,144042.32,790850.27
231210,201811,601,505,96,480798.72,91581.91,572380.63
231220,201811,1044,756,288,718523.83,274748.49,993272.32
231230,201811,1422,1134,288,1080858.65,274454.49,1355313.14
231240,201811,1410,1026,384,978465.48,365279.29,1343744.77
231250,201811,112,104,8,99212.57,7631.36,106843.93
231260,201811,289,190,99,181259.63,94156.26,275415.89
231270,201811,1014,843,171,798864.5,163125.23,961989.73
231280,201811,62,47,15,44833.45,14309.46,59142.91
231290,201811,7325,4093,3232,3895895.71,3081825.81,6977721.52
231300,201811,631,585,46,558083.04,43882.99,601966.03
231310,201811,726,672,54,639848.74,51515.3,691364.04
231320,201811,581,442,139,421169.48,132573.43,553742.91
231325,201811,89,80,9,76316.89,8586,84902.89
231330,201811,2048,1576,472,1498094.12,448414.38,1946508.50
231335,201811,252,224,28,213677.58,26710.09,240387.67
231340,201811,1646,1212,434,1155075.51,413738.93,1568814.44
231350,201811,1234,1016,218,968949.38,207392,1176341.38
231355,201811,429,372,57,354874.1,54375.94,409250.04
231360,201811,495,386,109,365743.71,103979.97,469723.68
231370,201811,92,78,14,74408.56,13356,87764.56
231375,201811,293,215,78,205105.67,74409.12,279514.79
231380,201811,468,383,85,364565.25,80892.87,445458.12
231390,201811,199,162,37,154546.03,35296.7,189842.73
231395,201811,727,457,270,435375.22,257573.14,692948.36
231400,201811,1084,897,187,853109.24,178038.14,1031147.38
231410,201811,1336,1091,245,1036954.3,232730.47,1269684.77
240010,201811,396,177,219,167696.2,208618.56,376314.76
240020,201811,2240,1770,470,1685710.46,448362.75,2134073.21
240030,201811,130,111,19,105880.83,18124.29,124005.12
240040,201811,31,31,0,29571.26,0,29571.26
240050,201811,519,447,72,425574.6,68685.21,494259.81
240060,201811,66,62,4,59144.23,3815.46,62959.69
240070,201811,195,152,43,144998,41020.38,186018.38
240080,201811,464,310,154,295717.59,145949.34,441666.93
240090,201811,102,90,12,85553.41,11447.46,97000.87
240100,201811,1462,1384,78,1316387.25,74220.03,1390607.28
240110,201811,1036,668,368,636257.77,350927.6,987185.37
240120,201811,141,120,21,114476.56,20033.2,134509.76
240130,201811,286,268,18,254954.43,17172,272126.43
240140,201811,82,63,19,60096.54,18123.78,78220.32
240145,201811,716,634,82,604061.64,78225.8,682287.44
240150,201811,19,15,4,14309.66,3787.38,18097.04
240160,201811,43,37,6,35297.14,5724,41021.14
240165,201811,37,31,6,29327.79,5723.86,35051.65
240170,201811,92,70,22,66300.02,20985.64,87285.66
240180,201811,82,68,14,64869.56,13356,78225.56
240185,201811,44,40,4,38148.06,3815.15,41963.21
240190,201811,13,11,2,10493.2,1908,12401.2
240200,201811,3035,1703,1332,1618255.58,1269447.53,2887703.11
240210,201811,169,131,38,124968.47,36249.03,161217.50
240220,201811,1101,795,306,758274.69,291906.5,1050181.19
240230,201811,847,785,62,746028.3,58490.9,804519.2
240240,201811,124,87,37,82994.18,35294.75,118288.93
240250,201811,87,78,9,74408.46,8584.12,82992.58
240260,201811,1816,1354,462,1290997.61,439992.35,1730989.96
240270,201811,191,168,23,159885.56,21939.44,181825.00
240280,201811,42,32,10,30526.1,9540,40066.1
240290,201811,50,49,1,46744.33,954,47698.33
240300,201811,180,102,78,97015.68,74408.1,171423.78
240310,201811,2049,1122,927,1060453.93,881767.24,1942221.17
240320,201811,204,194,10,184924,9540,194464
240325,201811,4310,2628,1682,2499109.18,1601150.57,4100259.75
240330,201811,66,62,4,59146.02,3815.87,62961.89
240340,201811,109,79,30,75359.9,28619.43,103979.33
240350,201811,90,80,10,76316.96,9539.73,85856.69
240360,201811,455,312,143,297636.06,136410.18,434046.24
240370,201811,43,41,2,39111.48,1908,41019.48
240375,201811,70,42,28,40065.09,26711.16,66776.25
240380,201811,226,184,42,175533.06,39967.11,215500.17
240390,201811,14,12,2,11447.66,1908,13355.66
240400,201811,77,73,4,69638.75,3815.56,73454.31
240410,201811,11,7,4,6676.96,3816,10492.96
240420,201811,919,703,216,668113.87,205002.23,873116.10
240430,201811,265,249,16,236635.41,15264,251899.41
240440,201811,82,47,35,44835.61,33389.16,78224.77
240450,201811,216,148,68,140612.42,64869.03,205481.45
240460,201811,62,49,13,46743.22,12401.09,59144.31
240470,201811,239,206,33,195676.33,31480.91,227157.24
240480,201811,15,14,1,13260.01,954,14214.01
240485,201811,77,67,10,63909.51,9540,73449.51
240490,201811,48,47,1,44624.07,954,45578.07
240500,201811,85,68,17,64870.22,16217.83,81088.05
240510,201811,51,36,15,34343.06,14309.33,48652.39
240520,201811,119,114,5,108753.82,4769.12,113522.94
240530,201811,54,48,6,45789.91,5723.6,51513.51
240540,201811,77,67,10,63915.68,9539.2,73454.88
240550,201811,14,13,1,12402,954,13356
240560,201811,378,278,100,264100.29,95396.51,359496.80
240570,201811,467,293,174,278658.04,165992.88,444650.92
240580,201811,1251,1013,238,960882.97,225891.71,1186774.68
240590,201811,28,26,2,24803.93,1908,26711.93
240600,201811,111,108,3,103030.75,2861.2,105891.95
240610,201811,509,426,83,406041.94,79180.19,485222.13
240615,201811,20,19,1,18126,954,19080
240620,201811,96,92,4,87766.99,3816,91582.99
240630,201811,36,34,2,32435.36,1908,34343.36
240640,201811,27,22,5,20988,4770,25758
240650,201811,237,199,38,188970.3,36250.37,225220.67
240660,201811,101,87,14,82997.06,13355.8,96352.86
240670,201811,298,177,121,166753.95,115433.16,282187.11
240680,201811,50,39,11,37205.02,10494,47699.02
240690,201811,48,45,3,42927.2,2862,45789.2
240700,201811,192,158,34,150730.1,32433.38,183163.48
240710,201811,1927,1229,698,1170939.68,665840.6,1836780.28
240720,201811,1081,789,292,751526.89,278559.11,1030086.00
240725,201811,65,61,4,58193.08,3816,62009.08
240730,201811,136,117,19,111612.1,18124.03,129736.13
240740,201811,238,201,37,190386.86,34343.02,224729.88
240750,201811,41,28,13,26708.31,12400.8,39109.11
240760,201811,37,34,3,32431.22,2862,35293.22
240770,201811,149,116,33,110661.01,31481.48,142142.49
240780,201811,683,566,117,539475.68,111616.05,651091.73
240790,201811,37,36,1,34342.65,954,35296.65
240800,201811,8952,6106,2846,5788555.11,2708559.3,8497114.41
240810,201811,20205,11167,9038,10612590.54,8612298.41,19224888.95
240820,201811,214,135,79,128490.47,75363.02,203853.49
240830,201811,1639,1344,295,1275980.6,281419.23,1557399.83
240840,201811,83,73,10,69636.39,9540,79176.39
240850,201811,85,75,10,71547.55,9539.8,81087.35
240860,201811,110,107,3,102076.13,2862,104938.13
240870,201811,62,54,8,51513.93,7631.14,59145.07
240880,201811,30,27,3,25747.82,2861.6,28609.42
240890,201811,1193,706,487,669569.64,464563.46,1134133.10
240895,201811,52,37,15,35298,14309.4,49607.4
240910,201811,160,146,14,139277.15,13356,152633.15
240920,201811,15,12,3,11448,2862,14310
240930,201811,396,360,36,342481.06,34342.29,376823.35
240933,201811,35,27,8,25756.65,7632,33388.65
240940,201811,2457,2171,286,2056894.44,269954.39,2326848.83
240950,201811,52,49,3,46741.29,2861.63,49602.92
240960,201811,32,26,6,24804,5724,30528
240970,201811,120,85,35,81082.42,32632.7,113715.12
240980,201811,194,155,39,147860.85,36628.3,184489.15
240990,201811,125,83,42,79178.56,40063.64,119242.20
241000,201811,67,62,5,59146.27,4768.86,63915.13
241010,201811,64,51,13,48649.76,12400.82,61050.58
241020,201811,112,105,7,100167.87,6678,106845.87
241025,201811,10,4,6,3816,5724,9540
241030,201811,119,96,23,91581.31,21941.61,113522.92
241040,201811,36,30,6,28616.08,5722.05,34338.13
241050,201811,89,78,11,74409.51,10493.66,84903.17
241060,201811,29,24,5,22893.74,4769.13,27662.87
241070,201811,15,15,0,14308.48,0,14308.48
241080,201811,62,55,7,52181.29,6677.2,58858.49
241090,201811,49,40,9,38159.66,8571.69,46731.35
241100,201811,74,64,10,61053.82,9538.89,70592.71
241105,201811,6,2,4,1907.33,3816,5723.33
241110,201811,48,45,3,42929.06,2861.57,45790.63
241120,201811,1451,1114,337,1059255.49,321485.11,1380740.60
241140,201811,224,185,39,175523.36,37205.12,212728.48
241142,201811,42,39,3,37205.02,2862,40067.02
241150,201811,1226,1077,149,1024896.18,142139.77,1167035.95
241160,201811,23,22,1,20987.22,954,21941.22
241170,201811,44,40,4,38157.22,3814.67,41971.89
241180,201811,48,41,7,38939.42,6678,45617.42
241190,201811,38,37,1,35297.2,954,36251.2
241200,201811,3899,2111,1788,2008434.63,1703516.02,3711950.65
241210,201811,69,59,10,56285.2,8675.6,64960.8
241220,201811,1419,959,460,914386.56,438794.73,1353181.29
241230,201811,241,201,40,191751.9,38156.77,229908.67
241240,201811,55,42,13,40067.92,12402,52469.92
241250,201811,1112,1022,90,974487.66,85852.33,1060339.99
241255,201811,50,40,10,38157.55,9539.4,47696.95
241260,201811,637,500,137,476985.35,130692.01,607677.36
241270,201811,47,35,12,33388.02,11447.8,44835.82
241280,201811,102,88,14,83946.44,13355.85,97302.29
241290,201811,109,83,26,79180.26,24803.23,103983.49
241300,201811,75,55,20,52469.4,19078.27,71547.67
241310,201811,49,38,11,36106.66,10492.96,46599.62
241320,201811,27,14,13,13355.59,12402,25757.59
241330,201811,64,58,6,55327.37,5724,61051.37
241335,201811,65,58,7,54662.59,6678,61340.59
241340,201811,188,140,48,133552.33,45789.64,179341.97
241350,201811,62,57,5,54372.27,4770,59142.27
241355,201811,41,38,3,36249.88,2862,39111.88
241360,201811,49,48,1,45791.26,953.6,46744.86
241370,201811,48,39,9,37077.32,8585.07,45662.39
241380,201811,40,36,4,34340.98,3815.73,38156.71
241390,201811,78,63,15,59901.45,14308.06,74209.51
241400,201811,206,167,39,158439.75,37200.49,195640.24
241410,201811,183,166,17,158355.72,16120.38,174476.10
241415,201811,100,79,21,75364.15,20032.81,95396.96
241420,201811,99,74,25,70589.6,23668.55,94258.15
241430,201811,28,27,1,25757.91,953.86,26711.77
241440,201811,501,416,85,396837.21,81087,477924.21
241445,201811,38,36,2,34340.14,1908,36248.14
241450,201811,283,232,51,221319.65,48652.15,269971.80
241460,201811,138,127,11,120910.76,10494,131404.76
241470,201811,44,37,7,35298,6677.66,41975.66
241475,201811,63,60,3,57237.74,2861.2,60098.94
241480,201811,99,71,28,66771,26709.51,93480.51
241490,201811,8,7,1,6678,954,7632
241500,201811,46,33,13,31482,12402,43884
250010,201811,104,89,15,84833.02,14308.91,99141.93
250020,201811,33,29,4,27662.54,3816,31478.54
250030,201811,829,617,212,587255.24,201182.47,788437.71
250040,201811,343,286,57,272836.7,54088.71,326925.41
250050,201811,235,195,40,185726.5,38158.9,223885.4
250053,201811,55,42,13,40068,12402,52470
250057,201811,0,0,0,0,0,0
250060,201811,465,358,107,341528.54,101787.04,443315.58
250070,201811,700,582,118,553205.71,112570.34,665776.05
250073,201811,8,8,0,7632,0,7632
250077,201811,194,146,48,138892.55,45792,184684.55
250080,201811,423,330,93,313183,88721.21,401904.21
250090,201811,202,133,69,125909.71,65796.33,191706.04
250100,201811,508,420,88,399719.49,83560.1,483279.59
250110,201811,566,431,135,409373.34,128785.02,538158.36
250115,201811,24,7,17,6678,16218,22896
250120,201811,114,84,30,80131.4,28618.64,108750.04
250130,201811,576,467,109,445515.9,103787,549302.9
250135,201811,13,8,5,7632,4770,12402
250140,201811,81,74,7,70593.83,6676.9,77270.73
250150,201811,580,423,157,402635.44,149458.11,552093.55
250153,201811,8,7,1,6678,954,7632
250157,201811,27,22,5,20986.51,4770,25756.51
250160,201811,215,171,44,163132.78,41974.6,205107.38
250170,201811,64,44,20,41976,19078.38,61054.38
250180,201811,4101,2808,1293,2662354.21,1228337.07,3890691.28
250190,201811,874,579,295,550408.01,281184.3,831592.31
250200,201811,53,44,9,41975.41,8584.72,50560.13
250205,201811,23,20,3,19078.01,2862,21940.01
250210,201811,88,77,11,73457.83,10494,83951.83
250215,201811,63,54,9,51515.8,8586,60101.8
250220,201811,26,20,6,19079.53,5724,24803.53
250230,201811,78,71,7,67719.46,6678,74397.46
250240,201811,241,199,42,189031.5,40067.67,229099.17
250250,201811,397,339,58,323402.75,55327.25,378730.00
250260,201811,35,31,4,29572.43,3815.4,33387.83
250270,201811,61,47,14,44838,13354.64,58192.64
250280,201811,380,315,65,300505.03,62008.06,362513.09
250290,201811,93,87,6,82709.96,5724,88433.96
250300,201811,555,382,173,363764.97,164998.75,528763.72
250310,201811,46,42,4,40066.21,3816,43882.21
250320,201811,1999,1366,633,1297867.31,602320.43,1900187.74
250330,201811,90,79,11,75365.56,10494,85859.56
250340,201811,24,20,4,19078.53,3816,22894.53
250350,201811,144,94,50,89387.8,47126.06,136513.86
250355,201811,35,27,8,25756.19,7629.83,33386.02
250360,201811,202,165,37,157408.15,35293.66,192701.81
250370,201811,2392,1619,773,1538270.49,735859.09,2274129.58
250375,201811,10,6,4,5724,3816,9540
250380,201811,54,39,15,37205,14310,51515
250390,201811,43,35,8,33390,7632,41022
250400,201811,16102,8200,7902,7798389.52,7531432.01,15329821.53
250403,201811,388,315,73,300311.04,69639.84,369950.88
250407,201811,60,52,8,49604.69,7631.96,57236.65
250410,201811,31,27,4,25758,3816,29574
250415,201811,43,29,14,27646.34,13336.92,40983.26
250420,201811,46,39,7,37204.65,6678,43882.65
250430,201811,1513,1288,225,1226534.78,214646.47,1441181.25
250435,201811,16,13,3,12402,2862,15264
250440,201811,690,589,101,559194.46,96350.39,655544.85
250450,201811,88,72,16,68687.16,14595.4,83282.56
250460,201811,419,289,130,275701.07,124010.34,399711.41
250470,201811,84,62,22,59148,20988,80136
250480,201811,330,263,67,250899.61,63917.16,314816.77
250485,201811,1,1,0,954,0,954
250490,201811,230,192,38,183162.54,36251.19,219413.73
250500,201811,80,59,21,56284.75,20033.6,76318.35
250510,201811,724,571,153,543951.86,144948.06,688899.92
250520,201811,173,119,54,113511.3,51511.23,165022.53
250523,201811,118,99,19,94439.46,18125.91,112565.37
250527,201811,98,78,20,74405.25,19080,93485.25
250530,201811,8,5,3,4770,2862,7632
250535,201811,23,19,4,18126,3816,21942
250540,201811,127,98,29,92774.87,27665.73,120440.60
250550,201811,70,67,3,63915.86,2862,66777.86
250560,201811,40,30,10,28619.59,9538.1,38157.69
250570,201811,154,124,30,118293.67,28619.88,146913.55
250580,201811,125,99,26,94215.8,24804,119019.8
250590,201811,20,15,5,14310,4770,19080
250600,201811,1253,844,409,803228.71,390168.78,1193397.49
250610,201811,152,132,20,125928,19080,145008
250620,201811,24,20,4,19079.45,3816,22895.45
250625,201811,68,51,17,48652,16217,64869
250630,201811,3038,1959,1079,1860719.56,1028211.27,2888930.83
250640,201811,206,172,34,164086.63,32435.56,196522.19
250650,201811,29,20,9,19080,8586,27666
250660,201811,46,35,11,33387.94,10493.33,43881.27
250670,201811,62,42,20,40065.61,19079.84,59145.45
250680,201811,389,319,70,304323.77,66778.44,371102.21
250690,201811,1870,1296,574,1232883.71,546908.66,1779792.37
250700,201811,932,816,116,775787.56,110449.4,886236.96
250710,201811,442,345,97,329128.2,92533.36,421661.56
250720,201811,110,86,24,82043.03,22895.43,104938.46
250730,201811,385,327,58,310990.01,55330.05,366320.06
250740,201811,54,50,4,47697.82,3815.43,51513.25
250750,201811,20882,12639,8243,12003076.75,7855377.76,19858454.51
250760,201811,76,58,18,55330.09,17169.21,72499.30
250770,201811,351,230,121,217477.43,113397.26,330874.69
250780,201811,55,42,13,40067.41,12401.66,52469.07
250790,201811,471,305,166,289045.41,157647.07,446692.48
250800,201811,152,140,12,132844.5,11447.57,144292.07
250810,201811,81,62,19,59147.66,18125.11,77272.77
250820,201811,160,131,29,124971.83,27666,152637.83
250830,201811,421,290,131,275656,124974,400630
250840,201811,52,50,2,47700,1908,49608
250850,201811,56,44,12,41974.33,11446.86,53421.19
250855,201811,13,11,2,10493,1908,12401
250860,201811,203,146,57,139283.24,54090.76,193374.00
250870,201811,34,31,3,29573.42,2862,32435.42
250880,201811,81,62,19,59135.42,18125.51,77260.93
250890,201811,2540,1883,657,1794641.21,625885.82,2420527.03
250900,201811,125,108,17,103030.3,16216.65,119246.95
250905,201811,124,97,27,92534.74,25757.07,118291.81
250910,201811,1174,835,339,795012.95,323116.13,1118129.08
250915,201811,111,78,33,74410.81,31481.1,105891.91
250920,201811,136,105,31,100168.6,29574,129742.6
250930,201811,165,104,61,99214.5,58192.39,157406.89
250933,201811,1,1,0,954,0,954
250937,201811,6,5,1,4770,954,5724
250939,201811,31,24,7,22894.82,6677.02,29571.84
250940,201811,109,83,26,79176.07,24801.8,103977.87
250950,201811,70,47,23,44838,21942,66780
250960,201811,91,51,40,48653.33,38160,86813.33
250970,201811,1220,868,352,826430.01,335134.79,1161564.80
250980,201811,91,65,26,62009.8,24804,86813.8
250990,201811,168,129,39,122573.81,37132.88,159706.69
251000,201811,77,68,9,64681.2,8585.33,73266.53
251010,201811,103,81,22,77257.56,20208.1,97465.66
251020,201811,83,73,10,68828.41,9540,78368.41
251030,201811,44,33,11,31482,10494,41976
251040,201811,53,39,14,37205.44,13355.5,50560.94
251050,201811,23,21,2,20034,1908,21942
251060,201811,51,40,11,37204.85,10494,47698.85
251065,201811,3,3,0,2862,0,2862
251070,201811,24,19,5,18111,4770,22881
251080,201811,4799,2329,2470,2211542.64,2349700.16,4561242.80
251090,201811,197,169,28,161225.66,26712,187937.66
251100,201811,18,17,1,16218,954,17172
251110,201811,44,35,9,33389.86,8586,41975.86
251120,201811,1837,1120,717,1063798.86,683722.29,1747521.15
251130,201811,386,315,71,300504.01,67732.99,368237.00
251140,201811,529,345,184,327957.33,175362.3,503319.63
251150,201811,307,265,42,252023.7,40066.64,292090.34
251160,201811,99,83,16,79167.23,15263.16,94430.39
251170,201811,99,78,21,74383.38,20028.54,94411.92
251180,201811,289,182,107,173607.97,102058.64,275666.61
251190,201811,189,128,61,121781.01,58193.34,179974.35
251200,201811,254,207,47,197476.24,44837.72,242313.96
251203,201811,36,34,2,32436,1908,34344
251207,201811,95,79,16,75364.93,15263.26,90628.19
251210,201811,1442,1045,397,995315.54,378435.92,1373751.46
251220,201811,45,36,9,34344,8586,42930
251230,201811,463,390,73,372056.04,69638.81,441694.85
251240,201811,102,74,28,69641.56,26712,96353.56
251250,201811,1354,970,384,922464.37,366185.24,1288649.61
251260,201811,13,8,5,7632,4770,12402
251270,201811,335,252,83,240406.06,79037.05,319443.11
251272,201811,65,59,6,56285.78,5724,62009.78
251274,201811,28,22,6,20988,5724,26712
251275,201811,24,16,8,15264,7631.41,22895.41
251276,201811,13,11,2,10494,1908,12402
251278,201811,9,7,2,6678,1908,8586
251280,201811,103,98,5,93488.22,4768.82,98257.04
251290,201811,711,536,175,511330.25,166938.47,678268.72
251300,201811,16,13,3,12402,2862,15264
251310,201811,374,270,104,257560.28,99210.62,356770.90
251315,201811,19,18,1,17171.13,954,18125.13
251320,201811,61,49,12,46746,11446.19,58192.19
251330,201811,80,71,9,67733.39,8586,76319.39
251335,201811,12,7,5,6676.75,4770,11446.75
251340,201811,706,416,290,396268.12,275620.28,671888.40
251350,201811,37,35,2,33389.4,1908,35297.4
251360,201811,74,64,10,61051.16,9538.5,70589.66
251365,201811,14,14,0,13356,0,13356
251370,201811,5424,3695,1729,3519864.46,1648046,5167910.46
251380,201811,49,40,9,38159.27,8586,46745.27
251385,201811,3,3,0,2862,0,2862
251390,201811,706,555,151,528307.28,142805.93,671113.21
251392,201811,11,5,6,4770,5724,10494
251394,201811,9,9,0,8586,0,8586
251396,201811,14,9,5,8586,4770,13356
251398,201811,18,15,3,14310,2862,17172
251400,201811,42,35,7,33389.25,6678,40067.25
251410,201811,37,31,6,29573.25,5724,35297.25
251420,201811,102,76,26,72504,24804,97308
251430,201811,41,38,3,36251.6,2862,39113.6
251440,201811,34,22,12,20988,11448,32436
251445,201811,57,52,5,49603.39,4770,54373.39
251450,201811,411,362,49,343677.82,46746,390423.82
251455,201811,2,1,1,954,954,1908
251460,201811,17,13,4,12401.03,3816,16217.03
251465,201811,6,3,3,2862,2862,5724
251470,201811,47,37,10,35298,9540,44838
251480,201811,26,23,3,21942,2862,24804
251490,201811,119,82,37,77750,34334,112084
251500,201811,126,101,25,96351.91,23083.51,119435.42
251510,201811,38,30,8,28619.15,7631.5,36250.65
251520,201811,25,25,0,23848.7,0,23848.7
251530,201811,4519,3181,1338,3028080.63,1276128.73,4304209.36
251540,201811,74,65,9,62010,8586,70596
251550,201811,411,317,94,301460.2,89142,390602.2
251560,201811,23,16,7,15264,6676.35,21940.35
251570,201811,20,20,0,19079.56,0,19079.56
251580,201811,125,103,22,98261.83,20986.76,119248.59
251590,201811,121,90,31,86034.09,29574,115608.09
251593,201811,26,16,10,15262.38,9539.43,24801.81
251597,201811,59,48,11,45791.77,10494,56285.77
251600,201811,1097,781,316,743705.4,299812.72,1043518.12
251610,201811,214,163,51,155501.12,47975.83,203476.95
251615,201811,3,3,0,2861.43,0,2861.43
251620,201811,4295,2858,1437,2716602.97,1368266.19,4084869.16
251630,201811,445,327,118,311947.42,112555.27,424502.69
251640,201811,149,107,42,102076.2,40068,142144.2
251650,201811,273,199,74,188008.54,70593.67,258602.21
251660,201811,225,203,22,193656.36,20796.22,214452.58
251670,201811,360,281,79,266365.86,75360.75,341726.61
251675,201811,3,3,0,2862,0,2862
251680,201811,97,87,10,82995.29,9540,92535.29
251690,201811,344,287,57,272838.14,54027.53,326865.67
251700,201811,283,241,42,229324.68,40053.69,269378.37
251710,201811,23,15,8,14308.72,7631.09,21939.81
251720,201811,31,21,10,20034,9252,29286
251740,201811,10,8,2,7632,1908,9540
260005,201811,3174,1805,1369,1710802.51,1305092.87,3015895.38
260010,201811,1550,1116,434,1060466.75,411729.96,1472196.71
260020,201811,429,380,49,362513.7,46746,409259.7
260030,201811,580,420,160,399903.45,152635.57,552539.02
260040,201811,856,534,322,508331.7,307168.77,815500.47
260050,201811,1155,835,320,796324.21,304027.08,1100351.29
260060,201811,410,371,39,353161.4,37205.2,390366.6
260070,201811,1457,916,541,871022.19,513133.04,1384155.23
260080,201811,730,576,154,548681.61,146910.9,695592.51
260090,201811,574,358,216,341278.96,206061.72,547340.68
260100,201811,238,169,69,160399.09,65821.97,226221.06
260105,201811,231,131,100,124970.83,95399.52,220370.35
260110,201811,2778,2053,725,1958500.86,691340.87,2649841.73
260120,201811,2930,1460,1470,1383069.39,1400011.63,2783081.02
260130,201811,160,113,47,107794.24,44835.25,152629.49
260140,201811,2165,1427,738,1351460.75,701705.76,2053166.51
260150,201811,227,149,78,142144.49,74409.64,216554.13
260160,201811,302,253,49,241357.1,46743.6,288100.7
260170,201811,3422,2098,1324,1994392.98,1261670.2,3256063.18
260180,201811,150,126,24,120194.46,22893.72,143088.18
260190,201811,2298,1619,679,1541338.32,647738.44,2189076.76
260200,201811,930,756,174,719707.57,165697.87,885405.44
260210,201811,1429,1016,413,969085.81,393017.07,1362102.88
260220,201811,731,663,68,632488.43,64869.34,697357.77
260230,201811,1216,922,294,877371.85,280465.22,1157837.07
260240,201811,230,175,55,165988.01,52469.59,218457.60
260250,201811,83,62,21,59144.5,20033.18,79177.68
260260,201811,1001,722,279,688769.32,266154.38,954923.70
260270,201811,429,347,82,329648.03,77941.5,407589.53
260280,201811,1388,928,460,884791.3,438481.46,1323272.76
260290,201811,6446,3483,2963,3304158.24,2819816.82,6123975.06
260300,201811,891,783,108,744872.68,102739.32,847612.00
260310,201811,518,412,106,391661.83,101115.67,492777.50
260320,201811,885,666,219,635074.49,208915.4,843989.89
260330,201811,38,29,9,27662.76,8585.39,36248.15
260340,201811,75,54,21,51511.98,20033.4,71545.38
260345,201811,5645,3166,2479,3014253.66,2363845.72,5378099.38
260350,201811,495,360,135,341405.35,128787.83,470193.18
260360,201811,282,145,137,138321.09,130667.84,268988.93
260370,201811,680,451,229,426429.61,218440.25,644869.86
260380,201811,619,443,176,422615.26,166749.85,589365.11
260390,201811,300,254,46,241228.88,42926.67,284155.55
260392,201811,103,90,13,85850.29,12401.77,98252.06
260400,201811,4078,2349,1729,2232420.32,1649028.49,3881448.81
260410,201811,14673,7782,6891,7408778.13,6570912.74,13979690.87
260415,201811,123,112,11,106846.52,10494,117340.52
260420,201811,1802,1084,718,1029174.87,683581.99,1712756.86
260430,201811,191,174,17,164965.43,16216.71,181182.14
260440,201811,225,162,63,153809.02,60101.02,213910.04
260450,201811,477,346,131,328779.71,124974,453753.71
260460,201811,846,451,395,427548.22,376813.39,804361.61
260470,201811,371,230,141,218649.24,134408.59,353057.83
260480,201811,221,142,79,135456.35,75361.32,210817.67
260490,201811,217,177,40,168852.19,38159.16,207011.35
260500,201811,1140,773,367,735101.39,349823.89,1084925.28
260510,201811,756,603,153,574286.97,145005.28,719292.25
260515,201811,254,229,25,218461.5,23373,241834.5
260520,201811,3341,2002,1339,1902454.4,1274661.61,3177116.01
260530,201811,810,658,152,625217.28,145001.78,770219.06
260540,201811,564,431,133,411161.32,125918.16,537079.48
260545,201811,12,9,3,8586,2862,11448
260550,201811,350,219,131,208913.29,124970.63,333883.92
260560,201811,526,398,128,378818.83,121825.4,500644.23
260570,201811,1013,831,182,790035.7,173334.28,963369.98
260580,201811,258,230,28,219411.25,26710.35,246121.60
260590,201811,650,375,275,356323.35,262338.87,618662.22
260600,201811,8122,4214,3908,4000357.14,3723665.53,7724022.67
260610,201811,498,336,162,320530.56,154258.2,474788.76
260620,201811,3720,1947,1773,1844868.7,1688422.4,3533291.1
260630,201811,80,77,3,73454.07,2862,76316.07
260640,201811,3717,2042,1675,1943670.08,1597809.74,3541479.82
260650,201811,319,232,87,221324.36,82378.8,303703.16
260660,201811,521,355,166,338280.69,158360.49,496641.18
260670,201811,102,74,28,70594.33,26711.19,97305.52
260680,201811,3681,2077,1604,1964418.58,1529730.83,3494149.41
260690,201811,125,96,29,91578.61,27664.39,119243.00
260700,201811,334,206,128,195757.39,122108.95,317866.34
260710,201811,37,34,3,32434.39,2862,35296.39
260720,201811,2277,1373,904,1303543.18,860020.97,2163564.15
260730,201811,628,476,152,454072.31,142803.11,596875.42
260740,201811,59,55,4,52467.92,3815.33,56283.25
260750,201811,642,450,192,428968.09,183163.32,612131.41
260760,201811,627,339,288,323401.04,274743.08,598144.12
260765,201811,989,519,470,492162.05,448137.38,940299.43
260770,201811,225,170,55,162172.73,52467.16,214639.89
260775,201811,822,492,330,467963.82,314797.93,782761.75
260780,201811,269,176,93,167894.86,88719.23,256614.09
260790,201811,12228,6742,5486,6406328.49,5225745.92,11632074.41
260795,201811,167,116,51,109490.64,48650.48,158141.12
260800,201811,287,239,48,227515.81,45788.74,273304.55
260805,201811,175,114,61,108022.09,58191.16,166213.25
260810,201811,738,646,92,615023.98,87762.56,702786.54
260820,201811,320,214,106,202796.69,101121.05,303917.74
260825,201811,201,139,62,132431.37,59148,191579.37
260830,201811,269,171,98,163127.18,93486.86,256614.04
260840,201811,238,173,65,164362.26,62004.85,226367.11
260845,201811,215,145,70,138327.75,66778.11,205105.86
260850,201811,508,374,134,355117.39,127834.53,482951.92
260860,201811,257,191,66,182012.43,62961.47,244973.90
260870,201811,374,273,101,259337.73,96352.21,355689.94
260875,201811,735,521,214,495903.64,204150.17,700053.81
260880,201811,1611,996,615,948471.14,586479.74,1534950.88
260890,201811,2432,1717,715,1632510.83,680838.71,2313349.54
260900,201811,1030,711,319,676974.51,304321.33,981295.84
260910,201811,279,219,60,208921.51,57236.73,266158.24
260915,201811,313,217,96,207012.43,91582.19,298594.62
260920,201811,178,99,79,94439.26,75362.1,169801.36
260930,201811,394,339,55,323357.23,52380.39,375737.62
260940,201811,2900,1593,1307,1515741.11,1246342.4,2762083.51
260950,201811,2055,1193,862,1131725.01,822333.41,1954058.42
260960,201811,14131,7365,6766,6994095.66,6446238.01,13440333.67
260970,201811,439,379,60,360575.38,57238.08,417813.46
260980,201811,194,171,23,162840.66,21941.85,184782.51
260990,201811,2593,2128,465,2027494.92,442644.74,2470139.66
261000,201811,4375,2590,1785,2458490.01,1701022.48,4159512.49
261010,201811,180,136,44,129742.46,41976,171718.46
261020,201811,613,462,151,440585.05,144050.34,584635.39
261030,201811,226,169,57,161200.63,54126.87,215327.50
261040,201811,367,325,42,310041.04,39777.41,349818.45
261050,201811,489,427,62,407344.91,59141.66,466486.57
261060,201811,1345,892,453,848796.81,432146.94,1280943.75
261070,201811,9008,4593,4415,4355464.98,4204837.05,8560302.03
261080,201811,391,296,95,281598.56,90626.77,372225.33
261090,201811,2280,1746,534,1656999.27,507680.95,2164680.22
261100,201811,1093,767,326,729645.75,309395.66,1039041.41
261110,201811,8263,5069,3194,4830876.78,3043987.7,7874864.48
261120,201811,268,226,42,215593.87,40061.4,255655.27
261130,201811,575,337,238,320962.1,226853.03,547815.13
261140,201811,189,123,66,117339.84,62963.16,180303.00
261150,201811,686,417,269,397309.25,255662.13,652971.38
261153,201811,74,70,4,65819.92,3815.73,69635.65
261160,201811,77782,39240,38542,37313196.63,36742615.44,74055812.07
261170,201811,455,344,111,327530.79,105889.78,433420.57
261180,201811,1819,1124,695,1067134.5,663007.66,1730142.16
261190,201811,616,430,186,409939.37,177426.06,587365.43
261200,201811,220,191,29,181490.24,27665,209155.24
261210,201811,33,29,4,27665.12,3815.56,31480.68
261220,201811,2643,1863,780,1770766.01,743505.08,2514271.09
261230,201811,339,249,90,237535.66,85839.67,323375.33
261240,201811,458,396,62,373757.59,59146.43,432904.02
261245,201811,229,191,38,182207.3,36251.95,218459.25
261247,201811,162,126,36,120192.81,34343.4,154536.21
261250,201811,2888,1469,1419,1400306.9,1352289.75,2752596.65
261255,201811,257,232,25,221038.79,23849.07,244887.86
261260,201811,870,753,117,718343.86,111612.51,829956.37
261270,201811,179,137,42,130690.25,40064.82,170755.07
261280,201811,174,146,28,139275.45,26711.56,165987.01
261290,201811,127,89,38,84666.72,36252,120918.72
261300,201811,1253,900,353,858569.63,336751.9,1195321.53
261310,201811,780,521,259,496158.95,246458.82,742617.77
261320,201811,563,381,182,363455.87,173615.55,537071.42
261330,201811,973,751,222,713431.88,210937.66,924369.54
261340,201811,300,170,130,162177.51,124018.01,286195.52
261350,201811,823,588,235,559981.1,224187.41,784168.51
261360,201811,1259,821,438,782789.66,417766.05,1200555.71
261370,201811,5005,3077,1928,2920566.76,1836304.4,4756871.16
261380,201811,576,426,150,404493.94,142808.95,547302.89
261390,201811,3496,2332,1164,2220530.85,1107117.7,3327648.55
261400,201811,284,257,27,244598.64,25757,270355.64
261410,201811,1097,734,363,700213.67,346297.41,1046511.08
261420,201811,887,558,329,531022.34,313828.73,844851.07
261430,201811,332,301,31,286297.15,29287.09,315584.24
261440,201811,124,113,11,107790.57,10494,118284.57
261450,201811,2519,2084,435,1985411.93,414721.56,2400133.49
261460,201811,741,594,147,565714.15,140234.82,705948.97
261470,201811,258,199,59,189011.67,56246.73,245258.40
261480,201811,373,297,76,282360.81,72480.92,354841.73
261485,201811,347,214,133,203474.96,126876.85,330351.81
261500,201811,627,424,203,404491.43,193657.11,598148.54
261510,201811,49,33,16,31480.28,15261.09,46741.37
261520,201811,112,99,13,94441.13,12402,106843.13
261530,201811,4189,2659,1530,2528810.38,1457333.76,3986144.14
261540,201811,1132,696,436,663486.42,415923.34,1079409.76
261550,201811,294,147,147,139122.2,140215.01,279337.21
261560,201811,819,546,273,518473.02,259275.06,777748.08
261570,201811,385,301,84,287145.59,80134.11,367279.70
261580,201811,384,298,86,283521.21,82040.54,365561.75
261590,201811,196,160,36,152636.23,34342.12,186978.35
261600,201811,303,241,62,229137.99,58667.82,287805.81
261610,201811,104,92,12,87289.51,11447.39,98736.90
261618,201811,65,51,14,48651.57,13355,62006.57
261620,201811,202,125,77,119248.42,73455.84,192704.26
261630,201811,584,453,131,429795.7,124970.51,554766.21
261640,201811,6453,3445,3008,3277915.79,2865606.09,6143521.88
261650,201811,507,326,181,310304.13,172668.33,482972.46
270010,201811,539,478,61,455709.87,57429,513138.87
270020,201811,306,242,64,230852.32,61056,291908.32
270030,201811,9292,5991,3301,5695271.45,3145663.89,8840935.34
270040,201811,2032,1256,776,1197903.36,739040.2,1936943.56
270050,201811,175,128,47,122111,44837.07,166948.07
270060,201811,115,65,50,62010,47700,109710
270070,201811,905,659,246,627156.34,234369.67,861526.01
270080,201811,38,32,6,30528,5724,36252
270090,201811,20,16,4,15262.74,3816,19078.74
270100,201811,1242,825,417,785170.96,395662.21,1180833.17
270110,201811,144,108,36,103030.02,34343.03,137373.05
270120,201811,227,186,41,176588.73,39113.8,215702.53
270130,201811,252,175,77,166655.84,73455.45,240111.29
270135,201811,100,60,40,57238.56,38156.79,95395.35
270140,201811,1329,811,518,772521.62,493195.11,1265716.73
270150,201811,267,212,55,202242.62,52469.33,254711.95
270160,201811,528,394,134,375863.49,127166.68,503030.17
270170,201811,765,495,270,471068.85,256331.3,727400.15
270180,201811,72,56,16,53104.48,15053.25,68157.73
270190,201811,100,89,11,84905.4,10494,95399.4
270200,201811,108,97,11,92346.21,10494,102840.21
270210,201811,478,253,225,241355.83,214361.39,455717.22
270220,201811,185,144,41,137374.49,39114,176488.49
270230,201811,2130,1290,840,1225113.14,800260.13,2025373.27
270235,201811,729,554,175,527339.66,166762.25,694101.91
270240,201811,3138,2457,681,2331230.81,646837.38,2978068.19
270250,201811,172,122,50,116384.92,47698.92,164083.84
270255,201811,222,191,31,182212.56,29190.09,211402.65
270260,201811,348,277,71,264247.47,67732.82,331980.29
270270,201811,110,47,63,44822,60101.46,104923.46
270280,201811,207,126,81,120203.66,77253.4,197457.06
270290,201811,1208,923,285,879279.83,270996.73,1150276.56
270300,201811,292,191,101,182210.18,96066,278276.18
270310,201811,917,739,178,702655.75,169091.7,871747.45
270320,201811,891,762,129,725542.6,122776.84,848319.44
270330,201811,280,235,45,223221.34,42929.29,266150.63
270340,201811,61,50,11,47699.48,10494,58193.48
270350,201811,92,47,45,44599.5,42930,87529.5
270360,201811,71,39,32,37203.81,30528,67731.81
270370,201811,55,44,11,41973.7,10494,52467.7
270375,201811,69,43,26,41019.92,24803.56,65823.48
270380,201811,1068,618,450,588605.88,429290.88,1017896.76
270390,201811,191,110,81,104938.28,77272.48,182210.76
270400,201811,713,523,190,497699.54,181257.45,678956.99
270410,201811,703,509,194,485262.04,185063.9,670325.94
270420,201811,413,273,140,258736.59,133467.23,392203.82
270430,201811,33195,23823,9372,22666227.36,8932995.48,31599222.84
270440,201811,495,389,106,371098.19,100837.8,471935.99
270450,201811,782,419,363,398881.71,345331.51,744213.22
270460,201811,195,152,43,145002.67,41021.56,186024.23
270470,201811,1434,959,475,914204.77,453142.4,1367347.17
270480,201811,544,444,100,421260.52,94681.03,515941.55
270490,201811,25,20,5,19080,4770,23850
270500,201811,517,426,91,406383.33,86807.5,493190.83
270510,201811,743,457,286,435968.16,272838.77,708806.93
270520,201811,349,217,132,206799,125928,332727
270530,201811,65,58,7,54027.38,6678,60705.38
270540,201811,122,93,29,88719.78,27666,116385.78
270550,201811,1733,1311,422,1250039.2,402089.58,1652128.78
270560,201811,310,149,161,142144.91,153592.5,295737.41
270570,201811,481,330,151,312885.84,143849.94,456735.78
270580,201811,86,65,21,61466.05,20033.88,81499.93
270590,201811,73,59,14,56286,13355.6,69641.6
270600,201811,179,146,33,139281.08,31480.56,170761.64
270610,201811,203,169,34,161202.94,32435.7,193638.64
270620,201811,30,29,1,27666,954,28620
270630,201811,3934,3003,931,2853063.41,885981.64,3739045.05
270640,201811,906,668,238,635462.88,226728.23,862191.11
270642,201811,222,187,35,178392.71,33389.09,211781.80
270644,201811,262,179,83,170568.03,79177.23,249745.26
270650,201811,284,168,116,160267.61,110655.12,270922.73
270660,201811,253,205,48,195566.34,45792,241358.34
270670,201811,3172,2413,759,2291899.81,721255.64,3013155.45
270680,201811,467,270,197,257560.45,187928.05,445488.50
270690,201811,1143,730,413,694647.46,393979.03,1088626.49
270700,201811,36,27,9,25757.8,8585.96,34343.76
270710,201811,905,686,219,652999.02,208925.15,861924.17
270720,201811,260,200,60,190794.1,56952.52,247746.62
270730,201811,1965,1156,809,1099905.68,769202.79,1869108.47
270740,201811,44,27,17,25757.01,16218,41975.01
270750,201811,668,489,179,466297.52,170083.51,636381.03
270760,201811,304,218,86,207969.6,82041.14,290010.74
270770,201811,2832,1816,1016,1726017.04,968249.59,2694266.63
270780,201811,89,56,33,53419.23,31444.46,84863.69
270790,201811,260,175,85,166948.66,81088.64,248037.30
270800,201811,2001,1610,391,1534114.15,371510.74,1905624.89
270810,201811,297,238,59,227034.04,56267.33,283301.37
270820,201811,160,106,54,101121.83,51415.2,152537.03
270830,201811,894,648,246,617405.61,234384.84,851790.45
270840,201811,1427,1058,369,1008560.24,350335.92,1358896.16
270850,201811,1638,1002,636,949160.09,606714.19,1555874.28
270860,201811,2504,1639,865,1561987.19,822267.29,2384254.48
270870,201811,124,68,56,64870.6,53421.8,118292.4
270880,201811,922,692,230,659193.7,218521.59,877715.29
270890,201811,334,244,90,232429.36,85853.82,318283.18
270895,201811,72,63,9,60101,8586,68687
270900,201811,101,78,23,74411.83,21942,96353.83
270910,201811,324,254,70,241170.11,66779.2,307949.31
270915,201811,1907,1166,741,1107552.15,703877.56,1811429.71
270920,201811,495,417,78,397807.31,74410.65,472217.96
270930,201811,6216,4543,1673,4328213.19,1593220.97,5921434.16
270940,201811,2390,1821,569,1734940.75,541831.36,2276772.11
280010,201811,43,38,5,36251.11,4769.94,41021.05
280020,201811,729,630,99,598102.22,93487.46,691589.68
280030,201811,20166,13041,7125,12354860.74,6766739.29,19121600.03
280040,201811,341,222,119,211783.02,112093.24,323876.26
280050,201811,388,300,88,285902.89,83948.16,369851.05
280060,201811,339,228,111,215388.7,105890.13,321278.83
280067,201811,984,696,288,662016.18,273787.37,935803.55
280070,201811,136,113,23,107795.94,21941.41,129737.35
280100,201811,617,488,129,462782.73,122865.38,585648.11
280110,201811,78,73,5,69640.75,4769.6,74410.35
280120,201811,626,500,126,476987.89,120200.81,597188.70
280130,201811,1432,906,526,862839.65,501640.93,1364480.58
280140,201811,480,391,89,372047,83950.49,455997.49
280150,201811,351,256,95,242577.59,90624.82,333202.41
280160,201811,97,84,13,80132.18,12402,92534.18
280170,201811,430,280,150,265901.33,143094.54,408995.87
280190,201811,27,25,2,23849.43,1908,25757.43
280200,201811,28,22,6,20987,5724,26711
280210,201811,2826,2013,813,1901787.7,769703.75,2671491.45
280220,201811,41,31,10,29572.5,9539.14,39111.64
280230,201811,327,272,55,258642.16,52469.2,311111.36
280240,201811,117,111,6,105745.65,5724,111469.65
280250,201811,17,11,6,10494,5724,16218
280260,201811,85,75,10,71547.88,9540,81087.88
280270,201811,159,124,35,118294.38,33388.61,151682.99
280280,201811,195,127,68,121153.96,64871.08,186025.04
280290,201811,3181,2305,876,2187099.3,834524.71,3021624.01
280300,201811,1613,1234,379,1173327.64,361558.02,1534885.66
280310,201811,107,103,4,97851.01,3816,101667.01
280320,201811,662,454,208,433104.98,198428,631532.98
280330,201811,367,264,103,251852.41,98133.81,349986.22
280340,201811,420,338,82,321724.76,77461.32,399186.08
280350,201811,3565,2767,798,2628244.77,758524.77,3386769.54
280360,201811,447,282,165,269022.22,156450.16,425472.38
280370,201811,101,90,11,85856.08,10494,96350.08
280380,201811,56,43,13,41020.18,12402,53422.18
280390,201811,184,156,28,148817.03,26711.8,175528.83
280400,201811,343,233,110,221361.17,104935.91,326297.08
280410,201811,287,233,54,221311.63,51514.83,272826.46
280420,201811,173,145,28,138327.98,26712,165039.98
280430,201811,112,86,26,82040.08,24695.46,106735.54
280440,201811,700,543,157,513115.02,149572.87,662687.89
280445,201811,120,112,8,106845.37,7631.64,114477.01
280450,201811,1150,988,162,939108.47,154540.77,1093649.24
280460,201811,764,564,200,530395,190796.33,721191.33
280470,201811,191,176,15,167903.33,13345,181248.33
280480,201811,2381,1696,685,1601508.01,651131.62,2252639.63
280490,201811,351,323,28,307020.81,26712,333732.81
280500,201811,42,38,4,36250.79,3816,40066.79
280510,201811,144,112,32,106544.7,30239.48,136784.18
280520,201811,55,41,14,39112.5,13356,52468.5
280530,201811,75,51,24,48654,22896,71550
280540,201811,524,424,100,403394.7,95113.4,498508.1
280550,201811,737,677,60,644057.1,57238.98,701296.08
280560,201811,504,439,65,415959.36,62006.83,477966.19
280570,201811,1804,1378,426,1309725.64,405538.89,1715264.53
280580,201811,611,471,140,447857.11,133456.6,581313.71
280590,201811,169,109,60,103979.63,57240,161219.63
280600,201811,377,318,59,303361.51,56284.74,359646.25
280610,201811,135,102,33,97308,31480.8,128788.8
280620,201811,544,449,95,426577.53,90476.7,517054.23
280630,201811,165,138,27,131645.64,25757.38,157403.02
280640,201811,201,163,38,154655.1,36251.77,190906.87
280650,201811,78,54,24,51513.84,22896,74409.84
280660,201811,140,101,39,96353.09,36966.26,133319.35
280670,201811,1731,1093,638,1032784.63,604247.59,1637032.22
280680,201811,182,155,27,146078.06,25758,171836.06
280690,201811,59,49,10,46741.4,9539.6,56281.0
280700,201811,21,21,0,20032.47,0,20032.47
280710,201811,1439,1102,337,1042469.24,321496.19,1363965.43
280720,201811,118,80,38,73539.03,36249.97,109789.00
280730,201811,27,23,4,21941,3816,25757
280740,201811,2474,1834,640,1742553.27,609706.53,2352259.80
280750,201811,227,201,26,191754,24804,216558
280760,201811,670,456,214,434814.59,204152.59,638967.18
290010,201811,203,137,66,130694.07,62960.41,193654.48
290020,201811,176,163,13,155501.46,12402,167903.46
290030,201811,600,394,206,374621.98,196518.28,571140.26
290035,201811,133,109,24,101491.36,22895.55,124386.91
290040,201811,282,180,102,171708.97,97305.23,269014.20
290050,201811,81,62,19,59143.91,18125.2,77269.11
290060,201811,263,121,142,115144.75,135466.48,250611.23
290070,201811,5636,2792,2844,2655556.8,2711152.51,5366709.31
290080,201811,496,222,274,211416.29,261343.15,472759.44
290090,201811,391,172,219,164081.52,208918.21,372999.73
290100,201811,1618,1073,545,1019541.92,519350,1538891.92
290110,201811,817,490,327,464855.55,311411.87,776267.42
290115,201811,207,189,18,179349.1,17170.74,196519.84
290120,201811,774,505,269,481095.29,256619.91,737715.20
290130,201811,426,254,172,242018.16,164086.2,406104.36
290135,201811,301,226,75,214925.45,71549.13,286474.58
290140,201811,305,255,50,243259.85,47699.8,290959.65
290150,201811,129,96,33,91553.6,31480.59,123034.19
290160,201811,252,190,62,180008.15,59142.35,239150.50
290170,201811,88,63,25,60098.74,23850,83948.74
290180,201811,164,128,36,122106.14,34342.9,156449.04
290190,201811,442,363,79,346003.65,75078.49,421082.14
290195,201811,311,190,121,181249.09,115433.21,296682.30
290200,201811,278,231,47,220372.46,44836.03,265208.49
290205,201811,149,93,56,88717.61,53419.53,142137.14
290210,201811,1146,831,315,791590.93,300501.32,1092092.25
290220,201811,228,128,100,121628.59,95397.7,217026.29
290225,201811,289,112,177,106838.29,168848.15,275686.44
290230,201811,63,41,22,39110.22,20987.6,60097.82
290240,201811,308,120,188,114191.23,179346.13,293537.36
290250,201811,265,244,21,232071.01,20033.56,252104.57
290260,201811,299,241,58,228854.76,55331.02,284185.78
290265,201811,189,158,31,149904.39,29574,179478.39
290270,201811,1414,1171,243,1115914.91,230662.81,1346577.72
290280,201811,466,341,125,324562.46,119247.56,443810.02
290290,201811,1258,738,520,696902.27,496067.8,1192970.07
290300,201811,453,383,70,365084.77,66780,431864.77
290310,201811,314,141,173,134508.34,165039.31,299547.65
290320,201811,4025,2501,1524,2382213.52,1452034.95,3834248.47
290323,201811,184,160,24,152636.29,22895.28,175531.57
290327,201811,161,126,35,119927.3,33388.73,153316.03
290330,201811,88,48,40,45787.11,38157.06,83944.17
290340,201811,912,366,546,347516.22,520585.83,868102.05
290350,201811,606,362,244,345336.24,232769.61,578105.85
290360,201811,372,278,94,264237.5,89674.06,353911.56
290370,201811,904,371,533,353900.48,508434.18,862334.66
290380,201811,309,188,121,179348.08,115431.24,294779.32
290390,201811,2496,1567,929,1491014.12,884348.95,2375363.07
290395,201811,249,142,107,134935.67,102076.86,237012.53
290400,201811,284,208,76,198138.77,72502.33,270641.10
290405,201811,241,212,29,202244.47,27666,229910.47
290410,201811,595,508,87,481614.22,82996.89,564611.11
290420,201811,239,188,51,179347.04,48651.17,227998.21
290430,201811,493,313,180,298593.55,171716.17,470309.72
290440,201811,73,64,9,61054.59,8585.26,69639.85
290450,201811,236,182,54,173618.14,51513.86,225132.00
290460,201811,1914,1149,765,1094174.93,729302.32,1823477.25
290470,201811,1433,605,828,575965.66,789473.67,1365439.33
290475,201811,588,550,38,523821.92,36250.86,560072.78
290480,201811,292,166,126,158359.1,120201.82,278560.92
290485,201811,231,217,14,207006.13,13353.65,220359.78
290490,201811,1190,860,330,820424.35,313857.04,1134281.39
290500,201811,709,362,347,344100.68,331031.23,675131.91
290510,201811,222,169,53,161224.89,50562,211786.89
290515,201811,139,84,55,80132.02,52469.69,132601.71
290520,201811,1441,940,501,894152.64,473434.21,1367586.85
290530,201811,316,288,28,274747.67,26710.17,301457.84
290540,201811,100,57,43,54374.76,41018.38,95393.14
290550,201811,153,128,25,122109.39,23781.65,145891.04
290560,201811,3315,1388,1927,1323105.55,1837688.06,3160793.61
290570,201811,6098,3104,2994,2957326.99,2852018.78,5809345.77
290580,201811,1268,759,509,722810.6,484855.58,1207666.18
290590,201811,552,456,96,434245.74,91582.73,525828.47
290600,201811,1757,1213,544,1151691.74,518931.39,1670623.13
290610,201811,219,197,22,187711,20988,208699
290620,201811,342,305,37,290961.36,35297.33,326258.69
290630,201811,2064,887,1177,843021.76,1118664.96,1961686.72
290640,201811,149,123,26,117342,24804,142146
290650,201811,1724,818,906,779381.87,864302.6,1643684.47
290660,201811,279,228,51,217508.5,48651.06,266159.56
290670,201811,1024,525,499,500267.61,475678.97,975946.58
290680,201811,1218,980,238,933646.29,226086.85,1159733.14
290682,201811,291,215,76,204777.82,72476.65,277254.47
290685,201811,233,151,82,143095.78,78224.04,221319.82
290687,201811,965,627,338,595627.76,322443.07,918070.83
290689,201811,135,75,60,71527.83,57219.75,128747.58
290690,201811,643,263,380,250863.12,361615.05,612478.17
290700,201811,246,120,126,114478.37,120201.65,234680.02
290710,201811,707,479,228,456946.18,217505.7,674451.88
290720,201811,1035,842,193,803102.71,183639.63,986742.34
290730,201811,1153,665,488,632231.19,464585.62,1096816.81
290740,201811,15,13,2,12402,1908,14310
290750,201811,1384,640,744,608628.1,706397.59,1315025.69
290755,201811,73,65,8,62007.85,7144.96,69152.81
290760,201811,304,263,41,250897.11,39114,290011.11
290770,201811,190,178,12,169799.35,11161,180960.35
290780,201811,1023,814,209,774566.01,197568.66,972134.67
290790,201811,379,266,113,253748.77,107799.77,361548.54
290800,201811,2622,1057,1565,1005707.49,1492156.82,2497864.31
290810,201811,448,315,133,300216.66,126880.69,427097.35
290820,201811,394,238,156,226074.33,148814.98,374889.31
290830,201811,408,287,121,273789.5,115432.43,389221.93
290840,201811,1730,1072,658,1020500.57,625640.51,1646141.08
290850,201811,785,433,352,413064.36,334844.08,747908.44
290860,201811,649,296,353,282380.74,336465.25,618845.99
290870,201811,654,467,187,443998.42,178315.55,622313.97
290880,201811,122,68,54,64870.1,51515.09,116385.19
290890,201811,339,241,98,229902.73,93479.95,323382.68
290900,201811,171,129,42,123064,40066.96,163130.96
290910,201811,371,282,89,269022.19,84903.24,353925.43
290920,201811,228,194,34,185072.9,32434.16,217507.06
290930,201811,838,638,200,608355.48,190773.35,799128.83
290940,201811,250,208,42,197663.76,40067.62,237731.38
290950,201811,171,100,71,95396.75,67734,163130.75
290960,201811,455,310,145,294480.85,138038.25,432519.10
290970,201811,253,224,29,213499.12,27665.16,241164.28
290980,201811,1524,1078,446,1024206.62,424414.61,1448621.23
290990,201811,390,326,64,310973.45,60979.5,371952.95
291000,201811,859,247,612,234826.16,583835.95,818662.11
291005,201811,2209,953,1256,907074.44,1196439,2103513.44
291010,201811,153,138,15,131649.59,14308.96,145958.55
291020,201811,103,81,22,77273.24,20987.53,98260.77
291030,201811,99,72,27,68685.02,25758,94443.02
291040,201811,575,296,279,282374.86,266157.86,548532.72
291050,201811,1373,770,603,733187.62,575232.26,1308419.88
291060,201811,1508,835,673,795225.3,642028.5,1437253.8
291070,201811,1941,1439,502,1366475.1,477625.63,1844100.73
291072,201811,7422,2749,4673,2619095.46,4455473.03,7074568.49
291075,201811,210,170,40,161697.96,38158.78,199856.74
291077,201811,51,34,17,32434.1,16218,48652.1
291080,201811,19952,8854,11098,8418855.88,10574956.28,18993812.16
291085,201811,299,241,58,229905.2,55327.03,285232.23
291090,201811,302,117,185,111325.83,176479.05,287804.88
291100,201811,660,194,466,185072.7,444553.1,629625.8
291110,201811,404,304,100,289991.02,95396.93,385387.95
291120,201811,2520,1224,1296,1167526.71,1234096.42,2401623.13
291125,201811,59,30,29,28619,27665.22,56284.22
291130,201811,214,190,24,181257.68,22896,204153.68
291140,201811,144,110,34,104934.74,32147.41,137082.15
291150,201811,369,147,222,140232.54,211787.54,352020.08
291160,201811,371,308,63,292861.3,60099.06,352960.36
291165,201811,25,21,4,20033.26,3816,23849.26
291170,201811,3032,1525,1507,1450636.49,1434021.13,2884657.62
291180,201811,1316,514,802,490128.1,764982.73,1255110.83
291185,201811,77,75,2,71548.58,1908,73456.58
291190,201811,1289,567,722,538634.67,687939.7,1226574.37
291200,201811,163,124,39,118292.91,37205.54,155498.45
291210,201811,2233,896,1337,851324.27,1273639.4,2124963.67
291220,201811,271,202,69,191744.31,65825.8,257570.11
291230,201811,1024,356,668,338743.47,637256.39,975999.86
291240,201811,435,414,21,393711.85,20034,413745.85
291250,201811,442,363,79,346297.52,75364.49,421662.01
291260,201811,48,36,12,34341.08,11447.12,45788.20
291270,201811,1210,494,716,471271.79,682770.77,1154042.56
291280,201811,370,171,199,162640.88,189834.31,352475.19
291290,201811,1758,901,857,858096.24,816793.21,1674889.45
291300,201811,231,181,50,172004.53,47700,219704.53
291310,201811,230,206,24,196510.88,22895.33,219406.21
291320,201811,1403,1008,395,958752.1,375757.87,1334509.97
291330,201811,133,114,19,106653.42,18126,124779.42
291340,201811,169,95,74,90625.01,70592.9,161217.91
291345,201811,132,88,44,83949.64,41972.57,125922.21
291350,201811,1588,529,1059,504439.19,1010053.27,1514492.46
291360,201811,8592,4276,4316,4067245.01,4113452.8,8180697.81
291370,201811,1129,636,493,606441.64,470304.1,1076745.74
291380,201811,264,207,57,197472.39,54089.41,251561.80
291390,201811,3873,1726,2147,1641341.91,2046106.77,3687448.68
291400,201811,2102,1510,592,1437841.48,564034.09,2001875.57
291410,201811,156,136,20,128789.66,19079.83,147869.49
291420,201811,116,86,30,82037.25,28619.66,110656.91
291430,201811,164,92,72,87049.75,67727.53,154777.28
291440,201811,507,409,98,388097.19,93491.5,481588.69
291450,201811,905,567,338,538410.54,321201.1,859611.64
291460,201811,1784,1446,338,1377696.53,322446.54,1700143.07
291465,201811,2216,1034,1182,985319.01,1127252.47,2112571.48
291470,201811,2815,1429,1386,1359265.09,1321470.65,2680735.74
291480,201811,11831,5254,6577,5000871.25,6264857.06,11265728.31
291490,201811,568,242,326,230856.41,310705.86,541562.27
291500,201811,370,205,165,195556.02,157407.52,352963.54
291510,201811,1236,480,756,456732.72,720917.53,1177650.25
291520,201811,961,434,527,413875.74,502734.48,916610.22
291530,201811,999,276,723,263293.09,689397.33,952690.42
291535,201811,118,101,17,96347.49,16216.87,112564.36
291540,201811,357,106,251,101123.13,238488.46,339611.59
291550,201811,1206,574,632,545938.31,602596.77,1148535.08
291560,201811,5472,2786,2686,2644484.46,2550950.53,5195434.99
291570,201811,206,104,102,99213.36,97307.38,196520.74
291580,201811,1247,764,483,728229.69,460766.21,1188995.90
291590,201811,86,35,51,33195.02,48649.11,81844.13
291600,201811,1367,643,724,612449.49,690655.33,1303104.82
291610,201811,1457,680,777,647406.84,741206.78,1388613.62
291620,201811,573,265,308,252802.1,293439.61,546241.71
291630,201811,492,164,328,156453.46,312906.5,469359.96
291640,201811,3913,1973,1940,1872563.52,1849025.14,3721588.66
291650,201811,423,285,138,270921.66,130850.22,401771.88
291660,201811,422,171,251,162440.69,238354.17,400794.86
291670,201811,225,143,82,135841.17,78226.59,214067.76
291680,201811,689,393,296,374916.36,282268.61,657184.97
291685,201811,601,332,269,316477.48,256433.66,572911.14
291690,201811,584,307,277,292867.8,263285.12,556152.92
291700,201811,956,755,201,719525.07,190790.45,910315.52
291710,201811,1691,793,898,755636.96,855795.03,1611431.99
291720,201811,403,266,137,253754.58,130691.65,384446.23
291730,201811,944,558,386,530441.44,368225.9,898667.34
291733,201811,268,185,83,176202.76,79178.93,255381.69
291735,201811,68,53,15,50560.86,14309.73,64870.59
291740,201811,349,269,80,256617.05,76317.24,332934.29
291750,201811,2013,1331,682,1262305.22,649788.25,1912093.47
291760,201811,3067,1694,1373,1609859.48,1307430.2,2917289.68
291770,201811,810,541,269,513956.66,256618.92,770575.58
291780,201811,46,28,18,26712,17171.76,43883.76
291790,201811,167,80,87,76316.48,82996.52,159313.00
291800,201811,10099,4153,5946,3951988.32,5668301.67,9620289.99
291810,201811,1140,827,313,788373.51,298598.92,1086972.43
291820,201811,267,191,76,182209.58,72500.06,254709.64
291830,201811,1099,426,673,404998.62,641064.53,1046063.15
291835,201811,596,550,46,524557.39,43882.78,568440.17
291840,201811,4763,2462,2301,2342926.57,2193608.53,4536535.10
291845,201811,289,98,191,93490.07,182183,275673.07
291850,201811,331,291,40,277372.83,38160,315532.83
291855,201811,264,107,157,102072.6,149767.96,251840.56
291860,201811,175,109,66,103016.69,62954.66,165971.35
291870,201811,84,34,50,32433.9,47698.11,80132.01
291875,201811,187,172,15,164086.05,14309.2,178395.25
291880,201811,487,383,104,364555.18,99214.71,463769.89
291890,201811,246,80,166,76305.63,156925.6,233231.23
291900,201811,57,32,25,30526.45,23849.86,54376.31
291905,201811,133,95,38,90340.02,36251.33,126591.35
291910,201811,174,142,32,135462.7,30528,165990.7
291915,201811,408,363,45,344612.35,42929.16,387541.51
291920,201811,5020,2603,2417,2479923.82,2304794.17,4784717.99
291930,201811,183,108,75,103023.53,71548.39,174571.92
291940,201811,331,184,147,175054.19,139279.14,314333.33
291950,201811,1149,933,216,889300.7,206060.21,1095360.91
291955,201811,1109,663,446,632268.94,425323.72,1057592.66
291960,201811,185,130,55,124016.16,52183.32,176199.48
291970,201811,773,585,188,558074.51,179345.81,737420.32
291980,201811,1516,1342,174,1276187.34,165033.73,1441221.07
291990,201811,131,121,10,115430.13,9540,124970.13
291992,201811,175,94,81,88911.28,77272.93,166184.21
291995,201811,147,100,47,95398.39,44836.28,140234.67
292000,201811,384,295,89,279837.83,84901.49,364739.32
292010,201811,288,205,83,194596.57,78223.23,272819.80
292020,201811,283,207,76,197471.3,72500.21,269971.51
292030,201811,141,109,32,103983.51,30527.73,134511.24
292040,201811,635,322,313,307180.01,298595.47,605775.48
292045,201811,95,87,8,82994.42,7631.3,90625.72
292050,201811,932,664,268,632427.92,255381.4,887809.32
292060,201811,939,773,166,735508.81,158358.66,893867.47
292070,201811,48,20,28,19080,26711.16,45791.16
292080,201811,127,87,40,82991.78,38158.69,121150.47
292090,201811,509,184,325,175334.99,310040.32,485375.31
292100,201811,1430,626,804,595609.13,766003.51,1361612.64
292105,201811,209,180,29,171713.51,27666,199379.51
292110,201811,2138,796,1342,759045.56,1278625.62,2037671.18
292120,201811,666,525,141,499711.14,134508.57,634219.71
292130,201811,445,257,188,245171.22,179347.93,424519.15
292140,201811,200,157,43,149774.86,40219.26,189994.12
292145,201811,167,88,79,83658.59,75319.82,158978.41
292150,201811,1459,1173,286,1119011.88,271516.79,1390528.67
292160,201811,177,143,34,136134.6,32435.15,168569.75
292170,201811,1208,1062,146,1010940,139221.02,1150161.02
292180,201811,212,152,60,145004.25,57238.2,202242.45
292190,201811,159,95,64,90628.58,61053.52,151682.10
292200,201811,1306,479,827,455995.61,788299.18,1244294.79
292205,201811,125,111,14,105835.98,13355.18,119191.16
292210,201811,371,262,109,248556.58,103267.88,351824.46
292220,201811,21,16,5,15264,4770,20034
292225,201811,38,34,4,32435.63,3816,36251.63
292230,201811,961,770,191,732983.27,182205.57,915188.84
292240,201811,614,446,168,424371.88,160271.38,584643.26
292250,201811,1728,1108,620,1056996.16,591174.33,1648170.49
292260,201811,441,255,186,243262.88,176680.8,419943.68
292265,201811,255,178,77,169579.24,73456.26,243035.50
292270,201811,757,338,419,322445.33,398757.65,721202.98
292273,201811,207,116,91,109884.14,86810.72,196694.86
292275,201811,175,91,84,86806.6,79849,166655.6
292280,201811,139,99,40,94440.39,38159.36,132599.75
292285,201811,66,56,10,52753.58,9538.43,62292.01
292290,201811,571,387,184,366693.48,175239.87,541933.35
292300,201811,1652,636,1016,606439.98,968394.51,1574834.49
292303,201811,100,70,30,66774.38,28618.42,95392.80
292305,201811,110,78,32,74411.79,30528,104939.79
292310,201811,832,543,289,517630.95,274583.01,792213.96
292320,201811,671,506,165,482523,157404.74,639927.74
292330,201811,185,101,84,96353.8,80134.37,176488.17
292335,201811,277,218,59,207964.6,56284.87,264249.47
292340,201811,587,410,177,390385.88,168850.64,559236.52
292350,201811,269,145,124,137515.81,118007.59,255523.40
292360,201811,713,541,172,512467.82,164085.35,676553.17
292370,201811,757,582,175,555223.94,166946.54,722170.48
292380,201811,654,508,146,482949.48,139283.15,622232.63
292390,201811,504,197,307,187930.85,291914.02,479844.87
292400,201811,3445,2135,1310,2016882.16,1245800.29,3262682.45
292405,201811,268,176,92,167423.77,87479.66,254903.43
292410,201811,146,88,58,83952,55330.62,139282.62
292420,201811,302,259,43,246794.85,41020.99,287815.84
292430,201811,535,420,115,400672.28,109228.02,509900.30
292440,201811,589,505,84,480249.69,79849.4,560099.09
292450,201811,260,199,61,189844.87,58192.64,248037.51
292460,201811,584,435,149,413264.41,142048.5,555312.91
292465,201811,218,179,39,170272.37,36465.8,206738.17
292467,201811,110,67,43,63913.41,41019.02,104932.43
292470,201811,268,182,86,173620.07,82039.49,255659.56
292480,201811,343,229,114,217501.62,108464.65,325966.27
292490,201811,228,153,75,145956.32,71548.76,217505.08
292500,201811,1142,496,646,472965.13,616106.23,1089071.36
292510,201811,3380,1534,1846,1462449.44,1758169.65,3220619.09
292520,201811,1089,529,560,502775.25,534208.64,1036983.89
292525,201811,383,273,110,260431.23,104939.6,365370.83
292530,201811,4239,1733,2506,1650540.9,2388620.83,4039161.73
292540,201811,470,251,219,239446.69,208920.7,448367.39
292550,201811,1062,577,485,549661.14,462121.87,1011783.01
292560,201811,325,306,19,291920.58,18125.8,310046.38
292570,201811,307,234,73,223232.34,69640.96,292873.30
292575,201811,468,301,167,286862.43,159317.13,446179.56
292580,201811,958,615,343,585298.99,326922.01,912221.00
292590,201811,542,465,77,443295.95,73453.77,516749.72
292593,201811,142,113,29,107795.89,27666,135461.89
292595,201811,185,143,42,136415.28,40066.45,176481.73
292600,201811,1263,934,329,890692.21,313186.89,1203879.10
292610,201811,133,104,29,99215.14,27408.42,126623.56
292620,201811,534,444,90,423262.21,85859.2,509121.41
292630,201811,1385,793,592,754914.56,563113.28,1318027.84
292640,201811,796,553,243,527214.04,231815.48,759029.52
292650,201811,182,154,28,146471.5,26711.03,173182.53
292660,201811,2031,1461,570,1388873.85,539568.32,1928442.17
292665,201811,145,105,40,100165.65,38157.79,138323.44
292670,201811,403,326,77,310980.74,73449.65,384430.39
292680,201811,256,196,60,186978.18,56761.4,243739.58
292690,201811,191,146,45,139278.63,42928.02,182206.65
292700,201811,943,625,318,595272.15,303364.02,898636.17
292710,201811,107,94,13,89669.66,12402,102071.66
292720,201811,865,485,380,461874.17,362504,824378.17
292730,201811,204,96,108,90623.53,103031.3,193654.83
292740,201811,67945,33577,34368,31955720,32753367.22,64709087.22
292750,201811,378,270,108,256606.19,102220.77,358826.96
292760,201811,329,268,61,253401.37,58191.98,311593.35
292770,201811,786,329,457,313570.02,435971.23,749541.25
292780,201811,415,157,258,149262.38,246127.31,395389.69
292790,201811,742,367,375,350107.72,357505.39,707613.11
292800,201811,1178,722,456,687818.68,434722.1,1122540.78
292805,201811,422,124,298,117770.02,284278.47,402048.49
292810,201811,1480,846,634,806203.11,604794.31,1410997.42
292820,201811,740,606,134,576202.57,127532.76,703735.33
292830,201811,105,84,21,80133.96,20032.46,100166.42
292840,201811,669,554,115,528299.05,109689.79,637988.84
292850,201811,133,89,44,84905.23,41975.51,126880.74
292860,201811,2247,1319,928,1253479.64,885299.51,2138779.15
292870,201811,3473,2336,1137,2224715.16,1084666.36,3309381.52
292880,201811,1474,967,507,918703.25,482467.82,1401171.07
292890,201811,502,430,72,410164.4,68686.92,478851.32
292895,201811,135,90,45,84495.18,42927.02,127422.20
292900,201811,391,287,104,273796,99216,373012
292905,201811,461,236,225,225139.97,214639.58,439779.55
292910,201811,423,321,102,305875.98,97303.19,403179.17
292920,201811,546,245,301,233720.09,287148.11,520868.20
292925,201811,501,463,38,441019.92,36229.38,477249.30
292930,201811,576,358,218,341520.5,207970.63,549491.13
292935,201811,295,128,167,122111.27,159306.61,281417.88
292937,201811,247,165,82,157402.15,78227.06,235629.21
292940,201811,199,154,45,146915.31,42928.6,189843.91
292950,201811,1148,593,555,562592.24,529361.46,1091953.70
292960,201811,594,404,190,385398.6,181254.25,566652.85
292970,201811,256,182,74,172948.4,70594.47,243542.87
292975,201811,145,82,63,77989.23,59901.2,137890.43
292980,201811,270,184,86,174698.25,82042.13,256740.38
292990,201811,1322,986,336,932967.14,319344.31,1252311.45
293000,201811,106,76,30,72502.36,28618.93,101121.29
293010,201811,2747,1658,1089,1575559.44,1035537.87,2611097.31
293015,201811,667,535,132,510378.36,125282.67,635661.03
293020,201811,338,276,62,263302.32,59147.71,322450.03
293030,201811,614,536,78,510762.66,74412,585174.66
293040,201811,345,271,74,258526.54,70593.43,329119.97
293050,201811,2764,1625,1139,1541647.21,1082712.82,2624360.03
293060,201811,251,201,50,190550.75,46737.8,237288.55
293070,201811,3486,1790,1696,1699667.01,1616296.1,3315963.11
293075,201811,92,61,31,58193.2,29573.39,87766.59
293076,201811,70,47,23,44836.15,21942,66778.15
293077,201811,469,285,184,268252.38,175527.8,443780.18
293080,201811,454,408,46,388940.69,43884,432824.69
293090,201811,131,115,16,109706.43,15263.5,124969.93
293100,201811,522,368,154,351069.5,146912.25,497981.75
293105,201811,339,237,102,225805.51,97307.1,323112.61
293110,201811,175,124,51,118292.12,48652.59,166944.71
293120,201811,325,217,108,207013.43,102839.78,309853.21
293130,201811,245,165,80,157406.31,76318.5,233724.81
293135,201811,8012,3196,4816,3041660.76,4585233.6,7626894.36
293140,201811,186,123,63,117338.1,60101.41,177439.51
293150,201811,332,283,49,269201.62,46744.49,315946.11
293160,201811,431,250,181,238493.03,172670.48,411163.51
293170,201811,146,100,46,95400,43018.8,138418.8
293180,201811,470,322,148,306892.68,141187.88,448080.56
293190,201811,1337,928,409,880643.64,389895.61,1270539.25
293200,201811,535,474,61,451480.76,57381.93,508862.69
293210,201811,367,278,89,265043.9,84187.04,349230.94
293220,201811,2686,1101,1585,1048400.32,1509916.71,2558317.03
293230,201811,1765,653,1112,620920.7,1060834.98,1681755.68
293240,201811,223,204,19,194616,18125,212741
293245,201811,113,95,18,90624.64,17171.21,107795.85
293250,201811,735,272,463,259235.59,441696.6,700932.19
293260,201811,313,262,51,248985.2,48653.51,297638.71
293270,201811,1163,563,600,535169.38,572383.94,1107553.32
293280,201811,247,140,107,133553.07,102074.59,235627.66
293290,201811,3055,2006,1049,1912721.97,1000697.32,2913419.29
293300,201811,722,514,208,487982.99,194921.7,682904.69
293305,201811,153,131,22,124963.61,20984.11,145947.72
293310,201811,139,107,32,102072.01,30527.66,132599.67
293315,201811,153,119,34,113523.56,32435,145958.56
293317,201811,93,65,28,62007.49,26711.23,88718.72
293320,201811,980,569,411,541852.57,392087.59,933940.16
293325,201811,195,69,126,65821.87,120196.83,186018.70
293330,201811,13059,6162,6897,5869681.92,6572390.99,12442072.91
293340,201811,255,186,69,177438.9,64867.1,242306.0
293345,201811,245,193,52,184118.96,49606.14,233725.10
293350,201811,643,356,287,339610.15,272314.75,611924.90
293360,201811,1586,1134,452,1080854.97,430622.4,1511477.37
310010,201811,149,77,72,73456.37,68397.72,141854.09
310020,201811,1073,598,475,568610.6,452165.49,1020776.09
310030,201811,337,275,62,261215.03,59146.4,320361.43
310040,201811,48,29,19,27666,18126,45792
310050,201811,188,124,64,117626.9,60766,178392.9
310060,201811,247,172,75,163606.74,71546.25,235152.99
310070,201811,16,8,8,7632,7632,15264
310080,201811,46,25,21,23850,20032.64,43882.64
310090,201811,982,521,461,491072.06,438916.68,929988.74
310100,201811,308,234,74,223226.31,70590.26,293816.57
310110,201811,731,395,336,375495.43,319275.76,694771.19
310120,201811,389,213,176,202242.83,167898.73,370141.56
310130,201811,33,21,12,20033.5,11448,31481.5
310140,201811,23,12,11,11448,10494,21942
310150,201811,1303,890,413,841134.86,393129.61,1234264.47
310160,201811,2101,1067,1034,1010037.47,984005.65,1994043.12
310163,201811,94,54,40,51513.41,38160,89673.41
310170,201811,2616,1130,1486,1077167.53,1414455.24,2491622.77
310180,201811,135,51,84,48652.1,79754.25,128406.35
310190,201811,496,339,157,323396.51,149201.04,472597.55
310200,201811,503,321,182,306226.42,173621.61,479848.03
310205,201811,56,42,14,40065.54,13353.22,53418.76
310210,201811,284,231,53,220365.96,50561.33,270927.29
310220,201811,58,34,24,32436,22895.96,55331.96
310230,201811,270,189,81,180108.79,77269.4,257378.19
310240,201811,107,93,14,88710.85,13356,102066.85
310250,201811,103,83,20,79181.57,19079.4,98260.97
310260,201811,778,423,355,400563.34,337929.25,738492.59
310270,201811,278,184,94,174971.22,89671.84,264643.06
310280,201811,363,274,89,260714.85,84902.85,345617.70
310285,201811,217,155,62,147561.86,59147.63,206709.49
310290,201811,257,148,109,141188.15,103979.99,245168.14
310300,201811,150,123,27,117337.94,25757,143094.94
310310,201811,10,8,2,7631.05,1908,9539.05
310320,201811,26,15,11,14310,10493.42,24803.42
310330,201811,33,25,8,23850,7632,31482
310340,201811,1751,1151,600,1089971.74,571522.27,1661494.01
310350,201811,2894,1584,1310,1506948.66,1249111.35,2756060.01
310360,201811,41,34,7,32435.5,6678,39113.5
310370,201811,128,107,21,102069.49,19746,121815.49
310375,201811,113,43,70,41019.79,66758.76,107778.55
310380,201811,51,29,22,27666,20988,48654
310390,201811,99,67,32,63917.96,30526.87,94444.83
310400,201811,2390,1573,817,1496932.58,779118.86,2276051.44
310410,201811,126,70,56,66780,53422.58,120202.58
310420,201811,684,363,321,345428.85,305248.98,650677.83
310430,201811,320,214,106,203914.94,100836.43,304751.37
310440,201811,70,42,28,40064.82,26710.93,66775.75
310445,201811,81,66,15,62964,14310,77274
310450,201811,858,541,317,516101.51,302409.92,818511.43
310460,201811,263,192,71,182397.48,67733.22,250130.70
310470,201811,507,330,177,314808.49,168852.86,483661.35
310480,201811,81,60,21,57239.82,20033.2,77273.02
310490,201811,527,251,276,238484.41,263290.85,501775.26
310500,201811,127,53,74,50562,70595.13,121157.13
310510,201811,602,402,200,382247.16,190782.23,573029.39
310520,201811,131,90,41,85858.72,39112.96,124971.68
310530,201811,93,40,53,38158.75,50269.03,88427.78
310540,201811,461,283,178,267570.03,169519.98,437090.01
310550,201811,87,56,31,53420.82,29574,82994.82
310560,201811,2983,2060,923,1953162.28,879280.84,2832443.12
310570,201811,114,78,36,74407.75,34341.5,108749.25
310590,201811,361,239,122,226317.65,116369.7,342687.35
310600,201811,162,92,70,85323.22,66775.59,152098.81
310610,201811,61,24,37,22896,35297.5,58193.5
310620,201811,47136,22726,24410,21601918.26,23246948.98,44848867.24
310630,201811,631,406,225,384006.46,213480.1,597486.56
310640,201811,144,118,26,112091.46,24801.09,136892.55
310650,201811,168,148,20,140903.4,19080,159983.4
310660,201811,90,57,33,54377.15,31482,85859.15
310665,201811,60,42,18,40067.56,17171.2,57238.76
310670,201811,6576,2950,3626,2806311.08,3455198.02,6261509.10
310680,201811,58,37,21,35296.53,20032.4,55328.93
310690,201811,601,430,171,403306.07,163126.36,566432.43
310700,201811,61,39,22,37206,20844.9,58050.9
310710,201811,1248,841,407,801007.75,387690.61,1188698.36
310720,201811,92,29,63,27666,60098.67,87764.67
310730,201811,1379,967,412,920296.89,392750.02,1313046.91
310740,201811,996,561,435,531730.54,414427.56,946158.10
310750,201811,249,148,101,140230.85,96350.13,236580.98
310760,201811,64,47,17,44838,15930,60768
310770,201811,96,45,51,42928.89,48652.73,91581.62
310780,201811,400,325,75,309453.67,71547.11,381000.78
310790,201811,98,80,18,76317.41,17171.49,93488.90
310800,201811,448,215,233,204104.94,221992.12,426097.06
310810,201811,173,121,52,114368.75,48649.9,163018.65
310820,201811,352,280,72,267116.64,68684.53,335801.17
310825,201811,202,165,37,157404.14,35298,192702.14
310830,201811,467,225,242,213984.94,230855.11,444840.05
310840,201811,380,220,160,209873.32,152634.06,362507.38
310850,201811,109,87,22,82997,20987,103984
310855,201811,387,307,80,292871.34,76318.7,369190.04
310860,201811,1444,1077,367,1022039.5,348365.66,1370405.16
310870,201811,53,42,11,40068,10494,50562
310880,201811,82,64,18,60769.29,17171.46,77940.75
310890,201811,309,184,125,175531.85,119243.91,294775.76
310900,201811,642,301,341,284549.49,324999.21,609548.70
310910,201811,242,167,75,157970.75,71546.68,229517.43
310920,201811,481,287,194,269961.67,185068.01,455029.68
310925,201811,34,26,8,24804,7344,32148
310930,201811,1085,662,423,630992.75,403320.99,1034313.74
310940,201811,680,350,330,333610.1,314813.12,648423.22
310945,201811,117,72,45,68680.94,42929.23,111610.17
310950,201811,250,199,51,189840.76,48653.51,238494.27
310960,201811,84,30,54,28618.36,51500.06,80118.42
310970,201811,164,104,60,99213.33,56953.26,156166.59
310980,201811,47,25,22,23848.38,20986.88,44835.26
310990,201811,151,84,67,79841.08,63912.73,143753.81
311000,201811,844,420,424,397221.36,404462.88,801684.24
311010,201811,43,35,8,33390,7632,41022
311020,201811,44,28,16,26712,15264,41976
311030,201811,392,236,156,223223.82,148431.59,371655.41
311040,201811,38,33,5,31481.05,4770,36251.05
311050,201811,467,194,273,184494.29,259862.47,444356.76
311060,201811,765,437,328,414787.14,312619.12,727406.26
311070,201811,343,162,181,154533.99,172664.68,327198.67
311080,201811,108,58,50,55330.39,47698.29,103028.68
311090,201811,388,184,204,174576.06,194611.46,369187.52
311100,201811,603,360,243,343145.14,231242.36,574387.50
311110,201811,700,488,212,465530.67,202229.58,667760.25
311115,201811,73,53,20,50562,19080,69642
311120,201811,1090,579,511,549432.2,486569.05,1036001.25
311130,201811,404,238,166,226858.51,158362.27,385220.78
311140,201811,165,87,78,82707.91,73599.89,156307.80
311150,201811,361,234,127,223227.56,120914.29,344141.85
311160,201811,743,535,208,507988.11,197951.29,705939.40
311170,201811,80,60,20,57238.2,18793.8,76032.0
311180,201811,352,238,114,226755.63,108465.54,335221.17
311190,201811,35,17,18,16218,17169.45,33387.45
311200,201811,341,241,100,228281.87,95398.79,323680.66
311205,201811,33,22,11,20988,10494,31482
311210,201811,50,42,8,39779.61,7631.33,47410.94
311220,201811,20,18,2,17169.71,1907.44,19077.15
311230,201811,1644,1073,571,1018586.55,544732.7,1563319.25
311240,201811,178,113,65,107589,62006.47,169595.47
311250,201811,98,29,69,27666,65820.51,93486.51
311260,201811,553,347,206,331030.65,196521.22,527551.87
311265,201811,114,80,34,76319.24,32436,108755.24
311270,201811,289,206,83,196518.45,79178.1,275696.55
311280,201811,215,98,117,93490.91,111041.4,204532.31
311290,201811,110,91,19,86812.67,17835.25,104647.92
311300,201811,569,364,205,347238.74,195271.81,542510.55
311310,201811,26,20,6,19079.66,5724,24803.66
311320,201811,674,500,174,476021.34,165987.8,642009.14
311330,201811,1073,793,280,756247.36,266144.77,1022392.13
311340,201811,2690,1905,785,1807531.93,747400.6,2554932.53
311350,201811,272,209,63,199382.66,60100.55,259483.21
311360,201811,179,109,70,103986,66424.03,170410.03
311370,201811,1215,498,717,473372.24,683436.42,1156808.66
311380,201811,7,6,1,5724,954,6678
311390,201811,267,143,124,136412.62,118099.78,254512.40
311400,201811,153,102,51,97304.06,48653.6,145957.66
311410,201811,99,56,43,53135.84,41021.79,94157.63
311420,201811,304,171,133,161877.16,126875.09,288752.25
311430,201811,868,571,297,542557.67,283043.4,825601.07
311440,201811,488,342,146,326257.56,138990.1,465247.66
311450,201811,327,206,121,196519.49,115431.44,311950.93
311455,201811,302,206,96,196221.6,91583.33,287804.93
311460,201811,135,57,78,54371.54,73599.12,127970.66
311470,201811,24,14,10,13354.23,9540,22894.23
311480,201811,34,14,20,13353.12,19078.22,32431.34
311490,201811,17,11,6,10494,5724,16218
311500,201811,20,10,10,9540,9540,19080
311510,201811,642,456,186,432764.06,177433.09,610197.15
311520,201811,44,35,9,32722.18,8586,41308.18
311530,201811,1789,1345,444,1270597.03,423571.02,1694168.05
311535,201811,73,52,21,49608,20033.66,69641.66
311540,201811,35,30,5,28619.77,4770,33389.77
311545,201811,192,142,50,135465.23,47699.16,183164.39
311547,201811,33,24,9,22895.16,8586,31481.16
311550,201811,678,318,360,302826.38,343395.43,646221.81
311560,201811,44,29,15,27665.55,14309.03,41974.58
311570,201811,293,200,93,190225.56,88722,278947.56
311580,201811,326,194,132,184495.4,125924.3,310419.7
311590,201811,34,30,4,28620,3816,32436
311600,201811,95,77,18,73457.56,17172,90629.56
311610,201811,259,227,32,215587.71,30528,246115.71
311615,201811,111,92,19,87759.97,17935.2,105695.17
311620,201811,22,12,10,11447.52,9537.6,20985.12
311630,201811,85,71,14,67732.9,13355.6,81088.5
311640,201811,136,71,65,67733.37,62008.46,129741.83
311650,201811,135,98,37,92774.5,35296,128070.5
311660,201811,418,205,213,195560.91,203192.26,398753.17
311670,201811,165,107,58,101828.46,55332,157160.46
311680,201811,223,162,61,152965.23,57429.56,210394.79
311690,201811,18,11,7,10493.5,6678,17171.5
311700,201811,201,142,59,135180.11,55904.4,191084.51
311710,201811,211,133,78,126880.56,74410.72,201291.28
311720,201811,37,27,10,25470.68,9539.66,35010.34
311730,201811,594,392,202,372677.52,192698.42,565375.94
311740,201811,38,28,10,26712,9540,36252
311750,201811,712,483,229,457612.56,218460.5,676073.06
311760,201811,61,33,28,31482,26712,58194
311770,201811,398,199,199,186973,189844.2,376817.2
311780,201811,175,97,78,92248.56,74408.33,166656.89
311783,201811,84,75,9,71549,8586,80135
311787,201811,35,14,21,13356,20034,33390
311790,201811,265,125,140,119249,133555.07,252804.07
311800,201811,673,456,217,430373.76,206343.38,636717.14
311810,201811,44,37,7,35295,6678,41973
311820,201811,109,93,16,88716.48,15262.55,103979.03
311830,201811,1971,1245,726,1180432.93,688070.62,1868503.55
311840,201811,1047,577,470,545840.33,445944.08,991784.41
311850,201811,11,7,4,6678,3816,10494
311860,201811,9577,4355,5222,4137645.39,4975222.91,9112868.30
311870,201811,144,80,64,76319.3,61056,137375.3
311880,201811,952,707,245,672933.8,233729,906662.8
311890,201811,220,111,109,105892.64,103983.35,209875.99
311900,201811,81,34,47,32436,44837.49,77273.49
311910,201811,1424,888,536,844918.14,509226.27,1354144.41
311920,201811,232,153,79,145959.5,75365.86,221325.36
311930,201811,923,522,401,497688.19,382288.61,879976.80
311940,201811,2577,1366,1211,1300765.18,1151921.94,2452687.12
311950,201811,46,33,13,31482,12402,43884
311960,201811,66,48,18,45791.74,17172,62963.74
311970,201811,28,18,10,14881.84,9539.2,24421.04
311980,201811,42,32,10,30241.76,9540,39781.76
311990,201811,52,38,14,36252,13355.2,49607.2
311995,201811,64,44,20,41975,19080,61055
312000,201811,35,25,10,23562.8,9540,33102.8
312010,201811,83,62,21,59148,20034,79182
312015,201811,101,75,26,71260.2,24804,96064.2
312020,201811,140,90,50,85572,47700,133272
312030,201811,47,38,9,35568.52,8584.13,44152.65
312040,201811,84,53,31,50558.37,29571.21,80129.58
312050,201811,207,115,92,109709.36,87766.4,197475.76
312060,201811,66,40,26,38159.36,24322.4,62481.76
312070,201811,74,46,28,43883.3,26711.56,70594.86
312080,201811,544,250,294,238485.99,280470.87,518956.86
312083,201811,54,39,15,37205,14309,51514
312087,201811,115,93,22,88717,20988,109705
312090,201811,3065,1800,1265,1703722.79,1204543.57,2908266.36
312100,201811,159,109,50,103475.59,46911.74,150387.33
312110,201811,117,74,43,70306.65,41020.78,111327.43
312120,201811,148,112,36,105877.18,34340.48,140217.66
312125,201811,93,52,41,49607.24,39112.49,88719.73
312130,201811,125,83,42,79176.45,40067.16,119243.61
312140,201811,142,109,33,103407.96,31481.8,134889.76
312150,201811,46,36,10,34342.65,9540,43882.65
312160,201811,1559,1028,531,975589.47,505148.35,1480737.82
312170,201811,12,10,2,9540,1908,11448
312180,201811,105,66,39,62240.02,37107.05,99347.07
312190,201811,30,26,4,24803.04,3815.13,28618.17
312200,201811,747,643,104,611726.15,99211.82,710937.97
312210,201811,91,60,31,57239,29574,86813
312220,201811,135,96,39,91336.86,37205.2,128542.06
312230,201811,3654,1792,1862,1705742.27,1775074.27,3480816.54
312235,201811,161,109,52,103981.39,49607.93,153589.32
312240,201811,106,73,33,69641.25,31482,101123.25
312245,201811,175,121,54,115417.12,51515.66,166932.78
312247,201811,59,42,17,39301.49,16218,55519.49
312250,201811,182,86,96,82041.1,91579.92,173621.02
312260,201811,108,71,37,66866.63,35297.16,102163.79
312270,201811,137,86,51,82044,48653.6,130697.6
312280,201811,26,16,10,15263.58,9540,24803.58
312290,201811,160,108,52,103030.16,48640.04,151670.20
312300,201811,201,134,67,127835.36,63917.8,191753.16
312310,201811,56,52,4,49608,3816,53424
312320,201811,446,285,161,270204.59,152012.68,422217.27
312330,201811,88,78,10,73641.22,9253.8,82895.02
312340,201811,36,17,19,16218,18125.89,34343.89
312350,201811,18,11,7,10494,6677.4,17171.4
312352,201811,100,69,31,65825,29573.4,95398.4
312360,201811,563,257,306,244213.73,291908.74,536122.47
312370,201811,313,181,132,172381.92,125350.46,297732.38
312380,201811,139,95,44,90628.16,41975,132603.16
312385,201811,174,142,32,135179.63,30527.02,165706.65
312390,201811,307,192,115,182492.77,109028.31,291521.08
312400,201811,382,295,87,281428.05,82509.6,363937.65
312410,201811,915,296,619,281894.61,590038.9,871933.51
312420,201811,618,482,136,458866.05,129739.54,588605.59
312430,201811,862,641,221,609094.41,210829.68,819924.09
312440,201811,46,34,12,32434.79,11448,43882.79
312450,201811,208,128,80,122111.26,76319.2,198430.46
312460,201811,60,29,31,27663.76,29572.83,57236.59
312470,201811,55,35,20,33390,19080,52470
312480,201811,200,120,80,114479.98,76320,190799.98
312490,201811,273,190,83,181254.27,79181.4,260435.67
312500,201811,34,19,15,18125,14310,32435
312510,201811,466,179,287,170757.9,273171.38,443929.28
312520,201811,43,15,28,14309,26709.65,41018.65
312530,201811,51,37,14,35298,13356,48654
312540,201811,102,89,13,84906,12401.53,97307.53
312550,201811,39,31,8,29572.8,7632,37204.8
312560,201811,216,162,54,154249.15,51228.93,205478.08
312570,201811,449,266,183,253756.16,174026.79,427782.95
312580,201811,87,46,41,43882.65,39114,82996.65
312590,201811,270,214,56,204152.92,53424,257576.92
312595,201811,140,125,15,119248.45,14310,133558.45
312600,201811,75,46,29,43451,27666,71117
312610,201811,1646,865,781,818396.61,742067.21,1560463.82
312620,201811,192,137,55,130693.17,52462.49,183155.66
312630,201811,69,59,10,56281.76,9537.99,65819.75
312640,201811,47,13,34,12401.53,32435.4,44836.93
312650,201811,157,131,26,124685.4,24802,149487.4
312660,201811,70,52,18,49462.33,17172,66634.33
312670,201811,873,576,297,548527.5,282809.05,831336.55
312675,201811,39,31,8,29574,7631.56,37205.56
312680,201811,83,55,28,52088.4,26712,78800.4
312690,201811,240,127,113,121148.46,107514.34,228662.80
312695,201811,36,29,7,27666,6678,34344
312700,201811,223,127,96,121152.51,91577.12,212729.63
312705,201811,80,65,15,61723.32,14309.26,76032.58
312707,201811,126,93,33,87680.84,31482,119162.84
312710,201811,1927,1032,895,981222.16,852616.47,1833838.63
312720,201811,68,34,34,32436,32436,64872
312730,201811,286,168,118,159317.4,112569.62,271887.02
312733,201811,55,46,9,43883,8586,52469
312735,201811,22,16,6,15263,5724,20987
312737,201811,72,38,34,36252,32436,68688
312738,201811,56,40,16,38155.12,15264,53419.12
312740,201811,74,49,25,46457.65,23847.95,70305.60
312750,201811,69,51,18,48654,17171.33,65825.33
312760,201811,276,203,73,193652.74,69637.7,263290.44
312770,201811,7631,3554,4077,3369597.83,3882097.63,7251695.46
312780,201811,432,331,101,315485.51,96352.83,411838.34
312790,201811,23,18,5,17170.26,4770,21940.26
312800,201811,1624,1132,492,1073309.87,467915.06,1541224.93
312810,201811,377,241,136,229325.75,129740.59,359066.34
312820,201811,192,143,49,136416.62,46744.76,183161.38
312825,201811,26,17,9,16218,8586,24804
312830,201811,276,165,111,156153.44,105247.31,261400.75
312840,201811,152,111,41,105891.34,39112.12,145003.46
312850,201811,54,49,5,46745,4770,51515
312860,201811,164,100,64,95111.62,61054.15,156165.77
312870,201811,998,528,470,501095.84,448360.75,949456.59
312880,201811,152,103,49,98117.71,46649.69,144767.40
312890,201811,169,118,51,111755.43,48654,160409.43
312900,201811,207,157,50,149110.2,47699.23,196809.43
312910,201811,192,99,93,93655.78,88721.45,182377.23
312920,201811,158,89,69,84902.65,65825.2,150727.85
312930,201811,326,232,94,221327.29,89675.29,311002.58
312940,201811,116,81,35,77267.57,33387.29,110654.86
312950,201811,710,471,239,448267.69,228001.84,676269.53
312960,201811,171,133,38,126385.8,36252,162637.8
312965,201811,59,52,7,49320.8,6678,55998.8
312970,201811,287,230,57,218455.15,54375.91,272831.06
312980,201811,2347,1230,1117,1167913.72,1065273.78,2233187.50
312990,201811,47,28,19,26711.84,18126,44837.84
313000,201811,44,26,18,24804,17171,41975
313005,201811,174,135,39,128548.47,36917.21,165465.68
313010,201811,935,384,551,365070.05,525620.19,890690.24
313020,201811,190,101,89,95875.34,84903.17,180778.51
313030,201811,212,140,72,131347.48,68685.62,200033.10
313040,201811,68,26,42,24799.93,40065.44,64865.37
313050,201811,293,204,89,194606.04,84901.47,279507.51
313055,201811,46,35,11,33390,10494,43884
313060,201811,121,85,36,81086.46,34056.85,115143.31
313065,201811,61,41,20,39114,19080,58194
313070,201811,147,78,69,74411.9,65825.56,140237.46
313080,201811,42,18,24,16883.17,22895.53,39778.70
313090,201811,720,500,220,475125.79,209874.82,685000.61
313100,201811,168,65,103,62009.04,98234.96,160244.00
313110,201811,136,76,60,72501.7,57239.56,129741.26
313115,201811,186,102,84,96438.09,80134.79,176572.88
313120,201811,780,435,345,414680.47,327872.54,742553.01
313130,201811,5519,3019,2500,2853011.44,2376818.84,5229830.28
313140,201811,153,81,72,77271.93,68687.71,145959.64
313150,201811,312,249,63,237542.28,59814.16,297356.44
313160,201811,200,147,53,139948.37,50561.2,190509.57
313170,201811,1411,985,426,928181.03,405981.99,1334163.02
313180,201811,312,186,126,176789.94,120101.79,296891.73
313190,201811,761,465,296,441393.27,280362.21,721755.48
313200,201811,27,26,1,24803.72,954,25757.72
313210,201811,1049,885,164,840726.7,156449.27,997175.97
313220,201811,247,169,78,160267.85,73217.3,233485.15
313230,201811,273,205,68,194593.8,64869.6,259463.4
313240,201811,1947,1043,904,991337.72,859710.24,1851047.96
313250,201811,1293,971,322,920861.73,305257.58,1226119.31
313260,201811,95,54,41,51515,39112.11,90627.11
313270,201811,956,564,392,534343.42,373954.67,908298.09
313280,201811,62,52,10,49488.44,9539.83,59028.27
313290,201811,223,180,43,170666.6,40058.09,210724.69
313300,201811,363,190,173,178095.37,165037.99,343133.36
313310,201811,246,127,119,121149.11,113515.64,234664.75
313320,201811,376,287,89,271830.8,84900.8,356731.6
313330,201811,1374,850,524,809673.4,498686.99,1308360.39
313340,201811,336,233,103,222278.85,98261.09,320539.94
313350,201811,518,353,165,334844.43,157405.56,492249.99
313360,201811,116,69,47,65824.12,44548.27,110372.39
313370,201811,192,71,121,67728.58,115422.63,183151.21
313375,201811,279,167,112,159302.19,106842.39,266144.58
313380,201811,1352,703,649,667796.33,619108.72,1286905.05
313390,201811,53,47,6,43870.71,5723.2,49593.91
313400,201811,417,281,136,268068.43,129167,397235.43
313410,201811,23,14,9,13356,8585.28,21941.28
313420,201811,4710,2473,2237,2350817.17,2126406.45,4477223.62
313430,201811,145,67,78,63913.53,74313.18,138226.71
313440,201811,1506,1037,469,985191.97,445969.98,1431161.95
313450,201811,62,27,35,25755.59,33101.36,58856.95
313460,201811,378,176,202,167413.57,191748.5,359162.07
313470,201811,532,245,287,233728.16,273125.11,506853.27
313480,201811,153,107,46,101109.3,43881.82,144991.12
313490,201811,512,248,264,236294.55,251796.96,488091.51
313500,201811,23,14,9,13355.4,8586,21941.4
313505,201811,1010,790,220,752699.95,209873.37,962573.32
313507,201811,99,59,40,56285,38160,94445
313510,201811,2819,1811,1008,1720953.01,961606.66,2682559.67
313520,201811,3600,2819,781,2676590.37,744298.3,3420888.67
313530,201811,45,30,15,28618.37,14308.62,42926.99
313535,201811,110,86,24,81754.97,22893.03,104648.00
313540,201811,74,56,18,53420.36,17171,70591.36
313545,201811,110,93,17,88721.55,16218,104939.55
313550,201811,236,195,41,186027.75,38826,224853.75
313560,201811,329,166,163,158362.65,155500.84,313863.49
313570,201811,59,29,30,27666,28620,56286
313580,201811,1332,739,593,702604.89,564846.2,1267451.09
313590,201811,77,46,31,43882,29574,73456
313600,201811,698,422,276,402286.56,263009.55,665296.11
313610,201811,61,47,14,44203.49,13356,57559.49
313620,201811,1383,732,651,688584.05,616375.91,1304959.96
313630,201811,1643,1257,386,1195361.19,368221.24,1563582.43
313640,201811,129,76,53,72502.9,50561.64,123064.54
313650,201811,240,112,128,106844.83,121537.36,228382.19
313652,201811,18,18,0,17172,0,17172
313655,201811,60,35,25,33390,23850,57240
313657,201811,48,44,4,41976,3816,45792
313660,201811,137,93,44,88718.51,41988.47,130706.98
313665,201811,658,318,340,303352.81,324106.99,627459.80
313670,201811,10280,7142,3138,6788343.43,2992675.64,9781019.07
313680,201811,44,33,11,31482,10383,41865
313690,201811,157,117,40,111617.12,38158.44,149775.56
313695,201811,78,59,19,56284.68,18126,74410.68
313700,201811,309,248,61,236290.22,58192.55,294482.77
313710,201811,145,98,47,93491.74,44837.28,138329.02
313720,201811,1152,559,593,530785.83,564043.74,1094829.57
313730,201811,61,42,19,40068,18126,58194
313740,201811,162,132,30,125924.83,28618.34,154543.17
313750,201811,441,323,118,308134.84,112569.13,420703.97
313753,201811,246,180,66,171050.33,62964,234014.33
313760,201811,1274,462,812,440442.61,772153.39,1212596.00
313770,201811,362,266,96,252844.34,91580.95,344425.29
313780,201811,760,396,364,377772.98,346955.82,724728.80
313790,201811,31,30,1,28046.29,954,29000.29
313800,201811,153,97,56,92530.22,53420.95,145951.17
313810,201811,70,40,30,38159.2,28619.6,66778.8
313820,201811,1296,649,647,617317.98,615945.01,1233262.99
313830,201811,66,48,18,45791,17172,62963
313835,201811,60,50,10,47698.41,9539.33,57237.74
313840,201811,1734,1083,651,1028741.43,619789.29,1648530.72
313850,201811,186,63,123,60098.99,117341.6,177440.59
313860,201811,477,367,110,346706.91,104935.91,451642.82
313862,201811,174,116,58,110660.56,55045.16,165705.72
313865,201811,97,77,20,73453.98,19080,92533.98
313867,201811,48,37,11,35296.68,10494,45790.68
313868,201811,30,19,11,17360,10493.6,27853.6
313870,201811,127,66,61,62961.69,58194,121155.69
313880,201811,370,232,138,221315.64,131355.1,352670.74
313890,201811,335,180,155,170937.49,147291.43,318228.92
313900,201811,902,495,407,471258.55,388198.03,859456.58
313910,201811,137,100,37,95396.68,34629.73,130026.41
313920,201811,629,444,185,423367.44,176075.69,599443.13
313925,201811,33,29,4,27665,3816,31481
313930,201811,829,638,191,608349.12,182179.28,790528.40
313940,201811,1821,1147,674,1091518.94,642289.22,1733808.16
313950,201811,938,603,335,573136.44,319287.77,892424.21
313960,201811,1399,811,588,769674.44,559405.32,1329079.76
313970,201811,127,85,42,81086.32,40061.26,121147.58
313980,201811,211,138,73,131402.85,69640.05,201042.90
313990,201811,383,231,152,220362.1,144997.02,365359.12
314000,201811,940,631,309,598451.84,294769.24,893221.08
314010,201811,80,53,27,50562,25758,76320
314015,201811,53,16,37,15264,35298,50562
314020,201811,54,39,15,37205.37,14310,51515.37
314030,201811,82,38,44,36089.82,41975.49,78065.31
314040,201811,45,30,15,28620,14308.93,42928.93
314050,201811,310,184,126,175244.19,120202.49,295446.68
314053,201811,99,65,34,61051.16,32435.73,93486.89
314055,201811,300,181,119,172660.68,113519.68,286180.36
314060,201811,147,124,23,116814.45,21942,138756.45
314070,201811,1057,540,517,512932.47,492579.89,1005512.36
314080,201811,222,145,77,137371.03,72403.44,209774.47
314085,201811,144,94,50,89669.18,47698.8,137367.98
314090,201811,363,266,97,253708.45,92530.99,346239.44
314100,201811,478,396,82,373954.38,77652,451606.38
314110,201811,748,410,338,389494.78,321867.2,711361.98
314120,201811,94,54,40,51514.12,38160,89674.12
314130,201811,25,12,13,11448,12401.56,23849.56
314140,201811,1130,690,440,653260.01,416599.04,1069859.05
314150,201811,164,104,60,98926.62,57238.89,156165.51
314160,201811,347,260,87,245166.31,82797.02,327963.33
314170,201811,80,62,18,57711.86,17172,74883.86
314180,201811,739,650,89,619802.77,83945.39,703748.16
314190,201811,101,60,41,57237.62,39111.67,96349.29
314200,201811,585,405,180,386038.16,170765.7,556803.86
314210,201811,283,218,65,207014.74,61721.68,268736.42
314220,201811,313,236,77,223218.67,73164.81,296383.48
314225,201811,68,50,18,47700,17172,64872
314230,201811,112,50,62,47697.17,59144.01,106841.18
314240,201811,142,110,32,104937.59,30526.32,135463.91
314250,201811,62,40,22,38159.2,20988,59147.2
314260,201811,195,96,99,91581.67,94442.45,186024.12
314270,201811,333,265,68,252802.2,64867.14,317669.34
314280,201811,698,394,304,375850.88,290006.6,665857.48
314290,201811,555,454,101,431852.06,96062.93,527914.99
314300,201811,397,286,111,269681.9,105837.49,375519.39
314310,201811,1436,974,462,927164.39,440707.97,1367872.36
314315,201811,37,30,7,28617,6677.06,35294.06
314320,201811,613,398,215,378825.15,204468.4,583293.55
314330,201811,10717,5422,5295,5161906.71,5046746.35,10208653.06
314340,201811,585,272,313,259195.39,298012.88,557208.27
314345,201811,38,29,9,27665.69,8585.26,36250.95
314350,201811,191,119,72,113523.09,68687.17,182210.26
314360,201811,83,54,29,51515.06,27666,79181.06
314370,201811,56,47,9,44837,8586,53423
314380,201811,92,65,27,62008.85,25470.98,87479.83
314390,201811,3353,2142,1211,2037677.03,1152283.66,3189960.69
314400,201811,698,499,199,473145.4,189842.83,662988.23
314410,201811,456,300,156,286186.11,148819.1,435005.21
314420,201811,19,9,10,8586,9539.4,18125.4
314430,201811,2489,906,1583,858866.36,1507642.83,2366509.19
314435,201811,273,162,111,154255.7,104937.43,259193.13
314437,201811,28,22,6,20987.36,5724,26711.36
314440,201811,99,72,27,68687.68,25757.28,94444.96
314450,201811,155,112,43,106845.18,41018.96,147864.14
314460,201811,657,309,348,294764.32,331976.88,626741.20
314465,201811,88,59,29,56285.19,27665.33,83950.52
314467,201811,70,57,13,54362.19,12402,66764.19
314470,201811,407,209,198,195906.37,187927.46,383833.83
314480,201811,1091,527,564,502749.8,537838.93,1040588.73
314490,201811,88,65,23,62008.9,21942,83950.9
314500,201811,306,205,101,195564.45,96352.79,291917.24
314505,201811,131,87,44,82996,41976,124972
314510,201811,236,196,40,186977.09,38159.16,225136.25
314520,201811,1273,667,606,627316.98,576963.26,1204280.24
314530,201811,758,604,154,575555.71,146915.01,722470.72
314535,201811,216,134,82,127070.71,78225.96,205296.67
314537,201811,67,40,27,38160,25758,63918
314540,201811,13,8,5,7632,4769.49,12401.49
314545,201811,48,31,17,29574,16218,45792
314550,201811,81,43,38,41020,36252,77272
314560,201811,832,449,383,424806.73,365366.83,790173.56
314570,201811,21,17,4,16218,3816,20034
314580,201811,15,8,7,7632,6678,14310
314585,201811,22,17,5,16218,4770,20988
314587,201811,81,71,10,67730.36,9540,77270.36
314590,201811,591,437,154,415338.67,146619.02,561957.69
314600,201811,961,634,327,599747.18,309763.23,909510.41
314610,201811,965,519,446,492245.6,424985.99,917231.59
314620,201811,147,107,40,100836.09,38158.99,138995.08
314625,201811,96,70,26,66779.53,24803.2,91582.73
314630,201811,1230,639,591,608122.2,563239.6,1171361.8
314640,201811,88,59,29,56286,27379.8,83665.8
314650,201811,193,112,81,106559.53,76795.76,183355.29
314655,201811,65,49,16,46745.4,15264,62009.4
314660,201811,19,15,4,14310,3816,18126
314670,201811,200,156,44,148520.07,41973.49,190493.56
314675,201811,217,129,88,123058.66,83950.15,207008.81
314690,201811,555,304,251,289898.8,239446.04,529344.84
314700,201811,2413,1312,1101,1245646.67,1049689.58,2295336.25
314710,201811,1635,956,679,907667.79,647038.96,1554706.75
314720,201811,407,244,163,231366.75,155497.89,386864.64
314730,201811,516,267,249,252696.41,237230.72,489927.13
314740,201811,696,345,351,327448.83,334841.88,662290.71
314750,201811,21,18,3,17172,2862,20034
314760,201811,328,158,170,150723.08,162160.11,312883.19
314770,201811,121,84,37,79849.49,35298,115147.49
314780,201811,20,6,14,5724,13356,19080
314790,201811,2429,1535,894,1459816.01,852010.85,2311826.86
314795,201811,59,51,8,48405,7632,56037
314800,201811,2959,1746,1213,1658801.28,1155741.74,2814543.02
314810,201811,1519,848,671,806776.75,638492.8,1445269.55
314820,201811,99,56,43,53419.86,41020.32,94440.18
314830,201811,216,175,41,166225.67,38825.73,205051.40
314840,201811,83,48,35,45792,33390,79182
314850,201811,352,171,181,163129.94,172669.85,335799.79
314860,201811,711,537,174,510288.02,164365.1,674653.12
314870,201811,1502,793,709,755514.99,676078.14,1431593.13
314875,201811,58,50,8,47699.5,7632,55331.5
314880,201811,46,31,15,29572.77,14310,43882.77
314890,201811,54,30,24,28619,22895.08,51514.08
314900,201811,33,26,7,24801.31,6677.14,31478.45
314910,201811,255,171,84,163117.61,80134.33,243251.94
314915,201811,159,139,20,132603.13,19080,151683.13
314920,201811,121,73,48,69640.65,45505.33,115145.98
314930,201811,1055,531,524,504678.03,499303.62,1003981.65
314940,201811,52,40,12,38160,11448,49608
314950,201811,39,27,12,25757.1,11448,37205.1
314960,201811,54,40,14,38160,13356,51516
314970,201811,145,73,72,69635.38,68686.13,138321.51
314980,201811,302,194,108,182833.19,102077.56,284910.75
314990,201811,463,257,206,244454.6,195602.44,440057.04
314995,201811,216,64,152,61055.62,144995.95,206051.57
315000,201811,95,79,16,75362.15,15264,90626.15
315010,201811,46,30,16,28620,15264,43884
315015,201811,177,145,32,137602.96,30528,168130.96
315020,201811,74,64,10,61056,9540,70596
315030,201811,117,90,27,84902.59,25757.56,110660.15
315040,201811,69,51,18,48651.82,17170.63,65822.45
315050,201811,199,119,80,113524.74,76030.92,189555.66
315053,201811,42,37,5,35298,4626.9,39924.9
315057,201811,97,80,17,75937.77,16217.83,92155.60
315060,201811,74,64,10,59133.3,9539.35,68672.65
315070,201811,105,59,46,56283.76,43881.36,100165.12
315080,201811,381,311,70,296689.97,66779.56,363469.53
315090,201811,109,64,45,61053.39,42928.35,103981.74
315100,201811,81,41,40,39112.19,38158.37,77270.56
315110,201811,291,163,128,154633.1,122107.43,276740.53
315120,201811,1664,841,823,796932.08,783210.02,1580142.10
315130,201811,343,248,95,236580.31,90624.54,327204.85
315140,201811,535,316,219,299831.44,208915.79,508747.23
315150,201811,987,474,513,450928.59,488908.29,939836.88
315160,201811,222,112,110,106844.53,104939.43,211783.96
315170,201811,333,218,115,206047.17,109419.41,315466.58
315180,201811,3283,1388,1895,1319518.85,1804206.21,3123725.06
315190,201811,329,192,137,182776.7,130696.2,313472.9
315200,201811,1241,721,520,686179.94,495203.94,1181383.88
315210,201811,1588,899,689,855036.11,654848.94,1509885.05
315213,201811,43,25,18,23850,17172,41022
315217,201811,217,174,43,165981.9,41020.2,207002.1
315220,201811,1565,1201,364,1144671.04,346966.04,1491637.08
315230,201811,167,121,46,115145.47,43883.14,159028.61
315240,201811,427,271,156,258531.07,147614.43,406145.50
315250,201811,2549,1262,1287,1203345.59,1226692.08,2430037.67
315260,201811,148,89,59,84904.08,56283.66,141187.74
315270,201811,131,92,39,87189.92,37206,124395.92
315280,201811,699,455,244,433387.61,232761.9,666149.51
315290,201811,208,125,83,119240.58,78217.72,197458.30
315300,201811,73,52,21,49604.07,20033.12,69637.19
315310,201811,69,63,6,60096.98,5724,65820.98
315320,201811,167,96,71,91584,67734,159318
315330,201811,59,50,9,47698.46,8586,56284.46
315340,201811,408,290,118,275468.18,112567.69,388035.87
315350,201811,154,91,63,86810.46,60096.35,146906.81
315360,201811,96,50,46,47700,43884,91584
315370,201811,59,35,24,32672.2,22896,55568.2
315380,201811,11,7,4,6678,3816,10494
315390,201811,66,15,51,14309,48653.2,62962.2
315400,201811,849,641,208,606051.97,197757.86,803809.83
315410,201811,357,218,139,207674.39,132311.24,339985.63
315415,201811,64,48,16,45790,15264,61054
315420,201811,203,154,49,145797.54,46743.84,192541.38
315430,201811,681,395,286,375580.08,272349.34,647929.42
315440,201811,88,61,27,58191.2,25757.2,83948.4
315445,201811,255,206,49,196208.63,46746,242954.63
315450,201811,187,140,47,133547.73,44833.2,178380.93
315460,201811,3528,1784,1744,1698813.52,1660958.32,3359771.84
315470,201811,42,19,23,18125,21939.21,40064.21
315480,201811,63,25,38,23848.75,36250.68,60099.43
315490,201811,640,400,240,379537.91,228955.71,608493.62
315500,201811,23,15,8,14310,7632,21942
315510,201811,152,100,52,95397.14,49606.72,145003.86
315520,201811,74,65,9,62008.99,8586,70594.99
315530,201811,53,28,25,26711.06,23849.56,50560.62
315540,201811,240,160,80,152635.77,76317.58,228953.35
315550,201811,179,141,38,134510.75,36251.8,170762.55
315560,201811,742,593,149,564363.11,142146,706509.11
315570,201811,318,165,153,154198.3,145766.09,299964.39
315580,201811,682,447,235,425750.13,224181.51,649931.64
315590,201811,203,107,96,102077,91584,193661
315600,201811,296,221,75,210584.15,71546.48,282130.63
315610,201811,96,48,48,45791.09,45790.3,91581.39
315620,201811,34,28,6,26712,5724,32436
315630,201811,139,90,49,85854.51,46744.39,132598.90
315640,201811,66,40,26,38157.96,24802.35,62960.31
315645,201811,65,47,18,44838,16694,61532
315650,201811,169,122,47,115810.75,44264.36,160075.11
315660,201811,473,212,261,202245.4,248993.53,451238.93
315670,201811,2451,1216,1235,1158193.39,1177066.57,2335259.96
315680,201811,856,582,274,551831.9,261395.32,813227.22
315690,201811,682,468,214,446337.56,204151.17,650488.73
315700,201811,1921,1016,905,964078.42,863264.03,1827342.45
315710,201811,336,93,243,88720.07,231814.45,320534.52
315720,201811,451,290,161,276181.31,153589.26,429770.57
315725,201811,205,164,41,156168,39114,195282
315727,201811,41,21,20,20034,19080,39114
315730,201811,50,48,2,45786.89,1908,47694.89
315733,201811,92,61,31,58189.9,29573.05,87762.95
315737,201811,51,39,12,37204.4,11446.46,48650.86
315740,201811,44,36,8,34344,7631.33,41975.33
315750,201811,156,120,36,114480,34342.62,148822.62
315760,201811,44,34,10,32434.63,9540,41974.63
315765,201811,125,80,45,76319,42930,119249
315770,201811,233,144,89,137367.28,84617.16,221984.44
315780,201811,3406,1768,1638,1679744.28,1560818.95,3240563.23
315790,201811,209,159,50,151684.2,47126.39,198810.59
315800,201811,292,212,80,202243.72,76317.59,278561.31
315810,201811,95,57,38,54377,35964,90341
315820,201811,803,584,219,554259.94,208925.66,763185.60
315830,201811,137,80,57,76317.52,54377.76,130695.28
315840,201811,92,64,28,61054.33,26710.52,87764.85
315850,201811,265,196,69,186979.14,65824.82,252803.96
315860,201811,13,5,8,4769.66,7632,12401.66
315870,201811,36,29,7,27666,6676.1,34342.1
315880,201811,109,69,40,65822.31,38158.95,103981.26
315890,201811,87,65,22,62009,20988,82997
315895,201811,478,326,152,309336.29,144344.41,453680.70
315900,201811,75,37,38,35011,36252,71263
315910,201811,40,26,14,24564.2,13356,37920.2
315920,201811,181,114,67,108755.16,62949.75,171704.91
315930,201811,45,16,29,15263.3,27664.34,42927.64
315935,201811,149,115,34,109708.57,32419.94,142128.51
315940,201811,92,69,23,65821.59,21941.35,87762.94
315950,201811,47,34,13,32435.15,12402,44837.15
315960,201811,554,263,291,249620.95,276745.51,526366.46
315970,201811,36,29,7,27664.96,6678,34342.96
315980,201811,699,329,370,312470.82,352976.35,665447.17
315990,201811,262,153,109,145714.03,103673.45,249387.48
316000,201811,51,34,17,32149.03,15931.4,48080.43
316010,201811,78,66,12,62963.04,11448,74411.04
316020,201811,115,94,21,89675,20033.4,109708.4
316030,201811,406,219,187,208349.19,177862.64,386211.83
316040,201811,519,221,298,209870.7,283989.07,493859.77
316045,201811,63,56,7,53424,6678,60102
316050,201811,16,14,2,13355.4,1908,15263.4
316060,201811,103,67,36,63918,34344,98262
316070,201811,1094,708,386,670069.18,367466.67,1037535.85
316080,201811,100,64,36,60766.39,34342.74,95109.13
316090,201811,41,24,17,22227.76,16217.83,38445.59
316095,201811,75,63,12,60094.62,11448,71542.62
316100,201811,314,183,131,174052.34,124967.9,299020.24
316105,201811,36,25,11,23849.69,10494,34343.69
316110,201811,1924,1551,373,1468893.74,355167.34,1824061.08
316120,201811,80,59,21,56284.97,19747.1,76032.07
316130,201811,136,105,31,99003,29574,128577
316140,201811,29,21,8,20032.27,7632,27664.27
316150,201811,211,148,63,140471.38,60096.33,200567.71
316160,201811,82,49,33,46746,31482,78228
316165,201811,68,50,18,47501,16455.11,63956.11
316170,201811,199,136,63,128789.37,60102,188891.37
316180,201811,202,87,115,82996.07,109418.15,192414.22
316190,201811,143,105,38,99211.5,36251.46,135462.96
316200,201811,697,393,304,374914.97,289147.57,664062.54
316210,201811,776,519,257,496692.46,245171.74,741864.20
316220,201811,113,76,37,72500.88,35297.04,107797.92
316225,201811,26,15,11,14310,10494,24804
316230,201811,31,19,12,18126,11448,29574
316240,201811,640,513,127,489395.43,121155.6,610551.03
316245,201811,115,97,18,92535.58,17171.85,109707.43
316250,201811,1520,1055,465,999058.24,442335.21,1441393.45
316255,201811,121,97,24,92154.34,22881.58,115035.92
316257,201811,185,97,88,92535.47,83665.36,176200.83
316260,201811,195,137,58,129394.63,55230.94,184625.57
316265,201811,28,19,9,18126,8586,26712
316270,201811,677,474,203,449185.72,193582.16,642767.88
316280,201811,547,336,211,319253.77,200619.61,519873.38
316290,201811,708,468,240,444354.61,228957.53,673312.14
316292,201811,523,208,315,198140.39,300250.26,498390.65
316294,201811,104,62,42,59148,40068,99216
316295,201811,305,139,166,130657.09,158358.35,289015.44
316300,201811,101,72,29,68688,27666,96354
316310,201811,37,20,17,18793.73,16217.58,35011.31
316320,201811,43,26,17,24800.4,16218,41018.4
316330,201811,135,87,48,82035.52,45504.39,127539.91
316340,201811,145,100,45,95395.46,42925.8,138321.26
316350,201811,193,140,53,132930.01,50561.26,183491.27
316360,201811,25,18,7,17172,6678,23850
316370,201811,1080,579,501,546617.86,477640.45,1024258.31
316380,201811,127,97,30,92538,28620,121158
316390,201811,125,90,35,85852.72,33386.5,119239.22
316400,201811,139,105,34,100168.39,32435,132603.39
316410,201811,307,225,82,213264.72,78227.86,291492.58
316420,201811,208,147,61,139521.78,58193.07,197714.85
316430,201811,157,82,75,78224.75,71546.27,149771.02
316440,201811,96,48,48,45792,45791.44,91583.44
316443,201811,36,34,2,32436,1908,34344
316447,201811,64,50,14,47700,13356,61056
316450,201811,227,171,56,163124.44,53423.49,216547.93
316460,201811,73,30,43,28618.89,41019.76,69638.65
316470,201811,1656,1210,446,1145616.87,423344.58,1568961.45
316480,201811,12,10,2,9540,1908,11448
316490,201811,18,7,11,6677.91,10494,17171.91
316500,201811,154,102,52,97019.83,49606.04,146625.87
316510,201811,166,126,40,119199.41,38160,157359.41
316520,201811,193,119,74,113520.39,70588.29,184108.68
316530,201811,163,114,49,108754.56,46744.62,155499.18
316540,201811,140,80,60,76318.16,57239.83,133557.99
316550,201811,137,95,42,90630,40067.93,130697.93
316553,201811,257,123,134,117336.14,127834.06,245170.20
316555,201811,34,27,7,24947.51,6678,31625.51
316556,201811,11,8,3,7632,2862,10494
316557,201811,18,13,5,12402,4769.4,17171.4
316560,201811,65,51,14,48651.38,13353.75,62005.13
316570,201811,245,222,23,211163.56,21942,233105.56
316580,201811,21,16,5,15264,4769.56,20033.56
316590,201811,115,99,16,94446,15264,109710
316600,201811,178,145,33,137562.33,31481.53,169043.86
316610,201811,68,48,20,45504.46,19079,64583.46
316620,201811,135,104,31,99212.52,29573.2,128785.72
316630,201811,44,34,10,32434.97,9539.23,41974.20
316640,201811,16,10,6,9540,5724,15264
316650,201811,72,56,16,53424,15264,68688
316660,201811,9,4,5,3577,4769.8,8346.8
316670,201811,442,157,285,149747.26,271592.98,421340.24
316680,201811,162,114,48,108752.69,45591.69,154344.38
316690,201811,192,124,68,118293.99,64870.27,183164.26
316695,201811,63,55,8,52469.51,7632,60101.51
316700,201811,15,8,7,7631.04,6677.94,14308.98
316710,201811,750,554,196,526539.33,186976.11,713515.44
316720,201811,4989,2525,2464,2397373.97,2345653.25,4743027.22
316730,201811,16,15,1,14310,954,15264
316740,201811,125,81,44,77274,41974.82,119248.82
316750,201811,21,14,7,13356,6677.53,20033.53
316760,201811,324,262,62,249943.23,59148,309091.23
316770,201811,138,75,63,71549,60100.33,131649.33
316780,201811,76,47,29,44527.22,27664.49,72191.71
316790,201811,56,43,13,41019.33,12402,53421.33
316800,201811,1784,1101,683,1049297.71,651091.03,1700388.74
316805,201811,18,10,8,9539.2,7632,17171.2
316810,201811,71,47,24,44834.37,22895.47,67729.84
316820,201811,41,19,22,18126,20987.39,39113.39
316830,201811,93,42,51,40065.2,48652,88717.2
316840,201811,513,310,203,295448.13,193658.47,489106.60
316850,201811,350,230,120,218745.24,114476.02,333221.26
316860,201811,6037,2689,3348,2549986.81,3187555.23,5737542.04
316870,201811,1478,964,514,911111.26,484873.68,1395984.94
316880,201811,126,66,60,62673.13,57233.18,119906.31
316890,201811,247,167,80,159305.79,76317.15,235622.94
316900,201811,428,295,133,278863.11,126876.17,405739.28
316905,201811,18,8,10,7632,9538.46,17170.46
316910,201811,53,24,29,22896,27664.76,50560.76
316920,201811,135,106,29,100400.89,27666,128066.89
316930,201811,1925,984,941,935532.68,895471.01,1831003.69
316935,201811,894,546,348,518938.18,330735.3,849673.48
316940,201811,1106,638,468,607658.54,445873.97,1053532.51
316950,201811,184,94,90,89673.25,85856.91,175530.16
316960,201811,1120,626,494,595846.87,470960.39,1066807.26
316970,201811,662,518,144,493965.54,137374,631339.54
316980,201811,111,67,44,63917.93,41965.54,105883.47
316990,201811,2218,1470,748,1395291.52,710339.15,2105630.67
317000,201811,336,259,77,247081.02,73456.26,320537.28
317005,201811,254,179,75,170761.21,71546.72,242307.93
317010,201811,6479,3628,2851,3441775.06,2718526.92,6160301.98
317020,201811,16522,7393,9129,7019668.91,8693906.12,15713575.03
317030,201811,80,31,49,29574,46529.26,76103.26
317040,201811,3133,1973,1160,1877864.9,1103821.72,2981686.62
317043,201811,83,59,24,56284,22896,79180
317047,201811,35,17,18,16218,17159,33377
317050,201811,181,139,42,132601.94,40068,172669.94
317052,201811,131,99,32,94444.69,30527.6,124972.29
317057,201811,195,146,49,139282.56,46167,185449.56
317060,201811,58,39,19,37204.48,17839.03,55043.51
317065,201811,59,47,12,44838,11448,56286
317070,201811,2016,952,1064,903404.29,1013594.12,1916998.41
317075,201811,109,57,52,54375.05,49607.96,103983.01
317080,201811,867,452,415,429194.74,395687.72,824882.46
317090,201811,642,513,129,487051.75,123062.99,610114.74
317100,201811,431,325,106,308124.35,101121,409245.35
317103,201811,113,96,17,91584,16218,107802
317107,201811,39,34,5,32436,4770,37206
317110,201811,107,47,60,44837.74,57236.8,102074.54
317115,201811,43,37,6,35298,5724,41022
317120,201811,1891,964,927,911422.01,883864.96,1795286.97
317130,201811,1962,1277,685,1213016.68,652791.08,1865807.76
317140,201811,11,9,2,8585.69,1908,10493.69
317150,201811,266,158,108,150436.13,102257.41,252693.54
317160,201811,313,226,87,215273.47,82992.72,298266.19
317170,201811,208,142,66,135464.92,62958.45,198423.37
317180,201811,441,319,122,303606.18,116386.28,419992.46
317190,201811,256,176,80,167901.93,76033.33,243935.26
317200,201811,820,577,243,537107.84,231568.4,768676.24
317210,201811,156,88,68,82990.92,64868.39,147859.31
317220,201811,19,12,7,11447.89,6676.76,18124.65
320010,201811,628,470,158,444792.73,150726.68,595519.41
320013,201811,134,99,35,94440.45,33389.22,127829.67
320016,201811,284,178,106,169811.41,101122.43,270933.84
320020,201811,744,444,300,419935.37,284283.73,704219.10
320030,201811,153,112,41,106845.82,38779.32,145625.14
320035,201811,147,109,38,103975.45,36249.06,140224.51
320040,201811,505,261,244,248126.07,232197.26,480323.33
320050,201811,116,87,29,82996.11,27665.83,110661.94
320060,201811,1608,764,844,728670.64,804464.88,1533135.52
320070,201811,106,70,36,66159.46,34342.1,100501.56
320080,201811,785,448,337,424527.69,321495.8,746023.49
320090,201811,1241,871,370,827269.82,350475.98,1177745.80
320100,201811,337,193,144,184118.27,137374.29,321492.56
320110,201811,130,85,45,79224.2,42642,121866.2
320115,201811,113,93,20,88721.11,19080,107801.11
320120,201811,3390,1893,1497,1795140.9,1423855.15,3218996.05
320130,201811,7575,3583,3992,3395332.95,3800148.34,7195481.29
320140,201811,431,284,147,270253.56,139978.04,410231.60
320150,201811,1993,1161,832,1099959.06,793402.95,1893362.01
320160,201811,682,305,377,289417.8,358232.25,647650.05
320170,201811,114,90,24,85089.3,22896,107985.3
320180,201811,53,31,22,29573.3,20988,50561.3
320190,201811,239,160,79,152629.46,75078,227707.46
320200,201811,57,45,12,42928.56,11448,54376.56
320210,201811,881,493,388,468334.23,369162.71,837496.94
320220,201811,316,117,199,111613.4,189554.68,301168.08
320225,201811,84,69,15,65822.46,14308.61,80131.07
320230,201811,590,385,205,365753.56,194749.52,560503.08
320240,201811,3183,1601,1582,1523952.78,1506885.9,3030838.68
320245,201811,476,328,148,311615.73,141189.91,452805.64
320250,201811,238,124,114,117333.52,108755.46,226088.98
320255,201811,143,114,29,107447.07,27519.18,134966.25
320260,201811,184,131,53,124969.09,50514.05,175483.14
320265,201811,163,130,33,123198.36,31482,154680.36
320270,201811,155,125,30,119248.19,28618.56,147866.75
320280,201811,1002,598,404,565494.55,385405.8,950900.35
320290,201811,65,56,9,53424,8586,62010
320300,201811,556,391,165,371487.92,156351.88,527839.80
320305,201811,675,371,304,353923.98,289527.54,643451.52
320310,201811,222,125,97,116612.42,91774.92,208387.34
320313,201811,317,162,155,154543.97,147581.53,302125.50
320316,201811,109,89,20,84905.53,19079.04,103984.57
320320,201811,3417,1556,1861,1478675.24,1773304.85,3251980.09
320330,201811,261,197,64,187262.03,59138.45,246400.48
320332,201811,893,539,354,512291.98,336658.46,848950.44
320334,201811,247,153,94,145669.58,89676,235345.58
320335,201811,144,103,41,97302.38,39114,136416.38
320340,201811,589,410,179,389362.51,170086.82,559449.33
320350,201811,992,430,562,407999.86,534442.7,942442.56
320360,201811,174,94,80,88835.02,76317.14,165152.16
320370,201811,247,188,59,177637.15,55240,232877.15
320380,201811,295,203,92,191979.26,87766.85,279746.11
320390,201811,1151,707,444,671551.61,422943,1094494.61
320400,201811,322,233,89,220833.65,84903.77,305737.42
320405,201811,925,396,529,377187.21,504316.85,881504.06
320410,201811,986,503,483,478165.63,460419.85,938585.48
320420,201811,489,252,237,239919.74,226094.19,466013.93
320425,201811,197,106,91,101122.89,86810.1,187932.99
320430,201811,404,231,173,218744.08,165039.65,383783.73
320435,201811,171,116,55,109841.97,52468.91,162310.88
320440,201811,206,122,84,116387.22,80135,196522.22
320450,201811,131,76,55,72504,52469.07,124973.07
320455,201811,250,206,44,195554.51,41974.66,237529.17
320460,201811,248,155,93,147867,87858.79,235725.79
320465,201811,115,78,37,74410.52,35297.26,109707.78
320470,201811,665,425,240,404180.27,228945.2,633125.47
320480,201811,186,122,64,115575.32,61053.82,176629.14
320490,201811,3078,1531,1547,1457982.08,1472738.26,2930720.34
320495,201811,97,60,37,57212.19,34721.45,91933.64
320500,201811,9637,4851,4786,4595623.97,4552875.36,9148499.33
320501,201811,539,270,269,257577.86,256625,514202.86
320503,201811,292,207,85,195944.11,81086.17,277030.28
320506,201811,262,196,66,186980.3,62961.68,249941.98
320510,201811,965,455,510,431023.8,484986.94,916010.74
320515,201811,81,68,13,63906.52,12401.66,76308.18
320517,201811,211,150,61,143095.89,58194,201289.89
320520,201811,7071,3143,3928,2983705.52,3739461.09,6723166.61
320530,201811,5560,2802,2758,2663976.33,2624974.17,5288950.50
330010,201811,3169,1645,1524,1560817.97,1449884.95,3010702.92
330015,201811,158,66,92,61808.23,87766.82,149575.05
330020,201811,3643,1599,2044,1521817.01,1949581.49,3471398.50
330022,201811,249,136,113,129014.51,106832.01,235846.52
330023,201811,552,194,358,184017.59,341517.25,525534.84
330025,201811,603,121,482,115427.99,459522.73,574950.72
330030,201811,1992,1295,697,1226968.3,661626.91,1888595.21
330040,201811,2450,1278,1172,1214884.13,1115875.05,2330759.18
330045,201811,8523,2739,5784,2604845.88,5511072.64,8115918.52
330050,201811,872,562,310,535313.16,295726.01,831039.17
330060,201811,940,585,355,554238.58,337337.85,891576.43
330070,201811,3474,1344,2130,1275474.22,2030608.97,3306083.19
330080,201811,1490,700,790,661752.26,752089.26,1413841.52
330090,201811,376,217,159,206816.58,151682.4,358498.98
330093,201811,284,129,155,123059.2,147804.09,270863.29
330095,201811,101,54,47,50847.6,44837.46,95685.06
330100,201811,9639,4989,4650,4747746.28,4432909.33,9180655.61
330110,201811,505,222,283,209391.86,269973.53,479365.39
330115,201811,579,311,268,296682.53,255661.96,552344.49
330120,201811,381,195,186,184879.35,176479.45,361358.80
330130,201811,1552,414,1138,394222.65,1085610.86,1479833.51
330140,201811,601,318,283,303328.14,269003.31,572331.45
330150,201811,472,277,195,263153.49,185070.12,448223.61
330160,201811,207,129,78,123065.49,74410.83,197476.32
330170,201811,27286,9635,17651,9167594.29,16825537.25,25993131.54
330180,201811,243,156,87,146268.37,82280.16,228548.53
330185,201811,870,335,535,318323.77,508794.51,827118.28
330187,201811,325,99,226,94441.25,215586.18,310027.43
330190,201811,5639,2271,3368,2155322.33,3209908.49,5365230.82
330200,201811,4734,1501,3233,1426463.36,3078869.56,4505332.92
330205,201811,419,249,170,237392.48,161886.9,399279.38
330210,201811,1030,640,390,602788.23,370087.07,972875.30
330220,201811,2617,1577,1040,1498843.93,991170.64,2490014.57
330225,201811,570,309,261,294141.08,248317.24,542458.32
330227,201811,2423,766,1657,727589.37,1580308.34,2307897.71
330230,201811,221,127,94,120479.59,89670.46,210150.05
330240,201811,3738,1989,1749,1891824.57,1663970.56,3555795.13
330245,201811,155,69,86,65454.19,82043,147497.19
330250,201811,6689,3450,3239,3276734.1,3079804.88,6356538.98
330260,201811,578,168,410,160265.4,391118.47,551383.87
330270,201811,3496,1279,2217,1219260.69,2114108.27,3333368.96
330280,201811,467,299,168,282611.03,160250.8,442861.83
330285,201811,7220,2382,4838,2267322.02,4612539.42,6879861.44
330290,201811,588,223,365,212735.85,348194.95,560930.80
330300,201811,801,535,266,506535.81,253719.99,760255.80
330310,201811,443,244,199,230855.37,189842.77,420698.14
330320,201811,8416,3238,5178,3081125.26,4933825.06,8014950.32
330330,201811,9136,3628,5508,3452395.43,5250669.23,8703064.66
330340,201811,2691,1602,1089,1525391.01,1038851.98,2564242.99
330350,201811,18291,7260,11031,6893576.83,10503541.13,17397117.96
330360,201811,2429,1217,1212,1160022.49,1156211.94,2316234.43
330370,201811,1056,558,498,530175,473014.3,1003189.3
330380,201811,857,368,489,350336.07,465949.4,816285.47
330385,201811,614,318,296,302402.56,282378.43,584780.99
330390,201811,5312,2930,2382,2778366.18,2269388.24,5047754.42
330395,201811,290,179,111,169797.43,104120.27,273917.70
330400,201811,723,390,333,368602.97,315842.33,684445.30
330410,201811,508,361,147,341497,139743.57,481240.57
330411,201811,237,131,106,124785.84,101074.36,225860.20
330412,201811,255,107,148,100830.1,141182.91,242013.01
330414,201811,6055,2496,3559,2376590.15,3392052.84,5768642.99
330415,201811,592,273,319,259449.71,303344.88,562794.59
330420,201811,2278,1189,1089,1129997.86,1036754.1,2166751.96
330430,201811,1806,857,949,815355.57,902057.93,1717413.50
330440,201811,275,129,146,123057.59,139276.09,262333.68
330450,201811,123,54,69,51516,65824.12,117340.12
330452,201811,1814,866,948,824913.29,904025.51,1728938.80
330455,201811,111550,40283,71267,38342408.23,67927218.52,106269626.75
330460,201811,262,110,152,104934.62,144978.04,249912.66
330470,201811,1254,683,571,645908.01,544429.16,1190337.17
330475,201811,1413,380,1033,361546.53,983756.41,1345302.94
330480,201811,811,432,379,411442.95,360590.92,772033.87
330490,201811,13915,4841,9074,4611535.02,8650469.88,13262004.90
330500,201811,1342,608,734,579874.25,699946.44,1279820.69
330510,201811,11283,3894,7389,3707828.81,7043923.82,10751752.63
330513,201811,102,50,52,47698.99,49606.47,97305.46
330515,201811,836,344,492,323170.91,468964.39,792135.30
330520,201811,2574,958,1616,913665.75,1541399.6,2455065.35
330530,201811,219,115,104,109180.66,99015.19,208195.85
330540,201811,355,179,176,170476.35,167421.68,337898.03
330550,201811,2996,1086,1910,1033823.52,1819797.71,2853621.23
330555,201811,789,301,488,287119.92,464558.37,751678.29
330560,201811,623,211,412,201290.61,393005.52,594296.13
330570,201811,251,178,73,169807.83,69638.85,239446.68
330575,201811,787,333,454,317436.37,431040.2,748476.57
330580,201811,3435,1916,1519,1821594.88,1447581.01,3269175.89
330590,201811,323,161,162,153590.78,154540.8,308131.58
330600,201811,1121,726,395,690439.62,375118.6,1065558.22
330610,201811,1552,858,694,811613.83,658837.82,1470451.65
330615,201811,195,145,50,137466.12,47697.38,185163.50
330620,201811,1055,438,617,415635.32,585915.88,1001551.20
330630,201811,4029,2559,1470,2425154.34,1395023.4,3820177.74
350010,201811,604,399,205,379436.96,195569.26,575006.22
350020,201811,42,20,22,19079.56,20986.22,40065.78
350030,201811,532,342,190,325108.17,180059.26,505167.43
350040,201811,125,49,76,46400.98,72504,118904.98
350050,201811,296,161,135,153591.55,128761.36,282352.91
350055,201811,87,50,37,47697.98,35296.9,82994.88
350060,201811,71,25,46,23850,43883.73,67733.73
350070,201811,826,490,336,461870.47,318709.27,780579.74
350075,201811,72,48,24,45791.4,22894.26,68685.66
350080,201811,50,31,19,28937.96,17172,46109.96
350090,201811,93,52,41,49607.56,39107.89,88715.45
350100,201811,292,183,109,173861.51,103982.53,277844.04
350110,201811,57,37,20,35298,19080,54378
350115,201811,164,101,63,95681.34,60101.4,155782.74
350120,201811,106,71,35,67734,33390,101124
350130,201811,345,166,179,157586.69,170764.93,328351.62
350140,201811,37,23,14,21175.04,13356,34531.04
350150,201811,68,53,15,50562,14310,64872
350160,201811,2600,1027,1573,976539.51,1499409.23,2475948.74
350170,201811,406,248,158,234674.74,149677.09,384351.83
350180,201811,183,97,86,92536.24,82044,174580.24
350190,201811,1045,552,493,524566.48,469704.14,994270.62
350200,201811,67,23,44,21941.26,41709.75,63651.01
350210,201811,1337,752,585,710321.3,556916.72,1267238.02
350220,201811,682,581,101,550112.81,96353.75,646466.56
350230,201811,84,58,26,55329.94,24801.46,80131.40
350240,201811,61,46,15,43884,14309.34,58193.34
350250,201811,1230,612,618,577575.94,588928,1166503.94
350260,201811,91,65,26,62009.3,24803.4,86812.7
350270,201811,841,551,290,524278.14,275194.63,799472.77
350275,201811,310,127,183,120770,174580.72,295350.72
350280,201811,4746,2429,2317,2303389.95,2208323.01,4511712.96
350290,201811,418,202,216,192700.32,205488.02,398188.34
350300,201811,58,32,26,30526.46,24803,55329.46
350310,201811,103,67,36,63917,34344,98261
350315,201811,40,25,15,23850,14309.92,38159.92
350320,201811,3327,1655,1672,1574295.52,1594232.52,3168528.04
350330,201811,1692,905,787,859174.45,749595.19,1608769.64
350335,201811,21,14,7,13355,6677,20032
350340,201811,134,62,72,59148,68346.29,127494.29
350350,201811,92,47,45,44838,42930,87768
350360,201811,129,84,45,80120.66,42924.83,123045.49
350370,201811,90,54,36,50556.18,34334.46,84890.64
350380,201811,774,333,441,316719.18,419937.24,736656.42
350390,201811,1508,609,899,579191.53,856473.01,1435664.54
350395,201811,25,20,5,19079,4770,23849
350400,201811,1670,885,785,834318.73,746242.9,1580561.63
350410,201811,2306,1026,1280,975385.25,1220436.41,2195821.66
350420,201811,242,149,93,141527.9,88721,230248.9
350430,201811,73,43,30,40445,28619.47,69064.47
350440,201811,150,112,38,105842.36,36252,142094.36
350450,201811,1644,1013,631,960171.22,601847.39,1562018.61
350460,201811,336,126,210,120203.49,200050.56,320254.05
350470,201811,16,10,6,9540,5724,15264
350480,201811,166,91,75,86810.02,71549.13,158359.15
350490,201811,235,119,116,112562.51,110663.3,223225.81
350500,201811,42,18,24,17171.29,22895.54,40066.83
350510,201811,164,110,54,104939.26,51515.83,156455.09
350520,201811,457,218,239,204927.4,227366.87,432294.27
350530,201811,445,211,234,201287.91,223227.44,424515.35
350535,201811,74,58,16,55072.48,15264,70336.48
350540,201811,382,195,187,186023.32,178106.34,364129.66
350550,201811,2735,1608,1127,1526672.35,1072648.44,2599320.79
350560,201811,656,459,197,437090.23,187574.48,624664.71
350570,201811,4150,1755,2395,1667631.21,2281838.35,3949469.56
350580,201811,387,190,197,179556.51,187908.11,367464.62
350590,201811,899,499,400,475741.64,380639.86,856381.50
350600,201811,6254,3158,3096,2996279.74,2948149.39,5944429.13
350610,201811,1541,795,746,753745.13,711651.48,1465396.61
350620,201811,35,23,12,21942,11448,33390
350630,201811,242,141,101,133549.77,95388.2,228937.97
350635,201811,908,373,535,354890.6,509145.13,864035.73
350640,201811,120,89,31,84906,29573.5,114479.5
350650,201811,1917,1262,655,1199718.87,623375.85,1823094.72
350660,201811,752,333,419,317034.16,399705.32,716739.48
350670,201811,318,162,156,154109.5,148816.4,302925.9
350680,201811,181,95,86,90628.7,82044,172672.7
350690,201811,201,104,97,99216,92532.18,191748.18
350700,201811,760,365,395,344839.81,376814.9,721654.71
350710,201811,349,134,215,126623.51,205098.82,331722.33
350715,201811,57,45,12,42930,11446.66,54376.66
350720,201811,17,10,7,9540,6678,16218
350730,201811,44,27,17,25758,16217.78,41975.78
350740,201811,213,117,96,111606.95,91581.13,203188.08
350745,201811,18,9,9,8557,8586,17143
350750,201811,2170,1374,796,1301553.14,758697.32,2060250.46
350760,201811,3745,1641,2104,1563121.98,2003346.95,3566468.93
350770,201811,60,41,19,39111.93,18125.2,57237.13
350775,201811,49,36,13,34344,12387,46731
350780,201811,420,213,207,203199.78,197456.56,400656.34
350790,201811,369,154,215,146913.87,205104.25,352018.12
350800,201811,452,257,195,245173.9,186024.95,431198.85
350810,201811,521,416,105,395893.74,99881.45,495775.19
350820,201811,90,54,36,51514.06,34342.94,85857.00
350830,201811,84,47,37,44837.6,35297.86,80135.46
350840,201811,775,336,439,320250.29,417173.08,737423.37
350850,201811,1802,1043,759,989625.11,723972.3,1713597.41
350860,201811,603,353,250,332888.52,238499.16,571387.68
350870,201811,439,298,141,284289.62,134226.28,418515.90
350880,201811,285,154,131,144944.72,124305.36,269250.08
350890,201811,40,26,14,24803.78,13356,38159.78
350900,201811,1481,478,1003,454514.31,956083.33,1410597.64
350910,201811,25,15,10,14310,9540,23850
350920,201811,622,340,282,324023.76,267965.78,591989.54
350925,201811,1211,652,559,619680.44,531559.98,1151240.42
350930,201811,98,61,37,58192.09,35297.8,93489.89
350940,201811,731,408,323,387986.17,306290.69,694276.86
350945,201811,111,81,30,76736.49,28620,105356.49
350950,201811,15935,7629,8306,7251595.27,7916981.8,15168577.07
350960,201811,1278,594,684,563015.87,652500.2,1215516.07
350970,201811,1140,589,551,559302.75,525049.41,1084352.16
350980,201811,93,64,29,61055.93,27666,88721.93
350990,201811,370,134,236,126871.02,225134.15,352005.17
350995,201811,34,16,18,15263.77,17171,32434.77
351000,201811,628,442,186,419417.99,177440.4,596858.39
351010,201811,49,30,19,28619.8,18125,46744.8
351015,201811,54,38,16,36251.13,15264,51515.13
351020,201811,1673,985,688,938249.25,654337.56,1592586.81
351030,201811,350,241,109,227049.39,103982.16,331031.55
351040,201811,854,452,402,430665.53,382530.36,813195.89
351050,201811,3359,1574,1785,1492950.79,1702310.87,3195261.66
351060,201811,5078,2087,2991,1980379.05,2850611.54,4830990.59
351070,201811,417,262,155,248658.43,147868.09,396526.52
351080,201811,798,574,224,547114.65,212736.6,759851.25
351090,201811,60,28,32,26712,30528,57240
351100,201811,451,265,186,250568.75,177435.97,428004.72
351110,201811,2108,1009,1099,956975.23,1045617.67,2002592.90
351120,201811,71,35,36,33390,34344,67734
351130,201811,173,59,114,56285.42,108465.45,164750.87
351140,201811,342,235,107,222941.54,102074.3,325015.84
351150,201811,425,228,197,216593.37,187927.04,404520.41
351160,201811,260,172,88,163800.87,83949.42,247750.29
351170,201811,187,103,84,98256.38,79367.71,177624.09
351190,201811,89,61,28,58191.71,26711.4,84903.11
351200,201811,369,242,127,230196.33,121155.22,351351.55
351210,201811,126,60,66,56985.38,62963.06,119948.44
351220,201811,536,324,212,305485.15,202237.49,507722.64
351230,201811,287,208,79,198428.54,75343.55,273772.09
351240,201811,235,102,133,97306.65,126880.85,224187.50
351250,201811,74,52,22,49381.29,20983,70364.29
351260,201811,153,111,42,105893.32,39780,145673.32
351270,201811,51,21,30,20033.12,28618.67,48651.79
351280,201811,1101,497,604,471232.17,575351.66,1046583.83
351290,201811,233,109,124,103985.59,118007,221992.59
351300,201811,3703,1744,1959,1656837.95,1868492.19,3525330.14
351310,201811,767,393,374,374917.9,356790.61,731708.51
351320,201811,113,68,45,64869.53,42930,107799.53
351330,201811,40,27,13,25758,12402,38160
351340,201811,1252,778,474,735883.61,450096.18,1185979.79
351350,201811,2571,1474,1097,1402381.19,1045898.92,2448280.11
351360,201811,788,392,396,373963.62,377462.79,751426.41
351370,201811,378,191,187,182202.56,177751.99,359954.55
351380,201811,9045,4103,4942,3898559.15,4703470.33,8602029.48
351385,201811,28,18,10,17172,9540,26712
351390,201811,286,213,73,203202,69642,272844
351400,201811,67,42,25,40067.56,23787.86,63855.42
351410,201811,446,279,167,265054.58,159314.35,424368.93
351420,201811,60,48,12,45792,11447.66,57239.66
351430,201811,69,39,30,37204.48,28619.56,65824.04
351440,201811,797,557,240,529228.31,228946.47,758174.78
351450,201811,262,132,130,125925.35,124013.51,249938.86
351460,201811,116,54,62,51515.03,59148,110663.03
351470,201811,137,72,65,67733.19,62009.8,129742.99
351480,201811,533,303,230,287798.92,219406.97,507205.89
351490,201811,291,106,185,101120.56,176486.26,277606.82
351492,201811,31,22,9,20988,8586,29574
351495,201811,26,18,8,17172,7632,24804
351500,201811,3591,1543,2048,1465413.86,1949291.8,3414705.66
351510,201811,1831,763,1068,727304.77,1015679.92,1742984.69
351512,201811,22,18,4,17172,3816,20988
351515,201811,195,112,83,106845.6,79181.05,186026.65
351518,201811,796,497,299,474116.12,285244.28,759360.40
351519,201811,75,49,26,46746,24804,71550
351520,201811,141,87,54,82360.12,51514.96,133875.08
351530,201811,22,15,7,14310,6678,20988
351535,201811,132,75,57,71548.48,54377.2,125925.68
351540,201811,457,327,130,309545.32,124019.2,433564.52
351550,201811,1346,813,533,771203.5,506540.07,1277743.57
351560,201811,73,40,33,38159.19,31463,69622.19
351565,201811,10,6,4,5724,3816,9540
351570,201811,2639,1367,1272,1301751.41,1212737.86,2514489.27
351580,201811,39,35,4,33390,3816,37206
351590,201811,69,46,23,43884,21942,65826
351600,201811,196,145,51,138329,48654,186983
351610,201811,60,29,31,27666,29573.66,57239.66
351620,201811,5919,3371,2548,3203448.67,2427283.74,5630732.41
351630,201811,2609,1345,1264,1279163.83,1203086.92,2482250.75
351640,201811,1705,822,883,782685.14,839421.83,1622106.97
351650,201811,35,30,5,28620,4770,33390
351660,201811,153,98,55,93491,52469.73,145960.73
351670,201811,719,440,279,417396.66,266152.65,683549.31
351680,201811,73,59,14,56286,13356,69642
351685,201811,35,21,14,20034,13356,33390
351690,201811,312,218,94,206101.48,89674.15,295775.63
351700,201811,159,113,46,107802,43883.46,151685.46
351710,201811,74,50,24,47700,22896,70596
351720,201811,129,63,66,60100.48,62964,123064.48
351730,201811,96,66,30,62000.72,28614.83,90615.55
351740,201811,726,484,242,458556.63,230857.72,689414.35
351750,201811,357,150,207,142461.95,197189.35,339651.30
351760,201811,792,611,181,582271.53,172672.99,754944.52
351770,201811,306,261,45,248982.42,42929.4,291911.82
351780,201811,166,95,71,90611.24,67732.94,158344.18
351790,201811,253,133,120,126879.82,114478.2,241358.02
351800,201811,49,31,18,29574,17172,46746
351810,201811,122,83,39,79182,37206,116388
351820,201811,875,632,243,597174.48,231527.95,828702.43
351830,201811,521,186,335,176677.15,319579.32,496256.47
351840,201811,1890,958,932,905676.52,887551.84,1793228.36
351850,201811,235,173,62,164409.44,59147.46,223556.90
351860,201811,742,507,235,476201.25,223895.62,700096.87
351870,201811,5640,2699,2941,2563677.05,2797834.95,5361512.00
351880,201811,18887,8222,10665,7822295.79,10160074,17982369.79
351885,201811,91,61,30,57470.32,28620,86090.32
351890,201811,69,57,12,54377.2,11448,65825.2
351900,201811,226,134,92,127156.99,87767.3,214924.29
351905,201811,79,33,46,31479.88,43882.77,75362.65
351907,201811,3208,1406,1802,1338470.24,1716275.98,3054746.22
351910,201811,180,74,106,70596,101124,171720
351920,201811,128,73,55,69640.55,52429.25,122069.80
351925,201811,88,59,29,56285.09,27666,83951.09
351930,201811,393,258,135,244790.77,128786.1,373576.87
351940,201811,238,108,130,103026.42,124013.67,227040.09
351950,201811,139,81,58,77274,55332,132606
351960,201811,895,422,473,400827.71,449412.52,850240.23
351970,201811,1927,1042,885,991900.36,843671.82,1835572.18
351980,201811,152,77,75,71550,71548.55,143098.55
351990,201811,276,182,94,171433.82,88872.28,260306.10
352000,201811,365,226,139,215307.71,132601.82,347909.53
352010,201811,377,231,146,220367.72,138805.96,359173.68
352020,201811,204,71,133,67733.56,126876.18,194609.74
352030,201811,1050,551,499,524926.75,475394.02,1000320.77
352040,201811,587,251,336,239452.66,320535.38,559988.04
352042,201811,284,92,192,87765.33,182588.51,270353.84
352044,201811,378,224,154,212824.35,146915.66,359740.01
352050,201811,3344,1328,2016,1260058.02,1921639.67,3181697.69
352060,201811,106,67,39,63917.56,36918.03,100835.59
352070,201811,102,74,28,69303.55,26712,96015.55
352080,201811,69,43,26,40067.56,24804,64871.56
352090,201811,175,117,58,111616.76,55329.65,166946.41
352100,201811,269,128,141,121809.41,133330.58,255139.99
352110,201811,112,33,79,31481.8,75365.22,106847.02
352115,201811,71,28,43,26712,41022,67734
352120,201811,95,67,28,62675.56,26712,89387.56
352130,201811,226,188,38,179347.93,36251.4,215599.33
352140,201811,188,80,108,75836.32,102740.43,178576.75
352150,201811,118,65,53,61055.04,50559.29,111614.33
352160,201811,133,85,48,81088.29,45790.35,126878.64
352170,201811,369,256,113,243259.5,107797.59,351057.09
352180,201811,618,415,203,394273.27,193647.16,587920.43
352190,201811,263,102,161,97297.46,153553.38,250850.84
352200,201811,32,17,15,16216.86,14310,30526.86
352210,201811,3907,1646,2261,1561996.29,2149996.23,3711992.52
352215,201811,54,30,24,28619.68,22438.08,51057.76
352220,201811,7053,2731,4322,2600531.07,4120796.76,6721327.83
352230,201811,3306,2119,1187,2007130.71,1126665.05,3133795.76
352240,201811,2279,1315,964,1252281.75,917320.96,2169602.71
352250,201811,2625,1356,1269,1288586.57,1206309.98,2494896.55
352260,201811,1055,570,485,542235.59,462395.89,1004631.48
352265,201811,59,26,33,24803.56,31479.96,56283.52
352270,201811,424,248,176,235624.55,167826.89,403451.44
352280,201811,425,268,157,254380.4,149768.33,404148.73
352290,201811,174,109,65,103982.61,62009.11,165991.72
352300,201811,97,73,24,69641.22,22896,92537.22
352310,201811,5841,2819,3022,2676302.85,2877078.32,5553381.17
352320,201811,968,509,459,482057.1,435823.6,917880.7
352330,201811,526,253,273,241022.89,260152.25,501175.14
352340,201811,1395,682,713,647858.37,677396.7,1325255.07
352350,201811,332,209,123,199382.91,117048.69,316431.60
352360,201811,234,98,136,92584.48,127134.35,219718.83
352370,201811,102,67,35,63918,33389.66,97307.66
352380,201811,119,72,47,68687.23,44837.65,113524.88
352390,201811,2481,1115,1366,1058606.31,1300109.11,2358715.42
352400,201811,480,206,274,196514.15,260812.36,457326.51
352410,201811,803,575,228,545186.06,217496.67,762682.73
352420,201811,109,71,38,67730.32,36248.5,103978.82
352430,201811,1781,798,983,756853.74,935457.19,1692310.93
352440,201811,3194,1628,1566,1542726.98,1491907.02,3034634.00
352450,201811,199,165,34,157407,32434.2,189841.2
352460,201811,593,303,290,288489.42,275981.61,564471.03
352470,201811,634,223,411,212728.78,392061.18,604789.96
352480,201811,1361,767,594,729796.47,566377.16,1296173.63
352490,201811,84,31,53,29574,50562,80136
352500,201811,1207,543,664,516185.44,633124.68,1149310.12
352510,201811,757,414,343,393981.31,327215.88,721197.19
352520,201811,584,258,326,246114.8,310851.06,556965.86
352530,201811,1724,903,821,861446.53,782831.46,1644277.99
352540,201811,75,50,25,47698.14,23849.2,71547.34
352550,201811,186,108,78,103030.33,73744.2,176774.53
352560,201811,52,41,11,39114,10494,49608
352570,201811,670,351,319,334227.16,304292.77,638519.93
352580,201811,61,42,19,39104.91,18125.3,57230.21
352585,201811,18,7,11,6678,10494,17172
352590,201811,4423,2252,2171,2141392.72,2068223.41,4209616.13
352600,201811,352,245,107,232524.07,102078,334602.07
352610,201811,959,432,527,410135.72,502724.7,912860.42
352620,201811,980,406,574,386360.08,546952.39,933312.47
352630,201811,168,63,105,60102,100159.32,160261.32
352640,201811,564,388,176,368131.68,167899.69,536031.37
352650,201811,90,59,31,56284.76,29574,85858.76
352660,201811,81,48,33,45792,31482,77274
352670,201811,1694,921,773,876057.89,736219.82,1612277.71
352680,201811,907,577,330,544845.24,313339.78,858185.02
352690,201811,4474,2061,2413,1957378.83,2299516.55,4256895.38
352700,201811,113,69,44,65536.83,41976,107512.83
352710,201811,1334,709,625,675129.47,593539.12,1268668.59
352720,201811,1356,651,705,617534.18,671972.23,1289506.41
352725,201811,25,23,2,21942,1908,23850
352730,201811,378,190,188,180073.49,179347.5,359420.99
352740,201811,424,272,152,257515.4,145006.69,402522.09
352750,201811,24,16,8,14977.8,7632,22609.8
352760,201811,196,138,58,131649.22,55330.24,186979.46
352770,201811,81,64,17,61055.06,16217.39,77272.45
352780,201811,79,43,36,41021.22,34343,75364.22
352790,201811,31,25,6,23850,5724,29574
352800,201811,251,176,75,167898.85,71263.73,239162.58
352810,201811,171,111,60,103366.42,57240,160606.42
352820,201811,61,48,13,45365.36,12401,57766.36
352830,201811,92,64,28,61056,26710.63,87766.63
352840,201811,649,337,312,320573.32,297642.3,618215.62
352850,201811,1389,485,904,462005.81,862369.47,1324375.28
352860,201811,135,88,47,83315.11,44837.86,128152.97
352870,201811,45,28,17,26712,16218,42930
352880,201811,190,127,63,121137.92,60101.33,181239.25
352885,201811,28,21,7,20034,6678,26712
352890,201811,58,41,17,39114,15930,55044
352900,201811,4850,2348,2502,2222648.75,2378865.33,4601514.08
352910,201811,39,32,7,30528,6678,37206
352920,201811,688,423,265,402586.72,252807.79,655394.51
352930,201811,1242,600,642,570220.33,609204.67,1179425.00
352940,201811,6498,2759,3739,2621452.73,3564713.88,6186166.61
352950,201811,97,39,58,37205.73,55331,92536.73
352960,201811,62,41,21,39114,20033.66,59147.66
352965,201811,19,8,11,7632,10493.26,18125.26
352970,201811,493,374,119,353479.29,112558.45,466037.74
352980,201811,175,93,82,88720.66,78218.16,166938.82
352990,201811,981,433,548,412095.67,521708.69,933804.36
353000,201811,70,33,37,31482,35298,66780
353010,201811,557,345,212,329123.6,202227.98,531351.58
353020,201811,286,210,76,200336.74,72502.18,272838.92
353030,201811,1252,561,691,533368.85,658482.99,1191851.84
353040,201811,91,57,34,54377.62,32435.33,86812.95
353050,201811,1359,875,484,828013.27,461423.95,1289437.22
353060,201811,8354,3737,4617,3548315.68,4397652.07,7945967.75
353070,201811,1697,1081,616,1025214.66,586175.73,1611390.39
353080,201811,1337,717,620,681930.64,590487.5,1272418.14
353090,201811,57,33,24,31481.91,22894.76,54376.67
353100,201811,62,50,12,47700,11448,59148
353110,201811,2069,645,1424,613558.14,1355521.1,1969079.24
353120,201811,85,47,38,44835.52,36250.2,81085.72
353130,201811,868,430,438,408101.7,417685.97,825787.67
353140,201811,584,232,352,221316.72,335793.87,557110.59
353150,201811,358,203,155,192705.6,147858.29,340563.89
353160,201811,100,81,19,77274,18126,95400
353170,201811,195,64,131,61055.82,124931.88,185987.70
353180,201811,968,449,519,426035.37,494488.48,920523.85
353190,201811,494,359,135,341507.07,128490.67,469997.74
353200,201811,210,110,100,104264.21,95395.47,199659.68
353205,201811,26,20,6,19080,5724,24804
353210,201811,83,50,33,47698.43,31481.89,79180.32
353215,201811,54,31,23,29573.31,21941.48,51514.79
353220,201811,83,48,35,45792,33390,79182
353230,201811,155,62,93,59148,88721.87,147869.87
353240,201811,301,165,136,157401.61,129738.4,287140.01
353250,201811,203,106,97,101121.28,92536.24,193657.52
353260,201811,469,335,134,318430.5,127825.12,446255.62
353270,201811,65,48,17,45791.1,15550.2,61341.3
353280,201811,96,52,44,49412.2,41976,91388.2
353282,201811,123,86,37,82043.43,35294.89,117338.32
353284,201811,24,19,5,18126,4770,22896
353286,201811,0,0,0,0,0,0
353290,201811,78,44,34,41974.29,32434.32,74408.61
353300,201811,417,231,186,217544.11,177442.46,394986.57
353310,201811,52,45,7,42929.89,6677.96,49607.85
353320,201811,62,38,24,36251,22896,59147
353325,201811,57,34,23,32420,21620,54040
353330,201811,66,48,18,45645.65,17172,62817.65
353340,201811,622,208,414,197742.72,394357.93,592100.65
353350,201811,913,428,485,407300.05,461684.76,868984.81
353360,201811,108,87,21,82997,19746,102743
353370,201811,123,69,54,65824,51515.6,117339.6
353380,201811,29,20,9,19067,8586,27653
353390,201811,1117,535,582,510367.55,555202.78,1065570.33
353400,201811,48,30,18,28619.52,17172,45791.52
353410,201811,113,72,41,68687.84,39058,107745.84
353420,201811,59,24,35,22896,33388.99,56284.99
353430,201811,572,382,190,360839.25,180969.69,541808.94
353440,201811,10321,4505,5816,4286146.7,5540066.32,9826213.02
353450,201811,55,31,24,29574,22896,52470
353460,201811,607,339,268,321172.11,254950.56,576122.67
353470,201811,2145,1160,985,1102627.94,936936.27,2039564.21
353475,201811,232,153,79,144067.53,75363.66,219431.19
353480,201811,186,153,33,145954.18,31480.59,177434.77
353490,201811,240,142,98,135466.49,93490.64,228957.13
353500,201811,192,111,81,104926.23,77272.3,182198.53
353510,201811,98,71,27,67708.46,25746.46,93454.92
353520,201811,202,139,63,132606,60102,192708
353530,201811,476,253,223,241358.54,212738.85,454097.39
353540,201811,368,245,123,233403.98,117341.73,350745.71
353550,201811,730,491,239,464569.24,227998.99,692568.23
353560,201811,621,262,359,248374.96,341869.66,590244.62
353570,201811,62,32,30,30528,28618.36,59146.36
353580,201811,356,274,82,259674.8,78227.49,337902.29
353590,201811,87,60,27,56921.04,25757.66,82678.70
353600,201811,270,153,117,145629.83,110981.8,256611.63
353610,201811,118,62,56,58827.96,53422.8,112250.76
353620,201811,588,311,277,296685.41,263969.44,560654.85
353625,201811,50,30,20,28620,19080,47700
353630,201811,243,175,68,164524.16,64872,229396.16
353640,201811,127,86,41,81567,39113.52,120680.52
353650,201811,903,357,546,338467.11,520857.12,859324.23
353657,201811,24,19,5,18126,4770,22896
353660,201811,257,141,116,134509.87,110660.8,245170.67
353670,201811,779,464,315,440550.46,300499.97,741050.43
353680,201811,105,74,31,70352.58,29572.56,99925.14
353690,201811,44,35,9,33110,8586,41696
353700,201811,276,197,79,187937.69,75078.6,263016.29
353710,201811,462,222,240,210819.38,228667.03,439486.41
353715,201811,47,34,13,32149.8,12402,44551.8
353720,201811,353,163,190,155484.68,181257.76,336742.44
353730,201811,1099,679,420,645743.1,399624.99,1045368.09
353740,201811,657,359,298,341617.63,284286.35,625903.98
353750,201811,89,57,32,53846.14,30527.76,84373.90
353760,201811,2807,1071,1736,1019616.65,1652300.3,2671916.95
353770,201811,99,81,18,76797,17172,93969
353780,201811,1230,600,630,569531.5,598800.81,1168332.31
353790,201811,512,298,214,282183.35,201543.35,483726.70
353800,201811,3298,1674,1624,1587775.97,1547671.9,3135447.87
353810,201811,229,133,96,126021.87,91565,217586.87
353820,201811,201,98,103,93485.51,97628.58,191114.09
353830,201811,47,40,7,38159.8,6677.8,44837.6
353850,201811,168,87,81,82997.08,77271.57,160268.65
353860,201811,493,222,271,211066.24,258135.77,469202.01
353870,201811,5275,2656,2619,2515721.41,2489236.11,5004957.52
353880,201811,686,490,196,466115.5,186977.5,653093.0
353890,201811,587,333,254,317391.49,242025.83,559417.32
353900,201811,140,71,69,67732.66,65825.05,133557.71
353910,201811,174,85,89,81088.51,84905.16,165993.67
353920,201811,453,248,205,235383.71,195112.54,430496.25
353930,201811,1036,616,420,585954.5,399868.41,985822.91
353940,201811,184,99,85,94445.2,80222.66,174667.86
353950,201811,531,324,207,308101.66,197458.13,505559.79
353960,201811,71,58,13,55329.8,12401.78,67731.58
353970,201811,74,43,31,41022,29574,70596
353980,201811,1568,765,803,727423.13,765071.43,1492494.56
353990,201811,75,42,33,40067.19,31482,71549.19
354000,201811,366,183,183,173901.84,174373.56,348275.40
354010,201811,93,52,41,49608,38637,88245
354020,201811,545,349,196,331983.38,186977.2,518960.58
354025,201811,50,39,11,37205.6,10494,47699.6
354030,201811,66,38,28,36252,26712,62964
354040,201811,94,67,27,63536.4,25758,89294.4
354050,201811,195,105,90,99881.56,85857.24,185738.80
354060,201811,767,370,397,352973.74,376477.71,729451.45
354070,201811,896,528,368,502332.86,351061.02,853393.88
354075,201811,221,115,106,109419.3,100159.8,209579.1
354080,201811,299,129,170,122778.78,162176.39,284955.17
354085,201811,18,11,7,10494,6678,17172
354090,201811,315,174,141,165912.02,134512.18,300424.20
354100,201811,5657,2417,3240,2294639.91,3083589,5378228.91
354105,201811,88,42,46,40062.4,43879.78,83942.18
354110,201811,47,21,26,20034,24804,44838
354120,201811,138,97,41,92392.47,39113.56,131506.03
354130,201811,712,472,240,450263.52,228645.42,678908.94
354140,201811,3131,1456,1675,1385367.82,1595893.94,2981261.76
354150,201811,648,404,244,383222.06,231339.56,614561.62
354160,201811,717,455,262,432768.84,249652.92,682421.76
354165,201811,23,14,9,13356,8586,21942
354170,201811,181,123,58,116673.29,55332,172005.29
354180,201811,67,42,25,39328.17,23850,63178.17
354190,201811,209,96,113,89962.2,107800.85,197763.05
354200,201811,127,69,58,65347.93,55332,120679.93
354210,201811,67,32,35,30527.37,33389.06,63916.43
354220,201811,635,396,239,377778.49,226756.84,604535.33
354230,201811,160,67,93,63916.55,88718.12,152634.67
354240,201811,318,208,110,197469.95,104937.55,302407.50
354250,201811,88,54,34,51515.12,32435.62,83950.74
354260,201811,2018,952,1066,896787.3,1014358.28,1911145.58
354270,201811,96,71,25,67733.33,23850,91583.33
354280,201811,44,23,21,21941.37,20034,41975.37
354290,201811,142,98,44,92679.66,41976,134655.66
354300,201811,416,284,132,270605.49,125756.46,396361.95
354310,201811,101,74,27,69640.2,25757,95397.2
354320,201811,188,100,88,95399.21,83951.33,179350.54
354323,201811,15,14,1,13356,954,14310
354325,201811,110,65,45,61199.4,42929.5,104128.9
354330,201811,2642,878,1764,832935.02,1680482.95,2513417.97
354340,201811,10649,5254,5395,5000606.87,5139985.61,10140592.48
354350,201811,126,82,44,78224.63,41829.08,120053.71
354360,201811,89,49,40,46745.56,38159.85,84905.41
354370,201811,264,147,117,140235.51,111616.16,251851.67
354380,201811,209,123,86,116552.14,82041.92,198594.06
354390,201811,2775,1001,1774,951490.2,1690545.04,2642035.24
354400,201811,330,172,158,164084.65,150155.84,314240.49
354410,201811,622,300,322,284558.87,306226.81,590785.68
354420,201811,279,175,104,166945.64,99209.92,266155.56
354425,201811,311,184,127,175534.48,121158,296692.48
354430,201811,185,114,71,108135.83,66970.8,175106.63
354440,201811,34,25,9,23850,8586,32436
354450,201811,49,35,14,33389.62,13356,46745.62
354460,201811,104,61,43,58193.61,41021.13,99214.74
354470,201811,41,27,14,25758,13355.1,39113.1
354480,201811,114,58,56,55316.56,53413.46,108730.02
354490,201811,142,88,54,83791.67,51512.87,135304.54
354500,201811,398,196,202,186979.51,192701.27,379680.78
354510,201811,103,72,31,68687.56,29574,98261.56
354515,201811,38,14,24,13356,22894.63,36250.63
354520,201811,1632,712,920,677952.01,877194.8,1555146.81
354530,201811,694,357,337,338841.73,320624.73,659466.46
354540,201811,282,159,123,151682.03,117330.66,269012.69
354550,201811,44,27,17,25756,16218,41974
354560,201811,158,89,69,84613.46,65813.4,150426.86
354570,201811,131,88,43,82996.56,41021.78,124018.34
354580,201811,1965,939,1026,892538.34,978181.19,1870719.53
354600,201811,264,148,116,139737.89,110648.06,250385.95
354610,201811,74,65,9,61050,8575,69625
354620,201811,62,19,43,18125.56,41017.23,59142.79
354625,201811,19,12,7,11448,6665,18113
354630,201811,324,219,105,208587.99,100166.66,308754.65
354640,201811,797,516,281,488025.01,268069.61,756094.62
354650,201811,77,44,33,41960.32,31446.12,73406.44
354660,201811,811,602,209,570268.69,199383.77,769652.46
354670,201811,270,95,175,89990.92,165982.46,255973.38
354680,201811,1282,484,798,461714.7,760783.96,1222498.66
354690,201811,84,54,30,50549.69,28619.04,79168.73
354700,201811,77,56,21,53421.48,20032.2,73453.68
354710,201811,59,41,18,38477.96,17172,55649.96
354720,201811,19,18,1,17172,954,18126
354730,201811,1842,792,1050,752386.78,1001493.39,1753880.17
354740,201811,62,43,19,41020.95,18125.52,59146.47
354750,201811,436,259,177,247059.61,168565.83,415625.44
354760,201811,510,314,196,296962.01,186691.1,483653.11
354765,201811,11,5,6,4770,5723,10493
354770,201811,347,224,123,212864.03,117332.13,330196.16
354780,201811,8145,3331,4814,3165884.56,4588364.64,7754249.20
354790,201811,111,64,47,61056,44837.66,105893.66
354800,201811,440,240,200,228957.05,190484.54,419441.59
354805,201811,105,52,53,48971,50562,99533
354810,201811,130,76,54,72503.39,51514.76,124018.15
354820,201811,188,79,109,75147.68,103986,179133.68
354830,201811,41,23,18,21941.86,17171.2,39113.06
354840,201811,61,42,19,40067.06,18126,58193.06
354850,201811,4647,2092,2555,1988716.38,2433567.01,4422283.39
354860,201811,329,160,169,152639.56,159108.57,311748.13
354870,201811,12387,5588,6799,5302329.47,6477172.98,11779502.45
354880,201811,3111,1171,1940,1115168.61,1849347.14,2964515.75
354890,201811,2900,1605,1295,1523735.23,1234395.79,2758131.02
354900,201811,59,39,20,37206,19080,56286
354910,201811,1247,657,590,623195.69,562826.05,1186021.74
354920,201811,51,42,9,40068,8586,48654
354925,201811,14,8,6,7632,5724,13356
354930,201811,31,28,3,26431,2862,29293
354940,201811,839,617,222,585912.83,211780,797692.83
354950,201811,216,143,73,135746.44,69640.53,205386.97
354960,201811,162,64,98,61056,93203.5,154259.5
354970,201811,903,594,309,561767.44,294130.43,855897.87
354980,201811,8557,3160,5397,3005906.96,5144375.15,8150282.11
354990,201811,9073,4312,4761,4097566.07,4535268,8632834.07
354995,201811,540,188,352,179347.32,335800.28,515147.60
355000,201811,491,170,321,162174.51,305991.16,468165.67
355010,201811,613,386,227,368239.18,214321.97,582561.15
355020,201811,747,470,277,447409.24,264223.86,711633.10
355030,201811,209271,81600,127671,77600968.19,121687739.75,199288707.94
355040,201811,742,348,394,329920.34,375196.84,705117.18
355050,201811,153,103,50,96967.77,47700,144667.77
355060,201811,1601,809,792,766898.92,754028.74,1520927.66
355070,201811,1459,714,745,677440.89,710369.36,1387810.25
355080,201811,205,118,87,112568.14,82109.2,194677.34
355090,201811,302,195,107,183917.31,101121.86,285039.17
355100,201811,4909,2433,2476,2299067.94,2358704.49,4657772.43
355110,201811,270,174,96,165018,91583.22,256601.22
355120,201811,86,62,24,59147,22881,82028
355130,201811,57,32,25,30427.18,23850,54277.18
355140,201811,183,120,63,113762.87,60100.82,173863.69
355150,201811,699,423,276,402274.05,262819.62,665093.67
355160,201811,474,231,243,217970.93,231816.91,449787.84
355170,201811,2091,1097,994,1045364.37,946635.04,1991999.41
355180,201811,637,275,362,261392.56,345056.98,606449.54
355190,201811,224,154,70,146913.81,66778.73,213692.54
355200,201811,118,68,50,64871,47699.06,112570.06
355210,201811,710,401,309,382545.91,294745.28,677291.19
355220,201811,6971,3708,3263,3526527.71,3101224.85,6627752.56
355230,201811,107,63,44,59529.06,41970.19,101499.25
355240,201811,4424,1909,2515,1809789.09,2394890.91,4204680.00
355250,201811,5541,2641,2900,2514436.92,2762644.13,5277081.05
355255,201811,49,30,19,28620,18126,46746
355260,201811,185,111,74,104919.12,70555.62,175474.74
355270,201811,170,103,67,98260.09,63196,161456.09
355280,201811,6392,2683,3709,2553760.67,3534530.51,6088291.18
355290,201811,75,58,17,55332,16218,71550
355300,201811,192,123,69,116378,65536.49,181914.49
355310,201811,107,59,48,56284.76,45791.26,102076.02
355320,201811,88,46,42,43883.29,39117.4,83000.69
355330,201811,282,158,124,150055.86,118292.94,268348.80
355340,201811,1610,537,1073,509674.51,1022895.77,1532570.28
355350,201811,134,70,64,66779.96,61054.74,127834.70
355360,201811,179,114,65,108542.76,62009.7,170552.46
355365,201811,25,20,5,19080,4770,23850
355370,201811,1041,602,439,569259.21,417460.67,986719.88
355380,201811,792,520,272,495485.11,259483.22,754968.33
355385,201811,66,46,20,43882.88,19078.93,62961.81
355390,201811,106,63,43,60102,41021.36,101123.36
355395,201811,183,111,72,104813.78,68686.81,173500.59
355400,201811,1605,977,628,926787.23,596690.72,1523477.95
355410,201811,4904,2342,2562,2217292.58,2435953.72,4653246.30
355420,201811,51,38,13,36251,12402,48653
355430,201811,351,210,141,199002.83,134510.48,333513.31
355440,201811,81,48,33,45791.53,31481.16,77272.69
355450,201811,452,220,232,207425.86,220361.45,427787.31
355460,201811,68,52,16,48649.42,15263.33,63912.75
355465,201811,51,32,19,30526.6,18125.2,48651.8
355470,201811,184,75,109,70593.98,103982.55,174576.53
355475,201811,14,9,5,8586,4770,13356
355480,201811,468,208,260,197557.83,247367,444924.83
355490,201811,116,82,34,78227.01,32434,110661.01
355495,201811,57,28,29,26710.55,27664.92,54375.47
355500,201811,1647,923,724,873845.92,690461.92,1564307.84
355510,201811,267,196,71,184367.37,67732.27,252099.64
355520,201811,30,23,7,21654,6678,28332
355530,201811,26,18,8,17172,7630.38,24802.38
355535,201811,81,39,42,37205.56,40066.53,77272.09
355540,201811,2379,945,1434,900047.93,1367026.85,2267074.78
355550,201811,65,38,27,36251.22,25758,62009.22
355560,201811,242,118,124,112571.53,117364.75,229936.28
355570,201811,28,19,9,18125.56,8586,26711.56
355580,201811,263,179,84,170763.12,79841.6,250604.72
355590,201811,25,16,9,15264,8586,23850
355600,201811,269,137,132,130697.6,125629.76,256327.36
355610,201811,225,152,73,145006.56,69642,214648.56
355620,201811,1324,631,693,601667.9,660573.48,1262241.38
355630,201811,419,309,110,294779.8,103978.96,398758.76
355635,201811,126,60,66,57239.36,62934.04,120173.40
355640,201811,583,330,253,313857.53,241358.97,555216.50
355645,201811,848,365,483,346722.57,458885.06,805607.63
355650,201811,2124,893,1231,847337.66,1174248.67,2021586.33
355660,201811,256,139,117,132600.12,111617.5,244217.62
355670,201811,517,206,311,195866.83,296388.75,492255.58
355680,201811,209,119,90,112561.66,85190.2,197751.86
355690,201811,88,40,48,38160,45440,83600
355695,201811,14,11,3,10494,2862,13356
355700,201811,1151,597,554,564067.72,527636.99,1091704.71
355710,201811,2240,1218,1022,1158573.79,974457.6,2133031.39
355715,201811,19,16,3,15264,2862,18126
355720,201811,206,124,82,116700.1,78225.68,194925.78
355730,201811,98,58,40,54456.32,38158.86,92615.18
410010,201811,134,113,21,107801.19,20034,127835.19
410020,201811,106,92,14,87767.15,13354.7,101121.85
410030,201811,165,104,61,98544.14,57903.82,156447.96
410040,201811,1006,548,458,521790.67,436716.8,958507.47
410045,201811,31,26,5,24802.78,4770,29572.78
410050,201811,473,267,206,254710.43,196043.16,450753.59
410060,201811,278,212,66,202244.93,62961.17,265206.10
410070,201811,308,254,54,242315.23,51513.97,293829.20
410080,201811,167,105,62,100166.44,59146.66,159313.10
410090,201811,76,68,8,64650.66,7632,72282.66
410100,201811,298,214,84,204147.31,80037.49,284184.80
410105,201811,49,28,21,26709.72,20032.49,46742.21
410110,201811,330,197,133,187932.85,126877.31,314810.16
410115,201811,31,21,10,20033.09,9539.93,29573.02
410120,201811,405,212,193,201958.56,184114.84,386073.40
410130,201811,47,30,17,28619.56,16216.2,44835.76
410140,201811,3145,1530,1615,1452544.46,1535550.32,2988094.78
410150,201811,2726,1105,1621,1052355.21,1545801.79,2598157.00
410160,201811,502,320,182,304977.08,173616.31,478593.39
410165,201811,67,45,22,42928.18,20987.06,63915.24
410170,201811,169,122,47,114960.81,44835.23,159796.04
410180,201811,2171,1268,903,1205515.77,860229.5,2065745.27
410185,201811,36,31,5,29574,4770,34344
410190,201811,493,323,170,307368.9,162176.99,469545.89
410200,201811,964,729,235,694603.16,224182.58,918785.74
410210,201811,570,300,270,285873.57,257288.94,543162.51
410220,201811,42,21,21,20033.6,20005.12,40038.72
410230,201811,128,70,58,66777,55327.18,122104.18
410240,201811,744,490,254,466877.29,242309.33,709186.62
410250,201811,371,277,94,263648.91,89666.25,353315.16
410260,201811,299,173,126,165039.5,120204,285243.5
410270,201811,29,19,10,18126,9540,27666
410275,201811,62,46,16,43883.33,15264,59147.33
410280,201811,328,191,137,181949.09,130696.44,312645.53
410290,201811,238,151,87,144048.92,82039.97,226088.89
410300,201811,80,63,17,60102,16216.55,76318.55
410302,201811,25,16,9,15264,8586,23850
410304,201811,45,31,14,29574,13355.55,42929.55
410305,201811,217,121,96,114754.56,91576.44,206331.00
410310,201811,264,168,96,160263.36,91562.35,251825.71
410315,201811,49,36,13,34314.93,12402,46716.93
410320,201811,140,96,44,91581.56,41976,133557.56
410322,201811,36,25,11,23850,10494,34344
410330,201811,171,122,49,116387,46546.35,162933.35
410335,201811,100,61,39,58187.23,37203.52,95390.75
410337,201811,42,36,6,34338.65,5723.17,40061.82
410340,201811,31,29,2,27665.51,1908,29573.51
410345,201811,224,141,83,134511.49,79180.22,213691.71
410347,201811,51,38,13,36251.39,12402,48653.39
410350,201811,234,140,94,133556.35,89674.38,223230.73
410360,201811,470,290,180,274103.91,170183.66,444287.57
410370,201811,2403,1026,1377,976382.05,1311341.28,2287723.33
410380,201811,225,142,83,135462.81,79180.6,214643.41
410390,201811,368,273,95,260417.26,90626.61,351043.87
410395,201811,37,24,13,22895,12015,34910
410400,201811,838,423,415,402179.67,394543.83,796723.50
410405,201811,93,71,22,67730.77,20988,88718.77
410410,201811,37,28,9,26712,8585.2,35297.2
410420,201811,1658,823,835,782901.37,794965.01,1577866.38
410425,201811,171,82,89,78028,84903.77,162931.77
410430,201811,2199,1285,914,1221769.05,871276.14,2093045.19
410440,201811,386,286,100,272826.11,95397.68,368223.79
410442,201811,362,246,116,233715.93,110663.34,344379.27
410445,201811,416,294,122,280468.48,116384.69,396853.17
410450,201811,389,202,187,192701.41,178381.66,371083.07
410460,201811,467,250,217,237902.38,207002.77,444905.15
410465,201811,200,125,75,118961.43,71546.37,190507.80
410470,201811,230,147,83,140225.2,79176.66,219401.86
410480,201811,5996,2972,3024,2815830.56,2878896.8,5694727.36
410490,201811,1425,926,499,881877.15,472867.76,1354744.91
410500,201811,273,160,113,152638.45,107797.09,260435.54
410510,201811,174,129,45,123063.09,42914,165977.09
410520,201811,255,191,64,182208.31,61054.27,243262.58
410530,201811,235,86,149,82040.87,142125.96,224166.83
410540,201811,319,229,90,217690.86,85853.47,303544.33
410550,201811,1673,748,925,713284.44,881217.11,1594501.55
410560,201811,131,101,30,96350.12,28618.07,124968.19
410570,201811,428,295,133,279322.07,126879.8,406201.87
410580,201811,3175,1433,1742,1365795.35,1661325.86,3027121.21
410590,201811,401,284,117,270930.26,111614.62,382544.88
410600,201811,189,161,28,153589.09,26709.92,180299.01
410610,201811,60,50,10,47699.36,9539.06,57238.42
410620,201811,241,175,66,166944.15,62960.92,229905.07
410630,201811,439,257,182,245174.61,173624.12,418798.73
410640,201811,1032,650,382,616244.05,362800.96,979045.01
410645,201811,102,77,25,73067.29,23850,96917.29
410650,201811,362,246,116,233722.68,110661.34,344384.02
410655,201811,77,58,19,55330.61,18125.15,73455.76
410657,201811,44,18,26,17171.07,24801.23,41972.30
410660,201811,612,434,178,412187.75,169804.98,581992.73
410670,201811,74,63,11,60100.75,10494,70594.75
410680,201811,200,167,33,158642.64,31481.4,190124.04
410685,201811,16,11,5,10493.84,4770,15263.84
410690,201811,28096,12229,15867,11642894.71,15125486.39,26768381.10
410700,201811,328,242,86,230574.24,82042.49,312616.73
410710,201811,125,103,22,98259.19,20988,119247.19
410712,201811,21,15,6,14310,5724,20034
410715,201811,86,64,22,61053.91,20986.85,82040.76
410720,201811,615,367,248,350102.44,236567.9,586670.34
410725,201811,178,132,46,125924.39,43879.86,169804.25
410730,201811,86,52,34,49606.94,32435.83,82042.77
410740,201811,112,82,30,78224.86,28618.41,106843.27
410750,201811,223,161,62,153591.81,59141.88,212733.69
410752,201811,25,16,9,15263.16,8586,23849.16
410753,201811,50,22,28,20315.43,26712,47027.43
410754,201811,39,22,17,20698.1,16213.9,36912.0
410755,201811,80,54,26,50943.6,24803.23,75746.83
410760,201811,728,415,313,395557.92,298587.74,694145.66
410765,201811,1677,813,864,768735.69,823079.83,1591815.52
410770,201811,107,84,23,80134.52,21941,102075.52
410773,201811,53,39,14,37205.59,13356,50561.59
410775,201811,176,136,40,129074.88,38158.4,167233.28
410780,201811,80,44,36,41975.49,34344,76319.49
410785,201811,54,43,11,41021.23,10494,51515.23
410790,201811,72,33,39,31480.29,37204.21,68684.50
410800,201811,290,181,109,171704.46,103984.72,275689.18
410810,201811,24,20,4,19079.88,3528,22607.88
410820,201811,182,133,49,126877.31,46744.12,173621.43
410830,201811,8487,3811,4676,3623280.26,4458078.43,8081358.69
410832,201811,101,70,31,66777.35,29572.68,96350.03
410840,201811,1440,805,635,765661.97,604836.32,1370498.29
410845,201811,65,42,23,39777.28,21942,61719.28
410850,201811,197,138,59,130845.84,56285.55,187131.39
410855,201811,53,46,7,43880.78,6678,50558.78
410860,201811,682,395,287,375577.76,273790.32,649368.08
410865,201811,104,81,23,77271.38,21942,99213.38
410870,201811,158,134,24,127835.1,22892.6,150727.7
410880,201811,1128,568,560,541159.07,534125.38,1075284.45
410890,201811,84,58,26,55329.23,24803.39,80132.62
410895,201811,71,54,17,51515.29,16218,67733.29
410900,201811,21,13,8,12400.67,7629.92,20030.59
410910,201811,15,13,2,12402,1908,14310
410920,201811,34,23,11,21940.56,10494,32434.56
410930,201811,512,330,182,314593.69,173620.31,488214.00
410940,201811,4367,2555,1812,2427097.93,1725563.61,4152661.54
410950,201811,114,85,29,81087.53,27665,108752.53
410960,201811,771,346,425,329502.36,405238.83,734741.19
410965,201811,70,54,16,51228.8,15264,66492.8
410970,201811,639,461,178,439314.1,169809.3,609123.4
410975,201811,110,65,45,61495.22,42925.87,104421.09
410980,201811,1622,742,880,704333.38,837952.58,1542285.96
410990,201811,271,187,84,178389.17,79843.46,258232.63
411000,201811,65,40,25,38159.65,23564,61723.65
411005,201811,24,19,5,18123.99,4770,22893.99
411007,201811,248,141,107,134220.69,102066.52,236287.21
411010,201811,580,405,175,386354.86,166942.42,553297.28
411020,201811,292,202,90,192698.21,85855.16,278553.37
411030,201811,17,9,8,8586,7631.61,16217.61
411040,201811,51,37,14,35296.18,13356,48652.18
411050,201811,223,173,50,164182.9,47520.7,211703.6
411060,201811,517,347,170,331014.48,162176.04,493190.52
411065,201811,69,59,10,56280.57,9540,65820.57
411070,201811,1218,799,419,757311.67,399714.67,1157026.34
411080,201811,232,166,66,158358.89,62957.28,221316.17
411090,201811,112,84,28,80134.25,26711.6,106845.85
411095,201811,283,113,170,107797.76,162165.66,269963.42
411100,201811,113,93,20,88719.97,19078.58,107798.55
411110,201811,123,86,37,82042.12,35296.78,117338.90
411120,201811,190,140,50,133557.11,47694.64,181251.75
411125,201811,196,91,105,86160.13,100112.65,186272.78
411130,201811,124,107,17,101432.07,16217.71,117649.78
411140,201811,191,129,62,123039.11,58620.79,181659.90
411150,201811,1244,826,418,787305.11,397520.41,1184825.52
411155,201811,124,83,41,78894.48,39111.74,118006.22
411160,201811,24,12,12,11447.98,11448,22895.98
411170,201811,54,49,5,46173.6,4770,50943.6
411180,201811,974,647,327,615019.34,311941.5,926960.84
411190,201811,341,193,148,183449.27,141190.26,324639.53
411200,201811,679,445,234,423231.06,222206.03,645437.09
411210,201811,701,379,322,359997.33,307177.19,667174.52
411220,201811,150,111,39,105892.02,37204.4,143096.42
411230,201811,43,36,7,34344,6677,41021
411240,201811,127,87,40,82998,38159.29,121157.29
411250,201811,433,317,116,302399.63,110655.97,413055.60
411260,201811,20,13,7,12401.33,6678,19079.33
411270,201811,294,160,134,152635.76,127829.64,280465.40
411275,201811,207,183,24,173965.52,22896,196861.52
411280,201811,224,158,66,150400.2,62959.53,213359.73
411290,201811,56,41,15,39113.44,14310,53423.44
411295,201811,149,117,32,111618,30525.83,142143.83
411300,201811,68,35,33,33389.07,31482,64871.07
411310,201811,92,71,21,67731.3,20033.21,87764.51
411320,201811,748,540,208,513515.38,196818.37,710333.75
411325,201811,64,41,23,39113.97,21942,61055.97
411330,201811,930,600,330,570369.76,314057.2,884426.96
411340,201811,26,17,9,16218,8262,24480
411342,201811,70,53,17,50561.42,16217.02,66778.44
411345,201811,124,64,60,61056,57239.64,118295.64
411350,201811,499,394,105,374384.35,99863.09,474247.44
411360,201811,55,35,20,33389.79,19080,52469.79
411370,201811,14416,5886,8530,5594666.79,8121606.6,13716273.39
411373,201811,183,135,48,128787,45791.34,174578.34
411375,201811,71,59,12,56285.51,11446.95,67732.46
411380,201811,95,73,22,69642,20988,90630
411390,201811,131,89,42,84903.98,40067.06,124971.04
411400,201811,361,274,87,261372.85,82991.7,344364.55
411410,201811,437,228,209,216841.1,199093.03,415934.13
411420,201811,1050,476,574,451805.25,546584.08,998389.33
411430,201811,417,266,151,253092.78,144033.81,397126.59
411435,201811,37,26,11,24804,10493.66,35297.66
411440,201811,475,382,93,362722.13,88720.86,451442.99
411450,201811,426,359,67,342474.46,63915.78,406390.24
411460,201811,768,306,462,290972.42,436733.78,727706.20
411470,201811,84,62,22,59145.38,20988,80133.38
411480,201811,647,369,278,349532.34,264630.7,614163.04
411490,201811,299,190,109,181256.29,103697.32,284953.61
411500,201811,109,92,17,87557.88,15827.56,103385.44
411510,201811,218,177,41,168105.28,39111.06,207216.34
411520,201811,5984,2334,3650,2221500.38,3473988.93,5695489.31
411530,201811,114,79,35,75365.66,33389.4,108755.06
411535,201811,51,22,29,20987.2,27664.47,48651.67
411540,201811,360,249,111,236503.11,105888.88,342391.99
411545,201811,55,40,15,38159.33,14310,52469.33
411550,201811,76,58,18,55328.99,17172,72500.99
411560,201811,388,178,210,167904.6,200330.61,368235.21
411570,201811,787,304,483,288752.53,460559.12,749311.65
411573,201811,29,18,11,17172,10493.76,27665.76
411575,201811,284,180,104,171706.45,99209.77,270916.22
411580,201811,1258,502,756,476622.45,719336.49,1195958.94
411585,201811,78,39,39,37205,37204.13,74409.13
411590,201811,22,16,6,15262.67,5724,20986.67
411600,201811,26,12,14,11448,13356,24804
411605,201811,243,102,141,97303.95,134506.85,231810.80
411610,201811,241,163,78,155496.71,74407.98,229904.69
411620,201811,343,201,142,191275.54,134823.73,326099.27
411630,201811,56,40,16,38157.48,15263.99,53421.47
411640,201811,35,29,6,27664.26,5724,33388.26
411650,201811,13,8,5,7632,4769,12401
411660,201811,33,25,8,23850,7632,31482
411670,201811,247,185,62,176484.18,59147.64,235631.82
411680,201811,156,136,20,129743,19080,148823
411690,201811,591,316,275,300716.1,261945.69,562661.79
411695,201811,61,45,16,42928.34,15262.05,58190.39
411700,201811,156,134,22,127832.02,20987.8,148819.82
411705,201811,104,68,36,64871.25,34343.1,99214.35
411710,201811,308,206,102,195449.43,97304.32,292753.75
411720,201811,138,90,48,85855.61,45787.61,131643.22
411721,201811,60,51,9,48650.65,8585,57235.65
411722,201811,100,43,57,41018.93,54375.76,95394.69
411725,201811,151,116,35,110086.76,33388.99,143475.75
411727,201811,76,61,15,58191.4,14023.8,72215.2
411729,201811,35,28,7,26712,6677.56,33389.56
411730,201811,542,350,192,332299.61,182873.04,515172.65
411740,201811,40,25,15,23849.66,14308.94,38158.60
411745,201811,71,47,24,44032.72,22893.92,66926.64
411750,201811,876,409,467,389071.43,444929.88,834001.31
411760,201811,1214,923,291,879255.15,277591.62,1156846.77
411770,201811,452,300,152,286192.63,145000.48,431193.11
411780,201811,336,216,120,206059.71,114475.71,320535.42
411790,201811,529,301,228,285231.85,217201.99,502433.84
411800,201811,171,135,36,128785.72,34343.89,163129.61
411810,201811,164,124,40,118292.59,38157.88,156450.47
411820,201811,2128,1027,1101,976187.74,1049485.1,2025672.84
411830,201811,13,13,0,12401.45,0,12401.45
411840,201811,1938,1204,734,1146675.91,698754.69,1845430.60
411845,201811,50,20,30,19078.93,28616.15,47695.08
411850,201811,1232,696,536,662398.27,509348.59,1171746.86
411860,201811,47,32,15,30238.68,14308.93,44547.61
411870,201811,77,54,23,51513.46,21654.33,73167.79
411880,201811,422,271,151,258404.09,144049.25,402453.34
411885,201811,105,69,36,65825.48,34344,100169.48
411890,201811,322,204,118,192405.84,112560.53,304966.37
411900,201811,69,50,19,47700,18126,65826
411910,201811,184,144,40,137360.46,37315.6,174676.06
411915,201811,2120,919,1201,874232.22,1144381.65,2018613.87
411920,201811,125,103,22,98257.1,20988,119245.1
411925,201811,12,8,4,7632,3816,11448
411930,201811,802,593,209,563777.51,199382.04,763159.55
411940,201811,593,414,179,394470.78,170756.5,565227.28
411950,201811,901,482,419,459072.67,398445.22,857517.89
411960,201811,1054,727,327,690672.36,311945.15,1002617.51
411965,201811,26,18,8,17171.2,7631.78,24802.98
411970,201811,77,69,8,65821.11,7632,73453.11
411980,201811,166,117,49,111614.87,46744.07,158358.94
411990,201811,5141,3011,2130,2852493.91,2030060.57,4882554.48
411995,201811,456,172,284,164086.3,270930.25,435016.55
412000,201811,307,189,118,180099.55,112557.54,292657.09
412010,201811,52,31,21,29572.16,20033.16,49605.32
412015,201811,45,33,12,31481.4,11448,42929.4
412020,201811,28,24,4,22609.8,3816,26425.8
412030,201811,58,50,8,47699.46,7632,55331.46
412033,201811,57,39,18,37176.26,17171.13,54347.39
412035,201811,73,47,26,44837.32,24803.33,69640.65
412040,201811,36,24,12,22605.83,11446.89,34052.72
412050,201811,198,148,50,141187,47697.72,188884.72
412060,201811,764,588,176,558075.94,166907.72,724983.66
412065,201811,49,33,16,31482,15263.56,46745.56
412070,201811,160,107,53,101405.34,50559.57,151964.91
412080,201811,284,154,130,146914.14,124014.35,270928.49
412085,201811,33,16,17,15264,16217.18,31481.18
412090,201811,768,487,281,462897.89,268063.47,730961.36
412100,201811,249,210,39,199370.75,37206,236576.75
412110,201811,67,53,14,50561.16,13355.14,63916.30
412120,201811,317,205,112,194996.04,106840.89,301836.93
412125,201811,82,48,34,45503.65,32435.17,77938.82
412130,201811,42,30,12,28311.56,11447.56,39759.12
412135,201811,27,16,11,15263,10493.2,25756.2
412140,201811,317,226,91,214590.46,86808.98,301399.44
412150,201811,248,174,74,165038.12,70595.56,235633.68
412160,201811,87,52,35,49605.76,33388.24,82994.00
412170,201811,673,474,199,451897.3,189838.06,641735.36
412175,201811,38,29,9,27666,8586,36252
412180,201811,200,159,41,151081.46,38493.34,189574.80
412190,201811,332,264,68,251176.98,64869.25,316046.23
412200,201811,202,126,76,120199.12,72499.65,192698.77
412210,201811,79,62,17,59144.87,16217.73,75362.60
412215,201811,229,161,68,153591.23,64581.06,218172.29
412217,201811,75,59,16,56278.3,15262.05,71540.35
412220,201811,815,612,203,583833.49,193655.57,777489.06
412230,201811,337,204,133,192993.1,126826.32,319819.42
412240,201811,1344,660,684,625953.67,649982.51,1275936.18
412250,201811,369,239,130,227997.52,124010.63,352008.15
412260,201811,108,79,29,75364.18,27665.39,103029.57
412265,201811,174,137,37,130373.98,35295.75,165669.73
412270,201811,80,52,28,49606.18,26712,76318.18
412280,201811,92,73,19,69640.45,18125.99,87766.44
412290,201811,96,67,29,63916.77,27663.92,91580.69
412300,201811,212,137,75,130695.49,71404.31,202099.80
412310,201811,44,39,5,37205.88,4770,41975.88
412320,201811,93,79,14,75366,13355.4,88721.4
412330,201811,177,154,23,146912.48,21940.59,168853.07
412340,201811,151,106,45,101119.03,42640.99,143760.02
412350,201811,602,308,294,292810.54,280461.31,573271.85
412360,201811,29,25,4,23847.78,3816,27663.78
412370,201811,164,143,21,134989.19,20033.66,155022.85
412380,201811,263,197,66,187648.89,62850.6,250499.49
412382,201811,52,27,25,25754.73,23846.48,49601.21
412385,201811,142,104,38,99215.22,36251.55,135466.77
412390,201811,289,222,67,211776.58,63914.8,275691.38
412395,201811,71,56,15,53417.07,14308.26,67725.33
412400,201811,75,51,24,48651.89,22894.6,71546.49
412402,201811,256,127,129,121149.63,122777.02,243926.65
412405,201811,836,332,504,314299.7,479801.95,794101.65
412410,201811,979,611,368,580296.73,351061.52,931358.25
412420,201811,14,12,2,11447,1908,13355
412430,201811,21,15,6,14309.04,5724,20033.04
412440,201811,609,335,274,317108.76,259529.06,576637.82
412450,201811,78,66,12,62963.33,11447,74410.33
412460,201811,82,61,21,58188.73,20032.98,78221.71
412470,201811,230,181,49,172667.01,46745.8,219412.81
412480,201811,166,125,41,118283.78,39111.96,157395.74
412490,201811,160,139,21,132601.91,20033.09,152635.00
412500,201811,459,375,84,356155.29,80133.86,436289.15
412510,201811,185,155,30,147581,28620,176201
412520,201811,137,74,63,70590.1,60097.18,130687.28
412530,201811,107,56,51,53424,48366.93,101790.93
412535,201811,109,79,30,75333.23,28619.06,103952.29
412540,201811,71,36,35,34341.41,33387.65,67729.06
412545,201811,96,71,25,67731.6,23850,91581.6
412550,201811,3536,1611,1925,1533186.03,1833970.51,3367156.54
412555,201811,14,10,4,9540,3816,13356
412560,201811,588,438,150,415730.92,143092.36,558823.28
412570,201811,747,411,336,390520.34,320525.9,711046.24
412575,201811,86,60,26,57238.85,24803.23,82042.08
412580,201811,165,109,56,103984.58,53421.85,157406.43
412590,201811,34,32,2,30527.97,1908,32435.97
412600,201811,173,130,43,124018.27,41021.22,165039.49
412610,201811,31,19,12,18126,11446.97,29572.97
412620,201811,148,130,18,124015.07,17171.6,141186.67
412625,201811,2203,1170,1033,1113078.42,983262.71,2096341.13
412627,201811,71,57,14,54377,13354.99,67731.99
412630,201811,424,285,139,270340.45,132603.6,402944.05
412635,201811,68,20,48,19079.32,45788.42,64867.74
412640,201811,124,82,42,78225.56,40065.41,118290.97
412650,201811,351,221,130,210822.61,124010.28,334832.89
412660,201811,475,296,179,281650.73,170758.27,452409.00
412665,201811,51,45,6,42929.33,5724,48653.33
412667,201811,288,199,89,189003.51,84634.31,273637.82
412670,201811,61,52,9,49605.53,8585.02,58190.55
412680,201811,299,236,63,225142.74,60100.95,285243.69
412690,201811,105,66,39,62963.14,36915.19,99878.33
412700,201811,157,105,52,100169.56,49319.11,149488.67
412710,201811,1396,868,528,820485.78,501612.86,1322098.64
412720,201811,237,158,79,150726.31,75364.47,226090.78
412730,201811,194,157,37,149772.88,34343.56,184116.44
412740,201811,425,234,191,223084.67,182210.82,405295.49
412750,201811,467,273,194,259474.96,185062.93,444537.89
412760,201811,266,139,127,132602.41,121153.12,253755.53
412770,201811,2133,1207,926,1146916.52,881825.59,2028742.11
412780,201811,157,122,35,116382.61,33387.38,149769.99
412785,201811,263,130,133,123540.78,126879.47,250420.25
412788,201811,37,22,15,20986.93,14309.6,35296.53
412790,201811,135,111,24,105226.2,22896,128122.2
412795,201811,153,114,39,108754.87,37204.42,145959.29
412796,201811,308,214,94,203239.22,89534.2,292773.42
412800,201811,575,380,195,362216.08,186023.21,548239.29
412810,201811,3015,1662,1353,1579742.58,1289483.64,2869226.22
412820,201811,954,619,335,581405.86,318213.34,899619.20
412830,201811,14,11,3,10494,2861.56,13355.56
412840,201811,226,162,64,153585.24,61051.84,214637.08
412850,201811,782,529,253,502750.11,241354.71,744104.82
412853,201811,173,90,83,85859.56,78894.32,164753.88
412855,201811,221,119,102,112393.17,97306.43,209699.60
412860,201811,94,68,26,64872,24803.41,89675.41
412862,201811,58,43,15,41018.32,14301.82,55320.14
412863,201811,6,5,1,4770,954,5724
412865,201811,41,30,11,28619,10494,39113
412870,201811,109,71,38,67733.8,36251,103984.8
412880,201811,99,73,26,69641.43,24803.39,94444.82
420005,201811,42,37,5,35296.6,4765.06,40061.66
420010,201811,380,254,126,240847.93,119912.52,360760.45
420020,201811,83,67,16,63912.99,15261.44,79174.43
420030,201811,29,27,2,25758,1908,27666
420040,201811,109,84,25,80134.65,23850,103984.65
420050,201811,55,34,21,32434.06,20034,52468.06
420055,201811,19,18,1,17172,954,18126
420060,201811,32,24,8,22896,7632,30528
420070,201811,108,91,17,86809.6,16207.79,103017.39
420075,201811,11,10,1,9540,954,10494
420080,201811,48,44,4,41019.71,3816,44835.71
420090,201811,35,33,2,30704.49,1908,32612.49
420100,201811,165,139,26,131648.65,24803.66,156452.31
420110,201811,20,20,0,19079.26,0,19079.26
420120,201811,55,43,12,41018.78,11447.26,52466.04
420125,201811,86,70,16,66776.8,15263.41,82040.21
420127,201811,34,30,4,28619.6,3815.33,32434.93
420130,201811,396,250,146,238488.72,139028.99,377517.71
420140,201811,1309,746,563,710320.27,537010.12,1247330.39
420150,201811,45,40,5,38160,4770,42930
420160,201811,37,35,2,33389.22,1908,35297.22
420165,201811,19,14,5,13355,4769,18124
420170,201811,70,45,25,42926.97,23847.33,66774.30
420180,201811,24,23,1,21940.19,954,22894.19
420190,201811,30,27,3,25758,2862,28620
420195,201811,125,61,64,58194,61054.68,119248.68
420200,201811,1263,566,697,533615.93,663842.46,1197458.39
420205,201811,69,40,29,38157.48,27666,65823.48
420207,201811,109,61,48,57955,45782.46,103737.46
420208,201811,22,17,5,16217.08,3911.4,20128.48
420209,201811,20,16,4,15263.82,3816,19079.82
420210,201811,462,225,237,214357.04,226009.34,440366.38
420213,201811,43,35,8,33390,7631.4,41021.4
420215,201811,28,24,4,22894.26,3816,26710.26
420220,201811,66,43,23,41022,21941.13,62963.13
420230,201811,800,454,346,431666.99,329585.95,761252.94
420240,201811,2277,1533,744,1454377.09,709312.09,2163689.18
420243,201811,39,31,8,29572.95,7632,37204.95
420245,201811,125,63,62,60099.45,59143.76,119243.21
420250,201811,56,34,22,32436,20987.72,53423.72
420253,201811,43,35,8,33389.33,7631.8,41021.13
420257,201811,13,11,2,10493.14,1908,12401.14
420260,201811,102,89,13,84904.53,12400.2,97304.73
420270,201811,38,31,7,29561,6678,36239
420280,201811,277,208,69,196672.63,64550.18,261222.81
420285,201811,20,12,8,11447.4,7632,19079.4
420287,201811,56,36,20,34343.89,19079.03,53422.92
420290,201811,967,683,284,648649.66,270065.03,918714.69
420300,201811,1406,1124,282,1067303.62,266821.1,1334124.72
420310,201811,57,44,13,41973.43,12402,54375.43
420315,201811,33,29,4,27666,3816,31482
420320,201811,852,436,416,414960.66,396845.54,811806.20
420325,201811,0,0,0,0,0,0
420330,201811,124,85,39,81089.4,37089.1,118178.5
420340,201811,166,112,54,105865.21,51485.3,157350.51
420350,201811,258,191,67,180641.04,63915.35,244556.39
420360,201811,771,585,186,555189.94,177139.16,732329.10
420370,201811,116,71,45,67533.31,42639.79,110173.10
420380,201811,1133,805,328,763328.53,312786.4,1076114.93
420390,201811,263,177,86,167010.87,81326.72,248337.59
420395,201811,182,132,50,125924.37,46836.19,172760.56
420400,201811,250,190,60,180215.88,57238.85,237454.73
420410,201811,61,46,15,43884,14309.11,58193.11
420415,201811,34,32,2,30528,1908,32436
420417,201811,53,39,14,37203.81,13336.92,50540.73
420419,201811,11,11,0,10494,0,10494
420420,201811,2840,1748,1092,1656325.43,1039420.14,2695745.57
420425,201811,77,63,14,60085.69,13028.38,73114.07
420430,201811,1260,886,374,841541.5,354947.75,1196489.25
420435,201811,17,15,2,14310,1908,16218
420440,201811,106,73,33,68977.08,31308.6,100285.68
420445,201811,22,20,2,19080,1908,20988
420450,201811,72,36,36,34340.8,34344,68684.8
420455,201811,216,164,52,156391.58,49533.47,205925.05
420460,201811,2362,1563,799,1487142.06,761945.96,2249088.02
420470,201811,116,85,31,81049.9,29574,110623.9
420475,201811,6,6,0,5724,0,5724
420480,201811,879,660,219,623489.99,207869.35,831359.34
420490,201811,112,85,27,81088.72,25756.83,106845.55
420500,201811,642,287,355,271812.58,338662.51,610475.09
420510,201811,18,15,3,14310,2862,17172
420515,201811,27,21,6,20033,5723.75,25756.75
420517,201811,10,10,0,9540,0,9540
420519,201811,0,0,0,0,0,0
420520,201811,70,53,17,50561.11,16218,66779.11
420530,201811,166,112,54,105881.19,51515.33,157396.52
420535,201811,20,19,1,18125.03,953.76,19078.79
420540,201811,5063,2997,2066,2845205.48,1965591.18,4810796.66
420543,201811,27,27,0,25756.84,0,25756.84
420545,201811,201,141,60,134511.68,57220.66,191732.34
420550,201811,869,703,166,667722.9,158179.82,825902.72
420555,201811,39,28,11,26712,10494,37206
420560,201811,66,53,13,50177.16,12402,62579.16
420570,201811,157,93,64,88719.58,61046.13,149765.71
420580,201811,298,133,165,126879.9,157119.01,283998.91
420590,201811,515,365,150,347915.11,143091.23,491006.34
420600,201811,105,57,48,54090.25,45792,99882.25
420610,201811,41,38,3,36251,2862,39113
420620,201811,76,62,14,59147.1,13355.7,72502.8
420630,201811,162,117,45,111596.67,42903.23,154499.90
420640,201811,93,83,10,78989.99,9540,88529.99
420650,201811,231,121,110,114763.02,104318.8,219081.82
420660,201811,56,43,13,40257.8,12402,52659.8
420665,201811,38,29,9,27664.23,8586,36250.23
420670,201811,327,247,80,234917.28,76293.75,311211.03
420675,201811,16,15,1,14310,954,15264
420680,201811,38,28,10,26711.4,9540,36251.4
420690,201811,176,148,28,140421.28,26709.26,167130.54
420700,201811,671,468,203,445063.6,193358.77,638422.37
420710,201811,152,86,66,82038.01,62675.77,144713.78
420720,201811,110,89,21,84895.81,20033.2,104929.01
420730,201811,569,370,199,351899.08,188521.35,540420.43
420740,201811,47,46,1,43883.14,954,44837.14
420750,201811,501,336,165,320246.3,157401.73,477648.03
420757,201811,19,16,3,15262.8,2862,18124.8
420760,201811,36,30,6,28619.31,5724,34343.31
420765,201811,72,58,14,55330.12,13354.87,68684.99
420768,201811,67,59,8,56283.45,7631.6,63915.05
420770,201811,83,70,13,66779.11,12402,79181.11
420775,201811,45,41,4,38157.21,3815,41972.21
420780,201811,242,190,52,181247.81,49607.43,230855.24
420785,201811,13,10,3,9539.15,2861.56,12400.71
420790,201811,177,148,29,141066.49,26671.84,167738.33
420800,201811,71,54,17,50752.8,16217.6,66970.4
420810,201811,249,218,31,207952.27,28763.1,236715.37
420820,201811,2350,1391,959,1321243.22,913476.02,2234719.24
420830,201811,610,341,269,323010.45,255651.39,578661.84
420840,201811,152,113,39,107798.39,36499.67,144298.06
420845,201811,442,195,247,185637.78,234387.74,420025.52
420850,201811,237,189,48,180300.49,45787.59,226088.08
420860,201811,64,54,10,51515.93,9540,61055.93
420870,201811,120,86,34,81802.29,31958.38,113760.67
420880,201811,176,122,54,116375.12,51037.8,167412.92
420890,201811,887,440,447,417480.41,426106.6,843587.01
420895,201811,9,9,0,8586,0,8586
420900,201811,417,329,88,310969.55,83913.68,394883.23
420910,201811,5836,3299,2537,3134531.79,2415094.35,5549626.14
420915,201811,77,71,6,67733.56,5723.03,73456.59
420917,201811,19,14,5,13355.89,4770,18125.89
420920,201811,22,15,7,14310,6678,20988
420930,201811,2798,1726,1072,1637826.68,1016189.54,2654016.22
420940,201811,615,447,168,425094.15,158582.8,583676.95
420945,201811,10,8,2,7631.83,1908,9539.83
420950,201811,57,52,5,49607.9,4770,54377.9
420960,201811,118,94,24,89626.92,22881,112507.92
420970,201811,298,240,58,227250.57,55290.6,282541.17
420980,201811,22,22,0,20988,0,20988
420985,201811,63,55,8,52468.71,7632,60100.71
420990,201811,76,61,15,58187.67,14309.15,72496.82
421000,201811,31,20,11,19080,10493,29573
421003,201811,68,47,21,44836.55,20034,64870.55
421005,201811,8,5,3,4770,2862,7632
421010,201811,755,532,223,506263.21,211618.26,717881.47
421020,201811,28,23,5,21942,4770,26712
421030,201811,128,108,20,102683.45,19080,121763.45
421040,201811,72,59,13,55106.99,12401.1,67508.09
421050,201811,321,229,92,216732.59,87761.02,304493.61
421055,201811,25,21,4,20034,3815.84,23849.84
421060,201811,79,54,25,51515.07,23849.26,75364.33
421070,201811,49,45,4,42930,3816,46746
421080,201811,35,33,2,31482,1908,33390
421085,201811,25,20,5,19079,4770,23849
421090,201811,41,30,11,28618.3,10494,39112.3
421100,201811,129,94,35,89673.39,33387.96,123061.35
421105,201811,220,177,43,168562.02,40991.95,209553.97
421110,201811,112,91,21,86191.09,20034,106225.09
421120,201811,156,122,34,115885.03,32405.24,148290.27
421125,201811,17,12,5,11446.37,4769.6,16215.97
421130,201811,806,524,282,498741.8,267509.79,766251.59
421140,201811,31,23,8,21224.81,7632,28856.81
421145,201811,39,31,8,29573.38,7631.42,37204.80
421150,201811,107,77,30,73457.56,28620,102077.56
421160,201811,65,42,23,40057.23,21940.6,61997.83
421165,201811,17,16,1,15263.2,954,16217.2
421170,201811,196,167,29,158365.53,27651,186016.53
421175,201811,154,103,51,98259.6,48605.38,146864.98
421180,201811,61,40,21,37791.74,20034,57825.74
421185,201811,16,13,3,12402,2862,15264
421187,201811,0,0,0,0,0,0
421189,201811,39,29,10,27666,9530.02,37196.02
421190,201811,1614,1022,592,973970.57,563484.75,1537455.32
421200,201811,90,68,22,63905.33,20986.77,84892.10
421205,201811,28,18,10,17170.22,9540,26710.22
421210,201811,172,123,49,117336.49,46745.12,164081.61
421220,201811,283,223,60,212110.64,57231.93,269342.57
421223,201811,53,44,9,41780.81,8585.2,50366.01
421225,201811,69,43,26,40827,24804,65631
421227,201811,95,72,23,68685.39,21941.33,90626.72
421230,201811,52,39,13,37205.06,12402,49607.06
421240,201811,19,19,0,18126,0,18126
421250,201811,355,221,134,209479.7,127041.74,336521.44
421260,201811,27,22,5,20988,4769.61,25757.61
421265,201811,1,1,0,954,0,954
421270,201811,52,46,6,43881.88,5722.72,49604.60
421280,201811,340,193,147,184116.17,139280.29,323396.46
421290,201811,327,218,109,207721.4,101850.43,309571.83
421300,201811,25,21,4,20034,3815.56,23849.56
421310,201811,53,40,13,37492.2,12402,49894.2
421315,201811,30,20,10,19079.56,9540,28619.56
421320,201811,135,95,40,90625.15,38154.91,128780.06
421330,201811,109,84,25,77881.03,23833.89,101714.92
421335,201811,39,27,12,25757.33,11448,37205.33
421340,201811,297,205,92,194743.37,87767.6,282510.97
421350,201811,192,111,81,105439.95,77272.57,182712.52
421360,201811,678,504,174,477149.33,165968.69,643118.02
421370,201811,195,151,44,144047.63,41639.43,185687.06
421380,201811,133,107,26,102071.87,24804,126875.87
421390,201811,17,12,5,11447.89,4769.01,16216.90
421400,201811,120,103,17,98259.03,16217.48,114476.51
421410,201811,23,19,4,18126,3815.78,21941.78
421415,201811,21,20,1,19078.37,954,20032.37
421420,201811,148,123,25,116768.56,23848.73,140617.29
421430,201811,14,10,4,9539.56,3815.13,13354.69
421440,201811,58,45,13,42928.81,12402,55330.81
421450,201811,93,79,14,75362.81,13356,88718.81
421460,201811,57,48,9,44985.05,8585,53570.05
421470,201811,67,44,23,41976,21942,63918
421480,201811,646,484,162,460941.62,154525.36,615466.98
421490,201811,22,21,1,20019,954,20973
421500,201811,509,329,180,312051.18,171357.36,483408.54
421505,201811,26,17,9,16217,8585.65,24802.65
421507,201811,36,30,6,28618.57,5724,34342.57
421510,201811,74,50,24,47696.43,22895.33,70591.76
421520,201811,65,56,9,52657.01,8585,61242.01
421530,201811,54,48,6,45790.82,5722.31,51513.13
421535,201811,27,26,1,24534.55,954,25488.55
421540,201811,58,49,9,46744.24,8585.56,55329.80
421545,201811,96,72,24,68193.46,22895.4,91088.86
421550,201811,300,219,81,208243.01,77272.85,285515.86
421555,201811,25,20,5,19079.29,4669.06,23748.35
421560,201811,8,7,1,6678,954,7632
421565,201811,126,91,35,86050.48,33390,119440.48
421567,201811,29,25,4,23848.91,3815.01,27663.92
421568,201811,33,31,2,29573.22,1908,31481.22
421569,201811,7,7,0,6678,0,6678
421570,201811,174,117,57,111612.27,54374.71,165986.98
421575,201811,27,22,5,20986.99,4770,25756.99
421580,201811,720,435,285,413053.44,270925.44,683978.88
421590,201811,22,21,1,20034,954,20988
421600,201811,129,80,49,76316.04,45489.52,121805.56
421605,201811,107,76,31,72159.47,29572.6,101732.07
421610,201811,187,149,38,141187.79,36251.13,177438.92
421620,201811,1090,649,441,616621.71,420390.9,1037012.61
421625,201811,24,22,2,20987.29,1908,22895.29
421630,201811,293,186,107,176619.79,101209.82,277829.61
421635,201811,17,8,9,7632,8586,16218
421640,201811,99,85,14,80895.18,13356,94251.18
421650,201811,285,167,118,159297.43,112551.49,271848.92
421660,201811,2187,1325,862,1260811.55,821124.06,2081935.61
421670,201811,193,136,57,129738.5,54369.19,184107.69
421680,201811,174,158,16,150728.7,15263.38,165992.08
421690,201811,352,248,104,234851.59,98247.48,333099.07
421700,201811,61,39,22,37205.74,20123.46,57329.20
421710,201811,26,25,1,23849.08,953.6,24802.68
421715,201811,8,7,1,6678,954,7632
421720,201811,590,432,158,410537.13,148991.1,559528.23
421725,201811,13,6,7,5723.32,6678,12401.32
421730,201811,40,28,12,25992.53,11448,37440.53
421740,201811,87,42,45,40066.64,42925.25,82991.89
421750,201811,224,170,54,159727.94,51516,211243.94
421755,201811,26,24,2,22894.42,1908,24802.42
421760,201811,104,74,30,70595.25,28619.56,99214.81
421770,201811,594,399,195,376692.86,185444.13,562136.99
421775,201811,30,19,11,18125,10494,28619
421780,201811,199,157,42,149767.46,40066.21,189833.67
421790,201811,161,134,27,126942.01,25757.25,152699.26
421795,201811,17,14,3,13356,2862,16218
421800,201811,497,317,180,301613.83,171474.51,473088.34
421810,201811,72,57,15,54376.86,14310,68686.86
421820,201811,317,215,102,204147.67,97305.16,301452.83
421825,201811,130,109,21,103983.01,20034,124017.01
421830,201811,132,99,33,94444.29,31482,125926.29
421835,201811,3,3,0,2862,0,2862
421840,201811,56,48,8,45775.52,7632,53407.52
421850,201811,80,69,11,65821.44,10480,76301.44
421860,201811,40,32,8,30528,7631.99,38159.99
421870,201811,979,751,228,707668.95,216665.61,924334.56
421875,201811,54,46,8,43881.75,7631.45,51513.20
421880,201811,169,122,47,116385.45,44547.56,160933.01
421885,201811,29,23,6,21942,5724,27666
421890,201811,124,88,36,83950.8,33374,117324.8
421895,201811,46,42,4,40064.52,3814.28,43878.80
421900,201811,161,129,32,122681.87,30465.4,153147.27
421910,201811,68,43,25,41021.09,23849.66,64870.75
421915,201811,30,25,5,23850,4770,28620
421917,201811,42,31,11,29573.86,10493.63,40067.49
421920,201811,33,30,3,28620,2860.67,31480.67
421930,201811,747,584,163,553860.62,155454.53,709315.15
421935,201811,55,48,7,45792,6678,52470
421940,201811,40,36,4,34344,3815.32,38159.32
421950,201811,848,564,284,535006.83,270164.22,805171.05
421960,201811,41,34,7,32147.56,6673.12,38820.68
421970,201811,366,232,134,219587.14,127818.14,347405.28
421985,201811,32,21,11,20034,10494,30528
422000,201811,0,0,0,0,0,0
430003,201811,197,49,148,46030.5,141189.94,187220.44
430005,201811,38,29,9,27665.53,8586,36251.53
430010,201811,278,198,80,188412.32,76318.65,264730.97
430020,201811,150,97,53,92248.8,50558.2,142807.0
430030,201811,131,103,28,97969.96,26711.66,124681.62
430040,201811,2973,1736,1237,1646169.2,1179071.84,2825241.04
430045,201811,67,58,9,55039.61,8586,63625.61
430047,201811,6,5,1,4770,954,5724
430050,201811,78,66,12,62960.6,11448,74408.6
430055,201811,15,13,2,12402,1907.6,14309.6
430057,201811,5,3,2,2861.62,1908,4769.62
430060,201811,3652,2170,1482,2061371.6,1410690.03,3472061.63
430063,201811,60,55,5,52466.69,4770,57236.69
430064,201811,155,128,27,122108.81,25753.97,147862.78
430066,201811,8,6,2,5724,1908,7632
430070,201811,43,33,10,31480.71,9540,41020.71
430080,201811,68,46,22,43182.16,20986.84,64169.00
430085,201811,35,13,22,12402,20986.14,33388.14
430087,201811,32,23,9,21797,8586,30383
430090,201811,72,65,7,61722.33,6678,68400.33
430100,201811,131,89,42,83950.61,40066.81,124017.42
430105,201811,145,74,71,70401.35,67424.43,137825.78
430107,201811,20,15,5,14310,4770,19080
430110,201811,417,248,169,235711.15,161106.97,396818.12
430120,201811,142,130,12,123058.11,11447.95,134506.06
430130,201811,804,498,306,474458.23,290380.53,764838.76
430140,201811,119,112,7,106560.18,6678,113238.18
430150,201811,112,72,40,67921.8,37205.28,105127.08
430155,201811,32,29,3,27666,2862,30528
430160,201811,3767,2251,1516,2124756.11,1444490.18,3569246.29
430163,201811,328,148,180,139363.98,171436.52,310800.50
430165,201811,27,19,8,18125.98,7632,25757.98
430170,201811,92,78,14,74410.7,13354.6,87765.3
430175,201811,87,67,20,63914.42,18411.18,82325.60
430180,201811,105,84,21,80129.83,19411.9,99541.73
430185,201811,34,26,8,24803.33,7631.8,32435.13
430187,201811,95,40,55,38160,52162,90322
430190,201811,221,127,94,121104.55,89664.45,210769.00
430192,201811,14,13,1,12402,953,13355
430195,201811,16,11,5,10492.35,4770,15262.35
430200,201811,171,150,21,142430.84,19746.7,162177.54
430205,201811,19,18,1,17171.83,954,18125.83
430210,201811,658,512,146,484695.04,137655.23,622350.27
430215,201811,17,12,5,11447.49,4769.39,16216.88
430220,201811,71,50,21,47695.32,20031.33,67726.65
430222,201811,13,7,6,6678,5723.55,12401.55
430223,201811,12,7,5,6676.99,4769.23,11446.22
430225,201811,3,2,1,1908,954,2862
430230,201811,301,181,120,171717.48,114379.3,286096.78
430235,201811,55,40,15,38155.08,14299.41,52454.49
430237,201811,29,22,7,20987,6678,27665
430240,201811,136,88,48,83758.26,45791.52,129549.78
430245,201811,71,59,12,56284.41,11446.39,67730.80
430250,201811,194,114,80,108740.75,76306.76,185047.51
430258,201811,11,9,2,8586,1908,10494
430260,201811,34,29,5,27666,4759.85,32425.85
430265,201811,35,29,6,27646.92,5723.33,33370.25
430270,201811,547,410,137,385104.87,129806.8,514911.67
430280,201811,1038,644,394,609348.54,374310.93,983659.47
430290,201811,380,220,160,207961.09,152637.13,360598.22
430300,201811,2141,1192,949,1131494.93,901933.69,2033428.62
430310,201811,1963,1031,932,977222.58,886022.14,1863244.72
430320,201811,52,44,8,41960.51,7631.39,49591.90
430330,201811,98,87,11,82517.32,10494,93011.32
430340,201811,67,60,7,57238.47,6677.25,63915.72
430350,201811,1668,1163,505,1097328.68,479978.47,1577307.15
430355,201811,24,22,2,20988,1908,22896
430360,201811,86,43,43,41019.6,41019.41,82039.01
430367,201811,28,20,8,19077.73,7631.41,26709.14
430370,201811,56,48,8,45790.37,7630.45,53420.82
430380,201811,136,102,34,96733.92,32435.58,129169.50
430390,201811,607,383,224,365090.39,213107.32,578197.71
430400,201811,143,110,33,103021.22,31460.71,134481.93
430410,201811,60,47,13,44837.22,12401.6,57238.82
430420,201811,507,336,171,319007.99,161614.71,480622.70
430430,201811,54,52,2,48970.31,1097.1,50067.41
430435,201811,153,116,37,109709.1,35296.91,145006.01
430440,201811,508,339,169,322911.66,161028.72,483940.38
430450,201811,1180,973,207,921681.03,197461.85,1119142.88
430460,201811,5057,2798,2259,2654770.7,2148492.48,4803263.18
430461,201811,17,15,2,14310,1908,16218
430462,201811,9,6,3,5724,2862,8586
430463,201811,1037,553,484,525411.22,461348.02,986759.24
430465,201811,24,14,10,13355.99,9540,22895.99
430466,201811,672,486,186,461716.54,177241.49,638958.03
430467,201811,99,57,42,53135.76,40057.54,93193.30
430468,201811,108,65,43,62006.87,40769.33,102776.20
430469,201811,24,19,5,18126,4770,22896
430470,201811,1172,652,520,616489.45,493824.19,1110313.64
430471,201811,51,38,13,36232.69,12401.22,48633.91
430480,201811,102,62,40,58288.69,38146.87,96435.56
430485,201811,6,6,0,5435.2,0,5435.2
430490,201811,88,72,16,67868.43,15264,83132.43
430495,201811,37,26,11,24804,10493.24,35297.24
430500,201811,191,127,64,120867,60662.68,181529.68
430510,201811,3277,2149,1128,2039416.29,1074582.93,3113999.22
430511,201811,18,17,1,16218,954,17172
430512,201811,137,97,40,92531.48,38158.96,130690.44
430513,201811,51,41,10,38635.52,9537.21,48172.73
430515,201811,32,30,2,28619.6,1908,30527.6
430517,201811,166,148,18,140234.28,17152.12,157386.40
430520,201811,364,255,109,242581.81,103953.27,346535.08
430530,201811,90,52,38,49606.49,36250.8,85857.29
430535,201811,471,319,152,303820.93,144969.41,448790.34
430537,201811,9,9,0,8586,0,8586
430540,201811,76,52,24,49604.09,22895.13,72499.22
430543,201811,367,116,251,110662.21,239449.58,350111.79
430544,201811,44,41,3,39111.56,2861.66,41973.22
430545,201811,359,178,181,169292.48,172419.11,341711.59
430550,201811,43,36,7,34341.71,6678,41019.71
430558,201811,5,3,2,2862,1908,4770
430560,201811,53,25,28,23848.3,26709.6,50557.9
430570,201811,109,44,65,41974.88,61947.09,103921.97
430580,201811,124,100,24,95397.4,21941.46,117338.86
430583,201811,14,14,0,13355.93,0,13355.93
430585,201811,10,4,6,3816,5724,9540
430587,201811,15,7,8,6678,7632,14310
430590,201811,153,125,28,118009.3,26709.78,144719.08
430593,201811,3,3,0,2862,0,2862
430595,201811,18,14,4,13353.91,3816,17169.91
430597,201811,54,30,24,28620,22895.48,51515.48
430600,201811,221,156,65,148811.41,61722.57,210533.98
430605,201811,163,103,60,98260.69,56559.56,154820.25
430607,201811,27,22,5,20986.83,4770,25756.83
430610,201811,1625,769,856,731009.65,811009.65,1542019.30
430613,201811,3,3,0,2861.6,0,2861.6
430620,201811,117,84,33,80132.58,31471.04,111603.62
430630,201811,47,41,6,39111.04,5722.74,44833.78
430632,201811,32,27,5,25757.28,4770,30527.28
430635,201811,40,37,3,35298,2862,38160
430637,201811,55,32,23,30527.45,21942,52469.45
430640,201811,201,113,88,106369.22,83948.34,190317.56
430642,201811,23,21,2,20034,1908,21942
430645,201811,36,29,7,27666,6676.66,34342.66
430650,201811,257,207,50,197184.51,47648.77,244833.28
430655,201811,4,4,0,3816,0,3816
430660,201811,970,475,495,451566.6,470215.18,921781.78
430670,201811,71,50,21,47697.48,20033.4,67730.88
430673,201811,73,40,33,38157.08,31478.98,69636.06
430675,201811,14,11,3,10494,2862,13356
430676,201811,504,310,194,295008.3,184989.38,479997.68
430680,201811,246,174,72,163795.74,68395.43,232191.17
430690,201811,537,327,210,310751.02,198646.57,509397.59
430692,201811,7,5,2,4770,1908,6678
430693,201811,143,97,46,92534.76,43873.05,136407.81
430695,201811,75,63,12,59166.62,11445.79,70612.41
430697,201811,60,38,22,36250.18,20987.2,57237.38
430700,201811,1570,1102,468,1039754.21,446454.79,1486209.00
430705,201811,22,20,2,19078.11,1907.47,20985.58
430710,201811,257,169,88,161221.61,83948.83,245170.44
430720,201811,107,91,16,86622.5,15263.2,101885.7
430730,201811,126,108,18,102072.6,17169.63,119242.23
430740,201811,64,42,22,40066.73,20986.68,61053.41
430745,201811,35,28,7,26710,6678,33388
430750,201811,348,230,118,218472.48,111608.89,330081.37
430755,201811,82,49,33,46743.03,31481.19,78224.22
430760,201811,355,214,141,201471.48,134476.44,335947.92
430770,201811,1436,753,683,715418.33,646944.9,1362363.23
430780,201811,318,204,114,193612.85,108686.81,302299.66
430781,201811,30,25,5,23850,4769,28619
430783,201811,53,42,11,39749.16,10493.4,50242.56
430786,201811,6,3,3,2862,2861.56,5723.56
430790,201811,525,339,186,322495.32,177132.38,499627.70
430800,201811,158,131,27,124264.81,25755.25,150020.06
430805,201811,43,39,4,37205.61,3816,41021.61
430807,201811,42,25,17,23849,16214.62,40063.62
430810,201811,78,52,26,49604.38,24803.6,74407.98
430820,201811,138,84,54,80132.62,50846.52,130979.14
430825,201811,12,10,2,9540,1908,11448
430830,201811,233,217,16,206419.38,15262.6,221681.98
430840,201811,128,85,43,81088.85,40160.06,121248.91
430843,201811,5,3,2,2862,1908,4770
430845,201811,71,40,31,38159.27,29572.05,67731.32
430850,201811,584,411,173,389739.13,164913.44,554652.57
430860,201811,164,102,62,96635.13,58464.16,155099.29
430865,201811,73,43,30,40351.69,28298.3,68649.99
430870,201811,84,68,16,64201.34,15261.74,79463.08
430880,201811,156,117,39,111593.32,37202.2,148795.52
430885,201811,7,5,2,4770,1907.44,6677.44
430890,201811,342,210,132,197434.73,125920.96,323355.69
430900,201811,535,374,161,352559.46,153112.44,505671.90
430905,201811,106,45,61,42927.12,58185.89,101113.01
430910,201811,269,149,120,142143.21,113783.26,255926.47
430912,201811,5,5,0,4770,0,4770
430915,201811,34,28,6,26710.21,5724,32434.21
430920,201811,4255,2372,1883,2255667.44,1794261.75,4049929.19
430925,201811,4,3,1,2862,954,3816
430930,201811,2095,1245,850,1180661.93,810584.87,1991246.80
430940,201811,259,165,94,156724.74,89650.84,246375.58
430950,201811,151,120,31,114477.95,29573.12,144051.07
430955,201811,23,14,9,13355.72,8586,21941.72
430957,201811,19,18,1,17172,954,18126
430960,201811,248,165,83,154015.58,77699.16,231714.74
430965,201811,109,68,41,64870.05,39113.46,103983.51
430970,201811,83,68,15,64870.62,13355.1,78225.72
430975,201811,38,34,4,32435.93,3815.22,36251.15
430980,201811,46,30,16,28616.25,15262.9,43879.15
430990,201811,119,90,29,85855.21,27662.17,113517.38
430995,201811,116,111,5,104652.48,4770,109422.48
431000,201811,308,140,168,131395.93,160262.13,291658.06
431010,201811,344,205,139,194994.74,130865.48,325860.22
431020,201811,1945,1142,803,1081420.65,761746.21,1843166.86
431030,201811,42,33,9,31482,8586,40068
431033,201811,387,196,191,186166.35,182207.03,368373.38
431036,201811,14,9,5,8586,4769.63,13355.63
431040,201811,132,80,52,75362.38,48828.68,124191.06
431041,201811,41,29,12,27665.08,11447.16,39112.24
431043,201811,47,28,19,26709.57,18125.61,44835.18
431046,201811,11,7,4,6678,3815.83,10493.83
431050,201811,200,129,71,122488.11,67732.39,190220.50
431053,201811,78,47,31,44074.16,29574,73648.16
431055,201811,61,42,19,40068,18105.51,58173.51
431057,201811,17,17,0,16218,0,16218
431060,201811,1658,1054,604,994148.74,574257.71,1568406.45
431065,201811,19,11,8,10494,7631.13,18125.13
431070,201811,70,64,6,61054.31,5723.87,66778.18
431075,201811,7,7,0,6678,0,6678
431080,201811,138,85,53,80515.31,50555.54,131070.85
431085,201811,33,30,3,28618.51,2862,31480.51
431087,201811,13,11,2,10494,1908,12402
431090,201811,55,43,12,41020.8,11447.06,52467.86
431100,201811,1223,731,492,686563.83,469345.32,1155909.15
431110,201811,250,156,94,148818.34,89362.72,238181.06
431112,201811,28,17,11,16218,10493.66,26711.66
431113,201811,34,24,10,22895.5,9539.07,32434.57
431115,201811,160,112,48,106207.09,45781.66,151988.75
431120,201811,607,362,245,343397.25,232702.24,576099.49
431123,201811,4,3,1,2862,954,3816
431125,201811,96,86,10,81757.12,9540,91297.12
431127,201811,9,4,5,3815.25,4770,8585.25
431130,201811,681,438,243,415367.46,231499.22,646866.68
431140,201811,754,519,235,493872.26,224104.99,717977.25
431142,201811,35,27,8,24545,7631.78,32176.78
431150,201811,202,150,52,142388.37,49594.23,191982.60
431160,201811,56,50,6,47699.07,5724,53423.07
431162,201811,19,14,5,13356,4770,18126
431164,201811,5,5,0,4770,0,4770
431170,201811,106,86,20,82041.44,19078.45,101119.89
431171,201811,63,36,27,34103.58,25737.32,59840.90
431173,201811,1,1,0,954,0,954
431175,201811,205,104,101,97969.92,96342.42,194312.34
431177,201811,76,57,19,54375.9,17428.56,71804.46
431179,201811,14,12,2,11447.8,1908,13355.8
431180,201811,446,275,171,261624.62,163103.6,424728.22
431190,201811,88,67,21,63917.8,20033.3,83951.1
431198,201811,68,47,21,44836.74,20032.34,64869.08
431200,201811,20,16,4,15263.82,3814.46,19078.28
431205,201811,23,23,0,21942,0,21942
431210,201811,85,51,34,48366.26,32434.29,80800.55
431213,201811,31,26,5,24801.71,4770,29571.71
431215,201811,25,22,3,20987.96,2861.4,23849.36
431217,201811,5,4,1,3816,954,4770
431220,201811,68,58,10,55330.75,9538.53,64869.28
431225,201811,152,100,52,95381.28,49586.48,144967.76
431230,201811,99,86,13,82040.55,12399.19,94439.74
431235,201811,8,8,0,7631.66,0,7631.66
431237,201811,23,16,7,15264,6678,21942
431238,201811,10,7,3,6389,2862,9251
431240,201811,1000,654,346,622196.76,329743.71,951940.47
431242,201811,39,38,1,36249.06,954,37203.06
431244,201811,11,8,3,7632,2862,10494
431245,201811,55,41,14,39113.03,13356,52469.03
431247,201811,12,10,2,9540,1908,11448
431250,201811,276,146,130,139211.57,123988.15,263199.72
431260,201811,61,46,15,43881.79,14310,58191.79
431261,201811,19,13,6,12401.58,5724,18125.58
431262,201811,16,16,0,15263.66,0,15263.66
431265,201811,163,90,73,85859.6,69640.96,155500.56
431267,201811,15,14,1,13355.23,954,14309.23
431270,201811,322,264,58,251565.92,55328.32,306894.24
431275,201811,39,36,3,34343.33,2862,37205.33
431280,201811,18,14,4,12521.25,3816,16337.25
431290,201811,24,19,5,18125.46,4769.98,22895.44
431295,201811,4,4,0,3816,0,3816
431300,201811,24,21,3,20032.92,2862,22894.92
431301,201811,7,7,0,6678,0,6678
431303,201811,53,35,18,32979.24,16885.59,49864.83
431306,201811,232,121,111,115258.37,105214.38,220472.75
431308,201811,7,5,2,4770,1908,6678
431310,201811,66,57,9,54376.4,8585.56,62961.96
431320,201811,130,79,51,75345.61,48336.4,123682.01
431330,201811,173,115,58,109704.83,55328.62,165033.45
431333,201811,32,26,6,24803.63,5724,30527.63
431335,201811,9,4,5,3816,4770,8586
431337,201811,327,150,177,142404.96,167806.37,310211.33
431339,201811,23,20,3,19078.32,2862,21940.32
431340,201811,3009,1735,1274,1649727.18,1212718.38,2862445.56
431342,201811,39,24,15,22896,14310,37206
431344,201811,18,18,0,17170.93,0,17170.93
431346,201811,4,4,0,3816,0,3816
431349,201811,35,32,3,30528,2862,33390
431350,201811,911,541,370,512773.04,351305.22,864078.26
431360,201811,50,44,6,41973.14,5723.78,47696.92
431365,201811,317,150,167,143075.44,158350.76,301426.20
431370,201811,1336,801,535,761610.43,510155.28,1271765.71
431380,201811,97,83,14,79180.51,13355.17,92535.68
431390,201811,517,285,232,270211.24,221300,491511.24
431395,201811,294,131,163,124969.92,155475.7,280445.62
431400,201811,40,30,10,28619.86,9539.4,38159.26
431402,201811,105,73,32,69638.2,30525.27,100163.47
431403,201811,22,14,8,13355.88,7630.76,20986.64
431405,201811,645,351,294,332906.39,279847.18,612753.57
431406,201811,31,27,4,25757.43,3816,29573.43
431407,201811,52,41,11,39112.84,10492.53,49605.37
431410,201811,3393,2073,1320,1962654.24,1254699.36,3217353.60
431413,201811,17,14,3,13356,2862,16218
431415,201811,70,53,17,50560.29,16218,66778.29
431417,201811,23,12,11,11447.31,10493.85,21941.16
431420,201811,313,222,91,211147.91,86811.85,297959.76
431430,201811,47,22,25,20987.23,23850,44837.23
431440,201811,8961,6373,2588,6012947.01,2461102.78,8474049.79
431442,201811,28,15,13,14309.66,12402,26711.66
431445,201811,23,20,3,19080,2862,21942
431446,201811,7,6,1,5724,954,6678
431447,201811,85,61,24,58191.79,22895.2,81086.99
431449,201811,53,46,7,43881.45,6675.8,50557.25
431450,201811,414,283,131,269690.79,124250.15,393940.94
431454,201811,0,0,0,0,0,0
431455,201811,50,39,11,37206,10494,47700
431460,201811,519,359,160,340425.69,152348.94,492774.63
431470,201811,123,96,27,91580.36,25506.41,117086.77
431475,201811,11,10,1,9540,954,10494
431477,201811,36,24,12,22895.98,11447.04,34343.02
431478,201811,7,6,1,5723.93,954,6677.93
431480,201811,504,317,187,301580.31,178318.48,479898.79
431490,201811,28135,16089,12046,15275290.92,11456340.05,26731630.97
431500,201811,79,56,23,53183.34,21941.66,75125.00
431505,201811,36,21,15,20033.35,14310,34343.35
431507,201811,12,10,2,9540,1908,11448
431510,201811,270,184,86,174145.38,81060.19,255205.57
431513,201811,24,20,4,19080,3816,22896
431514,201811,8,7,1,6677.33,954,7631.33
431515,201811,81,67,14,63917.68,13355.5,77273.18
431517,201811,4,3,1,2861.52,954,3815.52
431520,201811,37,33,4,31481.21,3815.16,35296.37
431530,201811,1571,708,863,673531.81,822847.85,1496379.66
431531,201811,24,22,2,20986.44,1908,22894.44
431532,201811,26,18,8,17171.29,7631.16,24802.45
431535,201811,25,16,9,15264,8586,23850
431540,201811,144,128,16,121469.57,15263.7,136733.27
431545,201811,16,14,2,13356,1908,15264
431550,201811,359,202,157,192414.95,149671.45,342086.40
431555,201811,13,12,1,11448,954,12402
431560,201811,4504,3185,1319,3009452.95,1255986.92,4265439.87
431570,201811,810,437,373,412770.78,353910.36,766681.14
431575,201811,35,24,11,22896,10494,33390
431580,201811,96,69,27,64869.45,25758,90627.45
431590,201811,143,120,23,113519.47,21941.03,135460.50
431595,201811,11,10,1,9540,954,10494
431600,201811,217,121,96,115411.62,91581.55,206993.17
431610,201811,126,93,33,87480.66,31481.2,118961.86
431620,201811,43,35,8,33389.26,7632,41021.26
431630,201811,140,118,22,112566.31,20986.18,133552.49
431640,201811,1355,853,502,807135.75,476567.09,1283702.84
431642,201811,39,36,3,33867,2862,36729
431643,201811,46,20,26,19080,24804,43884
431645,201811,301,175,126,166941.57,119915.41,286856.98
431647,201811,9,9,0,8586,0,8586
431650,201811,36,26,10,24802,9540,34342
431660,201811,302,190,112,180297.96,106839.54,287137.50
431670,201811,230,110,120,102308.38,114441.39,216749.77
431673,201811,5,4,1,3816,953.42,4769.42
431675,201811,31,26,5,24517.8,4769.04,29286.84
431680,201811,1130,822,308,780346.46,292207.08,1072553.54
431690,201811,4796,2930,1866,2770421.59,1774874.63,4545296.22
431695,201811,23,18,5,17172,4770,21942
431697,201811,0,0,0,0,0,0
431700,201811,175,135,40,128784.68,38157.16,166941.84
431710,201811,4036,1759,2277,1673544.65,2171632.33,3845176.98
431720,201811,1375,835,540,787839.97,514172.36,1302012.33
431725,201811,1,1,0,954,0,954
431730,201811,1206,822,384,776197.28,366330.81,1142528.09
431740,201811,1363,678,685,642267.12,652292.65,1294559.77
431750,201811,1868,1217,651,1151645.17,619093.41,1770738.58
431755,201811,6,5,1,4770,954,5724
431760,201811,1041,677,364,645471.04,347016.53,992487.57
431770,201811,395,292,103,276923.33,97753.15,374676.48
431775,201811,30,22,8,20988,7630.76,28618.76
431780,201811,566,356,210,338779.71,200322.45,539102.16
431790,201811,165,126,39,119241.75,37157.49,156399.24
431795,201811,13,12,1,11448,954,12402
431800,201811,3370,1778,1592,1681467.28,1513035.02,3194502.30
431805,201811,20,17,3,16216.58,2862,19078.58
431810,201811,610,408,202,386616.5,192554.55,579171.05
431820,201811,323,184,139,175529.17,132602.96,308132.13
431830,201811,2338,1418,920,1349126.85,876374.42,2225501.27
431840,201811,507,338,169,319080.55,160926.45,480007.00
431842,201811,34,28,6,26711.23,5724,32435.23
431843,201811,12,9,3,8586,2862,11448
431844,201811,16,14,2,13354.49,1908,15262.49
431845,201811,30,27,3,25758,2861.93,28619.93
431846,201811,27,22,5,20988,4770,25758
431848,201811,15,13,2,12400.58,1907.54,14308.12
431849,201811,9,7,2,6678,1908,8586
431850,201811,817,673,144,639388.15,137130.1,776518.25
431860,201811,109,78,31,74405.16,28616.74,103021.90
431861,201811,3,2,1,1908,954,2862
431862,201811,51,32,19,30528,18124.47,48652.47
431870,201811,3430,2039,1391,1936634.97,1323465.7,3260100.67
431880,201811,952,701,251,662979.92,238487.59,901467.51
431890,201811,1312,819,493,774726.16,468093.81,1242819.97
431900,201811,178,126,52,120200.2,48812.11,169012.31
431910,201811,55,41,14,39111.06,13355.01,52466.07
431912,201811,39,22,17,20966.27,16026.36,36992.63
431915,201811,130,104,26,99209.93,24801.32,124011.25
431920,201811,152,112,40,106558.02,38158.1,144716.12
431930,201811,82,67,15,63200.92,14310,77510.92
431935,201811,3,3,0,2862,0,2862
431936,201811,15,14,1,13356,954,14310
431937,201811,16,11,5,10494,4770,15264
431940,201811,470,316,154,297444.23,145939.18,443383.41
431950,201811,491,313,178,296591.2,169648.69,466239.89
431960,201811,736,421,315,397701.12,300316.25,698017.37
431970,201811,72,64,8,61056,7632,68688
431971,201811,3,3,0,2862,0,2862
431973,201811,24,19,5,18125.46,4770,22895.46
431975,201811,8,7,1,6677.92,954,7631.92
431980,201811,205,129,76,121963.41,72500.02,194463.43
431990,201811,1222,658,564,626232.6,537978.05,1164210.65
432000,201811,1665,912,753,861983.65,715960.79,1577944.44
432010,201811,282,187,95,177091.95,90626.96,267718.91
432020,201811,174,143,31,136418.12,29573.53,165991.65
432023,201811,17,14,3,13356,2862,16218
432026,201811,67,61,6,58192.64,5724,63916.64
432030,201811,67,31,36,29573.38,34343.08,63916.46
432032,201811,19,16,3,15264,2862,18126
432035,201811,53,42,11,40065.75,10494,50559.75
432040,201811,105,73,32,69637.84,30527.8,100165.64
432045,201811,8,7,1,6678,954,7632
432050,201811,75,44,31,41975.04,29571.29,71546.33
432055,201811,111,83,28,79176.24,26709.94,105886.18
432057,201811,1,0,1,0,954,954
432060,201811,35,32,3,30528,2862,33390
432065,201811,30,26,4,24804,3815.2,28619.2
432067,201811,87,78,9,74391.03,8585.83,82976.86
432070,201811,405,307,98,290406.05,93449.51,383855.56
432080,201811,818,569,249,541109.06,237464.62,778573.68
432085,201811,16,12,4,11448,3816,15264
432090,201811,264,165,99,157405.52,94438.94,251844.46
432100,201811,171,113,58,107511.52,55329.13,162840.65
432110,201811,608,419,189,389257.91,179302.29,568560.20
432120,201811,940,572,368,545650.22,350951.06,896601.28
432130,201811,511,376,135,357358.54,127691.07,485049.61
432132,201811,24,21,3,20034,2862,22896
432135,201811,79,65,14,62008.18,13355.31,75363.49
432140,201811,267,213,54,202898.75,51513.93,254412.68
432143,201811,195,123,72,117338.06,68683.92,186021.98
432145,201811,275,191,84,180956.42,79846.39,260802.81
432146,201811,14,13,1,12402,954,13356
432147,201811,130,62,68,59147.66,64847.88,123995.54
432149,201811,15,12,3,11447.1,2862,14309.1
432150,201811,839,516,323,491997.88,306367.73,798365.61
432160,201811,1402,733,669,696858.56,637246.46,1334105.02
432162,201811,4,3,1,2862,954,3816
432163,201811,18,14,4,13356,3815.66,17171.66
432166,201811,118,88,30,84417.1,28619.16,113036.26
432170,201811,229,124,105,117616.2,100164.44,217780.64
432180,201811,545,340,205,320325.84,195269.19,515595.03
432183,201811,8,7,1,6678,954,7632
432185,201811,81,71,10,67732.86,9539.29,77272.15
432190,201811,462,264,198,251454.69,188742.93,440197.62
432195,201811,86,74,12,69878.38,11447.57,81325.95
432200,201811,409,264,145,251841.74,138273.09,390114.83
432210,201811,121,77,44,71691.16,41974.69,113665.85
432215,201811,56,52,4,49608,3815.66,53423.66
432218,201811,20,19,1,18124.87,954,19078.87
432220,201811,687,354,333,336667.81,317155.05,653822.86
432225,201811,13,7,6,6678,5723.6,12401.6
432230,201811,146,93,53,88479.06,50562,139041.06
432232,201811,13,12,1,11448,954,12402
432234,201811,4,3,1,2862,954,3816
432235,201811,2,2,0,1908,0,1908
432237,201811,29,17,12,16218,11448,27666
432240,201811,4341,2447,1894,2322461.83,1800393.99,4122855.82
432250,201811,1067,682,385,647184.21,367109.84,1014294.05
432252,201811,45,39,6,36727.91,5724,42451.91
432253,201811,60,48,12,45790.69,11448,57238.69
432254,201811,25,12,13,11446.15,12402,23848.15
432255,201811,14,13,1,12402,954,13356
432260,201811,883,701,182,666991.43,172657.45,839648.88
432270,201811,238,172,66,164084.25,62951.38,227035.63
432280,201811,127,95,32,90135.7,30527.9,120663.6
432285,201811,1,1,0,954,0,954
432290,201811,69,62,7,57239.89,6678,63917.89
432300,201811,4572,2630,1942,2490043.32,1848511.06,4338554.38
432310,201811,117,97,20,92389.84,19079.13,111468.97
432320,201811,19,17,2,16216.06,1908,18124.06
432330,201811,17,13,4,12400.22,3816,16216.22
432335,201811,7,6,1,5724,954,6678
432340,201811,40,36,4,34342.58,3815.4,38157.98
432345,201811,97,68,29,64870.23,27663.87,92534.10
432350,201811,21,20,1,19080,954,20034
432360,201811,6,4,2,3816,1908,5724
432370,201811,25,25,0,23850,0,23850
432375,201811,35,32,3,30528,2862,33390
432377,201811,8,8,0,7632,0,7632
432380,201811,167,75,92,70878.23,87710.67,158588.90
500020,201811,247,141,106,134510.36,100520.64,235031.00
500025,201811,118,59,59,55331.5,56284.31,111615.81
500060,201811,1475,915,560,872322.83,532648.96,1404971.79
500070,201811,788,373,415,355474.11,395900.97,751375.08
500080,201811,135,106,29,101123.73,27666,128789.73
500085,201811,137,110,27,104365.2,24922.65,129287.85
500090,201811,328,160,168,152633.72,160267.13,312900.85
500100,201811,743,393,350,372052.2,333306.18,705358.38
500110,201811,2256,1032,1224,984113.18,1165446.18,2149559.36
500124,201811,267,155,112,147869,106560.8,254429.8
500150,201811,328,136,192,129727.63,182764.91,312492.54
500190,201811,535,372,163,354217.71,155010.6,509228.31
500200,201811,194,166,28,158012.16,26711.14,184723.30
500210,201811,1452,524,928,499662.27,883945.17,1383607.44
500215,201811,245,141,104,133553.88,99214.47,232768.35
500220,201811,785,509,276,484044.02,263288.42,747332.44
500230,201811,260,176,84,167184.83,79657.5,246842.33
500240,201811,699,485,214,461325.92,203867.84,665193.76
500260,201811,595,225,370,214637.95,352967.72,567605.67
500270,201811,28985,12411,16574,11807354.54,15792306.29,27599660.83
500280,201811,192,71,121,67733.45,115432.08,183165.53
500290,201811,1198,713,485,679205.02,462669.34,1141874.36
500295,201811,418,260,158,247742.64,150717.73,398460.37
500310,201811,62,19,43,18126,41021.19,59147.19
500315,201811,738,441,297,420691.84,283316.74,704008.58
500320,201811,3668,1855,1813,1766249.21,1728144.02,3494393.23
500325,201811,919,507,412,483196.5,391793.07,874989.57
500330,201811,1494,693,801,658676.31,763804.83,1422481.14
500345,201811,324,246,78,233710.44,74412,308122.44
500348,201811,244,146,98,139278.45,93464.17,232742.62
500350,201811,131,65,66,62010,62963.54,124973.54
500370,201811,5446,2447,2999,2327617.27,2858698.66,5186315.93
500375,201811,351,259,92,247066.97,87765.13,334832.10
500380,201811,603,345,258,329123.38,246116.56,575239.94
500390,201811,71,35,36,33390,34343.12,67733.12
500400,201811,215,148,67,141170.41,63902.42,205072.83
500410,201811,561,224,337,213595.93,321320.22,534916.15
500430,201811,537,376,161,358699.27,153591.13,512290.40
500440,201811,205,104,101,98543.26,96350.6,194893.86
500450,201811,406,175,231,166240.7,220362.12,386602.82
500460,201811,302,154,148,146906.46,140893.91,287800.37
500470,201811,449,353,96,335587.72,90614.62,426202.34
500480,201811,111,65,46,62009.19,43883.43,105892.62
500490,201811,108,45,63,42923.35,60100.91,103024.26
500500,201811,1452,527,925,500723.81,881624.43,1382348.24
500510,201811,48,37,11,35297.57,10478,45775.57
500515,201811,108,75,33,71549.72,31480,103029.72
500520,201811,352,195,157,184974.13,149471.72,334445.85
500525,201811,86,49,37,46745.89,35011.09,81756.98
500540,201811,912,386,526,368167.68,500779.59,868947.27
500560,201811,911,522,389,496232.3,370783.54,867015.84
500568,201811,987,584,403,554541.53,384164.69,938706.22
500570,201811,1209,687,522,651774.73,494457.72,1146232.45
500580,201811,339,172,167,163791.26,159259.3,323050.56
500600,201811,312,163,149,154789.96,142112.78,296902.74
500620,201811,932,661,271,626469.83,258341.55,884811.38
500625,201811,79,67,12,63249.56,11448,74697.56
500627,201811,24,12,12,11447,11448,22895
500630,201811,1582,849,733,808578.08,698984.21,1507562.29
500635,201811,533,307,226,292450.04,215455.86,507905.90
500640,201811,429,227,202,213674.36,192681.51,406355.87
500660,201811,5499,2108,3391,2007560.44,3231957.68,5239518.12
500690,201811,584,205,379,195148.54,359722.39,554870.93
500710,201811,366,179,187,170473.16,178359.18,348832.34
500720,201811,968,574,394,545900.47,375848.5,921748.97
500730,201811,202,120,82,114475.28,78222.23,192697.51
500740,201811,848,373,475,354477.55,452548.91,807026.46
500750,201811,145,46,99,43880.47,94409.7,138290.17
500755,201811,127,91,36,86525.53,34344,120869.53
500769,201811,759,423,336,402891.72,320494.41,723386.13
500770,201811,426,224,202,213682.73,192693.84,406376.57
500780,201811,169,112,57,106556.2,54377,160933.2
500790,201811,1067,541,526,515581.41,501705.33,1017286.74
500793,201811,269,150,119,143097.45,113508.71,256606.16
500795,201811,177,129,48,123055.18,45776,168831.18
500797,201811,45,33,12,31481.56,11447.46,42929.02
500800,201811,416,185,231,176469.09,220369.3,396838.39
500830,201811,2258,1264,994,1203386.49,947225.39,2150611.88
500840,201811,144,107,37,102078,35283,137361
510010,201811,168,94,74,89661.66,70565.49,160227.15
510020,201811,482,228,254,217075.7,241572.44,458648.14
510025,201811,1683,970,713,924433.39,677572.83,1602006.22
510030,201811,673,348,325,331920.82,309254.37,641175.19
510035,201811,132,60,72,57197.02,68662.07,125859.09
510040,201811,388,175,213,166943.14,202719.29,369662.43
510050,201811,416,228,188,216709.29,178476.53,395185.82
510060,201811,112,58,54,55319.94,51504.04,106823.98
510080,201811,226,92,134,87719.11,127718.25,215437.36
510100,201811,76,35,41,33389.01,39094.92,72483.93
510120,201811,39,24,15,22895.43,14310,37205.43
510125,201811,402,248,154,235908.28,146851.6,382759.88
510130,201811,574,332,242,316262.72,230095.48,546358.20
510140,201811,407,133,274,126862.58,261381.51,388244.09
510160,201811,99,42,57,40066.79,54361.03,94427.82
510170,201811,858,524,334,499498.17,317892.39,817390.56
510180,201811,2889,1396,1493,1327956.94,1422544.81,2750501.75
510185,201811,11,6,5,5724,4769.22,10493.22
510190,201811,221,76,145,72501.58,138315.81,210817.39
510250,201811,2600,1544,1056,1471827.02,1006220.14,2478047.16
510260,201811,199,145,54,138036.84,51461.46,189498.30
510263,201811,454,252,202,239390.9,192671.15,432062.05
510267,201811,672,377,295,358032.54,281005.86,639038.40
510268,201811,59,30,29,28620,27664.42,56284.42
510269,201811,71,34,37,32420.11,35296.96,67717.07
510270,201811,402,203,199,193466.89,189376.68,382843.57
510279,201811,227,169,58,161173.19,55034.29,216207.48
510285,201811,180,73,107,69615.46,102075.78,171691.24
510300,201811,523,290,233,276205.29,222169,498374.29
510305,201811,206,96,110,91542.68,104857.44,196400.12
510310,201811,109,56,53,53422.88,50552.46,103975.34
510320,201811,859,538,321,512617.63,305989.5,818607.13
510325,201811,411,165,246,157396.57,234384.25,391780.82
510330,201811,435,247,188,235608.48,179330.82,414939.30
510335,201811,611,342,269,326180.85,256130.67,582311.52
510336,201811,49,35,14,33389.56,13355.89,46745.45
510337,201811,118,50,68,47689.15,64860.59,112549.74
510340,201811,17245,8223,9022,7821337.51,8594930.64,16416268.15
510343,201811,69,50,19,47689.52,18126,65815.52
510345,201811,163,111,52,105882.54,49290.38,155172.92
510350,201811,663,369,294,351046.73,280366.96,631413.69
510360,201811,199,123,76,117325.63,72382.58,189708.21
510370,201811,143,74,69,70565.29,65691.42,136256.71
510380,201811,90,63,27,60101.06,25743,85844.06
510385,201811,57,27,30,25758,28603,54361
510390,201811,118,50,68,47700,64833.84,112533.84
510395,201811,46,35,11,33388.4,10494,43882.4
510410,201811,703,471,232,449316.03,221295.73,670611.76
510420,201811,574,276,298,262283.92,282662.24,544946.16
510450,201811,53,30,23,28620,21941.48,50561.48
510452,201811,41,24,17,22896,16217.35,39113.35
510454,201811,55,26,29,24804,27656.46,52460.46
510455,201811,128,78,50,74391.47,47698.29,122089.76
510460,201811,183,98,85,93296.28,81042.37,174338.65
510480,201811,746,437,309,415713.15,294380.41,710093.56
510490,201811,348,180,168,171340.47,159804.11,331144.58
510500,201811,249,191,58,182199.56,55329.55,237529.11
510510,201811,799,460,339,438220.1,323365.2,761585.3
510515,201811,1154,612,542,583466.84,516995.17,1100462.01
510517,201811,253,106,147,100836.8,140207.5,241044.3
510520,201811,237,158,79,150591.33,75239.75,225831.08
510523,201811,95,69,26,65821.98,24794.46,90616.44
510525,201811,754,434,320,413219.44,305136.76,718356.20
510530,201811,17,13,4,12400.89,3816,16216.89
510550,201811,265,117,148,111602,141185.98,252787.98
510558,201811,281,139,142,132565.47,135439.39,268004.86
510560,201811,408,241,167,229621.88,159285.94,388907.82
510562,201811,648,460,188,437503.34,178863.19,616366.53
510590,201811,803,417,386,397750.56,368195.87,765946.43
510600,201811,260,144,116,137352.68,110610.82,247963.50
510610,201811,170,82,88,78206.92,83651.79,161858.71
510615,201811,195,80,115,76299.52,109703.86,186003.38
510617,201811,19,11,8,10492.12,7631.33,18123.45
510618,201811,119,56,63,53423.03,59623.65,113046.68
510619,201811,102,71,31,67717.75,29558,97275.75
510620,201811,179,98,81,93481.79,77274,170755.79
510621,201811,196,124,72,118267.17,68644.23,186911.40
510622,201811,465,296,169,282248.81,161184.91,443433.72
510623,201811,347,236,111,225081.07,105862.71,330943.78
510624,201811,94,46,48,43864.66,45790.86,89655.52
510625,201811,541,330,211,314528.58,200616.52,515145.10
510626,201811,113,71,42,67732.03,40067.61,107799.64
510627,201811,60,43,17,41020.93,16218,57238.93
510628,201811,157,94,63,89622.39,60042.85,149665.24
510629,201811,256,166,90,158361.12,84882.65,243243.77
510630,201811,458,237,221,226007.4,210175.58,436182.98
510631,201811,10,3,7,2862,6389.9,9251.9
510637,201811,351,202,149,192341.72,141937.87,334279.59
510642,201811,970,543,427,517651.05,407202.65,924853.70
510645,201811,0,0,0,0,0,0
510650,201811,1468,977,491,931136.77,468248.98,1399385.75
510665,201811,79,41,38,39041.45,36250.8,75292.25
510670,201811,66,38,28,36251.56,26712,62963.56
510675,201811,1167,719,448,684625.73,427355.89,1111981.62
510677,201811,356,182,174,172586.92,165824.79,338411.71
510680,201811,104,61,43,58163,41006.6,99169.6
510682,201811,203,102,101,96971.38,96352.83,193324.21
510685,201811,52,39,13,37204.72,12401.76,49606.48
510700,201811,613,359,254,342292.13,242101.61,584393.74
510704,201811,1097,597,500,566344.11,474715.99,1041060.10
510706,201811,126,65,61,62003.18,58143.04,120146.22
510710,201811,397,270,127,256576.58,121040.17,377616.75
510715,201811,63,47,16,44828.46,15263.28,60091.74
510718,201811,208,116,92,110538.92,87757.91,198296.83
510719,201811,36,18,18,17171.73,17171.74,34343.47
510720,201811,198,133,65,126861.52,61722.33,188583.85
510724,201811,90,35,55,33380.22,52427.56,85807.78
510726,201811,55,28,27,26701.94,25725.87,52427.81
510729,201811,71,31,40,29574,38120.84,67694.84
510730,201811,478,272,206,259449.92,196359.43,455809.35
510735,201811,108,43,65,41020.95,62003.99,103024.94
510740,201811,29,16,13,15264,12402,27666
510757,201811,18,14,4,13356,3816,17172
510760,201811,7074,3742,3332,3558920.43,3172255.78,6731176.21
510770,201811,710,334,376,317275.85,358473.16,675749.01
510774,201811,16,6,10,5724,9537.66,15261.66
510775,201811,117,88,29,83938.49,27656.31,111594.80
510776,201811,28,7,21,6678,20033.6,26711.6
510777,201811,186,83,103,79149.73,98230.37,177380.10
510779,201811,48,22,26,20973,24754.92,45727.92
510780,201811,291,163,128,155388.43,122023.59,277412.02
510785,201811,430,231,199,220318.83,189774.42,410093.25
510787,201811,196,95,101,90613.62,96316.03,186929.65
510788,201811,0,0,0,0,0,0
510790,201811,2395,1265,1130,1204584.12,1075425.14,2280009.26
510792,201811,1107,634,473,604206.32,450712.07,1054918.39
510794,201811,118,59,59,56283.48,56248.28,112531.76
510795,201811,2390,1396,994,1324928.59,945512.59,2270441.18
510800,201811,186,117,69,110350.11,65809.19,176159.30
510805,201811,174,118,56,112569.75,53417.36,165987.11
510810,201811,99,41,58,38977.28,55202.77,94180.05
510820,201811,258,123,135,116881.39,127766.44,244647.83
510830,201811,67,41,26,39113.57,24788.11,63901.68
510835,201811,10,8,2,7632,1908,9540
510840,201811,9224,4550,4674,4325679.52,4450756.24,8776435.76
510850,201811,210,85,125,81077.27,119199.26,200276.53
510860,201811,390,173,217,164815.03,206294.63,371109.66
510880,201811,64,49,15,46719.46,14308.09,61027.55
510885,201811,72,44,28,41950.66,26681.22,68631.88
510890,201811,73,43,30,41021.33,28620,69641.33
510895,201811,182,107,75,102074.5,71220.53,173295.03
520005,201811,41,29,12,27661.58,11447.14,39108.72
520010,201811,276,125,151,119244.77,143949.36,263194.13
520013,201811,673,417,256,397756.72,243928.74,641685.46
520015,201811,52,38,14,36252,13355.56,49607.56
520017,201811,96,55,41,52181,39111.95,91292.95
520020,201811,23,13,10,12402,9540,21942
520025,201811,2018,1100,918,1048472.66,874902.7,1923375.36
520030,201811,813,424,389,403520.19,370477.74,773997.93
520050,201811,76,51,25,48653.36,23850,72503.36
520055,201811,46,30,16,28619.82,15262.81,43882.63
520060,201811,191,127,64,121157.73,61054.5,182212.23
520080,201811,590,420,170,400660.77,162178.89,562839.66
520082,201811,19,14,5,13356,4770,18126
520085,201811,101,75,26,71547.52,24800.6,96348.12
520090,201811,92,62,30,59144.02,28617.8,87761.82
520110,201811,9186,4007,5179,3817621,4937635.13,8755256.13
520120,201811,14,8,6,7431.66,5723.39,13155.05
520130,201811,775,543,232,517701.27,220876.04,738577.31
520140,201811,11855,6702,5153,6386730.44,4912446.34,11299176.78
520145,201811,46,34,12,32434.34,11447.28,43881.62
520150,201811,189,146,43,139280.28,41020.15,180300.43
520160,201811,32,24,8,22895.32,7632,30527.32
520170,201811,242,150,92,143049.95,87717,230766.95
520180,201811,140,74,66,70589.13,62957.98,133547.11
520215,201811,216,139,77,132314.18,73168.73,205482.91
520235,201811,70,52,18,49607.83,17172,66779.83
520250,201811,129,78,51,74411.71,48366.21,122777.92
520260,201811,113,70,43,66779.12,40067.96,106847.08
520280,201811,46,32,14,29852,13355.2,43207.2
520310,201811,38,26,12,24804,11447.07,36251.07
520320,201811,163,104,59,99202.01,56283.21,155485.22
520330,201811,797,421,376,401560.92,358684.1,760245.02
520340,201811,350,199,151,189841.42,144026.07,333867.49
520350,201811,530,246,284,234678.21,270861.47,505539.68
520355,201811,89,53,36,50560.49,34344,84904.49
520357,201811,25,18,7,17171.59,6678,23849.59
520360,201811,1,1,0,954,0,954
520380,201811,143,74,69,70594.11,65822.12,136416.23
520390,201811,273,118,155,112092.04,147859.56,259951.60
520393,201811,15,11,4,10492.7,3816,14308.7
520396,201811,97,60,37,57235.8,35298,92533.8
520400,201811,217,126,91,118570.98,86813.2,205384.18
520410,201811,195,100,95,95383.35,90615,185998.35
520420,201811,23,16,7,15264,6678,21942
520425,201811,315,142,173,135460.32,164738.68,300199.00
520430,201811,464,241,223,229708.08,212663.06,442371.14
520440,201811,613,416,197,396845.83,187911.4,584757.23
520450,201811,1929,868,1061,827208.93,1011501.39,1838710.32
520455,201811,58,41,17,39112.83,16218,55330.83
520460,201811,32,16,16,15261.69,15264,30525.69
520465,201811,26,22,4,20986.89,3816,24802.89
520470,201811,419,259,160,246775.32,152633.61,399408.93
520480,201811,80,47,33,44837.56,31403.56,76241.12
520485,201811,123,44,79,41975.9,75077.79,117053.69
520490,201811,427,311,116,296498.37,110658.12,407156.49
520495,201811,173,105,68,100166.47,64870.36,165036.83
520500,201811,176,132,44,125926.78,41975.19,167901.97
520505,201811,174,91,83,86806.35,79179.27,165985.62
520510,201811,1761,874,887,831164.49,843503.8,1674668.29
520520,201811,36,29,7,27666,6678,34344
520530,201811,232,175,57,165221.89,54368.46,219590.35
520540,201811,533,363,170,344309.31,162174.95,506484.26
520545,201811,148,85,63,81088.33,60100.59,141188.92
520547,201811,51,30,21,28620,20034,48654
520549,201811,1158,566,592,539592.66,564599.97,1104192.63
520551,201811,299,157,142,149774.03,135174.01,284948.04
520552,201811,47,28,19,26710.6,18125.19,44835.79
520570,201811,16,9,7,8586,6678,15264
520580,201811,290,174,116,165979.43,110656.78,276636.21
520590,201811,158,96,62,91580.09,58860.84,150440.93
520620,201811,1161,546,615,519995.25,586393.95,1106389.20
520630,201811,41,25,16,23849.02,15262.24,39111.26
520640,201811,405,233,172,222275.04,164067.63,386342.67
520650,201811,61,40,21,38159.45,20032.19,58191.64
520660,201811,35,19,16,18113,15263.23,33376.23
520670,201811,35,30,5,28618.3,4769.4,33387.7
520680,201811,55,37,18,35298,17172,52470
520690,201811,32,10,22,9540,20950.9,30490.9
520710,201811,39,35,4,33387.2,3816,37203.2
520725,201811,192,125,67,119247.61,63916.69,183164.30
520735,201811,60,42,18,40066.37,17170.53,57236.90
520740,201811,408,201,207,191016.74,197451.43,388468.17
520750,201811,36,28,8,26712,7632,34344
520753,201811,57,39,18,37204.75,17170.72,54375.47
520760,201811,113,76,37,72503.1,35298,107801.1
520780,201811,292,219,73,208921.1,69618.64,278539.74
520790,201811,163,83,80,78888.65,76318.69,155207.34
520800,201811,3438,1842,1596,1754784.9,1522022.79,3276807.69
520810,201811,171,125,46,119240.75,43882.96,163123.71
520815,201811,5,5,0,4770,0,4770
520830,201811,149,105,44,100166.83,41689.4,141856.23
520840,201811,354,234,120,222750.55,114473.19,337223.74
520850,201811,111,72,39,68661.73,37052.11,105713.84
520860,201811,1695,1080,615,1028834.85,585525.72,1614360.57
520870,201811,31448,15406,16042,14670303.53,15287489.33,29957792.86
520880,201811,1098,598,500,569900.09,476961.66,1046861.75
520890,201811,797,469,328,445771.45,312795.56,758567.01
520910,201811,1021,544,477,514701.53,455049.47,969751.00
520915,201811,103,77,26,73457.33,24794.46,98251.79
520920,201811,407,198,209,188316.51,199369.54,387686.05
520929,201811,16,15,1,14309.1,954,15263.1
520940,201811,76,49,27,46744.88,25757.96,72502.84
520945,201811,20,12,8,11448,7632,19080
520960,201811,47,30,17,28619.6,16217.4,44837.0
520970,201811,325,203,122,192732.64,116095.36,308828.00
520980,201811,85,65,20,62007.96,19080,81087.96
520990,201811,477,322,155,307174.02,147859.85,455033.87
520993,201811,126,60,66,57239.4,62962.03,120201.43
520995,201811,244,136,108,128776.08,102451.3,231227.38
521000,201811,1587,930,657,886221.56,626375.58,1512597.14
521010,201811,666,311,355,296045.3,338585.57,634630.87
521015,201811,19,12,7,11447.46,6678,18125.46
521020,201811,1463,1025,438,977184.19,417454.72,1394638.91
521030,201811,48,34,14,32433.68,13355.79,45789.47
521040,201811,952,593,359,565152.24,342172.88,907325.12
521056,201811,41,29,12,27665.44,11448,39113.44
521060,201811,134,84,50,80134.55,47699.62,127834.17
521080,201811,465,351,114,334524.62,108752.79,443277.41
521090,201811,534,322,212,305647.98,202240.42,507888.40
521100,201811,277,207,70,197461.85,66778.73,264240.58
521120,201811,1058,742,316,707257.2,301150.99,1008408.19
521130,201811,365,262,103,249935.23,97355.6,347290.83
521140,201811,177,97,80,92536.57,76317.81,168854.38
521150,201811,2776,1215,1561,1157482.04,1487888.87,2645370.91
521160,201811,32,17,15,16218,14310,30528
521170,201811,196,114,82,108744.2,78224.92,186969.12
521180,201811,1149,728,421,692857.45,400902.13,1093759.58
521190,201811,2539,1077,1462,1027415.7,1394408.73,2421824.43
521200,201811,49,36,13,34341.69,12400.59,46742.28
521205,201811,12,9,3,8586,2862,11448
521210,201811,145,83,62,79180.73,59148,138328.73
521220,201811,827,571,256,542804.88,243590.7,786395.58
521225,201811,33,22,11,20987,10493.06,31480.06
521230,201811,111,74,37,70309.8,35297.37,105607.17
521250,201811,6226,3593,2633,3417410.05,2509492.6,5926902.65
521260,201811,23,15,8,14309.12,7630.55,21939.67
521270,201811,139,109,30,103982.79,28620,132602.79
521280,201811,437,260,177,246696.71,168855.82,415552.53
521290,201811,30,12,18,11448,17172,28620
521295,201811,97,65,32,62008.79,30527.87,92536.66
521300,201811,222,116,106,110632.12,100751.26,211383.38
521305,201811,34,23,11,21942,10494,32436
521308,201811,1096,813,283,774373.24,269661.51,1044034.75
521310,201811,1348,802,546,763008.41,519670.93,1282679.34
521340,201811,20,16,4,15264,3816,19080
521350,201811,133,99,34,94445.11,32436,126881.11
521370,201811,190,126,64,119916.42,60769.8,180686.22
521375,201811,182,101,81,96354,76987.8,173341.8
521377,201811,54,37,17,35297.33,16218,51515.33
521380,201811,1081,705,376,668373.1,358694.49,1027067.59
521385,201811,15,8,7,7632,6678,14310
521390,201811,104,84,20,79813.92,19080,98893.92
521400,201811,329,211,118,201001.99,112569.45,313571.44
521405,201811,150,80,70,76312.76,66776.84,143089.60
521410,201811,60,39,21,37204.97,20033.5,57238.47
521440,201811,201,147,54,139427.02,51513.94,190940.96
521450,201811,728,404,324,385404.59,309087.11,694491.70
521460,201811,1195,740,455,705927.52,434016.47,1139943.99
521470,201811,12,8,4,7631.98,3816,11447.98
521480,201811,46,31,15,29533.6,14224,43757.6
521483,201811,310,171,139,162600.6,132601.42,295202.02
521486,201811,289,185,104,175787.03,98535.15,274322.18
521487,201811,22,11,11,10493,10494,20987
521490,201811,26,15,11,14310,10494,24804
521500,201811,115,77,38,73453.99,36251.33,109705.32
521520,201811,41,29,12,27664.66,11448,39112.66
521523,201811,640,393,247,371582.48,235627.7,607210.18
521525,201811,46,30,16,28620,14977.79,43597.79
521530,201811,254,134,120,127830.98,114477.44,242308.42
521540,201811,30,16,14,15264,13356,28620
521550,201811,89,39,50,36870.79,47628.46,84499.25
521560,201811,803,552,251,526310.2,239299.63,765609.83
521565,201811,54,36,18,34341.49,17169.97,51511.46
521570,201811,497,333,164,317655.71,156347.65,474003.36
521580,201811,59,37,22,35296.34,20988,56284.34
521590,201811,38,21,17,20033.83,16216.77,36250.60
521600,201811,27,16,11,15262.37,10494,25756.37
521630,201811,245,129,116,123052.86,109648.22,232701.08
521640,201811,299,155,144,147865.65,136801.01,284666.66
521645,201811,28,15,13,14309.83,12402,26711.83
521680,201811,221,140,81,133551.5,77272.82,210824.32
521690,201811,2,2,0,1907.11,0,1907.11
521710,201811,1173,560,613,533715.16,584772.38,1118487.54
521720,201811,545,371,174,353894.51,165942.94,519837.45
521730,201811,638,305,333,290859.54,316557.82,607417.36
521740,201811,904,369,535,351975.93,509168.37,861144.30
521760,201811,1645,912,733,868408.64,698942.76,1567351.40
521770,201811,819,516,303,492244.56,288585.39,780829.95
521800,201811,2047,1284,763,1221264.3,726442.55,1947706.85
521805,201811,35,20,15,19078.5,14308.55,33387.05
521810,201811,90,58,32,55045.8,30528,85573.8
521830,201811,950,677,273,643911.51,260422.35,904333.86
521839,201811,87,57,30,54378,28618.68,82996.68
521850,201811,1112,590,522,561401.97,497544.24,1058946.21
521860,201811,357,223,134,212736.84,127543.54,340280.38
521870,201811,74,43,31,41020.83,29573.46,70594.29
521878,201811,40,19,21,18124.57,20032.92,38157.49
521880,201811,4643,2094,2549,1995334.72,2429557.4,4424892.12
521890,201811,583,412,171,393026,162841.78,555867.78
521900,201811,295,236,59,224506.01,56283.33,280789.34
521910,201811,153,107,46,102077.15,43884,145961.15
521920,201811,54,27,27,25757.23,25758,51515.23
521925,201811,35,21,14,20034,13354.49,33388.49
521930,201811,1123,642,481,612203.87,458150.57,1070354.44
521935,201811,35,27,8,25758,7632,33390
521940,201811,191,98,93,93491,88716.98,182207.98
521945,201811,15,13,2,12401.4,1908,14309.4
521950,201811,9,5,4,4770,3814.34,8584.34
521960,201811,76,57,19,54375.42,18125.86,72501.28
521970,201811,422,273,149,260143.75,142140.07,402283.82
521971,201811,95,48,47,45788.92,44837.36,90626.28
521973,201811,28,13,15,12402,14310,26712
521975,201811,1202,620,582,590981.19,554380.89,1145362.08
521980,201811,248,172,76,164084.19,72502.22,236586.41
521990,201811,73,54,19,51515.53,18124.89,69640.42
522000,201811,291,187,104,178393.52,99213.63,277607.15
522005,201811,19,11,8,10494,7632,18126
522010,201811,1154,652,502,621050.77,478275.07,1099325.84
522015,201811,57,36,21,34327.77,20032.42,54360.19
522020,201811,874,479,395,455987.13,376033.33,832020.46
522026,201811,28,20,8,19080,7632,26712
522028,201811,15,11,4,10494,3816,14310
522040,201811,755,299,456,285210.6,434932.98,720143.58
522045,201811,2254,1396,858,1331283.97,817683.2,2148967.17
522050,201811,164,80,84,76319.5,80135.6,156455.1
522060,201811,550,352,198,335516.35,188791.88,524308.23
522068,201811,130,88,42,83660.94,40067.29,123728.23
522070,201811,10,10,0,9540,0,9540
522100,201811,45,25,20,23849.94,19080,42929.94
522108,201811,40,31,9,29573.56,8586,38159.56
522119,201811,56,30,26,28618.15,24802.67,53420.82
522130,201811,75,28,47,26697.87,44803.42,71501.29
522140,201811,3828,1928,1900,1834728.2,1809934.52,3644662.72
522145,201811,53,34,19,32434.66,18126,50560.66
522150,201811,63,48,15,45792,14308.71,60100.71
522155,201811,55,37,18,35283,17169.42,52452.42
522157,201811,4,3,1,2862,954,3816
522160,201811,1733,1020,713,971773.99,680168.55,1651942.54
522170,201811,395,265,130,251873.07,124014.24,375887.31
522180,201811,38,20,18,19078.53,17170.65,36249.18
522185,201811,1978,779,1199,739825.41,1143276.02,1883101.43
522190,201811,45,26,19,24803,18030.13,42833.13
522200,201811,303,183,120,174577.76,114475.11,289052.87
522205,201811,159,109,50,103984.91,47698.89,151683.80
522220,201811,161,116,45,110663.33,42930,153593.33
522230,201811,32,27,5,25758,4770,30528
530010,201811,55473,28568,26905,27112061.47,25614417.48,52726478.95
110001,201812,522,415,107,395900.46,101432.96,497333.42
110002,201812,2799,1716,1083,1635531.76,1032304.6,2667836.36
110003,201812,92,77,15,73259,14310,87569
110004,201812,2011,1306,705,1243808.1,672283.8,1916091.9
110005,201812,438,357,81,339422.9,77274,416696.9
110006,201812,455,351,104,334099.95,99196.92,433296.87
110007,201812,80,65,15,62010,14310,76320
110008,201812,235,134,101,126882,96354,223236
110009,201812,821,578,243,549504.86,231623,781127.86
110010,201812,1813,1119,694,1066728.12,661772.21,1728500.33
110011,201812,1876,1459,417,1389741.2,397808.46,1787549.66
110012,201812,4184,2441,1743,2322686.42,1661731.12,3984417.54
110013,201812,773,595,178,567620.46,169145,736765.46
110014,201812,375,323,52,307092.8,49608,356700.8
110015,201812,1436,1161,275,1104575.13,262330.92,1366906.05
110018,201812,1130,687,443,655084,422609.23,1077693.23
110020,201812,15638,9169,6469,8703683.96,6164775.44,14868459.40
110025,201812,659,486,173,460701.11,165033,625734.11
110026,201812,41,28,13,26712,12402,39114
110028,201812,1644,1190,454,1132280.31,430094.95,1562375.26
110029,201812,140,126,14,120204,13356,133560
110030,201812,2464,1669,795,1589603.74,757529.46,2347133.20
110032,201812,400,315,85,300201,81086,381287
110033,201812,678,502,176,476666.5,167617.8,644284.3
110034,201812,371,274,97,259084,91871,350955
110037,201812,105,88,17,83952,16218,100170
110040,201812,354,242,112,230868,106848,337716
110045,201812,964,655,309,623345,293082.39,916427.39
110050,201812,92,79,13,75080,12402,87482
110060,201812,85,48,37,45792,35298,81090
110070,201812,116,71,45,67734,42644,110378
110080,201812,412,249,163,235036.98,155478.15,390515.13
110090,201812,34,28,6,26712,5724,32436
110092,201812,103,56,47,53424,44768,98192
110094,201812,196,142,54,135468,51516,186984
110100,201812,31,26,5,24804,4770,29574
110110,201812,66,40,26,38160,24804,62964
110120,201812,72,59,13,56286,12402,68688
110130,201812,303,247,56,234163.12,53424,287587.12
110140,201812,246,161,85,153403.2,81080.46,234483.66
110143,201812,51,42,9,40068,8586,48654
110145,201812,24,18,6,17172,5724,22896
110146,201812,24,12,12,11448,11448,22896
110147,201812,39,30,9,28620,8586,37206
110148,201812,40,28,12,26660.57,11448,38108.57
110149,201812,318,227,91,216271.8,86814,303085.8
110150,201812,91,64,27,61056,25758,86814
110155,201812,8,7,1,6678,954,7632
110160,201812,69,58,11,55332,10494,65826
110170,201812,203,162,41,154548,38827.8,193375.8
110175,201812,49,36,13,34344,12402,46746
110180,201812,95,82,13,78228,12402,90630
120001,201812,142,98,44,93492,41968,135460
120005,201812,192,121,71,115434,67734,183168
120010,201812,1043,672,371,637599.03,353863.12,991462.15
120013,201812,147,100,47,95390.46,44647.2,140037.66
120017,201812,93,55,38,52470,36252,88722
120020,201812,3635,2915,720,2756088.18,684490.23,3440578.41
120025,201812,578,329,249,311846.1,236675.48,548521.58
120030,201812,1057,893,164,843999.22,155741,999740.22
120032,201812,48,41,7,39114,6678,45792
120033,201812,221,193,28,183774.75,26712,210486.75
120034,201812,159,115,44,107802,41976,149778
120035,201812,37,28,9,26712,8586,35298
120038,201812,394,254,140,241596.88,133560,375156.88
120039,201812,22,21,1,20034,954,20988
120040,201812,14210,9841,4369,9330889.12,4160121.82,13491010.94
120042,201812,49,43,6,41022,5724,46746
120043,201812,11,3,8,2862,7632,10494
120045,201812,549,354,195,335189.68,185067.58,520257.26
120050,201812,1278,980,298,928960.37,284287.23,1213247.60
120060,201812,1440,1175,265,1117134,251856,1368990
120070,201812,501,359,142,339158.12,135458.46,474616.58
120080,201812,169,104,65,98729.46,61771.5,160500.96
130002,201812,147,104,43,99216,41022,140238
130006,201812,76,44,32,41976,30528,72504
130008,201812,145,77,68,72759.6,64193.72,136953.32
130010,201812,144,80,64,76298.12,61056,137354.12
130014,201812,252,183,69,174582,65826,240408
130020,201812,96,54,42,51516,40068,91584
130030,201812,916,549,367,523746,350108.46,873854.46
130040,201812,315,159,156,151686,147870.28,299556.28
130050,201812,580,315,265,300223.8,252810,553033.8
130060,201812,888,607,281,577794.04,268030.24,845824.28
130063,201812,575,322,253,307188,241296.36,548484.36
130068,201812,189,123,66,117342,62677.8,180019.8
130070,201812,1325,910,415,867274.44,395910,1263184.44
130080,201812,682,450,232,428918.4,221319,650237.4
130083,201812,72,40,32,37896,30528,68424
130090,201812,369,189,180,178626.96,171720,350346.96
130100,201812,1129,510,619,486540,590239.8,1076779.8
130110,201812,706,307,399,292878,380646,673524
130115,201812,176,72,104,68688,99216,167904
130120,201812,1640,1037,603,989298,575262,1564560
130130,201812,612,425,187,405450,178398,583848
130140,201812,1542,1165,377,1110789.9,358704.2,1469494.1
130150,201812,421,361,60,344394,57240,401634
130160,201812,466,266,200,253764,190800,444564
130165,201812,29,21,8,20034,7632,27666
130170,201812,972,700,272,667729.4,259488,927217.4
130180,201812,148,89,59,84906,56286,141192
130185,201812,2406,1195,1211,1138676,1154702.92,2293378.92
130190,201812,3578,2254,1324,2144631.77,1262079.99,3406711.76
130195,201812,288,231,57,220374,54378,274752
130200,201812,171,81,90,77264.46,85860,163124.46
130210,201812,78,40,38,38160,36252,74412
130220,201812,179,125,54,119250,51516,170766
130230,201812,329,207,122,197478,116388,313866
130240,201812,1425,905,520,862030.4,495789.03,1357819.43
130250,201812,4836,3131,1705,2981101.76,1626436.57,4607538.33
130255,201812,433,210,223,200340,212722.72,413062.72
130260,201812,54901,26572,28329,25312780.05,27018748.25,52331528.30
130270,201812,1601,1062,539,1011687.86,514206,1525893.86
130280,201812,120,73,47,69642,44838,114480
130290,201812,2121,1534,587,1463436,559711.8,2023147.8
130300,201812,432,311,121,296694,115434,412128
130310,201812,889,466,423,444564,403542,848106
130320,201812,459,246,213,233730,203202,436932
130330,201812,735,450,285,429300,271603.8,700903.8
130340,201812,3405,2018,1387,1920879.4,1321481,3242360.4
130350,201812,461,296,165,282384,157410,439794
130353,201812,838,353,485,336476,462690,799166
130356,201812,820,376,444,358704,423576,782280
130360,201812,66,42,24,40068,22896,62964
130370,201812,680,513,167,489402,159318,648720
130380,201812,606,422,184,402559.38,175536,578095.38
130390,201812,493,392,101,373968,96354,470322
130395,201812,177,39,138,37206,131652,168858
130400,201812,69,45,24,42930,22896,65826
130406,201812,2087,1299,788,1234602.5,750586.4,1985188.9
130410,201812,475,205,270,195570,257560.92,453130.92
130420,201812,3186,2582,604,2460394.82,576216,3036610.82
130423,201812,159,77,82,73458,78228,151686
130426,201812,154,88,66,83952,62964,146916
130430,201812,408,271,137,258534,130698,389232
130440,201812,202,68,134,64872,127836,192708
140002,201812,35,12,23,11448,21942,33390
140005,201812,204,126,78,119965.5,74412,194377.5
140010,201812,10599,7078,3521,6718578.5,3357032.6,10075611.1
140015,201812,149,67,82,63918,78228,142146
140017,201812,122,84,38,80136,36252,116388
140020,201812,475,320,155,304326,147870,452196
140023,201812,38,19,19,17907,18126,36033
140028,201812,19,12,7,11448,6678,18126
140030,201812,350,249,101,237546,95752.98,333298.98
140040,201812,57,39,18,37206,17076.6,54282.6
140045,201812,249,110,139,104940,132606,237546
140047,201812,632,436,196,413932.39,186507,600439.39
140050,201812,149,96,53,90771,50562,141333
140060,201812,41,30,11,27885.42,10494,38379.42
140070,201812,34,31,3,28820.05,2862,31682.05
150010,201812,4742,2972,1770,2833380.4,1686673,4520053.4
150013,201812,156,109,47,103699.8,44838,148537.8
150020,201812,1066,582,484,555228,461736,1016964
150030,201812,716,296,420,282384,400680,683064
150034,201812,196,128,68,122112,64872,186984
150040,201812,1417,853,564,813762,538056,1351818
150050,201812,659,385,274,366288.8,261196,627484.8
150060,201812,4788,3098,1690,2952306.37,1612012.5,4564318.87
150070,201812,318,145,173,138330,165042,303372
150080,201812,14339,7218,7121,6873503.13,6785425.34,13658928.47
150085,201812,401,254,147,242306.46,140238,382544.46
150090,201812,753,642,111,612468,105894,718362
150095,201812,348,216,132,206064,125107.56,331171.56
150100,201812,58,40,18,38160,17172,55332
150110,201812,168,84,84,80136,80136,160272
150120,201812,428,317,111,302418,105894,408312
150125,201812,55,23,32,21942,30528,52470
150130,201812,1943,1050,893,1000946.34,851917.23,1852863.57
150140,201812,54486,25591,28895,24378135.09,27550749.54,51928884.63
150145,201812,188,105,83,100170,79182,179352
150150,201812,2826,1300,1526,1240200,1453133.2,2693333.2
150157,201812,426,299,127,285246,121153.23,406399.23
150160,201812,123,96,27,91584,25758,117342
150170,201812,3682,2743,939,2615629.5,895519.8,3511149.3
150172,201812,330,226,104,215604,99216,314820
150175,201812,82,49,33,46746,31482,78228
150178,201812,784,521,263,495793.8,250902,746695.8
150180,201812,3111,1518,1593,1447361.6,1519378.76,2966740.36
150190,201812,333,215,118,205110,112572,317682
150195,201812,122,62,60,59148,57240,116388
150200,201812,200,96,104,91584,99216,190800
150210,201812,3156,2563,593,2444425.46,564716.5,3009141.96
150215,201812,532,344,188,328176,179066,507242
150220,201812,3828,2603,1225,2481702.8,1165003.87,3646706.67
150230,201812,1150,932,218,888548.04,207972,1096520.04
150240,201812,5885,3466,2419,3303408.73,2307717,5611125.73
150250,201812,33,16,17,15264,16218,31482
150260,201812,79,48,31,45792,29574,75366
150270,201812,2364,1534,830,1462973.9,790933.18,2253907.08
150275,201812,561,350,211,333900,201294,535194
150276,201812,110,49,61,46746,58194,104940
150277,201812,767,330,437,314801.46,416898,731699.46
150280,201812,336,212,124,202248,118296,320544
150285,201812,84,42,42,40068,40068,80136
150290,201812,966,590,376,562767.74,358418,921185.74
150293,201812,661,314,347,299546.46,331038,630584.46
150295,201812,473,215,258,205110,245998.44,451108.44
150300,201812,77,40,37,38160,35298,73458
150304,201812,160,107,53,102078,50562,152640
150307,201812,389,322,67,307188,63918,371106
150309,201812,575,421,154,401605.92,145650,547255.92
150310,201812,253,171,82,163134,78228,241362
150320,201812,1769,1229,540,1172184.57,514921.5,1687106.07
150330,201812,2082,1202,880,1146040.2,839520,1985560.2
150340,201812,199,135,64,128551.5,61056,189607.5
150345,201812,619,338,281,322270.74,268074,590344.74
150350,201812,411,324,87,306701.46,82998,389699.46
150360,201812,4597,2957,1640,2817387.46,1564550.46,4381937.92
150370,201812,782,551,231,524930,220365,745295
150375,201812,195,103,92,98262,87768,186030
150380,201812,1394,943,451,899622,429968,1329590
150390,201812,744,429,315,409262,300510,709772
150400,201812,103,86,17,82044,16218,98262
150405,201812,1263,823,440,784054.6,419456.74,1203511.34
150410,201812,133,89,44,84906,41976,126882
150420,201812,7440,4088,3352,3898588.28,3196145.2,7094733.48
150430,201812,533,352,181,335808,172674,508482
150440,201812,576,342,234,325505,223236,548741
150442,201812,2211,1194,1017,1134479.1,969927.03,2104406.13
150445,201812,523,334,189,318636,179352,497988
150450,201812,255,127,128,121158,122112,243270
150460,201812,746,566,180,537755.49,171700.92,709456.41
150470,201812,1342,814,528,775602,503712,1279314
150475,201812,223,175,48,166950,45792,212742
150480,201812,1265,887,378,846198,360325.8,1206523.8
150490,201812,606,330,276,314820,263304,578124
150495,201812,328,234,94,223236,89676,312912
150497,201812,301,204,97,194616,92528.46,287144.46
150500,201812,426,294,132,280476,125928,406404
150503,201812,900,446,454,425198,432812,858010
150506,201812,1007,665,342,634410,326258.46,960668.46
150510,201812,1238,702,536,669422,511344,1180766
150520,201812,271,180,91,171720,86814,258534
150530,201812,1607,887,720,843050.3,686880,1529930.3
150540,201812,238,164,74,156456,70596,227052
150543,201812,759,429,330,408674.52,314533.8,723208.32
150548,201812,492,345,147,329130,140238,469368
150549,201812,60,43,17,41022,16218,57240
150550,201812,2880,1521,1359,1450081,1296200,2746281
150553,201812,3187,1888,1299,1799622,1239236.46,3038858.46
150555,201812,144,78,66,74412,62964,137376
150560,201812,59,45,14,42930,13356,56286
150563,201812,79,42,37,40068,35298,75366
150565,201812,170,104,66,99216,62964,162180
150570,201812,416,276,140,263284.92,133560,396844.92
150580,201812,1577,708,869,674855.9,829026,1503881.9
150590,201812,804,513,291,489402,277614,767016
150600,201812,462,283,179,269982,170766,440748
150610,201812,145,125,20,118401,19080,137481
150611,201812,127,89,38,84906,36252,121158
150613,201812,3226,1995,1231,1903230,1174365,3077595
150616,201812,501,300,201,285962,191754,477716
150618,201812,1243,673,570,641241.18,543780,1185021.18
150619,201812,400,307,93,292878,88722,381600
150620,201812,1280,753,527,718362,502471.8,1220833.8
150630,201812,309,202,107,192708,102078,294786
150635,201812,490,211,279,201294,266166,467460
150640,201812,57,28,29,26712,27666,54378
150650,201812,2376,1395,981,1330027.93,935297.8,2265325.73
150655,201812,250,185,65,176490,62010,238500
150658,201812,104,58,46,55332,43884,99216
150660,201812,498,348,150,331992,143100,475092
150670,201812,1019,373,646,355546.8,616265.46,971812.26
150680,201812,9711,5322,4389,5069349.07,4185723.78,9255072.85
150690,201812,55,34,21,32436,20034,52470
150700,201812,506,334,172,318445.2,164088,482533.2
150710,201812,287,168,119,160272,113526,273798
150715,201812,848,520,328,495097.92,312883.38,807981.30
150720,201812,420,328,92,312912,87481.8,400393.8
150730,201812,961,517,444,493209,423289.8,916498.8
150740,201812,222,155,67,147870,63918,211788
150745,201812,808,444,364,423576,347256,770832
150746,201812,51,31,20,29574,19080,48654
150747,201812,260,201,59,191754,56286,248040
150750,201812,134,77,57,73458,54378,127836
150760,201812,1743,1144,599,1091376,571446,1662822
150770,201812,373,199,174,189846,165820.95,355666.95
150775,201812,96,44,52,41976,49608,91584
150780,201812,196,107,89,102078,84906,186984
150790,201812,865,473,392,451242,373968,825210
150795,201812,1485,874,611,833796,582894,1416690
150796,201812,383,221,162,210834,154548,365382
150797,201812,291,163,128,155502,122112,277614
150800,201812,1439,866,573,825205.23,546342,1371547.23
150803,201812,590,486,104,463644,99216,562860
150805,201812,192,123,69,117342,65812.46,183154.46
150808,201812,1013,560,453,534240,432162,966402
150810,201812,3390,2351,1039,2238457.75,990242.66,3228700.41
150812,201812,440,239,201,228006,191754,419760
150815,201812,969,641,328,610135.47,312912,923047.47
150820,201812,1562,954,608,909162,580012.92,1489174.92
150830,201812,809,575,234,547596,223236,770832
150835,201812,192,115,77,109710,73458,183168
150840,201812,1337,863,474,822635,452196,1274831
160005,201812,51,30,21,28620,20034,48654
160010,201812,195,123,72,117342,68684,186026
160015,201812,117,68,49,64872,46746,111618
160020,201812,133,77,56,73458,53424,126882
160021,201812,43,23,20,21942,19080,41022
160023,201812,119,72,47,68688,44838,113526
160025,201812,30,13,17,12402,16218,28620
160027,201812,1511,868,643,825496.7,612668,1438164.7
160030,201812,15657,8103,7554,7721884.88,7201233.51,14923118.39
160040,201812,306,177,129,168858,123066,291924
160050,201812,707,359,348,342486,331228.8,673714.8
160053,201812,325,187,138,177825.8,131652,309477.8
160055,201812,30,22,8,20988,7632,28620
160060,201812,6531,3465,3066,3295114.8,2924006.2,6219121.0
160070,201812,174,109,65,103300,62010,165310
160080,201812,86,44,42,41976,40068,82044
170025,201812,25,14,11,13356,10494,23850
170030,201812,223,183,40,174385,38160,212545
170035,201812,226,105,121,100170,115434,215604
170040,201812,182,140,42,133254.72,40068,173322.72
170070,201812,330,203,127,193662,121158,314820
170100,201812,363,266,97,253764,92538,346302
170105,201812,61,50,11,47700,10494,58194
170110,201812,108,67,41,63918,39114,103032
170130,201812,65,32,33,30528,31196,61724
170190,201812,99,66,33,62964,31482,94446
170200,201812,391,264,127,251179.2,121053.76,372232.96
170210,201812,6013,3171,2842,3015293.19,2709246.86,5724540.05
170215,201812,104,48,56,45792,53424,99216
170220,201812,1414,1042,372,992193.46,354602,1346795.46
170230,201812,155,103,52,98262,49608,147870
170240,201812,537,355,182,338670,173628,512298
170255,201812,1110,894,216,852666.12,205777.8,1058443.92
170270,201812,38,27,11,25758,10303.2,36061.2
170290,201812,96,72,24,68688,22896,91584
170300,201812,86,58,28,54568.8,26712,81280.8
170305,201812,48,37,11,35298,10494,45792
170307,201812,62,46,16,43884,15264,59148
170310,201812,108,61,47,58194,44838,103032
170320,201812,21,17,4,16218,3816,20034
170330,201812,24,22,2,20988,1908,22896
170360,201812,27,16,11,15264,10494,25758
170370,201812,120,63,57,60102,54378,114480
170380,201812,84,64,20,61056,19080,80136
170382,201812,44,39,5,37206,4770,41976
170384,201812,140,106,34,101124,32436,133560
170386,201812,62,27,35,25758,33390,59148
170388,201812,51,20,31,19080,29574,48654
170389,201812,25,20,5,19080,4770,23850
170390,201812,58,33,25,31473,23850,55323
170410,201812,33,24,9,22896,8586,31482
170460,201812,17,13,4,12402,3816,16218
170510,201812,34,27,7,25758,6678,32436
170550,201812,1531,887,644,845643.91,613879.92,1459523.83
170555,201812,111,78,33,74412,31482,105894
170560,201812,97,71,26,67734,24804,92538
170600,201812,39,18,21,17172,20034,37206
170610,201812,192,102,90,95910.39,85556,181466.39
170625,201812,36,20,16,19080,15264,34344
170650,201812,79,58,21,55332,20034,75366
170700,201812,571,436,135,412596,128503.8,541099.8
170710,201812,162,99,63,94446,60084,154530
170720,201812,86,69,17,65826,16218,82044
170730,201812,72,43,29,41022,27666,68688
170740,201812,89,66,23,62964,21942,84906
170755,201812,67,35,32,33390,30528,63918
170765,201812,138,69,69,65540,65826,131366
170770,201812,224,135,89,128503.8,84906,213409.8
170820,201812,600,396,204,377784,193901,571685
170825,201812,32,19,13,18126,12402,30528
170830,201812,84,66,18,62964,17172,80136
170900,201812,192,150,42,143100,40068,183168
170930,201812,838,442,396,421668,377212,798880
170950,201812,3071,1355,1716,1291421.8,1634947.31,2926369.11
170980,201812,16,9,7,8586,6678,15264
171050,201812,143,111,32,105894,30528,136422
171070,201812,38,32,6,30528,5724,36252
171090,201812,44,33,11,31482,10494,41976
171110,201812,20,13,7,12402,6678,19080
171150,201812,42,21,21,20034,20034,40068
171180,201812,22,10,12,9540,11448,20988
171190,201812,150,86,64,82044,61056,143100
171195,201812,65,51,14,48654,13356,62010
171200,201812,47,22,25,20988,23850,44838
171215,201812,4,3,1,2862,954,3816
171240,201812,54,44,10,41976,9540,51516
171245,201812,55,50,5,47700,4770,52470
171250,201812,69,37,32,35298,30518.46,65816.46
171270,201812,16,12,4,11448,3816,15264
171280,201812,40,36,4,34201,3816,38017
171320,201812,992,569,423,542826,401539.26,944365.26
171330,201812,420,207,213,197478,203202,400680
171360,201812,90,64,26,61056,24804,85860
171370,201812,25,13,12,12402,11448,23850
171380,201812,135,110,25,104940,23620.09,128560.09
171395,201812,56,35,21,33390,20034,53424
171420,201812,308,201,107,191754,102078,293832
171430,201812,67,54,13,51516,12402,63918
171488,201812,195,106,89,101124,84906,186030
171500,201812,57,32,25,30528,23850,54378
171510,201812,68,45,23,42930,21942,64872
171515,201812,42,35,7,33390,6392,39782
171525,201812,31,26,5,24804,4770,29574
171550,201812,12,7,5,6678,4770,11448
171570,201812,59,31,28,29574,26712,56286
171575,201812,331,210,121,200340,115424.46,315764.46
171610,201812,1721,872,849,829988.99,808416.2,1638405.19
171620,201812,134,94,40,89122.68,38160,127282.68
171630,201812,55,29,26,27666,24804,52470
171650,201812,268,180,88,171720,83952,255672
171660,201812,266,144,122,137376,116098,253474
171665,201812,55,39,16,37206,15264,52470
171670,201812,428,248,180,235352.3,171433.8,406786.1
171700,201812,66,59,7,56286,6678,62964
171720,201812,26,10,16,9540,15264,24804
171750,201812,105,57,48,54378,45792,100170
171780,201812,77,62,15,59148,14310,73458
171790,201812,77,66,11,62964,10494,73458
171800,201812,38,30,8,28620,7632,36252
171820,201812,2073,1189,884,1131585.25,840512.8,1972098.05
171830,201812,34,27,7,25758,6678,32436
171840,201812,68,43,25,41022,23850,64872
171845,201812,31,19,12,18126,11448,29574
171850,201812,39,30,9,28620,8586,37206
171855,201812,79,62,17,59148,16218,75366
171865,201812,10,8,2,7632,1908,9540
171870,201812,30,22,8,20988,7632,28620
171875,201812,82,56,26,53424,24804,78228
171880,201812,31,21,10,20034,9540,29574
171884,201812,48,25,23,23850,21942,45792
171886,201812,126,48,78,45792,74125.8,119917.8
171888,201812,25,19,6,18126,5724,23850
171889,201812,19,15,4,14310,3816,18126
171890,201812,58,48,10,45792,9540,55332
171900,201812,43,30,13,28620,12402,41022
172000,201812,40,33,7,31482,6678,38160
172010,201812,42,36,6,33533.1,5724,39257.1
172015,201812,26,16,10,15064,9253.8,24317.8
172020,201812,139,89,50,84906,47700,132606
172025,201812,32,21,11,20034,10494,30528
172030,201812,42,26,16,24804,15264,40068
172049,201812,74,46,28,43884,26712,70596
172065,201812,147,95,52,90630,49608,140238
172080,201812,96,65,31,60827.84,29574,90401.84
172085,201812,25,12,13,11448,12402,23850
172090,201812,417,324,93,308299.41,87959,396258.41
172093,201812,26,20,6,19080,5724,24804
172097,201812,18,10,8,9540,7346,16886
172100,201812,4843,2741,2102,2607340.02,2002295.2,4609635.22
172110,201812,83,56,27,53424,25758,79182
172120,201812,1697,1457,240,1384816.19,227833.41,1612649.60
172125,201812,3,3,0,2862,0,2862
172130,201812,16,12,4,11448,3816,15264
172208,201812,192,121,71,115434,67734,183168
172210,201812,400,199,201,189846,191468,381314
210005,201812,2935,1839,1096,1751353.22,1042438,2793791.22
210010,201812,182,92,90,87768,85860,173628
210015,201812,35,25,10,23850,9540,33390
210020,201812,348,189,159,180306,151686,331992
210030,201812,343,218,125,207972,119241,327213
210040,201812,149,115,34,109710,32436,142146
210043,201812,270,192,78,183168,74412,257580
210047,201812,589,322,267,306806.4,254718,561524.4
210050,201812,300,220,80,209880,76320,286200
210055,201812,43,33,10,31482,9540,41022
210060,201812,558,443,115,422522.79,109423.8,531946.59
210070,201812,418,313,105,298602,100170,398772
210080,201812,109,99,10,94446,9540,103986
210083,201812,303,140,163,133560,155502,289062
210087,201812,41,31,10,28772.64,9540,38312.64
210090,201812,478,334,144,318636,137376,456012
210095,201812,479,355,124,338660.46,118296,456956.46
210100,201812,691,535,156,510056.1,147870.02,657926.12
210110,201812,145,84,61,80136,58194,138330
210120,201812,5393,4122,1271,3926613.8,1212238.8,5138852.6
210125,201812,209,122,87,116388,82998,199386
210130,201812,522,286,236,271890,225124.92,497014.92
210135,201812,33,20,13,19080,12402,31482
210140,201812,4393,3453,940,3291568.82,896760,4188328.82
210150,201812,372,237,135,226098,128790,354888
210160,201812,3421,2888,533,2752292.78,508196,3260488.78
210170,201812,1162,916,246,873864,234684,1108548
210173,201812,127,108,19,103032,18126,121158
210177,201812,436,224,212,213696,202248,415944
210180,201812,33,18,15,17172,14310,31482
210190,201812,413,272,141,259488,134514,394002
210193,201812,1,1,0,954,0,954
210197,201812,79,53,26,50562,24785.88,75347.88
210200,201812,643,514,129,490203.36,123066,613269.36
210203,201812,255,173,82,164756,78228,242984
210207,201812,390,307,83,292878,79182,372060
210210,201812,783,720,63,686880,60102,746982
210215,201812,77,66,11,62964,10494,73458
210220,201812,397,330,67,314820,63631.8,378451.8
210230,201812,306,238,68,227052,64872,291924
210232,201812,1470,951,519,906968,495126,1402094
210235,201812,160,127,33,120968,31482,152450
210237,201812,43,25,18,23850,17172,41022
210240,201812,90,75,15,71550,14310,85860
210250,201812,186,152,34,145008,32436,177444
210255,201812,355,264,91,251856,86814,338670
210260,201812,416,268,148,255672,141192,396864
210270,201812,692,443,249,422622,237546,660168
210275,201812,52,39,13,37206,12402,49608
210280,201812,1074,694,380,659408.43,361184.5,1020592.93
210290,201812,515,345,170,329130,162180,491310
210300,201812,5945,3557,2388,3387769.14,2276960.23,5664729.37
210310,201812,108,77,31,73458,29574,103032
210312,201812,118,79,39,75366,37206,112572
210315,201812,116,89,27,84906,25758,110664
210317,201812,123,91,32,86814,30528,117342
210320,201812,2383,1979,404,1886255.84,385416,2271671.84
210325,201812,131,91,40,85860,37874,123734
210330,201812,5265,2827,2438,2691181.63,2325842.46,5017024.09
210340,201812,1350,980,370,934101,352909.07,1287010.07
210350,201812,621,515,106,491071.5,101124,592195.5
210355,201812,140,114,26,108756,24804,133560
210360,201812,2595,1662,933,1582163.7,889796,2471959.7
210370,201812,1251,566,685,539964,653490,1193454
210375,201812,191,98,93,93492,88722,182214
210380,201812,728,546,182,520884,173628,694512
210390,201812,202,169,33,161226,31482,192708
210400,201812,426,364,62,347256,59129,406385
210405,201812,1021,698,323,665892,308142,974034
210407,201812,56,45,11,42930,10494,53424
210408,201812,64,57,7,54378,6678,61056
210409,201812,329,276,53,263304,50562,313866
210410,201812,446,347,99,331038,94437,425475
210420,201812,199,164,35,156456,33390,189846
210430,201812,41,28,13,26712,12402,39114
210440,201812,367,228,139,217512,132606,350118
210450,201812,154,119,35,113526,33390,146916
210455,201812,228,125,103,119250,98262,217512
210460,201812,341,217,124,207018,118296,325314
210462,201812,68,56,12,53424,11448,64872
210465,201812,168,122,46,116388,43884,160272
210467,201812,540,390,150,372056,143100,515156
210470,201812,43,36,7,34344,6678,41022
210480,201812,1310,928,382,885312,364428,1249740
210490,201812,215,134,81,127836,77274,205110
210500,201812,579,317,262,302418,249948,552366
210510,201812,571,447,124,426438,118296,544734
210515,201812,426,242,184,230868,175536,406404
210520,201812,410,359,51,342199.8,48654,390853.8
210530,201812,9468,5085,4383,4838806.77,4172692.23,9011499.00
210535,201812,128,94,34,89676,32436,122112
210540,201812,1543,960,583,914695.8,555418.8,1470114.6
210542,201812,1222,602,620,573926.4,591194,1165120.4
210545,201812,13,12,1,11448,954,12402
210547,201812,133,114,19,108756,18126,126882
210550,201812,733,523,210,497833,200340,698173
210560,201812,179,150,29,143100,27666,170766
210565,201812,30,22,8,20988,7632,28620
210570,201812,1369,1082,287,1030988.26,273798,1304786.26
210580,201812,111,97,14,92538,13356,105894
210590,201812,776,622,154,592624.8,146916,739540.8
210592,201812,33,29,4,27666,3816,31482
210594,201812,107,88,19,83952,18126,102078
210596,201812,92,77,15,73458,14310,87768
210598,201812,129,93,36,88722,34344,123066
210600,201812,337,285,52,271890,49608,321498
210610,201812,256,237,19,225144,18126,243270
210620,201812,44,27,17,25758,16218,41976
210630,201812,68,65,3,62010,2862,64872
210632,201812,1075,724,351,690696,334377,1025073
210635,201812,20,17,3,16218,2862,19080
210637,201812,102,71,31,67734,29574,97308
210640,201812,592,519,73,495126,69642,564768
210650,201812,415,338,77,321526.62,72504,394030.62
210660,201812,400,292,108,277138,103032,380170
210663,201812,24,13,11,12402,10494,22896
210667,201812,112,36,76,34344,72504,106848
210670,201812,269,236,33,224429,31482,255911
210675,201812,566,301,265,287154,252810,539964
210680,201812,212,134,78,127836,74412,202248
210690,201812,638,516,122,492264,116388,608652
210700,201812,185,138,47,131652,44838,176490
210710,201812,284,164,120,156265.2,114480,270745.2
210720,201812,136,117,19,111618,18126,129744
210725,201812,70,61,9,58194,8586,66780
210730,201812,26,19,7,18126,6678,24804
210735,201812,406,280,126,267120,119918,387038
210740,201812,560,474,86,452196,82044,534240
210745,201812,158,117,41,111618,39114,150732
210750,201812,2440,1153,1287,1098007,1227778.92,2325785.92
210760,201812,263,198,65,188892,61995.69,250887.69
210770,201812,403,313,90,298554.3,85573.8,384128.1
210780,201812,425,311,114,296694,108756,405450
210790,201812,190,146,44,139284,41976,181260
210800,201812,159,117,42,111618,40068,151686
210805,201812,49,45,4,42930,3816,46746
210810,201812,488,379,109,360898.2,103986,464884.2
210820,201812,2347,1879,468,1784884.61,446472,2231356.61
210825,201812,169,90,79,85860,75366,161226
210830,201812,787,498,289,474138,274752,748890
210840,201812,208,142,66,135468,62964,198432
210845,201812,256,167,89,159318,84906,244224
210850,201812,823,535,288,510390,274752,785142
210860,201812,4063,2160,1903,2059114.3,1815156.72,3874271.02
210870,201812,478,364,114,347256,108756,456012
210880,201812,69,51,18,48654,17172,65826
210890,201812,350,296,54,282384,51516,333900
210900,201812,602,388,214,370152,204156,574308
210905,201812,67,34,33,32436,31482,63918
210910,201812,2022,1507,515,1436387.99,491310,1927697.99
210920,201812,207,69,138,65826,131652,197478
210923,201812,81,58,23,55332,21942,77274
210927,201812,432,190,242,181260,230868,412128
210930,201812,67,53,14,50562,13356,63918
210940,201812,93,73,20,69642,19080,88722
210945,201812,200,94,106,89676,101124,190800
210950,201812,521,379,142,361566,135463.23,497029.23
210955,201812,75,50,25,47700,23850,71550
210960,201812,2385,1081,1304,1029652.4,1244016,2273668.4
210970,201812,116,102,14,97308,13356,110664
210975,201812,92,83,9,79182,8586,87768
210980,201812,1185,532,653,507413.52,622676,1130089.52
210990,201812,4305,2717,1588,2590917.13,1514952,4105869.13
211000,201812,1381,1099,282,1048160,268741.8,1316901.8
211003,201812,918,635,283,605790,269973,875763
211010,201812,499,442,57,421668,54378,476046
211020,201812,1595,601,994,573354,948056.58,1521410.58
211023,201812,30,26,4,24517.8,3816,28333.8
211027,201812,68,46,22,43884,20988,64872
211030,201812,389,268,121,255672,115434,371106
211040,201812,322,256,66,243938,62964,306902
211050,201812,1175,767,408,731698.92,388941.23,1120640.15
211060,201812,685,584,101,555228,96354,651582
211065,201812,21,17,4,16218,3816,20034
211070,201812,930,762,168,725336.74,160272,885608.74
211080,201812,88,84,4,80136,3816,83952
211085,201812,60,31,29,29288,27666,56954
211090,201812,90,72,18,68688,17172,85860
211100,201812,502,403,99,384462,94446,478908
211102,201812,259,177,82,168858,78228,247086
211105,201812,224,155,69,147870,65826,213696
211107,201812,135,78,57,74412,54378,128790
211110,201812,833,541,292,515542,278559,794101
211120,201812,5777,2653,3124,2525374.46,2979204.23,5504578.69
211125,201812,32,25,7,23850,6678,30528
211130,201812,45318,19591,25727,18654444.79,24532684.52,43187129.31
211140,201812,433,370,63,352022,60102,412124
211150,201812,1298,830,468,791486.1,446182,1237668.1
211153,201812,166,98,68,93492,64872,158364
211157,201812,65,51,14,48654,13356,62010
211160,201812,715,597,118,568822.5,112572,681394.5
211163,201812,0,0,0,0,0,0
211167,201812,10,9,1,8586,954,9540
211170,201812,443,315,128,300510,122112,422622
211172,201812,123,86,37,82044,35298,117342
211174,201812,268,161,107,153594,102078,255672
211176,201812,507,369,138,352026,131652,483678
211178,201812,98,65,33,62010,31482,93492
211180,201812,211,167,44,159318,41813.82,201131.82
211190,201812,67,62,5,59148,4770,63918
211195,201812,28,18,10,17172,9540,26712
211200,201812,154,133,21,126538.56,20034,146572.56
211210,201812,510,329,181,313198.2,172674,485872.2
211220,201812,4091,2324,1767,2209104.39,1680211.02,3889315.41
211223,201812,95,90,5,85678.74,4770,90448.74
211227,201812,68,50,18,47700,17172,64872
211230,201812,783,637,146,607554.9,139264.92,746819.82
211240,201812,412,312,100,297361.8,95400,392761.8
211245,201812,193,90,103,85860,98262,184122
211250,201812,1644,1407,237,1341286.12,226098,1567384.12
211260,201812,828,661,167,630594,159318,789912
211270,201812,2059,1640,419,1564560,398772.2,1963332.2
211280,201812,1873,1141,732,1087560.8,698328,1785888.8
211285,201812,208,123,85,117342,80289,197631
211290,201812,693,474,219,452005.2,208926,660931.2
211300,201812,818,636,182,606466.09,173628,780094.09
211400,201812,1584,919,665,876726,634410,1511136
220005,201812,17,16,1,15264,954,16218
220010,201812,90,68,22,64872,20701.8,85573.8
220020,201812,639,512,127,486858.88,121158,608016.88
220025,201812,109,106,3,101124,2862,103986
220027,201812,38,31,7,29574,6678,36252
220030,201812,103,84,19,80136,18126,98262
220040,201812,1166,883,283,841238.04,269982,1111220.04
220045,201812,42,30,12,28620,11448,40068
220050,201812,676,565,111,537848.96,105894,643742.96
220060,201812,174,149,25,142146,23850,165996
220070,201812,105,95,10,90630,9540,100170
220080,201812,14,13,1,12402,954,13356
220090,201812,34,28,6,26712,5724,32436
220095,201812,2,1,1,954,954,1908
220100,201812,25,21,4,20034,3816,23850
220105,201812,26,24,2,22610,1908,24518
220110,201812,217,197,20,187651.8,19080,206731.8
220115,201812,49,46,3,43884,2862,46746
220117,201812,22,20,2,19080,1908,20988
220120,201812,1487,1092,395,1040432.4,376830,1417262.4
220130,201812,28,28,0,26712,0,26712
220140,201812,100,79,21,74412,20034,94446
220150,201812,479,346,133,330084,126882,456966
220155,201812,4,4,0,3816,0,3816
220157,201812,18,15,3,14310,2862,17172
220160,201812,79,68,11,64872,10494,75366
220170,201812,37,35,2,33390,1908,35298
220173,201812,6,6,0,5724,0,5724
220177,201812,5,5,0,4770,0,4770
220180,201812,64,64,0,61051.23,0,61051.23
220190,201812,1064,954,110,910116,104940,1015056
220191,201812,43,38,5,36252,4770,41022
220192,201812,69,66,3,62964,2862,65826
220194,201812,46,43,3,41022,2862,43884
220196,201812,105,88,17,83952,16218,100170
220198,201812,6,4,2,3816,1908,5724
220200,201812,427,354,73,337383,69642,407025
220202,201812,38,34,4,32436,3816,36252
220205,201812,41,37,4,35298,3816,39114
220207,201812,15,14,1,13356,954,14310
220208,201812,83,44,39,41976,37206,79182
220209,201812,31,28,3,26712,2862,29574
220210,201812,15,13,2,12402,1908,14310
220211,201812,26,26,0,24804,0,24804
220213,201812,42,38,4,36252,3530,39782
220217,201812,37,29,8,27666,7632,35298
220220,201812,2090,1353,737,1287136.8,701715,1988851.8
220225,201812,12,5,7,4770,6678,11448
220230,201812,957,757,200,721729.62,190160.82,911890.44
220240,201812,156,143,13,136422,12402,148824
220245,201812,32,29,3,26821.04,2862,29683.04
220250,201812,116,104,12,99216,11448,110664
220253,201812,42,36,6,34344,5724,40068
220255,201812,29,26,3,24804,2862,27666
220260,201812,694,506,188,482724,179352,662076
220265,201812,13,8,5,7632,4770,12402
220270,201812,716,636,80,606018.96,75843,681861.96
220271,201812,43,36,7,34344,6678,41022
220272,201812,26,26,0,24804,0,24804
220273,201812,14,12,2,11448,1908,13356
220275,201812,58,46,12,43884,11448,55332
220277,201812,12,10,2,9540,1908,11448
220280,201812,14,11,3,10494,2862,13356
220285,201812,46,43,3,41022,2862,43884
220290,201812,1450,1240,210,1179668.8,200293,1379961.8
220300,201812,50,48,2,45792,1908,47700
220310,201812,316,268,48,255668,45783,301451
220320,201812,434,401,33,381124,31482,412606
220323,201812,0,0,0,0,0,0
220325,201812,16,11,5,10494,4770,15264
220327,201812,12,11,1,10494,954,11448
220330,201812,212,148,64,141192,61056,202248
220335,201812,134,116,18,110664,17172,127836
220340,201812,30,19,11,18126,10494,28620
220342,201812,59,51,8,48654,7632,56286
220345,201812,86,78,8,74412,7632,82044
220350,201812,432,379,53,358943.42,50562,409505.42
220360,201812,43,31,12,29574,11448,41022
220370,201812,1162,948,214,903628.8,203869.8,1107498.6
220375,201812,28,26,2,24804,1908,26712
220380,201812,40,33,7,31482,6678,38160
220385,201812,18,15,3,14310,2862,17172
220390,201812,2321,1336,985,1269850.55,938593.5,2208444.05
220400,201812,30,27,3,25758,2862,28620
220410,201812,19,18,1,17172,954,18126
220415,201812,13,12,1,11448,954,12402
220420,201812,132,109,23,103986,21655.8,125641.8
220430,201812,130,119,11,112524.8,10494,123018.8
220435,201812,21,15,6,14305.23,5724,20029.23
220440,201812,301,256,45,244224,42930,287154
220450,201812,342,176,166,166738.98,158364,325102.98
220455,201812,56,54,2,51516,1908,53424
220460,201812,19,19,0,17458.2,0,17458.2
220465,201812,105,69,36,65826,34344,100170
220470,201812,239,211,28,201294,26712,228006
220480,201812,76,67,9,63918,8586,72504
220490,201812,88,76,12,72504,11448,83952
220500,201812,95,80,15,76320,14310,90630
220510,201812,380,305,75,290207,71359.2,361566.2
220515,201812,20,18,2,17172,1908,19080
220520,201812,376,337,39,320469,37206,357675
220525,201812,20,15,5,14310,4770,19080
220527,201812,37,29,8,27666,6822,34488
220530,201812,37,16,21,15264,20034,35298
220535,201812,6,6,0,5724,0,5724
220540,201812,59,50,9,47700,8586,56286
220545,201812,55,37,18,35298,17172,52470
220550,201812,652,499,153,475282.8,145962,621244.8
220551,201812,26,21,5,20034,4770,24804
220552,201812,12,12,0,11448,0,11448
220553,201812,51,46,5,43884,4770,48654
220554,201812,11,7,4,6391.8,3816,10207.8
220555,201812,29,26,3,24804,2862,27666
220556,201812,53,49,4,46746,3816,50562
220557,201812,56,51,5,48654,4770,53424
220558,201812,6,2,4,1908,3816,5724
220559,201812,6,6,0,5724,0,5724
220560,201812,67,44,23,41785.2,21942,63727.2
220570,201812,794,486,308,462439.88,293832,756271.88
220580,201812,559,515,44,491310,41309,532619
220585,201812,6,5,1,4770,954,5724
220590,201812,14,14,0,13356,0,13356
220595,201812,63,48,15,45792,14310,60102
220600,201812,21,13,8,12402,7632,20034
220605,201812,20,19,1,18126,954,19080
220610,201812,69,61,8,58194,7632,65826
220620,201812,565,450,115,429061.5,109710,538771.5
220630,201812,5,4,1,3816,954,4770
220635,201812,37,33,4,31482,3816,35298
220640,201812,102,80,22,76320,20988,97308
220650,201812,113,106,7,101124,6678,107802
220660,201812,37,30,7,28620,6678,35298
220665,201812,4,4,0,3816,0,3816
220667,201812,14,13,1,12402,954,13356
220669,201812,29,26,3,24804,2862,27666
220670,201812,69,55,14,52470,13356,65826
220672,201812,69,47,22,44838,20988,65826
220675,201812,37,29,8,27666,7632,35298
220680,201812,39,33,6,31482,5724,37206
220690,201812,45,43,2,41022,1908,42930
220695,201812,53,23,30,21942,28620,50562
220700,201812,1653,1277,376,1216416.78,358704,1575120.78
220710,201812,5,3,2,2862,1908,4770
220720,201812,108,88,20,83713.5,19080,102793.5
220730,201812,19,18,1,17172,954,18126
220735,201812,3,1,2,954,1908,2862
220740,201812,49,44,5,41976,4770,46746
220750,201812,102,86,16,82044,15264,97308
220755,201812,15,15,0,14310,0,14310
220760,201812,59,55,4,52470,3816,56286
220770,201812,5697,3008,2689,2863469.83,2560381.41,5423851.24
220775,201812,22,10,12,9540,11448,20988
220777,201812,17,16,1,15264,954,16218
220779,201812,17,14,3,13356,2862,16218
220780,201812,885,760,125,724372.2,118964,843336.2
220785,201812,17,11,6,10494,5724,16218
220790,201812,1047,836,211,795161,201294,996455
220793,201812,12,12,0,11448,0,11448
220795,201812,21,20,1,19080,954,20034
220800,201812,4012,3073,939,2929731.47,895115.89,3824847.36
220810,201812,65,57,8,54378,7632,62010
220820,201812,246,225,21,214650,20034,234684
220830,201812,1213,1039,174,990915.03,165996,1156911.03
220840,201812,2393,1670,723,1581337.21,686862.66,2268199.87
220850,201812,54,46,8,43884,7632,51516
220855,201812,14,9,5,8586,4770,13356
220860,201812,10,9,1,8586,954,9540
220865,201812,23,21,2,20034,1908,21942
220870,201812,67,63,4,60102,3816,63918
220880,201812,328,253,75,240694.2,71264,311958.2
220885,201812,38,35,3,33390,2862,36252
220887,201812,17,17,0,16218,0,16218
220890,201812,103,91,12,86814,11448,98262
220900,201812,54,31,23,29574,21942,51516
220910,201812,56,48,8,45792,7632,53424
220915,201812,10,9,1,8586,954,9540
220920,201812,43,39,4,37206,3816,41022
220930,201812,42,41,1,39114,954,40068
220935,201812,18,18,0,17172,0,17172
220937,201812,40,37,3,35298,2862,38160
220940,201812,57,52,5,49608,4770,54378
220945,201812,0,0,0,0,0,0
220950,201812,45,41,4,39114,3816,42930
220955,201812,40,37,3,35298,2862,38160
220960,201812,2,2,0,1908,0,1908
220965,201812,30,27,3,25758,2862,28620
220970,201812,55,46,9,43884,8586,52470
220975,201812,13,11,2,10494,1908,12402
220980,201812,32,30,2,28620,1908,30528
220985,201812,68,60,8,57240,7632,64872
220987,201812,33,31,2,29574,1908,31482
220990,201812,15,14,1,13356,954,14310
220995,201812,29,24,5,22896,4770,27666
220997,201812,52,42,10,40068,9540,49608
221000,201812,1140,1026,114,975657.8,108469.8,1084127.6
221005,201812,62,56,6,53424,5724,59148
221010,201812,17,13,4,12402,3816,16218
221020,201812,46,44,2,41976,1908,43884
221030,201812,31,25,6,23850,5724,29574
221035,201812,23,23,0,21942,0,21942
221037,201812,11,6,5,5724,4770,10494
221038,201812,27,24,3,22896,2862,25758
221039,201812,22,22,0,20988,0,20988
221040,201812,256,220,36,209880,34344,244224
221050,201812,234,198,36,188892,34344,223236
221060,201812,1797,1585,212,1509639.84,202248,1711887.84
221062,201812,33,32,1,30528,954,31482
221063,201812,13,9,4,8586,3816,12402
221065,201812,54,47,7,44838,6678,51516
221070,201812,142,123,19,117056,18126,135182
221080,201812,376,333,43,317682,40735.8,358417.8
221090,201812,34,33,1,31482,954,32436
221093,201812,54,35,19,33390,18126,51516
221095,201812,10,9,1,8586,954,9540
221097,201812,18,15,3,14310,2862,17172
221100,201812,25237,14724,10513,14024765.57,10022680.13,24047445.70
221110,201812,1057,784,273,746866,260442,1007308
221120,201812,529,398,131,379406,124974,504380
221130,201812,961,786,175,748604.6,166950,915554.6
221135,201812,37,34,3,32436,2862,35298
221140,201812,42,35,7,33390,6678,40068
221150,201812,13,10,3,9540,2862,12402
221160,201812,13,13,0,12402,0,12402
221170,201812,14,14,0,13356,0,13356
230010,201812,168,154,14,146916,13356,160272
230015,201812,126,105,21,100141.38,20034,120175.38
230020,201812,1619,1370,249,1304977,237304.9,1542281.9
230030,201812,1662,1198,464,1138276.38,442656,1580932.38
230040,201812,205,179,26,169287.5,24804,194091.5
230050,201812,214,155,59,147870,56286,204156
230060,201812,160,131,29,124210.8,27666,151876.8
230070,201812,287,257,30,245178,28620,273798
230075,201812,849,741,108,704624.8,102745.8,807370.6
230080,201812,187,161,26,153594,24804,178398
230090,201812,110,78,32,73648.8,30528,104176.8
230100,201812,1979,1176,803,1119589,766006,1885595
230110,201812,2730,1760,970,1676584.16,924807.8,2601391.96
230120,201812,970,778,192,739799.6,183168,922967.6
230125,201812,144,121,23,115434,21942,137376
230130,201812,476,424,52,404496,49608,454104
230140,201812,202,178,24,169812,22896,192708
230150,201812,162,122,40,116388,38160,154548
230160,201812,927,801,126,763677,120204,883881
230170,201812,593,546,47,516657.7,44838,561495.7
230180,201812,80,75,5,71550,4770,76320
230185,201812,409,354,55,336350.83,52470,388820.83
230190,201812,2264,1830,434,1741642.82,413719,2155361.82
230195,201812,492,427,65,407358,62010,469368
230200,201812,384,330,54,313856.46,51516,365372.46
230205,201812,373,241,132,228951.67,125928,354879.67
230210,201812,1274,1014,260,965278.12,247220.18,1212498.30
230220,201812,1530,1042,488,994068,465496,1459564
230230,201812,889,772,117,736297.2,111618,847915.2
230240,201812,1674,1443,231,1375700.7,220345.38,1596046.08
230250,201812,1796,1484,312,1411597.37,297648,1709245.37
230260,201812,3045,1884,1161,1793240.26,1106640.77,2899881.03
230270,201812,1387,1117,270,1062732.19,256387.5,1319119.69
230280,201812,2751,2056,695,1954977.56,662362.2,2617339.76
230290,201812,408,365,43,343742.01,41022,384764.01
230300,201812,517,384,133,365076.72,126882,491958.72
230310,201812,425,319,106,304178.13,101124,405302.13
230320,201812,948,810,138,769176.21,130914.74,900090.95
230330,201812,302,240,62,228196.8,58958,287154.8
230340,201812,455,367,88,348826.2,83952,432778.2
230350,201812,3103,1976,1127,1884760.56,1072526.04,2957286.60
230360,201812,280,217,63,207018,60102,267120
230365,201812,143,113,30,107087,28620,135707
230370,201812,9839,4885,4954,4647975.46,4720351.88,9368327.34
230380,201812,480,408,72,388946,67734.6,456680.6
230390,201812,517,289,228,275706,217512,493218
230393,201812,265,220,45,208874.16,42930,251804.16
230395,201812,350,283,67,269734,63918,333652
230400,201812,613,485,128,460591.68,121615.92,582207.60
230410,201812,2663,1672,991,1589460.75,944652,2534112.75
230420,201812,6258,4145,2113,3933135.71,2011216.14,5944351.85
230423,201812,314,273,41,260442,39114,299556
230425,201812,376,307,69,292564,65826,358390
230426,201812,122,101,21,95628.96,19747.8,115376.76
230427,201812,80,77,3,73458,2862,76320
230428,201812,1420,729,691,695179.8,659157.38,1354337.18
230430,201812,463,378,85,360417.2,81090,441507.2
230435,201812,843,595,248,566197.43,235352.61,801550.04
230440,201812,85525,38100,47425,36253576.82,45181057.17,81434633.99
230445,201812,276,189,87,180306,82998,263304
230450,201812,547,437,110,416898,104940,521838
230460,201812,60,50,10,47700,9540,57240
230465,201812,306,251,55,239454,52470,291924
230470,201812,1945,1528,417,1457712,396711.1,1854423.1
230480,201812,157,149,8,141859.8,7632,149491.8
230490,201812,288,231,57,220374,54378,274752
230495,201812,455,342,113,325385.38,107802,433187.38
230500,201812,974,732,242,697374,230581.8,927955.8
230510,201812,49,40,9,38160,8586,46746
230520,201812,389,306,83,291725,79182,370907
230523,201812,2183,1378,805,1312079.67,766663.6,2078743.27
230526,201812,299,250,49,238480.92,45955,284435.92
230530,201812,679,506,173,480435.2,164088.2,644523.4
230533,201812,193,182,11,173628,10494,184122
230535,201812,352,264,88,251856,83666,335522
230540,201812,1850,1631,219,1553330.08,208639.8,1761969.88
230550,201812,3721,2395,1326,2275264.46,1263940.29,3539204.75
230560,201812,587,446,141,424530.4,133532.75,558063.15
230565,201812,209,152,57,145008,53614.8,198622.8
230570,201812,299,264,35,251856,33390,285246
230580,201812,1119,828,291,787642.1,276660,1064302.1
230590,201812,969,754,215,716693.6,204823.8,921517.4
230600,201812,254,232,22,220584.07,20988,241572.07
230610,201812,348,276,72,263114,68688,331802
230620,201812,171,140,31,132606,29574,162180
230625,201812,726,529,197,503064.08,187042.68,690106.76
230630,201812,1287,1017,270,970186,257198.4,1227384.4
230640,201812,3701,3205,496,3050621.65,471429.67,3522051.32
230650,201812,420,368,52,350127.13,49593.69,399720.82
230655,201812,667,578,89,550430.8,84769.45,635200.25
230660,201812,360,304,56,290016,53137.8,343153.8
230670,201812,431,381,50,363474,47700,411174
230680,201812,200,180,20,171720,19080,190800
230690,201812,885,766,119,730735.38,113526,844261.38
230700,201812,737,626,111,596889.8,105579.8,702469.6
230710,201812,743,705,38,671617,36252,707869
230720,201812,150,129,21,122674.86,20034,142708.86
230725,201812,254,202,52,192708,49599,242307
230730,201812,11971,6501,5470,6185522.37,5210551.88,11396074.25
230740,201812,658,532,126,507242,119513.46,626755.46
230750,201812,828,708,120,673954.1,114480,788434.1
230760,201812,1377,1187,190,1127665.25,181202.76,1308868.01
230763,201812,319,267,52,252762.95,49579.38,302342.33
230765,201812,7181,3403,3778,3240176.42,3601853.22,6842029.64
230770,201812,5010,2584,2426,2455209.9,2312267.36,4767477.26
230780,201812,690,607,83,576176.1,79167.69,655343.79
230790,201812,225,185,40,176490,37359.4,213849.4
230800,201812,1140,834,306,794104.83,291924,1086028.83
230810,201812,1316,1172,144,1117086.3,137376,1254462.3
230820,201812,347,245,102,232777,97308,330085
230830,201812,949,819,130,777812.41,124020,901832.41
230835,201812,287,248,39,235638,36491,272129
230837,201812,167,140,27,133560,25758,159318
230840,201812,927,741,186,705830,177158,882988
230850,201812,1522,1324,198,1262619,188578,1451197
230860,201812,301,227,74,216558,70596,287154
230870,201812,1833,1563,270,1490120,256979.38,1747099.38
230880,201812,46,33,13,31482,12402,43884
230890,201812,564,516,48,492141.8,45778,537919.8
230900,201812,279,208,71,198432,67537,265969
230910,201812,207,168,39,159508.8,37206,196714.8
230920,201812,410,322,88,307188,83952,391140
230930,201812,939,667,272,633170.44,259488,892658.44
230940,201812,848,675,173,643731.2,164852,808583.2
230945,201812,501,419,82,399250,78228,477478
230950,201812,391,334,57,318636,54378,373014
230960,201812,2583,1760,823,1672227.6,784800,2457027.6
230970,201812,1775,1005,770,957293.7,733334.6,1690628.3
230980,201812,209,176,33,167904,31482,199386
230990,201812,141,113,28,107802,25955.47,133757.47
231000,201812,209,190,19,179352,18126,197478
231010,201812,147,113,34,107515.8,32436,139951.8
231020,201812,1319,919,400,874632.38,381572,1256204.38
231025,201812,1026,771,255,732378.04,240942.8,973320.84
231030,201812,1126,947,179,903147.8,170766,1073913.8
231040,201812,142,97,45,91793.88,42199,133992.88
231050,201812,992,884,108,841571.9,103032,944603.9
231060,201812,147,128,19,122112,18126,140238
231070,201812,1473,1041,432,991016.1,412100,1403116.1
231080,201812,261,244,17,231965.1,16218,248183.1
231085,201812,587,368,219,350119,208926,559045
231090,201812,246,204,42,194616,40068,234684
231095,201812,162,129,33,123066,31482,154548
231100,201812,136,114,22,108756,19747.8,128503.8
231110,201812,362,314,48,297366.1,45792,343158.1
231120,201812,297,254,43,242311.23,41022,283333.23
231123,201812,142,136,6,129744,5724,135468
231126,201812,315,253,62,241362,59148,300510
231130,201812,4609,3599,1010,3424218.3,962715.72,4386934.02
231135,201812,213,184,29,175536,27666,203202
231140,201812,3130,2300,830,2190783.42,790846.92,2981630.34
231150,201812,368,351,17,334854,16218,351072
231160,201812,1208,959,249,911777.08,237289.04,1149066.12
231170,201812,534,363,171,346302,163134,509436
231180,201812,1657,1411,246,1345330.8,234655.38,1579986.18
231190,201812,201,175,26,166950,24804,191754
231195,201812,220,189,31,179582,29574,209156
231200,201812,831,679,152,647766,144055,791821
231210,201812,602,506,96,481770.8,91584,573354.8
231220,201812,1046,758,288,720452.07,274752,995204.07
231230,201812,1420,1132,288,1078974.04,274465.8,1353439.84
231240,201812,1417,1028,389,980397.8,370066.34,1350464.14
231250,201812,112,104,8,99216,7632,106848
231260,201812,291,192,99,183168,94160,277328
231270,201812,1015,847,168,802596.06,159972,962568.06
231280,201812,62,47,15,44838,14310,59148
231290,201812,7383,4128,3255,3929674.63,3103878.21,7033552.84
231300,201812,629,583,46,556182,43884,600066
231310,201812,733,678,55,645595,52470,698065
231320,201812,580,441,139,420238,132577.38,552815.38
231325,201812,90,80,10,76320,9540,85860
231330,201812,2063,1586,477,1507820.04,453246.4,1961066.44
231335,201812,252,223,29,212742,27666,240408
231340,201812,1655,1219,436,1161782.08,415657.8,1577439.88
231350,201812,1241,1020,221,972869,210262,1183131
231355,201812,427,370,57,352980,54378,407358
231360,201812,493,385,108,364810.2,103032,467842.2
231370,201812,91,77,14,73458,13356,86814
231375,201812,294,214,80,204156,76320,280476
231380,201812,468,382,86,363636.92,81853.2,445490.12
231390,201812,202,165,37,157410,35298,192708
231395,201812,728,457,271,435386.52,258534,693920.52
231400,201812,1087,899,188,855074.53,179009.38,1034083.91
231410,201812,1348,1101,247,1046539.4,234657,1281196.4
240010,201812,398,178,220,168660.26,209585,378245.26
240020,201812,2244,1775,469,1690884.84,447422,2138306.84
240030,201812,130,111,19,105894,18126,124020
240040,201812,31,31,0,29574,0,29574
240050,201812,519,446,73,424630.45,69642,494272.45
240060,201812,65,61,4,58194,3816,62010
240070,201812,199,156,43,148824,41022,189846
240080,201812,465,312,153,297644,145008.71,442652.71
240090,201812,103,91,12,86508.72,11448,97956.72
240100,201812,1466,1387,79,1319272.35,75175.2,1394447.55
240110,201812,1045,675,370,642978.26,352837,995815.26
240120,201812,142,121,21,115434,20034,135468
240130,201812,285,267,18,254001.54,17172,271173.54
240140,201812,82,62,20,59148,19080,78228
240145,201812,718,636,82,605980.8,78228,684208.8
240150,201812,19,15,4,14310,3787.38,18097.38
240160,201812,44,37,7,35298,6678,41976
240165,201812,37,31,6,29336,5724,35060
240170,201812,94,69,25,65349,23850,89199
240180,201812,83,68,15,64872,14310,79182
240185,201812,44,40,4,38150.46,3816,41966.46
240190,201812,13,11,2,10494,1908,12402
240200,201812,3045,1707,1338,1621480.13,1275213,2896693.13
240210,201812,169,131,38,124974,36252,161226
240220,201812,1104,797,307,760195,292868.46,1053063.46
240230,201812,848,785,63,746056.05,59454,805510.05
240240,201812,123,86,37,82044,35298,117342
240250,201812,89,80,9,76320,8586,84906
240260,201812,1817,1353,464,1290075.12,441911.88,1731987.00
240270,201812,191,169,22,160844.4,20988,181832.4
240280,201812,42,32,10,30528,9540,40068
240290,201812,50,49,1,46746,954,47700
240300,201812,180,102,78,97021.8,74412,171433.8
240310,201812,2052,1127,925,1065283.98,880084.14,1945368.12
240320,201812,203,192,11,183018.04,10494,193512.04
240325,201812,4314,2630,1684,2501534.98,1603413.86,4104948.84
240330,201812,67,63,4,60102,3816,63918
240340,201812,109,79,30,75366,28620,103986
240350,201812,90,80,10,76320,9540,85860
240360,201812,462,316,146,301464,139284,440748
240370,201812,43,41,2,39114,1908,41022
240375,201812,70,42,28,40068,26712,66780
240380,201812,227,185,42,176490,39973,216463
240390,201812,14,12,2,11448,1908,13356
240400,201812,78,74,4,70596,3816,74412
240410,201812,11,7,4,6678,3816,10494
240420,201812,922,706,216,670998.4,205014.6,876013.0
240430,201812,263,247,16,234727.89,15264,249991.89
240440,201812,83,47,36,44838,34344,79182
240450,201812,212,145,67,137757.8,63918,201675.8
240460,201812,62,49,13,46746,12402,59148
240470,201812,237,205,32,194726.66,30528,225254.66
240480,201812,15,14,1,13260.6,954,14214.6
240485,201812,78,68,10,64872,9540,74412
240490,201812,47,47,0,44628.12,0,44628.12
240500,201812,86,69,17,65826,16218,82044
240510,201812,51,36,15,34344,14310,48654
240520,201812,119,114,5,108756,4770,113526
240530,201812,53,47,6,44838,5724,50562
240540,201812,79,69,10,65826,9540,75366
240550,201812,14,13,1,12402,954,13356
240560,201812,379,279,100,265062.23,95400,360462.23
240570,201812,470,295,175,280571.4,166950,447521.4
240580,201812,1258,1015,243,962825.9,230673.2,1193499.1
240590,201812,28,26,2,24804,1908,26712
240600,201812,111,108,3,103032,2862,105894
240610,201812,512,428,84,407955.7,80136,488091.7
240615,201812,20,19,1,18126,954,19080
240620,201812,95,91,4,86814,3816,90630
240630,201812,36,34,2,32436,1908,34344
240640,201812,27,22,5,20988,4770,25758
240650,201812,236,198,38,188033.9,36252,224285.9
240660,201812,102,88,14,83952,13356,97308
240670,201812,298,177,121,166759.3,115434,282193.3
240680,201812,50,39,11,37206,10494,47700
240690,201812,47,45,2,42930,1908,44838
240700,201812,193,158,35,150732,33390,184122
240710,201812,1929,1227,702,1169361.63,669689.46,1839051.09
240720,201812,1081,790,291,752505.86,277614,1030119.86
240725,201812,65,61,4,58194,3816,62010
240730,201812,137,118,19,112572,18126,130698
240740,201812,239,202,37,191343.78,34344.02,225687.80
240750,201812,41,28,13,26712,12402,39114
240760,201812,38,35,3,33390,2862,36252
240770,201812,149,116,33,110664,31482,142146
240780,201812,680,563,117,536615.46,111618,648233.46
240790,201812,37,36,1,34344,954,35298
240800,201812,9035,6180,2855,5860110.8,2717223.5,8577334.3
240810,201812,20242,11197,9045,10642032.5,8619514.22,19261546.72
240820,201812,213,134,79,127545.03,75366,202911.03
240830,201812,1641,1345,296,1276986.76,282384,1559370.76
240840,201812,84,74,10,70596,9540,80136
240850,201812,84,74,10,70596,9540,80136
240860,201812,110,107,3,102078,2862,104940
240870,201812,62,54,8,51516,7632,59148
240880,201812,30,27,3,25748.46,2862,28610.46
240890,201812,1197,708,489,671522.78,466502,1138024.78
240895,201812,52,37,15,35298,14310,49608
240910,201812,160,146,14,139284,13356,152640
240920,201812,15,12,3,11448,2862,14310
240930,201812,395,359,36,341532,34344,375876
240933,201812,34,26,8,24804,7632,32436
240940,201812,2461,2175,286,2060863.13,269962.92,2330826.05
240950,201812,52,49,3,46746,2862,49608
240960,201812,32,26,6,24804,5724,30528
240970,201812,121,86,35,82044,32636,114680
240980,201812,194,155,39,147870,36633.6,184503.6
240990,201812,125,83,42,79182,40068,119250
241000,201812,66,61,5,58194,4770,62964
241010,201812,62,50,12,47700,11448,59148
241020,201812,113,106,7,101124,6678,107802
241025,201812,9,3,6,2862,5724,8586
241030,201812,120,97,23,92538,21942,114480
241040,201812,36,30,6,28620,5724,34344
241050,201812,88,78,10,74412,9540,83952
241060,201812,29,24,5,22896,4770,27666
241070,201812,16,16,0,15264,0,15264
241080,201812,62,55,7,52183.8,6678,58861.8
241090,201812,49,40,9,38160,8571.69,46731.69
241100,201812,74,64,10,61056,9540,70596
241105,201812,6,2,4,1908,3816,5724
241110,201812,48,45,3,42930,2862,45792
241120,201812,1449,1113,336,1057796.07,320544,1378340.07
241140,201812,226,187,39,177445,37206,214651
241142,201812,43,40,3,38160,2862,41022
241150,201812,1222,1074,148,1022068.8,141192,1163260.8
241160,201812,23,22,1,20988,954,21942
241170,201812,44,40,4,38160,3816,41976
241180,201812,47,40,7,37985.42,6678,44663.42
241190,201812,38,37,1,35298,954,36252
241200,201812,3890,2103,1787,2000870.72,1702639.66,3703510.38
241210,201812,69,59,10,56286,8682,64968
241220,201812,1418,961,457,916329.04,435944.92,1352273.96
241230,201812,242,202,40,192708,38160,230868
241240,201812,55,42,13,40068,12402,52470
241250,201812,1112,1022,90,974511.2,85860,1060371.2
241255,201812,50,40,10,38160,9540,47700
241260,201812,633,497,136,474133.23,129744,603877.23
241270,201812,48,35,13,33390,12402,45792
241280,201812,101,88,13,83952,12402,96354
241290,201812,109,83,26,79182,24804,103986
241300,201812,77,57,20,54378,19080,73458
241310,201812,49,38,11,36109,10494,46603
241320,201812,28,14,14,13356,13356,26712
241330,201812,63,58,5,55332,4770,60102
241335,201812,66,58,8,54664.2,7632,62296.2
241340,201812,188,140,48,133560,45792,179352
241350,201812,62,57,5,54378,4770,59148
241355,201812,43,38,5,36252,4770,41022
241360,201812,50,49,1,46746,954,47700
241370,201812,48,39,9,37081.98,8586,45667.98
241380,201812,40,36,4,34344,3816,38160
241390,201812,77,62,15,58957.2,14310,73267.2
241400,201812,203,164,39,155597.4,37206,192803.4
241410,201812,185,168,17,160272,16122.6,176394.6
241415,201812,100,79,21,75366,20034,95400
241420,201812,100,75,25,71550,23679,95229
241430,201812,28,27,1,25758,954,26712
241440,201812,501,416,85,396850,81090,477940
241445,201812,38,36,2,34344,1908,36252
241450,201812,283,232,51,221328,48654,269982
241460,201812,137,126,11,119966,10494,130460
241470,201812,43,36,7,34344,6678,41022
241475,201812,63,60,3,57240,2862,60102
241480,201812,100,72,28,67734.69,26712,94446.69
241490,201812,8,7,1,6678,954,7632
241500,201812,47,34,13,32436,12402,44838
250010,201812,104,89,15,84834.45,14310,99144.45
250020,201812,33,29,4,27666,3816,31482
250030,201812,834,622,212,592043.2,201199.6,793242.8
250040,201812,343,286,57,272844,54091.8,326935.8
250050,201812,236,196,40,186693.8,38160,224853.8
250053,201812,55,42,13,40068,12402,52470
250057,201812,0,0,0,0,0,0
250060,201812,464,357,107,340578,101791.8,442369.8
250070,201812,701,582,119,553210,113526,666736
250073,201812,7,7,0,6678,0,6678
250077,201812,195,147,48,139846.86,45792,185638.86
250080,201812,421,330,91,313199.2,86814,400013.2
250090,201812,202,133,69,125928,65806.92,191734.92
250100,201812,512,423,89,402588,84525,487113
250110,201812,568,432,136,410344.02,129744,540088.02
250115,201812,24,7,17,6678,16218,22896
250120,201812,113,83,30,79182,28620,107802
250130,201812,575,466,109,444564,103796,548360
250135,201812,13,8,5,7632,4770,12402
250140,201812,85,78,7,74412,6678,81090
250150,201812,577,422,155,401701.58,147555.18,549256.76
250153,201812,9,8,1,7632,954,8586
250157,201812,27,22,5,20988,4770,25758
250160,201812,217,173,44,165042,41976,207018
250170,201812,64,44,20,41976,19080,61056
250180,201812,4115,2818,1297,2672091.74,1232240,3904331.74
250190,201812,869,574,295,546188.96,281430,827618.96
250200,201812,52,44,8,41976,7632,49608
250205,201812,23,20,3,19080,2862,21942
250210,201812,88,77,11,73458,10494,83952
250215,201812,63,55,8,52470,7632,60102
250220,201812,26,20,6,19080,5724,24804
250230,201812,78,71,7,67730,6678,74408
250240,201812,242,200,42,189989.1,40068,230057.1
250250,201812,401,343,58,327222,55332,382554
250260,201812,35,31,4,29574,3816,33390
250270,201812,61,47,14,44838,13356,58194
250280,201812,379,314,65,299556,62010,361566
250290,201812,93,86,7,81757.8,6678,88435.8
250300,201812,557,383,174,364734.71,165983,530717.71
250310,201812,45,41,4,39114,3816,42930
250320,201812,2004,1366,638,1297909.35,607116.8,1905026.15
250330,201812,90,79,11,75366,10494,85860
250340,201812,23,20,3,19080,2862,21942
250350,201812,147,96,51,91297.8,48081.6,139379.4
250355,201812,36,28,8,26712,7632,34344
250360,201812,201,164,37,156456,35298,191754
250370,201812,2406,1628,778,1548133.98,740655.82,2288789.80
250375,201812,8,4,4,3816,3816,7632
250380,201812,54,39,15,37206,14310,51516
250390,201812,43,35,8,33390,7632,41022
250400,201812,16207,8250,7957,7846544.52,7584958.85,15431503.37
250403,201812,388,316,72,301268.43,68688,369956.43
250407,201812,60,52,8,49608,7632,57240
250410,201812,31,26,5,24804,4770,29574
250415,201812,42,28,14,26692.92,13336.92,40029.84
250420,201812,45,38,7,36252,6678,42930
250430,201812,1512,1283,229,1221789,218466,1440255
250435,201812,15,12,3,11448,2862,14310
250440,201812,691,590,101,560167.38,96354,656521.38
250450,201812,88,72,16,68688,14596.2,83284.2
250460,201812,423,292,131,278568,124964.46,403532.46
250470,201812,83,61,22,58194,20988,79182
250480,201812,327,260,67,248040,63918,311958
250485,201812,2,1,1,954,954,1908
250490,201812,231,193,38,184122,36252,220374
250500,201812,81,60,21,57240,20034,77274
250510,201812,724,570,154,543017,145907.43,688924.43
250520,201812,174,120,54,114465.69,51511.23,165976.92
250523,201812,117,98,19,93492,18126,111618
250527,201812,98,78,20,74407.23,19080,93487.23
250530,201812,8,5,3,4770,2862,7632
250535,201812,24,20,4,19080,3816,22896
250540,201812,127,98,29,92776.5,27666,120442.5
250550,201812,70,67,3,63918,2862,66780
250560,201812,40,30,10,28620,9540,38160
250570,201812,154,124,30,118296,28620,146916
250580,201812,124,100,24,95175.8,22896,118071.8
250590,201812,21,15,6,14310,5724,20034
250600,201812,1253,842,411,801361.35,392094,1193455.35
250610,201812,155,134,21,127836,20034,147870
250620,201812,24,20,4,19080,3816,22896
250625,201812,69,52,17,49608,16218,65826
250630,201812,3038,1962,1076,1863994.73,1025442.28,2889437.01
250640,201812,208,172,36,164088,34344,198432
250650,201812,29,20,9,19080,8586,27666
250660,201812,45,34,11,32436,10494,42930
250670,201812,61,40,21,38160,20034,58194
250680,201812,389,320,69,305280,65826,371106
250690,201812,1880,1305,575,1241517.78,547955.4,1789473.18
250700,201812,931,816,115,775813.56,109500.12,885313.68
250710,201812,442,345,97,329130,92538,421668
250720,201812,113,88,25,83952,23850,107802
250730,201812,384,326,58,310050.6,55332,365382.6
250740,201812,54,50,4,47700,3816,51516
250750,201812,20969,12709,8260,12069907.15,7871881,19941788.15
250760,201812,75,57,18,54378,17172,71550
250770,201812,351,229,122,216529.52,114551.55,331081.07
250780,201812,55,42,13,40068,12402,52470
250790,201812,472,305,167,289062.92,158602.5,447665.42
250800,201812,152,140,12,132844.5,11448,144292.5
250810,201812,80,61,19,58194,18126,76320
250820,201812,157,129,28,123066,26712,149778
250830,201812,425,293,132,278520.5,125928,404448.5
250840,201812,52,50,2,47700,1908,49608
250850,201812,56,44,12,41976,11448,53424
250855,201812,13,11,2,10494,1908,12402
250860,201812,202,145,57,138330,54091.8,192421.8
250870,201812,34,30,4,28620,3816,32436
250880,201812,82,62,20,59138.46,19080,78218.46
250890,201812,2555,1895,660,1806131.88,628781.5,2434913.38
250900,201812,125,109,16,103986,15264,119250
250905,201812,124,97,27,92538,25758,118296
250910,201812,1175,839,336,799009.58,320257.8,1119267.38
250915,201812,112,78,34,74412,32436,106848
250920,201812,137,104,33,99216,31482,130698
250930,201812,165,103,62,98262,59148,157410
250933,201812,1,1,0,954,0,954
250937,201812,6,5,1,4770,954,5724
250939,201812,31,24,7,22896,6678,29574
250940,201812,111,85,26,81090,24804,105894
250950,201812,69,46,23,43884,21942,65826
250960,201812,93,50,43,47700,41022,88722
250970,201812,1222,867,355,825497,338002.2,1163499.2
250980,201812,92,65,27,62010,25758,87768
250990,201812,169,130,39,123533.46,37134.45,160667.91
251000,201812,77,68,9,64681.2,8586,73267.2
251010,201812,104,82,22,78224,20209.53,98433.53
251020,201812,82,72,10,67877.1,9540,77417.1
251030,201812,44,33,11,31482,10494,41976
251040,201812,54,40,14,38160,13356,51516
251050,201812,23,21,2,20034,1908,21942
251060,201812,51,40,11,37206,10494,47700
251065,201812,3,3,0,2862,0,2862
251070,201812,23,19,4,18117,3816,21933
251080,201812,4822,2340,2482,2221508.54,2361313.01,4582821.55
251090,201812,198,169,29,161226,27666,188892
251100,201812,18,17,1,16218,954,17172
251110,201812,44,35,9,33390,8586,41976
251120,201812,1841,1120,721,1063856.4,687548,1751404.4
251130,201812,389,317,72,302418,68688,371106
251140,201812,530,347,183,329894.8,174413.34,504308.14
251150,201812,306,265,41,252038,39114,291152
251160,201812,99,83,16,79178,15264,94442
251170,201812,99,78,21,74388.15,20029.23,94417.38
251180,201812,288,182,106,173619.23,101115.23,274734.46
251190,201812,192,132,60,125599.83,57240,182839.83
251200,201812,254,207,47,196829.28,44838,241667.28
251203,201812,37,35,2,33390,1908,35298
251207,201812,96,79,17,75366,16218,91584
251210,201812,1453,1053,400,1003008.53,381313.8,1384322.33
251220,201812,46,37,9,35298,8586,43884
251230,201812,463,389,74,370978.8,70596,441574.8
251240,201812,102,74,28,69642,26712,96354
251250,201812,1358,971,387,923444.87,369055,1292499.87
251260,201812,12,7,5,6678,4770,11448
251270,201812,335,253,82,241362,78085,319447
251272,201812,67,61,6,58194,5724,63918
251274,201812,29,23,6,21942,5724,27666
251275,201812,27,18,9,17172,8586,25758
251276,201812,11,9,2,8586,1908,10494
251278,201812,8,7,1,6678,954,7632
251280,201812,104,99,5,94446,4770,99216
251290,201812,720,544,176,518976,167904,686880
251300,201812,16,13,3,12402,2862,15264
251310,201812,373,268,105,255668,100170,355838
251315,201812,19,18,1,17172,954,18126
251320,201812,61,49,12,46746,11448,58194
251330,201812,80,71,9,67734,8586,76320
251335,201812,12,7,5,6678,4770,11448
251340,201812,708,417,291,397226.52,276589.25,673815.77
251350,201812,37,35,2,33390,1908,35298
251360,201812,74,64,10,61041.69,9540,70581.69
251365,201812,14,14,0,13356,0,13356
251370,201812,5440,3700,1740,3524779.98,1658626,5183405.98
251380,201812,48,39,9,37206,8586,45792
251385,201812,3,3,0,2862,0,2862
251390,201812,704,555,149,528326.2,140906,669232.2
251392,201812,11,5,6,4770,5724,10494
251394,201812,9,9,0,8586,0,8586
251396,201812,14,9,5,8586,4770,13356
251398,201812,19,16,3,15264,2862,18126
251400,201812,42,35,7,33390,6678,40068
251410,201812,37,31,6,29574,5724,35298
251420,201812,103,76,27,72504,25758,98262
251430,201812,40,37,3,35298,2862,38160
251440,201812,34,21,13,20034,12402,32436
251445,201812,56,51,5,48654,4770,53424
251450,201812,411,361,50,342738.8,47700,390438.8
251455,201812,2,1,1,954,954,1908
251460,201812,16,13,3,12402,2862,15264
251465,201812,6,3,3,2862,2862,5724
251470,201812,47,37,10,35298,9540,44838
251480,201812,26,23,3,21942,2862,24804
251490,201812,121,83,38,78705,35299,114004
251500,201812,126,101,25,96354,23087,119441
251510,201812,37,29,8,27666,7632,35298
251520,201812,25,25,0,23850,0,23850
251530,201812,4526,3186,1340,3033162.57,1278064.26,4311226.83
251540,201812,73,64,9,61056,8586,69642
251550,201812,411,317,94,301464.2,89152,390616.2
251560,201812,23,16,7,15264,6678,21942
251570,201812,20,20,0,19080,0,19080
251580,201812,125,103,22,98262,20988,119250
251590,201812,120,89,31,85087,29574,114661
251593,201812,25,16,9,15264,8586,23850
251597,201812,58,48,10,45792,9540,55332
251600,201812,1097,782,315,744699.02,298882.84,1043581.86
251610,201812,218,167,51,159318,47987,207305
251615,201812,3,3,0,2862,0,2862
251620,201812,4297,2859,1438,2716405.64,1369278,4085683.64
251630,201812,446,328,118,312912,112563,425475
251640,201812,148,106,42,101124,40068,141192
251650,201812,274,200,74,188967.1,70596,259563.1
251660,201812,225,202,23,192708,21751.2,214459.2
251670,201812,363,283,80,268286,76320,344606
251675,201812,4,4,0,3816,0,3816
251680,201812,96,86,10,82044,9540,91584
251690,201812,342,286,56,271890,53073.89,324963.89
251700,201812,285,243,42,231235.29,40053.69,271288.98
251710,201812,23,15,8,14310,7632,21942
251720,201812,31,21,10,20034,9254,29288
251740,201812,10,8,2,7632,1908,9540
260005,201812,3174,1806,1368,1711835.34,1304204.1,3016039.44
260010,201812,1568,1132,436,1075804.52,413655.12,1489459.64
260020,201812,426,378,48,360612,45792,406404
260030,201812,580,419,161,398958.98,153594,552552.98
260040,201812,859,535,324,509302.44,309086.46,818388.90
260050,201812,1163,841,322,802076,305948.2,1108024.2
260060,201812,411,371,40,353170.8,38160,391330.8
260070,201812,1448,910,538,864685.3,510282.36,1374967.66
260080,201812,728,574,154,546785.1,146916,693701.1
260090,201812,575,356,219,339396.12,208926,548322.12
260100,201812,236,168,68,159462,64872,224334
260105,201812,230,130,100,124020,95400,219420
260110,201812,2775,2053,722,1958553,688502,2647055
260120,201812,2947,1468,1479,1390754.21,1409345.1,2800099.31
260130,201812,159,112,47,106848,44838,151686
260140,201812,2170,1429,741,1353683.71,704606.26,2058289.97
260150,201812,225,147,78,140238,74412,214650
260160,201812,305,255,50,243270,47700,290970
260170,201812,3413,2092,1321,1988722.58,1258841.36,3247563.94
260180,201812,154,130,24,124020,22896,146916
260190,201812,2309,1624,685,1546145.9,653490,2199635.9
260200,201812,936,762,174,725469.02,165710,891179.02
260210,201812,1426,1013,413,966251.27,393039.11,1359290.38
260220,201812,731,663,68,632502,64872,697374
260230,201812,1215,921,294,876442.99,280476,1156918.99
260240,201812,230,175,55,165996,52470,218466
260250,201812,85,63,22,60102,20988,81090
260260,201812,1002,723,279,689742,266166,955908
260270,201812,431,347,84,329655.2,79849.8,409505.0
260280,201812,1382,931,451,887697.8,430254,1317951.8
260290,201812,6466,3498,2968,3318525.95,2824476,6143001.95
260300,201812,896,788,108,749683.6,102746,852429.6
260310,201812,522,416,106,395485.47,101124,496609.47
260320,201812,887,667,220,636031.2,209880,845911.2
260330,201812,40,31,9,29574,8586,38160
260340,201812,75,54,21,51516,20034,71550
260345,201812,5643,3160,2483,3008636.55,2367743.84,5376380.39
260350,201812,495,361,134,342364.08,127836,470200.08
260360,201812,281,146,135,139284,128761.38,268045.38
260370,201812,681,452,229,427635.6,218462,646097.6
260380,201812,620,446,174,425484,164851.56,590335.56
260390,201812,301,255,46,242191.98,42930,285121.98
260392,201812,102,89,13,84906,12402,97308
260400,201812,4076,2352,1724,2236334.86,1644325.22,3880660.08
260410,201812,14679,7772,6907,7399522.95,6586585.12,13986108.07
260415,201812,123,112,11,106848,10494,117342
260420,201812,1805,1091,714,1035450.04,679788.84,1715238.88
260430,201812,193,175,18,165935.66,17172,183107.66
260440,201812,223,162,61,153824,58194,212018
260450,201812,476,345,131,327845,124974,452819
260460,201812,847,451,396,427584.8,377779.23,805364.03
260470,201812,371,230,141,218656.8,134419,353075.8
260480,201812,221,142,79,135468,75366,210834
260490,201812,219,179,40,170766,38160,208926
260500,201812,1134,768,366,730384.2,348877.8,1079262.0
260510,201812,758,603,155,574308,146916,721224
260515,201812,250,225,25,214650,23373,238023
260520,201812,3345,2012,1333,1912120.52,1269002.62,3181123.14
260530,201812,809,659,150,626193.64,143100,769293.64
260540,201812,564,432,132,412128,124974.72,537102.72
260545,201812,12,9,3,8586,2862,11448
260550,201812,348,218,130,207972,124020,331992
260560,201812,530,402,128,382649.6,121825.8,504475.4
260570,201812,1009,831,178,790055.8,169525.8,959581.6
260580,201812,258,230,28,219420,26712,246132
260590,201812,648,377,271,358246.08,258534,616780.08
260600,201812,8117,4229,3888,4014047.53,3704711.13,7718758.66
260610,201812,497,336,161,320544,153307.8,473851.8
260620,201812,3711,1943,1768,1842152.21,1683786.97,3525939.18
260630,201812,82,79,3,75366,2862,78228
260640,201812,3713,2037,1676,1938962.43,1598847.3,3537809.73
260650,201812,321,233,88,222282,83336.67,305618.67
260660,201812,527,359,168,342104.4,160272,502376.4
260670,201812,103,75,28,71550,26712,98262
260680,201812,3674,2072,1602,1960022.31,1527964.84,3487987.15
260690,201812,125,96,29,91584,27666,119250
260700,201812,334,207,127,196714.8,121158,317872.8
260710,201812,36,33,3,31482,2862,34344
260720,201812,2282,1377,905,1307451.69,861023.16,2168474.85
260730,201812,635,482,153,459828,143767.8,603595.8
260740,201812,58,54,4,51516,3816,55332
260750,201812,643,451,192,429929.64,183168,613097.64
260760,201812,629,341,288,325314,274752,600066
260765,201812,991,523,468,495999.8,446233.5,942233.3
260770,201812,228,173,55,165042,52470,217512
260775,201812,821,489,332,465123.8,316719,781842.8
260780,201812,270,178,92,169812,87768,257580
260790,201812,12239,6763,5476,6426728.29,5217230.65,11643958.94
260795,201812,166,115,51,108546.12,48654,157200.12
260800,201812,289,242,47,230391,44838,275229
260805,201812,176,113,63,107073.14,60102,167175.14
260810,201812,738,647,91,615988.26,86814,702802.26
260820,201812,315,210,105,199577.6,100170,299747.6
260825,201812,202,140,62,133386.57,59148,192534.57
260830,201812,272,173,99,165042,94446,259488
260840,201812,237,174,63,165329,60102,225431
260845,201812,212,143,69,136422,65826,202248
260850,201812,507,373,134,354178.09,127836,482014.09
260860,201812,255,190,65,181062.34,62010,243072.34
260870,201812,375,276,99,262351,94446,356797
260875,201812,727,518,209,493058.69,199386,692444.69
260880,201812,1624,1007,617,959005.29,588427.2,1547432.49
260890,201812,2429,1717,712,1632563.82,678008.8,2310572.62
260900,201812,1028,711,317,676991.79,302418,979409.79
260910,201812,277,217,60,207018,57240,264258
260915,201812,314,217,97,207018,92538,299556
260920,201812,178,100,78,95400,74412,169812
260930,201812,397,343,54,327179.38,51430.45,378609.83
260940,201812,2913,1601,1312,1523445.89,1250865.92,2774311.81
260950,201812,2059,1199,860,1137493.82,820440,1957933.82
260960,201812,14100,7343,6757,6974323.29,6438742.23,13413065.52
260970,201812,440,380,60,361540.2,57240,418780.2
260980,201812,193,170,23,161893.8,21942,183835.8
260990,201812,2606,2137,469,2036157.94,446472,2482629.94
261000,201812,4375,2597,1778,2466628.12,1694424.05,4161052.17
261010,201812,179,135,44,128790,41976,170766
261020,201812,615,463,152,441559,145008,586567
261030,201812,225,168,57,160257.69,54129.96,214387.65
261040,201812,366,324,42,309096,39781.8,348877.8
261050,201812,489,428,61,408312,58194,466506
261060,201812,1343,892,451,848822.75,430254,1279076.75
261070,201812,8985,4587,4398,4349892.68,4189081.94,8538974.62
261080,201812,392,297,95,282566,90630,373196
261090,201812,2282,1744,538,1655196.05,511526.9,2166722.95
261100,201812,1100,766,334,728713.8,317052.36,1045766.16
261110,201812,8341,5121,3220,4880413.86,3068926.09,7949339.95
261120,201812,269,227,42,216558,40063.23,256621.23
261130,201812,577,340,237,323836.1,225908,549744.1
261140,201812,190,124,66,118296,62964,181260
261150,201812,685,417,268,397340,255672,653012
261153,201812,74,70,4,65826.31,3816,69642.31
261160,201812,77810,39260,38550,37334838.51,36753100.86,74087939.37
261170,201812,455,345,110,328500.36,104940,433440.36
261180,201812,1812,1117,695,1060495.62,663030,1723525.62
261190,201812,617,432,185,411500.8,176481,587981.8
261200,201812,221,191,30,181496.3,28620,210116.3
261210,201812,33,29,4,27666,3816,31482
261220,201812,2652,1871,781,1778477.48,744487.8,2522965.28
261230,201812,337,248,89,236592,84891.69,321483.69
261240,201812,462,399,63,376632.95,60102,436734.95
261245,201812,232,194,38,185076,36252,221328
261247,201812,165,129,36,123066,34344,157410
261250,201812,2892,1474,1418,1405128.26,1352199.6,2757327.86
261255,201812,257,231,26,220374,24804,245178
261260,201812,874,756,118,721224,112572,833796
261270,201812,181,137,44,130698,41976,172674
261280,201812,175,147,28,140238,26712,166950
261290,201812,129,91,38,86575.5,36252,122827.5
261300,201812,1256,902,354,860508,337716,1198224
261310,201812,777,521,256,496175.8,243603.9,739779.7
261320,201812,567,382,185,364428,176490,540918
261330,201812,977,754,223,716317.5,211896.46,928213.96
261340,201812,300,169,131,161226,124974,286200
261350,201812,824,587,237,559044.2,226098,785142.2
261360,201812,1259,823,436,784740.37,415944,1200684.37
261370,201812,4997,3075,1922,2918792.33,1830656.91,4749449.24
261380,201812,577,427,150,405459.64,142814,548273.64
261390,201812,3525,2359,1166,2245573.28,1109127.5,3354700.78
261400,201812,283,257,26,244605.6,24804,269409.6
261410,201812,1100,737,363,703098,346297.23,1049395.23
261420,201812,881,554,327,527249.26,311939.46,839188.72
261430,201812,332,299,33,284400,31195.8,315595.8
261440,201812,124,113,11,107802,10494,118296
261450,201812,2529,2088,441,1989292.24,420466.04,2409758.28
261460,201812,745,596,149,567630.02,142146,709776.02
261470,201812,257,197,60,186841.8,57201.84,244043.64
261480,201812,381,302,79,287155,75362,362517
261485,201812,346,213,133,202534.2,126882,329416.2
261500,201812,627,422,205,402588,195570,598158
261510,201812,49,33,16,31482,15264,46746
261520,201812,111,98,13,93492,12402,105894
261530,201812,4178,2654,1524,2523567.3,1451632.07,3975199.37
261540,201812,1136,700,436,667336.36,415944,1083280.36
261550,201812,289,146,143,138188,136402.92,274590.92
261560,201812,818,546,272,518500.2,258334.6,776834.8
261570,201812,389,306,83,291924,79182,371106
261580,201812,385,299,86,284482,82044,366526
261590,201812,199,162,37,154548,35298,189846
261600,201812,303,242,61,230105,57717,287822
261610,201812,105,93,12,88320.33,11448,99768.33
261618,201812,65,51,14,48654,13356,62010
261620,201812,206,128,78,122112,74412,196524
261630,201812,583,453,130,429801.6,124020,553821.6
261640,201812,6443,3434,3009,3267720.59,2866800.4,6134520.99
261650,201812,506,324,182,308418.66,173628,482046.66
270010,201812,541,479,62,456680,58385,515065
270020,201812,304,241,63,229910,60102,290012
270030,201812,9285,5983,3302,5688188.48,3145685.97,8833874.45
270040,201812,2035,1259,776,1200790.26,739063.8,1939854.06
270050,201812,174,127,47,121158,44838,165996
270060,201812,114,65,49,62010,46746,108756
270070,201812,901,657,244,625254.62,232471.26,857725.88
270080,201812,38,32,6,30528,5724,36252
270090,201812,20,16,4,15264,3816,19080
270100,201812,1241,826,415,786931.29,393763.7,1180694.99
270110,201812,144,108,36,103032,34344,137376
270120,201812,227,187,40,177644,38160,215804
270130,201812,250,173,77,164755.8,73458,238213.8
270135,201812,101,61,40,58194,38160,96354
270140,201812,1338,819,519,780294.37,494163.2,1274457.57
270150,201812,266,211,55,201294,52470,253764
270160,201812,529,394,135,375876,128122.2,503998.2
270170,201812,770,500,270,475855.2,256339.8,732195.0
270180,201812,74,58,16,55014.04,15054.12,70068.16
270190,201812,99,88,11,83952,10494,94446
270200,201812,108,97,11,92347.2,10494,102841.2
270210,201812,481,255,226,243270,215317.8,458587.8
270220,201812,185,144,41,137376,39114,176490
270230,201812,2127,1290,837,1225297.31,797430.14,2022727.45
270235,201812,727,553,174,526404.11,165836.06,692240.17
270240,201812,3131,2455,676,2328989.15,642112,2971101.15
270250,201812,172,122,50,116388,47700,164088
270255,201812,223,192,31,183168,29192.4,212360.4
270260,201812,350,278,72,265212,68688,333900
270270,201812,109,47,62,44829,59148,103977
270280,201812,226,136,90,129744,85840.92,215584.92
270290,201812,1206,921,285,877398.42,271013.46,1148411.88
270300,201812,294,192,102,183168,97021.8,280189.8
270310,201812,912,735,177,698875.17,168153.12,867028.29
270320,201812,888,759,129,722796.8,122779.8,845576.6
270330,201812,281,236,45,224190,42930,267120
270340,201812,63,51,12,48654,11448,60102
270350,201812,92,47,45,44599.5,42930,87529.5
270360,201812,70,39,31,37206,29574,66780
270370,201812,56,44,12,41976,11448,53424
270375,201812,69,43,26,41022,24804,65826
270380,201812,1045,611,434,581940,414036,995976
270390,201812,190,110,80,104940,76320,181260
270400,201812,713,524,189,498681.27,180306,678987.27
270410,201812,701,508,193,484314.04,184112.46,668426.50
270420,201812,412,274,138,259698,131576.92,391274.92
270430,201812,33269,23883,9386,22723883.36,8946771.33,31670654.69
270440,201812,498,390,108,372060,102745.8,474805.8
270450,201812,785,421,364,400798.29,346302.66,747100.95
270460,201812,196,153,43,145962,41022,186984
270470,201812,1431,959,472,914227.41,450288,1364515.41
270480,201812,543,444,99,421286.8,93730.5,515017.3
270490,201812,25,20,5,19080,4770,23850
270500,201812,515,425,90,405450,85860,491310
270510,201812,749,461,288,439794,274752,714546
270520,201812,347,216,131,205855,124974,330829
270530,201812,65,58,7,54950.4,6678,61628.4
270540,201812,121,92,29,87768,27666,115434
270550,201812,1731,1311,420,1250371.18,400193.46,1650564.64
270560,201812,306,148,158,141192,150732,291924
270570,201812,485,332,153,314803.56,145762.05,460565.61
270580,201812,86,65,21,62010,20034,82044
270590,201812,72,58,14,55332,13356,68688
270600,201812,180,146,34,139284,32436,171720
270610,201812,204,171,33,163125,31482,194607
270620,201812,30,29,1,27666,954,28620
270630,201812,3917,2993,924,2842672.84,879331.42,3722004.26
270640,201812,906,667,239,634514.6,227691.8,862206.4
270642,201812,220,185,35,176490,33390,209880
270644,201812,262,179,83,170575.74,79177.23,249752.97
270650,201812,287,168,119,160272,113526,273798
270660,201812,255,208,47,198432,44838,243270
270670,201812,3165,2413,752,2292401.16,714604.52,3007005.68
270680,201812,468,271,197,258525,187933.23,446458.23
270690,201812,1147,730,417,694667.88,397808.46,1092476.34
270700,201812,36,27,9,25758,8586,34344
270710,201812,905,687,218,653977,207972,861949
270720,201812,260,199,61,189846,57907.8,247753.8
270730,201812,1960,1150,810,1094216.41,770443.4,1864659.81
270740,201812,44,27,17,25758,16218,41976
270750,201812,667,489,178,466316,169145,635461
270760,201812,304,218,86,207972,82044,290016
270770,201812,2832,1816,1016,1725839.08,968291,2694130.08
270780,201812,88,55,33,52465.23,31464.46,83929.69
270790,201812,258,172,86,164088,82044,246132
270800,201812,1996,1603,393,1527469.25,373162.83,1900632.08
270810,201812,295,237,58,226083.69,55323.23,281406.92
270820,201812,159,105,54,100170,51421,151591
270830,201812,892,646,246,615512.23,234394,849906.23
270840,201812,1429,1063,366,1013362.9,347496,1360858.9
270850,201812,1639,1001,638,947647.56,608633.46,1556281.02
270860,201812,2520,1643,877,1565740.76,833188.17,2398928.93
270870,201812,126,70,56,66780,53424,120204
270880,201812,925,696,229,663093.14,217600.58,880693.72
270890,201812,332,241,91,229570.56,86809.23,316379.79
270895,201812,71,61,10,58194,9540,67734
270900,201812,100,77,23,73458,21942,95400
270910,201812,323,253,70,240217.2,66780,306997.2
270915,201812,1906,1169,737,1110110.17,700752.94,1810863.11
270920,201812,495,418,77,397849.8,73458,471307.8
270930,201812,6203,4539,1664,4324610.84,1584857.09,5909467.93
270940,201812,2392,1824,568,1737840.68,540900,2278740.68
280010,201812,43,38,5,36252,4770,41022
280020,201812,731,632,99,600034.13,93492,693526.13
280030,201812,20239,13115,7124,12425146.47,6765776.39,19190922.86
280040,201812,340,221,119,210834,112095,322929
280050,201812,389,301,88,286867.8,83952,370819.8
280060,201812,340,229,111,216002.63,105894,321896.63
280067,201812,985,696,289,662042,274752.25,936794.25
280070,201812,134,112,22,106848,20988,127836
280100,201812,616,487,129,461185.87,122876,584061.87
280110,201812,79,74,5,70596,4770,75366
280120,201812,626,501,125,477954,119250,597204
280130,201812,1439,914,525,870525.8,500706.9,1371232.7
280140,201812,485,396,89,376830,83952,460782
280150,201812,355,260,95,246406.09,90630,337036.09
280160,201812,96,84,12,80136,11448,91584
280170,201812,432,283,149,268785.56,142146,410931.56
280190,201812,27,25,2,23850,1908,25758
280200,201812,29,23,6,21942,5724,27666
280210,201812,2833,2021,812,1909459.71,769230.88,2678690.59
280220,201812,42,32,10,30528,9540,40068
280230,201812,330,275,55,261515.63,52470,313985.63
280240,201812,117,111,6,105750.9,5724,111474.9
280250,201812,18,12,6,11448,5724,17172
280260,201812,84,74,10,70596,9540,80136
280270,201812,160,124,36,118296,34344,152640
280280,201812,195,127,68,121158,64872,186030
280290,201812,3198,2317,881,2198835.58,839354.05,3038189.63
280300,201812,1614,1236,378,1175266.19,360612,1535878.19
280310,201812,107,103,4,97861.29,3816,101677.29
280320,201812,667,458,209,436932,199386,636318
280330,201812,367,265,102,252810,97183.98,349993.98
280340,201812,420,338,82,321737,77465,399202
280350,201812,3592,2794,798,2654126.19,758553.51,3412679.70
280360,201812,453,286,167,272844,158364,431208
280370,201812,101,90,11,85860,10494,96354
280380,201812,53,40,13,38160,12402,50562
280390,201812,184,156,28,148824,26712,175536
280400,201812,343,235,108,223284.1,103032,326316.1
280410,201812,290,236,54,224191,51516,275707
280420,201812,171,143,28,136422,26712,163134
280430,201812,112,86,26,82044,24695.63,106739.63
280440,201812,699,542,157,513063.2,149577.66,662640.86
280445,201812,119,111,8,105894,7632,113526
280450,201812,1159,995,164,945835.46,156456,1102291.46
280460,201812,760,560,200,526616.81,190800,717416.81
280470,201812,192,177,15,168858,13357,182215
280480,201812,2394,1706,688,1611150.29,654027.89,2265178.18
280490,201812,350,322,28,306082,26712,332794
280500,201812,42,38,4,36252,3816,40068
280510,201812,143,112,31,106547.2,29288,135835.2
280520,201812,57,43,14,41022,13356,54378
280530,201812,76,50,26,47700,24804,72504
280540,201812,527,427,100,406268.84,95113.8,501382.64
280550,201812,739,678,61,645056.2,58194,703250.2
280560,201812,503,438,65,415133.1,62010,477143.1
280570,201812,1810,1382,428,1313823.04,407456.83,1721279.87
280580,201812,609,470,139,446946.6,132511,579457.6
280590,201812,169,109,60,103986,57240,161226
280600,201812,377,318,59,303372,56286,359658
280610,201812,133,99,34,94446,32436,126882
280620,201812,547,454,93,431399.5,88578.9,519978.4
280630,201812,165,137,28,130698,26712,157410
280640,201812,200,162,38,153719,36252,189971
280650,201812,78,54,24,51516,22896,74412
280660,201812,141,102,39,97308,36967.5,134275.5
280670,201812,1760,1118,642,1056781.15,608087.95,1664869.10
280680,201812,182,155,27,145514.14,25758,171272.14
280690,201812,59,50,9,47700,8586,56286
280700,201812,20,20,0,19080,0,19080
280710,201812,1451,1115,336,1053911.95,320544,1374455.95
280720,201812,117,80,37,73554.34,35298,108852.34
280730,201812,26,22,4,20988,3816,24804
280740,201812,2474,1835,639,1743576.79,608786.46,2352363.25
280750,201812,227,201,26,191754,24804,216558
280760,201812,677,462,215,440557.2,205110,645667.2
290010,201812,203,137,66,130698,62964,193662
290020,201812,177,163,14,155502,13356,168858
290030,201812,600,394,206,374635.8,196524,571159.8
290035,201812,136,112,24,104359.2,22896,127255.2
290040,201812,285,180,105,171720,100170,271890
290050,201812,80,61,19,58194,18126,76320
290060,201812,266,122,144,116101.8,137376,253477.8
290070,201812,5645,2803,2842,2666372.27,2708079.9,5374452.17
290080,201812,495,222,273,211425.64,260423,471848.64
290090,201812,392,173,219,165042,208926,373968
290100,201812,1629,1082,547,1028176.2,521265.8,1549442.0
290110,201812,813,488,325,462967.48,309516.53,772484.01
290115,201812,206,188,18,178398,17172,195570
290120,201812,771,502,269,478240.2,256626,734866.2
290130,201812,425,254,171,242020.26,163134,405154.26
290135,201812,302,227,75,215880.66,71550,287430.66
290140,201812,306,257,49,245178,46746,291924
290150,201812,131,98,33,93464,31482,124946
290160,201812,249,188,61,178112.58,58194,236306.58
290170,201812,89,64,25,61056,23850,84906
290180,201812,166,130,36,124020,34344,158364
290190,201812,443,365,78,347924,74125.8,422049.8
290195,201812,307,187,120,178398,114480,292878
290200,201812,281,233,48,222282,45792,268074
290205,201812,148,92,56,87768,53424,141192
290210,201812,1149,833,316,793538.2,301464,1095002.2
290220,201812,228,128,100,121635,95400,217035
290225,201812,288,111,177,105894,168858,274752
290230,201812,63,41,22,39114,20988,60102
290240,201812,310,120,190,114480,181260,295740
290250,201812,266,245,21,233034,20034,253068
290260,201812,302,244,58,231727,55332,287059
290265,201812,188,157,31,148961,29574,178535
290270,201812,1412,1168,244,1113080.2,231626.71,1344706.91
290280,201812,470,342,128,325521.01,122112,447633.01
290290,201812,1265,746,519,705035.98,495126,1200161.98
290300,201812,455,385,70,366999.23,66780,433779.23
290310,201812,311,139,172,132606,164088,296694
290320,201812,4044,2519,1525,2399388.95,1453038.2,3852427.15
290323,201812,184,160,24,152640,22896,175536
290327,201812,164,129,35,122794.11,33390,156184.11
290330,201812,90,50,40,47700,38160,85860
290340,201812,910,365,545,346569.2,519644,866213.2
290350,201812,606,363,243,346302,231822,578124
290360,201812,372,278,94,264258.81,89676,353934.81
290370,201812,908,373,535,355842,510376,866218
290380,201812,312,192,120,183168,114480,297648
290390,201812,2498,1566,932,1490087.38,887220,2377307.38
290395,201812,249,142,107,134943.8,102078,237021.8
290400,201812,286,210,76,200054,72504,272558
290405,201812,248,219,29,208926,27666,236592
290410,201812,594,508,86,481627.64,82044,563671.64
290420,201812,242,191,51,182214,48654,230868
290430,201812,491,311,180,296694,171720,468414
290440,201812,74,65,9,62010,8586,70596
290450,201812,237,183,54,174582,51516,226098
290460,201812,1911,1150,761,1095231.8,725517.52,1820749.32
290470,201812,1433,607,826,577958.22,787689.36,1365647.58
290475,201812,588,550,38,523833,36252,560085
290480,201812,291,165,126,157410,120204,277614
290485,201812,236,222,14,211788,13356,225144
290490,201812,1193,862,331,822348,314820.2,1137168.2
290500,201812,711,363,348,345062,331992,677054
290510,201812,221,170,51,162180,48654,210834
290515,201812,141,85,56,81090,53424,134514
290520,201812,1438,946,492,899623.38,465171.62,1364795.00
290530,201812,314,287,27,273798,25758,299556
290540,201812,103,57,46,54378,43884,98262
290550,201812,152,127,25,121158,23783.22,144941.22
290560,201812,3306,1391,1915,1326002.76,1826286.49,3152289.25
290570,201812,6108,3110,2998,2963187.21,2855986.18,5819173.39
290580,201812,1264,757,507,720937.8,482962.5,1203900.3
290590,201812,558,459,99,437123,94446,531569
290600,201812,1765,1217,548,1156507.85,522763.38,1679271.23
290610,201812,220,198,22,188673,20988,209661
290620,201812,342,305,37,290970,35298,326268
290630,201812,2059,890,1169,846866.69,1111062.02,1957928.71
290640,201812,151,124,27,118296,25758,144054
290650,201812,1716,816,900,777501,858600,1636101
290660,201812,283,231,52,220374,49608,269982
290670,201812,1025,524,501,499324,477608.38,976932.38
290680,201812,1223,982,241,935587.8,228960,1164547.8
290682,201812,291,215,76,204799.3,72485.46,277284.76
290685,201812,236,153,83,145008,79182,224190
290687,201812,972,628,344,596596.1,328176,924772.1
290689,201812,135,75,60,71536,57225.69,128761.69
290690,201812,639,265,374,252781.92,355916.8,608698.72
290700,201812,246,121,125,115434,119250,234684
290710,201812,708,479,229,456966,218466,675432
290720,201812,1042,845,197,805975,187175,993150
290730,201812,1157,669,488,636258.24,464502.6,1100760.84
290740,201812,15,13,2,12402,1908,14310
290750,201812,1389,644,745,612463.23,707379.45,1319842.68
290755,201812,72,64,8,61056,7145.46,68201.46
290760,201812,305,264,41,251856,39114,290970
290770,201812,192,180,12,171710.46,11162,182872.46
290780,201812,1026,815,211,776520.46,199481.4,976001.86
290790,201812,378,265,113,252810,107802,360612
290800,201812,2630,1062,1568,1010501.04,1495051.56,2505552.60
290810,201812,451,317,134,302132,127836,429968
290820,201812,396,240,156,227992,148824,376816
290830,201812,409,288,121,274752,115434,390186
290840,201812,1735,1074,661,1022450.8,628514.48,1650965.28
290850,201812,783,434,349,414036,331992,746028
290860,201812,642,292,350,278568,333614,612182
290870,201812,651,465,186,442311.6,177368,619679.6
290880,201812,124,70,54,66780,51516,118296
290890,201812,339,242,97,230868,92538,323406
290900,201812,171,129,42,123066,40068,163134
290910,201812,373,283,90,269982,85860,355842
290920,201812,229,194,35,185076,33390,218466
290930,201812,842,641,201,611228,191735,802963
290940,201812,250,209,41,198622.8,39114,237736.8
290950,201812,171,100,71,95400,67734,163134
290960,201812,457,313,144,297362.24,137089.8,434452.04
290970,201812,254,225,29,214459.2,27666,242125.2
290980,201812,1534,1085,449,1030921.76,427297.2,1458218.96
290990,201812,393,328,65,312893.46,61954.38,374847.84
291000,201812,860,249,611,236742.06,582894,819636.06
291005,201812,2243,981,1262,933813.76,1202217.03,2136030.79
291010,201812,153,138,15,131652,14310,145962
291020,201812,102,80,22,76320,20988,97308
291030,201812,99,72,27,68688,25758,94446
291040,201812,576,298,278,284292,265212,549504
291050,201812,1376,768,608,731313.43,580032,1311345.43
291060,201812,1511,839,672,799070.4,641088,1440158.4
291070,201812,1946,1444,502,1371436.53,477647.5,1849084.03
291072,201812,7412,2752,4660,2622058.43,4442884.42,7064942.85
291075,201812,214,173,41,164565,39114,203679
291077,201812,52,35,17,33390,16218,49608
291080,201812,19997,8880,11117,8445534.32,10593525.23,19039059.55
291085,201812,298,241,57,229914,54373.23,284287.23
291090,201812,301,116,185,110378,176480.46,286858.46
291100,201812,664,194,470,185076,448380,633456
291110,201812,404,305,99,290950.92,94446,385396.92
291120,201812,2512,1225,1287,1168507,1225829.26,2394336.26
291125,201812,59,30,29,28620,27666,56286
291130,201812,215,191,24,182214,22896,205110
291140,201812,142,108,34,103032,32150,135182
291150,201812,369,148,221,141192,210834,352026
291160,201812,376,312,64,296694.5,61056,357750.5
291165,201812,26,22,4,20988,3816,24804
291170,201812,3048,1537,1511,1462339.31,1437924.8,2900264.11
291180,201812,1311,512,799,488251.38,762131.76,1250383.14
291185,201812,79,77,2,73458,1908,75366
291190,201812,1294,570,724,541523.13,689866.8,1231389.93
291200,201812,165,126,39,120204,37206,157410
291210,201812,2233,898,1335,853384.21,1271778.14,2125162.35
291220,201812,271,202,69,191754.64,65826,257580.64
291230,201812,1026,356,670,338766,639180,977946
291240,201812,436,413,23,392762,21942,414704
291250,201812,443,364,79,347256,75366,422622
291260,201812,52,39,13,37206,12402,49608
291270,201812,1210,492,718,469368,684685.8,1154053.8
291280,201812,368,172,196,163596.89,186974.46,350571.35
291290,201812,1761,905,856,861939.2,815862,1677801.2
291300,201812,230,180,50,171052.2,47700,218752.2
291310,201812,231,207,24,197478,22896,220374
291320,201812,1406,1008,398,958770,378643.29,1337413.29
291330,201812,134,115,19,107778.81,18126,125904.81
291340,201812,171,95,76,90630,72504,163134
291345,201812,137,93,44,88722,41976,130698
291350,201812,1591,533,1058,508291.2,1009141.3,1517432.5
291360,201812,8573,4266,4307,4058180.7,4104912.55,8163093.25
291370,201812,1134,637,497,607412,474129,1081541
291380,201812,261,205,56,195570,53137.8,248707.8
291390,201812,3873,1726,2147,1641408.23,2046139.8,3687548.03
291400,201812,2101,1506,595,1434816,565661.86,2000477.86
291410,201812,157,137,20,129744,19080,148824
291420,201812,119,88,31,83952,29574,113526
291430,201812,162,91,71,86107,66780.53,152887.53
291440,201812,506,407,99,386221.8,94446,480667.8
291450,201812,909,571,338,542255.48,321211.8,863467.28
291460,201812,1804,1464,340,1394891.1,324360,1719251.1
291465,201812,2222,1045,1177,996069.41,1122547.52,2118616.93
291470,201812,2830,1440,1390,1369821.83,1325330,2695151.83
291480,201812,11833,5266,6567,5013574.69,6256339.43,11269914.12
291490,201812,565,241,324,229914,308809.8,538723.8
291500,201812,371,206,165,196524,157410,353934
291510,201812,1236,480,756,456758.99,720937.8,1177696.79
291520,201812,962,439,523,418655.94,498932.46,917588.40
291530,201812,999,278,721,265212,687528.72,952740.72
291535,201812,118,101,17,96354,16218,112572
291540,201812,358,106,252,101124,239454.6,340578.6
291550,201812,1203,571,632,543114.1,602633,1145747.1
291560,201812,5471,2790,2681,2649651.33,2546890.22,5196541.55
291570,201812,203,102,101,97308,96354,193662
291580,201812,1247,763,484,727326.46,461731.23,1189057.69
291590,201812,87,36,51,34150.9,48654,82804.9
291600,201812,1376,649,727,618192,693540,1311732
291610,201812,1458,680,778,647436.87,742184,1389620.87
291620,201812,571,265,306,252810,291542.4,544352.4
291630,201812,489,162,327,154548,311958,466506
291640,201812,3922,1964,1958,1863676.86,1866298.06,3729974.92
291650,201812,422,284,138,269983,130852.73,400835.73
291660,201812,420,169,251,160533.96,238356.9,398890.86
291670,201812,226,144,82,136804,78228,215032
291680,201812,687,391,296,373014,282279.46,655293.46
291685,201812,600,331,269,315536,256435.2,571971.2
291690,201812,583,306,277,291924,263295,555219
291700,201812,953,753,200,717632.19,189846,907478.19
291710,201812,1690,794,896,756818.24,853907.06,1610725.30
291720,201812,400,265,135,252805.23,128790,381595.23
291730,201812,946,556,390,528563.9,372050.46,900614.36
291733,201812,269,186,83,177157.8,79182,256339.8
291735,201812,68,53,15,50562,14310,64872
291740,201812,351,271,80,258534,76320,334854
291750,201812,2021,1338,683,1269060.28,650760,1919820.28
291760,201812,3064,1691,1373,1607251.6,1307457,2914708.6
291770,201812,807,541,266,514015.26,253764,767779.26
291780,201812,45,27,18,25758,17172,42930
291790,201812,167,81,86,77274,82044,159318
291800,201812,10108,4169,5939,3967387.74,5661956.75,9629344.49
291810,201812,1138,826,312,787431.8,297648,1085079.8
291820,201812,270,192,78,183168,74412,257580
291830,201812,1103,430,673,408831,641079,1049910
291835,201812,599,552,47,526478,44838,571316
291840,201812,4795,2481,2314,2361119.63,2206058.76,4567178.39
291845,201812,287,98,189,93492,180277.38,273769.38
291850,201812,332,293,39,279283.5,37206,316489.5
291855,201812,261,106,155,101124,147870,248994
291860,201812,175,109,66,103032,62964,165996
291870,201812,83,33,50,31482,47700,79182
291875,201812,188,173,15,165042,14310,179352
291880,201812,486,382,104,363618,99216,462834
291890,201812,247,81,166,77264.46,156933.2,234197.66
291900,201812,57,32,25,30528,23850,54378
291905,201812,133,95,38,90344,36252,126596
291910,201812,173,141,32,134514,30528,165042
291915,201812,413,369,44,350358,41976,392334
291920,201812,5020,2603,2417,2480001.61,2304881.86,4784883.47
291930,201812,181,107,74,102078,70596,172674
291940,201812,332,185,147,176013,139284,315297
291950,201812,1152,936,216,892181,206064,1098245
291955,201812,1130,679,451,647558.99,430111,1077669.99
291960,201812,185,130,55,124020,52183.8,176203.8
291970,201812,774,585,189,558090,180306,738396
291980,201812,1522,1348,174,1281943.66,164756.4,1446700.06
291990,201812,132,122,10,116388,9540,125928
291992,201812,176,93,83,87958.8,79182,167140.8
291995,201812,149,101,48,96354,45792,142146
292000,201812,385,295,90,279860.59,85860,365720.59
292010,201812,292,206,86,195570.8,81090,276660.8
292020,201812,283,205,78,195570,74412,269982
292030,201812,141,110,31,104940,29574,134514
292040,201812,636,323,313,308142,298602,606744
292045,201812,97,88,9,83952,8586,92538
292050,201812,931,667,264,635308.67,251570,886878.67
292060,201812,942,776,166,738397.28,158364,896761.28
292070,201812,48,20,28,19080,26712,45792
292080,201812,131,89,42,84906,40068,124974
292090,201812,509,185,324,176299.2,309096,485395.2
292100,201812,1434,633,801,602308.7,763172.72,1365481.42
292105,201812,209,180,29,171720,27666,199386
292110,201812,2137,795,1342,758110.72,1278687.6,2036798.32
292120,201812,669,527,142,501625.79,135468,637093.79
292130,201812,445,258,187,246132,178398,424530
292140,201812,199,157,42,149778,39269.26,189047.26
292145,201812,166,87,79,82712,75323.07,158035.07
292150,201812,1462,1176,286,1121904,271529.96,1393433.96
292160,201812,177,143,34,136135.8,32436,168571.8
292170,201812,1209,1061,148,1010011.96,141134.76,1151146.72
292180,201812,209,152,57,145008,54378,199386
292190,201812,158,95,63,90630,60102,150732
292200,201812,1304,476,828,453151.71,789282.44,1242434.15
292205,201812,124,110,14,104940,13356,118296
292210,201812,372,263,109,249519,103270.5,352789.5
292220,201812,21,16,5,15264,4770,20034
292225,201812,39,34,5,32436,4770,37206
292230,201812,965,773,192,735888.23,183168,919056.23
292240,201812,622,454,168,432019,160272,592291
292250,201812,1729,1109,620,1057986,591194,1649180
292260,201812,440,256,184,244224,174772.8,418996.8
292265,201812,254,178,76,169812,72504,242316
292270,201812,757,341,416,325314,395910.8,721224.8
292273,201812,208,118,90,111794.49,85860,197654.49
292275,201812,177,92,85,87768,80803.8,168571.8
292280,201812,139,99,40,94446,38160,132606
292285,201812,67,57,10,53710.2,9540,63250.2
292290,201812,575,389,186,368721.41,177158,545879.41
292300,201812,1647,636,1011,606458,963660.58,1570118.58
292303,201812,102,70,32,66780,30528,97308
292305,201812,112,80,32,76320,30528,106848
292310,201812,833,547,286,521476,271736.15,793212.15
292320,201812,671,509,162,485395.2,154548,639943.2
292330,201812,185,101,84,96354,80136,176490
292335,201812,280,220,60,209880,57240,267120
292340,201812,585,410,175,390400.85,166950,557350.85
292350,201812,270,145,125,137519.1,118963.8,256482.9
292360,201812,711,542,169,513634.68,161226,674860.68
292370,201812,759,581,178,554274,169812,724086
292380,201812,654,510,144,484870.92,137376,622246.92
292390,201812,501,197,304,187938,289062.4,477000.4
292400,201812,3456,2145,1311,2028917.68,1246813,3275730.68
292405,201812,269,178,91,169335,86527.8,255862.8
292410,201812,146,88,58,83952,55332,139284
292420,201812,301,258,43,245845.8,41022,286867.8
292430,201812,537,420,117,400680,111141,511821
292440,201812,595,510,85,485986.8,80803.8,566790.6
292450,201812,262,201,61,191754,58194,249948
292460,201812,581,434,147,412319.34,140142.6,552461.94
292465,201812,216,178,38,169482.02,35514.09,204996.11
292467,201812,111,67,44,63918,41976,105894
292470,201812,268,182,86,173628,82044,255672
292480,201812,347,233,114,221328.5,108470,329798.5
292490,201812,228,153,75,145962,71550,217512
292500,201812,1138,498,640,474881,610388.28,1085269.28
292510,201812,3389,1538,1851,1466298.12,1762983.6,3229281.72
292520,201812,1094,529,565,502801.7,539001,1041802.7
292525,201812,385,275,110,262345.23,104940,367285.23
292530,201812,4229,1736,2493,1653456.04,2376274.76,4029730.80
292540,201812,468,251,217,239454,207018,446472
292550,201812,1060,579,481,551624.74,458341.18,1009965.92
292560,201812,322,303,19,289062,18126,307188
292570,201812,304,233,71,222282,67734,290016
292575,201812,470,303,167,288776,159318,448094
292580,201812,960,621,339,591289.2,323120,914409.2
292590,201812,545,468,77,446169.59,73458,519627.59
292593,201812,143,113,30,107802,28620,136422
292595,201812,185,143,42,136422,40068,176490
292600,201812,1265,934,331,889989.19,315106.2,1205095.39
292610,201812,133,104,29,99216,27408.42,126624.42
292620,201812,532,443,89,422327,84906,507233
292630,201812,1389,793,596,754934,566953.14,1321887.14
292640,201812,801,556,245,530090.1,233730,763820.1
292650,201812,183,154,29,146480,27666,174146
292660,201812,2046,1466,580,1393694.03,549122.83,1942816.86
292665,201812,145,105,40,100170,38160,138330
292670,201812,401,324,77,309092,73458,382550
292680,201812,255,196,59,186984,55809,242793
292690,201812,191,146,45,139284,42930,182214
292700,201812,947,629,318,599112.8,303372,902484.8
292710,201812,109,96,13,91584,12402,103986
292720,201812,877,493,384,469520.64,366336,835856.64
292730,201812,205,97,108,91584.5,103032,194616.5
292740,201812,68010,33643,34367,32020091.01,32753959.52,64774050.53
292750,201812,381,272,109,258534.94,103175.57,361710.51
292760,201812,334,273,61,258191.3,58194,316385.3
292770,201812,784,331,453,315488,432162,747650
292780,201812,416,158,258,150218.28,246132,396350.28
292790,201812,746,369,377,352026,359419.5,711445.5
292800,201812,1183,722,461,687834,439507.8,1127341.8
292805,201812,418,122,296,115863.3,282384,398247.3
292810,201812,1477,845,632,805271.8,602928,1408199.8
292820,201812,742,608,134,578124.1,127540.8,705664.9
292830,201812,105,85,20,81090,19080,100170
292840,201812,671,556,115,530234,109695.69,639929.69
292850,201812,133,89,44,84906,41976,126882
292860,201812,2252,1322,930,1256401.94,887220,2143621.94
292870,201812,3477,2340,1137,2229091.95,1084688.46,3313780.41
292880,201812,1484,972,512,923521.86,487256,1410777.86
292890,201812,503,432,71,412100,67734,479834
292895,201812,135,91,44,85455.5,41976,127431.5
292900,201812,390,286,104,272844,99216,372060
292905,201812,460,235,225,224190,214650,438840
292910,201812,426,325,101,309717,96354,406071
292920,201812,545,245,300,233730,286200,519930
292925,201812,501,463,38,441024.66,36233,477257.66
292930,201812,572,355,217,338670,207018,545688
292935,201812,295,128,167,122112,159309,281421
292937,201812,248,167,81,159318,77274,236592
292940,201812,198,154,44,146916,41976,188892
292950,201812,1149,595,554,564531.3,528421,1092952.3
292960,201812,604,415,189,395910,180306,576216
292970,201812,255,181,74,172007,70596,242603
292975,201812,144,83,61,78943.5,58004,136947.5
292980,201812,271,185,86,175660.43,82044,257704.43
292990,201812,1321,984,337,932066.87,320309.93,1252376.80
293000,201812,106,76,30,72504,28620,101124
293010,201812,2757,1664,1093,1581313.32,1039400.51,2620713.83
293015,201812,667,535,132,510390,125289,635679
293020,201812,340,278,62,265212,59148,324360
293030,201812,614,536,78,510772,74412,585184
293040,201812,349,275,74,262350,70596,332946
293050,201812,2764,1627,1137,1543589.48,1080845.38,2624434.86
293060,201812,249,200,49,189613,45792.8,235405.8
293070,201812,3487,1793,1694,1703557.4,1614437.36,3317994.76
293075,201812,92,61,31,58194,29574,87768
293076,201812,70,47,23,44838,21942,66780
293077,201812,471,283,188,266383.31,179352,445735.31
293080,201812,456,410,46,390854,43884,434738
293090,201812,133,116,17,110664,16218,126882
293100,201812,526,371,155,353934,147870,501804
293105,201812,338,237,101,225812,96354,322166
293110,201812,175,124,51,118296,48654,166950
293120,201812,326,219,107,208594,101887.2,310481.2
293130,201812,245,165,80,157410,76320,233730
293135,201812,8017,3203,4814,3048663.75,4583694.74,7632358.49
293140,201812,186,123,63,116102,60102,176204
293150,201812,335,286,49,272081,46746,318827
293160,201812,431,249,182,237546,173628,411174
293170,201812,149,101,48,96354,44934,141288
293180,201812,473,325,148,309764,141192,450956
293190,201812,1341,931,410,883524.23,390854,1274378.23
293200,201812,536,474,62,451497,58337.1,509834.1
293210,201812,369,280,89,266968,84190.5,351158.5
293220,201812,2682,1106,1576,1053190.41,1501357.97,2554548.38
293230,201812,1763,651,1112,619031.8,1060848,1679879.8
293240,201812,224,204,20,194616,19080,213696
293245,201812,113,95,18,90630,17172,107802
293250,201812,732,272,460,259240,438840,698080
293260,201812,315,264,51,250902.17,48654,299556.17
293270,201812,1158,557,601,529470.68,573354,1102824.68
293280,201812,248,141,107,134514,102078,236592
293290,201812,3061,2013,1048,1918757,999779,2918536
293300,201812,726,518,208,491825.5,194998.19,686823.69
293305,201812,154,132,22,125928,20988,146916
293310,201812,142,109,33,103986,31482,135468
293315,201812,157,121,36,115434,34344,149778
293317,201812,94,66,28,62964,26712,89676
293320,201812,976,569,407,541872.5,388278,930150.5
293325,201812,192,69,123,65826,117342,183168
293330,201812,13083,6178,6905,5883627.52,6579546.29,12463173.81
293340,201812,256,186,70,177444,65826,243270
293345,201812,247,195,52,186030,49608,235638
293350,201812,647,358,289,341532,274227.3,615759.3
293360,201812,1588,1132,456,1078974,434451.8,1513425.8
310010,201812,148,76,72,72504,68402,140906
310020,201812,1078,601,477,571255.4,454104.12,1025359.52
310030,201812,334,273,61,259316.88,58194,317510.88
310040,201812,47,29,18,27666,17172,44838
310050,201812,188,124,64,117817.73,60770,178587.73
310060,201812,247,174,73,165519,69642,235161
310070,201812,16,8,8,7632,7632,15264
310080,201812,46,25,21,23850,20034,43884
310090,201812,979,517,462,487304.88,439889.8,927194.68
310100,201812,306,234,72,223236,68688,291924
310110,201812,732,396,336,376462.9,320057.66,696520.56
310120,201812,390,215,175,204156.2,166950,371106.2
310130,201812,33,21,12,20034,11448,31482
310140,201812,23,12,11,11448,10494,21942
310150,201812,1299,887,412,838330.8,392189.8,1230520.6
310160,201812,2110,1077,1033,1019637.73,983097.4,2002735.13
310163,201812,94,54,40,51516,38160,89676
310170,201812,2612,1129,1483,1076274.2,1411635.4,2487909.6
310180,201812,135,50,85,47700,80708.4,128408.4
310190,201812,496,339,157,323406,149205.6,472611.6
310200,201812,499,318,181,303372,172674,476046
310205,201812,56,42,14,40068,13356,53424
310210,201812,284,231,53,220374,50562,270936
310220,201812,60,36,24,34344,22896,57240
310230,201812,272,190,82,181069.2,78228,259297.2
310240,201812,110,96,14,91584,13356,104940
310250,201812,103,83,20,79182,19080,98262
310260,201812,786,427,359,404402.24,341751.42,746153.66
310270,201812,277,184,93,174983,88722,263705
310280,201812,363,274,89,260729,84906,345635
310285,201812,219,156,63,148515.86,60102,208617.86
310290,201812,259,150,109,143100,103986,247086
310300,201812,150,123,27,117342,25758,143100
310310,201812,10,8,2,7632,1908,9540
310320,201812,26,15,11,14310,10494,24804
310330,201812,33,25,8,23850,7632,31482
310340,201812,1753,1154,599,1093857.6,570587.6,1664445.2
310350,201812,2901,1592,1309,1514613.81,1248204.8,2762818.61
310360,201812,41,34,7,32436,6678,39114
310370,201812,128,107,21,102078,19748,121826
310375,201812,112,42,70,40068,66761,106829
310380,201812,51,29,22,27666,20988,48654
310390,201812,97,65,32,62010,30528,92538
310400,201812,2395,1583,812,1506558,774361.8,2280919.8
310410,201812,125,69,56,65826,53424,119250
310420,201812,687,365,322,347352.2,306225.06,653577.26
310430,201812,323,215,108,204871.5,102745.8,307617.3
310440,201812,71,43,28,41022,26712,67734
310445,201812,80,66,14,62964,13356,76320
310450,201812,856,541,315,516114,300510,816624
310460,201812,261,190,71,180497,67734,248231
310470,201812,507,329,178,313866,169812,483678
310480,201812,80,59,21,56286,20034,76320
310490,201812,533,257,276,244224,263304,507528
310500,201812,127,53,74,50562,70596,121158
310510,201812,601,406,195,386084.6,186021,572105.6
310520,201812,132,91,41,86814,39114,125928
310530,201812,95,41,54,39114,51229.8,90343.8
310540,201812,467,287,180,271414.6,171433.8,442848.4
310550,201812,87,56,31,53424,29574,82998
310560,201812,2984,2062,922,1955254.14,877727.7,2832981.84
310570,201812,112,76,36,72504,34344,106848
310590,201812,360,237,123,224429.8,117327.69,341757.49
310600,201812,161,92,69,85336.7,65826,151162.7
310610,201812,61,24,37,22896,35298,58194
310620,201812,47360,22837,24523,21711628.97,23356111.22,45067740.19
310630,201812,629,403,226,381171.2,214459.4,595630.6
310640,201812,143,117,26,111141,24804,135945
310650,201812,165,145,20,138330,19080,157410
310660,201812,90,57,33,54378,31482,85860
310665,201812,60,42,18,40068,17172,57240
310670,201812,6618,2962,3656,2817906.87,3484141.98,6302048.85
310680,201812,59,38,21,36252,20034,56286
310690,201812,601,430,171,403343.16,163134,566477.16
310700,201812,60,39,21,37206,19890.9,57096.9
310710,201812,1257,849,408,809412.5,388659.8,1198072.3
310720,201812,94,29,65,27666,62010,89676
310730,201812,1378,968,410,921278.5,390854,1312132.5
310740,201812,989,556,433,526751.7,412548.26,939299.96
310750,201812,246,145,101,137376.18,96354,233730.18
310760,201812,63,46,17,43884,15932,59816
310770,201812,95,44,51,41976,48654,90630
310780,201812,400,325,75,309468.6,71550,381018.6
310790,201812,97,80,17,76320,16218,92538
310800,201812,450,217,233,206017,221995.8,428012.8
310810,201812,171,121,50,114375.2,46746,161121.2
310820,201812,351,280,71,267120,67734,334854
310825,201812,203,166,37,158364,35298,193662
310830,201812,467,224,243,213035.94,231822,444857.94
310840,201812,377,216,161,206064,153594,359658
310850,201812,109,87,22,82998,20988,103986
310855,201812,394,314,80,299556,76320,375876
310860,201812,1450,1083,367,1027537.3,348382.9,1375920.2
310870,201812,52,41,11,39114,10494,49608
310880,201812,81,64,17,60769.8,16218,76987.8
310890,201812,308,183,125,174582,119250,293832
310900,201812,642,300,342,283626,325962.8,609588.8
310910,201812,242,168,74,158937.2,70596,229533.2
310920,201812,480,286,194,269983.2,185076,455059.2
310925,201812,35,27,8,25758,7346,33104
310930,201812,1082,661,421,630191.33,401538.3,1031729.63
310940,201812,676,349,327,332659.8,311958,644617.8
310945,201812,117,71,46,67734,43884,111618
310950,201812,249,199,50,189846,47700,237546
310960,201812,85,30,55,28620,52466,81086
310970,201812,163,104,59,99216,55999.8,155215.8
310980,201812,46,25,21,23850,20034,43884
310990,201812,149,82,67,77942,63918,141860
311000,201812,850,426,424,402970.49,404487,807457.49
311010,201812,42,34,8,32436,7632,40068
311020,201812,45,29,16,27666,15264,42930
311030,201812,394,238,156,224857.8,148443,373300.8
311040,201812,38,33,5,31482,4770,36252
311050,201812,467,194,273,184504,259869.6,444373.6
311060,201812,765,437,328,414799.6,312626,727425.6
311070,201812,345,163,182,155502,173628,329130
311080,201812,108,58,50,55332,47700,103032
311090,201812,386,183,203,174582,193662,368244
311100,201812,602,360,242,343153.8,230295.6,573449.4
311110,201812,702,490,212,467460,202239,669699
311115,201812,75,54,21,51516,20034,71550
311120,201812,1095,583,512,553270.2,487875.8,1041146.0
311130,201812,401,238,163,226861.2,155502,382363.2
311140,201812,166,89,77,84619.8,72647.1,157266.9
311150,201812,361,236,125,225144,119250,344394
311160,201812,740,534,206,507051.4,196047,703098.4
311170,201812,79,59,20,56286,18793.8,75079.8
311180,201812,349,236,113,224857.8,107516,332373.8
311190,201812,35,17,18,16218,17172,33390
311200,201812,339,239,100,226384.6,95400,321784.6
311205,201812,32,22,10,20988,9540,30528
311210,201812,50,42,8,39782,7632,47414
311220,201812,20,18,2,17172,1908,19080
311230,201812,1641,1077,564,1022424.94,538056,1560480.94
311240,201812,180,115,65,109506.33,62010,171516.33
311250,201812,99,30,69,28620,65826,94446
311260,201812,559,351,208,334854,198432,533286
311265,201812,113,80,33,76320,31482,107802
311270,201812,294,209,85,199386,81090,280476
311280,201812,213,99,114,94446,108183.6,202629.6
311290,201812,111,92,19,87768,17840,105608
311300,201812,573,366,207,349164,197192,546356
311310,201812,26,20,6,19080,5724,24804
311320,201812,672,499,173,475092,165042,640134
311330,201812,1071,793,278,756202.24,264258.4,1020460.64
311340,201812,2692,1910,782,1811220.61,744674.66,2555895.27
311350,201812,273,210,63,200340,60102,260442
311360,201812,180,110,70,104940,66493.8,171433.8
311370,201812,1211,496,715,471476.5,681537.6,1153014.1
311380,201812,7,6,1,5724,954,6678
311390,201812,266,144,122,137376,116197.2,253573.2
311400,201812,154,103,51,98262,48654,146916
311410,201812,100,57,43,54092,41022,95114
311420,201812,306,171,135,161894.8,128790,290684.8
311430,201812,870,573,297,544497.2,283052,827549.2
311440,201812,485,341,144,325314,137089.8,462403.8
311450,201812,327,206,121,196524,115434,311958
311455,201812,301,206,95,196228.8,90630,286858.8
311460,201812,136,58,78,55332,73606.27,128938.27
311470,201812,24,14,10,13356,9540,22896
311480,201812,35,15,20,14310,19080,33390
311490,201812,18,12,6,11448,5724,17172
311500,201812,20,10,10,9540,9540,19080
311510,201812,650,459,191,435657.3,182214,617871.3
311520,201812,43,34,9,31768.2,8586,40354.2
311530,201812,1790,1348,442,1273659.72,421668,1695327.72
311535,201812,73,52,21,49608,20034,69642
311540,201812,36,31,5,29574,4770,34344
311545,201812,193,142,51,135468,48654,184122
311547,201812,34,25,9,23850,8586,32436
311550,201812,693,323,370,307617.3,352961.46,660578.76
311560,201812,43,28,15,26712,14310,41022
311570,201812,294,201,93,191181.6,88722,279903.6
311580,201812,326,193,133,183549.6,126882,310431.6
311590,201812,34,30,4,28620,3816,32436
311600,201812,95,77,18,73458,17172,90630
311610,201812,261,229,32,217512.5,30528,248040.5
311615,201812,111,92,19,87768,17935.2,105703.2
311620,201812,22,12,10,11448,9540,20988
311630,201812,86,72,14,68688,13356,82044
311640,201812,137,72,65,68688,62010,130698
311650,201812,135,98,37,92776.5,35298,128074.5
311660,201812,422,207,215,197478,205110,402588
311670,201812,166,109,57,103741,54378,158119
311680,201812,223,163,60,153927.95,56476.8,210404.75
311690,201812,18,11,7,10494,6678,17172
311700,201812,200,142,58,135181.8,54950.4,190132.2
311710,201812,211,132,79,125928,75366,201294
311720,201812,37,27,10,25472,9540,35012
311730,201812,598,400,198,380324,188892,569216
311740,201812,38,28,10,26712,9540,36252
311750,201812,713,481,232,455727.91,221328,677055.91
311760,201812,62,33,29,31482,27666,59148
311770,201812,398,199,199,186984.82,189846,376830.82
311780,201812,175,97,78,92252,74412,166664
311783,201812,86,76,10,72504,9540,82044
311787,201812,35,14,21,13356,20034,33390
311790,201812,264,126,138,120204,131652,251856
311800,201812,669,453,216,427536,205396.2,632932.2
311810,201812,46,39,7,37206,6678,43884
311820,201812,110,94,16,89676,15264,104940
311830,201812,1983,1255,728,1190026.1,690116.52,1880142.62
311840,201812,1051,580,471,547502.7,446911.54,994414.24
311850,201812,11,7,4,6678,3816,10494
311860,201812,9597,4362,5235,4144615.61,4987117.27,9131732.88
311870,201812,140,77,63,73458,60102,133560
311880,201812,952,709,243,674850.8,231822,906672.8
311890,201812,222,112,110,106848,104940,211788
311900,201812,80,34,46,32436,43884,76320
311910,201812,1425,889,536,844673.1,509245.4,1353918.5
311920,201812,230,152,78,145008,74412,219420
311930,201812,922,520,402,495794,383270,879064
311940,201812,2570,1371,1199,1306027,1140507,2446534
311950,201812,50,36,14,34344,13356,47700
311960,201812,66,48,18,45792,17172,62964
311970,201812,28,18,10,14882.4,9540,24422.4
311980,201812,42,32,10,30241.8,9540,39781.8
311990,201812,52,38,14,36252,13356,49608
311995,201812,64,44,20,41976,19080,61056
312000,201812,35,25,10,23563.8,9540,33103.8
312010,201812,86,65,21,62010,20034,82044
312015,201812,100,75,25,71264,23850,95114
312020,201812,140,90,50,85574,47700,133274
312030,201812,47,38,9,35585,8586,44171
312040,201812,84,53,31,50562,29574,80136
312050,201812,209,116,93,110664,88722,199386
312060,201812,66,40,26,38160,24323.6,62483.6
312070,201812,73,46,27,43884,25758,69642
312080,201812,543,250,293,238500,279522,518022
312083,201812,55,39,16,37206,15264,52470
312087,201812,115,93,22,88722,20988,109710
312090,201812,3102,1830,1272,1733423.9,1211250.95,2944674.85
312100,201812,159,109,50,103480.38,46918,150398.38
312110,201812,117,74,43,70309.8,41022,111331.8
312120,201812,150,113,37,106849,35298,142147
312125,201812,95,52,43,49608,41022,90630
312130,201812,125,83,42,79182,40068,119250
312140,201812,143,110,33,104649,31482,136131
312150,201812,46,36,10,34344,9540,43884
312160,201812,1555,1026,529,973940.2,503540.48,1477480.68
312170,201812,12,10,2,9540,1908,11448
312180,201812,104,65,39,61295,37111,98406
312190,201812,30,26,4,24804,3816,28620
312200,201812,753,649,104,617476.7,99216,716692.7
312210,201812,90,59,31,56286,29574,85860
312220,201812,136,97,39,92300,37206,129506
312230,201812,3668,1801,1867,1714416.58,1779977.58,3494394.16
312235,201812,161,109,52,103986,49608,153594
312240,201812,106,73,33,69642,31482,101124
312245,201812,173,120,53,114476,50562,165038
312247,201812,59,42,17,39305,16218,55523
312250,201812,179,85,94,81090,89676,170766
312260,201812,108,71,37,66876.2,35298,102174.2
312270,201812,138,86,52,82044,49608,131652
312280,201812,27,16,11,15264,10494,25758
312290,201812,158,108,50,103032,46747,149779
312300,201812,201,134,67,127836,63918,191754
312310,201812,58,54,4,51516,3816,55332
312320,201812,445,284,161,269266.5,152020.1,421286.6
312330,201812,87,77,10,72694.8,9253.8,81948.6
312340,201812,37,17,20,16218,19080,35298
312350,201812,18,11,7,10494,6678,17172
312352,201812,102,71,31,67734,29574,97308
312360,201812,563,256,307,243270,292878,536148
312370,201812,311,179,132,170479.8,125356,295835.8
312380,201812,137,93,44,88722,41976,130698
312385,201812,172,139,33,132319.8,31482,163801.8
312390,201812,304,190,114,180592.2,108089,288681.2
312400,201812,384,297,87,283338,82522,365860
312410,201812,919,300,619,285723,590236,875959
312420,201812,620,485,135,461736.2,128790,590526.2
312430,201812,864,644,220,611982.05,209880,821862.05
312440,201812,46,34,12,32436,11448,43884
312450,201812,207,127,80,121158,76320,197478
312460,201812,59,29,30,27666,28620,56286
312470,201812,55,35,20,33390,19080,52470
312480,201812,202,122,80,116388,76320,192708
312490,201812,272,190,82,181260,78228,259488
312500,201812,34,19,15,18126,14310,32436
312510,201812,468,183,285,174582,271274.39,445856.39
312520,201812,43,15,28,14310,26712,41022
312530,201812,51,37,14,35298,13356,48654
312540,201812,102,89,13,84906,12402,97308
312550,201812,40,31,9,29574,8586,38160
312560,201812,217,164,53,156170,50275.8,206445.8
312570,201812,452,268,184,255672,174987.45,430659.45
312580,201812,88,47,41,44838,39114,83952
312590,201812,268,213,55,203202,52470,255672
312595,201812,138,123,15,117342,14310,131652
312600,201812,73,44,29,41547,27666,69213
312610,201812,1647,865,782,818438.98,743071.4,1561510.38
312620,201812,195,140,55,133560,52465.23,186025.23
312630,201812,69,59,10,56286,9540,65826
312640,201812,47,13,34,12402,32436,44838
312650,201812,158,132,26,125642,24804,150446
312660,201812,71,53,18,50419,17172,67591
312670,201812,881,580,301,552366.1,286654.1,839020.2
312675,201812,38,30,8,28620,7632,36252
312680,201812,83,55,28,52088.4,26712,78800.4
312690,201812,240,126,114,120194.46,108660.6,228855.06
312695,201812,37,30,7,28620,6678,35298
312700,201812,223,127,96,121158,91584,212742
312705,201812,80,65,15,61723.8,14310,76033.8
312707,201812,126,93,33,87875.24,31482,119357.24
312710,201812,1939,1041,898,990798.6,855739,1846537.6
312720,201812,68,34,34,32436,32436,64872
312730,201812,286,168,118,159318,112572,271890
312733,201812,54,45,9,42930,8586,51516
312735,201812,22,16,6,15264,5724,20988
312737,201812,72,37,35,35298,33390,68688
312738,201812,56,40,16,38160,15264,53424
312740,201812,75,48,27,45506,25758,71264
312750,201812,70,51,19,48654,18126,66780
312760,201812,277,203,74,193662,70596,264258
312770,201812,7651,3562,4089,3375660.62,3894675,7270335.62
312780,201812,431,331,100,315487.8,95400,410887.8
312790,201812,23,18,5,17172,4770,21942
312800,201812,1629,1136,493,1077302.21,468891.78,1546193.99
312810,201812,376,242,134,230295.6,127836,358131.6
312820,201812,192,144,48,137376,45792,183168
312825,201812,26,17,9,16218,8586,24804
312830,201812,274,164,110,155217,104301,259518
312840,201812,152,111,41,105894,39114,145008
312850,201812,53,48,5,45792,4770,50562
312860,201812,164,100,64,95400,61056,156456
312870,201812,997,528,469,501105.14,447426,948531.14
312880,201812,153,104,49,99072.9,46650.6,145723.5
312890,201812,167,117,50,111618,47700,159318
312900,201812,206,156,50,148156.2,47700,195856.2
312910,201812,190,99,91,93663.72,86814,180477.72
312920,201812,157,89,68,84906,64872,149778
312930,201812,326,233,93,222282,88722,311004
312940,201812,116,81,35,77274,33390,110664
312950,201812,712,473,239,450192.6,228006,678198.6
312960,201812,172,133,39,126386,37206,163592
312965,201812,60,53,7,50275.8,6678,56953.8
312970,201812,285,228,57,216558.2,54378,270936.2
312980,201812,2370,1231,1139,1168930,1086315.8,2255245.8
312990,201812,46,27,19,25758,18126,43884
313000,201812,44,26,18,24804,17172,41976
313005,201812,176,137,39,130459.5,36920,167379.5
313010,201812,933,385,548,366040.26,522783,888823.26
313020,201812,190,101,89,95877,84906,180783
313030,201812,210,138,72,129458.8,68688,198146.8
313040,201812,69,26,43,24804,41022,65826
313050,201812,294,205,89,195570,84906,280476
313055,201812,46,35,11,33390,10494,43884
313060,201812,124,87,37,82998,35011.8,118009.8
313065,201812,60,41,19,39114,18126,57240
313070,201812,147,78,69,74412,65826,140238
313080,201812,42,18,24,16885.8,22896,39781.8
313090,201812,719,500,219,475139.9,208926,684065.9
313100,201812,167,65,102,62010,97300,159310
313110,201812,136,75,61,71550,58194,129744
313115,201812,185,101,84,96153.66,80136,176289.66
313120,201812,783,438,345,417566,327890,745456
313130,201812,5522,3029,2493,2862267.52,2371213.87,5233481.39
313140,201812,154,82,72,78228,68688,146916
313150,201812,314,250,64,238500,60769.8,299269.8
313160,201812,200,146,54,138998,51516,190514
313170,201812,1413,985,428,929164.81,407921.4,1337086.21
313180,201812,313,186,127,176795.28,121158,297953.28
313190,201812,761,467,294,443323.8,278473.6,721797.4
313200,201812,28,26,2,24804,1908,26712
313210,201812,1051,887,164,842670.46,156451.23,999121.69
313220,201812,251,169,82,160272,77038.9,237310.9
313230,201812,272,203,69,192709,65826,258535
313240,201812,1954,1044,910,992343.93,865464.03,1857807.96
313250,201812,1292,972,320,922817.64,303373.8,1226191.44
313260,201812,92,52,40,49608,38160,87768
313270,201812,957,566,391,536292.1,373014,909306.1
313280,201812,62,52,10,49488.75,9540,59028.75
313290,201812,223,180,43,170671.6,40069,210740.6
313300,201812,361,190,171,178113,163134,341247
313310,201812,243,126,117,120204,111618,231822
313320,201812,377,288,89,273083.3,84906,357989.3
313330,201812,1376,853,523,812618.2,497750.5,1310368.7
313340,201812,335,232,103,221328,98262,319590
313350,201812,514,349,165,331038.1,157410,488448.1
313360,201812,114,67,47,63918,44552,108470
313370,201812,193,72,121,68688,115434,184122
313375,201812,279,166,113,158364,107802,266166
313380,201812,1353,709,644,673543.08,614372,1287915.08
313390,201812,54,48,6,44838.8,5724,50562.8
313400,201812,421,285,136,271890,129172,401062
313410,201812,23,13,10,12402,9540,21942
313420,201812,4735,2493,2242,2369996.18,2131237.76,4501233.94
313430,201812,145,67,78,63918,74316.6,138234.6
313440,201812,1507,1038,469,986437.33,445996,1432433.33
313450,201812,64,27,37,25758,35011.8,60769.8
313460,201812,381,178,203,169326,192708,362034
313470,201812,532,245,287,233730,273130.2,506860.2
313480,201812,153,106,47,100171,44838,145009
313490,201812,513,249,264,237255.23,251809,489064.23
313500,201812,23,14,9,13356,8586,21942
313505,201812,1025,805,220,767120.94,209880,977000.94
313507,201812,98,59,39,56286,37206,93492
313510,201812,2829,1819,1010,1728828.08,963540,2692368.08
313520,201812,3608,2822,786,2679884.16,749086.91,3428971.07
313530,201812,44,29,15,27666,14310,41976
313535,201812,111,87,24,82711.8,22896,105607.8
313540,201812,75,57,18,54378,17172,71550
313545,201812,112,95,17,90630,16218,106848
313550,201812,237,197,40,187938,37874,225812
313560,201812,330,166,164,158364,156456,314820
313570,201812,59,29,30,27666,28620,56286
313580,201812,1341,749,592,712161,563910,1276071
313590,201812,77,46,31,43884,29574,73458
313600,201812,700,426,274,406118,261110,667228
313610,201812,60,46,14,43597.8,13356,56953.8
313620,201812,1390,737,653,693492.62,618315.74,1311808.36
313630,201812,1650,1263,387,1201113.4,369198,1570311.4
313640,201812,130,77,53,73458,50562,124020
313650,201812,241,112,129,106848,122494,229342
313652,201812,19,19,0,18126,0,18126
313655,201812,59,34,25,32436,23850,56286
313657,201812,48,44,4,41976,3816,45792
313660,201812,137,93,44,88722,41993.17,130715.17
313665,201812,655,318,337,303372,321259.5,624631.5
313670,201812,10297,7139,3158,6785263.35,3011301.8,9796565.15
313680,201812,44,33,11,31482,10390,41872
313690,201812,157,117,40,111618,38160,149778
313695,201812,79,60,19,57240,18126,75366
313700,201812,313,250,63,238214,60102,298316
313710,201812,138,95,43,90630,41022,131652
313720,201812,1149,555,594,526990,565045.86,1092035.86
313730,201812,62,42,20,40068,19080,59148
313740,201812,162,132,30,125928,28620,154548
313750,201812,441,323,118,308142,112572,420714
313753,201812,246,180,66,171052.2,62964,234016.2
313760,201812,1272,460,812,438554,772188.18,1210742.18
313770,201812,363,268,95,254766.2,90630,345396.2
313780,201812,760,396,364,377784,346969.8,724753.8
313790,201812,31,30,1,28047.6,954,29001.6
313800,201812,154,97,57,92538,54378,146916
313810,201812,69,40,29,38160,27666,65826
313820,201812,1301,652,649,620196,617597,1237793
313830,201812,66,48,18,45792,17172,62964
313835,201812,60,50,10,47700,9540,57240
313840,201812,1735,1084,651,1029942.4,619814.2,1649756.6
313850,201812,187,64,123,61056,117342,178398
313860,201812,475,366,109,345778.3,103986,449764.3
313862,201812,174,116,58,110664,55045.8,165709.8
313865,201812,98,78,20,74412,19080,93492
313867,201812,48,37,11,35298,10494,45792
313868,201812,30,19,11,17363,10494,27857
313870,201812,126,66,60,62964,57240,120204
313880,201812,372,235,137,224190,130412,354602
313890,201812,335,180,155,170957.8,147297.6,318255.4
313900,201812,909,499,410,475092.5,391093,866185.5
313910,201812,137,100,37,95400,34630.2,130030.2
313920,201812,626,444,182,423385.2,173394,596779.2
313925,201812,33,29,4,27666,3816,31482
313930,201812,834,643,191,613135.8,182191,795326.8
313940,201812,1818,1145,673,1088418.6,641374.4,1729793.0
313950,201812,941,604,337,574118.2,321211.8,895330.0
313960,201812,1407,818,589,776394.5,560380,1336774.5
313970,201812,126,85,41,81090,39114,120204
313980,201812,211,138,73,131414,69642,201056
313990,201812,383,230,153,219420,145962,365382
314000,201812,941,631,310,598493.9,295735.23,894229.13
314010,201812,80,53,27,50562,25758,76320
314015,201812,52,16,36,15264,34344,49608
314020,201812,54,39,15,37206,14310,51516
314030,201812,80,38,42,36089.82,40068,76157.82
314040,201812,44,30,14,28620,13356,41976
314050,201812,312,185,127,176204,120347.1,296551.1
314053,201812,98,64,34,60102.4,32436,92538.4
314055,201812,300,182,118,173628,112572,286200
314060,201812,147,124,23,116817.3,21942,138759.3
314070,201812,1059,544,515,516791.34,490690,1007481.34
314080,201812,220,144,76,136422,71454.88,207876.88
314085,201812,145,95,50,90630,47700,138330
314090,201812,366,267,99,254671,94441.23,349112.23
314100,201812,480,398,82,375877,77656,453533
314110,201812,748,412,336,391416.66,319971.6,711388.26
314120,201812,94,54,40,51516,38160,89676
314130,201812,25,12,13,11448,12402,23850
314140,201812,1132,694,438,657096.32,414704.46,1071800.78
314150,201812,164,104,60,98929.8,57240,156169.8
314160,201812,349,260,89,245178.8,84716,329894.8
314170,201812,81,63,18,58862.6,17172,76034.6
314180,201812,741,653,88,622676,82998.5,705674.5
314190,201812,99,59,40,56286,38160,94446
314200,201812,584,405,179,386052.04,169812,555864.04
314210,201812,283,218,65,207018,61724,268742
314220,201812,312,236,76,223237,72218,295455
314225,201812,67,49,18,46746,17172,63918
314230,201812,112,50,62,47700,59148,106848
314240,201812,141,109,32,103986,30528,134514
314250,201812,61,39,22,37206,20988,58194
314260,201812,195,96,99,91584,94446,186030
314270,201812,334,266,68,253764,64872,318636
314280,201812,699,396,303,377775,289062,666837
314290,201812,557,456,101,433784.5,96067.8,529852.3
314300,201812,398,287,111,269432.6,105847,375279.6
314310,201812,1437,974,463,927203.6,441672.43,1368876.03
314315,201812,38,30,8,28620,7632,36252
314320,201812,609,397,212,377962.8,201453.03,579415.83
314330,201812,10754,5435,5319,5174441.99,5069860.75,10244302.74
314340,201812,593,276,317,263017.8,301846,564863.8
314345,201812,38,29,9,27666,8586,36252
314350,201812,189,118,71,112572,67734,180306
314360,201812,82,53,29,50562,27666,78228
314370,201812,58,48,10,45792,9540,55332
314380,201812,93,65,28,62010,26425.8,88435.8
314390,201812,3354,2148,1206,2043468.5,1147567.4,3191035.9
314400,201812,703,503,200,476992.2,190800,667792.2
314410,201812,453,300,153,286200,145962,432162
314420,201812,20,10,10,9540,9540,19080
314430,201812,2480,907,1573,859856.79,1498559.6,2358416.39
314435,201812,272,162,110,154261.8,103986,258247.8
314437,201812,29,23,6,21942,5724,27666
314440,201812,99,72,27,68688,25758,94446
314450,201812,155,112,43,106848,41022,147870
314460,201812,659,311,348,296694,331992,628686
314465,201812,90,60,30,57240,28620,85860
314467,201812,70,57,13,54369,12402,66771
314470,201812,408,209,199,195934.52,188892.5,384827.02
314480,201812,1093,528,565,503712,538819.2,1042531.2
314490,201812,87,64,23,61056,21942,82998
314500,201812,307,205,102,195570,97308,292878
314505,201812,131,87,44,82998,41976,124974
314510,201812,234,195,39,186030,37206,223236
314520,201812,1273,668,605,628691.7,576025.8,1204717.5
314530,201812,760,606,154,577489,146916,724405
314535,201812,216,134,82,127072.8,78228,205300.8
314537,201812,67,40,27,38160,25758,63918
314540,201812,13,8,5,7632,4770,12402
314545,201812,48,31,17,29574,16218,45792
314550,201812,81,43,38,41022,36252,77274
314560,201812,835,453,382,428632.8,364428,793060.8
314570,201812,21,17,4,16218,3816,20034
314580,201812,15,8,7,7632,6678,14310
314585,201812,22,17,5,16218,4770,20988
314587,201812,80,71,9,67734,8586,76320
314590,201812,594,438,156,416326.5,148537.8,564864.3
314600,201812,961,634,327,599773.26,310730.81,910504.07
314610,201812,967,524,443,497034.7,422145,919179.7
314620,201812,147,107,40,100837.8,38160,138997.8
314625,201812,96,71,25,67734,23850,91584
314630,201812,1226,634,592,603357.3,564241.8,1167599.1
314640,201812,87,59,28,56286,26425.8,82711.8
314650,201812,193,112,81,106561.8,76797,183358.8
314655,201812,65,48,17,45792,16218,62010
314660,201812,19,15,4,14310,3816,18126
314670,201812,203,158,45,150446,42930,193376
314675,201812,217,130,87,124020,82998,207018
314690,201812,555,305,250,290970,238500,529470
314700,201812,2413,1314,1099,1248290.42,1047825.9,2296116.32
314710,201812,1634,955,679,906694.24,647146.1,1553840.34
314720,201812,407,242,165,229465.62,157410,386875.62
314730,201812,514,267,247,252715.8,235247.4,487963.2
314740,201812,697,347,350,329368.5,333900,663268.5
314750,201812,19,16,3,15264,2862,18126
314760,201812,328,159,169,151686,161216.46,312902.46
314770,201812,121,84,37,79850,35298,115148
314780,201812,20,6,14,5724,13356,19080
314790,201812,2423,1533,890,1457985.8,848239.56,2306225.36
314795,201812,61,52,9,49370,8586,57956
314800,201812,2965,1750,1215,1663641.86,1157774.4,2821416.26
314810,201812,1536,864,672,822205.7,639467,1461672.7
314820,201812,99,56,43,53424,41022,94446
314830,201812,218,177,41,168142.5,38828,206970.5
314840,201812,83,48,35,45792,33390,79182
314850,201812,351,171,180,163134,171720,334854
314860,201812,712,537,175,510294.86,165329.1,675623.96
314870,201812,1502,792,710,754614,677053.8,1431667.8
314875,201812,58,50,8,47700,7632,55332
314880,201812,46,31,15,29574,14310,43884
314890,201812,55,32,23,30528,21942,52470
314900,201812,32,25,7,23850,6678,30528
314910,201812,256,172,84,164088,80136,244224
314915,201812,159,139,20,132606,19080,151686
314920,201812,118,72,46,68688,43884,112572
314930,201812,1065,540,525,513582.33,500277.6,1013859.93
314940,201812,51,40,11,38160,10494,48654
314950,201812,39,27,12,25758,11448,37206
314960,201812,54,40,14,38160,13356,51516
314970,201812,146,74,72,70596,68688,139284
314980,201812,301,193,108,181880.1,103032,284912.1
314990,201812,462,256,206,243508.5,195618.5,439127.0
314995,201812,214,64,150,61056,143090.46,204146.46
315000,201812,92,76,16,72504,15264,87768
315010,201812,46,30,16,28620,15264,43884
315015,201812,176,144,32,136650.96,30528,167178.96
315020,201812,72,62,10,59148,9540,68688
315030,201812,117,90,27,84906,25758,110664
315040,201812,70,52,18,49608,17172,66780
315050,201812,194,116,78,110664,74126,184790
315053,201812,44,38,6,36252,5580.9,41832.9
315057,201812,97,80,17,75938.4,16218,92156.4
315060,201812,75,64,11,57908.96,10494,68402.96
315070,201812,105,59,46,56286,43884,100170
315080,201812,382,312,70,297648,66780,364428
315090,201812,109,64,45,61056,42930,103986
315100,201812,81,41,40,39114,38160,77274
315110,201812,288,161,127,152736,121158,273894
315120,201812,1662,839,823,795059.23,783234.64,1578293.87
315130,201812,346,250,96,238500,91584,330084
315140,201812,534,316,218,299842.2,207972,507814.2
315150,201812,987,473,514,450003,490070,940073
315160,201812,221,112,109,106848,103986,210834
315170,201812,330,217,113,205111.2,107515.8,312627.0
315180,201812,3291,1396,1895,1326920.4,1804463.3,3131383.7
315190,201812,325,190,135,180879,128790,309669
315200,201812,1241,720,521,685258.2,496175.4,1181433.6
315210,201812,1591,903,688,858887.8,653932.2,1512820.0
315213,201812,43,25,18,23850,17172,41022
315217,201812,218,176,42,167904,40068,207972
315220,201812,1569,1206,363,1149466.4,346016,1495482.4
315230,201812,168,122,46,116102,43884,159986
315240,201812,428,272,156,259488,147622.5,407110.5
315250,201812,2533,1253,1280,1194784.83,1220258.44,2415043.27
315260,201812,147,88,59,83952,56286,140238
315270,201812,130,92,38,87195.6,36252,123447.6
315280,201812,693,453,240,431495,228950.46,660445.46
315290,201812,206,125,81,119250,76320,195570
315300,201812,73,52,21,49608,20034,69642
315310,201812,70,64,6,61056,5724,66780
315320,201812,169,98,71,93492,67734,161226
315330,201812,59,50,9,47700,8586,56286
315340,201812,409,291,118,276431.04,112572,389003.04
315350,201812,153,90,63,85860,60102,145962
315360,201812,94,48,46,45792,43884,89676
315370,201812,58,34,24,31720.5,22466.7,54187.2
315380,201812,11,7,4,6678,3816,10494
315390,201812,74,19,55,18126,52470,70596
315400,201812,848,642,206,607030.5,195856.2,802886.7
315410,201812,357,218,139,207686,132320,340006
315415,201812,62,47,15,44838,14310,59148
315420,201812,203,155,48,146774,45792,192566
315430,201812,684,396,288,376544,274275.8,650819.8
315440,201812,90,62,28,59148,26712,85860
315445,201812,254,205,49,195255.18,46746,242001.18
315450,201812,186,140,46,133560,43884,177444
315460,201812,3540,1788,1752,1703263.4,1668681.1,3371944.5
315470,201812,42,19,23,18126,21942,40068
315480,201812,63,25,38,23850,36252,60102
315490,201812,645,402,243,381456.9,231154.2,612611.1
315500,201812,23,15,8,14310,7632,21942
315510,201812,153,101,52,96354,49608,145962
315520,201812,75,66,9,62964,8586,71550
315530,201812,53,28,25,26712,23850,50562
315540,201812,239,160,79,152640,75366,228006
315550,201812,182,143,39,136422,37206,173628
315560,201812,738,591,147,562474.8,140238,702712.8
315570,201812,319,164,155,153261.5,147680,300941.5
315580,201812,684,450,234,428633,223236,651869
315590,201812,204,108,96,103032,91584,194616
315600,201812,298,223,75,212503.5,71550,284053.5
315610,201812,95,48,47,45792,44838,90630
315620,201812,34,28,6,26712,5724,32436
315630,201812,137,90,47,85860,44838,130698
315640,201812,67,41,26,39114,24804,63918
315645,201812,63,45,18,42930,16695,59625
315650,201812,171,125,46,118678,43311.6,161989.6
315660,201812,476,214,262,204156,249948,454104
315670,201812,2459,1220,1239,1160809.32,1181215.26,2342024.58
315680,201812,861,588,273,558519.3,260442,818961.3
315690,201812,681,472,209,450167,199386,649553
315700,201812,1927,1023,904,970038.47,862321,1832359.47
315710,201812,335,95,240,90630,228960,319590
315720,201812,449,289,160,275419.8,152640,428059.8
315725,201812,205,164,41,156170,39114,195284
315727,201812,41,21,20,20034,19080,39114
315730,201812,50,48,2,45792,1908,47700
315733,201812,91,60,31,57240,29574,86814
315737,201812,51,39,12,37206,11448,48654
315740,201812,43,35,8,33390,7632,41022
315750,201812,157,121,36,115434,34344,149778
315760,201812,44,34,10,32436,9540,41976
315765,201812,126,81,45,77274,42930,120204
315770,201812,235,146,89,139284,84620,223904
315780,201812,3416,1779,1637,1690307.74,1560059.4,3250367.14
315790,201812,209,159,50,151686,47127.6,198813.6
315800,201812,289,209,80,199386,76320,275706
315810,201812,94,56,38,53424,35966,89390
315820,201812,805,586,219,556183.34,208926,765109.34
315830,201812,137,81,56,77274,53424,130698
315840,201812,92,64,28,61056,26712,87768
315850,201812,266,196,70,186984,66780,253764
315860,201812,13,5,8,4770,7632,12402
315870,201812,37,30,7,28620,6678,35298
315880,201812,110,70,40,66780,38160,104940
315890,201812,87,65,22,62010,20988,82998
315895,201812,486,334,152,317348,144361.59,461709.59
315900,201812,76,38,38,35966,36252,72218
315910,201812,41,28,13,26473.5,12402,38875.5
315920,201812,180,114,66,108756,62010.9,170766.9
315930,201812,45,16,29,15264,27666,42930
315935,201812,148,114,34,108756,32427,141183
315940,201812,93,69,24,65826,22896,88722
315950,201812,47,34,13,32436,12402,44838
315960,201812,551,263,288,249633.38,273893.6,523526.98
315970,201812,36,29,7,27666,6678,34344
315980,201812,703,334,369,317253,352026,669279
315990,201812,263,153,110,145724,104645,250369
316000,201812,52,35,17,33103.8,15931.8,49035.6
316010,201812,79,67,12,63918,11448,75366
316020,201812,117,97,20,92538,19080,111618
316030,201812,409,222,187,211216,177874,389090
316040,201812,520,222,298,210834.2,284006,494840.2
316045,201812,63,56,7,53424,6678,60102
316050,201812,16,14,2,13356,1908,15264
316060,201812,104,67,37,63918,35298,99216
316070,201812,1103,714,389,675834.3,370343,1046177.3
316080,201812,105,68,37,64872,35298,100170
316090,201812,41,24,17,22228.2,16218,38446.2
316095,201812,75,63,12,60102,11448,71550
316100,201812,316,185,131,175965.8,124974,300939.8
316105,201812,36,25,11,23850,10494,34344
316110,201812,1925,1550,375,1468922.35,357082.2,1826004.55
316120,201812,79,58,21,55332,19747.8,75079.8
316130,201812,136,105,31,99217,29574,128791
316140,201812,29,21,8,20034,7632,27666
316150,201812,215,150,65,142384.5,62010,204394.5
316160,201812,80,48,32,45792,30528,76320
316165,201812,69,51,18,48464,16456.5,64920.5
316170,201812,199,135,64,127836,61056,188892
316180,201812,204,89,115,84906,109424,194330
316190,201812,142,105,37,99216,35298,134514
316200,201812,694,393,301,374922,286295.4,661217.4
316210,201812,776,519,257,496713.41,245178,741891.41
316220,201812,113,77,36,73458,34344,107802
316225,201812,26,15,11,14310,10494,24804
316230,201812,31,19,12,18126,11448,29574
316240,201812,645,519,126,495126,120204,615330
316245,201812,118,99,19,94446,18126,112572
316250,201812,1523,1054,469,998153.5,446185.88,1444339.38
316255,201812,121,97,24,92156.4,22881.69,115038.09
316257,201812,185,97,88,92538,83718.48,176256.48
316260,201812,196,138,58,130355.06,55237,185592.06
316265,201812,28,19,9,18126,8586,26712
316270,201812,677,475,202,450145.9,192632,642777.9
316280,201812,549,338,211,321181.8,200626.6,521808.4
316290,201812,709,467,242,443419.38,230868,674287.38
316292,201812,521,207,314,197191.8,299318,496509.8
316294,201812,105,63,42,60102,40068,100170
316295,201812,301,138,163,129727,155502,285229
316300,201812,101,72,29,68688,27666,96354
316310,201812,37,20,17,18793.8,16218,35011.8
316320,201812,42,26,16,24804,15264,40068
316330,201812,134,88,46,82998.5,43597.8,126596.3
316340,201812,145,101,44,96354,41976,138330
316350,201812,192,140,52,132940,49608,182548
316360,201812,25,18,7,17172,6678,23850
316370,201812,1079,577,502,544755.3,478612.26,1023367.56
316380,201812,129,99,30,94446,28620,123066
316390,201812,125,90,35,85860,33390,119250
316400,201812,138,104,34,99216,32436,131652
316410,201812,305,224,81,212312.7,77274,289586.7
316420,201812,208,146,62,138568.5,59148,197716.5
316430,201812,156,82,74,78228,70596,148824
316440,201812,98,48,50,45792,47700,93492
316443,201812,36,34,2,32436,1908,34344
316447,201812,65,51,14,48654,13356,62010
316450,201812,232,173,59,165042,56286,221328
316460,201812,72,29,43,27666,41022,68688
316470,201812,1652,1209,443,1146396.09,420500.79,1566896.88
316480,201812,12,10,2,9540,1908,11448
316490,201812,18,7,11,6678,10494,17172
316500,201812,154,102,52,97021.8,49608,146629.8
316510,201812,166,126,40,119202.3,38160,157362.3
316520,201812,193,119,74,113526,70596,184122
316530,201812,160,112,48,106848,45792,152640
316540,201812,141,80,61,76320,58194,134514
316550,201812,138,96,42,91584,40068,131652
316553,201812,261,125,136,119250,129744,248994
316555,201812,35,28,7,25908,6678,32586
316556,201812,11,8,3,7632,2862,10494
316557,201812,18,13,5,12402,4770,17172
316560,201812,66,51,15,48654,14310,62964
316570,201812,242,220,22,209260,20988,230248
316580,201812,21,16,5,15264,4770,20034
316590,201812,115,99,16,94446,15264,109710
316600,201812,180,147,33,139475,31482,170957
316610,201812,67,48,19,45505.8,18126,63631.8
316620,201812,137,106,31,101124,29574,130698
316630,201812,42,33,9,31482,8586,40068
316640,201812,17,10,7,9540,6678,16218
316650,201812,72,56,16,53424,15264,68688
316660,201812,8,3,5,2862,4770,7632
316670,201812,442,155,287,147851,273511.8,421362.8
316680,201812,162,114,48,108469.8,45602,154071.8
316690,201812,190,123,67,117342,63918,181260
316695,201812,63,55,8,52470,7632,60102
316700,201812,15,8,7,7632,6678,14310
316710,201812,747,551,196,524652.8,186984,711636.8
316720,201812,4971,2517,2454,2389856.83,2336219.23,4726076.06
316730,201812,16,15,1,14310,954,15264
316740,201812,124,80,44,76320,41976,118296
316750,201812,20,13,7,12402,6678,19080
316760,201812,320,258,62,246132,59148,305280
316770,201812,137,75,62,71550,59148,130698
316780,201812,76,47,29,44532.72,27666,72198.72
316790,201812,56,43,13,41022,12402,53424
316800,201812,1769,1103,666,1051212.8,634888,1686100.8
316805,201812,18,10,8,9540,7632,17172
316810,201812,71,47,24,44838,22896,67734
316820,201812,43,20,23,19080,21942,41022
316830,201812,94,42,52,40068,49608,89676
316840,201812,513,310,203,295454,193662,489116
316850,201812,350,232,118,220660.2,112572,333232.2
316860,201812,6066,2692,3374,2552805.75,3212628.4,5765434.15
316870,201812,1497,977,520,924334.3,490644.2,1414978.5
316880,201812,126,64,62,60769.8,59148,119917.8
316890,201812,247,167,80,159318,76320,235638
316900,201812,430,295,135,278883.28,128790,407673.28
316905,201812,19,9,10,8586,9540,18126
316910,201812,53,24,29,22896,27666,50562
316920,201812,135,107,28,101363,26712,128075
316930,201812,1925,986,939,937496.2,893612.7,1831108.9
316935,201812,894,548,346,520884.72,328844,849728.72
316940,201812,1106,638,468,607698.4,445890.26,1053588.66
316950,201812,183,94,89,89676,84906,174582
316960,201812,1124,628,496,597776.8,472888.46,1070665.26
316970,201812,665,522,143,497788,136422,634210
316980,201812,112,68,44,64872,41966.46,106838.46
316990,201812,2235,1480,755,1405863.58,715046.94,2120910.52
317000,201812,339,260,79,248040,75366,323406
317005,201812,251,177,74,168858,70596,239454
317010,201812,6494,3650,2844,3462166.71,2711936,6174102.71
317020,201812,16552,7443,9109,7068911.11,8677635.9,15746547.01
317030,201812,81,32,49,30528,46529.26,77057.26
317040,201812,3125,1970,1155,1875091.03,1099104.61,2974195.64
317043,201812,82,58,24,55332,22896,78228
317047,201812,35,17,18,16218,17168,33386
317050,201812,180,139,41,132606,39114,171720
317052,201812,131,99,32,94446,30528,124974
317057,201812,196,147,49,140238,46174,186412
317060,201812,59,40,19,38160,17839.8,55999.8
317065,201812,60,48,12,45792,11448,57240
317070,201812,2011,950,1061,901531.5,1010763.4,1912294.9
317075,201812,108,57,51,54378,48654,103032
317080,201812,866,456,410,432620.68,390950,823570.68
317090,201812,651,523,128,497558.7,122112,619670.7
317100,201812,430,325,105,308142,100170,408312
317103,201812,114,97,17,92538,16218,108756
317107,201812,39,34,5,32436,4770,37206
317110,201812,110,47,63,44838,60102,104940
317115,201812,44,38,6,36252,5724,41976
317120,201812,1901,969,932,915927.92,888671,1804598.92
317130,201812,1965,1284,681,1218505.8,649007,1867512.8
317140,201812,11,9,2,8586,1908,10494
317150,201812,266,158,108,150446,103032,253478
317160,201812,312,226,86,215287,82044,297331
317170,201812,210,144,66,137376,62964,200340
317180,201812,439,318,121,302656.5,115434,418090.5
317190,201812,261,179,82,170766,77941.8,248707.8
317200,201812,821,581,240,541214.2,228722,769936.2
317210,201812,152,86,66,81090.2,62964,144054.2
317220,201812,21,13,8,12402,7632,20034
320010,201812,628,466,162,441225.7,154548,595773.7
320013,201812,135,100,35,95400,33390,128790
320016,201812,286,179,107,170766,102078,272844
320020,201812,740,441,299,417115.55,283338.32,700453.87
320030,201812,154,113,41,107802,38780.1,146582.1
320035,201812,143,106,37,101124,35298,136422
320040,201812,507,263,244,250043.8,232203.8,482247.6
320050,201812,113,86,27,82044,25758,107802
320060,201812,1613,771,842,735391.6,802582.06,1537973.66
320070,201812,109,72,37,68067.9,35298,103365.9
320080,201812,796,457,339,433147,323406,756553
320090,201812,1244,874,370,830448.16,350499.8,1180947.96
320100,201812,339,195,144,186030,137376,323406
320110,201812,130,85,45,79230.2,42644,121874.2
320115,201812,113,93,20,88722,19080,107802
320120,201812,3399,1899,1500,1800965.4,1426776.34,3227741.74
320130,201812,7602,3592,4010,3403905.98,3817553.95,7221459.93
320140,201812,430,283,147,269315,139994,409309
320150,201812,2002,1168,834,1107007.31,795054.06,1902061.37
320160,201812,682,306,376,290388.83,357302.79,647691.62
320170,201812,113,90,23,85097,21942,107039
320180,201812,53,31,22,29574,20988,50562
320190,201812,240,160,80,152630.46,76034,228664.46
320200,201812,57,45,12,42930,11448,54378
320210,201812,887,495,392,470418.6,372996,843414.6
320220,201812,316,119,197,113526,187652,301178
320225,201812,84,69,15,65826,14310,80136
320230,201812,592,384,208,364810.4,197622,562432.4
320240,201812,3177,1605,1572,1527832.8,1497688.58,3025521.38
320245,201812,478,330,148,313532.3,141192,454724.3
320250,201812,236,123,113,116388.6,107802,224190.6
320255,201812,144,115,29,108403.02,27523,135926.02
320260,201812,186,133,53,126882,50514.3,177396.3
320265,201812,163,130,33,123210,31482,154692
320270,201812,158,128,30,122112,28620,150732
320280,201812,1007,602,405,568108.25,386370,954478.25
320290,201812,65,56,9,53424,8586,62010
320300,201812,557,392,165,372461.5,156361.1,528822.6
320305,201812,676,369,307,352026,292401.8,644427.8
320310,201812,222,125,97,116627.7,91782,208409.7
320313,201812,319,162,157,154548,149492,304040
320316,201812,110,89,21,84906,20034,104940
320320,201812,3421,1565,1856,1487326,1768597.6,3255923.6
320330,201812,263,198,65,188892,60102.8,248994.8
320332,201812,892,539,353,512349.6,335713.3,848062.9
320334,201812,247,153,94,145676,89676,235352
320335,201812,144,103,41,97308.4,39114,136422.4
320340,201812,589,410,179,389594,170099,559693
320350,201812,998,431,567,408981.67,539220.48,948202.15
320360,201812,174,94,80,88836.48,76320,165156.48
320370,201812,247,188,59,177660,55253,232913
320380,201812,294,203,91,191993.3,86814,278807.3
320390,201812,1157,711,446,675395.8,425389,1100784.8
320400,201812,321,233,88,220852.2,83952,304804.2
320405,201812,930,398,532,379115.6,507215.92,886331.52
320410,201812,986,505,481,480101.4,458541,938642.4
320420,201812,491,254,237,240599.9,226098,466697.9
320425,201812,199,107,92,102078,87768,189846
320430,201812,405,231,174,218752.7,165996,384748.7
320435,201812,171,116,55,109776.78,52470,162246.78
320440,201812,207,123,84,117342,80136,197478
320450,201812,129,74,55,70596,52470,123066
320455,201812,248,204,44,193663,41976,235639
320460,201812,249,154,95,146916,89771.6,236687.6
320465,201812,117,79,38,75366,36252,111618
320470,201812,665,427,238,406119.74,227048,633167.74
320480,201812,187,123,64,116531.1,61056,177587.1
320490,201812,3087,1537,1550,1463089.06,1475690.64,2938779.70
320495,201812,98,61,37,58175,34726,92901
320500,201812,9680,4878,4802,4621733.53,4568869.81,9190603.34
320501,201812,545,273,272,260442,259488,519930
320503,201812,294,209,85,197859.8,81090,278949.8
320506,201812,261,195,66,186030,62964,248994
320510,201812,988,465,523,440582.3,497407.1,937989.4
320515,201812,81,68,13,63918.9,12402,76320.9
320517,201812,212,151,61,144054,58194,202248
320520,201812,7080,3163,3917,3004165.15,3729885.86,6734051.01
320530,201812,5598,2812,2786,2673877.06,2651704.24,5325581.30
330010,201812,3170,1648,1522,1564654.6,1448035.71,3012690.31
330015,201812,158,67,91,62774.08,86814,149588.08
330020,201812,3653,1603,2050,1525715.72,1955414,3481129.72
330022,201812,250,136,114,129029,107802.8,236831.8
330023,201812,553,193,360,183072.6,343440,526512.6
330025,201812,609,122,487,116388,464311.8,580699.8
330030,201812,1995,1300,695,1232812.28,659761.68,1892573.96
330040,201812,2448,1277,1171,1214268,1115038.3,2329306.3
330045,201812,8525,2739,5786,2605279.5,5513363.97,8118643.47
330050,201812,880,570,310,542969.1,295740,838709.1
330060,201812,944,586,358,555230.1,340215.48,895445.58
330070,201812,3469,1345,2124,1277459.47,2024972.56,3302432.03
330080,201812,1493,701,792,663463.94,754098.23,1417562.17
330090,201812,377,216,161,205873.2,153594,359467.2
330093,201812,284,128,156,122112,148770,270882
330095,201812,101,54,47,50848.2,44838,95686.2
330100,201812,9656,4993,4663,4751772.11,4445497.1,9197269.21
330110,201812,507,219,288,206541.1,274752,481293.1
330115,201812,579,310,269,295740,256626,552366
330120,201812,383,197,186,186793.2,176490.8,363284.0
330130,201812,1550,412,1138,391845.96,1085634,1477479.96
330140,201812,600,317,283,302391,269029,571420
330150,201812,473,276,197,262206.9,185872.99,448079.89
330160,201812,210,129,81,123066,77274,200340
330170,201812,27315,9667,17648,9198172.42,16823334.51,26021506.93
330180,201812,244,156,88,146277.02,83236.5,229513.52
330185,201812,865,333,532,316432.8,505965.66,822398.46
330187,201812,324,99,225,94446,214650,309096
330190,201812,5653,2268,3385,2152877.17,3226280.68,5379157.85
330200,201812,4784,1503,3281,1429379.26,3125050.76,4554430.02
330205,201812,426,253,173,241218.9,164756,405974.9
330210,201812,1024,639,385,601912.14,365334.9,967247.04
330220,201812,2618,1577,1041,1499163.3,992160.2,2491323.5
330225,201812,568,309,259,294147,246418.2,540565.2
330227,201812,2421,765,1656,726652.46,1579468.23,2306120.69
330230,201812,222,128,94,121445,89676,211121
330240,201812,3736,1987,1749,1890099.64,1664190.63,3554290.27
330245,201812,156,70,86,66466,82044,148510
330250,201812,6755,3498,3257,3320834.1,3097176.32,6418010.42
330260,201812,580,168,412,160272,393048,553320
330270,201812,3485,1278,2207,1218355,2104715.8,3323070.8
330280,201812,465,299,166,282643.18,158355,440998.18
330285,201812,7228,2377,4851,2263061.47,4625461.32,6888522.79
330290,201812,597,227,370,216558,352980,569538
330300,201812,808,544,264,515160.7,251829,766989.7
330310,201812,443,246,197,232776.7,187938,420714.7
330320,201812,8386,3235,5151,3078418.9,4908832.24,7987251.14
330330,201812,9120,3631,5489,3455696.22,5232580.13,8688276.35
330340,201812,2696,1608,1088,1531161.26,1037932.92,2569094.18
330350,201812,18282,7273,11009,6907118.59,10482923.95,17390042.54
330360,201812,2409,1209,1200,1152413.2,1144791,2297204.2
330370,201812,1065,558,507,530146.35,481615.9,1011762.25
330380,201812,856,370,486,352254.96,463121,815375.96
330385,201812,610,318,292,302419,278568,580987
330390,201812,5319,2940,2379,2788160.27,2266623,5054783.27
330395,201812,286,177,109,167904.3,102221.2,270125.5
330400,201812,725,393,332,371488.6,315019.88,686508.48
330410,201812,507,362,145,342059,137840.33,479899.33
330411,201812,240,133,107,126701,102030.3,228731.3
330412,201812,253,107,146,100838,139284,240122
330414,201812,6062,2503,3559,2383527.88,3391899.9,5775427.78
330415,201812,591,271,320,257552.34,304326.8,561879.14
330420,201812,2273,1190,1083,1131722.32,1031075,2162797.32
330430,201812,1815,873,942,830414,895426,1725840
330440,201812,273,129,144,123066,137376,260442
330450,201812,120,52,68,49608,64872,114480
330452,201812,1814,865,949,824030,905032.34,1729062.34
330455,201812,111412,40318,71094,38377697.51,67764562.3,106142259.81
330460,201812,262,110,152,104940,144981,249921
330470,201812,1262,690,572,652634.58,545392.46,1198027.04
330475,201812,1409,379,1030,360612.8,980930.95,1341543.75
330480,201812,809,431,378,410506.2,359659,770165.2
330490,201812,13894,4842,9052,4613139.27,8630390.07,13243529.34
330500,201812,1353,614,739,585612.9,704749,1290361.9
330510,201812,11271,3884,7387,3697897,7042365.84,10740262.84
330513,201812,103,51,52,47890.8,49608,97498.8
330515,201812,837,345,492,323913.4,468987,792900.4
330520,201812,2569,958,1611,913713,1536750.9,2450463.9
330530,201812,216,115,101,109185.8,96164,205349.8
330540,201812,357,179,178,170479.8,169335,339814.8
330550,201812,2992,1090,1902,1037666.2,1812838.9,2850505.1
330555,201812,804,306,498,291905,474138.8,766043.8
330560,201812,645,213,432,203202,412101,615303
330570,201812,250,177,73,168858,69642,238500
330575,201812,787,332,455,316728,432015.5,748743.5
330580,201812,3435,1920,1515,1824990.94,1444117.7,3269108.64
330590,201812,324,162,162,154548,154548,309096
330600,201812,1127,731,396,694951.04,376086.84,1071037.88
330610,201812,1555,860,695,813573.74,659835.9,1473409.64
330615,201812,197,148,49,140333.4,46746,187079.4
330620,201812,1056,438,618,415658.7,587855,1003513.7
330630,201812,4032,2566,1466,2432363.98,1391316.1,3823680.08
350010,201812,605,400,205,380408.47,194766.73,575175.20
350020,201812,42,20,22,19080,20988,40068
350030,201812,531,343,188,326078,178162.66,504240.66
350040,201812,125,49,76,46402.56,72504,118906.56
350050,201812,299,161,138,152973.9,131633.46,284607.36
350055,201812,89,51,38,48654,36252,84906
350060,201812,72,26,46,24804,43884,68688
350070,201812,825,492,333,464253.7,316088.44,780342.14
350075,201812,74,49,25,46746,23850,70596
350080,201812,50,31,19,28937.96,17172,46109.96
350090,201812,92,51,41,48654,39109.23,87763.23
350100,201812,293,184,109,174820.5,103986,278806.5
350110,201812,56,37,19,35298,18126,53424
350115,201812,163,99,64,93778.2,61056,154834.2
350120,201812,108,72,36,68688,34344,103032
350130,201812,347,166,181,157657,172674,330331
350140,201812,37,23,14,21179,13356,34535
350150,201812,68,53,15,50562,14310,64872
350160,201812,2613,1036,1577,984671.13,1503358.06,2488029.19
350170,201812,404,246,158,232776.2,149682.8,382459.0
350180,201812,183,97,86,92538,82044,174582
350190,201812,1048,557,491,529376.64,467827.49,997204.13
350200,201812,67,23,44,21942,41711.08,63653.08
350210,201812,1340,752,588,710225.13,559798.66,1270023.79
350220,201812,680,579,101,548228.73,96354,644582.73
350230,201812,82,56,26,53424,24804,78228
350240,201812,60,45,15,42930,14310,57240
350250,201812,1224,612,612,577410.9,583218.66,1160629.56
350260,201812,91,64,27,61056,25758,86814
350270,201812,848,555,293,528106.58,278072.92,806179.50
350275,201812,310,128,182,121731,173628,295359
350280,201812,4747,2433,2314,2307305.04,2206515.22,4513820.26
350290,201812,421,201,220,191749.23,209307.8,401057.03
350300,201812,58,32,26,30528,24804,55332
350310,201812,105,68,37,64872,35298,100170
350315,201812,40,25,15,23850,14310,38160
350320,201812,3319,1653,1666,1572470.86,1588583.26,3161054.12
350330,201812,1695,904,791,859017.92,753438.04,1612455.96
350335,201812,21,14,7,13356,6678,20034
350340,201812,135,63,72,60102,68355,128457
350350,201812,90,46,44,43884,41976,85860
350360,201812,129,85,44,81086,41976,123062
350370,201812,89,53,36,49608.96,34334.46,83943.42
350380,201812,771,329,442,312245.2,420904.8,733150.0
350390,201812,1524,614,910,583992.93,866995.4,1450988.33
350395,201812,25,20,5,19080,4770,23850
350400,201812,1690,891,799,839611.43,759648.16,1599259.59
350410,201812,2325,1033,1292,982106.76,1231941.03,2214047.79
350420,201812,243,150,93,142497,88722,231219
350430,201812,74,43,31,40450,29574,70024
350440,201812,150,111,39,104892.5,37206,142098.5
350450,201812,1660,1020,640,965675.15,610465,1576140.15
350460,201812,336,126,210,120204,200053.8,320257.8
350470,201812,16,10,6,9540,5724,15264
350480,201812,167,92,75,87768,71550,159318
350490,201812,234,119,115,112572.8,109710,222282.8
350500,201812,42,18,24,17172,22896,40068
350510,201812,163,109,54,103986,51516,155502
350520,201812,462,223,239,209705.06,227369.96,437075.02
350530,201812,450,208,242,198432,230868,429300
350535,201812,73,58,15,55074.42,14310,69384.42
350540,201812,380,196,184,186984,175249.8,362233.8
350550,201812,2734,1614,1120,1532462.76,1066037.23,2598499.99
350560,201812,660,463,197,440934.03,187580.25,628514.28
350570,201812,4152,1758,2394,1672472.08,2281169.2,3953641.28
350580,201812,387,189,198,179353,188878.46,368231.46
350590,201812,896,497,399,473852,379692.96,853544.96
350600,201812,6253,3165,3088,3002467.69,2940500.66,5942968.35
350610,201812,1542,799,743,758170.4,708813,1466983.4
350620,201812,35,23,12,21942,11448,33390
350630,201812,239,139,100,131652.96,94447,226099.96
350635,201812,909,374,535,355862,509170.81,865032.81
350640,201812,118,88,30,83952,28620,112572
350650,201812,1919,1265,654,1202615.03,622466.76,1825081.79
350660,201812,756,334,422,317992.05,402584,720576.05
350670,201812,320,163,157,155073.2,149778,304851.2
350680,201812,180,95,85,90630,81090,171720
350690,201812,201,106,95,101124,90630,191754
350700,201812,764,368,396,347737.94,377784,725521.94
350710,201812,353,135,218,127581.56,207972,335553.56
350715,201812,56,44,12,41976,11448,53424
350720,201812,17,10,7,9540,6678,16218
350730,201812,44,27,17,25758,16218,41976
350740,201812,212,117,95,111608.46,90630,202238.46
350745,201812,18,9,9,8562,8586,17148
350750,201812,2169,1373,796,1299450.52,758738.96,2058189.48
350760,201812,3747,1649,2098,1570809.83,1997698.42,3568508.25
350770,201812,60,41,19,39114,18126,57240
350775,201812,49,35,14,33390,13347,46737
350780,201812,419,213,206,203202,196507,399709
350790,201812,367,152,215,145008,205110,350118
350800,201812,452,259,193,247086,184122,431208
350810,201812,525,418,107,397819,101792,499611
350820,201812,90,54,36,51516,34344,85860
350830,201812,83,46,37,43884,35298,79182
350840,201812,775,330,445,314534,422994.8,737528.8
350850,201812,1798,1043,755,989885.13,720229.46,1710114.59
350860,201812,601,352,249,331975.8,237546,569521.8
350870,201812,441,299,142,285246,135181.8,420427.8
350880,201812,288,157,131,147822.8,124306.2,272129.0
350890,201812,40,26,14,24804,13356,38160
350900,201812,1486,480,1006,456453.93,958960.8,1415414.73
350910,201812,25,15,10,14310,9540,23850
350920,201812,626,339,287,323088.04,272748.6,595836.64
350925,201812,1219,656,563,623516.26,535385.4,1158901.66
350930,201812,97,61,36,58194,34344,92538
350940,201812,735,407,328,387037.8,311226.6,698264.4
350945,201812,110,81,29,76738,27666,104404
350950,201812,16003,7695,8308,7312972.41,7919356.74,15232329.15
350960,201812,1281,597,684,565906.16,652532,1218438.16
350970,201812,1149,590,559,560287.96,532704.46,1092992.42
350980,201812,93,64,29,61056,27666,88722
350990,201812,372,135,237,127836.72,226098,353934.72
350995,201812,34,16,18,15264,17172,32436
351000,201812,630,440,190,417536.07,181260,598796.07
351010,201812,49,30,19,28620,18126,46746
351015,201812,58,39,19,37206,18126,55332
351020,201812,1673,983,690,936983.04,656256.8,1593239.84
351030,201812,356,243,113,228960,107802,336762
351040,201812,853,449,404,427851.59,384462.66,812314.25
351050,201812,3351,1572,1779,1491121.58,1696786.07,3187907.65
351060,201812,5074,2084,2990,1977375.72,2849849.92,4827225.64
351070,201812,417,265,152,251542.96,145008,396550.96
351080,201812,798,575,223,548073,211788,759861
351090,201812,60,27,33,25758,31482,57240
351100,201812,458,267,191,252496.48,182209.23,434705.71
351110,201812,2110,1010,1100,957044.08,1047043.46,2004087.54
351120,201812,70,34,36,32436,34344,66780
351130,201812,172,59,113,56286,107515.8,163801.8
351140,201812,341,235,106,222949.84,101124,324073.84
351150,201812,426,231,195,219468.8,186030,405498.8
351160,201812,260,173,87,164756,82998,247754
351170,201812,190,105,85,100170,80327,180497
351190,201812,87,59,28,56286,26712,82998
351200,201812,373,244,129,232490,123066,355556
351210,201812,126,60,66,56985.38,62964,119949.38
351220,201812,542,326,216,307431.12,206064,513495.12
351230,201812,286,206,80,196524,76300.92,272824.92
351240,201812,233,101,132,96354,125928,222282
351250,201812,74,52,22,49384,20988,70372
351260,201812,151,111,40,105894,38160,144054
351270,201812,51,21,30,20034,28620,48654
351280,201812,1097,494,603,468416.46,574430.38,1042846.84
351290,201812,233,108,125,103032,118964,221996
351300,201812,3727,1742,1985,1655170.4,1893369,3548539.4
351310,201812,767,391,376,373014,358704,731718
351320,201812,113,68,45,64872,42930,107802
351330,201812,40,27,13,25758,12402,38160
351340,201812,1252,773,479,731172.93,454936.03,1186108.96
351350,201812,2584,1492,1092,1420555.3,1041186.06,2461741.36
351360,201812,785,394,391,374636.52,372696.04,747332.56
351370,201812,378,190,188,181255.23,178715.96,359971.19
351380,201812,9065,4098,4967,3895123.21,4727657.29,8622780.50
351385,201812,28,18,10,17172,9540,26712
351390,201812,284,212,72,202248,68688,270936
351400,201812,65,41,24,39114,22849.92,61963.92
351410,201812,454,285,169,270793.9,161226,432019.9
351420,201812,61,49,12,46746,11448,58194
351430,201812,69,39,30,37206,28620,65826
351440,201812,798,558,240,530221.76,228956,759177.76
351450,201812,264,134,130,127836,124020,251856
351460,201812,116,55,61,52470,58194,110664
351470,201812,136,71,65,66780,62010,128790
351480,201812,526,299,227,284006.29,216558,500564.29
351490,201812,288,106,182,101124,173628,274752
351492,201812,31,22,9,20988,8586,29574
351495,201812,27,19,8,18126,7632,25758
351500,201812,3594,1547,2047,1468759.63,1948398.41,3417158.04
351510,201812,1832,761,1071,725421.8,1018757.46,1744179.26
351512,201812,22,18,4,17172,3816,20988
351515,201812,194,112,82,106848,78228,185076
351518,201812,804,501,303,477950,289062,767012
351519,201812,74,49,25,46746,23850,70596
351520,201812,142,86,56,81407.96,53424,134831.96
351530,201812,22,15,7,14310,6678,20988
351535,201812,131,75,56,71550,53424,124974
351540,201812,456,327,129,309575,123066,432641
351550,201812,1353,813,540,770611.92,513242.86,1283854.78
351560,201812,73,40,33,38160,31463,69623
351565,201812,10,6,4,5724,3816,9540
351570,201812,2654,1378,1276,1312289.12,1216633.65,2528922.77
351580,201812,39,35,4,33390,3816,37206
351590,201812,68,45,23,42930,21942,64872
351600,201812,194,143,51,136422,48654,185076
351610,201812,61,29,32,27666,30528,58194
351620,201812,5937,3381,2556,3212267.48,2434963.87,5647231.35
351630,201812,2619,1347,1272,1281822.49,1210764.53,2492587.02
351640,201812,1711,825,886,785590.38,842334.8,1627925.18
351650,201812,35,30,5,28620,4770,33390
351660,201812,152,98,54,93492,51516,145008
351670,201812,722,445,277,421440.34,264258,685698.34
351680,201812,73,59,14,56286,13356,69642
351685,201812,36,21,15,20034,14310,34344
351690,201812,309,216,93,204437.78,88722,293159.78
351700,201812,162,116,46,110664,43884,154548
351710,201812,77,51,26,48654,24804,73458
351720,201812,133,66,67,62964,63918,126882
351730,201812,96,66,30,62010.96,28615.23,90626.19
351740,201812,729,482,247,455511.92,235633.23,691145.15
351750,201812,357,149,208,141510,198238,339748
351760,201812,797,613,184,584207.41,175536,759743.41
351770,201812,305,260,45,248040,42930,290970
351780,201812,165,95,70,90621,66780,157401
351790,201812,255,135,120,128790,114480,243270
351800,201812,49,31,18,29574,17172,46746
351810,201812,123,83,40,79182,38160,117342
351820,201812,879,636,243,601022.6,231531.23,832553.83
351830,201812,518,186,332,176680.8,316728,493408.8
351840,201812,1883,954,929,901934.4,884764.94,1786699.34
351850,201812,234,172,62,163468.8,59148,222616.8
351860,201812,737,505,232,474332.6,221037.23,695369.83
351870,201812,5622,2697,2925,2562151.6,2782925.44,5345077.04
351880,201812,18973,8200,10773,7801740.03,10263966.07,18065706.10
351885,201812,91,61,30,57479,28620,86099
351890,201812,70,58,12,55332,11448,66780
351900,201812,225,133,92,126215,87768,213983
351905,201812,78,33,45,31482,42930,74412
351907,201812,3230,1412,1818,1344465.26,1731647.6,3076112.86
351910,201812,179,73,106,69642,101124,170766
351920,201812,129,73,56,69642,53401.69,123043.69
351925,201812,89,59,30,56286,28620,84906
351930,201812,393,258,135,245081.47,128790,373871.47
351940,201812,240,108,132,103032,125928,228960
351950,201812,139,81,58,77274,55332,132606
351960,201812,893,419,474,398091.73,450383.6,848475.33
351970,201812,1934,1046,888,995737.84,846571,1842308.84
351980,201812,149,75,74,71550,70596,142146
351990,201812,276,182,94,171435,88874.64,260309.64
352000,201812,370,228,142,216940,135468,352408
352010,201812,381,236,145,225144,137853,362997
352020,201812,203,70,133,66780,126882,193662
352030,201812,1074,554,520,527800.5,495443.96,1023244.46
352040,201812,590,254,336,242316,320544,562860
352042,201812,290,92,198,87768,188320,276088
352044,201812,377,224,153,212827.86,145962,358789.86
352050,201812,3369,1336,2033,1267753.18,1937946.26,3205699.44
352060,201812,106,67,39,63918,36920,100838
352070,201812,102,74,28,69326,26712,96038
352080,201812,68,42,26,40068,24804,64872
352090,201812,172,115,57,109710,54378,164088
352100,201812,271,128,143,121822,135270,257092
352110,201812,111,32,79,30528,75366,105894
352115,201812,71,28,43,26712,41022,67734
352120,201812,96,67,29,62678,27666,90344
352130,201812,227,188,39,179352,37206,216558
352140,201812,191,82,109,77751,103700,181451
352150,201812,118,65,53,61056.04,50562,111618.04
352160,201812,134,86,48,82044,45792,127836
352170,201812,371,258,113,245178.04,107802,352980.04
352180,201812,620,416,204,395243.5,194612,589855.5
352190,201812,260,101,159,96344.46,151647.84,247992.30
352200,201812,31,17,14,16218,13356,29574
352210,201812,3919,1657,2262,1572606.87,2151398.62,3724005.49
352215,201812,55,31,24,29574,22438.08,52012.08
352220,201812,7092,2735,4357,2604405.44,4154430.57,6758836.01
352230,201812,3315,2128,1187,2017518.85,1126980.68,3144499.53
352240,201812,2292,1332,960,1268534.69,913543.08,2182077.77
352250,201812,2632,1353,1279,1285816.96,1215924.36,2501741.32
352260,201812,1048,564,484,536525.23,461450,997975.23
352265,201812,58,25,33,23850,31482,55332
352270,201812,431,257,174,245178,165940,411118
352280,201812,424,267,157,254401,149773.23,404174.23
352290,201812,176,109,67,103986,63918,167904
352300,201812,97,73,24,69642,22896,92538
352310,201812,5876,2830,3046,2687277.93,2900290.04,5587567.97
352320,201812,969,507,462,480164.76,438983.1,919147.86
352330,201812,526,256,270,243890.1,257294,501184.1
352340,201812,1399,681,718,646927,681921,1328848
352350,201812,337,211,126,201294,119918,321212
352360,201812,233,97,136,91631.7,127147.52,218779.22
352370,201812,102,67,35,63918,33390,97308
352380,201812,121,73,48,69642,45792,115434
352390,201812,2475,1112,1363,1055919.32,1297532.03,2353451.35
352400,201812,482,207,275,197478,261777.6,459255.6
352410,201812,812,581,231,550957.76,220087.8,771045.56
352420,201812,109,71,38,67734,36252,103986
352430,201812,1801,815,986,773124.88,938362.3,1711487.18
352440,201812,3187,1621,1566,1537072.28,1492016.67,3029088.95
352450,201812,199,165,34,157410,32436,189846
352460,201812,602,306,296,291366.68,281716.2,573082.88
352470,201812,634,224,410,213696,391131,604827
352480,201812,1360,763,597,726629.96,569252,1295881.96
352490,201812,68,26,42,24804,40068,64872
352500,201812,1205,540,665,513348.4,634115,1147463.4
352510,201812,758,416,342,395910.96,326268,722178.96
352520,201812,591,261,330,248994,314676.9,563670.9
352530,201812,1712,903,809,861462,771404.6,1632866.6
352540,201812,74,50,24,47700,22896,70596
352550,201812,185,108,77,103032,72790.2,175822.2
352560,201812,50,40,10,38160,9540,47700
352570,201812,684,352,332,335205,316708.92,651913.92
352580,201812,61,42,19,39114.65,18126,57240.65
352585,201812,18,7,11,6678,10494,17172
352590,201812,4423,2255,2168,2144347.11,2065158.23,4209505.34
352600,201812,354,246,108,233492.46,103032,336524.46
352610,201812,974,441,533,418365.33,508482,926847.33
352620,201812,988,409,579,389232.2,551730,940962.2
352630,201812,169,63,106,60102,101114.46,161216.46
352640,201812,561,387,174,367186.02,165996,533182.02
352650,201812,90,60,30,57240,28620,85860
352660,201812,81,48,33,45792,31482,77274
352670,201812,1686,916,770,871333.89,733486.6,1604820.49
352680,201812,907,576,331,544078.16,314312.04,858390.20
352690,201812,4471,2060,2411,1956921.84,2297844.24,4254766.08
352700,201812,116,72,44,68401.8,41976,110377.8
352710,201812,1346,720,626,685639.8,594529.6,1280169.4
352720,201812,1352,648,704,614979.07,671039.03,1286018.10
352725,201812,24,22,2,20988,1908,22896
352730,201812,380,190,190,180081.81,181260,361341.81
352740,201812,426,273,153,258487.68,145702,404189.68
352750,201812,24,16,8,14977.8,7632,22609.8
352760,201812,193,134,59,127836,56286,184122
352770,201812,82,65,17,62010,16218,78228
352780,201812,77,42,35,40068,33390,73458
352790,201812,31,25,6,23850,5724,29574
352800,201812,251,176,75,167904,71263.8,239167.8
352810,201812,171,111,60,103383.42,57240,160623.42
352820,201812,63,50,13,47274.52,12402,59676.52
352830,201812,91,64,27,61056,25758,86814
352840,201812,657,341,316,323921.66,301464,625385.66
352850,201812,1384,485,899,462022.2,857646,1319668.2
352860,201812,136,89,47,84270,44838,129108
352870,201812,46,28,18,26712,17172,43884
352880,201812,189,128,61,121329.72,58194,179523.72
352885,201812,28,21,7,20034,6678,26712
352890,201812,59,41,18,39114,16886,56000
352900,201812,4854,2358,2496,2232370.18,2374258.07,4606628.25
352910,201812,39,32,7,30528,6678,37206
352920,201812,686,423,263,402588,250902,653490
352930,201812,1238,600,638,570318.02,605967.98,1176286.00
352940,201812,6515,2762,3753,2624469.88,3578830.87,6203300.75
352950,201812,99,40,59,38160,56286,94446
352960,201812,61,41,20,39114,19080,58194
352965,201812,19,8,11,7632,10494,18126
352970,201812,495,375,120,354455.15,113527,467982.15
352980,201812,174,94,80,89676,76320,165996
352990,201812,982,438,544,416869.38,517908.2,934777.58
353000,201812,67,31,36,29574,34344,63918
353010,201812,555,343,212,327222,202228.92,529450.92
353020,201812,287,211,76,201294,72504,273798
353030,201812,1264,570,694,541994.17,661389.66,1203383.83
353040,201812,91,57,34,54378,32436,86814
353050,201812,1356,876,480,830351.93,457633.8,1287985.73
353060,201812,8493,3760,4733,3570729.01,4508753.07,8079482.08
353070,201812,1699,1089,610,1032955.46,580479.56,1613435.02
353080,201812,1337,717,620,681967.55,589503,1271470.55
353090,201812,57,33,24,31482,22896,54378
353100,201812,62,50,12,47700,11448,59148
353110,201812,2067,643,1424,611691.54,1355579.03,1967270.57
353120,201812,87,49,38,46746,36252,82998
353130,201812,872,429,443,407162.09,422500.14,829662.23
353140,201812,582,232,350,221328,333900,555228
353150,201812,359,203,156,192708,148814.46,341522.46
353160,201812,99,80,19,76320,18126,94446
353170,201812,192,63,129,60102,123038.46,183140.46
353180,201812,973,451,522,427965.26,497369,925334.26
353190,201812,499,364,135,346302.9,128504,474806.9
353200,201812,209,111,98,105227,93492,198719
353205,201812,26,20,6,19080,5724,24804
353210,201812,85,51,34,48654,32436,81090
353215,201812,54,31,23,29574,21942,51516
353220,201812,82,47,35,44838,33390,78228
353230,201812,156,62,94,59148,89676,148824
353240,201812,302,167,135,159318,128790,288108
353250,201812,202,105,97,100170,92538,192708
353260,201812,467,333,134,317254,127826.46,445080.46
353270,201812,65,48,17,45792,15550.2,61342.2
353280,201812,96,52,44,49418,41976,91394
353282,201812,123,85,38,81090,36252,117342
353284,201812,25,20,5,19080,4770,23850
353286,201812,0,0,0,0,0,0
353290,201812,78,44,34,41976,32436,74412
353300,201812,420,234,186,219988.42,177444,397432.42
353310,201812,52,45,7,42930,6678,49608
353320,201812,60,37,23,35298,21942,57240
353325,201812,57,34,23,32427,21638,54065
353330,201812,67,49,18,46603,17172,63775
353340,201812,621,211,410,200611.89,390559.03,591170.92
353350,201812,919,429,490,408285.18,466489,874774.18
353360,201812,108,87,21,82998,19748,102746
353370,201812,123,69,54,65826,51516,117342
353380,201812,29,20,9,19076,8586,27662
353390,201812,1113,530,583,505620,556182,1061802
353400,201812,48,30,18,28620,17172,45792
353410,201812,112,71,41,67734,39067,106801
353420,201812,59,24,35,22896,33390,56286
353430,201812,571,381,190,359912.59,180973.8,540886.39
353440,201812,10366,4518,5848,4298751.47,5571556.01,9870307.48
353450,201812,55,31,24,29574,22896,52470
353460,201812,607,338,269,320236.83,255910.5,576147.33
353470,201812,2146,1157,989,1098356.62,941097.38,2039454.00
353475,201812,236,155,81,145183.6,77274,222457.6
353480,201812,187,154,33,146916,31482,178398
353490,201812,238,140,98,133560,93492,227052
353500,201812,190,110,80,103986.96,76320,180306.96
353510,201812,99,72,27,68669.46,25748.46,94417.92
353520,201812,205,142,63,135468,60102,195570
353530,201812,474,250,224,238500,213696,452196
353540,201812,368,246,122,234361.27,116388,350749.27
353550,201812,738,495,243,468416.62,231822,700238.62
353560,201812,635,265,370,252198.49,352379.52,604578.01
353570,201812,62,32,30,30242,28620,58862
353580,201812,358,274,84,258438.98,80136,338574.98
353590,201812,88,60,28,56922.04,26712,83634.04
353600,201812,271,151,120,143737,113844,257581
353610,201812,118,62,56,58830.04,53424,112254.04
353620,201812,594,314,280,299556,266833.8,566389.8
353625,201812,51,30,21,28620,20034,48654
353630,201812,241,175,66,164527.36,62964,227491.36
353640,201812,126,86,40,81567,38160,119727
353650,201812,899,356,543,337525.2,518022,855547.2
353657,201812,25,20,5,19080,4770,23850
353660,201812,259,143,116,136422,110664,247086
353670,201812,781,472,309,448380.2,294786,743166.2
353680,201812,104,73,31,69404,29574,98978
353690,201812,45,36,9,34070,8586,42656
353700,201812,275,197,78,187938,74125.8,262063.8
353710,201812,464,224,240,212742.8,228674,441416.8
353715,201812,47,33,14,31195.8,13356,44551.8
353720,201812,351,160,191,152631,182214,334845
353730,201812,1106,678,428,644809.2,407262.6,1052071.8
353740,201812,653,357,296,340004.47,282384,622388.47
353750,201812,89,57,32,53846.14,30528,84374.14
353760,201812,2819,1085,1734,1033031.11,1650447.28,2683478.39
353770,201812,98,80,18,75843,17172,93015
353780,201812,1252,604,648,573545.96,615998,1189543.96
353790,201812,510,296,214,280296.42,201557.35,481853.77
353800,201812,3316,1679,1637,1591476.29,1560191.73,3151668.02
353810,201812,230,134,96,126982.71,91575,218557.71
353820,201812,201,98,103,93492,97001.37,190493.37
353830,201812,47,40,7,38160,6678,44838
353850,201812,169,87,82,82998,78228,161226
353860,201812,493,223,270,212026.5,257198.4,469224.9
353870,201812,5301,2673,2628,2530857.73,2498337.47,5029195.20
353880,201812,692,496,196,470609.4,186984,657593.4
353890,201812,588,336,252,320258,240122,560380
353900,201812,138,71,67,67734,63918,131652
353910,201812,174,85,89,81090,84906,165996
353920,201812,450,247,203,234446.4,193219.16,427665.56
353930,201812,1035,616,419,585971.79,398954.48,984926.27
353940,201812,185,99,86,94446,81186,175632
353950,201812,536,325,211,309064.8,201285,510349.8
353960,201812,70,57,13,54378,12402,66780
353970,201812,74,43,31,41022,29574,70596
353980,201812,1587,770,817,732206.95,778479.76,1510686.71
353990,201812,75,42,33,40068,31482,71550
354000,201812,366,182,184,172961,175341.2,348302.2
354010,201812,93,52,41,49608,38637,88245
354020,201812,545,352,193,334854,184122,518976
354025,201812,49,39,10,37206,9540,46746
354030,201812,66,38,28,36252,26712,62964
354040,201812,95,68,27,64490.4,25758,90248.4
354050,201812,195,104,91,98930,86814,185744
354060,201812,765,369,396,352026,375543.4,727569.4
354070,201812,908,541,367,514769.03,350118,864887.03
354075,201812,222,114,108,108470,102078.8,210548.8
354080,201812,298,128,170,121825.8,162180,284005.8
354085,201812,19,12,7,11448,6678,18126
354090,201812,313,172,141,164007,134514,298521
354100,201812,5662,2431,3231,2307830.96,3075158.31,5382989.27
354105,201812,89,43,46,41022,43884,84906
354110,201812,48,22,26,20988,24804,45792
354120,201812,136,96,40,91444.97,38160,129604.97
354130,201812,713,470,243,448380,231532,679912
354140,201812,3132,1460,1672,1389202.8,1593090.14,2982292.94
354150,201812,647,404,243,383235,230391,613626
354160,201812,716,451,265,428966.1,252524,681490.1
354165,201812,24,15,9,14310,8586,22896
354170,201812,180,123,57,116674.2,54378,171052.2
354180,201812,66,41,25,38569.92,23850,62419.92
354190,201812,207,96,111,89962.2,105894,195856.2
354200,201812,125,69,56,65349,53424,118773
354210,201812,66,31,35,29574,33390,62964
354220,201812,643,400,243,381600,230582.35,612182.35
354230,201812,160,66,94,62964,89676,152640
354240,201812,320,209,111,198432.49,105894,304326.49
354250,201812,87,53,34,50562,32436,82998
354260,201812,2019,952,1067,897268.04,1015338.67,1912606.71
354270,201812,96,71,25,67734,23850,91584
354280,201812,44,23,21,21942,20034,41976
354290,201812,140,96,44,90773.1,41976,132749.1
354300,201812,419,285,134,271573,127678,399251
354310,201812,101,74,27,69642.2,25758,95400.2
354320,201812,190,102,88,97308,83381,180689
354323,201812,15,14,1,13356,954,14310
354325,201812,111,66,45,62487,42930,105417
354330,201812,2636,881,1755,835553.26,1672242.31,2507795.57
354340,201812,10658,5259,5399,5005570.83,5144005.93,10149576.76
354350,201812,126,82,44,78228,41832.9,120060.9
354360,201812,89,49,40,46746,38160,84906
354370,201812,261,145,116,138330,110664,248994
354380,201812,208,123,85,116556,81090,197646
354390,201812,2782,1007,1775,957245.96,1691379.78,2648625.74
354400,201812,334,174,160,165996,151782,317778
354410,201812,619,298,321,282666.43,305280.2,587946.63
354420,201812,279,175,104,166146,99216,265362
354425,201812,312,183,129,174582,123066,297648
354430,201812,186,115,71,109089.9,66970.8,176060.7
354440,201812,34,25,9,23850,8586,32436
354450,201812,48,35,13,33390,12402,45792
354460,201812,105,62,43,59148,41022,100170
354470,201812,42,27,15,25758,14310,40068
354480,201812,114,57,57,54369,54368.46,108737.46
354490,201812,144,88,56,83792.97,53424,137216.97
354500,201812,403,197,206,187938,196524,384462
354510,201812,101,72,29,68688,27666,96354
354515,201812,39,14,25,13356,23850,37206
354520,201812,1624,711,913,677013.4,870563.56,1547576.96
354530,201812,688,350,338,332178.8,321594.2,653773.0
354540,201812,283,159,124,151686,118291.23,269977.23
354550,201812,44,27,17,25758,16218,41976
354560,201812,161,89,72,84619.8,68678.46,153298.26
354570,201812,136,90,46,84907,43884,128791
354580,201812,1964,938,1026,892275,978218.26,1870493.26
354600,201812,264,150,114,140886.92,108741.69,249628.61
354610,201812,74,64,10,60103,9531,69634
354620,201812,62,19,43,18126,41017.23,59143.23
354625,201812,19,12,7,11448,6674,18122
354630,201812,322,217,105,206691.04,100170,306861.04
354640,201812,802,519,283,490914.16,269314.2,760228.36
354650,201812,77,44,33,41967,31453.92,73420.92
354660,201812,814,605,209,573148.46,199386,772534.46
354670,201812,268,93,175,88086,165997,254083
354680,201812,1286,482,804,459828,766539,1226367
354690,201812,85,55,30,51517,28620,80137
354700,201812,78,56,22,53424,20988,74412
354710,201812,58,40,18,37523.96,17172,54695.96
354720,201812,21,20,1,19080,954,20034
354730,201812,1835,791,1044,751457.7,995785.2,1747242.9
354740,201812,62,43,19,41022,18126,59148
354750,201812,439,258,181,246123,172388,418511
354760,201812,508,314,194,296995,184790,481785
354765,201812,11,5,6,4770,5724,10494
354770,201812,345,223,122,211918.03,116388,328306.03
354780,201812,8107,3309,4798,3144802.39,4573460.72,7718263.11
354790,201812,111,64,47,61056,44838,105894
354800,201812,442,242,200,230868,190494.92,421362.92
354805,201812,105,51,54,48018,51516,99534
354810,201812,127,75,52,71550,49608,121158
354820,201812,193,81,112,77065,106848,183913
354830,201812,40,22,18,20988,17172,38160
354840,201812,62,42,20,40068,19080,59148
354850,201812,4642,2104,2538,2000239.59,2417155.77,4417395.36
354860,201812,332,160,172,152640,161980.52,314620.52
354870,201812,12496,5631,6865,5343749.37,6540844.48,11884593.85
354880,201812,3104,1165,1939,1109486.26,1848493.6,2957979.86
354890,201812,2899,1612,1287,1530698.13,1226815.38,2757513.51
354900,201812,59,39,20,37206,19080,56286
354910,201812,1244,655,589,621333.17,561906,1183239.17
354920,201812,50,42,8,40068,7632,47700
354925,201812,14,8,6,7632,5724,13356
354930,201812,31,28,3,26442,2862,29304
354940,201812,842,618,224,586903.69,213696,800599.69
354950,201812,217,143,74,135755,70596,206351
354960,201812,162,64,98,61056,93206,154262
354970,201812,904,597,307,564678.14,292239.02,856917.16
354980,201812,8544,3158,5386,3003328.85,5134304.47,8137633.32
354990,201812,9063,4313,4750,4097703.22,4525294.42,8622997.64
354995,201812,539,189,350,180306,333900,514206
355000,201812,490,171,319,163129.23,304087.5,467216.73
355010,201812,615,387,228,369198,215300.48,584498.48
355020,201812,744,467,277,444559.59,264250,708809.59
355030,201812,210343,81921,128422,77910139.59,122411416.92,200321556.51
355040,201812,748,352,396,333757.6,376639.2,710396.8
355050,201812,152,102,50,96037.77,47700,143737.77
355060,201812,1613,817,796,774568.94,757906.1,1532475.04
355070,201812,1457,710,747,673669.16,712312,1385981.16
355080,201812,205,118,87,112572,82110.8,194682.8
355090,201812,297,190,107,179162,101125,280287
355100,201812,4888,2421,2467,2288053.2,2350204.22,4638257.42
355110,201812,271,175,96,165993,91584,257577
355120,201812,86,62,24,59148,22887,82035
355130,201812,58,33,25,31382,23850,55232
355140,201812,183,120,63,113764.5,60102,173866.5
355150,201812,700,422,278,401344,264735,666079
355160,201812,474,230,244,217035.96,232776,449811.96
355170,201812,2094,1098,996,1046353.14,948574.96,1994928.10
355180,201812,642,278,364,264258,346969.8,611227.8
355190,201812,224,154,70,146916,66780,213696
355200,201812,118,68,50,64872,47700,112572
355210,201812,707,401,306,382554,291905.46,674459.46
355220,201812,6986,3723,3263,3541256.86,3101066.7,6642323.56
355230,201812,108,64,44,60483.6,41971.23,102454.83
355240,201812,4419,1907,2512,1807979.74,2392186.09,4200165.83
355250,201812,5569,2647,2922,2520255.42,2783893.36,5304148.78
355255,201812,50,30,20,28620,19080,47700
355260,201812,186,111,75,104921.12,71522.46,176443.58
355270,201812,170,103,67,98262,63203,161465
355280,201812,6366,2674,3692,2545250.72,3518706.46,6063957.18
355290,201812,75,58,17,55332,16218,71550
355300,201812,192,122,70,115434.8,66494,181928.8
355310,201812,108,60,48,57240,45792,103032
355320,201812,89,47,42,44838,39120.6,83958.6
355330,201812,286,162,124,153880.2,118296,272176.2
355340,201812,1605,535,1070,507783.81,1020780,1528563.81
355350,201812,132,70,62,66780,59148,125928
355360,201812,179,116,63,110454.12,60102,170556.12
355365,201812,25,20,5,19080,4770,23850
355370,201812,1032,597,435,564606.74,413740.55,978347.29
355380,201812,792,519,273,494534.52,260442,754976.52
355385,201812,66,47,19,44838,18126,62964
355390,201812,106,63,43,60102,41022,101124
355395,201812,186,110,76,103873.23,72504,176377.23
355400,201812,1605,975,630,926151.52,598858.04,1525009.56
355410,201812,4903,2339,2564,2214604.84,2439114.8,4653719.64
355420,201812,51,37,14,35298,13356,48654
355430,201812,350,208,142,197096.4,135468,332564.4
355440,201812,81,48,33,45792,31482,77274
355450,201812,452,221,231,208402.14,219420.2,427822.34
355460,201812,67,52,15,48654.42,14310,62964.42
355465,201812,51,32,19,30528,18126,48654
355470,201812,184,75,109,70596.1,103986,174582.1
355475,201812,15,10,5,9540,4770,14310
355480,201812,467,209,258,198528.2,245464.2,443992.4
355490,201812,115,81,34,77274,32436,109710
355495,201812,57,28,29,26712,27666,54378
355500,201812,1645,923,722,874183.13,688613.59,1562796.72
355510,201812,269,198,71,186302.92,67734,254036.92
355520,201812,30,22,8,20702,7632,28334
355530,201812,25,17,8,16218,7632,23850
355535,201812,82,40,42,38160,40068,78228
355540,201812,2379,944,1435,899117.53,1368027.96,2267145.49
355550,201812,63,37,26,35298,24804,60102
355560,201812,242,118,124,112572,118009.8,230581.8
355570,201812,28,19,9,18126,8586,26712
355580,201812,264,179,85,170766,80800,251566
355590,201812,25,16,9,15264,8586,23850
355600,201812,271,140,131,133560,124683.23,258243.23
355610,201812,229,152,77,145008,73458,218466
355620,201812,1330,635,695,605504,662520.38,1268024.38
355630,201812,425,312,113,297648,106848.96,404496.96
355635,201812,126,60,66,57240,62951,120191
355640,201812,581,329,252,312912.16,240408,553320.16
355645,201812,847,363,484,344823.3,459856.82,804680.12
355650,201812,2120,890,1230,844837.6,1173401.46,2018239.06
355660,201812,257,140,117,133560,111618,245178
355670,201812,522,207,315,196841.96,300223.8,497065.76
355680,201812,209,119,90,112573,85192.2,197765.2
355690,201812,88,40,48,38160,45448,83608
355695,201812,14,11,3,10494,2862,13356
355700,201812,1149,597,552,564115.62,525838.15,1089953.77
355710,201812,2249,1230,1019,1169783.56,971649,2141432.56
355715,201812,19,16,3,15264,2862,18126
355720,201812,206,123,83,115752.08,79182,194934.08
355730,201812,99,58,41,54457.95,39114,93571.95
410010,201812,134,113,21,107802,20034,127836
410020,201812,107,92,15,87768,14310,102078
410030,201812,165,104,61,98549,58146,156695
410040,201812,1011,550,461,523709.74,439604,963313.74
410045,201812,31,26,5,24804,4770,29574
410050,201812,472,266,206,253764,196047,449811
410060,201812,275,208,67,198432,63918,262350
410070,201812,309,255,54,242983.8,51516,294499.8
410080,201812,166,105,61,100170,58194,158364
410090,201812,77,69,8,65617,7632,73249
410100,201812,297,212,85,202248,80994.6,283242.6
410105,201812,47,28,19,26712,18126,44838
410110,201812,327,196,131,186984,124974,311958
410115,201812,31,21,10,20034,9540,29574
410120,201812,406,215,191,204823.8,182214,387037.8
410130,201812,47,30,17,28620,16218,44838
410140,201812,3151,1529,1622,1451855.46,1542523.4,2994378.86
410150,201812,2729,1109,1620,1056213.14,1544883.8,2601096.94
410160,201812,501,317,184,302122.26,175536,477658.26
410165,201812,68,46,22,43884,20988,64872
410170,201812,171,124,47,116871,44838,161709
410180,201812,2174,1269,905,1206524.28,862198.95,2068723.23
410185,201812,35,31,4,29574,3816,33390
410190,201812,496,325,171,309286.8,163134,472420.8
410200,201812,963,727,236,692708.94,225144,917852.94
410210,201812,571,301,270,286839.18,257294,544133.18
410220,201812,42,21,21,20034,20012.12,40046.12
410230,201812,132,73,59,69642,56286,125928
410240,201812,739,488,251,465266,239454,704720
410250,201812,375,278,97,264607.84,92533.23,357141.07
410260,201812,304,172,132,164088,125928,290016
410270,201812,29,19,10,18126,9540,27666
410275,201812,62,46,16,43884,15264,59148
410280,201812,329,191,138,181954.52,131652,313606.52
410290,201812,238,151,87,144054,82044,226098
410300,201812,80,63,17,60102,16218,76320
410302,201812,25,16,9,15264,8586,23850
410304,201812,44,30,14,28620,13356,41976
410305,201812,215,120,95,113812.2,90630,204442.2
410310,201812,264,170,94,162180,89656.92,251836.92
410315,201812,49,36,13,34320,12402,46722
410320,201812,138,95,43,90630,41022,131652
410322,201812,34,23,11,21942,10494,32436
410330,201812,170,122,48,116388,45602,161990
410335,201812,100,60,40,57240,38160,95400
410337,201812,41,35,6,33390,5724,39114
410340,201812,31,29,2,27666,1908,29574
410345,201812,224,140,84,133560,80136,213696
410347,201812,50,37,13,35298,12402,47700
410350,201812,233,141,92,134514,87768,222282
410360,201812,475,293,182,276978.4,172103,449081.4
410370,201812,2403,1026,1377,974923.32,1311225.82,2286149.14
410380,201812,227,143,84,136422,80136,216558
410390,201812,369,272,97,259484,92538,352022
410395,201812,35,24,11,22896,10494,33390
410400,201812,842,423,419,402213.2,397137.1,799350.3
410405,201812,92,71,21,67734,20034,87768
410410,201812,37,28,9,26712,8586,35298
410420,201812,1658,820,838,780085.89,797576.96,1577662.85
410425,201812,172,82,90,78038,85860,163898
410430,201812,2195,1283,912,1219880.54,869380.2,2089260.74
410440,201812,387,286,101,272844,96354,369198
410442,201812,363,247,116,234685,110664,345349
410445,201812,413,293,120,278726.06,114480,393206.06
410450,201812,395,206,189,196524,180306,376830
410460,201812,465,250,215,237918.06,205110,443028.06
410465,201812,203,128,75,120585.6,71550,192135.6
410470,201812,233,147,86,140238,82044,222282
410480,201812,6024,2995,3029,2838123.78,2883842.33,5721966.11
410490,201812,1435,930,505,885723,478622.85,1364345.85
410500,201812,272,159,113,151686,107802,259488
410510,201812,175,129,46,123066,43875,166941
410520,201812,255,191,64,182214,61056,243270
410530,201812,230,84,146,80136,139280,219416
410540,201812,320,230,90,218661.95,85855.23,304517.18
410550,201812,1669,748,921,713305.8,877434.36,1590740.16
410560,201812,132,102,30,97308,28620,125928
410570,201812,431,296,135,280296.2,128790,409086.2
410580,201812,3192,1441,1751,1373471.8,1669978,3043449.8
410590,201812,402,285,117,271890,111618,383508
410600,201812,190,162,28,154548,26712,181260
410610,201812,59,50,9,47700,8586,56286
410620,201812,242,176,66,167904,62964,230868
410630,201812,439,258,181,246132,172674,418806
410640,201812,1040,652,388,618191.27,368545.28,986736.55
410645,201812,103,77,26,73458,24804,98262
410650,201812,364,247,117,234684,111618,346302
410655,201812,78,58,20,55332,19080,74412
410657,201812,44,18,26,17172,24804,41976
410660,201812,617,438,179,416036.8,170766,586802.8
410670,201812,74,63,11,60102,10494,70596
410680,201812,201,168,33,159604.2,31482,191086.2
410685,201812,17,11,6,10494,5724,16218
410690,201812,28094,12207,15887,11622807.59,15145468.85,26768276.44
410700,201812,322,240,82,228674,78228,306902
410710,201812,130,107,23,102078,21942,124020
410712,201812,20,14,6,13356,5724,19080
410715,201812,89,67,22,63918,20988,84906
410720,201812,621,373,248,355842,236583,592425
410725,201812,178,132,46,125928,43884,169812
410730,201812,86,52,34,49608,32436,82044
410740,201812,113,83,30,79182,28620,107802
410750,201812,226,162,64,154548,61051.23,215599.23
410752,201812,25,16,9,15264,8586,23850
410753,201812,50,22,28,20315.43,26712,47027.43
410754,201812,38,22,16,20702,15264,35966
410755,201812,80,53,27,49989.6,25758,75747.6
410760,201812,731,414,317,394621.12,302418,697039.12
410765,201812,1680,818,862,773559,821194.26,1594753.26
410770,201812,105,82,23,78228,21942,100170
410773,201812,53,39,14,37206,13356,50562
410775,201812,174,134,40,127168.2,38160,165328.2
410780,201812,82,46,36,43884,34344,78228
410785,201812,56,45,11,42930,10494,53424
410790,201812,75,36,39,34344,37206,71550
410800,201812,288,181,107,171721,102078,273799
410810,201812,24,20,4,19080,3530,22610
410820,201812,182,134,48,127836,45792,173628
410830,201812,8532,3834,4698,3645347.01,4479032.14,8124379.15
410832,201812,103,73,30,69642,28620,98262
410840,201812,1446,809,637,769518.08,606498.28,1376016.36
410845,201812,65,42,23,39782,21942,61724
410850,201812,199,141,58,133719.52,55332,189051.52
410855,201812,53,46,7,43884,6678,50562
410860,201812,687,398,289,378452.76,275706,654158.76
410865,201812,105,81,24,77274,22896,100170
410870,201812,157,133,24,126882,22896,149778
410880,201812,1134,575,559,547874.82,533231,1081105.82
410890,201812,84,58,26,55332,24804,80136
410895,201812,70,53,17,50562,16218,66780
410900,201812,21,13,8,12402,7632,20034
410910,201812,15,13,2,12402,1908,14310
410920,201812,33,22,11,20988,10494,31482
410930,201812,510,328,182,312700.98,173628,486328.98
410940,201812,4368,2556,1812,2428147.6,1725670.4,4153818.0
410950,201812,114,85,29,81090,27666,108756
410960,201812,777,350,427,333327.6,407168,740495.6
410965,201812,70,54,16,51229.8,15264,66493.8
410970,201812,639,461,178,439326.2,169812,609138.2
410975,201812,111,66,45,62453,42930,105383
410980,201812,1624,740,884,702459.82,841805.6,1544265.42
410990,201812,272,188,84,179352,79849.8,259201.8
411000,201812,65,40,25,38160,23564,61724
411005,201812,25,19,6,18126,5724,23850
411007,201812,248,143,105,136135.8,100170,236305.8
411010,201812,579,403,176,384462,167904,552366
411020,201812,295,205,90,195570,85860,281430
411030,201812,16,9,7,8586,6678,15264
411040,201812,52,37,15,35298,14310,49608
411050,201812,223,174,49,165379.96,46619.12,211999.08
411060,201812,518,348,170,331983,162180,494163
411065,201812,69,59,10,56286,9540,65826
411070,201812,1222,802,420,760202.31,400680,1160882.31
411080,201812,231,165,66,157410,62964,220374
411090,201812,111,83,28,79182,26712,105894
411095,201812,284,114,170,108756,162170,270926
411100,201812,115,95,20,90630,19080,109710
411110,201812,122,85,37,81090,35298,116388
411120,201812,194,141,53,134514,50562,185076
411125,201812,199,92,107,86833.08,102030.3,188863.38
411130,201812,126,108,18,102394,17172,119566
411140,201812,191,129,62,123044.12,58623.3,181667.42
411150,201812,1244,827,417,788280.66,396470.96,1184751.62
411155,201812,124,83,41,78895.8,39114,118009.8
411160,201812,24,11,13,10494,12402,22896
411170,201812,53,48,5,45504.67,4770,50274.67
411180,201812,975,651,324,618860.63,309091.23,927951.86
411190,201812,340,195,145,185362.2,138330,323692.2
411200,201812,685,447,238,425167.89,226032.18,651200.07
411210,201812,707,380,327,360970.21,311949,672919.21
411220,201812,151,112,39,106848,37206,144054
411230,201812,43,36,7,34344,6678,41022
411240,201812,126,86,40,82044,38160,120204
411250,201812,432,317,115,302418,109710,412128
411260,201812,20,13,7,12402,6678,19080
411270,201812,292,159,133,151686,126882,278568
411275,201812,207,183,24,174152.8,22896,197048.8
411280,201812,224,158,66,150415,62964,213379
411290,201812,58,43,15,41022,14310,55332
411295,201812,152,120,32,114480,30528,145008
411300,201812,69,36,33,34344,31482,65826
411310,201812,91,70,21,66780,20034,86814
411320,201812,744,535,209,508769,197783.28,706552.28
411325,201812,63,40,23,38160,21942,60102
411330,201812,927,597,330,567726.41,314652.46,882378.87
411340,201812,26,17,9,16218,8272,24490
411342,201812,71,54,17,51516,16218,67734
411345,201812,123,62,61,59148,58194,117342
411350,201812,498,394,104,374397.64,98930,473327.64
411360,201812,56,36,20,34344,19080,53424
411370,201812,14458,5907,8551,5614935.09,8142080.88,13757015.97
411373,201812,182,135,47,128790,44838,173628
411375,201812,72,60,12,57240,11448,68688
411380,201812,95,73,22,69642,20988,90630
411390,201812,133,89,44,84906,41976,126882
411400,201812,364,278,86,265203,82044,347247
411410,201812,436,229,207,217798.2,197192,414990.2
411420,201812,1049,475,574,450860.4,546594.3,997454.7
411430,201812,416,266,150,253096.2,143091,396187.2
411435,201812,36,25,11,23850,10494,34344
411440,201812,475,383,92,362462.17,87768,450230.17
411450,201812,426,359,67,342486,63918,406404
411460,201812,769,307,462,291170.96,437129.67,728300.63
411470,201812,84,62,22,59148,20988,80136
411480,201812,653,374,279,354316.4,265593.6,619910.0
411490,201812,302,192,110,183168,104653.8,287821.8
411500,201812,110,93,17,88518.33,15837,104355.33
411510,201812,219,178,41,169064.06,39114,208178.06
411520,201812,5997,2341,3656,2228491.9,3480067.66,5708559.56
411530,201812,114,79,35,75366,33390,108756
411535,201812,51,22,29,20988,27666,48654
411540,201812,360,248,112,235569.9,106848,342417.9
411545,201812,56,40,16,38160,15264,53424
411550,201812,79,61,18,58194,17172,75366
411560,201812,389,179,210,169100.86,200340,369440.86
411570,201812,786,302,484,286859.44,461536.46,748395.90
411573,201812,30,18,12,17172,11448,28620
411575,201812,285,180,105,171720,100170,271890
411580,201812,1255,500,755,475693.02,718422.4,1194115.42
411585,201812,77,38,39,36252,37206,73458
411590,201812,22,16,6,15264,5724,20988
411600,201812,26,12,14,11448,13356,24804
411605,201812,241,102,139,97308,132606,229914
411610,201812,242,164,78,156456,74412,230868
411620,201812,342,200,142,190323,134829,325152
411630,201812,56,40,16,38160,15264,53424
411640,201812,35,29,6,27666,5724,33390
411650,201812,13,8,5,7632,4770,12402
411660,201812,35,27,8,25758,7632,33390
411670,201812,247,184,63,175536,60102,235638
411680,201812,155,135,20,128790,19080,147870
411690,201812,589,313,276,298023.56,262980.2,561003.76
411695,201812,61,45,16,42930,15264,58194
411700,201812,156,134,22,127836,20988,148824
411705,201812,101,65,36,62010,34344,96354
411710,201812,311,208,103,197365.81,98262,295627.81
411720,201812,138,91,47,86814,44838,131652
411721,201812,60,51,9,48654,8586,57240
411722,201812,100,43,57,41022,54378,95400
411725,201812,150,115,35,109137.8,33390,142527.8
411727,201812,75,60,15,57240,14023.8,71263.8
411729,201812,35,28,7,26712,6678,33390
411730,201812,540,348,192,330401.96,182881.8,513283.76
411740,201812,40,25,15,23850,14310,38160
411745,201812,71,47,24,44047,22896,66943
411750,201812,879,411,468,390997.9,445895.03,836892.93
411760,201812,1214,920,294,876431.2,280467,1156898.2
411770,201812,451,300,151,286200,144054,430254
411780,201812,334,216,118,206064,112572,318636
411790,201812,530,302,228,286226.47,216501.84,502728.31
411800,201812,171,135,36,128790,34344,163134
411810,201812,167,126,41,120204,39114,159318
411820,201812,2120,1024,1096,973348.22,1044860.3,2018208.52
411830,201812,13,13,0,12402,0,12402
411840,201812,1940,1204,736,1146708,700697.2,1847405.2
411845,201812,51,21,30,20034,28620,48654
411850,201812,1235,700,535,666232.4,508436.48,1174668.88
411860,201812,48,33,15,31196,14310,45506
411870,201812,76,54,22,51516,20701.8,72217.8
411880,201812,422,271,151,258420,144054,402474
411885,201812,105,69,36,65826,34344,100170
411890,201812,322,205,117,193376.99,111608.46,304985.45
411900,201812,68,50,18,47700,17172,64872
411910,201812,184,144,40,137366.46,37320.48,174686.94
411915,201812,2115,917,1198,872359.57,1141828.05,2014187.62
411920,201812,124,102,22,97308,20988,118296
411925,201812,12,8,4,7632,3816,11448
411930,201812,802,590,212,560954,202248,763202
411940,201812,594,413,181,393525,172674,566199
411950,201812,902,483,419,460037.88,398454.04,858491.92
411960,201812,1060,730,330,692458.79,314820,1007278.79
411965,201812,26,18,8,17172,7632,24804
411970,201812,77,69,8,65826,7632,73458
411980,201812,167,117,50,111618,47700,159318
411990,201812,5182,3025,2157,2866198.99,2055880.44,4922079.43
411995,201812,453,172,281,164088,268074,432162
412000,201812,306,190,116,181069.2,110654.46,291723.66
412010,201812,54,32,22,30528,20988,51516
412015,201812,46,33,13,31482,12402,43884
412020,201812,27,23,4,21655.8,3816,25471.8
412030,201812,59,51,8,48654,7632,56286
412033,201812,57,38,19,36228,18126,54354
412035,201812,71,47,24,44838,22896,67734
412040,201812,37,24,13,22610,12402,35012
412050,201812,200,149,51,142146,48654,190800
412060,201812,768,590,178,559998.74,168821.8,728820.54
412065,201812,49,33,16,31482,15264,46746
412070,201812,161,109,52,103318.2,49608,152926.2
412080,201812,287,156,131,148824,124974,273798
412085,201812,34,16,18,15264,17172,32436
412090,201812,775,490,285,465791.2,271890,737681.2
412100,201812,248,210,38,199387,36252,235639
412110,201812,67,53,14,50562,13356,63918
412120,201812,316,204,112,194043.6,106848,300891.6
412125,201812,82,48,34,45505.8,32436,77941.8
412130,201812,40,29,11,27361,10494,37855
412135,201812,27,16,11,15264,10494,25758
412140,201812,320,228,92,216657.05,87768,304425.05
412150,201812,248,174,74,165042.04,70596,235638.04
412160,201812,87,52,35,49608,33390,82998
412170,201812,676,474,202,451909.8,192708,644617.8
412175,201812,37,28,9,26712,8586,35298
412180,201812,200,159,41,151086.61,38493.9,189580.51
412190,201812,334,264,70,251183.43,66780,317963.43
412200,201812,199,123,76,117342,72504,189846
412210,201812,78,61,17,58194,16218,74412
412215,201812,230,162,68,154548,64585.8,219133.8
412217,201812,75,59,16,56286,15264,71550
412220,201812,816,612,204,583848,194616,778464
412230,201812,341,205,136,193948.2,129707.46,323655.66
412240,201812,1337,656,681,622475.54,647378.56,1269854.10
412250,201812,370,240,130,228960,124020,352980
412260,201812,108,79,29,75366,27666,103032
412265,201812,175,137,38,130380.04,36252,166632.04
412270,201812,80,52,28,49608,26712,76320
412280,201812,92,73,19,69642,18126,87768
412290,201812,96,66,30,62964,28620,91584
412300,201812,214,137,77,130698,73314.9,204012.9
412310,201812,44,39,5,37206,4770,41976
412320,201812,94,80,14,76320,13356,89676
412330,201812,177,154,23,146916,21942,168858
412340,201812,153,109,44,103318.2,41690,145008.2
412350,201812,603,308,295,292830.3,281430,574260.3
412360,201812,29,25,4,23850,3816,27666
412370,201812,167,146,21,137853,20034,157887
412380,201812,264,197,67,187651.8,63814,251465.8
412382,201812,53,28,25,26712,23850,50562
412385,201812,144,106,38,101124,36252,137376
412390,201812,289,222,67,211788,63918,275706
412395,201812,72,57,15,54378,14310,68688
412400,201812,73,51,22,48654,20988,69642
412402,201812,252,124,128,118291.23,121825.8,240117.03
412405,201812,838,329,509,311458.24,484804.46,796262.70
412410,201812,973,607,366,576667.28,349164,925831.28
412420,201812,14,12,2,11448,1908,13356
412430,201812,21,15,6,14310,5724,20034
412440,201812,608,334,274,316356.94,259676.4,576033.34
412450,201812,81,69,12,65826,11448,77274
412460,201812,82,61,21,58194,20034,78228
412470,201812,231,183,48,174582,45792,220374
412480,201812,167,124,43,117342.9,41022,158364.9
412490,201812,158,138,20,131652,19080,150732
412500,201812,457,375,82,356175.8,78228,434403.8
412510,201812,187,156,31,148538,29574,178112
412520,201812,138,74,64,70596,61056,131652
412530,201812,107,56,51,53424,48367.8,101791.8
412535,201812,111,81,30,77256,28620,105876
412540,201812,71,36,35,34344,33390,67734
412545,201812,96,71,25,67734,23850,91584
412550,201812,3534,1614,1920,1536092.64,1830250.8,3366343.44
412555,201812,14,10,4,9540,3816,13356
412560,201812,591,438,153,415753.2,145962,561715.2
412570,201812,744,412,332,391483.44,316728,708211.44
412575,201812,86,60,26,57240,24804,82044
412580,201812,165,109,56,103986,53424,157410
412590,201812,34,32,2,30528,1908,32436
412600,201812,173,130,43,124020,41022,165042
412610,201812,31,19,12,18126,11448,29574
412620,201812,150,131,19,124974,18126,143100
412625,201812,2207,1175,1032,1118033.75,982364.39,2100398.14
412627,201812,71,57,14,54378,13356,67734
412630,201812,422,283,139,268448.23,132606,401054.23
412635,201812,67,19,48,18126,45792,63918
412640,201812,120,79,41,75366,39114,114480
412650,201812,350,219,131,208926,124969.23,333895.23
412660,201812,472,293,179,278807,170766,449573
412665,201812,51,45,6,42930,5724,48654
412667,201812,293,202,91,191937.54,86571.8,278509.34
412670,201812,62,52,10,49608,9540,59148
412680,201812,301,238,63,227052,60102,287154
412690,201812,104,65,39,62010,36920,98930
412700,201812,153,103,50,98262,47414,145676
412710,201812,1395,868,527,820538.4,501804,1322342.4
412720,201812,239,159,80,151686,76320,228006
412730,201812,195,159,36,151686,33390,185076
412740,201812,430,238,192,226908.9,183168,410076.9
412750,201812,466,272,194,258534,185076,443610
412760,201812,265,137,128,130698,122112,252810
412770,201812,2136,1207,929,1146970.92,884731,2031701.92
412780,201812,156,121,35,115434,33390,148824
412785,201812,262,129,133,122589,126882,249471
412788,201812,37,22,15,20988,14310,35298
412790,201812,135,111,24,105226.2,22896,128122.2
412795,201812,154,115,39,109710,37206,146916
412796,201812,308,215,93,204206,88588.44,292794.44
412800,201812,575,375,200,357454.26,190800,548254.26
412810,201812,3003,1655,1348,1573129.3,1284747.03,2857876.33
412820,201812,954,623,331,584577.69,314411,898988.69
412830,201812,13,11,2,10494,1908,12402
412840,201812,227,161,66,152640.2,62964,215604.2
412850,201812,782,528,254,501804,242316,744120
412853,201812,173,90,83,85860,78896,164756
412855,201812,222,120,102,113368.82,97308,210676.82
412860,201812,97,70,27,66780,25758,92538
412862,201812,58,43,15,41022,14310,55332
412863,201812,6,5,1,4770,954,5724
412865,201812,41,30,11,28620,10494,39114
412870,201812,109,71,38,67734,36252,103986
412880,201812,101,74,27,70310,25758,96068
420005,201812,42,37,5,35298,4770,40068
420010,201812,381,256,125,243126.9,118964,362090.9
420020,201812,86,70,16,66780,15264,82044
420030,201812,29,27,2,25758,1908,27666
420040,201812,110,85,25,81090,23850,104940
420050,201812,54,33,21,31482,20034,51516
420055,201812,19,18,1,17172,954,18126
420060,201812,31,23,8,21942,7632,29574
420070,201812,110,93,17,88722,16208.46,104930.46
420075,201812,11,10,1,9540,954,10494
420080,201812,49,44,5,41022,4770,45792
420090,201812,35,33,2,30704.49,1908,32612.49
420100,201812,166,140,26,132606.2,24804,157410.2
420110,201812,20,20,0,19080,0,19080
420120,201812,55,43,12,41022,11448,52470
420125,201812,86,70,16,66780,15264,82044
420127,201812,33,29,4,27666,3816,31482
420130,201812,395,248,147,236592,139989.96,376581.96
420140,201812,1312,747,565,711027.38,538944,1249971.38
420150,201812,45,40,5,38160,4770,42930
420160,201812,36,34,2,32436,1908,34344
420165,201812,19,14,5,13356,4770,18126
420170,201812,73,46,27,43884,25758,69642
420180,201812,24,23,1,21942,954,22896
420190,201812,31,27,4,25758,3816,29574
420195,201812,127,62,65,59148,62010,121158
420200,201812,1268,571,697,538421.52,663881.38,1202302.90
420205,201812,66,38,28,36252,26712,62964
420207,201812,109,63,46,59864,43874.46,103738.46
420208,201812,22,17,5,16218,3911.4,20129.4
420209,201812,20,16,4,15264,3816,19080
420210,201812,463,226,237,215317.8,226022.22,441340.02
420213,201812,43,35,8,33390,7632,41022
420215,201812,29,25,4,23850,3816,27666
420220,201812,66,43,23,41022,21942,62964
420230,201812,804,457,347,434547.2,330542.46,765089.66
420240,201812,2276,1530,746,1451612.37,711245.16,2162857.53
420243,201812,39,31,8,29574,7632,37206
420245,201812,125,62,63,59148,60102,119250
420250,201812,57,34,23,32436,21942,54378
420253,201812,43,35,8,33390,7632,41022
420257,201812,14,12,2,11448,1908,13356
420260,201812,105,91,14,86814,13356,100170
420270,201812,39,32,7,30524,6678,37202
420280,201812,278,209,69,197662.06,64692.1,262354.16
420285,201812,20,12,8,11448,7632,19080
420287,201812,56,36,20,34344,19080,53424
420290,201812,969,684,285,649642.18,271063.1,920705.28
420300,201812,1404,1122,282,1065666.78,266834.34,1332501.12
420310,201812,57,44,13,41976,12402,54378
420315,201812,33,29,4,27666,3816,31482
420320,201812,850,435,415,414012.15,395906,809918.15
420325,201812,0,0,0,0,0,0
420330,201812,125,85,40,81090,38045.52,119135.52
420340,201812,165,111,54,104932,51487.38,156419.38
420350,201812,262,194,68,183521.78,64872,248393.78
420360,201812,771,584,187,554265.7,178113.38,732379.08
420370,201812,118,73,45,69452,42644,112096
420380,201812,1144,813,331,771051.76,315690.84,1086742.60
420390,201812,262,177,85,167027.52,80374.5,247402.02
420395,201812,183,132,51,125928,47790.63,173718.63
420400,201812,247,187,60,177369,57240,234609
420410,201812,62,47,15,44838,14310,59148
420415,201812,34,32,2,30528,1908,32436
420417,201812,53,39,14,37206,13336.92,50542.92
420419,201812,12,12,0,11448,0,11448
420420,201812,2846,1760,1086,1668041.42,1033746.88,2701788.30
420425,201812,77,64,13,61047,12087.72,73134.72
420430,201812,1272,892,380,847350.7,360680.72,1208031.42
420435,201812,17,15,2,14310,1908,16218
420440,201812,106,74,32,69990.56,30398.48,100389.04
420445,201812,23,21,2,20034,1908,21942
420450,201812,72,36,36,34344,34344,68688
420455,201812,221,167,54,159271.92,51460.38,210732.30
420460,201812,2365,1567,798,1491054.96,761067.9,2252122.86
420470,201812,116,85,31,81051.84,29574,110625.84
420475,201812,6,6,0,5724,0,5724
420480,201812,879,661,218,624470.72,206923,831393.72
420490,201812,112,85,27,81090,25758,106848
420500,201812,641,288,353,272781.2,336762,609543.2
420510,201812,18,15,3,14310,2862,17172
420515,201812,27,21,6,20034,5724,25758
420517,201812,10,10,0,9540,0,9540
420519,201812,0,0,0,0,0,0
420520,201812,72,53,19,50562,18126,68688
420530,201812,166,112,54,105894.9,51516,157410.9
420535,201812,20,19,1,18126,954,19080
420540,201812,5104,3023,2081,2870278.94,1979980.18,4850259.12
420543,201812,27,27,0,25758,0,25758
420545,201812,202,143,59,136422,56266.92,192688.92
420550,201812,875,707,168,671580.32,160114.73,831695.05
420555,201812,39,28,11,26712,10494,37206
420560,201812,67,54,13,51134.4,12402,63536.4
420570,201812,157,94,63,89676,60092.46,149768.46
420580,201812,296,132,164,125928,156170,282098
420590,201812,516,365,151,347923.8,144054,491977.8
420600,201812,106,58,48,55046,45792,100838
420610,201812,41,38,3,36252,2862,39114
420620,201812,75,62,13,59148,12402,71550
420630,201812,161,117,44,111609.23,41968,153577.23
420640,201812,91,82,9,78037.2,8586,86623.2
420650,201812,231,122,109,115720.2,103367.23,219087.43
420660,201812,57,44,13,41212.8,12402,53614.8
420665,201812,39,29,10,27666,9540,37206
420670,201812,329,249,80,236830.5,76301.46,313131.96
420675,201812,16,15,1,14310,954,15264
420680,201812,37,27,10,25758,9540,35298
420690,201812,177,149,28,142146,26712,168858
420700,201812,676,472,204,449021.01,194382.36,643403.37
420710,201812,153,87,66,82998,62677.8,145675.8
420720,201812,112,91,21,86804.46,20034,106838.46
420730,201812,580,378,202,359545.5,191413.66,550959.16
420740,201812,47,46,1,43884,954,44838
420750,201812,501,336,165,320257.8,157410,477667.8
420757,201812,19,16,3,15264,2862,18126
420760,201812,36,30,6,28620,5724,34344
420765,201812,72,58,14,55332,13356,68688
420768,201812,67,59,8,56286,7632,63918
420770,201812,81,68,13,64872,12402,77274
420775,201812,46,42,4,39114,3816,42930
420780,201812,243,191,52,182204.46,49608,231812.46
420785,201812,14,10,4,9540,3816,13356
420790,201812,178,149,29,142053.3,26684.46,168737.76
420800,201812,71,54,17,50752.8,16218,66970.8
420810,201812,252,220,32,209871,29717.1,239588.1
420820,201812,2352,1389,963,1318747.89,917353.8,2236101.69
420830,201812,609,340,269,322087.83,255472.46,577560.29
420840,201812,153,114,39,108756,36502,145258
420845,201812,441,196,245,186599.07,232490,419089.07
420850,201812,236,188,48,179352,45792,225144
420860,201812,64,54,10,51516,9540,61056
420870,201812,122,88,34,83713.5,31959,115672.5
420880,201812,174,121,53,115424.46,50085,165509.46
420890,201812,883,440,443,418471.54,422390.42,840861.96
420895,201812,8,8,0,7632,0,7632
420900,201812,421,332,89,313857.46,84877.92,398735.38
420910,201812,5856,3303,2553,3138566.23,2430470.87,5569037.10
420915,201812,77,71,6,67734,5724,73458
420917,201812,20,15,5,14310,4770,19080
420920,201812,22,15,7,14310,6678,20988
420930,201812,2816,1740,1076,1652612.76,1022065.76,2674678.52
420940,201812,614,447,167,425102.6,157666.08,582768.68
420945,201812,10,8,2,7632,1908,9540
420950,201812,57,52,5,49608,4770,54378
420960,201812,119,96,23,91546.92,21933,113479.92
420970,201812,300,242,58,229201.85,55304.46,284506.31
420980,201812,22,22,0,20988,0,20988
420985,201812,65,58,7,55332,6678,62010
420990,201812,77,61,16,58194,15264,73458
421000,201812,31,20,11,19080,10494,29574
421003,201812,70,49,21,46746,20025,66771
421005,201812,8,5,3,4770,2862,7632
421010,201812,759,533,226,507233,214498.2,721731.2
421020,201812,28,23,5,21942,4770,26712
421030,201812,127,107,20,101745,19080,120825
421040,201812,72,59,13,55332,12402,67734
421050,201812,323,229,94,217034.2,89676,306710.2
421055,201812,25,21,4,20034,3816,23850
421060,201812,80,54,26,51516,24804,76320
421070,201812,49,45,4,42559,3816,46375
421080,201812,34,32,2,30528,1908,32436
421085,201812,24,19,5,18126,4770,22896
421090,201812,41,30,11,28620,10494,39114
421100,201812,130,95,35,90630,33390,124020
421105,201812,218,176,42,167617.8,40044.69,207662.49
421110,201812,114,93,21,88101.9,20034,108135.9
421120,201812,158,123,35,116846.46,33361.38,150207.84
421125,201812,17,12,5,11448,4770,16218
421130,201812,805,524,281,498766.05,266572.54,765338.59
421140,201812,31,23,8,21226.5,7632,28858.5
421145,201812,41,32,9,30528,8586,39114
421150,201812,107,77,30,73458,28620,102078
421160,201812,66,43,23,41012.46,21942,62954.46
421165,201812,17,16,1,15264,954,16218
421170,201812,198,169,29,160313.84,27657,187970.84
421175,201812,156,105,51,100170,48606.38,148776.38
421180,201812,61,40,21,37798,20034,57832
421185,201812,16,13,3,12402,2862,15264
421187,201812,0,0,0,0,0,0
421189,201812,40,30,10,28620,9530.46,38150.46
421190,201812,1607,1017,590,969255.46,561591.58,1530847.04
421200,201812,90,68,22,63918.7,20988,84906.7
421205,201812,27,17,10,16218,9540,25758
421210,201812,172,123,49,117342,46746,164088
421220,201812,283,222,61,211167.9,58194,269361.9
421223,201812,52,44,8,41786,7632,49418
421225,201812,69,44,25,41786,23850,65636
421227,201812,96,73,23,69642,21942,91584
421230,201812,52,39,13,37206,12402,49608
421240,201812,19,19,0,18126,0,18126
421250,201812,357,222,135,210454,127998.18,338452.18
421260,201812,27,22,5,20988,4770,25758
421265,201812,1,1,0,954,0,954
421270,201812,53,47,6,44838,5724,50562
421280,201812,342,194,148,185076,140238,325314
421290,201812,327,219,108,208688,100906.26,309594.26
421300,201812,26,21,5,20034,4770,24804
421310,201812,53,40,13,37492.2,12402,49894.2
421315,201812,28,18,10,17172,9540,26712
421320,201812,134,93,41,88722,39114,127836
421330,201812,109,84,25,78018.12,23841,101859.12
421335,201812,40,28,12,26712,11448,38160
421340,201812,297,206,91,194473.05,86814,281287.05
421350,201812,195,112,83,106405,79182,185587
421360,201812,677,503,174,476228.5,165977.46,642205.96
421370,201812,195,151,44,144054,41642.1,185696.1
421380,201812,134,107,27,102073.23,25758,127831.23
421390,201812,17,12,5,11448,4770,16218
421400,201812,122,105,17,100170,16218,116388
421410,201812,22,19,3,18126,2862,20988
421415,201812,21,20,1,19080,954,20034
421420,201812,145,120,25,114480,23850,138330
421430,201812,15,11,4,10494,3816,14310
421440,201812,57,45,12,42930,11448,54378
421450,201812,93,79,14,75366,13356,88722
421460,201812,58,48,10,44987.77,9540,54527.77
421470,201812,68,45,23,42930,21942,64872
421480,201812,645,483,162,460018.8,154539,614557.8
421490,201812,22,21,1,20025,954,20979
421500,201812,511,331,180,313972.76,170927.98,484900.74
421505,201812,24,17,7,16218,6678,22896
421507,201812,36,30,6,28620,5724,34344
421510,201812,78,53,25,50562,23850,74412
421520,201812,65,56,9,52661,8586,61247
421530,201812,53,47,6,44838,5724,50562
421535,201812,27,26,1,24537,954,25491
421540,201812,58,49,9,46746,8586,55332
421545,201812,97,73,24,69156,22896,92052
421550,201812,300,220,80,209213,76320,285533
421555,201812,26,20,6,19080,5629,24709
421560,201812,8,7,1,6678,954,7632
421565,201812,126,89,37,84142.8,35298,119440.8
421567,201812,29,25,4,23850,3816,27666
421568,201812,33,31,2,29574,1908,31482
421569,201812,7,7,0,6678,0,6678
421570,201812,174,117,57,111618,54378,165996
421575,201812,27,22,5,20988,4770,25758
421580,201812,716,433,283,411548.2,269028.34,680576.54
421590,201812,21,20,1,19080,954,20034
421600,201812,131,80,51,76320,47415,123735
421605,201812,108,77,31,73125,29574,102699
421610,201812,186,148,38,140238.2,35992.75,176230.95
421620,201812,1098,651,447,618545.92,426123.38,1044669.30
421625,201812,24,21,3,20034,2862,22896
421630,201812,294,186,108,176633.8,102174,278807.8
421635,201812,17,8,9,7632,8586,16218
421640,201812,99,85,14,80900,13356,94256
421650,201812,289,166,123,158344.92,117322.92,275667.84
421660,201812,2190,1326,864,1261847.7,823084.06,2084931.76
421670,201812,193,136,57,129744,54378,184122
421680,201812,174,158,16,150732,15264,165996
421690,201812,349,246,103,232968.42,97298.58,330267.00
421700,201812,62,40,22,38160,20130,58290
421710,201812,27,26,1,24804,954,25758
421715,201812,8,7,1,6678,954,7632
421720,201812,590,434,156,412468.8,147097.26,559566.06
421725,201812,14,6,8,5724,7632,13356
421730,201812,41,29,12,26958.12,11448,38406.12
421740,201812,87,42,45,40068,42930,82998
421750,201812,222,167,55,156873.2,52470,209343.2
421755,201812,26,24,2,22896,1908,24804
421760,201812,106,76,30,72504,28620,101124
421770,201812,598,398,200,375829.38,190240.9,566070.28
421775,201812,30,19,11,18126,10494,28620
421780,201812,202,158,44,150732,41976,192708
421790,201812,160,134,26,127182,24804,151986
421795,201812,19,15,4,14310,3816,18126
421800,201812,500,321,179,305437.31,170528,475965.31
421810,201812,72,56,16,53424,15264,68688
421820,201812,320,216,104,205110.2,99216,304326.2
421825,201812,130,109,21,103986,20034,124020
421830,201812,132,99,33,94446,31482,125928
421835,201812,3,3,0,2862,0,2862
421840,201812,54,46,8,43875,7632,51507
421850,201812,80,69,11,65826,10490,76316
421860,201812,40,33,7,31482,6678,38160
421870,201812,973,746,227,703331.2,215797.42,919128.62
421875,201812,54,46,8,43884,7632,51516
421880,201812,168,121,47,115434,44552,159986
421885,201812,29,23,6,21942,5724,27666
421890,201812,126,89,37,84906,34336,119242
421895,201812,48,44,4,41976,3816,45792
421900,201812,161,128,33,121751.1,31446,153197.1
421910,201812,68,43,25,41022,23850,64872
421915,201812,30,25,5,23850,4770,28620
421917,201812,43,32,11,30528,10494,41022
421920,201812,34,31,3,29574,2862,32436
421930,201812,743,582,161,552676.56,153567,706243.56
421935,201812,54,47,7,44838,6678,51516
421940,201812,40,36,4,34344,3816,38160
421950,201812,846,564,282,536916.92,268752.73,805669.65
421960,201812,41,34,7,32150,6678,38828
421970,201812,368,234,134,221500.32,127827,349327.32
421985,201812,32,21,11,20034,10494,30528
422000,201812,0,0,0,0,0,0
430003,201812,198,49,149,46746,142146,188892
430005,201812,39,30,9,28620,8586,37206
430010,201812,275,197,78,187461,74412,261873
430020,201812,152,98,54,93206,51516,144722
430030,201812,131,104,27,98929.8,25758,124687.8
430040,201812,2965,1732,1233,1642703.24,1175309.74,2818012.98
430045,201812,68,59,9,55999.8,8586,64585.8
430047,201812,6,5,1,4770,954,5724
430050,201812,79,67,12,63918,11448,75366
430055,201812,15,13,2,12402,1908,14310
430057,201812,5,3,2,2862,1908,4770
430060,201812,3669,2176,1493,2067429.96,1422236.12,3489666.08
430063,201812,60,55,5,52470,4770,57240
430064,201812,154,129,25,123066,23850,146916
430066,201812,7,6,1,5724,954,6678
430070,201812,45,35,10,33390,9540,42930
430080,201812,68,46,22,43184.33,20988,64172.33
430085,201812,34,12,22,11448,20988,32436
430087,201812,31,22,9,20845,8586,29431
430090,201812,72,65,7,62010,6678,68688
430100,201812,128,88,40,82998,38160,121158
430105,201812,146,75,71,71360,67714.92,139074.92
430107,201812,20,15,5,14310,4770,19080
430110,201812,417,248,169,235723.86,161111.52,396835.38
430120,201812,142,130,12,123066,11448,134514
430130,201812,805,500,305,476379.9,289443.6,765823.5
430140,201812,119,112,7,106787,6678,113465
430150,201812,112,72,40,67925,37206,105131
430155,201812,32,29,3,27666,2862,30528
430160,201812,3759,2247,1512,2121012.52,1440711.92,3561724.44
430163,201812,334,153,181,144150.14,172397.34,316547.48
430165,201812,27,19,8,18126,7632,25758
430170,201812,92,78,14,74412,13356,87768
430175,201812,87,67,20,63918,18412.2,82330.2
430180,201812,103,83,20,79182,18459.9,97641.9
430185,201812,35,27,8,25758,7632,33390
430187,201812,95,40,55,38160,52164.8,90324.8
430190,201812,222,127,95,121110.3,90620.46,211730.76
430192,201812,14,13,1,12402,954,13356
430195,201812,16,11,5,10494,4770,15264
430200,201812,172,151,21,143386.2,19747.8,163134.0
430205,201812,20,19,1,18126,954,19080
430210,201812,658,511,147,484345.8,138759.5,623105.3
430215,201812,17,13,4,12402,3816,16218
430220,201812,72,51,21,48654,20034,68688
430222,201812,13,7,6,6678,5724,12402
430223,201812,12,7,5,6678,4770,11448
430225,201812,2,1,1,954,954,1908
430230,201812,304,181,123,171720,117246.6,288966.6
430235,201812,55,40,15,38160,14300.46,52460.46
430237,201812,30,23,7,21942,6678,28620
430240,201812,139,89,50,84715.2,47700,132415.2
430245,201812,72,60,12,57240,11448,68688
430250,201812,195,115,80,109700.46,76310.46,186010.92
430258,201812,11,9,2,8586,1908,10494
430260,201812,34,29,5,27666,4760.46,32426.46
430265,201812,35,29,6,27646.92,5724,33370.92
430270,201812,550,412,138,387082.74,130786.02,517868.76
430280,201812,1041,645,396,610321.5,376210.6,986532.1
430290,201812,382,221,161,208926.8,153594,362520.8
430300,201812,2149,1198,951,1135319.26,903918.15,2039237.41
430310,201812,1962,1029,933,975371.78,887049.93,1862421.71
430320,201812,53,45,8,42915.69,7632,50547.69
430330,201812,98,87,11,82521,10494,93015
430340,201812,68,60,8,57240,7632,64872
430350,201812,1667,1163,504,1097086.69,479061.18,1576147.87
430355,201812,24,22,2,20988,1908,22896
430360,201812,86,43,43,41022,41022,82044
430367,201812,28,20,8,19080,7632,26712
430370,201812,56,48,8,45792,7632,53424
430380,201812,136,103,33,97689.6,31482,129171.6
430390,201812,612,386,226,367957.8,215022.26,582980.06
430400,201812,143,110,33,103032,31462.92,134494.92
430410,201812,59,46,13,43884,12402,56286
430420,201812,507,336,171,317778.8,161637.56,479416.36
430430,201812,54,52,2,48972.63,1097.1,50069.73
430435,201812,155,118,37,111618,35298,146916
430440,201812,509,336,173,320067.8,164851.2,484919.0
430450,201812,1180,973,207,921717.38,197468.46,1119185.84
430460,201812,5050,2793,2257,2651207.89,2146848.89,4798056.78
430461,201812,17,15,2,14310,1908,16218
430462,201812,9,6,3,5724,2862,8586
430463,201812,1040,553,487,525425.92,464246.1,989672.02
430465,201812,24,14,10,13356,9540,22896
430466,201812,675,488,187,463644.2,178207.2,641851.4
430467,201812,100,57,43,53343.8,41012.46,94356.26
430468,201812,109,66,43,62964,40770.91,103734.91
430469,201812,24,19,5,18126,4770,22896
430470,201812,1175,659,516,623192.35,490164.3,1113356.65
430471,201812,51,38,13,36232.92,12402,48634.92
430480,201812,104,62,42,58289.4,40058.46,98347.86
430485,201812,6,6,0,5438,0,5438
430490,201812,88,72,16,68258.7,15264,83522.7
430495,201812,38,27,11,25758,10494,36252
430500,201812,191,127,64,120871.8,60680.46,181552.26
430510,201812,3331,2188,1143,2076762.73,1088981.46,3165744.19
430511,201812,17,16,1,15264,954,16218
430512,201812,139,98,41,93492,39114,132606
430513,201812,51,41,10,38637,9540,48177
430515,201812,32,30,2,28620,1908,30528
430517,201812,167,149,18,141192,17148.15,158340.15
430520,201812,367,255,112,242603,106819.38,349422.38
430530,201812,90,52,38,49608,36252,85860
430535,201812,472,320,152,304794.23,144980.15,449774.38
430537,201812,9,9,0,8586,0,8586
430540,201812,76,52,24,49608,22896,72504
430543,201812,367,116,251,110664,239454,350118
430544,201812,44,41,3,39114,2862,41976
430545,201812,362,181,181,172404.66,172429.78,344834.44
430550,201812,44,36,8,34344,7632,41976
430558,201812,5,3,2,2862,1908,4770
430560,201812,54,25,29,23850,27666,51516
430570,201812,111,44,67,41976,63860.76,105836.76
430580,201812,123,100,23,95400,20988.8,116388.8
430583,201812,14,14,0,13356,0,13356
430585,201812,10,4,6,3816,5724,9540
430587,201812,16,8,8,7632,7632,15264
430590,201812,153,125,28,118009.8,26712,144721.8
430593,201812,2,2,0,1908,0,1908
430595,201812,17,14,3,13356,2862,16218
430597,201812,52,30,22,28620,20988,49608
430600,201812,220,155,65,147860.46,61723.8,209584.26
430605,201812,162,102,60,97308,56562.66,153870.66
430607,201812,27,22,5,20988,4770,25758
430610,201812,1639,779,860,740008.96,815085.24,1555094.20
430613,201812,3,3,0,2862,0,2862
430620,201812,117,84,33,80136,31472.46,111608.46
430630,201812,47,41,6,39114,5724,44838
430632,201812,32,27,5,25758,4770,30528
430635,201812,40,37,3,35298,2862,38160
430637,201812,54,31,23,29574,21942,51516
430640,201812,199,113,86,106371,82044,188415
430642,201812,23,21,2,20034,1908,21942
430645,201812,36,29,7,27666,6678,34344
430650,201812,257,207,50,197192,47652.3,244844.3
430655,201812,4,4,0,3816,0,3816
430660,201812,975,482,493,458253.9,468318.8,926572.7
430670,201812,74,52,22,49608,20988,70596
430673,201812,75,41,34,39114,32436,71550
430675,201812,14,11,3,10494,2862,13356
430676,201812,506,312,194,296933.12,185005.07,481938.19
430680,201812,245,175,70,164756,66493.8,231249.8
430690,201812,541,332,209,315822.24,197663.36,513485.60
430692,201812,7,5,2,4770,1908,6678
430693,201812,146,99,47,94446,44828.46,139274.46
430695,201812,75,63,12,59405.58,11448,70853.58
430697,201812,59,37,22,35298,20988,56286
430700,201812,1584,1111,473,1049069.28,451242,1500311.28
430705,201812,22,20,2,19080,1908,20988
430710,201812,259,171,88,163134,83952,247086
430720,201812,106,90,16,85669.2,15264,100933.2
430730,201812,130,112,18,105894,17172,123066
430740,201812,65,42,23,40068,21942,62010
430745,201812,36,29,7,27666,6678,34344
430750,201812,346,231,115,219430.64,108756,328186.64
430755,201812,86,51,35,48654,33390,82044
430760,201812,354,213,141,200531.72,134485.92,335017.64
430770,201812,1440,752,688,714499.2,651789.55,1366288.75
430780,201812,327,206,121,195542.72,115377.3,310920.02
430781,201812,30,25,5,23850,4770,28620
430783,201812,55,44,11,41658.13,10494,52152.13
430786,201812,6,3,3,2862,2862,5724
430790,201812,531,343,188,326331.72,179056.46,505388.18
430800,201812,158,131,27,124481.92,25758,150239.92
430805,201812,45,41,4,39114,3816,42930
430807,201812,42,25,17,23850,16218,40068
430810,201812,78,52,26,49608,24804,74412
430820,201812,140,84,56,80136,52756.2,132892.2
430825,201812,12,10,2,9540,1908,11448
430830,201812,233,217,16,206426.72,15264,221690.72
430840,201812,129,85,44,81090,41117.4,122207.4
430843,201812,5,3,2,2862,1908,4770
430845,201812,71,40,31,38160,29574,67734
430850,201812,582,410,172,388414.4,163984.76,552399.16
430860,201812,164,102,62,96640.2,58470.66,155110.86
430865,201812,74,43,31,40354.2,29259.18,69613.38
430870,201812,84,68,16,64204.2,15264,79468.2
430880,201812,157,117,40,111598.92,38160,149758.92
430885,201812,7,5,2,4770,1908,6678
430890,201812,344,210,134,197705.8,127836,325541.8
430900,201812,536,374,162,352569.78,154071,506640.78
430905,201812,107,46,61,43884,58194,102078
430910,201812,271,150,121,143100,114758,257858
430912,201812,5,5,0,4770,0,4770
430915,201812,34,28,6,26712,5724,32436
430920,201812,4256,2373,1883,2256758.23,1794418.46,4051176.69
430925,201812,4,3,1,2862,954,3816
430930,201812,2095,1242,853,1177866.82,813521.05,1991387.87
430940,201812,263,169,94,160548.66,89656.92,250205.58
430950,201812,154,123,31,117342,29574,146916
430955,201812,23,14,9,13356,8586,21942
430957,201812,19,18,1,17172,954,18126
430960,201812,253,168,85,156885.3,79612.2,236497.5
430965,201812,108,68,40,64872,38160,103032
430970,201812,86,70,16,66780,14310,81090
430975,201812,38,34,4,32436,3816,36252
430980,201812,45,29,16,27666,15264,42930
430990,201812,117,90,27,85860,25758,111618
430995,201812,117,112,5,105607.8,4770,110377.8
431000,201812,309,139,170,130459.2,162180,292639.2
431010,201812,346,206,140,195951.6,131823.72,327775.32
431020,201812,1943,1138,805,1078807.62,764952.42,1843760.04
431030,201812,42,33,9,31482,8586,40068
431033,201812,388,196,192,186173.2,183168,369341.2
431036,201812,14,9,5,8586,4770,13356
431040,201812,133,81,52,76320,48830.49,125150.49
431041,201812,40,28,12,26712,11448,38160
431043,201812,48,28,20,26712,19080,45792
431046,201812,11,7,4,6678,3816,10494
431050,201812,199,128,71,121539.6,67734,189273.6
431053,201812,79,47,32,44074.8,30528,74602.8
431055,201812,61,42,19,40068,18106.92,58174.92
431057,201812,19,19,0,18126,0,18126
431060,201812,1658,1053,605,993250.14,575336.98,1568587.12
431065,201812,18,11,7,10494,6678,17172
431070,201812,70,64,6,61056,5724,66780
431075,201812,6,6,0,5724,0,5724
431080,201812,138,85,53,80517.6,50562,131079.6
431085,201812,32,29,3,27666,2862,30528
431087,201812,13,11,2,10494,1908,12402
431090,201812,55,43,12,41022,11448,52470
431100,201812,1221,733,488,688791.72,465552,1154343.72
431110,201812,251,155,96,147870,91279.46,239149.46
431112,201812,28,17,11,16218,10494,26712
431113,201812,34,24,10,22896,9540,32436
431115,201812,160,112,48,106211.87,45782.46,151994.33
431120,201812,610,363,247,344366.18,234627.72,578993.90
431123,201812,4,3,1,2862,954,3816
431125,201812,99,89,10,84619.8,9540,94159.8
431127,201812,9,4,5,3816,4770,8586
431130,201812,683,439,244,416611.8,232470.72,649082.52
431140,201812,755,520,235,494840,224113.68,718953.68
431142,201812,34,27,7,24546,6678,31224
431150,201812,202,150,52,142394.04,49598.46,191992.50
431160,201812,56,50,6,47700,5724,53424
431162,201812,19,14,5,13356,4770,18126
431164,201812,5,5,0,4770,0,4770
431170,201812,104,85,19,81090,18126,99216
431171,201812,65,38,27,36013.5,25738.92,61752.42
431173,201812,1,1,0,954,0,954
431175,201812,204,103,101,97022,96344.46,193366.46
431177,201812,76,57,19,54378,17439.92,71817.92
431179,201812,14,12,2,11448,1908,13356
431180,201812,444,273,171,259726.5,163115.46,422841.96
431190,201812,87,66,21,62964,20034,82998
431198,201812,67,47,20,44838,19080,63918
431200,201812,20,16,4,15264,3816,19080
431205,201812,23,23,0,21942,0,21942
431210,201812,85,51,34,48367.8,32436,80803.8
431213,201812,33,28,5,26712,4770,31482
431215,201812,25,22,3,20988,2862,23850
431217,201812,5,4,1,3816,954,4770
431220,201812,70,59,11,56286,10494,66780
431225,201812,152,101,51,96345,48634.92,144979.92
431230,201812,100,88,12,83952,11448,95400
431235,201812,8,8,0,7632,0,7632
431237,201812,26,19,7,18126,6678,24804
431238,201812,10,7,3,6392,2862,9254
431240,201812,1005,660,345,628667.52,328805.64,957473.16
431242,201812,39,38,1,36252,954,37206
431244,201812,11,8,3,7632,2862,10494
431245,201812,53,40,13,38160,12402,50562
431247,201812,12,10,2,9540,1908,11448
431250,201812,275,147,128,140171.22,122092.92,262264.14
431260,201812,61,45,16,42930,15264,58194
431261,201812,19,13,6,12402,5724,18126
431262,201812,16,16,0,15264,0,15264
431265,201812,165,92,73,87768,69642,157410
431267,201812,15,14,1,13356,954,14310
431270,201812,325,267,58,254431.8,55332,309763.8
431275,201812,39,36,3,34344,2862,37206
431280,201812,18,14,4,12521.25,3816,16337.25
431290,201812,24,19,5,18126,4770,22896
431295,201812,5,4,1,3816,954,4770
431300,201812,24,21,3,20034,2862,22896
431301,201812,7,7,0,6678,0,6678
431303,201812,53,35,18,33108.34,16885.8,49994.14
431306,201812,233,121,112,115264.18,106170.66,221434.84
431308,201812,7,5,2,4770,1908,6678
431310,201812,67,58,9,55332,8586,63918
431320,201812,133,80,53,76300.92,50247.18,126548.10
431330,201812,177,116,61,110664,58194,168858
431333,201812,32,26,6,24804,5724,30528
431335,201812,10,6,4,5724,3816,9540
431337,201812,331,153,178,145132.1,168762.6,313894.7
431339,201812,23,20,3,19080,2862,21942
431340,201812,3016,1739,1277,1653579.61,1214664.98,2868244.59
431342,201812,38,23,15,21942,14310,36252
431344,201812,19,19,0,18126,0,18126
431346,201812,4,4,0,3816,0,3816
431349,201812,34,31,3,29574,2862,32436
431350,201812,918,545,373,516621.86,354182.04,870803.90
431360,201812,50,44,6,41976,5724,47700
431365,201812,321,153,168,145942.92,159308.46,305251.38
431370,201812,1342,807,535,767360.11,510222.06,1277582.17
431380,201812,99,85,14,81090,13356,94446
431390,201812,522,290,232,274990.5,221308.92,496299.42
431395,201812,299,133,166,126882,158345,285227
431400,201812,41,31,10,29574,9540,39114
431402,201812,104,72,32,68688,30528,99216
431403,201812,21,13,8,12402,7632,20034
431405,201812,647,353,294,334835.62,280161.67,614997.29
431406,201812,31,27,4,25758,3816,29574
431407,201812,54,42,12,40068,11448,51516
431410,201812,3428,2099,1329,1986963.19,1263383.08,3250346.27
431413,201812,17,14,3,13356,2862,16218
431415,201812,72,54,18,51516,17172,68688
431417,201812,23,12,11,11448,10494,21942
431420,201812,315,220,95,209243.96,90630,299873.96
431430,201812,47,22,25,20988,23850,44838
431440,201812,8964,6377,2587,6016923.72,2460286.21,8477209.93
431442,201812,28,15,13,14310,12402,26712
431445,201812,23,20,3,19080,2862,21942
431446,201812,7,6,1,5724,954,6678
431447,201812,85,61,24,58194,22896,81090
431449,201812,54,47,7,44838,6678,51516
431450,201812,414,282,132,268741.8,125212.5,393954.3
431454,201812,0,0,0,0,0,0
431455,201812,50,39,11,37206,10494,47700
431460,201812,519,361,158,342342.9,150445.8,492788.7
431470,201812,124,96,28,91584,26462,118046
431475,201812,11,10,1,9540,954,10494
431477,201812,36,24,12,22896,11448,34344
431478,201812,7,6,1,5724,954,6678
431480,201812,501,315,186,299680.02,177377.22,477057.24
431490,201812,28256,16123,12133,15308726.06,11540038.04,26848764.10
431500,201812,83,60,23,57001.5,21942,78943.5
431505,201812,33,19,14,18126,13356,31482
431507,201812,12,10,2,9540,1908,11448
431510,201812,267,183,84,173199,79153.38,252352.38
431513,201812,24,20,4,19080,3816,22896
431514,201812,7,6,1,5724,954,6678
431515,201812,81,67,14,63918,13356,77274
431517,201812,5,4,1,3816,954,4770
431520,201812,38,34,4,32436,3816,36252
431530,201812,1565,708,857,673810.44,817154.09,1490964.53
431531,201812,24,22,2,20988,1908,22896
431532,201812,26,18,8,17172,7632,24804
431535,201812,26,16,10,15264,9540,24804
431540,201812,142,126,16,119564.82,15264,134828.82
431545,201812,16,14,2,13356,1908,15264
431550,201812,361,204,157,194329.8,149682.6,344012.4
431555,201812,13,12,1,11448,954,12402
431560,201812,4512,3191,1321,3016208.9,1257976.31,4274185.21
431570,201812,817,442,375,417566.2,355832.46,773398.66
431575,201812,36,24,12,22896,11448,34344
431580,201812,98,71,27,66780,25758,92538
431590,201812,147,124,23,117342,21942,139284
431595,201812,11,10,1,9540,954,10494
431600,201812,220,124,96,118276.92,91584,209860.92
431610,201812,128,95,33,89389.8,31482,120871.8
431620,201812,44,36,8,34344,7632,41976
431630,201812,138,116,22,110664,20988,131652
431640,201812,1357,856,501,809898.92,475655.14,1285554.06
431642,201812,38,35,3,32913,2862,35775
431643,201812,47,20,27,19080,25758,44838
431645,201812,303,176,127,167904,120871.8,288775.8
431647,201812,10,10,0,9540,0,9540
431650,201812,36,26,10,24804,9540,34344
431660,201812,305,192,113,182214,107802,290016
431670,201812,230,110,120,102316.5,114451.38,216767.88
431673,201812,5,4,1,3816,954,4770
431675,201812,31,26,5,24517.8,4770,29287.8
431680,201812,1128,820,308,778464,292229.82,1070693.82
431690,201812,4823,2943,1880,2783161.89,1790260.02,4573421.91
431695,201812,23,18,5,17172,4770,21942
431697,201812,0,0,0,0,0,0
431700,201812,175,136,39,129744,37206,166950
431710,201812,4042,1769,2273,1683135.4,2167942.4,3851077.8
431720,201812,1370,834,536,787223.22,510376.46,1297599.68
431725,201812,1,1,0,954,0,954
431730,201812,1206,823,383,777208.32,365382,1142590.32
431740,201812,1370,680,690,644198.12,657137.18,1301335.30
431750,201812,1866,1220,646,1154556.7,614347.92,1768904.62
431755,201812,6,5,1,4770,954,5724
431760,201812,1032,669,363,637844.4,346264.38,984108.78
431770,201812,396,293,103,277890.66,97889.94,375780.60
431775,201812,30,22,8,20988,7632,28620
431780,201812,568,358,210,340702.02,200330.46,541032.48
431790,201812,169,130,39,123066,37158.3,160224.3
431795,201812,13,12,1,11448,954,12402
431800,201812,3363,1773,1590,1677768.24,1511861.32,3189629.56
431805,201812,20,17,3,16218,2862,19080
431810,201812,609,407,202,386608.5,192555.9,579164.4
431820,201812,323,184,139,175536,132606,308142
431830,201812,2344,1426,918,1356783.57,874530.19,2231313.76
431840,201812,503,336,167,317205.8,159032,476237.8
431842,201812,34,28,6,26712,5724,32436
431843,201812,12,9,3,8586,2862,11448
431844,201812,16,14,2,13356,1908,15264
431845,201812,30,27,3,25758,2862,28620
431846,201812,27,22,5,20988,4770,25758
431848,201812,15,13,2,12402,1908,14310
431849,201812,10,7,3,6678,2862,9540
431850,201812,817,672,145,638630.51,138091.5,776722.01
431860,201812,108,77,31,73458,28620,102078
431861,201812,3,2,1,1908,954,2862
431862,201812,52,34,18,32436,17172,49608
431870,201812,3436,2042,1394,1939600.06,1326483.06,3266083.12
431880,201812,953,701,252,663002,239454,902456
431890,201812,1318,821,497,776671.54,471929.98,1248601.52
431900,201812,180,128,52,122112,48816.18,170928.18
431910,201812,55,41,14,39114,13356,52470
431912,201812,39,22,17,20988,16027.2,37015.2
431915,201812,130,104,26,99216,24804,124020
431920,201812,153,112,41,106561.8,39114,145675.8
431930,201812,82,67,15,63202.5,14310,77512.5
431935,201812,3,3,0,2862,0,2862
431936,201812,12,11,1,10494,954,11448
431937,201812,19,14,5,13356,4770,18126
431940,201812,472,317,155,299079,146906.96,445985.96
431950,201812,501,316,185,299480.42,176338.44,475818.86
431960,201812,740,420,320,396780.22,305128.44,701908.66
431970,201812,73,65,8,62010,7632,69642
431971,201812,3,3,0,2862,0,2862
431973,201812,25,20,5,19080,4770,23850
431975,201812,8,7,1,6678,954,7632
431980,201812,206,129,77,122108.51,73458,195566.51
431990,201812,1229,658,571,626258.99,544688,1170946.99
432000,201812,1667,911,756,861332.12,718879.16,1580211.28
432010,201812,287,191,96,180916.56,91584,272500.56
432020,201812,174,143,31,136422,29574,165996
432023,201812,17,14,3,13356,2862,16218
432026,201812,70,64,6,61056,5724,66780
432030,201812,67,31,36,29574,34344,63918
432032,201812,19,16,3,15264,2862,18126
432035,201812,54,42,12,40068,11448,51516
432040,201812,103,71,32,67734,30528,98262
432045,201812,9,8,1,7632,954,8586
432050,201812,75,44,31,41976,29574,71550
432055,201812,111,82,29,78228,27666,105894
432057,201812,1,0,1,0,954,954
432060,201812,35,32,3,30528,2862,33390
432065,201812,31,27,4,25758,3816,29574
432067,201812,89,80,9,76300.92,8586,84886.92
432070,201812,406,308,98,291676.86,93463.92,385140.78
432080,201812,822,573,249,544943.88,237479.3,782423.18
432085,201812,17,13,4,12402,3816,16218
432090,201812,268,168,100,160272,95400,255672
432100,201812,171,111,60,105607.8,57240,162847.8
432110,201812,607,419,188,389176.65,178359.84,567536.49
432120,201812,939,574,365,547576.92,348105.06,895681.98
432130,201812,512,373,139,354506.4,131508.9,486015.3
432132,201812,24,21,3,20034,2862,22896
432135,201812,79,65,14,62010,13356,75366
432140,201812,269,216,53,205768.26,50562,256330.26
432143,201812,194,122,72,116388,68688,185076
432145,201812,280,192,88,181928.6,83665.8,265594.4
432146,201812,14,13,1,12402,954,13356
432147,201812,130,62,68,59148,64848.15,123996.15
432149,201812,16,12,4,11448,3816,15264
432150,201812,842,519,323,494877.96,307169.57,802047.53
432160,201812,1408,736,672,700390.18,640144.36,1340534.54
432162,201812,4,3,1,2862,954,3816
432163,201812,18,14,4,13356,3816,17172
432166,201812,118,88,30,84430,28620,113050
432170,201812,233,125,108,118583,103032,221615
432180,201812,547,341,206,321307.2,196238,517545.2
432183,201812,8,7,1,6678,954,7632
432185,201812,80,70,10,66780,9540,76320
432190,201812,465,267,198,254326.86,188768.52,443095.38
432195,201812,86,74,12,69880.5,11448,81328.5
432200,201812,408,262,146,249948,139236.84,389184.84
432210,201812,122,77,45,71693.1,42930,114623.1
432215,201812,56,52,4,49608,3816,53424
432218,201812,20,19,1,18126,954,19080
432220,201812,684,354,330,336686.48,314322.28,651008.76
432225,201812,13,7,6,6678,5724,12402
432230,201812,147,94,53,89437.5,50562,139999.5
432232,201812,12,11,1,10494,954,11448
432234,201812,4,3,1,2862,954,3816
432235,201812,2,2,0,1908,0,1908
432237,201812,29,17,12,16218,11448,27666
432240,201812,4351,2452,1899,2328286.54,1805226.92,4133513.46
432250,201812,1079,690,389,655827.3,370943.82,1026771.12
432252,201812,45,39,6,36729,5724,42453
432253,201812,60,48,12,45792,11448,57240
432254,201812,25,12,13,11448,12402,23850
432255,201812,14,13,1,12402,954,13356
432260,201812,886,703,183,668936.26,173628,842564.26
432270,201812,240,175,65,166950,62000.46,228950.46
432280,201812,130,98,32,93015.8,30528,123543.8
432285,201812,1,1,0,954,0,954
432290,201812,70,62,8,57240,7632,64872
432300,201812,4604,2640,1964,2497963.38,1869679.36,4367642.74
432310,201812,118,98,20,93348.9,19080,112428.9
432320,201812,19,17,2,16218,1908,18126
432330,201812,17,13,4,12402,3816,16218
432335,201812,7,6,1,5724,954,6678
432340,201812,40,36,4,34344,3816,38160
432345,201812,96,68,28,64872,26712,91584
432350,201812,23,22,1,20988,954,21942
432360,201812,6,4,2,3816,1908,5724
432370,201812,25,25,0,23850,0,23850
432375,201812,35,32,3,30528,2862,33390
432377,201812,8,8,0,7632,0,7632
432380,201812,169,76,93,71836.2,88674.3,160510.5
500020,201812,247,140,107,133410,101190.78,234600.78
500025,201812,119,58,61,54378,58194,112572
500060,201812,1472,915,557,872337.6,531000.61,1403338.21
500070,201812,794,376,418,358353,398772,757125
500080,201812,136,107,29,102078,27666,129744
500085,201812,137,110,27,104367.8,24923.25,129291.05
500090,201812,326,159,167,151686,159318,311004
500100,201812,752,401,351,379692.33,334282,713974.33
500110,201812,2255,1033,1222,985108.84,1163934.32,2149043.16
500124,201812,267,155,112,147870,106561.8,254431.8
500150,201812,327,136,191,129735,181844.46,311579.46
500190,201812,536,373,163,355174.2,155016,510190.2
500200,201812,192,164,28,156113,26712,182825
500210,201812,1473,529,944,504451.39,899246.37,1403697.76
500215,201812,245,142,103,134514.42,98262,232776.42
500220,201812,788,512,276,486935.72,263294.46,750230.18
500230,201812,262,178,84,169096.5,79659,248755.5
500240,201812,699,487,212,463478.8,201961.8,665440.6
500260,201812,595,225,370,214650,352980,567630
500270,201812,29074,12452,16622,11846840.6,15840233.16,27687073.76
500280,201812,193,71,122,67734,116388,184122
500290,201812,1194,711,483,677321.92,460773,1138094.92
500295,201812,421,262,159,249662,151676.46,401338.46
500310,201812,62,19,43,18126,41022,59148
500315,201812,736,442,294,421658.46,280466.46,702124.92
500320,201812,3674,1859,1815,1770587.31,1730138.94,3500726.25
500325,201812,913,505,408,481293,388946,870239
500330,201812,1484,692,792,657736.74,755234.64,1412971.38
500345,201812,323,246,77,233721.2,73458,307179.2
500348,201812,245,148,97,141192,92519.46,233711.46
500350,201812,130,64,66,61056,62964,124020
500370,201812,5457,2452,3005,2331808.89,2864781.58,5196590.47
500375,201812,350,258,92,246122.46,87768,333890.46
500380,201812,600,344,256,328176,244214.46,572390.46
500390,201812,70,34,36,32436,34344,66780
500400,201812,215,149,66,142126.92,62955,205081.92
500410,201812,563,226,337,215530.15,321363.22,536893.37
500430,201812,536,374,162,356796,154548,511344
500440,201812,206,104,102,98709.34,97308,196017.34
500450,201812,405,175,230,166244.8,219410.46,385655.26
500460,201812,298,152,146,145008,138988.26,283996.26
500470,201812,447,352,95,334650.26,89667,424317.26
500480,201812,111,65,46,62010,43884,105894
500490,201812,108,45,63,42925.23,60102,103027.23
500500,201812,1459,534,925,507487.98,881900.41,1389388.39
500510,201812,49,38,11,36252,10485,46737
500515,201812,108,75,33,71550,31482,103032
500520,201812,353,198,155,188320,147580,335900
500525,201812,86,49,37,46746,35011.8,81757.8
500540,201812,917,387,530,369131.76,504614.61,873746.37
500560,201812,913,525,388,499111.58,369837.38,868948.96
500568,201812,986,582,404,552070.8,385126,937196.8
500570,201812,1215,688,527,652882.04,499739.7,1152621.74
500580,201812,337,172,165,163792.26,157369,321161.26
500600,201812,313,164,149,155745.27,142128,297873.27
500620,201812,933,663,270,628393.64,257389.2,885782.84
500625,201812,78,66,12,62296.2,11448,73744.2
500627,201812,27,12,15,11448,14310,25758
500630,201812,1584,851,733,810509.66,698995.8,1509505.46
500635,201812,533,307,226,292458.24,215460.9,507919.14
500640,201812,429,226,203,212743.8,193643.46,406387.26
500660,201812,5496,2108,3388,2007598.7,3229167.52,5236766.22
500690,201812,583,207,376,197130.24,357063.97,554194.21
500710,201812,372,183,189,174497,180288,354785
500720,201812,971,576,395,547820.69,376820.46,924641.15
500730,201812,203,121,82,115434,78223.23,193657.23
500740,201812,845,373,472,354554.95,450008.44,804563.39
500750,201812,145,46,99,43884,94417.92,138301.92
500755,201812,125,90,35,85574,33390,118964
500769,201812,755,422,333,401966.27,317660,719626.27
500770,201812,431,229,202,218456.46,192698.46,411154.92
500780,201812,167,110,57,104654,54378,159032
500790,201812,1063,542,521,516563.25,496984.46,1013547.71
500793,201812,268,150,118,143100,112277,255377
500795,201812,176,128,48,122102.46,45783,167885.46
500797,201812,45,33,12,31482,11448,42930
500800,201812,417,185,232,176481,221328,397809
500830,201812,2258,1269,989,1208214.12,942521.99,2150736.11
500840,201812,143,106,37,101124,35289,136413
510010,201812,169,94,75,89666.46,71521.38,161187.84
510020,201812,484,229,255,218181.6,242733.96,460915.56
510025,201812,1690,970,720,924500.59,684371.08,1608871.67
510030,201812,678,349,329,332899.92,313091.92,645991.84
510035,201812,130,59,71,56258.46,67715.46,123973.92
510040,201812,388,175,213,166950,202745.72,369695.72
510050,201812,415,227,188,215798.66,178528.46,394327.12
510060,201812,114,59,55,56276.46,52460.46,108736.92
510080,201812,225,92,133,87735.15,126777.6,214512.75
510100,201812,76,35,41,33390,39094.92,72484.92
510120,201812,39,24,15,22896,14310,37206
510125,201812,397,247,150,234955.89,143058.38,378014.27
510130,201812,574,335,239,319184.81,227494.04,546678.85
510140,201812,407,134,273,127827,260437.23,388264.23
510160,201812,98,42,56,40068,53420,93488
510170,201812,855,524,331,499574.43,315094.76,814669.19
510180,201812,2890,1400,1490,1332069.72,1419887.4,2751957.12
510185,201812,11,6,5,5724,4770,10494
510190,201812,223,77,146,73458,139279.23,212737.23
510250,201812,2599,1545,1054,1472861.53,1004373.56,2477235.09
510260,201812,200,146,54,139092.84,51479.46,190572.30
510263,201812,460,260,200,247049.46,190771.92,437821.38
510267,201812,674,380,294,360997.99,280196.45,641194.44
510268,201812,59,30,29,28620,27666,56286
510269,201812,71,34,37,32427,35298,67725
510270,201812,404,204,200,194446.44,190373.94,384820.38
510279,201812,227,169,58,161199,55036.46,216235.46
510285,201812,183,77,106,73439.46,101124,174563.46
510300,201812,520,288,232,274328.91,221244.84,495573.75
510305,201812,206,96,110,91561.46,104864.22,196425.68
510310,201812,109,57,52,54378,49598.46,103976.46
510320,201812,859,541,318,515546.18,303222.38,818768.56
510325,201812,409,166,243,158354.46,231535.8,389890.26
510330,201812,435,248,187,236579,178378.92,414957.92
510335,201812,615,345,270,329069.84,257124.78,586194.62
510336,201812,49,35,14,33390,13356,46746
510337,201812,116,49,67,46736.46,63908.46,110644.92
510340,201812,17259,8226,9033,7826099.28,8607909.61,16434008.89
510343,201812,69,50,19,47690.46,18126,65816.46
510345,201812,162,111,51,105884.46,48339.38,154223.84
510350,201812,666,374,292,355853.53,278493.84,634347.37
510360,201812,196,121,75,115425,71477.46,186902.46
510370,201812,143,75,68,71521.38,64759.14,136280.52
510380,201812,91,64,27,61056,25749,86805
510385,201812,57,27,30,25758,28611,54369
510390,201812,117,50,67,47700,63879.84,111579.84
510395,201812,46,35,11,33390,10494,43884
510410,201812,707,472,235,450284,224166.69,674450.69
510420,201812,572,276,296,262386.88,280945.45,543332.33
510450,201812,54,30,24,28620,22896,51516
510452,201812,42,23,19,21942,18126,40068
510454,201812,54,26,28,24804,26702.46,51506.46
510455,201812,128,78,50,74392.92,47700,122092.92
510460,201812,183,97,86,92357.92,82006.38,174364.30
510480,201812,754,445,309,423127.15,294448.9,717576.05
510490,201812,347,180,167,171369.34,158860.78,330230.12
510500,201812,249,190,59,181250.46,56286,237536.46
510510,201812,797,458,339,436331.72,323377.38,759709.10
510515,201812,1158,614,544,585682.38,518929.38,1104611.76
510517,201812,254,107,147,101791.8,140214.69,242006.49
510520,201812,236,156,80,148721.22,76226.84,224948.06
510523,201812,95,69,26,65826,24794.46,90620.46
510525,201812,756,437,319,416143.84,304223.76,720367.60
510530,201812,17,13,4,12402,3816,16218
510550,201812,264,118,146,112563,139284,251847
510558,201812,282,139,143,132573.15,136402.92,268976.07
510560,201812,413,242,171,230582,163116,393698
510562,201812,657,465,192,442279.17,182681.46,624960.63
510590,201812,801,415,386,395844.3,368216.69,764060.99
510600,201812,258,143,115,136402.92,109672.92,246075.84
510610,201812,169,82,87,78208.92,82702.46,160911.38
510615,201812,196,82,114,78208.92,108756,186964.92
510617,201812,19,11,8,10494,7632,18126
510618,201812,117,56,61,53424,57717,111141
510619,201812,102,71,31,67725,29565,97290
510620,201812,181,99,82,94436.46,78228,172664.46
510621,201812,194,124,70,118277.46,66752.46,185029.92
510622,201812,466,298,168,284199.84,160243.92,444443.76
510623,201812,350,235,115,224143.38,109681.38,333824.76
510624,201812,94,46,48,43875,45792,89667
510625,201812,543,330,213,314628.3,202625.52,517253.82
510626,201812,112,70,42,66780,40068,106848
510627,201812,61,43,18,41022,17172,58194
510628,201812,156,93,63,88684.92,60044.76,148729.68
510629,201812,261,169,92,161226,86794.92,248020.92
510630,201812,457,235,222,224114.76,211270.82,435385.58
510631,201812,10,3,7,2862,6392,9254
510637,201812,356,206,150,196187.72,142962.84,339150.56
510642,201812,969,542,427,516726.18,407215.44,923941.62
510645,201812,0,0,0,0,0,0
510650,201812,1465,977,488,931436.92,465429.22,1396866.14
510665,201812,81,42,39,40012,37206,77218
510670,201812,66,38,28,36252,26712,62964
510675,201812,1165,722,443,687802.43,422599.23,1110401.66
510677,201812,353,179,174,169769.84,165875.76,335645.60
510680,201812,105,61,44,58176,41967,100143
510682,201812,205,103,102,97940,97308,195248
510685,201812,52,39,13,37206,12402,49608
510700,201812,616,360,256,343321.92,244072.76,587394.68
510704,201812,1104,602,502,571747.62,476333.36,1048080.98
510706,201812,127,65,62,62005.23,59110.92,121116.15
510710,201812,403,277,126,263287.24,120089.68,383376.92
510715,201812,62,47,15,44828.46,14310,59138.46
510718,201812,207,115,92,109616.76,87758.46,197375.22
510719,201812,36,18,18,17172,17172,34344
510720,201812,199,135,64,128781,61012.22,189793.22
510724,201812,89,34,55,32426.46,52437.38,84863.84
510726,201812,53,27,26,25748.46,24786,50534.46
510729,201812,74,34,40,32436,38121.84,70557.84
510730,201812,480,271,209,258516,199248,457764
510735,201812,106,41,65,39114,62010,101124
510740,201812,29,16,13,15264,12402,27666
510757,201812,18,14,4,13356,3816,17172
510760,201812,7099,3764,3335,3580429.13,3176600.95,6757030.08
510770,201812,708,332,376,315528.18,358537.3,674065.48
510774,201812,16,6,10,5724,9540,15264
510775,201812,115,87,28,82988.46,26702.46,109690.92
510776,201812,28,7,21,6678,20034,26712
510777,201812,186,82,104,78199.38,99187.38,177386.76
510779,201812,50,24,26,22887,24766.92,47653.92
510780,201812,288,161,127,153531.46,121093,274624.46
510785,201812,431,232,199,221280.84,189779.22,411060.06
510787,201812,197,95,102,90621,97290.23,187911.23
510788,201812,0,0,0,0,0,0
510790,201812,2395,1264,1131,1203995.32,1077003.9,2280999.22
510792,201812,1109,636,473,606266.55,450845.96,1057112.51
510794,201812,118,59,59,56286,56257.92,112543.92
510795,201812,2393,1406,987,1334802.03,938915.52,2273717.55
510800,201812,186,116,70,109405.46,66771,176176.46
510805,201812,174,120,54,114480,51516,165996
510810,201812,100,42,58,39975.84,55207.98,95183.82
510820,201812,259,122,137,115961.46,129698.03,245659.49
510830,201812,67,41,26,39114,24795,63909
510835,201812,10,8,2,7632,1908,9540
510840,201812,9212,4545,4667,4323128.08,4445833.74,8768961.82
510850,201812,209,85,124,81080.46,118258.38,199338.84
510860,201812,389,172,217,163919.52,206365.42,370284.94
510880,201812,65,49,16,46727.46,15264,61991.46
510885,201812,71,44,27,41957.46,25729.38,67686.84
510890,201812,72,43,29,41022,27666,68688
510895,201812,182,106,76,101124,72195.46,173319.46
520005,201812,44,30,14,28620,13356,41976
520010,201812,275,125,150,119250,143005,262255
520013,201812,681,426,255,406376,242983.8,649359.8
520015,201812,52,38,14,36252,13356,49608
520017,201812,96,55,41,52184,39114,91298
520020,201812,23,13,10,12402,9540,21942
520025,201812,2027,1108,919,1056121.44,875867.4,1931988.84
520030,201812,814,426,388,405441,369531.9,774972.9
520050,201812,77,52,25,49608,23850,73458
520055,201812,46,30,16,28620,15264,43884
520060,201812,190,126,64,120204,61056,181260
520080,201812,588,419,169,399726,161226,560952
520082,201812,19,14,5,13356,4770,18126
520085,201812,101,75,26,71550,24804,96354
520090,201812,92,61,31,58194,29574,87768
520110,201812,9209,4027,5182,3836870.22,4941637.44,8778507.66
520120,201812,14,8,6,7431.66,5724,13155.66
520130,201812,781,544,237,518680.8,225659.9,744340.7
520140,201812,11932,6754,5178,6436464.94,4936306.57,11372771.51
520145,201812,47,34,13,32436,12402,44838
520150,201812,190,147,43,140238,41022,181260
520160,201812,32,24,8,22896,7632,30528
520170,201812,246,151,95,144022,90593,234615
520180,201812,140,74,66,70596,62964,133560
520215,201812,216,139,77,132319.8,73171.8,205491.6
520235,201812,71,53,18,50562,17172,67734
520250,201812,129,78,51,74412,48367.8,122779.8
520260,201812,113,70,43,66780,40068,106848
520280,201812,47,33,14,30815,13356,44171
520310,201812,38,26,12,24804,11448,36252
520320,201812,166,105,61,100160.46,58194,158354.46
520330,201812,800,424,376,404459.46,358695,763154.46
520340,201812,349,200,149,190800,142127.46,332927.46
520350,201812,527,242,285,230868,271833.46,502701.46
520355,201812,88,52,36,49608,34344,83952
520357,201812,26,19,7,18126,6678,24804
520360,201812,1,1,0,954,0,954
520380,201812,143,74,69,70596,65826,136422
520390,201812,274,119,155,113288,147870,261158
520393,201812,15,11,4,10494,3816,14310
520396,201812,96,60,36,57240,34344,91584
520400,201812,219,128,91,120491.2,86814,207305.2
520410,201812,195,100,95,95391,90621,186012
520420,201812,23,16,7,15264,6678,21942
520425,201812,315,144,171,137376,162467.88,299843.88
520430,201812,465,242,223,230868,212686,443554
520440,201812,617,420,197,400680,187918.92,588598.92
520450,201812,1926,866,1060,825335.46,1010603.52,1835938.98
520455,201812,59,42,17,40068,16218,56286
520460,201812,32,16,16,15264,15264,30528
520465,201812,26,22,4,20988,3816,24804
520470,201812,414,258,156,245826.63,148824,394650.63
520480,201812,81,48,33,45792,31437,77229
520485,201812,123,44,79,41976,75080,117056
520490,201812,431,315,116,300325.98,110664,410989.98
520495,201812,175,106,69,101124,65826,166950
520500,201812,176,132,44,125928,41976,167904
520505,201812,174,91,83,86809.23,79182,165991.23
520510,201812,1768,878,890,835192.52,846518.48,1681711.00
520520,201812,36,29,7,27666,6678,34344
520530,201812,233,177,56,167134.12,53414.46,220548.58
520540,201812,536,364,172,345949.02,164088,510037.02
520545,201812,145,85,60,81090,57240,138330
520547,201812,52,30,22,28620,20988,49608
520549,201812,1152,563,589,536778,561779,1098557
520551,201812,297,156,141,148824,134228,283052
520552,201812,46,28,18,26712,17172,43884
520570,201812,16,9,7,8586,6678,15264
520580,201812,291,176,115,167894.46,109710,277604.46
520590,201812,161,98,63,93483,59815.8,153298.8
520620,201812,1161,548,613,521934.48,584506.26,1106440.74
520630,201812,41,25,16,23850,15264,39114
520640,201812,405,233,172,222282,164079,386361
520650,201812,62,40,22,38160,20988,59148
520660,201812,35,19,16,18117,15264,33381
520670,201812,35,30,5,28620,4770,33390
520680,201812,56,37,19,35298,18126,53424
520690,201812,34,11,23,10494,21913.92,32407.92
520710,201812,38,34,4,32436,3816,36252
520725,201812,190,125,65,119250,62010,181260
520735,201812,60,42,18,40068,17172,57240
520740,201812,409,202,207,191993.4,197469,389462.4
520750,201812,37,29,8,27666,7632,35298
520753,201812,56,38,18,36252,17172,53424
520760,201812,116,78,38,74412,36252,110664
520780,201812,293,220,73,209880,69623,279503
520790,201812,162,83,79,78895.8,75366,154261.8
520800,201812,3443,1848,1595,1760576.06,1521096,3281672.06
520810,201812,171,125,46,119250,43884,163134
520815,201812,5,5,0,4770,0,4770
520830,201812,149,105,44,100170,41689.8,141859.8
520840,201812,358,237,121,225621,115434,341055
520850,201812,111,72,39,68669.46,37053.36,105722.82
520860,201812,1702,1084,618,1032715.54,588428.2,1621143.74
520870,201812,31550,15465,16085,14727363.46,15328467.22,30055830.68
520880,201812,1106,600,506,571827.8,482704.92,1054532.72
520890,201812,800,472,328,448657.4,312807.46,761464.86
520910,201812,1026,548,478,518547.94,456012,974559.94
520915,201812,102,77,25,73458,23850,97308
520920,201812,407,198,209,188319.6,199376.46,387696.06
520929,201812,16,15,1,14310,954,15264
520940,201812,76,49,27,46746,25758,72504
520945,201812,20,12,8,11448,7632,19080
520960,201812,48,31,17,29574,16218,45792
520970,201812,331,208,123,197516.8,117055.8,314572.6
520980,201812,87,66,21,62964,20034,82998
520990,201812,474,321,153,306234,145962,452196
520993,201812,126,60,66,57240,62964,120204
520995,201812,245,136,109,128791,103414,232205
521000,201812,1590,930,660,886266.8,629258.8,1515525.6
521010,201812,667,312,355,297035.36,338594.76,635630.12
521015,201812,18,11,7,10494,6678,17172
521020,201812,1464,1028,436,980082.9,415573.22,1395656.12
521030,201812,48,34,14,32436,13356,45792
521040,201812,952,593,359,565484.2,342200,907684.2
521056,201812,40,29,11,27666,10494,38160
521060,201812,135,85,50,81090,47700,128790
521080,201812,466,352,114,335493.92,108756,444249.92
521090,201812,536,327,209,310431.6,199386,509817.6
521100,201812,277,207,70,197469,66780,264249
521120,201812,1055,742,313,707295.8,298306.8,1005602.6
521130,201812,364,261,103,248984.46,97376.6,346361.06
521140,201812,177,97,80,92538,76320,168858
521150,201812,2773,1213,1560,1155620.88,1486977.03,2642597.91
521160,201812,32,17,15,16218,14310,30528
521170,201812,195,114,81,108746.46,77274,186020.46
521180,201812,1152,733,419,697651.26,399011.2,1096662.46
521190,201812,2544,1077,1467,1027438.92,1399212.72,2426651.64
521200,201812,49,36,13,34344,12402,46746
521205,201812,12,9,3,8586,2862,11448
521210,201812,143,81,62,77274,59148,136422
521220,201812,827,570,257,541872.8,244558.6,786431.4
521225,201812,33,22,11,20988,10494,31482
521230,201812,111,75,36,71550,34344,105894
521250,201812,6215,3586,2629,3411147.26,2505759.26,5916906.52
521260,201812,23,15,8,14310,7632,21942
521270,201812,140,110,30,104940,28620,133560
521280,201812,438,260,178,246704.4,169812,416516.4
521290,201812,30,12,18,11448,17172,28620
521295,201812,99,67,32,63918,30528,94446
521300,201812,220,114,106,108738,100791.92,209529.92
521305,201812,35,24,11,22896,10494,33390
521308,201812,1090,810,280,772489.14,266825,1039314.14
521310,201812,1344,799,545,760197.8,518738.92,1278936.72
521340,201812,20,16,4,15264,3816,19080
521350,201812,132,98,34,93492,32436,125928
521370,201812,191,127,64,120871.8,60769.8,181641.6
521375,201812,183,101,82,96354,77941.8,174295.8
521377,201812,54,37,17,35298,16218,51516
521380,201812,1085,708,377,671283.66,359658,1030941.66
521385,201812,15,8,7,7632,6678,14310
521390,201812,104,84,20,79818.04,19080,98898.04
521400,201812,330,212,118,201961.8,112572,314533.8
521405,201812,149,80,69,76320,65826,142146
521410,201812,60,39,21,37206,20034,57240
521440,201812,201,146,55,138473.1,52470,190943.1
521450,201812,731,406,325,387324,310050,697374
521460,201812,1194,742,452,707868,431160.92,1139028.92
521470,201812,12,8,4,7632,3816,11448
521480,201812,46,31,15,29547,14245,43792
521483,201812,313,173,140,164498.5,133560,298058.5
521486,201812,290,186,104,176938.38,98549,275487.38
521487,201812,22,11,11,10494,10494,20988
521490,201812,25,14,11,13356,10494,23850
521500,201812,117,78,39,74412,37206,111618
521520,201812,41,29,12,27666,11448,39114
521523,201812,645,398,247,376375.32,235638,612013.32
521525,201812,46,30,16,28620,14977.8,43597.8
521530,201812,257,137,120,130698,114480,245178
521540,201812,30,16,14,15264,13356,28620
521550,201812,90,41,49,38781.92,46690.92,85472.84
521560,201812,805,556,249,530138,237403,767541
521565,201812,54,36,18,34344,17172,51516
521570,201812,501,334,167,318626.46,159223.3,477849.76
521580,201812,59,37,22,35298,20988,56286
521590,201812,37,20,17,19080,16218,35298
521600,201812,27,16,11,15264,10494,25758
521630,201812,245,129,116,123056.46,109673.96,232730.42
521640,201812,300,155,145,147870,137757.6,285627.6
521645,201812,28,15,13,14310,12402,26712
521680,201812,221,140,81,133560,77274,210834
521690,201812,2,2,0,1908,0,1908
521710,201812,1167,560,607,533953.8,579069,1113022.8
521720,201812,547,371,176,353924.46,167866.46,521790.92
521730,201812,642,307,335,292783,318483.56,611266.56
521740,201812,903,370,533,352951.92,507291.32,860243.24
521760,201812,1649,917,732,873240.63,698014,1571254.63
521770,201812,818,519,299,495126,284778.54,779904.54
521800,201812,2047,1285,762,1222338.48,725570.1,1947908.58
521805,201812,33,20,13,19080,12402,31482
521810,201812,90,58,32,55045.8,30528,85573.8
521830,201812,953,680,273,646813,260433,907246
521839,201812,87,57,30,54378,28620,82998
521850,201812,1110,589,521,560486.92,496709.14,1057196.06
521860,201812,358,225,133,214650,126596,341246
521870,201812,75,44,31,41976,29574,71550
521878,201812,39,19,20,18126,19080,37206
521880,201812,4658,2104,2554,2004946.36,2434434.96,4439381.32
521890,201812,583,415,168,395910,159985.8,555895.8
521900,201812,296,237,59,225461.96,56286,281747.96
521910,201812,152,106,46,101124,43884,145008
521920,201812,54,27,27,25758,25758,51516
521925,201812,36,22,14,20988,13356,34344
521930,201812,1131,643,488,613225.98,464917.88,1078143.86
521935,201812,35,27,8,25758,7632,33390
521940,201812,191,98,93,93492,88717.23,182209.23
521945,201812,15,13,2,12402,1908,14310
521950,201812,9,5,4,4770,3816,8586
521960,201812,77,58,19,55332,18126,73458
521970,201812,421,272,149,259201.8,142146,401347.8
521971,201812,92,46,46,43884,43884,87768
521973,201812,28,13,15,12402,14310,26712
521975,201812,1212,625,587,595773.2,559177.66,1154950.86
521980,201812,250,173,77,165042,73458,238500
521990,201812,75,54,21,51516,20034,71550
522000,201812,291,187,104,178398,99216,277614
522005,201812,19,11,8,10494,7632,18126
522010,201812,1151,650,501,620091,477620.1,1097711.1
522015,201812,58,37,21,35289,20034,55323
522020,201812,878,485,393,461736.2,374140.12,835876.32
522026,201812,28,20,8,19080,7632,26712
522028,201812,15,11,4,10494,3816,14310
522040,201812,761,301,460,287136,438785.46,725921.46
522045,201812,2281,1405,876,1339927.26,834598.6,2174525.86
522050,201812,164,80,84,76320,80136,156456
522060,201812,546,349,197,332659.8,187842.6,520502.4
522068,201812,129,88,41,83813.59,39114,122927.59
522070,201812,10,10,0,9540,0,9540
522100,201812,45,25,20,23850,19080,42930
522108,201812,40,31,9,29574,8586,38160
522119,201812,57,31,26,29574,24804,54378
522130,201812,76,28,48,26703,45774,72477
522140,201812,3828,1929,1899,1835779.28,1809119.98,3644899.26
522145,201812,53,34,19,32436,18126,50562
522150,201812,63,48,15,45792,14310,60102
522155,201812,55,37,18,35289,17172,52461
522157,201812,4,3,1,2862,954,3816
522160,201812,1737,1026,711,977659.2,678285,1655944.2
522170,201812,396,266,130,253764,124020,377784
522180,201812,38,20,18,19080,17172,36252
522185,201812,1974,781,1193,741824.5,1137591.46,1879415.96
522190,201812,45,26,19,24804,18030.6,42834.6
522200,201812,303,183,120,174582,114480,289062
522205,201812,158,109,49,103986,46746,150732
522220,201812,160,115,45,109710,42930,152640
522230,201812,33,28,5,26712,4770,31482
530010,201812,55474,28612,26862,27156165.18,25574769.74,52730934.92
